ind,time,household_id,member,household_founded,infant,school_age,adult,retired,household_size
0,0,0,0;1;2;3,0,0,1,2,1,4
1,0,1,4;5;6;7,0,0,2,1,1,4
2,0,2,8;9;10;11;12;13,0,0,2,2,2,6
3,0,3,14;15,0,0,0,2,0,2
4,0,4,16;17;18,0,1,0,1,1,3
5,0,5,19,0,0,0,0,1,1
6,0,6,20;21;22,0,0,0,3,0,3
7,0,7,23;24,0,0,0,1,1,2
8,0,8,25;26,0,0,0,2,0,2
9,0,9,27;28;29,0,1,0,2,0,3
10,0,10,30,0,0,0,1,0,1
11,0,11,31;32,0,0,0,1,1,2
12,0,12,33;34;35;36;37;38,0,0,3,3,0,6
13,0,13,39,0,0,0,1,0,1
14,0,14,40;41;42;43;44,0,1,0,4,0,5
15,0,15,45;46;47;48;49;50,0,0,1,5,0,6
16,0,16,51;52,0,0,0,1,1,2
17,0,17,53;54;55;56;57;8207,0,2,2,2,0,6
18,0,18,58,0,0,0,1,0,1
19,0,19,59;60;61,0,1,0,1,1,3
20,0,20,62;63;64;65,0,0,2,2,0,4
21,0,21,66;67,0,0,0,1,1,2
22,0,22,69;70;71,0,0,0,3,0,3
23,0,23,72;73;74;75,0,0,2,2,0,4
24,0,24,76;77,0,0,0,1,1,2
25,0,25,78;79;80;81,0,1,1,2,0,4
26,0,26,82;83;84,0,0,1,0,2,3
27,0,27,85;86;87,0,1,0,2,0,3
28,0,28,88;89;90,0,0,2,0,1,3
29,0,29,91;92;93;94,0,2,0,2,0,4
30,0,30,95,0,0,0,1,0,1
31,0,31,96;97,0,0,0,2,0,2
32,0,32,98,0,0,0,1,0,1
33,0,33,99;100,0,0,0,2,0,2
34,0,34,101;102;103,0,0,0,1,2,3
35,0,35,104;105;107,0,0,1,1,1,3
36,0,36,108;109;110;111;112;113,0,1,2,3,0,6
37,0,37,114;115;116,0,0,1,2,0,3
38,0,38,117;118;119;120,0,1,1,2,0,4
39,0,39,121;123,0,0,0,0,2,2
40,0,40,124;125,0,0,0,2,0,2
41,0,41,126;127,0,0,0,0,2,2
42,0,42,128;129;130,0,0,0,2,1,3
43,0,43,131;132,0,0,0,2,0,2
44,0,44,133;134;135;136,0,2,0,2,0,4
45,0,45,137,0,0,0,1,0,1
46,0,46,138;7434,0,0,0,2,0,2
47,0,47,139;140,0,0,0,1,1,2
48,0,48,141,0,0,0,1,0,1
49,0,49,142;144;145;146;147,0,0,1,4,0,5
50,0,50,148;149,0,0,0,1,1,2
51,0,51,150,0,0,0,1,0,1
52,0,52,151;152;153,0,0,1,1,1,3
53,0,53,154;155;10021,0,1,0,2,0,3
54,0,54,156;157;158;159;160,0,1,1,3,0,5
55,0,55,162;163,0,0,1,1,0,2
56,0,56,164;6873;10008,0,1,0,2,0,3
57,0,57,165;166,0,0,0,2,0,2
58,0,58,167;168;169;170,0,2,0,1,1,4
59,0,59,171;172,0,0,0,2,0,2
60,0,60,173;174;175,0,0,1,1,1,3
61,0,61,176;177;178;179;180;181;182;183,0,0,4,4,0,8
62,0,62,185;186,0,0,0,1,1,2
63,0,63,187;188;189,0,0,1,1,1,3
64,0,64,190;192,0,0,0,2,0,2
65,0,65,193;194,0,0,0,2,0,2
66,0,66,195;196;10107,0,1,0,2,0,3
67,0,67,197;198;199,0,0,1,1,1,3
68,0,68,200;201;202;203;204;205,0,0,1,5,0,6
69,0,69,206;207,0,0,0,2,0,2
70,0,70,208,0,0,0,0,1,1
71,0,71,209;210,0,0,0,2,0,2
72,0,72,211;212;213,0,0,2,0,1,3
73,0,73,214;215;216;217;218;219,0,2,2,2,0,6
74,0,74,220;221,0,0,0,1,1,2
75,0,75,222,0,0,0,0,1,1
76,0,76,223;224;225,0,0,0,1,2,3
77,0,77,226;227;228,0,1,0,2,0,3
78,0,78,229;230;231;232,0,0,0,4,0,4
79,0,79,233;234;235,0,0,0,3,0,3
80,0,80,236;237;238;239;240,0,0,1,3,1,5
81,0,81,241;242,0,0,0,2,0,2
82,0,82,243;244,0,0,0,2,0,2
83,0,83,245;246;247,0,0,1,2,0,3
84,0,84,248;249;250,0,0,1,2,0,3
85,0,85,251;252,0,0,0,2,0,2
86,0,86,253;254,0,0,0,2,0,2
87,0,87,255,0,0,0,1,0,1
88,0,88,256;257,0,0,0,2,0,2
89,0,89,258,0,0,0,1,0,1
90,0,90,260;261;262;10062,0,1,0,3,0,4
91,0,91,263,0,0,0,0,1,1
92,0,93,265;266;267;268,0,1,0,2,1,4
93,0,94,269;270;271;272,0,0,1,3,0,4
94,0,95,273;274,0,0,0,0,2,2
95,0,96,275;276;277;278,0,0,2,2,0,4
96,0,97,279,0,0,0,1,0,1
97,0,98,280,0,0,0,1,0,1
98,0,99,281;282;283,0,0,0,3,0,3
99,0,100,284;285,0,0,0,2,0,2
100,0,101,286;287,0,0,0,2,0,2
101,0,102,288;289,0,0,0,2,0,2
102,0,103,290;291;292;293;294,0,0,2,2,1,5
103,0,104,295;296,0,0,0,2,0,2
104,0,105,297,0,0,0,1,0,1
105,0,106,298;299;300,0,0,0,3,0,3
106,0,107,301;302,0,0,0,2,0,2
107,0,108,303,0,0,0,1,0,1
108,0,109,304;305;306;307,0,0,0,4,0,4
109,0,110,308;309;310;311,0,0,0,3,1,4
110,0,111,312;313;314;315;316,0,0,1,3,1,5
111,0,112,317;318;319;320,0,2,0,2,0,4
112,0,113,321;322,0,0,0,2,0,2
113,0,114,323;324,0,0,0,2,0,2
114,0,115,325;326,0,0,0,2,0,2
115,0,116,327,0,0,0,1,0,1
116,0,117,328,0,0,0,0,1,1
117,0,118,329;330;331;332;333;334,0,1,1,4,0,6
118,0,119,335;336;337,0,0,0,3,0,3
119,0,120,338,0,0,0,0,1,1
120,0,121,339;340,0,0,0,1,1,2
121,0,122,341;342,0,0,0,2,0,2
122,0,123,343,0,0,0,1,0,1
123,0,124,344;345,0,0,0,2,0,2
124,0,125,346;347;348;349;350,0,0,3,2,0,5
125,0,126,351,0,0,0,0,1,1
126,0,127,352,0,0,0,1,0,1
127,0,128,353;354;355;356;357,0,0,2,2,1,5
128,0,129,358;359;360;361,0,0,1,3,0,4
129,0,130,362,0,0,0,1,0,1
130,0,131,363;364,0,0,0,2,0,2
131,0,132,365;366;367,0,1,0,1,1,3
132,0,133,369;370;371,0,0,0,2,1,3
133,0,134,372,0,0,0,1,0,1
134,0,135,373,0,0,0,0,1,1
135,0,136,374;375;376;377;378;379,0,1,1,2,2,6
136,0,137,380,0,0,0,1,0,1
137,0,138,381;382;383,0,1,0,2,0,3
138,0,139,384;385;386,0,1,0,2,0,3
139,0,140,387,0,0,0,1,0,1
140,0,141,388;389;390,0,0,1,2,0,3
141,0,142,391;392;393,0,0,0,2,1,3
142,0,143,394,0,0,0,1,0,1
143,0,144,395;396;397,0,0,0,2,1,3
144,0,145,398;399,0,0,0,2,0,2
145,0,146,400,0,0,0,1,0,1
146,0,147,401,0,0,0,1,0,1
147,0,148,402;403;404;405,0,1,1,2,0,4
148,0,149,406,0,0,0,1,0,1
149,0,150,407;408;409;410,0,0,0,2,2,4
150,0,151,411,0,0,0,1,0,1
151,0,152,412;413;414,0,0,1,2,0,3
152,0,153,415,0,0,0,0,1,1
153,0,154,416,0,0,0,1,0,1
154,0,155,417,0,0,0,1,0,1
155,0,156,418;419;420;421,0,0,1,3,0,4
156,0,157,422;423;424,0,0,0,3,0,3
157,0,158,425;426,0,0,0,2,0,2
158,0,159,427;428,0,0,0,2,0,2
159,0,160,429;430;431,0,1,1,0,1,3
160,0,161,432;433,0,0,0,1,1,2
161,0,162,435;436,0,0,0,2,0,2
162,0,163,437;438;439;440,0,0,1,3,0,4
163,0,164,441;442;443;444,0,0,1,2,1,4
164,0,165,445;446;447;448,0,2,0,2,0,4
165,0,166,449;450,0,0,0,1,1,2
166,0,167,451;452,0,0,0,1,1,2
167,0,168,453;454,0,0,0,2,0,2
168,0,169,455;456;457;458;459;460;461,0,1,0,4,2,7
169,0,170,462;463,0,0,0,1,1,2
170,0,171,464;465;466;467,0,0,0,4,0,4
171,0,172,468;469,0,0,0,1,1,2
172,0,173,470,0,0,1,0,0,1
173,0,174,471;472,0,0,0,1,1,2
174,0,175,473;474;475;476;477,0,2,0,3,0,5
175,0,176,478;479;480;6937,0,0,2,2,0,4
176,0,177,481;482,0,0,0,2,0,2
177,0,178,483;484;485;486;487;488;489;490,0,0,2,5,1,8
178,0,179,491;492;493;494,0,2,0,2,0,4
179,0,180,495,0,0,0,1,0,1
180,0,181,496;497,0,0,0,2,0,2
181,0,182,498;499,0,0,0,2,0,2
182,0,183,500,0,0,0,1,0,1
183,0,184,501;502;503,0,0,1,1,1,3
184,0,185,504;505,0,0,0,1,1,2
185,0,186,506,0,0,0,1,0,1
186,0,187,507;508,0,0,0,1,1,2
187,0,188,509;510;511;512;513,0,0,2,3,0,5
188,0,189,514;515;516;517,0,0,1,2,1,4
189,0,190,518;519;520,0,0,0,3,0,3
190,0,191,521;522;523;524,0,0,0,3,1,4
191,0,192,525;526;527,0,0,0,1,2,3
192,0,193,529;530,0,0,0,2,0,2
193,0,194,531,0,0,0,1,0,1
194,0,195,532,0,0,0,1,0,1
195,0,196,533,0,0,0,0,1,1
196,0,197,534;535;536;537,0,0,2,2,0,4
197,0,198,538;539,0,0,0,2,0,2
198,0,199,540;541;542,0,0,0,3,0,3
199,0,200,543;544;545;546,0,2,0,2,0,4
200,0,201,547;548;549;550,0,0,0,3,1,4
201,0,202,551;552,0,0,0,2,0,2
202,0,203,553;554,0,0,0,1,1,2
203,0,204,555;556;557;558,0,0,0,1,3,4
204,0,205,559;560;561;562,0,1,1,1,1,4
205,0,206,563;564,0,0,0,1,1,2
206,0,207,565;566;567;568,0,0,1,3,0,4
207,0,208,569,0,0,0,1,0,1
208,0,209,571;5145,0,0,0,2,0,2
209,0,210,572;573;574,0,1,0,2,0,3
210,0,211,575,0,0,0,1,0,1
211,0,212,576,0,0,0,1,0,1
212,0,213,577;578,0,0,1,0,1,2
213,0,214,579,0,0,0,1,0,1
214,0,215,580,0,0,0,0,1,1
215,0,216,581;582;583;584,0,0,1,3,0,4
216,0,217,585,0,0,0,1,0,1
217,0,218,589;590,0,0,0,2,0,2
218,0,219,591;592;593;594,0,0,0,3,1,4
219,0,220,595;596,0,0,0,2,0,2
220,0,221,597;598,0,0,0,1,1,2
221,0,222,599;600,0,0,0,1,1,2
222,0,223,601;602;603;604,0,1,1,2,0,4
223,0,224,605,0,0,0,1,0,1
224,0,225,606;607;608,0,0,0,0,3,3
225,0,226,609,0,0,0,1,0,1
226,0,227,610;611;612;613,0,2,0,2,0,4
227,0,228,614;615;616;617,0,0,1,3,0,4
228,0,229,618;619,0,0,0,1,1,2
229,0,230,620,0,0,0,1,0,1
230,0,231,621;622,0,0,0,1,1,2
231,0,232,623,0,0,0,1,0,1
232,0,233,624;626,0,0,0,2,0,2
233,0,234,627,0,0,0,0,1,1
234,0,235,628;629;630;631;632,0,2,1,2,0,5
235,0,236,633;634,0,0,0,1,1,2
236,0,238,637;638;639,0,0,1,2,0,3
237,0,239,640;641;642;643,0,0,1,2,1,4
238,0,240,644;645,0,0,0,1,1,2
239,0,241,646;647;648,0,0,1,2,0,3
240,0,242,649,0,0,0,0,1,1
241,0,243,650;651;652;653,0,2,0,2,0,4
242,0,244,654,0,0,0,0,1,1
243,0,245,656;657,0,0,0,2,0,2
244,0,246,658,0,0,0,1,0,1
245,0,247,659;660,0,0,0,2,0,2
246,0,248,661;662,0,0,0,1,1,2
247,0,249,663;664;665,0,1,0,0,2,3
248,0,250,666;667,0,0,0,2,0,2
249,0,251,669,0,0,0,1,0,1
250,0,252,670,0,0,0,1,0,1
251,0,253,671;673;674,0,0,1,1,1,3
252,0,254,675;676,0,0,0,2,0,2
253,0,255,677;678;679;680,0,0,1,2,1,4
254,0,256,682;683;684;685;686,0,0,2,3,0,5
255,0,257,687;688,0,0,0,2,0,2
256,0,258,689,0,0,0,1,0,1
257,0,259,690,0,0,0,0,1,1
258,0,260,691;692,0,0,0,1,1,2
259,0,261,693,0,0,0,0,1,1
260,0,262,694,0,0,0,1,0,1
261,0,263,696,0,0,0,0,1,1
262,0,264,697;698,0,0,0,2,0,2
263,0,265,699;700;701;702,0,0,0,3,1,4
264,0,266,703;704;705;706,0,0,1,1,2,4
265,0,267,707,0,0,0,1,0,1
266,0,268,708;3877,0,0,0,2,0,2
267,0,269,709;710,0,0,0,2,0,2
268,0,270,711;712;713;714,0,0,1,2,1,4
269,0,271,715,0,0,0,1,0,1
270,0,272,716;717,0,0,0,1,1,2
271,0,273,718;719;720;721,0,0,2,2,0,4
272,0,274,722;723,0,0,0,2,0,2
273,0,275,724;725;727;728,0,0,0,4,0,4
274,0,276,729;730;731;732,0,0,0,3,1,4
275,0,277,733;734;735;736,0,0,0,3,1,4
276,0,278,737,0,0,0,1,0,1
277,0,279,738,0,0,0,1,0,1
278,0,280,739;740,0,1,0,0,1,2
279,0,281,741;742,0,0,0,2,0,2
280,0,282,743,0,0,0,1,0,1
281,0,283,744;745,0,0,0,1,1,2
282,0,284,746;747,0,0,0,2,0,2
283,0,285,748,0,0,0,1,0,1
284,0,286,749;750;751;752;753,0,0,3,1,1,5
285,0,287,754,0,0,0,0,1,1
286,0,288,755;756;10108,0,1,0,1,1,3
287,0,289,757;758,0,0,0,2,0,2
288,0,291,760,0,0,0,1,0,1
289,0,292,761;762,0,0,0,2,0,2
290,0,294,764;765,0,0,1,1,0,2
291,0,295,766;767,0,0,0,2,0,2
292,0,296,768;769;770;771,0,0,1,1,2,4
293,0,297,772;773;774,0,0,2,1,0,3
294,0,298,775;776;777;778,0,0,0,3,1,4
295,0,299,779;780;781,0,0,0,3,0,3
296,0,300,782;783,0,0,0,2,0,2
297,0,301,784;785;786;787,0,0,1,1,2,4
298,0,302,788,0,0,0,1,0,1
299,0,303,789,0,0,0,1,0,1
300,0,304,790;791;792;793;794;795,0,0,3,2,1,6
301,0,305,796;797;798,0,0,0,3,0,3
302,0,306,799;800;801;802;803;804;10106,0,3,2,2,0,7
303,0,307,805,0,0,0,1,0,1
304,0,308,806;807,0,0,0,2,0,2
305,0,309,808;809;810;811,0,0,1,2,1,4
306,0,310,812;813,0,0,0,2,0,2
307,0,311,814;815,0,0,0,2,0,2
308,0,312,816,0,0,0,1,0,1
309,0,313,817;818;819,0,0,0,3,0,3
310,0,314,820,0,0,0,1,0,1
311,0,315,821;822,0,0,0,2,0,2
312,0,316,823,0,0,0,1,0,1
313,0,317,824;825;826;829,0,0,1,0,3,4
314,0,318,830;831,0,0,0,2,0,2
315,0,319,832;833,0,0,0,2,0,2
316,0,321,835;836;837;838;839,0,1,2,2,0,5
317,0,322,840;841,0,0,0,1,1,2
318,0,323,842;843;844,0,0,0,2,1,3
319,0,324,845;846;847;848,0,0,0,2,2,4
320,0,325,849;850,0,0,0,0,2,2
321,0,326,851;852;853,0,0,1,2,0,3
322,0,327,854;855,0,0,0,2,0,2
323,0,328,856,0,0,0,0,1,1
324,0,329,857;858;860,0,0,0,2,1,3
325,0,330,861;862;863;864;865,0,1,1,3,0,5
326,0,331,866;867,0,0,0,2,0,2
327,0,332,868;869;870;871,0,0,1,3,0,4
328,0,333,872;873;874,0,0,0,2,1,3
329,0,334,875;876;877;878;10049,0,2,1,2,0,5
330,0,335,879;880,0,0,0,2,0,2
331,0,336,881;882,0,0,0,2,0,2
332,0,337,883,0,0,0,1,0,1
333,0,338,885;886,0,0,0,2,0,2
334,0,339,887;888;889;890;891;892,0,0,3,2,1,6
335,0,340,893;894;895;896,0,0,1,3,0,4
336,0,341,897;898,0,0,1,1,0,2
337,0,342,899;900;901;902;903,0,0,1,3,1,5
338,0,343,904;905,0,0,0,2,0,2
339,0,344,906;907;908;909,0,1,0,3,0,4
340,0,345,910,0,0,0,0,1,1
341,0,346,911,0,0,0,1,0,1
342,0,347,912;913,0,0,0,2,0,2
343,0,348,914;915,0,0,0,1,1,2
344,0,349,916,0,0,0,1,0,1
345,0,350,917;918;919;920;921,0,0,2,2,1,5
346,0,351,922;923,0,0,0,1,1,2
347,0,352,924;925,0,0,0,2,0,2
348,0,353,926;927;928;929,0,0,1,2,1,4
349,0,354,930;931;932;933,0,0,2,2,0,4
350,0,355,934;935;936,0,0,0,2,1,3
351,0,356,937;938,0,0,0,1,1,2
352,0,357,939;940,0,0,0,2,0,2
353,0,358,941;942;943;944;945,0,0,2,2,1,5
354,0,359,946,0,0,0,1,0,1
355,0,360,947,0,0,0,1,0,1
356,0,361,948;949;950;951;952;953,0,1,0,5,0,6
357,0,362,954;955,0,0,0,2,0,2
358,0,363,956;957;958;959;960,0,1,1,1,2,5
359,0,364,962;963;964,0,0,0,3,0,3
360,0,365,965;966,0,0,0,2,0,2
361,0,366,967;968,0,0,0,2,0,2
362,0,367,969;970;971;972;973;974;975;976;977;978,0,0,0,8,2,10
363,0,368,979;980;981;982,0,0,1,2,1,4
364,0,369,983;984;985;986;987;988,0,1,2,3,0,6
365,0,370,989;990,0,0,0,2,0,2
366,0,371,991,0,0,0,1,0,1
367,0,372,992;993,0,0,0,1,1,2
368,0,373,994;995,0,0,0,2,0,2
369,0,374,996;5825,0,0,0,2,0,2
370,0,375,997;998,0,0,0,1,1,2
371,0,376,999;1000;1001,0,0,1,2,0,3
372,0,377,1002,0,0,0,1,0,1
373,0,378,1004;1005,0,0,0,2,0,2
374,0,379,1006;1007;1008;1009;1010,0,0,1,4,0,5
375,0,380,1011,0,0,0,0,1,1
376,0,381,1012;1013,0,0,0,2,0,2
377,0,382,1014;1015;1016,0,0,1,1,1,3
378,0,383,1017;1018,0,0,0,0,2,2
379,0,385,1020;1021,0,0,0,2,0,2
380,0,386,1022,0,0,0,0,1,1
381,0,387,1023;1024;1025;1026;1027,0,1,1,2,1,5
382,0,388,1028;1029;1030;1031;1032,0,0,1,4,0,5
383,0,389,1033;1034;1035,0,1,0,1,1,3
384,0,390,1036,0,0,0,1,0,1
385,0,391,1037;1038,0,0,0,0,2,2
386,0,392,1039,0,0,0,1,0,1
387,0,393,1040;1041;1042;1043;1044;1045,0,2,0,2,2,6
388,0,394,1046,0,0,0,1,0,1
389,0,395,1047;1048;1049;1050;1051,0,3,0,1,1,5
390,0,396,1052;1053;1054;1055;1056,0,0,1,3,1,5
391,0,397,1057,0,0,0,1,0,1
392,0,398,1058,0,0,0,1,0,1
393,0,399,1059;1060;1061,0,0,0,3,0,3
394,0,400,1062;1063;1064;1065,0,0,1,3,0,4
395,0,401,1066,0,0,0,1,0,1
396,0,402,1067;1068,0,0,0,1,1,2
397,0,403,1069;1070;1071,0,0,0,2,1,3
398,0,404,1072;1073;1074,0,0,0,2,1,3
399,0,405,1075,0,0,0,1,0,1
400,0,406,1076;1077;10072,0,1,0,2,0,3
401,0,407,1078,0,0,0,1,0,1
402,0,408,1079,0,0,0,0,1,1
403,0,409,1080;1081,0,0,0,2,0,2
404,0,410,1082,0,0,0,1,0,1
405,0,411,1083;1084,0,0,1,1,0,2
406,0,412,1085;1086,0,0,0,2,0,2
407,0,413,1087,0,0,0,1,0,1
408,0,414,1088;1089,0,0,0,2,0,2
409,0,415,1090;1091;1092;1093,0,2,0,2,0,4
410,0,416,1094;1095;1096;6775,0,0,1,3,0,4
411,0,417,1097;1098;1099;1100,0,0,1,2,1,4
412,0,418,1101;1102;10048,0,1,0,2,0,3
413,0,419,1103;1104,0,0,1,0,1,2
414,0,420,1105;1106;1107,0,1,0,2,0,3
415,0,421,1108,0,0,0,1,0,1
416,0,422,1109;1110,0,0,0,1,1,2
417,0,423,1111;1112,0,0,0,2,0,2
418,0,424,1113;1114;1115;1116,0,0,1,3,0,4
419,0,425,1117,0,0,0,1,0,1
420,0,426,1118,0,0,0,1,0,1
421,0,427,1119;1121;1122;1123,0,0,2,0,2,4
422,0,428,1124;1125,0,0,0,2,0,2
423,0,429,1126;1127;1128,0,0,0,1,2,3
424,0,430,1129;1130,0,0,0,2,0,2
425,0,431,1131,0,0,0,1,0,1
426,0,432,1132;1133;1134,0,0,1,1,1,3
427,0,433,1135;1136,0,0,1,1,0,2
428,0,434,1137;1138;1139;1140;1141,0,0,3,2,0,5
429,0,435,1142;1143;1144,0,1,0,1,1,3
430,0,436,1145;1146;1147;1148,0,0,2,1,1,4
431,0,437,1149;1150;1151;1152,0,1,1,0,2,4
432,0,438,1153;1154,0,0,0,1,1,2
433,0,439,1155;1156;1157;1158,0,1,1,1,1,4
434,0,440,1159;1160;1161;1162;1163;1164,0,1,2,2,1,6
435,0,441,1165;1166;1167;1168;1169,0,0,1,3,1,5
436,0,442,1170,0,0,0,0,1,1
437,0,443,1171,0,0,0,0,1,1
438,0,444,1172;1173;1174,0,0,0,2,1,3
439,0,445,1175;1176,0,0,0,2,0,2
440,0,446,1177,0,0,0,1,0,1
441,0,447,1179,0,0,0,1,0,1
442,0,448,1180;1181,0,0,0,2,0,2
443,0,449,1182,0,0,0,1,0,1
444,0,450,1183;1184,0,0,0,1,1,2
445,0,451,1185;1186,0,0,0,2,0,2
446,0,452,1187;1188,0,0,0,1,1,2
447,0,453,1189;1190;1191;1192,0,2,0,2,0,4
448,0,454,1193,0,0,0,1,0,1
449,0,455,1194;1195;1196;1197,0,0,0,3,1,4
450,0,456,1198,0,0,0,1,0,1
451,0,457,1200;1201,0,0,0,2,0,2
452,0,458,1202;1203,0,0,0,1,1,2
453,0,459,1204;4248,0,0,0,2,0,2
454,0,460,1205;1206;1207;1208;1209,0,0,0,4,1,5
455,0,461,1210;1211;1212;1213,0,0,2,2,0,4
456,0,462,1214;1215;1216;1217;1218,0,0,3,2,0,5
457,0,463,1219,0,0,0,1,0,1
458,0,464,1220;1221,0,0,0,2,0,2
459,0,465,1222,0,0,0,1,0,1
460,0,466,1223;1224,0,0,0,2,0,2
461,0,467,1225;1226;1227,0,0,0,3,0,3
462,0,468,1228;1229;1230;1231,0,1,0,2,1,4
463,0,469,1232,0,0,0,0,1,1
464,0,470,1233;1234;1235;1236,0,0,2,1,1,4
465,0,471,1237;1238;1239,0,0,2,0,1,3
466,0,472,1240;1241;1242,0,1,0,2,0,3
467,0,473,1244;1245;1246;1247,0,0,0,3,1,4
468,0,474,1248;1249;1250;1251;1252,0,0,2,2,1,5
469,0,475,1253;1254,0,0,0,1,1,2
470,0,476,1255;1256,0,0,0,2,0,2
471,0,477,1257;1258;1259,0,0,0,2,1,3
472,0,478,1260,0,1,0,0,0,1
473,0,479,1261;1262;1263,0,0,1,1,1,3
474,0,480,1264;1265;1266;1267,0,2,0,2,0,4
475,0,481,1268;1269;1270,0,0,1,1,1,3
476,0,482,1271;1273;1274,0,0,0,2,1,3
477,0,483,1275;1276,0,0,0,2,0,2
478,0,484,1277;1278,0,0,0,2,0,2
479,0,485,1279;1280,0,0,0,2,0,2
480,0,486,1281,0,0,0,0,1,1
481,0,487,1282;1283;1284,0,1,0,1,1,3
482,0,488,1285;1286;1287;1288,0,0,2,1,1,4
483,0,489,1289,0,0,0,0,1,1
484,0,490,1290;1291,0,0,0,2,0,2
485,0,491,1292;1293;1294;1295;1296,0,0,1,3,1,5
486,0,492,1297;1298;1299;1300;1301,0,0,1,3,1,5
487,0,493,1302;1303;1304;1305,0,1,1,1,1,4
488,0,494,1306;1307;1308,0,2,0,1,0,3
489,0,495,1309;1310,0,0,0,2,0,2
490,0,496,1311;1312;1313;1314,0,0,2,1,1,4
491,0,497,1315;1316;1317;1318,0,0,1,3,0,4
492,0,498,1319;1320;1321,0,0,1,1,1,3
493,0,499,1322,0,0,0,1,0,1
494,0,500,1323;1324,0,0,0,2,0,2
495,0,501,1325;1326,0,0,0,1,1,2
496,0,502,1327;1328;3565,0,0,1,2,0,3
497,0,503,1329,0,0,0,1,0,1
498,0,504,1330;1331;1332;1333;1334,0,1,1,2,1,5
499,0,505,1335;1336,0,0,0,1,1,2
500,0,506,1337,0,0,0,0,1,1
501,0,507,1338;1339,0,0,1,1,0,2
502,0,508,1340;1341,0,0,0,2,0,2
503,0,509,1342;1343;1344;1345,0,1,1,1,1,4
504,0,510,1346;1347;1348,0,0,0,2,1,3
505,0,511,1349;1350;1351;1352,0,0,2,0,2,4
506,0,512,1353;1354;1355,0,0,0,2,1,3
507,0,513,1356;1357;1358;1359;1360,0,2,0,1,2,5
508,0,514,1361;1362;1363;1364,0,0,1,2,1,4
509,0,515,1365,0,0,0,1,0,1
510,0,516,1366;1367;1368,0,0,0,3,0,3
511,0,517,1369;1370;1371;1372,0,0,1,3,0,4
512,0,518,1373;1374,0,0,0,2,0,2
513,0,519,1375;1376,0,0,2,0,0,2
514,0,520,1377,0,0,0,0,1,1
515,0,521,1378;1379,0,0,0,1,1,2
516,0,522,1380;1381;1382,0,1,0,1,1,3
517,0,523,1383,0,0,0,1,0,1
518,0,524,1384;1385;1386;1387;1388,0,1,2,2,0,5
519,0,525,1389,0,0,0,0,1,1
520,0,526,1390,0,0,0,1,0,1
521,0,527,1391,0,0,0,1,0,1
522,0,528,1392;1393,0,0,0,2,0,2
523,0,529,1394;1395;1396,0,0,0,1,2,3
524,0,530,1397;1398;1399,0,0,1,2,0,3
525,0,531,1400;1401,0,0,0,2,0,2
526,0,532,1402;1403,0,0,0,1,1,2
527,0,533,1404,0,0,0,0,1,1
528,0,534,1405,0,0,0,1,0,1
529,0,535,1407;1408,0,0,0,2,0,2
530,0,536,1409;1410,0,0,0,2,0,2
531,0,537,1411;1412,0,0,0,1,1,2
532,0,538,1413;1415;1416,0,0,1,1,1,3
533,0,539,1417;1418;1419;1421,0,0,0,2,2,4
534,0,540,1422;1423;1424,0,0,0,3,0,3
535,0,541,1425;1426;1427;1428,0,1,1,0,2,4
536,0,542,1429;1431;1432,0,1,0,1,1,3
537,0,543,1433,0,0,0,1,0,1
538,0,544,1434,0,0,0,0,1,1
539,0,545,1435;1436,0,0,0,2,0,2
540,0,546,1437;1438,0,0,0,2,0,2
541,0,547,1439;1440,0,0,0,2,0,2
542,0,548,1441;6517,0,0,0,2,0,2
543,0,549,1442;1443,0,0,0,2,0,2
544,0,550,1444,0,0,0,1,0,1
545,0,551,1445;1446;1447,0,0,0,2,1,3
546,0,552,1448;1449;1450;1451;1452,0,1,2,1,1,5
547,0,553,1453,0,0,0,1,0,1
548,0,554,1454;1455,0,0,0,1,1,2
549,0,555,1456;1457;1458,0,0,0,3,0,3
550,0,556,1459;1460;1461,0,1,0,2,0,3
551,0,557,1462;1463,0,0,0,1,1,2
552,0,558,1464,0,0,0,1,0,1
553,0,559,1465;1466;1467;1468,0,2,0,2,0,4
554,0,560,1469;1470;1471;1472,0,1,1,2,0,4
555,0,561,1473;1474,0,0,0,1,1,2
556,0,562,1475;1476;1477;1478,0,0,2,2,0,4
557,0,563,1479;1480,0,0,0,1,1,2
558,0,564,1481;1482,0,0,0,2,0,2
559,0,565,1483;1484;1485;1486,0,0,2,1,1,4
560,0,566,1487;1488;1489,0,0,0,2,1,3
561,0,567,1491;1492;1493,0,1,0,2,0,3
562,0,568,1494;1495;1496,0,0,0,3,0,3
563,0,569,1497;1498;1499;1500,0,0,1,2,1,4
564,0,570,1501,0,0,0,0,1,1
565,0,571,1502,0,0,0,1,0,1
566,0,572,1503;1504;1505,0,0,0,1,2,3
567,0,573,1506;10099,0,1,0,1,0,2
568,0,574,1507;1508;1509,0,0,0,2,1,3
569,0,575,1510;1511,0,0,0,2,0,2
570,0,576,1513;1514;1515,0,0,1,2,0,3
571,0,577,1516;1517,0,0,0,2,0,2
572,0,578,1518;1519,0,0,0,1,1,2
573,0,579,1520;1521;1522,0,0,1,2,0,3
574,0,580,1523;1524;1525;1526,0,0,2,2,0,4
575,0,581,1527;1528,0,0,0,1,1,2
576,0,582,1529,0,0,0,1,0,1
577,0,583,1530;1531,0,0,0,2,0,2
578,0,584,1533;1534;1535;1536;1537;1538,0,1,3,2,0,6
579,0,585,1539;1540;1541;1542,0,0,0,4,0,4
580,0,586,1543;1544;1545,0,1,1,0,1,3
581,0,587,1546;1547;1548,0,0,1,2,0,3
582,0,589,1550;1551,0,0,0,2,0,2
583,0,590,1552;1553;10003,0,1,0,1,1,3
584,0,591,1554;1555;1556,0,0,0,3,0,3
585,0,592,1557;1558,0,0,0,2,0,2
586,0,593,1559;1560,0,0,0,2,0,2
587,0,594,1561;1562;1563;1564;1565,0,2,0,3,0,5
588,0,595,1566;1567,0,0,0,2,0,2
589,0,596,1568;1569;1570;1571;1572,0,0,2,1,2,5
590,0,597,1573;1574;1575,0,0,1,1,1,3
591,0,598,1576;1577,0,1,0,0,1,2
592,0,599,1578,0,0,0,1,0,1
593,0,600,1579;1580,0,0,0,1,1,2
594,0,601,1581,0,0,0,1,0,1
595,0,602,1582;1583;1584,0,0,1,1,1,3
596,0,603,1585;1586;1587,0,0,0,3,0,3
597,0,604,1588;1589;1590;1591;1592,0,0,1,3,1,5
598,0,605,1593;1594,0,0,0,2,0,2
599,0,606,1595,0,0,0,1,0,1
600,0,607,1596;4276;10116,0,1,0,2,0,3
601,0,608,1597;1598;1599,0,0,1,2,0,3
602,0,609,1600,0,0,0,0,1,1
603,0,610,1601;1602;1603;1604,0,1,1,1,1,4
604,0,611,1605;1606,0,0,0,2,0,2
605,0,612,1607;1608;1609;7132,0,0,2,2,0,4
606,0,613,1610;1611;1612;1613,0,0,0,4,0,4
607,0,614,1614;1615;1616;1617;1618;1619,0,2,0,3,1,6
608,0,615,1620;1621;1622;1623,0,2,0,2,0,4
609,0,616,1624;1625,0,0,0,2,0,2
610,0,617,1626;1627,0,0,0,1,1,2
611,0,618,1628;1629;1630,0,0,1,2,0,3
612,0,619,1631;1632,0,0,0,2,0,2
613,0,620,1633;1634,0,0,0,2,0,2
614,0,621,1635;1636;1637,0,0,1,2,0,3
615,0,622,1638;1639;1640,0,0,1,1,1,3
616,0,623,1641;1642,0,0,0,2,0,2
617,0,624,1643;1644,0,0,0,1,1,2
618,0,625,1646;1647;1648;1649,0,0,1,3,0,4
619,0,626,1650;1651;1652;1653;1654;1655,0,0,3,3,0,6
620,0,627,1656;1657,0,0,0,2,0,2
621,0,628,1658,0,0,0,1,0,1
622,0,629,1659,0,0,0,1,0,1
623,0,630,1660;1661,0,0,0,2,0,2
624,0,631,1662;1663,0,1,0,0,1,2
625,0,632,1664;1665;1666;1667;1668,0,2,1,1,1,5
626,0,633,1669;1670;1671,0,2,0,0,1,3
627,0,634,1672;1673;1674,0,0,0,1,2,3
628,0,635,1675,0,0,0,1,0,1
629,0,636,1676,0,0,0,0,1,1
630,0,637,1677;1678,0,0,0,2,0,2
631,0,638,1679;1680;1681;1682,0,1,0,2,1,4
632,0,639,1683;1684;1685,0,0,0,3,0,3
633,0,640,1686;1687;1688;1689,0,0,0,2,2,4
634,0,641,1690;1691;1692;1693;1694,0,0,2,3,0,5
635,0,642,1695;1696;1697;1698;1699;1700,0,1,1,3,1,6
636,0,643,1701;1702,0,0,1,0,1,2
637,0,644,1703;1704;1705;1706;1707,0,0,3,1,1,5
638,0,645,1708;1709,0,0,0,1,1,2
639,0,646,1710,0,0,0,1,0,1
640,0,647,1712;1713;1714,0,0,1,1,1,3
641,0,648,1715,0,0,0,1,0,1
642,0,649,1716;1717;1718;1719;1720;1721,0,2,1,3,0,6
643,0,650,1722;1723,0,0,0,2,0,2
644,0,651,1724;1725;1726;1727,0,1,1,1,1,4
645,0,652,1728;1729;1730;1731;1732,0,0,0,2,3,5
646,0,653,1733;1734,0,0,0,2,0,2
647,0,654,1735;1737,0,0,0,2,0,2
648,0,655,1738;1739;1740;1741,0,0,1,3,0,4
649,0,656,1742;1743,0,0,0,2,0,2
650,0,657,1744;1745;1746;1747,0,1,1,2,0,4
651,0,658,1748;1749;1750;1751,0,0,1,3,0,4
652,0,659,1752;1753,0,0,0,0,2,2
653,0,660,1754,0,0,0,1,0,1
654,0,661,1755;1756,0,0,1,0,1,2
655,0,662,1757;1758,0,0,0,1,1,2
656,0,663,1760,0,0,0,1,0,1
657,0,664,1761;1762,0,0,0,2,0,2
658,0,665,1763;1764,0,0,0,2,0,2
659,0,666,1765;1766,0,0,1,1,0,2
660,0,667,1767;1768;1769;1770;1771,0,0,2,2,1,5
661,0,668,1772;1773;1774;1775;1776,0,0,1,3,1,5
662,0,669,1777;1778,0,0,0,1,1,2
663,0,670,1779;1780,0,0,0,1,1,2
664,0,671,1781;1782;1784,0,0,0,3,0,3
665,0,672,1785;1786;1787;1788;1789,0,0,3,2,0,5
666,0,673,1790,0,0,0,1,0,1
667,0,674,1791,0,0,0,1,0,1
668,0,675,1792;1793,0,0,0,1,1,2
669,0,676,1794,0,0,0,0,1,1
670,0,677,1795;1796;1797,0,1,0,2,0,3
671,0,678,1798;1799,0,0,0,0,2,2
672,0,679,1800;1801;1802;1803,0,1,0,2,1,4
673,0,680,1804;1805,0,0,0,2,0,2
674,0,681,1806;1807;1808,0,1,0,0,2,3
675,0,682,1809;1810;10043,0,1,0,2,0,3
676,0,683,1811,0,0,0,1,0,1
677,0,684,1812;1813;1814,0,0,1,2,0,3
678,0,686,1816,0,0,0,1,0,1
679,0,687,1817;1818;1819,0,0,0,3,0,3
680,0,688,1820;1821;1822;1823;1824,0,0,1,3,1,5
681,0,689,1825;1826,0,0,0,1,1,2
682,0,690,1827,0,0,0,1,0,1
683,0,691,1828,0,0,0,1,0,1
684,0,692,1829;1830,0,0,0,2,0,2
685,0,693,1831,0,0,0,1,0,1
686,0,694,1832;1833;1834,0,0,0,1,2,3
687,0,695,1835;1836;1837,0,1,0,1,1,3
688,0,696,1838;1839;1840,0,1,0,2,0,3
689,0,697,1841;1842,0,0,0,2,0,2
690,0,698,1843,0,0,0,1,0,1
691,0,699,1844;1845;1846;1847,0,0,1,2,1,4
692,0,700,1848;1849;1850;1851,0,0,0,2,2,4
693,0,701,1852,0,0,0,1,0,1
694,0,702,1853;1854,0,0,0,2,0,2
695,0,703,1855,0,0,0,1,0,1
696,0,704,1856;1857;10061,0,1,0,2,0,3
697,0,705,1858;1859,0,0,0,1,1,2
698,0,706,1861,0,0,0,1,0,1
699,0,707,1862;1863,0,0,0,2,0,2
700,0,708,1864;1866,0,0,0,1,1,2
701,0,709,1867;1868,0,0,0,2,0,2
702,0,710,1869,0,0,0,1,0,1
703,0,711,1870,0,0,0,1,0,1
704,0,712,1871;1872;1873,0,0,0,2,1,3
705,0,713,1874;1875,0,0,0,2,0,2
706,0,714,1876;1877,0,0,0,2,0,2
707,0,715,1878;1879,0,0,0,1,1,2
708,0,716,1880;1881;1882;1883,0,1,0,3,0,4
709,0,717,1884,0,0,0,0,1,1
710,0,718,1885,0,0,0,0,1,1
711,0,719,1886;1887;1888;1889;1890,0,0,1,4,0,5
712,0,720,1891;1892,0,0,0,2,0,2
713,0,721,1893;1894;1895,0,0,0,3,0,3
714,0,722,1896;1897,0,0,0,1,1,2
715,0,723,1898;1900;1901,0,0,0,3,0,3
716,0,724,1903;1904,0,0,0,1,1,2
717,0,725,1905;1906,0,0,0,1,1,2
718,0,726,1907;1908;1909,0,0,0,2,1,3
719,0,727,1910;1911;1912;1913,0,0,0,4,0,4
720,0,728,1914;1915,0,0,0,2,0,2
721,0,729,1916,0,0,0,1,0,1
722,0,730,1917,0,0,0,1,0,1
723,0,731,1918;1919,0,0,0,1,1,2
724,0,732,1920;1921,0,0,0,2,0,2
725,0,733,1923;1924;1925,0,0,1,2,0,3
726,0,734,1926;1927,0,0,0,1,1,2
727,0,735,1928;1929;1930,0,1,1,0,1,3
728,0,736,1931;1932;1933,0,0,2,1,0,3
729,0,737,1934,0,0,0,1,0,1
730,0,738,1935;1936,0,0,1,1,0,2
731,0,739,1937,0,0,0,1,0,1
732,0,740,1938;1939;1940,0,1,0,2,0,3
733,0,741,1941;1942;1943;1944,0,2,0,2,0,4
734,0,742,1945;1946;1948;1949;1950,0,0,0,5,0,5
735,0,743,1951;1952;1953,0,0,0,1,2,3
736,0,744,1954;1955,0,0,0,1,1,2
737,0,745,1956,0,0,0,0,1,1
738,0,747,1958;8274,0,0,0,2,0,2
739,0,748,1959;1960,0,0,0,0,2,2
740,0,749,1961;1962;1963,0,0,2,0,1,3
741,0,750,1964;1965;1966;10063,0,2,0,2,0,4
742,0,751,1967;1968,0,0,0,2,0,2
743,0,752,1969;1970,0,0,0,2,0,2
744,0,753,1971;1973;1974,0,0,1,2,0,3
745,0,754,1975;1976;1977;1978;1979,0,0,1,4,0,5
746,0,755,1980;1981,0,0,0,2,0,2
747,0,756,1982;1983;1984;1986;1987,0,0,2,1,2,5
748,0,757,1988;1989;1990,0,0,1,2,0,3
749,0,758,1991,0,0,0,1,0,1
750,0,759,1992;1993,0,0,0,1,1,2
751,0,760,1994;1995,0,0,0,1,1,2
752,0,761,1996,0,0,0,1,0,1
753,0,762,1997;1998,0,0,0,2,0,2
754,0,763,1999,0,0,0,0,1,1
755,0,764,2000;2001;2002,0,0,0,2,1,3
756,0,765,2003,0,0,0,0,1,1
757,0,766,2004,0,0,0,0,1,1
758,0,767,2005,0,0,0,1,0,1
759,0,768,2006;2007;2008;2009;2010,0,0,4,1,0,5
760,0,769,2011;2012;2013;2014;2015,0,1,2,1,1,5
761,0,770,2016;2018,0,0,0,2,0,2
762,0,771,2019;2020;2021;2022,0,0,0,4,0,4
763,0,772,2023;2024,0,0,0,2,0,2
764,0,773,2025;2026;2027,0,0,1,2,0,3
765,0,774,2028;2029;2030;2031;2032;2033,0,0,3,3,0,6
766,0,775,2034;2035;2036;2039;2040;2042;2043,0,0,0,5,2,7
767,0,776,2044;7753,0,0,0,2,0,2
768,0,777,2045,0,0,0,1,0,1
769,0,778,2046;2047,0,0,0,1,1,2
770,0,779,2048,0,0,0,0,1,1
771,0,780,2049;2050,0,0,0,1,1,2
772,0,781,2051,0,0,0,0,1,1
773,0,782,2052;2053;10086,0,1,0,2,0,3
774,0,783,2054;2055,0,0,0,2,0,2
775,0,784,2056;2057;2058;2059,0,0,2,1,1,4
776,0,785,2060,0,0,0,1,0,1
777,0,786,2061;2062;2063,0,2,0,1,0,3
778,0,787,2064,0,0,0,1,0,1
779,0,788,2065;2066;2067;2068;2069,0,1,2,2,0,5
780,0,789,2070;2071,0,0,0,2,0,2
781,0,790,2072,0,0,0,1,0,1
782,0,791,2073,0,0,0,1,0,1
783,0,792,2074;2075;2076;2077,0,0,0,3,1,4
784,0,793,2078;2079,0,0,0,1,1,2
785,0,794,2080,0,0,0,1,0,1
786,0,795,2081;2082,0,0,0,1,1,2
787,0,796,2083;2084;2085,0,1,0,2,0,3
788,0,797,2086;2087;10103,0,1,0,1,1,3
789,0,798,2088;2089;2090;2091;2092;2093,0,0,3,3,0,6
790,0,799,2094;2095,0,0,0,2,0,2
791,0,800,2096,0,0,0,0,1,1
792,0,801,2097;2098;2099;2100;2101,0,0,0,4,1,5
793,0,802,2102,0,0,0,0,1,1
794,0,803,2103,0,0,0,1,0,1
795,0,804,2104,0,0,0,0,1,1
796,0,805,2105;2106;2107;2108,0,0,1,2,1,4
797,0,806,2109;2110,0,0,0,2,0,2
798,0,807,2111;2112,0,0,0,1,1,2
799,0,808,2113,0,0,0,1,0,1
800,0,809,2114;9123,0,0,0,2,0,2
801,0,810,2115;2116,0,0,0,1,1,2
802,0,811,2117;2118,0,0,0,2,0,2
803,0,812,2119;2120;2121,0,1,0,2,0,3
804,0,813,2122;2123,0,1,0,0,1,2
805,0,814,2124;2125,0,0,0,2,0,2
806,0,815,2127,0,0,0,1,0,1
807,0,816,2128;2129;2131,0,0,0,3,0,3
808,0,817,2134;2135;2136;2138,0,0,0,3,1,4
809,0,818,2139;2140;2141;2142,0,1,0,3,0,4
810,0,819,2143;3544,0,0,0,2,0,2
811,0,820,2144;2145;2146,0,1,0,2,0,3
812,0,821,2147;2148,0,0,0,2,0,2
813,0,822,2149;2150,0,0,0,1,1,2
814,0,823,2151,0,0,0,0,1,1
815,0,824,2152;2153,0,0,0,2,0,2
816,0,825,2154;2155;2156,0,0,0,3,0,3
817,0,826,2157;2158;2159,0,1,0,2,0,3
818,0,827,2160;5752,0,0,0,2,0,2
819,0,828,2161;2162,0,0,0,2,0,2
820,0,829,2163;2164,0,0,0,2,0,2
821,0,830,2165;2166;2167;2168;2169,0,0,1,3,1,5
822,0,831,2170,0,0,0,1,0,1
823,0,832,2171;2172,0,0,0,1,1,2
824,0,833,2173;2174;2175;2176,0,1,1,2,0,4
825,0,834,2177;2178;2179;2180,0,0,1,2,1,4
826,0,835,2181;2182,0,0,0,0,2,2
827,0,836,2183;2184,0,0,0,1,1,2
828,0,837,2185;2186,0,0,0,1,1,2
829,0,838,2187;2188;2189,0,0,1,2,0,3
830,0,839,2190,0,0,0,1,0,1
831,0,840,2191;2192,0,0,0,1,1,2
832,0,841,2193;2194,0,0,0,2,0,2
833,0,842,2195;2196,0,0,0,1,1,2
834,0,843,2197,0,0,0,1,0,1
835,0,844,2198;7879,0,0,0,2,0,2
836,0,845,2199,0,0,0,0,1,1
837,0,846,2200;2201;2202;2203,0,0,0,2,2,4
838,0,847,2204;2205;2206,0,0,0,3,0,3
839,0,848,2207;2208;2209;2210,0,0,0,2,2,4
840,0,849,2211,0,0,0,1,0,1
841,0,850,2212;2213;2214;2215,0,0,1,3,0,4
842,0,851,2216;2217;2218;2219,0,0,0,3,1,4
843,0,852,2220;2221;2222;2224;2225,0,0,0,3,2,5
844,0,853,2226;2227,0,0,0,2,0,2
845,0,854,2228;2229,0,0,0,2,0,2
846,0,855,2230;2231;2232;2233;2234,0,2,2,1,0,5
847,0,856,2235;2236,0,0,0,1,1,2
848,0,857,2237;2238;2239;2240,0,0,2,1,1,4
849,0,858,2241,0,0,0,1,0,1
850,0,859,2242;2243;2244;2245;2246;2247,0,1,2,3,0,6
851,0,860,2248;2249;2250,0,1,0,2,0,3
852,0,861,2251;2252;2253;2254;2255;2256,0,0,1,4,1,6
853,0,862,2257;2258,0,0,0,2,0,2
854,0,863,2259;2260;2261,0,0,0,2,1,3
855,0,864,2262;2263;2264;2265;10039,0,1,1,3,0,5
856,0,865,2266;2267;2268,0,1,0,2,0,3
857,0,866,2270;2271,0,1,0,0,1,2
858,0,867,2272;2273,0,0,1,1,0,2
859,0,868,2274;2275,0,0,0,2,0,2
860,0,869,2276;2277;2279;2280;2281,0,0,0,5,0,5
861,0,870,2282;2283;2284,0,0,0,3,0,3
862,0,871,2285,0,0,0,1,0,1
863,0,872,2286,0,0,0,1,0,1
864,0,873,2287;2288;2289;2290;2291;10093;10111,0,2,3,2,0,7
865,0,874,2292;2293;2294;2295;10010,0,1,2,1,1,5
866,0,875,2296,0,0,0,0,1,1
867,0,876,2297,0,0,0,1,0,1
868,0,877,2298;2299;2300;2301,0,0,2,2,0,4
869,0,878,2302;2303,0,0,0,1,1,2
870,0,879,2304;2305,0,0,0,0,2,2
871,0,880,2306,0,0,0,1,0,1
872,0,881,2307,0,0,0,1,0,1
873,0,882,2308;2309;2311,0,0,0,2,1,3
874,0,883,2312,0,0,0,1,0,1
875,0,884,2313,0,0,0,1,0,1
876,0,885,2315;2316;2317,0,0,0,3,0,3
877,0,886,2318;2319;2320;2321;2322;2323,0,1,2,1,2,6
878,0,887,2325;2326;2327,0,0,0,2,1,3
879,0,888,2328;2329;2330;10022,0,2,0,2,0,4
880,0,889,2331,0,0,0,1,0,1
881,0,890,2332,0,0,0,1,0,1
882,0,891,2333;2334,0,0,0,2,0,2
883,0,892,2335;2336,0,0,0,2,0,2
884,0,893,2337;2338;2339,0,1,0,2,0,3
885,0,894,2340;2341;2342,0,0,0,2,1,3
886,0,895,2343;2344,0,0,0,2,0,2
887,0,896,2345;2346;2347,0,0,0,3,0,3
888,0,897,2348;2349;2350;2351,0,0,0,2,2,4
889,0,898,2352;2353;2354;2355;2356,0,0,2,1,2,5
890,0,899,2357,0,0,0,0,1,1
891,0,900,2358;2359;2360;2361,0,1,1,2,0,4
892,0,901,2362;2363;2364;2365;2366,0,0,3,2,0,5
893,0,902,2367;2368;2369;2370,0,2,0,2,0,4
894,0,903,2371;2372,0,0,1,1,0,2
895,0,904,2373;2374,0,0,0,2,0,2
896,0,905,2375;2376;2377,0,0,0,2,1,3
897,0,906,2378,0,0,0,1,0,1
898,0,907,2379,0,0,0,1,0,1
899,0,908,2380;2381;2382;2383;2384;2385,0,0,2,4,0,6
900,0,909,2386;6079,0,0,0,2,0,2
901,0,910,2387;2388;2389,0,1,0,2,0,3
902,0,911,2390;2391,0,0,0,2,0,2
903,0,912,2392;2393;2394;2395;2396,0,1,2,2,0,5
904,0,913,2397,0,0,0,0,1,1
905,0,914,2398;2399,0,0,0,1,1,2
906,0,915,2400;2401;2402;2403;2404,0,0,1,2,2,5
907,0,916,2405;2407;2408,0,0,0,2,1,3
908,0,917,2409;2410;2411,0,0,0,3,0,3
909,0,918,2412;2413;2414,0,0,0,3,0,3
910,0,919,2415;2416;2417;2418,0,0,2,2,0,4
911,0,920,2419,0,0,0,0,1,1
912,0,921,2420;2421,0,0,0,1,1,2
913,0,922,2422;2423,0,0,0,2,0,2
914,0,923,2424;2425,0,0,0,0,2,2
915,0,925,2427;2428,0,0,0,1,1,2
916,0,926,2429;2430;2431,0,0,0,3,0,3
917,0,927,2432;2433;2434,0,0,2,1,0,3
918,0,928,2435;2436,0,0,0,2,0,2
919,0,929,2437;2438,0,0,0,2,0,2
920,0,930,2439;2440;2441;2442,0,1,0,3,0,4
921,0,931,2444;2445;2446,0,0,0,3,0,3
922,0,932,2447;2448;2449,0,0,1,0,2,3
923,0,933,2450,0,0,0,0,1,1
924,0,934,2451;2452,0,0,0,2,0,2
925,0,935,636;2453;2454;2455;2456,0,0,0,5,0,5
926,0,936,2457;2458;2459,0,0,0,2,1,3
927,0,937,2460;2461;2462,0,0,0,3,0,3
928,0,938,2463;2464;2465;2466;2467;2468,0,0,0,5,1,6
929,0,939,2469;2470,0,0,0,0,2,2
930,0,940,2471;2472,0,0,0,2,0,2
931,0,941,2473;2474;2475;2476,0,1,1,2,0,4
932,0,942,2477;2478;2479;2480;2481,0,0,1,4,0,5
933,0,943,2482;2483,0,0,0,0,2,2
934,0,944,2484;2485,0,0,0,2,0,2
935,0,945,2486,0,0,0,1,0,1
936,0,946,2487,0,0,0,1,0,1
937,0,947,2488;2489,0,0,0,2,0,2
938,0,948,2490;2491;2492;2493;2494,0,0,2,2,1,5
939,0,949,2495;2496;2497;2498;2499;2500,0,0,2,3,1,6
940,0,950,2501;2502;2503,0,0,0,2,1,3
941,0,951,2504;2505;2506;2507;2508,0,0,1,2,2,5
942,0,952,2509;2510;2511,0,0,0,3,0,3
943,0,953,2512;2513,0,0,0,1,1,2
944,0,954,2514;2515;2516;2517,0,0,1,1,2,4
945,0,955,2518,0,0,0,0,1,1
946,0,956,2519;2520,0,0,0,2,0,2
947,0,957,2521;2522;2523;2524,0,2,0,2,0,4
948,0,958,2525;2528;2529,0,0,0,3,0,3
949,0,959,2530;2531,0,0,0,0,2,2
950,0,960,2532;2533;2534,0,1,0,1,1,3
951,0,961,2536,0,0,0,1,0,1
952,0,962,2537;2538;2539,0,1,0,1,1,3
953,0,963,2540,0,0,0,0,1,1
954,0,964,2541;2542;2543;2544;2545,0,1,2,1,1,5
955,0,965,2546;2547,0,0,0,1,1,2
956,0,966,2548;2549,0,0,0,1,1,2
957,0,967,2550,0,0,0,1,0,1
958,0,968,2551;2552,0,0,0,2,0,2
959,0,969,2553;2554;2555;2556,0,0,2,2,0,4
960,0,970,2557;2558;2559,0,0,1,1,1,3
961,0,971,2560;2561;2562,0,0,0,2,1,3
962,0,972,2563;2564;10109,0,1,0,2,0,3
963,0,973,2565;2566,0,0,0,2,0,2
964,0,974,2567;2568,0,0,0,2,0,2
965,0,975,2569;2570,0,0,0,2,0,2
966,0,976,2571;2572;2573,0,0,0,2,1,3
967,0,977,2574;2575;10005,0,1,0,2,0,3
968,0,978,2576;2577,0,0,0,2,0,2
969,0,979,2578;2579;2580;2581,0,0,2,1,1,4
970,0,980,2582,0,0,0,1,0,1
971,0,981,2583;2584;2585;2586,0,0,0,3,1,4
972,0,982,2587,0,0,0,0,1,1
973,0,983,2588;2589,0,0,0,2,0,2
974,0,984,2590;2591,0,0,0,2,0,2
975,0,985,2592;2593;2594,0,0,1,1,1,3
976,0,986,2596,0,0,0,0,1,1
977,0,987,2597;2598,0,1,0,1,0,2
978,0,988,2599;2600,0,0,0,2,0,2
979,0,989,2601;2602,0,0,0,1,1,2
980,0,990,2603;2604;2605;2606,0,0,2,2,0,4
981,0,991,2607;2608,0,0,0,1,1,2
982,0,992,2609;2610,0,0,0,1,1,2
983,0,993,2611,0,0,0,0,1,1
984,0,994,2612;2613,0,0,0,2,0,2
985,0,995,2614;2615,0,0,0,1,1,2
986,0,996,2616,0,0,0,0,1,1
987,0,997,2617,0,0,0,1,0,1
988,0,998,2618;2619;2620;2621,0,0,2,1,1,4
989,0,999,2622;2623;2624;2625,0,0,1,2,1,4
990,0,1000,2626;2627;2628;2629,0,0,2,0,2,4
991,0,1001,2630;10068,0,1,0,1,0,2
992,0,1002,2631;2632,0,0,0,2,0,2
993,0,1003,2633;2634,0,0,0,1,1,2
994,0,1004,2635;2636,0,0,0,2,0,2
995,0,1005,2637,0,0,0,1,0,1
996,0,1006,2638;2639,0,0,0,2,0,2
997,0,1007,2640;2641,0,0,0,2,0,2
998,0,1008,2642;2643,0,0,0,0,2,2
999,0,1009,2644,0,0,0,0,1,1
1000,0,1010,2645;2646;2647;2648,0,0,0,2,2,4
1001,0,1011,2649;2650;2651,0,0,1,0,2,3
1002,0,1012,2652;2653;2654;2655;2656,0,0,2,3,0,5
1003,0,1013,2657;2658;10004,0,1,0,1,1,3
1004,0,1014,2659,0,0,0,0,1,1
1005,0,1015,2660;2661,0,0,0,2,0,2
1006,0,1016,2662;2663,0,0,0,2,0,2
1007,0,1017,2664;2665,0,0,0,2,0,2
1008,0,1018,2666;2667;2668;2669;2670,0,0,2,3,0,5
1009,0,1019,2671;2672;2673,0,0,0,3,0,3
1010,0,1020,2675,0,0,0,0,1,1
1011,0,1021,2676,0,0,0,1,0,1
1012,0,1022,2678;2679;2680;2681,0,0,1,3,0,4
1013,0,1023,2682;2683;2684,0,0,0,3,0,3
1014,0,1024,2685;2686;2687;2689,0,0,1,2,1,4
1015,0,1025,2690;2691;2692;2693;2694,0,0,3,2,0,5
1016,0,1026,2695,0,0,0,1,0,1
1017,0,1027,2696,0,0,0,1,0,1
1018,0,1028,2697,0,0,0,1,0,1
1019,0,1029,2698;2699;2700;2701,0,0,3,1,0,4
1020,0,1030,2702,0,0,0,1,0,1
1021,0,1031,2703,0,0,0,1,0,1
1022,0,1032,2704,0,0,0,1,0,1
1023,0,1033,2705;2706;2707,0,0,0,2,1,3
1024,0,1034,2708,0,0,0,1,0,1
1025,0,1035,2709;2710,0,0,0,1,1,2
1026,0,1036,2711,0,0,0,1,0,1
1027,0,1037,2712,0,0,0,1,0,1
1028,0,1038,2713;2715,0,0,0,1,1,2
1029,0,1039,2716;2717,0,0,0,2,0,2
1030,0,1040,2718;2719;2720;2721,0,0,0,2,2,4
1031,0,1041,2722;2723;2724,0,0,0,3,0,3
1032,0,1042,2725,0,0,0,1,0,1
1033,0,1043,2726;2727;2728;2729,0,2,0,2,0,4
1034,0,1044,2730;2731;2732;2733,0,0,0,2,2,4
1035,0,1045,2734;2735;2736;2737;2738,0,1,0,3,1,5
1036,0,1046,2739;2740;2741;2742,0,0,1,2,1,4
1037,0,1047,2743;2744;2745;2746;2747;2748,0,0,0,6,0,6
1038,0,1048,2749;2750;2751,0,1,1,1,0,3
1039,0,1049,2752,0,0,0,1,0,1
1040,0,1051,2754;2755,0,0,0,1,1,2
1041,0,1052,2756;2757,0,0,0,2,0,2
1042,0,1053,2758;2759;2760,0,1,0,1,1,3
1043,0,1054,2761;4730,0,0,0,2,0,2
1044,0,1055,2763;2764;2765;2766,0,0,1,2,1,4
1045,0,1056,2767,0,0,0,1,0,1
1046,0,1057,2768,0,0,0,0,1,1
1047,0,1058,2769;2770,0,0,0,0,2,2
1048,0,1059,2772;2773;2774;2775,0,2,0,1,1,4
1049,0,1060,2776;2777;2778,0,0,0,3,0,3
1050,0,1061,2779;2780,0,0,0,1,1,2
1051,0,1062,2781;2782;2783;2784,0,0,2,0,2,4
1052,0,1063,2785;2786;2787;2788;2789,0,0,3,1,1,5
1053,0,1064,2790;2791,0,0,0,2,0,2
1054,0,1065,2792;2793,0,0,0,2,0,2
1055,0,1066,2794;2795,0,0,1,1,0,2
1056,0,1067,2796;2797;2798;2799;2800,0,0,3,2,0,5
1057,0,1068,2801;2802;2803;2804;2805,0,0,0,5,0,5
1058,0,1069,2806;2807,0,0,0,2,0,2
1059,0,1070,2808;2810;2811;2812,0,0,3,0,1,4
1060,0,1071,2813;2814;2815;2816;2817;2818,0,1,3,2,0,6
1061,0,1072,2819;2820,0,0,0,2,0,2
1062,0,1073,2821;2822,0,0,0,2,0,2
1063,0,1074,2823;2824;2825;10006,0,1,0,2,1,4
1064,0,1075,2826;2827;2828,0,0,0,3,0,3
1065,0,1076,2829;2830,0,0,0,2,0,2
1066,0,1077,2831;2833;2834,0,0,1,1,1,3
1067,0,1078,2835,0,0,0,1,0,1
1068,0,1079,2836;2837;2838;2839;2840,0,0,2,2,1,5
1069,0,1080,2841;2842;2843,0,0,1,1,1,3
1070,0,1081,2844;2845,0,0,0,1,1,2
1071,0,1082,2846;2847,0,0,0,1,1,2
1072,0,1083,2848;2849;2850,0,0,0,1,2,3
1073,0,1084,2851;2852,0,0,0,2,0,2
1074,0,1085,2853;2854;2855,0,1,0,1,1,3
1075,0,1086,2856;2857,0,0,0,2,0,2
1076,0,1087,2858;2859;2860;2861,0,0,0,2,2,4
1077,0,1088,2862;2864;2865,0,0,1,2,0,3
1078,0,1089,2866;2867,0,0,0,1,1,2
1079,0,1090,2868;2869;2870;2871,0,2,0,2,0,4
1080,0,1091,2872;2873;2874;2875;2876,0,1,0,3,1,5
1081,0,1092,2877;2878,0,0,1,0,1,2
1082,0,1093,2879;2880;2881;3190;10087,0,1,2,2,0,5
1083,0,1094,2882,0,0,0,1,0,1
1084,0,1095,2884,0,0,0,1,0,1
1085,0,1096,264;2885;10023,0,1,0,2,0,3
1086,0,1097,2886,0,0,0,0,1,1
1087,0,1098,2887,0,0,0,1,0,1
1088,0,1099,2888;2889;2891;2892;2893,0,1,2,2,0,5
1089,0,1100,2894;2896,0,1,0,1,0,2
1090,0,1101,2897,0,0,0,1,0,1
1091,0,1102,2898;2899,0,0,0,2,0,2
1092,0,1103,2900;2901,0,0,0,2,0,2
1093,0,1104,2902;2903,0,0,0,2,0,2
1094,0,1105,2904;2905,0,0,0,2,0,2
1095,0,1106,2906;2907,0,0,0,1,1,2
1096,0,1107,2908,0,0,0,1,0,1
1097,0,1108,2909;2910,0,1,0,1,0,2
1098,0,1109,2911,0,0,0,1,0,1
1099,0,1110,2912;2914,0,0,0,2,0,2
1100,0,1111,2915;2916,0,0,0,2,0,2
1101,0,1112,2917,0,0,0,1,0,1
1102,0,1113,2918;2919;2920,0,1,1,1,0,3
1103,0,1114,2921;2922,0,0,0,1,1,2
1104,0,1115,2923;2924,0,0,0,2,0,2
1105,0,1116,2925;2926,0,0,0,2,0,2
1106,0,1117,2927;2928;2929;2930,0,0,0,3,1,4
1107,0,1118,2931;2932,0,0,0,1,1,2
1108,0,1119,2933;2934;2935,0,0,0,2,1,3
1109,0,1120,2936,0,0,0,0,1,1
1110,0,1121,2937;2938,0,0,0,1,1,2
1111,0,1122,2939;2940,0,0,0,2,0,2
1112,0,1123,2941,0,0,0,1,0,1
1113,0,1124,2943;2944,0,0,0,2,0,2
1114,0,1125,2945,0,0,0,1,0,1
1115,0,1126,2946;2947;2948;2949;2950,0,1,2,2,0,5
1116,0,1127,2951;2952;2953;2954,0,0,0,2,2,4
1117,0,1128,2955;2956,0,0,0,2,0,2
1118,0,1129,2957;2958;2959;2960,0,0,2,2,0,4
1119,0,1130,2961;2962;2963;2964;2965,0,3,0,1,1,5
1120,0,1131,2966;2967,0,0,0,2,0,2
1121,0,1132,2968,0,0,0,1,0,1
1122,0,1133,2969;2970;2971;2972,0,0,1,2,1,4
1123,0,1134,2973;2974;2975;2976,0,2,0,2,0,4
1124,0,1135,2977;2978;2979;2980,0,0,2,1,1,4
1125,0,1136,2981;2982,0,0,0,2,0,2
1126,0,1137,2983;2984;2985;2986,0,0,0,3,1,4
1127,0,1138,2987,0,0,0,1,0,1
1128,0,1139,2988;2989,0,0,0,2,0,2
1129,0,1140,2990;2991,0,0,0,2,0,2
1130,0,1141,2992,0,0,0,0,1,1
1131,0,1142,2993;2994;2995;2996;10089,0,1,2,2,0,5
1132,0,1143,2997;2998;2999,0,0,0,1,2,3
1133,0,1144,3000;3001;3003;3004,0,0,2,1,1,4
1134,0,1145,3005;3006;3007,0,1,0,1,1,3
1135,0,1146,3008;3010;3011;3012,0,0,2,2,0,4
1136,0,1147,3013;3014,0,0,0,1,1,2
1137,0,1148,3015;3016,0,0,0,0,2,2
1138,0,1149,3017;3018;3019;10035,0,2,0,2,0,4
1139,0,1150,3020;3021,0,0,0,1,1,2
1140,0,1151,3022;3023,0,0,0,2,0,2
1141,0,1152,3024,0,0,0,1,0,1
1142,0,1153,3025;3026;3027;3028;3029,0,1,1,3,0,5
1143,0,1154,3030;3031;3032;3033;3034,0,0,0,2,3,5
1144,0,1155,3035,0,0,0,0,1,1
1145,0,1156,3036;3037;3038;3039;3040;3041,0,0,1,4,1,6
1146,0,1157,3042;3043;3044;3045;3046,0,1,1,3,0,5
1147,0,1158,3047;3048,0,0,0,2,0,2
1148,0,1159,3049;3050,0,0,0,1,1,2
1149,0,1160,3051;3052,0,0,0,0,2,2
1150,0,1161,3053;3054;3055,0,1,0,2,0,3
1151,0,1162,3056;3057;3058,0,1,0,0,2,3
1152,0,1163,3059;3060;3061;3062,0,0,0,2,2,4
1153,0,1164,3063;3064,0,0,0,0,2,2
1154,0,1165,3066;3067;3068;3069;3070;3071,0,1,2,2,1,6
1155,0,1166,3072;8867,0,0,0,2,0,2
1156,0,1167,3073;3074;3075,0,0,0,2,1,3
1157,0,1168,3076;3077;3078,0,0,1,2,0,3
1158,0,1169,3079,0,0,0,0,1,1
1159,0,1170,3080,0,0,0,1,0,1
1160,0,1171,3081;3082;3083,0,0,0,3,0,3
1161,0,1172,3084;3085;3086;3087,0,0,1,3,0,4
1162,0,1173,3088,0,0,0,0,1,1
1163,0,1174,3089;3090,0,0,0,1,1,2
1164,0,1175,3091;3092;3093;3094,0,0,0,4,0,4
1165,0,1176,3095;3096,0,0,0,1,1,2
1166,0,1177,3097;3098;3099,0,0,0,2,1,3
1167,0,1178,3101;3102;3103,0,0,1,0,2,3
1168,0,1179,3104,0,0,0,0,1,1
1169,0,1180,3105;3106;3107;3108,0,1,0,2,1,4
1170,0,1181,3109;3110;3111,0,1,0,2,0,3
1171,0,1182,3112,0,0,0,1,0,1
1172,0,1183,3113;3114,0,0,0,2,0,2
1173,0,1184,3115;3116;3117;3118,0,1,2,1,0,4
1174,0,1185,3119;3120;3121;3122,0,1,2,1,0,4
1175,0,1186,3124;3125;3126;3127,0,2,1,1,0,4
1176,0,1187,3128;4236,0,0,0,2,0,2
1177,0,1188,3129,0,0,0,0,1,1
1178,0,1189,3130;3131;3132,0,0,1,1,1,3
1179,0,1190,3134;3135;3136;3137,0,1,1,2,0,4
1180,0,1191,3138;3139;3140;3141,0,1,1,2,0,4
1181,0,1192,3142,0,0,0,1,0,1
1182,0,1193,3143;3144;3145;3146,0,2,0,2,0,4
1183,0,1194,3147;3148,0,0,0,1,1,2
1184,0,1195,3149,0,0,0,0,1,1
1185,0,1196,3150;3151,0,0,0,2,0,2
1186,0,1197,3152,0,0,0,0,1,1
1187,0,1198,3153;3154;3155;3156,0,1,1,1,1,4
1188,0,1199,3157;3158;3159;3160;3161,0,0,1,3,1,5
1189,0,1200,3162;3163;3164;3165,0,0,1,3,0,4
1190,0,1201,3166;3167,0,0,0,2,0,2
1191,0,1202,3168;3169,0,0,0,2,0,2
1192,0,1203,3170,0,0,0,1,0,1
1193,0,1204,3171;3173,0,0,1,1,0,2
1194,0,1205,3174;3175,0,0,0,2,0,2
1195,0,1206,3176;3177;3178,0,0,0,3,0,3
1196,0,1207,3179;3180,0,0,0,1,1,2
1197,0,1208,3181;3182,0,0,0,2,0,2
1198,0,1209,3183;3184;3185,0,1,0,1,1,3
1199,0,1210,3186;3187,0,0,0,1,1,2
1200,0,1211,3188;3189;3191;3192;3193,0,0,1,3,1,5
1201,0,1212,3194;3195,0,0,0,1,1,2
1202,0,1213,3196;3197;3198,0,0,0,2,1,3
1203,0,1214,3199;3200;3201;3202,0,0,2,2,0,4
1204,0,1215,3203;3204,0,0,0,2,0,2
1205,0,1216,3205;3206;3207;3208;3209,0,1,2,2,0,5
1206,0,1217,3210;3211,0,0,0,2,0,2
1207,0,1218,3212;3213;3214;3215,0,0,1,2,1,4
1208,0,1219,3216;3217;3218;3219,0,0,2,2,0,4
1209,0,1220,3220;3221;3222;10014,0,1,1,2,0,4
1210,0,1221,3223,0,0,0,1,0,1
1211,0,1222,3224;3225;3226;3227,0,0,0,3,1,4
1212,0,1223,3228;3229,0,0,0,2,0,2
1213,0,1224,3230;3231;3232;3233;3234,0,0,2,1,2,5
1214,0,1225,3235;3236;3237;3238;3239;3240;3241,0,1,2,3,1,7
1215,0,1226,3242;3243,0,0,0,1,1,2
1216,0,1227,3244;3245;3246;3247,0,2,0,1,1,4
1217,0,1228,3248,0,0,0,0,1,1
1218,0,1229,3249,0,0,0,1,0,1
1219,0,1230,3250,0,0,0,0,1,1
1220,0,1231,3251;3252,0,0,0,1,1,2
1221,0,1232,3253;3254;3255;3256,0,1,0,3,0,4
1222,0,1233,3257;3258,0,0,0,2,0,2
1223,0,1234,3259;3260,0,0,0,2,0,2
1224,0,1235,3261;3262,0,0,0,2,0,2
1225,0,1236,3263,0,0,0,1,0,1
1226,0,1237,3264;3265;3266;3267,0,2,0,2,0,4
1227,0,1238,3268;3269,0,0,0,2,0,2
1228,0,1239,3270,0,0,0,1,0,1
1229,0,1240,3272;3273,0,0,0,0,2,2
1230,0,1241,3274;3275;3276;3277,0,0,2,2,0,4
1231,0,1242,3278,0,0,0,1,0,1
1232,0,1243,3279;3280;3281,0,0,0,3,0,3
1233,0,1244,3282;3283,0,0,0,2,0,2
1234,0,1245,3284;3285,0,0,0,2,0,2
1235,0,1246,3286,0,0,0,0,1,1
1236,0,1247,3287;3288;3289,0,0,1,2,0,3
1237,0,1248,3290;3291;3292,0,0,0,3,0,3
1238,0,1249,3293,0,0,0,1,0,1
1239,0,1250,3294;3295;3296,0,0,0,2,1,3
1240,0,1251,3297;3298,0,0,1,0,1,2
1241,0,1252,3299,0,0,0,1,0,1
1242,0,1253,3300;3301,0,0,0,1,1,2
1243,0,1254,3303;3304,0,0,0,1,1,2
1244,0,1255,3306;3307;3308;3309,0,0,2,1,1,4
1245,0,1256,3310;3311;3312,0,0,0,3,0,3
1246,0,1257,3313;3314;3315,0,0,1,2,0,3
1247,0,1258,3316;3317;3318,0,1,0,2,0,3
1248,0,1259,3319;3320,0,0,0,2,0,2
1249,0,1260,3322,0,0,0,1,0,1
1250,0,1261,3323;3324,0,0,0,2,0,2
1251,0,1262,3325,0,0,0,1,0,1
1252,0,1263,3326;3327,0,0,0,2,0,2
1253,0,1264,3328;3329,0,0,0,0,2,2
1254,0,1265,3330,0,0,0,1,0,1
1255,0,1266,3331;3332,0,0,0,1,1,2
1256,0,1267,3333;3334,0,0,0,0,2,2
1257,0,1268,3335;3336;3337;3338,0,0,1,3,0,4
1258,0,1269,3339;3340;3341,0,1,0,2,0,3
1259,0,1270,3342,0,0,0,1,0,1
1260,0,1271,3343,0,0,0,1,0,1
1261,0,1272,3344;3345;3346,0,0,1,2,0,3
1262,0,1273,3347;3348,0,0,0,1,1,2
1263,0,1274,3349;3350,0,0,0,2,0,2
1264,0,1275,3351;3352;3353;3354;3355;3356,0,1,0,3,2,6
1265,0,1276,3357;3358;3359,0,1,0,2,0,3
1266,0,1277,3360;3361;3362;3363,0,0,1,3,0,4
1267,0,1278,3364,0,0,0,1,0,1
1268,0,1279,3365;3366;3367,0,2,0,0,1,3
1269,0,1280,3368;3369,0,0,0,2,0,2
1270,0,1281,3370;3371,0,0,0,2,0,2
1271,0,1282,3372;3373;3374;3375;3376;3377,0,0,4,2,0,6
1272,0,1283,3378;3379;3380;3381,0,0,2,2,0,4
1273,0,1284,3382;3383,0,0,0,2,0,2
1274,0,1285,3384;3385;3386;3387;3388,0,1,1,3,0,5
1275,0,1286,3389;3390;3392,0,0,0,3,0,3
1276,0,1287,3393;3394;3395;3396;3397,0,0,2,3,0,5
1277,0,1288,3398;3399;3400;3401;3402;3403,0,1,3,2,0,6
1278,0,1289,3404;3405;3406;3407,0,0,1,2,1,4
1279,0,1290,3408;3409,0,0,0,2,0,2
1280,0,1291,3410,0,0,0,1,0,1
1281,0,1292,3411,0,0,0,1,0,1
1282,0,1293,3412,0,0,0,1,0,1
1283,0,1294,3413;3414,0,0,0,1,1,2
1284,0,1295,3415;3416;3417;3418;3419;3420,0,1,1,3,1,6
1285,0,1296,3421;7862,0,0,0,2,0,2
1286,0,1297,3422;3423;3424,0,1,0,2,0,3
1287,0,1298,3425,0,0,0,1,0,1
1288,0,1299,3426;3427;3428;3429,0,0,2,2,0,4
1289,0,1300,3430;3431;3432,0,0,0,3,0,3
1290,0,1301,3433;3434;3436;3437;3438,0,0,2,1,2,5
1291,0,1302,3439;3440,0,0,0,2,0,2
1292,0,1303,3441;3442,0,0,0,2,0,2
1293,0,1304,3443;3444;3445,0,0,0,2,1,3
1294,0,1305,3446,0,0,0,1,0,1
1295,0,1306,3447;3448;3449;3450,0,0,2,2,0,4
1296,0,1307,3451;3453;3454,0,0,0,1,2,3
1297,0,1308,3455;3456;3457;3458,0,0,1,2,1,4
1298,0,1309,3459,0,0,0,1,0,1
1299,0,1310,3460,0,0,0,1,0,1
1300,0,1311,3461;3462;3463,0,0,1,2,0,3
1301,0,1312,3464,0,0,0,0,1,1
1302,0,1313,3465;3466;3467;3468,0,0,2,1,1,4
1303,0,1314,3469;3470;3471;3472,0,1,1,2,0,4
1304,0,1315,3473;3474;3475;3476;3477;3478,0,1,3,1,1,6
1305,0,1316,3479;3480;3481,0,1,0,2,0,3
1306,0,1317,3482,0,0,0,0,1,1
1307,0,1318,3483;3484,0,0,0,0,2,2
1308,0,1319,3485,0,0,0,0,1,1
1309,0,1320,3486;3487,0,0,0,2,0,2
1310,0,1321,3488;3489,0,0,0,1,1,2
1311,0,1322,3490;3491;3492;3493,0,0,1,3,0,4
1312,0,1323,3494;3495;3496,0,0,0,3,0,3
1313,0,1324,3497;3787,0,0,0,2,0,2
1314,0,1325,3498;3499,0,0,0,2,0,2
1315,0,1326,3500;3501;3502;3503;3504,0,2,1,1,1,5
1316,0,1327,3505;3506;3507,0,1,0,1,1,3
1317,0,1328,3508,0,0,0,1,0,1
1318,0,1329,3509;3648,0,0,0,2,0,2
1319,0,1330,3510,0,0,0,1,0,1
1320,0,1331,3511;3512,0,0,0,2,0,2
1321,0,1332,3513;3514,0,0,0,2,0,2
1322,0,1333,3515;3516;3517;3518,0,0,2,2,0,4
1323,0,1334,3519;3520,0,0,1,1,0,2
1324,0,1335,3521;3522;3523;3524,0,0,2,2,0,4
1325,0,1336,3525,0,0,0,1,0,1
1326,0,1337,3526;3527,0,0,0,2,0,2
1327,0,1338,3528;3529;3530;3531,0,0,2,2,0,4
1328,0,1339,3532;3533;3534;10095;10113,0,2,0,3,0,5
1329,0,1340,3535,0,0,0,1,0,1
1330,0,1341,3536;3537;3538;3539;3540,0,0,1,3,1,5
1331,0,1342,3541,0,0,0,1,0,1
1332,0,1343,3542;3543;3545,0,0,0,1,2,3
1333,0,1344,3546;3547;3548;3549,0,0,0,4,0,4
1334,0,1345,3550,0,0,0,1,0,1
1335,0,1346,3551;3552;3553,0,0,0,1,2,3
1336,0,1347,3554;3555,0,0,0,2,0,2
1337,0,1348,3556;3557,0,0,0,2,0,2
1338,0,1349,3558;3559;3560;3561,0,1,1,0,2,4
1339,0,1350,3562;3563;3564;3566,0,0,1,1,2,4
1340,0,1351,3567,0,0,0,1,0,1
1341,0,1352,3569;3570,0,0,0,2,0,2
1342,0,1353,3571;3572;3573;3574;3575,0,0,3,2,0,5
1343,0,1354,3576;3577;3578,0,1,0,2,0,3
1344,0,1355,3579,0,0,0,0,1,1
1345,0,1356,3580;8882,0,0,0,2,0,2
1346,0,1357,3581;3582;3583,0,0,0,2,1,3
1347,0,1358,3584;3585;3586,0,0,0,3,0,3
1348,0,1359,3587;3588;3589;3590;3591;3592,0,2,0,2,2,6
1349,0,1360,3593;3594;3595,0,0,1,2,0,3
1350,0,1361,3596;3597,0,0,0,2,0,2
1351,0,1362,3598;3599;3600;3601,0,2,0,1,1,4
1352,0,1363,3602;3603,0,0,0,2,0,2
1353,0,1364,3604;3605,0,0,0,0,2,2
1354,0,1365,3606;3607,0,0,0,1,1,2
1355,0,1367,3609;3610;3611;3612,0,0,2,2,0,4
1356,0,1368,3614;3615,0,0,1,1,0,2
1357,0,1370,3618,0,0,0,1,0,1
1358,0,1371,3619;3620;3621,0,0,1,2,0,3
1359,0,1372,3622,0,0,0,1,0,1
1360,0,1373,3623,0,0,0,1,0,1
1361,0,1374,3624;3625;3626,0,0,0,3,0,3
1362,0,1375,3627,0,0,0,1,0,1
1363,0,1376,3628;3630,0,0,0,0,2,2
1364,0,1377,3631;3632;3633,0,0,0,2,1,3
1365,0,1378,3634;3635;3636,0,0,0,2,1,3
1366,0,1379,3637;3638;3639,0,0,0,3,0,3
1367,0,1380,3640;3641;3642,0,0,0,3,0,3
1368,0,1381,3644;3645,0,0,0,2,0,2
1369,0,1382,3647;3649;3650,0,0,0,2,1,3
1370,0,1383,3651;3652,0,0,0,2,0,2
1371,0,1384,3653,0,0,0,0,1,1
1372,0,1385,3654;3655;3656,0,0,0,2,1,3
1373,0,1386,3657;3658,0,0,0,2,0,2
1374,0,1387,3659;3660,0,0,0,2,0,2
1375,0,1388,3661,0,0,0,1,0,1
1376,0,1389,3663;3664,0,0,0,0,2,2
1377,0,1390,3665;3666;3667,0,0,0,1,2,3
1378,0,1391,3668;3669,0,0,0,1,1,2
1379,0,1392,3670;3671;3672;3673;3674;3675,0,0,3,3,0,6
1380,0,1393,3676;3677;3678;3679,0,1,1,2,0,4
1381,0,1394,3680,0,0,0,1,0,1
1382,0,1395,3681;3682;10094,0,1,0,1,1,3
1383,0,1396,3683;3684;3685,0,0,0,2,1,3
1384,0,1397,3686;3687,0,0,0,2,0,2
1385,0,1398,3688;3689;3690;3691,0,0,1,3,0,4
1386,0,1399,3692;3693,0,0,0,0,2,2
1387,0,1400,3694;3695;3696,0,0,2,1,0,3
1388,0,1401,3697;3698;3699;3700;8225;8226,0,0,3,3,0,6
1389,0,1402,3701;3702,0,0,0,0,2,2
1390,0,1403,3703;3704,0,0,1,1,0,2
1391,0,1404,3705,0,0,0,1,0,1
1392,0,1405,3706;3707;3708;3709;3710,0,0,1,4,0,5
1393,0,1406,3711;3712;3713,0,0,1,1,1,3
1394,0,1407,3714;3715;3716;3717,0,0,2,1,1,4
1395,0,1408,3718,0,0,0,1,0,1
1396,0,1409,3719;3720,0,0,0,1,1,2
1397,0,1410,3721;3722,0,0,0,2,0,2
1398,0,1411,3723;3724;3725;3726;3727,0,0,2,3,0,5
1399,0,1412,3728;3729;3730;3731,0,1,1,2,0,4
1400,0,1413,3732,0,0,0,1,0,1
1401,0,1414,3734;3735,0,1,0,0,1,2
1402,0,1415,3736;3737;3738,0,0,1,2,0,3
1403,0,1416,3739,0,0,0,1,0,1
1404,0,1417,3740;3741,0,0,1,1,0,2
1405,0,1418,3742;3743,0,0,0,2,0,2
1406,0,1419,3744;3745,0,0,0,2,0,2
1407,0,1420,3746;3747;3748;3749,0,0,2,2,0,4
1408,0,1421,3751;3752;3753,0,0,1,2,0,3
1409,0,1422,3754;3755,0,0,0,2,0,2
1410,0,1423,3756;3757;3758;3759,0,0,2,1,1,4
1411,0,1424,3760,0,0,0,1,0,1
1412,0,1425,3761;3762;10085,0,1,0,2,0,3
1413,0,1426,3763;10037,0,1,0,1,0,2
1414,0,1427,3764;3765;3766;3767;3768,0,0,1,2,2,5
1415,0,1428,3769,0,0,0,1,0,1
1416,0,1429,3771,0,0,0,0,1,1
1417,0,1430,3772;7615,0,0,0,2,0,2
1418,0,1431,3773,0,0,0,0,1,1
1419,0,1432,3774;3775;3776,0,1,0,1,1,3
1420,0,1433,3777;3778;3779;3780,0,0,0,3,1,4
1421,0,1434,3781;3782,0,0,0,2,0,2
1422,0,1435,3783,0,0,0,1,0,1
1423,0,1436,3784;3785;3786,0,0,0,3,0,3
1424,0,1437,3788,0,0,0,1,0,1
1425,0,1438,3789;3790,0,0,0,2,0,2
1426,0,1439,3791;3792;3793;3794,0,0,1,3,0,4
1427,0,1440,3795;3796;3797;3798,0,1,0,2,1,4
1428,0,1441,3799;3800;3801;3802,0,0,1,3,0,4
1429,0,1442,3803;3804,0,0,0,1,1,2
1430,0,1443,3805;3806,0,0,0,2,0,2
1431,0,1444,3807;3808,0,0,0,2,0,2
1432,0,1445,3809;3810;3811;3812;3813,0,0,2,3,0,5
1433,0,1446,3814,0,0,0,1,0,1
1434,0,1447,3815;3816;3817,0,0,0,2,1,3
1435,0,1448,3818;3819;3820,0,1,0,2,0,3
1436,0,1449,3821,0,0,0,1,0,1
1437,0,1450,3822;3824,0,0,0,2,0,2
1438,0,1451,3825;3826,0,0,0,2,0,2
1439,0,1452,3827;3828;3829,0,0,0,3,0,3
1440,0,1453,3830;3831;3832;3833;3834,0,0,2,3,0,5
1441,0,1454,3835;3836;3837,0,0,0,1,2,3
1442,0,1455,3838;3839;3840;3841;3842,0,3,0,1,1,5
1443,0,1456,3843;3844,0,0,0,2,0,2
1444,0,1457,3845;3846,0,0,0,1,1,2
1445,0,1458,3847;3848;3849;3850,0,0,2,2,0,4
1446,0,1459,3851,0,0,0,1,0,1
1447,0,1460,3852;3853;3854,0,0,0,2,1,3
1448,0,1461,3855;3856,0,0,0,2,0,2
1449,0,1462,3857;3858;3859;3860,0,0,2,2,0,4
1450,0,1463,3861;3862;3863,0,1,0,2,0,3
1451,0,1465,3865;3866;3867;3868;3869,0,0,1,3,1,5
1452,0,1466,3870;3871;3872;3873;3874,0,1,2,1,1,5
1453,0,1467,3875;3876;3878;3879,0,0,1,1,2,4
1454,0,1468,3880,0,0,0,1,0,1
1455,0,1469,3881,0,0,0,0,1,1
1456,0,1470,3882;3883,0,0,1,1,0,2
1457,0,1471,3884;3885;3886,0,0,1,2,0,3
1458,0,1472,3887,0,0,0,1,0,1
1459,0,1473,3888;3889,0,0,0,2,0,2
1460,0,1474,3890;3891;3892,0,0,0,3,0,3
1461,0,1475,3893;3895;10115,0,1,1,1,0,3
1462,0,1476,3896;3897,0,0,0,2,0,2
1463,0,1477,3898,0,0,0,1,0,1
1464,0,1478,3899;3900;3901,0,1,0,0,2,3
1465,0,1479,3902;3903;3904,0,0,0,3,0,3
1466,0,1480,3905;3906,0,0,0,2,0,2
1467,0,1481,3907;3908,0,0,0,2,0,2
1468,0,1482,3909,0,0,0,0,1,1
1469,0,1483,3910;3911,0,0,0,1,1,2
1470,0,1484,3912;3913,0,0,0,2,0,2
1471,0,1485,3915;3916;3917,0,0,0,2,1,3
1472,0,1486,3918;3919;3920;3921;3922,0,0,2,2,1,5
1473,0,1487,3923;3924;3925,0,0,0,3,0,3
1474,0,1488,3927,0,0,0,0,1,1
1475,0,1489,3928,0,0,0,0,1,1
1476,0,1490,3929;3930,0,0,1,0,1,2
1477,0,1491,3931;3932;3933;3934,0,0,0,4,0,4
1478,0,1492,3935;3936;3937,0,0,0,1,2,3
1479,0,1493,3938;3939;3940,0,0,0,3,0,3
1480,0,1494,3941;3942,0,0,0,1,1,2
1481,0,1495,3943;3944;3945,0,0,1,2,0,3
1482,0,1496,3946;3947;3948;3949,0,0,0,3,1,4
1483,0,1497,3950;3951;3952,0,1,0,1,1,3
1484,0,1498,3953;3954;3955;3956,0,0,0,4,0,4
1485,0,1499,3957;3958;3959;3960;3961;3962;3963,0,0,4,2,1,7
1486,0,1500,3964;3965,0,0,0,2,0,2
1487,0,1501,3966;3967;3968;3969,0,1,1,2,0,4
1488,0,1502,3970;3971;3972,0,0,0,3,0,3
1489,0,1503,3973,0,0,0,1,0,1
1490,0,1504,3974;3976;3977;3978,0,0,2,2,0,4
1491,0,1505,3979;3980,0,0,0,2,0,2
1492,0,1506,3981,0,0,0,1,0,1
1493,0,1508,3983;3984;3985;3986,0,0,1,3,0,4
1494,0,1509,3987;3988,0,0,0,2,0,2
1495,0,1510,3989;3990,0,0,0,1,1,2
1496,0,1511,3991;3992,0,0,0,2,0,2
1497,0,1512,3993;3994;3995;3996,0,0,2,2,0,4
1498,0,1513,3997;3998,0,0,0,1,1,2
1499,0,1514,3999;7359,0,0,0,2,0,2
1500,0,1515,4001;4002;4003;4004;4005,0,0,0,4,1,5
1501,0,1516,4006,0,0,0,0,1,1
1502,0,1517,4007;4008,0,0,0,1,1,2
1503,0,1518,4009;4010,0,0,0,2,0,2
1504,0,1519,4011,0,0,0,1,0,1
1505,0,1520,4012;4013,0,0,0,2,0,2
1506,0,1521,4014;4015;4016,0,0,1,2,0,3
1507,0,1522,4017,0,0,0,1,0,1
1508,0,1524,4019;4020;4021;4022;4023,0,1,1,3,0,5
1509,0,1525,4024;4025,0,0,0,1,1,2
1510,0,1526,4026;4027;4028,0,0,0,2,1,3
1511,0,1527,4029;4030,0,0,0,2,0,2
1512,0,1528,4031,0,0,0,1,0,1
1513,0,1529,4032;4033;4034;4035,0,0,2,1,1,4
1514,0,1530,4036,0,0,0,1,0,1
1515,0,1531,4038;4039;10079,0,1,0,2,0,3
1516,0,1532,4040,0,0,0,0,1,1
1517,0,1533,4041;4042;4043;4044;4045;4046,0,0,4,2,0,6
1518,0,1534,4047;4048;4049,0,0,0,1,2,3
1519,0,1535,4050;4051;4052;4053,0,0,1,3,0,4
1520,0,1536,4054;4055;4056;4057,0,2,0,2,0,4
1521,0,1537,4058,0,0,0,1,0,1
1522,0,1538,4059;4060;4061;4062,0,0,1,2,1,4
1523,0,1539,4063,0,0,0,1,0,1
1524,0,1540,4065,0,0,0,1,0,1
1525,0,1541,4066;4067,0,0,0,1,1,2
1526,0,1542,4068;4069;4070,0,0,1,2,0,3
1527,0,1543,4071;4072;4073;4074;4075,0,2,1,2,0,5
1528,0,1544,4076;4077,0,0,0,2,0,2
1529,0,1545,4078;4079,0,0,0,1,1,2
1530,0,1546,4080;4081,0,0,0,1,1,2
1531,0,1547,4082,0,0,0,1,0,1
1532,0,1548,4083;4084;4085;4086,0,0,0,4,0,4
1533,0,1549,4087,0,0,0,0,1,1
1534,0,1550,4088,0,0,0,1,0,1
1535,0,1551,4089;4090;4091;4092;4093,0,3,0,2,0,5
1536,0,1552,4094,0,0,0,1,0,1
1537,0,1553,4095,0,0,0,1,0,1
1538,0,1554,4096;4097,0,0,0,0,2,2
1539,0,1555,4098,0,0,0,1,0,1
1540,0,1556,4099;4100;4101;4102;4103,0,0,2,3,0,5
1541,0,1557,4104;4105;4106,0,1,0,2,0,3
1542,0,1558,4107;4108;4109,0,0,1,1,1,3
1543,0,1559,4110;4111;4112,0,0,0,2,1,3
1544,0,1560,4113;4114;4115,0,0,0,2,1,3
1545,0,1561,4116,0,0,0,1,0,1
1546,0,1562,4117;4118,0,0,0,1,1,2
1547,0,1563,4119;4120,0,0,0,2,0,2
1548,0,1564,4121;4122,0,0,0,0,2,2
1549,0,1565,4123;4124,0,0,0,2,0,2
1550,0,1566,4125,0,0,0,1,0,1
1551,0,1567,4126;4127,0,0,0,2,0,2
1552,0,1568,4128;4129;5803,0,0,1,2,0,3
1553,0,1569,4130;4131;4132,0,0,0,2,1,3
1554,0,1570,4133,0,0,0,1,0,1
1555,0,1571,4134,0,0,0,1,0,1
1556,0,1572,4135;4136;10018,0,1,0,2,0,3
1557,0,1573,4137;4138,0,0,0,1,1,2
1558,0,1574,4139;4140;4141,0,0,2,1,0,3
1559,0,1575,4142,0,0,0,1,0,1
1560,0,1576,4143;4144,0,0,0,2,0,2
1561,0,1577,4145;4146;4147;4148;4149;4150;4151,0,2,2,1,2,7
1562,0,1578,4152,0,0,0,1,0,1
1563,0,1579,4153;4154,0,0,0,2,0,2
1564,0,1580,4155;4156,0,0,0,2,0,2
1565,0,1581,4157;4158,0,0,0,2,0,2
1566,0,1582,4159;4160,0,0,0,1,1,2
1567,0,1583,4161;4162,0,0,0,2,0,2
1568,0,1584,4163;4164;4165;4166,0,0,2,1,1,4
1569,0,1585,4167;4168;4169;4170,0,0,2,1,1,4
1570,0,1586,4171,0,0,0,1,0,1
1571,0,1587,4172,0,0,0,1,0,1
1572,0,1588,4174;4175,0,0,0,1,1,2
1573,0,1589,4176;4177;4178,0,0,0,2,1,3
1574,0,1590,4179,0,0,0,1,0,1
1575,0,1591,4181;4182,0,0,0,1,1,2
1576,0,1592,4183;4184,0,0,0,2,0,2
1577,0,1593,4185;4186;4187;4188;4189,0,0,2,3,0,5
1578,0,1594,4190;4191,0,0,0,1,1,2
1579,0,1595,4192;4193,0,0,0,2,0,2
1580,0,1596,4194,0,0,0,0,1,1
1581,0,1597,4195;4196;4197;4198,0,0,0,3,1,4
1582,0,1598,4199;7907,0,0,0,2,0,2
1583,0,1599,4200;4202,0,0,0,1,1,2
1584,0,1600,4203;4204,0,0,0,2,0,2
1585,0,1601,4205,0,0,0,1,0,1
1586,0,1602,4206;4207;4208;4209;4210,0,0,0,4,1,5
1587,0,1603,4211,0,0,0,1,0,1
1588,0,1604,4212;4213,0,0,0,0,2,2
1589,0,1605,4214;4215,0,0,0,1,1,2
1590,0,1606,4216;4217;4218;4219;4220;4221,0,1,3,1,1,6
1591,0,1607,4222;4223;4224,0,0,0,3,0,3
1592,0,1608,4225;4226,0,0,0,1,1,2
1593,0,1609,4227;4228;4229,0,1,0,1,1,3
1594,0,1611,4231;4232,0,0,0,2,0,2
1595,0,1612,4233;4234;4235,0,1,0,1,1,3
1596,0,1614,4237;4238,0,0,0,2,0,2
1597,0,1615,4239,0,0,0,1,0,1
1598,0,1616,4240;4241,0,0,0,2,0,2
1599,0,1617,4242;4244,0,0,0,1,1,2
1600,0,1618,4245;4246,0,0,0,2,0,2
1601,0,1619,4247;4249,0,0,0,2,0,2
1602,0,1620,4250;4251;4252,0,0,1,1,1,3
1603,0,1621,4253;4254,0,0,0,2,0,2
1604,0,1622,4255;4256;4257;4258;4259,0,0,2,3,0,5
1605,0,1623,4260,0,0,0,1,0,1
1606,0,1624,4261,0,0,0,1,0,1
1607,0,1625,4262,0,0,0,1,0,1
1608,0,1626,4263;4264,0,0,0,2,0,2
1609,0,1627,4265;4266;4267;4268,0,0,2,1,1,4
1610,0,1628,4269;4270;4271;4272;4273;4274,0,0,3,3,0,6
1611,0,1629,4275;4277;4278;4279;4280,0,0,2,2,1,5
1612,0,1630,4281;4282;4283;4284;4285,0,0,3,2,0,5
1613,0,1631,4286;4287;4288,0,0,0,3,0,3
1614,0,1632,4289;4290,0,0,1,1,0,2
1615,0,1633,4291,0,0,0,1,0,1
1616,0,1634,4292;4293;4294;4295,0,1,0,3,0,4
1617,0,1635,4296;4297,0,0,0,2,0,2
1618,0,1636,4298;4299;10007,0,1,0,2,0,3
1619,0,1637,4300;4301,0,0,0,1,1,2
1620,0,1638,4302;4303;4304,0,1,0,2,0,3
1621,0,1639,4305;4306;4307;4308,0,0,2,2,0,4
1622,0,1640,4309,0,0,0,1,0,1
1623,0,1641,4310;4311,0,0,0,2,0,2
1624,0,1642,4312;4314;4315,0,0,1,1,1,3
1625,0,1643,4316;4317,0,0,0,2,0,2
1626,0,1644,4318,0,0,0,1,0,1
1627,0,1645,4319;4320;4321,0,0,0,2,1,3
1628,0,1646,4322,0,0,0,0,1,1
1629,0,1647,4323;4324,0,0,0,2,0,2
1630,0,1648,4325,0,0,0,1,0,1
1631,0,1649,4327,0,0,0,0,1,1
1632,0,1650,4328;4329,0,0,0,2,0,2
1633,0,1651,4330;4331,0,0,0,2,0,2
1634,0,1652,4332,0,0,0,1,0,1
1635,0,1653,4333,0,0,0,1,0,1
1636,0,1654,4334;4335;4336;4337,0,1,1,2,0,4
1637,0,1655,4338;4339;4340,0,0,0,1,2,3
1638,0,1656,4341,0,0,0,1,0,1
1639,0,1657,4342;4343,0,0,0,0,2,2
1640,0,1658,4344,0,0,0,1,0,1
1641,0,1659,4345;4346,0,0,0,2,0,2
1642,0,1660,4347,0,0,0,1,0,1
1643,0,1661,4348;4349;4350,0,0,0,2,1,3
1644,0,1662,4351;4352,0,0,0,2,0,2
1645,0,1663,4353;4354;4355;4356,0,0,0,2,2,4
1646,0,1664,4357,0,0,0,1,0,1
1647,0,1665,834;4358,0,0,0,2,0,2
1648,0,1666,4359;4360,0,0,0,0,2,2
1649,0,1667,4361;4362;4363,0,0,0,1,2,3
1650,0,1668,4364,0,0,0,1,0,1
1651,0,1669,4365,0,0,0,1,0,1
1652,0,1670,4366;4367;4368;4369;4370,0,0,3,1,1,5
1653,0,1671,4371;4372;4373;4374;4375,0,0,2,2,1,5
1654,0,1672,4376;4377;4378;4379,0,0,0,3,1,4
1655,0,1673,4380;4381,0,0,1,1,0,2
1656,0,1674,4382;4383;4384;4385,0,1,0,3,0,4
1657,0,1675,4386;4387,0,0,0,2,0,2
1658,0,1676,4388;4389;4390,0,0,0,2,1,3
1659,0,1677,4391;4392,0,0,0,1,1,2
1660,0,1678,4393;4394;4395,0,0,0,2,1,3
1661,0,1679,4396;4397;4398;4399;4400;4401,0,0,3,2,1,6
1662,0,1680,4402;4403,0,0,0,2,0,2
1663,0,1681,4404;4405;4406,0,0,0,2,1,3
1664,0,1682,4407,0,0,0,1,0,1
1665,0,1683,4408;4409;4410;4411,0,0,1,3,0,4
1666,0,1684,4412;4413,0,0,0,2,0,2
1667,0,1685,4414,0,0,0,0,1,1
1668,0,1686,4415;4416;4417,0,0,0,2,1,3
1669,0,1687,4418;4419,0,0,0,2,0,2
1670,0,1688,4420;4421,0,0,0,2,0,2
1671,0,1689,4422;4423,0,0,0,1,1,2
1672,0,1690,4424;4425,0,0,0,1,1,2
1673,0,1691,4426;4427,0,0,0,1,1,2
1674,0,1692,4428,0,0,0,1,0,1
1675,0,1693,4429,0,0,0,1,0,1
1676,0,1694,4430;4431,0,0,0,2,0,2
1677,0,1696,4433;4434;4435;4436,0,0,2,2,0,4
1678,0,1697,4437;4438,0,0,0,2,0,2
1679,0,1698,4439,0,0,0,0,1,1
1680,0,1699,4440;4441,0,0,0,1,1,2
1681,0,1701,4443;4444;4445,0,0,0,3,0,3
1682,0,1702,4446;4447;4448;4449,0,0,2,2,0,4
1683,0,1703,4450;4451,0,0,0,2,0,2
1684,0,1704,4452;4453,0,0,0,2,0,2
1685,0,1705,4454;4455;4456,0,1,0,2,0,3
1686,0,1706,4457;4458;4459;4460,0,0,0,1,3,4
1687,0,1707,4461,0,0,0,1,0,1
1688,0,1708,4462;4463,0,0,0,1,1,2
1689,0,1709,4464,0,0,0,1,0,1
1690,0,1710,4465;4466,0,0,0,2,0,2
1691,0,1711,3002;4467,0,0,0,2,0,2
1692,0,1712,4468;4469;4470;4471,0,2,0,2,0,4
1693,0,1713,4472;4473;4474;4475;4476,0,1,1,2,1,5
1694,0,1714,4477;4478;4479,0,0,1,1,1,3
1695,0,1715,4480;4481;4482,0,0,2,1,0,3
1696,0,1716,4483;4484;4485;4486;4487,0,0,1,4,0,5
1697,0,1717,4488;4489,0,0,0,1,1,2
1698,0,1718,4490;4491;4492;4493,0,0,0,3,1,4
1699,0,1719,4494,0,0,0,1,0,1
1700,0,1720,4495;4496,0,0,0,1,1,2
1701,0,1721,4497;4498;4499;4500,0,0,0,4,0,4
1702,0,1722,4501;4502,0,0,0,2,0,2
1703,0,1723,4503;4504;4505;4506,0,0,1,3,0,4
1704,0,1724,4507;4508;4509;4510;4511,0,0,3,2,0,5
1705,0,1725,4512;4513;4514;4515;4516,0,2,1,1,1,5
1706,0,1726,4517,0,0,0,1,0,1
1707,0,1727,4518;4519,0,0,0,1,1,2
1708,0,1728,4520;4521;4522;4523,0,1,0,3,0,4
1709,0,1729,1549;4524,0,0,0,2,0,2
1710,0,1730,4525;4526;4527;4528,0,0,1,3,0,4
1711,0,1731,4529;4530,0,0,0,2,0,2
1712,0,1732,4531,0,0,0,1,0,1
1713,0,1733,4532;4533;4534;4535,0,1,0,2,1,4
1714,0,1734,4536,0,0,0,1,0,1
1715,0,1735,4537,0,0,0,0,1,1
1716,0,1736,4538;4539,0,0,0,2,0,2
1717,0,1737,4540;4541;4542;4543;4544,0,1,2,2,0,5
1718,0,1738,4545,0,0,0,1,0,1
1719,0,1739,4546;4547;4548,0,0,0,3,0,3
1720,0,1740,4550;4551;4552;4553,0,0,1,1,2,4
1721,0,1741,4554;4555,0,0,0,1,1,2
1722,0,1742,4556,0,0,0,1,0,1
1723,0,1743,4557,0,0,0,0,1,1
1724,0,1744,4558;4559,0,0,0,2,0,2
1725,0,1745,4560;4561,0,0,0,2,0,2
1726,0,1746,4562,0,0,0,1,0,1
1727,0,1747,4563;4564;4565,0,0,0,2,1,3
1728,0,1748,4566;4567,0,0,0,1,1,2
1729,0,1749,4569;4570;4571,0,1,0,0,2,3
1730,0,1750,4572;4573,0,0,0,0,2,2
1731,0,1751,4575;4576;4577,0,0,1,1,1,3
1732,0,1752,4578,0,0,0,1,0,1
1733,0,1753,4579;4580;4581;4582,0,0,1,2,1,4
1734,0,1754,4583,0,0,0,0,1,1
1735,0,1755,4584;4585;4586;4587,0,1,1,2,0,4
1736,0,1756,4588;4589;4590,0,0,0,2,1,3
1737,0,1757,4591;4593;4594;4595,0,0,1,2,1,4
1738,0,1758,4596;4597,0,0,0,1,1,2
1739,0,1759,4598;4599;4600;4601,0,0,2,0,2,4
1740,0,1760,4602;4603,0,0,0,1,1,2
1741,0,1761,4604;4605;4606;4607;4608,0,0,0,5,0,5
1742,0,1762,4609;4610,0,0,0,2,0,2
1743,0,1763,4611;4612,0,0,0,2,0,2
1744,0,1764,4613;4614;4615;4616;4617,0,0,1,2,2,5
1745,0,1765,4618,0,0,0,1,0,1
1746,0,1766,4620;4621;4622;4623,0,0,0,3,1,4
1747,0,1767,4624;4625,0,0,0,1,1,2
1748,0,1768,4626;4627;4628;4629;4630,0,1,2,2,0,5
1749,0,1769,4631;4632;4633;4634,0,2,0,1,1,4
1750,0,1770,4635;4636;4637,0,0,1,2,0,3
1751,0,1771,4638,0,0,0,1,0,1
1752,0,1772,4639;4640;4641,0,0,0,3,0,3
1753,0,1773,4642;4643,0,0,0,1,1,2
1754,0,1774,4645,0,0,0,1,0,1
1755,0,1775,4646;4647;4648;4649,0,0,1,3,0,4
1756,0,1776,4650;4651,0,0,0,2,0,2
1757,0,1777,4652;4653;4654;4655;4656,0,1,2,1,1,5
1758,0,1778,4657;4658,0,0,0,2,0,2
1759,0,1779,4659;4660,0,0,0,2,0,2
1760,0,1780,4661,0,0,0,1,0,1
1761,0,1781,4662,0,0,0,1,0,1
1762,0,1782,4663,0,0,0,0,1,1
1763,0,1783,4664;4665,0,0,0,0,2,2
1764,0,1784,4666;4667;4668;4669,0,1,0,3,0,4
1765,0,1785,4670,0,0,0,1,0,1
1766,0,1786,4671;4672,0,0,0,1,1,2
1767,0,1787,4673;4674,0,0,0,2,0,2
1768,0,1788,4675;4676;4677,0,1,0,2,0,3
1769,0,1789,4678;4679;4680,0,0,1,2,0,3
1770,0,1790,4681;4682,0,0,0,1,1,2
1771,0,1791,4683;4684,0,0,0,1,1,2
1772,0,1792,4685;4686,0,0,0,2,0,2
1773,0,1793,4687;4688;4689;4690,0,0,2,2,0,4
1774,0,1794,4691;4692;4693;4694,0,0,2,2,0,4
1775,0,1795,4695;4696,0,0,0,0,2,2
1776,0,1796,4697;4698;4699;4700,0,2,0,1,1,4
1777,0,1797,4701,0,0,0,0,1,1
1778,0,1798,4702;4703;4704;10081,0,2,0,2,0,4
1779,0,1799,4705;4706;4707,0,0,0,3,0,3
1780,0,1800,4708;4709,0,0,0,2,0,2
1781,0,1801,4710,0,0,0,0,1,1
1782,0,1802,4711;4712;4713;4714,0,0,2,2,0,4
1783,0,1803,4715;4716,0,0,0,0,2,2
1784,0,1804,4717;4718,0,0,0,2,0,2
1785,0,1805,4719;4720;4721;4722;4723,0,0,3,1,1,5
1786,0,1806,4724;4725,0,0,0,1,1,2
1787,0,1807,4726;4727,0,0,0,2,0,2
1788,0,1808,4728;4729,0,0,0,0,2,2
1789,0,1810,4731;4732,0,0,0,1,1,2
1790,0,1811,4733;4734;4735;4736,0,0,1,3,0,4
1791,0,1812,4737;4738;4739;4740,0,0,0,4,0,4
1792,0,1813,4741;4742;4743,0,1,0,2,0,3
1793,0,1814,4744;4745,0,0,0,0,2,2
1794,0,1815,4746;4747;4748,0,1,0,1,1,3
1795,0,1816,4749;4750;4751;4752,0,1,0,3,0,4
1796,0,1817,4753;4754;4755;4756;4757,0,1,2,2,0,5
1797,0,1818,4758,0,0,0,1,0,1
1798,0,1819,4759;4760,0,0,0,1,1,2
1799,0,1820,4761;4762;4763;4764;4765,0,0,0,5,0,5
1800,0,1821,4766,0,0,0,1,0,1
1801,0,1822,4767;4768;4769;4770;4771,0,0,2,2,1,5
1802,0,1823,4772;4773,0,0,0,1,1,2
1803,0,1824,4774;4775,0,0,0,2,0,2
1804,0,1825,4776,0,0,0,1,0,1
1805,0,1826,4777;4778,0,0,0,2,0,2
1806,0,1827,4779;4780,0,0,0,2,0,2
1807,0,1828,4781,0,0,0,1,0,1
1808,0,1829,4782;4783,0,0,0,2,0,2
1809,0,1830,4784,0,0,0,1,0,1
1810,0,1831,4785,0,0,0,1,0,1
1811,0,1832,4786,0,0,0,1,0,1
1812,0,1833,3100;4787,0,0,0,2,0,2
1813,0,1834,4788;7009,0,0,0,2,0,2
1814,0,1835,4789;4790;4791;4792;4793,0,0,1,2,2,5
1815,0,1836,4795;4797;4798;4799,0,0,1,3,0,4
1816,0,1837,4800,0,0,0,1,0,1
1817,0,1838,4801;4802;4803;4804,0,0,0,3,1,4
1818,0,1839,4805;4806,0,0,0,2,0,2
1819,0,1840,4807;4808;4809,0,0,1,1,1,3
1820,0,1841,4810;4811,0,0,0,2,0,2
1821,0,1842,4812;4813,0,0,0,2,0,2
1822,0,1843,4814;4815,0,0,0,1,1,2
1823,0,1844,4816,0,0,0,1,0,1
1824,0,1845,4817,0,0,0,0,1,1
1825,0,1846,4818;4821,0,0,0,2,0,2
1826,0,1847,4822;4823,0,0,0,2,0,2
1827,0,1848,4824,0,0,0,1,0,1
1828,0,1849,4825;4826;4827;4828,0,0,2,1,1,4
1829,0,1850,4829,0,0,0,1,0,1
1830,0,1851,4830;4831;4832;4833,0,2,0,2,0,4
1831,0,1852,4834;4835,0,0,0,2,0,2
1832,0,1853,4836;4837;4838,0,0,0,2,1,3
1833,0,1854,4839;4840,0,0,0,1,1,2
1834,0,1855,4841;4842,0,0,0,2,0,2
1835,0,1856,4843;4844;4845;4846,0,2,0,2,0,4
1836,0,1857,4847,0,0,0,0,1,1
1837,0,1858,4848;4849;4850;4851,0,1,1,2,0,4
1838,0,1859,4852;4853;4854;4855;4856,0,0,3,1,1,5
1839,0,1860,4857;4858;4859;4860;4861;4862,0,0,4,1,1,6
1840,0,1861,4863;4864;4865;4866;4867;4868,0,2,0,4,0,6
1841,0,1862,4869;4870,0,0,0,2,0,2
1842,0,1863,4871;4872;4873;4874,0,0,2,2,0,4
1843,0,1864,4875;4876,0,0,0,1,1,2
1844,0,1865,4877;4878,0,0,0,1,1,2
1845,0,1866,4879;8171;10075,0,1,0,2,0,3
1846,0,1867,4880;4881;4882;4883,0,1,0,2,1,4
1847,0,1868,4884;4886;4887;4888;4889,0,0,1,3,1,5
1848,0,1869,4890;4891;4892,0,1,0,1,1,3
1849,0,1870,2527;4893,0,0,0,2,0,2
1850,0,1871,4894;4895;4896;4897;4898,0,0,1,2,2,5
1851,0,1872,4899;4900,0,0,0,2,0,2
1852,0,1873,4901;4902,0,0,0,1,1,2
1853,0,1874,4903,0,0,0,0,1,1
1854,0,1875,4904;4905,0,0,0,1,1,2
1855,0,1876,4906,0,0,0,0,1,1
1856,0,1877,4907;4908;4909,0,0,1,2,0,3
1857,0,1878,4910,0,0,0,1,0,1
1858,0,1879,4911;4912,0,0,0,1,1,2
1859,0,1880,4913;4914;4915;4916,0,0,0,3,1,4
1860,0,1881,4917;4918;4919;4920,0,0,0,4,0,4
1861,0,1882,4921;4922;4923;4924;4925,0,0,1,4,0,5
1862,0,1883,4926,0,0,0,1,0,1
1863,0,1884,4927;4928;4929;4930;4931,0,0,0,4,1,5
1864,0,1885,4932;4933,0,0,0,2,0,2
1865,0,1886,4934,0,0,0,1,0,1
1866,0,1887,4935;4936,0,0,0,2,0,2
1867,0,1888,4937;4939;4940;4941,0,0,0,2,2,4
1868,0,1889,4942;4943;4944;4945;4946,0,2,0,3,0,5
1869,0,1890,4947;4948;4949;4950,0,0,2,2,0,4
1870,0,1891,4951;4952;4953;4954;4955;4956,0,1,2,3,0,6
1871,0,1892,4957;4958;4959;4960,0,2,0,2,0,4
1872,0,1893,4961;4962;4963,0,0,1,2,0,3
1873,0,1894,4964;4965,0,0,0,2,0,2
1874,0,1895,4966;4967;4968,0,0,0,2,1,3
1875,0,1896,4969;4970,0,0,0,1,1,2
1876,0,1897,4972;4973,0,0,0,1,1,2
1877,0,1898,4974;4975,0,0,0,1,1,2
1878,0,1899,4976;4977;4978;4979,0,0,1,2,1,4
1879,0,1900,4980;4981,0,0,0,1,1,2
1880,0,1901,4983,0,0,0,1,0,1
1881,0,1902,4984,0,0,0,0,1,1
1882,0,1903,4985,0,0,0,1,0,1
1883,0,1904,4986,0,0,0,1,0,1
1884,0,1905,4987;4988;4989;4990,0,0,1,2,1,4
1885,0,1906,4991;4992,0,0,0,2,0,2
1886,0,1907,4993;4994,0,0,0,1,1,2
1887,0,1908,4995;4996,0,0,0,1,1,2
1888,0,1909,4442;4997,0,0,0,2,0,2
1889,0,1910,4998;4999;5000;5001;5002,0,0,2,2,1,5
1890,0,1911,5003;5004;5005,0,0,0,1,2,3
1891,0,1912,5006;5007;5008,0,0,0,3,0,3
1892,0,1913,5009;5010,0,0,0,1,1,2
1893,0,1914,5011;5012;5013,0,0,1,2,0,3
1894,0,1915,5014;5015;5016;5017,0,0,1,2,1,4
1895,0,1916,5018;5019,0,0,0,2,0,2
1896,0,1917,5020;5021;5022,0,0,0,2,1,3
1897,0,1918,5023;5024;5025,0,0,2,0,1,3
1898,0,1919,5026;5027,0,1,0,1,0,2
1899,0,1920,5028,0,0,0,1,0,1
1900,0,1921,5029;5030;5031;5032,0,1,1,1,1,4
1901,0,1922,5033;5034,0,0,0,2,0,2
1902,0,1923,5035;5036,0,0,0,2,0,2
1903,0,1924,5037;5038,0,0,0,2,0,2
1904,0,1925,5039;5040,0,1,0,0,1,2
1905,0,1926,5041;5042;5043;5044,0,0,2,2,0,4
1906,0,1927,5045;5046;5047,0,1,0,2,0,3
1907,0,1928,5048;5049;5050,0,0,0,3,0,3
1908,0,1929,5051;5052;5053,0,0,0,3,0,3
1909,0,1930,5054;5055,0,0,0,1,1,2
1910,0,1931,5056;5057,0,0,0,1,1,2
1911,0,1932,5058;5059;5060,0,0,0,2,1,3
1912,0,1933,5061;5062;5063;5064,0,1,1,1,1,4
1913,0,1934,5065;5066,0,0,0,2,0,2
1914,0,1935,5067;5068,0,0,0,2,0,2
1915,0,1936,5069;5070;5071;5072,0,0,1,2,1,4
1916,0,1937,5073;5074,0,0,0,2,0,2
1917,0,1938,5075;5076,0,0,0,1,1,2
1918,0,1939,5077,0,0,0,0,1,1
1919,0,1940,5078;5079,0,0,0,0,2,2
1920,0,1941,5080;5081,0,0,0,1,1,2
1921,0,1942,5082;5083;5084;5085;5086;5087,0,0,2,3,1,6
1922,0,1943,5088;5089;10012,0,1,0,1,1,3
1923,0,1944,5090;5091,0,0,0,1,1,2
1924,0,1945,5092;5093,0,0,0,1,1,2
1925,0,1946,5094;5095;5096;5097,0,1,0,2,1,4
1926,0,1947,5098;5099;5100,0,1,0,2,0,3
1927,0,1948,5101;5102,0,0,0,1,1,2
1928,0,1949,5103;5104;5105,0,0,1,1,1,3
1929,0,1950,5106,0,0,0,0,1,1
1930,0,1951,5107,0,0,0,0,1,1
1931,0,1952,5108,0,0,0,1,0,1
1932,0,1953,5110;5111;5113;5114,0,0,1,3,0,4
1933,0,1954,5115;5116,0,0,0,2,0,2
1934,0,1955,5117;5118;5119,0,0,0,3,0,3
1935,0,1956,5120,0,0,0,1,0,1
1936,0,1957,5121,0,0,0,0,1,1
1937,0,1958,5122,0,0,0,0,1,1
1938,0,1959,5123;5124,0,0,0,2,0,2
1939,0,1960,759;5125,0,0,0,2,0,2
1940,0,1961,5126;5127;5128,0,1,0,1,1,3
1941,0,1962,5129;5130,0,0,0,1,1,2
1942,0,1963,5131;5132;5133;5134;5135,0,1,1,2,1,5
1943,0,1964,5136;5137,0,0,1,1,0,2
1944,0,1965,5138,0,0,0,1,0,1
1945,0,1966,5139;5140,0,0,0,2,0,2
1946,0,1967,5141;5142,0,0,0,1,1,2
1947,0,1968,5143;5144,0,0,0,2,0,2
1948,0,1969,5146;5147;5148;5149,0,0,0,1,3,4
1949,0,1970,5150;5151,0,0,0,1,1,2
1950,0,1971,5152;5153,0,0,0,2,0,2
1951,0,1972,5154;5155;5156,0,1,0,1,1,3
1952,0,1973,5157;5158;5159;5160;5161,0,1,2,2,0,5
1953,0,1974,5162;5163,0,0,0,2,0,2
1954,0,1975,5164;5165;5166,0,0,1,2,0,3
1955,0,1976,5167;5168;5169;5170,0,0,1,3,0,4
1956,0,1977,5171,0,0,0,0,1,1
1957,0,1978,5172;5173;5174;5175,0,1,1,1,1,4
1958,0,1979,5176;5177;5178,0,0,0,3,0,3
1959,0,1980,5179;5180;5181,0,0,1,2,0,3
1960,0,1981,5182,0,0,0,1,0,1
1961,0,1982,5183,0,0,0,1,0,1
1962,0,1983,5184;5185;5186;5187,0,2,0,2,0,4
1963,0,1984,5188;5189;5190;5191;5192,0,0,3,1,1,5
1964,0,1985,5193;5194,0,0,0,1,1,2
1965,0,1986,5195;5196,0,0,1,1,0,2
1966,0,1987,5197;5198,0,0,0,2,0,2
1967,0,1988,5199;5200;5201;5202,0,0,2,1,1,4
1968,0,1989,5203,0,0,0,0,1,1
1969,0,1990,5205;5206,0,0,0,2,0,2
1970,0,1991,5207;5208,0,0,0,2,0,2
1971,0,1992,5209;5210,0,0,0,2,0,2
1972,0,1993,5212;5213;5214;5215;5216,0,0,0,5,0,5
1973,0,1994,5217;5218,0,0,0,2,0,2
1974,0,1995,5219;5220;5221,0,0,0,3,0,3
1975,0,1996,5222;5223,0,0,0,2,0,2
1976,0,1997,5224;5225,0,0,0,1,1,2
1977,0,1998,5226;5227;5228,0,1,0,2,0,3
1978,0,1999,5229;5230;5231;5232,0,0,1,2,1,4
1979,0,2000,5233;5234;5236,0,0,0,2,1,3
1980,0,2001,5237;5238,0,0,0,1,1,2
1981,0,2002,5239,0,0,0,1,0,1
1982,0,2003,5240;5241,0,0,1,1,0,2
1983,0,2004,5242;5243;5244;5245,0,0,1,3,0,4
1984,0,2005,5246;5247;5248;5249,0,1,1,2,0,4
1985,0,2006,5250;5251,0,0,0,2,0,2
1986,0,2007,5252,0,0,0,0,1,1
1987,0,2008,5253;5254,0,0,0,1,1,2
1988,0,2009,5255;5256;5257;5258,0,1,0,2,1,4
1989,0,2010,5259;5260;5261,0,0,2,1,0,3
1990,0,2011,5262;5263,0,0,0,2,0,2
1991,0,2012,5264,0,0,0,1,0,1
1992,0,2013,5265;5266;5267,0,0,0,2,1,3
1993,0,2014,5268;5269,0,0,0,1,1,2
1994,0,2015,5270,0,0,0,0,1,1
1995,0,2016,5271,0,0,0,1,0,1
1996,0,2017,5272;5273,0,0,0,2,0,2
1997,0,2018,5274,0,0,0,1,0,1
1998,0,2019,5275;5276;5277;5278,0,0,1,2,1,4
1999,0,2020,5279,0,0,0,1,0,1
2000,0,2021,5280;5281;5282;5283,0,0,0,4,0,4
2001,0,2022,5284;5285,0,0,0,2,0,2
2002,0,2023,5286;5287;5288;5289,0,0,0,3,1,4
2003,0,2024,5290;5291,0,0,0,2,0,2
2004,0,2025,5292;5293;10064,0,1,0,1,1,3
2005,0,2026,5294;5295;5296;5297,0,1,1,2,0,4
2006,0,2027,5298,0,0,0,1,0,1
2007,0,2028,5299;5300;5301;5302,0,0,2,1,1,4
2008,0,2029,5303;5304,0,0,0,2,0,2
2009,0,2030,5305;5306;5307,0,0,0,2,1,3
2010,0,2031,5308;5309;5310;5311;10009,0,3,0,2,0,5
2011,0,2032,5312;5313,0,0,0,1,1,2
2012,0,2033,5314;5315,0,0,0,2,0,2
2013,0,2034,5316;5317;5318,0,0,1,2,0,3
2014,0,2035,5319;5320,0,0,0,2,0,2
2015,0,2036,5321;8005,0,0,0,2,0,2
2016,0,2037,5322,0,0,0,1,0,1
2017,0,2038,5323,0,0,0,1,0,1
2018,0,2039,5325,0,0,0,1,0,1
2019,0,2040,5326;5327;5328;5329;5330;5331,0,1,3,2,0,6
2020,0,2041,5332,0,0,0,1,0,1
2021,0,2042,5333,0,0,0,1,0,1
2022,0,2043,5334;5335;10013,0,1,0,2,0,3
2023,0,2044,5336;5337,0,0,0,2,0,2
2024,0,2045,5338,0,0,0,1,0,1
2025,0,2046,5339;5340,0,0,0,2,0,2
2026,0,2047,5341,0,0,0,1,0,1
2027,0,2048,5342;5343,0,0,0,2,0,2
2028,0,2049,5344;5345,0,0,0,1,1,2
2029,0,2050,5346;5347,0,0,0,1,1,2
2030,0,2051,5348;5349,0,0,0,1,1,2
2031,0,2052,5350;5351;5353,0,0,1,2,0,3
2032,0,2053,5354;5355,0,0,0,2,0,2
2033,0,2054,5356;5357,0,0,0,2,0,2
2034,0,2055,5358;5359;5360,0,0,0,2,1,3
2035,0,2056,5361;5362,0,0,0,2,0,2
2036,0,2057,5363;5364;5365;5366;5367,0,1,1,3,0,5
2037,0,2058,5369,0,0,0,1,0,1
2038,0,2059,5370;5371;5372,0,0,0,3,0,3
2039,0,2060,5373;5374,0,0,0,2,0,2
2040,0,2061,5375;5376;5377;5378;5379,0,0,1,4,0,5
2041,0,2062,5380;5381;5382,0,0,1,0,2,3
2042,0,2063,5383;5384,0,0,0,2,0,2
2043,0,2064,5386;5387,0,0,0,2,0,2
2044,0,2065,5388;5389;5390,0,1,0,1,1,3
2045,0,2066,5391;5392,0,0,0,2,0,2
2046,0,2067,5393,0,0,0,1,0,1
2047,0,2068,5394;5395;5396,0,0,3,0,0,3
2048,0,2069,5397;5398,0,0,0,2,0,2
2049,0,2070,5399;5400;5401;5402,0,1,0,2,1,4
2050,0,2071,5403;5404,0,0,0,2,0,2
2051,0,2072,5405;5406,0,0,0,2,0,2
2052,0,2073,5407;5408;5409;5410,0,0,1,2,1,4
2053,0,2074,5411;5412;5413,0,0,0,2,1,3
2054,0,2075,5414;5415,0,0,0,1,1,2
2055,0,2076,5416,0,0,0,1,0,1
2056,0,2077,5417;5418;5419;5420;5421,0,1,1,2,1,5
2057,0,2078,5422,0,0,0,1,0,1
2058,0,2079,5423;5424;5425,0,1,0,2,0,3
2059,0,2080,5426;5427,0,0,0,2,0,2
2060,0,2081,5428;5429,0,0,0,2,0,2
2061,0,2082,5430;5431;5432;5433,0,1,0,3,0,4
2062,0,2083,5434;5435;5436;5437,0,2,0,1,1,4
2063,0,2084,5438;5439;5440;5441;5442;5443,0,0,3,3,0,6
2064,0,2085,5444;5445,0,0,0,1,1,2
2065,0,2086,5446;5447;5448;5449,0,1,1,1,1,4
2066,0,2087,5450;5451;5452,0,0,0,2,1,3
2067,0,2088,4592;5453,0,0,0,2,0,2
2068,0,2089,5454;5455,0,0,0,2,0,2
2069,0,2090,5456;5457;5458;5459;5460,0,2,1,2,0,5
2070,0,2091,5461,0,0,0,1,0,1
2071,0,2093,5463;5464;10059,0,1,0,2,0,3
2072,0,2094,5465;5466,0,0,0,1,1,2
2073,0,2095,5467,0,0,0,0,1,1
2074,0,2096,5468;5469,0,0,0,1,1,2
2075,0,2097,5470;5471,0,0,0,1,1,2
2076,0,2098,5472;5473,0,0,0,1,1,2
2077,0,2099,5474,0,0,0,1,0,1
2078,0,2100,5475;5476,0,0,0,2,0,2
2079,0,2101,5477;5478;5479;5480,0,2,0,2,0,4
2080,0,2102,5481;5482,0,0,0,1,1,2
2081,0,2103,5484,0,0,0,1,0,1
2082,0,2104,5485;5486;5487,0,0,0,3,0,3
2083,0,2105,5488;5489;5490;5511,0,0,1,3,0,4
2084,0,2106,5491;5492,0,0,0,2,0,2
2085,0,2107,5493;5494;5495,0,0,0,1,2,3
2086,0,2108,5496;5497,0,0,0,1,1,2
2087,0,2109,5498;5499;5500,0,0,0,1,2,3
2088,0,2110,5502;5503,0,0,0,1,1,2
2089,0,2111,5504;5666,0,0,0,2,0,2
2090,0,2112,5505,0,0,0,1,0,1
2091,0,2113,5506,0,0,0,1,0,1
2092,0,2114,5507;5508,0,0,0,1,1,2
2093,0,2115,5509,0,0,0,1,0,1
2094,0,2116,5510;5512,0,0,0,2,0,2
2095,0,2117,5513;5514;5515;5516,0,0,0,4,0,4
2096,0,2118,5517;5518,0,0,0,2,0,2
2097,0,2119,5519;5520;5521;5522,0,2,0,1,1,4
2098,0,2120,5523;5524;5525;5526;6240,0,1,2,2,0,5
2099,0,2121,5527,0,0,0,1,0,1
2100,0,2122,5528,0,0,0,1,0,1
2101,0,2123,5529,0,0,0,1,0,1
2102,0,2124,5530;5531,0,0,0,1,1,2
2103,0,2125,5532;5533,0,0,0,2,0,2
2104,0,2126,3305;5534,0,0,0,2,0,2
2105,0,2127,5535;5536,0,0,0,2,0,2
2106,0,2128,5537,0,0,0,1,0,1
2107,0,2129,5538,0,0,0,0,1,1
2108,0,2130,5539;5540;5541;5542,0,0,0,3,1,4
2109,0,2131,5543;5544;5545;5546;5547,0,0,2,3,0,5
2110,0,2132,5548;5549;5550;10080,0,1,0,3,0,4
2111,0,2133,5551;5552;5553;5554,0,0,2,1,1,4
2112,0,2134,5555;5556;5557,0,1,0,2,0,3
2113,0,2135,5558,0,0,0,1,0,1
2114,0,2136,5560;5561,0,0,0,2,0,2
2115,0,2137,5562;5563;5564;5565,0,0,1,2,1,4
2116,0,2138,5566;5567;5568,0,0,0,1,2,3
2117,0,2139,5569;5570;5571;5572;5573,0,0,2,2,1,5
2118,0,2140,5574,0,0,0,1,0,1
2119,0,2141,5575;5576;5577,0,0,0,2,1,3
2120,0,2142,5578,0,0,0,1,0,1
2121,0,2143,5579;5580,0,0,0,2,0,2
2122,0,2144,5581,0,0,0,1,0,1
2123,0,2145,5582;10073,0,1,0,1,0,2
2124,0,2146,5583,0,0,0,1,0,1
2125,0,2147,5584;5585,0,0,0,0,2,2
2126,0,2148,5586;5587;5588;5589;5590,0,0,1,2,2,5
2127,0,2149,5591,0,0,0,1,0,1
2128,0,2150,5592,0,0,0,1,0,1
2129,0,2151,5593;5594,0,0,0,2,0,2
2130,0,2152,5595;5596,0,0,0,2,0,2
2131,0,2153,5597;5598,0,0,0,1,1,2
2132,0,2154,5599;5601,0,0,0,2,0,2
2133,0,2155,5602;5603;5604;5605;5606,0,0,3,2,0,5
2134,0,2156,5607,0,0,0,1,0,1
2135,0,2157,5608;5609,0,0,0,2,0,2
2136,0,2158,5610;5611;5612,0,0,0,2,1,3
2137,0,2159,5613,0,0,0,1,0,1
2138,0,2160,5614;5615;5616;5617,0,0,2,2,0,4
2139,0,2161,5618;5619,0,0,0,2,0,2
2140,0,2162,5620;5621,0,0,0,1,1,2
2141,0,2163,5623,0,0,0,0,1,1
2142,0,2164,5625;5626,0,0,0,2,0,2
2143,0,2165,5627;5628;5629;5630,0,0,1,2,1,4
2144,0,2166,5631;5632,0,0,0,1,1,2
2145,0,2167,5633,0,0,0,1,0,1
2146,0,2168,5634;5635,0,0,0,2,0,2
2147,0,2169,5636;5637;5638;5639,0,0,0,3,1,4
2148,0,2170,5640;5641;5642;5643;10047;10056,0,4,0,2,0,6
2149,0,2171,5644,0,0,0,1,0,1
2150,0,2172,5645;5646;5647,0,0,0,1,2,3
2151,0,2173,5648;5649,0,0,0,2,0,2
2152,0,2174,5650;5651,0,0,0,2,0,2
2153,0,2175,5652;5654,0,0,0,2,0,2
2154,0,2176,5655;5656,0,0,0,2,0,2
2155,0,2177,5657;5658;5659,0,1,0,1,1,3
2156,0,2178,5660;5661;5662,0,0,1,2,0,3
2157,0,2179,5663;5664,0,0,0,2,0,2
2158,0,2180,5665,0,0,0,0,1,1
2159,0,2181,5667;5668,0,0,0,2,0,2
2160,0,2182,5669,0,0,0,0,1,1
2161,0,2183,5670;5671,0,0,0,1,1,2
2162,0,2184,5672;5673;5674,0,0,1,2,0,3
2163,0,2185,5675,0,0,0,1,0,1
2164,0,2186,5676,0,0,0,1,0,1
2165,0,2187,5677;5678;5679,0,0,1,1,1,3
2166,0,2188,5680;5681,0,0,0,2,0,2
2167,0,2189,5682,0,0,0,1,0,1
2168,0,2190,5683;5684,0,0,0,2,0,2
2169,0,2191,5686;5687;5688,0,0,1,1,1,3
2170,0,2192,5689;5691;5692,0,0,1,2,0,3
2171,0,2193,5693,0,0,0,1,0,1
2172,0,2194,5694;5695,0,0,0,2,0,2
2173,0,2195,5696;5697;5698,0,1,0,2,0,3
2174,0,2196,5699;5701;5702;5703;5704,0,0,2,3,0,5
2175,0,2197,5705;5706,0,0,0,1,1,2
2176,0,2198,5707;5708;5709;5710,0,1,1,2,0,4
2177,0,2199,5711;5712,0,0,0,2,0,2
2178,0,2200,5713,0,0,0,0,1,1
2179,0,2201,4201;5714;5715;5716,0,0,0,4,0,4
2180,0,2202,5717;10033,0,1,0,1,0,2
2181,0,2203,5718,0,0,0,1,0,1
2182,0,2204,5719;5720;5721;5722;5723,0,0,2,2,1,5
2183,0,2205,5724;5725;5726,0,0,1,2,0,3
2184,0,2206,5727,0,0,0,1,0,1
2185,0,2207,5728,0,0,0,0,1,1
2186,0,2208,5729;5730;5731,0,1,0,2,0,3
2187,0,2209,5732,0,0,0,1,0,1
2188,0,2210,5733;5734;5735;5736;5737;5738,0,1,2,2,1,6
2189,0,2211,5739;5740;5741;5742;5743,0,2,1,0,2,5
2190,0,2212,5744;5745;5747;5748;5749,0,0,1,3,1,5
2191,0,2213,5750;5751;5753,0,0,0,1,2,3
2192,0,2214,5755,0,0,0,1,0,1
2193,0,2215,5756;5757;5758,0,0,0,3,0,3
2194,0,2216,5759,0,0,0,0,1,1
2195,0,2217,5760;9331,0,0,0,2,0,2
2196,0,2218,5761,0,0,0,1,0,1
2197,0,2219,5762;5763;5764;5765;5766,0,1,0,3,1,5
2198,0,2220,5767;5768;5770;5771,0,0,0,4,0,4
2199,0,2221,5772;5773;5774;5775,0,1,0,1,2,4
2200,0,2222,5776;5777,0,0,0,1,1,2
2201,0,2224,5780;5781;5782,0,0,0,3,0,3
2202,0,2225,5783;5784,0,0,0,1,1,2
2203,0,2226,5785;5786;5787;5788;5789,0,0,3,1,1,5
2204,0,2227,5790,0,0,0,1,0,1
2205,0,2228,5791;5792;5793,0,1,1,1,0,3
2206,0,2229,5794;5795,0,0,0,1,1,2
2207,0,2230,5796;5797;5798;5799,0,0,2,1,1,4
2208,0,2231,5800;7942,0,0,0,2,0,2
2209,0,2232,5801,0,0,0,1,0,1
2210,0,2233,5802,0,0,0,0,1,1
2211,0,2235,5804;5805;5806,0,0,2,1,0,3
2212,0,2236,5807;5808;5809;5810;5811,0,0,2,3,0,5
2213,0,2237,5812;8644,0,0,0,2,0,2
2214,0,2238,5813;5814,0,1,0,1,0,2
2215,0,2239,5815,0,0,0,1,0,1
2216,0,2240,5816;5817,0,0,0,1,1,2
2217,0,2241,5818;5819,0,0,0,1,1,2
2218,0,2242,5820;5821,0,0,0,1,1,2
2219,0,2243,184;5822,0,0,0,2,0,2
2220,0,2244,5823;5824,0,0,0,2,0,2
2221,0,2245,5826;5827;5828,0,0,0,1,2,3
2222,0,2246,5829;5830,0,0,0,1,1,2
2223,0,2247,5831;5832,0,0,0,2,0,2
2224,0,2248,5833,0,0,0,1,0,1
2225,0,2249,5834;5835;10055,0,1,0,2,0,3
2226,0,2250,5836;5837,0,0,0,1,1,2
2227,0,2251,5838,0,0,0,1,0,1
2228,0,2252,5839;5840;5841,0,0,0,2,1,3
2229,0,2253,5842,0,0,0,1,0,1
2230,0,2254,5843;5844,0,0,0,2,0,2
2231,0,2255,5845,0,0,0,1,0,1
2232,0,2256,5847;5848;5849;5850,0,1,1,2,0,4
2233,0,2257,5851,0,0,0,0,1,1
2234,0,2258,5852;5853,0,0,0,0,2,2
2235,0,2260,5856;5857,0,0,0,2,0,2
2236,0,2261,5858;5859;5860,0,1,0,2,0,3
2237,0,2262,5861;5862;5863;5864,0,0,2,2,0,4
2238,0,2263,5865;5866,0,0,0,2,0,2
2239,0,2264,5867;5868;5869;5870;5871,0,0,2,3,0,5
2240,0,2265,5872;5873,0,0,0,1,1,2
2241,0,2266,5874;5876,0,0,0,1,1,2
2242,0,2267,5877,0,0,0,1,0,1
2243,0,2268,5878,0,0,0,1,0,1
2244,0,2269,5879,0,0,0,1,0,1
2245,0,2270,5880,0,0,0,1,0,1
2246,0,2271,5881;5882;5883,0,0,0,3,0,3
2247,0,2272,5884,0,0,0,1,0,1
2248,0,2273,5885;5886,0,0,0,0,2,2
2249,0,2274,5887;5889;5890,0,1,0,2,0,3
2250,0,2275,5891;5892;6565,0,0,1,2,0,3
2251,0,2276,5894;5895;7586,0,0,0,3,0,3
2252,0,2277,5896,0,0,0,1,0,1
2253,0,2278,5897;5898;5899;5900;5901;10032,0,2,1,2,1,6
2254,0,2279,5902,0,0,0,1,0,1
2255,0,2280,5903;5904;5905,0,0,1,0,2,3
2256,0,2281,5906;5907,0,0,0,2,0,2
2257,0,2282,5908;5909,0,0,0,1,1,2
2258,0,2283,5910;5911,0,0,0,2,0,2
2259,0,2284,5912;5913;5914,0,0,0,3,0,3
2260,0,2285,5915;5916;5917,0,1,0,1,1,3
2261,0,2286,5918,0,0,0,1,0,1
2262,0,2287,5919;5920,0,0,0,2,0,2
2263,0,2288,5921;5922,0,0,0,1,1,2
2264,0,2289,5923;5924,0,0,0,2,0,2
2265,0,2290,5925;5926,0,0,0,2,0,2
2266,0,2291,4018;5927;5928;5929;5930,0,2,0,3,0,5
2267,0,2292,5931;5932,0,0,0,2,0,2
2268,0,2293,5933,0,0,0,0,1,1
2269,0,2294,5934;5935;5936;5937,0,1,1,2,0,4
2270,0,2295,5938;5939;5940,0,0,0,2,1,3
2271,0,2296,5941;5942,0,0,0,2,0,2
2272,0,2298,5944;5945,0,0,0,2,0,2
2273,0,2299,5946,0,0,0,1,0,1
2274,0,2300,5947;5948;5949;5950,0,0,2,1,1,4
2275,0,2301,5951;5952;10090,0,1,0,1,1,3
2276,0,2302,5953;5954;5955,0,0,0,3,0,3
2277,0,2303,5956;5957,0,0,0,1,1,2
2278,0,2304,5958;5959,0,0,0,2,0,2
2279,0,2305,5960;5961;5962;5963;5964,0,0,3,1,1,5
2280,0,2306,5965;5966;5967;5968;5969;5970,0,0,4,2,0,6
2281,0,2307,5971;5972;5973;5974,0,0,0,2,2,4
2282,0,2308,5975,0,0,0,1,0,1
2283,0,2309,5977,0,0,0,1,0,1
2284,0,2310,5978,0,0,0,1,0,1
2285,0,2311,5979;5980;5981;5982,0,0,1,3,0,4
2286,0,2312,5983;5984;5985,0,0,1,2,0,3
2287,0,2313,5986;5987;5988,0,0,1,1,1,3
2288,0,2314,5989;5990;5991;5992,0,2,0,2,0,4
2289,0,2315,5993;5994,0,0,0,2,0,2
2290,0,2316,5995;5996;5997;5998,0,0,0,1,3,4
2291,0,2317,5999;6000;6001;6002;6003,0,2,0,3,0,5
2292,0,2318,6004;6005,0,0,0,2,0,2
2293,0,2319,6006,0,0,0,1,0,1
2294,0,2320,6007,0,0,0,1,0,1
2295,0,2321,6008,0,0,0,1,0,1
2296,0,2322,6009;6010,0,0,0,0,2,2
2297,0,2323,6011;6012,0,0,0,1,1,2
2298,0,2324,6013;6014;6015,0,1,0,1,1,3
2299,0,2325,6016;6017,0,0,0,2,0,2
2300,0,2326,6018;6019;6020;6021;6022,0,0,0,4,1,5
2301,0,2327,6023;6024,0,0,0,1,1,2
2302,0,2328,6025,0,0,0,1,0,1
2303,0,2329,6026;6027;6028,0,0,0,3,0,3
2304,0,2330,6029,0,0,0,1,0,1
2305,0,2331,6030;6032,0,0,0,2,0,2
2306,0,2332,6033;6034;6035;6036;6037,0,0,2,3,0,5
2307,0,2333,6038;6091,0,0,0,2,0,2
2308,0,2334,6039;6040,0,0,0,1,1,2
2309,0,2335,6041;6042,0,0,0,2,0,2
2310,0,2336,6043;6044,0,0,0,2,0,2
2311,0,2337,6045,0,0,0,0,1,1
2312,0,2338,6046,0,0,0,1,0,1
2313,0,2340,6048,0,0,0,1,0,1
2314,0,2341,6049;6050,0,0,0,2,0,2
2315,0,2342,6051;6052;6053;6054,0,0,2,2,0,4
2316,0,2343,6055;6056,0,1,1,0,0,2
2317,0,2344,6057,0,0,0,1,0,1
2318,0,2345,6058,0,0,0,0,1,1
2319,0,2346,6059,0,0,0,1,0,1
2320,0,2347,6060;6061,0,0,0,2,0,2
2321,0,2348,6063,0,0,0,1,0,1
2322,0,2349,6064;6065;6066;6067,0,0,0,3,1,4
2323,0,2350,6068;6069;6070;6071,0,1,1,2,0,4
2324,0,2351,6072;6073;6074,0,0,0,1,2,3
2325,0,2352,6075;6076,0,0,0,1,1,2
2326,0,2353,6077;6078,0,0,0,2,0,2
2327,0,2354,6080;6081,0,0,0,1,1,2
2328,0,2355,6082;6083;6084;6085,0,1,0,1,2,4
2329,0,2356,6086;6087;6088,0,1,0,0,2,3
2330,0,2357,6089;6090,0,0,0,2,0,2
2331,0,2359,6092,0,0,0,1,0,1
2332,0,2360,6093;6094,0,0,0,1,1,2
2333,0,2361,6095;6096,0,0,0,2,0,2
2334,0,2362,6097;6098,0,0,0,2,0,2
2335,0,2363,6100;6101;6102,0,0,2,1,0,3
2336,0,2364,6103;6104,0,0,0,1,1,2
2337,0,2365,6105;6106;6107;6108,0,0,1,3,0,4
2338,0,2366,6109;6110;6111;6112;6138;6139,0,0,4,2,0,6
2339,0,2367,6113;6114;10044,0,2,0,1,0,3
2340,0,2368,6115;6116;6117;6118,0,0,2,1,1,4
2341,0,2369,6119;6120;6121,0,0,0,3,0,3
2342,0,2370,6122;6123;6124,0,0,0,2,1,3
2343,0,2371,6125;6126;6127,0,1,0,2,0,3
2344,0,2372,6128;6129,0,0,0,1,1,2
2345,0,2373,6130,0,0,0,1,0,1
2346,0,2374,6131;6132;6133,0,0,1,0,2,3
2347,0,2375,6134;6135,0,0,0,1,1,2
2348,0,2376,6136,0,0,0,0,1,1
2349,0,2379,122;6140,0,0,0,2,0,2
2350,0,2380,6141;6142,0,0,0,2,0,2
2351,0,2381,6144,0,0,0,0,1,1
2352,0,2382,6146,0,0,0,0,1,1
2353,0,2383,6148;6149,0,0,0,2,0,2
2354,0,2384,6150;6151,0,0,0,1,1,2
2355,0,2385,6152;6153;6154;6155;10019,0,2,1,2,0,5
2356,0,2386,6156;6157;6158;6159,0,1,1,2,0,4
2357,0,2387,6160;6161,0,0,0,2,0,2
2358,0,2388,6162;6163;6164;10060,0,1,0,3,0,4
2359,0,2389,6165;6166,0,0,1,0,1,2
2360,0,2390,6167;6168;6169;6170,0,0,1,3,0,4
2361,0,2391,6171;6172,0,0,0,2,0,2
2362,0,2392,6173;6174,0,0,0,2,0,2
2363,0,2393,6175,0,0,0,1,0,1
2364,0,2394,6177;6178,0,0,0,0,2,2
2365,0,2395,6179;6180,0,0,0,2,0,2
2366,0,2396,6181;6182;6183;6184,0,0,2,2,0,4
2367,0,2397,6185;6186;6187;6188,0,0,2,1,1,4
2368,0,2398,6189;6190;6191;6192,0,0,2,1,1,4
2369,0,2399,6193;6194,0,0,0,2,0,2
2370,0,2400,6195;6196;6197,0,0,1,2,0,3
2371,0,2401,6198;6199;6200;6201;6202,0,1,1,2,1,5
2372,0,2402,6203,0,0,0,0,1,1
2373,0,2403,6204;6205,0,0,0,2,0,2
2374,0,2404,6206;6207;6208,0,1,0,2,0,3
2375,0,2405,6209;6210;6211;6212,0,1,0,2,1,4
2376,0,2406,6213,0,0,0,1,0,1
2377,0,2407,6214;6215;10100;10114,0,2,0,2,0,4
2378,0,2408,6216;6217;10036;10058,0,2,0,2,0,4
2379,0,2409,6218;6219;6220;6221;6222,0,0,1,4,0,5
2380,0,2410,6223;6224;6225,0,0,0,2,1,3
2381,0,2411,6226,0,0,0,1,0,1
2382,0,2412,6227,0,0,0,1,0,1
2383,0,2413,6228;6229,0,0,0,1,1,2
2384,0,2414,6230;6231;6232;6233,0,1,0,3,0,4
2385,0,2415,6234,0,0,0,1,0,1
2386,0,2416,6235;6236,0,0,0,1,1,2
2387,0,2418,6241;6242,0,0,0,2,0,2
2388,0,2419,6243;6244;6245;6246,0,0,0,2,2,4
2389,0,2420,6247;6248,0,0,0,1,1,2
2390,0,2421,6249,0,0,0,1,0,1
2391,0,2422,6250;6251;6252,0,1,0,1,1,3
2392,0,2423,6254,0,0,0,1,0,1
2393,0,2424,6255;6256,0,0,0,2,0,2
2394,0,2425,6257;6258;6259;6261;6262,0,2,0,1,2,5
2395,0,2426,6263;6264,0,0,0,1,1,2
2396,0,2427,6265;6266,0,0,0,1,1,2
2397,0,2428,6267;6268,0,0,0,1,1,2
2398,0,2429,6269;6270;6271;6272,0,1,0,1,2,4
2399,0,2430,6273;6274;6275,0,1,0,2,0,3
2400,0,2431,6276;6277;6278,0,0,1,1,1,3
2401,0,2432,6279;6280;6281,0,0,0,2,1,3
2402,0,2433,6282;6283;6284;6285,0,0,2,2,0,4
2403,0,2434,6286;6287;6288;6289;6290,0,0,1,3,1,5
2404,0,2435,6291,0,0,0,1,0,1
2405,0,2436,6292,0,0,0,1,0,1
2406,0,2437,6293;6294;6295;6296,0,0,2,1,1,4
2407,0,2438,6297;6298;6299,0,0,1,0,2,3
2408,0,2439,6300;6301,0,0,0,2,0,2
2409,0,2440,6302;6303;6304,0,0,0,2,1,3
2410,0,2441,681;6305,0,0,0,2,0,2
2411,0,2442,6306;6307;6308;6309,0,1,1,1,1,4
2412,0,2443,6310;6311;6312;6313,0,0,0,2,2,4
2413,0,2444,6314;6315,0,0,0,1,1,2
2414,0,2445,6317;6318;6319,0,0,1,2,0,3
2415,0,2446,6320;6321,0,0,0,2,0,2
2416,0,2447,6322;6323;6324;6325,0,0,0,4,0,4
2417,0,2448,6326;6327,0,0,0,2,0,2
2418,0,2449,6328;6329;6330;6331,0,0,2,2,0,4
2419,0,2450,6332,0,0,0,1,0,1
2420,0,2451,6333;6334;6335;6336,0,2,0,2,0,4
2421,0,2452,6337;6338;6339,0,0,0,2,1,3
2422,0,2453,6340;6341;6342,0,1,0,2,0,3
2423,0,2454,6343;6344;6345,0,0,1,2,0,3
2424,0,2455,6346;6347;6348,0,1,1,0,1,3
2425,0,2456,6349;6350,0,0,0,2,0,2
2426,0,2457,6351;6352;6353;6354,0,0,2,2,0,4
2427,0,2458,6355,0,0,0,1,0,1
2428,0,2459,6356;6357;6358,0,0,0,2,1,3
2429,0,2460,6359;6360,0,0,0,1,1,2
2430,0,2461,6361;6362;6363,0,1,0,1,1,3
2431,0,2462,6364,0,0,0,0,1,1
2432,0,2463,6365;6366,0,0,0,2,0,2
2433,0,2464,6367;6368;6369;6370,0,2,0,1,1,4
2434,0,2465,6371;6372;6373,0,0,0,1,2,3
2435,0,2466,6374,0,0,0,1,0,1
2436,0,2467,6375;6376;6377,0,0,0,2,1,3
2437,0,2468,6378;6379,0,0,0,2,0,2
2438,0,2469,6380,0,0,0,1,0,1
2439,0,2470,6381;6382,0,1,0,1,0,2
2440,0,2471,6383,0,0,0,1,0,1
2441,0,2472,6384,0,0,0,1,0,1
2442,0,2473,6385,0,0,0,1,0,1
2443,0,2474,6386;6387;6388;6389;6390,0,0,1,4,0,5
2444,0,2475,6391;6392;6393,0,1,0,1,1,3
2445,0,2476,6394,0,0,0,1,0,1
2446,0,2477,6395,0,0,0,1,0,1
2447,0,2478,6396;6397;6399;6400;6401,0,0,0,4,1,5
2448,0,2479,6402;6403;6404;6405;6406;6407;6408,0,0,3,4,0,7
2449,0,2480,6409;6410,0,0,0,2,0,2
2450,0,2481,6411,0,0,0,0,1,1
2451,0,2482,6412;6413;6414,0,0,0,2,1,3
2452,0,2483,6415;6416,0,0,0,1,1,2
2453,0,2484,6417,0,0,0,0,1,1
2454,0,2485,6418;6419;6420;6421,0,0,2,2,0,4
2455,0,2486,6423,0,0,0,1,0,1
2456,0,2487,6424,0,0,0,1,0,1
2457,0,2488,6425;6426,0,0,0,2,0,2
2458,0,2489,6427;6429,0,0,0,2,0,2
2459,0,2490,6430;6431,0,0,0,1,1,2
2460,0,2491,6432;6433,0,0,0,2,0,2
2461,0,2492,6434;6435;6436,0,0,0,2,1,3
2462,0,2493,6437,0,0,0,1,0,1
2463,0,2494,6438;6439;6440,0,0,0,3,0,3
2464,0,2495,6441;6442;6443;6444,0,2,0,2,0,4
2465,0,2496,6445;6446;6447,0,0,0,2,1,3
2466,0,2497,6448;6449,0,0,0,2,0,2
2467,0,2498,6450;6451;6452;6453;6454,0,0,2,3,0,5
2468,0,2499,6455;6456;6457;6458,0,0,1,3,0,4
2469,0,2500,6459;6460;6461,0,1,0,2,0,3
2470,0,2501,6462;6463;6464;6465;6466,0,0,3,2,0,5
2471,0,2502,6467,0,0,0,0,1,1
2472,0,2503,6468;6469;6470,0,2,0,1,0,3
2473,0,2504,6471;6472,0,0,0,1,1,2
2474,0,2505,6473;6474,0,0,0,2,0,2
2475,0,2506,6475,0,0,0,1,0,1
2476,0,2507,6476,0,0,0,1,0,1
2477,0,2508,6477;6478,0,0,0,2,0,2
2478,0,2509,6479;6480;6481,0,0,2,1,0,3
2479,0,2510,6482;6483,0,0,0,2,0,2
2480,0,2511,6484,0,0,0,1,0,1
2481,0,2512,6485;6486,0,0,0,2,0,2
2482,0,2513,6487;6488;6489;6490,0,1,1,1,1,4
2483,0,2514,6491;6492;6493;6494,0,0,1,3,0,4
2484,0,2515,6495;6496,0,0,0,2,0,2
2485,0,2516,6497;6498,0,0,0,1,1,2
2486,0,2517,6499;6500,0,0,0,2,0,2
2487,0,2518,6501;6502;6503,0,0,1,2,0,3
2488,0,2519,6504,0,0,0,1,0,1
2489,0,2520,6505,0,0,0,1,0,1
2490,0,2521,6506,0,0,0,1,0,1
2491,0,2522,6507;6508;6509,0,0,0,1,2,3
2492,0,2523,6510,0,0,0,1,0,1
2493,0,2524,6511;6512,0,0,0,1,1,2
2494,0,2525,6513;6514,0,0,0,2,0,2
2495,0,2526,6515;6516;6518,0,0,0,1,2,3
2496,0,2527,6519;6520,0,0,0,2,0,2
2497,0,2528,6521;6522,0,0,0,2,0,2
2498,0,2529,6523;6524;6525;6526,0,0,2,2,0,4
2499,0,2530,6527;6528;6529;6530;6531,0,0,2,2,1,5
2500,0,2531,6532;6533,0,0,0,2,0,2
2501,0,2532,6534;6535;6536;6537,0,0,2,2,0,4
2502,0,2533,6538,0,0,0,1,0,1
2503,0,2534,6539;6540;6541;6542;6543;6544,0,0,1,5,0,6
2504,0,2535,6545,0,0,0,0,1,1
2505,0,2536,6546,0,0,0,0,1,1
2506,0,2537,6547;6548,0,0,0,0,2,2
2507,0,2538,6549;6550;6551,0,0,0,3,0,3
2508,0,2539,6552;6553;6554;6555,0,0,2,1,1,4
2509,0,2540,6556;6557;6558;6559;6560;6561,0,2,1,1,2,6
2510,0,2541,6562;6563,0,0,0,1,1,2
2511,0,2542,6564,0,0,0,1,0,1
2512,0,2544,191;6566;6567,0,0,1,2,0,3
2513,0,2545,6568;6569,0,0,0,1,1,2
2514,0,2546,6570;6571,0,1,0,1,0,2
2515,0,2547,6572,0,0,0,1,0,1
2516,0,2548,6573;6574,0,0,0,2,0,2
2517,0,2549,6575,0,0,0,1,0,1
2518,0,2550,6576,0,0,0,0,1,1
2519,0,2551,6577;6578,0,0,0,1,1,2
2520,0,2552,6579;6580;6581;6582,0,0,1,3,0,4
2521,0,2553,6583,0,0,0,1,0,1
2522,0,2554,6584;6585;6586;6587,0,0,1,3,0,4
2523,0,2555,6588;6589;6590;6591,0,0,0,4,0,4
2524,0,2556,6592;6593;6594;6595,0,0,1,3,0,4
2525,0,2557,6596,0,0,0,0,1,1
2526,0,2558,6597;6598,0,0,0,1,1,2
2527,0,2559,6599,0,0,0,1,0,1
2528,0,2560,6600;6601;6602;6603;6604;6605,0,0,4,2,0,6
2529,0,2561,6606;6607,0,0,0,1,1,2
2530,0,2562,6608;6609,0,0,0,0,2,2
2531,0,2563,6610;6611;6612;10042,0,1,1,2,0,4
2532,0,2564,6613,0,0,0,0,1,1
2533,0,2565,6614;6615;6616,0,0,1,1,1,3
2534,0,2566,6617,0,0,0,1,0,1
2535,0,2567,6618;6619,0,0,0,2,0,2
2536,0,2568,6620;6621;6622;6623;6624;6625,0,0,1,4,1,6
2537,0,2569,6626;6627;6628;6629,0,0,2,1,1,4
2538,0,2570,6630;6631;6632,0,1,0,2,0,3
2539,0,2571,6633;6634;10024,0,1,0,2,0,3
2540,0,2572,6635;6636;6637,0,0,2,0,1,3
2541,0,2573,6638;6639;6640;6641;6642,0,2,0,2,1,5
2542,0,2574,6643,0,0,0,1,0,1
2543,0,2575,6644;6645,0,0,0,1,1,2
2544,0,2576,6646;6647;6648;6649,0,0,1,3,0,4
2545,0,2577,6650;6651;6652;6653;6654,0,0,2,3,0,5
2546,0,2578,6655;6656,0,0,0,1,1,2
2547,0,2579,6657;6658;6659;6660;6661,0,0,2,3,0,5
2548,0,2580,6662,0,0,0,1,0,1
2549,0,2581,6663;6664,0,0,0,1,1,2
2550,0,2582,6665,0,0,0,1,0,1
2551,0,2583,6666;6667;6668,0,0,0,3,0,3
2552,0,2584,6669;6670,0,0,0,2,0,2
2553,0,2585,6671;6672;6673;6674;6675,0,0,1,4,0,5
2554,0,2586,6676,0,0,0,1,0,1
2555,0,2587,6677;6678,0,0,0,1,1,2
2556,0,2588,6679,0,0,0,1,0,1
2557,0,2589,6680;6681,0,0,0,2,0,2
2558,0,2590,6682;6683,0,0,0,1,1,2
2559,0,2591,6684;6685,0,0,0,0,2,2
2560,0,2592,6686;6687;6688;6689,0,0,2,2,0,4
2561,0,2593,6690;6691;6692;6693,0,0,2,2,0,4
2562,0,2594,6694;6695;6696,0,0,0,3,0,3
2563,0,2595,6697;6698;6699;6700;6701;6702,0,1,3,1,1,6
2564,0,2596,6703;6704;6705;6706;6707,0,0,1,4,0,5
2565,0,2597,6708;6709,0,0,0,0,2,2
2566,0,2598,6710;6711;6712;6713,0,0,0,3,1,4
2567,0,2599,6714,0,0,0,1,0,1
2568,0,2600,6715,0,0,0,0,1,1
2569,0,2601,6716;6717;6718;6719;6720,0,0,2,2,1,5
2570,0,2602,6721;6722;6723;6724,0,0,0,2,2,4
2571,0,2603,6725;6726;6727;6728;6729,0,1,1,3,0,5
2572,0,2604,6730;6731;6732,0,0,0,3,0,3
2573,0,2605,6733;6734;6735;6736,0,0,1,1,2,4
2574,0,2606,6737;6738;10110,0,1,0,2,0,3
2575,0,2607,6739;6740,0,0,0,2,0,2
2576,0,2608,6741;6742;6743;6744,0,1,1,1,1,4
2577,0,2609,6745,0,0,0,1,0,1
2578,0,2610,6746;6747,0,0,0,1,1,2
2579,0,2611,6748;6749;6750;6751,0,0,1,2,1,4
2580,0,2612,6752;6753,0,0,0,2,0,2
2581,0,2613,6754,0,0,0,1,0,1
2582,0,2614,6755,0,0,0,0,1,1
2583,0,2615,6756;6757,0,0,0,2,0,2
2584,0,2616,6758;6759;6760;6761,0,0,0,3,1,4
2585,0,2617,6762;6763;6764;6765,0,0,1,3,0,4
2586,0,2618,6766;6767,0,0,0,2,0,2
2587,0,2619,6768;6769;6770,0,0,2,0,1,3
2588,0,2620,6771,0,0,0,1,0,1
2589,0,2621,6772;6773;6774,0,0,2,1,0,3
2590,0,2623,6776;6777,0,0,0,2,0,2
2591,0,2624,6779;6780;6781;6782,0,0,1,2,1,4
2592,0,2625,6783;6784;6785;6786,0,0,0,3,1,4
2593,0,2626,6787;6788,0,0,0,2,0,2
2594,0,2627,6789;6790;6791;6792,0,0,2,1,1,4
2595,0,2628,6793,0,0,0,0,1,1
2596,0,2629,6794;6795;6796;6797;6798,0,0,0,4,1,5
2597,0,2630,6799;6800,0,0,0,1,1,2
2598,0,2631,6801;6802,0,0,0,2,0,2
2599,0,2632,6803;6804;6805,0,0,1,2,0,3
2600,0,2633,6806,0,0,0,0,1,1
2601,0,2634,6807;6809,0,1,0,1,0,2
2602,0,2635,6810;6811,0,0,0,2,0,2
2603,0,2636,6812,0,0,0,0,1,1
2604,0,2637,6813;6814,0,0,0,2,0,2
2605,0,2638,6815;6816,0,0,0,1,1,2
2606,0,2639,6817;6818;6819;6820,0,0,2,1,1,4
2607,0,2640,6821;6822;6823,0,1,0,2,0,3
2608,0,2641,6824,0,0,0,1,0,1
2609,0,2642,6825;6826;6827,0,0,0,3,0,3
2610,0,2643,6828;6829,0,0,0,2,0,2
2611,0,2644,6830;6831,0,0,0,0,2,2
2612,0,2645,6832;6833,0,0,0,2,0,2
2613,0,2646,6834;6835;6836;6837;6838;6839,0,2,2,1,1,6
2614,0,2647,6840;6841,0,0,0,1,1,2
2615,0,2648,6842;6843;6844;6845;6846;6847;6848;6849,0,2,1,4,1,8
2616,0,2649,6850;6851;6852,0,0,0,2,1,3
2617,0,2650,6853;6854;6855;6856;6857,0,0,1,4,0,5
2618,0,2651,2753;6858,0,0,0,2,0,2
2619,0,2652,6859;6860,0,0,0,1,1,2
2620,0,2653,6861;6862;6863;6864;6866;6867,0,0,0,5,1,6
2621,0,2654,6868;6869,0,0,0,1,1,2
2622,0,2655,6870;6871,0,0,0,1,1,2
2623,0,2656,6874;6875,0,0,1,1,0,2
2624,0,2657,6876,0,0,0,1,0,1
2625,0,2658,6877;6878;6879;6880,0,0,2,1,1,4
2626,0,2659,6881;6882,0,0,0,1,1,2
2627,0,2660,6883;6884;6885,0,0,1,1,1,3
2628,0,2661,6886;6887;6888,0,0,0,1,2,3
2629,0,2662,6889;6890,0,0,0,1,1,2
2630,0,2663,6891,0,0,0,1,0,1
2631,0,2664,6892,0,0,0,1,0,1
2632,0,2665,6893;6894,0,0,0,1,1,2
2633,0,2666,6895;6896,0,0,0,2,0,2
2634,0,2667,6897,0,0,0,0,1,1
2635,0,2668,6898;6899,0,0,0,1,1,2
2636,0,2669,6900;6901,0,0,0,1,1,2
2637,0,2670,6902,0,0,0,1,0,1
2638,0,2671,6903;6904;6905,0,0,2,0,1,3
2639,0,2672,6906;6907,0,0,0,2,0,2
2640,0,2673,6908;6909;6910;6911,0,1,0,2,1,4
2641,0,2674,6912;6913;6914,0,0,0,3,0,3
2642,0,2675,6915,0,0,0,1,0,1
2643,0,2676,6916;6917;6918,0,0,1,1,1,3
2644,0,2677,6919;6920;6921;6922,0,0,0,2,2,4
2645,0,2678,6923;6924,0,0,0,2,0,2
2646,0,2679,6925,0,0,0,0,1,1
2647,0,2680,6926,0,0,0,1,0,1
2648,0,2681,6927;6928,0,0,0,1,1,2
2649,0,2682,6929;6930,0,0,0,1,1,2
2650,0,2683,6931;6932;6933,0,0,0,3,0,3
2651,0,2684,6934;6935;6936,0,0,0,2,1,3
2652,0,2685,6938;6939,0,0,0,2,0,2
2653,0,2686,6940;6941,0,0,0,2,0,2
2654,0,2687,6942;6943,0,0,0,1,1,2
2655,0,2688,6031;6944,0,0,0,2,0,2
2656,0,2689,6945;6946;6947;6948;6949;6950,0,0,2,4,0,6
2657,0,2690,6951;6952;6953;6954;6955,0,1,1,3,0,5
2658,0,2691,6956;6957,0,0,0,1,1,2
2659,0,2692,6958,0,0,0,1,0,1
2660,0,2693,6959,0,0,0,1,0,1
2661,0,2694,6960;6961,0,0,0,2,0,2
2662,0,2695,6962,0,0,0,0,1,1
2663,0,2696,6964,0,0,0,1,0,1
2664,0,2697,6965,0,0,0,1,0,1
2665,0,2698,6966;6967,0,0,1,1,0,2
2666,0,2699,6968;6969;6970;6971,0,0,2,2,0,4
2667,0,2700,6972;6973;6974,0,0,1,2,0,3
2668,0,2701,6975;6976,0,0,0,2,0,2
2669,0,2702,6977;6978,0,0,0,2,0,2
2670,0,2703,6979;6980;6981;6982,0,0,2,2,0,4
2671,0,2704,6983;6984;6986,0,0,1,2,0,3
2672,0,2705,6987;6988;6989;6990;6991,0,2,1,2,0,5
2673,0,2706,6992;6993;6994;6995,0,0,1,3,0,4
2674,0,2708,6997;6998;6999;7000,0,0,0,3,1,4
2675,0,2709,7001;7002;7003,0,0,0,2,1,3
2676,0,2710,7004,0,0,0,1,0,1
2677,0,2711,7005,0,0,0,1,0,1
2678,0,2712,7006;7007;7008,0,0,0,2,1,3
2679,0,2713,7010;7012,0,0,0,2,0,2
2680,0,2714,7013;7014;7015;7016,0,1,0,2,1,4
2681,0,2715,7017;7018;7019;7020,0,0,2,2,0,4
2682,0,2716,7021;7022;7023;7024;7025,0,0,1,3,1,5
2683,0,2717,7026,0,0,0,1,0,1
2684,0,2718,7027;7028;7029;7030,0,0,2,2,0,4
2685,0,2719,7031;7032;7033;7034;7035;7036;7037,0,1,2,1,3,7
2686,0,2720,7038;7039;7040,0,1,1,1,0,3
2687,0,2721,7041;7042,0,0,0,0,2,2
2688,0,2722,7043;7044,0,0,0,2,0,2
2689,0,2723,7045;10096,0,1,0,1,0,2
2690,0,2724,7046,0,0,0,1,0,1
2691,0,2725,7047;7048,0,0,0,2,0,2
2692,0,2726,7049;7050;7051,0,0,1,2,0,3
2693,0,2727,7052;7053;7054,0,1,0,1,1,3
2694,0,2728,7055,0,0,0,1,0,1
2695,0,2729,7056;7057;7058,0,0,0,3,0,3
2696,0,2730,7059,0,0,0,1,0,1
2697,0,2731,7060;7061,0,0,0,2,0,2
2698,0,2732,7063,0,0,0,1,0,1
2699,0,2733,7064,0,0,0,1,0,1
2700,0,2734,7065;7066;7067;7068,0,0,1,1,2,4
2701,0,2735,7069;7070;7071;7072;7073;7074,0,0,2,2,2,6
2702,0,2736,7075;7076;7077;7078,0,0,2,2,0,4
2703,0,2737,7079;7080;7081;7082,0,0,0,4,0,4
2704,0,2738,7083;7084,0,0,0,1,1,2
2705,0,2739,7085,0,0,0,1,0,1
2706,0,2740,7086;7087,0,0,0,1,1,2
2707,0,2741,7088;7089,0,0,0,1,1,2
2708,0,2742,7090;7091,0,0,0,2,0,2
2709,0,2743,7092;7093,0,0,0,2,0,2
2710,0,2744,672;7094,0,0,0,2,0,2
2711,0,2745,7095;7096;7097;7098,0,2,0,1,1,4
2712,0,2746,7099;7100;7101;7102,0,0,1,2,1,4
2713,0,2747,7103,0,0,0,0,1,1
2714,0,2748,7104;7105,0,0,0,1,1,2
2715,0,2749,7106;7108;7109;7110,0,0,1,2,1,4
2716,0,2750,7111;7112,0,0,0,2,0,2
2717,0,2751,7113;7114;7115,0,1,0,1,1,3
2718,0,2752,7116;7117;7118;7119,0,0,1,2,1,4
2719,0,2753,7120;7121,0,0,1,1,0,2
2720,0,2754,7122;7123;7124,0,0,0,2,1,3
2721,0,2755,7125;7126;7127;7128,0,0,2,0,2,4
2722,0,2756,6239;7130;7131,0,0,0,3,0,3
2723,0,2758,7133;7134,0,0,0,2,0,2
2724,0,2759,7135,0,0,0,1,0,1
2725,0,2760,7136;7137;7138;10071,0,1,1,2,0,4
2726,0,2761,7139;7140;7141;7142;7143,0,0,2,3,0,5
2727,0,2762,7144;7145,0,0,0,1,1,2
2728,0,2763,7146;7147,0,0,0,2,0,2
2729,0,2764,7148;7149;7150;7151,0,0,2,1,1,4
2730,0,2765,7152;7153;10051,0,1,0,1,1,3
2731,0,2766,7154;7156;7157;7158,0,1,1,2,0,4
2732,0,2767,7159,0,0,0,1,0,1
2733,0,2768,7160;7161,0,0,0,0,2,2
2734,0,2769,7162;7163;10040,0,2,0,1,0,3
2735,0,2770,7164,0,0,0,1,0,1
2736,0,2771,7165,0,0,0,1,0,1
2737,0,2772,7166;7167,0,0,0,1,1,2
2738,0,2773,7168;7169;7170;7171;7172,0,0,1,3,1,5
2739,0,2774,7173,0,0,0,1,0,1
2740,0,2775,7174;7175;7176;7177,0,1,1,1,1,4
2741,0,2776,7178;7179;7180;7181,0,0,2,2,0,4
2742,0,2777,7182,0,0,0,1,0,1
2743,0,2778,7183;7185,0,0,1,1,0,2
2744,0,2779,7186,0,0,0,1,0,1
2745,0,2780,7187,0,0,0,1,0,1
2746,0,2781,7188,0,0,0,1,0,1
2747,0,2782,7189;7190;7191;7192;7193,0,0,2,2,1,5
2748,0,2783,7194,0,0,0,1,0,1
2749,0,2784,7195;7196;7197,0,0,1,1,1,3
2750,0,2785,7198;7199,0,0,0,2,0,2
2751,0,2786,7200,0,0,0,0,1,1
2752,0,2787,7202;7203,0,0,1,0,1,2
2753,0,2788,7204;7205,0,0,0,2,0,2
2754,0,2789,7206;7207;7208,0,0,0,2,1,3
2755,0,2790,7209,0,0,0,1,0,1
2756,0,2791,7210;7211;7212,0,0,2,1,0,3
2757,0,2792,7213;7214;7215;7216,0,0,0,3,1,4
2758,0,2793,7217,0,0,0,1,0,1
2759,0,2794,7218;7219,0,0,0,1,1,2
2760,0,2795,7220;7221;7222;7223,0,0,2,0,2,4
2761,0,2796,7224;7225;7226;7227,0,0,0,3,1,4
2762,0,2797,7228;7229,0,0,0,2,0,2
2763,0,2798,7230;7231,0,0,0,0,2,2
2764,0,2799,5855;7232,0,0,0,2,0,2
2765,0,2800,7233;7234;7235;7236;7237;7238,0,0,1,4,1,6
2766,0,2801,7239,0,0,0,1,0,1
2767,0,2802,7240;7241,0,0,0,2,0,2
2768,0,2803,7242;7243,0,0,0,2,0,2
2769,0,2804,7244;9482,0,0,0,2,0,2
2770,0,2805,7245;7246,0,0,0,1,1,2
2771,0,2806,7247;7248;7249,0,0,0,1,2,3
2772,0,2807,7250,0,0,0,1,0,1
2773,0,2808,7251,0,0,0,1,0,1
2774,0,2809,7252;10029;10083,0,2,0,1,0,3
2775,0,2810,7254;7255;7256;7257,0,1,2,1,0,4
2776,0,2811,7258,0,0,0,1,0,1
2777,0,2812,7259;7260;7261,0,0,0,1,2,3
2778,0,2813,7262,0,0,0,0,1,1
2779,0,2814,7263;7264;10057;10082,0,2,0,2,0,4
2780,0,2815,7265;7266,0,0,0,2,0,2
2781,0,2816,7267;7268,0,0,0,1,1,2
2782,0,2817,7269,0,0,0,1,0,1
2783,0,2818,7270;7271,0,0,0,2,0,2
2784,0,2819,7272;7273;7274;7275;7276,0,0,2,3,0,5
2785,0,2820,7277;10078,0,1,0,1,0,2
2786,0,2821,7278;7279;7280,0,0,0,3,0,3
2787,0,2822,7281,0,0,0,0,1,1
2788,0,2823,7282;7283;7284,0,0,0,3,0,3
2789,0,2824,7285;7286,0,0,1,0,1,2
2790,0,2825,7287;7288,0,0,0,2,0,2
2791,0,2826,7289;7290,0,0,0,0,2,2
2792,0,2827,7291;7292;7293;7294;7295,0,1,2,2,0,5
2793,0,2828,7296,0,0,0,1,0,1
2794,0,2829,7297,0,0,0,1,0,1
2795,0,2830,7299;7300,0,0,0,2,0,2
2796,0,2831,7301;7302;7303;7304,0,0,1,2,1,4
2797,0,2832,7305;7306;7307,0,0,2,1,0,3
2798,0,2833,7308;7309;7310;7311,0,2,0,1,1,4
2799,0,2834,7312,0,0,0,1,0,1
2800,0,2835,7313;7315;7316,0,2,0,0,1,3
2801,0,2836,7317;7318;10069;10070,0,2,0,2,0,4
2802,0,2837,7319,0,0,0,1,0,1
2803,0,2838,7320;7321;7322;7323;7324,0,1,1,3,0,5
2804,0,2839,7325;7326,0,0,0,2,0,2
2805,0,2840,7327,0,0,0,1,0,1
2806,0,2841,7328;7329;7330;7331;7332,0,0,2,2,1,5
2807,0,2842,7333,0,0,0,1,0,1
2808,0,2843,7334,0,0,0,1,0,1
2809,0,2844,7335;7336,0,0,0,0,2,2
2810,0,2845,7337,0,0,0,1,0,1
2811,0,2846,7338;7339;7340;7341;7342;7343;7344,0,1,3,3,0,7
2812,0,2847,7345;7346,0,1,0,0,1,2
2813,0,2848,7347;7348,0,0,0,2,0,2
2814,0,2849,7349,0,0,0,0,1,1
2815,0,2850,7351;7352;7353,0,0,0,2,1,3
2816,0,2851,7354;7355,0,0,0,2,0,2
2817,0,2852,7356;7357,0,0,1,1,0,2
2818,0,2853,7358;7361,0,0,0,2,0,2
2819,0,2854,7362;7363,0,0,0,2,0,2
2820,0,2855,7364,0,0,0,1,0,1
2821,0,2856,7365;7366;7367,0,0,0,1,2,3
2822,0,2857,7368;7369,0,0,0,0,2,2
2823,0,2858,7370;7371;7372;7373,0,1,1,0,2,4
2824,0,2859,7374;7375,0,0,0,0,2,2
2825,0,2860,7376;7377;7378,0,0,0,2,1,3
2826,0,2861,7379,0,0,0,1,0,1
2827,0,2862,7380;7381;7382;7383,0,1,1,1,1,4
2828,0,2863,7384;7385,0,0,1,1,0,2
2829,0,2864,7386,0,0,0,1,0,1
2830,0,2865,7387;7388,0,0,0,2,0,2
2831,0,2866,7389;7390;7391,0,0,1,1,1,3
2832,0,2867,7392;7393;7394;7395;7396,0,2,1,2,0,5
2833,0,2868,7397;7398,0,0,1,0,1,2
2834,0,2869,7399,0,0,0,1,0,1
2835,0,2870,7400;7401;7402;7403;7404;7405,0,1,3,2,0,6
2836,0,2871,7406;10052,0,1,0,1,0,2
2837,0,2872,7408;7409;7410,0,1,0,1,1,3
2838,0,2873,7411;7412,0,0,0,1,1,2
2839,0,2874,7413;7414;7415,0,0,0,3,0,3
2840,0,2875,7416;7417;7418;7419,0,0,1,3,0,4
2841,0,2876,7420;7421;7422,0,0,0,2,1,3
2842,0,2877,7423;7424,0,0,0,1,1,2
2843,0,2878,7425;7426;7427;7428,0,0,0,4,0,4
2844,0,2879,7429,0,0,0,1,0,1
2845,0,2880,7430;7431;7432;7433;7435,0,0,0,3,2,5
2846,0,2881,7436,0,0,0,0,1,1
2847,0,2882,7437;7438;7439;7440,0,2,0,2,0,4
2848,0,2883,7441;7442;7443;7444;7445,0,3,0,2,0,5
2849,0,2884,7446,0,0,0,1,0,1
2850,0,2885,7447;7448;7449,0,0,0,2,1,3
2851,0,2886,7450;7451,0,0,0,1,1,2
2852,0,2887,7452;7453,0,0,0,1,1,2
2853,0,2888,7454;7455,0,0,0,1,1,2
2854,0,2889,7456,0,0,0,0,1,1
2855,0,2890,7457,0,0,0,1,0,1
2856,0,2891,7458;7459;7460;7461,0,0,2,2,0,4
2857,0,2892,7462;7463;7464;7465;7466,0,0,1,2,2,5
2858,0,2893,7467,0,0,0,1,0,1
2859,0,2894,7468;7469,0,0,0,2,0,2
2860,0,2895,7470,0,0,0,1,0,1
2861,0,2896,7471;7472,0,0,0,2,0,2
2862,0,2897,7473;7475;7476;7477,0,0,0,3,1,4
2863,0,2898,7478;7479,0,0,0,0,2,2
2864,0,2899,7480;7481,0,1,0,1,0,2
2865,0,2900,7482,0,0,0,1,0,1
2866,0,2901,7483;7484,0,0,0,1,1,2
2867,0,2902,7486;7487;7488,0,0,1,1,1,3
2868,0,2903,7489;7490,0,0,0,2,0,2
2869,0,2904,7491;7492,0,0,0,0,2,2
2870,0,2905,7493;7494;7495;7496,0,0,2,2,0,4
2871,0,2906,7497;7498;7499;7500,0,0,2,2,0,4
2872,0,2907,7501;7502;7503;10088,0,1,1,1,1,4
2873,0,2908,7504,0,0,0,1,0,1
2874,0,2909,7505;7506;7507;7508;7509;7510,0,1,2,2,1,6
2875,0,2910,7511,0,0,0,0,1,1
2876,0,2911,7512;7513,0,0,0,0,2,2
2877,0,2912,7514;7515,0,0,0,1,1,2
2878,0,2913,7518;7519;7520;7521,0,0,2,1,1,4
2879,0,2914,7522;7523;7524;7525,0,0,1,1,2,4
2880,0,2915,7526;7527,0,0,0,1,1,2
2881,0,2916,7528;7529;7530,0,1,0,1,1,3
2882,0,2917,7531,0,0,0,0,1,1
2883,0,2918,7532;7533;7534,0,0,1,1,1,3
2884,0,2919,7535;7536;7537;7538;7539,0,0,0,3,2,5
2885,0,2920,7540,0,0,0,1,0,1
2886,0,2921,7541;7542;10091;10117,0,2,0,2,0,4
2887,0,2922,7544,0,0,0,1,0,1
2888,0,2923,7545;7546,0,0,0,1,1,2
2889,0,2924,7547;7548;7549;7550,0,1,0,1,2,4
2890,0,2925,7551;7552;7553;7554;7555,0,1,2,1,1,5
2891,0,2926,7556,0,0,0,1,0,1
2892,0,2927,7557;7558;7559;7560;7561,0,0,1,4,0,5
2893,0,2928,7562,0,0,0,1,0,1
2894,0,2929,7564;7565,0,0,0,2,0,2
2895,0,2930,7566;7567;7568;7569;7570,0,0,1,3,1,5
2896,0,2931,7571;7572,0,0,0,1,1,2
2897,0,2932,1985;7573,0,0,0,2,0,2
2898,0,2933,7574;7575,0,0,0,2,0,2
2899,0,2934,7576,0,0,0,1,0,1
2900,0,2935,7577;7578;7579,0,0,0,2,1,3
2901,0,2936,7580,0,0,0,0,1,1
2902,0,2937,7581;7582;7583;7584;7585,0,0,0,5,0,5
2903,0,2939,7587;7588,0,0,0,1,1,2
2904,0,2940,1947;7589,0,0,0,2,0,2
2905,0,2941,7590;7591;7592,0,0,0,2,1,3
2906,0,2942,7593;7594;7595;7596,0,0,1,2,1,4
2907,0,2943,7597;7598,0,0,0,1,1,2
2908,0,2944,7599;7600;7601,0,0,1,1,1,3
2909,0,2945,7602;7603;7604,0,0,2,1,0,3
2910,0,2946,7605,0,0,0,1,0,1
2911,0,2947,7606;7607,0,0,0,2,0,2
2912,0,2948,7608;7609,0,0,0,1,1,2
2913,0,2949,7610;7611,0,0,0,2,0,2
2914,0,2950,7612;7613,0,0,0,1,1,2
2915,0,2951,7614;7616,0,0,0,2,0,2
2916,0,2952,7617;7618;7619;7620;7621;7622,0,1,1,4,0,6
2917,0,2953,7623;7624;7625;7626,0,0,0,3,1,4
2918,0,2954,7627;7628,0,0,0,2,0,2
2919,0,2955,7629;7630,0,0,0,0,2,2
2920,0,2956,7631;7632;7633;7634,0,1,0,1,2,4
2921,0,2957,7635;7636,0,0,0,2,0,2
2922,0,2958,7637;7638,0,0,0,1,1,2
2923,0,2959,7639,0,0,0,1,0,1
2924,0,2960,7640;7641;7642,0,0,0,2,1,3
2925,0,2961,7643,0,0,0,1,0,1
2926,0,2962,7644;7645;7646,0,0,0,3,0,3
2927,0,2963,7647;7648,0,0,0,2,0,2
2928,0,2964,7649;7650,0,0,0,2,0,2
2929,0,2965,7651;9299,0,0,0,2,0,2
2930,0,2966,7652;7653;7654,0,0,0,2,1,3
2931,0,2967,7655;7656;7657,0,0,1,1,1,3
2932,0,2968,7658;7659;7660;7661;7662,0,0,0,4,1,5
2933,0,2969,7663;7664;7665,0,1,0,1,1,3
2934,0,2970,7666,0,0,0,1,0,1
2935,0,2971,7667;9333,0,0,0,2,0,2
2936,0,2972,7668;7669;7670;7671;7672,0,0,1,4,0,5
2937,0,2973,7673;7674,0,0,0,2,0,2
2938,0,2974,7676;7677;7678;7679,0,0,1,3,0,4
2939,0,2975,1490;7680;7681;7682;7683,0,0,2,3,0,5
2940,0,2976,7684;7685,0,0,0,2,0,2
2941,0,2977,7686,0,0,0,0,1,1
2942,0,2978,7687,0,0,0,1,0,1
2943,0,2979,7688;7689;7690;7691;7692,0,0,1,3,1,5
2944,0,2980,7693,0,0,0,1,0,1
2945,0,2981,7694;7695;7696;7697;7698,0,0,3,2,0,5
2946,0,2982,7699;7700;7701,0,0,0,3,0,3
2947,0,2983,7702;7703;7704;7705,0,0,1,2,1,4
2948,0,2984,7706,0,0,0,1,0,1
2949,0,2985,7707;7708;7709,0,1,0,2,0,3
2950,0,2986,7710;7711;7712,0,0,2,0,1,3
2951,0,2987,7713,0,0,0,0,1,1
2952,0,2988,7714;7715,0,0,0,2,0,2
2953,0,2989,7716;7717,0,0,0,2,0,2
2954,0,2990,7718,0,0,0,1,0,1
2955,0,2991,7719,0,0,0,1,0,1
2956,0,2992,7720;7721;7722;7723;7724,0,1,1,3,0,5
2957,0,2993,7725;7726;7727;7728;7729,0,0,2,3,0,5
2958,0,2994,7730;7731;7732;7733,0,0,2,1,1,4
2959,0,2995,7734,0,0,0,1,0,1
2960,0,2996,7735;7736,0,0,0,0,2,2
2961,0,2997,7737;7738;7739,0,0,1,2,0,3
2962,0,2998,7740;7741,0,0,0,1,1,2
2963,0,2999,7742;7743;7744,0,0,1,1,1,3
2964,0,3000,7745;7746;7747,0,0,2,1,0,3
2965,0,3001,7749,0,0,0,0,1,1
2966,0,3002,7750;7751;7752,0,0,0,2,1,3
2967,0,3003,7754,0,0,0,0,1,1
2968,0,3004,7755,0,0,0,1,0,1
2969,0,3005,7756,0,0,0,1,0,1
2970,0,3006,7757,0,0,0,1,0,1
2971,0,3007,7758;7759,0,0,0,2,0,2
2972,0,3008,7760;7761;7762,0,1,0,2,0,3
2973,0,3009,7763;7764;7765;7766,0,2,0,0,2,4
2974,0,3010,1019;7767,0,0,0,2,0,2
2975,0,3011,7768;7769,0,0,0,2,0,2
2976,0,3012,7770,0,0,0,0,1,1
2977,0,3013,7771;7772,0,0,0,2,0,2
2978,0,3014,7773;7774,0,0,0,1,1,2
2979,0,3015,7775;7776;7777,0,0,2,1,0,3
2980,0,3016,7778;7779;7780;7781,0,2,0,1,1,4
2981,0,3017,7782;7783;7784;7785,0,0,1,3,0,4
2982,0,3018,7786,0,0,0,0,1,1
2983,0,3019,7787;7788;7789,0,1,0,1,1,3
2984,0,3020,7790;7791,0,0,0,2,0,2
2985,0,3021,7792,0,0,0,1,0,1
2986,0,3022,7793;7794,0,1,1,0,0,2
2987,0,3023,7795;7796,0,0,0,2,0,2
2988,0,3024,7797;10101,0,1,0,1,0,2
2989,0,3025,7798,0,0,0,1,0,1
2990,0,3026,7799;7800;7801;7802,0,0,1,2,1,4
2991,0,3027,7803;7804;7805,0,0,0,3,0,3
2992,0,3028,7806;7807;7808;7809,0,0,1,2,1,4
2993,0,3029,7810;7811,0,0,0,1,1,2
2994,0,3030,7812;7813;7814;7815,0,0,0,4,0,4
2995,0,3031,7816;7817;7818;7819,0,0,1,2,1,4
2996,0,3032,7820;7821;7822,0,0,0,3,0,3
2997,0,3033,7823;7824;7825;7826,0,0,1,3,0,4
2998,0,3034,7827;7828;7829;7830,0,0,0,3,1,4
2999,0,3035,7831,0,0,0,1,0,1
3000,0,3036,7832;7833,0,0,0,1,1,2
3001,0,3037,7834;7835,0,0,0,1,1,2
3002,0,3038,7836;7837;7838;7839,0,0,0,2,2,4
3003,0,3039,7840;7841;7842,0,0,0,3,0,3
3004,0,3040,7843;7844;7845;7846,0,0,0,4,0,4
3005,0,3041,7847;7848,0,0,0,1,1,2
3006,0,3042,7849;7850;7851,0,0,0,2,1,3
3007,0,3043,7852,0,0,0,1,0,1
3008,0,3044,7853,0,0,0,0,1,1
3009,0,3045,7854;7855;7856,0,1,0,2,0,3
3010,0,3046,7857;7858,0,0,0,2,0,2
3011,0,3047,7859,0,0,0,1,0,1
3012,0,3048,7860;7861;7863,0,0,0,1,2,3
3013,0,3049,7865,0,0,0,0,1,1
3014,0,3050,7866;7867;7868,0,0,2,1,0,3
3015,0,3051,7869;7870;7871;7872;7873;7874,0,0,2,4,0,6
3016,0,3052,7875;10066,0,1,0,1,0,2
3017,0,3053,6398;7876,0,0,0,2,0,2
3018,0,3054,7877;7878;10016,0,1,0,1,1,3
3019,0,3056,7880;7881;7882,0,0,1,1,1,3
3020,0,3057,7883,0,0,0,1,0,1
3021,0,3058,7884,0,0,0,1,0,1
3022,0,3059,7885;7886,0,0,0,2,0,2
3023,0,3060,7887;7888;7889;7890,0,1,1,2,0,4
3024,0,3061,7891;7892;7893;7894,0,0,2,2,0,4
3025,0,3062,7895;7896,0,0,0,1,1,2
3026,0,3063,7897;7898;7899;7900,0,0,0,4,0,4
3027,0,3064,7901;7902,0,0,0,1,1,2
3028,0,3065,7903,0,0,0,1,0,1
3029,0,3066,7905;7906,0,0,0,1,1,2
3030,0,3068,7908,0,0,0,1,0,1
3031,0,3069,7910;7911;7912;7913;7914,0,0,3,2,0,5
3032,0,3070,7915,0,0,0,1,0,1
3033,0,3071,7916;7917,0,0,0,2,0,2
3034,0,3072,7918;7919;7920;7921,0,0,1,2,1,4
3035,0,3073,7922,0,0,0,1,0,1
3036,0,3074,7923;7924;7925;7926;7927,0,0,3,1,1,5
3037,0,3075,7928;7929,0,0,0,2,0,2
3038,0,3076,7930;7931;7932;7933,0,0,0,4,0,4
3039,0,3077,7934;7935;7936,0,0,0,2,1,3
3040,0,3078,7937,0,0,0,1,0,1
3041,0,3079,7938;7939,0,0,1,1,0,2
3042,0,3080,7940;7941;7943;7944,0,0,0,3,1,4
3043,0,3081,7945;7946;7947,0,1,0,1,1,3
3044,0,3082,7948;7949,0,0,0,2,0,2
3045,0,3083,7950;7951,0,0,0,2,0,2
3046,0,3084,7952,0,0,0,0,1,1
3047,0,3085,7953;7954,0,0,0,2,0,2
3048,0,3086,7955,0,0,0,0,1,1
3049,0,3087,7956;7957,0,0,0,2,0,2
3050,0,3088,7958;7959,0,0,0,2,0,2
3051,0,3089,7960;7962;7963;7964,0,0,1,1,2,4
3052,0,3091,7966;7967;7968;7969,0,0,1,2,1,4
3053,0,3092,7970;7971;7972,0,1,0,2,0,3
3054,0,3093,7973;7974;7975,0,0,0,3,0,3
3055,0,3094,7976,0,0,0,1,0,1
3056,0,3095,7977;7978,0,0,0,2,0,2
3057,0,3096,7979;7980,0,0,0,1,1,2
3058,0,3097,7981;7983,0,0,0,0,2,2
3059,0,3098,7984;7985,0,0,0,2,0,2
3060,0,3099,7986,0,0,0,1,0,1
3061,0,3100,7987;7988;7989;7990,0,0,2,1,1,4
3062,0,3101,7991;7992;7993;7994;7995;10031,0,1,4,1,0,6
3063,0,3102,7996;7997;7998,0,0,1,2,0,3
3064,0,3103,7999;8000,0,0,0,0,2,2
3065,0,3104,8001;8002,0,0,0,2,0,2
3066,0,3105,8003,0,0,0,0,1,1
3067,0,3106,8004;8006,0,0,0,2,0,2
3068,0,3107,8007,0,0,0,1,0,1
3069,0,3108,8008;8009;8010,0,0,1,2,0,3
3070,0,3109,8011,0,0,0,1,0,1
3071,0,3110,8012;8013;8014,0,0,2,1,0,3
3072,0,3111,8015;8016,0,0,0,0,2,2
3073,0,3112,8017;8018;8019;8020,0,0,2,1,1,4
3074,0,3113,8021;8022;8023;8024;8025;8026;8027;8028,0,0,0,8,0,8
3075,0,3114,8029;8030;10105,0,1,0,2,0,3
3076,0,3115,8031;8032;8033;8034,0,0,0,3,1,4
3077,0,3116,8036;8037;8038;8039;8040,0,1,3,1,0,5
3078,0,3117,8041;8042;8043,0,0,0,3,0,3
3079,0,3118,8044,0,0,0,0,1,1
3080,0,3119,8045;8046;8047,0,1,0,2,0,3
3081,0,3120,8048;8049;8050;8051;8052,0,2,0,3,0,5
3082,0,3121,8053;8054,0,0,0,1,1,2
3083,0,3122,8055;8056;8057,0,1,0,2,0,3
3084,0,3123,8058,0,0,0,1,0,1
3085,0,3124,8059;8060,0,0,0,0,2,2
3086,0,3125,8061;8062;8063,0,0,0,2,1,3
3087,0,3126,8064;8065,0,0,1,1,0,2
3088,0,3127,8066;8067,0,0,0,2,0,2
3089,0,3128,8068,0,0,0,1,0,1
3090,0,3129,8069,0,0,0,1,0,1
3091,0,3130,8070;8071;8072;8073,0,0,0,4,0,4
3092,0,3131,8074,0,0,0,0,1,1
3093,0,3132,8075;8076,0,1,0,0,1,2
3094,0,3133,8078,0,0,0,1,0,1
3095,0,3134,8079;8080;8081,0,0,0,2,1,3
3096,0,3135,8082;8083,0,0,0,2,0,2
3097,0,3136,3982;8084,0,0,0,2,0,2
3098,0,3137,8085;8086;8087,0,0,1,2,0,3
3099,0,3138,8088;8089,0,0,0,2,0,2
3100,0,3139,8090;8091;8092,0,0,0,3,0,3
3101,0,3140,8093;8849,0,0,0,2,0,2
3102,0,3141,8094;8095,0,0,0,2,0,2
3103,0,3142,8097;8098;8099;8100,0,0,2,1,1,4
3104,0,3143,8101;8102,0,0,0,2,0,2
3105,0,3144,8103,0,0,0,1,0,1
3106,0,3145,8104,0,0,0,1,0,1
3107,0,3146,3616;8105;8106,0,0,1,2,0,3
3108,0,3147,8107;8108;8109;8110;8111;10092,0,2,2,2,0,6
3109,0,3148,8112;8113,0,0,0,1,1,2
3110,0,3149,8114;8115;8116;8117,0,0,0,2,2,4
3111,0,3150,8118;8119;8120,0,0,0,2,1,3
3112,0,3151,8121;8122;8123;8124,0,0,3,1,0,4
3113,0,3152,8125;8126;8127,0,0,0,3,0,3
3114,0,3153,8128;8129,0,0,0,2,0,2
3115,0,3154,8130;8131;8132;8133;10067,0,1,1,3,0,5
3116,0,3155,1815;8134;8135,0,0,1,2,0,3
3117,0,3156,8136;8137,0,0,0,1,1,2
3118,0,3157,8138;8139,0,0,0,2,0,2
3119,0,3158,8141,0,0,0,1,0,1
3120,0,3159,8142;8143;8144;8145;8146,0,2,1,1,1,5
3121,0,3160,8147;8148;8149;8150,0,1,1,2,0,4
3122,0,3161,8151;8152,0,0,0,1,1,2
3123,0,3162,8153;8154;8155,0,0,0,3,0,3
3124,0,3163,7350;8156,0,0,0,2,0,2
3125,0,3164,8157;8158,0,0,0,2,0,2
3126,0,3165,8160,0,0,0,1,0,1
3127,0,3166,8161,0,0,0,0,1,1
3128,0,3167,8162;8163;8164,0,0,0,3,0,3
3129,0,3168,8165;8166;8167;8168;8169,0,0,3,2,0,5
3130,0,3169,8170,0,0,0,0,1,1
3131,0,3170,8172;8173;8174;8175;8176;8177,0,0,2,3,1,6
3132,0,3171,8178,0,0,0,0,1,1
3133,0,3172,8179,0,0,0,1,0,1
3134,0,3173,8180;8181;8182;8183,0,0,0,2,2,4
3135,0,3174,8184;8185;8186;8187,0,0,0,3,1,4
3136,0,3175,8188;8189,0,0,0,2,0,2
3137,0,3176,8190;8191,0,0,0,1,1,2
3138,0,3177,8192,0,0,0,1,0,1
3139,0,3178,8193;8194,0,0,0,2,0,2
3140,0,3179,8195;8196;8197;8198,0,0,1,3,0,4
3141,0,3180,8199;8200;8201,0,1,0,2,0,3
3142,0,3181,8202,0,0,0,1,0,1
3143,0,3182,8203;8204;10020,0,1,0,2,0,3
3144,0,3183,8205;8206,0,0,0,1,1,2
3145,0,3185,8208,0,0,0,0,1,1
3146,0,3186,8209;8210,0,0,0,2,0,2
3147,0,3187,8211,0,0,0,1,0,1
3148,0,3188,8212,0,0,0,1,0,1
3149,0,3189,8214,0,0,0,1,0,1
3150,0,3190,8215;8216,0,0,0,2,0,2
3151,0,3191,8217;8218;8219;8220,0,0,1,1,2,4
3152,0,3192,8221;8222;8223;8224,0,0,0,4,0,4
3153,0,3194,8228;8229;8230,0,0,0,3,0,3
3154,0,3195,8231;8232,0,0,0,1,1,2
3155,0,3196,8233,0,0,0,0,1,1
3156,0,3197,3608;8234,0,0,0,2,0,2
3157,0,3198,8235;8236;8237;8238,0,2,0,2,0,4
3158,0,3199,8239,0,0,0,1,0,1
3159,0,3200,8240,0,0,0,1,0,1
3160,0,3201,8241;8242,0,0,0,2,0,2
3161,0,3202,8243;10011,0,1,0,1,0,2
3162,0,3204,8245;10026,0,1,0,1,0,2
3163,0,3205,8247;8248;10034;10045,0,2,0,2,0,4
3164,0,3206,8249;8250;8251;8252;8253,0,0,1,4,0,5
3165,0,3207,8254;8255,0,0,0,2,0,2
3166,0,3208,8256;8257,0,0,0,2,0,2
3167,0,3209,8258,0,0,0,0,1,1
3168,0,3210,8259,0,0,0,1,0,1
3169,0,3211,8260;8261;8262,0,0,0,3,0,3
3170,0,3212,8263;8264,0,0,0,2,0,2
3171,0,3213,8265,0,0,0,1,0,1
3172,0,3214,8266;8267;8268;8269;8270;8271;8272;8273,0,0,5,3,0,8
3173,0,3216,8275;8276;8277;8278,0,1,0,3,0,4
3174,0,3217,8279;8280,0,0,0,2,0,2
3175,0,3218,8281;8282;8283;8284;8285,0,0,3,2,0,5
3176,0,3219,8286;8287;8288,0,1,0,1,1,3
3177,0,3220,8289;8290;8291;8292,0,0,3,1,0,4
3178,0,3221,8293;8294,0,0,0,1,1,2
3179,0,3222,8295;8296;8297,0,0,1,2,0,3
3180,0,3223,8298,0,0,0,1,0,1
3181,0,3224,8299,0,0,0,1,0,1
3182,0,3225,8300;8301;8302,0,1,0,2,0,3
3183,0,3226,8303,0,0,0,1,0,1
3184,0,3227,8304;8305;8306;8307,0,0,2,2,0,4
3185,0,3228,8308;8309;8310,0,0,0,3,0,3
3186,0,3229,8311;8314;8315,0,0,0,1,2,3
3187,0,3230,8316;8317;8318,0,0,2,1,0,3
3188,0,3231,8319,0,0,0,1,0,1
3189,0,3232,8321;8322;8323;8324,0,0,1,3,0,4
3190,0,3233,8325;8326,0,0,0,1,1,2
3191,0,3234,8327;8328,0,1,0,1,0,2
3192,0,3235,8329;8330;8331;8332,0,0,2,1,1,4
3193,0,3236,8333;8334,0,0,0,1,1,2
3194,0,3237,8335;8336;8337;8338,0,1,2,0,1,4
3195,0,3238,8339;8340,0,0,0,1,1,2
3196,0,3239,8341;8342;8343,0,0,0,2,1,3
3197,0,3240,8344;8345,0,0,0,2,0,2
3198,0,3241,8346;8347,0,0,0,0,2,2
3199,0,3242,8349,0,0,0,1,0,1
3200,0,3243,8350;8351,0,0,0,1,1,2
3201,0,3244,8352;8353,0,0,0,2,0,2
3202,0,3245,8354;8355,0,0,0,2,0,2
3203,0,3246,8356,0,0,0,1,0,1
3204,0,3247,8357;8358,0,0,0,2,0,2
3205,0,3248,8359;8360;8361,0,0,0,3,0,3
3206,0,3249,8362;8363;8364;8365,0,0,1,2,1,4
3207,0,3250,8366;8367,0,0,0,2,0,2
3208,0,3251,8368;8369;8370,0,0,0,3,0,3
3209,0,3252,8371;8372,0,1,0,1,0,2
3210,0,3253,8373;8374;8375;8376,0,0,2,2,0,4
3211,0,3254,8377,0,0,0,0,1,1
3212,0,3255,8379;8380,0,0,0,2,0,2
3213,0,3256,8381;8382;8383;8384,0,0,0,4,0,4
3214,0,3257,8385,0,0,0,0,1,1
3215,0,3258,8386;8387;8388;8389;10028,0,1,2,1,1,5
3216,0,3259,8390;8391;8392,0,0,0,2,1,3
3217,0,3260,8393;8394,0,0,0,2,0,2
3218,0,3261,8395;8396,0,0,1,1,0,2
3219,0,3262,8397;8398,0,0,0,2,0,2
3220,0,3263,8399;8400;8401;8402;8403,0,0,0,4,1,5
3221,0,3264,8404;8405;8406;8407;8408;8409,0,1,3,2,0,6
3222,0,3265,8410,0,0,0,0,1,1
3223,0,3266,8411;8412,0,0,0,1,1,2
3224,0,3267,8413;8414,0,0,0,2,0,2
3225,0,3268,8415;8416;8417;8418,0,1,1,2,0,4
3226,0,3269,8419;8420;8421,0,1,0,1,1,3
3227,0,3270,8422;8423;8424;8425,0,0,1,3,0,4
3228,0,3271,8426;8427,0,0,0,2,0,2
3229,0,3272,8428;8429,0,0,0,2,0,2
3230,0,3273,8430;8431;8432,0,0,0,2,1,3
3231,0,3274,8433,0,0,0,1,0,1
3232,0,3275,8434,0,0,0,1,0,1
3233,0,3276,8435,0,0,0,1,0,1
3234,0,3277,8436;8437;8438,0,0,0,2,1,3
3235,0,3278,8439;8440,0,0,0,1,1,2
3236,0,3279,8441;8442;8443,0,0,1,2,0,3
3237,0,3280,8444;8445,0,0,0,1,1,2
3238,0,3281,8446;8447;8448,0,0,0,3,0,3
3239,0,3282,8449;8450,0,0,0,2,0,2
3240,0,3283,8451;8452,0,0,0,2,0,2
3241,0,3284,8453;8454;8455;8456,0,0,1,1,2,4
3242,0,3285,8457;8458;8459,0,0,0,2,1,3
3243,0,3286,8460;8461,0,0,0,1,1,2
3244,0,3287,8462;8463,0,0,0,2,0,2
3245,0,3288,8464;8465;8466,0,0,1,2,0,3
3246,0,3289,8467;8468;8469;8470,0,0,2,2,0,4
3247,0,3290,8471;8472;8473;8474,0,1,1,2,0,4
3248,0,3291,8475;8476,0,0,0,1,1,2
3249,0,3292,8477;8478;8479,0,0,0,1,2,3
3250,0,3293,8481;8482;8483,0,0,1,1,1,3
3251,0,3294,8484,0,0,0,0,1,1
3252,0,3295,8485;8486;8487;8488,0,0,0,4,0,4
3253,0,3296,8489;8490;8491;8492;8493;8494,0,0,2,4,0,6
3254,0,3297,8495;8496;8497;8498,0,0,2,1,1,4
3255,0,3298,8499;8500;8501;8502,0,0,1,2,1,4
3256,0,3299,8503;8504,0,0,0,1,1,2
3257,0,3300,8505,0,0,0,1,0,1
3258,0,3301,8506,0,0,0,1,0,1
3259,0,3302,8507,0,0,0,0,1,1
3260,0,3303,8508;8509,0,0,0,2,0,2
3261,0,3304,8510;8511;10017;10041,0,2,0,2,0,4
3262,0,3305,8513;8514;8515;8516,0,0,3,1,0,4
3263,0,3306,8517;8519;8520,0,0,2,0,1,3
3264,0,3307,8521,0,0,0,0,1,1
3265,0,3308,8522;8523,0,0,0,2,0,2
3266,0,3309,8524;8525;8526;8527,0,0,1,2,1,4
3267,0,3310,8528,0,0,0,1,0,1
3268,0,3311,8529;8530,0,0,0,1,1,2
3269,0,3312,8531,0,0,0,1,0,1
3270,0,3313,8532,0,0,0,1,0,1
3271,0,3314,8533;8534;8535,0,0,0,1,2,3
3272,0,3315,8536;8537;8538;8539,0,0,2,1,1,4
3273,0,3316,8540;8541;8542;8543;10084,0,1,0,3,1,5
3274,0,3317,8544;8545;8546;8548;8549,0,0,0,4,1,5
3275,0,3318,8550;8551;8552;8553,0,1,0,3,0,4
3276,0,3319,8554;8555;8556;10025,0,2,0,1,1,4
3277,0,3320,8557,0,0,0,1,0,1
3278,0,3321,8558;8559;8560;8561,0,0,2,2,0,4
3279,0,3322,8562;8563;10097,0,1,0,1,1,3
3280,0,3323,8564;8565;8566;8567;8568,0,0,2,3,0,5
3281,0,3324,8569,0,0,0,1,0,1
3282,0,3325,7982;8570,0,0,0,2,0,2
3283,0,3326,8571;8572;8573,0,0,2,1,0,3
3284,0,3327,8574,0,0,0,0,1,1
3285,0,3328,8575,0,0,0,1,0,1
3286,0,3329,8576,0,0,0,0,1,1
3287,0,3330,8577;8578;8579,0,0,0,2,1,3
3288,0,3331,8580;8581,0,0,0,1,1,2
3289,0,3332,8582;8583;8584,0,0,1,2,0,3
3290,0,3333,8585,0,0,0,1,0,1
3291,0,3334,8586,0,0,0,1,0,1
3292,0,3335,8587;8588;8589;8590;8591;8592,0,0,3,3,0,6
3293,0,3336,8593;8594;8595;8596,0,0,0,3,1,4
3294,0,3337,8597;8598,0,0,0,1,1,2
3295,0,3338,8599;8600,0,0,0,2,0,2
3296,0,3339,8601;8603;8604,0,0,0,2,1,3
3297,0,3340,5462;8605,0,0,0,2,0,2
3298,0,3341,8606;8607;10098,0,1,0,2,0,3
3299,0,3342,8608;8609,0,0,0,2,0,2
3300,0,3343,8610;8611;8612,0,1,0,1,1,3
3301,0,3344,8613,0,0,0,1,0,1
3302,0,3345,8614;8615;8616;8617;8618;8619,0,0,3,2,1,6
3303,0,3346,8620;8621;8622;8623;8624,0,0,2,2,1,5
3304,0,3347,8625;8626;8627;8628;8629,0,0,3,2,0,5
3305,0,3348,8630;8631,0,0,0,2,0,2
3306,0,3349,8632;8633;8634,0,0,0,3,0,3
3307,0,3350,8635,0,0,0,1,0,1
3308,0,3351,8636;8637;8638,0,0,1,2,0,3
3309,0,3352,8639;8640;8641;8642;8643,0,0,3,1,1,5
3310,0,3353,8645;8646,0,0,0,2,0,2
3311,0,3354,8647;8648;8649;8650,0,0,2,2,0,4
3312,0,3355,8651;8652,0,0,0,2,0,2
3313,0,3356,8653;8654,0,0,0,1,1,2
3314,0,3357,8655;8656,0,0,0,1,1,2
3315,0,3358,8657;8658,0,0,0,2,0,2
3316,0,3359,8659,0,0,0,1,0,1
3317,0,3360,8660,0,0,0,1,0,1
3318,0,3361,8661;8662;8663;8664;8665,0,0,0,5,0,5
3319,0,3362,8666,0,0,0,1,0,1
3320,0,3363,8667;8668,0,0,0,1,1,2
3321,0,3364,8669,0,0,0,1,0,1
3322,0,3365,8670;8671;8672,0,0,1,2,0,3
3323,0,3366,2714;8673;8674;8675,0,0,2,2,0,4
3324,0,3367,8676;8677;8678;8679;8680;8681,0,1,2,1,2,6
3325,0,3368,8682;8683,0,0,0,1,1,2
3326,0,3369,8684;8685,0,0,0,2,0,2
3327,0,3370,8686;8687;8688,0,0,1,2,0,3
3328,0,3371,8689,0,0,0,1,0,1
3329,0,3372,8690;8691;8692,0,0,0,3,0,3
3330,0,3373,8693;8694,0,0,0,2,0,2
3331,0,3374,8695;8696;8697;8698,0,2,0,1,1,4
3332,0,3375,8699;8700;8701,0,1,0,2,0,3
3333,0,3376,8702;8703;8708,0,1,0,2,0,3
3334,0,3377,8704,0,0,0,0,1,1
3335,0,3378,8705,0,0,0,1,0,1
3336,0,3379,8706;8707;10104,0,1,0,2,0,3
3337,0,3381,8709;8710;8711;8712,0,0,1,1,2,4
3338,0,3382,8713;8714;8715;8716,0,0,0,4,0,4
3339,0,3383,8717;8718;8719;8720;8721,0,1,0,3,1,5
3340,0,3384,8722;8723;10074,0,1,0,2,0,3
3341,0,3385,8724,0,0,0,1,0,1
3342,0,3386,8725;8726,0,0,0,1,1,2
3343,0,3387,8727;8728,0,0,0,2,0,2
3344,0,3388,8729;8730,0,0,0,2,0,2
3345,0,3389,8731,0,0,0,1,0,1
3346,0,3390,8732;8733,0,0,0,2,0,2
3347,0,3391,8734;8735,0,0,0,1,1,2
3348,0,3392,8736;8737,0,0,0,2,0,2
3349,0,3393,8738;8739;8740;8741,0,0,2,1,1,4
3350,0,3394,8742;8743,0,0,0,1,1,2
3351,0,3395,8744;8745;8746;8747,0,0,1,3,0,4
3352,0,3396,8748;8749,0,0,0,2,0,2
3353,0,3397,8750;8751;8752;8753,0,0,0,3,1,4
3354,0,3398,8754;8755;8756;8757,0,0,0,3,1,4
3355,0,3399,8758;8759;8760,0,0,1,1,1,3
3356,0,3400,8761;8762,0,0,0,2,0,2
3357,0,3401,8763;8764,0,0,0,2,0,2
3358,0,3402,8765;8766,0,0,0,1,1,2
3359,0,3403,8767;8768;8769;8770;8771;8772,0,0,0,4,2,6
3360,0,3404,8773;8774;10054,0,1,0,2,0,3
3361,0,3405,8775;8776,0,0,0,1,1,2
3362,0,3406,8777;8778;8779;8780;8781,0,0,2,1,2,5
3363,0,3407,6238;8782;8783;8784;8785,0,0,3,2,0,5
3364,0,3408,8786;8787,0,0,0,1,1,2
3365,0,3409,8788,0,0,0,1,0,1
3366,0,3410,8789,0,0,0,0,1,1
3367,0,3411,8790;8791,0,0,0,2,0,2
3368,0,3412,8792;8793,0,0,0,1,1,2
3369,0,3413,8794;8795;8796;8797;8798;8799,0,0,4,2,0,6
3370,0,3414,8800,0,0,0,1,0,1
3371,0,3415,8801;8802;8803,0,0,0,3,0,3
3372,0,3416,8804;8805;8806;8807;8808,0,0,3,2,0,5
3373,0,3417,8809;8810,0,0,0,0,2,2
3374,0,3418,8811;8812;8813;8814;8815,0,0,1,4,0,5
3375,0,3419,8816,0,0,0,0,1,1
3376,0,3420,8817;8818;8819;8820;8821;8822;8823,0,0,2,2,3,7
3377,0,3421,8824;8825;8826;8827,0,0,2,2,0,4
3378,0,3422,8828;8829;8830;8831,0,0,0,4,0,4
3379,0,3423,8832;8833,0,0,0,2,0,2
3380,0,3424,8834,0,0,0,1,0,1
3381,0,3425,8835;8836;8837;8838;8839;8840,0,2,0,4,0,6
3382,0,3426,8841;8842,0,0,0,2,0,2
3383,0,3427,8843;8844;8845,0,0,1,2,0,3
3384,0,3428,8846,0,0,0,0,1,1
3385,0,3429,8847;8848,0,0,0,1,1,2
3386,0,3431,8850;8852;8853;8854,0,1,1,2,0,4
3387,0,3432,8855;8856;8857;8858;8859,0,0,3,0,2,5
3388,0,3433,8860,0,0,0,1,0,1
3389,0,3434,8861,0,0,0,1,0,1
3390,0,3435,8862,0,1,0,0,0,1
3391,0,3436,2310;8863;8864,0,0,0,3,0,3
3392,0,3437,8865;8866,0,0,0,1,1,2
3393,0,3438,8868;8869,0,0,0,2,0,2
3394,0,3439,8870,0,0,0,1,0,1
3395,0,3440,8871;8872;8873,0,0,0,3,0,3
3396,0,3441,8874,0,0,0,1,0,1
3397,0,3442,8875;8877;8878,0,2,0,1,0,3
3398,0,3443,8879,0,0,0,1,0,1
3399,0,3444,8881,0,0,0,0,1,1
3400,0,3446,8883;8884;8885;8886,0,2,0,2,0,4
3401,0,3447,8887;8888,0,0,0,1,1,2
3402,0,3448,8889;8891;8892;8893;8894,0,0,3,1,1,5
3403,0,3449,8895,0,0,0,1,0,1
3404,0,3450,8896;8897;8898;8899,0,0,1,3,0,4
3405,0,3451,8900;8901;8902;8903;8904,0,0,2,2,1,5
3406,0,3452,8906,0,0,0,1,0,1
3407,0,3453,8907;8908,0,0,0,2,0,2
3408,0,3454,8909;8910;8911;8912,0,0,1,1,2,4
3409,0,3455,8913,0,0,0,0,1,1
3410,0,3456,8914;8915,0,0,0,2,0,2
3411,0,3457,8916;8917,0,0,0,2,0,2
3412,0,3458,8918;8919,0,0,0,2,0,2
3413,0,3459,8920;8921;8922,0,0,1,2,0,3
3414,0,3460,8923;8924,0,0,0,1,1,2
3415,0,3461,8925;8926;8927;8928,0,0,0,4,0,4
3416,0,3462,8929;8930;8931;8932,0,0,2,2,0,4
3417,0,3463,8934;8935;8936,0,0,0,3,0,3
3418,0,3464,8937,0,0,0,1,0,1
3419,0,3465,8938;8939,0,0,0,1,1,2
3420,0,3467,8941;8942;10050,0,1,0,2,0,3
3421,0,3468,8943;8944,0,0,0,2,0,2
3422,0,3469,8945;8946;8947;8948;8949,0,1,0,3,1,5
3423,0,3470,8950;8951;8952;8953,0,0,0,2,2,4
3424,0,3471,8954;8955;8956;8957,0,0,0,3,1,4
3425,0,3472,8958;8959,0,0,0,1,1,2
3426,0,3473,8960;8961,0,0,0,1,1,2
3427,0,3474,8962;8963,0,0,0,1,1,2
3428,0,3475,8964;8965;8966;8967,0,1,0,3,0,4
3429,0,3476,8968;8969,0,0,0,2,0,2
3430,0,3477,8970;8971,0,0,0,1,1,2
3431,0,3478,8972;8973,0,0,0,2,0,2
3432,0,3479,8974;8975;8976;8977;8978,0,1,1,1,2,5
3433,0,3480,8979,0,0,0,1,0,1
3434,0,3481,8980,0,0,0,0,1,1
3435,0,3482,8981;8982;8984;8985;8986;8987,0,0,2,4,0,6
3436,0,3483,8988;8989,0,0,0,2,0,2
3437,0,3484,8990,0,0,0,1,0,1
3438,0,3485,8991;8992,0,0,0,2,0,2
3439,0,3486,8993,0,0,0,1,0,1
3440,0,3487,8994;8995;8996;8997;8998,0,1,1,2,1,5
3441,0,3488,9000;10076,0,1,0,1,0,2
3442,0,3489,9001;9002;9003,0,0,1,1,1,3
3443,0,3490,9004;9005;9006;9007;9008;9009,0,0,3,2,1,6
3444,0,3491,9010;9011,0,0,0,2,0,2
3445,0,3492,9012;9013,0,0,0,1,1,2
3446,0,3493,9014;9015;9016;9017,0,0,1,3,0,4
3447,0,3494,9018,0,0,0,1,0,1
3448,0,3495,9019;9020;9021,0,0,0,3,0,3
3449,0,3496,9022;9023,0,0,0,2,0,2
3450,0,3497,9024;9025,0,0,0,2,0,2
3451,0,3498,9026,0,0,0,1,0,1
3452,0,3499,9027;9028,0,0,0,2,0,2
3453,0,3500,9029,0,0,0,1,0,1
3454,0,3501,9030;9031;9032;9033,0,0,2,2,0,4
3455,0,3502,9034,0,0,0,1,0,1
3456,0,3503,9035;9036;9037,0,1,0,2,0,3
3457,0,3504,9038;9040;9041;9042;9043,0,2,2,1,0,5
3458,0,3505,9044;9045;9046,0,1,1,1,0,3
3459,0,3506,9047;9048;9049,0,0,0,2,1,3
3460,0,3507,7474;9050,0,0,0,2,0,2
3461,0,3508,9051,0,0,0,0,1,1
3462,0,3509,9052;9053,0,0,0,2,0,2
3463,0,3510,9054;9055;9056,0,1,0,1,1,3
3464,0,3511,9057;9058,0,0,0,0,2,2
3465,0,3512,9059;9060,0,0,0,1,1,2
3466,0,3513,9061;9062;9063,0,0,1,1,1,3
3467,0,3514,9064,0,0,0,1,0,1
3468,0,3515,9065,0,0,0,1,0,1
3469,0,3516,9066;9067;9068;9069,0,0,2,2,0,4
3470,0,3517,9070,0,0,0,1,0,1
3471,0,3518,9071;9072;9073;9074,0,0,0,3,1,4
3472,0,3519,9075;9076;9077;9078,0,0,1,2,1,4
3473,0,3520,9079;9080;9081;9082,0,0,1,3,0,4
3474,0,3521,9083;9084,0,0,0,1,1,2
3475,0,3522,9085;9086;9087,0,0,0,1,2,3
3476,0,3523,9088,0,0,0,1,0,1
3477,0,3524,9089;9090;10015,0,1,0,1,1,3
3478,0,3525,9091;9092,0,0,0,2,0,2
3479,0,3526,9093;9094,0,0,0,1,1,2
3480,0,3527,9095;9096;9097;9098;9099,0,2,1,2,0,5
3481,0,3528,9100;9101;9102;9103,0,0,1,2,1,4
3482,0,3529,9104;9105;9106;9107,0,0,0,3,1,4
3483,0,3530,9108;9109,0,0,0,0,2,2
3484,0,3531,9110;9111;9112;9113;9114,0,0,1,3,1,5
3485,0,3532,9115;9116;9117;9118,0,0,2,1,1,4
3486,0,3533,9119;9120;9121,0,0,0,3,0,3
3487,0,3534,9122,0,0,0,1,0,1
3488,0,3535,9124;9125,0,0,0,1,1,2
3489,0,3536,9128;9129,0,0,0,2,0,2
3490,0,3537,9130;9131,0,0,0,2,0,2
3491,0,3538,9132;9134,0,0,1,0,1,2
3492,0,3539,9135;9136;9137;9138;9139,0,0,2,2,1,5
3493,0,3540,9140;9141,0,0,0,2,0,2
3494,0,3541,9142,0,0,0,1,0,1
3495,0,3542,9143;9144;9145,0,0,1,2,0,3
3496,0,3543,2132;9146,0,0,0,2,0,2
3497,0,3544,9147,0,0,0,1,0,1
3498,0,3545,9148;9149;9150;9151,0,2,0,2,0,4
3499,0,3546,9152,0,0,0,1,0,1
3500,0,3547,9153;9154,0,0,0,1,1,2
3501,0,3548,9155;9156,0,0,0,1,1,2
3502,0,3549,9157;9158;9159;9160;9161;9162,0,2,0,3,1,6
3503,0,3550,9163;9164;9165;9166;9167,0,0,2,2,1,5
3504,0,3551,9168,0,0,0,1,0,1
3505,0,3552,9169;9170;9171,0,0,0,3,0,3
3506,0,3553,9172;9173,0,0,0,1,1,2
3507,0,3554,9174;9175,0,0,0,1,1,2
3508,0,3555,9176;9177,0,0,0,2,0,2
3509,0,3556,9178;9179,0,0,0,1,1,2
3510,0,3557,9180,0,0,0,1,0,1
3511,0,3558,9181;9182,0,0,0,2,0,2
3512,0,3559,9183;9184,0,0,0,2,0,2
3513,0,3560,9185;9186;9187;9188;9189;10077,0,1,3,2,0,6
3514,0,3561,9190,0,0,0,1,0,1
3515,0,3562,9191;9192,0,0,0,1,1,2
3516,0,3563,9193;9864,0,0,0,2,0,2
3517,0,3564,9194;9195;9196;9197,0,1,0,1,2,4
3518,0,3565,9198;9199,0,0,0,1,1,2
3519,0,3566,9200;9201,0,0,0,2,0,2
3520,0,3567,9202;9203,0,0,0,2,0,2
3521,0,3568,9204;9205,0,0,0,2,0,2
3522,0,3569,9206;9208;9209;9210;9211,0,1,1,3,0,5
3523,0,3570,9212;9213;9214;9215,0,0,1,2,1,4
3524,0,3571,9216;9217,0,0,0,0,2,2
3525,0,3572,9218;9220;9221,0,0,2,1,0,3
3526,0,3573,9222;9223;9224;9225;9226;9227,0,0,3,3,0,6
3527,0,3574,9228;9229;9230;9231;9232,0,0,2,3,0,5
3528,0,3575,9233;9235,0,0,0,1,1,2
3529,0,3576,9236;9237;9238,0,0,0,3,0,3
3530,0,3577,9239;9240,0,0,0,1,1,2
3531,0,3578,9241,0,0,0,1,0,1
3532,0,3579,9242,0,0,0,1,0,1
3533,0,3580,9243;9244;9245;9246;9247,0,1,2,1,1,5
3534,0,3581,5875;9248,0,0,0,2,0,2
3535,0,3582,9249;9250,0,0,0,2,0,2
3536,0,3583,9251;9252,0,0,0,1,1,2
3537,0,3584,9253,0,0,0,1,0,1
3538,0,3585,9254;9255;9256;9257,0,0,1,2,1,4
3539,0,3586,9258;9259;9260,0,0,0,2,1,3
3540,0,3587,9261;9262,0,0,0,2,0,2
3541,0,3588,9263;9264;9266;9267,0,1,1,2,0,4
3542,0,3589,9268;9269;9270,0,0,0,3,0,3
3543,0,3590,9271,0,0,0,1,0,1
3544,0,3591,9272;9273,0,0,0,1,1,2
3545,0,3592,9274,0,0,0,1,0,1
3546,0,3593,9276;9277,0,0,0,1,1,2
3547,0,3594,9278;9279;9280;9281,0,0,2,0,2,4
3548,0,3595,9282,0,0,0,1,0,1
3549,0,3596,9283;9284;9285,0,0,1,2,0,3
3550,0,3597,9286,0,0,0,1,0,1
3551,0,3598,1957;9287,0,0,0,2,0,2
3552,0,3599,9288;9289,0,0,0,2,0,2
3553,0,3600,9290,0,0,0,1,0,1
3554,0,3601,9291,0,0,0,1,0,1
3555,0,3602,9292;9293,0,0,0,1,1,2
3556,0,3603,9294;9295,0,0,0,2,0,2
3557,0,3604,9296;9297;9298;9300,0,0,0,3,1,4
3558,0,3605,9301,0,0,0,1,0,1
3559,0,3606,9302;9303;9304,0,0,0,3,0,3
3560,0,3607,9305,0,0,0,0,1,1
3561,0,3608,9306;9307,0,0,0,2,0,2
3562,0,3609,9308,0,0,0,1,0,1
3563,0,3610,9309;9310;9311,0,0,0,1,2,3
3564,0,3611,9312;9313,0,0,0,2,0,2
3565,0,3612,9314;9315;9316;9317,0,2,0,1,1,4
3566,0,3613,9318;9319,0,0,0,2,0,2
3567,0,3614,9320,0,0,0,0,1,1
3568,0,3615,9321,0,0,0,1,0,1
3569,0,3616,9322,0,0,0,0,1,1
3570,0,3617,9323;9324;9326,0,0,0,2,1,3
3571,0,3618,9327;9329;9332,0,0,1,1,1,3
3572,0,3619,9334;9335;9336,0,0,1,1,1,3
3573,0,3620,9337;9338;9339;9340,0,0,1,2,1,4
3574,0,3621,9341;9342,0,0,0,2,0,2
3575,0,3622,9343;9344,0,0,0,1,1,2
3576,0,3623,9345,0,0,0,1,0,1
3577,0,3624,9346;9348,0,0,0,2,0,2
3578,0,3625,9349;9350;9351;9352,0,0,1,3,0,4
3579,0,3626,9353;9354;9355;9356;9357;9358,0,0,4,2,0,6
3580,0,3627,9359,0,0,0,1,0,1
3581,0,3628,9360;9361,0,0,0,2,0,2
3582,0,3629,9362;9363;9364;9365,0,2,0,2,0,4
3583,0,3630,9366;9367;9368;9369;9370;9371,0,0,2,4,0,6
3584,0,3631,9372;9373;10102,0,1,0,2,0,3
3585,0,3632,9374;9375,0,0,0,2,0,2
3586,0,3633,9376;9377,0,0,0,1,1,2
3587,0,3634,9378,0,0,0,1,0,1
3588,0,3635,9379;9380,0,0,0,0,2,2
3589,0,3636,9381;9382,0,0,0,2,0,2
3590,0,3637,9383;9384,0,0,0,2,0,2
3591,0,3638,9385,0,0,0,1,0,1
3592,0,3639,9386;9387;9388;9389,0,0,1,2,1,4
3593,0,3640,9390;9391;9392;9393;9394,0,0,2,3,0,5
3594,0,3641,9395;9396,0,0,0,1,1,2
3595,0,3642,9397,0,0,0,0,1,1
3596,0,3643,9398;9399;9400;9401;10046,0,1,2,2,0,5
3597,0,3644,9402;9403,0,0,0,1,1,2
3598,0,3645,9404;9405;9406,0,0,1,2,0,3
3599,0,3646,9407;9408,0,0,0,2,0,2
3600,0,3647,9409;9410;9411;9412,0,0,0,3,1,4
3601,0,3648,9413;9414,0,0,0,2,0,2
3602,0,3649,9415;9416;9417;9418;9419;9420,0,0,4,1,1,6
3603,0,3650,9421;9422;9423;9424;9425,0,1,2,1,1,5
3604,0,3651,9426;9427;9428;9429,0,0,0,3,1,4
3605,0,3652,9430,0,0,0,0,1,1
3606,0,3653,9431;9432;9433;9434,0,0,0,3,1,4
3607,0,3654,9435;9436,0,0,0,2,0,2
3608,0,3655,9437;9438,0,0,0,1,1,2
3609,0,3656,9439,0,0,0,1,0,1
3610,0,3657,9440;9441,0,0,0,2,0,2
3611,0,3658,9442,0,0,0,1,0,1
3612,0,3659,9444;9445,0,0,0,1,1,2
3613,0,3660,9446;9447;9448;9449;9450,0,0,1,1,3,5
3614,0,3661,9451,0,0,0,0,1,1
3615,0,3662,9452;9453;9454;9455,0,0,2,2,0,4
3616,0,3663,9456,0,0,0,1,0,1
3617,0,3664,9457;9458;9459;9460;9461,0,0,0,5,0,5
3618,0,3665,9462;9463,0,0,0,2,0,2
3619,0,3666,9464,0,0,0,1,0,1
3620,0,3667,9465;9466;9467,0,0,1,2,0,3
3621,0,3668,9468;9469;9470;9471,0,0,0,1,3,4
3622,0,3669,9472;9473,0,0,0,1,1,2
3623,0,3670,9474,0,0,0,1,0,1
3624,0,3671,9475;9476,0,0,0,1,1,2
3625,0,3672,9477,0,0,0,1,0,1
3626,0,3673,9478;9479,0,0,0,1,1,2
3627,0,3674,9480;9481;9483;9484;9485,0,0,2,3,0,5
3628,0,3675,9486,0,0,0,1,0,1
3629,0,3676,9487;9488;9489;9490;9491;9492,0,0,0,4,2,6
3630,0,3677,9493;9494,0,0,0,2,0,2
3631,0,3678,9495,0,0,0,1,0,1
3632,0,3679,9496,0,0,0,1,0,1
3633,0,3680,9497;9498;9499;9500;9501,0,0,3,2,0,5
3634,0,3681,9502,0,0,0,1,0,1
3635,0,3682,9503,0,0,0,1,0,1
3636,0,3683,9504;9505;9506,0,1,0,1,1,3
3637,0,3684,9507;9508,0,0,0,2,0,2
3638,0,3685,9509;9510;9511,0,0,0,3,0,3
3639,0,3686,9512;9513;9514;10027,0,2,1,1,0,4
3640,0,3687,9515;9516;9517;9518;9519;9520,0,3,1,0,2,6
3641,0,3688,9521;9522,0,0,0,2,0,2
3642,0,3689,9523,0,0,0,0,1,1
3643,0,3690,9524;9525;9526,0,0,1,2,0,3
3644,0,3691,9527;9528;9529;9530;9531,0,0,0,4,1,5
3645,0,3692,9532;9533;9534,0,0,0,0,3,3
3646,0,3693,9535,0,0,0,1,0,1
3647,0,3694,9536;9537;9538,0,0,0,3,0,3
3648,0,3695,9539,0,0,0,1,0,1
3649,0,3696,9541;9542,0,0,0,2,0,2
3650,0,3697,9543;9544,0,0,0,1,1,2
3651,0,3698,9545;9546;9547,0,0,0,2,1,3
3652,0,3699,9548;9549,0,0,0,2,0,2
3653,0,3700,9550;9551,0,0,0,2,0,2
3654,0,3701,9552;9553,0,0,0,1,1,2
3655,0,3702,9554,0,0,0,1,0,1
3656,0,3703,9555;9556;9557;9558;9559,0,0,0,5,0,5
3657,0,3704,9560;9561;9562;9563,0,1,2,1,0,4
3658,0,3705,9564;9565;9566,0,0,0,3,0,3
3659,0,3706,9567;9568,0,0,0,1,1,2
3660,0,3707,9569;9570;9571;9572;9573,0,0,2,3,0,5
3661,0,3708,9574;9575;9576,0,0,0,3,0,3
3662,0,3709,2278;9577,0,0,0,2,0,2
3663,0,3710,9578;9579;9580,0,1,0,1,1,3
3664,0,3711,9581;9582,0,0,0,1,1,2
3665,0,3712,9583;9584;9585,0,0,1,2,0,3
3666,0,3713,9586;9587;9588;9589,0,0,2,2,0,4
3667,0,3714,9590;9591,0,0,0,2,0,2
3668,0,3715,9592;9593;9594;9595;9596,0,0,1,1,3,5
3669,0,3716,9597,0,0,0,1,0,1
3670,0,3717,9598;9599;9600,0,0,0,2,1,3
3671,0,3718,9601;9602;9603,0,0,0,2,1,3
3672,0,3719,9604;9605;9606;9607;9608,0,0,3,2,0,5
3673,0,3720,9609,0,0,0,1,0,1
3674,0,3721,9610;9611,0,0,0,2,0,2
3675,0,3722,9612;9613,0,0,0,2,0,2
3676,0,3723,9614;9615;9616;10038,0,1,0,3,0,4
3677,0,3724,9617;9618,0,0,0,1,1,2
3678,0,3725,625;9619,0,0,0,2,0,2
3679,0,3726,9620;9621,0,0,0,2,0,2
3680,0,3727,9622;9623;9624;9625;9626,0,1,0,3,1,5
3681,0,3728,9627;9628;9629,0,0,0,1,2,3
3682,0,3729,9630,0,0,0,0,1,1
3683,0,3730,9631;9632,0,0,0,1,1,2
3684,0,3731,9633;9634,0,0,0,2,0,2
3685,0,3732,9635;9636;9637,0,0,1,2,0,3
3686,0,3733,9638;9639,0,0,1,0,1,2
3687,0,3734,9640;9641;9642;9643,0,0,2,2,0,4
3688,0,3735,9644,0,0,0,0,1,1
3689,0,3736,9645,0,0,0,1,0,1
3690,0,3737,9646;9647;9648;9649,0,0,2,2,0,4
3691,0,3738,9650;9651,0,0,1,1,0,2
3692,0,3739,9652;9653;9654;9655,0,1,1,2,0,4
3693,0,3740,9656;9657,0,0,0,2,0,2
3694,0,3741,9658,0,0,0,1,0,1
3695,0,3742,9659,0,0,0,1,0,1
3696,0,3743,9660;9661;9662,0,0,0,3,0,3
3697,0,3744,1420;9663;9664;9665;9666;9667,0,1,3,2,0,6
3698,0,3745,9668,0,0,0,0,1,1
3699,0,3746,9669,0,0,0,0,1,1
3700,0,3747,9670;9671,0,0,0,2,0,2
3701,0,3748,9672;9673,0,0,0,1,1,2
3702,0,3749,9674;9675;9676;9677,0,0,1,2,1,4
3703,0,3750,9678;9679;9680;9681,0,0,2,1,1,4
3704,0,3751,9682;9683,0,0,0,2,0,2
3705,0,3752,9684;9685;9686;9687;9688;9689,0,2,1,3,0,6
3706,0,3753,9690;9691;9692;9693;9694,0,0,3,2,0,5
3707,0,3754,9695;9696,0,0,0,2,0,2
3708,0,3755,9697;9698;9699,0,0,0,3,0,3
3709,0,3756,9700;9701,0,0,0,2,0,2
3710,0,3757,9702;9703;9704,0,0,0,3,0,3
3711,0,3758,9705;9706,0,0,0,2,0,2
3712,0,3759,9707;9708;9709;9710,0,1,1,2,0,4
3713,0,3760,9711;9712,0,0,0,2,0,2
3714,0,3761,763;9713;9714,0,0,0,3,0,3
3715,0,3762,9715;9716,0,0,0,1,1,2
3716,0,3763,9717;9718;9719;9720;9721;9722,0,0,3,2,1,6
3717,0,3764,9723,0,0,0,0,1,1
3718,0,3765,9724;9725;9726;9727;9728;9729,0,2,1,2,1,6
3719,0,3766,9730,0,0,0,1,0,1
3720,0,3767,9731,0,0,0,0,1,1
3721,0,3768,9732,0,0,0,0,1,1
3722,0,3769,9733;9734;9735;9736,0,2,0,2,0,4
3723,0,3770,9737;9738;9739;9740;9741,0,2,1,1,1,5
3724,0,3771,9742,0,1,0,0,0,1
3725,0,3772,9743;9744,0,0,0,2,0,2
3726,0,3773,9745;9746,0,0,0,0,2,2
3727,0,3774,9747;9748;9749;9750;9751,0,3,0,1,1,5
3728,0,3775,9752;9753,0,0,0,1,1,2
3729,0,3776,9754;9755;9756,0,0,1,2,0,3
3730,0,3777,9757,0,0,0,1,0,1
3731,0,3778,9758;9759;9760;9762,0,0,0,3,1,4
3732,0,3779,9763;9764;9765,0,2,0,1,0,3
3733,0,3780,9766;9767;9768;9769,0,0,1,3,0,4
3734,0,3781,9770;9771,0,0,0,2,0,2
3735,0,3782,9772;9773,0,0,0,2,0,2
3736,0,3783,9774;9775;9776;9777,0,0,2,2,0,4
3737,0,3784,9778;9779,0,0,0,1,1,2
3738,0,3785,9780;9781;9782;9783,0,0,2,1,1,4
3739,0,3786,9784;9785;9786;9787;9788,0,1,1,3,0,5
3740,0,3787,9789;9790;9791;9792,0,0,0,4,0,4
3741,0,3788,9793;9794,0,0,0,2,0,2
3742,0,3789,9795;9796;9797;9798;9799,0,0,2,2,1,5
3743,0,3790,9800,0,0,0,0,1,1
3744,0,3791,9801,0,0,0,1,0,1
3745,0,3792,9802;9803;9804,0,0,0,3,0,3
3746,0,3793,9805;9806;9807,0,0,0,2,1,3
3747,0,3794,9808;9809,0,0,0,2,0,2
3748,0,3795,9810,0,0,0,1,0,1
3749,0,3796,9812;9813,0,0,0,1,1,2
3750,0,3797,9814;9815;9816;9817;9818;9819,0,0,4,1,1,6
3751,0,3798,9820;9821,0,0,0,1,1,2
3752,0,3799,9822,0,0,0,1,0,1
3753,0,3800,9823;9824;9825;9826;9827,0,1,1,2,1,5
3754,0,3801,9828;9829;9830;9831;9832;9833;9834,0,0,0,6,1,7
3755,0,3802,9835;9836;9837;9838,0,0,2,1,1,4
3756,0,3803,9839;9840,0,0,0,1,1,2
3757,0,3804,9841;9842;9843;9844,0,0,1,3,0,4
3758,0,3805,9845,0,0,0,1,0,1
3759,0,3806,9846,0,0,0,1,0,1
3760,0,3807,9847;9848;9849,0,1,1,0,1,3
3761,0,3808,9850,0,0,0,0,1,1
3762,0,3809,9851;9852;9853;9854,0,0,1,3,0,4
3763,0,3810,9855;9856,0,0,0,1,1,2
3764,0,3811,9857;9858,0,0,0,1,1,2
3765,0,3812,9859;9861,0,0,0,2,0,2
3766,0,3813,9862;9863,0,0,0,2,0,2
3767,0,3815,9865,0,0,0,0,1,1
3768,0,3816,9866;9867;9868,0,0,0,2,1,3
3769,0,3817,9869;9870,0,0,0,2,0,2
3770,0,3818,9871;9872;9873;9874,0,0,0,2,2,4
3771,0,3819,9875,0,0,0,0,1,1
3772,0,3820,9876;9877;9878;9879,0,0,1,3,0,4
3773,0,3821,9880;9881;9882;9883,0,0,1,2,1,4
3774,0,3822,9884;9885;9886;9887;9888,0,2,0,2,1,5
3775,0,3823,5779;9889;9890;9891,0,1,1,2,0,4
3776,0,3824,9892;9893;9894;9895,0,0,0,3,1,4
3777,0,3825,9896;9897;9898,0,0,1,1,1,3
3778,0,3826,9899,0,0,0,1,0,1
3779,0,3827,9900;9901,0,0,0,2,0,2
3780,0,3828,9902,0,0,0,1,0,1
3781,0,3829,9903;9904,0,0,0,2,0,2
3782,0,3830,9905;9906,0,0,0,1,1,2
3783,0,3831,9907,0,0,0,1,0,1
3784,0,3832,9908;9909;9910;9911;9912,0,0,0,4,1,5
3785,0,3833,9913;9914;9915,0,0,0,2,1,3
3786,0,3834,9916,0,0,0,0,1,1
3787,0,3835,9917;9918,0,0,0,2,0,2
3788,0,3836,9919;9920;9921;9923,0,1,0,3,0,4
3789,0,3837,9924;9925;9926;9927,0,1,1,2,0,4
3790,0,3838,9928;9929;9930,0,0,0,2,1,3
3791,0,3839,9931;9932,0,0,0,1,1,2
3792,0,3840,9933,0,0,0,0,1,1
3793,0,3841,9934;9935,0,0,0,2,0,2
3794,0,3842,9936;9939;9940,0,0,1,1,1,3
3795,0,3843,9941;9942,0,0,0,0,2,2
3796,0,3844,9943;9944;9945;9946;9947,0,0,1,4,0,5
3797,0,3845,9948;9949;9950;9951,0,0,1,3,0,4
3798,0,3846,9952,0,0,0,1,0,1
3799,0,3847,9953,0,0,0,1,0,1
3800,0,3848,9954;9955,0,0,0,2,0,2
3801,0,3849,9956;9957,0,0,0,2,0,2
3802,0,3850,9958,0,0,0,1,0,1
3803,0,3851,9959,0,0,0,1,0,1
3804,0,3852,9960;9961;9963,0,0,1,1,1,3
3805,0,3853,9964;9965,0,0,0,1,1,2
3806,0,3854,9966;9967,0,0,0,1,1,2
3807,0,3855,9968;9969;9970;9971,0,0,0,3,1,4
3808,0,3856,9972;9973;9974;9975;9976,0,1,2,2,0,5
3809,0,3857,9977;9978,0,0,0,1,1,2
3810,0,3858,9979;9980,0,0,0,1,1,2
3811,0,3859,9981;9982,0,0,0,2,0,2
3812,0,3860,9983;9984;9985;9986;9987;10030,0,3,1,2,0,6
3813,0,3861,9988,0,0,0,1,0,1
3814,0,3862,9989;9990;9991,0,0,0,3,0,3
3815,0,3863,9992;9993,0,0,0,2,0,2
3816,0,3864,9994;9995;9996;9997;9998,0,0,0,3,2,5
3817,0,3865,9999;10000;10001;10002,0,0,0,4,0,4
3818,0,3866,68,0,0,0,1,0,1
3819,0,3867,106;3646,0,0,0,2,0,2
3820,0,3868,143;2324,0,0,0,2,0,2
3821,0,3869,368;2017;10065,0,1,0,2,0,3
3822,0,3870,434;3065,0,0,0,2,0,2
3823,0,3871,570,0,0,0,1,0,1
3824,0,3872,586,0,0,0,1,0,1
3825,0,3873,588,0,0,0,1,0,1
3826,0,3874,655,0,0,0,1,0,1
3827,0,3875,668,0,0,0,1,0,1
3828,0,3876,695,0,0,0,1,0,1
3829,0,3877,726,0,0,0,1,0,1
3830,0,3878,828;2133,0,0,0,2,0,2
3831,0,3879,884,0,0,0,1,0,1
3832,0,3880,961,0,0,0,0,1,1
3833,0,3881,1178,0,0,0,1,0,1
3834,0,3882,1272;3435,0,0,0,2,0,2
3835,0,3883,1759,0,0,0,1,0,1
3836,0,3884,1783;2913,0,0,0,2,0,2
3837,0,3885,1865,0,0,0,1,0,1
3838,0,3886,1899;6428,0,0,0,2,0,2
3839,0,3887,1972,0,0,0,1,0,1
3840,0,3888,2126;4971,0,0,0,2,0,2
3841,0,3889,2130;4938,0,0,0,2,0,2
3842,0,3890,2037;2223,0,0,0,2,0,2
3843,0,3891,2314,0,0,0,1,0,1
3844,0,3892,2443,0,0,0,1,0,1
3845,0,3893,2526,0,0,0,1,0,1
3846,0,3894,2674,0,0,0,1,0,1
3847,0,3895,2688;5600;10053,0,1,0,2,0,3
3848,0,3896,2762;8312,0,0,0,2,0,2
3849,0,3897,2809,0,0,0,1,0,1
3850,0,3898,2832,0,0,0,1,0,1
3851,0,3899,2863,0,0,0,0,1,1
3852,0,3900,1736;2942,0,0,0,2,0,2
3853,0,3901,3009,0,0,0,1,0,1
3854,0,3902,3452;9127,0,0,0,2,0,2
3855,0,3903,3613,0,0,0,1,0,1
3856,0,3904,2038;3643,0,0,0,2,0,2
3857,0,3905,3662,0,0,0,1,0,1
3858,0,3906,259;3914,0,0,0,2,0,2
3859,0,3907,4000;7516,0,0,0,2,0,2
3860,0,3908,4064,0,0,0,1,0,1
3861,0,3909,4173,0,0,0,1,0,1
3862,0,3910,528;4243,0,0,0,2,0,2
3863,0,3911,4549;4568,0,0,0,2,0,2
3864,0,3912,4619,0,0,0,1,0,1
3865,0,3913,4644,0,0,0,0,1,1
3866,0,3914,3302;4794,0,0,0,2,0,2
3867,0,3915,5109;7517,0,0,0,2,0,2
3868,0,3916,5112,0,0,0,0,1,1
3869,0,3917,5211,0,0,0,1,0,1
3870,0,3918,5235;9207,0,0,0,2,0,2
3871,0,3919,5324,0,0,0,0,1,1
3872,0,3920,5385;9126,0,0,0,2,0,2
3873,0,3921,2771;5622,0,0,0,2,0,2
3874,0,3922,5690,0,0,0,1,0,1
3875,0,3923,5700;6778,0,0,0,2,0,2
3876,0,3924,5754;7107,0,0,0,2,0,2
3877,0,3925,1922;5769;10112,0,1,0,2,0,3
3878,0,3926,5846,0,0,0,1,0,1
3879,0,3927,3133;5888,0,0,1,1,0,2
3880,0,3928,6143,0,0,0,1,0,1
3881,0,3929,6147;7485,0,0,0,2,0,2
3882,0,3930,3750;6176,0,0,0,2,0,2
3883,0,3931,1532,0,0,0,1,0,1
3884,0,3932,7011,0,0,0,1,0,1
3885,0,3933,7062,0,0,0,1,0,1
3886,0,3934,7155,0,0,0,1,0,1
3887,0,3935,7253,0,0,0,1,0,1
3888,0,3936,7407,0,0,0,1,0,1
3889,0,3937,4885;7904,0,0,0,2,0,2
3890,0,3938,8035,0,0,0,1,0,1
3891,0,3939,8096,0,0,0,1,0,1
3892,0,3940,8159,0,0,0,1,0,1
3893,0,3941,8213,0,0,0,1,0,1
3894,0,3942,8227,0,0,0,1,0,1
3895,0,3943,6985;8378,0,0,0,2,0,2
3896,0,3944,8480;8547,0,0,0,2,0,2
3897,0,3945,8518,0,0,0,1,0,1
3898,0,3946,3391;8602,0,0,0,2,0,2
3899,0,3947,8851,0,0,0,1,0,1
3900,0,3948,8890,0,0,0,1,0,1
3901,0,3949,8983,0,0,0,1,0,1
3902,0,3950,8999,0,0,0,1,0,1
3903,0,3951,9039,0,0,0,1,0,1
3904,0,3952,9219,0,0,0,0,1,1
3905,0,3953,1199;9328,0,0,0,2,0,2
3906,0,3954,3629;9347,0,0,0,2,0,2
3907,0,3955,9540,0,0,0,0,1,1
3908,0,3956,9761;9811,0,0,0,2,0,2
3909,0,3957,9922,0,0,0,1,0,1
3910,0,3958,5653;9937,0,0,0,2,0,2
3911,0,3959,7129;9962,0,0,0,2,0,2
3912,10,0,1;2;3,0,0,0,2,1,3
3913,10,1,4;6;10561;10941,0,1,1,2,0,4
3914,10,2,13;1571,0,0,0,2,0,2
3915,10,3,14;15,0,0,0,2,0,2
3916,10,4,17;18,0,0,1,1,0,2
3917,10,6,20;21,0,0,0,1,1,2
3918,10,7,23;24,0,0,0,0,2,2
3919,10,8,25;26;10312;10355,0,0,2,2,0,4
3920,10,9,27;28;29,0,0,1,1,1,3
3921,10,11,31,0,0,0,1,0,1
3922,10,12,33;34;37;38,0,0,0,2,2,4
3923,10,13,39;2735;10529;10728,0,1,1,2,0,4
3924,10,14,41;42;43;44,0,0,1,3,0,4
3925,10,15,46;47;48;49;50,0,0,1,3,1,5
3926,10,16,51;916;10137;10462;10951,0,1,2,2,0,5
3927,10,17,53;55;56;57,0,0,2,2,0,4
3928,10,18,58;4607;10410,0,0,1,2,0,3
3929,10,19,60;61,0,0,1,1,0,2
3930,10,20,62;63,0,0,0,2,0,2
3931,10,21,67,0,0,0,1,0,1
3932,10,22,70;2464;10586;10635;11039,0,2,1,2,0,5
3933,10,23,72;73;74;75,0,0,0,4,0,4
3934,10,24,76;77,0,0,0,0,2,2
3935,10,25,78;79;80;81;9436,0,0,2,3,0,5
3936,10,26,82;83,0,0,0,0,2,2
3937,10,27,85;86;87,0,0,1,2,0,3
3938,10,28,88;89,0,0,0,1,1,2
3939,10,29,91;92;93;94;10893,0,1,2,2,0,5
3940,10,30,95;10374;10691,0,1,1,1,0,3
3941,10,32,98,0,0,0,0,1,1
3942,10,33,99;100,0,0,0,2,0,2
3943,10,34,101;103,0,0,0,0,2,2
3944,10,35,104;107,0,0,0,1,1,2
3945,10,36,108;109;113,0,0,1,2,0,3
3946,10,37,115;116,0,0,0,2,0,2
3947,10,38,117;118;119;120,0,0,1,3,0,4
3948,10,39,121;123,0,0,0,0,2,2
3949,10,40,124;125,0,0,0,1,1,2
3950,10,42,129,0,0,0,0,1,1
3951,10,43,131,0,0,0,1,0,1
3952,10,44,133;134;135;136,0,0,2,2,0,4
3953,10,46,138;7434,0,0,0,2,0,2
3954,10,47,139;140,0,0,0,0,2,2
3955,10,48,141;2463,0,0,0,2,0,2
3956,10,49,142;145,0,0,0,0,2,2
3957,10,50,148;149,0,0,0,1,1,2
3958,10,51,150,0,0,0,1,0,1
3959,10,52,151;2075,0,0,0,2,0,2
3960,10,53,154;9550;10021;10307;10452,0,0,3,2,0,5
3961,10,54,156;157;159;160,0,0,1,2,1,4
3962,10,55,162;163;3627,0,0,1,2,0,3
3963,10,56,164;10008;10712;10881,0,2,1,1,0,4
3964,10,57,165;166,0,0,0,2,0,2
3965,10,58,169;170;4427,0,0,2,1,0,3
3966,10,59,171;172,0,0,0,2,0,2
3967,10,60,173;174;175,0,0,1,1,1,3
3968,10,61,180,0,0,0,1,0,1
3969,10,62,185,0,0,0,0,1,1
3970,10,63,187;188;189,0,0,0,2,1,3
3971,10,64,190;192,0,0,0,2,0,2
3972,10,65,193;194,0,0,0,2,0,2
3973,10,66,195;196;10107;10981,0,1,1,1,1,4
3974,10,67,198;199;2594,0,0,0,3,0,3
3975,10,68,200;204,0,0,0,2,0,2
3976,10,69,206;207,0,0,0,2,0,2
3977,10,70,208,0,0,0,0,1,1
3978,10,71,209;210;10503;10505;10853,0,1,2,2,0,5
3979,10,73,214;215;217;218;219,0,0,2,3,0,5
3980,10,74,221;3903,0,0,0,2,0,2
3981,10,76,223,0,0,0,0,1,1
3982,10,77,226;227;228,0,0,1,2,0,3
3983,10,78,230;231;232,0,0,0,2,1,3
3984,10,79,234;235,0,0,0,1,1,2
3985,10,80,237;238,0,0,0,1,1,2
3986,10,81,241;242,0,0,0,1,1,2
3987,10,82,243;244,0,0,0,2,0,2
3988,10,83,245;246;247,0,0,0,2,1,3
3989,10,84,248;249;250,0,0,0,3,0,3
3990,10,85,251;252,0,0,0,1,1,2
3991,10,86,253,0,0,0,1,0,1
3992,10,88,256;257,0,0,0,0,2,2
3993,10,89,258,0,0,0,1,0,1
3994,10,90,260;261;10062,0,0,1,2,0,3
3995,10,91,263,0,0,0,0,1,1
3996,10,93,265;267;268,0,0,1,1,1,3
3997,10,94,269,0,0,0,1,0,1
3998,10,95,273,0,0,0,0,1,1
3999,10,96,275;277,0,0,1,1,0,2
4000,10,99,281;283,0,0,0,1,1,2
4001,10,100,284;285,0,0,0,2,0,2
4002,10,101,287,0,0,0,1,0,1
4003,10,102,288;289,0,0,0,1,1,2
4004,10,103,290;291;293;294,0,0,1,1,2,4
4005,10,104,295;5239,0,0,0,2,0,2
4006,10,105,297;5510,0,0,0,2,0,2
4007,10,106,298;300,0,0,0,1,1,2
4008,10,107,301;3705,0,0,0,2,0,2
4009,10,108,303,0,0,0,1,0,1
4010,10,109,304;306,0,0,0,2,0,2
4011,10,110,310;311,0,0,0,1,1,2
4012,10,111,312;313;314;316,0,0,0,2,2,4
4013,10,112,317;318;319;320,0,0,2,1,1,4
4014,10,113,322;5282,0,0,0,2,0,2
4015,10,114,323;324,0,0,0,1,1,2
4016,10,115,325;326,0,0,0,1,1,2
4017,10,116,327;7155,0,0,0,2,0,2
4018,10,117,328,0,0,0,0,1,1
4019,10,118,332;334;2314,0,0,1,2,0,3
4020,10,119,335;337,0,0,0,1,1,2
4021,10,120,338,0,0,0,0,1,1
4022,10,121,339;340,0,0,0,0,2,2
4023,10,122,341;342,0,0,0,0,2,2
4024,10,123,343,0,0,0,1,0,1
4025,10,124,344;345,0,0,0,1,1,2
4026,10,125,346;347;350,0,0,0,2,1,3
4027,10,127,352;2748;11002,0,1,0,2,0,3
4028,10,128,354;10628;10765,0,2,0,1,0,3
4029,10,129,358;359,0,0,0,2,0,2
4030,10,130,362;8602,0,0,0,2,0,2
4031,10,131,363;364;10741,0,1,0,2,0,3
4032,10,132,366;367;3661;10612;10863,0,2,1,2,0,5
4033,10,134,372,0,0,0,1,0,1
4034,10,135,373,0,0,0,0,1,1
4035,10,136,374;377;378;379;2271,0,0,3,0,2,5
4036,10,137,380;484,0,0,0,2,0,2
4037,10,138,381;382;383,0,0,1,2,0,3
4038,10,139,384;385;386,0,0,1,2,0,3
4039,10,140,387;5755;10703;10995;11066,0,3,0,2,0,5
4040,10,141,388;389;390,0,0,0,2,1,3
4041,10,142,391;393,0,0,0,2,0,2
4042,10,143,394;6674,0,0,0,2,0,2
4043,10,144,395;396,0,0,0,1,1,2
4044,10,145,398;399,0,0,0,1,1,2
4045,10,146,400,0,0,0,0,1,1
4046,10,147,401;1424;10831,0,1,0,2,0,3
4047,10,148,403;404;405,0,0,1,2,0,3
4048,10,149,406,0,0,0,1,0,1
4049,10,150,407;408,0,0,0,0,2,2
4050,10,151,411;10308;10771,0,1,1,1,0,3
4051,10,152,412;414;9291,0,0,0,3,0,3
4052,10,155,417,0,0,0,1,0,1
4053,10,156,418;420;421,0,0,1,1,1,3
4054,10,157,422;424,0,0,0,2,0,2
4055,10,158,426;1297,0,0,0,2,0,2
4056,10,159,427;428,0,0,0,2,0,2
4057,10,160,429;431,0,0,1,0,1,2
4058,10,161,432,0,0,0,0,1,1
4059,10,162,435;436;10378,0,0,1,1,1,3
4060,10,163,437;438;439;440,0,0,0,4,0,4
4061,10,164,441;443;444,0,0,1,1,1,3
4062,10,165,445;446;447;448,0,0,2,2,0,4
4063,10,166,449;7557,0,0,0,2,0,2
4064,10,167,451;452;10186;10405;10745,0,1,2,1,1,5
4065,10,168,453;454,0,0,0,2,0,2
4066,10,169,456;460;461;6719,0,0,1,2,1,4
4067,10,170,462;463,0,0,0,1,1,2
4068,10,171,464;465,0,0,0,1,1,2
4069,10,172,468,0,0,0,0,1,1
4070,10,173,470;3238,0,0,0,2,0,2
4071,10,174,472,0,0,0,1,0,1
4072,10,175,473;474;476;477,0,0,2,0,2,4
4073,10,176,479;480;6937;9796,0,0,1,3,0,4
4074,10,177,481;482,0,0,0,1,1,2
4075,10,178,486;487;488,0,0,0,3,0,3
4076,10,179,491;492;493;494;7346;10194;10894,0,1,4,2,0,7
4077,10,180,495,0,0,0,0,1,1
4078,10,181,496;497,0,0,0,2,0,2
4079,10,182,498;499,0,0,0,2,0,2
4080,10,183,500;7490,0,0,0,2,0,2
4081,10,184,501;502;503;10358;10422,0,0,2,2,1,5
4082,10,185,504;505,0,0,0,1,1,2
4083,10,188,509;510;512,0,0,1,2,0,3
4084,10,190,518;519,0,0,0,1,1,2
4085,10,191,522;7559,0,0,0,2,0,2
4086,10,193,529;530,0,0,0,0,2,2
4087,10,194,531;9288;10214,0,0,1,2,0,3
4088,10,195,532,0,0,0,1,0,1
4089,10,197,535;3912,0,0,0,2,0,2
4090,10,198,538;539,0,0,0,1,1,2
4091,10,199,540;541,0,0,0,2,0,2
4092,10,200,543;545;546,0,0,2,1,0,3
4093,10,201,548;549,0,0,0,2,0,2
4094,10,202,551,0,0,0,1,0,1
4095,10,203,554;6761;10593,0,0,1,2,0,3
4096,10,205,559;560;562,0,0,1,0,2,3
4097,10,206,563;564,0,0,0,0,2,2
4098,10,207,565;567;568,0,0,0,2,1,3
4099,10,208,569;7268,0,0,0,2,0,2
4100,10,209,571;5145,0,0,0,0,2,2
4101,10,210,573;574,0,0,1,1,0,2
4102,10,212,576,0,0,0,1,0,1
4103,10,213,577,0,0,0,0,1,1
4104,10,214,579,0,0,0,1,0,1
4105,10,215,580,0,0,0,0,1,1
4106,10,216,581;582;584,0,0,0,3,0,3
4107,10,218,589,0,0,0,1,0,1
4108,10,219,591;592,0,0,0,2,0,2
4109,10,220,595;596,0,0,0,2,0,2
4110,10,221,598,0,0,0,0,1,1
4111,10,222,599,0,0,0,0,1,1
4112,10,223,601;602;604,0,0,1,0,2,3
4113,10,224,605,0,0,0,1,0,1
4114,10,226,2459,0,0,0,1,0,1
4115,10,227,610;612;613,0,0,2,1,0,3
4116,10,228,614;615,0,0,0,2,0,2
4117,10,229,618,0,0,0,0,1,1
4118,10,230,620;4407,0,0,0,2,0,2
4119,10,231,621;622,0,0,0,1,1,2
4120,10,233,624;626,0,0,0,1,1,2
4121,10,234,627,0,0,0,0,1,1
4122,10,235,629;631;632;10453;10774;10943,0,2,3,1,0,6
4123,10,236,633;634,0,0,0,1,1,2
4124,10,238,638;639;8292,0,0,0,2,1,3
4125,10,239,641;8224,0,0,0,2,0,2
4126,10,240,644;10417;10638;11072,0,2,1,1,0,4
4127,10,241,646;647;648,0,0,1,0,2,3
4128,10,242,649,0,0,0,0,1,1
4129,10,243,650;651;652;653,0,0,2,2,0,4
4130,10,245,656,0,0,0,1,0,1
4131,10,246,658;9833;10121;10369,0,0,2,2,0,4
4132,10,247,660,0,0,0,0,1,1
4133,10,249,663;664;665,0,0,1,0,2,3
4134,10,251,669;5509,0,0,0,2,0,2
4135,10,252,670,0,0,0,1,0,1
4136,10,253,671;674;5902,0,0,0,3,0,3
4137,10,254,675;676,0,0,0,2,0,2
4138,10,255,678,0,0,0,1,0,1
4139,10,256,682;683;684,0,0,0,3,0,3
4140,10,257,687;688,0,0,0,2,0,2
4141,10,258,689;5322;10195;10640,0,1,1,2,0,4
4142,10,259,690,0,0,0,0,1,1
4143,10,260,692,0,0,0,1,0,1
4144,10,262,694;9385,0,0,0,2,0,2
4145,10,263,696,0,0,0,0,1,1
4146,10,264,698,0,0,0,1,0,1
4147,10,265,699;700;701,0,0,0,1,2,3
4148,10,266,703;704,0,0,0,0,2,2
4149,10,268,708;3877,0,0,0,1,1,2
4150,10,269,709;710,0,0,0,2,0,2
4151,10,271,666;715,0,0,0,2,0,2
4152,10,272,717,0,0,0,0,1,1
4153,10,273,718;719;721,0,0,0,2,1,3
4154,10,274,722;723,0,0,0,2,0,2
4155,10,275,724;725;727,0,0,0,1,2,3
4156,10,276,729;731,0,0,0,1,1,2
4157,10,277,733;734;735,0,0,0,1,2,3
4158,10,280,739;740,0,0,1,0,1,2
4159,10,281,741;742,0,0,0,1,1,2
4160,10,282,743,0,0,0,0,1,1
4161,10,284,746;747,0,0,0,1,1,2
4162,10,285,748,0,0,0,0,1,1
4163,10,286,750,0,0,0,1,0,1
4164,10,288,756;10108;10347;10649,0,1,2,1,0,4
4165,10,289,757;758,0,0,0,1,1,2
4166,10,291,760;4861,0,0,0,2,0,2
4167,10,294,764;765,0,0,1,1,0,2
4168,10,295,766;767,0,0,0,2,0,2
4169,10,296,769;771,0,0,0,1,1,2
4170,10,298,775;2561,0,0,0,1,1,2
4171,10,299,780;781,0,0,0,2,0,2
4172,10,300,782;783,0,0,0,1,1,2
4173,10,301,785;786,0,0,1,0,1,2
4174,10,302,788;8259,0,0,0,1,1,2
4175,10,303,789;8361,0,0,0,2,0,2
4176,10,304,791;793;794;795,0,0,0,4,0,4
4177,10,305,796;797;7661,0,0,0,3,0,3
4178,10,306,799;800;802;803;804;10106;10457,0,0,4,3,0,7
4179,10,307,805,0,0,0,1,0,1
4180,10,308,807,0,0,0,1,0,1
4181,10,309,808;809;810,0,0,0,2,1,3
4182,10,310,812;813,0,0,0,2,0,2
4183,10,311,814;7062,0,0,0,2,0,2
4184,10,312,816,0,0,0,1,0,1
4185,10,313,817;818;6492,0,0,0,3,0,3
4186,10,314,820;1679,0,0,0,2,0,2
4187,10,315,821;822,0,0,0,2,0,2
4188,10,316,823,0,0,0,0,1,1
4189,10,317,824;826;829,0,0,0,1,2,3
4190,10,318,831,0,0,0,1,0,1
4191,10,319,832,0,0,0,1,0,1
4192,10,321,835;836;838;839,0,0,1,3,0,4
4193,10,323,842;843;844,0,0,0,1,2,3
4194,10,324,847;848,0,0,0,2,0,2
4195,10,325,849;850,0,0,0,0,2,2
4196,10,326,851;852,0,0,0,1,1,2
4197,10,327,854;855,0,0,0,2,0,2
4198,10,329,858;5094;10626,0,1,0,2,0,3
4199,10,330,861;864;865,0,0,1,2,0,3
4200,10,332,868;869;870;871;10751,0,1,0,4,0,5
4201,10,333,874,0,0,0,1,0,1
4202,10,334,876;877;878;4198;10049;10174,0,0,3,3,0,6
4203,10,335,879;880,0,0,0,1,1,2
4204,10,336,881;882,0,0,0,2,0,2
4205,10,338,885;886,0,0,0,1,1,2
4206,10,339,889;890;892,0,0,0,2,1,3
4207,10,340,894;895;896;1507,0,0,0,4,0,4
4208,10,341,897,0,0,0,0,1,1
4209,10,342,899;901;902;903,0,0,0,2,2,4
4210,10,343,904;905,0,0,0,1,1,2
4211,10,344,906;907;908;909,0,0,1,2,1,4
4212,10,346,911,0,0,0,0,1,1
4213,10,347,912;913,0,0,0,0,2,2
4214,10,348,914;7109,0,0,0,2,0,2
4215,10,350,918;920;921,0,0,0,2,1,3
4216,10,351,922,0,0,0,1,0,1
4217,10,352,924;925,0,0,0,2,0,2
4218,10,353,927;928,0,0,0,1,1,2
4219,10,354,930;931;933;8984;10136;10749;11052,0,2,1,4,0,7
4220,10,355,934;935;936,0,0,0,1,2,3
4221,10,356,937,0,0,0,1,0,1
4222,10,357,939;940,0,0,0,2,0,2
4223,10,358,941;942;944,0,0,0,2,1,3
4224,10,359,946,0,0,0,0,1,1
4225,10,360,947;3662,0,0,0,1,1,2
4226,10,361,948;949;950;952;953;10630;10901;11036,0,3,1,4,0,8
4227,10,362,954;955,0,0,0,2,0,2
4228,10,363,956;957;958;959;960,0,0,1,2,2,5
4229,10,364,30;962;964,0,0,0,3,0,3
4230,10,365,965;966,0,0,0,1,1,2
4231,10,366,967;968,0,0,0,1,1,2
4232,10,367,969;971;972;974;975;976;977,0,0,0,4,3,7
4233,10,368,980;981;982,0,0,1,0,2,3
4234,10,369,983;986;987;988,0,0,1,3,0,4
4235,10,371,991;8104,0,0,0,2,0,2
4236,10,372,992;993,0,0,0,1,1,2
4237,10,373,994;995,0,0,0,2,0,2
4238,10,374,996;5825,0,0,0,0,2,2
4239,10,375,997;998,0,0,0,0,2,2
4240,10,376,1000;1001,0,0,0,2,0,2
4241,10,377,1002,0,0,0,0,1,1
4242,10,378,1004;1005,0,0,0,1,1,2
4243,10,379,1007;1008;1010,0,0,0,2,1,3
4244,10,380,1011,0,0,0,0,1,1
4245,10,381,1013,0,0,0,1,0,1
4246,10,382,1015;1016,0,0,0,1,1,2
4247,10,383,1017;1018,0,0,0,0,2,2
4248,10,385,1021,0,0,0,1,0,1
4249,10,387,1025;1026;1027,0,0,1,2,0,3
4250,10,388,1028;1029,0,0,0,2,0,2
4251,10,389,1033;1034;1035,0,0,1,1,1,3
4252,10,390,737;1036,0,0,0,2,0,2
4253,10,391,1038,0,0,0,0,1,1
4254,10,392,1039,0,0,0,1,0,1
4255,10,393,1041;1044;1045,0,0,2,0,1,3
4256,10,394,1046,0,0,0,1,0,1
4257,10,395,1047;1048;1049;1050;1051,0,0,3,1,1,5
4258,10,396,1052;1055;1056,0,0,0,2,1,3
4259,10,397,1057;3836,0,0,0,0,2,2
4260,10,398,1058;3444,0,0,0,2,0,2
4261,10,399,1060;2703,0,0,0,2,0,2
4262,10,400,1063;1064;1065,0,0,0,3,0,3
4263,10,401,1066,0,0,0,0,1,1
4264,10,403,1069;1071;7299,0,0,0,3,0,3
4265,10,404,1072;1073,0,0,0,0,2,2
4266,10,406,1076;1077;10072;10295;10491,0,0,3,2,0,5
4267,10,408,1079,0,0,0,0,1,1
4268,10,409,1080;1081,0,0,0,2,0,2
4269,10,410,1082;1981;10239;10725,0,1,1,2,0,4
4270,10,411,1083;3364,0,0,0,2,0,2
4271,10,412,1085;1086,0,0,0,2,0,2
4272,10,413,1087;9147,0,0,0,2,0,2
4273,10,414,1088;1089,0,0,0,2,0,2
4274,10,415,1090;1092;1093;8227,0,0,2,2,0,4
4275,10,416,1094;1096,0,0,0,2,0,2
4276,10,417,1098,0,0,0,1,0,1
4277,10,418,1101;1102;10048;10172,0,0,2,2,0,4
4278,10,420,1059;1106;1107,0,0,1,2,0,3
4279,10,422,1109;1110,0,0,0,1,1,2
4280,10,423,1111;1112,0,0,0,2,0,2
4281,10,424,1113;1114,0,0,0,2,0,2
4282,10,425,1117,0,0,0,1,0,1
4283,10,427,1121,0,0,0,0,1,1
4284,10,428,1124;1125,0,0,0,1,1,2
4285,10,429,1127;1128,0,0,0,0,2,2
4286,10,430,1129;1130,0,0,0,2,0,2
4287,10,432,1132;1133;1134,0,0,0,2,1,3
4288,10,433,1135;1136;5341,0,0,0,3,0,3
4289,10,434,1137;1141;9613,0,0,0,3,0,3
4290,10,435,1142;1144,0,0,1,1,0,2
4291,10,436,1145;1146;1148,0,0,0,2,1,3
4292,10,437,1150;1152,0,0,1,0,1,2
4293,10,438,1154,0,0,0,0,1,1
4294,10,439,1155;1156;1158,0,0,1,1,1,3
4295,10,440,1159;1160;1161;1162;1163;1164,0,0,1,3,2,6
4296,10,441,1168;1169;1581,0,0,0,2,1,3
4297,10,444,1172;1173,0,0,0,0,2,2
4298,10,445,1175;1176,0,0,0,2,0,2
4299,10,447,1179;4088,0,0,0,2,0,2
4300,10,448,1180;1181,0,0,0,1,1,2
4301,10,449,1182;8981,0,0,0,2,0,2
4302,10,451,1185;1186,0,0,0,2,0,2
4303,10,452,1187,0,0,0,1,0,1
4304,10,453,1189;1190;1191;1192;10809,0,1,2,2,0,5
4305,10,454,1193,0,0,0,0,1,1
4306,10,455,1194;1196,0,0,0,1,1,2
4307,10,456,1198,0,0,0,1,0,1
4308,10,457,1201,0,0,0,1,0,1
4309,10,458,1202;1203,0,0,0,1,1,2
4310,10,459,1204;4248,0,0,0,2,0,2
4311,10,460,1206,0,0,0,0,1,1
4312,10,461,1210;1211,0,0,0,1,1,2
4313,10,462,1214;1215,0,0,0,1,1,2
4314,10,463,6474,0,0,0,1,0,1
4315,10,464,1220;1221;10148,0,0,1,2,0,3
4316,10,465,1222,0,0,0,0,1,1
4317,10,466,1223;1224,0,0,0,2,0,2
4318,10,467,1226;1227;2404;4429,0,0,0,3,1,4
4319,10,468,1228;1229;1231,0,0,1,1,1,3
4320,10,470,1233;1234,0,0,0,1,1,2
4321,10,472,1240;1241;1242,0,0,1,1,1,3
4322,10,473,1244;1245,0,0,0,0,2,2
4323,10,474,1248,0,0,0,1,0,1
4324,10,475,1253,0,0,0,0,1,1
4325,10,476,1255;1256,0,0,0,2,0,2
4326,10,477,1257;1258,0,0,0,1,1,2
4327,10,478,1260,0,0,1,0,0,1
4328,10,479,1261;1262,0,0,0,1,1,2
4329,10,480,1265;1266;1267,0,0,2,0,1,3
4330,10,481,1268;1269,0,0,0,1,1,2
4331,10,482,1271,0,0,0,0,1,1
4332,10,483,1275;1276,0,0,0,2,0,2
4333,10,484,1277;1278,0,0,0,2,0,2
4334,10,485,1279;1280,0,0,0,0,2,2
4335,10,486,1281,0,0,0,0,1,1
4336,10,487,1283;1284,0,0,1,1,0,2
4337,10,488,1285;1286;1287;10744,0,1,0,2,1,4
4338,10,489,1289,0,0,0,0,1,1
4339,10,490,1290;1291,0,0,0,1,1,2
4340,10,491,1293,0,0,0,0,1,1
4341,10,492,1299;1300;1301,0,0,0,1,2,3
4342,10,493,1302;1303;1304;1305,0,0,1,2,1,4
4343,10,495,1309;1310,0,0,0,2,0,2
4344,10,496,1311;1312;1313;1314,0,0,0,3,1,4
4345,10,497,1315;1316,0,0,0,2,0,2
4346,10,498,1319;1320,0,0,0,1,1,2
4347,10,500,1323;1324,0,0,0,2,0,2
4348,10,501,1325;1326,0,0,0,0,2,2
4349,10,502,1327;1328;3565,0,0,0,3,0,3
4350,10,503,1329;3441,0,0,0,2,0,2
4351,10,504,1330;1334,0,0,1,1,0,2
4352,10,505,1335,0,0,0,1,0,1
4353,10,507,1338;2278;10482;10632,0,1,1,2,0,4
4354,10,508,1341,0,0,0,1,0,1
4355,10,509,1342;1343;1345,0,0,1,1,1,3
4356,10,510,1347,0,0,0,0,1,1
4357,10,511,1350;1351,0,0,0,1,1,2
4358,10,513,1356;1359;1360,0,0,2,0,1,3
4359,10,514,1361;1362;1364,0,0,1,1,1,3
4360,10,515,1365;3043;10783,0,1,0,2,0,3
4361,10,516,1366;1367;1368,0,0,0,3,0,3
4362,10,517,1370,0,0,0,0,1,1
4363,10,518,1373;1374;10120;10610,0,1,1,1,1,4
4364,10,519,1375;8864;10674;10844;11051,0,3,0,2,0,5
4365,10,521,1378;1379,0,0,0,0,2,2
4366,10,522,1381;1382,0,0,1,1,0,2
4367,10,523,1383,0,0,0,1,0,1
4368,10,524,1384;1385;1387;1388,0,0,1,3,0,4
4369,10,525,1389,0,0,0,0,1,1
4370,10,526,1390,0,0,0,1,0,1
4371,10,528,1392;1393,0,0,0,1,1,2
4372,10,529,1395;1396,0,0,0,0,2,2
4373,10,530,1397;1398;1399,0,0,0,2,1,3
4374,10,531,1400;1401,0,0,0,2,0,2
4375,10,532,1402;1403,0,0,0,0,2,2
4376,10,534,1405;8870;10580;10666;11082,0,2,1,2,0,5
4377,10,535,1408,0,0,0,1,0,1
4378,10,536,1409;1410,0,0,0,2,0,2
4379,10,538,1415,0,0,0,1,0,1
4380,10,539,1418;1419;1421,0,0,0,1,2,3
4381,10,541,1425;1426;1427;1428,0,0,1,1,2,4
4382,10,542,1431;6846,0,0,0,2,0,2
4383,10,543,1433,0,0,0,1,0,1
4384,10,544,1434,0,0,0,0,1,1
4385,10,545,1435;1436,0,0,0,2,0,2
4386,10,546,1437;1438,0,0,0,1,1,2
4387,10,547,1440,0,0,0,1,0,1
4388,10,548,1441;6517,0,0,0,2,0,2
4389,10,549,1442;1443,0,0,0,1,1,2
4390,10,550,1444;9792,0,0,0,2,0,2
4391,10,552,1448;1450;1451;1452,0,0,3,0,1,4
4392,10,553,4314;10278;10688;10835,0,2,1,1,0,4
4393,10,554,1454;1455,0,0,0,0,2,2
4394,10,555,1456;1458;4134,0,0,0,3,0,3
4395,10,556,1459;1460;1461,0,0,1,2,0,3
4396,10,557,1463,0,0,0,1,0,1
4397,10,558,1464;4907;4908;10218;10601;11091,0,1,2,3,0,6
4398,10,559,1465;1466;1467;1468,0,0,2,1,1,4
4399,10,560,1469;1470;1471;1472;10481,0,0,2,2,1,5
4400,10,561,1473;1474,0,0,0,1,1,2
4401,10,562,1475;1476;1477;1478;10961,0,1,0,3,1,5
4402,10,563,1480,0,0,0,1,0,1
4403,10,564,1481;1482,0,0,0,0,2,2
4404,10,565,1183;1483;1485;1486,0,0,0,4,0,4
4405,10,566,1488;1489,0,0,0,1,1,2
4406,10,567,1491;1493;8031,0,0,1,2,0,3
4407,10,568,1495;1496,0,0,0,2,0,2
4408,10,569,1497;1499;1500;5273;10797,0,1,0,4,0,5
4409,10,570,1501,0,0,0,0,1,1
4410,10,571,1502;10357;10595;10795,0,1,2,1,0,4
4411,10,572,1503;1504;1505,0,0,0,1,2,3
4412,10,573,1506;3919;10099;10183;10494;10928,0,1,3,2,0,6
4413,10,574,1509;3027,0,0,0,2,0,2
4414,10,575,1510;1511,0,0,0,0,2,2
4415,10,576,1513;9002,0,0,0,2,0,2
4416,10,577,1517;6711,0,0,0,2,0,2
4417,10,578,1518;1519,0,0,0,1,1,2
4418,10,579,1520;1521;1522,0,0,0,3,0,3
4419,10,580,1524;1525;2722,0,0,0,3,0,3
4420,10,581,1527,0,0,0,0,1,1
4421,10,582,1529;3538;10406,0,0,1,2,0,3
4422,10,583,1131;1531,0,0,0,2,0,2
4423,10,584,1533;1536;1537;1538,0,0,1,3,0,4
4424,10,585,1539;1540;1542,0,0,0,2,1,3
4425,10,587,1547;1548;10882,0,1,0,2,0,3
4426,10,589,1550;1551,0,0,0,0,2,2
4427,10,590,1553;9321;10003,0,0,1,2,0,3
4428,10,591,1554;1555,0,0,0,1,1,2
4429,10,592,1557;1558,0,0,0,2,0,2
4430,10,593,1560;1655;11035,0,1,0,2,0,3
4431,10,594,1562;1563;1564;1565,0,0,2,2,0,4
4432,10,595,1566;1567,0,0,0,2,0,2
4433,10,596,1568;1569;1570;1572,0,0,0,2,2,4
4434,10,597,1573;1574,0,0,0,1,1,2
4435,10,599,1578,0,0,0,0,1,1
4436,10,600,1579,0,0,0,1,0,1
4437,10,603,1585;1587;9853,0,0,1,0,2,3
4438,10,604,1588;1591;1592,0,0,0,1,2,3
4439,10,605,1593;1594,0,0,0,2,0,2
4440,10,606,1595;4865,0,0,0,2,0,2
4441,10,607,1596;4276;10116;10627,0,1,1,2,0,4
4442,10,608,1597;1598,0,0,0,2,0,2
4443,10,610,1601;1602;1604,0,0,1,0,2,3
4444,10,611,1605;1606,0,0,0,2,0,2
4445,10,612,1607;1608;1609;7132,0,0,0,4,0,4
4446,10,613,1610;1612,0,0,0,2,0,2
4447,10,614,1614;1616;1618;1619,0,0,2,1,1,4
4448,10,615,1620;1621;1622;1623,0,0,2,1,1,4
4449,10,617,1626,0,0,0,1,0,1
4450,10,618,1628;1629;1630;10639;10753,0,2,0,3,0,5
4451,10,619,1631;1632;10702,0,1,0,2,0,3
4452,10,620,1633;1634,0,0,0,2,0,2
4453,10,621,1635;1636;1637,0,0,0,3,0,3
4454,10,622,1638;1639,0,0,0,1,1,2
4455,10,623,1641;1642,0,0,0,1,1,2
4456,10,624,1643;1644;10187;10392;10445;11081,0,1,3,1,1,6
4457,10,625,1647;1648;2480,0,0,0,3,0,3
4458,10,626,1650;1651,0,0,0,0,2,2
4459,10,627,1657,0,0,0,1,0,1
4460,10,628,1658;2835,0,0,0,2,0,2
4461,10,629,1659;8975,0,0,0,2,0,2
4462,10,630,1660;1661,0,0,0,2,0,2
4463,10,632,1664;1665;1666;1667;1668,0,0,2,2,1,5
4464,10,633,1669;1670;1671,0,0,2,0,1,3
4465,10,634,1673;5117;10852,0,1,0,2,0,3
4466,10,635,1675,0,0,0,0,1,1
4467,10,637,1677;1678,0,0,0,1,1,2
4468,10,638,1680;1681;1682,0,0,1,1,1,3
4469,10,639,1684;1685,0,0,0,2,0,2
4470,10,640,1687,0,0,0,0,1,1
4471,10,641,1690;1691;1692;1693;1694,0,0,0,4,1,5
4472,10,642,1697;1698;1700,0,0,2,1,0,3
4473,10,643,1701;1702,0,0,0,1,1,2
4474,10,644,1704;1705;1706;3901;9763;9764;9765,0,0,3,4,0,7
4475,10,645,1708;1709,0,0,0,1,1,2
4476,10,646,1710,0,0,0,1,0,1
4477,10,647,1712;4347,0,0,0,2,0,2
4478,10,648,1715;8540;10919;11057,0,2,0,2,0,4
4479,10,649,1716;1717;1720;1721,0,0,2,2,0,4
4480,10,650,1722;1723,0,0,0,1,1,2
4481,10,651,1724;1725;1726;1727,0,0,2,1,1,4
4482,10,653,1733;1734,0,0,0,2,0,2
4483,10,654,1735;1737,0,0,0,2,0,2
4484,10,655,1738;1739,0,0,0,1,1,2
4485,10,656,1742;1743,0,0,0,2,0,2
4486,10,657,1746;1747;7010,0,0,1,2,0,3
4487,10,658,1748;1749;1751,0,0,0,3,0,3
4488,10,659,1752,0,0,0,0,1,1
4489,10,661,1755;1756,0,0,0,1,1,2
4490,10,662,1758,0,0,0,1,0,1
4491,10,663,1760,0,0,0,1,0,1
4492,10,664,1761;1762,0,0,0,0,2,2
4493,10,665,1763;1764;10588;10810;10986,0,2,1,1,1,5
4494,10,666,1765;1766,0,0,0,1,1,2
4495,10,667,1767;1768;1770;1771,0,0,0,2,2,4
4496,10,668,1772;1774;1775,0,0,0,2,1,3
4497,10,669,1777;1778,0,0,0,0,2,2
4498,10,671,1781;1782,0,0,0,2,0,2
4499,10,672,1785;1786;1787,0,0,0,3,0,3
4500,10,673,2802,0,0,0,1,0,1
4501,10,674,1791,0,0,0,0,1,1
4502,10,675,1792;1793,0,0,0,0,2,2
4503,10,676,1794,0,0,0,0,1,1
4504,10,677,1219;1795;1797,0,0,1,2,0,3
4505,10,678,1799,0,0,0,0,1,1
4506,10,679,1800;1803,0,0,1,0,1,2
4507,10,680,1804;1805,0,0,0,2,0,2
4508,10,681,1807;1808,0,0,1,0,1,2
4509,10,682,1809;1810;10043;10210,0,0,2,2,0,4
4510,10,683,1811,0,0,0,0,1,1
4511,10,684,1812;1814,0,0,0,2,0,2
4512,10,687,1817;1819,0,0,0,1,1,2
4513,10,688,1822;1823,0,0,0,0,2,2
4514,10,689,1825;1826,0,0,0,1,1,2
4515,10,691,1828,0,0,0,1,0,1
4516,10,692,1829;1830,0,0,0,2,0,2
4517,10,696,1838;1840,0,0,1,1,0,2
4518,10,697,1841;1842,0,0,0,1,1,2
4519,10,698,1843;7783;10940;11067,0,2,0,2,0,4
4520,10,699,1844;1845;1846;1847,0,0,0,2,2,4
4521,10,700,1849;1851,0,0,0,0,2,2
4522,10,701,1852,0,0,0,0,1,1
4523,10,702,1853;1854,0,0,0,1,1,2
4524,10,703,1855,0,0,0,0,1,1
4525,10,704,1856;1857;10061;10192;10903,0,1,2,2,0,5
4526,10,705,1858;1859,0,0,0,0,2,2
4527,10,707,1862;1863,0,0,0,1,1,2
4528,10,708,1864;1866,0,0,0,1,1,2
4529,10,709,1867;1868;10972;11008,0,2,0,1,1,4
4530,10,710,1869;7936,0,0,0,2,0,2
4531,10,712,1871,0,0,0,0,1,1
4532,10,713,1874;1875,0,0,0,2,0,2
4533,10,714,1876;1877,0,0,0,1,1,2
4534,10,715,1878;1879,0,0,0,1,1,2
4535,10,716,1880;1881;1883;10238;10645,0,1,2,1,1,5
4536,10,718,1885,0,0,0,0,1,1
4537,10,719,1886;1887;1888;1889,0,0,0,3,1,4
4538,10,720,1891;1892;10265;10766,0,1,1,2,0,4
4539,10,721,307;1893;10802,0,1,0,2,0,3
4540,10,723,1898;5340,0,0,0,2,0,2
4541,10,724,1903,0,0,0,0,1,1
4542,10,725,1905;1906,0,0,0,1,1,2
4543,10,726,1909,0,0,0,0,1,1
4544,10,727,1911;1912,0,0,0,1,1,2
4545,10,728,1914;10672,0,1,0,1,0,2
4546,10,729,1916,0,0,0,1,0,1
4547,10,730,1917;7842,0,0,0,2,0,2
4548,10,731,1919,0,0,0,1,0,1
4549,10,733,1923,0,0,0,1,0,1
4550,10,734,1926,0,0,0,1,0,1
4551,10,735,1928;1929;1930,0,0,2,0,1,3
4552,10,736,1931;1933;4838,0,0,0,3,0,3
4553,10,738,4283,0,0,0,1,0,1
4554,10,739,1937;4195,0,0,0,2,0,2
4555,10,740,1939;1940,0,0,1,1,0,2
4556,10,741,1941;1942;1943;1944,0,0,2,1,1,4
4557,10,742,1945,0,0,0,1,0,1
4558,10,743,1951,0,0,0,0,1,1
4559,10,744,1955;6286,0,0,0,2,0,2
4560,10,745,1956,0,0,0,0,1,1
4561,10,747,1108;8274,0,0,0,2,0,2
4562,10,748,1959,0,0,0,0,1,1
4563,10,749,1961;1963,0,0,0,1,1,2
4564,10,750,1964;1965;1966;10063;10253;10644,0,1,3,2,0,6
4565,10,751,1968,0,0,0,1,0,1
4566,10,752,1969;1970;10761;10985,0,2,0,2,0,4
4567,10,753,1971;1973;1974;4405,0,0,0,4,0,4
4568,10,754,1975;1977;1979,0,0,0,3,0,3
4569,10,756,1984;1986;1987,0,0,0,2,1,3
4570,10,757,1989;2114,0,0,0,2,0,2
4571,10,758,1991;8951,0,0,0,2,0,2
4572,10,759,1992;1993;11068,0,1,0,1,1,3
4573,10,761,1996;2100,0,0,0,2,0,2
4574,10,762,1997;2251,0,0,0,2,0,2
4575,10,763,1999,0,0,0,0,1,1
4576,10,764,2000,0,0,0,0,1,1
4577,10,765,2003,0,0,0,0,1,1
4578,10,768,2006;2008;2009;10621,0,1,1,2,0,4
4579,10,769,798;2012;2013;2015,0,0,1,3,0,4
4580,10,770,2016;2018,0,0,0,2,0,2
4581,10,771,2019;2020;2021,0,0,0,0,3,3
4582,10,772,2023;2024,0,0,0,2,0,2
4583,10,773,2026;2027;10597;10724,0,1,1,2,0,4
4584,10,774,2028;2029;2031;2032,0,0,1,2,1,4
4585,10,775,2034;2036;2040;2043,0,0,0,1,3,4
4586,10,776,2044;7753,0,0,0,2,0,2
4587,10,777,2045,0,0,0,0,1,1
4588,10,778,2046,0,0,0,1,0,1
4589,10,779,2048,0,0,0,0,1,1
4590,10,780,2050,0,0,0,0,1,1
4591,10,782,2052;2053;10086,0,0,1,2,0,3
4592,10,783,2055,0,0,0,1,0,1
4593,10,784,2057,0,0,0,1,0,1
4594,10,785,2060;8024,0,0,0,2,0,2
4595,10,786,2061;2062;2063,0,0,2,0,1,3
4596,10,787,305;2064,0,0,0,2,0,2
4597,10,788,2065;2066;2068;2069,0,0,2,2,0,4
4598,10,789,2070;2071,0,0,0,2,0,2
4599,10,791,2073,0,0,0,1,0,1
4600,10,792,2074,0,0,0,1,0,1
4601,10,793,2078;2079,0,0,0,1,1,2
4602,10,794,2080;2889,0,0,0,2,0,2
4603,10,795,2081;6219,0,0,0,2,0,2
4604,10,796,2083;2084;2085,0,0,1,2,0,3
4605,10,797,2086;2087;10103;10271;10331,0,0,3,1,1,5
4606,10,798,2088;2090,0,0,0,2,0,2
4607,10,799,2094;2095,0,0,0,1,1,2
4608,10,801,2097;2098;2099;2101,0,0,0,3,1,4
4609,10,802,2102,0,0,0,0,1,1
4610,10,803,2103;5953,0,0,0,2,0,2
4611,10,805,2106;2108,0,0,0,1,1,2
4612,10,806,2109;2110,0,0,0,2,0,2
4613,10,807,2111;2112,0,0,0,1,1,2
4614,10,808,2113,0,0,0,1,0,1
4615,10,810,2115,0,0,0,0,1,1
4616,10,811,2118,0,0,0,0,1,1
4617,10,812,2119;2121,0,0,1,1,0,2
4618,10,813,2122;2123,0,0,1,0,1,2
4619,10,814,2124;2125,0,0,0,2,0,2
4620,10,815,2127,0,0,0,1,0,1
4621,10,816,2128;2129,0,0,0,2,0,2
4622,10,817,2134;2135;2136;2138,0,0,0,1,3,4
4623,10,818,2139;2140;2142,0,0,1,1,1,3
4624,10,819,2143;5588,0,0,0,2,0,2
4625,10,820,2144;2146,0,0,1,0,1,2
4626,10,821,2147;2148;10135,0,0,1,2,0,3
4627,10,822,2149,0,0,0,1,0,1
4628,10,823,2151,0,0,0,0,1,1
4629,10,824,2152;2153,0,0,0,2,0,2
4630,10,825,2154,0,0,0,0,1,1
4631,10,826,2157;2158;2159,0,0,1,2,0,3
4632,10,827,2160;5752,0,0,0,2,0,2
4633,10,828,2161;2162,0,0,0,1,1,2
4634,10,829,2163,0,0,0,1,0,1
4635,10,830,2165;2166;2167,0,0,0,1,2,3
4636,10,833,2173;2174;2175;2176,0,0,1,3,0,4
4637,10,834,2178,0,0,0,1,0,1
4638,10,836,2183;2184,0,0,0,1,1,2
4639,10,838,2188,0,0,0,0,1,1
4640,10,839,2190,0,0,0,0,1,1
4641,10,840,2191;2192,0,0,0,1,1,2
4642,10,841,2193;2194,0,0,0,1,1,2
4643,10,842,2195;2196,0,0,0,1,1,2
4644,10,843,2197,0,0,0,0,1,1
4645,10,844,2198;7879,0,0,0,2,0,2
4646,10,845,2199,0,0,0,0,1,1
4647,10,846,2200;2202,0,0,0,0,2,2
4648,10,847,2204;2205,0,0,0,2,0,2
4649,10,849,2211,0,0,0,0,1,1
4650,10,850,2214,0,0,0,1,0,1
4651,10,851,2216;2218,0,0,0,1,1,2
4652,10,852,2220;2221;2225;5323,0,0,0,4,0,4
4653,10,853,2226;2227,0,0,0,2,0,2
4654,10,854,2228;2229,0,0,0,1,1,2
4655,10,855,2230;2231;2233;2234;4159,0,0,2,3,0,5
4656,10,856,2235;2236,0,0,0,0,2,2
4657,10,857,2237;2238;10493;10932,0,1,1,1,1,4
4658,10,858,2241;8182,0,0,0,1,1,2
4659,10,859,2242;2243;2244;2247,0,0,1,3,0,4
4660,10,860,2248;2250,0,0,1,1,0,2
4661,10,861,2254;2255;2256,0,0,0,1,2,3
4662,10,862,2257;2258,0,0,0,2,0,2
4663,10,863,2259;2261,0,0,0,1,1,2
4664,10,864,2263;2264;2265;6046;10039;10259;10886,0,1,2,4,0,7
4665,10,865,2266;2267;2268,0,0,1,2,0,3
4666,10,867,1818;2272;2273,0,0,0,3,0,3
4667,10,868,2274;2275,0,0,0,2,0,2
4668,10,869,2276;2277,0,0,0,2,0,2
4669,10,870,2072;2282;2284,0,0,0,3,0,3
4670,10,871,2285;4707,0,0,0,2,0,2
4671,10,872,2286,0,0,0,0,1,1
4672,10,873,2287;2288;2289;2290;2291;10093;10111;10150;10404;10473,0,0,5,5,0,10
4673,10,874,2293;2294;4002;10010;10177,0,0,2,3,0,5
4674,10,875,2296,0,0,0,0,1,1
4675,10,876,2297;3451,0,0,0,2,0,2
4676,10,877,2298;2299;2300,0,0,1,1,1,3
4677,10,878,2303;10737,0,1,0,1,0,2
4678,10,879,2304,0,0,0,0,1,1
4679,10,881,2307,0,0,0,1,0,1
4680,10,884,2313,0,0,0,0,1,1
4681,10,885,2315;7473,0,0,0,2,0,2
4682,10,886,1583;2320,0,0,0,2,0,2
4683,10,887,2325;2327,0,0,0,0,2,2
4684,10,888,1870;2328;2330;10022;10266;10680,0,1,3,2,0,6
4685,10,889,2331,0,0,0,1,0,1
4686,10,890,978;2332,0,0,0,2,0,2
4687,10,891,2333;2334;10361;10447,0,0,2,1,1,4
4688,10,892,2335;2336,0,0,0,2,0,2
4689,10,893,2338;2339;10416;10420;10568,0,0,4,1,0,5
4690,10,894,2340;2341;2342,0,0,0,2,1,3
4691,10,895,2343;2344;10142;10321;10381,0,0,3,1,1,5
4692,10,896,2346;2347,0,0,0,1,1,2
4693,10,897,2350;2351;4722,0,0,0,3,0,3
4694,10,898,2352;2353;2354;2356,0,0,1,1,2,4
4695,10,899,2357,0,0,0,0,1,1
4696,10,900,2358;2360;2361,0,0,2,1,0,3
4697,10,901,2362;2363;2364;2365;2366,0,0,0,5,0,5
4698,10,902,2367;2368;2369;2370,0,0,2,2,0,4
4699,10,904,2373;2374;10415;11079,0,1,1,2,0,4
4700,10,905,2375;2376,0,0,0,0,2,2
4701,10,906,2378,0,0,0,0,1,1
4702,10,907,1118;2379,0,0,0,2,0,2
4703,10,908,2381;2382;2384,0,0,0,2,1,3
4704,10,909,2386;6079,0,0,0,2,0,2
4705,10,911,2390;2391,0,0,0,1,1,2
4706,10,912,2392;2393;2395;2396,0,0,1,2,1,4
4707,10,914,2398,0,0,0,1,0,1
4708,10,916,2408,0,0,0,0,1,1
4709,10,917,2410;2411,0,0,0,1,1,2
4710,10,918,2412;2413,0,0,0,1,1,2
4711,10,919,2415;2416;2417;10127;10245;10548,0,0,3,3,0,6
4712,10,921,2421,0,0,0,1,0,1
4713,10,922,2422;2423,0,0,0,2,0,2
4714,10,923,2424,0,0,0,0,1,1
4715,10,926,2431;2493;7458,0,0,0,3,0,3
4716,10,927,2432;2434,0,0,1,0,1,2
4717,10,928,2435;9822,0,0,0,2,0,2
4718,10,929,2437,0,0,0,0,1,1
4719,10,930,2439;2440;2441;2442,0,0,1,3,0,4
4720,10,931,2444;2445;2446,0,0,0,1,2,3
4721,10,932,2448;2449,0,0,0,1,1,2
4722,10,933,2450,0,0,0,0,1,1
4723,10,934,2452,0,0,0,0,1,1
4724,10,935,2453;2454;2456,0,0,0,3,0,3
4725,10,936,2457,0,0,0,0,1,1
4726,10,937,777;2460,0,0,0,2,0,2
4727,10,938,2465;2466;2467,0,0,0,1,2,3
4728,10,939,2469,0,0,0,0,1,1
4729,10,940,2471;2472;10319;10384;10451,0,0,3,2,0,5
4730,10,941,2473;2474;2475;2476,0,0,2,1,1,4
4731,10,942,2479;2481,0,0,0,2,0,2
4732,10,943,2482,0,0,0,0,1,1
4733,10,944,2484;2485,0,0,0,2,0,2
4734,10,946,2487,0,0,0,1,0,1
4735,10,947,2488;2489,0,0,0,2,0,2
4736,10,949,2496;2497;2498;2499,0,0,0,3,1,4
4737,10,950,2501;2502;2503,0,0,0,2,1,3
4738,10,951,2504;2505,0,0,0,0,2,2
4739,10,952,2511;4058,0,0,0,0,2,2
4740,10,953,458;2513;10847;10997,0,2,0,2,0,4
4741,10,954,2514;2515;2516,0,0,0,1,2,3
4742,10,955,2518,0,0,0,0,1,1
4743,10,956,2519;2520,0,0,0,1,1,2
4744,10,957,2521;2522;2523;2524,0,0,2,1,1,4
4745,10,958,2528;2529,0,0,0,0,2,2
4746,10,959,2530;2531,0,0,0,0,2,2
4747,10,960,2533;2534,0,0,1,1,0,2
4748,10,961,2536;8772,0,0,0,2,0,2
4749,10,962,2537;2538;2539,0,0,1,1,1,3
4750,10,964,2541;2542;2545,0,0,1,1,1,3
4751,10,965,2547,0,0,0,1,0,1
4752,10,966,2548;2549,0,0,0,1,1,2
4753,10,967,2550;5401,0,0,0,2,0,2
4754,10,968,2551;2552,0,0,0,2,0,2
4755,10,969,2553;2554;2555,0,0,0,3,0,3
4756,10,970,2558;9123,0,0,0,2,0,2
4757,10,972,2564;10109;10401;10637;10763,0,2,2,1,0,5
4758,10,973,2565;2566,0,0,0,0,2,2
4759,10,974,2567;2568,0,0,0,2,0,2
4760,10,976,2571;2573,0,0,0,1,1,2
4761,10,977,2574;10005;10340;10536,0,0,3,1,0,4
4762,10,978,2576;2577,0,0,0,1,1,2
4763,10,979,1816;2579;2581,0,0,0,3,0,3
4764,10,981,2585,0,0,0,1,0,1
4765,10,982,2587,0,0,0,0,1,1
4766,10,983,2588;2589,0,0,0,1,1,2
4767,10,984,2590,0,0,0,0,1,1
4768,10,985,2593;6767;10599;10629,0,1,1,2,0,4
4769,10,986,2596,0,0,0,0,1,1
4770,10,987,2597;2598,0,0,1,1,0,2
4771,10,988,2599;2600,0,0,0,2,0,2
4772,10,989,2602;7829;10262;11074,0,1,1,2,0,4
4773,10,990,2603;2604;2605;2606,0,0,0,2,2,4
4774,10,991,2607;2608,0,0,0,1,1,2
4775,10,992,2185;2609,0,0,0,2,0,2
4776,10,993,2611,0,0,0,0,1,1
4777,10,994,2613;10530;10641,0,1,1,1,0,3
4778,10,995,2614;2615;10707;11000,0,2,0,1,1,4
4779,10,997,2617;9730,0,0,0,2,0,2
4780,10,998,2618;2619;2620;2621,0,0,0,3,1,4
4781,10,999,2624,0,0,0,0,1,1
4782,10,1000,2626;2627,0,0,0,0,2,2
4783,10,1001,2630;10068;10173;10474,0,0,3,1,0,4
4784,10,1002,2631;2632,0,0,0,1,1,2
4785,10,1003,2634,0,0,0,1,0,1
4786,10,1004,2635;2636,0,0,0,1,1,2
4787,10,1005,2506;2637,0,0,0,2,0,2
4788,10,1006,2638;2639,0,0,0,1,1,2
4789,10,1007,2640;2641,0,0,0,2,0,2
4790,10,1008,2643,0,0,0,0,1,1
4791,10,1010,2645;2646;2647;2648,0,0,0,2,2,4
4792,10,1011,2650,0,0,0,0,1,1
4793,10,1012,2652;2653;2654,0,0,0,2,1,3
4794,10,1013,2658;10004;10337;10834,0,1,2,1,0,4
4795,10,1015,2660;2661,0,0,0,1,1,2
4796,10,1016,2662;8181,0,0,0,2,0,2
4797,10,1017,2664;2665,0,0,0,0,2,2
4798,10,1018,2666;2668;2669,0,0,0,3,0,3
4799,10,1019,2672;2673,0,0,0,2,0,2
4800,10,1020,2675,0,0,0,0,1,1
4801,10,1022,2678;2680,0,0,0,1,1,2
4802,10,1023,2683;2684,0,0,0,1,1,2
4803,10,1024,2685;2686;2689,0,0,0,1,2,3
4804,10,1025,2690;2691;2694,0,0,0,3,0,3
4805,10,1026,2695,0,0,0,0,1,1
4806,10,1027,2696,0,0,0,1,0,1
4807,10,1028,2697,0,0,0,1,0,1
4808,10,1029,2698;2699;2701,0,0,1,2,0,3
4809,10,1030,2702,0,0,0,1,0,1
4810,10,1032,2704,0,0,0,0,1,1
4811,10,1033,2705;2706;2707,0,0,0,2,1,3
4812,10,1034,2708,0,0,0,1,0,1
4813,10,1035,2709;2710,0,0,0,1,1,2
4814,10,1036,2711;2872,0,0,0,2,0,2
4815,10,1037,2712,0,0,0,1,0,1
4816,10,1038,2713,0,0,0,0,1,1
4817,10,1039,2716,0,0,0,1,0,1
4818,10,1040,2719;2721,0,0,0,0,2,2
4819,10,1042,2725;3898,0,0,0,2,0,2
4820,10,1043,2726;2727;2728;2729,0,0,2,1,1,4
4821,10,1044,2732,0,0,0,0,1,1
4822,10,1045,2734;2738,0,0,1,0,1,2
4823,10,1046,2739;2740,0,0,0,1,1,2
4824,10,1047,2746,0,0,0,0,1,1
4825,10,1048,2749;2751,0,0,1,1,0,2
4826,10,1049,2752,0,0,0,0,1,1
4827,10,1052,9490,0,0,0,1,0,1
4828,10,1053,2759;2760,0,0,1,1,0,2
4829,10,1054,2761;4730,0,0,0,0,2,2
4830,10,1055,2323;2763;2764,0,0,1,0,2,3
4831,10,1056,2767,0,0,0,0,1,1
4832,10,1057,2768,0,0,0,0,1,1
4833,10,1058,2769,0,0,0,0,1,1
4834,10,1059,2773;2774;2775;8322,0,0,2,2,0,4
4835,10,1060,2778,0,0,0,0,1,1
4836,10,1061,2779;2780,0,0,0,1,1,2
4837,10,1062,2782;2783;2784,0,0,1,1,1,3
4838,10,1063,2786;2789,0,0,1,1,0,2
4839,10,1064,2790,0,0,0,0,1,1
4840,10,1065,1532;2793,0,0,0,2,0,2
4841,10,1066,2794,0,0,0,0,1,1
4842,10,1067,2796;2797;2799,0,0,0,3,0,3
4843,10,1068,2801;2803,0,0,0,1,1,2
4844,10,1069,2806;2807,0,0,0,2,0,2
4845,10,1070,2810;2811;2812;3041;10582;10969;11016,0,2,1,4,0,7
4846,10,1071,2813;2814;2816;2818,0,0,1,2,1,4
4847,10,1072,2819;2820,0,0,0,1,1,2
4848,10,1073,2821;2822;10560;10804,0,1,1,2,0,4
4849,10,1074,2823;10006;10618,0,1,1,1,0,3
4850,10,1075,2826;2828,0,0,0,0,2,2
4851,10,1076,2829;2830,0,0,0,2,0,2
4852,10,1077,2831;2833,0,0,0,1,1,2
4853,10,1079,2836;2837;2838;2839,0,0,0,2,2,4
4854,10,1081,2844;2845,0,0,0,1,1,2
4855,10,1082,2846,0,0,0,0,1,1
4856,10,1084,2852,0,0,0,1,0,1
4857,10,1085,2854;2855,0,0,1,0,1,2
4858,10,1086,2856;2857,0,0,0,2,0,2
4859,10,1087,2859;2860;2861,0,0,0,1,2,3
4860,10,1088,2862;8362,0,0,0,2,0,2
4861,10,1089,2866;2867,0,0,0,1,1,2
4862,10,1090,2868;2869;2870;2871,0,0,2,2,0,4
4863,10,1091,2874;2875;2876,0,0,1,2,0,3
4864,10,1092,2877;2878,0,0,0,1,1,2
4865,10,1093,2880;2881;3190;10087;10380,0,0,2,3,0,5
4866,10,1094,2882,0,0,0,1,0,1
4867,10,1095,2884;7643,0,0,0,2,0,2
4868,10,1096,264;2885;10023;10393,0,0,2,2,0,4
4869,10,1098,3436,0,0,0,1,0,1
4870,10,1100,2894;2896,0,0,1,0,1,2
4871,10,1101,2897;7116,0,0,0,2,0,2
4872,10,1102,2898;2899,0,0,0,1,1,2
4873,10,1103,2900;5350;5353,0,0,0,3,0,3
4874,10,1104,2902;2903,0,0,0,2,0,2
4875,10,1105,2904;2905;10508,0,0,1,2,0,3
4876,10,1106,2906;2907,0,0,0,1,1,2
4877,10,1108,2909;2910;8689,0,0,1,1,1,3
4878,10,1109,2911;9702,0,0,0,2,0,2
4879,10,1110,2912,0,0,0,1,0,1
4880,10,1111,2915;2916,0,0,0,2,0,2
4881,10,1113,2918;2919;2920;3342;10260,0,0,2,3,0,5
4882,10,1115,2923;2924,0,0,0,1,1,2
4883,10,1116,1994;2926,0,0,0,2,0,2
4884,10,1117,2927,0,0,0,0,1,1
4885,10,1119,1545;2933,0,0,1,0,1,2
4886,10,1121,2937;2938,0,0,0,1,1,2
4887,10,1122,2939;2940,0,0,0,1,1,2
4888,10,1123,2941;10489;10604,0,0,2,1,0,3
4889,10,1124,2944;6972,0,0,0,2,0,2
4890,10,1125,2945,0,0,0,0,1,1
4891,10,1126,11;2946;2947;2948;2950,0,0,1,3,1,5
4892,10,1127,2954,0,0,0,0,1,1
4893,10,1128,2955;2956,0,0,0,2,0,2
4894,10,1129,2957;2958;2959;2960,0,0,0,3,1,4
4895,10,1130,2962;2963;2964;2965;6384,0,0,3,2,0,5
4896,10,1132,2968,0,0,0,0,1,1
4897,10,1133,2969;2972,0,0,0,1,1,2
4898,10,1134,2973;2974;2975;2976,0,0,2,2,0,4
4899,10,1135,2977;2978;2979;2980,0,0,0,3,1,4
4900,10,1136,2981;2982,0,0,0,2,0,2
4901,10,1137,2983;2984;2985,0,0,0,1,2,3
4902,10,1138,2987;8079,0,0,0,2,0,2
4903,10,1139,2988;2989,0,0,0,2,0,2
4904,10,1140,2990;2991,0,0,0,0,2,2
4905,10,1141,2992,0,0,0,0,1,1
4906,10,1142,2994;2995;2996;10089;10274;10446,0,0,4,2,0,6
4907,10,1144,3000;3003,0,0,1,0,1,2
4908,10,1145,3005;3006;3007,0,0,1,1,1,3
4909,10,1146,3008;3011,0,0,0,2,0,2
4910,10,1147,3013;3014,0,0,0,1,1,2
4911,10,1148,3015,0,0,0,0,1,1
4912,10,1149,3017;3018;3019;10035;10272,0,0,3,2,0,5
4913,10,1150,3020;3021,0,0,0,0,2,2
4914,10,1151,3022;3023,0,0,0,2,0,2
4915,10,1152,3024;10950,0,1,0,1,0,2
4916,10,1153,3025;3026;3028;3029,0,0,2,2,0,4
4917,10,1154,3030;3031;3033;3034,0,0,0,1,3,4
4918,10,1155,3035,0,0,0,0,1,1
4919,10,1156,3036;3037,0,0,0,1,1,2
4920,10,1157,3042;3045;3046,0,0,1,2,0,3
4921,10,1158,3047;3048,0,0,0,1,1,2
4922,10,1159,3049,0,0,0,0,1,1
4923,10,1160,3051;3052,0,0,0,0,2,2
4924,10,1161,3053;3054;3055,0,0,1,1,1,3
4925,10,1162,3057;3058,0,0,1,0,1,2
4926,10,1163,3059;3060;3061;7316,0,0,1,1,2,4
4927,10,1164,3063,0,0,0,0,1,1
4928,10,1165,3067;3068;3070;3071,0,0,1,2,1,4
4929,10,1166,8867;10653;10721;10812,0,3,0,1,0,4
4930,10,1167,3073;3074,0,0,0,2,0,2
4931,10,1168,3076;3077;3078,0,0,0,3,0,3
4932,10,1169,3079,0,0,0,0,1,1
4933,10,1170,3080;8824;10448;10798;11034,0,2,1,2,0,5
4934,10,1171,3081,0,0,0,1,0,1
4935,10,1172,1412;3084;3086;3087,0,0,0,4,0,4
4936,10,1174,3089;3090,0,0,0,0,2,2
4937,10,1175,3091;3092;3093,0,0,0,2,1,3
4938,10,1176,3095;3096,0,0,0,1,1,2
4939,10,1177,3097;3098;3099,0,0,0,1,2,3
4940,10,1178,3102,0,0,0,0,1,1
4941,10,1180,3105;3106;3108;10962,0,1,1,1,1,4
4942,10,1181,3109;3110;3111,0,0,1,2,0,3
4943,10,1184,3115;3118,0,0,1,0,1,2
4944,10,1185,745;3119;3120;3121;3122,0,0,1,4,0,5
4945,10,1186,3124;3125;3126;3127,0,0,2,2,0,4
4946,10,1187,4236,0,0,0,1,0,1
4947,10,1189,3131,0,0,0,1,0,1
4948,10,1190,3134;3135;3136;3137,0,0,1,2,1,4
4949,10,1191,3138;3139;3141,0,0,1,1,1,3
4950,10,1192,3142;6513;10320,0,0,1,2,0,3
4951,10,1193,3144;3145;3146;6922;10444;10779,0,1,3,2,0,6
4952,10,1194,3147;3148,0,0,0,1,1,2
4953,10,1195,3149,0,0,0,0,1,1
4954,10,1196,3150;3151,0,0,0,2,0,2
4955,10,1197,3152,0,0,0,0,1,1
4956,10,1198,3153;3156;4330,0,0,1,2,0,3
4957,10,1199,3158;3159;3161,0,0,0,2,1,3
4958,10,1200,3162;3163,0,0,0,1,1,2
4959,10,1202,3169;10154;10773,0,1,1,1,0,3
4960,10,1203,3170;9080,0,0,0,2,0,2
4961,10,1204,3171,0,0,0,1,0,1
4962,10,1205,102;3175,0,0,0,2,0,2
4963,10,1206,212;3176;3178,0,0,0,3,0,3
4964,10,1207,3179;3180,0,0,0,1,1,2
4965,10,1208,3181;3182,0,0,0,2,0,2
4966,10,1209,3140;3184,0,0,0,2,0,2
4967,10,1210,3187;6504;10436;10722,0,1,1,2,0,4
4968,10,1211,3188;3191;3193,0,0,0,1,2,3
4969,10,1212,3194,0,0,0,0,1,1
4970,10,1213,3196;3197;3198,0,0,0,2,1,3
4971,10,1214,3199;3200;3201,0,0,0,2,1,3
4972,10,1215,3203;3204,0,0,0,1,1,2
4973,10,1216,3205;3206;3208;3209,0,0,1,3,0,4
4974,10,1217,3210;3211,0,0,0,1,1,2
4975,10,1218,3213;3215,0,0,0,1,1,2
4976,10,1219,3216;3217;3218,0,0,0,1,2,3
4977,10,1220,3220;3221;3222;10014;10250;10569,0,0,3,3,0,6
4978,10,1221,3223,0,0,0,0,1,1
4979,10,1222,3226;3227,0,0,0,1,1,2
4980,10,1223,3228;3229,0,0,0,2,0,2
4981,10,1224,3230;3231;3233;3234,0,0,1,2,1,4
4982,10,1225,3236;3237;3240;3241;7712,0,0,1,3,1,5
4983,10,1226,3242,0,0,0,1,0,1
4984,10,1227,3244;3246;3247,0,0,2,1,0,3
4985,10,1229,520;3249,0,0,0,2,0,2
4986,10,1231,3251;3252,0,0,0,1,1,2
4987,10,1232,3253;3255;3256;10269,0,0,2,2,0,4
4988,10,1233,3257;3258,0,0,0,2,0,2
4989,10,1234,3259;3260,0,0,0,2,0,2
4990,10,1235,3261;3262;10636;10833;10992,0,3,0,1,1,5
4991,10,1236,7414,0,0,0,1,0,1
4992,10,1237,3264;3265;3266;3267,0,0,2,1,1,4
4993,10,1238,3268;3269,0,0,0,1,1,2
4994,10,1239,3270;3760,0,0,0,2,0,2
4995,10,1240,3272;3273,0,0,0,0,2,2
4996,10,1241,3275;3276,0,0,0,2,0,2
4997,10,1242,3278;8770,0,0,0,2,0,2
4998,10,1243,3279;3280,0,0,0,2,0,2
4999,10,1244,3282;3283,0,0,0,1,1,2
5000,10,1245,3284;3285;10434;10520;10677,0,1,2,1,1,5
5001,10,1247,3287;3288;3289,0,0,0,1,2,3
5002,10,1248,3290;3292,0,0,0,2,0,2
5003,10,1250,3294;3295;3296,0,0,0,2,1,3
5004,10,1251,3297;3298,0,0,0,1,1,2
5005,10,1252,3299;9157,0,0,0,0,2,2
5006,10,1253,3300;3301,0,0,0,1,1,2
5007,10,1254,3303,0,0,0,1,0,1
5008,10,1255,3306;3307;3309,0,0,0,1,2,3
5009,10,1256,3310;3311,0,0,0,1,1,2
5010,10,1257,3313;3314,0,0,0,2,0,2
5011,10,1258,3317;3318;7476,0,0,1,2,0,3
5012,10,1259,3319;3320,0,0,0,1,1,2
5013,10,1261,3323;3324,0,0,0,0,2,2
5014,10,1263,3326;3327,0,0,0,0,2,2
5015,10,1265,3330;9287,0,0,0,2,0,2
5016,10,1266,3331,0,0,0,1,0,1
5017,10,1267,3334,0,0,0,0,1,1
5018,10,1269,3340;3341,0,0,1,0,1,2
5019,10,1272,3344;3345;3346,0,0,0,2,1,3
5020,10,1273,3347;3348,0,0,0,1,1,2
5021,10,1274,3349;3350,0,0,0,1,1,2
5022,10,1275,3352;3353;3356,0,0,1,0,2,3
5023,10,1276,3357;3358;3359,0,0,1,1,1,3
5024,10,1277,3360;3361;3363,0,0,0,2,1,3
5025,10,1279,3365;3366;3367,0,0,2,0,1,3
5026,10,1280,3368;3369,0,0,0,2,0,2
5027,10,1281,3370;3371,0,0,0,2,0,2
5028,10,1282,3372;3373;3375;3376,0,0,1,2,1,4
5029,10,1283,3378;3379;3381,0,0,0,2,1,3
5030,10,1284,3382;3383,0,0,0,1,1,2
5031,10,1285,3384;3385;3386;3387;3388;10867,0,1,1,4,0,6
5032,10,1286,3390;3392,0,0,0,2,0,2
5033,10,1287,3393;3394;3396;9940,0,0,1,2,1,4
5034,10,1288,3398;3399;3401;3402;3403,0,0,1,2,2,5
5035,10,1289,3404;7760,0,0,0,2,0,2
5036,10,1290,3408;3409;10301;10523;10859,0,1,2,2,0,5
5037,10,1291,3410;3891,0,0,0,2,0,2
5038,10,1292,3411;7843;10977,0,1,0,2,0,3
5039,10,1293,887;3412,0,0,0,2,0,2
5040,10,1294,3413;3414,0,0,0,1,1,2
5041,10,1295,3415;3416;3417;3418;3420,0,0,1,3,1,5
5042,10,1296,3421;7862,0,0,0,0,2,2
5043,10,1297,3422;3423;3424,0,0,1,2,0,3
5044,10,1299,3426;3427;3428;3429,0,0,0,4,0,4
5045,10,1300,3430;3431,0,0,0,1,1,2
5046,10,1301,3185;3433;3434,0,0,1,0,2,3
5047,10,1302,3439;3440,0,0,0,1,1,2
5048,10,1304,3443;3445,0,0,0,0,2,2
5049,10,1305,3446,0,0,0,0,1,1
5050,10,1306,3447;3448,0,0,0,1,1,2
5051,10,1307,3453,0,0,0,0,1,1
5052,10,1308,3455;3458;6035,0,0,1,2,0,3
5053,10,1309,3459,0,0,0,1,0,1
5054,10,1310,3460;9297,0,0,0,2,0,2
5055,10,1311,3461;3462,0,0,0,2,0,2
5056,10,1313,3465;3466;3468,0,0,0,1,2,3
5057,10,1314,1839;3470;3471;3472,0,0,1,2,1,4
5058,10,1315,3474;3475;3476;3478;7342;10509,0,0,2,4,0,6
5059,10,1316,3479;3480;3481,0,0,1,2,0,3
5060,10,1317,3482,0,0,0,0,1,1
5061,10,1318,3483,0,0,0,0,1,1
5062,10,1320,2326;3487,0,0,0,2,0,2
5063,10,1321,3488;3489,0,0,0,1,1,2
5064,10,1322,3490;3492;3493,0,0,1,1,1,3
5065,10,1323,3494;3495;3496,0,0,0,1,2,3
5066,10,1324,3497;3787,0,0,0,2,0,2
5067,10,1325,3498;3499,0,0,0,0,2,2
5068,10,1326,3500;3501;3503;3504,0,0,2,1,1,4
5069,10,1327,3505;3507;8633,0,0,1,2,0,3
5070,10,1328,3508;3967,0,0,0,2,0,2
5071,10,1329,3509;10341,0,0,1,1,0,2
5072,10,1330,3510;3622,0,0,0,2,0,2
5073,10,1331,3511;3512;10149;10170;10282;10419,0,0,4,2,0,6
5074,10,1332,3513;3514;10594,0,0,1,1,1,3
5075,10,1333,3515;3516;3517,0,0,1,1,1,3
5076,10,1334,3519;3520,0,0,0,2,0,2
5077,10,1336,3525;4608,0,0,0,2,0,2
5078,10,1337,3526;3527;10872,0,1,0,2,0,3
5079,10,1338,3528;3529;3530,0,0,0,3,0,3
5080,10,1339,3532;3534;10095;10113;10163,0,0,3,2,0,5
5081,10,1340,3535,0,0,0,0,1,1
5082,10,1341,3536,0,0,0,0,1,1
5083,10,1342,3541;10819;10991,0,2,0,1,0,3
5084,10,1344,3546;3547,0,0,0,2,0,2
5085,10,1346,3551;3552;3553,0,0,0,1,2,3
5086,10,1347,3554;3555,0,0,0,2,0,2
5087,10,1348,3556;3557,0,0,0,1,1,2
5088,10,1349,3558;3561,0,0,1,0,1,2
5089,10,1350,3564,0,0,0,0,1,1
5090,10,1352,3569;3570,0,0,0,2,0,2
5091,10,1353,3571;3572;3573;3575,0,0,0,3,1,4
5092,10,1354,3576;3578,0,0,1,1,0,2
5093,10,1356,3580,0,0,0,1,0,1
5094,10,1357,3581;6931,0,0,0,2,0,2
5095,10,1358,3584;3585,0,0,0,0,2,2
5096,10,1359,3587;3588;3589;3591;3592,0,0,2,0,3,5
5097,10,1360,3593;3594;3595,0,0,0,3,0,3
5098,10,1361,3597,0,0,0,1,0,1
5099,10,1362,2754;3599;3600;3601,0,0,2,2,0,4
5100,10,1363,3602;3603,0,0,0,1,1,2
5101,10,1364,3604;3605,0,0,0,0,2,2
5102,10,1365,3606,0,0,0,0,1,1
5103,10,1367,3609;3611;3612,0,0,0,3,0,3
5104,10,1368,3614;3615,0,0,1,0,1,2
5105,10,1370,3618,0,0,0,1,0,1
5106,10,1371,3619;3620,0,0,0,1,1,2
5107,10,1373,3623;6060,0,0,0,2,0,2
5108,10,1374,3624,0,0,0,1,0,1
5109,10,1376,3628;3630,0,0,0,0,2,2
5110,10,1377,3631;3632,0,0,0,1,1,2
5111,10,1378,3635,0,0,0,1,0,1
5112,10,1379,3637,0,0,0,1,0,1
5113,10,1380,3640;3642,0,0,0,0,2,2
5114,10,1381,3644,0,0,0,1,0,1
5115,10,1382,3649,0,0,0,0,1,1
5116,10,1383,3651;3652,0,0,0,2,0,2
5117,10,1385,3654;3655;3656,0,0,0,2,1,3
5118,10,1386,3657;3658,0,0,0,2,0,2
5119,10,1387,3659;3660,0,0,0,0,2,2
5120,10,1389,3663,0,0,0,0,1,1
5121,10,1390,3666,0,0,0,0,1,1
5122,10,1391,3668;3669,0,0,0,1,1,2
5123,10,1392,3670;3671;3673;3674,0,0,0,2,2,4
5124,10,1393,3676;3677;3678;3679,0,0,1,2,1,4
5125,10,1394,3680;6550,0,0,0,2,0,2
5126,10,1395,3682;10094;10158,0,0,2,1,0,3
5127,10,1396,3683;3684;3685,0,0,0,2,1,3
5128,10,1397,3686;3687,0,0,0,2,0,2
5129,10,1398,3688;3689;3691,0,0,0,2,1,3
5130,10,1400,3694;3696;8487,0,0,0,3,0,3
5131,10,1401,3697;3698;3699;3700;8225,0,0,0,5,0,5
5132,10,1402,3701;3702,0,0,0,0,2,2
5133,10,1403,3703;7711,0,0,0,2,0,2
5134,10,1405,3707;3709;3710,0,0,1,1,1,3
5135,10,1406,3711;3713,0,0,1,0,1,2
5136,10,1407,3714;3716;3717,0,0,0,3,0,3
5137,10,1408,3718;8269,0,0,0,2,0,2
5138,10,1409,3719;3720,0,0,0,1,1,2
5139,10,1410,3721;3722,0,0,0,2,0,2
5140,10,1411,3723;3724;3725;3726;3727,0,0,0,5,0,5
5141,10,1412,3728;3729;3730;3731,0,0,1,3,0,4
5142,10,1414,3734;3735,0,0,1,0,1,2
5143,10,1415,3737;3738,0,0,0,2,0,2
5144,10,1416,3739;9990,0,0,0,2,0,2
5145,10,1418,3742;3743,0,0,0,1,1,2
5146,10,1419,3744;3745,0,0,0,1,1,2
5147,10,1420,3746;3747,0,0,0,2,0,2
5148,10,1421,3751;3752;3753,0,0,0,2,1,3
5149,10,1422,3755,0,0,0,1,0,1
5150,10,1423,3756;3757,0,0,0,1,1,2
5151,10,1425,3761;6156;6158;6159;10085;10233;10325;10528,0,0,5,3,0,8
5152,10,1426,3763;5978;10037;10251;10360,0,0,3,2,0,5
5153,10,1427,132;3766;3767;3768,0,0,0,4,0,4
5154,10,1428,3769,0,0,0,0,1,1
5155,10,1429,3771,0,0,0,0,1,1
5156,10,1430,7615;7900,0,0,0,2,0,2
5157,10,1431,3773,0,0,0,0,1,1
5158,10,1432,3774;3775;3776,0,0,1,1,1,3
5159,10,1433,3777;3779,0,0,0,0,2,2
5160,10,1434,3781;3782,0,0,0,2,0,2
5161,10,1435,3783;7420,0,0,0,0,2,2
5162,10,1436,3786,0,0,0,1,0,1
5163,10,1437,3788,0,0,0,1,0,1
5164,10,1438,3790,0,0,0,1,0,1
5165,10,1439,3793;3794,0,0,1,1,0,2
5166,10,1440,3795;3796;3797;3798;10197;10469,0,0,3,2,1,6
5167,10,1441,3800;3801,0,0,0,2,0,2
5168,10,1442,3804,0,0,0,0,1,1
5169,10,1443,3805;3806,0,0,0,2,0,2
5170,10,1444,3808;4190,0,0,0,2,0,2
5171,10,1445,3809;3810,0,0,0,2,0,2
5172,10,1446,1174;3814,0,0,0,2,0,2
5173,10,1447,3816,0,0,0,0,1,1
5174,10,1448,3818;3820,0,0,1,1,0,2
5175,10,1449,3821;8819,0,0,0,2,0,2
5176,10,1450,1043;3822,0,0,0,1,1,2
5177,10,1451,3791;3826,0,0,0,2,0,2
5178,10,1452,3827;3828,0,0,0,1,1,2
5179,10,1453,3830;3831;3832;3833;3834,0,0,0,4,1,5
5180,10,1455,3838;3839;3840;3841;3842,0,0,3,0,2,5
5181,10,1456,3843;3844,0,0,0,1,1,2
5182,10,1457,3845;3846;10414,0,0,1,1,1,3
5183,10,1458,3848;3849;3850;10870,0,1,0,3,0,4
5184,10,1459,3851;5474,0,0,0,2,0,2
5185,10,1460,3853,0,0,0,0,1,1
5186,10,1461,3855;3856,0,0,0,2,0,2
5187,10,1462,3857;3858;3859;3860,0,0,0,4,0,4
5188,10,1463,3861;3862;3863,0,0,1,2,0,3
5189,10,1465,3866,0,0,0,1,0,1
5190,10,1466,3870;3871;3873;3874,0,0,1,2,1,4
5191,10,1467,3875;3876,0,0,0,0,2,2
5192,10,1468,3880;4815;10874,0,1,0,2,0,3
5193,10,1469,3881,0,0,0,0,1,1
5194,10,1470,3114;3882;3883,0,0,0,2,1,3
5195,10,1471,3884;3885;3886,0,0,1,2,0,3
5196,10,1473,3888;3889,0,0,0,1,1,2
5197,10,1474,3890;3892,0,0,0,1,1,2
5198,10,1475,1306;1307;1308;3893;10115;10188;10243,0,0,5,2,0,7
5199,10,1476,3896;3897,0,0,0,1,1,2
5200,10,1479,3902;3904,0,0,0,1,1,2
5201,10,1480,3905;3906,0,0,0,0,2,2
5202,10,1481,3907;3908,0,0,0,2,0,2
5203,10,1483,3910;3911,0,0,0,1,1,2
5204,10,1485,3915;3917,0,0,0,0,2,2
5205,10,1486,3918;3920;3921,0,0,0,2,1,3
5206,10,1487,9622,0,0,0,1,0,1
5207,10,1488,3927,0,0,0,0,1,1
5208,10,1489,3928,0,0,0,0,1,1
5209,10,1490,3929;3930,0,0,0,1,1,2
5210,10,1491,3932;3933;3934,0,0,0,1,2,3
5211,10,1493,3938;3939,0,0,0,1,1,2
5212,10,1494,3941;3942,0,0,0,0,2,2
5213,10,1495,3943;3945,0,0,0,1,1,2
5214,10,1496,3948;3949,0,0,0,1,1,2
5215,10,1497,3950;3951;3952,0,0,1,1,1,3
5216,10,1498,2842;3954;3956;6424,0,0,0,4,0,4
5217,10,1499,3957;3958;3963,0,0,0,1,2,3
5218,10,1500,3964;3965,0,0,0,1,1,2
5219,10,1501,3966;3968;3969;5790;10617,0,1,1,3,0,5
5220,10,1502,3970;3972,0,0,0,2,0,2
5221,10,1503,3973,0,0,0,0,1,1
5222,10,1504,3974;3977;3978,0,0,0,3,0,3
5223,10,1505,3979;3980,0,0,0,2,0,2
5224,10,1506,3981;9919;10241;10435;10775,0,1,2,2,0,5
5225,10,1508,3983;3984;3986;10145,0,0,2,2,0,4
5226,10,1509,3988,0,0,0,1,0,1
5227,10,1510,3989;3990,0,0,0,1,1,2
5228,10,1511,3991;3992,0,0,0,2,0,2
5229,10,1512,3274;3994;3995,0,0,0,3,0,3
5230,10,1513,3997,0,0,0,0,1,1
5231,10,1514,3999;7359;10966,0,1,0,2,0,3
5232,10,1515,4001;4004,0,0,0,1,1,2
5233,10,1516,4006,0,0,0,0,1,1
5234,10,1518,4009;4010,0,0,0,2,0,2
5235,10,1519,4011,0,0,0,1,0,1
5236,10,1520,4012;4013,0,0,0,1,1,2
5237,10,1521,4014;4016,0,0,0,2,0,2
5238,10,1524,4019;4021;4023,0,0,1,2,0,3
5239,10,1525,4024;4025,0,0,0,1,1,2
5240,10,1526,4028,0,0,0,1,0,1
5241,10,1527,4029;5177,0,0,0,2,0,2
5242,10,1529,4032;4034,0,0,0,2,0,2
5243,10,1531,4038;10079;10204;10660,0,1,2,1,0,4
5244,10,1533,761;4042,0,0,0,2,0,2
5245,10,1535,4050;4052;10352;10521,0,0,2,2,0,4
5246,10,1536,4054;4055;4056;4057,0,0,2,1,1,4
5247,10,1538,4059;4060;4062,0,0,0,2,1,3
5248,10,1540,506;4065,0,0,0,2,0,2
5249,10,1541,4066;4067,0,0,0,1,1,2
5250,10,1542,4068;4069;4070,0,0,0,2,1,3
5251,10,1543,4071;4072;4074;4075,0,0,2,1,1,4
5252,10,1544,4076;4077,0,0,0,1,1,2
5253,10,1545,4078;4079,0,0,0,0,2,2
5254,10,1546,4080;4081,0,0,0,1,1,2
5255,10,1548,4083;4086,0,0,0,0,2,2
5256,10,1551,4090;4091;4092;4093,0,0,3,0,1,4
5257,10,1554,4097,0,0,0,0,1,1
5258,10,1555,4098;9106,0,0,0,2,0,2
5259,10,1556,4099;4100,0,0,0,2,0,2
5260,10,1557,4104;4106,0,0,1,1,0,2
5261,10,1558,4107;4109,0,0,0,2,0,2
5262,10,1559,4110,0,0,0,1,0,1
5263,10,1560,4113;4114,0,0,0,0,2,2
5264,10,1562,4117,0,0,0,1,0,1
5265,10,1563,4119;4120,0,0,0,1,1,2
5266,10,1564,4121,0,0,0,0,1,1
5267,10,1565,4123;4124;10792,0,1,0,1,1,3
5268,10,1567,4126,0,0,0,1,0,1
5269,10,1568,4128;5803,0,0,0,0,2,2
5270,10,1569,4130;4132,0,0,0,0,2,2
5271,10,1570,4133,0,0,0,1,0,1
5272,10,1572,4135;5626;10018;10346;10748,0,1,2,2,0,5
5273,10,1573,4137,0,0,0,0,1,1
5274,10,1574,4139;4140;9432,0,0,0,3,0,3
5275,10,1575,1695;4142,0,0,0,2,0,2
5276,10,1576,4143;4144,0,0,0,1,1,2
5277,10,1577,4145;4147;4150;4151,0,0,2,1,1,4
5278,10,1578,4152,0,0,0,1,0,1
5279,10,1579,4153;4154,0,0,0,2,0,2
5280,10,1581,4157;4158,0,0,0,2,0,2
5281,10,1583,4161;4162;10496,0,0,1,2,0,3
5282,10,1584,4163;4164,0,0,0,0,2,2
5283,10,1585,4167;4168,0,0,0,1,1,2
5284,10,1586,4171;7645,0,0,0,2,0,2
5285,10,1587,4172;6850;10124,0,0,1,2,0,3
5286,10,1588,4174;4175;10498;10515,0,0,2,1,1,4
5287,10,1589,4176;4177,0,0,0,1,1,2
5288,10,1590,4179,0,0,0,0,1,1
5289,10,1591,4181;4182,0,0,0,0,2,2
5290,10,1592,4183,0,0,0,1,0,1
5291,10,1593,4185;4186;4189,0,0,0,3,0,3
5292,10,1595,4192;4193,0,0,0,2,0,2
5293,10,1596,4194,0,0,0,0,1,1
5294,10,1598,4199;7907;10190;11064,0,1,1,2,0,4
5295,10,1599,4200;4202,0,0,0,0,2,2
5296,10,1600,4203;4204,0,0,0,1,1,2
5297,10,1601,4205;7021,0,0,0,2,0,2
5298,10,1602,4206;4207;4208;4210;10460,0,0,1,3,1,5
5299,10,1605,4215,0,0,0,1,0,1
5300,10,1606,4217;4218;4219;4221,0,0,1,2,1,4
5301,10,1607,4222;4223,0,0,0,2,0,2
5302,10,1608,4225;4226,0,0,0,1,1,2
5303,10,1609,4227;4229;10956,0,1,1,1,0,3
5304,10,1611,3982;4232,0,0,0,2,0,2
5305,10,1612,4234;4235,0,0,1,0,1,2
5306,10,1614,4237;4238,0,0,0,1,1,2
5307,10,1616,4240;4241,0,0,0,2,0,2
5308,10,1617,4242,0,0,0,0,1,1
5309,10,1618,4245;4246;10552,0,0,1,1,1,3
5310,10,1619,4247;4249,0,0,0,0,2,2
5311,10,1620,4251;4252,0,0,0,1,1,2
5312,10,1621,4253;4490,0,0,0,2,0,2
5313,10,1622,4255;4256;4257;4258,0,0,0,4,0,4
5314,10,1623,4260;9581,0,0,0,2,0,2
5315,10,1624,2731;4261,0,0,0,2,0,2
5316,10,1625,4262;6795,0,0,0,2,0,2
5317,10,1626,4263;4264;10123;10697,0,1,1,1,1,4
5318,10,1627,4265;4267;4268,0,0,0,2,1,3
5319,10,1628,4269;4270;4271;4272;4273,0,0,0,5,0,5
5320,10,1629,4275;4278;4279;6140,0,0,0,4,0,4
5321,10,1630,4284;6157,0,0,0,2,0,2
5322,10,1631,4286;4288,0,0,0,1,1,2
5323,10,1632,4290;5049,0,0,0,2,0,2
5324,10,1633,4291;5841;10334;10683;10836;10965,0,3,1,2,0,6
5325,10,1634,4292;4294;4295,0,0,1,2,0,3
5326,10,1635,4296;4297,0,0,0,2,0,2
5327,10,1636,4298;4299;10007;10681,0,1,1,2,0,4
5328,10,1637,4300;4301,0,0,0,0,2,2
5329,10,1638,4302;4303;4304,0,0,1,0,2,3
5330,10,1639,4305;4306;4307;10705,0,1,0,2,1,4
5331,10,1641,4310;4311,0,0,0,2,0,2
5332,10,1643,4316;4317,0,0,0,2,0,2
5333,10,1644,728,0,0,0,1,0,1
5334,10,1645,4319;4320;10315,0,0,1,2,0,3
5335,10,1646,4322,0,0,0,0,1,1
5336,10,1647,4323;4324,0,0,0,1,1,2
5337,10,1650,4328;4329,0,0,0,2,0,2
5338,10,1652,4332,0,0,0,1,0,1
5339,10,1653,4333;4492;10860,0,1,0,2,0,3
5340,10,1654,4334;4335;4337,0,0,1,2,0,3
5341,10,1655,4339,0,0,0,0,1,1
5342,10,1656,4341,0,0,0,0,1,1
5343,10,1657,4343,0,0,0,0,1,1
5344,10,1658,4344;10781,0,1,0,1,0,2
5345,10,1659,4345,0,0,0,1,0,1
5346,10,1661,4349;4350,0,0,0,1,1,2
5347,10,1662,4351;4352,0,0,0,1,1,2
5348,10,1663,4355;4356,0,0,0,1,1,2
5349,10,1664,4357;10864,0,1,0,1,0,2
5350,10,1665,4358;5267,0,0,0,2,0,2
5351,10,1666,4359;4360,0,0,0,0,2,2
5352,10,1667,4361,0,0,0,0,1,1
5353,10,1668,4364,0,0,0,1,0,1
5354,10,1669,2279;4365,0,0,0,2,0,2
5355,10,1670,4366;4367;4369;4370,0,0,0,3,1,4
5356,10,1671,4371;4372;4374;4375,0,0,0,2,2,4
5357,10,1672,4376;4377,0,0,0,2,0,2
5358,10,1674,4382;4383;4385,0,0,1,1,1,3
5359,10,1675,4386;4387,0,0,0,1,1,2
5360,10,1676,4390,0,0,0,0,1,1
5361,10,1677,4391,0,0,0,1,0,1
5362,10,1678,4393,0,0,0,0,1,1
5363,10,1679,4396;4397;4398;4401,0,0,0,3,1,4
5364,10,1680,4402;4403,0,0,0,2,0,2
5365,10,1681,4404,0,0,0,0,1,1
5366,10,1684,4412;4413,0,0,0,2,0,2
5367,10,1685,4414,0,0,0,0,1,1
5368,10,1686,4417,0,0,0,1,0,1
5369,10,1687,4419;10584;11017,0,1,1,1,0,3
5370,10,1688,4420;4421,0,0,0,1,1,2
5371,10,1689,4422,0,0,0,0,1,1
5372,10,1690,4424,0,0,0,1,0,1
5373,10,1692,4428,0,0,0,1,0,1
5374,10,1694,4431,0,0,0,0,1,1
5375,10,1696,4433;4434;4435,0,0,0,3,0,3
5376,10,1697,4437;4438,0,0,0,2,0,2
5377,10,1699,4440;4441,0,0,0,1,1,2
5378,10,1701,4443;4445,0,0,0,2,0,2
5379,10,1702,4446;4447;4448,0,0,1,2,0,3
5380,10,1703,4450,0,0,0,1,0,1
5381,10,1704,4452;4453,0,0,0,2,0,2
5382,10,1705,4454;4455;4456,0,0,1,2,0,3
5383,10,1706,4457;4459,0,0,0,1,1,2
5384,10,1707,1831;4461;10258;10585,0,0,2,2,0,4
5385,10,1708,4463,0,0,0,1,0,1
5386,10,1710,4466,0,0,0,0,1,1
5387,10,1711,3002;4467,0,0,0,2,0,2
5388,10,1712,4468;4469;4470;4471,0,0,2,2,0,4
5389,10,1713,4472;4476;7669;10343;10485,0,0,3,2,0,5
5390,10,1714,4477;4478,0,0,0,1,1,2
5391,10,1715,4480;4481,0,0,0,1,1,2
5392,10,1716,4483;4484,0,0,0,2,0,2
5393,10,1717,4488,0,0,0,1,0,1
5394,10,1718,4491;4493,0,0,0,1,1,2
5395,10,1719,4494;5644;10305;10907;11005,0,2,1,2,0,5
5396,10,1720,4495;4496,0,0,0,1,1,2
5397,10,1721,4497;4498,0,0,0,1,1,2
5398,10,1722,4501;8221,0,0,0,2,0,2
5399,10,1723,4503;4504;4505,0,0,0,2,1,3
5400,10,1724,4507;4508,0,0,0,2,0,2
5401,10,1725,4512;4513;4515;4516,0,0,2,0,2,4
5402,10,1726,4517,0,0,0,1,0,1
5403,10,1727,4518;4519,0,0,0,0,2,2
5404,10,1728,4520;4521;4523,0,0,1,1,1,3
5405,10,1729,1549;10573;10716,0,1,1,1,0,3
5406,10,1730,4525;4526;10220;10351;10575,0,0,3,2,0,5
5407,10,1731,4529;4530,0,0,0,1,1,2
5408,10,1732,4531,0,0,0,1,0,1
5409,10,1734,4536;6082,0,0,0,2,0,2
5410,10,1735,4537,0,0,0,0,1,1
5411,10,1736,4538,0,0,0,1,0,1
5412,10,1737,4540;4541;4542;4543;4544;10740,0,1,1,4,0,6
5413,10,1738,2212;4545,0,0,0,2,0,2
5414,10,1739,4546;4547,0,0,0,2,0,2
5415,10,1741,4554,0,0,0,1,0,1
5416,10,1743,4557,0,0,0,0,1,1
5417,10,1744,4558;4559,0,0,0,2,0,2
5418,10,1745,4560;4561;9450;10290,0,0,2,2,0,4
5419,10,1746,4562;9359,0,0,0,2,0,2
5420,10,1747,4563;4565;8705,0,0,0,3,0,3
5421,10,1748,4566,0,0,0,1,0,1
5422,10,1749,4569;4570;4571,0,0,1,0,2,3
5423,10,1750,4573,0,0,0,0,1,1
5424,10,1752,4578;6401,0,0,0,2,0,2
5425,10,1753,4579;4580;4581;4582,0,0,0,3,1,4
5426,10,1754,4583,0,0,0,0,1,1
5427,10,1755,4584;4585;4587,0,0,1,2,0,3
5428,10,1756,4588;4590,0,0,0,1,1,2
5429,10,1757,4591;4594,0,0,0,2,0,2
5430,10,1758,1292;4597,0,0,0,2,0,2
5431,10,1759,4599,0,0,0,0,1,1
5432,10,1760,4602,0,0,0,1,0,1
5433,10,1761,4604;4606,0,0,0,1,1,2
5434,10,1762,4609;4610,0,0,0,1,1,2
5435,10,1764,4613;4614;4617,0,0,1,1,1,3
5436,10,1765,4618;8549,0,0,0,2,0,2
5437,10,1766,4620,0,0,0,1,0,1
5438,10,1767,4625,0,0,0,1,0,1
5439,10,1768,1820;4627;4629;4630,0,0,1,3,0,4
5440,10,1769,4631;4632;4633;4634,0,0,2,0,2,4
5441,10,1770,4635;4636,0,0,0,2,0,2
5442,10,1771,4638,0,0,0,1,0,1
5443,10,1772,4639;4640;4641,0,0,0,0,3,3
5444,10,1773,4642;4643,0,0,0,1,1,2
5445,10,1774,1422;4645,0,0,0,2,0,2
5446,10,1775,4646;4647,0,0,0,2,0,2
5447,10,1776,4650;4651,0,0,0,2,0,2
5448,10,1777,4653;4654;4656;5058;10541,0,0,2,3,0,5
5449,10,1778,4657;4658,0,0,0,1,1,2
5450,10,1779,4660,0,0,0,1,0,1
5451,10,1780,4661,0,0,0,1,0,1
5452,10,1781,4662,0,0,0,0,1,1
5453,10,1783,4664;4665,0,0,0,0,2,2
5454,10,1784,4666;4669,0,0,1,1,0,2
5455,10,1785,4670,0,0,0,0,1,1
5456,10,1786,4672,0,0,0,0,1,1
5457,10,1787,4673;6514;10289;10429;10507;10837;11014,0,2,3,2,0,7
5458,10,1788,4675;4676;4677,0,0,1,2,0,3
5459,10,1789,3778;4679;4680,0,0,0,3,0,3
5460,10,1790,4681;4682,0,0,0,1,1,2
5461,10,1791,4683;4684,0,0,0,1,1,2
5462,10,1792,4685;4686,0,0,0,2,0,2
5463,10,1793,4687;4688;4689;4690,0,0,0,4,0,4
5464,10,1794,4691;4692;4693,0,0,0,3,0,3
5465,10,1795,4695;4696,0,0,0,0,2,2
5466,10,1796,4697;4698;4699;4700,0,0,2,0,2,4
5467,10,1797,4701,0,0,0,0,1,1
5468,10,1798,2260;4702;4704;10081;10211;10228,0,0,4,2,0,6
5469,10,1799,4705;4706,0,0,0,1,1,2
5470,10,1800,4708;4709,0,0,0,2,0,2
5471,10,1802,4711;4712;4713;4714,0,0,0,4,0,4
5472,10,1803,4716,0,0,0,0,1,1
5473,10,1804,4717;4718,0,0,0,2,0,2
5474,10,1805,4720;4723,0,0,0,1,1,2
5475,10,1806,4724;4725,0,0,0,1,1,2
5476,10,1807,4726;4727,0,0,0,2,0,2
5477,10,1808,4729,0,0,0,0,1,1
5478,10,1810,4731;4732,0,0,0,1,1,2
5479,10,1811,4733;4734;4736;10161;10267;10796,0,1,2,2,1,6
5480,10,1812,4738;4739,0,0,0,2,0,2
5481,10,1813,4741;4742;4743,0,0,1,2,0,3
5482,10,1814,4744;4745,0,0,0,0,2,2
5483,10,1815,4746;4747;4748,0,0,1,1,1,3
5484,10,1816,4750;4751;4752,0,0,1,1,1,3
5485,10,1817,4753;4754;4755;4756;4757,0,0,1,4,0,5
5486,10,1818,3641,0,0,0,1,0,1
5487,10,1819,4759;4760,0,0,0,1,1,2
5488,10,1820,4763;4764,0,0,0,2,0,2
5489,10,1821,525;4766,0,0,0,2,0,2
5490,10,1822,4535;4769,0,0,1,0,1,2
5491,10,1823,4772;4773,0,0,0,1,1,2
5492,10,1824,4774;4775,0,0,0,1,1,2
5493,10,1825,4776;5146,0,0,0,2,0,2
5494,10,1826,4777;4778,0,0,0,2,0,2
5495,10,1827,4779;4780;10931,0,1,0,2,0,3
5496,10,1828,3780;4781,0,0,0,2,0,2
5497,10,1829,4782;4783,0,0,0,2,0,2
5498,10,1830,4784,0,0,0,0,1,1
5499,10,1831,4785;7734;10303;10735,0,1,1,2,0,4
5500,10,1832,4786,0,0,0,1,0,1
5501,10,1833,3100;4787,0,0,0,2,0,2
5502,10,1834,4788;7009;10390;10558;10682,0,1,2,2,0,5
5503,10,1835,4789;4792;4793,0,0,0,2,1,3
5504,10,1836,4795;4798,0,0,0,1,1,2
5505,10,1837,4800,0,0,0,1,0,1
5506,10,1838,4801;4804,0,0,0,0,2,2
5507,10,1839,4805;4806,0,0,0,1,1,2
5508,10,1841,4810;4811,0,0,0,1,1,2
5509,10,1842,4812;4813,0,0,0,2,0,2
5510,10,1844,4816;8423,0,0,0,2,0,2
5511,10,1846,1541;2005;4821;10577;11083,0,1,1,3,0,5
5512,10,1847,4822,0,0,0,0,1,1
5513,10,1848,4824;9958,0,0,0,2,0,2
5514,10,1849,4825;4826,0,0,0,1,1,2
5515,10,1850,4829,0,0,0,1,0,1
5516,10,1851,4830;4831;4832;4833,0,0,2,2,0,4
5517,10,1852,4834;4835;10408,0,0,1,2,0,3
5518,10,1853,4836;4837,0,0,0,1,1,2
5519,10,1854,4839,0,0,0,0,1,1
5520,10,1855,4841;4842,0,0,0,1,1,2
5521,10,1856,4844;4845;4846,0,0,2,1,0,3
5522,10,1857,4847,0,0,0,0,1,1
5523,10,1858,4848;4849;4850;4851,0,0,1,3,0,4
5524,10,1859,4853;4855;4856,0,0,0,3,0,3
5525,10,1860,4858;4860;4862,0,0,0,3,0,3
5526,10,1861,4863;4864;4866;4867;4868,0,0,2,1,2,5
5527,10,1862,4870;8764,0,0,0,2,0,2
5528,10,1863,4871;4872,0,0,0,2,0,2
5529,10,1864,4875,0,0,0,1,0,1
5530,10,1865,4877;4878,0,0,0,1,1,2
5531,10,1866,4879;8171;10075;10350;10608,0,1,2,2,0,5
5532,10,1867,4881;4883,0,0,1,0,1,2
5533,10,1868,4884;4886;4887;4889,0,0,0,3,1,4
5534,10,1869,4890;4892,0,0,1,0,1,2
5535,10,1870,2527,0,0,0,1,0,1
5536,10,1871,4894;4895;4896,0,0,0,2,1,3
5537,10,1872,4899;4900,0,0,0,2,0,2
5538,10,1873,4901,0,0,0,1,0,1
5539,10,1875,4905;7013,0,0,0,2,0,2
5540,10,1876,4906,0,0,0,0,1,1
5541,10,1878,1683;4910,0,0,0,2,0,2
5542,10,1879,4912,0,0,0,1,0,1
5543,10,1880,4913;4914;4915,0,0,0,1,2,3
5544,10,1881,4917;4918;4919,0,0,0,3,0,3
5545,10,1882,4921;4922;4924,0,0,0,3,0,3
5546,10,1884,4928;4929;4930;4931,0,0,0,3,1,4
5547,10,1885,4933;10908,0,1,0,1,0,2
5548,10,1886,4556;4934,0,0,0,2,0,2
5549,10,1887,4935;4936,0,0,0,2,0,2
5550,10,1888,4937;4939,0,0,0,1,1,2
5551,10,1889,4943;4944;4945;4946,0,0,2,1,1,4
5552,10,1890,4947;4948;4950,0,0,0,3,0,3
5553,10,1891,4951;4952;4955;4956,0,0,2,2,0,4
5554,10,1892,2321;4958;4959;4960,0,0,2,1,1,4
5555,10,1893,4082;4963;5299,0,0,0,3,0,3
5556,10,1894,4965,0,0,0,1,0,1
5557,10,1895,4966;4968;9556,0,0,0,3,0,3
5558,10,1896,3923;4970,0,0,0,2,0,2
5559,10,1897,4972,0,0,0,1,0,1
5560,10,1898,4974;4975;10313,0,0,1,1,1,3
5561,10,1899,4976;4977;4979,0,0,0,2,1,3
5562,10,1900,4981,0,0,0,1,0,1
5563,10,1904,4986,0,0,0,1,0,1
5564,10,1905,4987;4989;4990,0,0,1,1,1,3
5565,10,1906,4991;4992,0,0,0,2,0,2
5566,10,1907,4994,0,0,0,0,1,1
5567,10,1908,4996,0,0,0,1,0,1
5568,10,1909,4442;4997,0,0,0,2,0,2
5569,10,1910,4998;4999;5001;5002,0,0,0,3,1,4
5570,10,1912,5006;5007,0,0,0,1,1,2
5571,10,1914,5011;5012,0,0,0,2,0,2
5572,10,1915,5014;5015;5016,0,0,0,2,1,3
5573,10,1916,5018,0,0,0,1,0,1
5574,10,1917,5020;5022,0,0,0,1,1,2
5575,10,1918,5023,0,0,0,0,1,1
5576,10,1919,1494;5027;10899;11058,0,2,1,1,0,4
5577,10,1920,5028,0,0,0,0,1,1
5578,10,1921,5029;5030;5032,0,0,1,1,1,3
5579,10,1922,5033;5034;10367;11053,0,1,1,2,0,4
5580,10,1923,5035;5036;10467,0,0,1,2,0,3
5581,10,1924,5038;9914,0,0,0,2,0,2
5582,10,1926,5042;5043;9528,0,0,0,3,0,3
5583,10,1927,5045;5047;5415,0,0,1,2,0,3
5584,10,1928,5048;5050,0,0,0,1,1,2
5585,10,1929,508;5052;5053,0,0,0,3,0,3
5586,10,1930,5054;5055;10196,0,0,1,1,1,3
5587,10,1931,5056,0,0,0,0,1,1
5588,10,1932,5060,0,0,0,1,0,1
5589,10,1933,4125;5061;5064,0,0,1,2,0,3
5590,10,1934,5065;5066,0,0,0,2,0,2
5591,10,1935,5067;5068,0,0,0,2,0,2
5592,10,1936,5069;5071;5072,0,0,0,2,1,3
5593,10,1937,5074;10386,0,0,1,1,0,2
5594,10,1938,5075;5076,0,0,0,1,1,2
5595,10,1939,5077,0,0,0,0,1,1
5596,10,1940,5078;5079,0,0,0,0,2,2
5597,10,1941,5080;5081,0,0,0,1,1,2
5598,10,1942,713;714;5083;5084,0,0,0,4,0,4
5599,10,1943,5088;5089;10012;10236;10418,0,0,3,1,1,5
5600,10,1944,5090;5091,0,0,0,1,1,2
5601,10,1945,5093,0,0,0,1,0,1
5602,10,1946,5095;5097;8874,0,0,1,2,0,3
5603,10,1947,5098;5100,0,0,1,0,1,2
5604,10,1948,5102,0,0,0,1,0,1
5605,10,1949,5103;5104;5105,0,0,0,2,1,3
5606,10,1950,5106,0,0,0,0,1,1
5607,10,1953,5111;5114,0,0,0,2,0,2
5608,10,1954,5115;5116,0,0,0,2,0,2
5609,10,1955,5118;5119,0,0,0,1,1,2
5610,10,1956,5120;7064,0,0,0,2,0,2
5611,10,1957,5121,0,0,0,0,1,1
5612,10,1960,759;5125,0,0,0,2,0,2
5613,10,1961,4017;5127;5128;10719,0,1,1,2,0,4
5614,10,1962,5129;5130,0,0,0,1,1,2
5615,10,1963,5131;5135,0,0,1,0,1,2
5616,10,1964,5136;5137;7250,0,0,1,2,0,3
5617,10,1966,5139;5140,0,0,0,1,1,2
5618,10,1967,5141;5142,0,0,0,1,1,2
5619,10,1968,5143;5144,0,0,0,2,0,2
5620,10,1969,5147,0,0,0,0,1,1
5621,10,1970,5150;5151,0,0,0,1,1,2
5622,10,1971,5152;5153,0,0,0,0,2,2
5623,10,1972,5154;5155;5156,0,0,1,1,1,3
5624,10,1973,5157;5158;5160;5161,0,0,1,2,1,4
5625,10,1974,5162;5163,0,0,0,2,0,2
5626,10,1975,5164;5165;5166,0,0,0,2,1,3
5627,10,1976,5167;5168;5170,0,0,0,3,0,3
5628,10,1977,5171,0,0,0,0,1,1
5629,10,1978,5172;5174;5175,0,0,2,1,0,3
5630,10,1979,5176;5178,0,0,0,1,1,2
5631,10,1980,5179;5180;10502;10623,0,1,1,1,1,4
5632,10,1981,5182,0,0,0,0,1,1
5633,10,1982,9439,0,0,0,1,0,1
5634,10,1983,5184;5185;5186;5187;10686;10865,0,2,2,2,0,6
5635,10,1984,5188;5190;5192,0,0,0,2,1,3
5636,10,1985,5194,0,0,0,0,1,1
5637,10,1986,4983;5195;5196,0,0,0,3,0,3
5638,10,1987,5197;5198,0,0,0,2,0,2
5639,10,1988,5199;5202,0,0,0,1,1,2
5640,10,1990,5205;5206,0,0,0,0,2,2
5641,10,1992,5209,0,0,0,0,1,1
5642,10,1993,5214;5215,0,0,0,1,1,2
5643,10,1994,5217;5218;10306;10534,0,0,2,2,0,4
5644,10,1995,5219;5221,0,0,0,2,0,2
5645,10,1996,5222;5223,0,0,0,1,1,2
5646,10,1997,5224;5225,0,0,0,1,1,2
5647,10,1998,5226;5227;5228;10388;10587,0,0,3,2,0,5
5648,10,1999,5229;5231;5232,0,0,0,3,0,3
5649,10,2000,5233;5236,0,0,0,1,1,2
5650,10,2001,5237;5238,0,0,0,1,1,2
5651,10,2003,5240;5241,0,0,1,0,1,2
5652,10,2004,5243;5244,0,0,0,2,0,2
5653,10,2005,5246;5247;5248;5249;10624;10974,0,2,1,3,0,6
5654,10,2006,5250;5251;10433;10598;10877,0,1,2,1,1,5
5655,10,2007,5252,0,0,0,0,1,1
5656,10,2008,5253;5254,0,0,0,0,2,2
5657,10,2009,5256;5257;5258,0,0,1,2,0,3
5658,10,2010,5259;5260,0,0,1,0,1,2
5659,10,2011,5262;5263,0,0,0,1,1,2
5660,10,2012,255;5264,0,0,0,2,0,2
5661,10,2013,5265;5266,0,0,0,1,1,2
5662,10,2016,5271,0,0,0,0,1,1
5663,10,2018,5274;6936;10531,0,0,1,2,0,3
5664,10,2019,5276;5277,0,0,0,2,0,2
5665,10,2020,5279,0,0,0,0,1,1
5666,10,2021,5283;9142,0,0,0,2,0,2
5667,10,2022,5284;5285,0,0,0,2,0,2
5668,10,2023,5287;5288,0,0,0,0,2,2
5669,10,2024,5290;5291,0,0,0,2,0,2
5670,10,2025,5293;8291;8731;10064;10302;10603,0,0,3,3,0,6
5671,10,2026,5294;5297,0,0,1,1,0,2
5672,10,2028,5300;5301;7315,0,0,1,1,1,3
5673,10,2029,5303;5304,0,0,0,1,1,2
5674,10,2030,5306;5307,0,0,0,0,2,2
5675,10,2031,5308;5309;5310;5311;10009;10122;10213;10988,0,1,5,2,0,8
5676,10,2033,5315;10816,0,1,0,1,0,2
5677,10,2034,5316;5317,0,0,0,1,1,2
5678,10,2035,5320,0,0,0,1,0,1
5679,10,2036,5321;8005;10156;10229;10497,0,0,3,2,0,5
5680,10,2039,5325;8954,0,0,0,2,0,2
5681,10,2040,5326;5327;5328;5329;5331,0,0,2,2,1,5
5682,10,2041,5332;8446;10309;10526,0,0,2,2,0,4
5683,10,2042,730;5333;10562;10615;10730,0,2,1,2,0,5
5684,10,2043,5334;5335;10013;10362,0,0,2,1,1,4
5685,10,2044,5336;5337,0,0,0,2,0,2
5686,10,2045,5338;6679,0,0,0,2,0,2
5687,10,2048,5343,0,0,0,1,0,1
5688,10,2049,5345,0,0,0,0,1,1
5689,10,2050,5346;8173,0,0,0,2,0,2
5690,10,2051,5348,0,0,0,0,1,1
5691,10,2053,5354;5355,0,0,0,1,1,2
5692,10,2055,5358;5359,0,0,0,1,1,2
5693,10,2056,5361,0,0,0,1,0,1
5694,10,2057,5363;5364;5367;11094,0,1,1,2,0,4
5695,10,2058,5369,0,0,0,1,0,1
5696,10,2059,5371,0,0,0,0,1,1
5697,10,2060,5373;5374,0,0,0,1,1,2
5698,10,2061,5375;5376;5378,0,0,0,2,1,3
5699,10,2063,5383;5384,0,0,0,2,0,2
5700,10,2064,5386;5387,0,0,0,1,1,2
5701,10,2065,5388;5390;10130;10455,0,0,3,1,0,4
5702,10,2066,1663;5391;5392;10506;11009,0,1,2,2,0,5
5703,10,2067,5245;5393,0,0,0,2,0,2
5704,10,2068,5394;5395;5396,0,0,0,3,0,3
5705,10,2069,5397;5398,0,0,0,1,1,2
5706,10,2070,5399;5400;5402,0,0,1,0,2,3
5707,10,2071,5403;5404,0,0,0,2,0,2
5708,10,2072,5405;5406,0,0,0,1,1,2
5709,10,2073,5407;5409;9950,0,0,0,3,0,3
5710,10,2074,5413,0,0,0,0,1,1
5711,10,2076,5416,0,0,0,1,0,1
5712,10,2077,5417;5418;5421,0,0,1,1,1,3
5713,10,2078,2486;5422;10694,0,1,0,2,0,3
5714,10,2079,5423;5424;5425,0,0,1,2,0,3
5715,10,2080,5427;6732;10221;10365;10868,0,1,2,2,0,5
5716,10,2081,5429,0,0,0,1,0,1
5717,10,2082,5431;5433,0,0,1,1,0,2
5718,10,2083,5435;5436;5437;10242;11096,0,1,3,1,0,5
5719,10,2084,5439;5440;5441,0,0,0,1,2,3
5720,10,2085,5444;5445,0,0,0,0,2,2
5721,10,2086,5446;5449,0,0,1,0,1,2
5722,10,2087,5452,0,0,0,1,0,1
5723,10,2088,4592;5453,0,0,0,2,0,2
5724,10,2089,5454;5455,0,0,0,2,0,2
5725,10,2090,5456;5457;5458;5459;5460,0,0,2,3,0,5
5726,10,2093,5463;5464;10059;10298;10389,0,0,3,2,0,5
5727,10,2094,5465;7540,0,0,0,2,0,2
5728,10,2096,5468;5469;10778,0,1,0,1,1,3
5729,10,2097,5470;5471,0,0,0,0,2,2
5730,10,2098,5473,0,0,0,1,0,1
5731,10,2100,5475,0,0,0,1,0,1
5732,10,2101,5477;5479;5480,0,0,2,0,1,3
5733,10,2102,5481;5482,0,0,0,1,1,2
5734,10,2103,5484,0,0,0,1,0,1
5735,10,2104,5485;5486;5487,0,0,0,2,1,3
5736,10,2105,5488;5489;5511,0,0,0,3,0,3
5737,10,2106,5491;5492,0,0,0,1,1,2
5738,10,2107,5494,0,0,0,0,1,1
5739,10,2108,5497,0,0,0,1,0,1
5740,10,2109,5499;5500,0,0,0,1,1,2
5741,10,2110,5502;5503,0,0,0,1,1,2
5742,10,2111,5504;5666,0,0,0,2,0,2
5743,10,2112,5505;8503,0,0,0,2,0,2
5744,10,2113,459;5506;10488;10953,0,1,1,2,0,4
5745,10,2114,5507;5508,0,0,0,1,1,2
5746,10,2117,5513;5514,0,0,0,1,1,2
5747,10,2118,5517;5518,0,0,0,2,0,2
5748,10,2119,5519;5520;5521;5522,0,0,2,1,1,4
5749,10,2120,5523;5524;5526,0,0,1,1,1,3
5750,10,2121,5527,0,0,0,1,0,1
5751,10,2122,5528;10205;10743,0,1,1,1,0,3
5752,10,2123,736;5529,0,0,0,2,0,2
5753,10,2124,5530;5531,0,0,0,1,1,2
5754,10,2125,5532,0,0,0,1,0,1
5755,10,2126,3305;5534,0,0,0,2,0,2
5756,10,2127,5535,0,0,0,1,0,1
5757,10,2128,5537,0,0,0,1,0,1
5758,10,2129,5538,0,0,0,0,1,1
5759,10,2130,5541,0,0,0,0,1,1
5760,10,2131,5543;5544,0,0,0,0,2,2
5761,10,2132,5549;5550;10080;10153;10324,0,0,3,2,0,5
5762,10,2133,5552;5553;5554,0,0,0,2,1,3
5763,10,2134,5555;5556;5557,0,0,1,1,1,3
5764,10,2136,5560;5561,0,0,0,2,0,2
5765,10,2137,5563;5564;5565,0,0,0,2,1,3
5766,10,2138,5567,0,0,0,0,1,1
5767,10,2139,5570;5572,0,0,0,2,0,2
5768,10,2140,5574;7618,0,0,0,2,0,2
5769,10,2141,5576;5577,0,0,0,0,2,2
5770,10,2142,5448;5578;10425,0,0,1,2,0,3
5771,10,2143,5579;5580,0,0,0,1,1,2
5772,10,2145,5582;10073;10147;10527;10805,0,1,3,1,0,5
5773,10,2146,5583,0,0,0,1,0,1
5774,10,2147,5584,0,0,0,0,1,1
5775,10,2148,5589,0,0,0,0,1,1
5776,10,2149,5591,0,0,0,1,0,1
5777,10,2150,5592;6563,0,0,0,2,0,2
5778,10,2151,5593;5594,0,0,0,1,1,2
5779,10,2152,5595;5596;10139,0,0,1,2,0,3
5780,10,2153,5597;5598,0,0,0,1,1,2
5781,10,2154,5599;5601,0,0,0,1,1,2
5782,10,2155,5602;5604,0,0,0,2,0,2
5783,10,2156,2405;5607,0,0,0,2,0,2
5784,10,2157,5608;5609,0,0,0,2,0,2
5785,10,2158,5610,0,0,0,0,1,1
5786,10,2159,4395;5613;10752;10980;11031,0,3,0,2,0,5
5787,10,2160,5614;5615,0,0,0,1,1,2
5788,10,2161,5618,0,0,0,1,0,1
5789,10,2162,5620;8559,0,0,0,2,0,2
5790,10,2163,5623,0,0,0,0,1,1
5791,10,2165,5009;5627;5630,0,0,1,2,0,3
5792,10,2166,5631;5632;10317;10449;10669,0,1,2,1,1,5
5793,10,2168,5634;7326,0,0,0,2,0,2
5794,10,2169,5637;5638;5639,0,0,0,0,3,3
5795,10,2170,5641;5642;5643;9920;10047;10056;10129,0,0,5,2,0,7
5796,10,2172,5645;5646,0,0,0,0,2,2
5797,10,2173,5648;5649;10191,0,0,1,2,0,3
5798,10,2174,5650;5651,0,0,0,2,0,2
5799,10,2175,5652;5654;10338;10898,0,1,1,2,0,4
5800,10,2176,5655;5656,0,0,0,1,1,2
5801,10,2177,5658;5659;9551,0,0,1,2,0,3
5802,10,2178,2562;5660;5662,0,0,0,3,0,3
5803,10,2179,5663;5664,0,0,0,1,1,2
5804,10,2180,5665,0,0,0,0,1,1
5805,10,2181,5667;7457,0,0,0,2,0,2
5806,10,2182,5669,0,0,0,0,1,1
5807,10,2184,5672;5673;5674,0,0,0,1,2,3
5808,10,2185,5220;5675;10208,0,0,1,2,0,3
5809,10,2186,5676;7001,0,0,0,2,0,2
5810,10,2187,5678,0,0,0,1,0,1
5811,10,2188,5680;5681,0,0,0,0,2,2
5812,10,2189,5682,0,0,0,0,1,1
5813,10,2190,5683,0,0,0,0,1,1
5814,10,2191,5686;5687;5688,0,0,0,2,1,3
5815,10,2192,2737;5689,0,0,0,2,0,2
5816,10,2193,5693,0,0,0,0,1,1
5817,10,2194,5694,0,0,0,1,0,1
5818,10,2195,5696;5697;5698;10376,0,0,2,2,0,4
5819,10,2196,5701;5703,0,0,0,1,1,2
5820,10,2197,5706;9526,0,0,0,2,0,2
5821,10,2198,5707;5710;6592,0,0,1,2,0,3
5822,10,2199,5711;5712;10322;10342,0,0,2,2,0,4
5823,10,2200,5713,0,0,0,0,1,1
5824,10,2201,4201,0,0,0,1,0,1
5825,10,2202,5717;9835;9838;10033;10557;10762;10954,0,2,2,3,0,7
5826,10,2203,5718,0,0,0,1,0,1
5827,10,2204,5719;5720;5723,0,0,1,0,2,3
5828,10,2205,5724;5725,0,0,0,1,1,2
5829,10,2206,5727,0,0,0,1,0,1
5830,10,2208,5730;5731,0,0,1,0,1,2
5831,10,2209,3887;5732,0,0,0,2,0,2
5832,10,2210,5734;5735;5736;5738,0,0,2,2,0,4
5833,10,2211,5740;5742;5743,0,0,2,0,1,3
5834,10,2212,5745;5747;5748;5838;8041,0,0,0,5,0,5
5835,10,2213,5750,0,0,0,0,1,1
5836,10,2215,5758,0,0,0,1,0,1
5837,10,2216,5759,0,0,0,0,1,1
5838,10,2217,5760;9331,0,0,0,2,0,2
5839,10,2218,5761;6843,0,0,0,0,2,2
5840,10,2219,5763;5764;5765;5766,0,0,1,1,2,4
5841,10,2220,5767;5768;5770,0,0,0,2,1,3
5842,10,2222,2001,0,0,0,1,0,1
5843,10,2224,5782,0,0,0,1,0,1
5844,10,2225,5783;5784,0,0,0,1,1,2
5845,10,2226,5785;5786;5788;5789,0,0,0,3,1,4
5846,10,2228,5791;5792;5793;7254;7257,0,0,2,3,0,5
5847,10,2230,5796;5797;6101,0,0,0,2,1,3
5848,10,2231,5800;7942,0,0,0,2,0,2
5849,10,2235,4550;5805;5806,0,0,0,3,0,3
5850,10,2236,5807;5809,0,0,0,2,0,2
5851,10,2237,5812;8644,0,0,0,2,0,2
5852,10,2238,5813;5814,0,0,1,0,1,2
5853,10,2239,5815;8192,0,0,0,2,0,2
5854,10,2240,5816;5817,0,0,0,1,1,2
5855,10,2241,5818;5819,0,0,0,1,1,2
5856,10,2242,5820;5821,0,0,0,1,1,2
5857,10,2243,184;5822,0,0,0,2,0,2
5858,10,2244,9894,0,0,0,1,0,1
5859,10,2245,5826;5827;5828,0,0,0,0,3,3
5860,10,2246,5829,0,0,0,0,1,1
5861,10,2247,5831;5832,0,0,0,1,1,2
5862,10,2248,4790;5833,0,0,0,2,0,2
5863,10,2249,5834;5835;10055;10206;10463,0,0,3,1,1,5
5864,10,2250,5836,0,0,0,1,0,1
5865,10,2252,3339;5840;10375,0,0,1,2,0,3
5866,10,2253,1273;5842,0,0,0,2,0,2
5867,10,2254,597;5844,0,0,0,2,0,2
5868,10,2255,5845,0,0,0,1,0,1
5869,10,2256,5847;5848;5850,0,0,1,2,0,3
5870,10,2257,5851,0,0,0,0,1,1
5871,10,2260,5856;5857,0,0,0,1,1,2
5872,10,2261,5858;5859;5860,0,0,1,2,0,3
5873,10,2262,4740;5862;5864,0,0,0,3,0,3
5874,10,2263,5865;5866,0,0,0,2,0,2
5875,10,2264,5722;5868;5869,0,0,0,3,0,3
5876,10,2265,5872;5873,0,0,0,1,1,2
5877,10,2266,5874;5876,0,0,0,1,1,2
5878,10,2268,5878,0,0,0,1,0,1
5879,10,2269,5879,0,0,0,0,1,1
5880,10,2270,5880,0,0,0,0,1,1
5881,10,2272,5884,0,0,0,1,0,1
5882,10,2273,5885;5886,0,0,0,0,2,2
5883,10,2274,5887;5890;10144;10189;10519;10937,0,1,4,1,0,6
5884,10,2275,5891;5892;6565,0,0,0,3,0,3
5885,10,2276,5895;7586,0,0,0,2,0,2
5886,10,2277,5896,0,0,0,1,0,1
5887,10,2278,5897;5898;5899;5901;10032;10119,0,0,3,2,1,6
5888,10,2281,5906,0,0,0,1,0,1
5889,10,2282,5908;5909;10880;10920,0,2,0,1,1,4
5890,10,2283,5910;5911,0,0,0,2,0,2
5891,10,2284,5912;5914,0,0,0,0,2,2
5892,10,2285,585;5916;5917,0,0,1,2,0,3
5893,10,2286,3955,0,0,0,1,0,1
5894,10,2287,5919;5920,0,0,0,2,0,2
5895,10,2288,5921;5922,0,0,0,1,1,2
5896,10,2289,5923;5924,0,0,0,2,0,2
5897,10,2290,5925;5926;10538;10768,0,1,1,2,0,4
5898,10,2291,4018;5927;5928;5929;5930,0,0,2,2,1,5
5899,10,2292,5931;10821,0,1,0,1,0,2
5900,10,2294,5934;5935;5936;5937,0,0,1,3,0,4
5901,10,2295,5938;5940,0,0,0,0,2,2
5902,10,2296,5941;5942,0,0,0,2,0,2
5903,10,2298,5944;10182;10692,0,1,1,1,0,3
5904,10,2299,1295;5946,0,0,0,2,0,2
5905,10,2300,5947;5948;5950,0,0,0,2,1,3
5906,10,2301,5951;5952;10090;10428;10542,0,0,3,1,1,5
5907,10,2302,5955,0,0,0,1,0,1
5908,10,2303,5956;5957,0,0,0,1,1,2
5909,10,2304,5958;5959,0,0,0,2,0,2
5910,10,2305,4156;5960;5962;5964,0,0,0,4,0,4
5911,10,2306,5965;5968;5969,0,0,0,3,0,3
5912,10,2307,5971;5973,0,0,0,0,2,2
5913,10,2308,2583;5975,0,0,0,0,2,2
5914,10,2311,5979;5980,0,0,0,2,0,2
5915,10,2312,5983;5984;5985,0,0,1,2,0,3
5916,10,2313,5987;5988,0,0,0,1,1,2
5917,10,2314,5989;5990;5991;5992;10827;11084,0,2,2,2,0,6
5918,10,2315,5993;5994,0,0,0,0,2,2
5919,10,2316,5997;5998,0,0,0,0,2,2
5920,10,2317,5999;6002;6003,0,0,2,1,0,3
5921,10,2318,6004;6005,0,0,0,1,1,2
5922,10,2319,4224;6006,0,0,0,2,0,2
5923,10,2320,2089;6007,0,0,0,2,0,2
5924,10,2321,6008,0,0,0,1,0,1
5925,10,2322,6009,0,0,0,0,1,1
5926,10,2323,6012,0,0,0,1,0,1
5927,10,2324,6014;6015;7841,0,0,1,2,0,3
5928,10,2325,6016,0,0,0,1,0,1
5929,10,2326,6019;6021,0,0,0,2,0,2
5930,10,2327,6023;6024,0,0,0,1,1,2
5931,10,2328,3425,0,0,0,1,0,1
5932,10,2329,3040;6027;6028,0,0,0,3,0,3
5933,10,2330,6029,0,0,0,0,1,1
5934,10,2331,6030;6032,0,0,0,2,0,2
5935,10,2332,6033;6034,0,0,0,0,2,2
5936,10,2333,6091,0,0,0,1,0,1
5937,10,2334,6039;6040;10767,0,1,0,1,1,3
5938,10,2335,6041;6042,0,0,0,2,0,2
5939,10,2336,6043;6044,0,0,0,2,0,2
5940,10,2340,6048,0,0,0,1,0,1
5941,10,2341,6049;6050,0,0,0,2,0,2
5942,10,2342,6051;6052;6053;6054;10671,0,1,0,3,1,5
5943,10,2343,6055;6056,0,0,2,0,0,2
5944,10,2345,6058,0,0,0,0,1,1
5945,10,2347,4155;6061,0,0,0,1,1,2
5946,10,2349,6065;6066,0,0,0,1,1,2
5947,10,2350,6068;6069;6071,0,0,1,2,0,3
5948,10,2351,6072,0,0,0,0,1,1
5949,10,2352,990;6075,0,0,0,2,0,2
5950,10,2354,6080;6081,0,0,0,1,1,2
5951,10,2355,6083;6085,0,0,1,0,1,2
5952,10,2356,6086;6088,0,0,1,0,1,2
5953,10,2357,6089,0,0,0,0,1,1
5954,10,2359,6092,0,0,0,0,1,1
5955,10,2361,6095;6096,0,0,0,2,0,2
5956,10,2362,6097;6098,0,0,0,2,0,2
5957,10,2364,6104,0,0,0,0,1,1
5958,10,2365,6105,0,0,0,1,0,1
5959,10,2366,6109;6110;6111;6112;6138,0,0,0,3,2,5
5960,10,2367,6113;6114;10044,0,0,2,1,0,3
5961,10,2368,6115;6117,0,0,0,2,0,2
5962,10,2369,6119;6120;6121,0,0,0,3,0,3
5963,10,2370,6122;6123;6124,0,0,0,2,1,3
5964,10,2371,6125;6127,0,0,1,1,0,2
5965,10,2372,6128;6129,0,0,0,1,1,2
5966,10,2374,6132;6133,0,0,0,1,1,2
5967,10,2375,6135,0,0,0,1,0,1
5968,10,2380,6141;6142,0,0,0,2,0,2
5969,10,2382,6146,0,0,0,0,1,1
5970,10,2383,6148;6149,0,0,0,2,0,2
5971,10,2384,1207;6150;11043,0,1,0,2,0,3
5972,10,2385,4089;6152;6155;10019;10131;10235,0,0,4,2,0,6
5973,10,2387,6160;6161,0,0,0,2,0,2
5974,10,2388,6162;6163;7410;10060;10184;10549,0,0,4,2,0,6
5975,10,2389,6165;6166,0,0,0,1,1,2
5976,10,2390,6167;6168,0,0,0,1,1,2
5977,10,2391,6171;6172,0,0,0,2,0,2
5978,10,2392,6173;6174,0,0,0,2,0,2
5979,10,2393,1718;6175,0,0,0,2,0,2
5980,10,2395,6180;10118;10589,0,0,2,1,0,3
5981,10,2396,6181;6182;6183,0,0,1,1,1,3
5982,10,2397,6186,0,0,0,1,0,1
5983,10,2398,6189;6190,0,0,0,1,1,2
5984,10,2399,6193;10349;10387;10544,0,0,3,1,0,4
5985,10,2400,772;774;6195;6196,0,0,1,3,0,4
5986,10,2401,866;6198;6200;6202,0,0,1,3,0,4
5987,10,2403,6204;6205,0,0,0,2,0,2
5988,10,2404,6206;6208;7602;7604,0,0,1,3,0,4
5989,10,2405,6209;6212,0,0,1,1,0,2
5990,10,2406,375,0,0,0,1,0,1
5991,10,2407,6214;10100;10114;10140;10300;10356;10673;10690,0,2,5,1,0,8
5992,10,2408,6216;6217;10036;10058;10383;10806;10967,0,2,3,2,0,7
5993,10,2409,6218;6220;6222,0,0,0,1,2,3
5994,10,2410,6223,0,0,0,1,0,1
5995,10,2412,6227,0,0,0,0,1,1
5996,10,2413,6228;6229,0,0,0,1,1,2
5997,10,2414,6232;6233,0,0,1,1,0,2
5998,10,2415,4211,0,0,0,1,0,1
5999,10,2416,6235,0,0,0,0,1,1
6000,10,2418,6241;6242;10284;10372;10890,0,1,2,2,0,5
6001,10,2419,6245,0,0,0,1,0,1
6002,10,2420,6247;6248,0,0,0,0,2,2
6003,10,2421,6249,0,0,0,0,1,1
6004,10,2422,1759;6251;6252,0,0,1,2,0,3
6005,10,2424,6255;6256,0,0,0,2,0,2
6006,10,2425,6257;6258;6261;6262,0,0,2,0,2,4
6007,10,2426,6263;6264,0,0,0,0,2,2
6008,10,2427,6266,0,0,0,1,0,1
6009,10,2428,6267;6268,0,0,0,1,1,2
6010,10,2429,6270;6271;6272,0,0,1,0,2,3
6011,10,2430,6273;6274;6275,0,0,1,2,0,3
6012,10,2432,6279;6280,0,0,0,1,1,2
6013,10,2433,6282;6283;6284;6285,0,0,0,4,0,4
6014,10,2434,6288;6289;6290,0,0,0,2,1,3
6015,10,2435,4325;6291,0,0,0,2,0,2
6016,10,2436,6292,0,0,0,1,0,1
6017,10,2437,6294;6296,0,0,0,1,1,2
6018,10,2438,6298;6299,0,0,0,1,1,2
6019,10,2439,6300;6301,0,0,0,0,2,2
6020,10,2441,681;6305,0,0,0,2,0,2
6021,10,2442,6306;6307;6309,0,0,1,1,1,3
6022,10,2443,6312,0,0,0,0,1,1
6023,10,2444,6314;6315,0,0,0,1,1,2
6024,10,2445,6221;6317;6319,0,0,0,3,0,3
6025,10,2446,6320;6321,0,0,0,2,0,2
6026,10,2447,6322;6324,0,0,0,1,1,2
6027,10,2448,6326;6327,0,0,0,2,0,2
6028,10,2449,6328;6329,0,0,0,2,0,2
6029,10,2450,6332,0,0,0,1,0,1
6030,10,2451,6333;6335;6336,0,0,2,1,0,3
6031,10,2452,6338,0,0,0,0,1,1
6032,10,2453,6341;6342,0,0,1,1,0,2
6033,10,2454,6343;6344;6345,0,0,0,3,0,3
6034,10,2455,6346;6348,0,0,1,0,1,2
6035,10,2456,6349;6350,0,0,0,0,2,2
6036,10,2457,6352;6353,0,0,0,1,1,2
6037,10,2458,6355,0,0,0,1,0,1
6038,10,2459,6356;6357;6358,0,0,0,0,3,3
6039,10,2460,9952,0,0,0,1,0,1
6040,10,2461,6361;6362;6363,0,0,1,1,1,3
6041,10,2462,6364,0,0,0,0,1,1
6042,10,2463,6365;6366;10216;10465,0,0,2,2,0,4
6043,10,2464,6367;6368;6369;6370,0,0,2,1,1,4
6044,10,2465,6372,0,0,0,0,1,1
6045,10,2467,6375;6376;6377,0,0,0,2,1,3
6046,10,2468,6378;6379;9849;10281;10442;10518,0,0,4,2,0,6
6047,10,2470,6382;6891,0,0,1,1,0,2
6048,10,2473,6385,0,0,0,0,1,1
6049,10,2474,6386;6387;6388;6389,0,0,1,3,0,4
6050,10,2475,6391;6393,0,0,1,0,1,2
6051,10,2477,6395,0,0,0,1,0,1
6052,10,2478,6397;6399,0,0,0,0,2,2
6053,10,2479,6402;6403;6404;6407,0,0,0,4,0,4
6054,10,2480,6409;6410;10501;10658,0,1,1,2,0,4
6055,10,2481,6411,0,0,0,0,1,1
6056,10,2482,6414,0,0,0,0,1,1
6057,10,2483,6415;6416,0,0,0,0,2,2
6058,10,2484,6417,0,0,0,0,1,1
6059,10,2485,6418;6419;6421;10377;10559,0,0,3,2,0,5
6060,10,2486,6423,0,0,0,1,0,1
6061,10,2488,6425;6426,0,0,0,2,0,2
6062,10,2489,6427;6429,0,0,0,1,1,2
6063,10,2490,6431,0,0,0,1,0,1
6064,10,2491,6432;6433,0,0,0,1,1,2
6065,10,2492,6435;6436,0,0,0,1,1,2
6066,10,2493,6437;8095,0,0,0,2,0,2
6067,10,2494,5775;6438;6439;6440,0,0,1,3,0,4
6068,10,2495,6441;6442;6443;6444;10949,0,1,2,1,1,5
6069,10,2496,6446,0,0,0,1,0,1
6070,10,2497,6448;6449;10256;10439;10718,0,1,2,2,0,5
6071,10,2498,6450;6451;6453,0,0,0,3,0,3
6072,10,2499,6455;6457,0,0,0,1,1,2
6073,10,2500,6459;6460;6461,0,0,1,2,0,3
6074,10,2501,6462;6465;6466,0,0,0,2,1,3
6075,10,2502,6467,0,0,0,0,1,1
6076,10,2503,6468;6469;6470,0,0,2,1,0,3
6077,10,2504,6471;6472,0,0,0,0,2,2
6078,10,2505,6473,0,0,0,1,0,1
6079,10,2506,4464;6475,0,0,0,1,1,2
6080,10,2508,6477;6478,0,0,0,1,1,2
6081,10,2509,4623;6479;6480,0,0,1,2,0,3
6082,10,2510,6482;6483;10499;10579,0,0,2,2,0,4
6083,10,2511,6484,0,0,0,0,1,1
6084,10,2512,6485;6486,0,0,0,2,0,2
6085,10,2513,6487;6488;6490,0,0,1,1,1,3
6086,10,2514,6491;6494,0,0,0,2,0,2
6087,10,2515,6495,0,0,0,1,0,1
6088,10,2516,6497,0,0,0,1,0,1
6089,10,2517,6499;6500,0,0,0,1,1,2
6090,10,2518,6502,0,0,0,1,0,1
6091,10,2521,1042;6506,0,0,0,2,0,2
6092,10,2522,6508,0,0,0,0,1,1
6093,10,2523,6510,0,0,0,0,1,1
6094,10,2524,6511,0,0,0,0,1,1
6095,10,2526,6515,0,0,0,0,1,1
6096,10,2527,6519;6520,0,0,0,2,0,2
6097,10,2528,6521;6522,0,0,0,2,0,2
6098,10,2529,6523;6524;6525,0,0,0,3,0,3
6099,10,2530,6527;6530;6531,0,0,0,2,1,3
6100,10,2531,6532,0,0,0,1,0,1
6101,10,2532,6534;6535,0,0,0,2,0,2
6102,10,2533,6538;9440,0,0,0,2,0,2
6103,10,2534,6539;6540,0,0,0,2,0,2
6104,10,2535,6545,0,0,0,0,1,1
6105,10,2537,6547,0,0,0,0,1,1
6106,10,2538,6549;6551,0,0,0,1,1,2
6107,10,2539,6552;6553;6555,0,0,0,2,1,3
6108,10,2540,213;6558;6560;6561,0,0,2,1,1,4
6109,10,2542,6564,0,0,0,1,0,1
6110,10,2544,191;6566;6567,0,0,0,3,0,3
6111,10,2545,6568;6569,0,0,0,0,2,2
6112,10,2546,6570;6571;6892,0,0,1,1,1,3
6113,10,2547,7206,0,0,0,1,0,1
6114,10,2548,6573;6574,0,0,0,0,2,2
6115,10,2549,6575;7930;10731;10999,0,2,0,2,0,4
6116,10,2550,6576,0,0,0,0,1,1
6117,10,2551,6578;8691,0,0,0,2,0,2
6118,10,2552,6579;6580;6582,0,0,0,2,1,3
6119,10,2553,4926;6583,0,0,0,2,0,2
6120,10,2554,6584;6585;6587;10132;10285;10345;10431,0,0,4,2,1,7
6121,10,2555,6589;6590;6591,0,0,0,3,0,3
6122,10,2556,6593;6594,0,0,0,2,0,2
6123,10,2557,6596,0,0,0,0,1,1
6124,10,2558,6597;6598,0,0,0,1,1,2
6125,10,2559,6599;7725,0,0,0,2,0,2
6126,10,2560,6600;6601;6603,0,0,1,1,1,3
6127,10,2561,6607,0,0,0,1,0,1
6128,10,2562,6609,0,0,0,0,1,1
6129,10,2563,6610;6611;6612;10042;10323;10490,0,0,3,2,1,6
6130,10,2565,6614;6615;6616,0,0,0,2,1,3
6131,10,2566,6617,0,0,0,1,0,1
6132,10,2567,6618;6619,0,0,0,2,0,2
6133,10,2568,6620;6621;6623;6624;6625,0,0,1,3,1,5
6134,10,2569,357;6626;6628,0,0,0,3,0,3
6135,10,2570,6630;6632;10180;10227,0,0,3,1,0,4
6136,10,2571,4239;6634;10024;10254;10472,0,0,3,2,0,5
6137,10,2572,6636;6637,0,0,0,2,0,2
6138,10,2573,6639;6640;6641;6642,0,0,2,1,1,4
6139,10,2574,5900;6643,0,0,0,2,0,2
6140,10,2575,6644;6645,0,0,0,0,2,2
6141,10,2576,6647;6649,0,0,0,2,0,2
6142,10,2577,6650;6651;6652;6653;6654,0,0,0,4,1,5
6143,10,2578,6323;6655,0,0,0,2,0,2
6144,10,2579,6657;6658;6660,0,0,0,3,0,3
6145,10,2580,6662,0,0,0,1,0,1
6146,10,2581,6663;6664;10249;10517;10732,0,1,2,1,1,5
6147,10,2582,5110;6665,0,0,0,2,0,2
6148,10,2583,6666;6667,0,0,0,2,0,2
6149,10,2584,6669;6670,0,0,0,1,1,2
6150,10,2585,6671;6673,0,0,0,0,2,2
6151,10,2586,6676,0,0,0,0,1,1
6152,10,2587,6677,0,0,0,1,0,1
6153,10,2589,6680,0,0,0,1,0,1
6154,10,2590,6682;6683,0,0,0,1,1,2
6155,10,2591,6684;6685,0,0,0,0,2,2
6156,10,2592,5749;6686;6687,0,0,0,2,1,3
6157,10,2593,6690;6691;6693,0,0,0,3,0,3
6158,10,2594,6694;6695,0,0,0,2,0,2
6159,10,2595,6697;6699;6700;6701;6702;8008,0,0,1,5,0,6
6160,10,2596,1544;6704;6705;6707,0,0,0,3,1,4
6161,10,2597,6708,0,0,0,0,1,1
6162,10,2598,6713,0,0,0,1,0,1
6163,10,2599,6714,0,0,0,0,1,1
6164,10,2600,6715,0,0,0,0,1,1
6165,10,2601,2295;6718,0,0,0,2,0,2
6166,10,2602,6722;6724,0,0,0,0,2,2
6167,10,2603,1353;6726;6728;6729,0,0,1,3,0,4
6168,10,2604,6730;6731,0,0,0,1,1,2
6169,10,2605,6733;6734;6736,0,0,0,1,2,3
6170,10,2606,6737;6738;10110;10746,0,1,1,2,0,4
6171,10,2607,6739;6740,0,0,0,1,1,2
6172,10,2608,6741;6742;6744,0,0,1,1,1,3
6173,10,2609,2510;6745,0,0,0,2,0,2
6174,10,2610,6746;6747,0,0,0,1,1,2
6175,10,2611,4289;6749,0,0,0,2,0,2
6176,10,2612,6752;6753,0,0,0,2,0,2
6177,10,2615,6756;10141,0,0,1,1,0,2
6178,10,2616,6758;6760,0,0,0,0,2,2
6179,10,2617,6762;6763;6764,0,0,0,2,1,3
6180,10,2619,1139;6770,0,0,0,2,0,2
6181,10,2620,6771,0,0,0,0,1,1
6182,10,2621,6772;6773,0,0,0,1,1,2
6183,10,2623,6776;6777,0,0,0,1,1,2
6184,10,2624,6779;6781;6782,0,0,0,3,0,3
6185,10,2625,6784;6786,0,0,0,0,2,2
6186,10,2626,6787;6788,0,0,0,1,1,2
6187,10,2627,6476;6790;6791,0,0,0,3,0,3
6188,10,2628,6793,0,0,0,0,1,1
6189,10,2629,2371;2372;6797;6798,0,0,0,2,2,4
6190,10,2631,6801;6802,0,0,0,2,0,2
6191,10,2632,6803;6804;6805,0,0,0,3,0,3
6192,10,2634,1978;6807;6809;10934,0,1,1,2,0,4
6193,10,2635,6810;6811,0,0,0,2,0,2
6194,10,2636,6812,0,0,0,0,1,1
6195,10,2637,6813;6814,0,0,0,2,0,2
6196,10,2638,6816;10207;10957,0,1,1,1,0,3
6197,10,2639,6817;6818;6820,0,0,0,2,1,3
6198,10,2640,6821;6822;6823,0,0,1,2,0,3
6199,10,2641,6824,0,0,0,1,0,1
6200,10,2642,6825;6826,0,0,0,1,1,2
6201,10,2643,6828;6829;10234;10395;11025,0,1,2,1,1,5
6202,10,2645,6832;9029,0,0,0,2,0,2
6203,10,2646,6834;6838;6839,0,0,2,1,0,3
6204,10,2647,6840;6841,0,0,0,1,1,2
6205,10,2648,6842;6844;6845;6847;6848;6849,0,0,2,2,2,6
6206,10,2649,6852;7333,0,0,0,2,0,2
6207,10,2650,6853;6855;6856;6857,0,0,0,4,0,4
6208,10,2651,2753;6858,0,0,0,2,0,2
6209,10,2652,6859;6860,0,0,0,1,1,2
6210,10,2653,6862;6866;6867,0,0,0,3,0,3
6211,10,2654,6868;6869,0,0,0,1,1,2
6212,10,2656,6874;6875,0,0,0,1,1,2
6213,10,2657,6876;8303,0,0,0,2,0,2
6214,10,2658,6877;6878;6879;6880,0,0,0,3,1,4
6215,10,2659,6881,0,0,0,1,0,1
6216,10,2660,6883;6884;6885,0,0,0,1,2,3
6217,10,2661,6886;6888,0,0,0,0,2,2
6218,10,2662,6889;6890,0,0,0,1,1,2
6219,10,2665,6893,0,0,0,0,1,1
6220,10,2668,6898;6899,0,0,0,0,2,2
6221,10,2669,6900;6901,0,0,0,1,1,2
6222,10,2670,4095;6902,0,0,0,2,0,2
6223,10,2671,6903;6904;6905,0,0,1,1,1,3
6224,10,2672,128;6906,0,0,0,2,0,2
6225,10,2673,6909;6910;6911,0,0,1,2,0,3
6226,10,2674,6913;6914;10403,0,0,1,2,0,3
6227,10,2675,6915,0,0,0,1,0,1
6228,10,2676,6916;6918,0,0,0,1,1,2
6229,10,2678,6923;6924,0,0,0,2,0,2
6230,10,2679,6925,0,0,0,0,1,1
6231,10,2680,6926,0,0,0,0,1,1
6232,10,2681,3235;6928,0,0,0,2,0,2
6233,10,2682,6929,0,0,0,1,0,1
6234,10,2684,6934;6935,0,0,0,1,1,2
6235,10,2685,6938;6939,0,0,0,2,0,2
6236,10,2686,6940;6941,0,0,0,1,1,2
6237,10,2687,6942;6943,0,0,0,1,1,2
6238,10,2688,6031;6944,0,0,0,2,0,2
6239,10,2689,6945;6946;6950,0,0,1,1,1,3
6240,10,2690,3442;6952;6954;6955;10394;10484;10620,0,1,3,3,0,7
6241,10,2691,6956;6957,0,0,0,0,2,2
6242,10,2694,6961,0,0,0,1,0,1
6243,10,2695,6962,0,0,0,0,1,1
6244,10,2698,4612;6966;6967,0,0,0,3,0,3
6245,10,2699,6969;6970;10866;10946,0,2,0,2,0,4
6246,10,2701,6975;6976,0,0,0,1,1,2
6247,10,2703,6979;6980;6982,0,0,0,2,1,3
6248,10,2704,1577;6983;6984;6986,0,0,1,1,2,4
6249,10,2705,6988;6990;6991;10440,0,0,3,1,0,4
6250,10,2706,3706;6992,0,0,0,2,0,2
6251,10,2708,6997;6998;7000,0,0,0,2,1,3
6252,10,2709,7003,0,0,0,0,1,1
6253,10,2710,7004,0,0,0,0,1,1
6254,10,2711,7005,0,0,0,1,0,1
6255,10,2712,7006;7008,0,0,0,0,2,2
6256,10,2714,7014;7015;7016,0,0,1,0,2,3
6257,10,2715,7017;7018;7020,0,0,0,3,0,3
6258,10,2716,7022;7023;7024;7025,0,0,0,3,1,4
6259,10,2717,7026;9064,0,0,0,2,0,2
6260,10,2718,7027;7028;7029;10861;11048,0,2,0,3,0,5
6261,10,2719,7031;7033;7034;7035;7037,0,0,1,2,2,5
6262,10,2720,7038;7039;7040,0,0,1,2,0,3
6263,10,2721,7041,0,0,0,0,1,1
6264,10,2722,7044,0,0,0,1,0,1
6265,10,2723,523;7045;10096;10427,0,0,2,2,0,4
6266,10,2724,7046,0,0,0,1,0,1
6267,10,2725,7048;9808;10224;10736,0,1,1,2,0,4
6268,10,2726,1837;7049;7050,0,0,1,1,1,3
6269,10,2727,7052;7053;7054,0,0,1,1,1,3
6270,10,2728,2733;7055,0,0,0,2,0,2
6271,10,2729,7057,0,0,0,1,0,1
6272,10,2730,7059,0,0,0,1,0,1
6273,10,2731,7060;7061,0,0,0,1,1,2
6274,10,2732,7063,0,0,0,0,1,1
6275,10,2734,7065;7067;7068,0,0,0,1,2,3
6276,10,2735,7070;7072;7073;7074,0,0,0,3,1,4
6277,10,2736,7075;7076,0,0,0,2,0,2
6278,10,2737,7080,0,0,0,1,0,1
6279,10,2738,7084,0,0,0,0,1,1
6280,10,2739,7085,0,0,0,1,0,1
6281,10,2740,7087,0,0,0,0,1,1
6282,10,2742,7090;7091,0,0,0,1,1,2
6283,10,2743,7092,0,0,0,1,0,1
6284,10,2744,672;7094,0,0,0,2,0,2
6285,10,2745,7095;7096;7097;7098,0,0,2,1,1,4
6286,10,2746,7099;7100;7101;7102,0,0,0,3,1,4
6287,10,2747,7103,0,0,0,0,1,1
6288,10,2749,7106;7110,0,0,1,0,1,2
6289,10,2751,7113;7115,0,0,1,1,0,2
6290,10,2752,7117,0,0,0,0,1,1
6291,10,2753,7120;7121,0,0,0,1,1,2
6292,10,2754,7122;7123,0,0,0,1,1,2
6293,10,2755,7126;7127;7128,0,0,0,2,1,3
6294,10,2756,7130;7131,0,0,0,2,0,2
6295,10,2758,7133;7134,0,0,0,2,0,2
6296,10,2759,137;7135;10711;11040,0,2,0,2,0,4
6297,10,2760,7136;7137;7138;10071;10359;10885,0,1,2,3,0,6
6298,10,2761,7139;7140;7142;7143,0,0,1,3,0,4
6299,10,2762,7144;7145,0,0,0,1,1,2
6300,10,2763,7147,0,0,0,1,0,1
6301,10,2764,7149;7150;7151,0,0,1,2,0,3
6302,10,2765,7152;7153,0,0,0,1,1,2
6303,10,2766,7154;7156;7158,0,0,1,2,0,3
6304,10,2769,7162;7163;10040;10335;10698;11069,0,2,3,1,0,6
6305,10,2770,6765;7164,0,0,0,2,0,2
6306,10,2771,2671;7165,0,0,0,2,0,2
6307,10,2772,7167;10782;10971,0,2,0,1,0,3
6308,10,2773,7169;7172,0,0,0,2,0,2
6309,10,2774,3312;7173,0,0,0,2,0,2
6310,10,2775,7174;7175;7176;7177,0,0,2,1,1,4
6311,10,2776,7178;7179;7180,0,0,0,3,0,3
6312,10,2777,7182,0,0,0,1,0,1
6313,10,2778,6543;7183;7185,0,0,0,3,0,3
6314,10,2780,7187,0,0,0,0,1,1
6315,10,2781,7188,0,0,0,1,0,1
6316,10,2782,7189;7190;7191;7193,0,0,1,2,1,4
6317,10,2783,144;7194,0,0,0,1,1,2
6318,10,2784,7195;7196;7197,0,0,1,1,1,3
6319,10,2785,7198;7199,0,0,0,2,0,2
6320,10,2787,7202,0,0,0,0,1,1
6321,10,2788,7204;7205,0,0,0,1,1,2
6322,10,2789,7208,0,0,0,1,0,1
6323,10,2790,7209,0,0,0,0,1,1
6324,10,2791,3815;4767;7212,0,0,0,3,0,3
6325,10,2792,7214;7215,0,0,0,1,1,2
6326,10,2793,7217,0,0,0,0,1,1
6327,10,2794,7218;7219,0,0,0,1,1,2
6328,10,2795,7220;7223,0,0,0,1,1,2
6329,10,2796,7224;7225;7226,0,0,0,2,1,3
6330,10,2797,7228;7229,0,0,0,2,0,2
6331,10,2798,7230;7231,0,0,0,0,2,2
6332,10,2799,5855;7232,0,0,0,1,1,2
6333,10,2800,7233;7234,0,0,0,1,1,2
6334,10,2801,7239,0,0,0,1,0,1
6335,10,2802,7240;7241;10714;10979,0,2,0,1,1,4
6336,10,2803,7242;7243,0,0,0,1,1,2
6337,10,2804,7244;9482,0,0,0,2,0,2
6338,10,2805,7245,0,0,0,1,0,1
6339,10,2806,7248,0,0,0,0,1,1
6340,10,2808,7251,0,0,0,0,1,1
6341,10,2809,7252;10029;10083,0,0,2,1,0,3
6342,10,2811,457;7258,0,0,0,2,0,2
6343,10,2812,7259,0,0,0,0,1,1
6344,10,2813,7262,0,0,0,0,1,1
6345,10,2814,7263;7264;10057;10082;10164;10780;10939,0,2,3,2,0,7
6346,10,2815,7265;7266,0,0,0,2,0,2
6347,10,2817,7269,0,0,0,1,0,1
6348,10,2818,7270;7271,0,0,0,1,1,2
6349,10,2819,5342;7272;7273;10277;10279;10413,0,0,3,3,0,6
6350,10,2820,7277;9362;10078;10543,0,0,2,2,0,4
6351,10,2821,7279;7280,0,0,0,1,1,2
6352,10,2822,7281,0,0,0,0,1,1
6353,10,2823,7282;7284,0,0,0,1,1,2
6354,10,2824,7285;7286,0,0,0,1,1,2
6355,10,2825,7287;7288,0,0,0,2,0,2
6356,10,2826,7289,0,0,0,0,1,1
6357,10,2827,7291;7292;7295,0,0,1,2,0,3
6358,10,2828,7296,0,0,0,1,0,1
6359,10,2829,7297;9899,0,0,0,2,0,2
6360,10,2831,7301;7304,0,0,1,0,1,2
6361,10,2832,7305;7307,0,0,0,1,1,2
6362,10,2833,5954;6965;7310;7311,0,0,2,2,0,4
6363,10,2834,3577;7312,0,0,0,2,0,2
6364,10,2836,1104;6668;7317;10069;10070;10157,0,0,3,3,0,6
6365,10,2837,7319,0,0,0,0,1,1
6366,10,2838,7320;7322;7323;7324,0,0,2,1,1,4
6367,10,2839,7325;9435,0,0,0,2,0,2
6368,10,2840,7327,0,0,0,0,1,1
6369,10,2841,7328;7329;7330;7331,0,0,0,3,1,4
6370,10,2843,7334,0,0,0,0,1,1
6371,10,2845,7337,0,0,0,0,1,1
6372,10,2846,7338;7339;7340;7341;7344,0,0,1,4,0,5
6373,10,2848,7347;7348,0,0,0,2,0,2
6374,10,2849,7349,0,0,0,0,1,1
6375,10,2850,7351,0,0,0,0,1,1
6376,10,2851,7354;7355;10407;10565,0,0,2,1,1,4
6377,10,2852,7356,0,0,0,0,1,1
6378,10,2853,7358;7361;7595,0,0,0,3,0,3
6379,10,2854,7363,0,0,0,1,0,1
6380,10,2855,7364;8080,0,0,0,2,0,2
6381,10,2856,7365;7366,0,0,0,0,2,2
6382,10,2857,7369,0,0,0,0,1,1
6383,10,2858,7371;7373,0,0,1,0,1,2
6384,10,2859,7374,0,0,0,0,1,1
6385,10,2860,7376;7377,0,0,0,1,1,2
6386,10,2861,6063;7379,0,0,0,2,0,2
6387,10,2862,2908;7380;7382;7383,0,0,1,3,0,4
6388,10,2863,7384;9946;10883,0,1,0,2,0,3
6389,10,2864,7386,0,0,0,1,0,1
6390,10,2865,7388,0,0,0,1,0,1
6391,10,2866,1750;7390,0,0,0,2,0,2
6392,10,2867,7392;7393;7394;7395;7396,0,0,2,2,1,5
6393,10,2868,7397,0,0,0,0,1,1
6394,10,2869,4577;7399,0,0,0,2,0,2
6395,10,2870,7400;7401;7402;7405,0,0,2,2,0,4
6396,10,2871,7406;10052;10807,0,1,1,1,0,3
6397,10,2874,7413;7415;10399;10648,0,1,1,2,0,4
6398,10,2875,7416;7417;7418;7419,0,0,0,3,1,4
6399,10,2877,7423;7424,0,0,0,1,1,2
6400,10,2878,5382;7426;7427;7428,0,0,0,4,0,4
6401,10,2880,7430;7433,0,0,0,0,2,2
6402,10,2881,7436,0,0,0,0,1,1
6403,10,2882,7437;7438;7439;7440,0,0,2,1,1,4
6404,10,2883,7442;7443;7444;7445,0,0,3,1,0,4
6405,10,2884,7446,0,0,0,0,1,1
6406,10,2885,7447;7448,0,0,0,0,2,2
6407,10,2886,7450;8196,0,0,0,2,0,2
6408,10,2887,7452;7453,0,0,0,1,1,2
6409,10,2888,7454;7455,0,0,0,1,1,2
6410,10,2892,7462,0,0,0,0,1,1
6411,10,2893,7467;8007,0,0,0,2,0,2
6412,10,2894,7468;7469,0,0,0,1,1,2
6413,10,2895,7470,0,0,0,1,0,1
6414,10,2896,7471;7472,0,0,0,2,0,2
6415,10,2897,7475,0,0,0,0,1,1
6416,10,2898,7478;7479,0,0,0,0,2,2
6417,10,2899,7480;7481,0,0,1,1,0,2
6418,10,2900,7482;8578;10402;10820,0,1,1,2,0,4
6419,10,2901,7483;7484,0,0,0,1,1,2
6420,10,2902,7487,0,0,0,0,1,1
6421,10,2903,7489;9761,0,0,0,2,0,2
6422,10,2904,7491,0,0,0,0,1,1
6423,10,2905,2804;7493;7496;10155;10706,0,1,1,3,0,5
6424,10,2906,7497;7499;7500,0,0,0,3,0,3
6425,10,2907,7501;7502;10088;10299;10606,0,0,3,1,1,5
6426,10,2908,6837;7504,0,0,0,2,0,2
6427,10,2909,7507;7509;7510,0,0,1,2,0,3
6428,10,2910,7511,0,0,0,0,1,1
6429,10,2911,7513,0,0,0,0,1,1
6430,10,2912,7514;7515,0,0,0,1,1,2
6431,10,2913,6102;7518;7519;7521,0,0,0,2,2,4
6432,10,2914,4285;7522;7523,0,0,0,2,1,3
6433,10,2915,7526;7527;10607;11042,0,2,0,1,1,4
6434,10,2916,7529;7530,0,0,1,1,0,2
6435,10,2917,7531,0,0,0,0,1,1
6436,10,2918,7533,0,0,0,0,1,1
6437,10,2919,7535;7536;7537,0,0,0,1,2,3
6438,10,2921,7541;7542;10091;10117;10151,0,0,3,2,0,5
6439,10,2922,2164;7544,0,0,0,0,2,2
6440,10,2923,7545,0,0,0,0,1,1
6441,10,2924,7549;7550,0,0,1,0,1,2
6442,10,2925,7551;7554;7555,0,0,1,2,0,3
6443,10,2926,7556,0,0,0,1,0,1
6444,10,2927,7558;7560;7561,0,0,0,1,2,3
6445,10,2929,7565,0,0,0,1,0,1
6446,10,2930,7566;9136,0,0,0,2,0,2
6447,10,2932,1985;7573,0,0,0,2,0,2
6448,10,2933,7575,0,0,0,1,0,1
6449,10,2934,7576,0,0,0,1,0,1
6450,10,2935,7577;7579,0,0,0,1,1,2
6451,10,2936,7580,0,0,0,0,1,1
6452,10,2937,7581;7583;7584,0,0,0,0,3,3
6453,10,2940,1947;7589,0,0,0,2,0,2
6454,10,2941,7590;7591;7592,0,0,0,2,1,3
6455,10,2942,7593;7594;7596,0,0,0,1,2,3
6456,10,2943,7598,0,0,0,1,0,1
6457,10,2944,7599,0,0,0,1,0,1
6458,10,2946,7605;9324,0,0,0,2,0,2
6459,10,2947,7606;7607,0,0,0,2,0,2
6460,10,2948,7608;7609,0,0,0,1,1,2
6461,10,2949,7610;7611,0,0,0,1,1,2
6462,10,2950,7612;7613,0,0,0,1,1,2
6463,10,2951,7614;7616,0,0,0,1,1,2
6464,10,2952,7617;7619;7621;7622,0,0,1,2,1,4
6465,10,2953,7626,0,0,0,0,1,1
6466,10,2954,7627;7628,0,0,0,2,0,2
6467,10,2955,7630,0,0,0,0,1,1
6468,10,2956,7631,0,0,0,0,1,1
6469,10,2957,7635,0,0,0,1,0,1
6470,10,2958,7638,0,0,0,1,0,1
6471,10,2959,3224,0,0,0,1,0,1
6472,10,2960,7640;7642,0,0,0,1,1,2
6473,10,2962,7644;7646,0,0,0,2,0,2
6474,10,2963,7647;7648,0,0,0,1,1,2
6475,10,2964,7649;7650,0,0,0,2,0,2
6476,10,2965,9299,0,0,0,1,0,1
6477,10,2966,7653,0,0,0,1,0,1
6478,10,2967,7655,0,0,0,1,0,1
6479,10,2968,7660;7662,0,0,0,1,1,2
6480,10,2969,7664;7665;10178;10225;10570;10776,0,1,4,1,0,6
6481,10,2970,7666,0,0,0,0,1,1
6482,10,2971,7667;9333,0,0,0,2,0,2
6483,10,2972,7668;7670,0,0,0,2,0,2
6484,10,2973,7674,0,0,0,0,1,1
6485,10,2974,7676;7677;7678,0,0,0,1,2,3
6486,10,2975,1490;7680;7681,0,0,0,3,0,3
6487,10,2976,7684;7685,0,0,0,2,0,2
6488,10,2977,7686,0,0,0,0,1,1
6489,10,2978,6057;7687,0,0,0,2,0,2
6490,10,2979,7688;7689,0,0,0,0,2,2
6491,10,2980,7693;9770,0,0,0,2,0,2
6492,10,2981,1020;7694;7696;7697;7698,0,0,1,4,0,5
6493,10,2982,7699;7700;7701,0,0,0,3,0,3
6494,10,2983,4576;7702;7705;8838,0,0,0,4,0,4
6495,10,2984,7706,0,0,0,1,0,1
6496,10,2985,7707;7708;7709,0,0,1,2,0,3
6497,10,2987,7713,0,0,0,0,1,1
6498,10,2988,7714;7715,0,0,0,1,1,2
6499,10,2989,7716;7717,0,0,0,1,1,2
6500,10,2990,779;7718,0,0,0,2,0,2
6501,10,2991,7719,0,0,0,1,0,1
6502,10,2992,7720;7721;7723;7724,0,0,1,3,0,4
6503,10,2993,7726;7727;7728,0,0,0,1,2,3
6504,10,2994,7730;7731;7732,0,0,0,1,2,3
6505,10,2996,7735;7736,0,0,0,0,2,2
6506,10,2997,7737;7738;10179;10984,0,1,1,2,0,4
6507,10,2998,7740;7741,0,0,0,1,1,2
6508,10,2999,7743;7744,0,0,0,2,0,2
6509,10,3000,7745;7747;8958,0,0,0,3,0,3
6510,10,3003,7754,0,0,0,0,1,1
6511,10,3004,2827;7755,0,0,0,2,0,2
6512,10,3005,7756,0,0,0,0,1,1
6513,10,3006,4084;7757,0,0,0,1,1,2
6514,10,3007,7759,0,0,0,0,1,1
6515,10,3008,7761;7762,0,0,1,0,1,2
6516,10,3009,7763;7764;7765;7766,0,0,2,0,2,4
6517,10,3010,1019;7767,0,0,0,2,0,2
6518,10,3011,7768;7769,0,0,0,2,0,2
6519,10,3013,7771;7772;11015,0,1,0,2,0,3
6520,10,3014,7773;7774,0,0,0,1,1,2
6521,10,3015,97;5461;7777,0,0,0,3,0,3
6522,10,3016,7779;7780;7781;8613,0,0,2,2,0,4
6523,10,3017,7782;7784;7785,0,0,0,3,0,3
6524,10,3019,7787;7789,0,0,1,1,0,2
6525,10,3020,7790;7791,0,0,0,1,1,2
6526,10,3021,7792,0,0,0,1,0,1
6527,10,3022,7793;7794,0,0,2,0,0,2
6528,10,3023,7795;7796,0,0,0,1,1,2
6529,10,3024,883;7797;10101;10244;10459,0,0,3,2,0,5
6530,10,3026,7799;7800;7801;7802,0,0,0,3,1,4
6531,10,3027,7803;7805,0,0,0,1,1,2
6532,10,3028,7807;7809;10933,0,1,0,2,0,3
6533,10,3029,7810;7811,0,0,0,1,1,2
6534,10,3030,7814,0,0,0,0,1,1
6535,10,3031,7816;7817;7818,0,0,0,2,1,3
6536,10,3032,7821;7822,0,0,0,1,1,2
6537,10,3033,7823;7824;7826,0,0,0,3,0,3
6538,10,3034,7830,0,0,0,0,1,1
6539,10,3035,7831,0,0,0,0,1,1
6540,10,3036,7832,0,0,0,0,1,1
6541,10,3037,7835,0,0,0,0,1,1
6542,10,3038,7837;7839,0,0,0,0,2,2
6543,10,3039,6785;7840,0,0,0,1,1,2
6544,10,3040,7845;7846,0,0,0,2,0,2
6545,10,3041,7847,0,0,0,1,0,1
6546,10,3042,7941,0,0,0,1,0,1
6547,10,3043,7852,0,0,0,1,0,1
6548,10,3045,7854;7855;7856;10167;10476;10909,0,1,3,1,1,6
6549,10,3046,963;7858;10246;10354,0,0,2,2,0,4
6550,10,3047,7859,0,0,0,0,1,1
6551,10,3048,7860;7861,0,0,0,0,2,2
6552,10,3049,7865,0,0,0,0,1,1
6553,10,3050,5846;7866,0,0,0,2,0,2
6554,10,3051,7869;7870,0,0,0,0,2,2
6555,10,3052,7875;10066;10166;10787,0,1,2,1,0,4
6556,10,3053,6398;7876,0,0,0,2,0,2
6557,10,3054,7878;9271;10016;10857,0,1,1,2,0,4
6558,10,3056,7880;7881,0,0,0,1,1,2
6559,10,3057,1983;7883,0,0,0,2,0,2
6560,10,3058,7884,0,0,0,0,1,1
6561,10,3059,7885;7886,0,0,0,2,0,2
6562,10,3060,7887;7888;7889;7890,0,0,1,3,0,4
6563,10,3061,7891;7892;7893;7894,0,0,0,3,1,4
6564,10,3062,7157;7896,0,0,0,2,0,2
6565,10,3063,7897;7898,0,0,0,1,1,2
6566,10,3064,7901,0,0,0,1,0,1
6567,10,3065,7903;10255;10397,0,0,2,1,0,3
6568,10,3068,7908,0,0,0,1,0,1
6569,10,3069,7910;7911;7912;7914,0,0,1,3,0,4
6570,10,3070,2747;7915;10146;10700;10829,0,2,1,2,0,5
6571,10,3071,7916;8626;10297;10596,0,0,2,2,0,4
6572,10,3072,3335;3337;7919;7920;7921,0,0,1,4,0,5
6573,10,3073,7922,0,0,0,0,1,1
6574,10,3074,7924,0,0,0,0,1,1
6575,10,3075,7928;7929,0,0,0,2,0,2
6576,10,3076,7931;7932;7933,0,0,0,1,2,3
6577,10,3077,7934;7935,0,0,0,1,1,2
6578,10,3078,4188;7937;10600,0,0,1,2,0,3
6579,10,3079,292;7938;7939,0,0,0,3,0,3
6580,10,3080,3112;7940;7943,0,0,0,3,0,3
6581,10,3081,7945;7946;7947,0,0,1,1,1,3
6582,10,3082,7948;7949,0,0,0,2,0,2
6583,10,3083,7950;7951,0,0,0,2,0,2
6584,10,3084,7952,0,0,0,0,1,1
6585,10,3085,7953;7954,0,0,0,2,0,2
6586,10,3086,7955,0,0,0,0,1,1
6587,10,3087,7956;7957,0,0,0,1,1,2
6588,10,3088,7958;7959,0,0,0,1,1,2
6589,10,3089,7962;7963,0,0,0,0,2,2
6590,10,3091,7966;7967;7968,0,0,0,1,2,3
6591,10,3092,7970;7971;7972,0,0,1,1,1,3
6592,10,3093,7974;7975,0,0,0,1,1,2
6593,10,3094,7976,0,0,0,0,1,1
6594,10,3095,7977;7978,0,0,0,1,1,2
6595,10,3096,7980,0,0,0,1,0,1
6596,10,3098,7985;10581;10659,0,1,1,1,0,3
6597,10,3099,7986;9809,0,0,0,2,0,2
6598,10,3100,2932;7987;7990;10876;11090,0,2,0,3,0,5
6599,10,3101,7159;7991;7993;7994;7995;10031;10590,0,0,2,5,0,7
6600,10,3102,7996;7997;7998;10471;10646;10830;11054,0,3,1,3,0,7
6601,10,3104,8001;8002,0,0,0,2,0,2
6602,10,3106,8004;8006,0,0,0,2,0,2
6603,10,3108,762;8009;8010,0,0,0,3,0,3
6604,10,3109,7321;8011,0,0,0,2,0,2
6605,10,3110,5882;8012;8013;8014,0,0,0,4,0,4
6606,10,3111,8015;8016,0,0,0,0,2,2
6607,10,3112,3792;8018;10159;10510;10754,0,1,2,2,0,5
6608,10,3113,8021;8025;8027;8028,0,0,0,3,1,4
6609,10,3114,8029;8030;10105;10212,0,0,2,1,1,4
6610,10,3115,8032;8034,0,0,0,1,1,2
6611,10,3116,8036;8037;8038;8039;8040,0,0,1,4,0,5
6612,10,3118,8044,0,0,0,0,1,1
6613,10,3119,8045;8047,0,0,1,1,0,2
6614,10,3120,8048;8049;8050;8051;8052,0,0,2,3,0,5
6615,10,3121,8053;8054,0,0,0,0,2,2
6616,10,3122,8055;8056;8057,0,0,1,2,0,3
6617,10,3123,7639;8058,0,0,0,2,0,2
6618,10,3124,8059,0,0,0,0,1,1
6619,10,3125,8062,0,0,0,1,0,1
6620,10,3126,8064;8065;8240,0,0,0,3,0,3
6621,10,3127,8066;8067,0,0,0,1,1,2
6622,10,3128,6231;8068,0,0,0,2,0,2
6623,10,3129,3854;8069,0,0,0,0,2,2
6624,10,3130,8073,0,0,0,0,1,1
6625,10,3133,8078,0,0,0,0,1,1
6626,10,3135,8082,0,0,0,1,0,1
6627,10,3137,8085;8087;10611,0,1,0,2,0,3
6628,10,3138,5996;8088,0,0,0,2,0,2
6629,10,3139,8090;8091;8092,0,0,0,3,0,3
6630,10,3140,2377;8849,0,0,0,2,0,2
6631,10,3141,8094,0,0,0,1,0,1
6632,10,3142,8098;8100;10801,0,1,0,2,0,3
6633,10,3143,8102,0,0,0,0,1,1
6634,10,3144,8103;9531,0,0,0,2,0,2
6635,10,3146,3616;8105,0,0,0,2,0,2
6636,10,3147,8107;8108;8109;8110;8111;10092;10175;10294,0,0,5,3,0,8
6637,10,3148,8112;8113,0,0,0,1,1,2
6638,10,3149,8116,0,0,0,0,1,1
6639,10,3150,8118;8119,0,0,0,1,1,2
6640,10,3151,8121;8129,0,0,0,2,0,2
6641,10,3152,8126;8127,0,0,0,2,0,2
6642,10,3154,8130;8131;10067;10126;10764,0,1,2,2,0,5
6643,10,3155,1815;8134,0,0,0,0,2,2
6644,10,3156,8136;8137,0,0,0,0,2,2
6645,10,3157,8138;8139,0,0,0,2,0,2
6646,10,3158,3189;8141;10551;10855,0,1,1,2,0,4
6647,10,3159,8142;8143;8145;8146;10326;10656,0,1,3,1,1,6
6648,10,3160,5207;8147;8149;8150;10576;10708,0,1,2,3,0,6
6649,10,3161,8151;8152,0,0,0,1,1,2
6650,10,3162,4932;8153,0,0,0,2,0,2
6651,10,3163,7350;8156,0,0,0,2,0,2
6652,10,3164,8157;8158,0,0,0,2,0,2
6653,10,3167,8162;8164;10370;10814,0,1,1,2,0,4
6654,10,3168,8165;8166;8167;11032,0,1,0,2,1,4
6655,10,3169,8170,0,0,0,0,1,1
6656,10,3170,8172;8174;8175;8176;8177,0,0,0,3,2,5
6657,10,3171,8178,0,0,0,0,1,1
6658,10,3172,7673;8179,0,0,0,2,0,2
6659,10,3174,8185;8186,0,0,0,0,2,2
6660,10,3175,8188;8189,0,0,0,2,0,2
6661,10,3176,8190;8191,0,0,0,1,1,2
6662,10,3178,8193;8194,0,0,0,2,0,2
6663,10,3179,8195;8197;8198,0,0,1,1,1,3
6664,10,3180,1432;8199;8200;8201,0,0,2,0,2,4
6665,10,3181,2076;8651,0,0,0,2,0,2
6666,10,3182,8203;8204;10020;10209;10391,0,0,3,1,1,5
6667,10,3183,8205;8206,0,0,0,1,1,2
6668,10,3185,8208,0,0,0,0,1,1
6669,10,3186,8209;8210,0,0,0,2,0,2
6670,10,3188,7828;8212,0,0,0,2,0,2
6671,10,3189,6757;8214,0,0,0,2,0,2
6672,10,3190,8215;8216,0,0,0,0,2,2
6673,10,3191,8217;8218;8219;8220,0,0,1,0,3,4
6674,10,3192,8222;8223,0,0,0,1,1,2
6675,10,3194,8229,0,0,0,1,0,1
6676,10,3195,8231,0,0,0,1,0,1
6677,10,3196,8233,0,0,0,0,1,1
6678,10,3197,3608;8234,0,0,0,0,2,2
6679,10,3198,6783;8236;8237;8238;10914,0,1,2,2,0,5
6680,10,3199,8184;8239;10286;10578;10750,0,1,2,2,0,5
6681,10,3201,8241;8242;10287;11088,0,1,1,1,1,4
6682,10,3202,884;8243;10011;10230;10647,0,1,2,2,0,5
6683,10,3204,8245;8659;10026;10193;10231;10525;10916,0,1,4,2,0,7
6684,10,3205,8247;8248;10034;10045;10171;10454,0,0,4,2,0,6
6685,10,3206,8250;8251,0,0,0,2,0,2
6686,10,3207,8255;10138;10430;10996,0,1,2,1,0,4
6687,10,3208,8257,0,0,0,1,0,1
6688,10,3211,8260;8261,0,0,0,1,1,2
6689,10,3212,8263;8264;10675;10727,0,2,0,1,1,4
6690,10,3213,8265,0,0,0,0,1,1
6691,10,3214,8266;8267;8271;8272;8273,0,0,0,5,0,5
6692,10,3216,8275;8278;9828,0,0,1,2,0,3
6693,10,3217,8279;8280,0,0,0,2,0,2
6694,10,3218,8281;8282,0,0,0,1,1,2
6695,10,3219,8286;8288,0,0,1,1,0,2
6696,10,3221,8293;8294,0,0,0,1,1,2
6697,10,3222,8295;8296;8297,0,0,1,0,2,3
6698,10,3223,8298;9886,0,0,0,2,0,2
6699,10,3224,8299,0,0,0,0,1,1
6700,10,3225,8301;8302,0,0,1,0,1,2
6701,10,3227,8305;8307;10990,0,1,0,2,0,3
6702,10,3228,8308;8309;8310,0,0,0,2,1,3
6703,10,3229,8311;8314;8315,0,0,0,1,2,3
6704,10,3230,8316;8317,0,0,0,1,1,2
6705,10,3231,2682;8319,0,0,0,2,0,2
6706,10,3232,8321;8323,0,0,0,1,1,2
6707,10,3233,8326,0,0,0,1,0,1
6708,10,3234,5721;8327;8328,0,0,1,2,0,3
6709,10,3235,8329;8331;9260,0,0,0,3,0,3
6710,10,3236,8333;8334;10791,0,1,0,1,1,3
6711,10,3237,8335;8337;8338,0,0,1,1,1,3
6712,10,3238,8340,0,0,0,1,0,1
6713,10,3239,8341;8342;8343,0,0,0,2,1,3
6714,10,3241,8346;8347,0,0,0,0,2,2
6715,10,3242,2409;8349,0,0,0,2,0,2
6716,10,3243,8350;10438,0,0,1,1,0,2
6717,10,3244,8352;8353,0,0,0,1,1,2
6718,10,3245,8354;8355,0,0,0,0,2,2
6719,10,3246,466;8356;10283;10567;10760,0,1,2,2,0,5
6720,10,3247,8357;8358,0,0,0,2,0,2
6721,10,3248,8359;8360,0,0,0,1,1,2
6722,10,3249,8363;8364;8365,0,0,0,1,2,3
6723,10,3250,8366;8367;10678,0,1,0,2,0,3
6724,10,3251,8369;8370,0,0,0,2,0,2
6725,10,3252,280;8371;8372,0,0,1,2,0,3
6726,10,3253,8373;8375;8376,0,0,0,3,0,3
6727,10,3254,8377,0,0,0,0,1,1
6728,10,3255,8379;8380,0,0,0,2,0,2
6729,10,3256,8381;8383,0,0,0,2,0,2
6730,10,3258,8387;8389;10028;10398,0,0,2,2,0,4
6731,10,3259,8390;8391,0,0,0,1,1,2
6732,10,3260,8393;8394,0,0,0,1,1,2
6733,10,3261,8395;8522;10800,0,1,0,2,0,3
6734,10,3262,4988;8397,0,0,0,2,0,2
6735,10,3263,8400;8402;8403,0,0,0,1,2,3
6736,10,3264,1357;8404;8406;8407;8408;8409,0,0,1,5,0,6
6737,10,3265,8410,0,0,0,0,1,1
6738,10,3267,8413;8414,0,0,0,1,1,2
6739,10,3268,8415;8416;8417;8418,0,0,1,3,0,4
6740,10,3269,8419;8421,0,0,1,1,0,2
6741,10,3270,8422;8424;8425,0,0,0,3,0,3
6742,10,3271,3543;8426;10133;10479,0,0,2,2,0,4
6743,10,3272,8428;8429,0,0,0,1,1,2
6744,10,3273,8430;8431;8432;10203;10247,0,0,2,2,1,5
6745,10,3276,8435;9461;10566,0,0,1,2,0,3
6746,10,3277,8436;8437;8438,0,0,0,2,1,3
6747,10,3278,8439,0,0,0,0,1,1
6748,10,3279,6648;8441;8442;8443,0,0,0,4,0,4
6749,10,3280,8444,0,0,0,0,1,1
6750,10,3281,8447;8448,0,0,0,2,0,2
6751,10,3282,8449;8450;10202;10327;10687,0,1,2,2,0,5
6752,10,3283,8451;8452,0,0,0,2,0,2
6753,10,3284,8453;8456,0,0,0,1,1,2
6754,10,3285,8459,0,0,0,0,1,1
6755,10,3286,8460;8461,0,0,0,1,1,2
6756,10,3287,8462;8463,0,0,0,2,0,2
6757,10,3288,8464;9431,0,0,0,2,0,2
6758,10,3289,8467;8468,0,0,0,2,0,2
6759,10,3290,8471;8472;8473;8474,0,0,1,1,2,4
6760,10,3291,8475;8476,0,0,0,1,1,2
6761,10,3292,8478;8479,0,0,0,1,1,2
6762,10,3293,8481;8482;8483,0,0,0,1,2,3
6763,10,3294,8484,0,0,0,0,1,1
6764,10,3295,8485;8486,0,0,0,0,2,2
6765,10,3296,416;8489;8490;8493;8494,0,0,0,5,0,5
6766,10,3297,8495;8496;8498;10181;10555,0,0,2,2,1,5
6767,10,3298,8499;8500,0,0,0,1,1,2
6768,10,3300,8505,0,0,0,1,0,1
6769,10,3301,4041;8506,0,0,0,2,0,2
6770,10,3303,8508;8509;10215;10348,0,0,2,2,0,4
6771,10,3304,2429;8510;10017;10041;10280,0,0,3,2,0,5
6772,10,3305,5351;8513;8515,0,0,0,3,0,3
6773,10,3306,8517;8519;8520,0,0,0,2,1,3
6774,10,3307,8521,0,0,0,0,1,1
6775,10,3309,8524;8525;8526,0,0,0,2,1,3
6776,10,3310,8528,0,0,0,0,1,1
6777,10,3311,8529,0,0,0,0,1,1
6778,10,3312,2312;8531,0,0,0,2,0,2
6779,10,3313,8532,0,0,0,1,0,1
6780,10,3314,8533;8535,0,0,0,1,1,2
6781,10,3315,8537;8539,0,0,0,2,0,2
6782,10,3316,8159;8542;10084;10848,0,1,1,2,0,4
6783,10,3317,8544;8545;8548,0,0,0,1,2,3
6784,10,3318,8550;8551;8553,0,0,1,2,0,3
6785,10,3319,4187;8554;8556;10025;10252;10667,0,1,3,2,0,6
6786,10,3320,8557;8911,0,0,0,2,0,2
6787,10,3322,8563;10097;10288;10437,0,0,3,1,0,4
6788,10,3323,8564;8565;8566,0,0,0,3,0,3
6789,10,3324,8569,0,0,0,1,0,1
6790,10,3325,7982;8570,0,0,0,2,0,2
6791,10,3326,8571,0,0,0,0,1,1
6792,10,3327,8574,0,0,0,0,1,1
6793,10,3328,8575,0,0,0,0,1,1
6794,10,3329,8576,0,0,0,0,1,1
6795,10,3330,8579,0,0,0,1,0,1
6796,10,3331,8580;8581,0,0,0,1,1,2
6797,10,3332,8582;8583,0,0,0,2,0,2
6798,10,3334,8586,0,0,0,0,1,1
6799,10,3335,8588;8590,0,0,0,2,0,2
6800,10,3336,8593;8594,0,0,0,1,1,2
6801,10,3338,8599;8600,0,0,0,2,0,2
6802,10,3339,8601;8603,0,0,0,0,2,2
6803,10,3340,5462;8605,0,0,0,0,2,2
6804,10,3341,8606;8607;10098;10201,0,0,2,1,1,4
6805,10,3342,8084;8608,0,0,0,2,0,2
6806,10,3343,5070;8611;8612;11050,0,1,1,2,0,4
6807,10,3345,8614;8615;8616;8618;8619,0,0,0,4,1,5
6808,10,3346,4809;8620;8621;8622,0,0,0,3,1,4
6809,10,3347,8625;8627,0,0,0,2,0,2
6810,10,3348,8630;8631,0,0,0,1,1,2
6811,10,3349,8632;8634,0,0,0,0,2,2
6812,10,3350,6672;8635,0,0,0,2,0,2
6813,10,3351,8636;8637;8638,0,0,0,2,1,3
6814,10,3352,8639;8640;8641;8643,0,0,0,2,2,4
6815,10,3353,8645;8646,0,0,0,2,0,2
6816,10,3354,8647;8648;8649;8650,0,0,0,3,1,4
6817,10,3356,8653,0,0,0,1,0,1
6818,10,3357,8655;8656,0,0,0,1,1,2
6819,10,3358,8657;8658,0,0,0,2,0,2
6820,10,3360,8660,0,0,0,1,0,1
6821,10,3361,8661;8663;8664;8665,0,0,0,2,2,4
6822,10,3362,6374;8666,0,0,0,2,0,2
6823,10,3363,8667,0,0,0,0,1,1
6824,10,3364,8669,0,0,0,0,1,1
6825,10,3365,8670;8671,0,0,0,2,0,2
6826,10,3366,8673,0,0,0,0,1,1
6827,10,3367,8676;8677;8678;8681,0,0,1,0,3,4
6828,10,3368,8682;8683,0,0,0,1,1,2
6829,10,3369,8684,0,0,0,1,0,1
6830,10,3370,8686;8687;8688,0,0,0,3,0,3
6831,10,3372,8690;8692,0,0,0,1,1,2
6832,10,3373,8693;8694,0,0,0,2,0,2
6833,10,3374,8695;8696;8697;8698,0,0,2,1,1,4
6834,10,3375,8699;8701,0,0,1,1,0,2
6835,10,3376,8702;8703;8708,0,0,1,2,0,3
6836,10,3377,8704,0,0,0,0,1,1
6837,10,3379,8706;10104;10160;10162,0,0,3,1,0,4
6838,10,3381,8709;8710;8711,0,0,0,1,2,3
6839,10,3382,8713;8715;8716,0,0,0,2,1,3
6840,10,3383,8717;8719;8721,0,0,1,2,0,3
6841,10,3384,8722;8723;10074;10199;10237;10441;10524,0,0,5,2,0,7
6842,10,3385,8724;10125,0,0,1,1,0,2
6843,10,3386,8725;8726,0,0,0,1,1,2
6844,10,3387,8727;8728,0,0,0,1,1,2
6845,10,3390,8733,0,0,0,0,1,1
6846,10,3391,8734;8735,0,0,0,1,1,2
6847,10,3392,8736;8737,0,0,0,1,1,2
6848,10,3393,8738;8739,0,0,0,0,2,2
6849,10,3394,8742;8743,0,0,0,1,1,2
6850,10,3395,8744;8745;8746,0,0,0,2,1,3
6851,10,3396,8748;8749,0,0,0,2,0,2
6852,10,3397,8750;8752;8753,0,0,0,2,1,3
6853,10,3398,8754;8755;8757,0,0,0,2,1,3
6854,10,3399,8758;8759,0,0,0,1,1,2
6855,10,3400,8761;8762,0,0,0,2,0,2
6856,10,3402,8765;8766,0,0,0,0,2,2
6857,10,3403,8767;8769,0,0,0,0,2,2
6858,10,3404,8773;8774;10054;10994,0,1,1,2,0,4
6859,10,3405,8775;8776,0,0,0,1,1,2
6860,10,3406,8778;8779;8780,0,0,0,2,1,3
6861,10,3407,6238;8782;8783;8784,0,0,1,2,1,4
6862,10,3408,8786,0,0,0,0,1,1
6863,10,3409,8788,0,0,0,0,1,1
6864,10,3410,8789,0,0,0,0,1,1
6865,10,3411,8790;8791,0,0,0,1,1,2
6866,10,3412,8792;8793,0,0,0,1,1,2
6867,10,3413,8794;8795;8796;8798;8799,0,0,0,4,1,5
6868,10,3414,8800,0,0,0,0,1,1
6869,10,3415,8802;8803,0,0,0,2,0,2
6870,10,3416,8804;8805;8806;8808;10699,0,1,0,4,0,5
6871,10,3417,8810,0,0,0,0,1,1
6872,10,3418,8811;8812;8813,0,0,0,2,1,3
6873,10,3420,8817;8820,0,0,0,0,2,2
6874,10,3421,8458;8825;8826;8827,0,0,0,4,0,4
6875,10,3422,8828;8829;8831,0,0,0,3,0,3
6876,10,3423,8832,0,0,0,1,0,1
6877,10,3425,8835;8836;8837;8839;8840,0,0,2,1,2,5
6878,10,3426,8841;8842,0,0,0,2,0,2
6879,10,3427,6799;8844;8845;10276,0,0,1,3,0,4
6880,10,3428,8846,0,0,0,0,1,1
6881,10,3429,8847;8848,0,0,0,1,1,2
6882,10,3431,8850;8852;8854,0,0,1,2,0,3
6883,10,3432,8856,0,0,0,0,1,1
6884,10,3433,8860,0,0,0,1,0,1
6885,10,3434,8861,0,0,0,1,0,1
6886,10,3435,8862,0,0,1,0,0,1
6887,10,3436,2310;8863,0,0,0,2,0,2
6888,10,3438,8868;8869,0,0,0,1,1,2
6889,10,3440,8872;8873,0,0,0,0,2,2
6890,10,3442,2388;2389;8875;8877;8878,0,0,3,2,0,5
6891,10,3443,8879,0,0,0,1,0,1
6892,10,3444,8881,0,0,0,0,1,1
6893,10,3446,8883;8884;8885;8886,0,0,2,2,0,4
6894,10,3447,122,0,0,0,1,0,1
6895,10,3448,8891;8892;8894,0,0,0,3,0,3
6896,10,3449,8895;10858;11003,0,2,0,1,0,3
6897,10,3450,8896;8897;8898,0,0,0,3,0,3
6898,10,3451,8900;8901;8903,0,0,0,2,1,3
6899,10,3452,5213;8906,0,0,0,2,0,2
6900,10,3453,8907,0,0,0,1,0,1
6901,10,3454,8909,0,0,0,0,1,1
6902,10,3456,8914;8915,0,0,0,2,0,2
6903,10,3457,8916;8917,0,0,0,1,1,2
6904,10,3458,8919,0,0,0,1,0,1
6905,10,3459,8920;8921,0,0,0,2,0,2
6906,10,3460,8923;8924,0,0,0,1,1,2
6907,10,3461,8926;8927,0,0,0,1,1,2
6908,10,3462,8930;8931;8932,0,0,0,3,0,3
6909,10,3463,8935;8936,0,0,0,1,1,2
6910,10,3464,7124;7571,0,0,0,2,0,2
6911,10,3467,8941;8942;10050;10168;10396,0,0,3,2,0,5
6912,10,3468,8943;8944,0,0,0,2,0,2
6913,10,3469,8945;8947;8949,0,0,1,0,2,3
6914,10,3470,8952,0,0,0,1,0,1
6915,10,3471,8956;8957,0,0,0,1,1,2
6916,10,3473,8961,0,0,0,0,1,1
6917,10,3474,8962;8963,0,0,0,0,2,2
6918,10,3475,8964;8965;8967,0,0,1,1,1,3
6919,10,3476,8968;8969;10223;10261;10696,0,1,2,2,0,5
6920,10,3477,8970,0,0,0,1,0,1
6921,10,3478,8972;8973,0,0,0,1,1,2
6922,10,3479,8974;8978,0,0,1,0,1,2
6923,10,3482,2570;8982;8986,0,0,0,3,0,3
6924,10,3483,8988;8989,0,0,0,1,1,2
6925,10,3484,8990,0,0,0,0,1,1
6926,10,3485,8992,0,0,0,1,0,1
6927,10,3486,3039;8993,0,0,0,2,0,2
6928,10,3487,7634;8994;8995;8998,0,0,2,1,1,4
6929,10,3488,4131;9000;10076;10219,0,0,2,2,0,4
6930,10,3490,1649;5581;9005;9008,0,0,0,3,1,4
6931,10,3491,9010;9011,0,0,0,1,1,2
6932,10,3492,9012,0,0,0,0,1,1
6933,10,3493,9014;9017,0,0,0,2,0,2
6934,10,3494,1589;9018,0,0,0,2,0,2
6935,10,3495,9019;9020,0,0,0,2,0,2
6936,10,3496,9022;9023,0,0,0,2,0,2
6937,10,3497,9025,0,0,0,1,0,1
6938,10,3498,6754;9026;10650;10955,0,2,0,2,0,4
6939,10,3499,9027;9028,0,0,0,2,0,2
6940,10,3501,9030;9031;9032;9033,0,0,0,4,0,4
6941,10,3502,9034;9529,0,0,0,2,0,2
6942,10,3503,9036;9037,0,0,1,1,0,2
6943,10,3504,6871;9038;9040;9041;9042;9043,0,0,2,3,1,6
6944,10,3505,588;9044;9045;9046,0,0,1,2,1,4
6945,10,3506,9048;9049,0,0,0,0,2,2
6946,10,3507,7474;9050,0,0,0,2,0,2
6947,10,3508,9051,0,0,0,0,1,1
6948,10,3509,9052;9053,0,0,0,1,1,2
6949,10,3510,9054;9055;9056,0,0,1,1,1,3
6950,10,3511,9058,0,0,0,0,1,1
6951,10,3512,9060,0,0,0,1,0,1
6952,10,3513,9061,0,0,0,0,1,1
6953,10,3515,9065,0,0,0,1,0,1
6954,10,3516,8076;9066;9067;9069,0,0,1,3,0,4
6955,10,3517,9070;10432,0,0,1,1,0,2
6956,10,3518,9071;9073;9074,0,0,0,0,3,3
6957,10,3519,9075;9076;9078;10458,0,0,1,2,1,4
6958,10,3520,9079;9081;9082,0,0,0,2,1,3
6959,10,3522,9085,0,0,0,0,1,1
6960,10,3523,8979,0,0,0,1,0,1
6961,10,3524,9089;9090;10015,0,0,1,1,1,3
6962,10,3525,9091;9092,0,0,0,1,1,2
6963,10,3526,9093;9094,0,0,0,1,1,2
6964,10,3527,2893;9095;9096;9098;9099,0,0,3,0,2,5
6965,10,3528,9100;9102;9103,0,0,0,3,0,3
6966,10,3529,9104;9107,0,0,0,1,1,2
6967,10,3530,9109,0,0,0,0,1,1
6968,10,3531,9110;9111,0,0,0,0,2,2
6969,10,3532,4380;9116;9117,0,0,0,3,0,3
6970,10,3533,9120;9121,0,0,0,1,1,2
6971,10,3534,9122,0,0,0,1,0,1
6972,10,3535,9124,0,0,0,0,1,1
6973,10,3536,9128;9129,0,0,0,2,0,2
6974,10,3537,9130;9131;10495;10513,0,0,2,1,1,4
6975,10,3538,9134,0,0,0,1,0,1
6976,10,3539,9135;9137;9139,0,0,1,0,2,3
6977,10,3540,9140;9141,0,0,0,2,0,2
6978,10,3542,9143;9144,0,0,0,1,1,2
6979,10,3543,2132;9146,0,0,0,2,0,2
6980,10,3545,9148;9149;9150;9151,0,0,2,0,2,4
6981,10,3546,4797;9152;10475;11044,0,1,1,2,0,4
6982,10,3547,9153;9154,0,0,0,1,1,2
6983,10,3548,9156,0,0,0,0,1,1
6984,10,3549,9158;9161;9162,0,0,2,0,1,3
6985,10,3550,9164;9167,0,0,0,1,1,2
6986,10,3551,8585;9168,0,0,0,2,0,2
6987,10,3552,9170;9171,0,0,0,1,1,2
6988,10,3553,9173,0,0,0,1,0,1
6989,10,3554,9175,0,0,0,0,1,1
6990,10,3555,9176;9177,0,0,0,2,0,2
6991,10,3556,9178;9179,0,0,0,1,1,2
6992,10,3557,8597;9180,0,0,0,1,1,2
6993,10,3558,9181;9182,0,0,0,1,1,2
6994,10,3559,9183;9184,0,0,0,2,0,2
6995,10,3560,9185;9186;9188;9189;10077;10522,0,0,2,4,0,6
6996,10,3561,9190,0,0,0,0,1,1
6997,10,3562,9192,0,0,0,1,0,1
6998,10,3563,9193;9864,0,0,0,2,0,2
6999,10,3564,9195;9197,0,0,1,0,1,2
7000,10,3565,9198;9199,0,0,0,1,1,2
7001,10,3566,9200;9201,0,0,0,2,0,2
7002,10,3567,9202;9203,0,0,0,2,0,2
7003,10,3568,9204;9205,0,0,0,1,1,2
7004,10,3569,9206;9208;9209;9210;9211,0,0,2,3,0,5
7005,10,3570,9212;9215,0,0,0,2,0,2
7006,10,3571,9217,0,0,0,0,1,1
7007,10,3572,1827;9218;9220,0,0,0,3,0,3
7008,10,3573,9222;9223;9225;9227,0,0,0,4,0,4
7009,10,3574,7498;9229;9230;9231,0,0,0,4,0,4
7010,10,3575,9233;9235,0,0,0,1,1,2
7011,10,3576,9236;9237;9238,0,0,0,2,1,3
7012,10,3577,9239;9240,0,0,0,1,1,2
7013,10,3578,9241,0,0,0,1,0,1
7014,10,3579,9242,0,0,0,1,0,1
7015,10,3580,9244;9245;9247,0,0,1,1,1,3
7016,10,3581,5875;9248,0,0,0,2,0,2
7017,10,3582,9249;9250,0,0,0,2,0,2
7018,10,3584,9253,0,0,0,1,0,1
7019,10,3585,2322;9254;9255,0,0,1,0,2,3
7020,10,3586,9258;9259,0,0,0,0,2,2
7021,10,3587,9261;9262,0,0,0,2,0,2
7022,10,3588,6572;9264;9266;9267,0,0,2,2,0,4
7023,10,3589,9268,0,0,0,1,0,1
7024,10,3591,9273,0,0,0,1,0,1
7025,10,3592,2917;9274;10701;10936,0,2,0,2,0,4
7026,10,3593,9276,0,0,0,1,0,1
7027,10,3594,9280;9281,0,0,0,2,0,2
7028,10,3595,2478,0,0,0,1,0,1
7029,10,3596,9283;9284;9285,0,0,0,2,1,3
7030,10,3597,9286;9658,0,0,0,2,0,2
7031,10,3602,9292;9293,0,0,0,1,1,2
7032,10,3603,9294;9295;10293;10464,0,0,2,2,0,4
7033,10,3604,9296;9298,0,0,0,2,0,2
7034,10,3605,9301;10329;10634,0,1,1,1,0,3
7035,10,3606,9302;9304,0,0,0,2,0,2
7036,10,3608,9306;9307,0,0,0,1,1,2
7037,10,3609,9308,0,0,0,0,1,1
7038,10,3610,9310,0,0,0,0,1,1
7039,10,3611,9312;9313,0,0,0,2,0,2
7040,10,3612,3533;9315;9316;9317;10264;10895,0,1,3,2,0,6
7041,10,3613,9318;9319;11045,0,1,0,2,0,3
7042,10,3614,9320,0,0,0,0,1,1
7043,10,3618,9327;9332,0,0,1,0,1,2
7044,10,3619,9334;9335,0,0,0,1,1,2
7045,10,3620,9337;9338;9339,0,0,0,1,2,3
7046,10,3621,9341;9342,0,0,0,1,1,2
7047,10,3622,9343,0,0,0,1,0,1
7048,10,3623,8938;9345,0,0,0,2,0,2
7049,10,3624,9346;9348,0,0,0,2,0,2
7050,10,3625,9349;10619;10726,0,2,0,1,0,3
7051,10,3626,9353;9355,0,0,0,1,1,2
7052,10,3628,9360;9361,0,0,0,2,0,2
7053,10,3629,9363;9364;9365,0,0,2,1,0,3
7054,10,3630,9366;9367;9370;9371,0,0,0,3,1,4
7055,10,3631,9372;9373;10102,0,0,1,2,0,3
7056,10,3632,9374;9375,0,0,0,2,0,2
7057,10,3633,3166;9377,0,0,0,2,0,2
7058,10,3634,5684;9378,0,0,0,2,0,2
7059,10,3635,9380,0,0,0,0,1,1
7060,10,3636,9381;9382,0,0,0,1,1,2
7061,10,3637,9383;9384,0,0,0,2,0,2
7062,10,3639,9386;9388;9389;10217;10248;10873,0,1,2,3,0,6
7063,10,3640,9390;9391;9393;9394,0,0,0,4,0,4
7064,10,3641,5515;9395,0,0,0,2,0,2
7065,10,3643,9398;9399;9400;10046;10443,0,0,3,2,0,5
7066,10,3644,9402;9403,0,0,0,0,2,2
7067,10,3645,9404;9405;9406,0,0,0,3,0,3
7068,10,3646,9407;9408,0,0,0,2,0,2
7069,10,3647,9409;9411,0,0,0,1,1,2
7070,10,3648,9413;9414,0,0,0,2,0,2
7071,10,3649,6153;9416;9417;9419;9420,0,0,0,5,0,5
7072,10,3650,9421;9422;9423;9425,0,0,1,2,1,4
7073,10,3651,9426;9427;9428;10412;10537;10777,0,1,2,2,1,6
7074,10,3652,9430,0,0,0,0,1,1
7075,10,3653,9433,0,0,0,0,1,1
7076,10,3655,9438,0,0,0,1,0,1
7077,10,3658,9442,0,0,0,1,0,1
7078,10,3659,9444;9445,0,0,0,1,1,2
7079,10,3660,9446,0,0,0,0,1,1
7080,10,3661,9451,0,0,0,0,1,1
7081,10,3662,9452;9453;9454;9455,0,0,0,4,0,4
7082,10,3663,9456,0,0,0,0,1,1
7083,10,3664,9457;9458;9459,0,0,0,1,2,3
7084,10,3665,9462;9463,0,0,0,2,0,2
7085,10,3666,9464;9470,0,0,0,2,0,2
7086,10,3667,9465;9466,0,0,0,2,0,2
7087,10,3668,9468;9469,0,0,0,0,2,2
7088,10,3669,9473,0,0,0,1,0,1
7089,10,3670,9474,0,0,0,1,0,1
7090,10,3671,9475;9476,0,0,0,1,1,2
7091,10,3672,9477,0,0,0,1,0,1
7092,10,3673,3643;9479,0,0,0,2,0,2
7093,10,3674,9481;9483;9485,0,0,0,2,1,3
7094,10,3675,9486,0,0,0,0,1,1
7095,10,3676,9487;9492,0,0,0,0,2,2
7096,10,3677,9493;9494,0,0,0,1,1,2
7097,10,3679,9496,0,0,0,1,0,1
7098,10,3680,9498;9499;9501,0,0,0,3,0,3
7099,10,3681,9502,0,0,0,0,1,1
7100,10,3682,9503,0,0,0,0,1,1
7101,10,3683,9504;9505;9506,0,0,1,0,2,3
7102,10,3684,9507;9508,0,0,0,2,0,2
7103,10,3685,9509;9511,0,0,0,2,0,2
7104,10,3686,7435;9512;9513;9514;10027;10232,0,0,3,3,0,6
7105,10,3687,9516;9517;9518;9519;9520,0,0,3,1,1,5
7106,10,3688,9521;9522;10292;10411,0,0,2,2,0,4
7107,10,3689,9523,0,0,0,0,1,1
7108,10,3690,9524;9525,0,0,0,2,0,2
7109,10,3691,9527;9530,0,0,0,1,1,2
7110,10,3692,9532;9533;9534,0,0,0,0,3,3
7111,10,3693,2022;9535,0,0,0,2,0,2
7112,10,3694,9536;9537,0,0,0,1,1,2
7113,10,3695,1391;9539,0,0,0,0,2,2
7114,10,3696,4346;9542,0,0,0,2,0,2
7115,10,3698,9545;9546;9547,0,0,0,2,1,3
7116,10,3699,9548;9549;10128;10532,0,0,2,2,0,4
7117,10,3701,9552;9553,0,0,0,1,1,2
7118,10,3702,9554,0,0,0,1,0,1
7119,10,3703,9555;9557,0,0,0,2,0,2
7120,10,3704,3741;6766;9560;9561;9563,0,0,1,4,0,5
7121,10,3705,9565;9566,0,0,0,2,0,2
7122,10,3706,9568,0,0,0,1,0,1
7123,10,3707,9569;9570,0,0,0,1,1,2
7124,10,3708,9574;9576,0,0,0,2,0,2
7125,10,3709,9577,0,0,0,1,0,1
7126,10,3710,9579;9580,0,0,1,0,1,2
7127,10,3712,9583;9584,0,0,0,2,0,2
7128,10,3713,9586;9587;9589,0,0,0,3,0,3
7129,10,3714,9590;9591,0,0,0,2,0,2
7130,10,3715,9594;9595,0,0,0,1,1,2
7131,10,3716,5633;9597;10758;10896,0,2,0,2,0,4
7132,10,3717,9599,0,0,0,1,0,1
7133,10,3718,9601;9602,0,0,0,1,1,2
7134,10,3719,9604;9605;9606;9608;10871,0,1,1,3,0,5
7135,10,3720,9609,0,0,0,0,1,1
7136,10,3721,9611,0,0,0,0,1,1
7137,10,3723,9614;9615;10038,0,0,1,2,0,3
7138,10,3724,9617;9618,0,0,0,1,1,2
7139,10,3725,625;9619,0,0,0,2,0,2
7140,10,3726,9620;9621;10563;10904;10948,0,2,1,2,0,5
7141,10,3727,9624;9625;9626,0,0,1,1,1,3
7142,10,3728,9627;9629,0,0,0,0,2,2
7143,10,3729,9630,0,0,0,0,1,1
7144,10,3730,9631;9632,0,0,0,1,1,2
7145,10,3731,9633;9634;10516,0,0,1,2,0,3
7146,10,3732,9635;9636;9637;10176;10200;10456;10545,0,0,4,3,0,7
7147,10,3734,9640;9641;9643,0,0,0,2,1,3
7148,10,3735,9644,0,0,0,0,1,1
7149,10,3736,279;9645;10799;10983,0,2,0,2,0,4
7150,10,3737,9646;9648;9649,0,0,0,3,0,3
7151,10,3738,9650,0,0,0,0,1,1
7152,10,3739,9652;9653;9654;9655,0,0,2,2,0,4
7153,10,3740,9656,0,0,0,1,0,1
7154,10,3742,5298;9659,0,0,0,2,0,2
7155,10,3743,9660;9661;9662,0,0,0,2,1,3
7156,10,3744,1420;9663;9664;9665;9666;9667,0,0,1,5,0,6
7157,10,3745,9668,0,0,0,0,1,1
7158,10,3746,9669,0,0,0,0,1,1
7159,10,3747,9670;9671,0,0,0,2,0,2
7160,10,3748,9672;9673,0,0,0,1,1,2
7161,10,3749,9674;9675;9676;9677,0,0,0,3,1,4
7162,10,3750,9678;9679;9680;9681,0,0,0,2,2,4
7163,10,3751,9682;9683,0,0,0,1,1,2
7164,10,3752,9685;9686;9688;9689,0,0,2,1,1,4
7165,10,3753,9691;9692;9693;9694,0,0,0,4,0,4
7166,10,3754,9695;9696,0,0,0,1,1,2
7167,10,3755,9697;9698;9699,0,0,0,1,2,3
7168,10,3756,9701,0,0,0,1,0,1
7169,10,3757,9703;9704,0,0,0,1,1,2
7170,10,3758,9705;9706,0,0,0,2,0,2
7171,10,3759,9707;9709;9710,0,0,2,0,1,3
7172,10,3760,9711;9712,0,0,0,1,1,2
7173,10,3761,763;9713,0,0,0,2,0,2
7174,10,3762,9715;9716,0,0,0,1,1,2
7175,10,3763,9717;9719;9720;9722,0,0,1,1,2,4
7176,10,3765,9724;9725;9726;9728;9729,0,0,2,2,1,5
7177,10,3767,9731,0,0,0,0,1,1
7178,10,3769,9733;9734;9735;9736,0,0,2,0,2,4
7179,10,3770,9737;9738;9740;9741,0,0,2,1,1,4
7180,10,3771,9742,0,0,1,0,0,1
7181,10,3772,9744,0,0,0,1,0,1
7182,10,3774,5040;9747;9748;9749;9750;9751,0,0,4,1,1,6
7183,10,3775,9752;9753,0,0,0,0,2,2
7184,10,3776,9754;9755;9756,0,0,0,3,0,3
7185,10,3778,9759,0,0,0,0,1,1
7186,10,3780,9766;9767;9769,0,0,0,3,0,3
7187,10,3781,9771,0,0,0,1,0,1
7188,10,3782,7170;9772,0,0,0,2,0,2
7189,10,3783,9774;9775;9776,0,0,0,3,0,3
7190,10,3784,9778;10165;11029,0,1,1,1,0,3
7191,10,3785,9780;9781;9782;9783,0,0,0,3,1,4
7192,10,3786,9784;9785;9788,0,0,1,2,0,3
7193,10,3787,9789;9791;10185,0,0,1,2,0,3
7194,10,3788,9793;9794,0,0,0,2,0,2
7195,10,3789,9795,0,0,0,0,1,1
7196,10,3790,9800,0,0,0,0,1,1
7197,10,3791,9801,0,0,0,1,0,1
7198,10,3792,9802;9803;9804;10371;10733;11092,0,2,1,2,1,6
7199,10,3793,9805;9806;9807,0,0,0,2,1,3
7200,10,3795,9810,0,0,0,1,0,1
7201,10,3797,1030;9815;9818;10512;10642,0,1,1,3,0,5
7202,10,3798,9820,0,0,0,0,1,1
7203,10,3800,9823;9824;9826;9827,0,0,1,2,1,4
7204,10,3801,9832;9834,0,0,0,0,2,2
7205,10,3803,5108;9840,0,0,0,2,0,2
7206,10,3804,9841;9842;9844,0,0,0,2,1,3
7207,10,3805,9460;9845,0,0,0,2,0,2
7208,10,3806,9846,0,0,0,1,0,1
7209,10,3809,4044;9854,0,0,0,2,0,2
7210,10,3810,9855;9856,0,0,0,1,1,2
7211,10,3811,9857;9858,0,0,0,1,1,2
7212,10,3812,5357;9859,0,0,0,2,0,2
7213,10,3813,9862;9863,0,0,0,2,0,2
7214,10,3816,9866;9867;9868,0,0,0,2,1,3
7215,10,3817,9869;9870;11019,0,1,0,2,0,3
7216,10,3818,9872;9873,0,0,0,0,2,2
7217,10,3819,9875,0,0,0,0,1,1
7218,10,3820,9876;9877;9878;9879,0,0,0,4,0,4
7219,10,3821,9880;9881;9883,0,0,0,1,2,3
7220,10,3822,7111;9885;9887;9888,0,0,2,2,0,4
7221,10,3823,5779;9889;9890;9891,0,0,1,1,2,4
7222,10,3824,3913;9893,0,0,0,2,0,2
7223,10,3825,9896;9897,0,0,0,1,1,2
7224,10,3827,552;9900;10756,0,1,0,2,0,3
7225,10,3828,2280;9902,0,0,0,2,0,2
7226,10,3829,9903;9904,0,0,0,2,0,2
7227,10,3830,9905;9906,0,0,0,0,2,2
7228,10,3831,9907,0,0,0,1,0,1
7229,10,3832,9908;9912,0,0,0,1,1,2
7230,10,3833,9915;10793;10930,0,2,0,1,0,3
7231,10,3834,9916,0,0,0,0,1,1
7232,10,3835,9917;9918,0,0,0,1,1,2
7233,10,3836,1416;9921;9923,0,0,1,2,0,3
7234,10,3837,9924;9927,0,0,1,0,1,2
7235,10,3838,9928;9929,0,0,0,1,1,2
7236,10,3839,5026;9931;10330;10670,0,1,1,2,0,4
7237,10,3841,9934;9935;10314;10739,0,1,1,1,1,4
7238,10,3844,9943;9945,0,0,0,1,1,2
7239,10,3845,9949,0,0,0,1,0,1
7240,10,3847,7578;9953,0,0,0,2,0,2
7241,10,3849,9956;9957,0,0,0,2,0,2
7242,10,3851,9959,0,0,0,1,0,1
7243,10,3852,9960;9961,0,0,0,1,1,2
7244,10,3853,9964,0,0,0,1,0,1
7245,10,3854,9966;9967,0,0,0,0,2,2
7246,10,3855,9968;9969;9971,0,0,0,2,1,3
7247,10,3856,9972;9973;9974;9976,0,0,1,3,0,4
7248,10,3857,9977;9978,0,0,0,1,1,2
7249,10,3858,9979;9980,0,0,0,0,2,2
7250,10,3859,9981;9982,0,0,0,1,1,2
7251,10,3860,9983;9984;9986;9987;10030;10336,0,0,4,2,0,6
7252,10,3861,8834;9988;10409;10574;10789,0,1,2,2,0,5
7253,10,3862,9989;9991;10685,0,1,0,2,0,3
7254,10,3863,9992;9993,0,0,0,1,1,2
7255,10,3864,9994;9995;9997;9998,0,0,0,2,2,4
7256,10,3865,9999;10000;10002,0,0,0,2,1,3
7257,10,3867,106;3646,0,0,0,2,0,2
7258,10,3868,143;2324,0,0,0,2,0,2
7259,10,3869,368;2017;10065;10198;10713;10947,0,2,2,2,0,6
7260,10,3870,434;3065,0,0,0,2,0,2
7261,10,3871,570;6059,0,0,0,2,0,2
7262,10,3872,586,0,0,0,1,0,1
7263,10,3874,524;655,0,0,0,2,0,2
7264,10,3876,695,0,0,0,1,0,1
7265,10,3877,726;3214,0,0,0,2,0,2
7266,10,3878,828;2133,0,0,0,2,0,2
7267,10,3882,1272;3435,0,0,0,2,0,2
7268,10,3884,1783;2913;10504,0,0,1,2,0,3
7269,10,3885,1865,0,0,0,1,0,1
7270,10,3886,6428,0,0,0,1,0,1
7271,10,3887,1972;9047,0,0,0,2,0,2
7272,10,3888,2126;4971,0,0,0,2,0,2
7273,10,3889,2130;4938;10310;10591,0,0,2,2,0,4
7274,10,3890,2037;2223,0,0,0,0,2,2
7275,10,3892,1924;2443;10665;11004,0,2,0,2,0,4
7276,10,3893,2526,0,0,0,1,0,1
7277,10,3894,2674,0,0,0,1,0,1
7278,10,3895,2688;5600;10053;10263;10693,0,1,2,2,0,5
7279,10,3896,2762;8312,0,0,0,2,0,2
7280,10,3897,2809,0,0,0,1,0,1
7281,10,3898,2832,0,0,0,1,0,1
7282,10,3899,2863,0,0,0,0,1,1
7283,10,3900,1736;2942,0,0,0,2,0,2
7284,10,3901,3009;3325,0,0,0,1,1,2
7285,10,3902,3452;9127,0,0,0,2,0,2
7286,10,3903,550;3613,0,0,0,2,0,2
7287,10,3904,2038,0,0,0,1,0,1
7288,10,3906,259;3914,0,0,0,2,0,2
7289,10,3907,4000;7516;11093,0,1,0,2,0,3
7290,10,3909,4173,0,0,0,0,1,1
7291,10,3910,528;4243,0,0,0,2,0,2
7292,10,3911,4549;4568,0,0,0,0,2,2
7293,10,3912,22;10631,0,1,0,1,0,2
7294,10,3913,4644,0,0,0,0,1,1
7295,10,3914,3302;4794,0,0,0,2,0,2
7296,10,3915,5109;7517,0,0,0,2,0,2
7297,10,3916,5112,0,0,0,0,1,1
7298,10,3917,315;5211,0,0,0,2,0,2
7299,10,3918,5235;5972;10535,0,0,1,2,0,3
7300,10,3920,5385;9126,0,0,0,2,0,2
7301,10,3922,1850;5690;10478,0,0,1,2,0,3
7302,10,3923,5700;6778,0,0,0,2,0,2
7303,10,3924,5754;7107,0,0,0,2,0,2
7304,10,3925,1922;5769;10112;10152;10400;10622,0,1,3,2,0,6
7305,10,3927,3133;5888,0,0,0,2,0,2
7306,10,3928,5771;6143;10311;10364;10662;10913,0,2,2,2,0,6
7307,10,3929,6147;7485;11059,0,1,0,2,0,3
7308,10,3930,3750;6176;11018,0,1,0,2,0,3
7309,10,3932,7011;9303,0,0,0,2,0,2
7310,10,3935,2667;7253;10268,0,0,1,2,0,3
7311,10,3936,7407,0,0,0,0,1,1
7312,10,3937,4885;7904,0,0,0,2,0,2
7313,10,3938,6703;8035,0,0,0,2,0,2
7314,10,3939,8096,0,0,0,1,0,1
7315,10,3941,8213,0,0,0,0,1,1
7316,10,3943,6985;8378;11070,0,1,0,2,0,3
7317,10,3944,8480,0,0,0,1,0,1
7318,10,3945,8518,0,0,0,0,1,1
7319,10,3946,2724;3391,0,0,0,2,0,2
7320,10,3947,5801;8851,0,0,0,2,0,2
7321,10,3948,711;8890;10571,0,0,1,2,0,3
7322,10,3949,8983,0,0,0,0,1,1
7323,10,3950,8999,0,0,0,1,0,1
7324,10,3951,9039,0,0,0,0,1,1
7325,10,3953,1199;9328,0,0,0,2,0,2
7326,10,3954,3629;9347;10134;10385;10784,0,1,2,2,0,5
7327,10,3955,9540,0,0,0,0,1,1
7328,10,3956,9811,0,0,0,1,0,1
7329,10,3958,5653;10353;10486;10884,0,1,2,1,0,4
7330,10,3959,7129;9962;10296;10625,0,1,1,2,0,4
7331,10,3960,111;3338;10143;10850,365,1,1,2,0,4
7332,10,3961,331,365,0,0,1,0,1
7333,10,3962,442,365,0,0,1,0,1
7334,10,3963,534;7812;10769,365,1,0,2,0,3
7335,10,3964,544,365,0,0,1,0,1
7336,10,3965,661,365,0,0,1,0,1
7337,10,3966,667;1075,365,0,0,2,0,2
7338,10,3968,787;10794;10989,365,2,0,1,0,3
7339,10,3969,875,365,0,0,0,1,1
7340,10,3970,1014;8026;11027,365,1,0,2,0,3
7341,10,3971,1054;8368;10564;10897,365,1,1,2,0,4
7342,10,3972,2131;8433,365,0,0,2,0,2
7343,10,3973,1346;1913,365,0,0,2,0,2
7344,10,3974,1417,365,0,0,1,0,1
7345,10,3975,1484,365,0,0,0,1,1
7346,10,3976,738;4524;10925,365,1,0,2,0,3
7347,10,3977,1590;2953,365,0,0,2,0,2
7348,10,3978,1689;2219,365,0,0,2,0,2
7349,10,3979,1699;7926;10339,365,0,1,2,0,3
7350,10,3980,1317;1745,365,0,0,2,0,2
7351,10,3982,4927;9021,365,0,0,2,0,2
7352,10,3983,1976;2217,365,0,0,2,0,2
7353,10,3984,2262,365,0,0,0,1,1
7354,10,3985,2308;7168,365,0,0,2,0,2
7355,10,3986,224;2407,365,0,0,2,0,2
7356,10,3987,2451;9480;10609;10825;11049,365,3,0,2,0,5
7357,10,3988,2468;8807,365,0,0,2,0,2
7358,10,3989,1611;2490,365,0,0,2,0,2
7359,10,3990,2612;6130,365,0,0,2,0,2
7360,10,3991,1023;2622;10511,365,0,1,2,0,3
7361,10,3992,575;3113,365,0,0,2,0,2
7362,10,3993,3389;6394,365,0,0,2,0,2
7363,10,3994,3586;8384;10169;10461;10547;10828,365,1,3,2,0,6
7364,10,3996,3715,365,0,0,0,1,1
7365,10,3997,556,365,0,0,1,0,1
7366,10,3998,3590;3936,365,0,0,0,2,2
7367,10,4000,4063;4231;10222;10328,365,0,2,2,0,4
7368,10,4001,4287,365,0,0,1,0,1
7369,10,4002,1318;10316;10514;10832,365,1,2,1,0,4
7370,10,4004,5051,365,0,0,0,1,1
7371,10,4005,2141;5085,365,0,0,2,0,2
7372,10,4007,5124,365,0,0,1,0,1
7373,10,4008,5132;9871,365,0,0,2,0,2
7374,10,4009,5208;8455,365,0,0,2,0,2
7375,10,4010,5428,365,0,0,0,1,1
7376,10,4011,5512,365,0,0,0,1,1
7377,10,4012,5545,365,0,0,1,0,1
7378,10,4013,1950;5587,365,0,0,2,0,2
7379,10,4014,5691;9642;10275,365,0,1,2,0,3
7380,10,4015,5757;6067;10480;11022,365,1,1,2,0,4
7381,10,4016,860;5762,365,0,0,2,0,2
7382,10,4017,5881;6077,365,0,0,2,0,2
7383,10,4018,6103,365,0,0,0,1,1
7384,10,4020,6022;6281;10240;10553,365,0,2,2,0,4
7385,10,4021,2771;6303,365,0,0,2,0,2
7386,10,4023,1896;1899,365,0,0,2,0,2
7387,10,4024,6501,365,0,0,1,0,1
7388,10,4025,6533,365,0,0,1,0,1
7389,10,4026,3107;6631,365,0,0,2,0,2
7390,10,4027,299;5671;10226;10483,365,0,2,2,0,4
7391,10,4028,6678,365,0,0,0,1,1
7392,10,4029,5210;6863,365,0,0,2,0,2
7393,10,4030,5360;6977,365,0,0,2,0,2
7394,10,4031,69;7058;10785;10982,365,2,0,2,0,4
7395,10,4032,40;7071,365,0,0,2,0,2
7396,10,4033,7081;8114,365,0,0,2,0,2
7397,10,4035,7210,365,0,0,1,0,1
7398,10,4036,2744,365,0,0,1,0,1
7399,10,4037,7547;7751,365,0,0,2,0,2
7400,10,4038,7007;7652,365,0,0,2,0,2
7401,10,4039,7658;9939;10291,365,0,1,2,0,3
7402,10,4040,2930;8249,365,0,0,2,0,2
7403,10,4041,6769;7871;10257;10910,365,1,1,2,0,4
7404,10,4042,5370;8089,365,0,0,2,0,2
7405,10,4044,8304,365,0,0,1,0,1
7406,10,4045,8398;8511,365,0,0,2,0,2
7407,10,4046,8160;8405,365,0,0,2,0,2
7408,10,4047,8420,365,0,0,0,1,1
7409,10,4053,7820;9269,365,0,0,2,0,2
7410,10,4054,1556;9326;10382;11085,365,1,1,2,0,4
7411,10,4056,1617;9538,365,0,0,2,0,2
7412,10,4058,7378;9559,365,0,0,2,0,2
7413,10,4059,9647,365,0,0,1,0,1
7414,10,4060,6330;9773;10273;10709,365,1,1,2,0,4
7415,10,4061,178;9790,365,0,0,2,0,2
7416,10,4062,590;9825,365,0,0,2,0,2
7417,10,4063,7849;9911;10655;10824,365,2,0,2,0,4
7418,10,4065,419;9948,365,0,0,2,0,2
7419,10,4066,8756;10633;11071,730,2,0,1,0,3
7420,10,4067,45;5438,730,0,0,2,0,2
7421,10,4068,155,730,0,0,0,1,1
7422,10,4069,943,730,0,0,1,0,1
7423,10,4070,266,730,0,0,1,0,1
7424,10,4071,270,730,0,0,1,0,1
7425,10,4072,302;5123,730,0,0,2,0,2
7426,10,4073,478,730,0,0,1,0,1
7427,10,4074,542;2525;10554;10689,730,1,1,2,0,4
7428,10,4076,617;5525;10487,730,0,1,2,0,3
7429,10,4077,578;705;10318,730,0,1,2,0,3
7430,10,4078,792;7539;10654;10915,730,2,0,2,0,4
7431,10,4079,308;840,730,0,0,2,0,2
7432,10,4080,4985,730,0,0,1,0,1
7433,10,4082,973;8946,730,0,0,2,0,2
7434,10,4083,999;3322,730,0,0,2,0,2
7435,10,4084,1166;4197;10344;10710,730,1,1,2,0,4
7436,10,4085,1246;6947;10922,730,1,0,2,0,3
7437,10,4086,1492,730,0,0,0,1,1
7438,10,4087,1523,730,0,0,1,0,1
7439,10,4088,1688;2253,730,0,0,2,0,2
7440,10,4089,1728;7752,730,0,0,2,0,2
7441,10,4090,1833;3785,730,0,0,2,0,2
7442,10,4091,5280,730,0,0,1,0,1
7443,10,4092,1980,730,0,0,1,0,1
7444,10,4093,1998,730,0,0,0,1,1
7445,10,4095,2208;8801;10304,730,0,1,2,0,3
7446,10,4098,2560,730,0,0,0,1,1
7447,10,4099,2663;5877,730,0,0,2,0,2
7448,10,4101,2743;9491,730,0,0,2,0,2
7449,10,4102,2825;9500;10332;10546;10968,730,1,2,2,0,5
7450,10,4104,1209;2879;10651;10905;11061,730,3,0,2,0,5
7451,10,4105,3143,730,0,0,1,0,1
7452,10,4108,593;3354,730,0,0,2,0,2
7453,10,4109,4399;10450;10723;10926,730,2,1,1,0,4
7454,10,4110,3469;6164;10715;10854,730,2,0,2,0,4
7455,10,4112,3549;8061,730,0,0,2,0,2
7456,10,4114,3690;8987,730,0,0,2,0,2
7457,10,4115,3799;8163,730,0,0,2,0,2
7458,10,4116,3868;8751;10652;10747,730,2,0,2,0,4
7459,10,4117,702;3878,730,0,0,2,0,2
7460,10,4119,4115;4621,730,0,0,2,0,2
7461,10,4120,4233,730,0,0,1,0,1
7462,10,4121,4384;5605;10843,730,1,0,2,0,3
7463,10,4123,4474,730,0,0,1,0,1
7464,10,4124,5546;10676;10826;11030,730,3,0,1,0,4
7465,10,4125,2966;4539,730,0,0,2,0,2
7466,10,4127,4652,730,0,0,0,1,1
7467,10,4128,7587;8925;10605;10729,730,1,1,2,0,4
7468,10,4129,4485;4761,730,0,0,2,0,2
7469,10,4132,4803,730,0,0,1,0,1
7470,10,4133,4648;4923,730,0,0,2,0,2
7471,10,4135,5087,730,0,0,1,0,1
7472,10,4137,5292,730,0,0,0,1,1
7473,10,4138,970;5305,730,0,0,2,0,2
7474,10,4140,1205;5362,730,0,0,2,0,2
7475,10,4141,5411;8871,730,0,0,2,0,2
7476,10,4142,5426,730,0,0,0,1,1
7477,10,4143,5536;8434,730,0,0,2,0,2
7478,10,4144,5635,730,0,0,0,1,1
7479,10,4145,3829;5640,730,0,0,2,0,2
7480,10,4146,5668,730,0,0,1,0,1
7481,10,4147,5795,730,0,0,1,0,1
7482,10,4148,2850;5894,730,0,0,2,0,2
7483,10,4149,5913,730,0,0,1,0,1
7484,10,4150,5939;7236,730,0,0,2,0,2
7485,10,4151,1719;6078,730,0,0,2,0,2
7486,10,4152,6090,730,0,0,0,1,1
7487,10,4153,6246;7077;10379;10616;10889,730,2,1,2,0,5
7488,10,4154,6454,730,0,0,1,0,1
7489,10,4155,1741;6581;10368;11077,730,1,1,2,0,4
7490,10,4156,3291;6638;10668;10978,730,2,0,2,0,4
7491,10,4157,6907,730,0,0,1,0,1
7492,10,4158,8997;10772;11026,730,2,0,1,0,3
7493,10,4159,7249;7283,730,0,0,2,0,2
7494,10,4160,329;7367;10550;10614,730,1,1,2,0,4
7495,10,4161,7449,730,0,0,1,0,1
7496,10,4162,5571;7722,730,0,0,2,0,2
7497,10,4163,35;7857;10468,730,0,1,2,0,3
7498,10,4164,2403;7863,730,0,0,2,0,2
7499,10,4165,8023,730,0,0,1,0,1
7500,10,4166,6452;8132,730,0,0,2,0,2
7501,10,4167,9616,730,0,0,1,0,1
7502,10,4168,4600;8252;10363;10888,730,1,1,2,0,4
7503,10,4169,8374,730,0,0,1,0,1
7504,10,4170,8465,730,0,0,1,0,1
7505,10,4171,8555,730,0,0,0,1,1
7506,10,4172,8558,730,0,0,1,0,1
7507,10,4173,5451;8595,730,0,0,2,0,2
7508,10,4174,3732;7850,730,0,0,2,0,2
7509,10,4175,8929,730,0,0,1,0,1
7510,10,4176,8730;8937,730,0,0,2,0,2
7511,10,4177,9001,730,0,0,0,1,1
7512,10,4178,9004,730,0,0,0,1,1
7513,10,4179,3351;9086,730,0,0,2,0,2
7514,10,4180,5628;9113,730,0,0,2,0,2
7515,10,4181,1920;6400,730,0,0,2,0,2
7516,10,4182,2795,730,0,0,1,0,1
7517,10,4184,9628,730,0,0,1,0,1
7518,10,4185,2107,730,0,0,1,0,1
7519,10,4186,4487;9786,730,0,0,2,0,2
7520,10,4188,5212;9944,730,0,0,2,0,2
7521,10,4189,0;7425,1095,0,0,2,0,2
7522,10,4190,12;6735,1095,0,0,2,0,2
7523,10,4192,176;8117,1095,0,0,2,0,2
7524,10,4193,233;7973,1095,0,0,2,0,2
7525,10,4195,296;6278,1095,0,0,2,0,2
7526,10,4196,321;10657,1095,1,0,1,0,2
7527,10,4197,330;9145,1095,0,0,2,0,2
7528,10,4198,425,1095,0,0,1,0,1
7529,10,4199,489;9351;10333;10742,1095,1,1,2,0,4
7530,10,4200,517;1250,1095,0,0,2,0,2
7531,10,4201,628,1095,0,0,0,1,1
7532,10,4203,815,1095,0,0,1,0,1
7533,10,4204,926;5699;10366;10539,1095,0,2,2,0,4
7534,10,4205,7567;9449,1095,0,0,2,0,2
7535,10,4206,1091,1095,0,0,0,1,1
7536,10,4207,1099;4046,1095,0,0,2,0,2
7537,10,4208,1138;1514,1095,0,0,2,0,2
7538,10,4209,1197,1095,0,0,1,0,1
7539,10,4210,1225,1095,0,0,0,1,1
7540,10,4211,1259;7302,1095,0,0,2,0,2
7541,10,4214,1559,1095,0,0,1,0,1
7542,10,4215,6447;6959,1095,0,0,2,0,2
7543,10,4217,1773,1095,0,0,0,1,1
7544,10,4218,1907;3971,1095,0,0,2,0,2
7545,10,4219,1009;1921,1095,0,0,2,0,2
7546,10,4220,2156;4500;10790,1095,1,0,2,0,3
7547,10,4221,2171;2427,1095,0,0,2,0,2
7548,10,4222,2591,1095,0,0,1,0,1
7549,10,4223,2655;7012;10851,1095,1,0,2,0,3
7550,10,4224,917;2757,1095,0,0,2,0,2
7551,10,4225,2788,1095,0,0,1,0,1
7552,10,4226,2928,1095,0,0,0,1,1
7553,10,4227,3044,1095,0,0,1,0,1
7554,10,4228,3165;4045,1095,0,0,2,0,2
7555,10,4229,3281;9097,1095,0,0,2,0,2
7556,10,4230,205;3377;10373,1095,0,1,2,0,3
7557,10,4232,3524,1095,0,0,1,0,1
7558,10,4233,2834;3540,1095,0,0,2,0,2
7559,10,4234,3625;8771,1095,0,0,2,0,2
7560,10,4235,282;3667,1095,0,0,2,0,2
7561,10,4236,3708;6458;10704;10964;11046,1095,3,0,2,0,5
7562,10,4237,3789,1095,0,0,1,0,1
7563,10,4238,3940,1095,0,0,1,0,1
7564,10,4239,4048;6224,1095,0,0,2,0,2
7565,10,4240,4064;7569,1095,0,0,2,0,2
7566,10,4241,4127,1095,0,0,0,1,1
7567,10,4242,2059;4148;10845,1095,1,0,2,0,3
7568,10,4243,4166;4274,1095,0,0,2,0,2
7569,10,4244,1640;4336;10788,1095,1,0,2,0,3
7570,10,4245,1821;4353,1095,0,0,2,0,2
7571,10,4246,3362,1095,0,0,1,0,1
7572,10,4247,4426,1095,0,0,0,1,1
7573,10,4248,4528;8033,1095,0,0,2,0,2
7574,10,4249,4611,1095,0,0,0,1,1
7575,10,4250,4626,1095,0,0,1,0,1
7576,10,4251,4762;6396;10477,1095,0,1,2,0,3
7577,10,4252,4802,1095,0,0,1,0,1
7578,10,4253,4898;9843;10613,1095,1,0,2,0,3
7579,10,4254,3062;4954;10717;11011,1095,2,0,2,0,4
7580,10,4255,236;5420,1095,0,0,2,0,2
7581,10,4256,4995,1095,0,0,0,1,1
7582,10,4257,5017;7585;10556;10862;10960,1095,2,1,2,0,5
7583,10,4259,5242,1095,0,0,0,1,1
7584,10,4260,5255,1095,0,0,0,1,1
7585,10,4261,5272,1095,0,0,0,1,1
7586,10,4262,5314,1095,0,0,1,0,1
7587,10,4263,2179;5365;10572,1095,0,1,2,0,3
7588,10,4264,5548,1095,0,0,1,0,1
7589,10,4265,5558;6958,1095,0,0,2,0,2
7590,10,4266,4510;5573;10470;10935,1095,1,1,2,0,4
7591,10,4268,3812;10426;10803;10929,1095,2,1,1,0,4
7592,10,4269,5729,1095,0,0,0,1,1
7593,10,4270,5871,1095,0,0,1,0,1
7594,10,4271,5961,1095,0,0,0,1,1
7595,10,4272,6020;6721,1095,0,0,2,0,2
7596,10,4273,6207;9572,1095,0,0,2,0,2
7597,10,4274,4085;6277,1095,0,0,2,0,2
7598,10,4276,3038;6588,1095,0,0,2,0,2
7599,10,4277,6633,1095,0,0,1,0,1
7600,10,4278,6681,1095,0,0,1,0,1
7601,10,4280,2776;6796,1095,0,0,2,0,2
7602,10,4281,6951,1095,0,0,1,0,1
7603,10,4282,5516;7213,1095,0,0,2,0,2
7604,10,4283,7318;10421,1095,0,1,1,0,2
7605,10,4285,7429,1095,0,0,1,0,1
7606,10,4286,6481;7464,1095,0,0,2,0,2
7607,10,4287,1848;7625,1095,0,0,2,0,2
7608,10,4288,2281;7641,1095,0,0,2,0,2
7609,10,4289,7804;9016,1095,0,0,2,0,2
7610,10,4290,6390;7819,1095,0,0,2,0,2
7611,10,4292,1235;7882;10823,1095,1,0,2,0,3
7612,10,4293,7256;8124,1095,0,0,2,0,2
7613,10,4294,8202,1095,0,0,1,0,1
7614,10,4296,4209;8277;10583;11037,1095,1,1,2,0,4
7615,10,4297,8284;9797,1095,0,0,2,0,2
7616,10,4298,8469,1095,0,0,1,0,1
7617,10,4299,8491,1095,0,0,1,0,1
7618,10,4300,8523,1095,0,0,0,1,1
7619,10,4301,873;8596,1095,0,0,2,0,2
7620,10,4303,1372;8662;10492;10976;11078,1095,2,1,2,0,5
7621,10,4304,951;8763,1095,0,0,2,0,2
7622,10,4305,36;8859,1095,0,0,2,0,2
7623,10,4306,8902,1095,0,0,1,0,1
7624,10,4307,3583;8948,1095,0,0,2,0,2
7625,10,4308,7651,1095,0,0,1,0,1
7626,10,4309,9830;10533;10973,1095,1,1,1,0,3
7627,10,4310,9488,1095,0,0,1,0,1
7628,10,4311,9558,1095,0,0,1,0,1
7629,10,4312,4533;9600;10663,1095,1,0,2,0,3
7630,10,4314,9700,1095,0,0,1,0,1
7631,10,4315,8382;9777;10424,1095,0,1,2,0,3
7632,10,4317,6595;9882,1095,0,0,2,0,2
7633,10,4318,7601;9898;10423,1095,0,1,2,0,3
7634,10,4319,4605;9910;10540;10911,1095,1,1,2,0,4
7635,10,4321,158;3518;10902,1460,1,0,2,0,3
7636,10,4322,4031;6873;10738;11041,1460,2,0,2,0,4
7637,10,4324,336;9831;10945,1460,1,0,2,0,3
7638,10,4325,348;6347,1460,0,0,2,0,2
7639,10,4326,361;1116,1460,0,0,2,0,2
7640,10,4327,423,1460,0,0,1,0,1
7641,10,4328,616;1925,1460,0,0,2,0,2
7642,10,4329,768,1460,0,0,1,0,1
7643,10,4332,825,1460,0,0,0,1,1
7644,10,4333,837;3069,1460,0,0,2,0,2
7645,10,4334,1012,1460,0,0,1,0,1
7646,10,4335,1105,1460,0,0,1,0,1
7647,10,4336,1212,1460,0,0,1,0,1
7648,10,4337,8306,1460,0,0,1,0,1
7649,10,4338,1230;6819,1460,0,0,2,0,2
7650,10,4339,1251;8501;11055,1460,1,0,2,0,3
7651,10,4340,1264,1460,0,0,1,0,1
7652,10,4341,1371,1460,0,0,1,0,1
7653,10,4342,1447;3895,1460,0,0,2,0,2
7654,10,4344,1603;6861;10987;11063,1460,2,0,2,0,4
7655,10,4345,1732;9214,1460,0,0,2,0,2
7656,10,4346,1895,1460,0,0,1,0,1
7657,10,4347,680;1904,1460,0,0,2,0,2
7658,10,4348,1952;2723;10879;10938,1460,2,0,2,0,4
7659,10,4349,2025,1460,0,0,0,1,1
7660,10,4350,4410,1460,0,0,1,0,1
7661,10,4351,2337,1460,0,0,0,1,1
7662,10,4352,2355;3239,1460,0,0,2,0,2
7663,10,4353,2380;6254;10466;10695;10993,1460,2,1,2,0,5
7664,10,4354,929;2383;10887,1460,1,0,2,0,3
7665,10,4355,2455;7216,1460,0,0,2,0,2
7666,10,4356,7657,1460,0,0,1,0,1
7667,10,4357,2563,1460,0,0,1,0,1
7668,10,4358,2582,1460,0,0,1,0,1
7669,10,4361,3083,1460,0,0,1,0,1
7670,10,4362,3254,1460,0,0,1,0,1
7671,10,4364,3432;10755;11012,1460,2,0,1,0,3
7672,10,4365,2892;3502,1460,0,0,2,0,2
7673,10,4366,3548,1460,0,0,1,0,1
7674,10,4367,3645,1460,0,0,0,1,1
7675,10,4369,3944;5603,1460,0,0,2,0,2
7676,10,4370,6456,1460,0,0,1,0,1
7677,10,4371,7;3960;10891,1460,1,0,2,0,3
7678,10,4373,3985;6920,1460,0,0,2,0,2
7679,10,4374,1218;3811,1460,0,0,2,0,2
7680,10,4375,2718;4005,1460,0,0,2,0,2
7681,10,4376,4020;5977,1460,0,0,2,0,2
7682,10,4379,4827,1460,0,0,1,0,1
7683,10,4381,834;2030,1460,0,0,2,0,2
7684,10,4382,4411;8516;11038,1460,1,0,2,0,3
7685,10,4383,4436,1460,0,0,1,0,1
7686,10,4385,4925;7019,1460,0,0,2,0,2
7687,10,4386,643;5113,1460,0,0,2,0,2
7688,10,4387,1487;5234,1460,0,0,2,0,2
7689,10,4389,5542;5562;10684,1460,1,0,2,0,3
7690,10,4390,5695,1460,0,0,1,0,1
7691,10,4391,1363;5811,1460,0,0,2,0,2
7692,10,4392,6038;6516,1460,0,0,2,0,2
7693,10,4394,6240;8985,1460,0,0,2,0,2
7694,10,4395,2765;6308;10643;10878,1460,2,0,2,0,4
7695,10,4397,6334;9169,1460,0,0,2,0,2
7696,10,4398,6351;10959,1460,1,0,1,0,2
7697,10,4399,6406;8168,1460,0,0,2,0,2
7698,10,4401,2180;6493,1460,0,0,2,0,2
7699,10,4402,6542;8071,1460,0,0,2,0,2
7700,10,4403,6556,1460,0,0,0,1,1
7701,10,4404,2922;4942,1460,0,0,2,0,2
7702,10,4405,6698,1460,0,0,0,1,1
7703,10,4406,6854;9196,1460,0,0,2,0,2
7704,10,4407,4379;6933,1460,0,0,2,0,2
7705,10,4408,4649,1460,0,0,1,0,1
7706,10,4409,5169;6993,1460,0,0,2,0,2
7707,10,4410,4916,1460,0,0,1,0,1
7708,10,4411,7066;8120,1460,0,0,2,0,2
7709,10,4412,1740,1460,0,0,1,0,1
7710,10,4413,6710;7112,1460,0,0,2,0,2
7711,10,4414,7274;9495,1460,0,0,2,0,2
7712,10,4415,7293;8123;10592;10734,1460,1,1,2,0,4
7713,10,4416,5970;7300,1460,0,0,2,0,2
7714,10,4417,7798;10840,1460,1,0,1,0,2
7715,10,4418,9119,1460,0,0,1,0,1
7716,10,4419,2628;7534,1460,0,0,2,0,2
7717,10,4420,360;7603,1460,0,0,2,0,2
7718,10,4421,4949;7671,1460,0,0,2,0,2
7719,10,4422,6191;7682,1460,0,0,2,0,2
7720,10,4423,4170;7692,1460,0,0,2,0,2
7721,10,4424,7695,1460,0,0,1,0,1
7722,10,4425,3157;7834,1460,0,0,2,0,2
7723,10,4426,516;7838,1460,0,0,2,0,2
7724,10,4427,2750;7925,1460,0,0,2,0,2
7725,10,4428,8046,1460,0,0,0,1,1
7726,10,4429,8401,1460,0,0,1,0,1
7727,10,4431,7465;8187,1460,0,0,2,0,2
7728,10,4432,979;8262,1460,0,0,2,0,2
7729,10,4433,2414;8399,1460,0,0,2,0,2
7730,10,4434,202;5313,1460,0,0,2,0,2
7731,10,4435,8729,1460,0,0,1,0,1
7732,10,4436,583;8830,1460,0,0,2,0,2
7733,10,4437,8843,1460,0,0,1,0,1
7734,10,4438,5982;8904,1460,0,0,2,0,2
7735,10,4439,8918,1460,0,0,1,0,1
7736,10,4440,9159;9243,1460,0,0,2,0,2
7737,10,4441,5261;9368,1460,0,0,2,0,2
7738,10,4442,9441,1460,0,0,1,0,1
7739,10,4443,8546;9544,1460,0,0,2,0,2
7740,10,4447,679,1460,0,0,1,0,1
7741,10,4448,1801;9963,1460,0,0,2,0,2
7742,10,4449,183;9947;11095,1825,1,0,2,0,3
7743,10,4450,271;6489,1825,0,0,2,0,2
7744,10,4451,430;8332,1825,0,0,2,0,2
7745,10,4452,636,1825,0,0,1,0,1
7746,10,4453,752;6413;10808,1825,1,0,2,0,3
7747,10,4454,1006;3563,1825,0,0,2,0,2
7748,10,4455,355;1031;10958,1825,1,0,2,0,3
7749,10,4457,6727,1825,0,0,1,0,1
7750,10,4458,1252,1825,0,0,1,0,1
7751,10,4459,356;1352;10679,1825,1,0,2,0,3
7752,10,4460,1546;9289,1825,0,0,2,0,2
7753,10,4461,1769;4030,1825,0,0,2,0,2
7754,10,4462,1836;4116,1825,0,0,2,0,2
7755,10,4463,1890;5741,1825,0,0,2,0,2
7756,10,4464,1988,1825,0,0,1,0,1
7757,10,4466,2213,1825,0,0,0,1,1
7758,10,4467,2387,1825,0,0,0,1,1
7759,10,4468,2438;8154;10849;10970,1825,2,0,2,0,4
7760,10,4469,609;9290,1825,0,0,2,0,2
7761,10,4470,2569,1825,0,0,1,0,1
7762,10,4471,2864,1825,0,0,1,0,1
7763,10,4472,3004;4015,1825,0,0,2,0,2
7764,10,4474,1263;3450,1825,0,0,2,0,2
7765,10,4475,2935;3544,1825,0,0,2,0,2
7766,10,4476,3610,1825,0,0,1,0,1
7767,10,4477,3681,1825,0,0,0,1,1
7768,10,4482,4178;4444;10846,1825,1,0,2,0,3
7769,10,4483,1936;6197;11028,1825,1,0,2,0,3
7770,10,4484,4315;9930,1825,0,0,2,0,2
7771,10,4485,732;4338,1825,0,0,2,0,2
7772,10,4486,4418,1825,0,0,1,0,1
7773,10,4487,4506;6064,1825,0,0,2,0,2
7774,10,4488,4615,1825,0,0,1,0,1
7775,10,4489,4678,1825,0,0,1,0,1
7776,10,4490,4703,1825,0,0,1,0,1
7777,10,4491,2687;4823,1825,0,0,2,0,2
7778,10,4492,5019,1825,0,0,1,0,1
7779,10,4493,9207,1825,0,0,1,0,1
7780,10,4494,5419;9651,1825,0,0,2,0,2
7781,10,4495,5430;7624,1825,0,0,2,0,2
7782,10,4496,5490;8567,1825,0,0,2,0,2
7783,10,4497,5493,1825,0,0,0,1,1
7784,10,4498,5533,1825,0,0,0,1,1
7785,10,4499,5539;8392,1825,0,0,2,0,2
7786,10,4500,3695;5617,1825,0,0,2,0,2
7787,10,4501,5636;6259,1825,0,0,2,0,2
7788,10,4502,5715;6037,1825,0,0,2,0,2
7789,10,4503,8741,1825,0,0,1,0,1
7790,10,4504,5774;9357,1825,0,0,2,0,2
7791,10,4505,5915,1825,0,0,0,1,1
7792,10,4506,5945,1825,0,0,1,0,1
7793,10,4507,5949;9015,1825,0,0,2,0,2
7794,10,4508,6001;6192,1825,0,0,2,0,2
7795,10,4509,2629;6107;10811;11075,1825,2,0,2,0,4
7796,10,4510,6211,1825,0,0,1,0,1
7797,10,4511,6213;7412,1825,0,0,2,0,2
7798,10,4512,4909;6325,1825,0,0,2,0,2
7799,10,4513,3947,1825,0,0,1,0,1
7800,10,4515,6239;6602,1825,0,0,2,0,2
7801,10,4516,6646,1825,0,0,1,0,1
7802,10,4517,6720,1825,0,0,1,0,1
7803,10,4518,7002,1825,0,0,1,0,1
7804,10,4519,1332;7043;10952,1825,1,0,2,0,3
7805,10,4520,7235,1825,0,0,1,0,1
7806,10,4523,6354;7508,1825,0,0,2,0,2
7807,10,4524,7564,1825,0,0,0,1,1
7808,10,4525,203;7683,1825,0,0,2,0,2
7809,10,4526,6689;7691;10720;10869,1825,2,0,2,0,4
7810,10,4527,2840;7868,1825,0,0,2,0,2
7811,10,4528,64;7989;10817,1825,1,0,2,0,3
7812,10,4531,3522;8155,1825,0,0,2,0,2
7813,10,4533,1958,1825,0,0,1,0,1
7814,10,4534,5000;6529,1825,0,0,2,0,2
7815,10,4535,8411,1825,0,0,0,1,1
7816,10,4536,1213;9105,1825,0,0,2,0,2
7817,10,4537,1586;8543;10841,1825,1,0,2,0,3
7818,10,4538,3397;8617,1825,0,0,2,0,2
7819,10,4539,8680;9684,1825,0,0,2,0,2
7820,10,4540,2843;8718,1825,0,0,2,0,2
7821,10,4541,3539;8747,1825,0,0,2,0,2
7822,10,4542,10,1825,0,0,1,0,1
7823,10,4543,239;6750,1825,0,0,2,0,2
7824,10,4544,3672;8922,1825,0,0,2,0,2
7825,10,4545,9024,1825,0,0,0,1,1
7826,10,4546,1123;9187;10602,1825,0,1,2,0,3
7827,10,4548,3865;9412,1825,0,0,2,0,2
7828,10,4549,9567,1825,0,0,0,1,1
7829,10,4550,6118,1825,0,0,1,0,1
7830,10,4552,9926,1825,0,0,1,0,1
7831,10,4553,9955,1825,0,0,0,1,1
7832,10,4554,8466,1825,0,0,1,0,1
7833,10,4555,9329;9996,1825,0,0,2,0,2
7834,10,4556,59,2190,0,0,0,1,1
7835,10,4557,65;5159;10661;10875;11023,2190,3,0,2,0,5
7836,10,4558,96;2741,2190,0,0,2,0,2
7837,10,4559,3924,2190,0,0,1,0,1
7838,10,4560,240;3449,2190,0,0,2,0,2
7839,10,4561,262;1515,2190,0,0,2,0,2
7840,10,4562,511;7404,2190,0,0,2,0,2
7841,10,4563,657,2190,0,0,1,0,1
7842,10,4564,773;945,2190,0,0,2,0,2
7843,10,4565,371;989,2190,0,0,2,0,2
7844,10,4566,1100;5377,2190,0,0,2,0,2
7845,10,4567,1151;5679,2190,0,0,2,0,2
7846,10,4568,1333;3419,2190,0,0,2,0,2
7847,10,4569,561;1776,2190,0,0,2,0,2
7848,10,4570,1873;7659,2190,0,0,2,0,2
7849,10,4571,1938;5189,2190,0,0,2,0,2
7850,10,4572,1962;9607,2190,0,0,2,0,2
7851,10,4573,2007;3758,2190,0,0,2,0,2
7852,10,4574,707;2206,2190,0,0,2,0,2
7853,10,4575,2301;6408,2190,0,0,2,0,2
7854,10,4576,603;2394;10664;10839,2190,2,0,2,0,4
7855,10,4577,642;2544,2190,0,0,2,0,2
7856,10,4579,2168;2742,2190,0,0,2,0,2
7857,10,4580,2755,2190,0,0,0,1,1
7858,10,4581,2067;2949,2190,0,0,2,0,2
7859,10,4582,2971;4061;10822,2190,1,0,2,0,3
7860,10,4583,2986;10001,2190,0,0,2,0,2
7861,10,4585,3085,2190,0,0,1,0,1
7862,10,4586,3174;3931;10786;10842,2190,2,0,2,0,4
7863,10,4587,3355,2190,0,0,1,0,1
7864,10,4588,3467;6537,2190,0,0,2,0,2
7865,10,4589,3167;3521,2190,0,0,2,0,2
7866,10,4590,9852,2190,0,0,1,0,1
7867,10,4592,3740,2190,0,0,1,0,1
7868,10,4593,3784,2190,0,0,0,1,1
7869,10,4594,3066;3807;10856,2190,1,0,2,0,3
7870,10,4595,2998;3824,2190,0,0,2,0,2
7871,10,4596,3962;9721,2190,0,0,2,0,2
7872,10,4597,4036,2190,0,0,1,0,1
7873,10,4598,4136;8652,2190,0,0,2,0,2
7874,10,4599,3128,2190,0,0,1,0,1
7875,10,4601,4331,2190,0,0,1,0,1
7876,10,4602,4373;9063,2190,0,0,2,0,2
7877,10,4603,5616;9221,2190,0,0,2,0,2
7878,10,4604,4479;7704,2190,0,0,2,0,2
7879,10,4605,4486;10815;11024,2190,2,0,1,0,3
7880,10,4606,4511;8561;10759,2190,1,0,2,0,3
7881,10,4607,1032;4527,2190,0,0,2,0,2
7882,10,4608,4589,2190,0,0,1,0,1
7883,10,4609,4735,2190,0,0,1,0,1
7884,10,4610,3869;4888,2190,0,0,2,0,2
7885,10,4611,5013,2190,0,0,1,0,1
7886,10,4612,5037,2190,0,0,1,0,1
7887,10,4613,5269;5339,2190,0,0,2,0,2
7888,10,4615,4522;9874,2190,0,0,2,0,2
7889,10,4617,5777,2190,0,0,1,0,1
7890,10,4618,6544,2190,0,0,1,0,1
7891,10,4619,5823,2190,0,0,1,0,1
7892,10,4620,5849,2190,0,0,1,0,1
7893,10,4621,5867,2190,0,0,1,0,1
7894,10,4622,5905;8226,2190,0,0,2,0,2
7895,10,4623,5799;6074,2190,0,0,2,0,2
7896,10,4624,1074;6170,2190,0,0,2,0,2
7897,10,4625,5432;6311;10757,2190,1,0,2,0,3
7898,10,4626,1165;6339;11047,2190,1,0,2,0,3
7899,10,4627,6463,2190,0,0,1,0,1
7900,10,4628,6706;9909,2190,0,0,2,0,2
7901,10,4629,6968,2190,0,0,1,0,1
7902,10,4630,2316;6974,2190,0,0,2,0,2
7903,10,4631,5191,2190,0,0,1,0,1
7904,10,4632,7047,2190,0,0,1,0,1
7905,10,4633,3922;7119,2190,0,0,2,0,2
7906,10,4634,7141,2190,0,0,1,0,1
7907,10,4635,182;3438;7238;10944,2190,1,1,2,0,4
7908,10,4636,6953;7495,2190,0,0,2,0,2
7909,10,4638,4920;7844,2190,0,0,2,0,2
7910,10,4639,7964,2190,0,0,1,0,1
7911,10,4640,8235,2190,0,0,1,0,1
7912,10,4641,3813;7836,2190,0,0,2,0,2
7913,10,4642,8254,2190,0,0,1,0,1
7914,10,4643,8256,2190,0,0,0,1,1
7915,10,4644,4553;8283,2190,0,0,2,0,2
7916,10,4646,1115;8470,2190,0,0,2,0,2
7917,10,4647,8492,2190,0,0,1,0,1
7918,10,4648,8604;9232,2190,0,0,2,0,2
7919,10,4649,2245;8679,2190,0,0,2,0,2
7920,10,4650,8707,2190,0,0,1,0,1
7921,10,4651,2679,2190,0,0,1,0,1
7922,10,4652,3155;8797,2190,0,0,2,0,2
7923,10,4653,8939,2190,0,0,0,1,1
7924,10,4654,181;9077,2190,0,0,2,0,2
7925,10,4655,3177;9112,2190,0,0,2,0,2
7926,10,4656,9263,2190,0,0,1,0,1
7927,10,4657,9282,2190,0,0,1,0,1
7928,10,4658,2559;9424,2190,0,0,2,0,2
7929,10,4659,2210;9510,2190,0,0,2,0,2
7930,10,4660,1754;3160,2190,0,0,2,0,2
7931,10,4661,9657,2190,0,0,1,0,1
7932,10,4662,9727,2190,0,0,1,0,1
7933,10,4663,513;9817,2190,0,0,2,0,2
7934,10,4664,8230;9895,2190,0,0,2,0,2
7935,10,4665,9932,2190,0,0,0,1,1
7936,10,4666,179;3477,2555,0,0,2,0,2
7937,10,4667,697,2555,0,0,1,0,1
7938,10,4668,720;1584,2555,0,0,2,0,2
7939,10,4669,863;1386,2555,0,0,2,0,2
7940,10,4670,893,2555,0,0,1,0,1
7941,10,4671,898;6070,2555,0,0,2,0,2
7942,10,4673,7899;9165,2555,0,0,2,0,2
7943,10,4674,1339,2555,0,0,1,0,1
7944,10,4677,1535;1824;11001;11033,2555,2,0,2,0,4
7945,10,4678,2306;7086,2555,0,0,2,0,2
7946,10,4679,1901;5086,2555,0,0,2,0,2
7947,10,4680,1910,2555,0,0,1,0,1
7948,10,4681,1957;9812,2555,0,0,2,0,2
7949,10,4682,1967,2555,0,0,1,0,1
7950,10,4683,2345;4027,2555,0,0,2,0,2
7951,10,4684,2436,2555,0,0,1,0,1
7952,10,4685,4893;6380,2555,0,0,2,0,2
7953,10,4686,2692;5025,2555,0,0,2,0,2
7954,10,4687,2792;4389,2555,0,0,2,0,2
7955,10,4688,4874,2555,0,0,1,0,1
7956,10,4689,2901;8853;10942,2555,1,0,2,0,3
7957,10,4690,1526;3012,2555,0,0,2,0,2
7958,10,4691,3072,2555,0,0,1,0,1
7959,10,4693,3993,2555,0,0,1,0,1
7960,10,4694,3407;8977,2555,0,0,2,0,2
7961,10,4695,1861;3567,2555,0,0,2,0,2
7962,10,4696,3574,2555,0,0,1,0,1
7963,10,4697,3638;7261,2555,0,0,2,0,2
7964,10,4699,5716,2555,0,0,1,0,1
7965,10,4700,3491;3847,2555,0,0,2,0,2
7966,10,4701,932;3879,2555,0,0,2,0,2
7967,10,4702,3996;4035,2555,0,0,2,0,2
7968,10,4703,4022;7808;10770;10912,2555,2,0,2,0,4
7969,10,4704,4039,2555,0,0,1,0,1
7970,10,4705,4111;8070,2555,0,0,2,0,2
7971,10,4706,4451,2555,0,0,0,1,1
7972,10,4707,4149;4628;10900,2555,1,0,2,0,3
7973,10,4708,110;4694,2555,0,0,2,0,2
7974,10,4709,4770;8674,2555,0,0,2,0,2
7975,10,4710,4808,2555,0,0,1,0,1
7976,10,4712,4880;7582,2555,0,0,2,0,2
7977,10,4713,1068;4891,2555,0,0,2,0,2
7978,10,4716,3650;4940,2555,0,0,2,0,2
7979,10,4717,4961,2555,0,0,1,0,1
7980,10,4719,1095;5133,2555,0,0,2,0,2
7981,10,4720,5201;6949,2555,0,0,2,0,2
7982,10,4721,5289;9564,2555,0,0,2,0,2
7983,10,4722,5319,2555,0,0,1,0,1
7984,10,4723,5478,2555,0,0,1,0,1
7985,10,4725,4978;5547,2555,0,0,2,0,2
7986,10,4726,5756,2555,0,0,1,0,1
7987,10,4727,5781,2555,0,0,1,0,1
7988,10,4728,5843,2555,0,0,1,0,1
7989,10,4729,5870;8396,2555,0,0,2,0,2
7990,10,4730,2787;6036,2555,0,0,2,0,2
7991,10,4731,6139;9138,2555,0,0,2,0,2
7992,10,4732,1122;6169,2555,0,0,2,0,2
7993,10,4733,5134;6184,2555,0,0,2,0,2
7994,10,4734,6187;9799,2555,0,0,2,0,2
7995,10,4735,6313;8589,2555,0,0,2,0,2
7996,10,4736,6318;9951;10813,2555,1,0,2,0,3
7997,10,4737,6775,2555,0,0,1,0,1
7998,10,4738,6917,2555,0,0,1,0,1
7999,10,4739,6932,2555,0,0,1,0,1
8000,10,4740,6973;9166,2555,0,0,2,0,2
8001,10,4741,4051;6999;11062,2555,1,0,2,0,3
8002,10,4742,2891;7036,2555,0,0,2,0,2
8003,10,4745,8822,2555,0,0,1,0,1
8004,10,4746,7574;8148,2555,0,0,2,0,2
8005,10,4747,7276;7672,2555,0,0,2,0,2
8006,10,4749,490;7776;10838,2555,1,0,2,0,3
8007,10,4750,2418;7867;10818,2555,1,0,2,0,3
8008,10,4751,7927;8388,2555,0,0,2,0,2
8009,10,4752,7988,2555,0,0,0,1,1
8010,10,4753,8020;8642,2555,0,0,2,0,2
8011,10,4755,8128,2555,0,0,1,0,1
8012,10,4756,7461;8144,2555,0,0,2,0,2
8013,10,4757,6464;8268,2555,0,0,2,0,2
8014,10,4759,8276,2555,0,0,1,0,1
8015,10,4760,2058;8336;10918,2555,1,0,2,0,3
8016,10,4761,8427,2555,0,0,1,0,1
8017,10,4762,6692;8560;10892,2555,1,0,2,0,3
8018,10,4763,8712;9257,2555,0,0,2,0,2
8019,10,4765,4073;8760;11006,2555,1,0,2,0,3
8020,10,4766,6723;8888,2555,0,0,2,0,2
8021,10,4767,5302;8893;10924,2555,1,0,2,0,3
8022,10,4768,8908,2555,0,0,0,1,1
8023,10,4769,6526;8966,2555,0,0,2,0,2
8024,10,4770,9246;9392,2555,0,0,2,0,2
8025,10,4771,9256;9358,2555,0,0,2,0,2
8026,10,4772,5704;9401,2555,0,0,2,0,2
8027,10,4773,2580,2555,0,0,1,0,1
8028,10,4774,8781;9562,2555,0,0,2,0,2
8029,10,4775,7913;9687;11020,2555,1,0,2,0,3
8030,10,4776,3010;9762,2555,0,0,2,0,2
8031,10,4777,8675;9837,2555,0,0,2,0,2
8032,10,4778,9925,2555,0,0,1,0,1
8033,10,4779,54;4449;10975;11089,2920,2,0,2,0,4
8034,10,4781,147;4668,2920,0,0,2,0,2
8035,10,4782,167,2920,0,0,1,0,1
8036,10,4783,254,2920,0,0,1,0,1
8037,10,4785,475;2092,2920,0,0,2,0,2
8038,10,4786,537;5063,2920,0,0,2,0,2
8039,10,4787,572,2920,0,0,1,0,1
8040,10,4789,4318,2920,0,0,1,0,1
8041,10,4790,7089;9829,2920,0,0,2,0,2
8042,10,4791,819,2920,0,0,0,1,1
8043,10,4793,1216;4103,2920,0,0,2,0,2
8044,10,4794,1238;2656,2920,0,0,2,0,2
8045,10,4795,1239;9571,2920,0,0,2,0,2
8046,10,4796,1270,2920,0,0,1,0,1
8047,10,4797,5379,2920,0,0,1,0,1
8048,10,4798,1516,2920,0,0,1,0,1
8049,10,4799,1615,2920,0,0,1,0,1
8050,10,4800,1217;1653,2920,0,0,2,0,2
8051,10,4801,1882;4475,2920,0,0,2,0,2
8052,10,4803,1935;5798,2920,0,0,2,0,2
8053,10,4804,2091;8628,2920,0,0,2,0,2
8054,10,4805,2500;2865,2920,0,0,2,0,2
8055,10,4806,4094;9970,2920,0,0,2,0,2
8056,10,4807,2543;7525,2920,0,0,2,0,2
8057,10,4808,2693;7553;10927,2920,1,0,2,0,3
8058,10,4809,2700;4953,2920,0,0,2,0,2
8059,10,4810,2717;6094,2920,0,0,2,0,2
8060,10,4811,1575;2815,2920,0,0,2,0,2
8061,10,4812,2847,2920,0,0,1,0,1
8062,10,4813,2925,2920,0,0,1,0,1
8063,10,4814,2967,2920,0,0,1,0,1
8064,10,4815,3082,2920,0,0,1,0,1
8065,10,4816,2798;3116,2920,0,0,2,0,2
8066,10,4817,3173;6554;10906,2920,1,0,2,0,3
8067,10,4818,1784;3192,2920,0,0,2,0,2
8068,10,4819,3277;8253,2920,0,0,2,0,2
8069,10,4820,2033;3400,2920,0,0,2,0,2
8070,10,4821,3463;8740,2920,0,0,2,0,2
8071,10,4822,3486,2920,0,0,1,0,1
8072,10,4823,3523;7488,2920,0,0,2,0,2
8073,10,4824,686;3566;11060,2920,1,0,2,0,3
8074,10,4825,3626;4348,2920,0,0,2,0,2
8075,10,4826,3754,2920,0,0,1,0,1
8076,10,4827,3772;9603,2920,0,0,2,0,2
8077,10,4828,3825,2920,0,0,1,0,1
8078,10,4829,3953,2920,0,0,1,0,1
8079,10,4830,272;3961,2920,0,0,2,0,2
8080,10,4831,4008,2920,0,0,1,0,1
8081,10,4832,4102;8169,2920,0,0,2,0,2
8082,10,4833,4220;7466,2920,0,0,2,0,2
8083,10,4834,4280;8285,2920,0,0,2,0,2
8084,10,4835,4293;5737,2920,0,0,2,0,2
8085,10,4836,4509;9739,2920,0,0,2,0,2
8086,10,4837,4601;6420,2920,0,0,2,0,2
8087,10,4838,4619,2920,0,0,1,0,1
8088,10,4839,3675;6971,2920,0,0,2,0,2
8089,10,4840,4667,2920,0,0,1,0,1
8090,10,4841,8125,2920,0,0,1,0,1
8091,10,4843,4859;8629;10917,2920,1,0,2,0,3
8092,10,4844,5073,2920,0,0,1,0,1
8093,10,4845,1652;5181,2920,0,0,2,0,2
8094,10,4846,1946,2920,0,0,1,0,1
8095,10,4847,5286,2920,0,0,1,0,1
8096,10,4848,5356,2920,0,0,1,0,1
8097,10,4849,5366,2920,0,0,1,0,1
8098,10,4850,1788;5410,2920,0,0,2,0,2
8099,10,4851,1247;5443,2920,0,0,2,0,2
8100,10,4852,5810,2920,0,0,1,0,1
8101,10,4853,5889,2920,0,0,1,0,1
8102,10,4855,6026,2920,0,0,0,1,1
8103,10,4856,6194;10998,2920,1,0,1,0,2
8104,10,4857,6230,2920,0,0,1,0,1
8105,10,4858,6405;7222,2920,0,0,2,0,2
8106,10,4859,6434;7690,2920,0,0,2,0,2
8107,10,4861,3749;6661,2920,0,0,2,0,2
8108,10,4862,6696;9352,2920,0,0,2,0,2
8109,10,4863,5612,2920,0,0,1,0,1
8110,10,4864,6751;7503;11007,2920,1,0,2,0,3
8111,10,4865,6912,2920,0,0,1,0,1
8112,10,4866,5974,2920,0,0,1,0,1
8113,10,4867,7387,2920,0,0,1,0,1
8114,10,4868,3531;7403,2920,0,0,2,0,2
8115,10,4869,3263,2920,0,0,1,0,1
8116,10,4870,1078;7459,2920,0,0,2,0,2
8117,10,4871,1157;7729;10923,2920,1,0,2,0,3
8118,10,4872,5963;7733,2920,0,0,2,0,2
8119,10,4873,7441,2920,0,0,1,0,1
8120,10,4875,397;7992,2920,0,0,2,0,2
8121,10,4876,6827;8043;11021,2920,1,0,2,0,3
8122,10,4877,6774;8083,2920,0,0,2,0,2
8123,10,4878,5981;8135,2920,0,0,2,0,2
8124,10,4879,3633;8211,2920,0,0,2,0,2
8125,10,4880,7505;8228,2920,0,0,2,0,2
8126,10,4881,8344,2920,0,0,1,0,1
8127,10,4882,8488,2920,0,0,1,0,1
8128,10,4883,6995;8502,2920,0,0,2,0,2
8129,10,4885,2800;8514,2920,0,0,2,0,2
8130,10,4886,3374;8568,2920,0,0,2,0,2
8131,10,4887,5278;8573,2920,0,0,2,0,2
8132,10,4888,7211;8584,2920,0,0,2,0,2
8133,10,4889,5606;8623,2920,0,0,2,0,2
8134,10,4890,8654,2920,0,0,0,1,1
8135,10,4891,8833,2920,0,0,1,0,1
8136,10,4892,8093,2920,0,0,1,0,1
8137,10,4893,8823;9003,2920,0,0,2,0,2
8138,10,4894,8552;9006;11010,2920,1,0,2,0,3
8139,10,4895,9068,2920,0,0,1,0,1
8140,10,4896,9088,2920,0,0,1,0,1
8141,10,4897,9174,2920,0,0,1,0,1
8142,10,4898,9228,2920,0,0,1,0,1
8143,10,4899,7227,2920,0,0,1,0,1
8144,10,4900,9350,2920,0,0,1,0,1
8145,10,4901,8122;9369,2920,0,0,2,0,2
8146,10,4902,9467,2920,0,0,1,0,1
8147,10,4903,9541,2920,0,0,1,0,1
8148,10,4904,3925,2920,0,0,1,0,1
8149,10,4905,9623,2920,0,0,1,0,1
8150,10,4906,5024;9768,2920,0,0,2,0,2
8151,10,4907,8270;9816;10963,2920,1,0,2,0,3
8152,10,4908,9901,2920,0,0,1,0,1
8153,10,4909,7409,2920,0,0,1,0,1
8154,10,4910,52,3285,0,0,0,1,1
8155,10,4911,84;4308;11056,3285,1,0,2,0,3
8156,10,4912,112;3315,3285,0,0,2,0,2
8157,10,4913,4499,3285,0,0,1,0,1
8158,10,4914,153;6981;10921,3285,1,0,2,0,3
8159,10,4915,278;4381,3285,0,0,2,0,2
8160,10,4916,286,3285,0,0,1,0,1
8161,10,4917,6659,3285,0,0,1,0,1
8162,10,4918,349;3748,3285,0,0,2,0,2
8163,10,4919,8732,3285,0,0,1,0,1
8164,10,4920,7431,3285,0,0,1,0,1
8165,10,4921,467,3285,0,0,1,0,1
8166,10,4922,623,3285,0,0,1,0,1
8167,10,4923,630;1344,3285,0,0,2,0,2
8168,10,4924,7030,3285,0,0,1,0,1
8169,10,4925,659,3285,0,0,1,0,1
8170,10,4926,811;1140,3285,0,0,2,0,2
8171,10,4927,536;853,3285,0,0,2,0,2
8172,10,4928,3343,3285,0,0,1,0,1
8173,10,4929,985;3207,3285,0,0,2,0,2
8174,10,4930,1084;6743,3285,0,0,2,0,2
8175,10,4931,1153,3285,0,0,1,0,1
8176,10,4932,1296,3285,0,0,1,0,1
8177,10,4933,4548,3285,0,0,1,0,1
8178,10,4934,1340,3285,0,0,1,0,1
8179,10,4935,1376;9588;11013,3285,1,0,2,0,3
8180,10,4936,1534;6896,3285,0,0,2,0,2
8181,10,4937,1561;1894,3285,0,0,2,0,2
8182,10,4938,1707;2433,3285,0,0,2,0,2
8183,10,4939,1900,3285,0,0,1,0,1
8184,10,4940,1990;4043,3285,0,0,2,0,2
8185,10,4941,2010;4721,3285,0,0,2,0,2
8186,10,4942,1178,3285,0,0,1,0,1
8187,10,4944,2120,3285,0,0,1,0,1
8188,10,4945,2169;2189,3285,0,0,2,0,2
8189,10,4946,2177,3285,0,0,0,1,1
8190,10,4947,2462;2517,3285,0,0,2,0,2
8191,10,4948,2477,3285,0,0,1,0,1
8192,10,4949,2623,3285,0,0,1,0,1
8193,10,4950,2670;3164,3285,0,0,2,0,2
8194,10,4951,413;2817,3285,0,0,2,0,2
8195,10,4952,2914;5099,3285,0,0,2,0,2
8196,10,4953,2943,3285,0,0,1,0,1
8197,10,4954,3168,3285,0,0,1,0,1
8198,10,4955,3457;5330,3285,0,0,2,0,2
8199,10,4956,3560;8099,3285,0,0,2,0,2
8200,10,4957,3596,3285,0,0,0,1,1
8201,10,4958,3621;9819,3285,0,0,2,0,2
8202,10,4959,3639,3285,0,0,1,0,1
8203,10,4960,3712,3285,0,0,1,0,1
8204,10,4961,3762,3285,0,0,1,0,1
8205,10,4963,3976;7237;11076,3285,1,0,2,0,3
8206,10,4965,4105,3285,0,0,1,0,1
8207,10,4966,2093;4169,3285,0,0,2,0,2
8208,10,4967,4259,3285,0,0,1,0,1
8209,10,4968,4416;8022,3285,0,0,2,0,2
8210,10,4969,4637;7679,3285,0,0,2,0,2
8211,10,4970,4765,3285,0,0,0,1,1
8212,10,4971,5021;8672,3285,0,0,2,0,2
8213,10,4972,4165;5044,3285,0,0,2,0,2
8214,10,4973,5281,3285,0,0,1,0,1
8215,10,4974,2014;5296,3285,0,0,2,0,2
8216,10,4975,5372;6978,3285,0,0,2,0,2
8217,10,4976,5622,3285,0,0,1,0,1
8218,10,4977,9937,3285,0,0,1,0,1
8219,10,4978,5702;5780,3285,0,0,2,0,2
8220,10,4979,5708,3285,0,0,1,0,1
8221,10,4981,5726;7275;11065,3285,1,0,2,0,3
8222,10,4982,6017,3285,0,0,1,0,1
8223,10,4983,9714,3285,0,0,1,0,1
8224,10,4984,6126,3285,0,0,1,0,1
8225,10,4985,6154,3285,0,0,1,0,1
8226,10,4986,6179,3285,0,0,1,0,1
8227,10,4987,5692;6188,3285,0,0,2,0,2
8228,10,4988,1613,3285,0,0,1,0,1
8229,10,4989,6295,3285,0,0,1,0,1
8230,10,4991,6496,3285,0,0,1,0,1
8231,10,4992,6503;8527,3285,0,0,2,0,2
8232,10,4993,2385;6586,3285,0,0,2,0,2
8233,10,4994,6622;9251,3285,0,0,2,0,2
8234,10,4995,1394,3285,0,0,1,0,1
8235,10,4996,6964,3285,0,0,1,0,1
8236,10,4997,7308,3285,0,0,1,0,1
8237,10,4998,7078,3285,0,0,1,0,1
8238,10,4999,7093,3285,0,0,1,0,1
8239,10,5000,7570,3285,0,0,1,0,1
8240,10,5001,7278,3285,0,0,1,0,1
8241,10,5002,3117;7332,3285,0,0,2,0,2
8242,10,5003,7343;7353,3285,0,0,2,0,2
8243,10,5004,7357;8019,3285,0,0,2,0,2
8244,10,5005,4362,3285,0,0,1,0,1
8245,10,5006,2508,3285,0,0,1,0,1
8246,10,5007,4873;7872,3285,0,0,2,0,2
8247,10,5008,2246;7874,3285,0,0,2,0,2
8248,10,5009,8042,3285,0,0,1,0,1
8249,10,5010,8106,3285,0,0,1,0,1
8250,10,5011,8324,3285,0,0,1,0,1
8251,10,5012,8587,3285,0,0,1,0,1
8252,10,5013,333;8591,3285,0,0,2,0,2
8253,10,5015,8318;8814,3285,0,0,2,0,2
8254,10,5016,8815,3285,0,0,1,0,1
8255,10,5017,4737,3285,0,0,1,0,1
8256,10,5018,6948,3285,0,0,1,0,1
8257,10,5019,2681;9009,3285,0,0,2,0,2
8258,10,5020,8899;9114,3285,0,0,2,0,2
8259,10,5021,2756,3285,0,0,1,0,1
8260,10,5022,5031;9596;11080,3285,1,0,2,0,3
8261,10,5023,8592;9639,3285,0,0,2,0,2
8262,10,5024,9743,3285,0,0,1,0,1
8263,10,5025,2240;9787,3285,0,0,2,0,2
8264,10,5026,5824,3285,0,0,1,0,1
8265,10,5027,6360,3285,0,0,1,0,1
8266,10,5028,9975,3285,0,0,1,0,1
8267,10,5029,3132;9985,3285,0,0,2,0,2
8268,10,5030,71,3650,0,0,1,0,1
8269,10,5031,146,3650,0,0,1,0,1
8270,10,5032,611,3650,0,0,0,1,1
8271,10,5033,706;4400,3650,0,0,2,0,2
8272,10,5034,216;801,3650,0,0,2,0,2
8273,10,5035,806,3650,0,0,1,0,1
8274,10,5036,4408,3650,0,0,1,0,1
8275,10,5037,867,3650,0,0,1,0,1
8276,10,5038,891;3308,3650,0,0,2,0,2
8277,10,5039,1061;3406,3650,0,0,2,0,2
8278,10,5040,1288;7051,3650,0,0,2,0,2
8279,10,5041,1369,3650,0,0,1,0,1
8280,10,5042,1407,3650,0,0,1,0,1
8281,10,5043,1453;5216,3650,0,0,2,0,2
8282,10,5044,1654;6604,3650,0,0,2,0,2
8283,10,5045,1656,3650,0,0,0,1,1
8284,10,5046,1789;3202,3650,0,0,2,0,2
8285,10,5047,1813,3650,0,0,1,0,1
8286,10,5048,1915,3650,0,0,1,0,1
8287,10,5049,6759,3650,0,0,1,0,1
8288,10,5050,2117;3103,3650,0,0,2,0,2
8289,10,5051,2145,3650,0,0,1,0,1
8290,10,5052,2203;2359,3650,0,0,2,0,2
8291,10,5053,2232;8624,3650,0,0,2,0,2
8292,10,5054,1599;2239,3650,0,0,2,0,2
8293,10,5055,1236;2556,3650,0,0,2,0,2
8294,10,5056,2651;9336;11073,3650,1,1,1,0,3
8295,10,5057,2676,3650,0,0,1,0,1
8296,10,5058,2766;9848,3650,0,0,2,0,2
8297,10,5059,2791,3650,0,0,1,0,1
8298,10,5060,2851,3650,0,0,1,0,1
8299,10,5061,3212,3650,0,0,1,0,1
8300,10,5062,685;3395;11086,3650,1,0,2,0,3
8301,10,5063,6025,3650,0,0,1,0,1
8302,10,5064,2887;5008,3650,0,0,2,0,2
8303,10,5065,1147;3437,3650,0,0,2,0,2
8304,10,5066,8882,3650,0,0,1,0,1
8305,10,5067,3607,3650,0,0,1,0,1
8306,10,5068,3704;4101,3650,0,0,2,0,2
8307,10,5069,1321;3759,3650,0,0,2,0,2
8308,10,5070,3802;7203,3650,0,0,2,0,2
8309,10,5071,3819,3650,0,0,0,1,1
8310,10,5072,3872;7391,3650,0,0,2,0,2
8311,10,5073,229,3650,0,0,1,0,1
8312,10,5074,5918,3650,0,0,1,0,1
8313,10,5075,4129;6108,3650,0,0,2,0,2
8314,10,5076,2054,3650,0,0,1,0,1
8315,10,5077,4423,3650,0,0,1,0,1
8316,10,5078,3380;4586,3650,0,0,2,0,2
8317,10,5079,4595;7739,3650,0,0,2,0,2
8318,10,5080,4659,3650,0,0,1,0,1
8319,10,5081,4771;8497,3650,0,0,2,0,2
8320,10,5082,4818,3650,0,0,1,0,1
8321,10,5083,4843,3650,0,0,0,1,1
8322,10,5084,4854;9226,3650,0,0,2,0,2
8323,10,5085,4964,3650,0,0,1,0,1
8324,10,5086,2805;5046,3650,0,0,2,0,2
8325,10,5087,5295,3650,0,0,1,0,1
8326,10,5088,5318;6688,3650,0,0,2,0,2
8327,10,5089,5442;6792,3650,0,0,2,0,2
8328,10,5090,5476,3650,0,0,1,0,1
8329,10,5091,5590;7969,3650,0,0,2,0,2
8330,10,5092,5619,3650,0,0,1,0,1
8331,10,5093,5661;9484,3650,0,0,2,0,2
8332,10,5094,4368;5787,3650,0,0,2,0,2
8333,10,5095,5804,3650,0,0,1,0,1
8334,10,5096,5808,3650,0,0,1,0,1
8335,10,5097,4828;5863,3650,0,0,2,0,2
8336,10,5098,5932,3650,0,0,0,1,1
8337,10,5099,5966,3650,0,0,1,0,1
8338,10,5100,5967,3650,0,0,1,0,1
8339,10,5101,6201;8785,3650,0,0,2,0,2
8340,10,5102,6215,3650,0,0,1,0,1
8341,10,5103,1714;6331,3650,0,0,2,0,2
8342,10,5104,6381,3650,0,0,1,0,1
8343,10,5105,6383,3650,0,0,1,0,1
8344,10,5106,9922,3650,0,0,1,0,1
8345,10,5107,6512,3650,0,0,1,0,1
8346,10,5108,4655;6536,3650,0,0,2,0,2
8347,10,5109,6559,3650,0,0,1,0,1
8348,10,5110,6605;7520,3650,0,0,2,0,2
8349,10,5111,1195,3650,0,0,1,0,1
8350,10,5112,6629;6675,3650,0,0,2,0,2
8351,10,5113,6987,3650,0,0,0,1,1
8352,10,5114,7082,3650,0,0,1,0,1
8353,10,5115,2625;7192,3650,0,0,2,0,2
8354,10,5116,7255,3650,0,0,1,0,1
8355,10,5117,7294;8996,3650,0,0,2,0,2
8356,10,5118,7306;9418,3650,0,0,2,0,2
8357,10,5119,4799;7385,3650,0,0,2,0,2
8358,10,5120,7398;9118,3650,0,1,1,0,2
8359,10,5121,7460,3650,0,0,1,0,1
8360,10,5122,7623,3650,0,0,1,0,1
8361,10,5123,7746,3650,0,0,1,0,1
8362,10,5124,7873;8133,3650,0,0,2,0,2
8363,10,5125,8086,3650,0,0,1,0,1
8364,10,5126,8386,3650,0,0,0,1,1
8365,10,5127,8072,3650,0,0,1,0,1
8366,10,5128,2215;8538,3650,0,0,2,0,2
8367,10,5129,8547,3650,0,0,1,0,1
8368,10,5130,2494;8572,3650,0,0,2,0,2
8369,10,5131,8609,3650,0,0,1,0,1
8370,10,5132,7372,3650,0,0,1,0,1
8371,10,5133,7815;8857,3650,0,0,2,0,2
8372,10,5134,8290;8858,3650,0,0,2,0,2
8373,10,5135,4514;8912,3650,0,0,2,0,2
8374,10,5136,4141;8928,3650,0,0,2,0,2
8375,10,5137,8991,3650,0,0,1,0,1
8376,10,5138,9798;11087,3650,1,0,1,0,2
8377,10,5139,9163,3650,0,0,1,0,1
8378,10,5140,4053;9224,3650,0,0,2,0,2
8379,10,5141,6509,3650,0,0,1,0,1
8380,10,5142,3219;9356,3650,0,0,2,0,2
8381,10,5143,8934;9410,3650,0,0,2,0,2
8382,10,5144,9429,3650,0,0,1,0,1
8383,10,5145,3946,3650,0,0,1,0,1
8384,10,5146,5709;9573,3650,0,0,2,0,2
8385,10,5147,753;9585,3650,0,0,2,0,2
8386,10,5148,9612,3650,0,0,1,0,1
8387,10,5149,9708,3650,0,0,1,0,1
8388,10,5150,9007,3650,0,0,1,0,1
8389,20,0,1,0,0,0,0,1,1
8390,20,1,4;10561;10941;11962,0,1,2,1,0,4
8391,20,2,13;1571,0,0,0,2,0,2
8392,20,3,14,0,0,0,0,1,1
8393,20,4,4337;10067;11703;11988,0,2,0,2,0,4
8394,20,6,20;21,0,0,0,1,1,2
8395,20,7,23;24,0,0,0,0,2,2
8396,20,8,25;26;10312;10355,0,0,0,4,0,4
8397,20,9,27;28;29,0,0,0,2,1,3
8398,20,12,33,0,0,0,0,1,1
8399,20,13,39;2735;10529;10728,0,0,2,2,0,4
8400,20,14,41;42,0,0,0,1,1,2
8401,20,15,46;47;49,0,0,0,2,1,3
8402,20,16,51;916;10137;10462;10951,0,0,2,3,0,5
8403,20,17,53;56;57;5819,0,0,0,4,0,4
8404,20,18,58;4607;10410,0,0,0,3,0,3
8405,20,19,60;61,0,0,0,1,1,2
8406,20,20,62;63;11812,0,1,0,1,1,3
8407,20,21,67,0,0,0,0,1,1
8408,20,22,70;10586;10635;11039;11116,0,0,4,1,0,5
8409,20,23,72;73,0,0,0,0,2,2
8410,20,24,76;77,0,0,0,0,2,2
8411,20,25,81;9436;11937,0,1,0,2,0,3
8412,20,27,85;86,0,0,0,1,1,2
8413,20,28,88;89,0,0,0,1,1,2
8414,20,29,91;92;10893;11163,0,0,2,1,1,4
8415,20,30,95;1306;10374;10691,0,0,1,3,0,4
8416,20,32,98,0,0,0,0,1,1
8417,20,33,99;100,0,0,0,2,0,2
8418,20,35,104,0,0,0,0,1,1
8419,20,36,108;109,0,0,0,1,1,2
8420,20,37,115;116;3825,0,0,0,1,2,3
8421,20,38,117;118;11276;11319,0,0,2,2,0,4
8422,20,39,121,0,0,0,0,1,1
8423,20,40,124;125,0,0,0,1,1,2
8424,20,42,129,0,0,0,0,1,1
8425,20,43,131;9034,0,0,0,2,0,2
8426,20,44,133;134;135,0,0,0,2,1,3
8427,20,46,138;7434,0,0,0,0,2,2
8428,20,47,140,0,0,0,0,1,1
8429,20,48,141;2463,0,0,0,2,0,2
8430,20,49,142;145,0,0,0,0,2,2
8431,20,50,148,0,0,0,1,0,1
8432,20,51,150,0,0,0,1,0,1
8433,20,52,151,0,0,0,1,0,1
8434,20,53,154;9550;10021;10307;10452,0,0,1,4,0,5
8435,20,54,156;159;160,0,0,0,2,1,3
8436,20,55,3627;5598,0,0,0,2,0,2
8437,20,56,164;576;10008;10712;10881;11098,0,0,3,3,0,6
8438,20,57,165;166,0,0,0,1,1,2
8439,20,58,170;4427,0,0,0,1,1,2
8440,20,59,171;172,0,0,0,1,1,2
8441,20,60,173;175,0,0,0,2,0,2
8442,20,61,180;2875;11686,0,1,0,2,0,3
8443,20,62,185,0,0,0,0,1,1
8444,20,63,189;8931;11626;11821;11981,0,3,0,2,0,5
8445,20,64,190;192,0,0,0,2,0,2
8446,20,65,193;194,0,0,0,1,1,2
8447,20,66,195;10981;11261,0,0,2,1,0,3
8448,20,67,198;199;3755,0,0,0,3,0,3
8449,20,68,204,0,0,0,0,1,1
8450,20,69,206;207,0,0,0,1,1,2
8451,20,70,208,0,0,0,0,1,1
8452,20,71,209;2759;10503;10505;10853,0,0,3,2,0,5
8453,20,73,214;215;218,0,0,0,2,1,3
8454,20,74,221;3903,0,0,0,2,0,2
8455,20,77,226;227,0,0,0,1,1,2
8456,20,78,230;231,0,0,0,0,2,2
8457,20,79,234;235,0,0,0,0,2,2
8458,20,80,238,0,0,0,0,1,1
8459,20,81,241,0,0,0,0,1,1
8460,20,82,243;244,0,0,0,2,0,2
8461,20,83,245;246,0,0,0,0,2,2
8462,20,84,249,0,0,0,1,0,1
8463,20,85,251;252,0,0,0,0,2,2
8464,20,88,256;257,0,0,0,0,2,2
8465,20,89,258;816,0,0,0,2,0,2
8466,20,90,261;10062,0,0,0,2,0,2
8467,20,91,263,0,0,0,0,1,1
8468,20,93,265;267;268,0,0,0,1,2,3
8469,20,94,269,0,0,0,0,1,1
8470,20,99,281;283,0,0,0,0,2,2
8471,20,100,285,0,0,0,0,1,1
8472,20,101,287,0,0,0,0,1,1
8473,20,102,288;289,0,0,0,0,2,2
8474,20,103,290,0,0,0,0,1,1
8475,20,104,295;5239,0,0,0,1,1,2
8476,20,105,297;5510,0,0,0,0,2,2
8477,20,106,298;300,0,0,0,1,1,2
8478,20,107,301;3705,0,0,0,2,0,2
8479,20,109,304;306,0,0,0,0,2,2
8480,20,110,311,0,0,0,0,1,1
8481,20,111,312;314,0,0,0,0,2,2
8482,20,112,320;1039,0,0,0,2,0,2
8483,20,113,322;5282,0,0,0,2,0,2
8484,20,116,327,0,0,0,1,0,1
8485,20,117,328,0,0,0,0,1,1
8486,20,118,332;2314,0,0,0,2,0,2
8487,20,119,335,0,0,0,0,1,1
8488,20,121,339,0,0,0,0,1,1
8489,20,122,341;342,0,0,0,0,2,2
8490,20,123,343,0,0,0,0,1,1
8491,20,124,344;345,0,0,0,1,1,2
8492,20,125,346;347,0,0,0,1,1,2
8493,20,127,352;2748;11002,0,0,1,2,0,3
8494,20,128,354;10628;10765;11234,0,0,3,1,0,4
8495,20,129,358;359,0,0,0,2,0,2
8496,20,130,362;8602,0,0,0,2,0,2
8497,20,131,363;364;10741,0,0,1,1,1,3
8498,20,132,366;367;3661;10612;10863,0,0,2,3,0,5
8499,20,135,373,0,0,0,0,1,1
8500,20,137,484;2331,0,0,0,2,0,2
8501,20,138,382;383;8031,0,0,0,3,0,3
8502,20,139,384;385,0,0,0,1,1,2
8503,20,140,5755;10703;10995;11066,0,0,3,1,0,4
8504,20,141,389,0,0,0,0,1,1
8505,20,142,4408,0,0,0,0,1,1
8506,20,143,394;6674,0,0,0,2,0,2
8507,20,144,396;11371;11556,0,0,2,1,0,3
8508,20,145,398,0,0,0,1,0,1
8509,20,146,400,0,0,0,0,1,1
8510,20,147,401;1424;10831;11403,0,0,2,2,0,4
8511,20,148,403;405,0,0,0,1,1,2
8512,20,150,407;408,0,0,0,0,2,2
8513,20,151,406;411;10771,0,0,1,2,0,3
8514,20,152,412;414,0,0,0,2,0,2
8515,20,155,417,0,0,0,0,1,1
8516,20,156,418;420,0,0,0,0,2,2
8517,20,157,422;424,0,0,0,0,2,2
8518,20,158,426;1297,0,0,0,0,2,2
8519,20,159,427;428,0,0,0,2,0,2
8520,20,160,429,0,0,0,0,1,1
8521,20,161,432,0,0,0,0,1,1
8522,20,162,435;436;10378;11162;11853,0,1,1,2,1,5
8523,20,163,437;438,0,0,0,0,2,2
8524,20,164,441,0,0,0,0,1,1
8525,20,165,446;447;448,0,0,0,3,0,3
8526,20,166,449;7557,0,0,0,2,0,2
8527,20,167,451;452;10405;10745,0,0,1,2,1,4
8528,20,168,453;454,0,0,0,1,1,2
8529,20,169,456;460;461,0,0,0,2,1,3
8530,20,170,463,0,0,0,0,1,1
8531,20,171,464;465,0,0,0,0,2,2
8532,20,173,3238;9117;11986,0,1,0,2,0,3
8533,20,174,472,0,0,0,0,1,1
8534,20,175,473;474;476,0,0,0,1,2,3
8535,20,176,479;6937;9796,0,0,0,1,2,3
8536,20,177,481;482,0,0,0,0,2,2
8537,20,178,486;487;488;756;2099;2555;10108;10347;10649,0,0,1,8,0,9
8538,20,179,491;492;7346;10194;10894;11502,0,0,2,3,1,6
8539,20,180,495,0,0,0,0,1,1
8540,20,181,496,0,0,0,1,0,1
8541,20,182,498;499,0,0,0,1,1,2
8542,20,183,500;7490;11104;12013,0,1,1,2,0,4
8543,20,184,502;10358;10422;11190,0,0,2,2,0,4
8544,20,185,504;505,0,0,0,1,1,2
8545,20,188,509;510,0,0,0,0,2,2
8546,20,191,522;7559,0,0,0,1,1,2
8547,20,193,529;530,0,0,0,0,2,2
8548,20,194,531;9288,0,0,0,2,0,2
8549,20,195,532;1463,0,0,0,1,1,2
8550,20,197,3912;7514,0,0,0,2,0,2
8551,20,198,539,0,0,0,0,1,1
8552,20,199,541;6315,0,0,0,2,0,2
8553,20,200,543,0,0,0,0,1,1
8554,20,202,551,0,0,0,0,1,1
8555,20,203,554;6761;10593;11248,0,0,2,2,0,4
8556,20,205,559,0,0,0,0,1,1
8557,20,206,563,0,0,0,0,1,1
8558,20,207,565;568;4369;11871,0,1,0,3,0,4
8559,20,208,569;7268,0,0,0,0,2,2
8560,20,209,571;5145,0,0,0,0,2,2
8561,20,216,581;582;584,0,0,0,3,0,3
8562,20,219,591,0,0,0,0,1,1
8563,20,220,595;596,0,0,0,2,0,2
8564,20,223,601;602,0,0,0,0,2,2
8565,20,224,605,0,0,0,0,1,1
8566,20,226,971;2459,0,0,0,0,2,2
8567,20,227,610;613;5622,0,0,0,1,2,3
8568,20,228,614;615,0,0,0,0,2,2
8569,20,230,620;4407,0,0,0,2,0,2
8570,20,231,622,0,0,0,1,0,1
8571,20,233,624;626,0,0,0,1,1,2
8572,20,234,627,0,0,0,0,1,1
8573,20,235,629;8763;10453;10774;10943,0,0,3,2,0,5
8574,20,236,634,0,0,0,1,0,1
8575,20,238,638,0,0,0,0,1,1
8576,20,239,641;8224;11488,0,0,1,2,0,3
8577,20,240,644;10417;10638;11072,0,0,2,2,0,4
8578,20,241,647;648,0,0,0,1,1,2
8579,20,243,651;653,0,0,0,2,0,2
8580,20,245,656,0,0,0,0,1,1
8581,20,246,253;9833;10369,0,0,0,3,0,3
8582,20,247,660,0,0,0,0,1,1
8583,20,249,663;664,0,0,0,0,2,2
8584,20,251,669;5509,0,0,0,0,2,2
8585,20,252,670,0,0,0,0,1,1
8586,20,253,671;5902,0,0,0,2,0,2
8587,20,254,675;676,0,0,0,1,1,2
8588,20,255,678,0,0,0,0,1,1
8589,20,256,682;683,0,0,0,1,1,2
8590,20,257,687,0,0,0,1,0,1
8591,20,258,689;10195;10640,0,0,1,2,0,3
8592,20,259,690,0,0,0,0,1,1
8593,20,260,692,0,0,0,0,1,1
8594,20,262,694;9385,0,0,0,0,2,2
8595,20,265,699;700,0,0,0,1,1,2
8596,20,266,703,0,0,0,0,1,1
8597,20,268,708;3877,0,0,0,0,2,2
8598,20,269,710,0,0,0,1,0,1
8599,20,271,666;715,0,0,0,0,2,2
8600,20,272,717,0,0,0,0,1,1
8601,20,273,718;719;721,0,0,0,2,1,3
8602,20,274,722;723;11459,0,0,1,1,1,3
8603,20,275,725;727,0,0,0,0,2,2
8604,20,276,729,0,0,0,0,1,1
8605,20,277,734;735,0,0,0,0,2,2
8606,20,280,739;740,0,0,0,1,1,2
8607,20,281,741;742,0,0,0,1,1,2
8608,20,282,743,0,0,0,0,1,1
8609,20,284,747,0,0,0,1,0,1
8610,20,286,750,0,0,0,1,0,1
8611,20,289,757;758,0,0,0,1,1,2
8612,20,291,4861,0,0,0,1,0,1
8613,20,295,766;767,0,0,0,1,1,2
8614,20,296,769,0,0,0,0,1,1
8615,20,298,775;2561,0,0,0,0,2,2
8616,20,299,780,0,0,0,0,1,1
8617,20,300,782;783,0,0,0,1,1,2
8618,20,301,785,0,0,0,0,1,1
8619,20,302,788;8259,0,0,0,0,2,2
8620,20,303,789;8361,0,0,0,2,0,2
8621,20,304,793;794;795;3699;4649,0,0,0,5,0,5
8622,20,305,796;7661,0,0,0,2,0,2
8623,20,306,800;802;804;1945;10106;10457;11340,0,0,2,5,0,7
8624,20,308,807,0,0,0,1,0,1
8625,20,309,808;810,0,0,0,1,1,2
8626,20,310,812;813,0,0,0,2,0,2
8627,20,311,814;8558,0,0,0,1,1,2
8628,20,313,818;5690,0,0,0,2,0,2
8629,20,314,820;1679,0,0,0,2,0,2
8630,20,315,821;822,0,0,0,0,2,2
8631,20,317,829,0,0,0,1,0,1
8632,20,319,832,0,0,0,0,1,1
8633,20,321,835;836;839,0,0,0,1,2,3
8634,20,324,847;2441,0,0,0,2,0,2
8635,20,325,849,0,0,0,0,1,1
8636,20,327,854;855,0,0,0,1,1,2
8637,20,329,858;5094;10626,0,0,1,2,0,3
8638,20,330,861;865;7454,0,0,0,2,1,3
8639,20,332,868;869;10751,0,0,1,1,1,3
8640,20,334,876;10174,0,0,0,2,0,2
8641,20,335,879;9878,0,0,0,2,0,2
8642,20,336,881;882,0,0,0,2,0,2
8643,20,339,889;890,0,0,0,1,1,2
8644,20,340,894;895;896;2674,0,0,0,4,0,4
8645,20,342,899,0,0,0,0,1,1
8646,20,343,904;905,0,0,0,0,2,2
8647,20,344,906;907;909,0,0,0,2,1,3
8648,20,347,912;913,0,0,0,0,2,2
8649,20,348,914;7109,0,0,0,2,0,2
8650,20,350,918,0,0,0,0,1,1
8651,20,351,922,0,0,0,1,0,1
8652,20,352,924;925,0,0,0,2,0,2
8653,20,353,928,0,0,0,0,1,1
8654,20,354,930;8984;10136;10749;11052;11195,0,0,3,3,0,6
8655,20,355,935,0,0,0,0,1,1
8656,20,356,937,0,0,0,0,1,1
8657,20,358,942;944,0,0,0,2,0,2
8658,20,359,946,0,0,0,0,1,1
8659,20,360,947;3662,0,0,0,0,2,2
8660,20,361,948;952;10630;10901;11036,0,0,3,2,0,5
8661,20,362,954;955,0,0,0,2,0,2
8662,20,364,30;962,0,0,0,0,2,2
8663,20,365,965;966,0,0,0,1,1,2
8664,20,366,968,0,0,0,0,1,1
8665,20,367,969,0,0,0,0,1,1
8666,20,368,981,0,0,0,0,1,1
8667,20,371,991;8104,0,0,0,2,0,2
8668,20,373,994;995,0,0,0,0,2,2
8669,20,374,996;5825,0,0,0,0,2,2
8670,20,375,998,0,0,0,0,1,1
8671,20,376,1000;11901,0,1,0,1,0,2
8672,20,378,1004;1005,0,0,0,1,1,2
8673,20,379,1007;1008,0,0,0,0,2,2
8674,20,380,1011,0,0,0,0,1,1
8675,20,381,1013,0,0,0,1,0,1
8676,20,382,1015,0,0,0,0,1,1
8677,20,387,1025;1026;3391,0,0,0,3,0,3
8678,20,388,1028;1029,0,0,0,1,1,2
8679,20,389,1033;1035,0,0,0,1,1,2
8680,20,390,737;1036,0,0,0,0,2,2
8681,20,391,1038,0,0,0,0,1,1
8682,20,393,1041;1044,0,0,0,1,1,2
8683,20,394,1046;9576,0,0,0,2,0,2
8684,20,395,1047;1048;1049;1051,0,0,0,2,2,4
8685,20,396,1052,0,0,0,0,1,1
8686,20,397,1057;3836,0,0,0,0,2,2
8687,20,398,1058;3444,0,0,0,2,0,2
8688,20,399,1060,0,0,0,1,0,1
8689,20,400,1063;1065;8480,0,0,0,2,1,3
8690,20,401,1066,0,0,0,0,1,1
8691,20,403,1069;7299,0,0,0,1,1,2
8692,20,404,1072;1073,0,0,0,0,2,2
8693,20,406,1076;1077;10072;10491,0,0,1,2,1,4
8694,20,409,1080;1081,0,0,0,0,2,2
8695,20,410,1082;1981;10239;10725,0,0,1,3,0,4
8696,20,411,1083;12073,0,1,0,1,0,2
8697,20,412,1085,0,0,0,0,1,1
8698,20,413,1087;9147,0,0,0,0,2,2
8699,20,414,1088;1089,0,0,0,1,1,2
8700,20,415,1090;8227,0,0,0,2,0,2
8701,20,416,1094,0,0,0,0,1,1
8702,20,418,1102;8188;10048;10172,0,0,0,4,0,4
8703,20,420,1059;1106;1107,0,0,0,3,0,3
8704,20,422,1110,0,0,0,1,0,1
8705,20,423,1112,0,0,0,1,0,1
8706,20,424,1114,0,0,0,1,0,1
8707,20,425,1117;4547,0,0,0,2,0,2
8708,20,427,1121,0,0,0,0,1,1
8709,20,428,1124;1125,0,0,0,1,1,2
8710,20,429,1128,0,0,0,0,1,1
8711,20,430,1129;1130,0,0,0,1,1,2
8712,20,432,1132,0,0,0,0,1,1
8713,20,433,1135;5341,0,0,0,1,1,2
8714,20,434,1137;1141;9613,0,0,0,3,0,3
8715,20,435,1142;5845,0,0,0,2,0,2
8716,20,436,1146,0,0,0,1,0,1
8717,20,437,1152,0,0,0,1,0,1
8718,20,439,1155;1156,0,0,0,0,2,2
8719,20,440,1160,0,0,0,0,1,1
8720,20,441,1168;1581,0,0,0,0,2,2
8721,20,444,1173,0,0,0,0,1,1
8722,20,445,1175;1176,0,0,0,1,1,2
8723,20,447,4088;11133,0,0,1,1,0,2
8724,20,448,1180;1181,0,0,0,1,1,2
8725,20,449,1182;8981,0,0,0,2,0,2
8726,20,451,1185;1186,0,0,0,1,1,2
8727,20,453,1189;1190;1191;1192;10809;11134,0,0,2,3,1,6
8728,20,455,1196,0,0,0,0,1,1
8729,20,456,1198;4938;11109;11285,0,0,2,2,0,4
8730,20,457,1201,0,0,0,1,0,1
8731,20,458,1202;1203,0,0,0,1,1,2
8732,20,459,1204,0,0,0,0,1,1
8733,20,461,1210;1211,0,0,0,1,1,2
8734,20,462,1215,0,0,0,0,1,1
8735,20,463,6474,0,0,0,1,0,1
8736,20,464,1220;1221;10148,0,0,0,1,2,3
8737,20,465,1222,0,0,0,0,1,1
8738,20,466,1223;3452,0,0,0,2,0,2
8739,20,467,1226;1227;4429,0,0,0,0,3,3
8740,20,468,3993,0,0,0,1,0,1
8741,20,470,1234,0,0,0,0,1,1
8742,20,472,1240;1241;1242,0,0,0,2,1,3
8743,20,473,1244,0,0,0,0,1,1
8744,20,475,1253,0,0,0,0,1,1
8745,20,477,1258,0,0,0,0,1,1
8746,20,478,1260;11359;11464,0,0,2,1,0,3
8747,20,479,1262,0,0,0,0,1,1
8748,20,480,1265;1266,0,0,0,1,1,2
8749,20,481,1268;1269,0,0,0,0,2,2
8750,20,482,1271,0,0,0,0,1,1
8751,20,483,1275;1276,0,0,0,2,0,2
8752,20,484,1277;1278,0,0,0,2,0,2
8753,20,485,1279,0,0,0,0,1,1
8754,20,486,1281,0,0,0,0,1,1
8755,20,487,321;1283;1284;10657,0,0,1,3,0,4
8756,20,488,1285;10744;11420;11522,0,0,3,1,0,4
8757,20,490,1291,0,0,0,1,0,1
8758,20,491,1293,0,0,0,0,1,1
8759,20,492,1299;1300,0,0,0,0,2,2
8760,20,493,1303;1304;1305,0,0,0,3,0,3
8761,20,495,1310,0,0,0,0,1,1
8762,20,496,1311;1312,0,0,0,1,1,2
8763,20,497,1315;1316,0,0,0,2,0,2
8764,20,498,1320,0,0,0,1,0,1
8765,20,500,1323;1324,0,0,0,2,0,2
8766,20,502,1327;3565,0,0,0,0,2,2
8767,20,503,1329;3441,0,0,0,2,0,2
8768,20,504,1330;4117,0,0,0,2,0,2
8769,20,507,1338;2278;10482;10632,0,0,2,2,0,4
8770,20,508,1341,0,0,0,0,1,1
8771,20,509,1342;1345,0,0,0,1,1,2
8772,20,510,1347,0,0,0,0,1,1
8773,20,513,1359,0,0,0,1,0,1
8774,20,514,1361;6266,0,0,0,2,0,2
8775,20,515,1365;3043;10783;11451,0,0,2,2,0,4
8776,20,517,1370,0,0,0,0,1,1
8777,20,518,1373;1374;10120;10610,0,0,1,2,1,4
8778,20,519,1375;8864;10674;10844;11051;11560;12115,0,1,4,2,0,7
8779,20,521,1378,0,0,0,0,1,1
8780,20,522,1381;1382,0,0,0,1,1,2
8781,20,524,1385;1388,0,0,0,1,1,2
8782,20,526,1390,0,0,0,0,1,1
8783,20,528,1392;1393,0,0,0,1,1,2
8784,20,530,1397;1398,0,0,0,0,2,2
8785,20,531,1400;1401,0,0,0,2,0,2
8786,20,532,1402,0,0,0,0,1,1
8787,20,534,1405;10580;10666;11082,0,0,3,1,0,4
8788,20,535,1408,0,0,0,0,1,1
8789,20,536,1409;1410,0,0,0,0,2,2
8790,20,538,1415,0,0,0,1,0,1
8791,20,539,1419,0,0,0,0,1,1
8792,20,541,1425,0,0,0,0,1,1
8793,20,542,1431;6846,0,0,0,2,0,2
8794,20,543,1433,0,0,0,0,1,1
8795,20,545,1435;1436,0,0,0,2,0,2
8796,20,546,1437;1438,0,0,0,1,1,2
8797,20,547,1440;8661,0,0,0,2,0,2
8798,20,549,1442;1443,0,0,0,0,2,2
8799,20,550,1444;9792,0,0,0,2,0,2
8800,20,552,1448;1452,0,0,0,1,1,2
8801,20,553,1515;4314;10278;10688;10835;11132;12070,0,1,3,3,0,7
8802,20,554,1455,0,0,0,0,1,1
8803,20,555,1456;1458;4134;11155;11356,0,0,2,3,0,5
8804,20,556,1459;1460;11275;11423,0,0,2,2,0,4
8805,20,558,1464;10601;11091,0,0,2,1,0,3
8806,20,559,1465;1466;1468,0,0,0,2,1,3
8807,20,560,1469;1470;10481,0,0,1,1,1,3
8808,20,562,1475;1476;10961,0,0,1,1,1,3
8809,20,564,1481;1482,0,0,0,0,2,2
8810,20,565,1183;1483,0,0,0,2,0,2
8811,20,566,1488,0,0,0,0,1,1
8812,20,567,1491;1493;3370,0,0,0,3,0,3
8813,20,568,1495;1496,0,0,0,1,1,2
8814,20,569,1497;5273;10797,0,0,1,2,0,3
8815,20,570,1501,0,0,0,0,1,1
8816,20,571,1502;2502;10357;10595;10795,0,0,2,3,0,5
8817,20,573,1506;3919;10099;10183;10494;10928,0,0,2,4,0,6
8818,20,574,1509;3027;11229;11642,0,1,1,2,0,4
8819,20,575,1510,0,0,0,0,1,1
8820,20,576,1513;9002,0,0,0,0,2,2
8821,20,577,1517;6711,0,0,0,1,1,2
8822,20,578,1519,0,0,0,0,1,1
8823,20,579,1520;1521,0,0,0,2,0,2
8824,20,580,1524;2722,0,0,0,2,0,2
8825,20,581,1527,0,0,0,0,1,1
8826,20,582,1529;3538;10406,0,0,0,3,0,3
8827,20,583,1131;1531,0,0,0,1,1,2
8828,20,584,1533;1538,0,0,0,1,1,2
8829,20,585,1539;1540;1542,0,0,0,2,1,3
8830,20,587,1547;1548;3263;10882,0,0,1,3,0,4
8831,20,589,1551,0,0,0,0,1,1
8832,20,590,1553;9321;11203;11351;11778,0,1,2,2,0,5
8833,20,591,1554;1555,0,0,0,1,1,2
8834,20,592,1557;1558;11215;11494,0,0,2,1,1,4
8835,20,593,1560;1655;11035;11992,0,1,1,2,0,4
8836,20,594,1562;1563;1565,0,0,0,3,0,3
8837,20,595,1566;1567,0,0,0,1,1,2
8838,20,596,1570,0,0,0,0,1,1
8839,20,597,1573,0,0,0,1,0,1
8840,20,599,1578,0,0,0,0,1,1
8841,20,600,1579,0,0,0,0,1,1
8842,20,603,1585;1587,0,0,0,0,2,2
8843,20,605,1593;1594,0,0,0,2,0,2
8844,20,606,4865,0,0,0,0,1,1
8845,20,607,1596;4276;10116;10627,0,0,1,3,0,4
8846,20,608,1597;1598,0,0,0,2,0,2
8847,20,610,1604;7802;12061,0,1,0,2,0,3
8848,20,612,7132,0,0,0,0,1,1
8849,20,613,1610;1612,0,0,0,0,2,2
8850,20,614,1618;1619;6335;12136,0,1,0,3,0,4
8851,20,615,1620;1621;1622,0,0,0,2,1,3
8852,20,617,1626,0,0,0,0,1,1
8853,20,618,1628;1629;10639;10753;11336,0,0,3,2,0,5
8854,20,619,1631;1632;10702,0,0,1,2,0,3
8855,20,620,1633;1634,0,0,0,2,0,2
8856,20,621,1635;1636,0,0,0,0,2,2
8857,20,622,1638;1639,0,0,0,1,1,2
8858,20,623,1641;1642,0,0,0,1,1,2
8859,20,624,1643;1644;10392;10445;11081,0,0,2,2,1,5
8860,20,625,1647;1648;2480;11506;11738,0,1,1,3,0,5
8861,20,626,1650;1651,0,0,0,0,2,2
8862,20,628,2835,0,0,0,1,0,1
8863,20,629,1659,0,0,0,0,1,1
8864,20,630,1660;1661,0,0,0,1,1,2
8865,20,632,1664;1665;1667;1668,0,0,0,3,1,4
8866,20,633,1669;1671,0,0,0,1,1,2
8867,20,634,1673;5117;10852;11424,0,0,2,2,0,4
8868,20,635,1675,0,0,0,0,1,1
8869,20,637,1677;1678,0,0,0,1,1,2
8870,20,639,1684;1685,0,0,0,2,0,2
8871,20,640,1687,0,0,0,0,1,1
8872,20,641,1690;1691;1693,0,0,0,2,1,3
8873,20,642,1700;6683;8308,0,0,0,3,0,3
8874,20,643,1001;1702,0,0,0,2,0,2
8875,20,644,1704;1705;3901;9763;9764,0,0,0,5,0,5
8876,20,645,1708;1709,0,0,0,1,1,2
8877,20,646,1710,0,0,0,1,0,1
8878,20,647,4347,0,0,0,0,1,1
8879,20,648,1715;8540;10919;11057,0,0,2,2,0,4
8880,20,649,1716;1717;1720;1721,0,0,0,3,1,4
8881,20,650,1722;1723,0,0,0,1,1,2
8882,20,651,1724;1725,0,0,0,0,2,2
8883,20,653,1733,0,0,0,1,0,1
8884,20,654,1735;1737,0,0,0,1,1,2
8885,20,655,1739;9203,0,0,0,2,0,2
8886,20,656,1742;1743,0,0,0,2,0,2
8887,20,657,1747;5049;7010,0,0,0,1,2,3
8888,20,658,1748;1749,0,0,0,2,0,2
8889,20,661,1756,0,0,0,1,0,1
8890,20,662,1758,0,0,0,0,1,1
8891,20,664,1762,0,0,0,0,1,1
8892,20,665,1763;1764;10588;10810;10986,0,0,3,1,1,5
8893,20,669,1778,0,0,0,0,1,1
8894,20,671,1781,0,0,0,0,1,1
8895,20,672,1785;1786,0,0,0,1,1,2
8896,20,673,2802;5867,0,0,0,2,0,2
8897,20,674,1791,0,0,0,0,1,1
8898,20,677,1219;1795,0,0,0,1,1,2
8899,20,678,1799,0,0,0,0,1,1
8900,20,679,1800;1803,0,0,0,1,1,2
8901,20,680,1804,0,0,0,0,1,1
8902,20,682,1809;1810;10210,0,0,0,3,0,3
8903,20,683,1811,0,0,0,0,1,1
8904,20,684,1812;1814;9263,0,0,0,3,0,3
8905,20,687,1817;1819,0,0,0,0,2,2
8906,20,688,1823,0,0,0,0,1,1
8907,20,689,1825,0,0,0,0,1,1
8908,20,691,1828,0,0,0,0,1,1
8909,20,692,1829;1830,0,0,0,2,0,2
8910,20,696,1838;1840,0,0,0,2,0,2
8911,20,697,1842,0,0,0,1,0,1
8912,20,698,1843;7783;10940;11067,0,0,2,2,0,4
8913,20,699,1844,0,0,0,0,1,1
8914,20,701,1852,0,0,0,0,1,1
8915,20,702,1853;1854,0,0,0,1,1,2
8916,20,703,1855,0,0,0,0,1,1
8917,20,704,1856;1857;10192;10903,0,0,1,2,1,4
8918,20,705,1858;1859,0,0,0,0,2,2
8919,20,707,1862,0,0,0,0,1,1
8920,20,708,1864;1866,0,0,0,0,2,2
8921,20,709,1868;2257;10972;11008,0,0,2,2,0,4
8922,20,710,1869;7936,0,0,0,2,0,2
8923,20,712,1871,0,0,0,0,1,1
8924,20,713,1874;1875,0,0,0,1,1,2
8925,20,714,1876;1877,0,0,0,1,1,2
8926,20,716,1880;1881;1883;10238;10645;11384,0,0,2,3,1,6
8927,20,719,1886;1889,0,0,0,1,1,2
8928,20,720,1891;1892;10265;10766,0,0,1,2,1,4
8929,20,721,307;1893;10802,0,0,1,2,0,3
8930,20,723,1898;5340,0,0,0,0,2,2
8931,20,725,1905;1906,0,0,0,1,1,2
8932,20,726,1909,0,0,0,0,1,1
8933,20,727,1912,0,0,0,1,0,1
8934,20,728,1914;10672,0,0,1,1,0,2
8935,20,729,1916,0,0,0,1,0,1
8936,20,730,1917;7842,0,0,0,2,0,2
8937,20,734,1926,0,0,0,0,1,1
8938,20,735,1928,0,0,0,0,1,1
8939,20,736,4838;11259,0,0,1,1,0,2
8940,20,738,4187;4283,0,0,0,2,0,2
8941,20,739,1937;4195,0,0,0,0,2,2
8942,20,740,1939,0,0,0,0,1,1
8943,20,741,1942;1944,0,0,0,1,1,2
8944,20,744,1955;6286,0,0,0,0,2,2
8945,20,747,1108;8274,0,0,0,2,0,2
8946,20,749,1963;7142,0,0,0,2,0,2
8947,20,750,1964;1965;10253;10644;11375,0,0,2,3,0,5
8948,20,751,1968,0,0,0,1,0,1
8949,20,752,1969;1970;10761;10985,0,0,2,2,0,4
8950,20,753,1971;4405,0,0,0,1,1,2
8951,20,754,1975;1977,0,0,0,1,1,2
8952,20,756,1984,0,0,0,0,1,1
8953,20,757,1989;8327,0,0,0,2,0,2
8954,20,758,8951,0,0,0,1,0,1
8955,20,759,1931;1993;11068,0,0,1,2,0,3
8956,20,761,1996,0,0,0,1,0,1
8957,20,762,1997;2251,0,0,0,2,0,2
8958,20,768,2006;2702;10621,0,0,1,2,0,3
8959,20,769,2012,0,0,0,1,0,1
8960,20,770,2016;2018,0,0,0,1,1,2
8961,20,771,2019;2020;2021,0,0,0,0,3,3
8962,20,772,2024,0,0,0,0,1,1
8963,20,773,2026;2027;8792;10597;10724,0,0,2,3,0,5
8964,20,774,2028,0,0,0,0,1,1
8965,20,775,2034;2036,0,0,0,0,2,2
8966,20,776,2044;7753,0,0,0,0,2,2
8967,20,777,2045,0,0,0,0,1,1
8968,20,778,2046,0,0,0,0,1,1
8969,20,782,2052;9477,0,0,0,2,0,2
8970,20,783,2055,0,0,0,0,1,1
8971,20,784,2057;8991,0,0,0,2,0,2
8972,20,785,2060;8024,0,0,0,2,0,2
8973,20,786,2061;2062,0,0,0,1,1,2
8974,20,787,2064,0,0,0,1,0,1
8975,20,788,2065;2066,0,0,0,1,1,2
8976,20,789,2070;2071,0,0,0,1,1,2
8977,20,791,2073;6485,0,0,0,2,0,2
8978,20,794,2080;2889,0,0,0,2,0,2
8979,20,795,2081;6219,0,0,0,0,2,2
8980,20,796,2083;2084,0,0,0,2,0,2
8981,20,797,2087;10103;10271;10331,0,0,0,4,0,4
8982,20,798,2088;2090,0,0,0,1,1,2
8983,20,799,2094;2095,0,0,0,1,1,2
8984,20,801,2097;2101,0,0,0,0,2,2
8985,20,803,2103;5953,0,0,0,2,0,2
8986,20,805,2106;2108,0,0,0,1,1,2
8987,20,806,2109;2110,0,0,0,2,0,2
8988,20,807,2111,0,0,0,0,1,1
8989,20,810,2115,0,0,0,0,1,1
8990,20,811,2118,0,0,0,0,1,1
8991,20,812,2119;2121,0,0,0,1,1,2
8992,20,813,2122,0,0,0,0,1,1
8993,20,814,2124;2125,0,0,0,0,2,2
8994,20,815,2127;6929,0,0,0,2,0,2
8995,20,816,2128;2129,0,0,0,2,0,2
8996,20,817,2135;2136;2138;6351;10959,0,0,1,2,2,5
8997,20,818,2140;2142,0,0,0,1,1,2
8998,20,819,2143,0,0,0,1,0,1
8999,20,820,2144;2146,0,0,0,1,1,2
9000,20,821,2147;2148;10135;11505,0,0,1,3,0,4
9001,20,822,2149;9867;11358;11523;11802,0,1,2,2,0,5
9002,20,823,2151,0,0,0,0,1,1
9003,20,824,2152;2153,0,0,0,0,2,2
9004,20,825,2154,0,0,0,0,1,1
9005,20,826,2157;2158,0,0,0,2,0,2
9006,20,827,2160;5752,0,0,0,0,2,2
9007,20,828,2161;2162,0,0,0,1,1,2
9008,20,829,2163,0,0,0,1,0,1
9009,20,830,2167,0,0,0,0,1,1
9010,20,833,2173;6345,0,0,0,2,0,2
9011,20,836,2184,0,0,0,0,1,1
9012,20,838,2188,0,0,0,0,1,1
9013,20,839,2190,0,0,0,0,1,1
9014,20,840,2191,0,0,0,0,1,1
9015,20,841,2193;2194,0,0,0,1,1,2
9016,20,842,2195;2196,0,0,0,0,2,2
9017,20,843,2197,0,0,0,0,1,1
9018,20,844,2198,0,0,0,1,0,1
9019,20,846,2202,0,0,0,0,1,1
9020,20,847,2204;2205,0,0,0,0,2,2
9021,20,850,2214,0,0,0,0,1,1
9022,20,851,2216;3580,0,0,0,2,0,2
9023,20,852,655;2220;2221;2225;5323;7556,0,0,0,6,0,6
9024,20,853,2226;2227,0,0,0,0,2,2
9025,20,854,2228;2229,0,0,0,0,2,2
9026,20,855,2231;12017;12103,0,2,0,1,0,3
9027,20,856,2235,0,0,0,0,1,1
9028,20,857,2238;10493;10932;11429,0,0,3,1,0,4
9029,20,858,8182,0,0,0,0,1,1
9030,20,859,2243;2247,0,0,0,2,0,2
9031,20,860,2248,0,0,0,0,1,1
9032,20,861,2254;2256,0,0,0,1,1,2
9033,20,862,2258,0,0,0,0,1,1
9034,20,863,2259;2261,0,0,0,0,2,2
9035,20,864,2263;2265;6046;10039;10259;10886,0,0,1,5,0,6
9036,20,865,2266;2267,0,0,0,2,0,2
9037,20,867,1818;2272,0,0,0,0,2,2
9038,20,868,2274;2275,0,0,0,2,0,2
9039,20,869,2276;2277,0,0,0,0,2,2
9040,20,870,2072;2284,0,0,0,2,0,2
9041,20,871,2285;4707,0,0,0,2,0,2
9042,20,873,2287;2288;10111;10150;10404;10473,0,0,1,5,0,6
9043,20,874,2293;4002;10010;10177,0,0,0,4,0,4
9044,20,876,2297,0,0,0,0,1,1
9045,20,877,2298;2299,0,0,0,1,1,2
9046,20,878,2303;7272;10737;11135,0,0,2,2,0,4
9047,20,881,2307,0,0,0,1,0,1
9048,20,884,2313,0,0,0,0,1,1
9049,20,885,375;2315,0,0,0,2,0,2
9050,20,886,1583;2320,0,0,0,2,0,2
9051,20,887,2327,0,0,0,0,1,1
9052,20,888,1870;2328;2330;10022;10266;10680,0,0,1,5,0,6
9053,20,890,978;2332,0,0,0,0,2,2
9054,20,891,2333;2334;10361;10447,0,0,1,2,1,4
9055,20,892,2335;2336,0,0,0,2,0,2
9056,20,893,549;2338;2339;10416;10420;10568,0,0,2,4,0,6
9057,20,894,2341;3425,0,0,0,0,2,2
9058,20,895,2343;2344;10321;10381,0,0,0,3,1,4
9059,20,896,2346;2347,0,0,0,0,2,2
9060,20,897,1371;2350;2351;4722;11922,0,1,0,4,0,5
9061,20,900,2358;2361,0,0,0,1,1,2
9062,20,901,2362;2363,0,0,0,1,1,2
9063,20,902,2367;2368,0,0,0,2,0,2
9064,20,904,2373;2374;10415;11079,0,0,1,3,0,4
9065,20,906,2378,0,0,0,0,1,1
9066,20,907,1118;2379,0,0,0,2,0,2
9067,20,908,2381;2382,0,0,0,0,2,2
9068,20,909,2386;6079,0,0,0,0,2,2
9069,20,912,2393;2396;5537,0,0,0,3,0,3
9070,20,916,2408,0,0,0,0,1,1
9071,20,917,2411,0,0,0,0,1,1
9072,20,918,2413,0,0,0,1,0,1
9073,20,919,2415;2416;10127;10245;10548,0,0,1,3,1,5
9074,20,922,2422;2423,0,0,0,2,0,2
9075,20,923,2424,0,0,0,0,1,1
9076,20,926,2431;2493;7458,0,0,0,1,2,3
9077,20,927,2432,0,0,0,0,1,1
9078,20,930,2439;2440,0,0,0,1,1,2
9079,20,932,2449;4793;11587,0,0,1,2,0,3
9080,20,933,2450,0,0,0,0,1,1
9081,20,934,2452,0,0,0,0,1,1
9082,20,935,2453;2454,0,0,0,1,1,2
9083,20,936,2457,0,0,0,0,1,1
9084,20,937,777;2460,0,0,0,2,0,2
9085,20,938,2465,0,0,0,1,0,1
9086,20,939,2469,0,0,0,0,1,1
9087,20,940,2471;2472;10319;10451,0,0,1,2,1,4
9088,20,941,2473;2474;2476,0,0,0,1,2,3
9089,20,942,2479;2481,0,0,0,2,0,2
9090,20,944,2484,0,0,0,0,1,1
9091,20,946,2487,0,0,0,1,0,1
9092,20,947,2488;2489,0,0,0,1,1,2
9093,20,949,2496,0,0,0,0,1,1
9094,20,950,2501;7647,0,0,0,2,0,2
9095,20,951,2505,0,0,0,0,1,1
9096,20,952,2511;4058,0,0,0,0,2,2
9097,20,953,458;2513;10847;10997;11510,0,0,3,2,0,5
9098,20,954,2514,0,0,0,0,1,1
9099,20,957,2521;2522;2524,0,0,0,1,2,3
9100,20,958,2528,0,0,0,0,1,1
9101,20,960,2533;2534,0,0,0,1,1,2
9102,20,961,2536;8772,0,0,0,0,2,2
9103,20,962,2538;4320;11898,0,1,0,2,0,3
9104,20,964,2541;2542,0,0,0,1,1,2
9105,20,966,308;2548,0,0,0,2,0,2
9106,20,967,2550;3260,0,0,0,2,0,2
9107,20,968,2551;2552,0,0,0,0,2,2
9108,20,969,2553;2554,0,0,0,1,1,2
9109,20,970,2558;9123,0,0,0,2,0,2
9110,20,972,2564;7804;10109;10401;10637;10763;11344,0,0,3,4,0,7
9111,20,973,2565;2566,0,0,0,0,2,2
9112,20,974,2567;2568,0,0,0,2,0,2
9113,20,976,2571;2573,0,0,0,0,2,2
9114,20,977,2574;10005;10340;10536,0,0,1,3,0,4
9115,20,978,2576;4273,0,0,0,2,0,2
9116,20,979,1816;2579,0,0,0,0,2,2
9117,20,981,2585,0,0,0,0,1,1
9118,20,982,2587,0,0,0,0,1,1
9119,20,983,2588;2589,0,0,0,1,1,2
9120,20,985,2593;6767;10599;10629;11128,0,0,3,2,0,5
9121,20,987,1367;2597;2598,0,0,0,3,0,3
9122,20,988,2599;2600,0,0,0,1,1,2
9123,20,989,2602;7829;10262;11074;11467,0,0,2,3,0,5
9124,20,990,2603;2604;2605,0,0,0,1,2,3
9125,20,992,2185;2609,0,0,0,1,1,2
9126,20,994,2613;4625;10530;10641;11200;11332,0,0,4,2,0,6
9127,20,995,2614;8609;10707;11000,0,0,2,2,0,4
9128,20,997,2617;9730,0,0,0,2,0,2
9129,20,998,2618;2621;4410,0,0,0,3,0,3
9130,20,999,2624,0,0,0,0,1,1
9131,20,1000,2626,0,0,0,0,1,1
9132,20,1001,1923;2630;10068;10173;10474,0,0,1,4,0,5
9133,20,1002,2631,0,0,0,0,1,1
9134,20,1004,2635;2636,0,0,0,1,1,2
9135,20,1005,2506,0,0,0,1,0,1
9136,20,1006,2638;2639,0,0,0,0,2,2
9137,20,1007,2640;2641,0,0,0,0,2,2
9138,20,1008,2643,0,0,0,0,1,1
9139,20,1012,2652;2653,0,0,0,1,1,2
9140,20,1013,1683;2658;10004;10337;10834;11197,0,0,2,4,0,6
9141,20,1016,2662;8181,0,0,0,2,0,2
9142,20,1017,2665,0,0,0,0,1,1
9143,20,1018,2666;2668,0,0,0,1,1,2
9144,20,1019,2672;2673,0,0,0,0,2,2
9145,20,1022,2680,0,0,0,0,1,1
9146,20,1023,2683,0,0,0,0,1,1
9147,20,1024,2685,0,0,0,0,1,1
9148,20,1025,2691,0,0,0,1,0,1
9149,20,1027,2696,0,0,0,0,1,1
9150,20,1028,2697,0,0,0,0,1,1
9151,20,1029,2699;2701,0,0,0,2,0,2
9152,20,1032,2704,0,0,0,0,1,1
9153,20,1034,2708,0,0,0,0,1,1
9154,20,1035,2709;2710,0,0,0,0,2,2
9155,20,1036,2711;2872,0,0,0,2,0,2
9156,20,1037,2712;6695,0,0,0,2,0,2
9157,20,1038,2713,0,0,0,0,1,1
9158,20,1040,2719,0,0,0,0,1,1
9159,20,1042,3898,0,0,0,0,1,1
9160,20,1043,2726;2727;2728,0,0,0,2,1,3
9161,20,1045,2734,0,0,0,0,1,1
9162,20,1047,2746,0,0,0,0,1,1
9163,20,1048,2749;2751;8479,0,0,0,3,0,3
9164,20,1049,2752,0,0,0,0,1,1
9165,20,1055,2763,0,0,0,0,1,1
9166,20,1056,2767,0,0,0,0,1,1
9167,20,1058,2769,0,0,0,0,1,1
9168,20,1059,2773;2774;2775;8322;11695,0,1,0,4,0,5
9169,20,1060,2778,0,0,0,0,1,1
9170,20,1061,2779;2780,0,0,0,0,2,2
9171,20,1063,2786,0,0,0,1,0,1
9172,20,1064,2790,0,0,0,0,1,1
9173,20,1065,1532;2793,0,0,0,2,0,2
9174,20,1066,2794,0,0,0,0,1,1
9175,20,1067,2796;2797,0,0,0,0,2,2
9176,20,1068,2801;2803,0,0,0,0,2,2
9177,20,1069,2806;2807;11546,0,0,1,2,0,3
9178,20,1070,1162;2810;2811;2812;3041;7000;10582;10969;11016;11246;11252;11620;12124,0,2,5,6,0,13
9179,20,1071,2813;2814,0,0,0,0,2,2
9180,20,1072,2819;2820,0,0,0,1,1,2
9181,20,1073,806;2821;10560;10804;11110,0,0,3,2,0,5
9182,20,1074,2823;5628;10006;10618;11462;11541;11897,0,1,3,3,0,7
9183,20,1075,2826;2828,0,0,0,0,2,2
9184,20,1076,2829;2830,0,0,0,2,0,2
9185,20,1077,2833,0,0,0,1,0,1
9186,20,1079,2836;2838;2839,0,0,0,1,2,3
9187,20,1081,2844,0,0,0,0,1,1
9188,20,1082,2846,0,0,0,0,1,1
9189,20,1084,2852,0,0,0,1,0,1
9190,20,1085,2854;2855,0,0,0,1,1,2
9191,20,1086,2856;2857,0,0,0,2,0,2
9192,20,1087,2859,0,0,0,0,1,1
9193,20,1088,2862;8362,0,0,0,2,0,2
9194,20,1089,2866,0,0,0,0,1,1
9195,20,1090,2869;2871;5150,0,0,0,3,0,3
9196,20,1091,2874;2876,0,0,0,1,1,2
9197,20,1092,2877,0,0,0,0,1,1
9198,20,1093,2054;3190;10087;10380,0,0,0,4,0,4
9199,20,1094,2882,0,0,0,1,0,1
9200,20,1096,264;10393;11322,0,0,1,2,0,3
9201,20,1098,3436;11317;11520,0,0,2,1,0,3
9202,20,1101,2897;7116,0,0,0,1,1,2
9203,20,1102,2898,0,0,0,1,0,1
9204,20,1103,2900,0,0,0,0,1,1
9205,20,1104,2902;2903,0,0,0,1,1,2
9206,20,1105,2904;2905;10508,0,0,1,1,1,3
9207,20,1106,2906,0,0,0,0,1,1
9208,20,1108,2909;2910;8689,0,0,0,1,2,3
9209,20,1109,2911;9702;11405;11718,0,1,1,2,0,4
9210,20,1110,2912,0,0,0,0,1,1
9211,20,1111,2915;2916,0,0,0,1,1,2
9212,20,1113,2918;3342;10260,0,0,0,3,0,3
9213,20,1115,2923;2924,0,0,0,0,2,2
9214,20,1116,1994;2926,0,0,0,2,0,2
9215,20,1117,2927,0,0,0,0,1,1
9216,20,1119,2933,0,0,0,0,1,1
9217,20,1121,2937;2938,0,0,0,1,1,2
9218,20,1122,2939;2940,0,0,0,0,2,2
9219,20,1123,162;2941;10489;10604;11112,0,0,3,2,0,5
9220,20,1124,2944;6972,0,0,0,2,0,2
9221,20,1125,2945,0,0,0,0,1,1
9222,20,1126,2946;2950;3274,0,0,0,3,0,3
9223,20,1127,2954,0,0,0,0,1,1
9224,20,1128,2955;2956,0,0,0,1,1,2
9225,20,1129,2957;2958;2959;2960,0,0,0,3,1,4
9226,20,1130,2962;2965;6384,0,0,0,3,0,3
9227,20,1132,2968,0,0,0,0,1,1
9228,20,1133,2969,0,0,0,0,1,1
9229,20,1134,2973;2974;2975,0,0,0,3,0,3
9230,20,1135,2977;2978;2979,0,0,0,2,1,3
9231,20,1136,2981;2982,0,0,0,1,1,2
9232,20,1137,2984,0,0,0,0,1,1
9233,20,1138,2987;8079,0,0,0,2,0,2
9234,20,1139,2988;2989,0,0,0,1,1,2
9235,20,1140,2990;2991,0,0,0,0,2,2
9236,20,1142,975;2994;10274;10446,0,0,1,3,0,4
9237,20,1144,3000,0,0,0,0,1,1
9238,20,1145,3005,0,0,0,1,0,1
9239,20,1146,3008;6456,0,0,0,1,1,2
9240,20,1147,3013,0,0,0,0,1,1
9241,20,1148,3015,0,0,0,0,1,1
9242,20,1149,3017;3018;3019;10035;10272,0,0,0,4,1,5
9243,20,1150,3020,0,0,0,0,1,1
9244,20,1152,3024;10950;11192,0,0,2,1,0,3
9245,20,1153,3025;3026;3028,0,0,0,3,0,3
9246,20,1154,3030,0,0,0,0,1,1
9247,20,1155,3035,0,0,0,0,1,1
9248,20,1156,3037,0,0,0,0,1,1
9249,20,1157,3042,0,0,0,0,1,1
9250,20,1158,3047;3048,0,0,0,1,1,2
9251,20,1159,3049,0,0,0,0,1,1
9252,20,1160,3051,0,0,0,0,1,1
9253,20,1161,3053;3054,0,0,0,1,1,2
9254,20,1162,3057,0,0,0,0,1,1
9255,20,1163,871;3061,0,0,0,2,0,2
9256,20,1165,3068;3070;3071,0,0,0,3,0,3
9257,20,1166,8867;9852;10653;10721;10812,0,0,3,2,0,5
9258,20,1168,3076;3077;11651;11829,0,2,0,2,0,4
9259,20,1169,3079,0,0,0,0,1,1
9260,20,1170,3080;8824;10448;10798;11034,0,0,3,2,0,5
9261,20,1171,3081,0,0,0,0,1,1
9262,20,1172,1412;3084;3086;3087,0,0,0,2,2,4
9263,20,1174,3090,0,0,0,0,1,1
9264,20,1175,3091;3093,0,0,0,0,2,2
9265,20,1176,3096,0,0,0,1,0,1
9266,20,1177,3097;3098,0,0,0,0,2,2
9267,20,1178,3102,0,0,0,0,1,1
9268,20,1180,3105;3108;10962;11701,0,1,1,2,0,4
9269,20,1181,3109;3110;3111,0,0,0,3,0,3
9270,20,1184,3115,0,0,0,0,1,1
9271,20,1185,745;3122;3254,0,0,0,3,0,3
9272,20,1186,1946;3124;3126;3127,0,0,0,4,0,4
9273,20,1189,3131;9350,0,0,0,1,1,2
9274,20,1190,3134;3135;3137,0,0,0,1,2,3
9275,20,1191,3138,0,0,0,1,0,1
9276,20,1192,3142;6513;10320,0,0,0,3,0,3
9277,20,1193,3144;6922;10444;10779;11493,0,0,3,2,0,5
9278,20,1194,3148,0,0,0,1,0,1
9279,20,1195,3149,0,0,0,0,1,1
9280,20,1196,3150;3151,0,0,0,2,0,2
9281,20,1198,3153;4330,0,0,0,2,0,2
9282,20,1199,3158;3159,0,0,0,1,1,2
9283,20,1200,3162,0,0,0,0,1,1
9284,20,1202,3169;7919;10154;10773;11395,0,0,2,3,0,5
9285,20,1203,3170;9080,0,0,0,2,0,2
9286,20,1204,3171,0,0,0,1,0,1
9287,20,1205,102;3175,0,0,0,2,0,2
9288,20,1206,3176,0,0,0,1,0,1
9289,20,1207,3180,0,0,0,1,0,1
9290,20,1208,3181;4152,0,0,0,2,0,2
9291,20,1209,3140;3184,0,0,0,2,0,2
9292,20,1210,3187;6504;10436;10722,0,0,2,2,0,4
9293,20,1211,3193,0,0,0,1,0,1
9294,20,1212,3194,0,0,0,0,1,1
9295,20,1213,3197;3198,0,0,0,1,1,2
9296,20,1214,3199;3200,0,0,0,1,1,2
9297,20,1215,3203,0,0,0,0,1,1
9298,20,1216,3205;3206,0,0,0,2,0,2
9299,20,1217,1368;3210,0,0,0,2,0,2
9300,20,1218,3213,0,0,0,0,1,1
9301,20,1219,3216,0,0,0,0,1,1
9302,20,1220,3220;3221;3222;10014;10250;10569,0,0,1,5,0,6
9303,20,1222,3227;7741,0,0,0,2,0,2
9304,20,1223,3228;3229,0,0,0,0,2,2
9305,20,1224,3230,0,0,0,0,1,1
9306,20,1225,3237;3240;3241;8432;10247,0,0,0,5,0,5
9307,20,1226,3242,0,0,0,0,1,1
9308,20,1227,3244;3247;6230,0,0,0,1,2,3
9309,20,1229,520;3249,0,0,0,2,0,2
9310,20,1231,3251,0,0,0,0,1,1
9311,20,1232,3253;3256;9435;10269;11127,0,0,1,4,0,5
9312,20,1233,3257;3258,0,0,0,2,0,2
9313,20,1235,1808;3261;3262;10636;10833;10992,0,0,3,2,1,6
9314,20,1236,7414,0,0,0,1,0,1
9315,20,1237,3265;3267,0,0,0,1,1,2
9316,20,1238,3268;3269,0,0,0,1,1,2
9317,20,1239,3270,0,0,0,0,1,1
9318,20,1240,3273,0,0,0,0,1,1
9319,20,1241,3275;6016,0,0,0,2,0,2
9320,20,1242,3278;8770,0,0,0,0,2,2
9321,20,1243,3279;3280,0,0,0,2,0,2
9322,20,1244,3282;3283,0,0,0,0,2,2
9323,20,1245,3284;3285;10434;10520;10677,0,0,3,1,1,5
9324,20,1247,3287;3288;3289,0,0,0,1,2,3
9325,20,1248,3290;3292,0,0,0,0,2,2
9326,20,1250,3294,0,0,0,1,0,1
9327,20,1251,3298,0,0,0,1,0,1
9328,20,1252,3299;9157,0,0,0,0,2,2
9329,20,1253,3300,0,0,0,0,1,1
9330,20,1254,3082;3303,0,0,0,0,2,2
9331,20,1255,3307,0,0,0,0,1,1
9332,20,1256,3310;3311,0,0,0,0,2,2
9333,20,1257,3313;3314,0,0,0,1,1,2
9334,20,1258,3317;3318;7476,0,0,0,1,2,3
9335,20,1259,3319,0,0,0,0,1,1
9336,20,1261,3323;3324,0,0,0,0,2,2
9337,20,1263,3326;3327,0,0,0,0,2,2
9338,20,1265,3330;9287,0,0,0,0,2,2
9339,20,1267,3334,0,0,0,0,1,1
9340,20,1269,3340,0,0,0,0,1,1
9341,20,1272,3344;3345,0,0,0,1,1,2
9342,20,1273,3347,0,0,0,0,1,1
9343,20,1274,3349;3350,0,0,0,1,1,2
9344,20,1276,3357;3358,0,0,0,0,2,2
9345,20,1277,3360;3361,0,0,0,0,2,2
9346,20,1280,3368;3369,0,0,0,2,0,2
9347,20,1282,3372,0,0,0,0,1,1
9348,20,1283,3378;3379,0,0,0,1,1,2
9349,20,1285,3384;3385;3387;10867,0,0,1,2,1,4
9350,20,1286,3390;3392,0,0,0,2,0,2
9351,20,1287,3393;3396,0,0,0,1,1,2
9352,20,1288,3398;3399;3403,0,0,0,1,2,3
9353,20,1289,3404;7760,0,0,0,2,0,2
9354,20,1290,3409;10301;10523;10859,0,0,2,2,0,4
9355,20,1291,2398;3410,0,0,0,2,0,2
9356,20,1292,3411;10977,0,0,1,1,0,2
9357,20,1293,887;3412,0,0,0,2,0,2
9358,20,1294,3413;3414,0,0,0,1,1,2
9359,20,1295,3415;3416,0,0,0,1,1,2
9360,20,1296,3421;7862,0,0,0,0,2,2
9361,20,1297,3422;3423,0,0,0,1,1,2
9362,20,1299,3426;3427;3428,0,0,0,2,1,3
9363,20,1300,3430;3431,0,0,0,1,1,2
9364,20,1301,3434,0,0,0,0,1,1
9365,20,1302,3440,0,0,0,0,1,1
9366,20,1304,3445,0,0,0,0,1,1
9367,20,1306,3448;11167;11392,0,0,2,1,0,3
9368,20,1307,3453,0,0,0,0,1,1
9369,20,1308,3455;6035;12091,0,1,0,2,0,3
9370,20,1309,3459,0,0,0,0,1,1
9371,20,1310,3460;9297,0,0,0,0,2,2
9372,20,1311,3461;3462,0,0,0,0,2,2
9373,20,1313,3465;3466,0,0,0,0,2,2
9374,20,1314,3470;3471,0,0,0,1,1,2
9375,20,1315,3474;7342;10509;11207,0,0,2,2,0,4
9376,20,1316,3480;3481,0,0,0,1,1,2
9377,20,1318,3483,0,0,0,0,1,1
9378,20,1320,2326;3487,0,0,0,2,0,2
9379,20,1322,3490;3493,0,0,0,1,1,2
9380,20,1323,3496,0,0,0,0,1,1
9381,20,1324,3497,0,0,0,0,1,1
9382,20,1325,3498;3499,0,0,0,0,2,2
9383,20,1326,3501;3504,0,0,0,2,0,2
9384,20,1327,3505;3507,0,0,0,2,0,2
9385,20,1328,3508;3967,0,0,0,0,2,2
9386,20,1329,3509;10341,0,0,0,2,0,2
9387,20,1330,3510;3622,0,0,0,0,2,2
9388,20,1331,3511;3512;10149;10170;10282;10419,0,0,1,5,0,6
9389,20,1332,3513;3514;10594;11824,0,1,1,1,1,4
9390,20,1333,3515;3516,0,0,0,1,1,2
9391,20,1334,3519,0,0,0,0,1,1
9392,20,1336,3525;4608,0,0,0,0,2,2
9393,20,1337,3526;10872,0,0,1,1,0,2
9394,20,1338,3528;3529,0,0,0,1,1,2
9395,20,1339,3532;3534;10095;10163,0,0,0,4,0,4
9396,20,1340,3535,0,0,0,0,1,1
9397,20,1341,3536,0,0,0,0,1,1
9398,20,1342,661;3541;10819;10991,0,0,2,2,0,4
9399,20,1344,3546;3547,0,0,0,0,2,2
9400,20,1346,3551;3553,0,0,0,1,1,2
9401,20,1347,3554;3555,0,0,0,2,0,2
9402,20,1348,3556;3557,0,0,0,0,2,2
9403,20,1352,3569;3570,0,0,0,0,2,2
9404,20,1353,3571;3572,0,0,0,1,1,2
9405,20,1354,3576,0,0,0,1,0,1
9406,20,1358,3584;3585,0,0,0,0,2,2
9407,20,1359,3587;3588;3592,0,0,0,1,2,3
9408,20,1360,3593;3594,0,0,0,1,1,2
9409,20,1362,2754;3599,0,0,0,1,1,2
9410,20,1363,3602;3603,0,0,0,1,1,2
9411,20,1364,3605,0,0,0,0,1,1
9412,20,1367,3609;3611,0,0,0,1,1,2
9413,20,1370,579;3618,0,0,0,2,0,2
9414,20,1371,3619;3620;11114,0,0,1,1,1,3
9415,20,1373,2884;3623,0,0,0,2,0,2
9416,20,1377,3631;3632,0,0,0,1,1,2
9417,20,1380,3642,0,0,0,0,1,1
9418,20,1385,3656,0,0,0,0,1,1
9419,20,1386,3657,0,0,0,0,1,1
9420,20,1387,3659;3660,0,0,0,0,2,2
9421,20,1391,3668;6607,0,0,0,2,0,2
9422,20,1392,3670;3671;3673;3674,0,0,0,2,2,4
9423,20,1393,3676;3677,0,0,0,1,1,2
9424,20,1394,3680;6550,0,0,0,2,0,2
9425,20,1395,3682;5103;10094,0,0,0,3,0,3
9426,20,1396,3683;3684,0,0,0,0,2,2
9427,20,1397,3686;3687,0,0,0,2,0,2
9428,20,1398,3688;3689,0,0,0,1,1,2
9429,20,1400,3694;8487,0,0,0,2,0,2
9430,20,1401,3697;8225,0,0,0,2,0,2
9431,20,1403,3703;7711,0,0,0,2,0,2
9432,20,1405,3707;3709,0,0,0,1,1,2
9433,20,1407,3714;3716;3717;9241,0,0,0,4,0,4
9434,20,1408,3718;8269,0,0,0,2,0,2
9435,20,1409,2822;3720,0,0,0,1,1,2
9436,20,1410,3721;3722,0,0,0,0,2,2
9437,20,1411,3723;3724,0,0,0,1,1,2
9438,20,1412,3729;3731;6501,0,0,0,3,0,3
9439,20,1414,3734;3735,0,0,0,1,1,2
9440,20,1415,3737;8430,0,0,0,2,0,2
9441,20,1416,9990;11726,0,1,0,1,0,2
9442,20,1418,3742;3743,0,0,0,1,1,2
9443,20,1419,3744;3745,0,0,0,1,1,2
9444,20,1420,3746;3747,0,0,0,1,1,2
9445,20,1421,3751;3752,0,0,0,1,1,2
9446,20,1423,3756;3757,0,0,0,1,1,2
9447,20,1425,3761;6156;6159;10085;10233;10325;10528,0,0,1,6,0,7
9448,20,1426,3763;5978;10037;10251;10360,0,0,0,5,0,5
9449,20,1427,132;2804;3766;3767;3768;7496;10706;11571;11762,0,1,2,6,0,9
9450,20,1430,7615;7900,0,0,0,2,0,2
9451,20,1431,3773,0,0,0,0,1,1
9452,20,1432,3775;9143,0,0,0,2,0,2
9453,20,1433,3779,0,0,0,0,1,1
9454,20,1434,3781;3782,0,0,0,1,1,2
9455,20,1435,3783;7420,0,0,0,0,2,2
9456,20,1436,3786,0,0,0,0,1,1
9457,20,1437,3788,0,0,0,1,0,1
9458,20,1439,2739;3793,0,0,0,2,0,2
9459,20,1440,3795;3797;3798;10197;10469,0,0,1,4,0,5
9460,20,1441,3800;3801,0,0,0,2,0,2
9461,20,1442,3804,0,0,0,0,1,1
9462,20,1443,3805;3806,0,0,0,0,2,2
9463,20,1444,3808;4190,0,0,0,2,0,2
9464,20,1445,3809;3810,0,0,0,1,1,2
9465,20,1446,1174;3814,0,0,0,2,0,2
9466,20,1447,3816,0,0,0,0,1,1
9467,20,1448,3818,0,0,0,0,1,1
9468,20,1449,3821;8819,0,0,0,2,0,2
9469,20,1450,1043;3822,0,0,0,0,2,2
9470,20,1451,3791;3826,0,0,0,2,0,2
9471,20,1452,3827;3828,0,0,0,1,1,2
9472,20,1453,3831;3832,0,0,0,2,0,2
9473,20,1455,3838;3839;3840;3842,0,0,0,2,2,4
9474,20,1457,3845;3846;10414,0,0,0,2,1,3
9475,20,1458,3848;3849;3850;8580;10870;11683,0,1,1,4,0,6
9476,20,1459,3851;5474,0,0,0,2,0,2
9477,20,1460,3853,0,0,0,0,1,1
9478,20,1461,3855;3856,0,0,0,2,0,2
9479,20,1462,3857;3858;3859;3860,0,0,0,3,1,4
9480,20,1463,3861;3862;3863,0,0,0,1,2,3
9481,20,1465,3866,0,0,0,0,1,1
9482,20,1466,3871;3874,0,0,0,2,0,2
9483,20,1468,3880;4815;10874;11381,0,0,2,2,0,4
9484,20,1470,3114,0,0,0,0,1,1
9485,20,1471,3884,0,0,0,0,1,1
9486,20,1473,3888,0,0,0,1,0,1
9487,20,1474,3890;3892,0,0,0,0,2,2
9488,20,1475,1307;1308;3893;6017;10188;10243,0,0,0,6,0,6
9489,20,1476,3896;3897,0,0,0,1,1,2
9490,20,1479,3902,0,0,0,1,0,1
9491,20,1480,3905;3906,0,0,0,0,2,2
9492,20,1481,3908,0,0,0,0,1,1
9493,20,1483,3910,0,0,0,1,0,1
9494,20,1485,3915;3917,0,0,0,0,2,2
9495,20,1486,3918;3920,0,0,0,0,2,2
9496,20,1487,1255;9622,0,0,0,2,0,2
9497,20,1489,3928,0,0,0,0,1,1
9498,20,1490,3929,0,0,0,0,1,1
9499,20,1491,3932;3933,0,0,0,0,2,2
9500,20,1493,3938;3939,0,0,0,0,2,2
9501,20,1494,3941;3942,0,0,0,0,2,2
9502,20,1495,3943,0,0,0,0,1,1
9503,20,1496,3949,0,0,0,0,1,1
9504,20,1497,3950,0,0,0,0,1,1
9505,20,1498,3954;6424,0,0,0,2,0,2
9506,20,1499,3957,0,0,0,0,1,1
9507,20,1500,3964,0,0,0,0,1,1
9508,20,1501,3966;3969;5790;10617;11115,0,0,2,3,0,5
9509,20,1502,3970,0,0,0,0,1,1
9510,20,1504,885;3974;3978,0,0,0,3,0,3
9511,20,1505,3979;3980,0,0,0,1,1,2
9512,20,1506,4423;9919;10241;10435;10775,0,0,2,3,0,5
9513,20,1508,3983;3984;10145,0,0,0,3,0,3
9514,20,1509,3988,0,0,0,0,1,1
9515,20,1510,3989,0,0,0,0,1,1
9516,20,1511,3991;3992,0,0,0,2,0,2
9517,20,1514,3999;7359;10966;11217,0,0,2,2,0,4
9518,20,1515,4001;4004,0,0,0,1,1,2
9519,20,1519,2861;4011,0,0,0,2,0,2
9520,20,1520,4012;4013,0,0,0,1,1,2
9521,20,1521,4014,0,0,0,1,0,1
9522,20,1524,4019,0,0,0,0,1,1
9523,20,1525,4024;4025,0,0,0,0,2,2
9524,20,1526,4028,0,0,0,0,1,1
9525,20,1527,4029;5177,0,0,0,2,0,2
9526,20,1531,4038;8751;10079;10204;10660,0,0,1,4,0,5
9527,20,1533,761;4042,0,0,0,2,0,2
9528,20,1535,4050;9463;10352;10521,0,0,1,3,0,4
9529,20,1536,4054;4055;4056,0,0,0,1,2,3
9530,20,1538,4059;4060,0,0,0,0,2,2
9531,20,1540,506;4065,0,0,0,2,0,2
9532,20,1541,4066;11483;11504,0,0,2,1,0,3
9533,20,1542,4068;4069,0,0,0,0,2,2
9534,20,1543,4071;4072;4074;4075,0,0,0,3,1,4
9535,20,1544,4076;4077,0,0,0,1,1,2
9536,20,1545,4078,0,0,0,0,1,1
9537,20,1546,4080,0,0,0,0,1,1
9538,20,1548,4083,0,0,0,0,1,1
9539,20,1551,4091;4093,0,0,0,2,0,2
9540,20,1555,4098;9106,0,0,0,2,0,2
9541,20,1556,4099;4100,0,0,0,2,0,2
9542,20,1557,4104;8235,0,0,0,2,0,2
9543,20,1558,4107;4109;5222,0,0,0,3,0,3
9544,20,1559,4110,0,0,0,0,1,1
9545,20,1560,4114,0,0,0,0,1,1
9546,20,1563,4119;4120,0,0,0,0,2,2
9547,20,1565,4123;4124;10792,0,0,1,1,1,3
9548,20,1567,4126,0,0,0,0,1,1
9549,20,1568,4128;5803,0,0,0,0,2,2
9550,20,1569,4130;4132,0,0,0,0,2,2
9551,20,1570,7361,0,0,0,1,0,1
9552,20,1572,4135;10346;10748,0,0,1,2,0,3
9553,20,1573,4137,0,0,0,0,1,1
9554,20,1574,9432,0,0,0,1,0,1
9555,20,1575,1695;4142;11331,0,0,1,2,0,3
9556,20,1576,4143;4144,0,0,0,0,2,2
9557,20,1577,4150,0,0,0,1,0,1
9558,20,1578,9173,0,0,0,1,0,1
9559,20,1581,4157;4158,0,0,0,1,1,2
9560,20,1583,4161;4162;10496;11117,0,0,2,2,0,4
9561,20,1584,4163,0,0,0,0,1,1
9562,20,1585,4168,0,0,0,1,0,1
9563,20,1586,1098;4171,0,0,0,2,0,2
9564,20,1587,4172;6932;10124,0,0,0,3,0,3
9565,20,1588,4174;4175;10498;10515,0,0,2,1,1,4
9566,20,1589,4176,0,0,0,0,1,1
9567,20,1590,4179,0,0,0,0,1,1
9568,20,1591,4182,0,0,0,0,1,1
9569,20,1592,4183,0,0,0,0,1,1
9570,20,1593,4185;4186;4189,0,0,0,2,1,3
9571,20,1595,4193,0,0,0,1,0,1
9572,20,1596,4194,0,0,0,0,1,1
9573,20,1598,4199;7907;10190;11064;11472;11991,0,1,2,3,0,6
9574,20,1599,4200,0,0,0,0,1,1
9575,20,1600,4203;4204,0,0,0,1,1,2
9576,20,1601,4205;7021,0,0,0,2,0,2
9577,20,1602,4206;4210;9223;10460,0,0,1,3,0,4
9578,20,1605,4215,0,0,0,1,0,1
9579,20,1606,4217;4219;4221,0,0,0,2,1,3
9580,20,1607,4222;4223,0,0,0,1,1,2
9581,20,1608,4225;4226,0,0,0,1,1,2
9582,20,1609,2832;4227;4229;10956,0,0,1,3,0,4
9583,20,1611,3982;4232,0,0,0,0,2,2
9584,20,1614,4237;4238,0,0,0,0,2,2
9585,20,1616,4240;4241,0,0,0,2,0,2
9586,20,1617,4242,0,0,0,0,1,1
9587,20,1618,4245;4246;10552,0,0,1,1,1,3
9588,20,1619,4247;4249,0,0,0,0,2,2
9589,20,1620,4251,0,0,0,0,1,1
9590,20,1621,4253;4490;11120,0,0,1,2,0,3
9591,20,1622,4255;4256;4258,0,0,0,2,1,3
9592,20,1623,4260;9581,0,0,0,0,2,2
9593,20,1624,2731;4261,0,0,0,0,2,2
9594,20,1625,4262;6795,0,0,0,1,1,2
9595,20,1626,4263;4264;10123;10697,0,0,1,2,1,4
9596,20,1627,4265,0,0,0,0,1,1
9597,20,1628,4269;4270;4272,0,0,0,3,0,3
9598,20,1629,4278;6140,0,0,0,0,2,2
9599,20,1630,4284;6157;11744,0,1,0,2,0,3
9600,20,1631,4288,0,0,0,0,1,1
9601,20,1633,4291;5841;10334;10683;10836;10965,0,0,3,3,0,6
9602,20,1634,589;4292;4295,0,0,0,3,0,3
9603,20,1635,4296;4297,0,0,0,2,0,2
9604,20,1636,4298;4299;10007;10681,0,0,1,2,1,4
9605,20,1637,4300;4301,0,0,0,0,2,2
9606,20,1638,4302;4303;4304,0,0,0,1,2,3
9607,20,1639,4306;10705;11099,0,0,2,1,0,3
9608,20,1641,4310;4311,0,0,0,1,1,2
9609,20,1643,4316,0,0,0,1,0,1
9610,20,1644,728;11186;11361,0,0,2,1,0,3
9611,20,1645,4319;10315,0,0,0,2,0,2
9612,20,1646,4322,0,0,0,0,1,1
9613,20,1647,4323;4324,0,0,0,1,1,2
9614,20,1650,4328,0,0,0,1,0,1
9615,20,1652,4332,0,0,0,1,0,1
9616,20,1653,4492;10860,0,0,1,1,0,2
9617,20,1654,4334,0,0,0,1,0,1
9618,20,1656,4341,0,0,0,0,1,1
9619,20,1658,4344;4554;10781;11185,0,0,2,2,0,4
9620,20,1659,4345,0,0,0,0,1,1
9621,20,1661,4350,0,0,0,0,1,1
9622,20,1662,4351;4352,0,0,0,1,1,2
9623,20,1663,4355;4356,0,0,0,0,2,2
9624,20,1664,4357;5068;10864;11213,0,0,2,2,0,4
9625,20,1665,4358;5267,0,0,0,2,0,2
9626,20,1666,4360,0,0,0,0,1,1
9627,20,1667,4361,0,0,0,0,1,1
9628,20,1669,4365;11589;11776,0,1,1,1,0,3
9629,20,1670,4366;4367,0,0,0,1,1,2
9630,20,1671,4371;4375,0,0,0,1,1,2
9631,20,1672,4376;4377,0,0,0,2,0,2
9632,20,1674,4382;4383,0,0,0,1,1,2
9633,20,1675,4386;4387,0,0,0,1,1,2
9634,20,1677,4391,0,0,0,1,0,1
9635,20,1678,4393,0,0,0,0,1,1
9636,20,1679,4396;4398,0,0,0,2,0,2
9637,20,1680,4402;4403,0,0,0,0,2,2
9638,20,1684,4412;4413,0,0,0,1,1,2
9639,20,1686,4417,0,0,0,0,1,1
9640,20,1687,926;4419;10584;11017,0,0,2,2,0,4
9641,20,1688,4420;4421,0,0,0,1,1,2
9642,20,1689,4422,0,0,0,0,1,1
9643,20,1690,4424,0,0,0,0,1,1
9644,20,1692,993;4428,0,0,0,2,0,2
9645,20,1694,4431,0,0,0,0,1,1
9646,20,1696,4433;4434,0,0,0,2,0,2
9647,20,1697,4437;4438,0,0,0,1,1,2
9648,20,1701,4445,0,0,0,1,0,1
9649,20,1702,4446;4447,0,0,0,2,0,2
9650,20,1704,4452,0,0,0,1,0,1
9651,20,1705,4454;4455;4456,0,0,0,2,1,3
9652,20,1707,4461;7155;10258;10585,0,0,1,3,0,4
9653,20,1708,4463,0,0,0,1,0,1
9654,20,1710,4466,0,0,0,0,1,1
9655,20,1711,3002;4467,0,0,0,2,0,2
9656,20,1712,4468;4469;4470;4471,0,0,0,4,0,4
9657,20,1713,4472;8505;9518;10343;10485;11758,0,1,1,4,0,6
9658,20,1715,4481,0,0,0,1,0,1
9659,20,1716,4483;4484,0,0,0,1,1,2
9660,20,1717,4488,0,0,0,0,1,1
9661,20,1718,4491,0,0,0,1,0,1
9662,20,1719,4494;5644;10305;10907;11005;11296,0,0,3,3,0,6
9663,20,1720,4496,0,0,0,1,0,1
9664,20,1721,4497;4498,0,0,0,1,1,2
9665,20,1722,8221,0,0,0,1,0,1
9666,20,1723,4503;4504;4505,0,0,0,2,1,3
9667,20,1724,4507;4508,0,0,0,2,0,2
9668,20,1725,4513;4515,0,0,0,1,1,2
9669,20,1727,4519,0,0,0,0,1,1
9670,20,1728,4520;4521,0,0,0,1,1,2
9671,20,1729,1549;10573;10716,0,0,2,1,0,3
9672,20,1730,4526;10220;10351;10575,0,0,1,3,0,4
9673,20,1731,805,0,0,0,1,0,1
9674,20,1734,4536;6082,0,0,0,2,0,2
9675,20,1735,4537,0,0,0,0,1,1
9676,20,1736,4538,0,0,0,0,1,1
9677,20,1737,4541;10740;11825,0,1,1,1,0,3
9678,20,1738,2212;4545,0,0,0,2,0,2
9679,20,1744,4558;4559,0,0,0,2,0,2
9680,20,1745,4560;4561;10290,0,0,0,2,1,3
9681,20,1746,4562;9359,0,0,0,0,2,2
9682,20,1747,4565;8705,0,0,0,0,2,2
9683,20,1749,4569,0,0,0,0,1,1
9684,20,1750,4573,0,0,0,0,1,1
9685,20,1752,4578;6401,0,0,0,1,1,2
9686,20,1753,4579,0,0,0,1,0,1
9687,20,1755,4584;4585,0,0,0,1,1,2
9688,20,1756,4588;4590,0,0,0,0,2,2
9689,20,1757,4591,0,0,0,0,1,1
9690,20,1758,1292;4597,0,0,0,1,1,2
9691,20,1759,4599,0,0,0,0,1,1
9692,20,1761,4604;4606,0,0,0,0,2,2
9693,20,1762,4609;4610,0,0,0,0,2,2
9694,20,1764,4614,0,0,0,0,1,1
9695,20,1765,4618;8549,0,0,0,0,2,2
9696,20,1766,4620,0,0,0,0,1,1
9697,20,1768,1820;4627;4629,0,0,0,3,0,3
9698,20,1769,4631;4633;4634,0,0,0,2,1,3
9699,20,1770,4635;4636,0,0,0,1,1,2
9700,20,1771,4638,0,0,0,1,0,1
9701,20,1772,4641,0,0,0,0,1,1
9702,20,1773,4642;4643,0,0,0,0,2,2
9703,20,1774,4645,0,0,0,1,0,1
9704,20,1775,315;4647,0,0,0,2,0,2
9705,20,1776,4650;4651,0,0,0,2,0,2
9706,20,1777,4653;4656;5058;10541;11297,0,0,2,3,0,5
9707,20,1778,4657;4658,0,0,0,1,1,2
9708,20,1780,4661,0,0,0,0,1,1
9709,20,1781,4662,0,0,0,0,1,1
9710,20,1783,4664,0,0,0,0,1,1
9711,20,1784,4666,0,0,0,0,1,1
9712,20,1785,4670,0,0,0,0,1,1
9713,20,1787,4673;7575;10289;10429;10507;10837;11014,0,0,4,3,0,7
9714,20,1788,4675;4676,0,0,0,1,1,2
9715,20,1789,3778;4679,0,0,0,0,2,2
9716,20,1790,4682,0,0,0,1,0,1
9717,20,1791,4683;4684,0,0,0,1,1,2
9718,20,1792,4685;4686,0,0,0,0,2,2
9719,20,1793,4687;4688,0,0,0,1,1,2
9720,20,1794,4692,0,0,0,0,1,1
9721,20,1795,4695,0,0,0,0,1,1
9722,20,1796,4697;4698;4699,0,0,0,1,2,3
9723,20,1797,4701,0,0,0,0,1,1
9724,20,1798,2260;4702;10211;10228,0,0,0,4,0,4
9725,20,1799,4705;4706,0,0,0,1,1,2
9726,20,1802,4711;4712;4714,0,0,0,3,0,3
9727,20,1803,4716,0,0,0,0,1,1
9728,20,1804,4717;4718,0,0,0,1,1,2
9729,20,1805,4723,0,0,0,1,0,1
9730,20,1806,4725,0,0,0,0,1,1
9731,20,1807,4727;8028,0,0,0,2,0,2
9732,20,1810,4731;4732,0,0,0,0,2,2
9733,20,1811,4733;4734;4736;10161;10267;10796,0,0,1,4,1,6
9734,20,1812,4738;4739,0,0,0,0,2,2
9735,20,1813,4741;4742;4743,0,0,0,2,1,3
9736,20,1814,4745,0,0,0,0,1,1
9737,20,1815,4746;8062,0,0,0,2,0,2
9738,20,1816,4751;5087,0,0,0,2,0,2
9739,20,1817,4753;4754,0,0,0,2,0,2
9740,20,1818,3641,0,0,0,1,0,1
9741,20,1819,4760,0,0,0,0,1,1
9742,20,1820,4763,0,0,0,1,0,1
9743,20,1821,525;4766,0,0,0,2,0,2
9744,20,1822,4535,0,0,0,1,0,1
9745,20,1823,4772,0,0,0,0,1,1
9746,20,1824,4774;4775,0,0,0,1,1,2
9747,20,1825,4776;5146;11166,0,0,1,2,0,3
9748,20,1826,4778;7847,0,0,0,2,0,2
9749,20,1827,4779;4780;10931,0,0,1,2,0,3
9750,20,1828,3780;4781,0,0,0,1,1,2
9751,20,1829,4782;4783,0,0,0,1,1,2
9752,20,1830,4784,0,0,0,0,1,1
9753,20,1831,4785;7734;10303;10735,0,0,1,3,0,4
9754,20,1832,4786;5536,0,0,0,2,0,2
9755,20,1833,3100;4787,0,0,0,2,0,2
9756,20,1834,4788;7009;10390;10558;10682;11681,0,1,2,3,0,6
9757,20,1836,4798,0,0,0,0,1,1
9758,20,1837,4800,0,0,0,0,1,1
9759,20,1838,4801;4804,0,0,0,0,2,2
9760,20,1839,4805;4806,0,0,0,1,1,2
9761,20,1841,4810;4811,0,0,0,1,1,2
9762,20,1842,4812;4813,0,0,0,2,0,2
9763,20,1844,4198;4816,0,0,0,2,0,2
9764,20,1846,1541;2005;3023;10577;11083;11266,0,0,3,3,0,6
9765,20,1847,4822,0,0,0,0,1,1
9766,20,1848,4824;9958,0,0,0,2,0,2
9767,20,1849,4826,0,0,0,0,1,1
9768,20,1850,4829,0,0,0,0,1,1
9769,20,1851,4830;4831,0,0,0,2,0,2
9770,20,1852,4834;4835;10408,0,0,0,3,0,3
9771,20,1853,4929,0,0,0,1,0,1
9772,20,1854,4839,0,0,0,0,1,1
9773,20,1855,4841,0,0,0,1,0,1
9774,20,1856,4844,0,0,0,0,1,1
9775,20,1858,4848;4849,0,0,0,2,0,2
9776,20,1859,3099;4853;11209;11572,0,0,2,2,0,4
9777,20,1860,4858;4862,0,0,0,2,0,2
9778,20,1861,4863;4864;4866,0,0,0,1,2,3
9779,20,1862,4870;8764,0,0,0,2,0,2
9780,20,1863,4871;4872,0,0,0,2,0,2
9781,20,1864,4875,0,0,0,0,1,1
9782,20,1865,4877;4878,0,0,0,1,1,2
9783,20,1866,4879;8171;10075;10350;10608;11455,0,0,2,4,0,6
9784,20,1867,4881;4883,0,0,0,1,1,2
9785,20,1868,275;4889,0,0,0,2,0,2
9786,20,1869,4890;4892,0,0,0,1,1,2
9787,20,1870,2527,0,0,0,0,1,1
9788,20,1871,4894;4895,0,0,0,0,2,2
9789,20,1873,4901,0,0,0,0,1,1
9790,20,1875,4905;7013,0,0,0,1,1,2
9791,20,1878,4910;4968,0,0,0,2,0,2
9792,20,1879,4912,0,0,0,0,1,1
9793,20,1880,4915,0,0,0,0,1,1
9794,20,1881,4918;4919,0,0,0,1,1,2
9795,20,1882,4921;4922,0,0,0,1,1,2
9796,20,1884,4659;4928,0,0,0,2,0,2
9797,20,1885,303;4933;10908,0,0,1,2,0,3
9798,20,1886,4556,0,0,0,0,1,1
9799,20,1887,4935;4936,0,0,0,1,1,2
9800,20,1889,4943;4944;4946,0,0,0,1,2,3
9801,20,1890,4947,0,0,0,0,1,1
9802,20,1891,4951;4956,0,0,0,2,0,2
9803,20,1892,4958;4960,0,0,0,1,1,2
9804,20,1893,4082;5299,0,0,0,0,2,2
9805,20,1895,4966;9556,0,0,0,2,0,2
9806,20,1896,3923;6332,0,0,0,2,0,2
9807,20,1898,4975;10313;11129,0,0,1,2,0,3
9808,20,1899,4976;4977,0,0,0,1,1,2
9809,20,1900,4981,0,0,0,0,1,1
9810,20,1904,4986,0,0,0,0,1,1
9811,20,1905,4989,0,0,0,0,1,1
9812,20,1906,4992,0,0,0,1,0,1
9813,20,1908,4996,0,0,0,0,1,1
9814,20,1909,4442,0,0,0,1,0,1
9815,20,1910,4999,0,0,0,0,1,1
9816,20,1912,5006;5007,0,0,0,1,1,2
9817,20,1914,5011;5012,0,0,0,2,0,2
9818,20,1915,680;5014;5016,0,0,0,3,0,3
9819,20,1916,5018,0,0,0,0,1,1
9820,20,1917,5020;5022,0,0,0,1,1,2
9821,20,1918,5023,0,0,0,0,1,1
9822,20,1919,851;1494;5027;10899;11058;11198;11436,0,0,4,3,0,7
9823,20,1920,5028,0,0,0,0,1,1
9824,20,1922,5033;5034;11053,0,0,1,2,0,3
9825,20,1923,5036;7428;10467;11181,0,0,2,2,0,4
9826,20,1924,5038;9914,0,0,0,2,0,2
9827,20,1926,5042;5043,0,0,0,2,0,2
9828,20,1927,5045;5415,0,0,0,1,1,2
9829,20,1928,5048;5050,0,0,0,0,2,2
9830,20,1929,508;5053,0,0,0,0,2,2
9831,20,1930,5055;10196,0,0,0,2,0,2
9832,20,1932,5060,0,0,0,0,1,1
9833,20,1933,4125;5061,0,0,0,1,1,2
9834,20,1934,5065;5066,0,0,0,2,0,2
9835,20,1935,4589;5067;11328,0,0,1,2,0,3
9836,20,1937,1919;5074,0,0,0,2,0,2
9837,20,1938,5076,0,0,0,1,0,1
9838,20,1941,5081,0,0,0,1,0,1
9839,20,1942,713;5084;8898,0,0,0,3,0,3
9840,20,1943,5088;7706;10236;10418,0,0,1,3,0,4
9841,20,1944,5091;9282,0,0,0,2,0,2
9842,20,1945,5093,0,0,0,1,0,1
9843,20,1946,5095;8874,0,0,0,2,0,2
9844,20,1947,5098,0,0,0,0,1,1
9845,20,1948,5102;5314;11260;11477;11612,0,1,2,2,0,5
9846,20,1950,5106,0,0,0,0,1,1
9847,20,1953,5111,0,0,0,0,1,1
9848,20,1954,5115;5116,0,0,0,1,1,2
9849,20,1955,5118;5119,0,0,0,0,2,2
9850,20,1956,5120;7064,0,0,0,1,1,2
9851,20,1957,5121,0,0,0,0,1,1
9852,20,1960,759;5125,0,0,0,1,1,2
9853,20,1961,4017;5127;5128;10719;11148,0,0,2,3,0,5
9854,20,1962,5129;5130,0,0,0,1,1,2
9855,20,1963,5131;5135,0,0,0,1,1,2
9856,20,1964,5136;5137;7250,0,0,0,1,2,3
9857,20,1966,5139;5140,0,0,0,1,1,2
9858,20,1967,5141;5142,0,0,0,0,2,2
9859,20,1968,5143,0,0,0,0,1,1
9860,20,1971,5152;5153,0,0,0,0,2,2
9861,20,1972,5154;5155,0,0,0,1,1,2
9862,20,1973,5157;5158,0,0,0,0,2,2
9863,20,1974,5162;5163,0,0,0,1,1,2
9864,20,1975,5165;8716,0,0,0,2,0,2
9865,20,1976,5167;5168,0,0,0,1,1,2
9866,20,1978,5172,0,0,0,1,0,1
9867,20,1979,5176;5178,0,0,0,1,1,2
9868,20,1980,5179;5180;10502;10623;11121;11491,0,0,4,1,1,6
9869,20,1981,5182,0,0,0,0,1,1
9870,20,1982,9439,0,0,0,1,0,1
9871,20,1983,419;5185;5187;10686;10865;11387,0,0,3,3,0,6
9872,20,1984,5190;5192,0,0,0,2,0,2
9873,20,1985,5194,0,0,0,0,1,1
9874,20,1986,4983;5196;11142,0,0,1,2,0,3
9875,20,1988,5199,0,0,0,0,1,1
9876,20,1990,5205,0,0,0,0,1,1
9877,20,1992,5209,0,0,0,0,1,1
9878,20,1993,5214;5215,0,0,0,0,2,2
9879,20,1994,5217;5218;10306;10534,0,0,1,3,0,4
9880,20,1995,5219;5221,0,0,0,0,2,2
9881,20,1997,5224,0,0,0,1,0,1
9882,20,1998,5226;10388;10587,0,0,1,2,0,3
9883,20,1999,5229;5231;5232,0,0,0,2,1,3
9884,20,2000,5233,0,0,0,1,0,1
9885,20,2001,5237;6741,0,0,0,2,0,2
9886,20,2003,5240,0,0,0,0,1,1
9887,20,2004,4803;5243,0,0,0,2,0,2
9888,20,2005,3119;5247;5249;10624;10974,0,0,2,3,0,5
9889,20,2006,5250;5251;10433;10598;10877,0,0,3,1,1,5
9890,20,2007,5252,0,0,0,0,1,1
9891,20,2008,5253,0,0,0,0,1,1
9892,20,2009,5256;5258,0,0,0,1,1,2
9893,20,2010,5259,0,0,0,0,1,1
9894,20,2011,5262;5263,0,0,0,0,2,2
9895,20,2012,255;5264,0,0,0,0,2,2
9896,20,2013,5265,0,0,0,1,0,1
9897,20,2016,5271,0,0,0,0,1,1
9898,20,2018,5274;6936;10531,0,0,1,2,0,3
9899,20,2020,5279,0,0,0,0,1,1
9900,20,2021,5283,0,0,0,0,1,1
9901,20,2022,5284;5285,0,0,0,1,1,2
9902,20,2023,5287,0,0,0,0,1,1
9903,20,2024,1958;5291,0,0,0,2,0,2
9904,20,2025,5293;8731;10302;10603,0,0,1,3,0,4
9905,20,2026,5294,0,0,0,0,1,1
9906,20,2028,2323;7315,0,0,0,2,0,2
9907,20,2029,5303;5304,0,0,0,0,2,2
9908,20,2030,5306;5307,0,0,0,0,2,2
9909,20,2031,5308;5309;10009;10988,0,0,1,3,0,4
9910,20,2033,5315;6176;10816;11431;11657,0,1,2,2,0,5
9911,20,2034,5316;5317,0,0,0,0,2,2
9912,20,2035,2661;5320,0,0,0,2,0,2
9913,20,2036,5321;8005;10156;10229;10497,0,0,1,4,0,5
9914,20,2039,5325;8954,0,0,0,2,0,2
9915,20,2040,5326;5327;5329;5331,0,0,0,3,1,4
9916,20,2041,5332;6514;10309;10526,0,0,1,3,0,4
9917,20,2042,730;5333;10562;10615;10730,0,0,3,2,0,5
9918,20,2043,5335;8525;8526;10013;10362,0,0,0,5,0,5
9919,20,2044,5336;5337,0,0,0,0,2,2
9920,20,2045,5338;6679,0,0,0,2,0,2
9921,20,2048,5343,0,0,0,0,1,1
9922,20,2049,5345,0,0,0,0,1,1
9923,20,2050,5346;8173,0,0,0,2,0,2
9924,20,2051,5348,0,0,0,0,1,1
9925,20,2053,5354;5355,0,0,0,1,1,2
9926,20,2055,5358;5359,0,0,0,0,2,2
9927,20,2056,1813;5361,0,0,0,1,1,2
9928,20,2057,5363;5367;11094,0,0,1,2,0,3
9929,20,2058,5369;5767,0,0,0,2,0,2
9930,20,2060,5373;5374,0,0,0,1,1,2
9931,20,2061,5375;5376;5378,0,0,0,1,2,3
9932,20,2063,5383;5384,0,0,0,1,1,2
9933,20,2064,5386;5387,0,0,0,0,2,2
9934,20,2065,4615;5388;5390;10130;10455,0,0,1,4,0,5
9935,20,2066,1663;5391;5392;10506;11009,0,0,2,3,0,5
9936,20,2067,1095;5393;11228;11875,0,1,1,2,0,4
9937,20,2069,5398,0,0,0,0,1,1
9938,20,2070,5400,0,0,0,0,1,1
9939,20,2071,5403;5404,0,0,0,2,0,2
9940,20,2072,5405;5406,0,0,0,1,1,2
9941,20,2073,5407,0,0,0,1,0,1
9942,20,2074,5413,0,0,0,0,1,1
9943,20,2077,5417,0,0,0,0,1,1
9944,20,2078,2486;5422;10694;11513,0,0,2,2,0,4
9945,20,2079,5423;5424,0,0,0,2,0,2
9946,20,2080,5427;6732;10221;10365;10868;11617,0,1,1,4,0,6
9947,20,2082,874;5431;5433,0,0,0,3,0,3
9948,20,2083,157;5435;5437;10242;11096,0,0,1,4,0,5
9949,20,2084,5440,0,0,0,0,1,1
9950,20,2085,5444,0,0,0,0,1,1
9951,20,2086,5446;5449,0,0,0,1,1,2
9952,20,2087,5452,0,0,0,0,1,1
9953,20,2088,4592,0,0,0,0,1,1
9954,20,2089,5454;5455,0,0,0,1,1,2
9955,20,2090,5456;5457;5460,0,0,0,2,1,3
9956,20,2093,5463;5464;10298;10389,0,0,0,4,0,4
9957,20,2096,5468;5469;10778;11278,0,0,2,1,1,4
9958,20,2101,5477,0,0,0,0,1,1
9959,20,2102,5481;5482,0,0,0,1,1,2
9960,20,2103,5484;5678,0,0,0,0,2,2
9961,20,2104,5486;5487,0,0,0,0,2,2
9962,20,2105,5488;5511,0,0,0,2,0,2
9963,20,2106,5465;5491,0,0,0,2,0,2
9964,20,2107,5494,0,0,0,0,1,1
9965,20,2108,5497,0,0,0,0,1,1
9966,20,2109,4660;5499;5500,0,0,0,2,1,3
9967,20,2110,5503,0,0,0,1,0,1
9968,20,2111,5504;5666;11730,0,1,0,2,0,3
9969,20,2112,5505;8503,0,0,0,1,1,2
9970,20,2113,459;5506;10488;10953,0,0,2,2,0,4
9971,20,2114,5507;5508,0,0,0,1,1,2
9972,20,2117,5513;5514,0,0,0,1,1,2
9973,20,2118,5517;5518,0,0,0,1,1,2
9974,20,2119,5520;5521,0,0,0,1,1,2
9975,20,2120,5524;5526;5756,0,0,0,3,0,3
9976,20,2122,5030;5528;10743,0,0,1,2,0,3
9977,20,2123,736,0,0,0,1,0,1
9978,20,2124,5530;5531,0,0,0,1,1,2
9979,20,2126,3305;5534,0,0,0,2,0,2
9980,20,2129,5538,0,0,0,0,1,1
9981,20,2130,5541,0,0,0,0,1,1
9982,20,2131,5544,0,0,0,0,1,1
9983,20,2132,5549;5550;10080;10153;10324,0,0,0,4,1,5
9984,20,2133,5552,0,0,0,0,1,1
9985,20,2134,5555;5556;5557,0,0,0,2,1,3
9986,20,2136,5560,0,0,0,1,0,1
9987,20,2137,5563;5564,0,0,0,0,2,2
9988,20,2139,5570,0,0,0,0,1,1
9989,20,2140,5574;7618,0,0,0,2,0,2
9990,20,2141,5576;5577,0,0,0,0,2,2
9991,20,2142,5448;5578;10425;11150;11485,0,0,3,2,0,5
9992,20,2143,5579;5580,0,0,0,1,1,2
9993,20,2145,4602;5582;10147;10527;10805;11399;11990,0,1,3,3,0,7
9994,20,2146,5583,0,0,0,0,1,1
9995,20,2149,5591,0,0,0,0,1,1
9996,20,2150,5592,0,0,0,0,1,1
9997,20,2151,5593;5594,0,0,0,0,2,2
9998,20,2152,4884;5596,0,0,0,2,0,2
9999,20,2154,5599,0,0,0,0,1,1
10000,20,2156,2405;5607,0,0,0,0,2,2
10001,20,2157,5608;5609,0,0,0,0,2,2
10002,20,2158,5610,0,0,0,0,1,1
10003,20,2159,4395;5613;10752;10980;11031;11240,0,0,4,2,0,6
10004,20,2162,5620;8559,0,0,0,0,2,2
10005,20,2163,5623,0,0,0,0,1,1
10006,20,2165,5009;5627,0,0,0,2,0,2
10007,20,2166,5083;5631;10317;10449;10669,0,0,2,3,0,5
10008,20,2168,5634;7326,0,0,0,0,2,2
10009,20,2170,5641;9920;10047;10129,0,0,0,4,0,4
10010,20,2172,5646,0,0,0,0,1,1
10011,20,2173,5648;5649;10191,0,0,0,3,0,3
10012,20,2174,5650;5651,0,0,0,1,1,2
10013,20,2175,5652;5654;10338;10898,0,0,1,3,0,4
10014,20,2176,5655;5656,0,0,0,0,2,2
10015,20,2177,5658,0,0,0,0,1,1
10016,20,2178,2562;5660,0,0,0,0,2,2
10017,20,2179,5663;5664,0,0,0,0,2,2
10018,20,2181,5667;7457,0,0,0,2,0,2
10019,20,2182,5669,0,0,0,0,1,1
10020,20,2184,5672;5673;5674,0,0,0,1,2,3
10021,20,2185,5220;5675;10208;11323,0,0,1,3,0,4
10022,20,2186,7001,0,0,0,1,0,1
10023,20,2188,5681,0,0,0,0,1,1
10024,20,2190,5683,0,0,0,0,1,1
10025,20,2193,5693,0,0,0,0,1,1
10026,20,2194,5694;7933,0,0,0,2,0,2
10027,20,2195,5696;5697;10376,0,0,0,2,1,3
10028,20,2196,5701,0,0,0,0,1,1
10029,20,2197,1416;9526,0,0,0,2,0,2
10030,20,2198,5878;6592,0,0,0,2,0,2
10031,20,2199,5712;10342,0,0,0,2,0,2
10032,20,2200,5713,0,0,0,0,1,1
10033,20,2201,4201,0,0,0,0,1,1
10034,20,2202,983;987;988;5717;9838;10033;10557;10762;10954,0,0,3,6,0,9
10035,20,2204,5720,0,0,0,0,1,1
10036,20,2205,5724;5725,0,0,0,1,1,2
10037,20,2206,2113;5727,0,0,0,0,2,2
10038,20,2208,5730,0,0,0,0,1,1
10039,20,2210,5734;5736;5738;8027,0,0,0,2,2,4
10040,20,2211,5742,0,0,0,1,0,1
10041,20,2212,5745;5747;5748;8041;11102;11235,0,0,2,1,3,6
10042,20,2215,5758,0,0,0,1,0,1
10043,20,2216,5759,0,0,0,0,1,1
10044,20,2217,5760;9331,0,0,0,2,0,2
10045,20,2218,5761;6843,0,0,0,0,2,2
10046,20,2219,5763;5766,0,0,0,1,1,2
10047,20,2220,5768;5770,0,0,0,0,2,2
10048,20,2224,5782,0,0,0,0,1,1
10049,20,2225,5783,0,0,0,0,1,1
10050,20,2226,5785,0,0,0,0,1,1
10051,20,2228,5791;5792;7254,0,0,0,3,0,3
10052,20,2230,5796,0,0,0,1,0,1
10053,20,2231,5800;7942,0,0,0,0,2,2
10054,20,2235,4550;5806,0,0,0,2,0,2
10055,20,2236,5807;9612,0,0,0,0,2,2
10056,20,2237,5812;8644,0,0,0,2,0,2
10057,20,2238,5813;5814,0,0,0,1,1,2
10058,20,2239,5815;8192,0,0,0,0,2,2
10059,20,2240,5816,0,0,0,1,0,1
10060,20,2241,5818,0,0,0,0,1,1
10061,20,2242,5821,0,0,0,0,1,1
10062,20,2243,184;5822,0,0,0,2,0,2
10063,20,2244,9894;9977,0,0,0,2,0,2
10064,20,2245,5826;5827;5828,0,0,0,0,3,3
10065,20,2246,5829,0,0,0,0,1,1
10066,20,2247,5831;5832,0,0,0,1,1,2
10067,20,2248,4790;5833,0,0,0,2,0,2
10068,20,2249,5834;5835;10206;10463,0,0,1,2,1,4
10069,20,2250,5836,0,0,0,0,1,1
10070,20,2252,3339;5840;10375,0,0,0,3,0,3
10071,20,2253,5842,0,0,0,0,1,1
10072,20,2254,597;5844,0,0,0,2,0,2
10073,20,2256,5847;5848,0,0,0,0,2,2
10074,20,2260,5856;5857,0,0,0,1,1,2
10075,20,2261,5732;5859,0,0,0,2,0,2
10076,20,2262,4740;5862;5864,0,0,0,3,0,3
10077,20,2263,5866,0,0,0,0,1,1
10078,20,2264,5722;5868;5869,0,0,0,3,0,3
10079,20,2265,5872,0,0,0,1,0,1
10080,20,2266,5874;5876,0,0,0,1,1,2
10081,20,2270,5880,0,0,0,0,1,1
10082,20,2272,5884,0,0,0,1,0,1
10083,20,2274,5887;5890;10144;10189;10519;10937,0,0,2,4,0,6
10084,20,2275,5891,0,0,0,1,0,1
10085,20,2276,5895;7586,0,0,0,0,2,2
10086,20,2277,5896,0,0,0,1,0,1
10087,20,2278,2809;5897;10032;10119,0,0,0,4,0,4
10088,20,2282,3085;5909;10880;10920,0,0,2,2,0,4
10089,20,2283,5910;5911,0,0,0,1,1,2
10090,20,2284,5912,0,0,0,0,1,1
10091,20,2285,585;5916,0,0,0,2,0,2
10092,20,2286,3955,0,0,0,1,0,1
10093,20,2287,5919,0,0,0,1,0,1
10094,20,2288,5921,0,0,0,0,1,1
10095,20,2289,5923;5924,0,0,0,2,0,2
10096,20,2290,5925;5926;10538;10768,0,0,2,2,0,4
10097,20,2291,4018;5927,0,0,0,0,2,2
10098,20,2292,5931;6681;10821,0,0,1,2,0,3
10099,20,2294,5934;5935;5937,0,0,0,2,1,3
10100,20,2295,5938,0,0,0,0,1,1
10101,20,2296,5941;5942,0,0,0,1,1,2
10102,20,2298,5944;7645;10182;10692,0,0,1,3,0,4
10103,20,2299,1295;5946,0,0,0,2,0,2
10104,20,2300,5947;5950,0,0,0,1,1,2
10105,20,2301,5951;9192;10090;10428;10542,0,0,2,3,0,5
10106,20,2302,3389;5955,0,0,0,2,0,2
10107,20,2303,5957,0,0,0,1,0,1
10108,20,2304,5958;5959,0,0,0,2,0,2
10109,20,2305,4156;5960;5962,0,0,0,3,0,3
10110,20,2306,867;5965,0,0,0,1,1,2
10111,20,2308,2583;5975,0,0,0,0,2,2
10112,20,2311,5979,0,0,0,0,1,1
10113,20,2312,5984,0,0,0,1,0,1
10114,20,2313,5987,0,0,0,0,1,1
10115,20,2314,5989;5991;5992;10827;11084;11363,0,0,3,3,0,6
10116,20,2315,5993,0,0,0,0,1,1
10117,20,2316,5997,0,0,0,0,1,1
10118,20,2317,5999;6003,0,0,0,1,1,2
10119,20,2318,6004;6005,0,0,0,0,2,2
10120,20,2319,4224;6006,0,0,0,2,0,2
10121,20,2320,2089,0,0,0,1,0,1
10122,20,2321,6008;8341,0,0,0,2,0,2
10123,20,2324,3843;6014;6015,0,0,0,1,2,3
10124,20,2326,6019;6021;7002,0,0,0,3,0,3
10125,20,2327,6023,0,0,0,0,1,1
10126,20,2329,3040;6027;6028,0,0,0,3,0,3
10127,20,2330,6029,0,0,0,0,1,1
10128,20,2331,6030;6032,0,0,0,0,2,2
10129,20,2332,6033,0,0,0,0,1,1
10130,20,2334,6039;7609;10767,0,0,1,2,0,3
10131,20,2335,6041;6042,0,0,0,1,1,2
10132,20,2336,6043;6044,0,0,0,2,0,2
10133,20,2340,2079;6048,0,0,0,0,2,2
10134,20,2341,6049;6050,0,0,0,1,1,2
10135,20,2342,6052;6053;10671;11208;11449,0,0,3,2,0,5
10136,20,2343,1360;6055;11542,0,0,1,2,0,3
10137,20,2347,4155;6061,0,0,0,0,2,2
10138,20,2349,6065,0,0,0,1,0,1
10139,20,2350,6068,0,0,0,1,0,1
10140,20,2352,990;6075,0,0,0,0,2,2
10141,20,2354,6080,0,0,0,0,1,1
10142,20,2355,6083;6085,0,0,0,1,1,2
10143,20,2359,6092,0,0,0,0,1,1
10144,20,2361,6095;6096,0,0,0,1,1,2
10145,20,2362,6097;6098,0,0,0,2,0,2
10146,20,2364,6104,0,0,0,0,1,1
10147,20,2365,6105,0,0,0,0,1,1
10148,20,2366,6109;6111;6138;6560,0,0,0,2,2,4
10149,20,2367,6113;10044,0,0,0,2,0,2
10150,20,2368,4566;6115,0,0,0,2,0,2
10151,20,2369,6120;6121,0,0,0,0,2,2
10152,20,2370,6124,0,0,0,0,1,1
10153,20,2371,6125,0,0,0,0,1,1
10154,20,2372,6128;6129,0,0,0,0,2,2
10155,20,2380,6141;6142,0,0,0,2,0,2
10156,20,2382,6146,0,0,0,0,1,1
10157,20,2383,6148;6149,0,0,0,1,1,2
10158,20,2384,5478;6150;11043;11613;12080,0,2,1,2,0,5
10159,20,2385,4089;10019;10131;10235,0,0,0,4,0,4
10160,20,2387,6160;8795,0,0,0,2,0,2
10161,20,2388,6162;6163;7410;10060;10184;10549,0,0,1,5,0,6
10162,20,2389,6165,0,0,0,0,1,1
10163,20,2390,6167;6168,0,0,0,1,1,2
10164,20,2391,6172,0,0,0,1,0,1
10165,20,2392,6173;6174,0,0,0,2,0,2
10166,20,2393,1718;6175,0,0,0,2,0,2
10167,20,2395,4010;6180;10118;10589,0,0,1,3,0,4
10168,20,2396,6181;6182,0,0,0,1,1,2
10169,20,2397,6186,0,0,0,0,1,1
10170,20,2398,6190,0,0,0,0,1,1
10171,20,2399,6193;8719;10349;10387;10544;11309,0,0,2,4,0,6
10172,20,2400,772;6195,0,0,0,0,2,2
10173,20,2401,866;6200,0,0,0,2,0,2
10174,20,2403,6204,0,0,0,1,0,1
10175,20,2404,6206;7602,0,0,0,0,2,2
10176,20,2405,6209;6212,0,0,0,2,0,2
10177,20,2407,6214;8833;10100;10114;10140;10300;10356;10673;10690,0,0,2,7,0,9
10178,20,2408,6216;6217;10036;10058;10806;10967;11249,0,0,3,4,0,7
10179,20,2409,6218;6220,0,0,0,0,2,2
10180,20,2410,6223,0,0,0,0,1,1
10181,20,2412,6227,0,0,0,0,1,1
10182,20,2413,6228,0,0,0,0,1,1
10183,20,2414,6232,0,0,0,0,1,1
10184,20,2416,6235,0,0,0,0,1,1
10185,20,2418,6241;6242;10284;10372;10890,0,0,1,4,0,5
10186,20,2419,6245,0,0,0,1,0,1
10187,20,2420,6248,0,0,0,0,1,1
10188,20,2421,6249,0,0,0,0,1,1
10189,20,2422,1759;6251;6252,0,0,0,3,0,3
10190,20,2424,6255;6256,0,0,0,2,0,2
10191,20,2425,6257;6258,0,0,0,0,2,2
10192,20,2426,6263;6264,0,0,0,0,2,2
10193,20,2428,6267,0,0,0,0,1,1
10194,20,2429,6272,0,0,0,1,0,1
10195,20,2430,6273;6274;6275,0,0,0,2,1,3
10196,20,2432,6279,0,0,0,1,0,1
10197,20,2433,6282;6283,0,0,0,1,1,2
10198,20,2434,6288;6290,0,0,0,1,1,2
10199,20,2435,6291,0,0,0,1,0,1
10200,20,2437,6294,0,0,0,0,1,1
10201,20,2438,6298,0,0,0,0,1,1
10202,20,2439,6300;6301,0,0,0,0,2,2
10203,20,2441,681;6305,0,0,0,2,0,2
10204,20,2442,6306,0,0,0,1,0,1
10205,20,2445,6221;6317,0,0,0,2,0,2
10206,20,2446,6320;6321,0,0,0,1,1,2
10207,20,2447,6324,0,0,0,1,0,1
10208,20,2449,6328;6329,0,0,0,0,2,2
10209,20,2451,4821;6333;6336,0,0,0,3,0,3
10210,20,2452,6338,0,0,0,0,1,1
10211,20,2453,3652;6342,0,0,0,2,0,2
10212,20,2454,6343;6344;9496,0,0,0,3,0,3
10213,20,2455,6346;6348,0,0,0,1,1,2
10214,20,2456,6349;6350,0,0,0,0,2,2
10215,20,2457,6353,0,0,0,1,0,1
10216,20,2459,6356;6357,0,0,0,0,2,2
10217,20,2460,6512;9952,0,0,0,0,2,2
10218,20,2461,6362,0,0,0,1,0,1
10219,20,2463,6365;6366;10216;10465;11294;11413,0,0,3,3,0,6
10220,20,2464,6367;6368,0,0,0,0,2,2
10221,20,2465,6372,0,0,0,0,1,1
10222,20,2467,6376,0,0,0,0,1,1
10223,20,2468,6379;9849;10281;10442;10518,0,0,2,3,0,5
10224,20,2470,6382;10046,0,0,0,2,0,2
10225,20,2474,6386;6387;6388,0,0,0,0,3,3
10226,20,2475,6391,0,0,0,0,1,1
10227,20,2477,4440;6395,0,0,0,2,0,2
10228,20,2479,6402;6403,0,0,0,1,1,2
10229,20,2480,6409;6410;10501;10658,0,0,2,2,0,4
10230,20,2482,6414,0,0,0,0,1,1
10231,20,2483,6416,0,0,0,0,1,1
10232,20,2484,6417,0,0,0,0,1,1
10233,20,2485,6418;6419;6421;10377;10559,0,0,1,3,1,5
10234,20,2486,6423,0,0,0,1,0,1
10235,20,2489,6427;6429,0,0,0,0,2,2
10236,20,2490,1831;6431,0,0,0,2,0,2
10237,20,2491,6432;6433,0,0,0,1,1,2
10238,20,2492,6436,0,0,0,0,1,1
10239,20,2493,6437;8095,0,0,0,1,1,2
10240,20,2494,5775;6438;6439;6440,0,0,0,4,0,4
10241,20,2495,6441;6442;6443;6444;10949;11274,0,0,2,3,1,6
10242,20,2496,6446,0,0,0,1,0,1
10243,20,2497,6448;6449;10256;10718,0,0,1,2,1,4
10244,20,2498,6450;6451,0,0,0,2,0,2
10245,20,2499,6455;6457,0,0,0,0,2,2
10246,20,2500,6459;6460,0,0,0,2,0,2
10247,20,2501,6462;6465,0,0,0,1,1,2
10248,20,2502,6467,0,0,0,0,1,1
10249,20,2503,6468;6469;6470,0,0,0,2,1,3
10250,20,2504,6471;6472,0,0,0,0,2,2
10251,20,2505,6473,0,0,0,0,1,1
10252,20,2506,4464;6475,0,0,0,0,2,2
10253,20,2508,6477;6478,0,0,0,1,1,2
10254,20,2509,4623;6479,0,0,0,1,1,2
10255,20,2510,2791;6482;10499;10579;11184,0,0,3,2,0,5
10256,20,2511,6484,0,0,0,0,1,1
10257,20,2513,6488,0,0,0,0,1,1
10258,20,2514,6491,0,0,0,1,0,1
10259,20,2516,6497;8202,0,0,0,2,0,2
10260,20,2517,6499;6500,0,0,0,0,2,2
10261,20,2521,1042;6506;11168;11311,0,0,2,2,0,4
10262,20,2522,6508,0,0,0,0,1,1
10263,20,2523,6510,0,0,0,0,1,1
10264,20,2527,6519,0,0,0,1,0,1
10265,20,2528,6521;6522,0,0,0,1,1,2
10266,20,2529,6523;6524,0,0,0,2,0,2
10267,20,2530,6527,0,0,0,0,1,1
10268,20,2531,6532;8861,0,0,0,2,0,2
10269,20,2532,6534;6535,0,0,0,2,0,2
10270,20,2533,6538;9440,0,0,0,1,1,2
10271,20,2534,6539;6540;6633,0,0,0,3,0,3
10272,20,2538,6549;6551,0,0,0,1,1,2
10273,20,2539,6552,0,0,0,0,1,1
10274,20,2540,213;8627;11709;12068,0,2,0,2,0,4
10275,20,2542,6564,0,0,0,1,0,1
10276,20,2544,191;6566,0,0,0,2,0,2
10277,20,2545,6569,0,0,0,0,1,1
10278,20,2546,6570;6892,0,0,0,0,2,2
10279,20,2547,7206,0,0,0,0,1,1
10280,20,2548,6573,0,0,0,0,1,1
10281,20,2549,6575;7930;10731;10999,0,0,2,2,0,4
10282,20,2551,6578,0,0,0,0,1,1
10283,20,2552,6579,0,0,0,0,1,1
10284,20,2553,4926;6583,0,0,0,0,2,2
10285,20,2554,6584;6585;6587;10285;10345;10431,0,0,1,4,1,6
10286,20,2555,6590;6591,0,0,0,1,1,2
10287,20,2556,6594,0,0,0,1,0,1
10288,20,2557,6596,0,0,0,0,1,1
10289,20,2558,6597,0,0,0,0,1,1
10290,20,2559,6599;7725,0,0,0,2,0,2
10291,20,2560,6600,0,0,0,0,1,1
10292,20,2562,6609,0,0,0,0,1,1
10293,20,2563,6610;6612;10042;10323;10490,0,0,1,4,0,5
10294,20,2565,6614,0,0,0,1,0,1
10295,20,2567,6618;6619,0,0,0,2,0,2
10296,20,2568,6620;6621;6623,0,0,0,1,2,3
10297,20,2570,6630;10180;10227,0,0,0,3,0,3
10298,20,2571,4239;6634;10024;10254;10472,0,0,1,4,0,5
10299,20,2572,950;1986;6636;6637;11585;11650;11801,0,2,1,4,0,7
10300,20,2573,6639;6640;6641;6642,0,0,0,3,1,4
10301,20,2574,5900;6643,0,0,0,2,0,2
10302,20,2575,6644;6645,0,0,0,0,2,2
10303,20,2576,6647,0,0,0,1,0,1
10304,20,2577,6650;6653;6654,0,0,0,3,0,3
10305,20,2578,6323;6655,0,0,0,2,0,2
10306,20,2579,6657;6658;6660,0,0,0,2,1,3
10307,20,2580,6662,0,0,0,0,1,1
10308,20,2581,6663;10249;10517;10732,0,0,2,2,0,4
10309,20,2582,5110;6665,0,0,0,0,2,2
10310,20,2583,6666;6667,0,0,0,2,0,2
10311,20,2584,6669;6670,0,0,0,1,1,2
10312,20,2585,6671;6673,0,0,0,0,2,2
10313,20,2586,6676,0,0,0,0,1,1
10314,20,2587,6677,0,0,0,0,1,1
10315,20,2589,2706;6680;11177,0,0,1,2,0,3
10316,20,2592,6686,0,0,0,0,1,1
10317,20,2593,6690;6691,0,0,0,0,2,2
10318,20,2595,6697;6700;6702;8008,0,0,0,4,0,4
10319,20,2596,6704;6705;6707,0,0,0,1,2,3
10320,20,2597,6708,0,0,0,0,1,1
10321,20,2599,6714,0,0,0,0,1,1
10322,20,2603,6726;6729,0,0,0,2,0,2
10323,20,2604,6730;6731,0,0,0,1,1,2
10324,20,2606,6737;6738;10110;10746,0,0,1,3,0,4
10325,20,2607,6739;6740,0,0,0,0,2,2
10326,20,2609,2510;6745,0,0,0,0,2,2
10327,20,2610,6746;6747,0,0,0,1,1,2
10328,20,2611,6749,0,0,0,0,1,1
10329,20,2612,6752;6753,0,0,0,2,0,2
10330,20,2615,6756;10141,0,0,0,1,1,2
10331,20,2616,6758,0,0,0,0,1,1
10332,20,2617,6762,0,0,0,1,0,1
10333,20,2619,1139;6770;11219;11438;11720,0,1,2,2,0,5
10334,20,2623,6776;6777,0,0,0,0,2,2
10335,20,2624,6781,0,0,0,1,0,1
10336,20,2625,6786,0,0,0,0,1,1
10337,20,2626,6787;6788,0,0,0,1,1,2
10338,20,2627,6476;6790,0,0,0,0,2,2
10339,20,2629,2371;6798,0,0,0,0,2,2
10340,20,2631,6801;6802;11306,0,0,1,2,0,3
10341,20,2632,6803;6804;6805,0,0,0,1,2,3
10342,20,2634,1978;4039;10934;11314,0,0,2,2,0,4
10343,20,2635,6811,0,0,0,1,0,1
10344,20,2636,6812,0,0,0,0,1,1
10345,20,2637,6813;6814,0,0,0,2,0,2
10346,20,2638,6816;10207;10957;11224,0,0,2,2,0,4
10347,20,2639,6817;6818;6820,0,0,0,2,1,3
10348,20,2640,6821;6822,0,0,0,0,2,2
10349,20,2641,6824,0,0,0,0,1,1
10350,20,2642,6825;6826,0,0,0,1,1,2
10351,20,2643,6828;6829;10234;10395;11025,0,0,1,3,1,5
10352,20,2645,6832;9029,0,0,0,0,2,2
10353,20,2646,1012;6834,0,0,0,0,2,2
10354,20,2647,6841,0,0,0,0,1,1
10355,20,2648,6844,0,0,0,0,1,1
10356,20,2649,6852;7333,0,0,0,0,2,2
10357,20,2650,6853;6855,0,0,0,2,0,2
10358,20,2651,2753;6858,0,0,0,0,2,2
10359,20,2652,6860,0,0,0,1,0,1
10360,20,2653,811;6862;6866;6867,0,0,0,3,1,4
10361,20,2654,6868;6869,0,0,0,1,1,2
10362,20,2657,6876;8303,0,0,0,2,0,2
10363,20,2658,2545;5191;6878;6880;11796,0,1,0,4,0,5
10364,20,2660,6883,0,0,0,0,1,1
10365,20,2661,6886;6888,0,0,0,0,2,2
10366,20,2662,6889;6890,0,0,0,0,2,2
10367,20,2665,6893,0,0,0,0,1,1
10368,20,2668,6898,0,0,0,0,1,1
10369,20,2669,6900,0,0,0,0,1,1
10370,20,2670,4095,0,0,0,1,0,1
10371,20,2672,6906,0,0,0,0,1,1
10372,20,2673,6909;6911,0,0,0,1,1,2
10373,20,2674,6913;6914;9937;10403,0,0,0,4,0,4
10374,20,2675,5476;6915,0,0,0,2,0,2
10375,20,2676,6916;6918,0,0,0,1,1,2
10376,20,2678,6923;6924,0,0,0,2,0,2
10377,20,2680,6926,0,0,0,0,1,1
10378,20,2681,3235;6928,0,0,0,2,0,2
10379,20,2685,6938;6939,0,0,0,1,1,2
10380,20,2686,6940;6941,0,0,0,1,1,2
10381,20,2687,6942;6943,0,0,0,0,2,2
10382,20,2688,6031;6944,0,0,0,2,0,2
10383,20,2689,6945;6946,0,0,0,0,2,2
10384,20,2690,3442;6952;6955;10394;10620;11125,0,0,2,4,0,6
10385,20,2691,6957,0,0,0,0,1,1
10386,20,2694,5364;6961,0,0,0,2,0,2
10387,20,2698,4612;6966,0,0,0,2,0,2
10388,20,2699,6969;10866;10946,0,0,2,1,0,3
10389,20,2701,6975;6976,0,0,0,1,1,2
10390,20,2703,6979;6980,0,0,0,0,2,2
10391,20,2704,1577;6984,0,0,0,1,1,2
10392,20,2705,4691;6988;6990;10440,0,0,1,3,0,4
10393,20,2706,6992,0,0,0,0,1,1
10394,20,2708,6998,0,0,0,0,1,1
10395,20,2710,7004,0,0,0,0,1,1
10396,20,2712,7006,0,0,0,0,1,1
10397,20,2714,7014,0,0,0,0,1,1
10398,20,2715,7017,0,0,0,1,0,1
10399,20,2716,7022;7023;7025,0,0,0,2,1,3
10400,20,2717,7026;9064,0,0,0,2,0,2
10401,20,2718,1248;7028;10861;11048,0,0,2,2,0,4
10402,20,2719,7034;7035,0,0,0,2,0,2
10403,20,2720,7038,0,0,0,0,1,1
10404,20,2722,7044,0,0,0,1,0,1
10405,20,2723,523;7045;10096;10427,0,0,1,3,0,4
10406,20,2725,7048;9808;10736;11199,0,0,2,2,0,4
10407,20,2726,7049,0,0,0,0,1,1
10408,20,2727,7053,0,0,0,0,1,1
10409,20,2728,2733;7055,0,0,0,0,2,2
10410,20,2729,659;7057,0,0,0,2,0,2
10411,20,2730,7059,0,0,0,0,1,1
10412,20,2731,7060;7061,0,0,0,0,2,2
10413,20,2732,7063,0,0,0,0,1,1
10414,20,2734,7065,0,0,0,0,1,1
10415,20,2735,7070;7074,0,0,0,1,1,2
10416,20,2736,7075;7076,0,0,0,2,0,2
10417,20,2737,7080,0,0,0,1,0,1
10418,20,2739,7085,0,0,0,0,1,1
10419,20,2742,7090;7091,0,0,0,1,1,2
10420,20,2743,7092,0,0,0,1,0,1
10421,20,2744,7094;11476;11611,0,1,1,1,0,3
10422,20,2745,7096;9868,0,0,0,2,0,2
10423,20,2746,7099;7100;7101;7102,0,0,0,2,2,4
10424,20,2747,7103,0,0,0,0,1,1
10425,20,2751,6428;7113;7115,0,0,0,3,0,3
10426,20,2753,7120,0,0,0,0,1,1
10427,20,2754,7122;7123,0,0,0,1,1,2
10428,20,2755,7126,0,0,0,0,1,1
10429,20,2756,7130;7131,0,0,0,0,2,2
10430,20,2758,7133;7134,0,0,0,2,0,2
10431,20,2759,7135;10711;11040,0,0,2,1,0,3
10432,20,2760,7136;7137;10071;10359;10885,0,0,1,3,1,5
10433,20,2761,7139;7140,0,0,0,1,1,2
10434,20,2763,7147,0,0,0,1,0,1
10435,20,2764,7149,0,0,0,1,0,1
10436,20,2765,7152;7153,0,0,0,1,1,2
10437,20,2766,7154;7156,0,0,0,1,1,2
10438,20,2769,1760;7162;10335;10698;11069,0,0,2,3,0,5
10439,20,2770,6765;7164,0,0,0,2,0,2
10440,20,2771,2671;7165,0,0,0,2,0,2
10441,20,2772,7167;10782;10971,0,0,2,1,0,3
10442,20,2773,7169;7296,0,0,0,1,1,2
10443,20,2775,7175,0,0,0,0,1,1
10444,20,2776,7178;7179,0,0,0,2,0,2
10445,20,2777,7182,0,0,0,0,1,1
10446,20,2778,6543;7183;7185,0,0,0,3,0,3
10447,20,2780,7187,0,0,0,0,1,1
10448,20,2782,7190,0,0,0,0,1,1
10449,20,2783,7194,0,0,0,0,1,1
10450,20,2784,7195;7196,0,0,0,1,1,2
10451,20,2785,7198;7199,0,0,0,2,0,2
10452,20,2787,7202,0,0,0,0,1,1
10453,20,2788,7204;7205,0,0,0,0,2,2
10454,20,2789,7208,0,0,0,0,1,1
10455,20,2791,3815;4767,0,0,0,2,0,2
10456,20,2792,7214,0,0,0,1,0,1
10457,20,2794,7218,0,0,0,0,1,1
10458,20,2795,7220,0,0,0,0,1,1
10459,20,2796,7225,0,0,0,0,1,1
10460,20,2797,7228;7229,0,0,0,2,0,2
10461,20,2798,7230;7231,0,0,0,0,2,2
10462,20,2799,5855;7232,0,0,0,0,2,2
10463,20,2800,7233,0,0,0,0,1,1
10464,20,2801,7239,0,0,0,0,1,1
10465,20,2802,7240;7241;10714;10979,0,0,2,1,1,4
10466,20,2803,7242;7243,0,0,0,1,1,2
10467,20,2806,7248,0,0,0,0,1,1
10468,20,2808,7251,0,0,0,0,1,1
10469,20,2809,7252;10029,0,0,0,2,0,2
10470,20,2811,457;7258,0,0,0,2,0,2
10471,20,2814,7263;7264;10057;10082;10164;10780;10939,0,0,2,5,0,7
10472,20,2815,7266,0,0,0,1,0,1
10473,20,2817,7269;8082,0,0,0,2,0,2
10474,20,2818,7270;7271,0,0,0,1,1,2
10475,20,2819,5342;7273;10277;10279;10413,0,0,0,5,0,5
10476,20,2820,7277;9362;10543;11460,0,0,2,2,0,4
10477,20,2821,7279,0,0,0,0,1,1
10478,20,2822,7281,0,0,0,0,1,1
10479,20,2823,7282;7284,0,0,0,0,2,2
10480,20,2824,6;7286,0,0,0,2,0,2
10481,20,2825,7288,0,0,0,0,1,1
10482,20,2826,7289,0,0,0,0,1,1
10483,20,2827,7291;7292,0,0,0,0,2,2
10484,20,2829,7297;9899,0,0,0,2,0,2
10485,20,2831,7301,0,0,0,0,1,1
10486,20,2832,7305;7307,0,0,0,1,1,2
10487,20,2833,5954;6965;7310;7311,0,0,0,4,0,4
10488,20,2834,3577;7312,0,0,0,2,0,2
10489,20,2836,1104;7317;10070;10157,0,0,0,4,0,4
10490,20,2837,7319,0,0,0,0,1,1
10491,20,2838,7320;7322;7324,0,0,0,2,1,3
10492,20,2839,7325;11797,0,1,0,1,0,2
10493,20,2840,7327,0,0,0,0,1,1
10494,20,2841,7328;7329;7331,0,0,0,1,2,3
10495,20,2843,7334,0,0,0,0,1,1
10496,20,2846,7338;7339;7344,0,0,0,3,0,3
10497,20,2848,7347;7348,0,0,0,1,1,2
10498,20,2850,7351,0,0,0,0,1,1
10499,20,2851,7354;7355;10565;11230,0,0,2,1,1,4
10500,20,2852,7356,0,0,0,0,1,1
10501,20,2853,7358,0,0,0,1,0,1
10502,20,2854,7363,0,0,0,1,0,1
10503,20,2855,7364;8080,0,0,0,2,0,2
10504,20,2856,7365,0,0,0,0,1,1
10505,20,2860,7377,0,0,0,0,1,1
10506,20,2861,4364;6063,0,0,0,2,0,2
10507,20,2862,2908;7380;7382,0,0,0,3,0,3
10508,20,2863,7384;9946;10883,0,0,1,2,0,3
10509,20,2865,7388,0,0,0,0,1,1
10510,20,2866,1750;7390;11287;11533,0,0,2,2,0,4
10511,20,2867,7392;7393;7395;7396,0,0,0,2,2,4
10512,20,2869,4577;7399,0,0,0,2,0,2
10513,20,2870,7400;7401;7405,0,0,0,3,0,3
10514,20,2871,7406;10052;10807;11453,0,0,2,2,0,4
10515,20,2874,1613;7415;10399;10648,0,0,1,3,0,4
10516,20,2875,7416;7417;7418,0,0,0,2,1,3
10517,20,2877,7424,0,0,0,0,1,1
10518,20,2878,7427,0,0,0,1,0,1
10519,20,2880,7433,0,0,0,0,1,1
10520,20,2882,7437;7438;7439;7440,0,0,0,3,1,4
10521,20,2883,7442;7443;7445,0,0,0,2,1,3
10522,20,2884,7446,0,0,0,0,1,1
10523,20,2885,7448,0,0,0,0,1,1
10524,20,2886,7450;8196,0,0,0,2,0,2
10525,20,2893,7467;8007,0,0,0,2,0,2
10526,20,2894,7468;7469,0,0,0,1,1,2
10527,20,2895,7470;7941,0,0,0,0,2,2
10528,20,2896,7471;7472,0,0,0,2,0,2
10529,20,2897,7475,0,0,0,0,1,1
10530,20,2898,7478;7479,0,0,0,0,2,2
10531,20,2899,3073;7480;7481,0,0,0,3,0,3
10532,20,2900,7482;10402;10820,0,0,1,2,0,3
10533,20,2901,7484,0,0,0,0,1,1
10534,20,2902,7487,0,0,0,0,1,1
10535,20,2903,7489,0,0,0,1,0,1
10536,20,2904,7491,0,0,0,0,1,1
10537,20,2906,7497;7500,0,0,0,2,0,2
10538,20,2907,7501;10088;10606,0,0,1,2,0,3
10539,20,2908,6837;7504;12096,0,1,0,2,0,3
10540,20,2909,7507,0,0,0,0,1,1
10541,20,2913,7518;7519,0,0,0,0,2,2
10542,20,2915,7526;10607;11042,0,0,2,1,0,3
10543,20,2916,7529,0,0,0,1,0,1
10544,20,2918,7533,0,0,0,0,1,1
10545,20,2919,7536;7537,0,0,0,0,2,2
10546,20,2921,7542;10091;10151,0,0,0,3,0,3
10547,20,2922,7544,0,0,0,0,1,1
10548,20,2923,7545,0,0,0,0,1,1
10549,20,2924,7549;7550,0,0,0,1,1,2
10550,20,2925,7551;7555,0,0,0,1,1,2
10551,20,2927,7558;7560,0,0,0,0,2,2
10552,20,2929,7565,0,0,0,0,1,1
10553,20,2932,1985;7573,0,0,0,2,0,2
10554,20,2934,7576,0,0,0,0,1,1
10555,20,2935,7577,0,0,0,0,1,1
10556,20,2936,7580,0,0,0,0,1,1
10557,20,2937,7581;7583;7584,0,0,0,0,3,3
10558,20,2940,1947;7589,0,0,0,2,0,2
10559,20,2941,7590;7592,0,0,0,1,1,2
10560,20,2942,7593;7594,0,0,0,0,2,2
10561,20,2943,7598,0,0,0,0,1,1
10562,20,2944,1569,0,0,0,1,0,1
10563,20,2946,7605;9324,0,0,0,0,2,2
10564,20,2947,7607;11237,0,0,1,1,0,2
10565,20,2948,7608,0,0,0,0,1,1
10566,20,2949,7610;7611,0,0,0,0,2,2
10567,20,2950,7612;7613,0,0,0,1,1,2
10568,20,2951,7614;7616,0,0,0,0,2,2
10569,20,2952,7617;7619,0,0,0,0,2,2
10570,20,2954,7627;7628,0,0,0,1,1,2
10571,20,2956,7631,0,0,0,0,1,1
10572,20,2957,6496;7635,0,0,0,2,0,2
10573,20,2959,3224,0,0,0,0,1,1
10574,20,2962,7644;7646,0,0,0,1,1,2
10575,20,2963,7648,0,0,0,0,1,1
10576,20,2964,7649;7650,0,0,0,1,1,2
10577,20,2965,3072;9299;11143,0,0,1,2,0,3
10578,20,2966,7653,0,0,0,0,1,1
10579,20,2967,4546;7655,0,0,0,2,0,2
10580,20,2968,7660;8103,0,0,0,1,1,2
10581,20,2969,2885;7664;7665;10225;10570;10776;11355,0,0,3,4,0,7
10582,20,2970,7666,0,0,0,0,1,1
10583,20,2971,7667;9333,0,0,0,2,0,2
10584,20,2972,7668;7670,0,0,0,0,2,2
10585,20,2973,7674,0,0,0,0,1,1
10586,20,2974,7676;7677;7678,0,0,0,1,2,3
10587,20,2975,1490;7680;7681,0,0,0,3,0,3
10588,20,2976,7684;7685,0,0,0,2,0,2
10589,20,2977,7686,0,0,0,0,1,1
10590,20,2978,6057;7687,0,0,0,0,2,2
10591,20,2979,7689,0,0,0,0,1,1
10592,20,2980,7693;9770,0,0,0,0,2,2
10593,20,2981,1020;7694;7697,0,0,0,3,0,3
10594,20,2982,7699;7700,0,0,0,2,0,2
10595,20,2983,7702;8838,0,0,0,2,0,2
10596,20,2985,7707;7708,0,0,0,2,0,2
10597,20,2988,7715,0,0,0,0,1,1
10598,20,2989,7716;7717,0,0,0,0,2,2
10599,20,2990,779;7718,0,0,0,2,0,2
10600,20,2991,7719,0,0,0,0,1,1
10601,20,2992,7720;7721,0,0,0,2,0,2
10602,20,2993,7726;7727,0,0,0,0,2,2
10603,20,2994,7731,0,0,0,0,1,1
10604,20,2996,7735;7736,0,0,0,0,2,2
10605,20,2997,7737;7738;10179;10984,0,0,1,3,0,4
10606,20,2999,7743,0,0,0,0,1,1
10607,20,3000,7745;8958,0,0,0,0,2,2
10608,20,3004,2827;7755,0,0,0,1,1,2
10609,20,3005,7756,0,0,0,0,1,1
10610,20,3006,4084;7757,0,0,0,0,2,2
10611,20,3007,7759,0,0,0,0,1,1
10612,20,3008,7761,0,0,0,0,1,1
10613,20,3009,7766,0,0,0,1,0,1
10614,20,3010,1019;7767,0,0,0,2,0,2
10615,20,3011,7769,0,0,0,1,0,1
10616,20,3013,7771;7772;11015,0,0,1,2,0,3
10617,20,3014,7774,0,0,0,1,0,1
10618,20,3015,97;5461,0,0,0,2,0,2
10619,20,3016,7779;7780;8613,0,0,0,2,1,3
10620,20,3017,7782;7784,0,0,0,1,1,2
10621,20,3019,7787,0,0,0,1,0,1
10622,20,3020,7790;7791,0,0,0,1,1,2
10623,20,3021,7792;11673,0,1,0,1,0,2
10624,20,3022,219;11630,0,1,0,1,0,2
10625,20,3023,7795;7796,0,0,0,0,2,2
10626,20,3024,883;7797;10101;10244;10459,0,0,1,4,0,5
10627,20,3026,7800;7801;9969,0,0,0,3,0,3
10628,20,3027,7803;7805,0,0,0,0,2,2
10629,20,3028,5858;7807;10933;11411,0,0,2,2,0,4
10630,20,3029,7810;7811,0,0,0,1,1,2
10631,20,3030,7814,0,0,0,0,1,1
10632,20,3031,7817,0,0,0,1,0,1
10633,20,3032,7821;7822,0,0,0,0,2,2
10634,20,3033,7823;7826,0,0,0,1,1,2
10635,20,3034,7830,0,0,0,0,1,1
10636,20,3035,7831,0,0,0,0,1,1
10637,20,3036,7832,0,0,0,0,1,1
10638,20,3037,7835,0,0,0,0,1,1
10639,20,3038,7837,0,0,0,0,1,1
10640,20,3039,6785;7840,0,0,0,0,2,2
10641,20,3040,7845;7846,0,0,0,2,0,2
10642,20,3043,7852,0,0,0,1,0,1
10643,20,3045,7854;7856;9657;10167;10476;10909,0,0,2,4,0,6
10644,20,3046,963;7858;10354,0,0,0,3,0,3
10645,20,3047,7859,0,0,0,0,1,1
10646,20,3049,7865,0,0,0,0,1,1
10647,20,3050,5846;7866,0,0,0,0,2,2
10648,20,3051,7870,0,0,0,0,1,1
10649,20,3052,7875;9170;10066;10166;10787,0,0,1,4,0,5
10650,20,3053,6398;7876,0,0,0,2,0,2
10651,20,3054,7878;9271;10857,0,0,1,2,0,3
10652,20,3056,7880;7881,0,0,0,1,1,2
10653,20,3057,1983;7883,0,0,0,1,1,2
10654,20,3059,7885;7886,0,0,0,0,2,2
10655,20,3060,7887;7888;7890,0,0,0,3,0,3
10656,20,3061,7892;7894,0,0,0,2,0,2
10657,20,3062,7157;7896,0,0,0,2,0,2
10658,20,3063,7897;7898,0,0,0,1,1,2
10659,20,3065,7903;10255;10397,0,0,0,3,0,3
10660,20,3069,7910;7911;7914,0,0,0,2,1,3
10661,20,3070,2747;7915;10146;10700;10829;11191,0,0,3,3,0,6
10662,20,3071,7916;8626;10297;10596,0,0,1,3,0,4
10663,20,3072,3335;3382;4235;7920;7921;11365,0,0,1,5,0,6
10664,20,3073,7922,0,0,0,0,1,1
10665,20,3074,7924,0,0,0,0,1,1
10666,20,3075,7928;9238,0,0,0,2,0,2
10667,20,3076,7931;7932,0,0,0,0,2,2
10668,20,3077,7934,0,0,0,0,1,1
10669,20,3078,4188;7937;10600;11838,0,1,1,2,0,4
10670,20,3079,292;7938,0,0,0,0,2,2
10671,20,3080,3112;7940;7943,0,0,0,0,3,3
10672,20,3081,7945;7946;7947,0,0,0,2,1,3
10673,20,3082,7949,0,0,0,1,0,1
10674,20,3083,7950;7951,0,0,0,1,1,2
10675,20,3085,7953;7954,0,0,0,1,1,2
10676,20,3087,7956;7957,0,0,0,0,2,2
10677,20,3088,7958,0,0,0,0,1,1
10678,20,3089,7962;7963,0,0,0,0,2,2
10679,20,3091,7967;7968,0,0,0,0,2,2
10680,20,3092,7970;7971;7972,0,0,0,1,2,3
10681,20,3094,7976,0,0,0,0,1,1
10682,20,3095,7977,0,0,0,1,0,1
10683,20,3096,7980,0,0,0,0,1,1
10684,20,3098,5881;7985;10581;10659,0,0,2,2,0,4
10685,20,3100,2932;7987;10876;11090,0,0,2,2,0,4
10686,20,3101,7159;7991;10590,0,0,1,2,0,3
10687,20,3102,7996;7997;10471;10646;10830;11054;11165,0,0,5,2,0,7
10688,20,3104,8001;8002,0,0,0,2,0,2
10689,20,3106,8004;8006,0,0,0,2,0,2
10690,20,3108,762;8009,0,0,0,0,2,2
10691,20,3109,7321;8011;11490,0,0,1,2,0,3
10692,20,3110,8012;8014,0,0,0,1,1,2
10693,20,3112,3792;8018;10159;10510;10754;11388;12090,0,1,3,3,0,7
10694,20,3113,8021;8025,0,0,0,1,1,2
10695,20,3114,8030;10212,0,0,0,1,1,2
10696,20,3115,8032,0,0,0,0,1,1
10697,20,3116,8036,0,0,0,0,1,1
10698,20,3119,8045,0,0,0,0,1,1
10699,20,3120,8048;8049;8051;8052,0,0,0,2,2,4
10700,20,3122,8055;8056;8057,0,0,0,3,0,3
10701,20,3123,7639;8058,0,0,0,0,2,2
10702,20,3124,8059,0,0,0,0,1,1
10703,20,3126,8064;8240,0,0,0,1,1,2
10704,20,3127,8066;8067,0,0,0,1,1,2
10705,20,3128,6231;8068,0,0,0,0,2,2
10706,20,3129,3854;8069,0,0,0,0,2,2
10707,20,3130,8073,0,0,0,0,1,1
10708,20,3133,8078,0,0,0,0,1,1
10709,20,3137,5548;8085;10611;11430,0,0,2,2,0,4
10710,20,3138,5996;8088,0,0,0,2,0,2
10711,20,3139,8090;8091,0,0,0,0,2,2
10712,20,3140,8849,0,0,0,1,0,1
10713,20,3141,6502;8094,0,0,0,0,2,2
10714,20,3142,8098;10801,0,0,1,1,0,2
10715,20,3143,8102,0,0,0,0,1,1
10716,20,3146,3616;8105,0,0,0,0,2,2
10717,20,3147,8107;8108;8111;10092;10294,0,0,0,4,1,5
10718,20,3148,8112;8113,0,0,0,1,1,2
10719,20,3149,8116,0,0,0,0,1,1
10720,20,3150,8118;9822,0,0,0,1,1,2
10721,20,3151,8129,0,0,0,1,0,1
10722,20,3152,8126;8127,0,0,0,0,2,2
10723,20,3154,8130;8131;10126;10764,0,0,1,2,1,4
10724,20,3155,1815;8134,0,0,0,0,2,2
10725,20,3156,8136;8137,0,0,0,0,2,2
10726,20,3157,8138,0,0,0,1,0,1
10727,20,3158,3189;8141;10551;10855,0,0,2,2,0,4
10728,20,3159,8142;8143;8145;10326;10656,0,0,1,3,1,5
10729,20,3160,5207;8147;10576;10708,0,0,2,2,0,4
10730,20,3161,7566;8152,0,0,0,2,0,2
10731,20,3162,4932;8153,0,0,0,0,2,2
10732,20,3163,7350;8156;11106,0,0,1,2,0,3
10733,20,3164,8157;8158,0,0,0,2,0,2
10734,20,3167,1658;8162;10370;10814,0,0,1,3,0,4
10735,20,3168,8165;8166;11032;11113,0,0,2,1,1,4
10736,20,3169,8170,0,0,0,0,1,1
10737,20,3170,8174;8175;8177,0,0,0,2,1,3
10738,20,3171,8178,0,0,0,0,1,1
10739,20,3172,8179,0,0,0,1,0,1
10740,20,3174,8185,0,0,0,0,1,1
10741,20,3176,8190,0,0,0,0,1,1
10742,20,3178,8193;8194,0,0,0,2,0,2
10743,20,3179,8195;8197;8198,0,0,0,1,2,3
10744,20,3180,1432;8199;8201,0,0,0,2,1,3
10745,20,3181,8651,0,0,0,1,0,1
10746,20,3182,8203;8437;10209;10391,0,0,0,4,0,4
10747,20,3183,8205,0,0,0,0,1,1
10748,20,3185,8208,0,0,0,0,1,1
10749,20,3186,8209;8210,0,0,0,0,2,2
10750,20,3188,7828;8212,0,0,0,0,2,2
10751,20,3189,6757;11161;11291,0,0,2,1,0,3
10752,20,3190,8216,0,0,0,0,1,1
10753,20,3191,1943;8219;8220;12063,0,1,0,2,1,4
10754,20,3192,8223,0,0,0,0,1,1
10755,20,3195,8231,0,0,0,1,0,1
10756,20,3197,3608;8234,0,0,0,0,2,2
10757,20,3198,6783;8236;8238;10914;11952,0,1,1,3,0,5
10758,20,3199,8184;8239;10286;10578;10750;11471,0,0,3,3,0,6
10759,20,3201,8241;8242;11088,0,0,1,1,1,3
10760,20,3202,884;8243;10011;10230;10647,0,0,1,4,0,5
10761,20,3204,8245;10026;10193;10231;10525;10916;11211,0,0,3,4,0,7
10762,20,3205,8247;9597;10171;10454,0,0,1,3,0,4
10763,20,3206,8250;8251,0,0,0,2,0,2
10764,20,3207,2634;8255;10138;10430;10996,0,0,2,3,0,5
10765,20,3208,8257,0,0,0,0,1,1
10766,20,3211,8261,0,0,0,0,1,1
10767,20,3212,8263;8264;10675;10727,0,0,2,1,1,4
10768,20,3214,8267;8271,0,0,0,2,0,2
10769,20,3216,8275;8278;9828,0,0,0,3,0,3
10770,20,3217,8279;8280,0,0,0,0,2,2
10771,20,3218,8281;8282,0,0,0,0,2,2
10772,20,3219,8286;8812,0,0,0,2,0,2
10773,20,3221,1848;8294,0,0,0,2,0,2
10774,20,3222,8296;8297,0,0,0,1,1,2
10775,20,3223,8298;9886,0,0,0,2,0,2
10776,20,3225,8301,0,0,0,0,1,1
10777,20,3227,1178;8305;10990,0,0,1,2,0,3
10778,20,3228,8309,0,0,0,0,1,1
10779,20,3230,8316,0,0,0,0,1,1
10780,20,3231,2682;8545,0,0,0,2,0,2
10781,20,3232,8321,0,0,0,1,0,1
10782,20,3233,5052;8326,0,0,0,1,1,2
10783,20,3234,5721;8328,0,0,0,2,0,2
10784,20,3235,8329;9260,0,0,0,0,2,2
10785,20,3236,8333;8334;10791;11138;11751,0,1,2,1,1,5
10786,20,3237,4370;8337,0,0,0,2,0,2
10787,20,3239,8342,0,0,0,0,1,1
10788,20,3242,8349,0,0,0,1,0,1
10789,20,3243,3295;8350;10438;11280;11300,0,0,3,2,0,5
10790,20,3244,8352;8353,0,0,0,1,1,2
10791,20,3245,8354;8355,0,0,0,0,2,2
10792,20,3246,466;2608;10567;10760,0,0,2,2,0,4
10793,20,3247,8357,0,0,0,1,0,1
10794,20,3248,8359;8360,0,0,0,0,2,2
10795,20,3249,8363;8364;8365,0,0,0,1,2,3
10796,20,3250,8366;8367;10678,0,0,1,2,0,3
10797,20,3251,8369;8370,0,0,0,1,1,2
10798,20,3252,280;8371,0,0,0,0,2,2
10799,20,3253,8373;8375,0,0,0,1,1,2
10800,20,3255,8379;8380,0,0,0,0,2,2
10801,20,3256,8381;8383,0,0,0,1,1,2
10802,20,3258,232;8387;8389;10398,0,0,0,4,0,4
10803,20,3259,8390;8391,0,0,0,0,2,2
10804,20,3260,8393,0,0,0,1,0,1
10805,20,3261,8395;8522;10800,0,0,1,2,0,3
10806,20,3262,4988,0,0,0,1,0,1
10807,20,3263,8400;8402,0,0,0,0,2,2
10808,20,3264,1357;8404;8408,0,0,0,3,0,3
10809,20,3265,8410,0,0,0,0,1,1
10810,20,3267,8413;8414,0,0,0,1,1,2
10811,20,3268,8415;8416;8417;8418,0,0,0,4,0,4
10812,20,3269,8419,0,0,0,0,1,1
10813,20,3270,8422,0,0,0,1,0,1
10814,20,3271,3543;8426;10133;10479,0,0,1,2,1,4
10815,20,3272,8428,0,0,0,0,1,1
10816,20,3276,8435;9461;10566,0,0,1,2,0,3
10817,20,3277,8438,0,0,0,0,1,1
10818,20,3278,8439,0,0,0,0,1,1
10819,20,3279,6648;8441,0,0,0,2,0,2
10820,20,3281,8447;8448,0,0,0,1,1,2
10821,20,3282,8450;10202;10327;10687,0,0,1,3,0,4
10822,20,3283,8451;8452,0,0,0,2,0,2
10823,20,3285,8459,0,0,0,0,1,1
10824,20,3286,8460;8461,0,0,0,0,2,2
10825,20,3287,8462;8463,0,0,0,2,0,2
10826,20,3288,8464;9431;11226;11446,0,0,2,2,0,4
10827,20,3289,8467;8468,0,0,0,0,2,2
10828,20,3290,8471;8472;8473;8474,0,0,0,2,2,4
10829,20,3291,8475,0,0,0,1,0,1
10830,20,3293,8482,0,0,0,0,1,1
10831,20,3294,8484,0,0,0,0,1,1
10832,20,3295,8485;8486,0,0,0,0,2,2
10833,20,3296,416,0,0,0,1,0,1
10834,20,3297,8495;8496;10181;10555,0,0,1,2,1,4
10835,20,3298,8500,0,0,0,0,1,1
10836,20,3301,4041;8506,0,0,0,2,0,2
10837,20,3303,8508;8509;10348,0,0,0,2,1,3
10838,20,3304,2429;8510;10017;10041;10280,0,0,0,5,0,5
10839,20,3305,5351;8513,0,0,0,2,0,2
10840,20,3306,8517,0,0,0,0,1,1
10841,20,3307,8521,0,0,0,0,1,1
10842,20,3310,8528,0,0,0,0,1,1
10843,20,3311,8529,0,0,0,0,1,1
10844,20,3312,2312,0,0,0,0,1,1
10845,20,3313,8532,0,0,0,0,1,1
10846,20,3314,8533;8535,0,0,0,0,2,2
10847,20,3315,8537,0,0,0,1,0,1
10848,20,3316,8159;8542;10848,0,0,1,2,0,3
10849,20,3317,8548,0,0,0,0,1,1
10850,20,3318,8550;8551,0,0,0,1,1,2
10851,20,3319,7453;8554;10025;10252;10667,0,0,1,4,0,5
10852,20,3320,8557;8911,0,0,0,2,0,2
10853,20,3322,8563;10097;10288;10437,0,0,1,3,0,4
10854,20,3323,8427;8564;8566,0,0,0,3,0,3
10855,20,3324,7642;8569,0,0,0,2,0,2
10856,20,3325,7982;8570,0,0,0,0,2,2
10857,20,3326,8571,0,0,0,0,1,1
10858,20,3328,8575,0,0,0,0,1,1
10859,20,3330,8579,0,0,0,0,1,1
10860,20,3332,8582;8583,0,0,0,2,0,2
10861,20,3334,8586,0,0,0,0,1,1
10862,20,3335,8588,0,0,0,1,0,1
10863,20,3336,4531;8593,0,0,0,2,0,2
10864,20,3338,8599;8600,0,0,0,2,0,2
10865,20,3339,8601;8603,0,0,0,0,2,2
10866,20,3340,5462;8605,0,0,0,0,2,2
10867,20,3341,8606;8607,0,0,0,1,1,2
10868,20,3342,8084;8608,0,0,0,0,2,2
10869,20,3343,5070;8611;11050;11437,0,0,2,2,0,4
10870,20,3345,8614;8615;8618,0,0,0,1,2,3
10871,20,3346,4809;8621;8622,0,0,0,2,1,3
10872,20,3348,8630;8631,0,0,0,1,1,2
10873,20,3349,8632;8634,0,0,0,0,2,2
10874,20,3350,8635,0,0,0,1,0,1
10875,20,3351,8636;8637,0,0,0,1,1,2
10876,20,3352,8640,0,0,0,0,1,1
10877,20,3353,8645,0,0,0,1,0,1
10878,20,3354,8647;8648,0,0,0,1,1,2
10879,20,3356,8653,0,0,0,1,0,1
10880,20,3357,8655;8656,0,0,0,0,2,2
10881,20,3358,5276;8658,0,0,0,2,0,2
10882,20,3360,7908;8660,0,0,0,1,1,2
10883,20,3361,8663;8665,0,0,0,0,2,2
10884,20,3362,8666,0,0,0,0,1,1
10885,20,3363,8667,0,0,0,0,1,1
10886,20,3364,8669,0,0,0,0,1,1
10887,20,3365,8670;8671,0,0,0,0,2,2
10888,20,3366,8673,0,0,0,0,1,1
10889,20,3367,8678;8681,0,0,0,1,1,2
10890,20,3368,8682,0,0,0,0,1,1
10891,20,3369,372;8684,0,0,0,2,0,2
10892,20,3370,8686,0,0,0,1,0,1
10893,20,3372,8690,0,0,0,0,1,1
10894,20,3373,8694,0,0,0,1,0,1
10895,20,3374,8695;8696;8697,0,0,0,2,1,3
10896,20,3375,8699,0,0,0,0,1,1
10897,20,3376,8702;8708,0,0,0,2,0,2
10898,20,3379,5920;8706;10104;10160;10162,0,0,0,5,0,5
10899,20,3382,8713,0,0,0,0,1,1
10900,20,3383,8721,0,0,0,1,0,1
10901,20,3384,8722;8723;10074;10199;10237;10441;10524,0,0,2,5,0,7
10902,20,3386,8726,0,0,0,0,1,1
10903,20,3387,8727;8728;11418,0,0,1,1,1,3
10904,20,3390,8733,0,0,0,0,1,1
10905,20,3391,8734,0,0,0,0,1,1
10906,20,3392,8736;8737,0,0,0,0,2,2
10907,20,3393,8738,0,0,0,0,1,1
10908,20,3394,442,0,0,0,1,0,1
10909,20,3395,8744;8745,0,0,0,1,1,2
10910,20,3396,8748,0,0,0,1,0,1
10911,20,3397,8752,0,0,0,1,0,1
10912,20,3398,8755;8757;11741,0,1,0,2,0,3
10913,20,3400,8761;8762,0,0,0,2,0,2
10914,20,3402,8765,0,0,0,0,1,1
10915,20,3403,8769,0,0,0,0,1,1
10916,20,3404,8773;8774;10054;10994,0,0,1,3,0,4
10917,20,3405,8775,0,0,0,0,1,1
10918,20,3406,7657;8779;11385;11511;11971,0,1,2,2,0,5
10919,20,3407,8782;8783;8784,0,0,0,2,1,3
10920,20,3410,8789,0,0,0,0,1,1
10921,20,3411,8790;8791,0,0,0,1,1,2
10922,20,3415,8802,0,0,0,1,0,1
10923,20,3416,8804;10699;11247;11569,0,0,3,1,0,4
10924,20,3418,8811;8813,0,0,0,0,2,2
10925,20,3420,8817;8820,0,0,0,0,2,2
10926,20,3421,8458;8825,0,0,0,0,2,2
10927,20,3422,8828;8831,0,0,0,2,0,2
10928,20,3423,8164;8832,0,0,0,2,0,2
10929,20,3425,8835;8837;8839,0,0,0,1,2,3
10930,20,3426,8841;8842,0,0,0,2,0,2
10931,20,3427,6799;8844;10276;12036,0,1,0,3,0,4
10932,20,3429,8847,0,0,0,0,1,1
10933,20,3431,8852;8854,0,0,0,1,1,2
10934,20,3435,8862,0,0,0,1,0,1
10935,20,3436,2310;8863,0,0,0,2,0,2
10936,20,3438,8868;8869,0,0,0,1,1,2
10937,20,3440,8873,0,0,0,0,1,1
10938,20,3442,2388;2389;8875;8878,0,0,0,4,0,4
10939,20,3443,8879,0,0,0,1,0,1
10940,20,3444,8881,0,0,0,0,1,1
10941,20,3446,8883;8884,0,0,0,1,1,2
10942,20,3447,122,0,0,0,0,1,1
10943,20,3448,8891;8892,0,0,0,1,1,2
10944,20,3449,8718;8895;10858;11003,0,0,2,2,0,4
10945,20,3450,8896;8897,0,0,0,0,2,2
10946,20,3451,8901,0,0,0,0,1,1
10947,20,3452,5213;8906,0,0,0,0,2,2
10948,20,3453,8907,0,0,0,0,1,1
10949,20,3456,8914;8915,0,0,0,1,1,2
10950,20,3457,8916;8917,0,0,0,0,2,2
10951,20,3458,8919,0,0,0,0,1,1
10952,20,3459,8920;8921,0,0,0,2,0,2
10953,20,3460,8923,0,0,0,0,1,1
10954,20,3461,8926;8927,0,0,0,1,1,2
10955,20,3462,8930,0,0,0,0,1,1
10956,20,3463,8935,0,0,0,0,1,1
10957,20,3464,7124;7571,0,0,0,2,0,2
10958,20,3467,8941;8942;10168;10396,0,0,0,4,0,4
10959,20,3468,8943,0,0,0,0,1,1
10960,20,3469,8947;8949,0,0,0,1,1,2
10961,20,3470,3635;8952,0,0,0,2,0,2
10962,20,3471,8956,0,0,0,0,1,1
10963,20,3473,8961,0,0,0,0,1,1
10964,20,3474,8962;8963,0,0,0,0,2,2
10965,20,3475,8964;8965,0,0,0,1,1,2
10966,20,3476,8968;8969;10223;10261;10696,0,0,1,4,0,5
10967,20,3477,8970,0,0,0,0,1,1
10968,20,3478,8972;8973,0,0,0,0,2,2
10969,20,3479,8978,0,0,0,1,0,1
10970,20,3482,2570;8982,0,0,0,0,2,2
10971,20,3483,8988;8989,0,0,0,1,1,2
10972,20,3484,8990,0,0,0,0,1,1
10973,20,3486,3039;8993,0,0,0,1,1,2
10974,20,3487,8994;8995,0,0,0,0,2,2
10975,20,3488,4131;9000;10076;11389,0,0,1,3,0,4
10976,20,3490,5581;9005,0,0,0,0,2,2
10977,20,3491,9010;9011,0,0,0,0,2,2
10978,20,3492,9012,0,0,0,0,1,1
10979,20,3493,9014,0,0,0,1,0,1
10980,20,3494,1589;9018,0,0,0,0,2,2
10981,20,3495,9019;9020,0,0,0,2,0,2
10982,20,3496,9022;9023,0,0,0,1,1,2
10983,20,3497,9025,0,0,0,0,1,1
10984,20,3498,9026;9784;10650;10955,0,0,2,2,0,4
10985,20,3499,9027;9028,0,0,0,1,1,2
10986,20,3501,9030;9032,0,0,0,2,0,2
10987,20,3502,9529,0,0,0,1,0,1
10988,20,3504,6871;9038;9043,0,0,0,1,2,3
10989,20,3505,588;9044,0,0,0,0,2,2
10990,20,3507,9050,0,0,0,1,0,1
10991,20,3508,9051,0,0,0,0,1,1
10992,20,3509,9052;9053,0,0,0,0,2,2
10993,20,3510,9055,0,0,0,1,0,1
10994,20,3512,310;9060,0,0,0,2,0,2
10995,20,3513,9061,0,0,0,0,1,1
10996,20,3515,9065,0,0,0,1,0,1
10997,20,3516,8076;9067,0,0,0,2,0,2
10998,20,3517,324;9070;10432,0,0,1,2,0,3
10999,20,3518,9071;9073,0,0,0,0,2,2
11000,20,3519,9075;9076;10458,0,0,1,1,1,3
11001,20,3520,9079;9081,0,0,0,0,2,2
11002,20,3522,9085,0,0,0,0,1,1
11003,20,3523,1865;8979,0,0,0,2,0,2
11004,20,3524,3655;9089;10015,0,0,0,3,0,3
11005,20,3525,9091;9092,0,0,0,0,2,2
11006,20,3526,9093;9094,0,0,0,1,1,2
11007,20,3527,2893;9095;9096;9098,0,0,0,2,2,4
11008,20,3528,9100,0,0,0,0,1,1
11009,20,3529,9107,0,0,0,1,0,1
11010,20,3532,4380,0,0,0,1,0,1
11011,20,3533,9120;9121,0,0,0,1,1,2
11012,20,3534,9122,0,0,0,1,0,1
11013,20,3535,9124,0,0,0,0,1,1
11014,20,3536,9128;9129,0,0,0,2,0,2
11015,20,3537,9130;9131;10495;10513,0,0,2,1,1,4
11016,20,3540,9140;9141,0,0,0,1,1,2
11017,20,3543,2132;9146,0,0,0,0,2,2
11018,20,3545,9149;9150,0,0,0,1,1,2
11019,20,3546,4797;9152;11044;11231,0,0,2,2,0,4
11020,20,3549,9158,0,0,0,0,1,1
11021,20,3550,9167,0,0,0,1,0,1
11022,20,3555,9176;9177,0,0,0,1,1,2
11023,20,3556,9179,0,0,0,0,1,1
11024,20,3557,8597;9180,0,0,0,0,2,2
11025,20,3558,9182,0,0,0,0,1,1
11026,20,3559,9183;9184;11210;11634;11886,0,2,1,2,0,5
11027,20,3560,9185;9186;10077;10522,0,0,1,2,1,4
11028,20,3563,9193;9864,0,0,0,1,1,2
11029,20,3565,9198;9199,0,0,0,1,1,2
11030,20,3566,9200;9201,0,0,0,1,1,2
11031,20,3568,9204;9205,0,0,0,1,1,2
11032,20,3569,9206;9209,0,0,0,1,1,2
11033,20,3570,8724;9212;10125,0,0,0,3,0,3
11034,20,3572,1827;9218,0,0,0,2,0,2
11035,20,3574,7498;9229;9231,0,0,0,1,2,3
11036,20,3576,9236;9237,0,0,0,1,1,2
11037,20,3577,9239;9240,0,0,0,0,2,2
11038,20,3579,4582,0,0,0,1,0,1
11039,20,3580,9247,0,0,0,1,0,1
11040,20,3581,5875;9248,0,0,0,2,0,2
11041,20,3582,9249;9250,0,0,0,2,0,2
11042,20,3584,9253,0,0,0,0,1,1
11043,20,3586,9258,0,0,0,0,1,1
11044,20,3587,9261;9262,0,0,0,2,0,2
11045,20,3588,6572;9264;9267,0,0,0,1,2,3
11046,20,3589,8093;9268,0,0,0,2,0,2
11047,20,3592,2917;9274;10701;10936,0,0,2,2,0,4
11048,20,3593,9276,0,0,0,1,0,1
11049,20,3594,1351;6102;9281;11530,0,0,1,3,0,4
11050,20,3595,2478;9761,0,0,0,2,0,2
11051,20,3596,9283;9284,0,0,0,1,1,2
11052,20,3597,9286;9658,0,0,0,2,0,2
11053,20,3603,9294;9295;10293;10464;11179,0,0,2,3,0,5
11054,20,3604,9296,0,0,0,0,1,1
11055,20,3605,9301;10634,0,0,1,1,0,2
11056,20,3606,9302;9304,0,0,0,1,1,2
11057,20,3608,9306;9307,0,0,0,0,2,2
11058,20,3609,9308,0,0,0,0,1,1
11059,20,3610,9310,0,0,0,0,1,1
11060,20,3611,9312;9313,0,0,0,2,0,2
11061,20,3612,3533;9315;9316;9317;10264;10895,0,0,1,5,0,6
11062,20,3613,9319;11045;11717,0,1,1,1,0,3
11063,20,3614,9320,0,0,0,0,1,1
11064,20,3618,9327,0,0,0,0,1,1
11065,20,3619,9335,0,0,0,0,1,1
11066,20,3620,9337;9338,0,0,0,0,2,2
11067,20,3621,9341;9342,0,0,0,1,1,2
11068,20,3623,8938;9345,0,0,0,2,0,2
11069,20,3624,9346;9348,0,0,0,1,1,2
11070,20,3625,1615;9349;10619;10726,0,0,2,2,0,4
11071,20,3628,9360;9361,0,0,0,1,1,2
11072,20,3629,4789;9363;9364;9365,0,0,0,3,1,4
11073,20,3630,9366;9367,0,0,0,1,1,2
11074,20,3631,9372;9373;10102,0,0,0,3,0,3
11075,20,3632,9374;9375,0,0,0,1,1,2
11076,20,3633,9377,0,0,0,0,1,1
11077,20,3634,5684;9378,0,0,0,2,0,2
11078,20,3636,9381;9382,0,0,0,1,1,2
11079,20,3637,9383;9384,0,0,0,1,1,2
11080,20,3639,4032;4034;9386;9389;10248;10873,0,0,1,5,0,6
11081,20,3640,9391;9393,0,0,0,2,0,2
11082,20,3641,695;9395,0,0,0,2,0,2
11083,20,3643,9399;10443,0,0,1,1,0,2
11084,20,3644,9403,0,0,0,0,1,1
11085,20,3645,9404;9405,0,0,0,1,1,2
11086,20,3646,9407;9408,0,0,0,2,0,2
11087,20,3647,9409,0,0,0,1,0,1
11088,20,3648,9413;9414,0,0,0,2,0,2
11089,20,3649,9416;9420,0,0,0,2,0,2
11090,20,3650,9421;9422,0,0,0,1,1,2
11091,20,3651,9426;9427;10412;10537;10777,0,0,2,2,1,5
11092,20,3653,9433,0,0,0,0,1,1
11093,20,3655,9438,0,0,0,0,1,1
11094,20,3658,9442,0,0,0,0,1,1
11095,20,3659,9444;9445,0,0,0,1,1,2
11096,20,3661,9451,0,0,0,0,1,1
11097,20,3662,9452;9453,0,0,0,2,0,2
11098,20,3663,9456,0,0,0,0,1,1
11099,20,3664,9458,0,0,0,0,1,1
11100,20,3665,9462,0,0,0,1,0,1
11101,20,3666,9464;9470,0,0,0,2,0,2
11102,20,3667,9465;9466,0,0,0,2,0,2
11103,20,3669,9473,0,0,0,0,1,1
11104,20,3670,9474,0,0,0,0,1,1
11105,20,3671,9475;9476,0,0,0,0,2,2
11106,20,3673,3643;9479,0,0,0,2,0,2
11107,20,3674,9481;9483,0,0,0,1,1,2
11108,20,3675,9486,0,0,0,0,1,1
11109,20,3676,9492,0,0,0,0,1,1
11110,20,3677,9493;9494,0,0,0,0,2,2
11111,20,3680,9498,0,0,0,1,0,1
11112,20,3681,9502,0,0,0,0,1,1
11113,20,3682,9503,0,0,0,0,1,1
11114,20,3683,9504;9506,0,0,0,1,1,2
11115,20,3684,9507;9508;11370;11896,0,1,1,2,0,4
11116,20,3685,9509,0,0,0,1,0,1
11117,20,3686,7435;9512;9513;9514,0,0,0,4,0,4
11118,20,3687,5703;9517;11934,0,1,0,2,0,3
11119,20,3688,9521;9522;10292;10411;11883;12032,0,2,0,4,0,6
11120,20,3689,9523,0,0,0,0,1,1
11121,20,3690,9524;9525,0,0,0,1,1,2
11122,20,3691,9530,0,0,0,0,1,1
11123,20,3693,2022;9535,0,0,0,2,0,2
11124,20,3694,9537,0,0,0,0,1,1
11125,20,3695,1391;9539,0,0,0,0,2,2
11126,20,3696,4346;9542,0,0,0,0,2,2
11127,20,3698,9546;9547,0,0,0,1,1,2
11128,20,3699,9548;9549;10128;10532,0,0,1,2,1,4
11129,20,3701,9552,0,0,0,1,0,1
11130,20,3702,9554,0,0,0,1,0,1
11131,20,3703,9555,0,0,0,0,1,1
11132,20,3704,6766;9560,0,0,0,2,0,2
11133,20,3705,9565;9566,0,0,0,0,2,2
11134,20,3706,9568,0,0,0,1,0,1
11135,20,3707,9569,0,0,0,0,1,1
11136,20,3708,9574,0,0,0,1,0,1
11137,20,3710,9579;9580,0,0,0,1,1,2
11138,20,3712,9583;9584,0,0,0,1,1,2
11139,20,3713,9587;11221;12001,0,1,1,1,0,3
11140,20,3714,9591,0,0,0,0,1,1
11141,20,3715,9594,0,0,0,1,0,1
11142,20,3716,5633;7441;10758;10896,0,0,2,2,0,4
11143,20,3717,9599,0,0,0,0,1,1
11144,20,3718,9601;9602,0,0,0,0,2,2
11145,20,3719,7523;9604;10871;11222,0,0,2,2,0,4
11146,20,3720,9609,0,0,0,0,1,1
11147,20,3721,9611,0,0,0,0,1,1
11148,20,3723,9614;9615;10038,0,0,0,3,0,3
11149,20,3724,9618,0,0,0,1,0,1
11150,20,3725,625;9619,0,0,0,2,0,2
11151,20,3726,8446;9620;10563;10904;10948;11558,0,0,4,2,0,6
11152,20,3727,9624,0,0,0,0,1,1
11153,20,3730,9631;9632,0,0,0,1,1,2
11154,20,3731,9633;9634;10516,0,0,1,1,1,3
11155,20,3732,9635;9636;10176;10200;10456;10545,0,0,2,4,0,6
11156,20,3734,9640;9641;9643,0,0,0,2,1,3
11157,20,3736,279;10799;10983,0,0,2,1,0,3
11158,20,3737,9570;9646,0,0,0,1,1,2
11159,20,3738,9650,0,0,0,0,1,1
11160,20,3739,9652;9653,0,0,0,1,1,2
11161,20,3740,9656,0,0,0,0,1,1
11162,20,3742,5298;9659,0,0,0,2,0,2
11163,20,3743,9660;9662,0,0,0,0,2,2
11164,20,3744,1420;9663;9665,0,0,0,3,0,3
11165,20,3747,9670;9671,0,0,0,1,1,2
11166,20,3748,9673,0,0,0,0,1,1
11167,20,3749,9675;9676;9677,0,0,0,3,0,3
11168,20,3750,9679;9681,0,0,0,1,1,2
11169,20,3751,9683,0,0,0,0,1,1
11170,20,3752,9685;9686,0,0,0,1,1,2
11171,20,3753,9691,0,0,0,0,1,1
11172,20,3754,9695,0,0,0,0,1,1
11173,20,3755,9697;9698,0,0,0,1,1,2
11174,20,3756,592;9701,0,0,0,2,0,2
11175,20,3757,9704,0,0,0,1,0,1
11176,20,3758,9705,0,0,0,1,0,1
11177,20,3759,9707,0,0,0,0,1,1
11178,20,3760,9711;9712,0,0,0,1,1,2
11179,20,3761,763;9713,0,0,0,2,0,2
11180,20,3763,9719,0,0,0,0,1,1
11181,20,3765,9724;9725;9726;9728;9729,0,0,0,4,1,5
11182,20,3767,9731,0,0,0,0,1,1
11183,20,3769,9733;9734;9735;9736,0,0,0,2,2,4
11184,20,3770,9738;9741,0,0,0,2,0,2
11185,20,3771,2068;9742;11573;12038,0,1,1,2,0,4
11186,20,3772,9744,0,0,0,0,1,1
11187,20,3774,5040;9749;9750;9751;9809;11301;11552,0,0,2,5,0,7
11188,20,3775,9752,0,0,0,0,1,1
11189,20,3776,9754;9755,0,0,0,2,0,2
11190,20,3778,9759,0,0,0,0,1,1
11191,20,3780,9766,0,0,0,1,0,1
11192,20,3781,7005;9771,0,0,0,2,0,2
11193,20,3782,7170;9772,0,0,0,2,0,2
11194,20,3783,9774;9775,0,0,0,0,2,2
11195,20,3784,1605;9778;10165;11029;11123,0,0,2,3,0,5
11196,20,3785,9780;9781,0,0,0,1,1,2
11197,20,3786,9785;9788,0,0,0,2,0,2
11198,20,3787,9789;9791;10185,0,0,0,3,0,3
11199,20,3788,9794,0,0,0,1,0,1
11200,20,3790,9800,0,0,0,0,1,1
11201,20,3791,9801,0,0,0,0,1,1
11202,20,3792,1199;9803;10733;11092,0,0,2,2,0,4
11203,20,3793,9805;9807,0,0,0,0,2,2
11204,20,3797,9815;10512;10642,0,0,2,1,0,3
11205,20,3800,9823;9824;9826,0,0,0,1,2,3
11206,20,3801,9832;9834,0,0,0,0,2,2
11207,20,3803,5108,0,0,0,0,1,1
11208,20,3804,9841,0,0,0,0,1,1
11209,20,3805,9845,0,0,0,0,1,1
11210,20,3809,908;4044,0,0,0,2,0,2
11211,20,3810,9855;9856,0,0,0,1,1,2
11212,20,3812,5357;9859,0,0,0,2,0,2
11213,20,3813,799;9863,0,0,0,2,0,2
11214,20,3817,9870;11019,0,0,1,1,0,2
11215,20,3818,9873,0,0,0,0,1,1
11216,20,3819,9875,0,0,0,0,1,1
11217,20,3820,9876;9877,0,0,0,1,1,2
11218,20,3821,9880;9881,0,0,0,0,2,2
11219,20,3822,7111;9888,0,0,0,1,1,2
11220,20,3823,9890;9891,0,0,0,1,1,2
11221,20,3824,9893,0,0,0,1,0,1
11222,20,3825,9897,0,0,0,1,0,1
11223,20,3827,552;9900;10756;11108,0,0,2,2,0,4
11224,20,3828,2280;9902,0,0,0,1,1,2
11225,20,3829,9903;9904,0,0,0,1,1,2
11226,20,3830,9905;9906,0,0,0,0,2,2
11227,20,3831,1666;9907,0,0,0,2,0,2
11228,20,3832,9908;9912,0,0,0,1,1,2
11229,20,3833,9915;10793;10930;11119;11615,0,1,3,1,0,5
11230,20,3835,9917;9918,0,0,0,1,1,2
11231,20,3836,9921,0,0,0,0,1,1
11232,20,3837,9924;9927,0,0,0,1,1,2
11233,20,3838,9928,0,0,0,0,1,1
11234,20,3839,5026;9931;10330;10670,0,0,1,3,0,4
11235,20,3841,1878;9934;10314;10739,0,0,1,3,0,4
11236,20,3844,9943;9945,0,0,0,1,1,2
11237,20,3845,9949,0,0,0,1,0,1
11238,20,3847,7578;9953,0,0,0,0,2,2
11239,20,3849,9956;9957,0,0,0,2,0,2
11240,20,3851,9959,0,0,0,0,1,1
11241,20,3852,9960;9961,0,0,0,0,2,2
11242,20,3853,9964,0,0,0,1,0,1
11243,20,3854,9966,0,0,0,0,1,1
11244,20,3855,9968;9971,0,0,0,0,2,2
11245,20,3856,9972;9973,0,0,0,1,1,2
11246,20,3858,9979;9980,0,0,0,0,2,2
11247,20,3859,9981;9982,0,0,0,0,2,2
11248,20,3860,9983;9986;9987;10336,0,0,0,4,0,4
11249,20,3861,8834;9988;10409;10574;10789,0,0,2,3,0,5
11250,20,3862,9989;9991;10685,0,0,1,1,1,3
11251,20,3863,9992;9993,0,0,0,0,2,2
11252,20,3864,6561;9994,0,0,0,1,1,2
11253,20,3865,10000;10002,0,0,0,2,0,2
11254,20,3867,106,0,0,0,0,1,1
11255,20,3868,143;2324,0,0,0,0,2,2
11256,20,3869,368;2017;10198;10713;10947,0,0,2,3,0,5
11257,20,3870,434;3065,0,0,0,1,1,2
11258,20,3871,570;6059,0,0,0,2,0,2
11259,20,3872,586,0,0,0,1,0,1
11260,20,3877,3214,0,0,0,1,0,1
11261,20,3878,828;2133,0,0,0,2,0,2
11262,20,3882,1272;3435,0,0,0,0,2,2
11263,20,3884,1783;10504,0,0,1,1,0,2
11264,20,3887,9047,0,0,0,1,0,1
11265,20,3888,2126;4971,0,0,0,2,0,2
11266,20,3889,2130;10310;10591,0,0,1,2,0,3
11267,20,3890,2037;2223,0,0,0,0,2,2
11268,20,3892,1924;2443;10665;11004,0,0,2,2,0,4
11269,20,3893,2526,0,0,0,0,1,1
11270,20,3895,2688;5600;10263;10693;11244;11583,0,0,3,3,0,6
11271,20,3896,2762;8312,0,0,0,2,0,2
11272,20,3900,1736;2942,0,0,0,2,0,2
11273,20,3901,3009;3325,0,0,0,0,2,2
11274,20,3902,2716;9127,0,0,0,2,0,2
11275,20,3903,550;3613,0,0,0,2,0,2
11276,20,3904,2038,0,0,0,1,0,1
11277,20,3906,259,0,0,0,1,0,1
11278,20,3907,4000;7516;11093;11350,0,0,2,2,0,4
11279,20,3910,528;4243,0,0,0,2,0,2
11280,20,3911,4549;4568,0,0,0,0,2,2
11281,20,3912,22;7226;10631,0,0,1,2,0,3
11282,20,3914,3302;4794,0,0,0,0,2,2
11283,20,3915,5109;7517,0,0,0,2,0,2
11284,20,3916,5112,0,0,0,0,1,1
11285,20,3918,5235;5972;10535,0,0,1,2,0,3
11286,20,3920,5385;9126,0,0,0,0,2,2
11287,20,3922,1850;10478,0,0,1,1,0,2
11288,20,3923,5700;6778,0,0,0,2,0,2
11289,20,3924,5754;7107,0,0,0,0,2,2
11290,20,3925,1922;5769;10152;10622;11487;11854,0,1,2,3,0,6
11291,20,3927,3133,0,0,0,1,0,1
11292,20,3928,5771;6143;10311;10364;10662;10913,0,0,2,4,0,6
11293,20,3929,6147;7485;11059;11810,0,1,1,2,0,4
11294,20,3930,3750;11018;11555,0,0,2,1,0,3
11295,20,3932,7011;9303,0,0,0,2,0,2
11296,20,3935,7253;9154;10268,0,0,0,3,0,3
11297,20,3936,7407,0,0,0,0,1,1
11298,20,3937,4885;7904,0,0,0,2,0,2
11299,20,3938,6703;8035,0,0,0,1,1,2
11300,20,3939,8096,0,0,0,0,1,1
11301,20,3941,8213,0,0,0,0,1,1
11302,20,3943,6985;8378;11070;11393;11722,0,1,2,2,0,5
11303,20,3945,8518,0,0,0,0,1,1
11304,20,3947,5801;8851,0,0,0,2,0,2
11305,20,3948,8890;10571,0,0,1,1,0,2
11306,20,3949,8983,0,0,0,0,1,1
11307,20,3950,8999,0,0,0,1,0,1
11308,20,3951,9039,0,0,0,0,1,1
11309,20,3953,9328;11270,0,0,1,1,0,2
11310,20,3954,3629;9347;10134;10385;10784,0,0,1,4,0,5
11311,20,3955,9540,0,0,0,0,1,1
11312,20,3956,2282;9811,0,0,0,2,0,2
11313,20,3958,5653;8753;10353;10486;10884,0,0,2,3,0,5
11314,20,3959,4667;7129;10296;10625,0,0,1,3,0,4
11315,20,3960,111;3338;10143;10850;11345;11545,365,0,3,3,0,6
11316,20,3961,331,365,0,0,0,1,1
11317,20,3963,534;3561;7812;10769;11267,365,0,2,3,0,5
11318,20,3966,1075,365,0,0,1,0,1
11319,20,3968,787;10794;10989;11421,365,0,3,1,0,4
11320,20,3969,875,365,0,0,0,1,1
11321,20,3970,1014;8026;11027,365,0,1,2,0,3
11322,20,3971,1054;8368;10564;10897,365,0,2,2,0,4
11323,20,3972,2131;8433,365,0,0,2,0,2
11324,20,3973,1346;1913,365,0,0,2,0,2
11325,20,3976,738;4524;10925;11457,365,0,2,2,0,4
11326,20,3977,1590;2953,365,0,0,2,0,2
11327,20,3978,1689;2219,365,0,0,2,0,2
11328,20,3979,1699;7926;10339,365,0,0,3,0,3
11329,20,3980,1317;1745;11586;11783,365,1,1,2,0,4
11330,20,3982,4927;9021;11737,365,1,0,2,0,3
11331,20,3983,1976;2217,365,0,0,2,0,2
11332,20,3985,2308,365,0,0,1,0,1
11333,20,3986,224;2407,365,0,0,2,0,2
11334,20,3987,2451;9480;10609;10825;11049;11390,365,0,4,2,0,6
11335,20,3988,2468;8807;11750;12014,365,2,0,2,0,4
11336,20,3989,1611;2490,365,0,0,2,0,2
11337,20,3990,2612;6130,365,0,0,2,0,2
11338,20,3991,1023;2622;10511,365,0,1,2,0,3
11339,20,3992,575;3113,365,0,0,0,2,2
11340,20,3994,3586;8384;10169;10461;10547;10828,365,0,3,3,0,6
11341,20,3997,556,365,0,0,0,1,1
11342,20,3998,3936,365,0,0,0,1,1
11343,20,4000,4231;7768;10222,365,0,0,3,0,3
11344,20,4002,1318;3468;10316;10514;10832,365,0,2,3,0,5
11345,20,4005,2141;5085;11364;11693,365,1,1,2,0,4
11346,20,4007,5124,365,0,0,0,1,1
11347,20,4008,5132;9871,365,0,0,2,0,2
11348,20,4009,5208;8455,365,0,0,2,0,2
11349,20,4010,5428,365,0,0,0,1,1
11350,20,4013,1950;5587,365,0,0,2,0,2
11351,20,4014,5691;9642;11960,365,1,0,2,0,3
11352,20,4015,5757;6067;11022,365,0,1,2,0,3
11353,20,4016,860;5762,365,0,0,0,2,2
11354,20,4017,6077;9716,365,0,0,2,0,2
11355,20,4018,6103,365,0,0,0,1,1
11356,20,4020,6022;6281;10240;10553;11382;12010,365,1,2,3,0,6
11357,20,4021,2771,365,0,0,0,1,1
11358,20,4023,1896;1899,365,0,0,2,0,2
11359,20,4025,6533,365,0,0,0,1,1
11360,20,4026,3107;11307;11690,365,1,1,1,0,3
11361,20,4027,299;5671;10226;10483,365,0,1,3,0,4
11362,20,4029,5210;6863;11675;12104,365,2,0,2,0,4
11363,20,4030,5360;6977,365,0,0,0,2,2
11364,20,4031,69;7058;10785;10982;11706,365,1,2,2,0,5
11365,20,4032,40;7071,365,0,0,2,0,2
11366,20,4033,1681;8114,365,0,0,2,0,2
11367,20,4035,940;7210,365,0,0,2,0,2
11368,20,4037,7547;7751,365,0,0,1,1,2
11369,20,4038,7007;7652,365,0,0,1,1,2
11370,20,4039,7658;9939;10291,365,0,0,3,0,3
11371,20,4040,2930;8249;11915,365,1,0,2,0,3
11372,20,4041,6769;7871;10910;11238,365,0,2,2,0,4
11373,20,4042,5370;8089,365,0,0,2,0,2
11374,20,4044,8304;8860,365,0,0,2,0,2
11375,20,4046,8160;8405,365,0,0,1,1,2
11376,20,4054,1556;9326;10382;11085,365,0,1,3,0,4
11377,20,4056,1617;9538,365,0,0,2,0,2
11378,20,4058,7378;9559,365,0,0,2,0,2
11379,20,4059,9647,365,0,0,1,0,1
11380,20,4060,6330;9975;10273;10709;11495,365,0,2,3,0,5
11381,20,4061,178;9790;11466;11576,365,0,2,2,0,4
11382,20,4062,590;9825,365,0,0,2,0,2
11383,20,4063,7849;10655;10824;11445,365,0,3,1,0,4
11384,20,4065,9948;11302,365,0,1,1,0,2
11385,20,4066,8756;10633;11071,730,0,2,1,0,3
11386,20,4067,45;5438;11684;11773,730,2,0,2,0,4
11387,20,4068,155,730,0,0,0,1,1
11388,20,4070,266,730,0,0,1,0,1
11389,20,4071,270,730,0,0,0,1,1
11390,20,4072,302;5123,730,0,0,2,0,2
11391,20,4073,478,730,0,0,0,1,1
11392,20,4074,542;2525;10554;10689,730,0,2,2,0,4
11393,20,4076,5525;10487;11124;11324;11624,730,1,3,1,0,5
11394,20,4077,578;705;10318,730,0,0,3,0,3
11395,20,4078,792;7539;10654;10915;11286,730,0,3,2,0,5
11396,20,4080,4985,730,0,0,0,1,1
11397,20,4082,973;8946,730,0,0,2,0,2
11398,20,4083,999;3322,730,0,0,0,2,2
11399,20,4084,1166;4197;10344;10710,730,0,1,3,0,4
11400,20,4085,1246;10922;11151,730,0,2,1,0,3
11401,20,4087,1523,730,0,0,0,1,1
11402,20,4088,1688;2253,730,0,0,0,2,2
11403,20,4089,1728;7752,730,0,0,1,1,2
11404,20,4090,3785;6917,730,0,0,2,0,2
11405,20,4091,5280;5804,730,0,0,2,0,2
11406,20,4093,1998,730,0,0,0,1,1
11407,20,4095,2208;8801;10304,730,0,0,3,0,3
11408,20,4098,2560,730,0,0,0,1,1
11409,20,4099,2663;5877,730,0,0,2,0,2
11410,20,4101,2743;9491,730,0,0,2,0,2
11411,20,4102,2825;9500;10332;10546;10968;11346,730,0,3,3,0,6
11412,20,4104,1209;2879;10651;10905;11061,730,0,3,2,0,5
11413,20,4105,3143,730,0,0,1,0,1
11414,20,4108,593;3354,730,0,0,2,0,2
11415,20,4109,4399;10450;10723;10926;11342,730,0,4,1,0,5
11416,20,4110,6164;10715;10854,730,0,2,1,0,3
11417,20,4112,3549;8061,730,0,0,2,0,2
11418,20,4114,3690,730,0,0,1,0,1
11419,20,4115,3799,730,0,0,1,0,1
11420,20,4116,3868;10652;10747,730,0,2,1,0,3
11421,20,4117,702;3878,730,0,0,0,2,2
11422,20,4119,4115;4621,730,0,0,1,1,2
11423,20,4121,4384;5605;10843;11245,730,0,2,2,0,4
11424,20,4124,5546;10676;10826;11030;11410,730,0,4,1,0,5
11425,20,4125,2966;4539,730,0,0,1,1,2
11426,20,4128,7587;8925;10605;10729,730,0,2,2,0,4
11427,20,4129,4485;4761,730,0,0,2,0,2
11428,20,4133,4648;4923,730,0,0,2,0,2
11429,20,4137,5292,730,0,0,0,1,1
11430,20,4138,970;5305,730,0,0,2,0,2
11431,20,4140,1205;5362,730,0,0,2,0,2
11432,20,4141,5411;8871,730,0,0,1,1,2
11433,20,4142,5426,730,0,0,0,1,1
11434,20,4143,8434,730,0,0,1,0,1
11435,20,4145,3829;5640,730,0,0,2,0,2
11436,20,4146,5668,730,0,0,0,1,1
11437,20,4147,5795,730,0,0,1,0,1
11438,20,4148,2850;5894,730,0,0,1,1,2
11439,20,4149,5913;9428;11661,730,1,0,2,0,3
11440,20,4150,7236,730,0,0,1,0,1
11441,20,4151,1719;6078,730,0,0,2,0,2
11442,20,4152,6090,730,0,0,0,1,1
11443,20,4153,3700;7077;10379;10616;10889,730,0,2,3,0,5
11444,20,4154,3069;6454;11996,730,1,0,2,0,3
11445,20,4155,1741;7353;10368;11077,730,0,1,3,0,4
11446,20,4156,3291;10668;10978;11158,730,0,3,1,0,4
11447,20,4157,6907,730,0,0,0,1,1
11448,20,4158,8997;10772;11026;12112,730,1,2,1,0,4
11449,20,4159,7249;7283,730,0,0,1,1,2
11450,20,4160,329;7367;10550;10614;11130;11239,730,0,4,2,0,6
11451,20,4161,7449,730,0,0,0,1,1
11452,20,4162,5571;7722;11951,730,1,0,2,0,3
11453,20,4163,35;7857;10468,730,0,1,2,0,3
11454,20,4164,2403;7863,730,0,0,2,0,2
11455,20,4165,8023,730,0,0,0,1,1
11456,20,4166,6452;8132,730,0,0,2,0,2
11457,20,4167,9616,730,0,0,1,0,1
11458,20,4168,4600;8252;10363;10888;11131;11660,730,1,2,3,0,6
11459,20,4169,8374,730,0,0,1,0,1
11460,20,4170,8465,730,0,0,1,0,1
11461,20,4171,8555,730,0,0,0,1,1
11462,20,4173,5451;8595,730,0,0,2,0,2
11463,20,4174,3732;7850,730,0,0,0,2,2
11464,20,4175,8929,730,0,0,0,1,1
11465,20,4176,8730;8937,730,0,0,2,0,2
11466,20,4179,3351;11481,730,0,1,1,0,2
11467,20,4180,9113,730,0,0,1,0,1
11468,20,4181,1920,730,0,0,0,1,1
11469,20,4185,2107,730,0,0,0,1,1
11470,20,4186,9786,730,0,0,1,0,1
11471,20,4188,5212;9944,730,0,0,2,0,2
11472,20,4189,0;7425,1095,0,0,2,0,2
11473,20,4190,12;6735;11500,1095,0,1,2,0,3
11474,20,4192,176;8117,1095,0,0,1,1,2
11475,20,4193,233,1095,0,0,1,0,1
11476,20,4195,296;6278,1095,0,0,2,0,2
11477,20,4197,9145;11514;12107,1095,1,1,1,0,3
11478,20,4198,425;8992,1095,0,0,0,2,2
11479,20,4199,489;9351;10333;10742,1095,0,1,3,0,4
11480,20,4200,517;1250;11498,1095,0,1,2,0,3
11481,20,4201,628,1095,0,0,0,1,1
11482,20,4203,815;1187,1095,0,0,1,1,2
11483,20,4204,5604;5699;10366;10539;11547,1095,0,2,3,0,5
11484,20,4205,7567;9449;11145;12054,1095,1,1,2,0,4
11485,20,4206,1091,1095,0,0,0,1,1
11486,20,4207,1099;4046,1095,0,0,2,0,2
11487,20,4208,1138;1514,1095,0,0,0,2,2
11488,20,4209,1197;4207,1095,0,0,2,0,2
11489,20,4210,1225,1095,0,0,0,1,1
11490,20,4211,1259;7302,1095,0,0,1,1,2
11491,20,4214,1559,1095,0,0,0,1,1
11492,20,4215,6447,1095,0,0,1,0,1
11493,20,4218,1907;3971,1095,0,0,0,2,2
11494,20,4219,1009;1921,1095,0,0,2,0,2
11495,20,4220,2156;4500;10790;11137;11368;11697,1095,1,3,2,0,6
11496,20,4221,2171;2427,1095,0,0,2,0,2
11497,20,4222,844;2591,1095,0,0,2,0,2
11498,20,4223,2417;2655;10851;11977,1095,1,1,2,0,4
11499,20,4224,917;2757,1095,0,0,0,2,2
11500,20,4225,2788,1095,0,0,1,0,1
11501,20,4227,3044,1095,0,0,0,1,1
11502,20,4228,3165;4045;11173;11380,1095,0,2,2,0,4
11503,20,4229,3281;9097,1095,0,0,2,0,2
11504,20,4230,205;3377;10373,1095,0,0,3,0,3
11505,20,4233,2834;3540;11508,1095,0,1,2,0,3
11506,20,4234,3625;8771,1095,0,0,2,0,2
11507,20,4235,282;3667,1095,0,0,2,0,2
11508,20,4236,3708;6458;10704;10964;11046,1095,0,3,2,0,5
11509,20,4237,3789,1095,0,0,0,1,1
11510,20,4238,3940,1095,0,0,1,0,1
11511,20,4239,4048;6224,1095,0,0,0,2,2
11512,20,4240,4064;7569;11152;11303;11680,1095,1,2,2,0,5
11513,20,4241,4127,1095,0,0,0,1,1
11514,20,4242,2059;10845;11575;11881,1095,1,2,1,0,4
11515,20,4243,4166;4274;11263;11465;11591,1095,0,3,2,0,5
11516,20,4244,1640;4336;10788,1095,0,1,2,0,3
11517,20,4245,1821,1095,0,0,0,1,1
11518,20,4246,3362;4474,1095,0,0,2,0,2
11519,20,4248,4528;8033;11659,1095,1,0,2,0,3
11520,20,4249,4611,1095,0,0,0,1,1
11521,20,4250,4626,1095,0,0,1,0,1
11522,20,4251,4762;6396;10477,1095,0,1,2,0,3
11523,20,4252,4802,1095,0,0,1,0,1
11524,20,4253,4898;10613;11534;11702,1095,1,2,1,0,4
11525,20,4254,3062;4954;10717;11011;11609;11879,1095,2,2,2,0,6
11526,20,4255,236;5420;12042,1095,1,0,2,0,3
11527,20,4257,5017;10556;10862;10960,1095,0,3,1,0,4
11528,20,4259,5242,1095,0,0,0,1,1
11529,20,4263,2179;5365;10572;11562;12021,1095,1,2,2,0,5
11530,20,4265,5558;6958,1095,0,0,0,2,2
11531,20,4266,4510;5573;10470;10935;11599;11815,1095,2,2,2,0,6
11532,20,4268,3812;10426;10803;10929,1095,0,3,1,0,4
11533,20,4269,5729,1095,0,0,0,1,1
11534,20,4270,5871,1095,0,0,1,0,1
11535,20,4272,6020;6721,1095,0,0,2,0,2
11536,20,4273,6207;9572,1095,0,0,2,0,2
11537,20,4274,6277,1095,0,0,1,0,1
11538,20,4276,3038;6588,1095,0,0,2,0,2
11539,20,4282,5516;7213,1095,0,0,2,0,2
11540,20,4283,1071;7318;10421,1095,0,1,2,0,3
11541,20,4285,7429,1095,0,0,1,0,1
11542,20,4286,6481;7464,1095,0,0,2,0,2
11543,20,4288,2281;7641,1095,0,0,2,0,2
11544,20,4289,9016;11160;11442;11984,1095,1,2,1,0,4
11545,20,4290,6390;7819,1095,0,0,2,0,2
11546,20,4292,1235;7882;10823;11193,1095,0,2,2,0,4
11547,20,4293,7256;8124,1095,0,0,2,0,2
11548,20,4296,4209;8277;10583;11037,1095,0,2,2,0,4
11549,20,4297,8284;9797;11917,1095,1,0,2,0,3
11550,20,4298,8469;11400,1095,0,1,1,0,2
11551,20,4299,8491,1095,0,0,0,1,1
11552,20,4300,8523,1095,0,0,0,1,1
11553,20,4301,873;8596;11327;11644,1095,1,1,2,0,4
11554,20,4303,1372;10492;10976;11078,1095,0,3,1,0,4
11555,20,4304,951;6626;11645,1095,1,0,2,0,3
11556,20,4305,36;8859,1095,0,0,2,0,2
11557,20,4306,8902,1095,0,0,1,0,1
11558,20,4307,3583;8948,1095,0,0,2,0,2
11559,20,4309,9830;10533;10973,1095,0,2,1,0,3
11560,20,4310,9488,1095,0,0,1,0,1
11561,20,4311,764;9558,1095,0,0,2,0,2
11562,20,4312,4533;9600;10663,1095,0,1,2,0,3
11563,20,4314,9700,1095,0,0,0,1,1
11564,20,4315,9777;10424;11699;12008,1095,2,1,1,0,4
11565,20,4317,6595;9882,1095,0,0,2,0,2
11566,20,4318,7601;9898;10423;11439;11731;11860,1095,2,2,2,0,6
11567,20,4319,4605;9910;10540;10911,1095,0,2,2,0,4
11568,20,4321,158;4522;10902,1460,0,1,2,0,3
11569,20,4322,4031;6873;10738;11041,1460,0,2,2,0,4
11570,20,4324,336;9831;10945,1460,0,1,2,0,3
11571,20,4325,6347,1460,0,0,1,0,1
11572,20,4326,361;1116,1460,0,0,2,0,2
11573,20,4328,1925;9017;11790;12029,1460,2,0,2,0,4
11574,20,4329,768,1460,0,0,1,0,1
11575,20,4336,1055;1212;11256;11658,1460,1,1,2,0,4
11576,20,4337,8306,1460,0,0,1,0,1
11577,20,4338,1230;6819,1460,0,0,2,0,2
11578,20,4339,1251;8501;11055;11254;11628,1460,1,2,2,0,5
11579,20,4340,1264;9623,1460,0,0,2,0,2
11580,20,4342,1447;3895,1460,0,0,2,0,2
11581,20,4344,1603;10987;11063;11526,1460,0,3,1,0,4
11582,20,4345,1732;9214;11997,1460,1,0,2,0,3
11583,20,4346,1895,1460,0,0,0,1,1
11584,20,4348,1952;2723;10879;10938,1460,0,2,2,0,4
11585,20,4351,2337,1460,0,0,0,1,1
11586,20,4352,2355;3239,1460,0,0,2,0,2
11587,20,4353,2380;6254;10466;10695;10993,1460,0,3,2,0,5
11588,20,4354,929;2383;10887;11164;11503,1460,0,3,2,0,5
11589,20,4355,2455;7216,1460,0,0,2,0,2
11590,20,4357,2563,1460,0,0,0,1,1
11591,20,4358,2582;2744,1460,0,0,0,2,2
11592,20,4362,4477;8315,1460,0,0,2,0,2
11593,20,4364,3432;10755;11012,1460,0,2,1,0,3
11594,20,4365,2892;3502;11377;11794,1460,1,1,2,0,4
11595,20,4366,3548;5906;11180;11255,1460,0,2,2,0,4
11596,20,4367,3645,1460,0,0,0,1,1
11597,20,4369,3944;5603,1460,0,0,2,0,2
11598,20,4371,7;9645;10891;11232,1460,0,2,2,0,4
11599,20,4373,3985;6920,1460,0,0,2,0,2
11600,20,4374,1218;3811,1460,0,0,2,0,2
11601,20,4375,2718;4005,1460,0,0,0,2,2
11602,20,4376,5977,1460,0,0,1,0,1
11603,20,4379,4827;9455;11396;11592;12028,1460,1,2,2,0,5
11604,20,4381,834;2030,1460,0,0,2,0,2
11605,20,4382,4411;8516;11038;11283;11653,1460,1,2,2,0,5
11606,20,4383,4436;8425,1460,0,0,2,0,2
11607,20,4385,4925;7019,1460,0,0,2,0,2
11608,20,4386,643;7925;11272;11596,1460,1,1,2,0,4
11609,20,4387,1487;6326;11475,1460,0,1,2,0,3
11610,20,4389,5542;5562;10684,1460,0,1,2,0,3
11611,20,4390,3597;5695,1460,0,0,2,0,2
11612,20,4391,1363;5811;11100,1460,0,1,2,0,3
11613,20,4392,6038;6516,1460,0,0,2,0,2
11614,20,4394,864;8985;11474;11507,1460,0,2,2,0,4
11615,20,4395,2765;6308;10643;10878;11157;11679,1460,1,3,2,0,6
11616,20,4397,6334;9169,1460,0,0,2,0,2
11617,20,4399,6406;8168,1460,0,0,2,0,2
11618,20,4401,6493;11378;11461,1460,0,2,1,0,3
11619,20,4402,6542;8071,1460,0,0,2,0,2
11620,20,4403,6556,1460,0,0,0,1,1
11621,20,4404,2922;4942,1460,0,0,1,1,2
11622,20,4405,6698,1460,0,0,0,1,1
11623,20,4406,6854;9196;11468,1460,0,1,2,0,3
11624,20,4409,5169;6993,1460,0,0,2,0,2
11625,20,4410,4916,1460,0,0,1,0,1
11626,20,4411,4318;7066,1460,0,0,2,0,2
11627,20,4412,1740,1460,0,0,1,0,1
11628,20,4413,6710;7112,1460,0,0,2,0,2
11629,20,4414,7274;9495,1460,0,0,2,0,2
11630,20,4415,7293;8123;10592;10734,1460,0,2,2,0,4
11631,20,4416,5970;7300;11608;11867;12048,1460,3,0,2,0,5
11632,20,4417,7798;8732;10840,1460,0,1,2,0,3
11633,20,4418,9119,1460,0,0,1,0,1
11634,20,4419,2628;7534;11911,1460,1,0,2,0,3
11635,20,4420,360;7603,1460,0,0,2,0,2
11636,20,4421,4949,1460,0,0,1,0,1
11637,20,4422,6191;7682,1460,0,0,2,0,2
11638,20,4423,4170;7692,1460,0,0,2,0,2
11639,20,4425,3157;7834,1460,0,0,2,0,2
11640,20,4426,516;7838;11333,1460,0,1,2,0,3
11641,20,4427,2750;11315;11422;11603,1460,1,2,1,0,4
11642,20,4429,1383;8401,1460,0,0,2,0,2
11643,20,4431,7465;8187,1460,0,0,2,0,2
11644,20,4432,979;8262,1460,0,0,2,0,2
11645,20,4433,2414;8399,1460,0,0,2,0,2
11646,20,4434,202;5313,1460,0,0,2,0,2
11647,20,4435,8729,1460,0,0,0,1,1
11648,20,4436,583;8830,1460,0,0,2,0,2
11649,20,4437,797;8843,1460,0,0,2,0,2
11650,20,4438,5982;8904,1460,0,0,2,0,2
11651,20,4440,9159;9243,1460,0,0,2,0,2
11652,20,4441,5261;11820,1460,1,0,1,0,2
11653,20,4443,8546;9544,1460,0,0,2,0,2
11654,20,4447,679;870;11600;11708,1460,2,0,2,0,4
11655,20,4448,1801;9963;11284;11808,1460,1,1,2,0,4
11656,20,4449,183;9947;11095;11176,1825,0,2,2,0,4
11657,20,4450,271;6489,1825,0,0,2,0,2
11658,20,4451,430;8332,1825,0,0,2,0,2
11659,20,4452,636,1825,0,0,1,0,1
11660,20,4453,752;10808;11335,1825,0,2,1,0,3
11661,20,4454,1006;3563,1825,0,0,2,0,2
11662,20,4455,355;1031;10958;12134,1825,1,1,2,0,4
11663,20,4457,9078;11206;11419,1825,0,2,1,0,3
11664,20,4458,1169;8331;11793,1825,1,0,2,0,3
11665,20,4459,356;1352;10679;11711;11894,1825,2,1,2,0,5
11666,20,4460,1546;9289,1825,0,0,2,0,2
11667,20,4461,1769;4030,1825,0,0,2,0,2
11668,20,4462,1836;4116,1825,0,0,1,1,2
11669,20,4464,667;1988,1825,0,0,2,0,2
11670,20,4466,2213,1825,0,0,0,1,1
11671,20,4467,2387,1825,0,0,0,1,1
11672,20,4468,2438;8154;10849;10970,1825,0,2,2,0,4
11673,20,4469,609,1825,0,0,0,1,1
11674,20,4470,2569,1825,0,0,0,1,1
11675,20,4471,2864;8903;11268;11374,1825,0,2,2,0,4
11676,20,4472,3004;4015;11188;11415,1825,0,2,2,0,4
11677,20,4474,1263;3450;11665;11870,1825,2,0,2,0,4
11678,20,4475,2935;3544,1825,0,0,2,0,2
11679,20,4476,3610,1825,0,0,0,1,1
11680,20,4482,4178;4444;10846,1825,0,1,2,0,3
11681,20,4483,1936;6197;11028;11566;11743,1825,1,2,2,0,5
11682,20,4484,4315,1825,0,0,1,0,1
11683,20,4485,732;4338,1825,0,0,2,0,2
11684,20,4486,4418,1825,0,0,0,1,1
11685,20,4487,4506;6064,1825,0,0,2,0,2
11686,20,4489,8087;11625,1825,1,0,1,0,2
11687,20,4490,4703,1825,0,0,0,1,1
11688,20,4491,2687;4823,1825,0,0,2,0,2
11689,20,4492,5019,1825,0,0,0,1,1
11690,20,4493,9207,1825,0,0,1,0,1
11691,20,4494,5419,1825,0,0,1,0,1
11692,20,4495,5430;7624,1825,0,0,2,0,2
11693,20,4496,5490;8567,1825,0,0,2,0,2
11694,20,4497,5493,1825,0,0,0,1,1
11695,20,4498,5533,1825,0,0,0,1,1
11696,20,4499,5539;8392,1825,0,0,2,0,2
11697,20,4500,3695;5617;11614;11974,1825,2,0,2,0,4
11698,20,4501,5636;6259,1825,0,0,1,1,2
11699,20,4502,5715;6037;11551;11779;11817,1825,2,1,2,0,5
11700,20,4503,8741;11979,1825,1,0,1,0,2
11701,20,4504,5774;9357,1825,0,0,2,0,2
11702,20,4505,5915,1825,0,0,0,1,1
11703,20,4506,5945,1825,0,0,1,0,1
11704,20,4507,5949;9015,1825,0,0,2,0,2
11705,20,4508,6001;11139;11535,1825,0,2,1,0,3
11706,20,4509,2629;7732;10811;11075;11782,1825,1,2,2,0,5
11707,20,4510,6211,1825,0,0,1,0,1
11708,20,4511,6213;7412,1825,0,0,2,0,2
11709,20,4512,6325,1825,0,0,1,0,1
11710,20,4515,6239;6602;11733;11967,1825,2,0,2,0,4
11711,20,4516,7386,1825,0,0,0,1,1
11712,20,4517,6720,1825,0,0,1,0,1
11713,20,4519,1332;10952;11478,1825,0,2,1,0,3
11714,20,4520,726;7235;11194;11233,1825,0,2,2,0,4
11715,20,4523,6354;7508,1825,0,0,2,0,2
11716,20,4524,7564,1825,0,0,0,1,1
11717,20,4525,203;7683;11414;11605,1825,1,1,2,0,4
11718,20,4526,6689;7691;10720;10869;11141,1825,0,3,2,0,5
11719,20,4527,2840;7868;11154;11367,1825,0,2,2,0,4
11720,20,4528,64;7989;10817,1825,0,1,2,0,3
11721,20,4531,3522;8155,1825,0,0,0,2,2
11722,20,4534,6529,1825,0,0,1,0,1
11723,20,4536,1213;1270;11715;12081,1825,2,0,2,0,4
11724,20,4537,1586;8543;10841;11241;11492,1825,0,3,2,0,5
11725,20,4538,3397;8617,1825,0,0,2,0,2
11726,20,4539,1216;8680;11724,1825,1,0,2,0,3
11727,20,4540,2843;11799,1825,1,0,1,0,2
11728,20,4541,3539,1825,0,0,1,0,1
11729,20,4542,10;8092,1825,0,0,2,0,2
11730,20,4543,239;6750,1825,0,0,2,0,2
11731,20,4544,3672;8922;11682;11927,1825,2,0,2,0,4
11732,20,4545,9024,1825,0,0,0,1,1
11733,20,4546,1123;9187;10602;11959,1825,1,1,2,0,4
11734,20,4548,3865;9412;11752,1825,1,0,2,0,3
11735,20,4550,6118;11469;11868,1825,1,1,1,0,3
11736,20,4552,357;9926,1825,0,0,2,0,2
11737,20,4553,9955,1825,0,0,0,1,1
11738,20,4554,6453;8466;11376;11882,1825,1,1,2,0,4
11739,20,4555,6394;9329,1825,0,0,2,0,2
11740,20,4556,59,2190,0,0,0,1,1
11741,20,4557,65;5159;9519;10661;10875;11023;11480;12023,2190,1,4,3,0,8
11742,20,4558,2741;11159;11649,2190,1,1,1,0,3
11743,20,4559,3924,2190,0,0,1,0,1
11744,20,4560,240;3449;11516;11903,2190,1,1,2,0,4
11745,20,4561,262,2190,0,0,1,0,1
11746,20,4562,511;7404,2190,0,0,2,0,2
11747,20,4564,773;11316;11588,2190,0,2,1,0,3
11748,20,4565,371;989,2190,0,0,2,0,2
11749,20,4566,1100;4874,2190,0,0,2,0,2
11750,20,4567,1151;11949,2190,1,0,1,0,2
11751,20,4568,1333;3419,2190,0,0,2,0,2
11752,20,4569,561;1776,2190,0,0,2,0,2
11753,20,4570,1873;7659,2190,0,0,2,0,2
11754,20,4571,1938;5189,2190,0,0,1,1,2
11755,20,4572,1962;9607;11739;12030,2190,2,0,2,0,4
11756,20,4573,2007;3758;11111;11813,2190,1,1,2,0,4
11757,20,4574,707;2206,2190,0,0,2,0,2
11758,20,4575,2301;6408,2190,0,0,2,0,2
11759,20,4576,603;3012;10664;10839;11781;12052,2190,2,2,2,0,6
11760,20,4577,642;2544,2190,0,0,2,0,2
11761,20,4579,2742,2190,0,0,1,0,1
11762,20,4581,2067;2949;11848,2190,1,0,2,0,3
11763,20,4582,2971;4061;10822,2190,0,1,2,0,3
11764,20,4583,2986;10001,2190,0,0,2,0,2
11765,20,4586,3174;3931;10786;10842;11146,2190,0,3,2,0,5
11766,20,4587,3355;8456;11832,2190,1,0,2,0,3
11767,20,4588,3467;6537;11770,2190,1,0,2,0,3
11768,20,4589,3167,2190,0,0,1,0,1
11769,20,4592,3740,2190,0,0,1,0,1
11770,20,4594,3066;5865;10856;11196,2190,0,2,2,0,4
11771,20,4595,2998,2190,0,0,1,0,1
11772,20,4596,3962;9721;11765,2190,1,0,2,0,3
11773,20,4597,4036,2190,0,0,0,1,1
11774,20,4598,4136;8652,2190,0,0,0,2,2
11775,20,4599,3128,2190,0,0,0,1,1
11776,20,4602,4373;8806,2190,0,0,2,0,2
11777,20,4603,5616;9221;11858,2190,1,0,2,0,3
11778,20,4604,7704;11559;11893,2190,1,1,1,0,3
11779,20,4605,4486;10815;11024,2190,0,2,1,0,3
11780,20,4606,4511;8561;10759;11924,2190,1,1,2,0,4
11781,20,4607,1032;4527,2190,0,0,2,0,2
11782,20,4609,3402;4735;11170;11258;11362;12019,2190,1,3,2,0,6
11783,20,4610,3869;4888;11889;11955,2190,2,0,2,0,4
11784,20,4611,684;5013,2190,0,0,2,0,2
11785,20,4612,5037;9628,2190,0,0,1,1,2
11786,20,4613,5269;5339,2190,0,0,1,1,2
11787,20,4618,903;6544,2190,0,0,2,0,2
11788,20,4619,3644;5823,2190,0,0,0,2,2
11789,20,4620,5849;11616;11933,2190,2,0,1,0,3
11790,20,4622,5905;8226,2190,0,0,2,0,2
11791,20,4623,5799;6074,2190,0,0,2,0,2
11792,20,4624,1074;6170,2190,0,0,2,0,2
11793,20,4625,6311;10757;11105,2190,0,2,1,0,3
11794,20,4626,1165;6339;11047,2190,0,1,2,0,3
11795,20,4627,6463,2190,0,0,0,1,1
11796,20,4628,6706;9909,2190,0,0,2,0,2
11797,20,4629,2178;6968,2190,0,0,2,0,2
11798,20,4630,6974,2190,0,0,1,0,1
11799,20,4632,7047,2190,0,0,1,0,1
11800,20,4633,3922;7119,2190,0,0,2,0,2
11801,20,4634,7141,2190,0,0,1,0,1
11802,20,4635,3438;7238;10944;11156;11412;11775,2190,1,3,2,0,6
11803,20,4638,4920;7844;11288;11748,2190,1,1,2,0,4
11804,20,4641,3813;7836;11529;11976,2190,1,1,2,0,4
11805,20,4642,15;8254,2190,0,0,1,1,2
11806,20,4643,8256,2190,0,0,0,1,1
11807,20,4644,4553;4860,2190,0,0,2,0,2
11808,20,4646,8470,2190,0,0,1,0,1
11809,20,4647,7180;8492,2190,0,0,2,0,2
11810,20,4648,8604;9232;11338;11554,2190,0,2,2,0,4
11811,20,4650,8707,2190,0,0,1,0,1
11812,20,4651,2679,2190,0,0,1,0,1
11813,20,4652,8797;11279;11482;11918,2190,1,2,1,0,4
11814,20,4653,8939,2190,0,0,0,1,1
11815,20,4654,181;9077,2190,0,0,2,0,2
11816,20,4655,9112;11187;11289,2190,0,2,1,0,3
11817,20,4658,2559;9424;12074,2190,1,0,2,0,3
11818,20,4659,3259;9510;11398,2190,0,1,2,0,3
11819,20,4660,1754;3160,2190,0,0,2,0,2
11820,20,4662,9727;11598;12095,2190,2,0,1,0,3
11821,20,4663,513;9817;11647,2190,1,0,2,0,3
11822,20,4664,8230;9202,2190,0,0,2,0,2
11823,20,4666,179;11372,2555,0,1,1,0,2
11824,20,4668,720;1584,2555,0,0,2,0,2
11825,20,4669,1386;11931;12039,2555,2,0,1,0,3
11826,20,4670,893,2555,0,0,1,0,1
11827,20,4671,898;6070,2555,0,0,2,0,2
11828,20,4673,7899;9165;11299,2555,0,1,2,0,3
11829,20,4677,1535;1824;11001;11033,2555,0,2,2,0,4
11830,20,4678,2306;7086,2555,0,0,2,0,2
11831,20,4679,1901;5086,2555,0,0,2,0,2
11832,20,4680,1910;4965,2555,0,0,2,0,2
11833,20,4681,1957;9812,2555,0,0,0,2,2
11834,20,4683,2345;4027,2555,0,0,2,0,2
11835,20,4684,2436,2555,0,0,0,1,1
11836,20,4685,4893;6380,2555,0,0,0,2,2
11837,20,4686,2692;5025;11183;11876;12097,2555,2,1,2,0,5
11838,20,4687,2792;4389,2555,0,0,0,2,2
11839,20,4689,2901;8853;10942;11463,2555,0,2,2,0,4
11840,20,4690,1526,2555,0,0,1,0,1
11841,20,4694,3407;8977,2555,0,0,2,0,2
11842,20,4695,1861;3567,2555,0,0,0,2,2
11843,20,4697,7261,2555,0,0,1,0,1
11844,20,4699,5716,2555,0,0,1,0,1
11845,20,4700,3491;3847,2555,0,0,1,1,2
11846,20,4701,932;3879;11175;11641,2555,1,1,2,0,4
11847,20,4702,4035;9189,2555,0,0,2,0,2
11848,20,4703,4022;7808;10770;10912,2555,0,2,2,0,4
11849,20,4705,4111;8070,2555,0,0,2,0,2
11850,20,4707,4149;4628;10900;11899,2555,1,1,2,0,4
11851,20,4708,110;4694,2555,0,0,2,0,2
11852,20,4709,8674;11144;11550;11632,2555,1,2,1,0,4
11853,20,4712,7582;8189,2555,0,0,2,0,2
11854,20,4713,1068;4891,2555,0,0,2,0,2
11855,20,4716,3650;4940,2555,0,0,0,2,2
11856,20,4719,5133;11861,2555,1,0,1,0,2
11857,20,4721,5289;9564,2555,0,0,2,0,2
11858,20,4722,5319;7820,2555,0,0,2,0,2
11859,20,4725,4978;5547;11348;11479,2555,0,2,2,0,4
11860,20,4727,4287;5781,2555,0,0,2,0,2
11861,20,4728,733;5843,2555,0,0,2,0,2
11862,20,4729,5870;8396;11433,2555,0,1,2,0,3
11863,20,4730,2787;6036;12055,2555,1,0,2,0,3
11864,20,4731,6139;9138;11273;11409,2555,0,2,2,0,4
11865,20,4732,1122;6169,2555,0,0,2,0,2
11866,20,4733,5134;6184,2555,0,0,2,0,2
11867,20,4734,6187;9799;11360;11509;11777,2555,1,2,2,0,5
11868,20,4735,6313;8589,2555,0,0,2,0,2
11869,20,4736,6318;9951;10813;11136;11819,2555,1,2,2,0,5
11870,20,4737,6775,2555,0,0,0,1,1
11871,20,4740,6973;11397;11742;12114,2555,2,1,1,0,4
11872,20,4741,4051;6999;11062;11443;12025,2555,1,2,2,0,5
11873,20,4742,2891;7036;11264;11670;11884,2555,2,1,2,0,5
11874,20,4745,404;8822;12040,2555,1,0,2,0,3
11875,20,4746,7574;8148,2555,0,0,2,0,2
11876,20,4747,7151;7276,2555,0,0,2,0,2
11877,20,4749,490;7776;10838;11574;11866;12035,2555,2,2,2,0,6
11878,20,4750,2418;7867;12067,2555,1,0,2,0,3
11879,20,4751,8388;11579;11716;12094,2555,2,1,1,0,4
11880,20,4753,8642;11669;11831,2555,2,0,1,0,3
11881,20,4755,8128,2555,0,0,1,0,1
11882,20,4756,7461;8144,2555,0,0,2,0,2
11883,20,4757,6464;8268;11969,2555,1,0,2,0,3
11884,20,4759,3022;9995;11352,2555,0,1,2,0,3
11885,20,4760,2058;8336;10918,2555,0,1,2,0,3
11886,20,4762,6692;8560;10892;11448;11759,2555,1,2,2,0,5
11887,20,4763,8712;9998;11205;11916;12000,2555,2,1,2,0,5
11888,20,4765,4073;8760;11006,2555,0,1,2,0,3
11889,20,4766,6723,2555,0,0,0,1,1
11890,20,4767,5302;8893;10924;11337;11874,2555,1,2,2,0,5
11891,20,4768,8908,2555,0,0,0,1,1
11892,20,4769,6526;8966,2555,0,0,2,0,2
11893,20,4770,9246;9392,2555,0,0,2,0,2
11894,20,4772,393;5704,2555,0,0,2,0,2
11895,20,4773,2580;4543,2555,0,0,2,0,2
11896,20,4774,8781,2555,0,0,1,0,1
11897,20,4775,7913;9687;11020;11441;11678,2555,1,2,2,0,5
11898,20,4776,9762,2555,0,0,1,0,1
11899,20,4777,8675;9837,2555,0,0,2,0,2
11900,20,4778,9925,2555,0,0,1,0,1
11901,20,4779,54;4449;10975;11089,2920,0,2,2,0,4
11902,20,4781,147;4668,2920,0,0,2,0,2
11903,20,4782,167,2920,0,0,0,1,1
11904,20,4783,2837,2920,0,0,0,1,1
11905,20,4785,475;2092,2920,0,0,2,0,2
11906,20,4786,537;5063,2920,0,0,2,0,2
11907,20,4787,572;5429,2920,0,0,2,0,2
11908,20,4790,1021;7089,2920,0,0,2,0,2
11909,20,4791,819,2920,0,0,0,1,1
11910,20,4793,4103;11674;11735;12083,2920,3,0,1,0,4
11911,20,4794,2656;9045;11103,2920,0,1,2,0,3
11912,20,4795,1239;9571,2920,0,0,2,0,2
11913,20,4798,1516,2920,0,0,1,0,1
11914,20,4800,1653;8619,2920,0,0,2,0,2
11915,20,4801,1882;4475,2920,0,0,2,0,2
11916,20,4803,1935,2920,0,0,1,0,1
11917,20,4804,2091;8628,2920,0,0,2,0,2
11918,20,4805,2500;2865,2920,0,0,2,0,2
11919,20,4806,4094;9970,2920,0,0,1,1,2
11920,20,4807,1217;7525;11216;11580,2920,0,2,2,0,4
11921,20,4808,7553;10927;11321,2920,0,2,1,0,3
11922,20,4809,2700;4953;11182;11788,2920,1,1,2,0,4
11923,20,4810,2717;6094,2920,0,0,2,0,2
11924,20,4811,1010;1575;11218;11540,2920,0,2,2,0,4
11925,20,4812,2847,2920,0,0,0,1,1
11926,20,4816,2798;3116,2920,0,0,2,0,2
11927,20,4817,3173;6554;10906;11147;11458;11633,2920,1,3,2,0,6
11928,20,4818,1784;3192,2920,0,0,2,0,2
11929,20,4819,3277;8253,2920,0,0,2,0,2
11930,20,4820,2033;3400,2920,0,0,2,0,2
11931,20,4821,3463;8740,2920,0,0,2,0,2
11932,20,4822,2001;3486,2920,0,0,2,0,2
11933,20,4823,3523;7488;11126,2920,0,1,2,0,3
11934,20,4824,686;3566;11060;11214;11470,2920,0,3,2,0,5
11935,20,4826,3754,2920,0,0,0,1,1
11936,20,4827,3772;9603,2920,0,0,2,0,2
11937,20,4829,3953,2920,0,0,1,0,1
11938,20,4831,4008,2920,0,0,0,1,1
11939,20,4832,4102;8169,2920,0,0,2,0,2
11940,20,4833,7466,2920,0,0,1,0,1
11941,20,4834,4280;8285;11271;11785,2920,1,1,2,0,4
11942,20,4835,4293;5737;11905,2920,1,0,2,0,3
11943,20,4836,4509;9739,2920,0,0,2,0,2
11944,20,4837,6420;7671,2920,0,0,2,0,2
11945,20,4838,4619;9208,2920,0,0,2,0,2
11946,20,4839,3675;6971,2920,0,0,2,0,2
11947,20,4841,4795;8125,2920,0,0,2,0,2
11948,20,4843,4859;8629;10917;11518;11814,2920,1,2,2,0,5
11949,20,4844,1606;5073,2920,0,0,2,0,2
11950,20,4845,1652;5181;11501;12002,2920,1,1,2,0,4
11951,20,4847,4009;5286,2920,0,0,2,0,2
11952,20,4848,5356,2920,0,0,1,0,1
11953,20,4849,5366,2920,0,0,1,0,1
11954,20,4850,1788;5410;11846,2920,1,0,2,0,3
11955,20,4851,1247;5443,2920,0,0,2,0,2
11956,20,4852,5810;8050,2920,0,0,2,0,2
11957,20,4856,6194;10998,2920,0,1,1,0,2
11958,20,4858,6285;6405,2920,0,0,2,0,2
11959,20,4859,6434;7690,2920,0,0,2,0,2
11960,20,4861,3749;6661,2920,0,0,2,0,2
11961,20,4862,6696;9352,2920,0,0,2,0,2
11962,20,4863,5612,2920,0,0,1,0,1
11963,20,4864,6751;7503;11007;11594,2920,1,1,2,0,4
11964,20,4865,6912,2920,0,0,0,1,1
11965,20,4866,1974;5974,2920,0,0,2,0,2
11966,20,4867,7387,2920,0,0,0,1,1
11967,20,4868,3531;7403,2920,0,0,2,0,2
11968,20,4870,1078;7459,2920,0,0,1,1,2
11969,20,4871,1157;7729;10923;11621;11855;11938,2920,3,1,2,0,6
11970,20,4872,5963;7733;12009,2920,1,0,2,0,3
11971,20,4875,397;7992;11496;11698;11914,2920,2,1,2,0,5
11972,20,4876,6827;8043;11021,2920,0,1,2,0,3
11973,20,4877,6774;11373;11756;11987,2920,2,1,1,0,4
11974,20,4878,5981;8135,2920,0,0,2,0,2
11975,20,4879,3633;8211;11201;11597,2920,1,1,2,0,4
11976,20,4880,8228,2920,0,0,1,0,1
11977,20,4881,974;8344;11434;11941,2920,1,1,2,0,4
11978,20,4882,4924;8488;11638,2920,1,0,2,0,3
11979,20,4883,6995;8502;11178;11262;11908,2920,1,2,2,0,5
11980,20,4885,2800;8514;11843;12004,2920,2,0,2,0,4
11981,20,4886,3374;8568,2920,0,0,2,0,2
11982,20,4887,5278;8573;11519;11906,2920,1,1,2,0,4
11983,20,4888,7211;8584;11265,2920,0,1,2,0,3
11984,20,4889,5606;8623;11804;11818,2920,2,0,2,0,4
11985,20,4893,8823;11484;11687,2920,1,1,1,0,3
11986,20,4894,1473;8552;11010;11250;11383,2920,0,3,2,0,5
11987,20,4895,6845;9068,2920,0,0,2,0,2
11988,20,4896,7901;9088,2920,0,0,2,0,2
11989,20,4897,4900;9174,2920,0,0,0,2,2
11990,20,4898,1417;4331,2920,0,0,2,0,2
11991,20,4901,3698;8122;11667,2920,1,0,2,0,3
11992,20,4902,6158;9467,2920,0,0,2,0,2
11993,20,4903,4348;9541,2920,0,0,2,0,2
11994,20,4904,3637;3925,2920,0,0,1,1,2
11995,20,4906,5024;9768,2920,0,0,2,0,2
11996,20,4907,7385;8270;10963;11174;11242;11666;11944,2920,2,3,2,0,7
11997,20,4908,7245,2920,0,0,1,0,1
11998,20,4909,3092;7409,2920,0,0,2,0,2
11999,20,4911,84;4308;11056,3285,0,1,2,0,3
12000,20,4912,959;3315;12093,3285,1,0,2,0,3
12001,20,4913,4499;11310;11553,3285,0,2,1,0,3
12002,20,4914,6981;10921;11604,3285,1,1,1,0,3
12003,20,4915,278;4381,3285,0,0,2,0,2
12004,20,4916,286,3285,0,0,1,0,1
12005,20,4917,210;6659,3285,0,0,2,0,2
12006,20,4918,349;3748;11202;12135,3285,1,1,2,0,4
12007,20,4921,75;467;11631;11864,3285,2,0,2,0,4
12008,20,4922,623,3285,0,0,1,0,1
12009,20,4923,630;1344;11118;11827,3285,1,1,2,0,4
12010,20,4924,6649,3285,0,0,1,0,1
12011,20,4926,1140;6910,3285,0,0,2,0,2
12012,20,4927,536;853,3285,0,0,2,0,2
12013,20,4928,3343,3285,0,0,1,0,1
12014,20,4929,985;8539,3285,0,0,2,0,2
12015,20,4930,1084;6743,3285,0,0,2,0,2
12016,20,4931,1153,3285,0,0,1,0,1
12017,20,4932,1296;5353;11489;11712,3285,1,1,2,0,4
12018,20,4933,293;4548,3285,0,0,2,0,2
12019,20,4934,1340,3285,0,0,0,1,1
12020,20,4935,1376;9588;11013,3285,0,1,2,0,3
12021,20,4936,1534;6896,3285,0,0,2,0,2
12022,20,4937,1561;4294;11334;11426,3285,0,2,2,0,4
12023,20,4938,2433;3218;11998,3285,1,0,2,0,3
12024,20,4939,1900,3285,0,0,0,1,1
12025,20,4940,4043;7744;11966,3285,1,0,2,0,3
12026,20,4941,4721;11293;11891,3285,1,1,1,0,3
12027,20,4944,2120,3285,0,0,1,0,1
12028,20,4945,2169;2189;11171;11236;11803,3285,1,2,2,0,5
12029,20,4946,2177,3285,0,0,0,1,1
12030,20,4947,2462;2517;11757,3285,1,0,2,0,3
12031,20,4948,2477,3285,0,0,0,1,1
12032,20,4950,2670;11857,3285,1,0,1,0,2
12033,20,4951,413;2817;11816,3285,1,0,2,0,3
12034,20,4952,2914;5099,3285,0,0,2,0,2
12035,20,4953,2943;4457,3285,0,0,1,1,2
12036,20,4955,3457;5330,3285,0,0,2,0,2
12037,20,4956,3560;8099,3285,0,0,2,0,2
12038,20,4957,3596,3285,0,0,0,1,1
12039,20,4958,3621;9819;11517;11764,3285,1,1,2,0,4
12040,20,4959,3639,3285,0,0,1,0,1
12041,20,4960,3712;9343,3285,0,0,2,0,2
12042,20,4961,3762,3285,0,0,0,1,1
12043,20,4963,3976;11076;11341;11568,3285,0,3,1,0,4
12044,20,4965,4105;4961,3285,0,0,1,1,2
12045,20,4966,4169,3285,0,0,1,0,1
12046,20,4967,4259;7330,3285,0,0,2,0,2
12047,20,4968,4416;8022,3285,0,0,1,1,2
12048,20,4969,4637;7679;11531;11694;12121,3285,2,1,2,0,5
12049,20,4970,4765,3285,0,0,0,1,1
12050,20,4971,8672,3285,0,0,1,0,1
12051,20,4972,4165;5044;12123,3285,1,0,2,0,3
12052,20,4973,5281,3285,0,0,0,1,1
12053,20,4974,2014;5296,3285,0,0,2,0,2
12054,20,4978,5702;5780,3285,0,0,2,0,2
12055,20,4979,5708,3285,0,0,1,0,1
12056,20,4981,2972;7275;11065,3285,0,1,2,0,3
12057,20,4983,2289;9714;11877,3285,1,0,2,0,3
12058,20,4984,5545;6126,3285,0,0,0,2,2
12059,20,4985,9134,3285,0,0,1,0,1
12060,20,4986,6179;9235,3285,0,0,0,2,2
12061,20,4987,5692;6188;11499,3285,0,1,2,0,3
12062,20,4989,6295;9188;12133,3285,1,0,2,0,3
12063,20,4992,6503;8527;12106,3285,1,0,2,0,3
12064,20,4993,2385;6586;11427;12131,3285,1,1,2,0,4
12065,20,4994,6622;9251,3285,0,0,2,0,2
12066,20,4995,1394,3285,0,0,0,1,1
12067,20,4996,6964;8836,3285,0,0,0,2,2
12068,20,4997,7308,3285,0,0,1,0,1
12069,20,4998,5160;7078,3285,0,0,2,0,2
12070,20,4999,7093,3285,0,0,1,0,1
12071,20,5000,1692,3285,0,0,1,0,1
12072,20,5002,3117;7332,3285,0,0,2,0,2
12073,20,5003,7343;11440,3285,0,1,1,0,2
12074,20,5004,7357;8019;11792;11936;12127,3285,3,0,2,0,5
12075,20,5005,4362;8229,3285,0,0,0,2,2
12076,20,5006,2508;6701,3285,0,0,2,0,2
12077,20,5007,4873;7872;11281;11456,3285,0,2,2,0,4
12078,20,5008,2246;7874,3285,0,0,2,0,2
12079,20,5010,8106;8759,3285,0,0,2,0,2
12080,20,5011,1609;3381;11953,3285,1,0,2,0,3
12081,20,5012,8587,3285,0,0,0,1,1
12082,20,5013,333;8591,3285,0,0,2,0,2
12083,20,5015,8318;8814;11447;11696;11968,3285,2,1,2,0,5
12084,20,5016,6736;8815,3285,0,0,2,0,2
12085,20,5017,4737;7966,3285,0,0,2,0,2
12086,20,5018,3833;6948;11435;11900,3285,1,1,2,0,4
12087,20,5019,2681;9008,3285,0,0,2,0,2
12088,20,5020,8899;9114,3285,0,0,2,0,2
12089,20,5021,2756,3285,0,0,0,1,1
12090,20,5022,5031;9596;11080;11671,3285,1,1,2,0,4
12091,20,5023,8592;11122;11295,3285,0,2,1,0,3
12092,20,5025,2240;9787;11512,3285,0,1,2,0,3
12093,20,5026,5824,3285,0,0,1,0,1
12094,20,5027,6360,3285,0,0,0,1,1
12095,20,5029,3132;9985;11961,3285,1,0,2,0,3
12096,20,5030,71,3650,0,0,1,0,1
12097,20,5031,146,3650,0,0,1,0,1
12098,20,5033,4400;11357;11561;11740,3650,1,2,1,0,4
12099,20,5034,216;801;12111,3650,1,0,2,0,3
12100,20,5038,891;3308;11107;11704,3650,1,1,2,0,4
12101,20,5039,1061;3406,3650,0,0,2,0,2
12102,20,5040,1288;7051,3650,0,0,2,0,2
12103,20,5042,1407,3650,0,0,1,0,1
12104,20,5043,1453;5216;11097;11277;11452;11539,3650,0,4,2,0,6
12105,20,5044,1654;6604,3650,0,0,2,0,2
12106,20,5045,1656,3650,0,0,0,1,1
12107,20,5046,1789;3202;11212;11721;12116,3650,2,1,2,0,5
12108,20,5048,1915;6426,3650,0,0,2,0,2
12109,20,5050,2117;3103;11627;12016,3650,2,0,2,0,4
12110,20,5051,2145;8957,3650,0,0,2,0,2
12111,20,5052,2203;6782,3650,0,0,2,0,2
12112,20,5053,2232;8624;11768;11929,3650,2,0,2,0,4
12113,20,5054,1599;9423;11257;11710;11839,3650,2,1,2,0,5
12114,20,5055,1236;3276;11308;11563,3650,0,2,2,0,4
12115,20,5056,2651;9336;11073;11909;11983,3650,2,1,2,0,5
12116,20,5057,2445;2676,3650,0,0,2,0,2
12117,20,5058,9848;11664;11902,3650,2,0,1,0,3
12118,20,5060,2390;2851,3650,0,0,2,0,2
12119,20,5061,3212;9371,3650,0,0,2,0,2
12120,20,5062,685;3395;11086;11880,3650,1,1,2,0,4
12121,20,5063,6025,3650,0,0,0,1,1
12122,20,5064,2887;5008;11220;11564,3650,0,2,2,0,4
12123,20,5065,1147;3437;11407;11833,3650,1,1,2,0,4
12124,20,5066,8882,3650,0,0,1,0,1
12125,20,5067,3607,3650,0,0,1,0,1
12126,20,5068,3704;4101;11101;11394,3650,0,2,2,0,4
12127,20,5069,1321;3759;11975,3650,1,0,2,0,3
12128,20,5070,7203;9417,3650,0,0,2,0,2
12129,20,5071,3819,3650,0,0,0,1,1
12130,20,5072,3872;7391,3650,0,0,2,0,2
12131,20,5073,229,3650,0,0,1,0,1
12132,20,5074,5918;6012;11619;11769,3650,2,0,2,0,4
12133,20,5075,4129;6108,3650,0,0,2,0,2
12134,20,5078,3380;5394;11153;11806,3650,1,1,2,0,4
12135,20,5079,4595;7739;11269;11444;12117,3650,1,2,2,0,5
12136,20,5081,4771;8497;12092,3650,1,0,2,0,3
12137,20,5082,4939,3650,0,0,1,0,1
12138,20,5083,4843,3650,0,0,0,1,1
12139,20,5084,4854;9226,3650,0,0,2,0,2
12140,20,5085,4964,3650,0,0,0,1,1
12141,20,5086,2805;5046,3650,0,0,2,0,2
12142,20,5087,5295,3650,0,0,0,1,1
12143,20,5088,5318;6688;11140,3650,0,1,2,0,3
12144,20,5089,4252;6792;12078,3650,1,0,2,0,3
12145,20,5091,5590;7969,3650,0,0,2,0,2
12146,20,5092,80;5619,3650,0,0,2,0,2
12147,20,5093,5661;9484;11760,3650,1,0,2,0,3
12148,20,5094,4368;5787,3650,0,0,2,0,2
12149,20,5096,5808,3650,0,0,0,1,1
12150,20,5097,4828;5863,3650,0,0,2,0,2
12151,20,5098,5932,3650,0,0,0,1,1
12152,20,5099,943,3650,0,0,1,0,1
12153,20,5100,933;5967;11636;11835,3650,2,0,2,0,4
12154,20,5101,6201;8785,3650,0,0,2,0,2
12155,20,5102,524;6215;11204,3650,0,1,2,0,3
12156,20,5103,1714;4693,3650,0,0,2,0,2
12157,20,5104,6381,3650,0,0,0,1,1
12158,20,5105,6383,3650,0,0,1,0,1
12159,20,5106,9922,3650,0,0,0,1,1
12160,20,5108,4655;5969;11578,3650,0,1,2,0,3
12161,20,5109,2881;6559;12072,3650,1,0,2,0,3
12162,20,5110,6238;7520,3650,0,0,2,0,2
12163,20,5112,6629;6675;11527;11705;12100,3650,2,1,2,0,5
12164,20,5113,6987,3650,0,0,0,1,1
12165,20,5115,2625;7192,3650,0,0,2,0,2
12166,20,5116,4680;4979;11349,3650,0,1,2,0,3
12167,20,5117,7294;11330,3650,0,1,1,0,2
12168,20,5118,7306;9418;11892;12087,3650,2,0,2,0,4
12169,20,5119,4799,3650,0,0,1,0,1
12170,20,5120,7398;9118;11149,3650,0,1,2,0,3
12171,20,5121,3678;7460,3650,0,0,2,0,2
12172,20,5122,5532;7623,3650,0,0,2,0,2
12173,20,5123,2795;7746,3650,0,0,2,0,2
12174,20,5124,7873;8133,3650,0,0,2,0,2
12175,20,5126,8386,3650,0,0,0,1,1
12176,20,5127,8072;9577,3650,0,0,2,0,2
12177,20,5128,2215;8538,3650,0,0,2,0,2
12178,20,5129,1657;8547,3650,0,0,1,1,2
12179,20,5130,1592;8572;11227;11859,3650,1,1,2,0,4
12180,20,5133,8857;11428,3650,0,1,1,0,2
12181,20,5134,8858;11223;11450,3650,0,2,1,0,3
12182,20,5135,4514,3650,0,0,1,0,1
12183,20,5136,4141;8928,3650,0,0,2,0,2
12184,20,5138,5458;9798;11087,3650,0,1,2,0,3
12185,20,5139,9163,3650,0,0,0,1,1
12186,20,5140,4053;11425;12057,3650,1,1,1,0,3
12187,20,5141,3790;6509,3650,0,0,2,0,2
12188,20,5142,3219;9356,3650,0,0,2,0,2
12189,20,5143,8934;9410;11172;11391,3650,0,2,2,0,4
12190,20,5144,8340;9429,3650,0,0,2,0,2
12191,20,5145,3946,3650,0,0,1,0,1
12192,20,5146,3612;5709,3650,0,0,2,0,2
12193,20,5147,753;9585,3650,0,0,2,0,2
12194,20,5149,9708,3650,0,0,1,0,1
12195,20,5150,7073;9007;12128,3650,1,0,2,0,3
12196,20,5151,43;9648,4015,0,0,2,0,2
12197,20,5152,107;9406;11995,4015,1,0,2,0,3
12198,20,5153,112;7143;11688,4015,1,0,2,0,3
12199,20,5154,188;2456,4015,0,0,2,0,2
12200,20,5155,217;771;11353;12102,4015,1,1,2,0,4
12201,20,5156,260;8936,4015,0,0,2,0,2
12202,20,5157,284,4015,0,0,0,1,1
12203,20,5158,326;5749,4015,0,0,2,0,2
12204,20,5159,350;1148,4015,0,0,2,0,2
12205,20,5160,380;4236,4015,0,0,0,2,2
12206,20,5161,3;390;11313,4015,0,1,2,0,3
12207,20,5162,2499,4015,0,0,1,0,1
12208,20,5166,936;939,4015,0,0,2,0,2
12209,20,5167,945;7495,4015,0,0,2,0,2
12210,20,5168,1016;6196,4015,0,0,2,0,2
12211,20,5169,1086;4211,4015,0,0,0,2,2
12212,20,5170,1096;8272,4015,0,0,2,0,2
12213,20,5172,1846;6951;11243;11486,4015,0,2,2,0,4
12214,20,5173,6400,4015,0,0,0,1,1
12215,20,5176,2359;2648,4015,0,0,2,0,2
12216,20,5177,2372;6875;11940,4015,1,0,2,0,3
12217,20,5179,2637;4275,4015,0,0,2,0,2
12218,20,5180,8319,4015,0,0,1,0,1
12219,20,5182,3204;6517,4015,0,0,2,0,2
12220,20,5183,3208;11369,4015,0,1,1,0,2
12221,20,5184,3309;8039;11878,4015,1,0,2,0,3
12222,20,5185,3363;3401;11885;12071,4015,2,0,2,0,4
12223,20,5186,3371,4015,0,0,1,0,1
12224,20,5187,3475;7696;11225;11544;11754;12044,4015,2,2,2,0,6
12225,20,5188,3595;8407;11725,4015,1,0,2,0,3
12226,20,5189,3685;4887,4015,0,0,2,0,2
12227,20,5190,3726;7998,4015,0,0,2,0,2
12228,20,5191,2421;3728,4015,0,0,2,0,2
12229,20,5192,3741;6166;11567,4015,0,1,2,0,3
12230,20,5193,3873;9033;11593;11789,4015,1,1,2,0,4
12231,20,5194,2230,4015,0,0,0,1,1
12232,20,5195,4267;4713;12099,4015,1,0,2,0,3
12233,20,5196,4289;7082,4015,0,0,0,2,2
12234,20,5197,2279;9388;12105,4015,1,0,2,0,3
12235,20,5198,4934;6327,4015,0,0,1,1,2
12236,20,5199,4586,4015,0,0,1,0,1
12237,20,5200,4613;4764,4015,0,0,2,0,2
12238,20,5202,1505;8780,4015,0,0,2,0,2
12239,20,5203,977;4917;11304,4015,0,1,2,0,3
12240,20,5204,5035,4015,0,0,1,0,1
12241,20,5205,137;3934;11347;11536,4015,0,2,2,0,4
12242,20,5206,5246,4015,0,0,1,0,1
12243,20,5207,1536;5277;11637;11774,4015,2,0,2,0,4
12244,20,5208,5290,4015,0,0,1,0,1
12245,20,5209,5401,4015,0,0,1,0,1
12246,20,5210,3696;11610;12122,4015,2,0,1,0,3
12247,20,5211,5485;9298,4015,0,0,2,0,2
12248,20,5212,1887;5588,4015,0,0,2,0,2
12249,20,5214,5764;6638;11189,4015,0,1,2,0,3
12250,20,5215,4654;11982,4015,1,0,1,0,2
12251,20,5218,6107;9874,4015,0,0,2,0,2
12252,20,5219,5244;6112;12003,4015,1,0,2,0,3
12253,20,5220,6123,4015,0,0,1,0,1
12254,20,5221,6284;11700;11823,4015,2,0,1,0,3
12255,20,5222,6319;7138,4015,0,0,2,0,2
12256,20,5223,348,4015,0,0,1,0,1
12257,20,5224,6054;6404;11386;11676;11787;12007,4015,3,1,2,0,6
12258,20,5225,6492,4015,0,0,1,0,1
12259,20,5226,6531;11635;11904,4015,2,0,1,0,3
12260,20,5228,6605,4015,0,0,1,0,1
12261,20,5229,6628;7150,4015,0,0,2,0,2
12262,20,5230,1163;9499;11416;11537;11811;12026,4015,2,2,2,0,6
12263,20,5231,6555,4015,0,0,1,0,1
12264,20,5232,6953,4015,0,0,1,0,1
12265,20,5233,1774;6954;11828;12050,4015,2,0,2,0,4
12266,20,5234,3706,4015,0,0,0,1,1
12267,20,5235,6728;7050,4015,0,0,2,0,2
12268,20,5236,573;7062,4015,0,0,2,0,2
12269,20,5237,2654;7121;11919;11973,4015,2,0,2,0,4
12270,20,5238,765;7127;11169;11312,4015,0,2,2,0,4
12271,20,5239,439;7222,4015,0,0,2,0,2
12272,20,5240,7521;11366;11408;12027,4015,1,2,1,0,4
12273,20,5241,697,4015,0,0,1,0,1
12274,20,5244,2395;7777;11970,4015,1,0,2,0,3
12275,20,5245,7841,4015,0,0,0,1,1
12276,20,5246,7701;7843;11727,4015,1,0,2,0,3
12277,20,5247,7889;9776;11320;11795;11850,4015,2,1,2,0,5
12278,20,5249,8139,4015,0,0,1,0,1
12279,20,5250,7020;8149,4015,0,0,2,0,2
12280,20,5251,9895,4015,0,0,1,0,1
12281,20,5252,8248,4015,0,0,1,0,1
12282,20,5253,3386;8376,4015,0,0,2,0,2
12283,20,5254,2244;8382,4015,0,0,2,0,2
12284,20,5255,7621;8515,4015,0,0,2,0,2
12285,20,5257,8565,4015,0,0,1,0,1
12286,20,5258,8594,4015,0,0,0,1,1
12287,20,5259,8747,4015,0,0,1,0,1
12288,20,5260,1766;8932,4015,0,0,2,0,2
12289,20,5261,6603;8986;11622,4015,1,0,2,0,3
12290,20,5263,1649,4015,0,0,1,0,1
12291,20,5264,639;9069;11354,4015,0,1,2,0,3
12292,20,5266,877;2475;11290;11590;11930,4015,1,2,2,0,5
12293,20,5267,2008;9227;11713,4015,1,0,2,0,3
12294,20,5271,8292;9773;11805,4015,1,0,2,0,3
12295,20,5272,8650;9818;11606;11851,4015,2,0,2,0,4
12296,20,5273,3960,4380,0,0,1,0,1
12297,20,5275,5618,4380,0,0,0,1,1
12298,20,5277,674;4963;11251;11343;11577;12011,4380,1,3,2,0,6
12299,20,5279,3207,4380,0,0,1,0,1
12300,20,5281,4248,4380,0,0,0,1,1
12301,20,5282,2556,4380,0,0,1,0,1
12302,20,5283,1471;9940,4380,0,0,2,0,2
12303,20,5284,79;1477;11538;11822,4380,1,1,2,0,4
12304,20,5286,1787;3930;11339;11888,4380,1,1,2,0,4
12305,20,5287,1805,4380,0,0,1,0,1
12306,20,5289,4307;11656,4380,1,0,1,0,2
12307,20,5290,2100,4380,0,0,1,0,1
12308,20,5292,2880;9844,4380,0,0,2,0,2
12309,20,5294,3031,4380,0,0,0,1,1
12310,20,5296,3394;6797,4380,0,0,2,0,2
12311,20,5297,2273;3518,4380,0,0,2,0,2
12312,20,5298,2384;3520;11791,4380,1,0,2,0,3
12313,20,5301,1933;3730;11402;11652,4380,1,1,2,0,4
12314,20,5302,7237;7705,4380,0,0,2,0,2
12315,20,5303,1399;3994,4380,0,0,2,0,2
12316,20,5305,4021;7176;11325;11692;12075,4380,2,1,2,0,5
12317,20,5306,1990;3691;11844,4380,1,0,2,0,3
12318,20,5307,4271;5572,4380,0,0,2,0,2
12319,20,5308,2694,4380,0,0,1,0,1
12320,20,5310,4325,4380,0,0,0,1,1
12321,20,5311,3527;7669,4380,0,0,2,0,2
12322,20,5313,5166,4380,0,0,1,0,1
12323,20,5314,4726,4380,0,0,1,0,1
12324,20,5315,4899;4931,4380,0,0,2,0,2
12325,20,5317,5001;11318,4380,0,1,1,0,2
12326,20,5319,4285;7212;11772,4380,1,0,2,0,3
12327,20,5320,5615;11253;11723,4380,1,1,1,0,3
12328,20,5321,6171,4380,0,0,0,1,1
12329,20,5322,6246,4380,0,0,1,0,1
12330,20,5323,892;6289,4380,0,0,2,0,2
12331,20,5324,3045;6299,4380,0,0,2,0,2
12332,20,5325,6694;9621,4380,0,0,2,0,2
12333,20,5326,714;6857,4380,0,0,2,0,2
12334,20,5327,7145,4380,0,0,1,0,1
12335,20,5328,2816;7172;11836,4380,1,0,2,0,3
12336,20,5329,9168;9901,4380,0,0,1,1,2
12337,20,5331,7604;7698;11292;11404,4380,0,2,2,0,4
12338,20,5334,1418,4380,0,0,1,0,1
12339,20,5336,5968;8020;11515;11943,4380,1,1,2,0,4
12340,20,5337,9369,4380,0,0,1,0,1
12341,20,5340,8443,4380,0,0,1,0,1
12342,20,5341,5248;8519;11329;11761,4380,1,1,2,0,4
12343,20,5342,8657,4380,0,0,1,0,1
12344,20,5343,1775,4380,0,0,1,0,1
12345,20,5344,7323;8688;11473;11532;11607,4380,1,2,2,0,5
12346,20,5345,8808;9230;11993,4380,1,0,2,0,3
12347,20,5346,247;8845;11939,4380,1,0,2,0,3
12348,20,5349,6881;9181,4380,0,0,2,0,2
12349,20,5351,5396;7499;11869;12069,4380,2,0,2,0,4
12350,20,5352,9401,4380,0,0,1,0,1
12351,20,5353,6198;9605,4380,0,0,2,0,2
12352,20,5355,2620;9666;11582;12047,4380,1,1,2,0,4
12353,20,5356,5936;9694,4380,0,0,2,0,2
12354,20,5357,7948;7986,4380,0,0,2,0,2
12355,20,5358,8625;9862,4380,0,0,1,1,2
12356,20,5359,7188;9929,4380,0,0,2,0,2
12357,20,5360,38;7419;11298;11767,4745,1,1,2,0,4
12358,20,5365,3753;12085,4745,1,0,1,0,2
12359,20,5367,724;6589,4745,0,0,2,0,2
12360,20,5368,838;7128;11305;11965,4745,1,1,2,0,4
12361,20,5370,902;7158;11497;11954,4745,1,1,2,0,4
12362,20,5371,3011,4745,0,0,1,0,1
12363,20,5372,5377;6652,4745,0,0,2,0,2
12364,20,5373,1301;6407,4745,0,0,2,0,2
12365,20,5375,1500;11326,4745,0,1,1,0,2
12366,20,5376,8679;9041,4745,0,0,2,0,2
12367,20,5377,1537;1726,4745,0,0,2,0,2
12368,20,5378,305;831,4745,0,0,2,0,2
12369,20,5379,2239;8520;12076,4745,1,0,2,0,3
12370,20,5380,3574;6718,4745,0,0,2,0,2
12371,20,5381,2342;5257,4745,0,0,2,0,2
12372,20,5382,2391,4745,0,0,0,1,1
12373,20,5383,4576;9225,4745,0,0,2,0,2
12374,20,5384,182;2581,4745,0,0,2,0,2
12375,20,5385,9009;9692,4745,0,0,2,0,2
12376,20,5386,6796,4745,0,0,1,0,1
12377,20,5388,8291,4745,0,0,1,0,1
12378,20,5389,837;3418,4745,0,0,2,0,2
12379,20,5390,3164;5741,4745,0,0,2,0,2
12380,20,5391,2294;6625,4745,0,0,2,0,2
12381,20,5392,3234;3986;11602;11780,4745,2,0,2,0,4
12382,20,5393,698;7173,4745,0,0,2,0,2
12383,20,5394,2031;8649;12043,4745,1,0,2,0,3
12384,20,5395,1451;3530;11417;11639;12015,4745,2,1,2,0,5
12385,20,5396,3615;9680,4745,0,0,2,0,2
12386,20,5397,3658,4745,0,0,1,0,1
12387,20,5398,3887;7695,4745,0,0,2,0,2
12388,20,5399,2789;3977;11401;11736,4745,1,1,2,0,4
12389,20,5401,4305,4745,0,0,0,1,1
12390,20,5402,706;3524,4745,0,0,2,0,2
12391,20,5403,4756;7893,4745,0,0,2,0,2
12392,20,5404,4908;8616,4745,0,0,2,0,2
12393,20,5405,7255,4745,0,0,1,0,1
12394,20,5407,5105;7554,4745,0,0,2,0,2
12395,20,5408,6229,4745,0,0,1,0,1
12396,20,5409,3161;5489,4745,0,0,2,0,2
12397,20,5410,6563,4745,0,0,0,1,1
12398,20,5411,3356;11528,4745,0,1,1,0,2
12399,20,5412,1287;2669,4745,0,0,2,0,2
12400,20,5413,5689;9482,4745,0,0,2,0,2
12401,20,5414,1890;9103,4745,0,0,2,0,2
12402,20,5415,1486;5779;11543;11895,4745,1,1,2,0,4
12403,20,5416,5789;5964,4745,0,0,2,0,2
12404,20,5418,3429;6110,4745,0,0,2,0,2
12405,20,5419,5202;6117;12129,4745,1,0,2,0,3
12406,20,5420,6331,4745,0,0,1,0,1
12407,20,5421,1441,4745,0,0,0,1,1
12408,20,5423,1353,4745,0,0,0,1,1
12409,20,5424,6773;6950;12125,4745,1,0,2,0,3
12410,20,5425,8083,4745,0,0,1,0,1
12411,20,5426,5442,4745,0,0,1,0,1
12412,20,5427,6904,4745,0,0,1,0,1
12413,20,5428,8590;11719,4745,1,0,1,0,2
12414,20,5429,5409;7012;11521;11841,4745,1,1,2,0,4
12415,20,5430,7265;9490,4745,0,0,2,0,2
12416,20,5431,1966;7561;11379;11689;11834,4745,2,1,2,0,5
12417,20,5432,3003;7912,4745,0,0,2,0,2
12418,20,5433,7993,4745,0,0,1,0,1
12419,20,5434,7994;9245,4745,0,0,2,0,2
12420,20,5435,3078;8037;11989,4745,1,0,2,0,3
12421,20,5436,2776;7505,4745,0,0,2,0,2
12422,20,5437,8307,4745,0,0,1,0,1
12423,20,5438,1698;8638;11406;11618;11745,4745,2,1,2,0,5
12424,20,5440,6530;8796,4745,0,0,2,0,2
12425,20,5441,2799;8798,4745,0,0,2,0,2
12426,20,5442,5735;8799;11729;11920,4745,2,0,2,0,4
12427,20,5443,8803,4745,0,0,1,0,1
12428,20,5444,9066,4745,0,0,1,0,1
12429,20,5445,9419;9608;12037,4745,1,0,2,0,3
12430,20,5446,7990;9783,4745,0,0,2,0,2
12431,20,5447,658,4745,0,0,1,0,1
12432,20,5448,5535;9857,4745,0,0,2,0,2
12433,20,5450,5211,5110,0,0,1,0,1
12434,20,5451,330,5110,0,0,1,0,1
12435,20,5452,388,5110,0,0,1,0,1
12436,20,5453,6363;8494;11454;11714,5110,1,1,2,0,4
12437,20,5454,444;5260;11432;11786;11963,5110,2,1,2,0,5
12438,20,5455,497,5110,0,0,1,0,1
12439,20,5456,540,5110,0,0,0,1,1
12440,20,5457,5322,5110,0,0,1,0,1
12441,20,5458,709;7431,5110,0,0,2,0,2
12442,20,5459,920;8894,5110,0,0,2,0,2
12443,20,5460,931,5110,0,0,1,0,1
12444,20,5461,958;8827;11847;12031,5110,2,0,2,0,4
12445,20,5462,1161;2364;12059,5110,1,0,2,0,3
12446,20,5463,1207,5110,0,0,1,0,1
12447,20,5465,1364;2784;11565;12046,5110,1,1,2,0,4
12448,20,5466,3312;9228,5110,0,0,2,0,2
12449,20,5467,1427;4690,5110,0,0,2,0,2
12450,20,5468,1450;1973;11887,5110,1,0,2,0,3
12451,20,5469,1525;4268,5110,0,0,2,0,2
12452,20,5472,1771;5072;11524,5110,0,1,2,0,3
12453,20,5474,2366;8167,5110,0,0,2,0,2
12454,20,5475,2497,5110,0,0,1,0,1
12455,20,5476,2815;9485,5110,0,0,2,0,2
12456,20,5478,5201;6631;11890,5110,1,0,2,0,3
12457,20,5480,3469;4594,5110,0,0,2,0,2
12458,20,5481,3727;6885,5110,0,0,2,0,2
12459,20,5482,3796,5110,0,0,0,1,1
12460,20,5483,3951;4062;11595;11747,5110,2,0,2,0,4
12461,20,5484,1179,5110,0,0,1,0,1
12462,20,5485,7493;8711,5110,0,0,2,0,2
12463,20,5486,4374;5928,5110,0,0,2,0,2
12464,20,5487,4435;5395,5110,0,0,2,0,2
12465,20,5488,2547;4333,5110,0,0,2,0,2
12466,20,5489,4517,5110,0,0,1,0,1
12467,20,5490,4581;6296;11601,5110,1,0,2,0,3
12468,20,5491,2063;4990;11549;11923,5110,1,1,2,0,4
12469,20,5492,3376;5002;11707;12012;12130,5110,3,0,2,0,5
12470,20,5494,4016;5113,5110,0,0,2,0,2
12471,20,5496,1706;9651;11623;11912,5110,2,0,2,0,4
12472,20,5497,5553,5110,0,0,1,0,1
12473,20,5498,953;5630;11581,5110,0,1,2,0,3
12474,20,5499,5100;5662;12022,5110,1,0,2,0,3
12475,20,5500,4140;9573,5110,0,0,2,0,2
12476,20,5501,5809;8100,5110,0,0,2,0,2
12477,20,5502,6240,5110,0,0,1,0,1
12478,20,5506,4070;6494,5110,0,0,2,0,2
12479,20,5507,4151;9827;11525;11994,5110,1,1,2,0,4
12480,20,5508,4379;9040,5110,0,0,2,0,2
12481,20,5509,6959,5110,0,0,1,0,1
12482,20,5510,7027,5110,0,0,1,0,1
12483,20,5511,3956;7043,5110,0,0,2,0,2
12484,20,5512,9829,5110,0,0,1,0,1
12485,20,5513,1339;7672,5110,0,0,2,0,2
12486,20,5515,9339,5110,0,0,1,0,1
12487,20,5516,8746;9561;11856,5110,1,0,2,0,3
12488,20,5519,1115,5110,0,0,1,0,1
12489,20,5520,8693,5110,0,0,0,1,1
12490,20,5522,3155,5110,0,0,1,0,1
12491,20,5523,2165;2377,5110,0,0,1,1,2
12492,20,5524,8912,5110,0,0,1,0,1
12493,20,5526,8585,5110,0,0,0,1,1
12494,20,5528,5459;9332,5110,0,0,2,0,2
12495,20,5529,2516;9355,5110,0,0,2,0,2
12496,20,5530,2983;9459,5110,0,0,2,0,2
12497,20,5531,7244,5110,0,0,1,0,1
12498,20,5532,9557,5110,0,0,0,1,1
12499,20,5533,3573;9649;11798;11948,5110,2,0,2,0,4
12500,20,5534,431;9693,5110,0,0,2,0,2
12501,20,5535,3981,5110,0,0,1,0,1
12502,20,5536,113;3921;11677,5475,1,0,2,0,3
12503,20,5537,1064;3477,5475,0,0,2,0,2
12504,20,5539,381,5475,0,0,1,0,1
12505,20,5540,445,5475,0,0,1,0,1
12506,20,5541,462,5475,0,0,1,0,1
12507,20,5542,798;2737,5475,0,0,2,0,2
12508,20,5543,6495,5475,0,0,1,0,1
12509,20,5544,949,5475,0,0,1,0,1
12510,20,5546,967,5475,0,0,1,0,1
12511,20,5547,972,5475,0,0,0,1,1
12512,20,5548,1224,5475,0,0,0,1,1
12513,20,5549,1343;8406,5475,0,0,2,0,2
12514,20,5550,37;2394;12113,5475,1,0,2,0,3
12515,20,5551,1467,5475,0,0,1,0,1
12516,20,5552,5234,5475,0,0,1,0,1
12517,20,5553,1544;3945,5475,0,0,2,0,2
12518,20,5554,1894,5475,0,0,1,0,1
12519,20,5555,1670;6127,5475,0,0,2,0,2
12520,20,5556,3738,5475,0,0,1,0,1
12521,20,5557,1738,5475,0,0,0,1,1
12522,20,5558,5021;5114,5475,0,0,2,0,2
12523,20,5560,574;1929,5475,0,0,2,0,2
12524,20,5561,1930;3367;11763,5475,1,0,2,0,3
12525,20,5562,1979,5475,0,0,1,0,1
12526,20,5563,2093,5475,0,0,1,0,1
12527,20,5564,2175;8038,5475,0,0,2,0,2
12528,20,5565,2321;7072;11685,5475,1,0,2,0,3
12529,20,5566,2369;4057,5475,0,0,2,0,2
12530,20,5567,2498;11957,5475,1,0,1,0,2
12531,20,5568,2543,5475,0,0,1,0,1
12532,20,5569,2667;8086,5475,0,0,2,0,2
12533,20,5570,2842;3458;11958;12110,5475,2,0,2,0,4
12534,20,5572,1522;2996;11845,5475,1,0,2,0,3
12535,20,5573,212;3120;11662;11985,5475,2,0,2,0,4
12536,20,5574,3121;7509,5475,0,0,2,0,2
12537,20,5575,3215;9637,5475,0,0,2,0,2
12538,20,5576,470;1608;12018,5475,1,0,2,0,3
12539,20,5577,9086,5475,0,0,1,0,1
12540,20,5578,2176;3359;11584;11734,5475,1,1,2,0,4
12541,20,5579,3503;6809,5475,0,0,2,0,2
12542,20,5580,2976;3578;11640;11753;12101,5475,3,0,2,0,5
12543,20,5581,3710;6791,5475,0,0,2,0,2
12544,20,5582,3885,5475,0,0,1,0,1
12545,20,5583,3891,5475,0,0,1,0,1
12546,20,5584,5245;7964,5475,0,0,2,0,2
12547,20,5585,3963;5047,5475,0,0,2,0,2
12548,20,5586,4085;9285,5475,0,0,2,0,2
12549,20,5587,4148,5475,0,0,1,0,1
12550,20,5588,1751;4279,5475,0,0,2,0,2
12551,20,5590,4501,5475,0,0,1,0,1
12552,20,5592,4587;11557;11643,5475,1,1,1,0,3
12553,20,5594,4601,5475,0,0,1,0,1
12554,20,5595,4700;11570,5475,0,1,1,0,2
12555,20,5596,4832;7016,5475,0,0,2,0,2
12556,20,5597,4850;7818,5475,0,0,2,0,2
12557,20,5598,4913,5475,0,0,0,1,1
12558,20,5599,5156;5174,5475,0,0,2,0,2
12559,20,5600,5164,5475,0,0,0,1,1
12560,20,5601,5554;9501,5475,0,0,2,0,2
12561,20,5602,1428;5659;11629,5475,1,0,2,0,3
12562,20,5604,5888,5475,0,0,1,0,1
12563,20,5605,4955;5892;11655,5475,1,0,2,0,3
12564,20,5606,5990,5475,0,0,0,1,1
12565,20,5607,4401;4950,5475,0,0,2,0,2
12566,20,5608,4542;6133,5475,0,0,2,0,2
12567,20,5610,6202;6839;11654;11978,5475,2,0,2,0,4
12568,20,5611,2123;6261;12045,5475,1,0,2,0,3
12569,20,5614,2434;6624,5475,0,0,2,0,2
12570,20,5615,1499;7340,5475,0,0,2,0,2
12571,20,5616,6902,5475,0,0,1,0,1
12572,20,5617,6949,5475,0,0,1,0,1
12573,20,5618,6466;7024,5475,0,0,2,0,2
12574,20,5619,3046,5475,0,0,1,0,1
12575,20,5620,3156;7373,5475,0,0,2,0,2
12576,20,5621,7426,5475,0,0,1,0,1
12577,20,5623,4153;7638,5475,0,0,2,0,2
12578,20,5624,1387;7723,5475,0,0,2,0,2
12579,20,5625,4669;7794,5475,0,0,2,0,2
12580,20,5626,55;8013,5475,0,0,2,0,2
12581,20,5627,8047,5475,0,0,1,0,1
12582,20,5628,8010;8065;12108,5475,1,0,2,0,3
12583,20,5629,2783;9816,5475,0,0,2,0,2
12584,20,5630,169;8302;12062,5475,1,0,2,0,3
12585,20,5632,6847;8483,5475,0,0,2,0,2
12586,20,5633,6292;8633,5475,0,0,2,0,2
12587,20,5634,8641;8826;11830,5475,1,0,2,0,3
12588,20,5635,5241;6088,5475,0,0,2,0,2
12589,20,5636,9006,5475,0,0,1,0,1
12590,20,5637,4544;9042,5475,0,0,2,0,2
12591,20,5638,9224,5475,0,0,1,0,1
12592,20,5639,3337;9400;11935,5475,1,0,2,0,3
12593,20,5641,5777,5475,0,0,1,0,1
12594,20,5642,440;9664,5475,0,0,2,0,2
12595,20,5643,9689,5475,0,0,1,0,1
12596,20,5644,8556;11648;11946,5475,2,0,1,0,3
12597,20,5645,7223,5475,0,0,1,0,1
12598,20,5647,631;9853;11928,5475,1,0,2,0,3
12599,20,5648,9976;11784,5475,1,0,1,0,2
12600,20,5649,11;612,5840,0,0,2,0,2
12601,20,5650,2464,5840,0,0,1,0,1
12602,20,5651,3141,5840,0,0,1,0,1
12603,20,5652,120;4851,5840,0,0,2,0,2
12604,20,5654,272,5840,0,0,1,0,1
12605,20,5655,840,5840,0,0,1,0,1
12606,20,5656,378;1847;11732;11862;12086,5840,3,0,2,0,5
12607,20,5657,1366;8490,5840,0,0,2,0,2
12608,20,5658,8743,5840,0,0,1,0,1
12609,20,5659,5529,5840,0,0,0,1,1
12610,20,5660,863,5840,0,0,1,0,1
12611,20,5661,1045;10030,5840,0,0,2,0,2
12612,20,5662,74,5840,0,0,1,0,1
12613,20,5663,2234;4617,5840,0,0,2,0,2
12614,20,5664,6183;6719,5840,0,0,2,0,2
12615,20,5665,1267;6823;11749;12079,5840,2,0,2,0,4
12616,20,5667,1485;1746;11926,5840,1,0,2,0,3
12617,20,5668,1572;8110,5840,0,0,2,0,2
12618,20,5669,1727;7709;11646;12005,5840,2,0,2,0,4
12619,20,5670,163;1770;12082,5840,1,0,2,0,3
12620,20,5671,7625,5840,0,0,0,1,1
12621,20,5672,2010,5840,0,0,1,0,1
12622,20,5673,2180,5840,0,0,1,0,1
12623,20,5674,2233;2523;11746;11999,5840,2,0,2,0,4
12624,20,5676,2268,5840,0,0,1,0,1
12625,20,5677,2360;3233;12084,5840,1,0,2,0,3
12626,20,5678,2365;10105,5840,0,0,2,0,2
12627,20,5680,3824,5840,0,0,0,1,1
12628,20,5681,3029;7634,5840,0,0,2,0,2
12629,20,5682,3125;9883,5840,0,0,2,0,2
12630,20,5683,3209;10012,5840,0,0,2,0,2
12631,20,5685,2271;3346;11873,5840,1,0,2,0,3
12632,20,5686,10040,5840,0,0,1,0,1
12633,20,5687,6309,5840,0,0,1,0,1
12634,20,5689,3146;12051,5840,1,0,1,0,2
12635,20,5690,2404;3968;11800,5840,1,0,2,0,3
12636,20,5691,4020;7278,5840,0,0,2,0,2
12637,20,5692,9854,5840,0,0,1,0,1
12638,20,5693,6850,5840,0,0,1,0,1
12639,20,5694,4317;8489,5840,0,0,2,0,2
12640,20,5696,8283,5840,0,0,1,0,1
12641,20,5697,4448;4752,5840,0,0,2,0,2
12642,20,5698,4755;9589;11672;11842,5840,2,0,2,0,4
12643,20,5699,4846;6601;12020,5840,1,0,2,0,3
12644,20,5700,4818,5840,0,0,1,0,1
12645,20,5701,5064;9056,5840,0,0,2,0,2
12646,20,5703,5227,5840,0,0,1,0,1
12647,20,5704,2300;5228;11668,5840,1,0,2,0,3
12648,20,5705,5310;10045,5840,0,0,2,0,2
12649,20,5706,5311;8409;11807,5840,1,0,2,0,3
12650,20,5707,5382;6905;11691,5840,1,0,2,0,3
12651,20,5708,5425,5840,0,0,1,0,1
12652,20,5709,5436;8612;11663;11910,5840,2,0,2,0,4
12653,20,5710,5565;7193,5840,0,0,2,0,2
12654,20,5711,5793;10113;11826;12118,5840,2,0,2,0,4
12655,20,5712,250;5805;12077,5840,1,0,2,0,3
12656,20,5714,5985;9454;11913;12033,5840,2,0,2,0,4
12657,20,5715,5998,5840,0,0,0,1,1
12658,20,5716,6114;10027,5840,0,0,2,0,2
12659,20,5717,6119,5840,0,0,1,0,1
12660,20,5718,6122,5840,0,0,1,0,1
12661,20,5720,6582;7596,5840,0,0,2,0,2
12662,20,5721,6668,5840,0,0,1,0,1
12663,20,5722,6699;7728;11728,5840,1,0,2,0,3
12664,20,5723,1987;6764;12064,5840,1,0,2,0,3
12665,20,5726,119;7197;11771;12126,5840,2,0,2,0,4
12666,20,5727,6222;7372,5840,0,0,2,0,2
12667,20,5728,6071;7383,5840,0,0,2,0,2
12668,20,5729,7474,5840,0,0,1,0,1
12669,20,5730,4479;9769,5840,0,0,2,0,2
12670,20,5732,786;7789,5840,0,0,2,0,2
12671,20,5734,9269,5840,0,0,1,0,1
12672,20,5735,8042,5840,0,0,1,0,1
12673,20,5736,7191,5840,0,0,1,0,1
12674,20,5737,334;8288,5840,0,0,2,0,2
12675,20,5738,5988;8317;11921;11972,5840,2,0,2,0,4
12676,20,5739,6571;8421,5840,0,0,2,0,2
12677,20,5740,9220,5840,0,0,1,0,1
12678,20,5741,3083;8449,5840,0,0,2,0,2
12679,20,5742,480;8643,5840,0,0,2,0,2
12680,20,5743,8659,5840,0,0,1,0,1
12681,20,5744,2245,5840,0,0,1,0,1
12682,20,5745,4855,5840,0,0,1,0,1
12683,20,5746,4945,5840,0,0,1,0,1
12684,20,5747,8967,5840,0,0,1,0,1
12685,20,5748,7316;9037;12109,5840,1,0,2,0,3
12686,20,5750,4748;9211,5840,0,0,2,0,2
12687,20,5751,9390,5840,0,0,1,0,1
12688,20,5754,2210;3725,5840,0,0,2,0,2
12689,20,5755,9511,5840,0,0,1,0,1
12690,20,5756,3010;6856,5840,0,0,2,0,2
12691,20,5757,9869,5840,0,0,0,1,1
12692,20,5758,8276,5840,0,0,1,0,1
12693,20,5759,9280,6205,0,0,1,0,1
12694,20,5761,242,6205,0,0,1,0,1
12695,20,5763,319;7765;11840,6205,1,0,2,0,3
12696,20,5764,386;10063;11956,6205,1,0,2,0,3
12697,20,5765,477;2370,6205,0,0,2,0,2
12698,20,5766,4385;5710;11755;12006,6205,2,0,2,0,4
12699,20,5767,803;6744,6205,0,0,2,0,2
12700,20,5768,886,6205,0,0,0,1,1
12701,20,5769,1507,6205,0,0,1,0,1
12702,20,5770,878;982;12058,6205,1,0,2,0,3
12703,20,5772,1134;9606;11945,6205,1,0,2,0,3
12704,20,5773,10049;11852,6205,1,0,1,0,2
12705,20,5774,1314;3201,6205,0,0,2,0,2
12706,20,5775,1697,6205,0,0,1,0,1
12707,20,5776,44;1837,6205,0,0,2,0,2
12708,20,5777,1980,6205,0,0,1,0,1
12709,20,5778,2053,6205,0,0,1,0,1
12710,20,5779,2168;7341;11907;12066,6205,2,0,2,0,4
12711,20,5781,2291;7068,6205,0,0,2,0,2
12712,20,5782,7168,6205,0,0,1,0,1
12713,20,5783,2316;3883,6205,0,0,2,0,2
12714,20,5784,6879,6205,0,0,1,0,1
12715,20,5785,2689;2738,6205,0,0,2,0,2
12716,20,5786,2690,6205,0,0,1,0,1
12717,20,5787,632;3136;11766;11925,6205,2,0,2,0,4
12718,20,5788,3163;6135,6205,0,0,2,0,2
12719,20,5789,3231;8493,6205,0,0,2,0,2
12720,20,5792,3320,6205,0,0,1,0,1
12721,20,5793,3375;4856,6205,0,0,2,0,2
12722,20,5794,1158;3420,6205,0,0,2,0,2
12723,20,5795,3591;7295,6205,0,0,2,0,2
12724,20,5796,3841;10112;11809,6205,1,0,2,0,3
12725,20,5798,3995;4147,6205,0,0,2,0,2
12726,20,5799,4154,6205,0,0,1,0,1
12727,20,5800,4218;4290,6205,0,0,2,0,2
12728,20,5801,9116,6205,0,0,1,0,1
12729,20,5802,4516,6205,0,0,1,0,1
12730,20,5803,4523;9197,6205,0,0,2,0,2
12731,20,5805,4689;8498;11947,6205,1,0,2,0,3
12732,20,5806,4757,6205,0,0,1,0,1
12733,20,5807,8423,6205,0,0,1,0,1
12734,20,5808,4867;9667;11964,6205,1,0,2,0,3
12735,20,5810,4952,6205,0,0,0,1,1
12736,20,5811,4991,6205,0,0,1,0,1
12737,20,5812,1369,6205,0,0,1,0,1
12738,20,5813,5184,6205,0,0,1,0,1
12739,20,5814,5297;7995,6205,0,0,2,0,2
12740,20,5815,5334,6205,0,0,0,1,1
12741,20,5816,5480;8877,6205,0,0,2,0,2
12742,20,5817,5601,6205,0,0,1,0,1
12743,20,5818,1328;5642;11872,6205,1,0,2,0,3
12744,20,5819,379;9765,6205,0,0,2,0,2
12745,20,5820,5899;6982;11837,6205,1,0,2,0,3
12746,20,5821,3601;5901,6205,0,0,2,0,2
12747,20,5822,3366;5929,6205,0,0,2,0,2
12748,20,5824,3961;6192,6205,0,0,2,0,2
12749,20,5825,2729;6262,6205,0,0,2,0,2
12750,20,5826,2290,6205,0,0,1,0,1
12751,20,5827,5432,6205,0,0,1,0,1
12752,20,5828,4329;6341,6205,0,0,2,0,2
12753,20,5829,421,6205,0,0,1,0,1
12754,20,5830,6369;6632,6205,0,0,2,0,2
12755,20,5831,6375,6205,0,0,1,0,1
12756,20,5832,6461;9740,6205,0,0,2,0,2
12757,20,5833,8146,6205,0,0,1,0,1
12758,20,5834,6567,6205,0,0,1,0,1
12759,20,5835,423,6205,0,0,1,0,1
12760,20,5836,6807,6205,0,0,1,0,1
12761,20,5837,6838;7781;11980,6205,1,0,2,0,3
12762,20,5838,6861,6205,0,0,1,0,1
12763,20,5839,7037;10053,6205,0,0,2,0,2
12764,20,5840,2760;7040;11950,6205,1,0,2,0,3
12765,20,5841,7081,6205,0,0,1,0,1
12766,20,5842,1623;7097,6205,0,0,2,0,2
12767,20,5843,1313;7110;12041,6205,1,0,2,0,3
12768,20,5844,7174,6205,0,0,1,0,1
12769,20,5845,5328,6205,0,0,1,0,1
12770,20,5847,4092;7402;11863,6205,1,0,2,0,3
12771,20,5848,1478;7747,6205,0,0,2,0,2
12772,20,5849,7793,6205,0,0,1,0,1
12773,20,5850,3575;7927,6205,0,0,2,0,2
12774,20,5851,2920;8150,6205,0,0,2,0,2
12775,20,5852,6480;8237;11942,6205,1,0,2,0,3
12776,20,5853,2878,6205,0,0,1,0,1
12777,20,5854,8398;8511,6205,0,0,2,0,2
12778,20,5855,3417,6205,0,0,1,0,1
12779,20,5856,8687,6205,0,0,0,1,1
12780,20,5857,8885,6205,0,0,1,0,1
12781,20,5858,9102;9266;12132,6205,1,0,2,0,3
12782,20,5859,9210;9782;12049,6205,1,0,2,0,3
12783,20,5860,9082;9425,6205,0,0,2,0,2
12784,20,5861,2354;9756,6205,0,0,2,0,2
12785,20,5863,2766,6205,0,0,1,0,1
12786,20,5864,3517;5860,6205,0,0,2,0,2
12787,20,5866,3739,6205,0,0,1,0,1
12788,20,5867,93;10246,6570,0,0,2,0,2
12789,20,5869,562;10232;11932,6570,1,0,2,0,3
12790,20,5870,294;652,6570,0,0,2,0,2
12791,20,5871,760,6570,0,0,1,0,1
12792,20,5872,318,6570,0,0,1,0,1
12793,20,5873,7762,6570,0,0,1,0,1
12794,20,5874,1092;1136;12089,6570,1,0,2,0,3
12795,20,5876,136;1231,6570,0,0,2,0,2
12796,20,5877,1309,6570,0,0,1,0,1
12797,20,5878,1545;10122,6570,0,0,2,0,2
12798,20,5879,1564;2250,6570,0,0,2,0,2
12799,20,5880,8324,6570,0,0,1,0,1
12800,20,5881,1734,6570,0,0,0,1,1
12801,20,5882,2913,6570,0,0,1,0,1
12802,20,5883,5069,6570,0,0,1,0,1
12803,20,5884,2009,6570,0,0,1,0,1
12804,20,5885,2015;10187,6570,0,0,2,0,2
12805,20,5886,921;2356,6570,0,0,2,0,2
12806,20,5888,2818;10142,6570,0,0,2,0,2
12807,20,5889,2868,6570,0,0,1,0,1
12808,20,5890,2919;9139,6570,0,0,2,0,2
12809,20,5891,2963;6991;11849,6570,1,0,2,0,3
12810,20,5892,1144;2964,6570,0,0,2,0,2
12811,20,5893,960;3007,6570,0,0,2,0,2
12812,20,5894,1027;3058,6570,0,0,2,0,2
12813,20,5895,3118;7304;12088,6570,1,0,2,0,3
12814,20,5897,3145;3886,6570,0,0,2,0,2
12815,20,5898,3255,6570,0,0,1,0,1
12816,20,5899,3266;8698,6570,0,0,2,0,2
12817,20,5900,2322;8273,6570,0,0,2,0,2
12818,20,5901,2724;6091,6570,0,0,2,0,2
12819,20,5902,3472;10139;12034,6570,1,0,2,0,3
12820,20,5903,6060,6570,0,0,1,0,1
12821,20,5904,503,6570,0,0,1,0,1
12822,20,5905,1833,6570,0,0,1,0,1
12823,20,5906,4052,6570,0,0,1,0,1
12824,20,5907,4139,6570,0,0,1,0,1
12825,20,5908,4192,6570,0,0,0,1,1
12826,20,5909,4233,6570,0,0,1,0,1
12827,20,5910,6933;9930,6570,0,0,2,0,2
12828,20,5911,2980,6570,0,0,1,0,1
12829,20,5912,604,6570,0,0,1,0,1
12830,20,5913,4646,6570,0,0,1,0,1
12831,20,5915,4880,6570,0,0,1,0,1
12832,20,5916,9843,6570,0,0,1,0,1
12833,20,5917,4837,6570,0,0,1,0,1
12834,20,5919,5186;9688,6570,0,0,2,0,2
12835,20,5920,5479;6848,6570,0,0,2,0,2
12836,20,5921,5527,6570,0,0,1,0,1
12837,20,5922,5626,6570,0,0,1,0,1
12838,20,5923,5698;10089;11865,6570,1,0,2,0,3
12839,20,5924,5372;5711,6570,0,0,2,0,2
12840,20,5925,5723;6101,6570,0,0,2,0,2
12841,20,5926,5731,6570,0,0,1,0,1
12842,20,5927,5743;10020,6570,0,0,2,0,2
12843,20,5928,387,6570,0,0,1,0,1
12844,20,5929,6565,6570,0,0,1,0,1
12845,20,5930,6007,6570,0,0,1,0,1
12846,20,5931,1694,6570,0,0,1,0,1
12847,20,5932,5195,6570,0,0,1,0,1
12848,20,5933,4845;6233;12065,6570,1,0,2,0,3
12849,20,5934,6370;8703;12024,6570,1,0,2,0,3
12850,20,5935,6393;10214,6570,0,0,2,0,2
12851,20,5936,6483,6570,0,0,1,0,1
12852,20,5937,6520,6570,0,0,1,0,1
12853,20,5938,6581,6570,0,0,1,0,1
12854,20,5939,5707,6570,0,0,1,0,1
12855,20,5940,6593,6570,0,0,0,1,1
12856,20,5941,2295;7030,6570,0,0,2,0,2
12857,20,5942,6947,6570,0,0,1,0,1
12858,20,5943,4678,6570,0,0,1,0,1
12859,20,5944,3638,6570,0,0,1,0,1
12860,20,5945,5726,6570,0,0,1,0,1
12861,20,5946,774;7510,6570,0,0,2,0,2
12862,20,5947,7724;10283,6570,0,0,2,0,2
12863,20,5948,4677;7785,6570,0,0,2,0,2
12864,20,5949,7029;7939,6570,0,0,2,0,2
12865,20,5950,8120,6570,0,0,1,0,1
12866,20,5951,8266,6570,0,0,1,0,1
12867,20,5953,4476;8338,6570,0,0,2,0,2
12868,20,5954,2409,6570,0,0,1,0,1
12869,20,5955,8397,6570,0,0,1,0,1
12870,20,5956,8886;9722,6570,0,0,2,0,2
12871,20,5957,8578,6570,0,0,1,0,1
12872,20,5958,8646,6570,0,0,1,0,1
12873,20,5959,7394,6570,0,0,1,0,1
12874,20,5960,3055;8840,6570,0,0,2,0,2
12875,20,5961,711,6570,0,0,1,0,1
12876,20,5962,3185;9099,6570,0,0,2,0,2
12877,20,5963,9151;10158,6570,0,0,2,0,2
12878,20,5964,2870;9161,6570,0,0,2,0,2
12879,20,5965,7712;9162,6570,0,0,2,0,2
12880,20,5966,3794;9215;12056,6570,1,0,2,0,3
12881,20,5967,9996,6570,0,0,1,0,1
12882,20,5968,6693;9394,6570,0,0,2,0,2
12883,20,5969,78,6570,0,0,1,0,1
12884,20,5970,665;9450,6570,0,0,2,0,2
12885,20,5971,9563;10299,6570,0,0,2,0,2
12886,20,5972,9590,6570,0,0,1,0,1
12887,20,5973,9626;9655,6570,0,0,2,0,2
12888,20,5974,9682,6570,0,0,1,0,1
12889,20,5975,2264;9696,6570,0,0,2,0,2
12890,20,5976,2539;9710,6570,0,0,2,0,2
12891,20,5977,6056;9720,6570,0,0,2,0,2
12892,20,5978,4487,6570,0,0,1,0,1
12893,20,5979,9793,6570,0,0,1,0,1
12894,20,5981,18,6935,0,0,1,0,1
12895,20,5982,48;6986,6935,0,0,2,0,2
12896,20,5983,96;5379;12098,6935,1,0,2,0,3
12897,20,5984,153,6935,0,0,1,0,1
12898,20,5985,316;4630,6935,0,0,2,0,2
12899,20,5986,374,6935,0,0,0,1,1
12900,20,5987,616,6935,0,0,1,0,1
12901,20,5988,688;1826,6935,0,0,2,0,2
12902,20,5989,5966,6935,0,0,1,0,1
12903,20,5990,1050,6935,0,0,1,0,1
12904,20,5991,2703,6935,0,0,1,0,1
12905,20,5992,1093,6935,0,0,1,0,1
12906,20,5993,1111,6935,0,0,1,0,1
12907,20,5994,1637;7163,6935,0,0,2,0,2
12908,20,5995,1682;10155,6935,0,0,2,0,2
12909,20,5996,1782,6935,0,0,1,0,1
12910,20,5997,1904,6935,0,0,1,0,1
12911,20,5998,5798,6935,0,0,1,0,1
12912,20,5999,1940;2069,6935,0,0,2,0,2
12913,20,6000,2075,6935,0,0,1,0,1
12914,20,6001,2159;4704,6935,0,0,2,0,2
12915,20,6002,7879,6935,0,0,1,0,1
12916,20,6003,2242,6935,0,0,1,0,1
12917,20,6004,2410,6935,0,0,1,0,1
12918,20,6005,2494,6935,0,0,1,0,1
12919,20,6006,2606,6935,0,0,1,0,1
12920,20,6007,1238,6935,0,0,1,0,1
12921,20,6008,2995,6935,0,0,1,0,1
12922,20,6009,3521,6935,0,0,1,0,1
12923,20,6010,50;3776,6935,0,0,2,0,2
12924,20,6011,3820,6935,0,0,1,0,1
12925,20,6012,3907,6935,0,0,1,0,1
12926,20,6013,1195,6935,0,0,1,0,1
12927,20,6014,9242,6935,0,0,1,0,1
12928,20,6015,1422,6935,0,0,1,0,1
12929,20,6016,6536,6935,0,0,1,0,1
12930,20,6017,4833;8701,6935,0,0,2,0,2
12931,20,6018,4970,6935,0,0,1,0,1
12932,20,6019,7585,6935,0,0,1,0,1
12933,20,6020,5032;10081,6935,0,0,2,0,2
12934,20,6021,7177,6935,0,0,1,0,1
12935,20,6022,3341;5522,6935,0,0,2,0,2
12936,20,6023,5643;8998,6935,0,0,2,0,2
12937,20,6026,5983,6935,0,0,1,0,1
12938,20,6027,6051,6935,0,0,0,1,1
12939,20,6028,6155;7444,6935,0,0,2,0,2
12940,20,6029,6161,6935,0,0,0,1,1
12941,20,6030,3679;6208;12053,6935,1,0,2,0,3
12942,20,6031,6378,6935,0,0,1,0,1
12943,20,6032,6413,6935,0,0,1,0,1
12944,20,6033,5000,6935,0,0,1,0,1
12945,20,6034,8176;8214,6935,0,0,2,0,2
12946,20,6035,4257;6970,6935,0,0,2,0,2
12947,20,6036,9166,6935,0,0,1,0,1
12948,20,6037,7039;10031,6935,0,0,2,0,2
12949,20,6038,2032;7054,6935,0,0,2,0,2
12950,20,6039,7227,6935,0,0,1,0,1
12951,20,6040,5939,6935,0,0,1,0,1
12952,20,6041,7257,6935,0,0,1,0,1
12953,20,6042,4133,6935,0,0,1,0,1
12954,20,6043,7530;10367,6935,0,0,2,0,2
12955,20,6044,7591,6935,0,0,1,0,1
12956,20,6045,7599,6935,0,0,1,0,1
12957,20,6046,7714,6935,0,0,1,0,1
12958,20,6047,1252,6935,0,0,1,0,1
12959,20,6048,8358,6935,0,0,1,0,1
12960,20,6049,8553;10034,6935,0,0,2,0,2
12961,20,6050,8870,6935,0,0,1,0,1
12962,20,6051,8996,6935,0,0,1,0,1
12963,20,6052,277;9046,6935,0,0,2,0,2
12964,20,6053,8442,6935,0,0,1,0,1
12965,20,6054,9256,6935,0,0,1,0,1
12966,20,6055,2013;9370,6935,0,0,2,0,2
12967,20,6056,9520;10308,6935,0,0,2,0,2
12968,20,6057,9586,6935,0,0,1,0,1
12969,20,6058,9639,6935,0,0,1,0,1
12970,20,6059,9748,6935,0,0,1,0,1
12971,20,6060,9810,6935,0,0,1,0,1
12972,20,6061,9984,6935,0,0,1,0,1
12973,20,6062,2896;10003,6935,0,0,2,0,2
12974,20,6063,10061;10383,6935,0,0,2,0,2
12975,20,6064,10078;10328,6935,0,0,2,0,2
12976,20,6065,10086,6935,0,0,1,0,1
12977,20,6066,2085;10093,6935,0,0,2,0,2
12978,20,6067,10098;10186,6935,0,0,2,0,2
12979,20,6068,10115;10215,6935,0,0,2,0,2
12980,20,6069,94;10018,7300,0,0,2,0,2
12981,20,6070,4808,7300,0,0,1,0,1
12982,20,6071,493;6389,7300,0,0,2,0,2
12983,20,6072,512;3246,7300,0,0,2,0,2
12984,20,6073,545;10484,7300,0,1,1,0,2
12985,20,6074,546;10407,7300,0,0,2,0,2
12986,20,6075,1164,7300,0,0,1,0,1
12987,20,6076,1334;8372,7300,0,0,2,0,2
12988,20,6077,1461;10201,7300,0,0,2,0,2
12989,20,6078,1472;10287;12060,7300,1,0,2,0,3
12990,20,6079,1797;10218,7300,0,0,2,0,2
12991,20,6080,2114,7300,0,0,1,0,1
12992,20,6081,5301,7300,0,0,1,0,1
12993,20,6082,2442,7300,0,0,1,0,1
12994,20,6083,817,7300,0,0,1,0,1
12995,20,6085,2948;10084,7300,0,0,2,0,2
12996,20,6086,87,7300,0,0,1,0,1
12997,20,6087,3364,7300,0,0,1,0,1
12998,20,6088,3373,7300,0,0,1,0,1
12999,20,6089,3408,7300,0,0,1,0,1
13000,20,6090,3424;5917,7300,0,0,2,0,2
13001,20,6091,3476;6967;12120,7300,1,0,2,0,3
13002,20,6092,1630;3492,7300,0,0,2,0,2
13003,20,6093,3600;10069,7300,0,0,2,0,2
13004,20,6094,3669,7300,0,0,0,1,1
13005,20,6095,5441,7300,0,0,1,0,1
13006,20,6096,3713,7300,0,0,1,0,1
13007,20,6097,8163,7300,0,0,1,0,1
13008,20,6098,3802,7300,0,0,1,0,1
13009,20,6099,3807,7300,0,0,1,0,1
13010,20,6100,3952;10065,7300,0,0,2,0,2
13011,20,6101,4023;9923,7300,0,0,2,0,2
13012,20,6102,4106;10371,7300,0,0,2,0,2
13013,20,6103,4525,7300,0,0,1,0,1
13014,20,6104,4530,7300,0,0,1,0,1
13015,20,6105,9709,7300,0,0,1,0,1
13016,20,6106,4777,7300,0,0,1,0,1
13017,20,6107,4868;10480;12119,7300,1,1,1,0,3
13018,20,6108,4948,7300,0,0,1,0,1
13019,20,6109,1056;4959,7300,0,0,2,0,2
13020,20,6110,4997,7300,0,0,1,0,1
13021,20,6111,5097;8109,7300,0,0,2,0,2
13022,20,6113,5161;6002,7300,0,0,2,0,2
13023,20,6114,5170;6616,7300,0,0,2,0,2
13024,20,6115,3388;5402,7300,0,0,2,0,2
13025,20,6116,617,7300,0,0,1,0,1
13026,20,6117,5676,7300,0,0,1,0,1
13027,20,6118,5679,7300,0,0,1,0,1
13028,20,6119,5602,7300,0,0,1,0,1
13029,20,6120,5788,7300,0,0,1,0,1
13030,20,6121,5850;9654,7300,0,0,2,0,2
13031,20,6122,494;5930,7300,0,0,2,0,2
13032,20,6123,5980,7300,0,0,1,0,1
13033,20,6124,4909,7300,0,0,1,0,1
13034,20,6125,2967,7300,0,0,1,0,1
13035,20,6126,6490;10322,7300,0,0,2,0,2
13036,20,6127,6849;7098,7300,0,0,2,0,2
13037,20,6128,672,7300,0,0,1,0,1
13038,20,6129,5175,7300,0,0,1,0,1
13039,20,6130,2693,7300,0,0,1,0,1
13040,20,6131,7570,7300,0,0,1,0,1
13041,20,6132,7606,7300,0,0,1,0,1
13042,20,6133,4571;7622,7300,0,0,2,0,2
13043,20,6134,986;7809,7300,0,0,2,0,2
13044,20,6135,7816,7300,0,0,0,1,1
13045,20,6136,9911,7300,0,0,1,0,1
13046,20,6137,8121,7300,0,0,1,0,1
13047,20,6138,6525,7300,0,0,1,0,1
13048,20,6139,4770,7300,0,0,1,0,1
13049,20,6140,9257,7300,0,0,1,0,1
13050,20,6141,8749,7300,0,0,1,0,1
13051,20,6142,9562,7300,0,0,1,0,1
13052,20,6143,8805,7300,0,0,1,0,1
13053,20,6144,7815,7300,0,0,1,0,1
13054,20,6145,1991,7300,0,0,1,0,1
13055,20,6146,8987,7300,0,0,1,0,1
13056,20,6147,9003,7300,0,0,1,0,1
13057,20,6148,6754,7300,0,0,1,0,1
13058,20,6149,3177,7300,0,0,1,0,1
13059,20,6150,9398,7300,0,0,0,1,1
13060,20,6151,6153,7300,0,0,1,0,1
13061,20,6152,9684,7300,0,0,1,0,1
13062,20,6153,2594,7300,0,0,1,0,1
13063,20,6154,3834;9879,7300,0,0,2,0,2
13064,20,6155,9887;10386,7300,0,0,2,0,2
13065,20,6156,5197,7300,0,0,1,0,1
13066,20,6157,10016;10257,7300,0,0,2,0,2
13067,20,6158,3478,7300,0,0,1,0,1
13068,20,6159,10043;10475,7300,0,1,1,0,2
13069,20,6160,10050;10056,7300,0,0,2,0,2
13070,20,6161,8040;10055,7300,0,0,2,0,2
13071,20,6162,10073,7300,0,0,1,0,1
13072,20,6163,10064;10083,7300,0,0,2,0,2
13073,20,6164,10107;10439,7300,0,1,1,0,2
13074,20,6165,10121;10295,7300,0,0,2,0,2
13075,20,6166,10117;10132,7300,0,0,2,0,2
13076,20,6167,10175;10384,7300,0,0,2,0,2
13077,20,6168,10178;10329,7300,0,0,2,0,2
13078,20,6169,10203;10275,7300,0,0,2,0,2
13079,20,6170,228;10205,7300,0,0,2,0,2
13080,20,6171,10213;10224,7300,0,0,2,0,2
13081,20,6172,10217;10400,7300,0,0,2,0,2
13082,20,6173,10023;10219,7300,0,0,2,0,2
13083,30,0,1,0,0,0,0,1,1
13084,30,1,4;7390;10941;11962,0,0,1,3,0,4
13085,30,2,272;1571;12196;12482;12857,0,1,2,2,0,5
13086,30,3,14,0,0,0,0,1,1
13087,30,4,4337;7947;11703;11988,0,0,2,2,0,4
13088,30,7,24,0,0,0,0,1,1
13089,30,8,25,0,0,0,1,0,1
13090,30,9,27;28;29,0,0,0,1,2,3
13091,30,12,33,0,0,0,0,1,1
13092,30,13,39;10529;10728,0,0,0,3,0,3
13093,30,14,41,0,0,0,0,1,1
13094,30,15,46;47,0,0,0,0,2,2
13095,30,16,51;916;10137;10951,0,0,0,4,0,4
13096,30,17,53;56;57;5819,0,0,0,3,1,4
13097,30,18,58;4607;10410,0,0,0,1,2,3
13098,30,19,61;6642;13124;13296,0,2,0,2,0,4
13099,30,20,62;63;11812,0,0,1,1,1,3
13100,30,22,70;6007;10635;11039;11116,0,0,0,5,0,5
13101,30,23,73,0,0,0,0,1,1
13102,30,24,76;77,0,0,0,0,2,2
13103,30,25,9436;11937,0,0,1,1,0,2
13104,30,27,85;86,0,0,0,0,2,2
13105,30,29,91;92;10893;11163,0,0,0,3,1,4
13106,30,30,95;1306;10691,0,0,0,2,1,3
13107,30,33,99;100,0,0,0,1,1,2
13108,30,36,108;109,0,0,0,0,2,2
13109,30,37,115;3825,0,0,0,0,2,2
13110,30,38,117;118;11276;11319,0,0,0,4,0,4
13111,30,39,121,0,0,0,0,1,1
13112,30,40,124;125,0,0,0,0,2,2
13113,30,43,131;9034,0,0,0,1,1,2
13114,30,44,133,0,0,0,0,1,1
13115,30,47,140,0,0,0,0,1,1
13116,30,48,2463,0,0,0,0,1,1
13117,30,49,145,0,0,0,0,1,1
13118,30,53,154;9550;10307,0,0,0,3,0,3
13119,30,54,160;10092,0,0,0,2,0,2
13120,30,55,3627;5598,0,0,0,2,0,2
13121,30,56,164;576;10712;11098,0,0,0,4,0,4
13122,30,57,165;166,0,0,0,0,2,2
13123,30,58,170;4427,0,0,0,1,1,2
13124,30,59,172,0,0,0,0,1,1
13125,30,60,173,0,0,0,0,1,1
13126,30,61,180;2875;11686;12159,0,0,2,2,0,4
13127,30,63,189;1979;11626;11821;11981,0,0,3,2,0,5
13128,30,64,190;192,0,0,0,0,2,2
13129,30,65,193;194,0,0,0,1,1,2
13130,30,66,195;9410,0,0,0,2,0,2
13131,30,67,3755,0,0,0,0,1,1
13132,30,68,204,0,0,0,0,1,1
13133,30,69,206;207,0,0,0,1,1,2
13134,30,70,208,0,0,0,0,1,1
13135,30,71,209;2759,0,0,0,2,0,2
13136,30,73,214;215,0,0,0,0,2,2
13137,30,74,221;3903,0,0,0,0,2,2
13138,30,77,226;227,0,0,0,0,2,2
13139,30,78,230;231,0,0,0,0,2,2
13140,30,79,234;235,0,0,0,0,2,2
13141,30,80,238,0,0,0,0,1,1
13142,30,81,241,0,0,0,0,1,1
13143,30,82,243;244,0,0,0,1,1,2
13144,30,83,246,0,0,0,0,1,1
13145,30,85,252,0,0,0,0,1,1
13146,30,88,257,0,0,0,0,1,1
13147,30,89,816,0,0,0,0,1,1
13148,30,90,261,0,0,0,0,1,1
13149,30,93,268,0,0,0,1,0,1
13150,30,94,269,0,0,0,0,1,1
13151,30,99,281;283,0,0,0,0,2,2
13152,30,100,285,0,0,0,0,1,1
13153,30,101,287,0,0,0,0,1,1
13154,30,102,288,0,0,0,0,1,1
13155,30,104,295,0,0,0,0,1,1
13156,30,105,5510,0,0,0,0,1,1
13157,30,107,301;3705,0,0,0,0,2,2
13158,30,109,304;306,0,0,0,0,2,2
13159,30,110,311,0,0,0,0,1,1
13160,30,112,320;1039,0,0,0,1,1,2
13161,30,113,322,0,0,0,0,1,1
13162,30,118,332;2314,0,0,0,1,1,2
13163,30,123,343,0,0,0,0,1,1
13164,30,124,344;345,0,0,0,0,2,2
13165,30,125,346,0,0,0,0,1,1
13166,30,127,352;2748;11002,0,0,0,3,0,3
13167,30,128,354;11234,0,0,0,2,0,2
13168,30,129,358;359,0,0,0,0,2,2
13169,30,130,362;8602,0,0,0,2,0,2
13170,30,131,364,0,0,0,1,0,1
13171,30,132,366;3661;10863,0,0,0,2,1,3
13172,30,137,484;2331,0,0,0,0,2,2
13173,30,138,382;8031,0,0,0,2,0,2
13174,30,139,384;385,0,0,0,1,1,2
13175,30,140,5755;8879;11066,0,0,0,3,0,3
13176,30,141,389,0,0,0,0,1,1
13177,30,142,4408,0,0,0,0,1,1
13178,30,143,394,0,0,0,0,1,1
13179,30,144,396;11371;11556,0,0,1,2,0,3
13180,30,145,398,0,0,0,0,1,1
13181,30,146,400,0,0,0,0,1,1
13182,30,147,401;1424;10831;11403,0,0,1,3,0,4
13183,30,148,403,0,0,0,0,1,1
13184,30,151,406;411,0,0,0,1,1,2
13185,30,152,412,0,0,0,0,1,1
13186,30,156,418,0,0,0,0,1,1
13187,30,157,422,0,0,0,0,1,1
13188,30,158,426;1297,0,0,0,0,2,2
13189,30,159,427;428,0,0,0,2,0,2
13190,30,160,429,0,0,0,0,1,1
13191,30,162,435;11853,0,0,1,1,0,2
13192,30,163,438,0,0,0,0,1,1
13193,30,164,441,0,0,0,0,1,1
13194,30,165,446,0,0,0,0,1,1
13195,30,166,7557,0,0,0,0,1,1
13196,30,167,452;10745,0,0,0,2,0,2
13197,30,168,453;454,0,0,0,0,2,2
13198,30,169,460,0,0,0,1,0,1
13199,30,171,464;465,0,0,0,0,2,2
13200,30,173,3238;8473;11986;12648,0,0,2,2,0,4
13201,30,174,472,0,0,0,0,1,1
13202,30,176,6937,0,0,0,0,1,1
13203,30,178,486;487;488;756;2099;2555;10108;12414,0,0,1,7,0,8
13204,30,179,491;492;10894;11502,0,0,1,2,1,4
13205,30,181,496,0,0,0,0,1,1
13206,30,183,500;6198;11104;12013,0,0,1,3,0,4
13207,30,184,502;10422;11190,0,0,0,3,0,3
13208,30,185,505;9616,0,0,0,2,0,2
13209,30,188,509;510,0,0,0,0,2,2
13210,30,191,7559,0,0,0,0,1,1
13211,30,194,531;9288,0,0,0,1,1,2
13212,30,195,532;1463,0,0,0,0,2,2
13213,30,197,3912;7514,0,0,0,0,2,2
13214,30,198,539,0,0,0,0,1,1
13215,30,199,541;6315,0,0,0,0,2,2
13216,30,200,543,0,0,0,0,1,1
13217,30,202,551,0,0,0,0,1,1
13218,30,203,554;6761;10593;11248,0,0,0,4,0,4
13219,30,207,565;568;6413;9356;11871;12545,0,0,2,4,0,6
13220,30,208,569;7268,0,0,0,0,2,2
13221,30,216,581;582,0,0,0,2,0,2
13222,30,219,591,0,0,0,0,1,1
13223,30,220,595;596,0,0,0,0,2,2
13224,30,223,601;602,0,0,0,0,2,2
13225,30,224,605,0,0,0,0,1,1
13226,30,226,971;2459,0,0,0,0,2,2
13227,30,227,610,0,0,0,0,1,1
13228,30,228,614;615,0,0,0,0,2,2
13229,30,230,620;4407,0,0,0,0,2,2
13230,30,231,622;12570,0,0,1,1,0,2
13231,30,233,624;626,0,0,0,1,1,2
13232,30,235,629;10774;10943,0,0,0,3,0,3
13233,30,236,634,0,0,0,0,1,1
13234,30,240,644;10638;11072,0,0,0,3,0,3
13235,30,241,647,0,0,0,0,1,1
13236,30,245,656,0,0,0,0,1,1
13237,30,246,9833,0,0,0,1,0,1
13238,30,247,660,0,0,0,0,1,1
13239,30,251,669;5509,0,0,0,0,2,2
13240,30,253,671,0,0,0,0,1,1
13241,30,254,675;676,0,0,0,1,1,2
13242,30,255,678,0,0,0,0,1,1
13243,30,256,683,0,0,0,0,1,1
13244,30,257,687,0,0,0,0,1,1
13245,30,258,689;9242,0,0,0,2,0,2
13246,30,262,694;9385,0,0,0,0,2,2
13247,30,265,700,0,0,0,0,1,1
13248,30,266,703,0,0,0,0,1,1
13249,30,268,3877,0,0,0,0,1,1
13250,30,269,710,0,0,0,0,1,1
13251,30,271,666;715,0,0,0,0,2,2
13252,30,272,717,0,0,0,0,1,1
13253,30,274,722;1809;11459,0,0,1,2,0,3
13254,30,275,725,0,0,0,0,1,1
13255,30,276,729,0,0,0,0,1,1
13256,30,280,740;10169;12998,0,1,0,2,0,3
13257,30,281,741;742,0,0,0,0,2,2
13258,30,284,747,0,0,0,0,1,1
13259,30,286,750,0,0,0,0,1,1
13260,30,289,757;758,0,0,0,1,1,2
13261,30,291,4861;4889,0,0,0,2,0,2
13262,30,295,766;767,0,0,0,0,2,2
13263,30,298,775;2561,0,0,0,0,2,2
13264,30,300,782,0,0,0,1,0,1
13265,30,302,8259,0,0,0,0,1,1
13266,30,303,789;8361,0,0,0,0,2,2
13267,30,304,794;795;3699;4487;4649;8747;12189;12229,0,0,2,6,0,8
13268,30,305,796;7661,0,0,0,1,1,2
13269,30,306,800;1945;11340,0,0,0,3,0,3
13270,30,308,807,0,0,0,0,1,1
13271,30,309,808,0,0,0,0,1,1
13272,30,310,812;813,0,0,0,1,1,2
13273,30,313,818;5690,0,0,0,2,0,2
13274,30,314,820;1679,0,0,0,2,0,2
13275,30,315,821;822,0,0,0,0,2,2
13276,30,317,135;829,0,0,0,2,0,2
13277,30,319,832,0,0,0,0,1,1
13278,30,321,835;836,0,0,0,0,2,2
13279,30,324,847;2441,0,0,0,2,0,2
13280,30,325,849,0,0,0,0,1,1
13281,30,327,854;855,0,0,0,1,1,2
13282,30,329,858;5094,0,0,0,1,1,2
13283,30,330,861;7454,0,0,0,0,2,2
13284,30,332,868;869;10751,0,0,0,2,1,3
13285,30,334,876,0,0,0,1,0,1
13286,30,335,9878,0,0,0,1,0,1
13287,30,336,881;882,0,0,0,0,2,2
13288,30,340,894;2674,0,0,0,0,2,2
13289,30,342,899,0,0,0,0,1,1
13290,30,343,905,0,0,0,0,1,1
13291,30,344,906;907,0,0,0,0,2,2
13292,30,347,912,0,0,0,0,1,1
13293,30,348,914;7109,0,0,0,0,2,2
13294,30,352,924;925,0,0,0,1,1,2
13295,30,353,928,0,0,0,0,1,1
13296,30,354,930;8984;10749;11052;12252,0,0,1,4,0,5
13297,30,356,937,0,0,0,0,1,1
13298,30,358,942;944,0,0,0,1,1,2
13299,30,360,947,0,0,0,0,1,1
13300,30,361,948;952;10901,0,0,0,3,0,3
13301,30,362,955,0,0,0,0,1,1
13302,30,364,30,0,0,0,0,1,1
13303,30,365,965;966,0,0,0,1,1,2
13304,30,371,991;8104,0,0,0,0,2,2
13305,30,373,995,0,0,0,0,1,1
13306,30,375,998,0,0,0,0,1,1
13307,30,376,1000;2967;11901,0,0,1,2,0,3
13308,30,378,1005,0,0,0,0,1,1
13309,30,382,1015,0,0,0,0,1,1
13310,30,387,1025;3391,0,0,0,1,1,2
13311,30,388,1028;1029,0,0,0,0,2,2
13312,30,390,737;1036,0,0,0,0,2,2
13313,30,393,1044,0,0,0,1,0,1
13314,30,394,1046;9576,0,0,0,0,2,2
13315,30,395,1048,0,0,0,0,1,1
13316,30,397,1057,0,0,0,0,1,1
13317,30,398,1058;3444,0,0,0,0,2,2
13318,30,400,1063;8480,0,0,0,0,2,2
13319,30,401,1066,0,0,0,0,1,1
13320,30,403,1069;7299,0,0,0,0,2,2
13321,30,406,1076;1077,0,0,0,0,2,2
13322,30,409,1081,0,0,0,0,1,1
13323,30,410,1082;6245;10725,0,0,0,3,0,3
13324,30,411,1083;12073,0,0,1,1,0,2
13325,30,412,1085,0,0,0,0,1,1
13326,30,413,9147,0,0,0,0,1,1
13327,30,414,1088;1089,0,0,0,0,2,2
13328,30,415,1090,0,0,0,0,1,1
13329,30,416,1094,0,0,0,0,1,1
13330,30,418,1102;8188,0,0,0,0,2,2
13331,30,420,1106;1107;1181,0,0,0,3,0,3
13332,30,422,1110,0,0,0,0,1,1
13333,30,423,1112,0,0,0,0,1,1
13334,30,424,1114,0,0,0,0,1,1
13335,30,425,1117,0,0,0,0,1,1
13336,30,428,1124,0,0,0,0,1,1
13337,30,430,1129;1130,0,0,0,1,1,2
13338,30,433,1135;5341,0,0,0,0,2,2
13339,30,434,9613,0,0,0,0,1,1
13340,30,435,5845,0,0,0,0,1,1
13341,30,436,1146,0,0,0,0,1,1
13342,30,437,1152;5742;12920,0,1,0,2,0,3
13343,30,439,1156,0,0,0,0,1,1
13344,30,440,1160,0,0,0,0,1,1
13345,30,441,1168,0,0,0,0,1,1
13346,30,444,1173,0,0,0,0,1,1
13347,30,445,1176,0,0,0,1,0,1
13348,30,447,4088;9511;11133,0,0,0,3,0,3
13349,30,449,1182;8981,0,0,0,0,2,2
13350,30,451,1185;1186,0,0,0,1,1,2
13351,30,453,1190;1192;10809;11134,0,0,0,4,0,4
13352,30,455,1196,0,0,0,0,1,1
13353,30,456,1198;4938;11109;11285,0,0,0,4,0,4
13354,30,457,1201,0,0,0,0,1,1
13355,30,461,1211,0,0,0,1,0,1
13356,30,462,1215,0,0,0,0,1,1
13357,30,463,6474,0,0,0,0,1,1
13358,30,464,1220;1221,0,0,0,0,2,2
13359,30,465,1222,0,0,0,0,1,1
13360,30,466,1223;3452,0,0,0,0,2,2
13361,30,467,1226;1227;4429,0,0,0,0,3,3
13362,30,468,3993,0,0,0,0,1,1
13363,30,470,1234,0,0,0,0,1,1
13364,30,472,1240;1241,0,0,0,0,2,2
13365,30,477,1258,0,0,0,0,1,1
13366,30,478,1260;11359;11464;12559;13203,0,1,2,2,0,5
13367,30,479,1262,0,0,0,0,1,1
13368,30,480,1266,0,0,0,1,0,1
13369,30,481,1269,0,0,0,0,1,1
13370,30,483,1275;1276,0,0,0,1,1,2
13371,30,484,1277;1278,0,0,0,0,2,2
13372,30,487,321;1283,0,0,0,2,0,2
13373,30,488,1285;7429;11420;11522,0,0,2,2,0,4
13374,30,491,1293,0,0,0,0,1,1
13375,30,493,1303;1304,0,0,0,1,1,2
13376,30,496,1311;1312,0,0,0,0,2,2
13377,30,497,1315;1316,0,0,0,1,1,2
13378,30,498,1320,0,0,0,1,0,1
13379,30,500,1323;1324,0,0,0,1,1,2
13380,30,502,1327;3565,0,0,0,0,2,2
13381,30,503,1329;3441,0,0,0,1,1,2
13382,30,504,1330;4117,0,0,0,0,2,2
13383,30,507,1338,0,0,0,1,0,1
13384,30,508,1341,0,0,0,0,1,1
13385,30,509,1342,0,0,0,0,1,1
13386,30,510,1347,0,0,0,0,1,1
13387,30,513,1359;8111;13009,0,1,0,2,0,3
13388,30,514,1361;6266,0,0,0,0,2,2
13389,30,515,1365;3043;10783;11451,0,0,1,3,0,4
13390,30,518,1373;10120,0,0,0,2,0,2
13391,30,519,4925;8864;10844;11560;12115,0,0,2,3,0,5
13392,30,522,1382,0,0,0,1,0,1
13393,30,526,1390,0,0,0,0,1,1
13394,30,528,1392;1393,0,0,0,0,2,2
13395,30,530,1398,0,0,0,0,1,1
13396,30,531,1400;1401,0,0,0,0,2,2
13397,30,532,1402,0,0,0,0,1,1
13398,30,534,1405;6807;10666;11082,0,0,0,4,0,4
13399,30,535,1408,0,0,0,0,1,1
13400,30,536,1409;1410,0,0,0,0,2,2
13401,30,542,6846,0,0,0,1,0,1
13402,30,543,1433,0,0,0,0,1,1
13403,30,545,1435;1436,0,0,0,2,0,2
13404,30,546,1437;1438,0,0,0,0,2,2
13405,30,549,1442,0,0,0,0,1,1
13406,30,550,1444;9792,0,0,0,1,1,2
13407,30,552,1448;1452,0,0,0,1,1,2
13408,30,553,1515;4314;10835;12070,0,0,1,3,0,4
13409,30,554,1455,0,0,0,0,1,1
13410,30,555,1456;4134;11155;11356,0,0,0,4,0,4
13411,30,556,1459;1460;11275;11423,0,0,1,3,0,4
13412,30,558,1464;11091,0,0,0,2,0,2
13413,30,559,1465;1466,0,0,0,0,2,2
13414,30,560,922;1469,0,0,0,2,0,2
13415,30,562,1475;9911,0,0,0,2,0,2
13416,30,564,1482,0,0,0,0,1,1
13417,30,565,1183;1483,0,0,0,0,2,2
13418,30,566,1488,0,0,0,0,1,1
13419,30,567,1491;5707,0,0,0,2,0,2
13420,30,568,1495;1496,0,0,0,1,1,2
13421,30,569,1497;5273,0,0,0,2,0,2
13422,30,571,1502;2502;10357,0,0,0,3,0,3
13423,30,573,1506;3919;12238,0,0,1,2,0,3
13424,30,574,1509;3027;11229;11642;12575,0,0,2,3,0,5
13425,30,576,1513,0,0,0,0,1,1
13426,30,577,1517;6711,0,0,0,0,2,2
13427,30,578,1519,0,0,0,0,1,1
13428,30,579,1520;1521,0,0,0,1,1,2
13429,30,580,1524;2722,0,0,0,0,2,2
13430,30,581,1527,0,0,0,0,1,1
13431,30,582,1529;3538;10406;12247;12396;12606,0,0,3,3,0,6
13432,30,583,1131;1531,0,0,0,0,2,2
13433,30,584,1538;13063,0,1,0,1,0,2
13434,30,585,1540,0,0,0,0,1,1
13435,30,587,1547;3263,0,0,0,2,0,2
13436,30,589,1551,0,0,0,0,1,1
13437,30,590,1553;9321;11203;11351;11778,0,0,1,4,0,5
13438,30,591,1555,0,0,0,0,1,1
13439,30,592,1557;1558;11215;11494,0,0,1,2,1,4
13440,30,593,1560;1655;11992,0,0,1,2,0,3
13441,30,594,1562;1563,0,0,0,0,2,2
13442,30,595,1566;1567,0,0,0,0,2,2
13443,30,599,1578,0,0,0,0,1,1
13444,30,600,1579,0,0,0,0,1,1
13445,30,603,1587,0,0,0,0,1,1
13446,30,605,1593;1594,0,0,0,1,1,2
13447,30,606,4865,0,0,0,0,1,1
13448,30,607,1596;4276;10116,0,0,0,3,0,3
13449,30,608,1597;1598,0,0,0,2,0,2
13450,30,610,1604;12061;12632,0,0,2,1,0,3
13451,30,612,7132,0,0,0,0,1,1
13452,30,613,1612,0,0,0,0,1,1
13453,30,614,1618;1619;6335;9513;12136;12147;12415;12420,0,0,4,4,0,8
13454,30,615,1620;1622;4140,0,0,0,3,0,3
13455,30,617,1626,0,0,0,0,1,1
13456,30,618,1629;5857;10753;11336,0,0,0,4,0,4
13457,30,621,1635;1636,0,0,0,0,2,2
13458,30,622,1638;1639,0,0,0,0,2,2
13459,30,623,1641;1642,0,0,0,0,2,2
13460,30,624,1643;10392;11081,0,0,0,3,0,3
13461,30,625,2480;2605;11506;11738,0,0,2,2,0,4
13462,30,626,1650,0,0,0,0,1,1
13463,30,628,2835,0,0,0,0,1,1
13464,30,629,1659,0,0,0,0,1,1
13465,30,630,1660;1661,0,0,0,0,2,2
13466,30,632,1664;1667;1668,0,0,0,2,1,3
13467,30,633,1671;1808;13146,0,1,0,2,0,3
13468,30,634,1673;5117;10852;11424,0,0,1,3,0,4
13469,30,637,1677;1678,0,0,0,0,2,2
13470,30,639,1684;1685,0,0,0,0,2,2
13471,30,641,1690,0,0,0,0,1,1
13472,30,642,6683;8308,0,0,0,1,1,2
13473,30,643,1702;2093,0,0,0,2,0,2
13474,30,644,1704;3901,0,0,0,1,1,2
13475,30,645,1708,0,0,0,0,1,1
13476,30,646,1710,0,0,0,0,1,1
13477,30,647,4347,0,0,0,0,1,1
13478,30,648,1715;8540;11057,0,0,0,3,0,3
13479,30,649,1716;1717;1720;1721,0,0,0,2,2,4
13480,30,650,1722;1723,0,0,0,1,1,2
13481,30,653,1733,0,0,0,0,1,1
13482,30,654,1735;1737,0,0,0,0,2,2
13483,30,655,1739;9203,0,0,0,0,2,2
13484,30,656,1742;1743,0,0,0,2,0,2
13485,30,657,1747;5049;7010,0,0,0,1,2,3
13486,30,658,1748;1749,0,0,0,1,1,2
13487,30,661,648;1756;12563;12983;13156,0,2,1,2,0,5
13488,30,662,1758,0,0,0,0,1,1
13489,30,665,1764;10810;10986,0,0,0,2,1,3
13490,30,669,1778,0,0,0,0,1,1
13491,30,671,1781,0,0,0,0,1,1
13492,30,672,1785;1786,0,0,0,0,2,2
13493,30,673,2802;5867,0,0,0,0,2,2
13494,30,674,1791,0,0,0,0,1,1
13495,30,677,1795,0,0,0,0,1,1
13496,30,680,1804,0,0,0,0,1,1
13497,30,682,1810,0,0,0,1,0,1
13498,30,683,1811,0,0,0,0,1,1
13499,30,684,1812;9263,0,0,0,2,0,2
13500,30,687,1817;1819,0,0,0,0,2,2
13501,30,688,1823,0,0,0,0,1,1
13502,30,689,1825,0,0,0,0,1,1
13503,30,691,1828,0,0,0,0,1,1
13504,30,692,1829;1830,0,0,0,0,2,2
13505,30,696,697;1838;1840,0,0,0,1,2,3
13506,30,698,1843;7783;10940,0,0,0,3,0,3
13507,30,704,1856,0,0,0,1,0,1
13508,30,707,1862,0,0,0,0,1,1
13509,30,708,1866,0,0,0,0,1,1
13510,30,709,2257;11008,0,0,0,2,0,2
13511,30,710,1869;7936,0,0,0,0,2,2
13512,30,712,1871,0,0,0,0,1,1
13513,30,713,1874,0,0,0,0,1,1
13514,30,714,1876,0,0,0,0,1,1
13515,30,716,1881;1883;4064;11384,0,0,0,4,0,4
13516,30,719,1889,0,0,0,1,0,1
13517,30,720,1891;8224;10766;11488,0,0,1,3,0,4
13518,30,721,1893,0,0,0,1,0,1
13519,30,723,1898;5340,0,0,0,0,2,2
13520,30,726,1909,0,0,0,0,1,1
13521,30,727,1912,0,0,0,0,1,1
13522,30,728,1914;10672,0,0,0,2,0,2
13523,30,729,1916,0,0,0,0,1,1
13524,30,730,1917;7842,0,0,0,0,2,2
13525,30,736,4838;7667;11259,0,0,0,3,0,3
13526,30,738,4187;4283,0,0,0,2,0,2
13527,30,739,1937;4195,0,0,0,0,2,2
13528,30,740,1939,0,0,0,0,1,1
13529,30,741,1942;1944,0,0,0,1,1,2
13530,30,744,1955;6286,0,0,0,0,2,2
13531,30,747,8274,0,0,0,1,0,1
13532,30,749,1963;7142;12365;12501;12950,0,1,2,2,0,5
13533,30,750,1964;1965;10253;10644;11375,0,0,0,5,0,5
13534,30,751,1968,0,0,0,0,1,1
13535,30,752,1969;1970;10985,0,0,0,2,1,3
13536,30,753,4405,0,0,0,0,1,1
13537,30,754,1975;1977,0,0,0,0,2,2
13538,30,756,1984,0,0,0,0,1,1
13539,30,757,8327,0,0,0,0,1,1
13540,30,758,7242;8951,0,0,0,2,0,2
13541,30,759,1931;1993;12293,0,0,1,2,0,3
13542,30,761,1996,0,0,0,0,1,1
13543,30,762,1997;2251,0,0,0,0,2,2
13544,30,768,2006;2702;10621,0,0,0,3,0,3
13545,30,769,2012,0,0,0,0,1,1
13546,30,770,2016;2018,0,0,0,1,1,2
13547,30,771,2021,0,0,0,0,1,1
13548,30,772,2024,0,0,0,0,1,1
13549,30,773,2026;8792;10724,0,0,0,3,0,3
13550,30,774,2028,0,0,0,0,1,1
13551,30,775,2034;2036,0,0,0,0,2,2
13552,30,776,2044;7753,0,0,0,0,2,2
13553,30,782,2052;9477,0,0,0,2,0,2
13554,30,784,2057;8991,0,0,0,1,1,2
13555,30,785,2060;8024,0,0,0,0,2,2
13556,30,786,2061;2062,0,0,0,1,1,2
13557,30,787,2064,0,0,0,0,1,1
13558,30,788,2065;2066,0,0,0,0,2,2
13559,30,789,2070,0,0,0,1,0,1
13560,30,791,2073;6485,0,0,0,0,2,2
13561,30,794,2080;2889,0,0,0,0,2,2
13562,30,795,2081;6219,0,0,0,0,2,2
13563,30,796,2084,0,0,0,0,1,1
13564,30,797,1432;10103;10271;10331;12958;12981;13019;13358,0,4,0,4,0,8
13565,30,798,2088;2090,0,0,0,1,1,2
13566,30,799,2094;2095,0,0,0,0,2,2
13567,30,801,2097,0,0,0,0,1,1
13568,30,803,2103;5953,0,0,0,2,0,2
13569,30,805,2106,0,0,0,0,1,1
13570,30,806,2109;2110,0,0,0,1,1,2
13571,30,807,2111,0,0,0,0,1,1
13572,30,811,2118,0,0,0,0,1,1
13573,30,812,2119,0,0,0,0,1,1
13574,30,814,2124;2125,0,0,0,0,2,2
13575,30,815,2127,0,0,0,0,1,1
13576,30,816,2128;2129,0,0,0,0,2,2
13577,30,817,2135;2136;2138;6351;10959,0,0,0,3,2,5
13578,30,818,2142;13058;13306,0,2,0,1,0,3
13579,30,819,2143,0,0,0,0,1,1
13580,30,821,2148;10135;11505,0,0,1,2,0,3
13581,30,822,2149;9867;11358;11523;11802,0,0,2,3,0,5
13582,30,824,2152;2153,0,0,0,0,2,2
13583,30,826,2157;2158,0,0,0,0,2,2
13584,30,827,2160;5752,0,0,0,0,2,2
13585,30,828,2161;2162,0,0,0,0,2,2
13586,30,829,2163,0,0,0,1,0,1
13587,30,830,2167,0,0,0,0,1,1
13588,30,833,2173;6345,0,0,0,2,0,2
13589,30,836,2184,0,0,0,0,1,1
13590,30,839,2190,0,0,0,0,1,1
13591,30,840,2191,0,0,0,0,1,1
13592,30,841,2193,0,0,0,0,1,1
13593,30,842,2196,0,0,0,0,1,1
13594,30,844,2198,0,0,0,0,1,1
13595,30,846,2202,0,0,0,0,1,1
13596,30,847,2204;2205,0,0,0,0,2,2
13597,30,850,2214,0,0,0,0,1,1
13598,30,852,655;2220;2225;5323;7556;9547,0,0,0,1,5,6
13599,30,853,2227,0,0,0,0,1,1
13600,30,854,2229,0,0,0,0,1,1
13601,30,856,2235,0,0,0,0,1,1
13602,30,857,2238;6207;11429,0,0,1,2,0,3
13603,30,858,8182,0,0,0,0,1,1
13604,30,859,2243;2247,0,0,0,1,1,2
13605,30,860,2248,0,0,0,0,1,1
13606,30,861,2254;2256,0,0,0,1,1,2
13607,30,862,2258,0,0,0,0,1,1
13608,30,863,2261,0,0,0,0,1,1
13609,30,864,2263;6046;10886,0,0,0,3,0,3
13610,30,865,2267,0,0,0,0,1,1
13611,30,867,2272,0,0,0,0,1,1
13612,30,868,2274;2275,0,0,0,0,2,2
13613,30,869,2276;2277,0,0,0,0,2,2
13614,30,870,2072;2284,0,0,0,0,2,2
13615,30,871,4707;9224,0,0,0,2,0,2
13616,30,873,1683;2287;10111;10404;10473,0,0,0,5,0,5
13617,30,874,2293;4002,0,0,0,2,0,2
13618,30,876,2297,0,0,0,0,1,1
13619,30,877,2299,0,0,0,1,0,1
13620,30,878,2303;7272;10737;11135,0,0,0,4,0,4
13621,30,885,375;2315,0,0,0,0,2,2
13622,30,886,1583;2320,0,0,0,2,0,2
13623,30,887,2327,0,0,0,0,1,1
13624,30,888,1870;2328;10680,0,0,0,3,0,3
13625,30,890,978;2332,0,0,0,0,2,2
13626,30,891,2333;2334;10361,0,0,0,2,1,3
13627,30,892,2335;2336,0,0,0,0,2,2
13628,30,893,2338;2339;10416;10420;10568,0,0,0,5,0,5
13629,30,894,2341;3425,0,0,0,0,2,2
13630,30,895,2343;2344;10381,0,0,0,2,1,3
13631,30,896,2346;2347,0,0,0,0,2,2
13632,30,897,1371;2350;4675;4722;11922,0,0,1,4,0,5
13633,30,900,2358,0,0,0,0,1,1
13634,30,901,2363,0,0,0,0,1,1
13635,30,902,2367;2368,0,0,0,2,0,2
13636,30,904,2373;2374;10415;11079,0,0,0,3,1,4
13637,30,906,2378,0,0,0,0,1,1
13638,30,907,1118;2379,0,0,0,0,2,2
13639,30,908,2381;2382,0,0,0,0,2,2
13640,30,909,2386;6079,0,0,0,0,2,2
13641,30,912,2393;2396;5537,0,0,0,1,2,3
13642,30,916,2408,0,0,0,0,1,1
13643,30,918,2413,0,0,0,0,1,1
13644,30,919,2415;9413,0,0,0,2,0,2
13645,30,922,8723,0,0,0,1,0,1
13646,30,926,7458,0,0,0,0,1,1
13647,30,930,2439;2440,0,0,0,0,2,2
13648,30,932,2449;4793;11587,0,0,1,2,0,3
13649,30,934,2452,0,0,0,0,1,1
13650,30,935,2453;2454,0,0,0,0,2,2
13651,30,936,2457,0,0,0,0,1,1
13652,30,937,777;2460,0,0,0,0,2,2
13653,30,938,2465,0,0,0,0,1,1
13654,30,940,2471,0,0,0,1,0,1
13655,30,941,2473;2474;2476,0,0,0,1,2,3
13656,30,942,2479,0,0,0,0,1,1
13657,30,946,2487,0,0,0,0,1,1
13658,30,947,2489,0,0,0,0,1,1
13659,30,950,2501;7647,0,0,0,0,2,2
13660,30,952,2511,0,0,0,0,1,1
13661,30,953,2513;4920;10997;11510,0,0,1,3,0,4
13662,30,957,2522;2524,0,0,0,1,1,2
13663,30,960,2533,0,0,0,0,1,1
13664,30,961,2536;8772,0,0,0,0,2,2
13665,30,962,2538;4320;11898,0,0,1,2,0,3
13666,30,966,308;2548,0,0,0,0,2,2
13667,30,967,2216;2550,0,0,0,2,0,2
13668,30,968,2551,0,0,0,0,1,1
13669,30,969,2554,0,0,0,0,1,1
13670,30,970,2558;9123,0,0,0,2,0,2
13671,30,972,2564;10401,0,0,0,2,0,2
13672,30,974,2568,0,0,0,0,1,1
13673,30,977,2114;2574,0,0,0,2,0,2
13674,30,979,1816;2579,0,0,0,0,2,2
13675,30,981,2585,0,0,0,0,1,1
13676,30,983,2588;2589,0,0,0,0,2,2
13677,30,985,2593;6767;10599;10629,0,0,0,4,0,4
13678,30,987,1367;2597,0,0,0,0,2,2
13679,30,988,2599;2600,0,0,0,0,2,2
13680,30,989,2602;7829;11074;11467,0,0,1,3,0,4
13681,30,992,2185;2609,0,0,0,0,2,2
13682,30,994,2613;4625;11200;11332,0,0,0,4,0,4
13683,30,995,2614;8609;10707,0,0,0,3,0,3
13684,30,997,2617;9730,0,0,0,0,2,2
13685,30,998,2618;4410,0,0,0,2,0,2
13686,30,1001,2630,0,0,0,1,0,1
13687,30,1002,2631,0,0,0,0,1,1
13688,30,1004,2635;2636,0,0,0,0,2,2
13689,30,1005,623,0,0,0,0,1,1
13690,30,1007,2640,0,0,0,0,1,1
13691,30,1008,2643,0,0,0,0,1,1
13692,30,1012,2652;2653,0,0,0,0,2,2
13693,30,1013,2658;10834,0,0,0,2,0,2
13694,30,1016,2662;8181,0,0,0,0,2,2
13695,30,1018,2666;2668,0,0,0,1,1,2
13696,30,1019,2672,0,0,0,0,1,1
13697,30,1022,2680,0,0,0,0,1,1
13698,30,1023,2683,0,0,0,0,1,1
13699,30,1024,2685,0,0,0,0,1,1
13700,30,1025,2691,0,0,0,0,1,1
13701,30,1027,2696,0,0,0,0,1,1
13702,30,1028,2697,0,0,0,0,1,1
13703,30,1029,2699;2701;2959;5135;12463;12682;12806;12948;13075,0,3,2,4,0,9
13704,30,1035,2710,0,0,0,0,1,1
13705,30,1036,2711;2872,0,0,0,0,2,2
13706,30,1037,2712;6695,0,0,0,0,2,2
13707,30,1042,3898,0,0,0,0,1,1
13708,30,1043,2727,0,0,0,1,0,1
13709,30,1048,2749;8479,0,0,0,2,0,2
13710,30,1049,2752,0,0,0,0,1,1
13711,30,1059,2773;8322;11695;12405,0,0,2,2,0,4
13712,30,1063,939;2786,0,0,0,2,0,2
13713,30,1065,1532;2793,0,0,0,0,2,2
13714,30,1066,2794,0,0,0,0,1,1
13715,30,1067,2796,0,0,0,0,1,1
13716,30,1069,2806;2807;11546,0,0,1,1,1,3
13717,30,1070,2810;2811;2812;3041;7000;10582;10969;11016;11246;11252;11620;12124,0,0,2,10,0,12
13718,30,1071,2813;2814,0,0,0,0,2,2
13719,30,1072,2819,0,0,0,1,0,1
13720,30,1073,2821;10804,0,0,0,2,0,2
13721,30,1074,2823;5628;10006;10618;11541;11897;12192,0,0,3,4,0,7
13722,30,1076,2829;2830,0,0,0,1,1,2
13723,30,1077,1700;2833;13309,0,1,0,2,0,3
13724,30,1079,2839,0,0,0,1,0,1
13725,30,1081,2844,0,0,0,0,1,1
13726,30,1084,2852,0,0,0,0,1,1
13727,30,1085,2854;2855,0,0,0,1,1,2
13728,30,1086,2856;2857,0,0,0,1,1,2
13729,30,1088,2862;8362,0,0,0,0,2,2
13730,30,1089,2866,0,0,0,0,1,1
13731,30,1090,5150,0,0,0,0,1,1
13732,30,1091,2874,0,0,0,0,1,1
13733,30,1093,2054;3190;10087,0,0,0,3,0,3
13734,30,1094,2882,0,0,0,0,1,1
13735,30,1096,264;9488;11322,0,0,0,3,0,3
13736,30,1098,2622;3436;11317;11520,0,0,1,3,0,4
13737,30,1101,2897;7116,0,0,0,0,2,2
13738,30,1102,2898;3371,0,0,0,0,2,2
13739,30,1103,2900,0,0,0,0,1,1
13740,30,1104,2902;2903,0,0,0,1,1,2
13741,30,1105,2904;2905,0,0,0,0,2,2
13742,30,1108,2909;8689,0,0,0,0,2,2
13743,30,1109,2911;9702;11405;11718,0,0,2,2,0,4
13744,30,1110,2912,0,0,0,0,1,1
13745,30,1111,2915;2916,0,0,0,1,1,2
13746,30,1113,2918;3342;10260,0,0,0,3,0,3
13747,30,1115,2923;2924,0,0,0,0,2,2
13748,30,1116,2926,0,0,0,0,1,1
13749,30,1117,2927,0,0,0,0,1,1
13750,30,1122,2940,0,0,0,0,1,1
13751,30,1123,2941;11112,0,0,0,2,0,2
13752,30,1124,2944;6972,0,0,0,1,1,2
13753,30,1126,2946,0,0,0,0,1,1
13754,30,1128,2955;2956,0,0,0,0,2,2
13755,30,1129,2958;8696;12279,0,0,1,2,0,3
13756,30,1130,2962;6384,0,0,0,2,0,2
13757,30,1133,2969,0,0,0,0,1,1
13758,30,1134,2973;2974,0,0,0,0,2,2
13759,30,1136,2981;2982,0,0,0,0,2,2
13760,30,1138,2987;8079,0,0,0,2,0,2
13761,30,1139,2988,0,0,0,0,1,1
13762,30,1142,1440;2994,0,0,0,2,0,2
13763,30,1146,3008;6456,0,0,0,0,2,2
13764,30,1147,3013,0,0,0,0,1,1
13765,30,1149,3017;3018;3019,0,0,0,2,1,3
13766,30,1152,3024;8719;11192,0,0,0,3,0,3
13767,30,1153,3025;3026,0,0,0,1,1,2
13768,30,1156,3037,0,0,0,0,1,1
13769,30,1157,3042,0,0,0,0,1,1
13770,30,1158,3047;3048,0,0,0,0,2,2
13771,30,1161,3053;3054,0,0,0,0,2,2
13772,30,1163,871;3061,0,0,0,2,0,2
13773,30,1165,3068;3071,0,0,0,1,1,2
13774,30,1166,8867;9852;10653;10721,0,0,0,4,0,4
13775,30,1168,3076;3077;11651;11829,0,0,2,1,1,4
13776,30,1169,3079,0,0,0,0,1,1
13777,30,1170,3080;10448;11034,0,0,0,3,0,3
13778,30,1172,1412;3084;3086,0,0,0,1,2,3
13779,30,1177,3097,0,0,0,0,1,1
13780,30,1180,3105;6564;10962;11701,0,0,1,3,0,4
13781,30,1181,3109;3110,0,0,0,1,1,2
13782,30,1185,745;6539,0,0,0,2,0,2
13783,30,1186,1946;3124,0,0,0,0,2,2
13784,30,1189,3131;9350,0,0,0,0,2,2
13785,30,1190,3134;3135,0,0,0,0,2,2
13786,30,1191,3138,0,0,0,0,1,1
13787,30,1192,6513;10320,0,0,0,2,0,2
13788,30,1193,3144;6922;11493,0,0,1,2,0,3
13789,30,1194,3148,0,0,0,0,1,1
13790,30,1196,3150;3151,0,0,0,2,0,2
13791,30,1198,3153;4330,0,0,0,0,2,2
13792,30,1199,3158,0,0,0,0,1,1
13793,30,1200,3162,0,0,0,0,1,1
13794,30,1202,3169;6343;10773,0,0,0,3,0,3
13795,30,1203,3170;9080,0,0,0,1,1,2
13796,30,1204,3171,0,0,0,0,1,1
13797,30,1205,102,0,0,0,0,1,1
13798,30,1206,3176,0,0,0,0,1,1
13799,30,1208,3181,0,0,0,0,1,1
13800,30,1209,3140;3184,0,0,0,2,0,2
13801,30,1210,3187;6504;10722,0,0,0,3,0,3
13802,30,1212,3194,0,0,0,0,1,1
13803,30,1213,3197,0,0,0,0,1,1
13804,30,1214,3199,0,0,0,0,1,1
13805,30,1215,3203,0,0,0,0,1,1
13806,30,1216,3205;3206,0,0,0,1,1,2
13807,30,1217,1368;3210,0,0,0,0,2,2
13808,30,1220,3220;3221;3222,0,0,0,2,1,3
13809,30,1222,3227;7741,0,0,0,0,2,2
13810,30,1223,3229,0,0,0,0,1,1
13811,30,1225,3237;8432,0,0,0,0,2,2
13812,30,1226,3242,0,0,0,0,1,1
13813,30,1227,3244,0,0,0,0,1,1
13814,30,1229,520;3249,0,0,0,2,0,2
13815,30,1231,3251,0,0,0,0,1,1
13816,30,1232,3253;3256;9435;11127,0,0,0,4,0,4
13817,30,1233,3257;3258,0,0,0,0,2,2
13818,30,1236,7414,0,0,0,1,0,1
13819,30,1237,3265,0,0,0,0,1,1
13820,30,1238,3268;3269,0,0,0,1,1,2
13821,30,1239,3270,0,0,0,0,1,1
13822,30,1241,3275;6016,0,0,0,0,2,2
13823,30,1242,3278,0,0,0,0,1,1
13824,30,1243,3279;3280,0,0,0,0,2,2
13825,30,1244,3282;3283,0,0,0,0,2,2
13826,30,1245,3284;3285,0,0,0,0,2,2
13827,30,1247,3288,0,0,0,0,1,1
13828,30,1248,3290;3292,0,0,0,0,2,2
13829,30,1250,3294,0,0,0,0,1,1
13830,30,1251,3298;4522,0,0,0,2,0,2
13831,30,1252,3299;9157,0,0,0,0,2,2
13832,30,1253,3300,0,0,0,0,1,1
13833,30,1254,3082;3303,0,0,0,0,2,2
13834,30,1256,3310,0,0,0,0,1,1
13835,30,1257,3313;3314,0,0,0,1,1,2
13836,30,1258,7476,0,0,0,0,1,1
13837,30,1261,3323,0,0,0,0,1,1
13838,30,1265,3330;9287,0,0,0,0,2,2
13839,30,1272,3344,0,0,0,0,1,1
13840,30,1273,3347,0,0,0,0,1,1
13841,30,1274,3349;3350,0,0,0,1,1,2
13842,30,1276,3357,0,0,0,0,1,1
13843,30,1277,3360,0,0,0,0,1,1
13844,30,1280,3368;3369,0,0,0,1,1,2
13845,30,1282,3372,0,0,0,0,1,1
13846,30,1283,3378;3379,0,0,0,1,1,2
13847,30,1285,3384;3385,0,0,0,1,1,2
13848,30,1286,3392,0,0,0,1,0,1
13849,30,1287,3393;3396,0,0,0,1,1,2
13850,30,1290,3409;9895,0,0,0,2,0,2
13851,30,1291,2398;3410,0,0,0,0,2,2
13852,30,1292,3212;3411;12214,0,0,1,2,0,3
13853,30,1293,887;3412,0,0,0,0,2,2
13854,30,1294,3414,0,0,0,0,1,1
13855,30,1295,3415,0,0,0,0,1,1
13856,30,1296,3421,0,0,0,0,1,1
13857,30,1297,3422;3423,0,0,0,1,1,2
13858,30,1299,3427,0,0,0,1,0,1
13859,30,1300,3430;3431,0,0,0,0,2,2
13860,30,1302,3440,0,0,0,0,1,1
13861,30,1306,3448;11167;11392,0,0,0,3,0,3
13862,30,1308,3455;6035;12091,0,0,1,2,0,3
13863,30,1309,3459,0,0,0,0,1,1
13864,30,1310,9297,0,0,0,0,1,1
13865,30,1311,3461;3462,0,0,0,0,2,2
13866,30,1315,3474;10509;11207,0,0,0,3,0,3
13867,30,1316,3480,0,0,0,0,1,1
13868,30,1320,2326;3487,0,0,0,0,2,2
13869,30,1322,3490,0,0,0,0,1,1
13870,30,1323,3496,0,0,0,0,1,1
13871,30,1324,3497,0,0,0,0,1,1
13872,30,1325,3498;3499,0,0,0,0,2,2
13873,30,1326,3501;3504,0,0,0,2,0,2
13874,30,1327,3505;8397,0,0,0,0,2,2
13875,30,1328,3508;3967,0,0,0,0,2,2
13876,30,1330,3622,0,0,0,0,1,1
13877,30,1331,3511;3512,0,0,0,1,1,2
13878,30,1332,3513;3514;11824,0,0,1,1,1,3
13879,30,1333,3515;3516,0,0,0,0,2,2
13880,30,1334,3519,0,0,0,0,1,1
13881,30,1336,3525,0,0,0,0,1,1
13882,30,1337,3526;5957;10872,0,0,0,3,0,3
13883,30,1338,3528;3529,0,0,0,0,2,2
13884,30,1339,3532;3534;10095,0,0,0,2,1,3
13885,30,1341,3536,0,0,0,0,1,1
13886,30,1342,661;3541;10819;10991,0,0,0,4,0,4
13887,30,1344,3547,0,0,0,0,1,1
13888,30,1346,3553,0,0,0,0,1,1
13889,30,1347,3554;3555,0,0,0,1,1,2
13890,30,1348,3556,0,0,0,0,1,1
13891,30,1352,3569;3570,0,0,0,0,2,2
13892,30,1353,3572,0,0,0,0,1,1
13893,30,1354,3576,0,0,0,0,1,1
13894,30,1358,3584;3585,0,0,0,0,2,2
13895,30,1359,3592,0,0,0,1,0,1
13896,30,1360,3593;3594,0,0,0,0,2,2
13897,30,1362,2754;3599,0,0,0,0,2,2
13898,30,1363,3602;3603,0,0,0,1,1,2
13899,30,1367,3611,0,0,0,1,0,1
13900,30,1370,579;3618,0,0,0,0,2,2
13901,30,1371,3619;11114,0,0,0,2,0,2
13902,30,1373,2884;3623,0,0,0,0,2,2
13903,30,1380,3642,0,0,0,0,1,1
13904,30,1386,3657,0,0,0,0,1,1
13905,30,1387,3660,0,0,0,0,1,1
13906,30,1391,3668;6607,0,0,0,2,0,2
13907,30,1392,3670,0,0,0,0,1,1
13908,30,1394,3680,0,0,0,0,1,1
13909,30,1395,3682;5103,0,0,0,2,0,2
13910,30,1396,3683,0,0,0,0,1,1
13911,30,1397,3686;3687,0,0,0,1,1,2
13912,30,1400,3694;8487,0,0,0,0,2,2
13913,30,1401,3697;8225,0,0,0,2,0,2
13914,30,1403,3703;7711,0,0,0,2,0,2
13915,30,1405,3709,0,0,0,1,0,1
13916,30,1407,3714;9241,0,0,0,1,1,2
13917,30,1408,3718;9431,0,0,0,2,0,2
13918,30,1409,2822;3720,0,0,0,0,2,2
13919,30,1410,3721,0,0,0,0,1,1
13920,30,1411,3723;3724,0,0,0,0,2,2
13921,30,1412,3729;6501,0,0,0,0,2,2
13922,30,1414,3735;12358;12567,0,0,2,1,0,3
13923,30,1415,3737;8430,0,0,0,2,0,2
13924,30,1416,3676;9990;11726,0,0,1,2,0,3
13925,30,1418,3743,0,0,0,0,1,1
13926,30,1419,3745,0,0,0,1,0,1
13927,30,1420,3746;3747,0,0,0,0,2,2
13928,30,1421,3751;3752,0,0,0,1,1,2
13929,30,1423,3756,0,0,0,0,1,1
13930,30,1425,3761;6156,0,0,0,2,0,2
13931,30,1426,3763;10360,0,0,0,2,0,2
13932,30,1427,132;2804;3766;3767;3768;4375;10706;11571;11762;12465,0,0,3,7,0,10
13933,30,1430,7615;7900,0,0,0,2,0,2
13934,30,1432,9143,0,0,0,0,1,1
13935,30,1434,3781,0,0,0,0,1,1
13936,30,1435,3783,0,0,0,0,1,1
13937,30,1437,210;3788,0,0,0,2,0,2
13938,30,1439,2739;3793,0,0,0,0,2,2
13939,30,1440,3797;7474;10197,0,0,0,3,0,3
13940,30,1441,3800;3801,0,0,0,0,2,2
13941,30,1443,3806,0,0,0,0,1,1
13942,30,1444,3808;4190,0,0,0,1,1,2
13943,30,1445,3809;3810,0,0,0,0,2,2
13944,30,1446,1174;3814,0,0,0,0,2,2
13945,30,1447,3816,0,0,0,0,1,1
13946,30,1448,3818,0,0,0,0,1,1
13947,30,1449,3821;8819,0,0,0,0,2,2
13948,30,1450,1043,0,0,0,0,1,1
13949,30,1451,3791;3826,0,0,0,0,2,2
13950,30,1452,3827;3828,0,0,0,1,1,2
13951,30,1455,3840,0,0,0,1,0,1
13952,30,1457,3845;3846;10414,0,0,0,2,1,3
13953,30,1458,3848;3849;3850;8580;10870;11683,0,0,1,5,0,6
13954,30,1459,3851;5474,0,0,0,0,2,2
13955,30,1460,3853,0,0,0,0,1,1
13956,30,1461,3855;3856,0,0,0,0,2,2
13957,30,1462,3857,0,0,0,0,1,1
13958,30,1463,3861;3862,0,0,0,0,2,2
13959,30,1465,3866,0,0,0,0,1,1
13960,30,1466,3871,0,0,0,0,1,1
13961,30,1468,3880;10874;11381,0,0,0,3,0,3
13962,30,1470,3114,0,0,0,0,1,1
13963,30,1473,3888,0,0,0,0,1,1
13964,30,1474,3890;3892,0,0,0,0,2,2
13965,30,1475,3893,0,0,0,1,0,1
13966,30,1476,3897,0,0,0,0,1,1
13967,30,1479,3902,0,0,0,0,1,1
13968,30,1481,3908,0,0,0,0,1,1
13969,30,1483,4193,0,0,0,1,0,1
13970,30,1486,3918,0,0,0,0,1,1
13971,30,1487,1255;9622,0,0,0,0,2,2
13972,30,1493,3939,0,0,0,0,1,1
13973,30,1494,3942,0,0,0,0,1,1
13974,30,1496,3949,0,0,0,0,1,1
13975,30,1497,3950,0,0,0,0,1,1
13976,30,1498,3954;6424,0,0,0,0,2,2
13977,30,1501,3966;5790;10617;11115,0,0,0,4,0,4
13978,30,1502,3970,0,0,0,0,1,1
13979,30,1504,885;3974,0,0,0,0,2,2
13980,30,1505,3979;3980,0,0,0,1,1,2
13981,30,1506,4423;9919;10775,0,0,0,3,0,3
13982,30,1508,3983;3984,0,0,0,2,0,2
13983,30,1510,3989,0,0,0,0,1,1
13984,30,1511,3991;3992,0,0,0,1,1,2
13985,30,1514,3999;7359;10966;11217,0,0,0,4,0,4
13986,30,1515,4001,0,0,0,1,0,1
13987,30,1520,4013,0,0,0,1,0,1
13988,30,1521,4014,0,0,0,0,1,1
13989,30,1524,4019,0,0,0,0,1,1
13990,30,1526,4028,0,0,0,0,1,1
13991,30,1527,4029;5177,0,0,0,0,2,2
13992,30,1531,4038;8751;10204;10660,0,0,0,4,0,4
13993,30,1533,761;4042,0,0,0,0,2,2
13994,30,1535,4050;9463,0,0,0,2,0,2
13995,30,1536,4055,0,0,0,0,1,1
13996,30,1538,4060,0,0,0,0,1,1
13997,30,1540,506;4065,0,0,0,0,2,2
13998,30,1541,4066;11483;11504,0,0,2,1,0,3
13999,30,1542,4068;4069,0,0,0,0,2,2
14000,30,1543,4072,0,0,0,0,1,1
14001,30,1544,4077,0,0,0,0,1,1
14002,30,1546,4080,0,0,0,0,1,1
14003,30,1551,4091;4093;10016,0,0,0,3,0,3
14004,30,1555,4098;9106,0,0,0,0,2,2
14005,30,1556,4099;4100,0,0,0,0,2,2
14006,30,1557,4104;8235,0,0,0,0,2,2
14007,30,1558,4107;5222,0,0,0,0,2,2
14008,30,1559,4110,0,0,0,0,1,1
14009,30,1560,4114,0,0,0,0,1,1
14010,30,1563,4119;4120,0,0,0,0,2,2
14011,30,1567,4126,0,0,0,0,1,1
14012,30,1568,4128,0,0,0,0,1,1
14013,30,1570,7361,0,0,0,0,1,1
14014,30,1572,699;4135;10346;10748,0,0,0,4,0,4
14015,30,1574,9432,0,0,0,0,1,1
14016,30,1575,1695;4142;11331,0,0,0,3,0,3
14017,30,1576,4143,0,0,0,0,1,1
14018,30,1577,4150,0,0,0,1,0,1
14019,30,1578,9173,0,0,0,0,1,1
14020,30,1581,4157;4158,0,0,0,0,2,2
14021,30,1583,4161;4162;10496;11117,0,0,0,3,1,4
14022,30,1586,1098;4171,0,0,0,0,2,2
14023,30,1587,4172;6932;10124,0,0,0,3,0,3
14024,30,1588,4174;4175,0,0,0,1,1,2
14025,30,1589,4176,0,0,0,0,1,1
14026,30,1590,4179,0,0,0,0,1,1
14027,30,1591,4182,0,0,0,0,1,1
14028,30,1592,4183,0,0,0,0,1,1
14029,30,1593,4185;4186,0,0,0,1,1,2
14030,30,1598,7907;11064;11472;11991,0,0,2,2,0,4
14031,30,1599,4200,0,0,0,0,1,1
14032,30,1600,4204,0,0,0,0,1,1
14033,30,1601,4205;7021,0,0,0,2,0,2
14034,30,1602,4206;9223,0,0,0,0,2,2
14035,30,1606,4217;4219,0,0,0,1,1,2
14036,30,1607,4223,0,0,0,0,1,1
14037,30,1609,2832;4227;4229,0,0,0,2,1,3
14038,30,1611,4232,0,0,0,0,1,1
14039,30,1614,4237;4238,0,0,0,0,2,2
14040,30,1616,4240,0,0,0,0,1,1
14041,30,1618,4246;10552,0,0,0,1,1,2
14042,30,1619,4247;4249,0,0,0,0,2,2
14043,30,1620,4251,0,0,0,0,1,1
14044,30,1621,4253;4490;11120,0,0,0,3,0,3
14045,30,1622,4255;4256,0,0,0,0,2,2
14046,30,1623,4260;9581,0,0,0,0,2,2
14047,30,1624,2731;4261,0,0,0,0,2,2
14048,30,1625,4262;6795,0,0,0,0,2,2
14049,30,1626,989;4263;10697,0,0,0,3,0,3
14050,30,1627,4265,0,0,0,0,1,1
14051,30,1628,4269;4270;4272,0,0,0,1,2,3
14052,30,1629,4278,0,0,0,0,1,1
14053,30,1630,4284;6157;11744,0,0,1,2,0,3
14054,30,1631,4288,0,0,0,0,1,1
14055,30,1633,5841;10334;10683,0,0,0,3,0,3
14056,30,1634,589;4292;4295,0,0,0,2,1,3
14057,30,1635,4296;4297,0,0,0,0,2,2
14058,30,1636,4299,0,0,0,0,1,1
14059,30,1637,4300,0,0,0,0,1,1
14060,30,1638,4302;4303,0,0,0,0,2,2
14061,30,1639,4306,0,0,0,1,0,1
14062,30,1641,4310;4311,0,0,0,0,2,2
14063,30,1643,4316,0,0,0,0,1,1
14064,30,1644,728;11186;11361,0,0,0,3,0,3
14065,30,1645,4319,0,0,0,0,1,1
14066,30,1647,4323,0,0,0,0,1,1
14067,30,1650,4328,0,0,0,0,1,1
14068,30,1652,4332,0,0,0,0,1,1
14069,30,1653,4492;8321;10860,0,0,0,3,0,3
14070,30,1654,4215;4334,0,0,0,2,0,2
14071,30,1658,4344;10781,0,0,0,2,0,2
14072,30,1659,4345,0,0,0,0,1,1
14073,30,1662,4351;4352,0,0,0,0,2,2
14074,30,1663,4355;4356,0,0,0,0,2,2
14075,30,1664,5068;9983;9987;11213,0,0,0,4,0,4
14076,30,1665,4358,0,0,0,0,1,1
14077,30,1669,4365;8267;11589;11776,0,0,2,2,0,4
14078,30,1670,4366,0,0,0,0,1,1
14079,30,1672,4376,0,0,0,0,1,1
14080,30,1674,4382,0,0,0,1,0,1
14081,30,1675,4387,0,0,0,0,1,1
14082,30,1677,4391,0,0,0,0,1,1
14083,30,1678,4393,0,0,0,0,1,1
14084,30,1680,4402;4403,0,0,0,0,2,2
14085,30,1684,4412;4413,0,0,0,0,2,2
14086,30,1687,926;4419;11017,0,0,0,3,0,3
14087,30,1688,4420,0,0,0,0,1,1
14088,30,1690,4424,0,0,0,0,1,1
14089,30,1692,4428,0,0,0,1,0,1
14090,30,1696,4433;4434,0,0,0,1,1,2
14091,30,1697,4437;4438,0,0,0,0,2,2
14092,30,1701,4445,0,0,0,0,1,1
14093,30,1702,4446;4447,0,0,0,1,1,2
14094,30,1705,2861;4455;4456,0,0,0,3,0,3
14095,30,1707,4461,0,0,0,1,0,1
14096,30,1708,4463,0,0,0,0,1,1
14097,30,1711,3002;4467,0,0,0,0,2,2
14098,30,1712,4469,0,0,0,0,1,1
14099,30,1713,4472;8505;10343;11758,0,0,1,3,0,4
14100,30,1715,1577;4481;13166,0,1,0,2,0,3
14101,30,1716,4483,0,0,0,0,1,1
14102,30,1717,4488,0,0,0,0,1,1
14103,30,1718,4491;9047,0,0,0,2,0,2
14104,30,1719,4494;5644,0,0,0,2,0,2
14105,30,1721,4498,0,0,0,0,1,1
14106,30,1722,8221,0,0,0,0,1,1
14107,30,1723,4503;4504,0,0,0,1,1,2
14108,30,1724,4508,0,0,0,0,1,1
14109,30,1727,4519,0,0,0,0,1,1
14110,30,1728,4521,0,0,0,0,1,1
14111,30,1729,1549;4452,0,0,0,2,0,2
14112,30,1730,4526;10575,0,0,0,1,1,2
14113,30,1731,805;3180,0,0,0,1,1,2
14114,30,1734,4536;6082,0,0,0,0,2,2
14115,30,1736,4538,0,0,0,0,1,1
14116,30,1737,4541;8071;10740;11825,0,0,1,3,0,4
14117,30,1738,2212;4545,0,0,0,0,2,2
14118,30,1744,4558;4559,0,0,0,1,1,2
14119,30,1745,4560;4561,0,0,0,1,1,2
14120,30,1746,4562;9359,0,0,0,0,2,2
14121,30,1747,4565,0,0,0,0,1,1
14122,30,1749,4569,0,0,0,0,1,1
14123,30,1750,4573,0,0,0,0,1,1
14124,30,1752,4578,0,0,0,0,1,1
14125,30,1753,4579,0,0,0,0,1,1
14126,30,1755,4584;4585,0,0,0,0,2,2
14127,30,1756,4588,0,0,0,0,1,1
14128,30,1757,4591,0,0,0,0,1,1
14129,30,1758,1292,0,0,0,0,1,1
14130,30,1761,4606,0,0,0,0,1,1
14131,30,1762,4609,0,0,0,0,1,1
14132,30,1765,4618;8549,0,0,0,0,2,2
14133,30,1766,4620,0,0,0,0,1,1
14134,30,1768,1820;4627;4629,0,0,0,3,0,3
14135,30,1769,3108;4633;4634,0,0,0,3,0,3
14136,30,1770,4635;4636,0,0,0,0,2,2
14137,30,1771,4638,0,0,0,0,1,1
14138,30,1773,4643,0,0,0,0,1,1
14139,30,1775,315,0,0,0,0,1,1
14140,30,1776,4650;4651,0,0,0,0,2,2
14141,30,1777,4653;4656;5058;10541;11297,0,0,0,5,0,5
14142,30,1778,4657,0,0,0,0,1,1
14143,30,1781,4662,0,0,0,0,1,1
14144,30,1784,4666,0,0,0,0,1,1
14145,30,1787,4673;7575;10429;10837;11014,0,0,0,5,0,5
14146,30,1789,3778;4679,0,0,0,0,2,2
14147,30,1790,4682,0,0,0,0,1,1
14148,30,1791,4684,0,0,0,0,1,1
14149,30,1792,4685,0,0,0,0,1,1
14150,30,1793,4687;4688,0,0,0,1,1,2
14151,30,1794,4692,0,0,0,0,1,1
14152,30,1796,4697;4699,0,0,0,1,1,2
14153,30,1798,2260;4702,0,0,0,0,2,2
14154,30,1799,4705;4706,0,0,0,1,1,2
14155,30,1802,4712,0,0,0,0,1,1
14156,30,1804,4717;4718,0,0,0,0,2,2
14157,30,1806,4725,0,0,0,0,1,1
14158,30,1807,4727;8028,0,0,0,0,2,2
14159,30,1810,4732,0,0,0,0,1,1
14160,30,1811,4734;4736,0,0,0,2,0,2
14161,30,1812,4738;4739,0,0,0,0,2,2
14162,30,1813,4741;4742;4743,0,0,0,1,2,3
14163,30,1815,4746;8062,0,0,0,1,1,2
14164,30,1816,5087,0,0,0,1,0,1
14165,30,1817,4753;4754,0,0,0,2,0,2
14166,30,1818,3641,0,0,0,0,1,1
14167,30,1819,4760,0,0,0,0,1,1
14168,30,1820,4763,0,0,0,0,1,1
14169,30,1821,525;4766,0,0,0,0,2,2
14170,30,1822,4535;10212;12629;13052;13336,0,2,1,2,0,5
14171,30,1823,4772,0,0,0,0,1,1
14172,30,1824,4774;4775,0,0,0,1,1,2
14173,30,1825,4776;5146;11166,0,0,0,3,0,3
14174,30,1826,7847,0,0,0,0,1,1
14175,30,1827,4779;4780;10931,0,0,0,2,1,3
14176,30,1828,3780;4781,0,0,0,0,2,2
14177,30,1829,4782;4783,0,0,0,1,1,2
14178,30,1831,4785;7734;10303,0,0,0,3,0,3
14179,30,1832,4786;5536,0,0,0,0,2,2
14180,30,1833,3100;9586,0,0,0,0,2,2
14181,30,1834,4788;7009;10390;10682;11224;11681,0,0,1,5,0,6
14182,30,1836,4798,0,0,0,0,1,1
14183,30,1838,4804,0,0,0,0,1,1
14184,30,1839,4805;4806,0,0,0,1,1,2
14185,30,1841,4810;4811,0,0,0,1,1,2
14186,30,1842,4813,0,0,0,0,1,1
14187,30,1844,4198;4816,0,0,0,0,2,2
14188,30,1846,1541;2005;3023;7804;11083;11266,0,0,0,5,1,6
14189,30,1847,4822,0,0,0,0,1,1
14190,30,1848,9958,0,0,0,0,1,1
14191,30,1849,4826,0,0,0,0,1,1
14192,30,1850,4829,0,0,0,0,1,1
14193,30,1851,4830;4831,0,0,0,2,0,2
14194,30,1852,4834;4835;10408,0,0,0,2,1,3
14195,30,1853,4929,0,0,0,0,1,1
14196,30,1854,4839,0,0,0,0,1,1
14197,30,1855,4841,0,0,0,1,0,1
14198,30,1856,4844,0,0,0,0,1,1
14199,30,1858,4848;4849,0,0,0,0,2,2
14200,30,1859,3099;4853;11209;11572,0,0,1,3,0,4
14201,30,1860,4858,0,0,0,0,1,1
14202,30,1862,4870;8764,0,0,0,2,0,2
14203,30,1864,4875,0,0,0,0,1,1
14204,30,1865,4878,0,0,0,0,1,1
14205,30,1866,4879;8171;10608;11455,0,0,1,3,0,4
14206,30,1867,4883,0,0,0,1,0,1
14207,30,1868,275,0,0,0,0,1,1
14208,30,1869,4892;13335,0,1,0,1,0,2
14209,30,1870,2527,0,0,0,0,1,1
14210,30,1871,4894;4895,0,0,0,0,2,2
14211,30,1873,4901,0,0,0,0,1,1
14212,30,1875,4905;7013,0,0,0,0,2,2
14213,30,1878,4910;4968,0,0,0,2,0,2
14214,30,1879,4912,0,0,0,0,1,1
14215,30,1881,4918,0,0,0,0,1,1
14216,30,1882,4921;4922,0,0,0,0,2,2
14217,30,1884,4659;4928,0,0,0,0,2,2
14218,30,1885,3981;4933;10908,0,0,0,3,0,3
14219,30,1886,4556,0,0,0,0,1,1
14220,30,1887,4935;4936,0,0,0,0,2,2
14221,30,1889,4943,0,0,0,0,1,1
14222,30,1890,4947,0,0,0,0,1,1
14223,30,1891,4951,0,0,0,0,1,1
14224,30,1892,4958,0,0,0,0,1,1
14225,30,1893,4082,0,0,0,0,1,1
14226,30,1895,4966;9556,0,0,0,0,2,2
14227,30,1898,3364;4975;10313;11129,0,0,0,4,0,4
14228,30,1899,4977,0,0,0,0,1,1
14229,30,1900,4981,0,0,0,0,1,1
14230,30,1904,4986,0,0,0,0,1,1
14231,30,1906,4992,0,0,0,1,0,1
14232,30,1908,4996,0,0,0,0,1,1
14233,30,1912,5006,0,0,0,0,1,1
14234,30,1914,5011;5012,0,0,0,0,2,2
14235,30,1915,680;5014,0,0,0,2,0,2
14236,30,1917,5022,0,0,0,0,1,1
14237,30,1919,851;1494;11058;11198;11436,0,0,1,4,0,5
14238,30,1922,5033;5034,0,0,0,2,0,2
14239,30,1923,5036;7428;11181,0,0,0,3,0,3
14240,30,1924,5038;9914,0,0,0,0,2,2
14241,30,1926,5042;5043,0,0,0,1,1,2
14242,30,1927,5045;5415,0,0,0,0,2,2
14243,30,1928,5050,0,0,0,0,1,1
14244,30,1929,508;5053,0,0,0,0,2,2
14245,30,1930,5055;10196,0,0,0,1,1,2
14246,30,1932,5060,0,0,0,0,1,1
14247,30,1933,4125;5061,0,0,0,0,2,2
14248,30,1934,5065;5066,0,0,0,1,1,2
14249,30,1935,5067;11328,0,0,0,2,0,2
14250,30,1937,1919;5074,0,0,0,1,1,2
14251,30,1938,5076,0,0,0,0,1,1
14252,30,1941,5081,0,0,0,0,1,1
14253,30,1942,713;8898,0,0,0,0,2,2
14254,30,1943,5088;7706,0,0,0,1,1,2
14255,30,1944,9282,0,0,0,0,1,1
14256,30,1945,5093,0,0,0,0,1,1
14257,30,1946,5095,0,0,0,1,0,1
14258,30,1948,5102;5314;11260;11477;11612,0,0,2,3,0,5
14259,30,1953,5111,0,0,0,0,1,1
14260,30,1954,5115;5116,0,0,0,1,1,2
14261,30,1955,5119,0,0,0,0,1,1
14262,30,1956,7064,0,0,0,0,1,1
14263,30,1960,759;5125,0,0,0,0,2,2
14264,30,1961,4017;5127;10719;11148,0,0,0,4,0,4
14265,30,1964,5136;7250,0,0,0,0,2,2
14266,30,1966,5139,0,0,0,1,0,1
14267,30,1967,5142,0,0,0,0,1,1
14268,30,1968,5143,0,0,0,0,1,1
14269,30,1971,5152;5153,0,0,0,0,2,2
14270,30,1972,5155,0,0,0,0,1,1
14271,30,1973,5157,0,0,0,0,1,1
14272,30,1974,5162;5163,0,0,0,1,1,2
14273,30,1975,5165;8716,0,0,0,1,1,2
14274,30,1976,5167;5168,0,0,0,0,2,2
14275,30,1978,4997;5172,0,0,0,0,2,2
14276,30,1979,5176,0,0,0,0,1,1
14277,30,1980,5179;8446;11491,0,0,1,2,0,3
14278,30,1982,9439,0,0,0,0,1,1
14279,30,1983,419;5185;10686;10865;11387,0,0,0,5,0,5
14280,30,1984,1239;5190;5192,0,0,0,3,0,3
14281,30,1986,2978;2979;4983;5196;11142,0,0,0,5,0,5
14282,30,1988,5199,0,0,0,0,1,1
14283,30,1990,5205,0,0,0,0,1,1
14284,30,1993,5214,0,0,0,0,1,1
14285,30,1994,5217;5218,0,0,0,0,2,2
14286,30,1995,5221,0,0,0,0,1,1
14287,30,1998,5226;10388,0,0,0,1,1,2
14288,30,1999,5232,0,0,0,1,0,1
14289,30,2000,5233,0,0,0,0,1,1
14290,30,2001,5237;6741,0,0,0,0,2,2
14291,30,2003,5240,0,0,0,0,1,1
14292,30,2004,4803;5243,0,0,0,0,2,2
14293,30,2005,3119;5247;5249;10974,0,0,0,4,0,4
14294,30,2006,5251;5824;10433;10598;10877,0,0,0,5,0,5
14295,30,2010,5259,0,0,0,0,1,1
14296,30,2011,5262;5263,0,0,0,0,2,2
14297,30,2012,255;5264,0,0,0,0,2,2
14298,30,2013,5265,0,0,0,0,1,1
14299,30,2016,5271,0,0,0,0,1,1
14300,30,2018,5274;6936,0,0,0,2,0,2
14301,30,2021,5283,0,0,0,0,1,1
14302,30,2022,5284;5285,0,0,0,1,1,2
14303,30,2024,1958;5291,0,0,0,1,1,2
14304,30,2025,5293;8731,0,0,0,2,0,2
14305,30,2026,5294,0,0,0,0,1,1
14306,30,2028,2323;7315;9655;9749;12873,0,1,0,4,0,5
14307,30,2030,5306,0,0,0,0,1,1
14308,30,2031,5308;5309;12142,0,0,1,1,1,3
14309,30,2033,5315;6176;11431;11657,0,0,2,2,0,4
14310,30,2034,5316,0,0,0,0,1,1
14311,30,2035,2661;5320,0,0,0,0,2,2
14312,30,2036,5321;8005,0,0,0,2,0,2
14313,30,2039,5325,0,0,0,0,1,1
14314,30,2040,5327;5331,0,0,0,1,1,2
14315,30,2041,5332;6514,0,0,0,2,0,2
14316,30,2042,730;4991;10730,0,0,0,3,0,3
14317,30,2043,5335;8525;10013,0,0,0,1,2,3
14318,30,2044,5336;5337,0,0,0,0,2,2
14319,30,2045,5338;6679,0,0,0,1,1,2
14320,30,2048,5343,0,0,0,0,1,1
14321,30,2050,5346;8173,0,0,0,1,1,2
14322,30,2053,5355,0,0,0,0,1,1
14323,30,2055,5358,0,0,0,0,1,1
14324,30,2056,5361,0,0,0,0,1,1
14325,30,2057,3831;3832;5363;11094;12453,0,0,1,4,0,5
14326,30,2058,5767,0,0,0,0,1,1
14327,30,2060,5374,0,0,0,0,1,1
14328,30,2061,5375,0,0,0,0,1,1
14329,30,2063,5383;5384,0,0,0,0,2,2
14330,30,2064,5386;5387,0,0,0,0,2,2
14331,30,2065,4615;5388;5390,0,0,0,3,0,3
14332,30,2066,5392;7787;11009,0,0,0,3,0,3
14333,30,2067,1095;5393;11228;11875,0,0,1,3,0,4
14334,30,2070,5400,0,0,0,0,1,1
14335,30,2071,5403;5404,0,0,0,2,0,2
14336,30,2077,5417,0,0,0,0,1,1
14337,30,2078,2486;5422;11513,0,0,1,2,0,3
14338,30,2079,5423;5424,0,0,0,2,0,2
14339,30,2080,5427;6732;10868;11617,0,0,1,3,0,4
14340,30,2082,5431,0,0,0,0,1,1
14341,30,2083,157;5435;5437;10242,0,0,0,4,0,4
14342,30,2085,5444,0,0,0,0,1,1
14343,30,2086,5446;5449,0,0,0,1,1,2
14344,30,2087,5452,0,0,0,0,1,1
14345,30,2088,4592,0,0,0,0,1,1
14346,30,2089,5454,0,0,0,0,1,1
14347,30,2090,5456;5457,0,0,0,1,1,2
14348,30,2093,5463;5464;10298,0,0,0,2,1,3
14349,30,2096,5468;10778;11278,0,0,0,3,0,3
14350,30,2102,5481,0,0,0,0,1,1
14351,30,2103,5484;5678,0,0,0,0,2,2
14352,30,2104,5486,0,0,0,0,1,1
14353,30,2105,5488,0,0,0,0,1,1
14354,30,2106,5465;5491,0,0,0,2,0,2
14355,30,2108,5497,0,0,0,0,1,1
14356,30,2109,4660;5499,0,0,0,0,2,2
14357,30,2110,5503,0,0,0,0,1,1
14358,30,2111,5666;11730,0,0,1,1,0,2
14359,30,2112,5505;8503,0,0,0,0,2,2
14360,30,2113,459;10488,0,0,0,2,0,2
14361,30,2114,5508,0,0,0,1,0,1
14362,30,2117,5513;5514,0,0,0,0,2,2
14363,30,2118,5517;5518,0,0,0,1,1,2
14364,30,2119,5520,0,0,0,0,1,1
14365,30,2120,5524;5526;5756,0,0,0,3,0,3
14366,30,2122,4812;5528,0,0,0,2,0,2
14367,30,2123,736,0,0,0,0,1,1
14368,30,2126,3305;5534,0,0,0,0,2,2
14369,30,2131,5544,0,0,0,0,1,1
14370,30,2132,5549,0,0,0,1,0,1
14371,30,2134,5555;5557,0,0,0,2,0,2
14372,30,2137,5564,0,0,0,0,1,1
14373,30,2140,5574,0,0,0,0,1,1
14374,30,2141,5577,0,0,0,0,1,1
14375,30,2142,5448;11150;11485,0,0,1,2,0,3
14376,30,2143,5579;5580,0,0,0,1,1,2
14377,30,2145,4602;5582;10147;11399;11990;12703,0,0,3,3,0,6
14378,30,2146,5583,0,0,0,0,1,1
14379,30,2150,5592,0,0,0,0,1,1
14380,30,2151,5594,0,0,0,0,1,1
14381,30,2152,4884;5596,0,0,0,0,2,2
14382,30,2154,5599,0,0,0,0,1,1
14383,30,2156,2405;5607,0,0,0,0,2,2
14384,30,2157,5608,0,0,0,0,1,1
14385,30,2159,4395;10752;10980;11031;11240,0,0,0,5,0,5
14386,30,2162,5620,0,0,0,0,1,1
14387,30,2165,5009;5627,0,0,0,2,0,2
14388,30,2166,5631;5966;10317,0,0,0,3,0,3
14389,30,2168,5634;7326,0,0,0,0,2,2
14390,30,2170,5641;9920;10047;10129,0,0,0,4,0,4
14391,30,2173,5648;5649;10191,0,0,0,2,1,3
14392,30,2174,5650;5651,0,0,0,0,2,2
14393,30,2175,5654;10338,0,0,0,2,0,2
14394,30,2176,5655;5656,0,0,0,0,2,2
14395,30,2177,5658,0,0,0,0,1,1
14396,30,2178,2562;5660,0,0,0,0,2,2
14397,30,2179,5663;5664,0,0,0,0,2,2
14398,30,2181,5667;7457,0,0,0,0,2,2
14399,30,2184,5673,0,0,0,0,1,1
14400,30,2185,5220;5675;11323,0,0,0,2,1,3
14401,30,2186,7001,0,0,0,0,1,1
14402,30,2188,5681,0,0,0,0,1,1
14403,30,2194,5694;7933,0,0,0,2,0,2
14404,30,2195,5697,0,0,0,1,0,1
14405,30,2196,5701,0,0,0,0,1,1
14406,30,2197,1416;9526;12296;12578,0,0,2,2,0,4
14407,30,2198,6592,0,0,0,1,0,1
14408,30,2199,5712;10342,0,0,0,2,0,2
14409,30,2201,4201,0,0,0,0,1,1
14410,30,2202,983;987;5717;10762;10954,0,0,0,5,0,5
14411,30,2206,2113;5727,0,0,0,0,2,2
14412,30,2208,5730,0,0,0,0,1,1
14413,30,2210,5734;5738;8027,0,0,0,1,2,3
14414,30,2212,5748;8041;11235,0,0,0,2,1,3
14415,30,2215,5758,0,0,0,0,1,1
14416,30,2219,5766;12520;12750;13136,0,2,1,1,0,4
14417,30,2220,5768;5770,0,0,0,0,2,2
14418,30,2224,5782,0,0,0,0,1,1
14419,30,2225,5783,0,0,0,0,1,1
14420,30,2226,5785,0,0,0,0,1,1
14421,30,2228,5791;7254,0,0,0,0,2,2
14422,30,2230,5796;7089,0,0,0,2,0,2
14423,30,2231,7942,0,0,0,0,1,1
14424,30,2235,4550,0,0,0,0,1,1
14425,30,2236,5807;9612,0,0,0,0,2,2
14426,30,2237,5812;8644,0,0,0,2,0,2
14427,30,2238,5813;5814,0,0,0,1,1,2
14428,30,2239,5815,0,0,0,0,1,1
14429,30,2240,5816,0,0,0,0,1,1
14430,30,2242,5821,0,0,0,0,1,1
14431,30,2243,184;5822,0,0,0,2,0,2
14432,30,2244,9894;9977,0,0,0,2,0,2
14433,30,2245,5826,0,0,0,0,1,1
14434,30,2246,5829,0,0,0,0,1,1
14435,30,2247,5832,0,0,0,0,1,1
14436,30,2248,5833,0,0,0,0,1,1
14437,30,2249,5835,0,0,0,0,1,1
14438,30,2250,5836,0,0,0,0,1,1
14439,30,2253,5842,0,0,0,0,1,1
14440,30,2254,597;5844,0,0,0,0,2,2
14441,30,2256,5847;5848,0,0,0,0,2,2
14442,30,2261,5732;5859,0,0,0,1,1,2
14443,30,2262,5862,0,0,0,0,1,1
14444,30,2263,5866,0,0,0,0,1,1
14445,30,2264,5722;5868;5869,0,0,0,3,0,3
14446,30,2265,5872,0,0,0,0,1,1
14447,30,2266,3404;5874,0,0,0,0,2,2
14448,30,2274,423;5887;5890;10189;10937,0,0,0,5,0,5
14449,30,2275,5891,0,0,0,0,1,1
14450,30,2276,7586,0,0,0,0,1,1
14451,30,2277,5896;9554,0,0,0,2,0,2
14452,30,2278,2809;5897,0,0,0,2,0,2
14453,30,2282,3085;5909;10880;10920,0,0,0,4,0,4
14454,30,2283,5910;5911,0,0,0,1,1,2
14455,30,2285,585;5916,0,0,0,0,2,2
14456,30,2286,3010;3955;12412,0,0,1,2,0,3
14457,30,2288,5921,0,0,0,0,1,1
14458,30,2289,5923;5924,0,0,0,1,1,2
14459,30,2290,3910;5925;10538;10768,0,0,0,4,0,4
14460,30,2291,4018,0,0,0,0,1,1
14461,30,2292,5931,0,0,0,0,1,1
14462,30,2294,5934;5935,0,0,0,0,2,2
14463,30,2295,5938,0,0,0,0,1,1
14464,30,2296,5941,0,0,0,1,0,1
14465,30,2298,5944;10182,0,0,0,2,0,2
14466,30,2299,1295;5946,0,0,0,0,2,2
14467,30,2300,5947;5950,0,0,0,1,1,2
14468,30,2301,5951;9192,0,0,0,1,1,2
14469,30,2302,3389;5955,0,0,0,2,0,2
14470,30,2304,5958;5959,0,0,0,2,0,2
14471,30,2305,4156;5960,0,0,0,2,0,2
14472,30,2306,867;5965,0,0,0,0,2,2
14473,30,2308,2583;5975,0,0,0,0,2,2
14474,30,2312,5984,0,0,0,0,1,1
14475,30,2314,5888;5989;5991;5992;11084;11363,0,0,0,6,0,6
14476,30,2316,5997,0,0,0,0,1,1
14477,30,2317,5999,0,0,0,0,1,1
14478,30,2318,6004,0,0,0,0,1,1
14479,30,2319,4224;6006,0,0,0,2,0,2
14480,30,2320,2089;9937,0,0,0,2,0,2
14481,30,2321,6008;8341,0,0,0,0,2,2
14482,30,2324,6014,0,0,0,0,1,1
14483,30,2326,6019;7002,0,0,0,0,2,2
14484,30,2327,6023,0,0,0,0,1,1
14485,30,2329,3040;6027,0,0,0,1,1,2
14486,30,2331,6030;6032,0,0,0,0,2,2
14487,30,2334,6039;7609;10767,0,0,0,3,0,3
14488,30,2335,6041;6042,0,0,0,0,2,2
14489,30,2336,6043;6044,0,0,0,2,0,2
14490,30,2340,2079;6048,0,0,0,0,2,2
14491,30,2341,6049;6050,0,0,0,0,2,2
14492,30,2342,6052;6053;7093;11208;11449,0,0,1,4,0,5
14493,30,2343,1360;6055;11542;12524;13102,0,1,2,2,0,5
14494,30,2347,4155;6061,0,0,0,0,2,2
14495,30,2349,6065,0,0,0,1,0,1
14496,30,2350,1842;6068,0,0,0,2,0,2
14497,30,2352,990;6075,0,0,0,0,2,2
14498,30,2354,6080,0,0,0,0,1,1
14499,30,2355,6085,0,0,0,1,0,1
14500,30,2359,6092,0,0,0,0,1,1
14501,30,2361,6095;6096,0,0,0,0,2,2
14502,30,2362,6097;6098,0,0,0,1,1,2
14503,30,2366,6109,0,0,0,0,1,1
14504,30,2367,6113;6811,0,0,0,0,2,2
14505,30,2368,4566;6115,0,0,0,0,2,2
14506,30,2369,6120,0,0,0,0,1,1
14507,30,2371,6125,0,0,0,0,1,1
14508,30,2372,6129,0,0,0,0,1,1
14509,30,2380,6141;6142,0,0,0,1,1,2
14510,30,2383,6148;6149,0,0,0,1,1,2
14511,30,2384,5478;6150;11043;11613;12080,0,0,2,3,0,5
14512,30,2385,4089;5721;8328;10131,0,0,0,2,2,4
14513,30,2387,6160;8795,0,0,0,0,2,2
14514,30,2388,6162;6163;7410;10549,0,0,0,2,2,4
14515,30,2390,6167;6168,0,0,0,0,2,2
14516,30,2392,6173;6174,0,0,0,1,1,2
14517,30,2393,1718;6175,0,0,0,0,2,2
14518,30,2395,4010;6180;10589,0,0,0,2,1,3
14519,30,2396,6181,0,0,0,1,0,1
14520,30,2397,6186,0,0,0,0,1,1
14521,30,2399,3632;6193;10349;10387;11309,0,0,0,5,0,5
14522,30,2400,772;6195,0,0,0,0,2,2
14523,30,2401,866;6200,0,0,0,0,2,2
14524,30,2403,3688;6204,0,0,0,2,0,2
14525,30,2404,6206;7602,0,0,0,0,2,2
14526,30,2405,6209,0,0,0,0,1,1
14527,30,2407,6214;8833;10300;10356;10673;10690,0,0,0,6,0,6
14528,30,2408,6216;6217;10806;11249,0,0,0,4,0,4
14529,30,2409,6218,0,0,0,0,1,1
14530,30,2410,6223,0,0,0,0,1,1
14531,30,2414,6232,0,0,0,0,1,1
14532,30,2416,6235,0,0,0,0,1,1
14533,30,2418,6241;6242;10284;10890,0,0,0,4,0,4
14534,30,2420,6248,0,0,0,0,1,1
14535,30,2422,6251,0,0,0,0,1,1
14536,30,2424,6256,0,0,0,0,1,1
14537,30,2425,6257,0,0,0,0,1,1
14538,30,2426,6263,0,0,0,0,1,1
14539,30,2428,6267,0,0,0,0,1,1
14540,30,2429,6272,0,0,0,1,0,1
14541,30,2430,6273;6274;6275,0,0,0,1,2,3
14542,30,2432,6279,0,0,0,0,1,1
14543,30,2433,6282;6283,0,0,0,0,2,2
14544,30,2435,6291,0,0,0,0,1,1
14545,30,2439,6301,0,0,0,0,1,1
14546,30,2441,681;6305,0,0,0,0,2,2
14547,30,2445,6221;6317,0,0,0,1,1,2
14548,30,2446,6320;6321,0,0,0,1,1,2
14549,30,2447,6324,0,0,0,0,1,1
14550,30,2449,6329,0,0,0,0,1,1
14551,30,2451,4821;6333,0,0,0,0,2,2
14552,30,2452,6338,0,0,0,0,1,1
14553,30,2453,3652;6342,0,0,0,1,1,2
14554,30,2454,6344;9496,0,0,0,2,0,2
14555,30,2459,6356,0,0,0,0,1,1
14556,30,2460,6512,0,0,0,0,1,1
14557,30,2461,6362,0,0,0,0,1,1
14558,30,2463,6365;6366;10465;11294;11413,0,0,1,3,1,5
14559,30,2464,6368,0,0,0,0,1,1
14560,30,2467,6376,0,0,0,0,1,1
14561,30,2468,817;6379;10281,0,0,0,3,0,3
14562,30,2470,6382;10046;13043,0,1,0,2,0,3
14563,30,2474,6386;6387;6388,0,0,0,0,3,3
14564,30,2475,6391,0,0,0,0,1,1
14565,30,2477,4440;6395,0,0,0,0,2,2
14566,30,2479,6402;6403,0,0,0,1,1,2
14567,30,2480,6409;6410,0,0,0,1,1,2
14568,30,2482,6414,0,0,0,0,1,1
14569,30,2485,6418;6419;6421;10559,0,0,0,2,2,4
14570,30,2486,6423,0,0,0,1,0,1
14571,30,2489,6427,0,0,0,0,1,1
14572,30,2490,1831;6431,0,0,0,2,0,2
14573,30,2491,6433,0,0,0,0,1,1
14574,30,2492,6436,0,0,0,0,1,1
14575,30,2493,6437;8095,0,0,0,0,2,2
14576,30,2494,6438;6439,0,0,0,0,2,2
14577,30,2495,298;6441;10949,0,0,0,3,0,3
14578,30,2497,5601;6448;10718,0,0,0,3,0,3
14579,30,2498,6450;6451,0,0,0,1,1,2
14580,30,2499,6457,0,0,0,0,1,1
14581,30,2500,6459;6460,0,0,0,0,2,2
14582,30,2501,6465;9927;12964;13155;13378,0,3,0,2,0,5
14583,30,2503,6468,0,0,0,0,1,1
14584,30,2504,6472,0,0,0,0,1,1
14585,30,2505,6473,0,0,0,0,1,1
14586,30,2506,4464;6475,0,0,0,0,2,2
14587,30,2508,6477,0,0,0,0,1,1
14588,30,2509,4623;6479,0,0,0,0,2,2
14589,30,2510,2791;6482;11184,0,0,0,2,1,3
14590,30,2513,6488,0,0,0,0,1,1
14591,30,2514,6491,0,0,0,0,1,1
14592,30,2516,6497;8202,0,0,0,0,2,2
14593,30,2517,6499,0,0,0,0,1,1
14594,30,2521,1042;6506;11311,0,0,0,3,0,3
14595,30,2528,6521,0,0,0,0,1,1
14596,30,2529,6523;6524,0,0,0,1,1,2
14597,30,2530,6527,0,0,0,0,1,1
14598,30,2531,6532;8861,0,0,0,0,2,2
14599,30,2532,6534,0,0,0,0,1,1
14600,30,2533,6538,0,0,0,0,1,1
14601,30,2534,6540;6633,0,0,0,0,2,2
14602,30,2540,213;8627;11709;12068;12280,0,0,3,2,0,5
14603,30,2544,191,0,0,0,0,1,1
14604,30,2546,6570;6892,0,0,0,0,2,2
14605,30,2549,6575;7930;10999,0,0,0,3,0,3
14606,30,2551,6578,0,0,0,0,1,1
14607,30,2553,4926,0,0,0,0,1,1
14608,30,2554,6584;6585;10345,0,0,0,2,1,3
14609,30,2555,6590;6591,0,0,0,0,2,2
14610,30,2556,6594,0,0,0,0,1,1
14611,30,2559,6599;7725,0,0,0,0,2,2
14612,30,2563,6610;8565;10323,0,0,0,2,1,3
14613,30,2567,6618;6619,0,0,0,2,0,2
14614,30,2570,5356;6630,0,0,0,0,2,2
14615,30,2571,4239;6634;10024,0,0,0,1,2,3
14616,30,2572,950;1986;6636;6637;11585;11650;11801;12242;12488,0,0,5,4,0,9
14617,30,2573,6639,0,0,0,0,1,1
14618,30,2574,5900;6643,0,0,0,2,0,2
14619,30,2577,6650,0,0,0,0,1,1
14620,30,2578,6323;6655,0,0,0,2,0,2
14621,30,2579,6657,0,0,0,0,1,1
14622,30,2580,6662,0,0,0,0,1,1
14623,30,2581,6663;10732,0,0,0,2,0,2
14624,30,2583,6666;6667,0,0,0,0,2,2
14625,30,2584,6669;6670,0,0,0,0,2,2
14626,30,2585,6673,0,0,0,0,1,1
14627,30,2587,6677,0,0,0,0,1,1
14628,30,2589,2706;11177,0,0,0,2,0,2
14629,30,2593,6690;6691,0,0,0,0,2,2
14630,30,2595,6697;8008,0,0,0,2,0,2
14631,30,2596,6704,0,0,0,0,1,1
14632,30,2597,6708,0,0,0,0,1,1
14633,30,2603,6726;6729,0,0,0,1,1,2
14634,30,2604,6730,0,0,0,1,0,1
14635,30,2606,6737;6738;10746,0,0,0,2,1,3
14636,30,2607,6739;6740,0,0,0,0,2,2
14637,30,2609,6745,0,0,0,0,1,1
14638,30,2610,6746,0,0,0,0,1,1
14639,30,2611,6749,0,0,0,0,1,1
14640,30,2612,6752;6753,0,0,0,0,2,2
14641,30,2615,6756,0,0,0,0,1,1
14642,30,2619,1139;6770;11219;11438;11720;12306;12902,0,1,3,3,0,7
14643,30,2623,6777,0,0,0,0,1,1
14644,30,2624,6781,0,0,0,1,0,1
14645,30,2627,6476;6790,0,0,0,0,2,2
14646,30,2629,2371;6798,0,0,0,0,2,2
14647,30,2631,6802;11306,0,0,0,2,0,2
14648,30,2632,6803;6804,0,0,0,0,2,2
14649,30,2634,1978;11314,0,0,0,2,0,2
14650,30,2636,6812,0,0,0,0,1,1
14651,30,2637,6814,0,0,0,0,1,1
14652,30,2638,10957,0,0,0,1,0,1
14653,30,2639,6817;6818,0,0,0,0,2,2
14654,30,2640,6821,0,0,0,0,1,1
14655,30,2641,6824,0,0,0,0,1,1
14656,30,2642,6825,0,0,0,1,0,1
14657,30,2643,6828;6829;10395,0,0,0,2,1,3
14658,30,2645,6832;9029,0,0,0,0,2,2
14659,30,2646,1012;6834,0,0,0,0,2,2
14660,30,2647,6841,0,0,0,0,1,1
14661,30,2648,6844,0,0,0,0,1,1
14662,30,2650,6853;6855,0,0,0,1,1,2
14663,30,2651,2753,0,0,0,0,1,1
14664,30,2652,6860,0,0,0,0,1,1
14665,30,2653,811;6862;6867,0,0,0,2,1,3
14666,30,2654,6868,0,0,0,0,1,1
14667,30,2657,6876,0,0,0,0,1,1
14668,30,2658,2545;5191;6878;6880;9355;11796;12627;13364,0,1,2,5,0,8
14669,30,2660,6883,0,0,0,0,1,1
14670,30,2661,6888,0,0,0,0,1,1
14671,30,2669,6900,0,0,0,0,1,1
14672,30,2670,4095,0,0,0,0,1,1
14673,30,2672,6906,0,0,0,0,1,1
14674,30,2673,6909;6911,0,0,0,1,1,2
14675,30,2674,6913,0,0,0,1,0,1
14676,30,2675,5476;6915,0,0,0,1,1,2
14677,30,2676,6918,0,0,0,1,0,1
14678,30,2678,6924;8423,0,0,0,0,2,2
14679,30,2680,6926,0,0,0,0,1,1
14680,30,2681,3235;6928,0,0,0,1,1,2
14681,30,2685,6938;6939,0,0,0,0,2,2
14682,30,2686,6940;6941,0,0,0,0,2,2
14683,30,2688,6031;6944,0,0,0,0,2,2
14684,30,2689,6945;6946,0,0,0,0,2,2
14685,30,2690,3442;6952;11125,0,0,0,3,0,3
14686,30,2691,6957,0,0,0,0,1,1
14687,30,2694,6961,0,0,0,0,1,1
14688,30,2698,6966,0,0,0,0,1,1
14689,30,2699,6969;8578;10946,0,0,0,3,0,3
14690,30,2701,6976,0,0,0,0,1,1
14691,30,2705,4691;6988;6990,0,0,0,3,0,3
14692,30,2706,6992,0,0,0,0,1,1
14693,30,2712,7006,0,0,0,0,1,1
14694,30,2714,7014,0,0,0,0,1,1
14695,30,2715,7017,0,0,0,0,1,1
14696,30,2716,7023,0,0,0,0,1,1
14697,30,2717,7026;9064,0,0,0,2,0,2
14698,30,2718,1248;7028,0,0,0,2,0,2
14699,30,2719,7034;7035,0,0,0,2,0,2
14700,30,2723,7045,0,0,0,1,0,1
14701,30,2725,7048;9808;10736;11199,0,0,0,4,0,4
14702,30,2727,7053,0,0,0,0,1,1
14703,30,2729,7057,0,0,0,0,1,1
14704,30,2730,7059,0,0,0,0,1,1
14705,30,2731,7061,0,0,0,0,1,1
14706,30,2735,7074,0,0,0,1,0,1
14707,30,2736,7075;7076,0,0,0,2,0,2
14708,30,2737,7080,0,0,0,0,1,1
14709,30,2739,7085,0,0,0,0,1,1
14710,30,2742,7091;8465,0,0,0,1,1,2
14711,30,2743,7092,0,0,0,0,1,1
14712,30,2744,7094;11476;11611,0,0,2,1,0,3
14713,30,2745,7096;9868,0,0,0,2,0,2
14714,30,2746,7099;7100,0,0,0,0,2,2
14715,30,2751,6428;7113;7115,0,0,0,1,2,3
14716,30,2754,7122;7123,0,0,0,0,2,2
14717,30,2756,7131,0,0,0,0,1,1
14718,30,2758,7133;7134,0,0,0,0,2,2
14719,30,2759,7135;10711;11040,0,0,0,3,0,3
14720,30,2760,7136;7137,0,0,0,0,2,2
14721,30,2761,7139;7140,0,0,0,1,1,2
14722,30,2763,7147,0,0,0,0,1,1
14723,30,2764,7149;7613,0,0,0,1,1,2
14724,30,2765,7153,0,0,0,0,1,1
14725,30,2766,7154,0,0,0,0,1,1
14726,30,2769,1760;7162;10335,0,0,0,3,0,3
14727,30,2770,6765;7164,0,0,0,2,0,2
14728,30,2771,2671;7165,0,0,0,1,1,2
14729,30,2772,5919;7167;10971,0,0,0,3,0,3
14730,30,2773,7169;7296,0,0,0,0,2,2
14731,30,2776,7178,0,0,0,1,0,1
14732,30,2777,7182,0,0,0,0,1,1
14733,30,2783,7194,0,0,0,0,1,1
14734,30,2785,7198;7199,0,0,0,1,1,2
14735,30,2788,7205,0,0,0,0,1,1
14736,30,2791,3815;4767,0,0,0,0,2,2
14737,30,2792,7214,0,0,0,0,1,1
14738,30,2794,7218,0,0,0,0,1,1
14739,30,2795,7220,0,0,0,0,1,1
14740,30,2796,7225,0,0,0,0,1,1
14741,30,2797,7228;7229,0,0,0,1,1,2
14742,30,2798,7231,0,0,0,0,1,1
14743,30,2799,5855;7232,0,0,0,0,2,2
14744,30,2801,7239,0,0,0,0,1,1
14745,30,2802,7241,0,0,0,1,0,1
14746,30,2809,7252,0,0,0,1,0,1
14747,30,2811,457;7258,0,0,0,0,2,2
14748,30,2814,7263;7264;10057;10780;10939,0,0,0,4,1,5
14749,30,2815,7266,0,0,0,0,1,1
14750,30,2817,7269;8082,0,0,0,2,0,2
14751,30,2818,7270;7271,0,0,0,0,2,2
14752,30,2819,5342;7273;10279,0,0,0,2,1,3
14753,30,2820,7277;9362;10543,0,0,0,3,0,3
14754,30,2821,7279,0,0,0,0,1,1
14755,30,2823,7284,0,0,0,0,1,1
14756,30,2824,6;7286;12445,0,0,1,2,0,3
14757,30,2825,7288,0,0,0,0,1,1
14758,30,2826,7289,0,0,0,0,1,1
14759,30,2827,7292,0,0,0,0,1,1
14760,30,2829,7297;9899,0,0,0,1,1,2
14761,30,2832,7305;7307,0,0,0,1,1,2
14762,30,2833,5954;6965,0,0,0,0,2,2
14763,30,2834,3577,0,0,0,0,1,1
14764,30,2836,7317;10070,0,0,0,1,1,2
14765,30,2838,7324;9623,0,0,0,2,0,2
14766,30,2839,7325;11797,0,0,1,1,0,2
14767,30,2840,7327,0,0,0,0,1,1
14768,30,2841,7328;7329;7331,0,0,0,1,2,3
14769,30,2846,7338;7344,0,0,0,1,1,2
14770,30,2848,7348,0,0,0,0,1,1
14771,30,2850,7351,0,0,0,0,1,1
14772,30,2851,7354;7355;11230,0,0,0,2,1,3
14773,30,2852,7356,0,0,0,0,1,1
14774,30,2853,7358,0,0,0,0,1,1
14775,30,2854,7363,0,0,0,0,1,1
14776,30,2855,8080,0,0,0,0,1,1
14777,30,2860,7377,0,0,0,0,1,1
14778,30,2861,4364;6063,0,0,0,0,2,2
14779,30,2862,2908;7380;7382,0,0,0,1,2,3
14780,30,2863,7384;9946,0,0,0,2,0,2
14781,30,2865,7388,0,0,0,0,1,1
14782,30,2866,1750;5602;11287;11533,0,0,1,3,0,4
14783,30,2867,7393;7395,0,0,0,1,1,2
14784,30,2869,4577;7399,0,0,0,2,0,2
14785,30,2870,7400;7401;7405,0,0,0,2,1,3
14786,30,2871,10807,0,0,0,1,0,1
14787,30,2874,1613;7415,0,0,0,0,2,2
14788,30,2875,7416;7417;7418,0,0,0,2,1,3
14789,30,2877,7424,0,0,0,0,1,1
14790,30,2878,7427,0,0,0,0,1,1
14791,30,2882,7438;7439;7440,0,0,0,2,1,3
14792,30,2883,7442;7443,0,0,0,1,1,2
14793,30,2886,7450;8196,0,0,0,0,2,2
14794,30,2893,7467,0,0,0,0,1,1
14795,30,2894,7468,0,0,0,1,0,1
14796,30,2895,7470;7941,0,0,0,0,2,2
14797,30,2896,7471;7472,0,0,0,1,1,2
14798,30,2897,7475,0,0,0,0,1,1
14799,30,2899,7480,0,0,0,0,1,1
14800,30,2900,7482;10820,0,0,0,2,0,2
14801,30,2901,7484,0,0,0,0,1,1
14802,30,2903,7489,0,0,0,0,1,1
14803,30,2907,3005;7501,0,0,0,2,0,2
14804,30,2908,6837;7504;12096,0,0,1,2,0,3
14805,30,2909,7507,0,0,0,0,1,1
14806,30,2915,1853;7526;10607;11042,0,0,0,4,0,4
14807,30,2919,7536;7537,0,0,0,0,2,2
14808,30,2921,7542;10151,0,0,0,2,0,2
14809,30,2923,7545,0,0,0,0,1,1
14810,30,2924,7550,0,0,0,1,0,1
14811,30,2925,7551,0,0,0,0,1,1
14812,30,2927,7560,0,0,0,0,1,1
14813,30,2929,7565,0,0,0,0,1,1
14814,30,2932,1985;7573,0,0,0,0,2,2
14815,30,2934,7576,0,0,0,0,1,1
14816,30,2937,7581;7583;7584,0,0,0,0,3,3
14817,30,2940,1947;7589,0,0,0,0,2,2
14818,30,2942,7594,0,0,0,0,1,1
14819,30,2943,7598,0,0,0,0,1,1
14820,30,2944,1569;1894,0,0,0,2,0,2
14821,30,2946,7605;9324,0,0,0,0,2,2
14822,30,2947,5322;7607;11237,0,0,0,3,0,3
14823,30,2949,7610;7611,0,0,0,0,2,2
14824,30,2951,7614,0,0,0,0,1,1
14825,30,2952,7619,0,0,0,0,1,1
14826,30,2956,7631,0,0,0,0,1,1
14827,30,2957,7635,0,0,0,0,1,1
14828,30,2959,3224,0,0,0,0,1,1
14829,30,2962,7644;7646,0,0,0,0,2,2
14830,30,2963,7648,0,0,0,0,1,1
14831,30,2964,7649;7650,0,0,0,1,1,2
14832,30,2965,3072;9299;11143,0,0,0,3,0,3
14833,30,2967,4546;7655,0,0,0,0,2,2
14834,30,2968,7660;8103,0,0,0,0,2,2
14835,30,2969,4711;7664;10776;11355,0,0,0,4,0,4
14836,30,2970,7666,0,0,0,0,1,1
14837,30,2971,9333,0,0,0,1,0,1
14838,30,2972,7668;7670,0,0,0,0,2,2
14839,30,2973,7674,0,0,0,0,1,1
14840,30,2974,7677;7678,0,0,0,0,2,2
14841,30,2975,1490;7680,0,0,0,0,2,2
14842,30,2976,7685,0,0,0,1,0,1
14843,30,2978,6057;7687,0,0,0,0,2,2
14844,30,2979,7689,0,0,0,0,1,1
14845,30,2980,7693;9770,0,0,0,0,2,2
14846,30,2981,1020;7694,0,0,0,1,1,2
14847,30,2982,7699;7700,0,0,0,2,0,2
14848,30,2983,7702;8838,0,0,0,2,0,2
14849,30,2985,7707;7708,0,0,0,1,1,2
14850,30,2989,7716;7717,0,0,0,0,2,2
14851,30,2990,779;7718,0,0,0,0,2,2
14852,30,2992,7721,0,0,0,1,0,1
14853,30,2993,7726,0,0,0,0,1,1
14854,30,2994,7731,0,0,0,0,1,1
14855,30,2997,4168;7737;10179,0,0,0,3,0,3
14856,30,2999,7743,0,0,0,0,1,1
14857,30,3000,7745,0,0,0,0,1,1
14858,30,3004,7755,0,0,0,0,1,1
14859,30,3006,4084;7757,0,0,0,0,2,2
14860,30,3007,7759,0,0,0,0,1,1
14861,30,3008,7761,0,0,0,0,1,1
14862,30,3009,7665;7766;13273,0,1,0,2,0,3
14863,30,3010,1019;7767,0,0,0,2,0,2
14864,30,3011,6543;7769,0,0,0,1,1,2
14865,30,3013,4818;7772;11015,0,0,0,3,0,3
14866,30,3014,7774,0,0,0,0,1,1
14867,30,3015,97;5461,0,0,0,0,2,2
14868,30,3016,7779;8613,0,0,0,0,2,2
14869,30,3017,7782;7784,0,0,0,1,1,2
14870,30,3020,7790;7791,0,0,0,0,2,2
14871,30,3021,6078;7792;11673;12298,0,0,2,2,0,4
14872,30,3022,219;11630;12342;12946,0,1,2,1,0,4
14873,30,3023,7795,0,0,0,0,1,1
14874,30,3024,883;7797,0,0,0,1,1,2
14875,30,3026,7800;7801;9969,0,0,0,2,1,3
14876,30,3027,7805,0,0,0,0,1,1
14877,30,3028,5858;7807;10933;11411,0,0,1,3,0,4
14878,30,3029,7810,0,0,0,0,1,1
14879,30,3030,7814,0,0,0,0,1,1
14880,30,3031,7817,0,0,0,0,1,1
14881,30,3032,7821,0,0,0,0,1,1
14882,30,3033,7826,0,0,0,1,0,1
14883,30,3035,7831,0,0,0,0,1,1
14884,30,3039,7840,0,0,0,0,1,1
14885,30,3040,7845,0,0,0,0,1,1
14886,30,3045,7854;9657;10476,0,0,0,3,0,3
14887,30,3046,963;7858,0,0,0,0,2,2
14888,30,3050,5846,0,0,0,0,1,1
14889,30,3051,7870,0,0,0,0,1,1
14890,30,3052,7875;9170;10166;10787,0,0,0,4,0,4
14891,30,3053,6398;7876,0,0,0,0,2,2
14892,30,3054,7878;9271,0,0,0,2,0,2
14893,30,3056,3028;7881;12479;13099,0,1,1,2,0,4
14894,30,3057,1983;7883,0,0,0,0,2,2
14895,30,3059,7885;7886,0,0,0,0,2,2
14896,30,3060,7887;7888;7890,0,0,0,1,2,3
14897,30,3061,7892;7894,0,0,0,1,1,2
14898,30,3062,7157;7896,0,0,0,2,0,2
14899,30,3063,7897;7898,0,0,0,0,2,2
14900,30,3065,7903;8139,0,0,0,2,0,2
14901,30,3069,7910;7911,0,0,0,0,2,2
14902,30,3070,2747;7915;10829;11191,0,0,0,4,0,4
14903,30,3071,4646;7916,0,0,0,1,1,2
14904,30,3072,3335;3382;4235;7920;11365,0,0,0,5,0,5
14905,30,3074,7924,0,0,0,0,1,1
14906,30,3076,7931;7932,0,0,0,0,2,2
14907,30,3077,7934,0,0,0,0,1,1
14908,30,3078,4188;7937;10600;11838;12402,0,0,2,3,0,5
14909,30,3079,292;7938,0,0,0,0,2,2
14910,30,3080,7940,0,0,0,0,1,1
14911,30,3082,7949,0,0,0,0,1,1
14912,30,3083,7950;7951,0,0,0,0,2,2
14913,30,3085,7953;7954,0,0,0,0,2,2
14914,30,3087,7956,0,0,0,0,1,1
14915,30,3088,7958,0,0,0,0,1,1
14916,30,3091,7968,0,0,0,0,1,1
14917,30,3092,7970;7971,0,0,0,0,2,2
14918,30,3096,7980,0,0,0,0,1,1
14919,30,3098,7985;10581;10659,0,0,0,3,0,3
14920,30,3100,2932;7987;10876;11090,0,0,0,4,0,4
14921,30,3101,7159;7991,0,0,0,2,0,2
14922,30,3102,7996;7997;10471;10830,0,0,0,4,0,4
14923,30,3104,8001,0,0,0,0,1,1
14924,30,3106,8004;8006,0,0,0,0,2,2
14925,30,3108,762;8009,0,0,0,0,2,2
14926,30,3109,7321;8011;11490,0,0,1,2,0,3
14927,30,3110,8012,0,0,0,0,1,1
14928,30,3112,3792;11388;12090,0,0,1,2,0,3
14929,30,3113,8021;8025,0,0,0,0,2,2
14930,30,3115,8032,0,0,0,0,1,1
14931,30,3116,8036,0,0,0,0,1,1
14932,30,3119,8045,0,0,0,0,1,1
14933,30,3120,8048;8051,0,0,0,1,1,2
14934,30,3122,8056,0,0,0,1,0,1
14935,30,3123,7639;8058,0,0,0,0,2,2
14936,30,3124,8059,0,0,0,0,1,1
14937,30,3126,8064;8240,0,0,0,0,2,2
14938,30,3127,8066,0,0,0,0,1,1
14939,30,3128,6231;8068,0,0,0,0,2,2
14940,30,3137,5548;8085;11430,0,0,1,2,0,3
14941,30,3138,5996;8088,0,0,0,0,2,2
14942,30,3139,8090;8091,0,0,0,0,2,2
14943,30,3140,8849,0,0,0,0,1,1
14944,30,3142,8098;10801,0,0,0,2,0,2
14945,30,3146,3616;8105,0,0,0,0,2,2
14946,30,3147,8107;8108,0,0,0,1,1,2
14947,30,3148,8112,0,0,0,0,1,1
14948,30,3150,8118;9822,0,0,0,0,2,2
14949,30,3152,8126,0,0,0,0,1,1
14950,30,3154,8130;8131,0,0,0,1,1,2
14951,30,3155,8134,0,0,0,0,1,1
14952,30,3156,8136,0,0,0,0,1,1
14953,30,3157,8138,0,0,0,0,1,1
14954,30,3158,3189;8141;10855,0,0,0,3,0,3
14955,30,3159,9391;10656,0,0,0,2,0,2
14956,30,3160,5207;8147;10708,0,0,0,3,0,3
14957,30,3161,8152,0,0,0,0,1,1
14958,30,3162,4932;8153,0,0,0,0,2,2
14959,30,3163,7350;8156;11106,0,0,0,3,0,3
14960,30,3164,8157;8158,0,0,0,1,1,2
14961,30,3167,8162;10370;10814,0,0,0,2,1,3
14962,30,3168,8166;11032;11113,0,0,0,3,0,3
14963,30,3170,8174,0,0,0,0,1,1
14964,30,3172,8179,0,0,0,0,1,1
14965,30,3176,8190,0,0,0,0,1,1
14966,30,3178,8193,0,0,0,0,1,1
14967,30,3179,8195,0,0,0,0,1,1
14968,30,3181,8651,0,0,0,0,1,1
14969,30,3182,8203;8437,0,0,0,2,0,2
14970,30,3186,8209,0,0,0,0,1,1
14971,30,3188,7828;8212,0,0,0,0,2,2
14972,30,3189,6757;11161;11291,0,0,0,3,0,3
14973,30,3191,1943;8219;8220;12063;12105;12207,0,0,3,2,1,6
14974,30,3192,8223,0,0,0,0,1,1
14975,30,3195,8231,0,0,0,1,0,1
14976,30,3197,3608;8234,0,0,0,0,2,2
14977,30,3198,6783;8236;8238;10914;11952,0,0,1,4,0,5
14978,30,3199,8184;8239;10750;11471,0,0,1,3,0,4
14979,30,3201,5578;8241,0,0,0,2,0,2
14980,30,3202,884;8243;10647,0,0,0,3,0,3
14981,30,3204,4970;8245;10916;11211,0,0,0,4,0,4
14982,30,3205,8247;9597;10454,0,0,0,3,0,3
14983,30,3206,8250;8251,0,0,0,1,1,2
14984,30,3207,8255;8882;10430,0,0,0,3,0,3
14985,30,3208,8257,0,0,0,0,1,1
14986,30,3211,8261,0,0,0,0,1,1
14987,30,3212,8263,0,0,0,1,0,1
14988,30,3216,8275;9828,0,0,0,0,2,2
14989,30,3217,8279,0,0,0,0,1,1
14990,30,3218,8281;8282,0,0,0,0,2,2
14991,30,3221,1848;8294,0,0,0,0,2,2
14992,30,3223,8298,0,0,0,0,1,1
14993,30,3225,8301,0,0,0,0,1,1
14994,30,3227,1178;8305;10990,0,0,0,3,0,3
14995,30,3228,8309,0,0,0,0,1,1
14996,30,3230,8316,0,0,0,0,1,1
14997,30,3231,2682;8545,0,0,0,1,1,2
14998,30,3233,5052;8326,0,0,0,0,2,2
14999,30,3235,8329;9260,0,0,0,0,2,2
15000,30,3236,3509;8334;11138;11751,0,0,1,3,0,4
15001,30,3237,4370;8337,0,0,0,2,0,2
15002,30,3242,8349,0,0,0,1,0,1
15003,30,3243,3295;8350;10438;11280;11300,0,0,0,5,0,5
15004,30,3244,8353,0,0,0,0,1,1
15005,30,3245,8354;8355,0,0,0,0,2,2
15006,30,3246,466;2608;10760,0,0,0,3,0,3
15007,30,3247,7676;8357,0,0,0,2,0,2
15008,30,3248,8359;8360,0,0,0,0,2,2
15009,30,3250,8366;8367;10678,0,0,0,2,1,3
15010,30,3251,8369;8370,0,0,0,0,2,2
15011,30,3252,280;8371,0,0,0,0,2,2
15012,30,3253,8373,0,0,0,0,1,1
15013,30,3255,8379,0,0,0,0,1,1
15014,30,3256,8381,0,0,0,0,1,1
15015,30,3258,8387,0,0,0,1,0,1
15016,30,3259,8390,0,0,0,0,1,1
15017,30,3260,4582;8393,0,0,0,2,0,2
15018,30,3261,8522,0,0,0,1,0,1
15019,30,3262,4988,0,0,0,0,1,1
15020,30,3263,8402,0,0,0,0,1,1
15021,30,3264,1357;8404,0,0,0,0,2,2
15022,30,3267,8413;8414,0,0,0,0,2,2
15023,30,3268,8415;8416;8418,0,0,0,1,2,3
15024,30,3270,8422,0,0,0,0,1,1
15025,30,3271,3543,0,0,0,0,1,1
15026,30,3272,8428,0,0,0,0,1,1
15027,30,3276,8435;9461;10566,0,0,0,2,1,3
15028,30,3277,8438,0,0,0,0,1,1
15029,30,3278,8439,0,0,0,0,1,1
15030,30,3279,6648;8441,0,0,0,0,2,2
15031,30,3281,8447,0,0,0,1,0,1
15032,30,3282,8450;10327,0,0,0,2,0,2
15033,30,3283,8451;8452,0,0,0,0,2,2
15034,30,3285,8459,0,0,0,0,1,1
15035,30,3286,8460,0,0,0,0,1,1
15036,30,3287,8462;8463,0,0,0,0,2,2
15037,30,3288,7493;8464;11226;11446,0,0,1,3,0,4
15038,30,3289,8468,0,0,0,0,1,1
15039,30,3290,8474,0,0,0,1,0,1
15040,30,3291,8475,0,0,0,0,1,1
15041,30,3296,416,0,0,0,0,1,1
15042,30,3297,8496,0,0,0,1,0,1
15043,30,3298,8500,0,0,0,0,1,1
15044,30,3301,4041;8506,0,0,0,0,2,2
15045,30,3303,8508;8509,0,0,0,1,1,2
15046,30,3304,8510,0,0,0,0,1,1
15047,30,3305,5351;8513,0,0,0,0,2,2
15048,30,3306,8517,0,0,0,0,1,1
15049,30,3307,8521,0,0,0,0,1,1
15050,30,3312,2312,0,0,0,0,1,1
15051,30,3313,8532,0,0,0,0,1,1
15052,30,3316,8159;8542;10848,0,0,0,3,0,3
15053,30,3318,8550;8551,0,0,0,1,1,2
15054,30,3319,7453;8554;10667;12469,0,0,1,3,0,4
15055,30,3320,8557;8911,0,0,0,0,2,2
15056,30,3322,8563,0,0,0,0,1,1
15057,30,3323,893;8427;8566,0,0,0,3,0,3
15058,30,3324,8569,0,0,0,0,1,1
15059,30,3326,8571,0,0,0,0,1,1
15060,30,3328,8575,0,0,0,0,1,1
15061,30,3330,8579,0,0,0,0,1,1
15062,30,3332,8582;8583,0,0,0,0,2,2
15063,30,3335,8588,0,0,0,0,1,1
15064,30,3336,8593,0,0,0,0,1,1
15065,30,3338,8599;8600,0,0,0,0,2,2
15066,30,3339,8603,0,0,0,0,1,1
15067,30,3340,8605,0,0,0,0,1,1
15068,30,3341,8606;8607,0,0,0,0,2,2
15069,30,3342,8084,0,0,0,0,1,1
15070,30,3343,5070;8611;11050;11437,0,0,1,3,0,4
15071,30,3345,8614,0,0,0,0,1,1
15072,30,3346,8621;8622,0,0,0,1,1,2
15073,30,3348,8630,0,0,0,0,1,1
15074,30,3349,8632;8634,0,0,0,0,2,2
15075,30,3350,8635,0,0,0,0,1,1
15076,30,3351,8636,0,0,0,0,1,1
15077,30,3352,8640,0,0,0,0,1,1
15078,30,3353,8645,0,0,0,0,1,1
15079,30,3354,8647;8648,0,0,0,0,2,2
15080,30,3356,8653,0,0,0,0,1,1
15081,30,3357,8655,0,0,0,0,1,1
15082,30,3358,5276;8658,0,0,0,0,2,2
15083,30,3360,7908;8660,0,0,0,0,2,2
15084,30,3362,8666,0,0,0,0,1,1
15085,30,3363,8667,0,0,0,0,1,1
15086,30,3364,8669,0,0,0,0,1,1
15087,30,3365,8671,0,0,0,0,1,1
15088,30,3367,5040;8681;12541,0,0,1,2,0,3
15089,30,3369,372,0,0,0,1,0,1
15090,30,3370,8686,0,0,0,0,1,1
15091,30,3372,8690,0,0,0,0,1,1
15092,30,3373,8694,0,0,0,0,1,1
15093,30,3376,8702;8708,0,0,0,0,2,2
15094,30,3379,5920;8706,0,0,0,1,1,2
15095,30,3382,8713,0,0,0,0,1,1
15096,30,3383,8721;10243;13210,0,1,0,2,0,3
15097,30,3384,7919;8722;10237;10441,0,0,0,4,0,4
15098,30,3386,8726,0,0,0,0,1,1
15099,30,3387,8728;11418,0,0,1,1,0,2
15100,30,3390,8733,0,0,0,0,1,1
15101,30,3391,8734,0,0,0,0,1,1
15102,30,3392,8736;8737,0,0,0,0,2,2
15103,30,3393,8738,0,0,0,0,1,1
15104,30,3394,442,0,0,0,0,1,1
15105,30,3395,8745,0,0,0,0,1,1
15106,30,3396,8748,0,0,0,0,1,1
15107,30,3397,8752,0,0,0,0,1,1
15108,30,3398,8755;8757;11741,0,0,1,2,0,3
15109,30,3400,8761;8762,0,0,0,0,2,2
15110,30,3402,8765,0,0,0,0,1,1
15111,30,3404,8773;8774;10994,0,0,0,2,1,3
15112,30,3405,8775,0,0,0,0,1,1
15113,30,3406,413;7657;11385;11511;11971,0,0,2,3,0,5
15114,30,3407,7977;8783;8784,0,0,0,3,0,3
15115,30,3411,4273;8790,0,0,0,2,0,2
15116,30,3415,8802,0,0,0,0,1,1
15117,30,3416,8804;10699;11247;11569,0,0,1,3,0,4
15118,30,3418,8811;8813,0,0,0,0,2,2
15119,30,3421,8825,0,0,0,0,1,1
15120,30,3422,8828;8831;9393,0,0,0,3,0,3
15121,30,3423,8164;8832,0,0,0,0,2,2
15122,30,3425,8835,0,0,0,0,1,1
15123,30,3426,8841;8842,0,0,0,1,1,2
15124,30,3427,6799;8844;10276;12036,0,0,1,3,0,4
15125,30,3429,8847,0,0,0,0,1,1
15126,30,3431,8852;8854,0,0,0,1,1,2
15127,30,3435,8862;10321;13015,0,1,0,2,0,3
15128,30,3436,2310;8863,0,0,0,0,2,2
15129,30,3438,8868,0,0,0,1,0,1
15130,30,3440,8873,0,0,0,0,1,1
15131,30,3442,2388;8875,0,0,0,1,1,2
15132,30,3446,8883;8884,0,0,0,1,1,2
15133,30,3447,122,0,0,0,0,1,1
15134,30,3448,8891;8892,0,0,0,1,1,2
15135,30,3449,8718;8895;10858;11003,0,0,0,4,0,4
15136,30,3450,8896;8897,0,0,0,0,2,2
15137,30,3451,8901,0,0,0,0,1,1
15138,30,3452,8906,0,0,0,0,1,1
15139,30,3453,8907,0,0,0,0,1,1
15140,30,3456,8914;8915,0,0,0,1,1,2
15141,30,3457,8917,0,0,0,0,1,1
15142,30,3458,8919,0,0,0,0,1,1
15143,30,3459,8920,0,0,0,0,1,1
15144,30,3460,8923,0,0,0,0,1,1
15145,30,3461,8926;8927,0,0,0,0,2,2
15146,30,3462,8930,0,0,0,0,1,1
15147,30,3463,8935,0,0,0,0,1,1
15148,30,3464,7124,0,0,0,0,1,1
15149,30,3467,8942;9704,0,0,0,2,0,2
15150,30,3468,8943,0,0,0,0,1,1
15151,30,3470,3635;8952,0,0,0,0,2,2
15152,30,3471,8956,0,0,0,0,1,1
15153,30,3474,8963,0,0,0,0,1,1
15154,30,3475,8964;8965,0,0,0,0,2,2
15155,30,3476,8968;8969;10261,0,0,0,2,1,3
15156,30,3477,8970,0,0,0,0,1,1
15157,30,3478,8973,0,0,0,0,1,1
15158,30,3479,2009;8978;12597;12744;13207,0,2,1,2,0,5
15159,30,3482,2570,0,0,0,0,1,1
15160,30,3483,8988,0,0,0,0,1,1
15161,30,3484,8990,0,0,0,0,1,1
15162,30,3486,3039;8993,0,0,0,0,2,2
15163,30,3488,4131;9000;11389,0,0,0,3,0,3
15164,30,3490,9005,0,0,0,0,1,1
15165,30,3491,9010,0,0,0,0,1,1
15166,30,3493,6383;9014,0,0,0,2,0,2
15167,30,3494,9018,0,0,0,0,1,1
15168,30,3495,9019;9020,0,0,0,1,1,2
15169,30,3496,9023,0,0,0,0,1,1
15170,30,3497,9025,0,0,0,0,1,1
15171,30,3498,9026;9784,0,0,0,2,0,2
15172,30,3501,9030,0,0,0,0,1,1
15173,30,3502,9529,0,0,0,0,1,1
15174,30,3504,9038,0,0,0,0,1,1
15175,30,3505,588;9044,0,0,0,0,2,2
15176,30,3507,2885;9050,0,0,0,2,0,2
15177,30,3509,9052;9053,0,0,0,0,2,2
15178,30,3510,4880;9055,0,0,0,2,0,2
15179,30,3512,310;9060,0,0,0,2,0,2
15180,30,3515,9065,0,0,0,1,0,1
15181,30,3516,8076;9067,0,0,0,1,1,2
15182,30,3517,324;9070,0,0,0,2,0,2
15183,30,3518,9073,0,0,0,0,1,1
15184,30,3519,2383;9076;12485,0,0,1,2,0,3
15185,30,3520,9079;9081,0,0,0,0,2,2
15186,30,3523,1865;8979,0,0,0,0,2,2
15187,30,3524,3655;9089,0,0,0,2,0,2
15188,30,3525,9092,0,0,0,0,1,1
15189,30,3526,9093,0,0,0,1,0,1
15190,30,3527,9096,0,0,0,0,1,1
15191,30,3528,9100,0,0,0,0,1,1
15192,30,3529,9107,0,0,0,0,1,1
15193,30,3532,4380,0,0,0,0,1,1
15194,30,3533,9121,0,0,0,0,1,1
15195,30,3534,9122,0,0,0,0,1,1
15196,30,3535,9124,0,0,0,0,1,1
15197,30,3536,9129,0,0,0,0,1,1
15198,30,3537,4530;9131,0,0,0,2,0,2
15199,30,3540,9140,0,0,0,0,1,1
15200,30,3543,2132;9146,0,0,0,0,2,2
15201,30,3545,9150,0,0,0,1,0,1
15202,30,3546,4797;9152;11044;11231,0,0,0,4,0,4
15203,30,3549,9158,0,0,0,0,1,1
15204,30,3550,9167,0,0,0,1,0,1
15205,30,3555,9176;9177,0,0,0,0,2,2
15206,30,3557,8597;9180,0,0,0,0,2,2
15207,30,3558,9182,0,0,0,0,1,1
15208,30,3559,9183;9184;11210;11634;11886,0,0,2,2,1,5
15209,30,3560,9185;9186;10077,0,0,0,2,1,3
15210,30,3563,9193;9864,0,0,0,0,2,2
15211,30,3565,9199,0,0,0,0,1,1
15212,30,3566,9200;9201,0,0,0,0,2,2
15213,30,3569,9206;9209,0,0,0,0,2,2
15214,30,3570,8724;9212;10125,0,0,0,1,2,3
15215,30,3572,1827,0,0,0,0,1,1
15216,30,3574,7498,0,0,0,0,1,1
15217,30,3576,9236;9237,0,0,0,0,2,2
15218,30,3580,10502;12749,0,1,0,1,0,2
15219,30,3581,5875;9248,0,0,0,2,0,2
15220,30,3582,9250,0,0,0,1,0,1
15221,30,3584,9253,0,0,0,0,1,1
15222,30,3587,9261;9262,0,0,0,1,1,2
15223,30,3588,6572;9264;9267,0,0,0,1,2,3
15224,30,3589,8093;9268,0,0,0,0,2,2
15225,30,3592,5224;9274;10936,0,0,0,3,0,3
15226,30,3593,9276,0,0,0,0,1,1
15227,30,3594,1351;2231;2240;6102;11530;12017;12103;12231;12400;12581;12849,0,1,6,4,0,11
15228,30,3595,2478;9761,0,0,0,0,2,2
15229,30,3596,9283,0,0,0,0,1,1
15230,30,3597,9286;9658,0,0,0,0,2,2
15231,30,3603,9294;9295;10293;11179;12301,0,0,1,3,1,5
15232,30,3604,9296,0,0,0,0,1,1
15233,30,3605,3373;9301;10634,0,0,0,3,0,3
15234,30,3606,9304,0,0,0,1,0,1
15235,30,3608,9307,0,0,0,0,1,1
15236,30,3609,9308,0,0,0,0,1,1
15237,30,3610,9310,0,0,0,0,1,1
15238,30,3611,9312;9313,0,0,0,1,1,2
15239,30,3612,3533;9315;9316,0,0,0,3,0,3
15240,30,3613,3739;9319;11717,0,0,1,2,0,3
15241,30,3618,9327,0,0,0,0,1,1
15242,30,3619,9335,0,0,0,0,1,1
15243,30,3620,9337,0,0,0,0,1,1
15244,30,3621,9341,0,0,0,0,1,1
15245,30,3623,8938;9345,0,0,0,0,2,2
15246,30,3624,9346,0,0,0,0,1,1
15247,30,3625,1615;9349;10619;10726,0,0,0,4,0,4
15248,30,3628,9360,0,0,0,1,0,1
15249,30,3629,4789;9363,0,0,0,0,2,2
15250,30,3630,9366;9367,0,0,0,0,2,2
15251,30,3631,9372;9373,0,0,0,0,2,2
15252,30,3632,9374;9375,0,0,0,1,1,2
15253,30,3633,9377,0,0,0,0,1,1
15254,30,3634,5684,0,0,0,1,0,1
15255,30,3636,9382,0,0,0,0,1,1
15256,30,3637,9383;9384,0,0,0,1,1,2
15257,30,3639,4032;9386,0,0,0,2,0,2
15258,30,3641,695;9395,0,0,0,0,2,2
15259,30,3643,4233;9399,0,0,0,1,1,2
15260,30,3645,9404;9405,0,0,0,0,2,2
15261,30,3646,9407;9408,0,0,0,1,1,2
15262,30,3647,9409,0,0,0,0,1,1
15263,30,3649,9416,0,0,0,0,1,1
15264,30,3651,10777;10992;13393,0,1,0,2,0,3
15265,30,3655,9438,0,0,0,0,1,1
15266,30,3659,9445,0,0,0,0,1,1
15267,30,3662,9452;9453,0,0,0,1,1,2
15268,30,3663,9456,0,0,0,0,1,1
15269,30,3666,9464;9470,0,0,0,2,0,2
15270,30,3667,9465;9466,0,0,0,0,2,2
15271,30,3670,9474,0,0,0,0,1,1
15272,30,3671,9476,0,0,0,0,1,1
15273,30,3673,3643;9479,0,0,0,1,1,2
15274,30,3674,9481;9483,0,0,0,0,2,2
15275,30,3675,9486,0,0,0,0,1,1
15276,30,3680,9498,0,0,0,0,1,1
15277,30,3682,9503,0,0,0,0,1,1
15278,30,3684,9508;11370;11896;12397,0,0,2,1,1,4
15279,30,3685,9509,0,0,0,0,1,1
15280,30,3686,7435;9512;9514,0,0,0,3,0,3
15281,30,3687,9517;11934,0,0,1,1,0,2
15282,30,3688,9521;9522;11883;12032,0,0,2,1,1,4
15283,30,3690,9524;9525,0,0,0,1,1,2
15284,30,3691,9530,0,0,0,0,1,1
15285,30,3693,2022;9535,0,0,0,0,2,2
15286,30,3694,9537,0,0,0,0,1,1
15287,30,3695,1391,0,0,0,0,1,1
15288,30,3696,4346;9542,0,0,0,0,2,2
15289,30,3698,9546,0,0,0,0,1,1
15290,30,3699,9548;9549,0,0,0,1,1,2
15291,30,3701,6021;9552,0,0,0,2,0,2
15292,30,3703,9555,0,0,0,0,1,1
15293,30,3704,6766;9560,0,0,0,1,1,2
15294,30,3705,9566,0,0,0,0,1,1
15295,30,3706,9568,0,0,0,0,1,1
15296,30,3707,9569,0,0,0,0,1,1
15297,30,3708,9574,0,0,0,0,1,1
15298,30,3710,9579,0,0,0,0,1,1
15299,30,3712,9583;9584,0,0,0,0,2,2
15300,30,3713,9587;11221;12001,0,0,1,2,0,3
15301,30,3715,9594,0,0,0,0,1,1
15302,30,3716,5560;5633,0,0,0,2,0,2
15303,30,3718,9601,0,0,0,0,1,1
15304,30,3719,7523;9604;11222,0,0,0,3,0,3
15305,30,3721,9611,0,0,0,0,1,1
15306,30,3723,9614;9615,0,0,0,0,2,2
15307,30,3724,9618,0,0,0,0,1,1
15308,30,3725,625;9619,0,0,0,2,0,2
15309,30,3726,9620;10904;11558,0,0,1,2,0,3
15310,30,3727,9624,0,0,0,0,1,1
15311,30,3730,9632,0,0,0,0,1,1
15312,30,3731,9633;9634;10516,0,0,0,2,1,3
15313,30,3732,9635;9636;10200;10456,0,0,0,3,1,4
15314,30,3734,9641,0,0,0,0,1,1
15315,30,3736,279;10983,0,0,0,2,0,2
15316,30,3737,9570;9646,0,0,0,0,2,2
15317,30,3739,9652;9653,0,0,0,0,2,2
15318,30,3740,9656,0,0,0,0,1,1
15319,30,3742,5298;9659,0,0,0,0,2,2
15320,30,3743,9662,0,0,0,0,1,1
15321,30,3744,1420;9663;9665,0,0,0,1,2,3
15322,30,3747,9670;9671,0,0,0,1,1,2
15323,30,3748,9673,0,0,0,0,1,1
15324,30,3749,9675;9676,0,0,0,1,1,2
15325,30,3752,9685;9686,0,0,0,1,1,2
15326,30,3753,9691,0,0,0,0,1,1
15327,30,3756,592;9701,0,0,0,0,2,2
15328,30,3758,9705,0,0,0,0,1,1
15329,30,3760,9711,0,0,0,0,1,1
15330,30,3761,763;9713,0,0,0,2,0,2
15331,30,3765,9724;9728;9729,0,0,0,2,1,3
15332,30,3769,9734,0,0,0,0,1,1
15333,30,3770,9738;9741,0,0,0,2,0,2
15334,30,3771,2068;9742;11573;12038;12517,0,0,3,2,0,5
15335,30,3772,9744,0,0,0,0,1,1
15336,30,3774,9750;9809;11301;11552,0,0,1,3,0,4
15337,30,3775,9752,0,0,0,0,1,1
15338,30,3776,9754;9755,0,0,0,0,2,2
15339,30,3780,9766,0,0,0,1,0,1
15340,30,3781,7005;9771,0,0,0,0,2,2
15341,30,3782,7170;9772,0,0,0,0,2,2
15342,30,3783,9774;9775,0,0,0,0,2,2
15343,30,3784,1605;9778;10165;11029;11123,0,0,0,5,0,5
15344,30,3785,9781,0,0,0,0,1,1
15345,30,3786,9785,0,0,0,0,1,1
15346,30,3787,9789;9791,0,0,0,0,2,2
15347,30,3788,9794,0,0,0,0,1,1
15348,30,3792,1199;9803;11092,0,0,0,3,0,3
15349,30,3793,9805;9807,0,0,0,0,2,2
15350,30,3797,9815;10512,0,0,0,2,0,2
15351,30,3800,9823,0,0,0,0,1,1
15352,30,3801,9832,0,0,0,0,1,1
15353,30,3803,5108,0,0,0,0,1,1
15354,30,3809,908;4044,0,0,0,2,0,2
15355,30,3810,9856,0,0,0,0,1,1
15356,30,3812,5357;9859,0,0,0,0,2,2
15357,30,3813,799;9863,0,0,0,0,2,2
15358,30,3817,4396;9870;11019,0,0,0,3,0,3
15359,30,3818,9873,0,0,0,0,1,1
15360,30,3820,9876;9877,0,0,0,1,1,2
15361,30,3821,9881,0,0,0,0,1,1
15362,30,3822,7111,0,0,0,0,1,1
15363,30,3823,9890;9891,0,0,0,1,1,2
15364,30,3824,9893,0,0,0,0,1,1
15365,30,3825,9573;9897;12225,0,0,1,2,0,3
15366,30,3827,552;9900;11108,0,0,0,3,0,3
15367,30,3828,2280;9902,0,0,0,0,2,2
15368,30,3829,9903;9904,0,0,0,0,2,2
15369,30,3831,1666;9907;12468,0,0,1,2,0,3
15370,30,3833,9915;10930;11119;11615,0,0,1,3,0,4
15371,30,3835,9917;9918,0,0,0,0,2,2
15372,30,3837,9924,0,0,0,0,1,1
15373,30,3839,5026;9931,0,0,0,2,0,2
15374,30,3841,1878;9934,0,0,0,2,0,2
15375,30,3844,9943,0,0,0,1,0,1
15376,30,3845,9949,0,0,0,0,1,1
15377,30,3847,7578;9953,0,0,0,0,2,2
15378,30,3849,9956;9957,0,0,0,2,0,2
15379,30,3851,9959,0,0,0,0,1,1
15380,30,3852,9960;9961,0,0,0,0,2,2
15381,30,3853,9964,0,0,0,0,1,1
15382,30,3855,9971,0,0,0,0,1,1
15383,30,3856,9972,0,0,0,0,1,1
15384,30,3859,9981,0,0,0,0,1,1
15385,30,3861,8834;9988;10574;10789,0,0,0,4,0,4
15386,30,3862,9991,0,0,0,1,0,1
15387,30,3863,9992,0,0,0,0,1,1
15388,30,3864,6561,0,0,0,1,0,1
15389,30,3865,10000;10002,0,0,0,0,2,2
15390,30,3867,106,0,0,0,0,1,1
15391,30,3868,143;2324,0,0,0,0,2,2
15392,30,3869,2017,0,0,0,1,0,1
15393,30,3870,434;3065,0,0,0,0,2,2
15394,30,3871,570;6059,0,0,0,0,2,2
15395,30,3872,586,0,0,0,1,0,1
15396,30,3878,828;2133,0,0,0,1,1,2
15397,30,3882,3435,0,0,0,0,1,1
15398,30,3884,1783,0,0,0,1,0,1
15399,30,3888,2126;4971,0,0,0,1,1,2
15400,30,3889,2130,0,0,0,1,0,1
15401,30,3892,1924;2443,0,0,0,2,0,2
15402,30,3893,2526,0,0,0,0,1,1
15403,30,3895,2688;5600;10263;11244;11583,0,0,1,4,0,5
15404,30,3896,2762;8312,0,0,0,0,2,2
15405,30,3900,1736;2942,0,0,0,1,1,2
15406,30,3901,3325,0,0,0,0,1,1
15407,30,3902,2716;9127,0,0,0,1,1,2
15408,30,3903,550;3613,0,0,0,0,2,2
15409,30,3904,2038,0,0,0,0,1,1
15410,30,3906,259,0,0,0,0,1,1
15411,30,3907,4000;7516;11350,0,0,0,3,0,3
15412,30,3910,528;4243,0,0,0,0,2,2
15413,30,3911,4549,0,0,0,0,1,1
15414,30,3912,22;7226,0,0,0,2,0,2
15415,30,3914,3302,0,0,0,0,1,1
15416,30,3915,7517,0,0,0,1,0,1
15417,30,3918,5235;5972;10535,0,0,0,3,0,3
15418,30,3920,5385;9126,0,0,0,0,2,2
15419,30,3922,9925;10478,0,0,0,2,0,2
15420,30,3923,5700;6778,0,0,0,2,0,2
15421,30,3924,5754;7107,0,0,0,0,2,2
15422,30,3925,1922;5769;10622;11487;11854,0,0,2,3,0,5
15423,30,3927,3133,0,0,0,1,0,1
15424,30,3928,5771;6143;10662;10913,0,0,0,4,0,4
15425,30,3929,5504;6147;11810,0,0,1,2,0,3
15426,30,3930,3750;6306;11555,0,0,1,2,0,3
15427,30,3932,7011;9303,0,0,0,1,1,2
15428,30,3935,7253;9154,0,0,0,1,1,2
15429,30,3936,7407,0,0,0,0,1,1
15430,30,3937,4885;7904,0,0,0,0,2,2
15431,30,3938,6703;8035,0,0,0,0,2,2
15432,30,3939,8096,0,0,0,0,1,1
15433,30,3941,8213,0,0,0,0,1,1
15434,30,3943,6985;8378;11070;11393;11722,0,0,1,4,0,5
15435,30,3947,5801;8851,0,0,0,1,1,2
15436,30,3948,6620;8890;10571,0,0,0,3,0,3
15437,30,3949,8983,0,0,0,0,1,1
15438,30,3950,8999,0,0,0,0,1,1
15439,30,3951,9039,0,0,0,0,1,1
15440,30,3953,7529;9328;11270,0,0,0,3,0,3
15441,30,3954,8870;9347;10134,0,0,0,3,0,3
15442,30,3956,2282;9811,0,0,0,0,2,2
15443,30,3958,5653;8753;10884,0,0,0,3,0,3
15444,30,3959,4667;7129,0,0,0,0,2,2
15445,30,3960,1065;3338;11345;11545,365,0,1,3,0,4
15446,30,3963,534;7812;11267,365,0,0,3,0,3
15447,30,3966,1075,365,0,0,0,1,1
15448,30,3968,787;10794;11421;12313,365,0,2,2,0,4
15449,30,3969,875,365,0,0,0,1,1
15450,30,3970,1014;8026;11027,365,0,0,3,0,3
15451,30,3971,1054;8368;10897,365,0,0,3,0,3
15452,30,3972,2131,365,0,0,1,0,1
15453,30,3973,1346;1913,365,0,0,0,2,2
15454,30,3976,738;4524;10925;11457,365,0,1,3,0,4
15455,30,3978,2219;6446,365,0,0,2,0,2
15456,30,3979,1699;7926;12257,365,0,1,2,0,3
15457,30,3980,1317;1745;11586;11783,365,0,2,2,0,4
15458,30,3982,4927;9021;11737,365,0,1,2,0,3
15459,30,3983,2217,365,0,0,1,0,1
15460,30,3985,2308,365,0,0,0,1,1
15461,30,3986,224;2407,365,0,0,0,2,2
15462,30,3987,2451;9480;11049;11390,365,0,0,4,0,4
15463,30,3988,499;2468;11750;12014,365,0,2,2,0,4
15464,30,3989,1611;2490,365,0,0,2,0,2
15465,30,3990,2612;6130,365,0,0,0,2,2
15466,30,3991,1023,365,0,0,1,0,1
15467,30,3992,575;3113,365,0,0,0,2,2
15468,30,3994,3586;4917;10828,365,0,0,3,0,3
15469,30,3997,556,365,0,0,0,1,1
15470,30,4000,4231;7768,365,0,0,0,2,2
15471,30,4002,1318;3468;10514,365,0,0,3,0,3
15472,30,4005,2141;5085;11364;11693,365,0,1,3,0,4
15473,30,4007,5124,365,0,0,0,1,1
15474,30,4008,5132;9871,365,0,0,1,1,2
15475,30,4009,8455,365,0,0,1,0,1
15476,30,4010,5428,365,0,0,0,1,1
15477,30,4013,1950;5587,365,0,0,0,2,2
15478,30,4014,5691;9642;11960;12341,365,0,2,2,0,4
15479,30,4015,5757;6067;11022,365,0,0,3,0,3
15480,30,4016,860;5762,365,0,0,0,2,2
15481,30,4017,6077;9716,365,0,0,2,0,2
15482,30,4020,6022;6281;10240;11382;12010,365,0,1,4,0,5
15483,30,4021,2771,365,0,0,0,1,1
15484,30,4023,1896;1899,365,0,0,0,2,2
15485,30,4025,6533,365,0,0,0,1,1
15486,30,4026,3107;11307;11690,365,0,1,2,0,3
15487,30,4027,299;5671,365,0,0,2,0,2
15488,30,4029,5210;6863;11675;12104,365,0,2,2,0,4
15489,30,4030,5360;6977,365,0,0,0,2,2
15490,30,4031,69;7058;10982;11706,365,0,1,3,0,4
15491,30,4032,40;7071,365,0,0,1,1,2
15492,30,4033,1681;8114,365,0,0,0,2,2
15493,30,4035,7210,365,0,0,0,1,1
15494,30,4037,7547;7751,365,0,0,0,2,2
15495,30,4038,7007;7652,365,0,0,0,2,2
15496,30,4039,9939,365,0,0,1,0,1
15497,30,4040,2930;8249;11915,365,0,1,2,0,3
15498,30,4041,6769;7871;10910;11238,365,0,0,4,0,4
15499,30,4042,5370;8089,365,0,0,2,0,2
15500,30,4044,8304;8860,365,0,0,1,1,2
15501,30,4054,1556;9326;11085,365,0,0,3,0,3
15502,30,4056,1617;9538,365,0,0,1,1,2
15503,30,4058,7378;9559,365,0,0,0,2,2
15504,30,4060,2606;6330;11495;12466,365,0,2,2,0,4
15505,30,4061,178;9790;11466;11576,365,0,2,2,0,4
15506,30,4062,590;9825,365,0,0,2,0,2
15507,30,4063,7849;10655;11445,365,0,1,2,0,3
15508,30,4065,5878;9948;11302,365,0,0,3,0,3
15509,30,4066,8756;10633;11071,730,0,0,3,0,3
15510,30,4067,45;5438;11684;11773,730,0,2,2,0,4
15511,30,4070,266,730,0,0,0,1,1
15512,30,4071,270,730,0,0,0,1,1
15513,30,4072,302;5123,730,0,0,0,2,2
15514,30,4073,478,730,0,0,0,1,1
15515,30,4074,542;2525;10689,730,0,0,3,0,3
15516,30,4076,5525;11124;11324;11624,730,0,1,3,0,4
15517,30,4077,578;705;10318,730,0,0,3,0,3
15518,30,4078,792;7539;10915;11286,730,0,0,4,0,4
15519,30,4080,4985,730,0,0,0,1,1
15520,30,4082,973;8946,730,0,0,1,1,2
15521,30,4083,999;3322,730,0,0,0,2,2
15522,30,4084,4197;10710,730,0,0,2,0,2
15523,30,4085,1246;9449;10922;11151,730,0,0,4,0,4
15524,30,4087,1523,730,0,0,0,1,1
15525,30,4088,1688,730,0,0,0,1,1
15526,30,4089,1728,730,0,0,0,1,1
15527,30,4090,3785;6917,730,0,0,0,2,2
15528,30,4091,5280,730,0,0,0,1,1
15529,30,4095,8801;9996,730,0,0,2,0,2
15530,30,4099,2663;5877,730,0,0,0,2,2
15531,30,4101,2743;9491,730,0,0,0,2,2
15532,30,4102,2825;9500;10968;11346,730,0,0,4,0,4
15533,30,4104,1209;2879;10651;10905;11061,730,0,0,5,0,5
15534,30,4105,3143,730,0,0,0,1,1
15535,30,4108,593;3354,730,0,0,0,2,2
15536,30,4109,4399;11342,730,0,0,2,0,2
15537,30,4110,78;6164;10715;10854,730,0,0,4,0,4
15538,30,4112,3549;8061,730,0,0,1,1,2
15539,30,4114,3690,730,0,0,1,0,1
15540,30,4116,3868;5945;10652,730,0,0,3,0,3
15541,30,4117,702;3878,730,0,0,0,2,2
15542,30,4119,4115,730,0,0,0,1,1
15543,30,4121,4384;5605;11245,730,0,0,3,0,3
15544,30,4124,5546;10826;11030;11410,730,0,1,3,0,4
15545,30,4125,2966;4539,730,0,0,0,2,2
15546,30,4128,7587;8925,730,0,0,2,0,2
15547,30,4129,4485;4761,730,0,0,0,2,2
15548,30,4133,4648;4923,730,0,0,2,0,2
15549,30,4137,5292,730,0,0,0,1,1
15550,30,4138,5305,730,0,0,0,1,1
15551,30,4140,1205;5362,730,0,0,1,1,2
15552,30,4141,5411,730,0,0,0,1,1
15553,30,4142,5426,730,0,0,0,1,1
15554,30,4143,8434,730,0,0,0,1,1
15555,30,4145,3829;5640,730,0,0,2,0,2
15556,30,4146,5668,730,0,0,0,1,1
15557,30,4147,5795,730,0,0,0,1,1
15558,30,4148,2850;5894,730,0,0,0,2,2
15559,30,4149,5913;9428;11661,730,0,1,2,0,3
15560,30,4150,7236,730,0,0,1,0,1
15561,30,4153,3700;7077;10379;10889,730,0,0,4,0,4
15562,30,4154,3069;6454;11996,730,0,1,2,0,3
15563,30,4155,1741;7353;12572,730,0,1,2,0,3
15564,30,4156,2576;3291;11158,730,0,0,3,0,3
15565,30,4157,6907,730,0,0,0,1,1
15566,30,4158,4381;8997;10772;11026;12112,730,0,1,4,0,5
15567,30,4159,7249,730,0,0,0,1,1
15568,30,4160,329;7367;10614;11130;11239,730,0,0,5,0,5
15569,30,4162,5571;7722;11951;12406,730,0,2,2,0,4
15570,30,4163,35;7857,730,0,0,2,0,2
15571,30,4164,2403;7863,730,0,0,0,2,2
15572,30,4166,6452;8132,730,0,0,2,0,2
15573,30,4168,4600;8252;10363;11660,730,0,1,3,0,4
15574,30,4169,8374,730,0,0,0,1,1
15575,30,4173,5451;8595,730,0,0,2,0,2
15576,30,4175,8929,730,0,0,0,1,1
15577,30,4176,8730;8937,730,0,0,0,2,2
15578,30,4179,3351;3795;11481,730,0,1,2,0,3
15579,30,4181,1920,730,0,0,0,1,1
15580,30,4185,2107,730,0,0,0,1,1
15581,30,4186,5918;9786,730,0,0,2,0,2
15582,30,4188,5212;9944,730,0,0,2,0,2
15583,30,4189,0;7425,1095,0,0,1,1,2
15584,30,4190,12;6735;11500,1095,0,1,2,0,3
15585,30,4192,176;8117,1095,0,0,0,2,2
15586,30,4195,296;6278,1095,0,0,2,0,2
15587,30,4197,3940;9145;11514;12107,1095,0,2,2,0,4
15588,30,4198,425;8992,1095,0,0,0,2,2
15589,30,4199,9351;10742,1095,0,0,2,0,2
15590,30,4200,517;1250;11498,1095,0,1,2,0,3
15591,30,4201,628,1095,0,0,0,1,1
15592,30,4203,1187,1095,0,0,0,1,1
15593,30,4204,5604;5699;11547,1095,0,1,2,0,3
15594,30,4205,7567;8744;12054,1095,0,1,2,0,3
15595,30,4206,1091,1095,0,0,0,1,1
15596,30,4207,1099;4046;12228,1095,0,1,2,0,3
15597,30,4208,1514,1095,0,0,0,1,1
15598,30,4209,4207,1095,0,0,1,0,1
15599,30,4211,1259,1095,0,0,0,1,1
15600,30,4214,1559,1095,0,0,0,1,1
15601,30,4215,1980;6447,1095,0,0,2,0,2
15602,30,4218,3971,1095,0,0,0,1,1
15603,30,4219,1009,1095,0,0,0,1,1
15604,30,4220,2156;4500;11368;11697,1095,0,1,3,0,4
15605,30,4221,2171;2427,1095,0,0,0,2,2
15606,30,4222,844;2591,1095,0,0,2,0,2
15607,30,4223,2417;2655;11977;13062,1095,1,1,2,0,4
15608,30,4224,917;2757,1095,0,0,0,2,2
15609,30,4227,3044,1095,0,0,0,1,1
15610,30,4228,3165;4045;11173;11380;12277,1095,0,1,4,0,5
15611,30,4229,3281;9097,1095,0,0,2,0,2
15612,30,4230,205;3377;10373,1095,0,0,3,0,3
15613,30,4233,2834;3540;11508,1095,0,1,2,0,3
15614,30,4234,3625;8771,1095,0,0,0,2,2
15615,30,4235,282,1095,0,0,0,1,1
15616,30,4236,6458;10704;10964;11046,1095,0,0,4,0,4
15617,30,4237,3789,1095,0,0,0,1,1
15618,30,4239,4048;6224,1095,0,0,0,2,2
15619,30,4240,7569;11303;11680,1095,0,1,2,0,3
15620,30,4241,4127,1095,0,0,0,1,1
15621,30,4242,2059;11575;11881,1095,0,2,1,0,3
15622,30,4243,4166;4274;11263;11465;11591,1095,0,2,3,0,5
15623,30,4244,1640;4336,1095,0,0,2,0,2
15624,30,4246,4474,1095,0,0,1,0,1
15625,30,4248,4528;11659,1095,0,1,1,0,2
15626,30,4250,4626,1095,0,0,0,1,1
15627,30,4251,4762;6396,1095,0,0,2,0,2
15628,30,4252,4802,1095,0,0,0,1,1
15629,30,4253,4898;11534;11702,1095,0,2,1,0,3
15630,30,4254,3062;4954;10717;11011;11609;11879,1095,0,2,4,0,6
15631,30,4255,236;5420;12042,1095,0,1,2,0,3
15632,30,4257,467;5017;10556;10862;10960,1095,0,0,5,0,5
15633,30,4263,2179;11562;12021;12600,1095,0,3,1,0,4
15634,30,4265,5558;6958,1095,0,0,0,2,2
15635,30,4266,4510;5573;10935;11599;11815;13313,1095,1,2,3,0,6
15636,30,4268,3812;9390;10803;10929,1095,0,0,4,0,4
15637,30,4269,5729,1095,0,0,0,1,1
15638,30,4272,6721,1095,0,0,0,1,1
15639,30,4276,3038;6588,1095,0,0,2,0,2
15640,30,4282,7213,1095,0,0,0,1,1
15641,30,4283,1071;7318;10421,1095,0,0,1,2,3
15642,30,4286,6481;7464,1095,0,0,2,0,2
15643,30,4288,2281;7641,1095,0,0,0,2,2
15644,30,4289,9016;11160;11442;11984;12720,1095,0,3,2,0,5
15645,30,4290,6390;7819;12429,1095,0,1,2,0,3
15646,30,4292,1235;7882;10823;11193;12206,1095,0,1,4,0,5
15647,30,4293,7256;8124;12157,1095,0,1,2,0,3
15648,30,4296,4209;8277,1095,0,0,2,0,2
15649,30,4297,8284;11917,1095,0,1,1,0,2
15650,30,4298,6246;8469;11400,1095,0,1,2,0,3
15651,30,4299,8491,1095,0,0,0,1,1
15652,30,4300,8523,1095,0,0,0,1,1
15653,30,4301,873;8596;11327;11644,1095,0,1,3,0,4
15654,30,4303,1372;10976;11078,1095,0,0,3,0,3
15655,30,4304,951;6626;11645;12232,1095,0,2,2,0,4
15656,30,4305,36;8859;12148;12451,1095,0,2,2,0,4
15657,30,4306,2279;8902,1095,0,0,2,0,2
15658,30,4307,3583;8948,1095,0,0,0,2,2
15659,30,4309,9830;10973,1095,0,0,2,0,2
15660,30,4312,4533;9600;10663,1095,0,0,2,1,3
15661,30,4314,9700,1095,0,0,0,1,1
15662,30,4315,8083;9777;11699;12008,1095,0,2,2,0,4
15663,30,4317,6595;9882,1095,0,0,2,0,2
15664,30,4318,7601;9898;11439;11731;11860,1095,0,3,2,0,5
15665,30,4319,4605;9910;10911,1095,0,0,3,0,3
15666,30,4321,158;8211;10902;12331,1460,0,1,3,0,4
15667,30,4322,4031;7497;10738,1460,0,0,3,0,3
15668,30,4324,336;9831,1460,0,0,1,1,2
15669,30,4328,1925;9017;11790;12029;12619,1460,0,3,2,0,5
15670,30,4336,1055;1212;11256;11658;12253,1460,0,2,3,0,5
15671,30,4337,5871;8306,1460,0,0,2,0,2
15672,30,4338,1230;6819,1460,0,0,2,0,2
15673,30,4339,1251;11254;11628,1460,0,1,2,0,3
15674,30,4342,1447;3895,1460,0,0,2,0,2
15675,30,4344,1603;4770;11063;11526,1460,0,1,3,0,4
15676,30,4345,1633;1732;11997,1460,0,1,2,0,3
15677,30,4346,1895,1460,0,0,0,1,1
15678,30,4348,2723;10938,1460,0,0,2,0,2
15679,30,4351,2337,1460,0,0,0,1,1
15680,30,4352,2355;3239,1460,0,0,2,0,2
15681,30,4353,2380;6254;10993,1460,0,0,3,0,3
15682,30,4354,929;2766;11164;11503,1460,0,1,3,0,4
15683,30,4355,7216,1460,0,0,1,0,1
15684,30,4357,2563,1460,0,0,0,1,1
15685,30,4358,2744,1460,0,0,0,1,1
15686,30,4362,4477;8315,1460,0,0,2,0,2
15687,30,4364,3432;11012,1460,0,0,2,0,2
15688,30,4365,2892;11377;11794,1460,0,1,2,0,3
15689,30,4366,3548;5906;11180;11255,1460,0,0,4,0,4
15690,30,4369,3944;5603,1460,0,0,2,0,2
15691,30,4371,7;9645;11232;12209,1460,0,1,3,0,4
15692,30,4373,3985,1460,0,0,1,0,1
15693,30,4374,1218;3811,1460,0,0,2,0,2
15694,30,4375,2718;4005,1460,0,0,0,2,2
15695,30,4376,5977,1460,0,0,0,1,1
15696,30,4379,4827;9455;11396;11592;12028,1460,0,2,3,0,5
15697,30,4381,2030,1460,0,0,0,1,1
15698,30,4382,4411;8516;11038;11283;11653,1460,0,1,4,0,5
15699,30,4383,4436;8425,1460,0,0,2,0,2
15700,30,4385,7019,1460,0,0,1,0,1
15701,30,4386,643;7925;11272;11596,1460,0,1,3,0,4
15702,30,4387,1487;6326;11475,1460,0,1,2,0,3
15703,30,4389,5542;5562,1460,0,0,2,0,2
15704,30,4390,3597;5695,1460,0,0,0,2,2
15705,30,4391,5811;9257;11100,1460,0,0,3,0,3
15706,30,4392,6038;6516,1460,0,0,2,0,2
15707,30,4394,864;8985;11474;11507,1460,0,2,2,0,4
15708,30,4395,2765;6308;10643;11157;11679;12526,1460,0,2,4,0,6
15709,30,4397,6334;9169,1460,0,0,2,0,2
15710,30,4399,6406;8168,1460,0,0,2,0,2
15711,30,4401,6493;11378;11461;12312;12587,1460,0,3,2,0,5
15712,30,4403,6556,1460,0,0,0,1,1
15713,30,4404,2922;4942,1460,0,0,0,2,2
15714,30,4406,6854;9196;11468,1460,0,1,2,0,3
15715,30,4409,6993;7852,1460,0,0,2,0,2
15716,30,4410,4916,1460,0,0,0,1,1
15717,30,4411,4318;7066,1460,0,0,2,0,2
15718,30,4412,1740,1460,0,0,0,1,1
15719,30,4413,6710,1460,0,0,1,0,1
15720,30,4414,7274;9495,1460,0,0,2,0,2
15721,30,4415,1376;8123;12564,1460,0,1,2,0,3
15722,30,4416,5970;7300;11608;11867;12048,1460,0,3,2,0,5
15723,30,4417,7798;8732,1460,0,0,2,0,2
15724,30,4418,9119,1460,0,0,0,1,1
15725,30,4419,2628;7534;11911,1460,0,1,2,0,3
15726,30,4420,360;7603,1460,0,0,2,0,2
15727,30,4421,1548;4949;12248;12427,1460,0,2,2,0,4
15728,30,4422,6191,1460,0,0,1,0,1
15729,30,4423,4170;7692,1460,0,0,2,0,2
15730,30,4425,3157;7834,1460,0,0,2,0,2
15731,30,4426,7838;11333,1460,0,0,2,0,2
15732,30,4427,2750;8931;11315;11422;11603,1460,0,2,3,0,5
15733,30,4429,1383;8401,1460,0,0,2,0,2
15734,30,4431,7465,1460,0,0,1,0,1
15735,30,4432,979;8262,1460,0,0,1,1,2
15736,30,4433,2414;8399,1460,0,0,0,2,2
15737,30,4434,202,1460,0,0,0,1,1
15738,30,4435,8729,1460,0,0,0,1,1
15739,30,4436,583;8830,1460,0,0,2,0,2
15740,30,4437,797;8843,1460,0,0,2,0,2
15741,30,4438,5982;8904;12605,1460,0,1,2,0,3
15742,30,4440,9159;9243,1460,0,0,1,1,2
15743,30,4441,2366;5261;11820,1460,0,1,2,0,3
15744,30,4443,8546;9544,1460,0,0,0,2,2
15745,30,4447,679;870;11600;11708,1460,0,2,2,0,4
15746,30,4448,9401;9963;11808,1460,0,1,2,0,3
15747,30,4449,183;9947;11176,1825,0,0,3,0,3
15748,30,4450,271;6489,1825,0,0,2,0,2
15749,30,4451,430;8332,1825,0,0,2,0,2
15750,30,4453,752;3493;11335,1825,0,0,3,0,3
15751,30,4454,1006;3563,1825,0,0,2,0,2
15752,30,4455,355;1031;12134,1825,0,1,2,0,3
15753,30,4457,6920;9078;11206;11419,1825,0,1,3,0,4
15754,30,4458,1169;8331;11793;12449;12924,1825,1,2,2,0,5
15755,30,4459,356;4398;11711;11894,1825,0,2,2,0,4
15756,30,4460,1546,1825,0,0,0,1,1
15757,30,4461,1769;4030,1825,0,0,2,0,2
15758,30,4462,1836;4116,1825,0,0,0,2,2
15759,30,4464,1988,1825,0,0,0,1,1
15760,30,4466,2213,1825,0,0,0,1,1
15761,30,4467,2387,1825,0,0,0,1,1
15762,30,4468,2438;8154,1825,0,0,2,0,2
15763,30,4469,609,1825,0,0,0,1,1
15764,30,4470,2569,1825,0,0,0,1,1
15765,30,4471,2864;3674;11374,1825,0,0,3,0,3
15766,30,4472,3004;4015;12381,1825,0,1,2,0,3
15767,30,4474,1263;11665;11870;12647,1825,0,3,1,0,4
15768,30,4475,2935;3544,1825,0,0,0,2,2
15769,30,4476,3610,1825,0,0,0,1,1
15770,30,4482,4178;4444;10846,1825,0,0,1,2,3
15771,30,4483,1936;6197;11028;11566;11743,1825,0,2,3,0,5
15772,30,4485,732;4338,1825,0,0,0,2,2
15773,30,4486,4418,1825,0,0,0,1,1
15774,30,4487,4506;6064,1825,0,0,2,0,2
15775,30,4489,8087;8175;11625,1825,0,1,2,0,3
15776,30,4490,4703,1825,0,0,0,1,1
15777,30,4491,2687;4823,1825,0,0,1,1,2
15778,30,4493,4939;9207,1825,0,0,2,0,2
15779,30,4494,3259;5419;12377;12822,1825,1,1,2,0,4
15780,30,4499,5539;8392,1825,0,0,0,2,2
15781,30,4500,3695;5617;11614;11974,1825,0,2,2,0,4
15782,30,4501,5636;6259,1825,0,0,0,2,2
15783,30,4502,5715;6037;11551;11779;11817;12633,1825,0,4,2,0,6
15784,30,4503,2180;8741;11979;12244,1825,0,2,2,0,4
15785,30,4504,5774;9357,1825,0,0,2,0,2
15786,30,4507,5949;9015,1825,0,0,2,0,2
15787,30,4508,6001;7585;11139;11535,1825,0,1,3,0,4
15788,30,4509,7732;11075;11782,1825,0,1,2,0,3
15789,30,4510,6211,1825,0,0,1,0,1
15790,30,4511,6213;7412,1825,0,0,0,2,2
15791,30,4515,6239;6602;11733;11967,1825,0,2,2,0,4
15792,30,4519,1332;3469;10952;11478,1825,0,1,3,0,4
15793,30,4520,726;7235;11194;11233,1825,0,0,4,0,4
15794,30,4523,6354;7508,1825,0,0,2,0,2
15795,30,4524,7564,1825,0,0,0,1,1
15796,30,4525,203;7683;11414;11605,1825,0,2,2,0,4
15797,30,4526,6689;7691;10869;11141,1825,0,0,4,0,4
15798,30,4527,7868;11367,1825,0,0,2,0,2
15799,30,4528,7989,1825,0,0,1,0,1
15800,30,4531,3522;8155,1825,0,0,0,2,2
15801,30,4536,1213;11715;12081,1825,0,2,1,0,3
15802,30,4537,1586;8543;11241;11492,1825,0,1,3,0,4
15803,30,4538,3397;8617;12305,1825,0,1,2,0,3
15804,30,4539,1216;8680;11724,1825,0,1,2,0,3
15805,30,4540,2843;11799,1825,0,1,1,0,2
15806,30,4541,3539;6953,1825,0,0,2,0,2
15807,30,4542,10;8092,1825,0,0,2,0,2
15808,30,4543,6750,1825,0,0,1,0,1
15809,30,4544,3672;11682;11927,1825,0,2,1,0,3
15810,30,4545,9024,1825,0,0,0,1,1
15811,30,4546,1123;9187;10602;11959,1825,0,1,3,0,4
15812,30,4548,3865;5613;11752,1825,0,1,2,0,3
15813,30,4550,3218;6118;11469;11868,1825,0,2,2,0,4
15814,30,4553,9955,1825,0,0,0,1,1
15815,30,4554,6453;8466;11376;11882,1825,0,1,3,0,4
15816,30,4555,6394;9329,1825,0,0,2,0,2
15817,30,4557,65;5159;9519;10875;11480;12023;12470,2190,0,3,4,0,7
15818,30,4558,2741;11649,2190,0,1,1,0,2
15819,30,4560,3449;11516;11903;12230;12540,2190,0,4,1,0,5
15820,30,4562,511;7404;12144;12421;12907,2190,1,2,2,0,5
15821,30,4564,773;1814;11316;11588,2190,0,1,3,0,4
15822,30,4567,1151;11949,2190,0,1,1,0,2
15823,30,4568,1333;3419,2190,0,0,2,0,2
15824,30,4569,561;1776,2190,0,0,2,0,2
15825,30,4570,1873;7659,2190,0,0,0,2,2
15826,30,4571,1938;5189,2190,0,0,0,2,2
15827,30,4572,1962;9607;11739;12030;12308,2190,0,3,2,0,5
15828,30,4573,2007;3758;11111;11813;12551,2190,0,2,3,0,5
15829,30,4574,707,2190,0,0,0,1,1
15830,30,4576,603;3012;11781;12052,2190,0,2,2,0,4
15831,30,4577,642;5963,2190,0,0,2,0,2
15832,30,4579,2742;5939;12611;13114,2190,1,1,2,0,4
15833,30,4581,2949;3960;11848,2190,0,1,2,0,3
15834,30,4582,2971;4061;12187,2190,0,1,2,0,3
15835,30,4583,10001,2190,0,0,1,0,1
15836,30,4586,3174;3931;10786;10842;11146,2190,0,0,5,0,5
15837,30,4587,3355;8456;11832;12295,2190,0,2,2,0,4
15838,30,4588,3467;11770,2190,0,1,1,0,2
15839,30,4589,3167,2190,0,0,0,1,1
15840,30,4592,3740;6788,2190,0,0,2,0,2
15841,30,4594,3066;5865;10856;11196,2190,0,0,4,0,4
15842,30,4595,2998,2190,0,0,0,1,1
15843,30,4596,3962;9721;11765,2190,0,1,2,0,3
15844,30,4597,4036,2190,0,0,0,1,1
15845,30,4598,4136;8652,2190,0,0,0,2,2
15846,30,4599,3128,2190,0,0,0,1,1
15847,30,4602,4373;8806,2190,0,0,2,0,2
15848,30,4603,5616;9221;11858,2190,0,1,2,0,3
15849,30,4604,49;7704;11559;11893;12328,2190,0,3,2,0,5
15850,30,4605,4486;10815;11024,2190,0,0,3,0,3
15851,30,4606,4511;8561;11924;12724,2190,0,2,2,0,4
15852,30,4607,1032;4527;12780,2190,1,0,2,0,3
15853,30,4609,3402;4735;11258;11362;12019,2190,0,1,4,0,5
15854,30,4610,3869;4888;11889;11955,2190,0,2,2,0,4
15855,30,4611,5013,2190,0,0,1,0,1
15856,30,4612,5037;9628,2190,0,0,0,2,2
15857,30,4613,5269,2190,0,0,0,1,1
15858,30,4618,903;6544,2190,0,0,2,0,2
15859,30,4619,3644;5823,2190,0,0,0,2,2
15860,30,4620,1238;5849;11616;11933;12681,2190,0,3,2,0,5
15861,30,4622,5905;8226,2190,0,0,2,0,2
15862,30,4623,5799;6074,2190,0,0,2,0,2
15863,30,4624,1074;6170,2190,0,0,2,0,2
15864,30,4625,6311;10757;11105,2190,0,0,3,0,3
15865,30,4626,1165,2190,0,0,1,0,1
15866,30,4628,6706;9909,2190,0,0,0,2,2
15867,30,4629,2178;6968,2190,0,0,2,0,2
15868,30,4632,7047,2190,0,0,0,1,1
15869,30,4633,3922;7119,2190,0,0,2,0,2
15870,30,4634,7141,2190,0,0,1,0,1
15871,30,4635,7238;10944;11156;11412;11775,2190,0,2,3,0,5
15872,30,4638,2208;7844;11288;11748,2190,0,1,3,0,4
15873,30,4641,3813;7836;11529;11976,2190,0,2,2,0,4
15874,30,4642,15,2190,0,0,0,1,1
15875,30,4643,8256,2190,0,0,0,1,1
15876,30,4644,4553;12456,2190,0,1,1,0,2
15877,30,4646,2010;8470,2190,0,0,2,0,2
15878,30,4647,7180;8492,2190,0,0,2,0,2
15879,30,4648,8604;9232;11338;11554,2190,0,1,3,0,4
15880,30,4650,8707,2190,0,0,0,1,1
15881,30,4651,2679,2190,0,0,0,1,1
15882,30,4652,3708;8797;11279;11482;11918,2190,0,2,3,0,5
15883,30,4654,9077,2190,0,0,1,0,1
15884,30,4655,9112;11289,2190,0,0,2,0,2
15885,30,4658,2559;9424;12074;12146;12615;13073,2190,1,3,2,0,6
15886,30,4659,9510;11398;12175,2190,0,1,2,0,3
15887,30,4660,1754;3160,2190,0,0,1,1,2
15888,30,4662,9214;9727;11598;12095,2190,0,2,2,0,4
15889,30,4663,513;9817;11647;12167,2190,0,2,2,0,4
15890,30,4664,8230;9202,2190,0,0,1,1,2
15891,30,4666,179;3387;11372,2555,0,0,3,0,3
15892,30,4668,1584;3463;12417,2555,0,1,2,0,3
15893,30,4669,1386;6111;11931;12039,2555,0,2,2,0,4
15894,30,4671,898;6070,2555,0,0,2,0,2
15895,30,4673,7899;9165,2555,0,0,2,0,2
15896,30,4677,1535;1824;11001;11033,2555,0,0,4,0,4
15897,30,4678,2306,2555,0,0,1,0,1
15898,30,4679,1901;5086,2555,0,0,2,0,2
15899,30,4680,1910;4965,2555,0,0,1,1,2
15900,30,4681,1957;9812,2555,0,0,0,2,2
15901,30,4683,2345;4027,2555,0,0,1,1,2
15902,30,4684,2436,2555,0,0,0,1,1
15903,30,4685,4893,2555,0,0,0,1,1
15904,30,4686,2692;5025;11183;11876;12097,2555,0,2,3,0,5
15905,30,4687,2792;4389,2555,0,0,0,2,2
15906,30,4689,2901;8853;11463,2555,0,1,2,0,3
15907,30,4690,1526,2555,0,0,1,0,1
15908,30,4694,3407;8977;12819;12947,2555,2,0,2,0,4
15909,30,4695,1861;3567,2555,0,0,0,2,2
15910,30,4700,3491;3847,2555,0,0,0,2,2
15911,30,4701,932;3879;11175;11641;13215,2555,1,1,3,0,5
15912,30,4702,4035;9189,2555,0,0,2,0,2
15913,30,4703,110;7808;10770,2555,0,0,3,0,3
15914,30,4705,4111;8070,2555,0,0,2,0,2
15915,30,4707,4149;4628;10900;11899,2555,0,1,3,0,4
15916,30,4708,3362;4694,2555,0,0,2,0,2
15917,30,4709,8674;11550;11632,2555,0,2,1,0,3
15918,30,4712,7582;8189,2555,0,0,2,0,2
15919,30,4713,1068;4891,2555,0,0,0,2,2
15920,30,4716,3650;4940,2555,0,0,0,2,2
15921,30,4719,5133;7928;11861;12326,2555,0,2,2,0,4
15922,30,4721,5289;9564,2555,0,0,0,2,2
15923,30,4722,5319,2555,0,0,0,1,1
15924,30,4725,4978;5547;11348;11479,2555,0,1,3,0,4
15925,30,4727,4287;5781,2555,0,0,0,2,2
15926,30,4728,733;5843,2555,0,0,1,1,2
15927,30,4729,5870;8396;11433;13193,2555,1,1,2,0,4
15928,30,4730,2787;6036;12055,2555,0,1,2,0,3
15929,30,4731,6139;9138;11273;12243,2555,0,1,3,0,4
15930,30,4732,1122;6169,2555,0,0,2,0,2
15931,30,4733,5134;6184,2555,0,0,2,0,2
15932,30,4734,6187;9799;11360;11509;11777,2555,0,2,3,0,5
15933,30,4735,6313;8589;12695,2555,0,1,2,0,3
15934,30,4736,6318;9951;11136;11819,2555,0,1,3,0,4
15935,30,4737,6775,2555,0,0,0,1,1
15936,30,4740,3193;6973;11397;11742;12114,2555,0,2,3,0,5
15937,30,4741,4051;6999;11062;11443;12025,2555,0,2,3,0,5
15938,30,4742,2891;7036;11264;11670;11884;12719,2555,0,3,3,0,6
15939,30,4745,404;8822;12040;12260;12932,2555,1,2,2,0,5
15940,30,4746,7574;8148,2555,0,0,0,2,2
15941,30,4747,7151;7276;12233;13224,2555,1,1,2,0,4
15942,30,4749,490;7776;11574;11866;12035;12154,2555,0,4,2,0,6
15943,30,4750,2418;7867;12067,2555,0,1,2,0,3
15944,30,4751,8388;9843;11579;11716;12094,2555,0,3,2,0,5
15945,30,4753,2232;8642;11669;11831;12918,2555,1,2,2,0,5
15946,30,4755,8128,2555,0,0,0,1,1
15947,30,4756,7461;8144;12522,2555,0,1,2,0,3
15948,30,4757,6464;8268;11969,2555,0,1,2,0,3
15949,30,4759,3022;9995;11352,2555,0,0,3,0,3
15950,30,4760,2058;9280;10918,2555,0,0,3,0,3
15951,30,4762,6692;8560;11448;11759;12150,2555,0,3,2,0,5
15952,30,4763,8712;9998;11205;11916;12000;12639,2555,0,3,3,0,6
15953,30,4765,4073,2555,0,0,1,0,1
15954,30,4766,6723,2555,0,0,0,1,1
15955,30,4767,5302;8893;11337;11874,2555,0,1,3,0,4
15956,30,4769,6526;8966,2555,0,0,2,0,2
15957,30,4770,9246;9392;12359;13035,2555,1,1,2,0,4
15958,30,4772,393;5704,2555,0,0,2,0,2
15959,30,4773,2580;4543;12249,2555,0,1,2,0,3
15960,30,4774,8781,2555,0,0,1,0,1
15961,30,4775,7913;9687;11020;11678,2555,0,1,3,0,4
15962,30,4776,9762,2555,0,0,1,0,1
15963,30,4777,8675;9837,2555,0,0,2,0,2
15964,30,4779,54;4449;11089;12215,2920,0,1,3,0,4
15965,30,4781,147;4668,2920,0,0,2,0,2
15966,30,4783,2837,2920,0,0,0,1,1
15967,30,4785,475;2092;12337;12845,2920,1,1,2,0,4
15968,30,4786,537;5063;12184;12602;12755,2920,1,2,2,0,5
15969,30,4787,5429,2920,0,0,0,1,1
15970,30,4793,4103;11674;11735;12083,2920,0,3,1,0,4
15971,30,4794,2656;9045;12661,2920,0,1,2,0,3
15972,30,4798,1516,2920,0,0,1,0,1
15973,30,4800,1653;8619,2920,0,0,2,0,2
15974,30,4801,1882;12554,2920,0,1,1,0,2
15975,30,4803,1935;6581,2920,0,0,2,0,2
15976,30,4804,2091;8628,2920,0,0,2,0,2
15977,30,4805,2500;2865,2920,0,0,2,0,2
15978,30,4806,4094,2920,0,0,0,1,1
15979,30,4807,1217;7525;11216;11580;12584,2920,0,2,3,0,5
15980,30,4808,2815;7553;10927;11321,2920,0,0,4,0,4
15981,30,4809,4953;8177;11182;11788,2920,0,1,3,0,4
15982,30,4810,2717;6094,2920,0,0,0,2,2
15983,30,4811,1010;1575;11218;11540;12595,2920,0,2,3,0,5
15984,30,4812,2847,2920,0,0,0,1,1
15985,30,4816,2798;3116;12863,2920,1,0,2,0,3
15986,30,4817,3173;6554;10906;11458;11633;12168;12436;13314,2920,1,4,3,0,8
15987,30,4818,1784;3192,2920,0,0,0,2,2
15988,30,4819,3277;3860;12315;13261,2920,1,1,2,0,4
15989,30,4820,2033;6653;12546,2920,0,1,2,0,3
15990,30,4821,7874;8740,2920,0,0,2,0,2
15991,30,4822,2001;3486,2920,0,0,0,2,2
15992,30,4823,3523;7488;12172;13032,2920,1,1,2,0,4
15993,30,4824,686;3566;11214;11470,2920,0,1,3,0,4
15994,30,4826,3754,2920,0,0,0,1,1
15995,30,4827,3772;9603,2920,0,0,0,2,2
15996,30,4829,3953,2920,0,0,0,1,1
15997,30,4832,4102;8169,2920,0,0,2,0,2
15998,30,4833,7466,2920,0,0,1,0,1
15999,30,4834,4280;11271;11785;12140,2920,0,2,2,0,4
16000,30,4835,4293;5737;11905,2920,0,1,2,0,3
16001,30,4836,4509;9739;12476;12678;13118,2920,1,2,2,0,5
16002,30,4837,6420;8375;13177,2920,1,0,2,0,3
16003,30,4838,4619;9208,2920,0,0,2,0,2
16004,30,4839,3675;6971,2920,0,0,2,0,2
16005,30,4841,4795;8125,2920,0,0,0,2,2
16006,30,4843,4859;8629;10917;11518;11814;12418,2920,0,3,3,0,6
16007,30,4844,1606;5073,2920,0,0,0,2,2
16008,30,4845,1652;5181;11501;12002;12149,2920,0,3,2,0,5
16009,30,4847,4009;5286,2920,0,0,0,2,2
16010,30,4849,5366;7185,2920,0,0,2,0,2
16011,30,4850,1788;5410;11846;12173,2920,0,2,2,0,4
16012,30,4851,1247;5443,2920,0,0,2,0,2
16013,30,4852,5810;8050,2920,0,0,2,0,2
16014,30,4856,6194;10998,2920,0,0,2,0,2
16015,30,4858,6405;6700;12303,2920,0,1,2,0,3
16016,30,4859,6434;7690,2920,0,0,2,0,2
16017,30,4861,3749;6661;12509;12923,2920,1,1,2,0,4
16018,30,4862,6696;9352,2920,0,0,2,0,2
16019,30,4863,5612,2920,0,0,0,1,1
16020,30,4864,6751;7503;11007;11594,2920,0,1,3,0,4
16021,30,4865,6912,2920,0,0,0,1,1
16022,30,4866,1974;5974,2920,0,0,2,0,2
16023,30,4868,3531;7403,2920,0,0,2,0,2
16024,30,4870,1078;7459,2920,0,0,0,2,2
16025,30,4871,1157;9639;10923;11621;11855;11938;12856,2920,1,3,3,0,7
16026,30,4872,5679;7733;12009;12275,2920,0,2,2,0,4
16027,30,4875,397;7992;11496;11698;11914,2920,0,3,2,0,5
16028,30,4876,6827;8043;11021,2920,0,0,3,0,3
16029,30,4877,6774;11373;11756;11987,2920,0,2,2,0,4
16030,30,4879,3633;11201;11597;12276;12416,2920,0,3,2,0,5
16031,30,4880,8228,2920,0,0,0,1,1
16032,30,4881,974;8344;11434;11941,2920,0,2,2,0,4
16033,30,4882,4924;11638;13125,2920,1,1,1,0,3
16034,30,4883,6995;8502;11178;11262;11908,2920,0,1,4,0,5
16035,30,4885,2800;8514;11843;12004,2920,0,2,2,0,4
16036,30,4886,3374;8568,2920,0,0,2,0,2
16037,30,4887,5278;8573;11519;11906,2920,0,2,2,0,4
16038,30,4888,8283;8584;11265;12180;12378,2920,0,2,3,0,5
16039,30,4889,5606;8623;11804;11818,2920,0,2,2,0,4
16040,30,4893,8823;11484;11687;12954,2920,1,2,1,0,4
16041,30,4894,1473;8552;11250;11383;12321,2920,0,1,4,0,5
16042,30,4895,6845;9068;12607;13352,2920,1,1,2,0,4
16043,30,4896,7901;9088,2920,0,0,0,2,2
16044,30,4897,9174,2920,0,0,0,1,1
16045,30,4898,1417;4331,2920,0,0,0,2,2
16046,30,4901,3698;8122;11667;12182;12390;12683,2920,0,4,2,0,6
16047,30,4902,6158;9467;12360,2920,0,1,2,0,3
16048,30,4903,4348;9541,2920,0,0,0,2,2
16049,30,4904,3637;3925,2920,0,0,0,2,2
16050,30,4906,5024;12349;12903,2920,1,1,1,0,3
16051,30,4907,7385;8270;10963;11242;11666;11944,2920,0,2,4,0,6
16052,30,4908,7245,2920,0,0,0,1,1
16053,30,4909,3092;7409,2920,0,0,0,2,2
16054,30,4911,4308;11056;12523,3285,0,1,2,0,3
16055,30,4912,959;3315;12093;12884,3285,1,1,2,0,4
16056,30,4913,4499;9684;11310;11553,3285,0,1,3,0,4
16057,30,4914,4586;6981;11604;12462,3285,0,2,2,0,4
16058,30,4916,286;7261,3285,0,0,1,1,2
16059,30,4918,349;3748;11202;12135,3285,0,1,3,0,4
16060,30,4921,75;159;11631;11864;12240,3285,0,3,2,0,5
16061,30,4923,630;1344;11118;11827;12798,3285,1,1,3,0,5
16062,30,4926,1140,3285,0,0,1,0,1
16063,30,4927,536;853;12302,3285,0,1,2,0,3
16064,30,4928,3343,3285,0,0,0,1,1
16065,30,4929,985;8539;12237,3285,0,1,2,0,3
16066,30,4930,1084;6743;12178;12941,3285,1,1,2,0,4
16067,30,4931,1153,3285,0,0,0,1,1
16068,30,4932,1296;5353;11489;11712,3285,0,2,2,0,4
16069,30,4933,293;4548,3285,0,0,2,0,2
16070,30,4934,1340,3285,0,0,0,1,1
16071,30,4935,4369;9588;11013,3285,0,0,3,0,3
16072,30,4936,1534,3285,0,0,0,1,1
16073,30,4937,1561;6028;11334;11426,3285,0,1,3,0,4
16074,30,4938,2433;3802;11998;12258,3285,0,2,2,0,4
16075,30,4939,1900,3285,0,0,0,1,1
16076,30,4940,4043;7744;11966;12333,3285,0,2,2,0,4
16077,30,4941,7815;11293;11891,3285,0,1,2,0,3
16078,30,4944,2120,3285,0,0,0,1,1
16079,30,4945,2189;3717;11171;11236;11803,3285,0,1,4,0,5
16080,30,4947,2462;4751;11757;12262,3285,0,2,2,0,4
16081,30,4948,2477,3285,0,0,0,1,1
16082,30,4950,2670;2980;11857,3285,0,1,2,0,3
16083,30,4951,2817;11816;12590,3285,0,2,1,0,3
16084,30,4952,2914;5099,3285,0,0,0,2,2
16085,30,4953,2943;4457,3285,0,0,0,2,2
16086,30,4956,3560;8099,3285,0,0,2,0,2
16087,30,4957,3596,3285,0,0,0,1,1
16088,30,4958,3621;9819;11517;11764,3285,0,2,2,0,4
16089,30,4961,3762,3285,0,0,0,1,1
16090,30,4963,239;3976;11076;11341;11568,3285,0,1,4,0,5
16091,30,4965,4961,3285,0,0,0,1,1
16092,30,4967,4259;7330,3285,0,0,2,0,2
16093,30,4968,4416;8022,3285,0,0,0,2,2
16094,30,4969,4637;7679;11531;11694;12121,3285,0,3,2,0,5
16095,30,4970,4765,3285,0,0,0,1,1
16096,30,4971,8672,3285,0,0,1,0,1
16097,30,4972,4165;5044;12123;13188,3285,1,1,2,0,4
16098,30,4973,5281,3285,0,0,0,1,1
16099,30,4974,2014;5296;12713;12770,3285,1,1,2,0,4
16100,30,4978,5702;5780,3285,0,0,1,1,2
16101,30,4979,5708,3285,0,0,1,0,1
16102,30,4981,74;7275;11065;12181,3285,0,1,3,0,4
16103,30,4983,2289;11877,3285,0,1,1,0,2
16104,30,4984,5545;6126,3285,0,0,0,2,2
16105,30,4986,6179;9235,3285,0,0,0,2,2
16106,30,4987,5692;6188;11499;12507;13024,3285,1,2,2,0,5
16107,30,4989,6295;9188;12133;12355,3285,0,2,2,0,4
16108,30,4992,6503;8527;12106,3285,0,1,2,0,3
16109,30,4993,2385;6586;11427;12131;12319,3285,0,3,2,0,5
16110,30,4994,6622;9251,3285,0,0,0,2,2
16111,30,4996,8836,3285,0,0,0,1,1
16112,30,4997,7308,3285,0,0,0,1,1
16113,30,4998,5160;7078;12267,3285,0,1,2,0,3
16114,30,5000,1692;6949;12403;12801,3285,1,1,2,0,4
16115,30,5002,3117;7332;12442,3285,0,1,2,0,3
16116,30,5003,7343;11440;12679,3285,0,2,1,0,3
16117,30,5004,7357;8019;11792;11936;12127,3285,0,3,2,0,5
16118,30,5005,4362;8229,3285,0,0,0,2,2
16119,30,5006,2508;6701;12311,3285,0,1,2,0,3
16120,30,5007,4873;7872;11456,3285,0,1,2,0,3
16121,30,5008,2246,3285,0,0,1,0,1
16122,30,5010,8759;13074;13368,3285,2,0,1,0,3
16123,30,5011,1609;3381;11953;13151,3285,1,1,2,0,4
16124,30,5012,8587,3285,0,0,0,1,1
16125,30,5013,333;810;12457;12665;13221,3285,1,2,2,0,5
16126,30,5015,8318;8814;11447;11696;11968,3285,0,3,2,0,5
16127,30,5016,6736;8815;12709;12992,3285,1,1,2,0,4
16128,30,5017,4737;7966,3285,0,0,2,0,2
16129,30,5018,3833;6948;11435;11900,3285,0,2,2,0,4
16130,30,5019,2681;9008,3285,0,0,2,0,2
16131,30,5020,8899;9114,3285,0,0,2,0,2
16132,30,5021,2756,3285,0,0,0,1,1
16133,30,5022,5031;9596;11671,3285,0,1,2,0,3
16134,30,5023,4034;8592;11295;12210,3285,0,1,3,0,4
16135,30,5025,7627;9787;11512,3285,0,1,2,0,3
16136,30,5029,616;3132;11961;12389;12730,3285,0,3,2,0,5
16137,30,5030,71;1693,3650,0,0,2,0,2
16138,30,5031,146;9032,3650,0,0,2,0,2
16139,30,5033,1252;4400;11357;11561;11740,3650,0,2,3,0,5
16140,30,5034,216;801;12111;12264,3650,0,2,2,0,4
16141,30,5038,891;3308;11107;11704,3650,0,1,3,0,4
16142,30,5039,1061;3406,3650,0,0,2,0,2
16143,30,5040,1288;12928,3650,1,0,1,0,2
16144,30,5042,1407;3799,3650,0,0,1,1,2
16145,30,5043,5216;11097;11277;11452;11539,3650,0,2,3,0,5
16146,30,5044,1654;6604,3650,0,0,2,0,2
16147,30,5045,1656,3650,0,0,0,1,1
16148,30,5046,1789;3202;11212;11721;12116,3650,0,2,3,0,5
16149,30,5048,1915;6426,3650,0,0,0,2,2
16150,30,5050,2117;3103;11627;12016;12585,3650,0,3,2,0,5
16151,30,5051,2145;8957,3650,0,0,0,2,2
16152,30,5052,2203,3650,0,0,1,0,1
16153,30,5053,8624;11768;11929;12718,3650,0,3,1,0,4
16154,30,5054,1599;9423;11257;11710;11839;12459;12640,3650,0,4,3,0,7
16155,30,5055,1236;3276;11308;11563;12796,3650,1,1,3,0,5
16156,30,5056,2651;9336;11073;11909;11983,3650,0,2,3,0,5
16157,30,5057,2445;2676,3650,0,0,0,2,2
16158,30,5058,5716;9848;11664;11902,3650,0,2,2,0,4
16159,30,5060,2390;2851,3650,0,0,2,0,2
16160,30,5062,685;3395;11880;12832,3650,1,1,2,0,4
16161,30,5063,6025,3650,0,0,0,1,1
16162,30,5064,2887;5008;11220;11564,3650,0,1,3,0,4
16163,30,5065,1147;3437;11407;11833,3650,0,2,2,0,4
16164,30,5067,3607,3650,0,0,0,1,1
16165,30,5068,3704;4101;11101;11394;12166;12291,3650,0,2,4,0,6
16166,30,5069,1321;8807;11975;12197,3650,0,2,2,0,4
16167,30,5070,584;7203;12256;12592,3650,0,2,2,0,4
16168,30,5071,3819,3650,0,0,0,1,1
16169,30,5072,3872;7391,3650,0,0,2,0,2
16170,30,5073,9697,3650,0,0,0,1,1
16171,30,5074,2053;6012;11619;11769,3650,0,2,2,0,4
16172,30,5075,4129;6108;12586,3650,0,1,2,0,3
16173,30,5078,3380;5394;11153;11806;12574;12799,3650,1,2,3,0,6
16174,30,5079,4595;7739;11269;11444;12117,3650,0,2,3,0,5
16175,30,5081,4771;8497;12092;12220,3650,0,2,2,0,4
16176,30,5084,4854;9226;12353;12423,3650,0,2,2,0,4
16177,30,5085,4964,3650,0,0,0,1,1
16178,30,5086,2805;5046,3650,0,0,2,0,2
16179,30,5087,5295,3650,0,0,0,1,1
16180,30,5088,5318;6688;12716;12976,3650,1,1,2,0,4
16181,30,5089,4252;6792;12078;12702;12904;13040,3650,2,2,2,0,6
16182,30,5091,503;7969;12612;12669;12982,3650,1,2,2,0,5
16183,30,5092,80;5619,3650,0,0,2,0,2
16184,30,5093,5661;9484;11760;12677,3650,0,2,2,0,4
16185,30,5094,4368;5787;12643;12901;13094,3650,2,1,2,0,5
16186,30,5096,5808,3650,0,0,0,1,1
16187,30,5097,4828;5863;12138,3650,0,1,2,0,3
16188,30,5100,933;3125;11636;11835,3650,0,2,2,0,4
16189,30,5101,6201;8785;12498;12823,3650,1,1,2,0,4
16190,30,5102,524;6215;11204,3650,0,0,3,0,3
16191,30,5103,1714;4693;12290,3650,0,1,2,0,3
16192,30,5104,6381,3650,0,0,0,1,1
16193,30,5106,9922,3650,0,0,0,1,1
16194,30,5108,4655;9768;11578;12387;12748;13010,3650,2,2,2,0,6
16195,30,5109,2881;9134;12072,3650,0,1,2,0,3
16196,30,5110,6238;7520;12717;13271,3650,1,1,2,0,4
16197,30,5112,6629;6675;11527;11705;12100,3650,0,3,2,0,5
16198,30,5115,7192;9166,3650,0,0,2,0,2
16199,30,5116,4680;4979;11349;12422,3650,0,1,3,0,4
16200,30,5117,931;7294;11330,3650,0,0,3,0,3
16201,30,5118,7306;9418;11892;12087;12335,3650,0,3,2,0,5
16202,30,5119,890;4799;12565;12807,3650,1,1,2,0,4
16203,30,5120,7398;9118;11149;12493;12705,3650,0,2,3,0,5
16204,30,5121,3678;7460,3650,0,0,2,0,2
16205,30,5122,5532;7623,3650,0,0,1,1,2
16206,30,5123,2795;7746,3650,0,0,2,0,2
16207,30,5124,2544;8133;12486,3650,0,1,2,0,3
16208,30,5127,8072;9577,3650,0,0,1,1,2
16209,30,5128,2215;8538;12505;12769,3650,1,1,2,0,4
16210,30,5130,1592;8572;11227;11859,3650,0,1,3,0,4
16211,30,5133,8857;9714;11428,3650,0,1,2,0,3
16212,30,5134,1100;8858;11223;11450;12340;12686;12837,3650,1,3,3,0,7
16213,30,5135,721;4514;12183;12908,3650,1,1,2,0,4
16214,30,5136,4141;8928,3650,0,0,2,0,2
16215,30,5138,5458;9798;11087,3650,0,0,3,0,3
16216,30,5139,9163,3650,0,0,0,1,1
16217,30,5140,4053;5441;11425;12057,3650,0,2,2,0,4
16218,30,5141,3790;6509,3650,0,0,0,2,2
16219,30,5142,3219;4723;12729,3650,0,1,2,0,3
16220,30,5143,8934;11172;11391,3650,0,0,3,0,3
16221,30,5144,8340;9429,3650,0,0,2,0,2
16222,30,5146,3612;5709;13007,3650,1,0,2,0,3
16223,30,5147,9585,3650,0,0,1,0,1
16224,30,5149,9708,3650,0,0,1,0,1
16225,30,5150,7073;9007;12128;12323;12835,3650,1,2,2,0,5
16226,30,5151,43;9648;12203;12370;12510,4015,0,3,2,0,5
16227,30,5152,107;9406;11995,4015,0,1,2,0,3
16228,30,5153,112;7143;11688,4015,0,1,2,0,3
16229,30,5154,188;2456,4015,0,0,2,0,2
16230,30,5155,217;771;11353;12102;12386;13069,4015,1,2,3,0,6
16231,30,5156,260;8936,4015,0,0,0,2,2
16232,30,5157,284,4015,0,0,0,1,1
16233,30,5158,326;5749;12222,4015,0,1,2,0,3
16234,30,5160,380;4236,4015,0,0,0,2,2
16235,30,5161,3;390;11313;12919,4015,1,0,3,0,4
16236,30,5162,2499,4015,0,0,1,0,1
16237,30,5167,945;7495,4015,0,0,2,0,2
16238,30,5168,1016;6196,4015,0,0,2,0,2
16239,30,5169,1086,4015,0,0,0,1,1
16240,30,5170,1096;12201;12450;13112,4015,1,2,1,0,4
16241,30,5172,1846;6951;11486,4015,0,1,2,0,3
16242,30,5173,6400,4015,0,0,0,1,1
16243,30,5176,2359;2648,4015,0,0,2,0,2
16244,30,5177,2372;6875;11940;12810;12906,4015,2,1,2,0,5
16245,30,5179,2637;4275,4015,0,0,2,0,2
16246,30,5180,943;8319,4015,0,0,2,0,2
16247,30,5182,3204;6517,4015,0,0,0,2,2
16248,30,5183,1648;3208;11369;12373,4015,0,1,3,0,4
16249,30,5184,3309;8039;11878;12334;13139,4015,1,2,2,0,5
16250,30,5185,3363;3401;11885;12071;12532,4015,0,3,2,0,5
16251,30,5187,3475;7696;11225;11544;11754;12044;13147,4015,1,3,3,0,7
16252,30,5188,3595;8407;11725,4015,0,1,2,0,3
16253,30,5189,3685;4887,4015,0,0,0,2,2
16254,30,5190,3726;7998,4015,0,0,2,0,2
16255,30,5191,2421;3728,4015,0,0,0,2,2
16256,30,5192,3741;6166;11567;12435,4015,0,2,2,0,4
16257,30,5193,3873;9033;11593;11789;12330,4015,0,3,2,0,5
16258,30,5194,2230,4015,0,0,0,1,1
16259,30,5195,4267;4713;12099,4015,0,1,2,0,3
16260,30,5196,7082,4015,0,0,0,1,1
16261,30,5198,4934;6327,4015,0,0,0,2,2
16262,30,5200,4613;4764,4015,0,0,2,0,2
16263,30,5202,1505;8780,4015,0,0,2,0,2
16264,30,5203,977;11304,4015,0,0,2,0,2
16265,30,5204,5035,4015,0,0,0,1,1
16266,30,5205,3934;11347;11536,4015,0,1,2,0,3
16267,30,5207,1536;6339;11637;11774,4015,0,2,2,0,4
16268,30,5208,5290,4015,0,0,0,1,1
16269,30,5209,5401,4015,0,0,1,0,1
16270,30,5210,3417;3696;11610;12122,4015,0,2,2,0,4
16271,30,5211,5485;9298,4015,0,0,0,2,2
16272,30,5212,1887;5588,4015,0,0,0,2,2
16273,30,5214,5764;6638;11189,4015,0,0,3,0,3
16274,30,5215,3738;4654;11982,4015,0,1,2,0,3
16275,30,5218,5378;9874,4015,0,0,2,0,2
16276,30,5219,5244;6112;12003;12188,4015,0,2,2,0,4
16277,30,5221,2481;6284;11700;11823;12234;12372;12623,4015,0,5,2,0,7
16278,30,5222,6319;7138,4015,0,0,2,0,2
16279,30,5223,278;348,4015,0,0,2,0,2
16280,30,5224,6054;6404;11386;11676;11787;12007;12538,4015,0,4,3,0,7
16281,30,5225,6492,4015,0,0,1,0,1
16282,30,5226,4755;6531;11635;11904;12310,4015,0,3,2,0,5
16283,30,5228,6605;8365;12836;13098,4015,2,0,2,0,4
16284,30,5229,6628;7150;12391;13072,4015,1,1,2,0,4
16285,30,5230,1163;9499;11416;11537;11811;12026;12603,4015,0,5,2,0,7
16286,30,5231,6480;6555;12273;12552;13226,4015,1,2,2,0,5
16287,30,5233,1774;11828;12050;12320,4015,0,3,1,0,4
16288,30,5234,3706,4015,0,0,0,1,1
16289,30,5235,6728;7050;12407;12868,4015,1,1,2,0,4
16290,30,5236,573;7062,4015,0,0,0,2,2
16291,30,5237,2654;7121;11919;11973;12518,4015,0,3,2,0,5
16292,30,5238,765;7127;11169;11312;12536;13370,4015,1,1,4,0,6
16293,30,5239,439;7222,4015,0,0,2,0,2
16294,30,5240,1352;7521;11366;11408;12027,4015,0,2,3,0,5
16295,30,5244,5442;7777;11970;12289,4015,0,2,2,0,4
16296,30,5246,7701;7843;11727,4015,0,1,2,0,3
16297,30,5247,9776;9926;11320;11795;11850,4015,0,2,3,0,5
16298,30,5250,7020;8149;12269;12905,4015,1,1,2,0,4
16299,30,5252,2986;8248,4015,0,0,2,0,2
16300,30,5253,3386;8376,4015,0,0,2,0,2
16301,30,5254,2244,4015,0,0,1,0,1
16302,30,5255,7621;8515;13038;13384,4015,2,0,2,0,4
16303,30,5259,4258,4015,0,0,1,0,1
16304,30,5260,1766;8932;12235;12508,4015,0,2,2,0,4
16305,30,5261,6603;8986;11622;12287,4015,0,2,2,0,4
16306,30,5263,1649;9643,4015,0,0,2,0,2
16307,30,5264,639;9069;11354,4015,0,0,3,0,3
16308,30,5266,2475;6353;11290;11590;11930,4015,0,2,3,0,5
16309,30,5267,2008;6299;11713;12471;12722,4015,0,3,2,0,5
16310,30,5271,8292;11805,4015,0,1,1,0,2
16311,30,5272,8650;9818;11606;11851;12408;12900,4015,1,3,2,0,6
16312,30,5275,5618,4380,0,0,0,1,1
16313,30,5277,674;4963;11577;12011;12268;13258,4380,1,3,2,0,6
16314,30,5281,4248,4380,0,0,0,1,1
16315,30,5282,2556,4380,0,0,1,0,1
16316,30,5283,3530;9940;12343;12596;12861,4380,1,2,2,0,5
16317,30,5284,79;1477;11538;11822,4380,0,2,2,0,4
16318,30,5286,1787;3930;11888,4380,0,1,2,0,3
16319,30,5287,1805,4380,0,0,0,1,1
16320,30,5289,4307;6947;11656,4380,0,1,2,0,3
16321,30,5290,2100,4380,0,0,0,1,1
16322,30,5292,2880;9844;12773;13182,4380,2,0,2,0,4
16323,30,5296,3394;6797,4380,0,0,0,2,2
16324,30,5298,2384;3520;11791;13082,4380,1,1,2,0,4
16325,30,5301,1933;3730;11402;11652;12576;13281,4380,1,3,2,0,6
16326,30,5302,7237;7705,4380,0,0,2,0,2
16327,30,5303,1399;3994,4380,0,0,2,0,2
16328,30,5305,4021;7176;11325;11692;12075,4380,0,2,3,0,5
16329,30,5306,3691;8442;11844;12579,4380,0,2,2,0,4
16330,30,5307,4271;5572;12141;12339;12766;13190,4380,2,2,2,0,6
16331,30,5308,2694;12464,4380,0,1,1,0,2
16332,30,5311,3527;7669,4380,0,0,2,0,2
16333,30,5313,5166,4380,0,0,1,0,1
16334,30,5314,4726,4380,0,0,0,1,1
16335,30,5315,4899;4931,4380,0,0,2,0,2
16336,30,5317,5001;7921;11318,4380,0,0,3,0,3
16337,30,5319,4862;7212;11772,4380,0,1,2,0,3
16338,30,5320,5615;6290;11253;11723;12309;12789;13132,4380,2,2,3,0,7
16339,30,5321,6171,4380,0,0,0,1,1
16340,30,5323,892;9420,4380,0,0,2,0,2
16341,30,5324,3045;7729;12870;13171,4380,2,0,2,0,4
16342,30,5325,6694;9621,4380,0,0,2,0,2
16343,30,5326,714;6857;12483;12571,4380,0,2,2,0,4
16344,30,5328,2816;7172;11836,4380,0,1,2,0,3
16345,30,5329,9168;9901,4380,0,0,0,2,2
16346,30,5331,7604;7698;11292;11404,4380,0,1,3,0,4
16347,30,5336,5968;9838;11515;11943;12352,4380,0,3,2,0,5
16348,30,5337,9369,4380,0,0,1,0,1
16349,30,5340,8443,4380,0,0,1,0,1
16350,30,5341,3207;8519;11329;11761;12383,4380,0,2,3,0,5
16351,30,5342,8657,4380,0,0,0,1,1
16352,30,5344,5084;7323;11473;11532;11607,4380,0,3,2,0,5
16353,30,5345,479;8808;11993;12398,4380,0,2,2,0,4
16354,30,5346,8845;11939;12392;12689,4380,0,3,1,0,4
16355,30,5349,6881,4380,0,0,0,1,1
16356,30,5351,5396;7499;11869;12069;12251;12577;13202,4380,1,4,2,0,7
16357,30,5353,572;9605,4380,0,0,2,0,2
16358,30,5355,2620;9666;11582;12047,4380,0,2,2,0,4
16359,30,5356,5936;9694;12655;12877,4380,1,1,2,0,4
16360,30,5357,7948,4380,0,0,1,0,1
16361,30,5358,9862,4380,0,0,0,1,1
16362,30,5359,9929,4380,0,0,0,1,1
16363,30,5360,38;7419;11767,4745,0,1,2,0,3
16364,30,5365,3753;8912;12085;13103,4745,1,1,2,0,4
16365,30,5368,838;7128;11305;11965;12880,4745,1,1,3,0,5
16366,30,5370,902;7158;11497;11954;12952,4745,1,2,2,0,5
16367,30,5371,3011,4745,0,0,1,0,1
16368,30,5372,5377;6652,4745,0,0,2,0,2
16369,30,5373,1301;6407,4745,0,0,2,0,2
16370,30,5375,1500;2395;12911,4745,1,0,2,0,3
16371,30,5376,8679;9041,4745,0,0,2,0,2
16372,30,5377,1537;1726;12137;12490;12974,4745,1,2,2,0,5
16373,30,5378,831,4745,0,0,0,1,1
16374,30,5379,2239;8520;12076;12844,4745,1,1,2,0,4
16375,30,5380,3574;6718;13184,4745,1,0,2,0,3
16376,30,5381,2342,4745,0,0,1,0,1
16377,30,5382,2391,4745,0,0,0,1,1
16378,30,5383,4576;9225;12284;12878,4745,1,1,2,0,4
16379,30,5384,182;2581;12346;12384;13380,4745,1,2,2,0,5
16380,30,5385,9009;9692,4745,0,0,2,0,2
16381,30,5386,6796,4745,0,0,0,1,1
16382,30,5388,7223;8291;12145;12917,4745,1,1,2,0,4
16383,30,5389,3418,4745,0,0,1,0,1
16384,30,5390,3164;5741,4745,0,0,2,0,2
16385,30,5391,2294;6625,4745,0,0,2,0,2
16386,30,5392,2027;3986;11602;11780,4745,0,2,2,0,4
16387,30,5393,698;7173,4745,0,0,0,2,2
16388,30,5394,2031;8649;12043;12573,4745,0,2,2,0,4
16389,30,5395,1451;7802;11417;11639;12015;12772,4745,1,3,2,0,6
16390,30,5396,3615;9680;12270;12425,4745,0,2,2,0,4
16391,30,5398,7695,4745,0,0,0,1,1
16392,30,5399,2789;4285;11401;11736;12286,4745,0,3,2,0,5
16393,30,5402,3524,4745,0,0,1,0,1
16394,30,5403,4756,4745,0,0,1,0,1
16395,30,5404,4908;8616,4745,0,0,2,0,2
16396,30,5405,617;2788;12271,4745,0,1,2,0,3
16397,30,5407,5105;7554,4745,0,0,2,0,2
16398,30,5409,3161;5489,4745,0,0,2,0,2
16399,30,5411,3356;11528;12530;12817,4745,1,2,1,0,4
16400,30,5412,1287;2669;12953;13311,4745,2,0,2,0,4
16401,30,5413,5689;9482,4745,0,0,0,2,2
16402,30,5415,1486;5779;11543;11895,4745,0,2,2,0,4
16403,30,5416,5789;5964;12165;12399,4745,0,2,2,0,4
16404,30,5418,3429;6110;12226;12480,4745,0,2,2,0,4
16405,30,5419,5202;6117;12129;12925,4745,1,1,2,0,4
16406,30,5420,6331,4745,0,0,1,0,1
16407,30,5421,1441,4745,0,0,0,1,1
16408,30,5423,1353,4745,0,0,0,1,1
16409,30,5424,6950;9764;12125;12356;12768;13392,4745,2,2,2,0,6
16410,30,5425,9572,4745,0,0,1,0,1
16411,30,5427,6904,4745,0,0,1,0,1
16412,30,5428,6861;8590;11719,4745,0,1,2,0,3
16413,30,5429,5409;7012;11521;11841,4745,0,2,2,0,4
16414,30,5430,7265,4745,0,0,0,1,1
16415,30,5431,1966;11379;11689;11834;12218;12922;13325,4745,2,3,2,0,7
16416,30,5432,3003;5792;12351;12913;13122,4745,2,1,2,0,5
16417,30,5433,7993,4745,0,0,1,0,1
16418,30,5434,7994;9245;12869;13217,4745,2,0,2,0,4
16419,30,5435,3078;8037;11989;12441,4745,0,2,2,0,4
16420,30,5436,2776,4745,0,0,0,1,1
16421,30,5438,1698;8638;11406;11618;11745,4745,0,3,2,0,5
16422,30,5440,6530;8796;13233,4745,1,0,2,0,3
16423,30,5441,2799;8798;12366,4745,0,1,2,0,3
16424,30,5442,5735;8799;11729;11920;12385;13227,4745,1,3,2,0,6
16425,30,5444,9066,4745,0,0,0,1,1
16426,30,5445,9419;9608;12037,4745,0,1,2,0,3
16427,30,5446,7990;9783;12347;12382,4745,0,2,2,0,4
16428,30,5447,658,4745,0,0,0,1,1
16429,30,5448,5535;9857,4745,0,0,0,2,2
16430,30,5451,330;6820;12376,5110,0,1,2,0,3
16431,30,5452,388,5110,0,0,0,1,1
16432,30,5453,6363;8494;11454;11714;12777;13394,5110,2,2,2,0,6
16433,30,5454,444;5260;11432;11786;11963,5110,0,3,2,0,5
16434,30,5455,497,5110,0,0,1,0,1
16435,30,5456,540,5110,0,0,0,1,1
16436,30,5458,709;7431,5110,0,0,0,2,2
16437,30,5459,920;8894;12593;13351,5110,1,1,2,0,4
16438,30,5461,958;8827;11847;12031;12474;12838;13100,5110,2,3,2,0,7
16439,30,5462,1161;2364;12059;13137,5110,1,1,2,0,4
16440,30,5463,1207;6440,5110,0,0,2,0,2
16441,30,5465,1364;5962;11565;12046;12588;13262,5110,1,3,2,0,6
16442,30,5466,3312;9228,5110,0,0,0,2,2
16443,30,5467,1427;4690;12367;12975;13379,5110,2,1,2,0,5
16444,30,5468,1450;4109;11887;12174;12473,5110,0,3,2,0,5
16445,30,5469,1525;4268,5110,0,0,2,0,2
16446,30,5472,1771;5072;11524,5110,0,1,2,0,3
16447,30,5474,8167;9677;12204,5110,0,1,2,0,3
16448,30,5476,2842;9485;12185;12582,5110,0,2,2,0,4
16449,30,5478,5201;6631;11890,5110,0,1,2,0,3
16450,30,5481,6885;12599,5110,0,1,1,0,2
16451,30,5483,3951;4062;11595;11747,5110,0,2,2,0,4
16452,30,5484,1179;5490,5110,0,0,2,0,2
16453,30,5485,8711;9571;12513,5110,0,1,2,0,3
16454,30,5486,4374;5928,5110,0,0,2,0,2
16455,30,5487,4435;5395,5110,0,0,2,0,2
16456,30,5488,2547;4333,5110,0,0,2,0,2
16457,30,5489,3923;4517,5110,0,0,2,0,2
16458,30,5490,4581;6296;11601;12636,5110,0,2,2,0,4
16459,30,5491,2063;6252;11549;11923;12733;13133,5110,1,3,2,0,6
16460,30,5492,3376;11707;12012;12130;12338,5110,0,4,1,0,5
16461,30,5496,1706;9651;11623;11912;12430;13026,5110,1,3,2,0,6
16462,30,5498,953;5630;11581;13113,5110,1,1,2,0,4
16463,30,5499,5100;5662;12022;13027,5110,1,1,2,0,4
16464,30,5501,5809;7697;12300;12987,5110,1,1,2,0,4
16465,30,5502,3471;6240,5110,0,0,2,0,2
16466,30,5506,4070;8779;12219,5110,0,1,2,0,3
16467,30,5507,4151;9827;11525;11994;12299;12654,5110,0,4,2,0,6
16468,30,5508,4379;9040,5110,0,0,2,0,2
16469,30,5509,6959;9558,5110,0,0,2,0,2
16470,30,5510,7027,5110,0,0,0,1,1
16471,30,5511,4594;7043,5110,0,0,2,0,2
16472,30,5512,4442,5110,0,0,0,1,1
16473,30,5513,1339;7672;12246;12580,5110,0,2,2,0,4
16474,30,5515,9339,5110,0,0,1,0,1
16475,30,5516,8746;9561;11856,5110,0,1,2,0,3
16476,30,5519,1115,5110,0,0,1,0,1
16477,30,5520,8693,5110,0,0,0,1,1
16478,30,5522,3155;7681;12413,5110,0,1,2,0,3
16479,30,5523,2165;2377,5110,0,0,0,2,2
16480,30,5528,5459;9332;12890;13198,5110,2,0,2,0,4
16481,30,5529,2516;4479,5110,0,0,2,0,2
16482,30,5530,2983,5110,0,0,0,1,1
16483,30,5531,7244,5110,0,0,0,1,1
16484,30,5532,9557,5110,0,0,0,1,1
16485,30,5533,3573;9649;11798;11948;12139,5110,0,3,2,0,5
16486,30,5534,431;9693,5110,0,0,2,0,2
16487,30,5536,113;3921;11677,5475,0,1,2,0,3
16488,30,5537,1064;3477;12375;12514,5475,0,2,2,0,4
16489,30,5539,381,5475,0,0,0,1,1
16490,30,5540,327;445,5475,0,0,1,1,2
16491,30,5541,462,5475,0,0,0,1,1
16492,30,5542,798;2737,5475,0,0,0,2,2
16493,30,5543,6495,5475,0,0,0,1,1
16494,30,5544,949,5475,0,0,1,0,1
16495,30,5546,967,5475,0,0,0,1,1
16496,30,5547,972,5475,0,0,0,1,1
16497,30,5548,1224,5475,0,0,0,1,1
16498,30,5549,1343;8406;12217;12824,5475,1,1,2,0,4
16499,30,5550,37;2394;12113;12854,5475,1,1,2,0,4
16500,30,5552,5234,5475,0,0,1,0,1
16501,30,5553,1544;3945;12239;12278;12818,5475,1,2,2,0,5
16502,30,5555,1670;6127,5475,0,0,2,0,2
16503,30,5558,5021;5114,5475,0,0,2,0,2
16504,30,5560,574;7481;12544;12731,5475,0,2,2,0,4
16505,30,5561,1930;3367;11763;12221,5475,0,2,2,0,4
16506,30,5564,2175;8038;12171;12477;12539;12698;13264,5475,1,4,2,0,7
16507,30,5565,2321;7072;11685,5475,0,1,2,0,3
16508,30,5566,4057;5367;12446;12670;12939,5475,1,2,2,0,5
16509,30,5567,2498;11957;12324,5475,0,2,1,0,3
16510,30,5569,2667;8086,5475,0,0,2,0,2
16511,30,5570,3458;5806;11958;12110;13068,5475,1,2,2,0,5
16512,30,5572,1522;2996;11845;12200;13131,5475,1,2,2,0,5
16513,30,5573,212;3120;11662;11985,5475,0,2,2,0,4
16514,30,5574,3121;7509,5475,0,0,2,0,2
16515,30,5575,3215;9637;12325;13000,5475,1,1,2,0,4
16516,30,5576,470;1608;12018;12447,5475,0,2,2,0,4
16517,30,5578,2176;3359;11584;11734;12943,5475,1,2,2,0,5
16518,30,5579,3503;6809;12191;12898;13267,5475,2,1,2,0,5
16519,30,5580,2976;3578;11640;11753;12101,5475,0,3,2,0,5
16520,30,5581,3710;6791;12155;12411,5475,0,2,2,0,4
16521,30,5582,3885,5475,0,0,1,0,1
16522,30,5583,3891,5475,0,0,0,1,1
16523,30,5584,181;7964;12409;13195,5475,1,1,2,0,4
16524,30,5585,5047;12986,5475,1,0,1,0,2
16525,30,5586,4085;9285,5475,0,0,2,0,2
16526,30,5588,1751;9230;12620;12967,5475,1,1,2,0,4
16527,30,5590,4501,5475,0,0,0,1,1
16528,30,5592,4587;11557;11643,5475,0,2,1,0,3
16529,30,5594,4601,5475,0,0,1,0,1
16530,30,5595,4700;11570;12714;12891,5475,1,2,1,0,4
16531,30,5596,4832;7016;12618;12894,5475,1,1,2,0,4
16532,30,5597,4850;7818,5475,0,0,2,0,2
16533,30,5598,4913,5475,0,0,0,1,1
16534,30,5599,3136;5156;12667,5475,0,1,2,0,3
16535,30,5601,5554;9501,5475,0,0,2,0,2
16536,30,5602,1428;2876;11629;12843,5475,1,1,2,0,4
16537,30,5605,4955;5892;11655;12443;13337,5475,1,2,2,0,5
16538,30,5607,4401;4950,5475,0,0,2,0,2
16539,30,5608,6133;12993,5475,1,0,1,0,2
16540,30,5610,6202;6839;11654;11978,5475,0,2,2,0,4
16541,30,5611,2123;7555;12045;12274;13105,5475,1,2,2,0,5
16542,30,5614,2434;6624;12345;12560;12746,5475,1,2,2,0,5
16543,30,5615,1499;7340,5475,0,0,2,0,2
16544,30,5616,6902,5475,0,0,0,1,1
16545,30,5618,6466;7024;12368;12558,5475,0,2,2,0,4
16546,30,5619,3046;3863;12820;13088,5475,2,0,2,0,4
16547,30,5620,3156;7373,5475,0,0,2,0,2
16548,30,5621,7426,5475,0,0,0,1,1
16549,30,5623,4153;7638,5475,0,0,2,0,2
16550,30,5624,1387;12227,5475,0,1,1,0,2
16551,30,5625,7794,5475,0,0,1,0,1
16552,30,5626,55;8336;12316,5475,0,1,2,0,3
16553,30,5627,6003;8047;12472;12874,5475,1,1,2,0,4
16554,30,5628,793;8010;12108;12699;12897,5475,1,2,2,0,5
16555,30,5629,2783;9816;12659,5475,0,1,2,0,3
16556,30,5630,169;8302;12062;12775,5475,1,1,2,0,4
16557,30,5632,6847;8483,5475,0,0,2,0,2
16558,30,5633,6292;8633,5475,0,0,0,2,2
16559,30,5634,8641;8826;11830;12176,5475,0,2,2,0,4
16560,30,5635,5241;6088,5475,0,0,2,0,2
16561,30,5636,6229;9006,5475,0,0,2,0,2
16562,30,5637,4544;9042;12502;12635,5475,0,2,2,0,4
16563,30,5639,3337;9400;11935;12212;12557;13049,5475,1,3,2,0,6
16564,30,5641,1060;5777,5475,0,0,0,2,2
16565,30,5642,440;9664;13030,5475,1,0,2,0,3
16566,30,5643,5553;9689;12193,5475,0,1,2,0,3
16567,30,5644,4075;8556;11648;11946,5475,0,2,2,0,4
16568,30,5645,3428;8591;12899;13255,5475,2,0,2,0,4
16569,30,5647,631;9853;11928;12876;13305,5475,2,1,2,0,5
16570,30,5648,5329;9976;11784;12497,5475,0,2,2,0,4
16571,30,5649,11;612;12786,5840,1,0,2,0,3
16572,30,5652,120;1929;12893,5840,1,0,2,0,3
16573,30,5655,840,5840,0,0,0,1,1
16574,30,5656,378;1847;11732;11862;12086,5840,0,3,2,0,5
16575,30,5657,1366;8490,5840,0,0,0,2,2
16576,30,5658,8743,5840,0,0,0,1,1
16577,30,5659,5529,5840,0,0,0,1,1
16578,30,5660,863,5840,0,0,1,0,1
16579,30,5661,10030;13050,5840,1,0,1,0,2
16580,30,5663,2234;4617;13275,5840,1,0,2,0,3
16581,30,5664,6183;6719;12487;13119,5840,1,1,2,0,4
16582,30,5665,1267;11749;12079;12848,5840,1,2,1,0,4
16583,30,5667,1746;11926;12741;13346,5840,2,1,1,0,4
16584,30,5668,3400;8110;12354,5840,0,1,2,0,3
16585,30,5669,1727;7709;11646;12005;13017,5840,1,2,2,0,5
16586,30,5670,163;1770;12082;12223;13398,5840,1,2,2,0,5
16587,30,5671,7625,5840,0,0,0,1,1
16588,30,5674,2233;2523;11746;11999,5840,0,2,2,0,4
16589,30,5676,2268,5840,0,0,1,0,1
16590,30,5677,3233;7500;12084;12379;13289,5840,1,2,2,0,5
16591,30,5678,2365;10105;12778,5840,1,0,2,0,3
16592,30,5680,3824,5840,0,0,0,1,1
16593,30,5681,3029;7634;12162;12604,5840,0,2,2,0,4
16594,30,5682,9883,5840,0,0,1,0,1
16595,30,5683,3209;10012;12444;12668;13053,5840,1,2,2,0,5
16596,30,5685,2271;3346;11873;12492;12684;13034,5840,1,3,2,0,6
16597,30,5686,7445;10040;12281;12666;13078,5840,1,2,2,0,5
16598,30,5687,6309;12475;12951,5840,1,1,1,0,3
16599,30,5689,3146;12051;12297;13037,5840,1,2,1,0,4
16600,30,5690,2404;3968;11800;12519,5840,0,2,2,0,4
16601,30,5691,4020;7278,5840,0,0,0,2,2
16602,30,5692,9726;9854,5840,0,0,2,0,2
16603,30,5693,6850,5840,0,0,1,0,1
16604,30,5694,4317;8489,5840,0,0,1,1,2
16605,30,5697,4752;12529,5840,0,1,1,0,2
16606,30,5698,9589;11672;11842;12553,5840,0,3,1,0,4
16607,30,5699,4846;6601;12020;12374,5840,0,2,2,0,4
16608,30,5701,5064;9056;12706,5840,0,1,2,0,3
16609,30,5703,651;5227,5840,0,0,2,0,2
16610,30,5704,2300;5228;11668;12511,5840,0,2,2,0,4
16611,30,5705,5310;10045;13076,5840,1,0,2,0,3
16612,30,5706,5311;8409;11807;12693,5840,0,2,2,0,4
16613,30,5707,5382;6905;11691;12186;12700;13194,5840,1,3,2,0,6
16614,30,5708,4074;5425;12549;12850;13048,5840,2,1,2,0,5
16615,30,5709,5436;11663;11910,5840,0,2,1,0,3
16616,30,5710,5565;7193;12336;12534,5840,0,2,2,0,4
16617,30,5711,5793;10113;11826;12118;12644,5840,0,3,2,0,5
16618,30,5712,250;5805;12077;13111,5840,1,1,2,0,4
16619,30,5714,5985;9454;11913;12033;12401,5840,0,3,2,0,5
16620,30,5716,6114;10027,5840,0,0,2,0,2
16621,30,5717,6119,5840,0,0,1,0,1
16622,30,5718,6122,5840,0,0,1,0,1
16623,30,5720,6582;7596;13108,5840,1,0,2,0,3
16624,30,5721,6668,5840,0,0,1,0,1
16625,30,5722,6699;11728;12452;13109,5840,1,2,1,0,4
16626,30,5723,1987;6764;12064,5840,0,1,2,0,3
16627,30,5726,119;7197;11771;12126,5840,0,2,2,0,4
16628,30,5727,6222;7372,5840,0,0,2,0,2
16629,30,5728,6071;7383;12804,5840,1,0,2,0,3
16630,30,5732,786;7789;12743;13180,5840,2,0,2,0,4
16631,30,5735,8042,5840,0,0,0,1,1
16632,30,5737,334;8288;12790;13090,5840,2,0,2,0,4
16633,30,5738,5988;8317;11921;11972;12348,5840,0,3,2,0,5
16634,30,5739,6571;8421;13340,5840,1,0,2,0,3
16635,30,5740,7156;9220;12410;12547,5840,0,2,2,0,4
16636,30,5741,3083,5840,0,0,0,1,1
16637,30,5742,480;12216;12621;12855,5840,1,2,1,0,4
16638,30,5744,1415;2245,5840,0,0,2,0,2
16639,30,5745,4855,5840,0,0,1,0,1
16640,30,5746,4945;12272;12842,5840,1,1,1,0,3
16641,30,5747,8967,5840,0,0,1,0,1
16642,30,5748,7316;9037;12109;12467,5840,0,2,2,0,4
16643,30,5750,4748;9211;12512;12866;13312,5840,2,1,2,0,5
16644,30,5754,2210;3725,5840,0,0,2,0,2
16645,30,5756,6856,5840,0,0,1,0,1
16646,30,5758,8276,5840,0,0,1,0,1
16647,30,5761,242,6205,0,0,1,0,1
16648,30,5763,319;7765;11840;12245,6205,0,2,2,0,4
16649,30,5764,386;10063;11956;13085;13214,6205,2,1,2,0,5
16650,30,5765,477;2370;12344;12432;13287,6205,1,2,2,0,5
16651,30,5766,4385;5710;11755;12006;12431;12495,6205,0,4,2,0,6
16652,30,5767,803;12968,6205,1,0,1,0,2
16653,30,5769,1507,6205,0,0,0,1,1
16654,30,5770,878;982;12058;12332;12434,6205,0,3,2,0,5
16655,30,5772,4147;9606;11945;12317;12388,6205,0,3,2,0,5
16656,30,5773,461;10049;11852,6205,0,1,2,0,3
16657,30,5774,1314;3201;12448;12734;13240,6205,1,2,2,0,5
16658,30,5775,1697,6205,0,0,0,1,1
16659,30,5776,44;1837,6205,0,0,2,0,2
16660,30,5779,2168;7341;11907;12066,6205,0,2,2,0,4
16661,30,5781,2291;7068,6205,0,0,2,0,2
16662,30,5782,7168,6205,0,0,0,1,1
16663,30,5783,2316;3883,6205,0,0,2,0,2
16664,30,5784,6879;7914;12609;12879;13239,6205,2,1,2,0,5
16665,30,5785,2689;2738;13205,6205,1,0,2,0,3
16666,30,5786,2690,6205,0,0,0,1,1
16667,30,5787,632;11766;11925,6205,0,2,1,0,3
16668,30,5788,6135,6205,0,0,0,1,1
16669,30,5789,3231;8493,6205,0,0,2,0,2
16670,30,5792,3320,6205,0,0,0,1,1
16671,30,5793,3375;4856;12265;12687;12892,6205,1,2,2,0,5
16672,30,5794,1158;3420;12762,6205,1,0,2,0,3
16673,30,5795,3591;10076;12961;13084,6205,2,0,2,0,4
16674,30,5796,3841;10112;11809;13141;13288,6205,2,1,2,0,5
16675,30,5798,3995;6773;12395;12791,6205,1,1,2,0,4
16676,30,5799,4154,6205,0,0,0,1,1
16677,30,5800,4218;4290,6205,0,0,2,0,2
16678,30,5801,9116,6205,0,0,0,1,1
16679,30,5802,2728;4516;13201;13285,6205,2,0,2,0,4
16680,30,5803,4523;9197;13101;13269,6205,2,0,2,0,4
16681,30,5805,4689;8498;11947;12169;12594,6205,0,3,2,0,5
16682,30,5806,3111;4757;12653,6205,0,1,2,0,3
16683,30,5808,4867;9667;11964;12481,6205,0,2,2,0,4
16684,30,5810,4952,6205,0,0,0,1,1
16685,30,5812,1369,6205,0,0,0,1,1
16686,30,5813,5184,6205,0,0,0,1,1
16687,30,5814,5297;7995,6205,0,0,2,0,2
16688,30,5815,5334,6205,0,0,0,1,1
16689,30,5816,5480;12972,6205,1,0,1,0,2
16690,30,5818,1328;5642;11872;12591,6205,0,2,2,0,4
16691,30,5819,379;9765;12199;12437;13127,6205,1,2,2,0,5
16692,30,5820,5899;6982;11837;12170,6205,0,2,2,0,4
16693,30,5821,3601;5901;12282;12556;12758,6205,1,2,2,0,5
16694,30,5822,3366;5929;12641;13142,6205,1,1,2,0,4
16695,30,5824,3961;6192;12194,6205,0,1,2,0,3
16696,30,5825,2729;6262;13282,6205,1,0,2,0,3
16697,30,5826,2290,6205,0,0,1,0,1
16698,30,5828,4329;6341,6205,0,0,0,2,2
16699,30,5829,421;2146,6205,0,0,2,0,2
16700,30,5830,6369;6632,6205,0,0,2,0,2
16701,30,5831,4225;6375,6205,0,0,2,0,2
16702,30,5832,6461;9740,6205,0,0,2,0,2
16703,30,5833,1026;8146;12691;13001,6205,1,1,2,0,4
16704,30,5834,4714;9681,6205,0,0,2,0,2
16705,30,5837,6838;11980,6205,0,1,1,0,2
16706,30,5839,7037;10053;12496;13064;13347,6205,2,1,2,0,5
16707,30,5840,2760;7040;11950;12782;13250,6205,2,1,2,0,5
16708,30,5841,7081,6205,0,0,0,1,1
16709,30,5842,1623;7097;13055,6205,1,0,2,0,3
16710,30,5843,1313;7110;12041;12195;12566,6205,0,3,2,0,5
16711,30,5844,7174,6205,0,0,0,1,1
16712,30,5847,4092;7402;11863;12439,6205,0,2,2,0,4
16713,30,5848,1478;7747;12143;12363;12674,6205,0,3,2,0,5
16714,30,5849,1467;7793;12255;12756;13219,6205,2,1,2,0,5
16715,30,5850,3575;7927,6205,0,0,2,0,2
16716,30,5852,277;8237;11942,6205,0,1,2,0,3
16717,30,5853,5674;9003;12314,6205,0,1,2,0,3
16718,30,5854,8398;8511,6205,0,0,1,1,2
16719,30,5857,8885,6205,0,0,1,0,1
16720,30,5858,9266;12132;12327,6205,0,2,1,0,3
16721,30,5859,9210;9782;12049;12329;12613,6205,0,3,2,0,5
16722,30,5860,9082;9425;12962,6205,1,0,2,0,3
16723,30,5861,2354;9756;12424,6205,0,1,2,0,3
16724,30,5864,5860;12649;13004,6205,1,1,1,0,3
16725,30,5867,93;10246;12177,6570,0,1,2,0,3
16726,30,5869,562;10232;11932;13330,6570,1,1,2,0,4
16727,30,5870,294;652;12404;12622;13187,6570,1,2,2,0,5
16728,30,5871,361;760,6570,0,0,2,0,2
16729,30,5872,318,6570,0,0,0,1,1
16730,30,5873,7762;9736;13145,6570,1,0,2,0,3
16731,30,5874,1092;1136;12089;13117,6570,1,1,2,0,4
16732,30,5876,1231,6570,0,0,1,0,1
16733,30,5877,1309,6570,0,0,0,1,1
16734,30,5878,1545;10122;12250,6570,0,1,2,0,3
16735,30,5879,1564;2250;12236;12419,6570,0,2,2,0,4
16736,30,5881,1734,6570,0,0,0,1,1
16737,30,5885,10187;12875,6570,1,0,1,0,2
16738,30,5886,921;12543;12688,6570,0,2,1,0,3
16739,30,5888,2818;10142;13091,6570,1,0,2,0,3
16740,30,5889,2868,6570,0,0,0,1,1
16741,30,5890,2919;9139;12455;12984,6570,1,1,2,0,4
16742,30,5891,2963;6991;11849,6570,0,1,2,0,3
16743,30,5892,1144;2964;12662;12999,6570,1,1,2,0,4
16744,30,5893,960;3007;12156;12813;13374,6570,2,1,2,0,5
16745,30,5894,1027;3058;12211;12732,6570,0,2,2,0,4
16746,30,5895,3118;12088;12369,6570,0,2,1,0,3
16747,30,5897,89;3145;12738,6570,1,0,2,0,3
16748,30,5898,3255;7025,6570,0,0,2,0,2
16749,30,5899,3266;8698;12929;13120,6570,2,0,2,0,4
16750,30,5900,2322;8273;12503;12642,6570,0,2,2,0,4
16751,30,5901,2724;6091,6570,0,0,1,1,2
16752,30,5902,3472;10139;12034;12294;12761;13071,6570,2,2,2,0,6
16753,30,5905,1833,6570,0,0,0,1,1
16754,30,5906,4052,6570,0,0,0,1,1
16755,30,5908,4192,6570,0,0,0,1,1
16756,30,5910,6933;9930,6570,0,0,2,0,2
16757,30,5912,604;4960,6570,0,0,2,0,2
16758,30,5917,4837,6570,0,0,0,1,1
16759,30,5919,5186;9688;12307;13252,6570,1,1,2,0,4
16760,30,5920,6848,6570,0,0,1,0,1
16761,30,5921,5527,6570,0,0,0,1,1
16762,30,5922,5626,6570,0,0,1,0,1
16763,30,5923,5698;10089;11865;12161;12852,6570,1,2,2,0,5
16764,30,5924,5711,6570,0,0,1,0,1
16765,30,5925,5723;6101;12438;12990,6570,1,1,2,0,4
16766,30,5927,5743;10020;12725,6570,0,1,2,0,3
16767,30,5929,6565,6570,0,0,0,1,1
16768,30,5931,1694;7780,6570,0,0,2,0,2
16769,30,5932,5195;6914,6570,0,0,2,0,2
16770,30,5933,6233;12065;12202,6570,0,2,1,0,3
16771,30,5934,6370;8703;12024;12266,6570,0,2,2,0,4
16772,30,5935,6393;10214;12350,6570,0,1,2,0,3
16773,30,5936,6483,6570,0,0,0,1,1
16774,30,5937,6520,6570,0,0,0,1,1
16775,30,5940,6593,6570,0,0,0,1,1
16776,30,5941,2295;7030,6570,0,0,2,0,2
16777,30,5943,1458;4678,6570,0,0,2,0,2
16778,30,5944,3638,6570,0,0,0,1,1
16779,30,5945,5726;8297;12283;13129,6570,1,1,2,0,4
16780,30,5946,774;7510;12937,6570,1,0,2,0,3
16781,30,5947,10283;12179;12697;12747,6570,1,2,1,0,4
16782,30,5948,4677;12292;12454;12657,6570,0,3,1,0,4
16783,30,5949,7029;7939;12224;13021,6570,1,1,2,0,4
16784,30,5951,8266,6570,0,0,1,0,1
16785,30,5953,4476;8338;12533;12800,6570,1,1,2,0,4
16786,30,5954,2409,6570,0,0,1,0,1
16787,30,5956,8886;9722,6570,0,0,2,0,2
16788,30,5958,8646,6570,0,0,0,1,1
16789,30,5959,7394,6570,0,0,1,0,1
16790,30,5960,3055;8840;13248,6570,1,0,2,0,3
16791,30,5962,3185;9099;12151;12357,6570,0,2,2,0,4
16792,30,5963,9151;10158;12362;13013,6570,1,1,2,0,4
16793,30,5964,2870;9161;12261;12752;13110,6570,2,1,2,0,5
16794,30,5965,7712;9162;13196,6570,1,0,2,0,3
16795,30,5966,3794;9215;12056;12651,6570,0,2,2,0,4
16796,30,5968,6693;9394;13186,6570,1,0,2,0,3
16797,30,5970,665;6536;13079;13295,6570,2,0,2,0,4
16798,30,5971,9563;10299;12153;13301,6570,1,1,2,0,4
16799,30,5972,9590,6570,0,0,0,1,1
16800,30,5973,2893;9626;12158;12921,6570,1,1,2,0,4
16801,30,5974,9682,6570,0,0,1,0,1
16802,30,5975,2264;9696,6570,0,0,2,0,2
16803,30,5976,2539;9710;13334,6570,1,0,2,0,3
16804,30,5977,6056;9720;12426;12794,6570,1,1,2,0,4
16805,30,5979,9793,6570,0,0,0,1,1
16806,30,5981,18,6935,0,0,1,0,1
16807,30,5982,48;6986,6935,0,0,2,0,2
16808,30,5983,96;5379;12098,6935,0,1,2,0,3
16809,30,5984,153,6935,0,0,1,0,1
16810,30,5985,316;4630;13096,6935,1,0,2,0,3
16811,30,5988,688;1826,6935,0,0,2,0,2
16812,30,5990,1050,6935,0,0,1,0,1
16813,30,5991,2703;9331,6935,0,0,1,1,2
16814,30,5993,1111;9507,6935,0,0,2,0,2
16815,30,5994,1637;7163;12561,6935,0,1,2,0,3
16816,30,5995,1682;10155;13236,6935,1,0,2,0,3
16817,30,5996,1782,6935,0,0,0,1,1
16818,30,5997,1904;6325,6935,0,0,2,0,2
16819,30,5998,5798,6935,0,0,1,0,1
16820,30,5999,1940;2069,6935,0,0,2,0,2
16821,30,6000,2075,6935,0,0,0,1,1
16822,30,6001,4515;4704;12213;12542;13143,6935,1,2,2,0,5
16823,30,6003,2242,6935,0,0,1,0,1
16824,30,6004,2410,6935,0,0,0,1,1
16825,30,6005,2494;5016;12973,6935,1,0,2,0,3
16826,30,6008,2995,6935,0,0,1,0,1
16827,30,6009,3521,6935,0,0,0,1,1
16828,30,6010,50;3776;12933,6935,1,0,2,0,3
16829,30,6011,3820;5937;13251,6935,1,0,2,0,3
16830,30,6012,3907,6935,0,0,0,1,1
16831,30,6015,1422,6935,0,0,1,0,1
16832,30,6017,4833;8701;12694;12944,6935,1,1,2,0,4
16833,30,6020,5032;10081,6935,0,0,2,0,2
16834,30,6021,2965;7177;12710;13167,6935,1,1,2,0,4
16835,30,6022,1305;3341;12371;12994;13328,6935,2,1,2,0,5
16836,30,6023,5643;8998;12935;13092,6935,2,0,2,0,4
16837,30,6026,5983,6935,0,0,0,1,1
16838,30,6027,6051,6935,0,0,0,1,1
16839,30,6028,6155;7444,6935,0,0,2,0,2
16840,30,6029,6161,6935,0,0,0,1,1
16841,30,6030,3679;6208;12053;12765,6935,1,1,2,0,4
16842,30,6031,6378,6935,0,0,1,0,1
16843,30,6033,5000,6935,0,0,1,0,1
16844,30,6034,8176;8214,6935,0,0,2,0,2
16845,30,6035,4257;12802;13018,6935,2,0,1,0,3
16846,30,6037,7039;10031,6935,0,0,2,0,2
16847,30,6038,2032;7054,6935,0,0,2,0,2
16848,30,6041,6641;7257,6935,0,0,2,0,2
16849,30,6042,4133,6935,0,0,0,1,1
16850,30,6043,10367;10526;12460;13178,6935,1,1,2,0,4
16851,30,6044,7591,6935,0,0,0,1,1
16852,30,6045,7599,6935,0,0,1,0,1
16853,30,6048,7183;8358,6935,0,0,2,0,2
16854,30,6049,8553;10034;12965;13022,6935,2,0,2,0,4
16855,30,6051,895;8996,6935,0,0,2,0,2
16856,30,6052,9046;12690;13199,6935,1,1,1,0,3
16857,30,6054,9256,6935,0,0,1,0,1
16858,30,6056,9520;10308;12484;13231,6935,1,1,2,0,4
16859,30,6059,9748,6935,0,0,1,0,1
16860,30,6060,9810,6935,0,0,0,1,1
16861,30,6061,9984,6935,0,0,0,1,1
16862,30,6062,2896;10003,6935,0,0,2,0,2
16863,30,6063,10061;10383;12259;12728;12938,6935,1,2,2,0,5
16864,30,6064,10328;12624;12795,6935,1,1,1,0,3
16865,30,6065,10086;10491;13363,6935,1,0,2,0,3
16866,30,6066,2085;10093,6935,0,0,2,0,2
16867,30,6067,10098;12959,6935,1,0,1,0,2
16868,30,6068,10115;12241,6935,0,1,1,0,2
16869,30,6069,94;10018;13307,7300,1,0,2,0,3
16870,30,6070,3924;4808,7300,0,0,2,0,2
16871,30,6071,493;6389,7300,0,0,2,0,2
16872,30,6072,512;3246;13189,7300,1,0,2,0,3
16873,30,6073,545;10484;12779;13020,7300,2,0,2,0,4
16874,30,6074,546;10407;12205;12812;12910,7300,2,1,2,0,5
16875,30,6075,1164;7311;12736;12839;13126,7300,2,1,2,0,5
16876,30,6076,1334,7300,0,0,1,0,1
16877,30,6077,1461;10201,7300,0,0,2,0,2
16878,30,6078,1472;10287;12060;12263;12989,7300,1,2,2,0,5
16879,30,6079,1797;10218;12831;13093;13247,7300,3,0,2,0,5
16880,30,6081,2330,7300,0,0,1,0,1
16881,30,6082,1093;2442;12489,7300,0,1,2,0,3
16882,30,6085,10084;13083,7300,1,0,1,0,2
16883,30,6086,87;7310;12393;12630,7300,0,2,2,0,4
16884,30,6089,3408,7300,0,0,0,1,1
16885,30,6090,3424;5917;13116,7300,1,0,2,0,3
16886,30,6091,3476;6967;12120,7300,0,1,2,0,3
16887,30,6092,1630;3492;12198;12318;12521,7300,0,3,2,0,5
16888,30,6093,3600;10069;12740;13089;13329,7300,3,0,2,0,5
16889,30,6096,5521,7300,0,0,1,0,1
16890,30,6097,8163,7300,0,0,1,0,1
16891,30,6099,3807,7300,0,0,1,0,1
16892,30,6100,3481;10065;12491;12528;12816;13326,7300,2,2,2,0,6
16893,30,6101,4023;9923;13067;13338,7300,2,0,2,0,4
16894,30,6102,4106;10371;12190;12808;13104,7300,2,1,2,0,5
16895,30,6103,7624,7300,0,0,1,0,1
16896,30,6105,3141;9709;12638,7300,0,1,2,0,3
16897,30,6106,4777,7300,0,0,0,1,1
16898,30,6107,10347;10480;12119;12164;12889,7300,1,2,2,0,5
16899,30,6108,4948,7300,0,0,0,1,1
16900,30,6109,1056;4959;13274,7300,1,0,2,0,3
16901,30,6111,5097;8109,7300,0,0,2,0,2
16902,30,6113,2948;5161,7300,0,0,2,0,2
16903,30,6114,5170;6616;12815;13081,7300,2,0,2,0,4
16904,30,6115,3388;5402;12548,7300,0,1,2,0,3
16905,30,6117,5676,7300,0,0,0,1,1
16906,30,6120,5788;8198;12598;13042,7300,1,1,2,0,4
16907,30,6121,5850;9654;12304;12499;12895;13344,7300,2,2,2,0,6
16908,30,6122,494;5930;13130;13286,7300,2,0,2,0,4
16909,30,6123,5980,7300,0,0,1,0,1
16910,30,6124,4909,7300,0,0,1,0,1
16911,30,6126,6490;10322;12160;13028,7300,1,1,2,0,4
16912,30,6127,6849;7098;12478;12628;13158,7300,1,2,2,0,5
16913,30,6128,672,7300,0,0,1,0,1
16914,30,6129,5175;10188;13276,7300,1,0,2,0,3
16915,30,6130,2693,7300,0,0,1,0,1
16916,30,6131,4016;7570,7300,0,0,2,0,2
16917,30,6132,7606,7300,0,0,1,0,1
16918,30,6133,4571;7622;13257,7300,1,0,2,0,3
16919,30,6134,986;7809,7300,0,0,2,0,2
16920,30,6137,8121,7300,0,0,1,0,1
16921,30,6138,6525,7300,0,0,1,0,1
16922,30,6141,3946;8749,7300,0,0,2,0,2
16923,30,6142,3502;8618,7300,0,0,2,0,2
16924,30,6143,8805,7300,0,0,0,1,1
16925,30,6145,1991,7300,0,0,0,1,1
16926,30,6148,6754;9028,7300,0,0,2,0,2
16927,30,6149,3673,7300,0,0,1,0,1
16928,30,6150,9398,7300,0,0,0,1,1
16929,30,6151,249;6153,7300,0,0,0,2,2
16930,30,6154,3834;9879;12616;12763;13016,7300,2,1,2,0,5
16931,30,6155,9887;10386;12721;12966;13140,7300,2,1,2,0,5
16932,30,6156,5197,7300,0,0,0,1,1
16933,30,6157,10019;10257;12163;12254;12883,7300,1,2,2,0,5
16934,30,6158,3478,7300,0,0,1,0,1
16935,30,6159,10043;10475;12394,7300,0,1,2,0,3
16936,30,6160,10050;10056;12846,7300,1,0,2,0,3
16937,30,6161,8040;10055;12531,7300,0,1,2,0,3
16938,30,6163,10064;10083;12927;13216,7300,2,0,2,0,4
16939,30,6164,10107;10439;12516;12834;13237,7300,2,1,2,0,5
16940,30,6165,10121;10295;12288,7300,0,1,2,0,3
16941,30,6166,10117;10132,7300,0,0,2,0,2
16942,30,6167,10175;10384;12152;12569,7300,0,2,2,0,4
16943,30,6168,10178;10329;12537;13173,7300,1,1,2,0,4
16944,30,6169,10203;10275;12871,7300,1,0,2,0,3
16945,30,6170,228;10205;12754,7300,1,0,2,0,3
16946,30,6171,10224;12208;12610;13080,7300,1,2,1,0,4
16947,30,6172,10400;12792;13362,7300,2,0,1,0,3
16948,30,6173,10219;12727,7300,0,1,1,0,2
16949,30,6174,405;10075;12527;12830;13033,7665,2,1,2,0,5
16950,30,6175,448;10094,7665,0,0,2,0,2
16951,30,6177,175;653;12663;12851,7665,1,1,2,0,4
16952,30,6178,667,7665,0,0,0,1,1
16953,30,6180,3254,7665,0,0,1,0,1
16954,30,6182,6744,7665,0,0,1,0,1
16955,30,6183,1004,7665,0,0,0,1,1
16956,30,6184,1108,7665,0,0,0,1,1
16957,30,6185,1284;10033;12797,7665,1,0,2,0,3
16958,30,6187,1628,7665,0,0,1,0,1
16959,30,6188,6560,7665,0,0,1,0,1
16960,30,6189,2015;9518,7665,0,0,2,0,2
16961,30,6192,2634,7665,0,0,1,0,1
16962,30,6193,2960;5137;12500;12886,7665,1,1,2,0,4
16963,30,6194,2975;10052;12942,7665,1,0,2,0,3
16964,30,6195,7912,7665,0,0,1,0,1
16965,30,6196,4787,7665,0,0,0,1,1
16966,30,6197,3126;12960;13225,7665,2,0,1,0,3
16967,30,6198,3240;3978,7665,0,0,2,0,2
16968,30,6199,3318;3874;12805;12914,7665,2,0,2,0,4
16969,30,6200,3234,7665,0,0,1,0,1
16970,30,6201,4056;5258,7665,0,0,2,0,2
16971,30,6203,4221;10060,7665,0,0,2,0,2
16972,30,6204,4554,7665,0,0,1,0,1
16973,30,6206,4874,7665,0,0,1,0,1
16974,30,6207,303,7665,0,0,1,0,1
16975,30,6208,5113;6529,7665,0,0,2,0,2
16976,30,6209,5245;8271,7665,0,0,2,0,2
16977,30,6210,5277;9371,7665,0,0,2,0,2
16978,30,6212,1142,7665,0,0,0,1,1
16979,30,6213,6159;8278;13153,7665,1,0,2,0,3
16980,30,6214,6261;9888;12859;13012,7665,2,0,2,0,4
16981,30,6216,896;12608;13046,7665,1,1,1,0,3
16982,30,6217,6923,7665,0,0,1,0,1
16983,30,6218,7571,7665,0,0,0,1,1
16984,30,6220,6542;7179,7665,0,0,2,0,2
16985,30,6222,262;7255,7665,0,0,2,0,2
16986,30,6223,7304;9580;12708;12996,7665,1,1,2,0,4
16987,30,6224,4169;7671,7665,0,0,2,0,2
16988,30,6225,1013;3887,7665,0,0,0,2,2
16989,30,6226,7724,7665,0,0,1,0,1
16990,30,6227,7889,7665,0,0,1,0,1
16991,30,6228,8002,7665,0,0,0,1,1
16992,30,6229,613;8145;13057;13373,7665,2,0,2,0,4
16993,30,6230,8272,7665,0,0,1,0,1
16994,30,6231,8333,7665,0,0,0,1,1
16995,30,6235,8874,7665,0,0,1,0,1
16996,30,6237,5760,7665,0,0,1,0,1
16997,30,6239,3629,7665,0,0,1,0,1
16998,30,6242,4824,7665,0,0,0,1,1
16999,30,6243,10306;12949;13157,7665,2,0,1,0,3
17000,30,6244,8877;10354;12957,7665,1,0,2,0,3
17001,30,6245,8201;10119;13106,7665,1,0,2,0,3
17002,30,6246,10163;12568;12793;13036,7665,2,1,1,0,4
17003,30,6247,1468;10164;12361,7665,0,1,2,0,3
17004,30,6248,10110;10168;12285,7665,0,1,2,0,3
17005,30,6249,10209;10511;12535,7665,0,1,2,0,3
17006,30,6250,10227;10432;12322;12589;12995,7665,1,2,2,0,5
17007,30,6251,10184;10377;12652;13206;13333,7665,2,1,2,0,5
17008,30,6252,10248;10291;12865;13107,7665,2,0,2,0,4
17009,30,6253,10255;10296;12656;12888;13115,7665,2,1,2,0,5
17010,30,6254,10262;10530;12504;12634;13066;13372,7665,2,2,2,0,6
17011,30,6255,10265;10594;12494;12745,7665,1,1,2,0,4
17012,30,6256,10486;13390,7665,1,0,1,0,2
17013,30,6257,10292;10482;12433;12675;12840,7665,1,2,2,0,5
17014,30,6258,10312;10364;13395,7665,1,0,2,0,3
17015,30,6259,10537;12380,7665,0,1,1,0,2
17016,30,6260,10319;10565,7665,0,0,2,0,2
17017,30,6261,2910;10080;12461;13170,8030,1,1,2,0,4
17018,30,6264,523,8030,0,0,1,0,1
17019,30,6266,975,8030,0,0,1,0,1
17020,30,6267,1049;2361;12916;13263,8030,2,0,2,0,4
17021,30,6268,1116;7592,8030,0,0,2,0,2
17022,30,6269,1242;10101,8030,0,0,2,0,2
17023,30,6271,4294,8030,0,0,1,0,1
17024,30,6272,10156,8030,0,0,1,0,1
17025,30,6273,2013,8030,0,0,1,0,1
17026,30,6274,2067;6649,8030,0,0,2,0,2
17027,30,6278,936;1647,8030,0,0,2,0,2
17028,30,6279,2871;5736,8030,0,0,2,0,2
17029,30,6280,4152,8030,0,0,0,1,1
17030,30,6282,3370,8030,0,0,0,1,1
17031,30,6283,636;5330,8030,0,0,2,0,2
17032,30,6285,1990;6444,8030,0,0,2,0,2
17033,30,6287,2285;4315,8030,0,0,2,0,2
17034,30,6288,3127;4809;12915;13191,8030,2,0,2,0,4
17035,30,6289,5246,8030,0,0,1,0,1
17036,30,6290,5333;6519,8030,0,0,2,0,2
17037,30,6291,148;5364,8030,0,0,0,2,2
17038,30,6292,5725,8030,0,0,1,0,1
17039,30,6294,8100,8030,0,0,1,0,1
17040,30,6296,5926,8030,0,0,0,1,1
17041,30,6301,7211,8030,0,0,1,0,1
17042,30,6302,2598;8688,8030,0,0,2,0,2
17043,30,6305,5430,8030,0,0,1,0,1
17044,30,6306,7645,8030,0,0,0,1,1
17045,30,6307,7728,8030,0,0,1,0,1
17046,30,6311,1148;7293,8030,0,0,2,0,2
17047,30,6314,2301;9562,8030,0,0,2,0,2
17048,30,6315,8839;10180;12645,8030,0,1,2,0,3
17049,30,6316,9231,8030,0,0,1,0,1
17050,30,6317,9348,8030,0,0,0,1,1
17051,30,6319,10042;10141;13097;13327,8030,2,0,2,0,4
17052,30,6320,3952,8030,0,0,1,0,1
17053,30,6321,10067,8030,0,0,1,0,1
17054,30,6322,10021;10071,8030,0,0,2,0,2
17055,30,6323,81,8030,0,0,1,0,1
17056,30,6324,218;10104;12885,8030,1,0,2,0,3
17057,30,6325,10058;10140;12673,8030,0,1,2,0,3
17058,30,6326,10106;10160;13123;13339,8030,2,0,2,0,4
17059,30,6327,10861;12826;13208,8030,2,0,1,0,3
17060,30,6328,10157;10225;12931,8030,1,0,2,0,3
17061,30,6329,10073;10226;13211,8030,1,0,2,0,3
17062,30,6330,10223;10234;12723;13290,8030,1,1,2,0,4
17063,30,6331,10148;10235;12428;13169,8030,1,1,2,0,4
17064,30,6332,10236;12759;12985;13128,8030,3,0,1,0,4
17065,30,6333,10256,8030,0,0,1,0,1
17066,30,6335,10252;10272;13353,8030,1,0,2,0,3
17067,30,6336,10309;10463,8030,0,0,2,0,2
17068,30,6337,10314;10453;12671;13148,8030,1,1,2,0,4
17069,30,6338,10316;10374;13175,8030,1,0,2,0,3
17070,30,6339,10446;10790,8030,0,0,2,0,2
17071,30,6340,10348;10398;12364;12997,8030,1,1,2,0,4
17072,30,6341,10150;10382;12862;13054;13302,8030,3,0,2,0,5
17073,30,6342,10391;10412;11453;12601,8030,0,2,2,0,4
17074,30,6343,10397;10403;13209,8030,1,0,2,0,3
17075,30,6344,116,8395,0,0,1,0,1
17076,30,6347,383;6336;12440;12858,8395,1,1,2,0,4
17077,30,6348,476;3859;12757,8395,1,0,2,0,3
17078,30,6349,549;4645,8395,0,0,2,0,2
17079,30,6350,2221,8395,0,0,1,0,1
17080,30,6351,5027;10038,8395,0,0,2,0,2
17081,30,6352,1035;2121;13383,8395,1,0,2,0,3
17082,30,6354,1308;9986;13144,8395,1,0,2,0,3
17083,30,6355,2278,8395,0,0,0,1,1
17084,30,6356,2784;8052;12882,8395,1,0,2,0,3
17085,30,6357,1388;10032,8395,0,0,2,0,2
17086,30,6358,1493;10562,8395,0,0,2,0,2
17087,30,6361,2169;3214,8395,0,0,2,0,2
17088,30,6362,2534;6707;12525;12767,8395,1,1,2,0,4
17089,30,6363,3260,8395,0,0,0,1,1
17090,30,6365,8903,8395,0,0,1,0,1
17091,30,6367,8449,8395,0,0,0,1,1
17092,30,6368,3886;6470;12712;13005;13321,8395,2,1,2,0,5
17093,30,6369,3403;10211;12692,8395,0,1,2,0,3
17094,30,6370,7760,8395,0,0,0,1,1
17095,30,6371,1775,8395,0,0,1,0,1
17096,30,6373,6332,8395,0,0,1,0,1
17097,30,6374,3969;10305;12711;13355,8395,1,1,2,0,4
17098,30,6376,6873;7102,8395,0,0,2,0,2
17099,30,6380,4468,8395,0,0,0,1,1
17100,30,6381,2369;8057;12701,8395,0,1,2,0,3
17101,30,6382,4860,8395,0,0,1,0,1
17102,30,6383,4868;10245;12980;13242,8395,2,0,2,0,4
17103,30,6384,4946;10241;13298,8395,1,0,2,0,3
17104,30,6385,5169,8395,0,0,1,0,1
17105,30,6386,4845;10216;13121,8395,1,0,2,0,3
17106,30,6387,1759,8395,0,0,0,1,1
17107,30,6391,6955;9317;12646,8395,0,1,2,0,3
17108,30,6392,9417,8395,0,0,1,0,1
17109,30,6393,8007,8395,0,0,0,1,1
17110,30,6396,1658,8395,0,0,0,1,1
17111,30,6397,8307,8395,0,0,1,0,1
17112,30,6398,8372,8395,0,0,1,0,1
17113,30,6399,1632;8564,8395,0,0,2,0,2
17114,30,6400,9128;9370,8395,0,0,2,0,2
17115,30,6404,4304;9450,8395,0,0,2,0,2
17116,30,6407,253,8395,0,0,0,1,1
17117,30,6408,10011;10353;12909,8395,1,0,2,0,3
17118,30,6409,10041,8395,0,0,1,0,1
17119,30,6410,10074;10126,8395,0,0,2,0,2
17120,30,6411,10078,8395,0,0,1,0,1
17121,30,6412,9365;10088;12555,8395,0,1,2,0,3
17122,30,6413,10096;10210,8395,0,0,2,0,2
17123,30,6414,2751;10097;12936,8395,1,0,2,0,3
17124,30,6415,10114;13366,8395,1,0,1,0,2
17125,30,6417,10123;10523;13172,8395,1,0,2,0,3
17126,30,6418,10521;12550;12680,8395,0,2,1,0,3
17127,30,6419,10144;10372;12764,8395,1,0,2,0,3
17128,30,6421,10149;10251;12833;13357,8395,2,0,2,0,4
17129,30,6422,3247;10170;12707;13246,8395,1,1,2,0,4
17130,30,6423,10193;10498;12506,8395,0,1,2,0,3
17131,30,6424,10109;10208;12751,8395,1,0,2,0,3
17132,30,6425,10217,8395,0,0,1,0,1
17133,30,6426,10172;10269;12614;12785;12988,8395,2,1,2,0,5
17134,30,6427,10332;10591;12617;12828,8395,1,1,2,0,4
17135,30,6428,10333;10727;12583;12979;13303,8395,2,1,2,0,5
17136,30,6429,10152;10351;12562,8395,0,1,2,0,3
17137,30,6430,10228;10359;12945,8395,1,0,2,0,3
17138,30,6431,10258;10380;12881,8395,1,0,2,0,3
17139,30,6432,10336;10431;12977,8395,1,0,2,0,3
17140,30,6433,10434;10472;12704,8395,0,1,2,0,3
17141,30,6434,10350;10436;12515,8395,0,1,2,0,3
17142,30,6435,10325;10449,8395,0,0,2,0,2
17143,30,6436,10290;10450;12660,8395,0,1,2,0,3
17144,30,6437,10479;10754;12672,8395,0,1,2,0,3
17145,30,6438,10490;10788;12783,8395,1,0,2,0,3
17146,30,6439,8013,8760,0,0,1,0,1
17147,30,6440,10344;12814,8760,1,0,1,0,2
17148,30,6444,350,8760,0,0,1,0,1
17149,30,6446,1307;10085,8760,0,0,2,0,2
17150,30,6447,1345;5433,8760,0,0,2,0,2
17151,30,6448,1565;10399;12860,8760,1,0,2,0,3
17152,30,6451,7086;8661,8760,0,0,1,1,2
17153,30,6452,2493;9751;12625;13163,8760,1,1,2,0,4
17154,30,6453,5328,8760,0,0,1,0,1
17155,30,6454,2775;10102;12847,8760,1,0,2,0,3
17156,30,6457,2972,8760,0,0,1,0,1
17157,30,6459,3070;6612;12760;13044,8760,2,0,2,0,4
17158,30,6461,3241;10099,8760,0,0,2,0,2
17159,30,6462,3267,8760,0,0,1,0,1
17160,30,6464,347;3759;13192,8760,1,0,2,0,3
17161,30,6465,5840;9412,8760,0,0,2,0,2
17162,30,6466,5775;10183,8760,0,0,2,0,2
17163,30,6467,4148,8760,0,0,1,0,1
17164,30,6470,2700;3457,8760,0,0,2,0,2
17165,30,6472,8954,8760,0,0,0,1,1
17166,30,6477,6285,8760,0,0,1,0,1
17167,30,6479,6442,8760,0,0,0,1,1
17168,30,6481,6494,8760,0,0,1,0,1
17169,30,6483,1705;6654;12771;13025,8760,2,0,2,0,4
17170,30,6485,6805,8760,0,0,1,0,1
17171,30,6487,7469,8760,0,0,0,1,1
17172,30,6488,4022,8760,0,0,1,0,1
17173,30,6489,8626,8760,0,0,0,1,1
17174,30,6490,3731;5590;12753,8760,1,0,2,0,3
17175,30,6491,7972;9849;13268,8760,1,0,2,0,3
17176,30,6492,4210;8033,8760,0,0,2,0,2
17177,30,6493,8065;8878;13230,8760,1,0,2,0,3
17178,30,6494,8324,8760,0,0,1,0,1
17179,30,6495,8384,8760,0,0,1,0,1
17180,30,6496,199;8526,8760,0,0,2,0,2
17181,30,6499,8921,8760,0,0,1,0,1
17182,30,6501,4990;9506;12637;12742;13213,8760,2,1,2,0,5
17183,30,6503,9788;10035,8760,0,0,2,0,2
17184,30,6504,10025;10310;13388,8760,1,0,2,0,3
17185,30,6505,10054;10195;12821;13008;13389,8760,3,0,2,0,5
17186,30,6506,10066;10138;13259,8760,1,0,2,0,3
17187,30,6507,10330,8760,0,0,1,0,1
17188,30,6508,10167;10250,8760,0,0,2,0,2
17189,30,6509,10233;10579,8760,0,0,2,0,2
17190,30,6510,10301;10586,8760,0,0,2,0,2
17191,30,6511,10302;10735;12650,8760,0,1,2,0,3
17192,30,6512,10007,8760,0,0,1,0,1
17193,30,6513,10501;10668,8760,0,0,2,0,2
17194,30,6514,10118;10221;13181,8760,1,0,2,0,3
17195,30,6515,10128;10411;12969,8760,1,0,2,0,3
17196,30,6516,10423;10741;12685;13047,8760,1,1,2,0,4
17197,30,6517,10176;10425;13162,8760,1,0,2,0,3
17198,30,6518,10427;10674;12735;12978;13256,8760,2,1,2,0,5
17199,30,6519,10428;10590,8760,0,0,2,0,2
17200,30,6520,10181;10461;12827;12930,8760,2,0,2,0,4
17201,30,6521,10494;10895;12626;13059,8760,1,1,2,0,4
17202,30,6522,9247;10068,8760,0,0,2,0,2
17203,30,6523,10513;10850;12631,8760,0,1,2,0,3
17204,30,6524,10518;10661;12726;12774,8760,1,1,2,0,4
17205,30,6525,10519;10520;12658;13299,8760,1,1,2,0,4
17206,30,6526,10524;10797;12737,8760,0,1,2,0,3
17207,30,6527,10534,8760,0,0,1,0,1
17208,30,6528,10339;10547;13003,8760,1,0,2,0,3
17209,30,6529,10444;10563,8760,0,0,2,0,2
17210,30,6530,10658;10838;12664;13220,8760,1,1,2,0,4
17211,30,6531,10583;10671;12715;12781;13006,8760,2,1,2,0,5
17212,30,6532,10274;10595;12784,8760,1,0,2,0,3
17213,30,6533,10561;10597;12934,8760,1,0,2,0,3
17214,30,6534,2735,9125,0,0,1,0,1
17215,30,6538,802;837,9125,0,0,2,0,2
17216,30,6539,1001,9125,0,0,1,0,1
17217,30,6541,10424;10455;12696;13387,9125,1,1,2,0,4
17218,30,6542,1104;3137;12853;13232,9125,2,0,2,0,4
17219,30,6543,1059;9769,9125,0,0,2,0,2
17220,30,6546,2351,9125,0,0,1,0,1
17221,30,6547,7723,9125,0,0,1,0,1
17222,30,6552,2567;2937,9125,0,0,2,0,2
17223,30,6553,6680,9125,0,0,1,0,1
17224,30,6556,2913,9125,0,0,1,0,1
17225,30,6557,10254;13294,9125,1,0,1,0,2
17226,30,6558,1590,9125,0,0,1,0,1
17227,30,6561,3507;7856,9125,0,0,2,0,2
17228,30,6562,3518,9125,0,0,1,0,1
17229,30,6563,8269;8389,9125,0,0,2,0,2
17230,30,6564,10159;12676;13377,9125,1,1,1,0,3
17231,30,6566,8135,9125,0,0,1,0,1
17232,30,6567,5516,9125,0,0,0,1,1
17233,30,6568,5522,9125,0,0,1,0,1
17234,30,6570,8020,9125,0,0,1,0,1
17235,30,6571,6015;10177;13218,9125,1,0,2,0,3
17236,30,6573,8014,9125,0,0,1,0,1
17237,30,6574,367;7346;12829,9125,1,0,2,0,3
17238,30,6575,5109,9125,0,0,1,0,1
17239,30,6578,2920,9125,0,0,1,0,1
17240,30,6579,8253,9125,0,0,1,0,1
17241,30,6580,2429,9125,0,0,0,1,1
17242,30,6581,8395,9125,0,0,0,1,1
17243,30,6582,8659,9125,0,0,1,0,1
17244,30,6584,10696;12809;13331,9125,2,0,1,0,3
17245,30,6585,10023,9125,0,0,1,0,1
17246,30,6586,1045,9125,0,0,1,0,1
17247,30,6587,10153;13361,9125,1,0,1,0,2
17248,30,6588,10044,9125,0,0,1,0,1
17249,30,6589,447;10100;13310,9125,1,0,2,0,3
17250,30,6590,10127;10467;12825,9125,1,0,2,0,3
17251,30,6591,10174;10967;12956;13385,9125,2,0,2,0,4
17252,30,6592,10186;10485;13356,9125,1,0,2,0,3
17253,30,6593,10005;10194;13164,9125,1,0,2,0,3
17254,30,6594,10202;13222,9125,1,0,1,0,2
17255,30,6595,839;10207;13324,9125,1,0,2,0,3
17256,30,6596,10229;10539,9125,0,0,2,0,2
17257,30,6597,10146;10396;12788,9125,1,0,2,0,3
17258,30,6598,10481;12739,9125,1,0,1,0,2
17259,30,6599,10268;10368;13292,9125,1,0,2,0,3
17260,30,6600,10409;10558;13234,9125,1,0,2,0,3
17261,30,6601,10435;10628,9125,0,0,2,0,2
17262,30,6602,10440;10947;13179,9125,1,0,2,0,3
17263,30,6603,10447;10639;13077,9125,1,0,2,0,3
17264,30,6604,10540;10636,9125,0,0,2,0,2
17265,30,6605,10466;10650;13168,9125,1,0,2,0,3
17266,30,6606,10497;10605,9125,0,0,2,0,2
17267,30,6607,10988;12955,9125,1,0,1,0,2
17268,30,6608,10522;10739;12811,9125,1,0,2,0,3
17269,30,6609,10418;10536;12787,9125,1,0,2,0,3
17270,30,6610,10553,9125,0,0,1,0,1
17271,30,6611,10587;10866;12776,9125,1,0,2,0,3
17272,30,6612,10596;10627;12803;13061,9125,2,0,2,0,4
17273,30,6613,10469;10601,9125,0,0,2,0,2
17274,30,6614,10610;10684;13238,9125,1,0,2,0,3
17275,30,6615,10612;10955;12896,9125,1,0,2,0,3
17276,30,6616,10613;10623;13360,9125,1,0,2,0,3
17277,30,6617,10624;10763;12971,9125,1,0,2,0,3
17278,30,6618,10280;10625;12841;13266,9125,2,0,2,0,4
17279,30,6619,10646,9125,0,0,1,0,1
17280,30,6620,10657;12867,9125,1,0,1,0,2
17281,30,6621,10495;10675;13161,9125,1,0,2,0,3
17282,30,6622,10677,9125,0,0,1,0,1
17283,30,6623,10626;10679,9125,0,0,2,0,2
17284,30,6624,10692;10873,9125,0,0,2,0,2
17285,30,6625,10695;10716;13284,9125,1,0,2,0,3
17286,30,6626,13,9490,0,0,1,0,1
17287,30,6627,26,9490,0,0,0,1,1
17288,30,6629,723,9490,0,0,0,1,1
17289,30,6630,909,9490,0,0,1,0,1
17290,30,6631,6587;7496,9490,0,0,2,0,2
17291,30,6632,1572,9490,0,0,1,0,1
17292,30,6633,1631,9490,0,0,0,1,1
17293,30,6635,307,9490,0,0,1,0,1
17294,30,6636,1952,9490,0,0,1,0,1
17295,30,6637,1689;8129,9490,0,0,2,0,2
17296,30,6638,2472,9490,0,0,0,1,1
17297,30,6639,877,9490,0,0,1,0,1
17298,30,6640,4011,9490,0,0,1,0,1
17299,30,6643,3639,9490,0,0,1,0,1
17300,30,6644,8922,9490,0,0,1,0,1
17301,30,6646,3713;8150;13176,9490,1,0,2,0,3
17302,30,6647,3716,9490,0,0,1,0,1
17303,30,6648,1166,9490,0,0,1,0,1
17304,30,6652,4815,9490,0,0,1,0,1
17305,30,6653,4589,9490,0,0,1,0,1
17306,30,6655,5231,9490,0,0,1,0,1
17307,30,6656,5479,9490,0,0,1,0,1
17308,30,6657,2953;9204,9490,0,0,2,0,2
17309,30,6658,9414,9490,0,0,1,0,1
17310,30,6659,6659,9490,0,0,1,0,1
17311,30,6660,6660;8408;12864;13135,9490,2,0,2,0,4
17312,30,6661,6801,9490,0,0,1,0,1
17313,30,6664,1021,9490,0,0,1,0,1
17314,30,6665,7396,9490,0,0,1,0,1
17315,30,6666,8187,9490,0,0,1,0,1
17316,30,6667,7485,9490,0,0,1,0,1
17317,30,6668,7561,9490,0,0,1,0,1
17318,30,6669,7720,9490,0,0,1,0,1
17319,30,6670,2840,9490,0,0,1,0,1
17320,30,6671,9826,9490,0,0,1,0,1
17321,30,6672,8612,9490,0,0,1,0,1
17322,30,6673,6469;8697;13138,9490,1,0,2,0,3
17323,30,6675,247,9490,0,0,1,0,1
17324,30,6677,9117,9490,0,0,1,0,1
17325,30,6680,9113,9490,0,0,1,0,1
17326,30,6682,10009,9490,0,0,1,0,1
17327,30,6683,10015,9490,0,0,1,0,1
17328,30,6684,10022;10457;13011;13283,9490,2,0,2,0,4
17329,30,6685,10036,9490,0,0,1,0,1
17330,30,6686,10143;10489;13365,9490,1,0,2,0,3
17331,30,6687,10161;10510;12926;13045;13249,9490,3,0,2,0,5
17332,30,6688,10162;10508,9490,0,0,2,0,2
17333,30,6689,10171;10615,9490,0,0,2,0,2
17334,30,6690,10190;10267,9490,0,0,2,0,2
17335,30,6691,10285;10376;13391,9490,1,0,2,0,3
17336,30,6692,10297,9490,0,0,1,0,1
17337,30,6693,10039;10340;13031,9490,1,0,2,0,3
17338,30,6694,7530;10192;13134,9490,1,0,2,0,3
17339,30,6695,10443;10515,9490,0,0,2,0,2
17340,30,6696,10445;10477;13260,9490,1,0,2,0,3
17341,30,6697,1051;9098,9490,0,0,2,0,2
17342,30,6698,10459;10504;13270,9490,1,0,2,0,3
17343,30,6699,10474;10881;13204,9490,1,0,2,0,3
17344,30,6700,10492;10573;12912,9490,1,0,2,0,3
17345,30,6701,10493;10792,9490,0,0,2,0,2
17346,30,6702,10273;10503;13254,9490,1,0,2,0,3
17347,30,6703,10468;10546,9490,0,0,2,0,2
17348,30,6704,10555;10645;13070;13183,9490,2,0,2,0,4
17349,30,6705,10560;10564,9490,0,0,2,0,2
17350,30,6706,10576;10799;13149,9490,1,0,2,0,3
17351,30,6707,10577;13265,9490,1,0,1,0,2
17352,30,6708,10199;10585;13065;13245,9490,2,0,2,0,4
17353,30,6709,10580;10592,9490,0,0,2,0,2
17354,30,6710,10528;10604,9490,0,0,2,0,2
17355,30,6711,10419;10609;13382,9490,1,0,2,0,3
17356,30,6712,10611;10885,9490,0,0,2,0,2
17357,30,6713,10259;10616,9490,0,0,2,0,2
17358,30,6714,10632;10687;13056,9490,1,0,2,0,3
17359,30,6715,10640;10769;12940;13396,9490,2,0,2,0,4
17360,30,6716,10483;10827,9490,0,0,2,0,2
17361,30,6717,10173;10670;13160,9490,1,0,2,0,3
17362,30,6718,10676;10731;12970,9490,1,0,2,0,3
17363,30,6719,10681;10825;12887;13367,9490,2,0,2,0,4
17364,30,6720,10700;13354,9490,1,0,1,0,2
17365,30,6721,10713;11010;13165,9490,1,0,2,0,3
17366,30,6722,10720;11053;13159,9490,1,0,2,0,3
17367,30,6723,10733;10977;12963,9490,1,0,2,0,3
17368,30,6724,10755;10878;12872;13291,9490,2,0,2,0,4
17369,30,6725,10791;10821;12991;13244,9490,2,0,2,0,4
17370,30,6727,458,9855,0,0,1,0,1
17371,30,6728,5731,9855,0,0,1,0,1
17372,30,6729,879;3198,9855,0,0,2,0,2
17373,30,6730,4189,9855,0,0,1,0,1
17374,30,6731,5967;8417,9855,0,0,2,0,2
17375,30,6732,1981,9855,0,0,1,0,1
17376,30,6733,5659,9855,0,0,1,0,1
17377,30,6735,9227,9855,0,0,1,0,1
17378,30,6736,8382;9238,9855,0,0,2,0,2
17379,30,6738,2621,9855,0,0,1,0,1
17380,30,6739,3087,9855,0,0,1,0,1
17381,30,6740,3122;8949,9855,0,0,2,0,2
17382,30,6742,3339,9855,0,0,1,0,1
17383,30,6743,6347;6537,9855,0,0,2,0,2
17384,30,6744,3561;10079,9855,0,0,2,0,2
17385,30,6747,4039,9855,0,0,1,0,1
17386,30,6749,4448;9364;13375,9855,1,0,2,0,3
17387,30,6750,3842;4470,9855,0,0,2,0,2
17388,30,6752,7785,9855,0,0,1,0,1
17389,30,6754,4956,9855,0,0,1,0,1
17390,30,6755,2265;5002,9855,0,0,2,0,2
17391,30,6756,684;9103,9855,0,0,2,0,2
17392,30,6757,5187;10048,9855,0,0,2,0,2
17393,30,6758,5981,9855,0,0,1,0,1
17394,30,6761,7714,9855,0,0,1,0,1
17395,30,6764,7490,9855,0,0,1,0,1
17396,30,6765,5864;7893,9855,0,0,2,0,2
17397,30,6766,8567,9855,0,0,1,0,1
17398,30,6767,8763,9855,0,0,1,0,1
17399,30,6768,1375,9855,0,0,1,0,1
17400,30,6769,9281,9855,0,0,1,0,1
17401,30,6772,2273;9985,9855,0,0,2,0,2
17402,30,6773,10029;10082;13348,9855,1,0,2,0,3
17403,30,6774,10206,9855,0,0,1,0,1
17404,30,6775,10239;10324;13280,9855,1,0,2,0,3
17405,30,6776,10230;10264,9855,0,0,2,0,2
17406,30,6777,10266;10315;13051;13350,9855,2,0,2,0,4
17407,30,6778,10294;10548;13318,9855,1,0,2,0,3
17408,30,6779,6443;10304;13320,9855,1,0,2,0,3
17409,30,6780,10341;10532;13228,9855,1,0,2,0,3
17410,30,6781,10091;10362;13277,9855,1,0,2,0,3
17411,30,6782,10090;10365;13293,9855,1,0,2,0,3
17412,30,6783,10037;10366,9855,0,0,2,0,2
17413,30,6784,10352;10369;13397,9855,1,0,2,0,3
17414,30,6785,10358;10402,9855,0,0,2,0,2
17415,30,6786,10288;10464;13343,9855,1,0,2,0,3
17416,30,6787,10072;10506;13174,9855,1,0,2,0,3
17417,30,6788,10527;10702;13229,9855,1,0,2,0,3
17418,30,6789,10533;10853,9855,0,0,2,0,2
17419,30,6790,10542;10909;13095,9855,1,0,2,0,3
17420,30,6791,10145;10545;13345,9855,1,0,2,0,3
17421,30,6792,10554;10588;13152,9855,1,0,2,0,3
17422,30,6793,10871;13039,9855,1,0,1,0,2
17423,30,6794,10278;10584,9855,0,0,2,0,2
17424,30,6795,10355,9855,0,0,1,0,1
17425,30,6796,10620;10975;13060;13371,9855,2,0,2,0,4
17426,30,6797,10630;10701,9855,0,0,2,0,2
17427,30,6798,10393;10631;13029,9855,1,0,2,0,3
17428,30,6799,10648;10892;13278,9855,1,0,2,0,3
17429,30,6800,10654;10758;13235,9855,1,0,2,0,3
17430,30,6801,10603;10669;13087,9855,1,0,2,0,3
17431,30,6802,10703;13041,9855,1,0,1,0,2
17432,30,6803,10551;10705;13241,9855,1,0,2,0,3
17433,30,6804,10729;11185;13369,9855,1,0,2,0,3
17434,30,6805,10747;11004;13023,9855,1,0,2,0,3
17435,30,6806,10734;10779,9855,0,0,2,0,2
17436,30,6807,10785;10813,9855,0,0,2,0,2
17437,30,6808,10499;10795;13243,9855,1,0,2,0,3
17438,30,6809,10442;10812;13322,9855,1,0,2,0,3
17439,30,6810,10816;11110;13014;13386,9855,2,0,2,0,4
17440,30,6811,10836;11025;13002,9855,1,0,2,0,3
17441,30,6812,10649;10847;13086,9855,1,0,2,0,3
17442,30,6813,10525;10879;13185,9855,1,0,2,0,3
17443,30,6814,10899;10970;13200,9855,1,0,2,0,3
17444,30,6815,10903;11197;13359,9855,1,0,2,0,3
17445,30,6816,84,10220,0,0,1,0,1
17446,30,6817,232,10220,0,0,1,0,1
17447,30,6820,8643,10220,0,0,1,0,1
17448,30,6821,718,10220,0,0,1,0,1
17449,30,6822,5432,10220,0,0,1,0,1
17450,30,6823,3289;4475,10220,0,0,2,0,2
17451,30,6824,1892,10220,0,0,0,1,1
17452,30,6826,5257,10220,0,0,1,0,1
17453,30,6827,2464,10220,0,0,1,0,1
17454,30,6828,2625,10220,0,0,1,0,1
17455,30,6829,162,10220,0,0,1,0,1
17456,30,6832,4505,10220,0,0,1,0,1
17457,30,6833,3262;4525,10220,0,0,2,0,2
17458,30,6834,6107,10220,0,0,1,0,1
17459,30,6835,5969,10220,0,0,1,0,1
17460,30,6836,3963,10220,0,0,1,0,1
17461,30,6838,2878,10220,0,0,1,0,1
17462,30,6839,414;9378,10220,0,0,2,0,2
17463,30,6840,6002;10286;13349,10220,1,0,2,0,3
17464,30,6841,6212;6702,10220,0,0,2,0,2
17465,30,6842,2360;5128;13342,10220,1,0,2,0,3
17466,30,6843,6348,10220,0,0,1,0,1
17467,30,6844,6782,10220,0,0,1,0,1
17468,30,6846,7295,10220,0,0,1,0,1
17469,30,6847,7781,10220,0,0,1,0,1
17470,30,6848,8120,10220,0,0,1,0,1
17471,30,6849,4542,10220,0,0,1,0,1
17472,30,6850,7101,10220,0,0,1,0,1
17473,30,6851,2497,10220,0,0,1,0,1
17474,30,6855,5703,10220,0,0,1,0,1
17475,30,6859,1471,10220,0,0,1,0,1
17476,30,6860,10014;10282;13323,10220,1,0,2,0,3
17477,30,6861,10017;10572;13253,10220,1,0,2,0,3
17478,30,6862,865,10220,0,0,1,0,1
17479,30,6863,10136;10289,10220,0,0,2,0,2
17480,30,6864,4471,10220,0,0,1,0,1
17481,30,6865,10130;10385;13341,10220,1,0,2,0,3
17482,30,6866,10215,10220,0,0,1,0,1
17483,30,6867,10062;10222,10220,0,0,2,0,2
17484,30,6869,10326;10375;13197,10220,1,0,2,0,3
17485,30,6870,10470,10220,0,0,1,0,1
17486,30,6871,10505;10784,10220,0,0,2,0,2
17487,30,6872,10569,10220,0,0,1,0,1
17488,30,6873,10664;10685;13212,10220,1,0,2,0,3
17489,30,6874,10244,10220,0,0,1,0,1
17490,30,6875,10460;10688;13308,10220,1,0,2,0,3
17491,30,6876,10544;10694,10220,0,0,2,0,2
17492,30,6877,10798;11243;13154,10220,1,0,2,0,3
17493,30,6878,10198;10800,10220,0,0,2,0,2
17494,30,6879,10840;10934;13297,10220,1,0,2,0,3
17495,30,6880,10723;10888;13150,10220,1,0,2,0,3
17496,30,6881,10898;10907,10220,0,0,2,0,2
17497,30,6882,10932;11086,10220,0,0,2,0,2
17498,30,6883,10948;11131;13315,10220,1,0,2,0,3
17499,30,6884,10956;11152;13279,10220,1,0,2,0,3
17500,30,6885,10961;11195,10220,0,0,2,0,2
17501,30,6886,10965;11088;13223,10220,1,0,2,0,3
17502,30,6887,10896;10984;13272,10220,1,0,2,0,3
17503,30,6888,10771;10995,10220,0,0,2,0,2
17504,30,6889,10996;11137,10220,0,0,2,0,2
17505,30,6890,11000;11144,10220,0,0,2,0,2
17506,30,6891,1141,10585,0,0,1,0,1
17507,30,6892,387,10585,0,0,1,0,1
17508,30,6895,804;10026,10585,0,0,2,0,2
17509,30,6896,806,10585,0,0,1,0,1
17510,30,6897,3798;6823,10585,0,0,2,0,2
17511,30,6898,1485,10585,0,0,1,0,1
17512,30,6899,1803,10585,0,0,1,0,1
17513,30,6900,2108;10133;13317,10585,1,0,2,0,3
17514,30,6901,2147,10585,0,0,1,0,1
17515,30,6902,2159,10585,0,0,1,0,1
17516,30,6905,240,10585,0,0,1,0,1
17517,30,6906,706,10585,0,0,1,0,1
17518,30,6907,6970,10585,0,0,1,0,1
17519,30,6908,4279,10585,0,0,1,0,1
17520,30,6909,357;1906,10585,0,0,2,0,2
17521,30,6910,4124;4871,10585,0,0,2,0,2
17522,30,6911,2389;5174,10585,0,0,2,0,2
17523,30,6912,5248,10585,0,0,1,0,1
17524,30,6913,1719;5365,10585,0,0,2,0,2
17525,30,6915,711;7191,10585,0,0,2,0,2
17526,30,6916,9086,10585,0,0,1,0,1
17527,30,6918,7682,10585,0,0,1,0,1
17528,30,6920,9735,10585,0,0,1,0,1
17529,30,6921,9797,10585,0,0,1,0,1
17530,30,6922,10008;10247;13376,10585,1,0,2,0,3
17531,30,6924,10249,10585,0,0,1,0,1
17532,30,6925,2950,10585,0,0,1,0,1
17533,30,6926,10389,10585,0,0,1,0,1
17534,30,6927,10452;10782;13319,10585,1,0,2,0,3
17535,30,6928,10185;10405,10585,0,0,2,0,2
17536,30,6929,10417,10585,0,0,1,0,1
17537,30,6930,10507,10585,0,0,1,0,1
17538,30,6931,10462;10531;13332,10585,1,0,2,0,3
17539,30,6932,10567;10637,10585,0,0,2,0,2
17540,30,6933,10665;10859;13304,10585,1,0,2,0,3
17541,30,6934,10004,10585,0,0,1,0,1
17542,30,6935,10709;10759,10585,0,0,2,0,2
17543,30,6936,10811,10585,0,0,1,0,1
17544,30,6937,10641;10822,10585,0,0,2,0,2
17545,30,6938,10832;11060,10585,0,0,2,0,2
17546,30,6939,10487;10833;13300,10585,1,0,2,0,3
17547,30,6940,10451;10841,10585,0,0,2,0,2
17548,30,6941,10843;10857,10585,0,0,2,0,2
17549,30,6942,10220,10585,0,0,1,0,1
17550,30,6943,10864;10921,10585,0,0,2,0,2
17551,30,6944,10426;10867,10585,0,0,2,0,2
17552,30,6945,10887;13381,10585,1,0,1,0,2
17553,30,6946,10849;10891,10585,0,0,2,0,2
17554,30,6947,10912;11344,10585,0,0,2,0,2
17555,30,6948,10926,10585,0,0,1,0,1
17556,30,6949,11132,10585,0,0,1,0,1
17557,30,6950,10945;11147,10585,0,0,2,0,2
17558,30,6951,11018,10585,0,0,1,0,1
17559,30,6952,10714;11045,10585,0,0,2,0,2
17560,30,6953,11047;11274,10585,0,0,2,0,2
17561,30,6954,11054,10585,0,0,1,0,1
17562,30,6955,11069,10585,0,0,1,0,1
17563,30,6956,11051;11080,10585,0,0,2,0,2
17564,30,6957,11095;11343,10585,0,0,2,0,2
17565,30,6958,64,10950,0,0,1,0,1
17566,30,6959,134,10950,0,0,1,0,1
17567,30,6960,368,10950,0,0,1,0,1
17568,30,6961,489,10950,0,0,1,0,1
17569,30,6962,988;10010;13316,10950,1,0,2,0,3
17570,30,6963,1191,10950,0,0,1,0,1
17571,30,6964,1634,10950,0,0,1,0,1
17572,30,6965,1663,10950,0,0,1,0,1
17573,30,6966,4851,10950,0,0,1,0,1
17574,30,6967,2356,10950,0,0,1,0,1
17575,30,6968,2422,10950,0,0,1,0,1
17576,30,6969,2455,10950,0,0,1,0,1
17577,30,6970,2543,10950,0,0,1,0,1
17578,30,6971,2594,10950,0,0,1,0,1
17579,30,6972,1923;4377,10950,0,0,2,0,2
17580,30,6973,6567,10950,0,0,1,0,1
17581,30,6974,3977,10950,0,0,1,0,1
17582,30,6975,8824,10950,0,0,1,0,1
17583,30,6976,2774,10950,0,0,1,0,1
17584,30,6977,3438,10950,0,0,1,0,1
17585,30,6978,3450,10950,0,0,1,0,1
17586,30,6979,137,10950,0,0,1,0,1
17587,30,6980,8760,10950,0,0,1,0,1
17588,30,6981,5301,10950,0,0,1,0,1
17589,30,6982,5460,10950,0,0,1,0,1
17590,30,6983,8987,10950,0,0,1,0,1
17591,30,6984,4291,10950,0,0,1,0,1
17592,30,6985,3517;9043,10950,0,0,2,0,2
17593,30,6986,6535,10950,0,0,1,0,1
17594,30,6987,1431,10950,0,0,1,0,1
17595,30,6988,7051,10950,0,0,1,0,1
17596,30,6989,4669,10950,0,0,1,0,1
17597,30,6990,7986,10950,0,0,1,0,1
17598,30,6991,6408,10950,0,0,1,0,1
17599,30,6992,8055,10950,0,0,1,0,1
17600,30,6993,8106,10950,0,0,1,0,1
17601,30,6994,9102,10950,0,0,1,0,1
17602,30,6995,9389,10950,0,0,1,0,1
17603,30,6996,7320,10950,0,0,1,0,1
17604,30,6997,9773,10950,0,0,1,0,1
17605,30,6998,10213,10950,0,0,1,0,1
17606,30,6999,10231;10606,10950,0,0,2,0,2
17607,30,7000,10154;10311,10950,0,0,2,0,2
17608,30,7001,10337,10950,0,0,1,0,1
17609,30,7002,136,10950,0,0,1,0,1
17610,30,7003,10378;10413,10950,0,0,2,0,2
17611,30,7004,10238,10950,0,0,1,0,1
17612,30,7005,10394;10557,10950,0,0,2,0,2
17613,30,7006,10550,10950,0,0,1,0,1
17614,30,7007,10578,10950,0,0,1,0,1
17615,30,7008,10698,10950,0,0,1,0,1
17616,30,7009,10743;10756,10950,0,0,2,0,2
17617,30,7010,10744;11037,10950,0,0,2,0,2
17618,30,7011,10761,10950,0,0,1,0,1
17619,30,7012,10764;10805,10950,0,0,2,0,2
17620,30,7013,10765;10924,10950,0,0,2,0,2
17621,30,7014,10570;10793,10950,0,0,2,0,2
17622,30,7015,10642;10796,10950,0,0,2,0,2
17623,30,7016,10802;11268,10950,0,0,2,0,2
17624,30,7017,10693;10808,10950,0,0,2,0,2
17625,30,7018,10817;10987,10950,0,0,2,0,2
17626,30,7019,10845;11168,10950,0,0,2,0,2
17627,30,7020,10517;10883,10950,0,0,2,0,2
17628,30,7021,10950;11093,10950,0,0,2,0,2
17629,30,7022,10953;11296,10950,0,0,2,0,2
17630,30,7023,10958;11077,10950,0,0,2,0,2
17631,30,7024,10972;11174,10950,0,0,2,0,2
17632,30,7025,10851;10978,10950,0,0,2,0,2
17633,30,7026,10979;11284,10950,0,0,2,0,2
17634,30,7027,10839;10981,10950,0,0,2,0,2
17635,30,7028,10989;11122,10950,0,0,2,0,2
17636,30,7029,11005;11460,10950,0,1,1,0,2
17637,30,7030,10919;11006,10950,0,0,2,0,2
17638,30,7031,11023,10950,0,0,1,0,1
17639,30,7032,11035,10950,0,0,1,0,1
17640,30,7033,11036;11048,10950,0,0,2,0,2
17641,30,7034,11041;11170,10950,0,0,2,0,2
17642,30,7035,11059;11462,10950,0,1,1,0,2
17643,30,7036,11067;11415,10950,0,1,1,0,2
17644,30,7037,11068;11326,10950,0,0,2,0,2
17645,30,7038,11096;11298,10950,0,0,2,0,2
17646,30,7039,10882;11099,10950,0,0,2,0,2
17647,30,7040,11102,10950,0,0,1,0,1
17648,30,7041,10824;11103,10950,0,0,2,0,2
17649,30,7042,11121;11281,10950,0,0,2,0,2
17650,30,7043,11126;11441,10950,0,1,1,0,2
17651,30,7044,11055;11128,10950,0,0,2,0,2
17652,30,7045,10928,10950,0,0,1,0,1
17653,30,7046,11140;11159,10950,0,0,2,0,2
17654,30,7047,10942;11145,10950,0,0,2,0,2
17655,30,7048,11154;11299,10950,0,0,2,0,2
17656,30,7049,11162;11251,10950,0,0,2,0,2
17657,30,7050,11165;11409,10950,0,1,1,0,2
17658,30,7051,11187;11339,10950,0,0,2,0,2
17659,30,7052,11188;11261,10950,0,0,2,0,2
17660,40,1,4;7390;11962,0,0,0,3,0,3
17661,40,2,272;1571;12482;12857,0,0,1,3,0,4
17662,40,3,14,0,0,0,0,1,1
17663,40,4,4337;7947;11703;13509,0,0,1,3,0,4
17664,40,8,25,0,0,0,0,1,1
17665,40,9,27;28,0,0,0,0,2,2
17666,40,13,39,0,0,0,0,1,1
17667,40,14,41,0,0,0,0,1,1
17668,40,15,46,0,0,0,0,1,1
17669,40,16,51;916,0,0,0,0,2,2
17670,40,17,53;57,0,0,0,1,1,2
17671,40,18,58;4607,0,0,0,0,2,2
17672,40,19,61;6642;13124;13296,0,0,2,2,0,4
17673,40,20,62;63;11812,0,0,0,2,1,3
17674,40,22,70;6007,0,0,0,0,2,2
17675,40,25,9436;11937,0,0,0,2,0,2
17676,40,27,85,0,0,0,0,1,1
17677,40,29,92,0,0,0,0,1,1
17678,40,30,95;1306,0,0,0,0,2,2
17679,40,33,99;100,0,0,0,0,2,2
17680,40,36,109,0,0,0,0,1,1
17681,40,37,3825,0,0,0,0,1,1
17682,40,38,117;11319;12316,0,0,0,3,0,3
17683,40,40,124,0,0,0,0,1,1
17684,40,43,131,0,0,0,0,1,1
17685,40,44,133,0,0,0,0,1,1
17686,40,47,140,0,0,0,0,1,1
17687,40,48,2463,0,0,0,0,1,1
17688,40,53,154;9550;10307,0,0,0,1,2,3
17689,40,54,3840;10092;13836;13976,0,0,2,2,0,4
17690,40,55,3627,0,0,0,0,1,1
17691,40,56,164;576;11098,0,0,0,2,1,3
17692,40,57,166,0,0,0,0,1,1
17693,40,60,173,0,0,0,0,1,1
17694,40,61,180;8253;11686;12159,0,0,0,4,0,4
17695,40,63,189;1979;11626,0,0,0,3,0,3
17696,40,65,193;194,0,0,0,1,1,2
17697,40,66,195;9410,0,0,0,1,1,2
17698,40,67,3755,0,0,0,0,1,1
17699,40,69,207,0,0,0,0,1,1
17700,40,71,209;2759,0,0,0,1,1,2
17701,40,73,214,0,0,0,0,1,1
17702,40,74,221;3903,0,0,0,0,2,2
17703,40,77,226;227,0,0,0,0,2,2
17704,40,79,234,0,0,0,0,1,1
17705,40,80,238,0,0,0,0,1,1
17706,40,82,243;244,0,0,0,0,2,2
17707,40,89,816,0,0,0,0,1,1
17708,40,90,261,0,0,0,0,1,1
17709,40,93,268,0,0,0,1,0,1
17710,40,94,269,0,0,0,0,1,1
17711,40,102,288,0,0,0,0,1,1
17712,40,104,295,0,0,0,0,1,1
17713,40,105,5510,0,0,0,0,1,1
17714,40,107,3705,0,0,0,0,1,1
17715,40,109,304,0,0,0,0,1,1
17716,40,112,1039,0,0,0,0,1,1
17717,40,113,322,0,0,0,0,1,1
17718,40,118,332;2314,0,0,0,0,2,2
17719,40,124,344,0,0,0,0,1,1
17720,40,127,352;2748;11002,0,0,0,2,1,3
17721,40,128,354,0,0,0,0,1,1
17722,40,129,358;359,0,0,0,0,2,2
17723,40,130,362,0,0,0,0,1,1
17724,40,132,366;3661,0,0,0,0,2,2
17725,40,137,2331,0,0,0,0,1,1
17726,40,138,382;8031,0,0,0,0,2,2
17727,40,139,384;385,0,0,0,0,2,2
17728,40,140,5755;8879;11066,0,0,0,1,2,3
17729,40,142,4408,0,0,0,0,1,1
17730,40,144,396;8055;11556,0,0,0,3,0,3
17731,40,145,398,0,0,0,0,1,1
17732,40,147,401;1424,0,0,0,2,0,2
17733,40,151,406;411,0,0,0,0,2,2
17734,40,156,418,0,0,0,0,1,1
17735,40,158,426,0,0,0,0,1,1
17736,40,159,427;428,0,0,0,0,2,2
17737,40,162,435;11853,0,0,0,1,1,2
17738,40,163,438,0,0,0,0,1,1
17739,40,164,441,0,0,0,0,1,1
17740,40,165,446,0,0,0,0,1,1
17741,40,166,7557,0,0,0,0,1,1
17742,40,168,453;454,0,0,0,0,2,2
17743,40,171,464,0,0,0,0,1,1
17744,40,173,3238;11986;12648,0,0,1,2,0,3
17745,40,174,472,0,0,0,0,1,1
17746,40,178,487;756;1287;2099;2555;12414,0,0,0,3,3,6
17747,40,179,491;492;11502,0,0,0,2,1,3
17748,40,181,496,0,0,0,0,1,1
17749,40,183,500;6198,0,0,0,1,1,2
17750,40,184,502,0,0,0,0,1,1
17751,40,185,505;9616,0,0,0,2,0,2
17752,40,188,510,0,0,0,0,1,1
17753,40,191,7559,0,0,0,0,1,1
17754,40,194,531;9288,0,0,0,0,2,2
17755,40,195,532;1463,0,0,0,0,2,2
17756,40,197,3912;7514,0,0,0,0,2,2
17757,40,198,539,0,0,0,0,1,1
17758,40,199,541;6315,0,0,0,0,2,2
17759,40,207,565;568;6413;9356;11871;12545,0,0,1,5,0,6
17760,40,208,7268,0,0,0,0,1,1
17761,40,216,581;582,0,0,0,0,2,2
17762,40,220,596,0,0,0,0,1,1
17763,40,223,602,0,0,0,0,1,1
17764,40,224,605,0,0,0,0,1,1
17765,40,227,610,0,0,0,0,1,1
17766,40,228,614,0,0,0,0,1,1
17767,40,230,620;4407,0,0,0,0,2,2
17768,40,231,622;12570,0,0,1,1,0,2
17769,40,233,624,0,0,0,0,1,1
17770,40,235,629;10774,0,0,0,2,0,2
17771,40,236,634,0,0,0,0,1,1
17772,40,240,644;11072,0,0,0,2,0,2
17773,40,245,656,0,0,0,0,1,1
17774,40,246,9833,0,0,0,0,1,1
17775,40,247,660,0,0,0,0,1,1
17776,40,251,5509,0,0,0,0,1,1
17777,40,253,671,0,0,0,0,1,1
17778,40,254,676,0,0,0,0,1,1
17779,40,257,687,0,0,0,0,1,1
17780,40,258,689;9242,0,0,0,1,1,2
17781,40,262,694,0,0,0,0,1,1
17782,40,269,710,0,0,0,0,1,1
17783,40,271,666;715,0,0,0,0,2,2
17784,40,274,722;1809,0,0,0,0,2,2
17785,40,276,729,0,0,0,0,1,1
17786,40,280,740;10169;12998,0,0,1,2,0,3
17787,40,281,741;742,0,0,0,0,2,2
17788,40,284,747,0,0,0,0,1,1
17789,40,286,750,0,0,0,0,1,1
17790,40,289,757;758,0,0,0,1,1,2
17791,40,291,4861;4889,0,0,0,2,0,2
17792,40,295,766;767,0,0,0,0,2,2
17793,40,298,775,0,0,0,0,1,1
17794,40,300,782,0,0,0,0,1,1
17795,40,303,789;8361,0,0,0,0,2,2
17796,40,304,794;795;3699;4487;4649;8124;12157;12189;12229,0,0,0,9,0,9
17797,40,305,796,0,0,0,0,1,1
17798,40,306,800;1945,0,0,0,0,2,2
17799,40,308,807,0,0,0,0,1,1
17800,40,310,812,0,0,0,0,1,1
17801,40,313,818;5690,0,0,0,0,2,2
17802,40,314,820;1679,0,0,0,0,2,2
17803,40,324,847;2441,0,0,0,2,0,2
17804,40,327,854,0,0,0,0,1,1
17805,40,329,858;5094,0,0,0,0,2,2
17806,40,330,7454,0,0,0,0,1,1
17807,40,332,868;869,0,0,0,1,1,2
17808,40,334,876,0,0,0,0,1,1
17809,40,335,9878,0,0,0,1,0,1
17810,40,336,881;882,0,0,0,0,2,2
17811,40,340,894;2674,0,0,0,0,2,2
17812,40,344,906,0,0,0,0,1,1
17813,40,348,914;7109,0,0,0,0,2,2
17814,40,352,924;925,0,0,0,0,2,2
17815,40,353,928,0,0,0,0,1,1
17816,40,354,930;8984;11052;12252,0,0,0,4,0,4
17817,40,356,937,0,0,0,0,1,1
17818,40,358,942,0,0,0,0,1,1
17819,40,361,948;4291,0,0,0,1,1,2
17820,40,362,955,0,0,0,0,1,1
17821,40,364,30,0,0,0,0,1,1
17822,40,365,965,0,0,0,0,1,1
17823,40,371,8104,0,0,0,0,1,1
17824,40,376,1000,0,0,0,1,0,1
17825,40,378,1005,0,0,0,0,1,1
17826,40,387,1025;3391,0,0,0,0,2,2
17827,40,388,1029,0,0,0,0,1,1
17828,40,393,1044;10260;13558;14140;14552,0,2,1,2,0,5
17829,40,394,1046;9576,0,0,0,0,2,2
17830,40,395,1048,0,0,0,0,1,1
17831,40,398,1058;3444,0,0,0,0,2,2
17832,40,400,8480,0,0,0,0,1,1
17833,40,403,1069;7299,0,0,0,0,2,2
17834,40,406,1077,0,0,0,0,1,1
17835,40,409,1081,0,0,0,0,1,1
17836,40,410,1082,0,0,0,0,1,1
17837,40,411,1083;9414,0,0,0,1,1,2
17838,40,414,1089,0,0,0,0,1,1
17839,40,415,1090,0,0,0,0,1,1
17840,40,416,1094,0,0,0,0,1,1
17841,40,418,1102;8188,0,0,0,0,2,2
17842,40,420,1106;1107;1181,0,0,0,3,0,3
17843,40,422,1110,0,0,0,0,1,1
17844,40,423,1112,0,0,0,0,1,1
17845,40,428,1124,0,0,0,0,1,1
17846,40,430,1129;1130,0,0,0,0,2,2
17847,40,433,5341,0,0,0,0,1,1
17848,40,434,9613,0,0,0,0,1,1
17849,40,435,5845,0,0,0,0,1,1
17850,40,436,1146,0,0,0,0,1,1
17851,40,437,902;5742;12920,0,0,1,2,0,3
17852,40,445,1176,0,0,0,0,1,1
17853,40,447,4088;9511;11133,0,0,0,2,1,3
17854,40,449,8981,0,0,0,0,1,1
17855,40,451,1185,0,0,0,0,1,1
17856,40,453,1190,0,0,0,0,1,1
17857,40,455,1196,0,0,0,0,1,1
17858,40,456,1198;7714,0,0,0,1,1,2
17859,40,457,1201,0,0,0,0,1,1
17860,40,461,1211,0,0,0,0,1,1
17861,40,463,6474,0,0,0,0,1,1
17862,40,464,1220;1221,0,0,0,0,2,2
17863,40,465,1222,0,0,0,0,1,1
17864,40,466,1223,0,0,0,0,1,1
17865,40,468,3993,0,0,0,0,1,1
17866,40,472,1241,0,0,0,0,1,1
17867,40,478,421;1260;12559;13203;13514,0,0,3,2,0,5
17868,40,480,1266;13666,0,0,1,1,0,2
17869,40,483,1275;1276,0,0,0,0,2,2
17870,40,484,1277;1278,0,0,0,0,2,2
17871,40,487,321;1283,0,0,0,1,1,2
17872,40,488,7429,0,0,0,1,0,1
17873,40,493,1303,0,0,0,0,1,1
17874,40,497,1315;1316,0,0,0,0,2,2
17875,40,498,1320,0,0,0,0,1,1
17876,40,500,1323;1324,0,0,0,0,2,2
17877,40,502,1327;3565,0,0,0,0,2,2
17878,40,503,1329;3441,0,0,0,0,2,2
17879,40,504,1330;4117,0,0,0,0,2,2
17880,40,507,1338,0,0,0,0,1,1
17881,40,513,1359;8111;13009,0,0,1,2,0,3
17882,40,514,6266,0,0,0,0,1,1
17883,40,515,1365;3043,0,0,0,0,2,2
17884,40,518,1373;10120,0,0,0,1,1,2
17885,40,519,4925;8864,0,0,0,2,0,2
17886,40,522,1382;8854,0,0,0,2,0,2
17887,40,528,1393,0,0,0,0,1,1
17888,40,531,1400;1401,0,0,0,0,2,2
17889,40,534,1405;6807,0,0,0,0,2,2
17890,40,535,1408,0,0,0,0,1,1
17891,40,542,6846,0,0,0,1,0,1
17892,40,543,1433,0,0,0,0,1,1
17893,40,545,1435;1436,0,0,0,0,2,2
17894,40,546,1438,0,0,0,0,1,1
17895,40,550,1444;9792,0,0,0,0,2,2
17896,40,552,1452,0,0,0,1,0,1
17897,40,553,4314;12070,0,0,0,2,0,2
17898,40,555,1456;4134,0,0,0,0,2,2
17899,40,556,1459;1460;11275,0,0,0,2,1,3
17900,40,558,1464,0,0,0,0,1,1
17901,40,559,1466,0,0,0,0,1,1
17902,40,560,922;1469,0,0,0,0,2,2
17903,40,562,1475;9911,0,0,0,1,1,2
17904,40,564,1482,0,0,0,0,1,1
17905,40,565,1483,0,0,0,0,1,1
17906,40,567,1491;5707,0,0,0,0,2,2
17907,40,568,1495;1496,0,0,0,0,2,2
17908,40,569,1497;5273,0,0,0,1,1,2
17909,40,571,1502;2502,0,0,0,0,2,2
17910,40,573,1506;3919;12238,0,0,0,3,0,3
17911,40,574,1509;3027;11229;11642;12575,0,0,1,4,0,5
17912,40,577,1517;6711,0,0,0,0,2,2
17913,40,578,1519,0,0,0,0,1,1
17914,40,579,1520;1521,0,0,0,0,2,2
17915,40,580,2722,0,0,0,0,1,1
17916,40,582,1529;3538;12247;12396;12606,0,0,1,4,0,5
17917,40,583,1131;1531,0,0,0,0,2,2
17918,40,584,1538;13063;13658,0,0,2,1,0,3
17919,40,585,1540,0,0,0,0,1,1
17920,40,587,1547;3263,0,0,0,0,2,2
17921,40,589,1551,0,0,0,0,1,1
17922,40,590,1553;9321;11351,0,0,0,2,1,3
17923,40,592,1558,0,0,0,1,0,1
17924,40,593,1560;7464,0,0,0,2,0,2
17925,40,594,1563,0,0,0,0,1,1
17926,40,595,1566,0,0,0,0,1,1
17927,40,600,1579,0,0,0,0,1,1
17928,40,605,1593;1594,0,0,0,0,2,2
17929,40,607,1596;4276,0,0,0,0,2,2
17930,40,608,1597;1598,0,0,0,1,1,2
17931,40,610,1604;12061;12632,0,0,1,2,0,3
17932,40,614,1618;1619;6335;9513;12136;12415;12420;13654,0,0,1,7,0,8
17933,40,615,1620;4140,0,0,0,2,0,2
17934,40,618,5857;11336,0,0,0,1,1,2
17935,40,621,1635;1636,0,0,0,0,2,2
17936,40,622,1638,0,0,0,0,1,1
17937,40,623,1642,0,0,0,0,1,1
17938,40,624,1643;11081,0,0,0,1,1,2
17939,40,625,2480;2605;6631;11738,0,0,0,4,0,4
17940,40,628,2835,0,0,0,0,1,1
17941,40,630,1661,0,0,0,0,1,1
17942,40,632,1664,0,0,0,0,1,1
17943,40,633,1671;1808;13146;13422;13643,0,0,3,2,0,5
17944,40,634,1673;5117,0,0,0,0,2,2
17945,40,637,1677,0,0,0,0,1,1
17946,40,639,1684;1685,0,0,0,0,2,2
17947,40,641,1690,0,0,0,0,1,1
17948,40,642,6683;8308,0,0,0,0,2,2
17949,40,643,1702;2093,0,0,0,2,0,2
17950,40,644,1704,0,0,0,0,1,1
17951,40,645,1708,0,0,0,0,1,1
17952,40,646,1710,0,0,0,0,1,1
17953,40,647,4347,0,0,0,0,1,1
17954,40,648,1715;8540,0,0,0,2,0,2
17955,40,649,1717;1721,0,0,0,1,1,2
17956,40,650,1723,0,0,0,0,1,1
17957,40,653,1733,0,0,0,0,1,1
17958,40,656,1742;1743,0,0,0,0,2,2
17959,40,657,1747,0,0,0,1,0,1
17960,40,658,1748;1749,0,0,0,1,1,2
17961,40,661,648;1756;12563;12983;13156,0,0,3,2,0,5
17962,40,672,1786,0,0,0,0,1,1
17963,40,673,2802;5867,0,0,0,0,2,2
17964,40,677,1795,0,0,0,0,1,1
17965,40,680,1804,0,0,0,0,1,1
17966,40,682,1810,0,0,0,0,1,1
17967,40,684,1812;9263,0,0,0,0,2,2
17968,40,692,1829;1830,0,0,0,0,2,2
17969,40,696,697,0,0,0,0,1,1
17970,40,698,1843;7783;10940,0,0,0,1,2,3
17971,40,708,1866,0,0,0,0,1,1
17972,40,709,2257;11008,0,0,0,1,1,2
17973,40,710,1869;7936,0,0,0,0,2,2
17974,40,716,1881;4064,0,0,0,2,0,2
17975,40,720,1891;8224,0,0,0,0,2,2
17976,40,721,1893,0,0,0,0,1,1
17977,40,723,5340,0,0,0,0,1,1
17978,40,727,1912,0,0,0,0,1,1
17979,40,728,1914;4775;10672,0,0,0,2,1,3
17980,40,729,1916,0,0,0,0,1,1
17981,40,730,1917;7842,0,0,0,0,2,2
17982,40,736,4838;7667,0,0,0,1,1,2
17983,40,738,4187;4283,0,0,0,2,0,2
17984,40,739,1937;4195,0,0,0,0,2,2
17985,40,747,8274,0,0,0,0,1,1
17986,40,749,1963;7142;12365;12501;12950,0,0,2,3,0,5
17987,40,750,1964;1965;10644,0,0,0,1,2,3
17988,40,751,1968,0,0,0,0,1,1
17989,40,752,1969;1970;10985,0,0,0,1,2,3
17990,40,753,4405,0,0,0,0,1,1
17991,40,754,1975;1977,0,0,0,0,2,2
17992,40,757,8327,0,0,0,0,1,1
17993,40,758,7242;8951,0,0,0,0,2,2
17994,40,759,1993;12293,0,0,0,2,0,2
17995,40,761,1996,0,0,0,0,1,1
17996,40,762,1997;2251,0,0,0,0,2,2
17997,40,768,2006,0,0,0,1,0,1
17998,40,769,2012,0,0,0,0,1,1
17999,40,770,2016,0,0,0,0,1,1
18000,40,773,2026;8792,0,0,0,0,2,2
18001,40,782,2052;9477,0,0,0,0,2,2
18002,40,784,8991,0,0,0,0,1,1
18003,40,785,8024,0,0,0,0,1,1
18004,40,787,2064,0,0,0,0,1,1
18005,40,788,2065,0,0,0,0,1,1
18006,40,791,2073;6485,0,0,0,0,2,2
18007,40,794,2080;2889,0,0,0,0,2,2
18008,40,795,6219,0,0,0,0,1,1
18009,40,796,2084,0,0,0,0,1,1
18010,40,797,1432;10103;10235;10271;10331;12428;12958;12981;13019;13169;13358;13606;13714;14239;14626,0,2,7,6,0,15
18011,40,798,2088,0,0,0,0,1,1
18012,40,799,2095,0,0,0,0,1,1
18013,40,803,2103;5953,0,0,0,0,2,2
18014,40,805,2106,0,0,0,0,1,1
18015,40,806,2110,0,0,0,0,1,1
18016,40,812,2119,0,0,0,0,1,1
18017,40,814,2124,0,0,0,0,1,1
18018,40,815,2127,0,0,0,0,1,1
18019,40,816,2128;2129,0,0,0,0,2,2
18020,40,817,2135;2138;6351,0,0,0,0,3,3
18021,40,818,2142;4743;13058;13306,0,0,2,2,0,4
18022,40,819,2143,0,0,0,0,1,1
18023,40,821,2148,0,0,0,0,1,1
18024,40,822,2149;9867;11802,0,0,0,2,1,3
18025,40,824,2152;2153,0,0,0,0,2,2
18026,40,826,2157;2158,0,0,0,0,2,2
18027,40,827,5752,0,0,0,0,1,1
18028,40,828,2162,0,0,0,0,1,1
18029,40,833,2173;6345,0,0,0,2,0,2
18030,40,841,2193,0,0,0,0,1,1
18031,40,844,2198,0,0,0,0,1,1
18032,40,847,2205,0,0,0,0,1,1
18033,40,850,2214,0,0,0,0,1,1
18034,40,852,655;2220;2225;5323,0,0,0,0,4,4
18035,40,853,2227,0,0,0,0,1,1
18036,40,857,2238;6207;11429,0,0,0,3,0,3
18037,40,858,8182,0,0,0,0,1,1
18038,40,859,2243;2247,0,0,0,1,1,2
18039,40,862,2258,0,0,0,0,1,1
18040,40,864,2263;6046,0,0,0,0,2,2
18041,40,865,2267,0,0,0,0,1,1
18042,40,868,2274,0,0,0,0,1,1
18043,40,870,2072;2284,0,0,0,0,2,2
18044,40,871,4707;9224,0,0,0,2,0,2
18045,40,873,1683;2287,0,0,0,0,2,2
18046,40,874,2293,0,0,0,0,1,1
18047,40,877,2299,0,0,0,0,1,1
18048,40,878,2303;7272,0,0,0,2,0,2
18049,40,885,375;2315,0,0,0,0,2,2
18050,40,886,1583;2320,0,0,0,2,0,2
18051,40,888,1870;2328,0,0,0,0,2,2
18052,40,892,2335,0,0,0,0,1,1
18053,40,893,2338;2339;10416;10568,0,0,0,3,1,4
18054,40,894,3425,0,0,0,0,1,1
18055,40,895,2344;2634,0,0,0,0,2,2
18056,40,896,2347,0,0,0,0,1,1
18057,40,897,1371;2350;4675;4722;11922,0,0,0,5,0,5
18058,40,901,2363,0,0,0,0,1,1
18059,40,902,2367,0,0,0,0,1,1
18060,40,904,2374,0,0,0,1,0,1
18061,40,907,1118;2379,0,0,0,0,2,2
18062,40,909,2386,0,0,0,0,1,1
18063,40,919,2415;9413,0,0,0,0,2,2
18064,40,926,7458,0,0,0,0,1,1
18065,40,930,2439,0,0,0,0,1,1
18066,40,932,2449;4793,0,0,0,2,0,2
18067,40,935,2453;2454,0,0,0,0,2,2
18068,40,937,777;2460,0,0,0,0,2,2
18069,40,938,2465,0,0,0,0,1,1
18070,40,940,2471,0,0,0,0,1,1
18071,40,941,2476,0,0,0,1,0,1
18072,40,942,2479,0,0,0,0,1,1
18073,40,946,2487,0,0,0,0,1,1
18074,40,947,2489,0,0,0,0,1,1
18075,40,950,2501,0,0,0,0,1,1
18076,40,953,2513;4920,0,0,0,0,2,2
18077,40,961,8772,0,0,0,0,1,1
18078,40,962,2538;4320;11898,0,0,0,1,2,3
18079,40,966,308;2548,0,0,0,0,2,2
18080,40,967,2216;2550,0,0,0,0,2,2
18081,40,969,2554,0,0,0,0,1,1
18082,40,970,2558;9123,0,0,0,0,2,2
18083,40,972,2564;4002,0,0,0,1,1,2
18084,40,974,2568,0,0,0,0,1,1
18085,40,977,2114;2574,0,0,0,0,2,2
18086,40,983,2588,0,0,0,0,1,1
18087,40,985,6767,0,0,0,1,0,1
18088,40,987,1367;2597,0,0,0,0,2,2
18089,40,988,2599,0,0,0,0,1,1
18090,40,989,2602;7829,0,0,0,2,0,2
18091,40,994,2613;4625;11332,0,0,0,3,0,3
18092,40,995,2614;8609;10707,0,0,0,1,2,3
18093,40,998,4410,0,0,0,0,1,1
18094,40,1001,2630,0,0,0,0,1,1
18095,40,1004,2635,0,0,0,0,1,1
18096,40,1005,623,0,0,0,0,1,1
18097,40,1007,2640,0,0,0,0,1,1
18098,40,1012,2652,0,0,0,0,1,1
18099,40,1013,2658,0,0,0,0,1,1
18100,40,1016,2662,0,0,0,0,1,1
18101,40,1018,2666;2668,0,0,0,0,2,2
18102,40,1025,2691,0,0,0,0,1,1
18103,40,1029,2699;2701;5135;12463;12682;12806;12948;13075,0,0,4,4,0,8
18104,40,1036,2711;2872,0,0,0,0,2,2
18105,40,1037,2712;6695,0,0,0,0,2,2
18106,40,1043,2727,0,0,0,0,1,1
18107,40,1048,2749;8479,0,0,0,0,2,2
18108,40,1059,2773;8322;11695;12405,0,0,0,3,1,4
18109,40,1063,7331,0,0,0,1,0,1
18110,40,1065,1532;2793,0,0,0,0,2,2
18111,40,1066,2794,0,0,0,0,1,1
18112,40,1070,2810;2811;2812;3041;7000;12124,0,0,0,6,0,6
18113,40,1071,2813;2814,0,0,0,0,2,2
18114,40,1072,2819,0,0,0,0,1,1
18115,40,1073,2821;10804,0,0,0,1,1,2
18116,40,1074,2823;5628;11541;11897;12192,0,0,0,5,0,5
18117,40,1076,2829;2830,0,0,0,0,2,2
18118,40,1077,1700;2833;13309;13920,0,0,2,2,0,4
18119,40,1079,2839,0,0,0,1,0,1
18120,40,1081,2844,0,0,0,0,1,1
18121,40,1084,2852,0,0,0,0,1,1
18122,40,1086,2856;2857,0,0,0,0,2,2
18123,40,1088,8362,0,0,0,0,1,1
18124,40,1089,2866,0,0,0,0,1,1
18125,40,1093,2054;3190,0,0,0,0,2,2
18126,40,1094,2882,0,0,0,0,1,1
18127,40,1096,264;9488;11322,0,0,0,1,2,3
18128,40,1098,2622;3436,0,0,0,2,0,2
18129,40,1101,2897;7116,0,0,0,0,2,2
18130,40,1102,2898,0,0,0,0,1,1
18131,40,1104,2903,0,0,0,0,1,1
18132,40,1105,2904;2905,0,0,0,0,2,2
18133,40,1108,8689,0,0,0,0,1,1
18134,40,1109,2911;9702,0,0,0,2,0,2
18135,40,1110,2912,0,0,0,0,1,1
18136,40,1111,2915;2916,0,0,0,0,2,2
18137,40,1113,2918;3342,0,0,0,1,1,2
18138,40,1116,2926,0,0,0,0,1,1
18139,40,1123,2941,0,0,0,0,1,1
18140,40,1124,2944;6972,0,0,0,0,2,2
18141,40,1126,2946,0,0,0,0,1,1
18142,40,1128,2956,0,0,0,0,1,1
18143,40,1129,2958,0,0,0,1,0,1
18144,40,1130,2962;6384,0,0,0,0,2,2
18145,40,1134,2973;2974,0,0,0,0,2,2
18146,40,1136,2981;2982,0,0,0,0,2,2
18147,40,1138,2987;8079,0,0,0,0,2,2
18148,40,1139,2988,0,0,0,0,1,1
18149,40,1142,1440;2994,0,0,0,0,2,2
18150,40,1146,6456,0,0,0,0,1,1
18151,40,1147,3013,0,0,0,0,1,1
18152,40,1152,3024;8719,0,0,0,1,1,2
18153,40,1153,3026,0,0,0,0,1,1
18154,40,1156,3037,0,0,0,0,1,1
18155,40,1157,3042,0,0,0,0,1,1
18156,40,1158,3047,0,0,0,0,1,1
18157,40,1165,3071,0,0,0,1,0,1
18158,40,1166,8867;9852,0,0,0,1,1,2
18159,40,1168,3076;3077;11829,0,0,0,2,1,3
18160,40,1170,3080,0,0,0,1,0,1
18161,40,1172,3084,0,0,0,0,1,1
18162,40,1180,3105;6564,0,0,0,1,1,2
18163,40,1181,3109;3110,0,0,0,0,2,2
18164,40,1185,745;6539,0,0,0,0,2,2
18165,40,1186,1946,0,0,0,0,1,1
18166,40,1189,3131;9350,0,0,0,0,2,2
18167,40,1190,3134,0,0,0,0,1,1
18168,40,1191,3138,0,0,0,0,1,1
18169,40,1193,3144,0,0,0,1,0,1
18170,40,1194,3148,0,0,0,0,1,1
18171,40,1198,4330,0,0,0,0,1,1
18172,40,1202,3169,0,0,0,0,1,1
18173,40,1203,3170,0,0,0,0,1,1
18174,40,1204,3171,0,0,0,0,1,1
18175,40,1205,102,0,0,0,0,1,1
18176,40,1208,3181,0,0,0,0,1,1
18177,40,1210,3187;6504,0,0,0,1,1,2
18178,40,1216,3205;3206,0,0,0,0,2,2
18179,40,1217,1368;3210,0,0,0,0,2,2
18180,40,1220,3220;3221;3222,0,0,0,2,1,3
18181,40,1222,3227,0,0,0,0,1,1
18182,40,1223,3229,0,0,0,0,1,1
18183,40,1225,3237;8432,0,0,0,0,2,2
18184,40,1226,3242,0,0,0,0,1,1
18185,40,1227,3244,0,0,0,0,1,1
18186,40,1229,520,0,0,0,0,1,1
18187,40,1231,3251,0,0,0,0,1,1
18188,40,1232,9435,0,0,0,0,1,1
18189,40,1233,3257;3258,0,0,0,0,2,2
18190,40,1236,7414,0,0,0,0,1,1
18191,40,1239,3270,0,0,0,0,1,1
18192,40,1241,3275;6016,0,0,0,0,2,2
18193,40,1243,3279;3280,0,0,0,0,2,2
18194,40,1244,3283,0,0,0,0,1,1
18195,40,1245,3284;3285,0,0,0,0,2,2
18196,40,1248,3292,0,0,0,0,1,1
18197,40,1250,3294,0,0,0,0,1,1
18198,40,1251,3298;4522,0,0,0,2,0,2
18199,40,1252,9157,0,0,0,0,1,1
18200,40,1254,3082;3303,0,0,0,0,2,2
18201,40,1257,3313,0,0,0,0,1,1
18202,40,1272,3344,0,0,0,0,1,1
18203,40,1273,3347,0,0,0,0,1,1
18204,40,1274,3349;3350,0,0,0,1,1,2
18205,40,1280,3369,0,0,0,0,1,1
18206,40,1285,3384;3385,0,0,0,1,1,2
18207,40,1286,3392,0,0,0,0,1,1
18208,40,1287,3396,0,0,0,1,0,1
18209,40,1290,9895,0,0,0,0,1,1
18210,40,1291,2398;3410,0,0,0,0,2,2
18211,40,1292,3411;6378;12214,0,0,0,3,0,3
18212,40,1293,887;3412,0,0,0,0,2,2
18213,40,1295,3415,0,0,0,0,1,1
18214,40,1297,3423,0,0,0,1,0,1
18215,40,1299,3427,0,0,0,0,1,1
18216,40,1306,3448,0,0,0,1,0,1
18217,40,1308,3455;6035,0,0,0,2,0,2
18218,40,1311,3462,0,0,0,0,1,1
18219,40,1315,3474;5508,0,0,0,2,0,2
18220,40,1316,3480,0,0,0,0,1,1
18221,40,1320,2326;3487,0,0,0,0,2,2
18222,40,1322,3490,0,0,0,0,1,1
18223,40,1324,3497,0,0,0,0,1,1
18224,40,1326,3501;3504,0,0,0,1,1,2
18225,40,1327,3505;8397,0,0,0,0,2,2
18226,40,1330,3622,0,0,0,0,1,1
18227,40,1331,3511;3512,0,0,0,0,2,2
18228,40,1332,497;3514;11824,0,0,0,2,1,3
18229,40,1333,3515;3516,0,0,0,0,2,2
18230,40,1334,3519,0,0,0,0,1,1
18231,40,1337,3526;5957,0,0,0,0,2,2
18232,40,1338,3529,0,0,0,0,1,1
18233,40,1339,3534,0,0,0,0,1,1
18234,40,1342,3541;10819,0,0,0,1,1,2
18235,40,1347,3554;3555,0,0,0,0,2,2
18236,40,1353,3572,0,0,0,0,1,1
18237,40,1354,3576,0,0,0,0,1,1
18238,40,1359,3592,0,0,0,1,0,1
18239,40,1362,2754;3599,0,0,0,0,2,2
18240,40,1363,3603,0,0,0,0,1,1
18241,40,1367,3611,0,0,0,1,0,1
18242,40,1370,579;3618,0,0,0,0,2,2
18243,40,1371,3619,0,0,0,1,0,1
18244,40,1373,2884;3623,0,0,0,0,2,2
18245,40,1387,3660,0,0,0,0,1,1
18246,40,1391,3668;6607,0,0,0,0,2,2
18247,40,1394,3680,0,0,0,0,1,1
18248,40,1395,3682;5103,0,0,0,0,2,2
18249,40,1397,3687,0,0,0,0,1,1
18250,40,1400,3694;8487,0,0,0,0,2,2
18251,40,1401,3697,0,0,0,0,1,1
18252,40,1403,3703;7711,0,0,0,2,0,2
18253,40,1407,3714,0,0,0,0,1,1
18254,40,1409,2822;3720,0,0,0,0,2,2
18255,40,1411,3723,0,0,0,0,1,1
18256,40,1412,3729;6501,0,0,0,0,2,2
18257,40,1414,3735;12358;12567,0,0,1,2,0,3
18258,40,1415,3737;8430,0,0,0,0,2,2
18259,40,1416,3676;9990,0,0,0,2,0,2
18260,40,1419,3745,0,0,0,0,1,1
18261,40,1420,3747,0,0,0,0,1,1
18262,40,1421,3751,0,0,0,0,1,1
18263,40,1423,3756,0,0,0,0,1,1
18264,40,1425,3761;6156,0,0,0,0,2,2
18265,40,1426,3763,0,0,0,0,1,1
18266,40,1427,132;2804;3766;3767;3768;12465,0,0,0,6,0,6
18267,40,1430,7615;7900,0,0,0,0,2,2
18268,40,1432,9143,0,0,0,0,1,1
18269,40,1434,3781,0,0,0,0,1,1
18270,40,1437,210;3788,0,0,0,0,2,2
18271,40,1439,2739;3793,0,0,0,0,2,2
18272,40,1440,3797;7474,0,0,0,0,2,2
18273,40,1441,3801,0,0,0,0,1,1
18274,40,1444,3808;4190,0,0,0,0,2,2
18275,40,1445,3809;3810,0,0,0,0,2,2
18276,40,1446,1174;3814,0,0,0,0,2,2
18277,40,1449,3821;8819,0,0,0,0,2,2
18278,40,1450,1043,0,0,0,0,1,1
18279,40,1451,3791,0,0,0,0,1,1
18280,40,1452,3827;3828,0,0,0,0,2,2
18281,40,1457,3845;10414,0,0,0,1,1,2
18282,40,1458,3848;8580,0,0,0,1,1,2
18283,40,1459,3851;5474,0,0,0,0,2,2
18284,40,1461,3856,0,0,0,0,1,1
18285,40,1462,3857,0,0,0,0,1,1
18286,40,1465,3866,0,0,0,0,1,1
18287,40,1473,3888,0,0,0,0,1,1
18288,40,1475,3893,0,0,0,0,1,1
18289,40,1476,3897,0,0,0,0,1,1
18290,40,1481,3908,0,0,0,0,1,1
18291,40,1486,3918,0,0,0,0,1,1
18292,40,1487,9622,0,0,0,0,1,1
18293,40,1496,3949,0,0,0,0,1,1
18294,40,1498,6424,0,0,0,0,1,1
18295,40,1501,3966,0,0,0,1,0,1
18296,40,1502,3970,0,0,0,0,1,1
18297,40,1504,885,0,0,0,0,1,1
18298,40,1505,3979;3980,0,0,0,0,2,2
18299,40,1506,4423;9919,0,0,0,0,2,2
18300,40,1508,3983;3984,0,0,0,0,2,2
18301,40,1510,3989,0,0,0,0,1,1
18302,40,1511,3992,0,0,0,1,0,1
18303,40,1514,3999;7359;10966,0,0,0,1,2,3
18304,40,1515,4001,0,0,0,1,0,1
18305,40,1520,4013,0,0,0,0,1,1
18306,40,1521,4014,0,0,0,0,1,1
18307,40,1527,4029;5177,0,0,0,0,2,2
18308,40,1531,4038;8751;10204,0,0,0,1,2,3
18309,40,1533,761;4042,0,0,0,0,2,2
18310,40,1535,4050;9463,0,0,0,0,2,2
18311,40,1536,4055,0,0,0,0,1,1
18312,40,1540,506;4065,0,0,0,0,2,2
18313,40,1541,137,0,0,0,0,1,1
18314,40,1542,4069,0,0,0,0,1,1
18315,40,1543,4072,0,0,0,0,1,1
18316,40,1544,4077,0,0,0,0,1,1
18317,40,1546,4080,0,0,0,0,1,1
18318,40,1551,4091;4093;5890;10016;13549;13767;14007,0,0,3,4,0,7
18319,40,1555,4098;9106,0,0,0,0,2,2
18320,40,1556,4099,0,0,0,0,1,1
18321,40,1557,4104;8235,0,0,0,0,2,2
18322,40,1558,5222,0,0,0,0,1,1
18323,40,1559,4110,0,0,0,0,1,1
18324,40,1570,7361,0,0,0,0,1,1
18325,40,1572,699;4135;10748,0,0,0,1,2,3
18326,40,1574,9432,0,0,0,0,1,1
18327,40,1576,4143,0,0,0,0,1,1
18328,40,1577,2396;4150,0,0,0,2,0,2
18329,40,1578,9173,0,0,0,0,1,1
18330,40,1581,4157;4158,0,0,0,0,2,2
18331,40,1583,4161;4162,0,0,0,0,2,2
18332,40,1586,4171,0,0,0,0,1,1
18333,40,1587,4172,0,0,0,0,1,1
18334,40,1588,4175,0,0,0,0,1,1
18335,40,1593,4186,0,0,0,0,1,1
18336,40,1598,7907;9748;11472;11991,0,0,0,4,0,4
18337,40,1600,4204,0,0,0,0,1,1
18338,40,1601,4205;7021,0,0,0,2,0,2
18339,40,1602,4206,0,0,0,0,1,1
18340,40,1609,2832;4227,0,0,0,0,2,2
18341,40,1611,4232,0,0,0,0,1,1
18342,40,1614,4237;4238,0,0,0,0,2,2
18343,40,1616,4240,0,0,0,0,1,1
18344,40,1618,4246,0,0,0,0,1,1
18345,40,1619,4249,0,0,0,0,1,1
18346,40,1621,4253;4490,0,0,0,1,1,2
18347,40,1622,4255,0,0,0,0,1,1
18348,40,1623,9581,0,0,0,0,1,1
18349,40,1624,2731,0,0,0,0,1,1
18350,40,1625,6795,0,0,0,0,1,1
18351,40,1626,989,0,0,0,0,1,1
18352,40,1628,4269;4270,0,0,0,0,2,2
18353,40,1629,4278,0,0,0,0,1,1
18354,40,1630,4284;6157;11744,0,0,0,3,0,3
18355,40,1633,1647;5841,0,0,0,2,0,2
18356,40,1634,589;4292,0,0,0,0,2,2
18357,40,1635,4296;4297,0,0,0,0,2,2
18358,40,1636,4299,0,0,0,0,1,1
18359,40,1641,4311,0,0,0,0,1,1
18360,40,1643,4316,0,0,0,0,1,1
18361,40,1644,728,0,0,0,1,0,1
18362,40,1647,4323,0,0,0,0,1,1
18363,40,1650,4328,0,0,0,0,1,1
18364,40,1653,4492;8321;10860,0,0,0,1,2,3
18365,40,1654,4334,0,0,0,0,1,1
18366,40,1658,4344,0,0,0,1,0,1
18367,40,1662,4351,0,0,0,0,1,1
18368,40,1665,4358,0,0,0,0,1,1
18369,40,1669,4365;8267,0,0,0,2,0,2
18370,40,1670,4366,0,0,0,0,1,1
18371,40,1672,4376,0,0,0,0,1,1
18372,40,1674,4382,0,0,0,0,1,1
18373,40,1675,4387,0,0,0,0,1,1
18374,40,1677,4391,0,0,0,0,1,1
18375,40,1680,4403,0,0,0,0,1,1
18376,40,1684,4412;4413,0,0,0,0,2,2
18377,40,1687,2913;4419,0,0,0,1,1,2
18378,40,1688,4420,0,0,0,0,1,1
18379,40,1692,4428,0,0,0,0,1,1
18380,40,1697,4437;4438,0,0,0,0,2,2
18381,40,1701,4445,0,0,0,0,1,1
18382,40,1702,4446;4447,0,0,0,0,2,2
18383,40,1705,2861;4455,0,0,0,0,2,2
18384,40,1707,4461,0,0,0,0,1,1
18385,40,1712,4469,0,0,0,0,1,1
18386,40,1713,4472;8505;11758,0,0,0,3,0,3
18387,40,1715,1577;4481;13166;13623,0,0,2,2,0,4
18388,40,1716,4483,0,0,0,0,1,1
18389,40,1718,4491;9047,0,0,0,0,2,2
18390,40,1719,4494;5644,0,0,0,1,1,2
18391,40,1721,4498,0,0,0,0,1,1
18392,40,1722,8221,0,0,0,0,1,1
18393,40,1723,4504,0,0,0,0,1,1
18394,40,1724,4508,0,0,0,0,1,1
18395,40,1728,4521,0,0,0,0,1,1
18396,40,1729,1549;4452,0,0,0,0,2,2
18397,40,1730,4526,0,0,0,0,1,1
18398,40,1731,805;3180,0,0,0,0,2,2
18399,40,1734,4536;6082,0,0,0,0,2,2
18400,40,1736,4538,0,0,0,0,1,1
18401,40,1737,4541,0,0,0,0,1,1
18402,40,1738,2212;4545,0,0,0,0,2,2
18403,40,1745,4560;4561,0,0,0,0,2,2
18404,40,1747,4565,0,0,0,0,1,1
18405,40,1752,4578,0,0,0,0,1,1
18406,40,1755,4584,0,0,0,0,1,1
18407,40,1756,4588,0,0,0,0,1,1
18408,40,1762,4609,0,0,0,0,1,1
18409,40,1765,4618;8549,0,0,0,0,2,2
18410,40,1766,4620,0,0,0,0,1,1
18411,40,1768,1820;4627,0,0,0,0,2,2
18412,40,1769,3108;4633;4634;13442;13533;14064,0,0,3,3,0,6
18413,40,1770,4636,0,0,0,0,1,1
18414,40,1771,4638,0,0,0,0,1,1
18415,40,1773,4643,0,0,0,0,1,1
18416,40,1775,315,0,0,0,0,1,1
18417,40,1776,4650;4651,0,0,0,0,2,2
18418,40,1777,4653;4656;5058,0,0,0,3,0,3
18419,40,1778,4657,0,0,0,0,1,1
18420,40,1784,4666,0,0,0,0,1,1
18421,40,1787,4673,0,0,0,0,1,1
18422,40,1790,4682,0,0,0,0,1,1
18423,40,1791,4684,0,0,0,0,1,1
18424,40,1792,4685,0,0,0,0,1,1
18425,40,1793,4688,0,0,0,0,1,1
18426,40,1794,4692,0,0,0,0,1,1
18427,40,1796,4699,0,0,0,1,0,1
18428,40,1798,2260;4702,0,0,0,0,2,2
18429,40,1799,4706,0,0,0,1,0,1
18430,40,1804,4717;4718,0,0,0,0,2,2
18431,40,1806,4725,0,0,0,0,1,1
18432,40,1807,4727;8028,0,0,0,0,2,2
18433,40,1811,4734,0,0,0,0,1,1
18434,40,1812,4738;4739,0,0,0,0,2,2
18435,40,1813,4742,0,0,0,0,1,1
18436,40,1815,4746;8062,0,0,0,0,2,2
18437,40,1817,4753;4754,0,0,0,0,2,2
18438,40,1819,4760,0,0,0,0,1,1
18439,40,1820,4763,0,0,0,0,1,1
18440,40,1821,525;4766,0,0,0,0,2,2
18441,40,1822,10147;10212;12629;13052;13336,0,0,3,2,0,5
18442,40,1825,4776;5146;11166,0,0,0,2,1,3
18443,40,1827,4779;4780,0,0,0,1,1,2
18444,40,1828,3780,0,0,0,0,1,1
18445,40,1829,4783,0,0,0,0,1,1
18446,40,1831,4785;7734;10303,0,0,0,3,0,3
18447,40,1832,4786;5536,0,0,0,0,2,2
18448,40,1834,4788;7009;10390;11681,0,0,0,3,1,4
18449,40,1842,4813,0,0,0,0,1,1
18450,40,1844,4198;4816,0,0,0,0,2,2
18451,40,1846,1541;2005;3023;7804,0,0,0,2,2,4
18452,40,1848,9958,0,0,0,0,1,1
18453,40,1851,4830,0,0,0,0,1,1
18454,40,1852,4835,0,0,0,0,1,1
18455,40,1855,2806;4841,0,0,0,2,0,2
18456,40,1856,4844,0,0,0,0,1,1
18457,40,1858,4848;4849,0,0,0,0,2,2
18458,40,1859,3099;4853;11572,0,0,0,3,0,3
18459,40,1862,4870;8764,0,0,0,0,2,2
18460,40,1865,4878,0,0,0,0,1,1
18461,40,1866,4879;8171;11455,0,0,0,3,0,3
18462,40,1867,4883,0,0,0,1,0,1
18463,40,1868,275,0,0,0,0,1,1
18464,40,1869,3963;4892;13335;14169,0,1,1,2,0,4
18465,40,1871,4895,0,0,0,0,1,1
18466,40,1875,7013,0,0,0,0,1,1
18467,40,1878,4910;4968,0,0,0,0,2,2
18468,40,1879,4912,0,0,0,0,1,1
18469,40,1881,4918,0,0,0,0,1,1
18470,40,1882,4922,0,0,0,0,1,1
18471,40,1884,4659;4928,0,0,0,0,2,2
18472,40,1885,3981;10908,0,0,0,1,1,2
18473,40,1886,4556,0,0,0,0,1,1
18474,40,1887,4936,0,0,0,0,1,1
18475,40,1889,4943,0,0,0,0,1,1
18476,40,1890,4947,0,0,0,0,1,1
18477,40,1893,4082,0,0,0,0,1,1
18478,40,1895,4966;9556,0,0,0,0,2,2
18479,40,1898,3364;4975,0,0,0,1,1,2
18480,40,1899,4977,0,0,0,0,1,1
18481,40,1900,4981,0,0,0,0,1,1
18482,40,1906,4992,0,0,0,0,1,1
18483,40,1908,4996,0,0,0,0,1,1
18484,40,1912,5006,0,0,0,0,1,1
18485,40,1914,5011;5012,0,0,0,0,2,2
18486,40,1915,680;5014,0,0,0,2,0,2
18487,40,1917,5022,0,0,0,0,1,1
18488,40,1919,851;1494;11198,0,0,0,2,1,3
18489,40,1922,5033;5034,0,0,0,1,1,2
18490,40,1923,5036;7428,0,0,0,1,1,2
18491,40,1924,5038;9914,0,0,0,0,2,2
18492,40,1926,5042,0,0,0,0,1,1
18493,40,1928,5050,0,0,0,0,1,1
18494,40,1929,508;5053,0,0,0,0,2,2
18495,40,1930,5055,0,0,0,0,1,1
18496,40,1933,5061,0,0,0,0,1,1
18497,40,1934,5066,0,0,0,0,1,1
18498,40,1935,4039;5067,0,0,0,1,1,2
18499,40,1937,1919;5074,0,0,0,0,2,2
18500,40,1941,5081,0,0,0,0,1,1
18501,40,1942,713,0,0,0,0,1,1
18502,40,1943,5088;7706,0,0,0,0,2,2
18503,40,1945,5093,0,0,0,0,1,1
18504,40,1946,5095,0,0,0,0,1,1
18505,40,1948,5102;5314;11260;11477;11612,0,0,0,5,0,5
18506,40,1953,5111,0,0,0,0,1,1
18507,40,1954,5115;5116,0,0,0,0,2,2
18508,40,1956,7064,0,0,0,0,1,1
18509,40,1960,759;5125,0,0,0,0,2,2
18510,40,1961,4017;5127;11148,0,0,0,1,2,3
18511,40,1964,7250,0,0,0,0,1,1
18512,40,1966,5139;9360,0,0,0,0,2,2
18513,40,1968,5143,0,0,0,0,1,1
18514,40,1972,5155,0,0,0,0,1,1
18515,40,1973,5157,0,0,0,0,1,1
18516,40,1974,5162;5163,0,0,0,0,2,2
18517,40,1975,5165;8716,0,0,0,0,2,2
18518,40,1976,5168,0,0,0,0,1,1
18519,40,1978,4997;5172,0,0,0,0,2,2
18520,40,1979,5176,0,0,0,0,1,1
18521,40,1980,5179;8446,0,0,0,1,1,2
18522,40,1982,9439,0,0,0,0,1,1
18523,40,1983,419;5185;10865,0,0,0,2,1,3
18524,40,1984,1239;5190;5192,0,0,0,3,0,3
18525,40,1986,2978;2979;4983,0,0,0,2,1,3
18526,40,1994,5217;5218,0,0,0,0,2,2
18527,40,1995,5221,0,0,0,0,1,1
18528,40,1998,5226,0,0,0,0,1,1
18529,40,2000,5233,0,0,0,0,1,1
18530,40,2001,5237;6741,0,0,0,0,2,2
18531,40,2004,4803;5243,0,0,0,0,2,2
18532,40,2005,3119;5247,0,0,0,0,2,2
18533,40,2006,5251;5824;10598;10877,0,0,0,2,2,4
18534,40,2011,5263,0,0,0,0,1,1
18535,40,2012,5264,0,0,0,0,1,1
18536,40,2016,5271,0,0,0,0,1,1
18537,40,2018,5274,0,0,0,1,0,1
18538,40,2022,5284;5285,0,0,0,0,2,2
18539,40,2024,1958;5291,0,0,0,0,2,2
18540,40,2025,5293;8731,0,0,0,2,0,2
18541,40,2028,2323;9655;9749;12873;13776;14076,0,0,3,3,0,6
18542,40,2031,5308;5309,0,0,0,1,1,2
18543,40,2033,5315;6176,0,0,0,2,0,2
18544,40,2036,5321;8005,0,0,0,0,2,2
18545,40,2039,5325,0,0,0,0,1,1
18546,40,2040,5327,0,0,0,0,1,1
18547,40,2041,5332;6514,0,0,0,0,2,2
18548,40,2042,730;4991,0,0,0,0,2,2
18549,40,2043,5335;8525,0,0,0,0,2,2
18550,40,2044,5336;5337,0,0,0,0,2,2
18551,40,2045,5338;6679,0,0,0,0,2,2
18552,40,2048,5343,0,0,0,0,1,1
18553,40,2050,8173,0,0,0,0,1,1
18554,40,2055,5358,0,0,0,0,1,1
18555,40,2056,5361,0,0,0,0,1,1
18556,40,2057,3831;5363;12453,0,0,0,3,0,3
18557,40,2058,5767,0,0,0,0,1,1
18558,40,2060,5374,0,0,0,0,1,1
18559,40,2061,5375,0,0,0,0,1,1
18560,40,2063,5383;5384,0,0,0,0,2,2
18561,40,2065,4615;5388,0,0,0,0,2,2
18562,40,2066,5392;11009,0,0,0,1,1,2
18563,40,2067,1095;5393;11875,0,0,0,3,0,3
18564,40,2070,5400,0,0,0,0,1,1
18565,40,2071,5403;5404,0,0,0,0,2,2
18566,40,2078,2486;5422,0,0,0,0,2,2
18567,40,2079,5423;5424,0,0,0,1,1,2
18568,40,2080,5427;6732;11617,0,0,0,3,0,3
18569,40,2082,5431,0,0,0,0,1,1
18570,40,2083,157;5435;5437,0,0,0,1,2,3
18571,40,2089,5454,0,0,0,0,1,1
18572,40,2090,5456;5457,0,0,0,0,2,2
18573,40,2093,5463;5464,0,0,0,0,2,2
18574,40,2096,5468,0,0,0,1,0,1
18575,40,2105,5488,0,0,0,0,1,1
18576,40,2106,5465,0,0,0,0,1,1
18577,40,2109,4660,0,0,0,0,1,1
18578,40,2111,5666;11730,0,0,0,2,0,2
18579,40,2112,5505,0,0,0,0,1,1
18580,40,2113,459,0,0,0,1,0,1
18581,40,2117,5513,0,0,0,0,1,1
18582,40,2118,5517;5518,0,0,0,1,1,2
18583,40,2119,5520,0,0,0,0,1,1
18584,40,2120,5524,0,0,0,1,0,1
18585,40,2123,736,0,0,0,0,1,1
18586,40,2126,3305;5534,0,0,0,0,2,2
18587,40,2134,5555,0,0,0,0,1,1
18588,40,2137,5564,0,0,0,0,1,1
18589,40,2142,1375;5448;11150,0,0,0,3,0,3
18590,40,2143,5579;5580,0,0,0,0,2,2
18591,40,2145,4602;5582;12703,0,0,1,1,1,3
18592,40,2150,5592,0,0,0,0,1,1
18593,40,2151,5594,0,0,0,0,1,1
18594,40,2152,4884;5596,0,0,0,0,2,2
18595,40,2156,5607,0,0,0,0,1,1
18596,40,2157,5608,0,0,0,0,1,1
18597,40,2159,4395;5000,0,0,0,2,0,2
18598,40,2165,5009;5627,0,0,0,0,2,2
18599,40,2166,5631;5966,0,0,0,0,2,2
18600,40,2170,5641;9920;10047,0,0,0,1,2,3
18601,40,2173,5648,0,0,0,0,1,1
18602,40,2174,5651,0,0,0,0,1,1
18603,40,2175,5654,0,0,0,0,1,1
18604,40,2176,5655;5656,0,0,0,0,2,2
18605,40,2177,5658,0,0,0,0,1,1
18606,40,2179,5663,0,0,0,0,1,1
18607,40,2181,7457,0,0,0,0,1,1
18608,40,2184,5673,0,0,0,0,1,1
18609,40,2185,5220;5675;11323,0,0,0,1,2,3
18610,40,2186,7001,0,0,0,0,1,1
18611,40,2194,5694;7933,0,0,0,0,2,2
18612,40,2197,1416;9526;12296;12578,0,0,1,3,0,4
18613,40,2198,6592,0,0,0,0,1,1
18614,40,2199,5712,0,0,0,0,1,1
18615,40,2202,983;5717,0,0,0,0,2,2
18616,40,2206,2113;5727,0,0,0,0,2,2
18617,40,2208,5730,0,0,0,0,1,1
18618,40,2210,5734,0,0,0,0,1,1
18619,40,2212,5748;11235,0,0,0,2,0,2
18620,40,2219,5766;12520;12750;13136,0,0,3,1,0,4
18621,40,2220,5770,0,0,0,0,1,1
18622,40,2225,5783,0,0,0,0,1,1
18623,40,2226,5785,0,0,0,0,1,1
18624,40,2228,5791;7254,0,0,0,0,2,2
18625,40,2230,5796;7089,0,0,0,0,2,2
18626,40,2231,7942,0,0,0,0,1,1
18627,40,2235,4550,0,0,0,0,1,1
18628,40,2237,8644,0,0,0,0,1,1
18629,40,2238,5813,0,0,0,0,1,1
18630,40,2242,5821,0,0,0,0,1,1
18631,40,2243,184;5822,0,0,0,0,2,2
18632,40,2244,9894;9977,0,0,0,0,2,2
18633,40,2247,5832,0,0,0,0,1,1
18634,40,2248,5833,0,0,0,0,1,1
18635,40,2250,5836,0,0,0,0,1,1
18636,40,2254,597;5844,0,0,0,0,2,2
18637,40,2256,5848,0,0,0,0,1,1
18638,40,2261,5732;5859,0,0,0,0,2,2
18639,40,2262,5862,0,0,0,0,1,1
18640,40,2264,5722;5868,0,0,0,2,0,2
18641,40,2265,5872,0,0,0,0,1,1
18642,40,2266,3404;5874,0,0,0,0,2,2
18643,40,2274,423;5887,0,0,0,1,1,2
18644,40,2275,5891,0,0,0,0,1,1
18645,40,2277,5896;9554,0,0,0,0,2,2
18646,40,2278,2809,0,0,0,0,1,1
18647,40,2282,3085;5909,0,0,0,0,2,2
18648,40,2283,5910,0,0,0,0,1,1
18649,40,2285,5916,0,0,0,0,1,1
18650,40,2286,3010;3955;12412,0,0,0,3,0,3
18651,40,2290,3910;5925;10538,0,0,0,1,2,3
18652,40,2294,5934;5935,0,0,0,0,2,2
18653,40,2298,5944,0,0,0,0,1,1
18654,40,2299,1295;5946,0,0,0,0,2,2
18655,40,2300,5950,0,0,0,1,0,1
18656,40,2301,5951;9192,0,0,0,0,2,2
18657,40,2302,3389;5955,0,0,0,0,2,2
18658,40,2305,4156;5960,0,0,0,0,2,2
18659,40,2306,867;5965,0,0,0,0,2,2
18660,40,2312,5984,0,0,0,0,1,1
18661,40,2314,5888;5989;5992,0,0,0,3,0,3
18662,40,2318,6004,0,0,0,0,1,1
18663,40,2319,4224,0,0,0,0,1,1
18664,40,2320,2089;9937,0,0,0,0,2,2
18665,40,2321,6008,0,0,0,0,1,1
18666,40,2329,3040;6027,0,0,0,0,2,2
18667,40,2331,6030;6032,0,0,0,0,2,2
18668,40,2334,6039;7609,0,0,0,1,1,2
18669,40,2335,6041,0,0,0,0,1,1
18670,40,2336,6043;6044,0,0,0,1,1,2
18671,40,2340,2079;6048,0,0,0,0,2,2
18672,40,2341,6049;6050,0,0,0,0,2,2
18673,40,2342,6052;7093,0,0,0,1,1,2
18674,40,2343,1360;6055;11542;12524;13102;14311,0,1,2,3,0,6
18675,40,2347,4155,0,0,0,0,1,1
18676,40,2349,6065,0,0,0,0,1,1
18677,40,2350,1842;6068,0,0,0,2,0,2
18678,40,2352,6075,0,0,0,0,1,1
18679,40,2355,6085,0,0,0,1,0,1
18680,40,2361,6095;6096,0,0,0,0,2,2
18681,40,2362,6097,0,0,0,0,1,1
18682,40,2367,6113;6811,0,0,0,0,2,2
18683,40,2368,6115,0,0,0,0,1,1
18684,40,2369,6120,0,0,0,0,1,1
18685,40,2371,6125,0,0,0,0,1,1
18686,40,2380,6141;6142,0,0,0,0,2,2
18687,40,2383,6149,0,0,0,0,1,1
18688,40,2384,5478;6150;12080,0,0,0,3,0,3
18689,40,2385,4089;5721;8328;10131,0,0,0,2,2,4
18690,40,2387,6160;8795,0,0,0,0,2,2
18691,40,2388,6162;6163,0,0,0,0,2,2
18692,40,2392,6173;6174,0,0,0,1,1,2
18693,40,2393,1718;6175,0,0,0,0,2,2
18694,40,2395,4010;6180;10589,0,0,0,1,2,3
18695,40,2396,6181,0,0,0,0,1,1
18696,40,2397,6186,0,0,0,0,1,1
18697,40,2399,6193;10387,0,0,0,1,1,2
18698,40,2401,866,0,0,0,0,1,1
18699,40,2403,3688,0,0,0,0,1,1
18700,40,2407,6214,0,0,0,0,1,1
18701,40,2408,6216;6217;10806,0,0,0,1,2,3
18702,40,2414,6232,0,0,0,0,1,1
18703,40,2418,6241;6242,0,0,0,0,2,2
18704,40,2422,6251,0,0,0,0,1,1
18705,40,2429,6272,0,0,0,1,0,1
18706,40,2430,6273;6274,0,0,0,0,2,2
18707,40,2432,6279,0,0,0,0,1,1
18708,40,2433,6282,0,0,0,0,1,1
18709,40,2435,6291,0,0,0,0,1,1
18710,40,2441,681;6305,0,0,0,0,2,2
18711,40,2445,6221;6317,0,0,0,0,2,2
18712,40,2446,6321,0,0,0,0,1,1
18713,40,2447,6324,0,0,0,0,1,1
18714,40,2449,6329,0,0,0,0,1,1
18715,40,2451,4821;6333,0,0,0,0,2,2
18716,40,2453,3652;6342,0,0,0,1,1,2
18717,40,2454,6344;9496,0,0,0,1,1,2
18718,40,2463,6365;6366;11413,0,0,0,2,1,3
18719,40,2468,817;6379,0,0,0,0,2,2
18720,40,2470,6382;10046;13043;13741,0,0,2,2,0,4
18721,40,2474,6387;6388,0,0,0,0,2,2
18722,40,2475,6391,0,0,0,0,1,1
18723,40,2477,4440,0,0,0,0,1,1
18724,40,2479,6402;6403,0,0,0,0,2,2
18725,40,2480,6409,0,0,0,0,1,1
18726,40,2485,6418;6419;6421,0,0,0,1,2,3
18727,40,2486,6423,0,0,0,1,0,1
18728,40,2489,6427,0,0,0,0,1,1
18729,40,2490,1831;6431,0,0,0,0,2,2
18730,40,2491,6433,0,0,0,0,1,1
18731,40,2492,6436,0,0,0,0,1,1
18732,40,2493,8095,0,0,0,0,1,1
18733,40,2494,6438;6439,0,0,0,0,2,2
18734,40,2495,298;6441,0,0,0,0,2,2
18735,40,2497,5601;6448,0,0,0,0,2,2
18736,40,2498,6450;6451,0,0,0,1,1,2
18737,40,2499,6457,0,0,0,0,1,1
18738,40,2500,6459;6460,0,0,0,0,2,2
18739,40,2501,7781;9927;12964;13155;13378,0,0,3,2,0,5
18740,40,2508,6477,0,0,0,0,1,1
18741,40,2509,4623,0,0,0,0,1,1
18742,40,2510,2791;6482,0,0,0,0,2,2
18743,40,2514,6491,0,0,0,0,1,1
18744,40,2516,6497,0,0,0,0,1,1
18745,40,2517,6499,0,0,0,0,1,1
18746,40,2521,1042;6506,0,0,0,1,1,2
18747,40,2528,6521,0,0,0,0,1,1
18748,40,2531,6532;8861,0,0,0,0,2,2
18749,40,2532,6534,0,0,0,0,1,1
18750,40,2534,6540;6633,0,0,0,0,2,2
18751,40,2540,213;8627;11709;12105;12280,0,0,0,5,0,5
18752,40,2544,191,0,0,0,0,1,1
18753,40,2549,6575;7930;10999,0,0,0,1,2,3
18754,40,2551,6578,0,0,0,0,1,1
18755,40,2553,4926,0,0,0,0,1,1
18756,40,2554,1516;6585;10345,0,0,0,1,2,3
18757,40,2555,6590;6591,0,0,0,0,2,2
18758,40,2556,6594,0,0,0,0,1,1
18759,40,2559,6599;7725,0,0,0,0,2,2
18760,40,2563,6610;8565,0,0,0,0,2,2
18761,40,2567,6618;6619,0,0,0,1,1,2
18762,40,2570,6630,0,0,0,0,1,1
18763,40,2571,4239;6634,0,0,0,0,2,2
18764,40,2572,950;1986;6636;7682;11801;12242;12488,0,0,0,7,0,7
18765,40,2574,5900;6643,0,0,0,2,0,2
18766,40,2577,6650,0,0,0,0,1,1
18767,40,2578,6323;6655,0,0,0,0,2,2
18768,40,2579,6657,0,0,0,0,1,1
18769,40,2580,6662,0,0,0,0,1,1
18770,40,2581,6663;10732,0,0,0,1,1,2
18771,40,2583,6666;6667,0,0,0,0,2,2
18772,40,2584,6669;6670,0,0,0,0,2,2
18773,40,2587,6677,0,0,0,0,1,1
18774,40,2589,2706,0,0,0,0,1,1
18775,40,2595,6697;8008,0,0,0,0,2,2
18776,40,2596,6704,0,0,0,0,1,1
18777,40,2603,6726;6729,0,0,0,1,1,2
18778,40,2604,949;6730,0,0,0,2,0,2
18779,40,2606,6737;6738,0,0,0,1,1,2
18780,40,2610,6746,0,0,0,0,1,1
18781,40,2611,6749,0,0,0,0,1,1
18782,40,2612,6752;6753,0,0,0,0,2,2
18783,40,2615,6756,0,0,0,0,1,1
18784,40,2619,1139;6770;11219;11720;12306;12902,0,0,1,5,0,6
18785,40,2631,6802,0,0,0,1,0,1
18786,40,2632,6803,0,0,0,0,1,1
18787,40,2634,1978,0,0,0,0,1,1
18788,40,2637,6814,0,0,0,0,1,1
18789,40,2638,11184;14003,0,0,1,1,0,2
18790,40,2640,6821,0,0,0,0,1,1
18791,40,2641,6824,0,0,0,0,1,1
18792,40,2642,6825,0,0,0,0,1,1
18793,40,2643,6829,0,0,0,0,1,1
18794,40,2645,6832,0,0,0,0,1,1
18795,40,2646,1012,0,0,0,0,1,1
18796,40,2647,6841,0,0,0,0,1,1
18797,40,2650,6853;6855,0,0,0,1,1,2
18798,40,2651,2753,0,0,0,0,1,1
18799,40,2652,6860,0,0,0,0,1,1
18800,40,2653,811;6862;6867,0,0,0,2,1,3
18801,40,2654,6868,0,0,0,0,1,1
18802,40,2657,6876,0,0,0,0,1,1
18803,40,2658,2545;5191;6878;6880;9355;11796;12627;13364;13629,0,0,3,6,0,9
18804,40,2661,6888,0,0,0,0,1,1
18805,40,2670,4095,0,0,0,0,1,1
18806,40,2673,6911,0,0,0,1,0,1
18807,40,2674,6913,0,0,0,0,1,1
18808,40,2675,5476;6915,0,0,0,0,2,2
18809,40,2678,6924;8423,0,0,0,0,2,2
18810,40,2681,3235;6928,0,0,0,0,2,2
18811,40,2685,6939,0,0,0,0,1,1
18812,40,2688,6944,0,0,0,0,1,1
18813,40,2689,6945,0,0,0,0,1,1
18814,40,2690,3442;6952;11125,0,0,0,1,2,3
18815,40,2694,6961,0,0,0,0,1,1
18816,40,2698,6966,0,0,0,0,1,1
18817,40,2699,6969;8578,0,0,0,1,1,2
18818,40,2701,6976,0,0,0,0,1,1
18819,40,2705,4691;6988,0,0,0,0,2,2
18820,40,2706,6992,0,0,0,0,1,1
18821,40,2716,7023,0,0,0,0,1,1
18822,40,2717,7026;9064,0,0,0,0,2,2
18823,40,2718,1248;7028,0,0,0,0,2,2
18824,40,2719,5113;7034;7035;8443,0,0,0,4,0,4
18825,40,2723,7045,0,0,0,0,1,1
18826,40,2725,7048;9808;10736,0,0,0,3,0,3
18827,40,2729,7057,0,0,0,0,1,1
18828,40,2730,7059,0,0,0,0,1,1
18829,40,2735,7074,0,0,0,1,0,1
18830,40,2736,7075;7076,0,0,0,1,1,2
18831,40,2742,7091;8465,0,0,0,0,2,2
18832,40,2743,7092,0,0,0,0,1,1
18833,40,2744,7094,0,0,0,1,0,1
18834,40,2745,7096;9868,0,0,0,0,2,2
18835,40,2746,7100,0,0,0,0,1,1
18836,40,2751,6428;7113,0,0,0,0,2,2
18837,40,2756,7131,0,0,0,0,1,1
18838,40,2758,7133;7134,0,0,0,0,2,2
18839,40,2759,10711;14698,0,1,0,1,0,2
18840,40,2760,7136;7137,0,0,0,0,2,2
18841,40,2761,7139,0,0,0,1,0,1
18842,40,2763,7147,0,0,0,0,1,1
18843,40,2764,7149;7613,0,0,0,0,2,2
18844,40,2769,1760;7162,0,0,0,0,2,2
18845,40,2770,6765;7164,0,0,0,2,0,2
18846,40,2771,2671,0,0,0,0,1,1
18847,40,2772,5919;7167;10971,0,0,0,1,2,3
18848,40,2773,7296,0,0,0,0,1,1
18849,40,2776,7178,0,0,0,0,1,1
18850,40,2777,7182,0,0,0,0,1,1
18851,40,2785,7199,0,0,0,0,1,1
18852,40,2792,7214,0,0,0,0,1,1
18853,40,2794,7218,0,0,0,0,1,1
18854,40,2796,7225,0,0,0,0,1,1
18855,40,2797,7228;7229,0,0,0,1,1,2
18856,40,2799,5855,0,0,0,0,1,1
18857,40,2801,7239,0,0,0,0,1,1
18858,40,2809,7252,0,0,0,1,0,1
18859,40,2811,7258,0,0,0,0,1,1
18860,40,2814,7263;7264;10057;10939,0,0,0,2,2,4
18861,40,2815,7266,0,0,0,0,1,1
18862,40,2817,8082,0,0,0,0,1,1
18863,40,2818,7270,0,0,0,0,1,1
18864,40,2819,7273,0,0,0,0,1,1
18865,40,2820,7277;9362,0,0,0,1,1,2
18866,40,2821,7279,0,0,0,0,1,1
18867,40,2824,7286;12445,0,0,0,2,0,2
18868,40,2825,7288,0,0,0,0,1,1
18869,40,2827,7292,0,0,0,0,1,1
18870,40,2829,7297;9899,0,0,0,0,2,2
18871,40,2832,7307;8672,0,0,0,2,0,2
18872,40,2833,6965,0,0,0,0,1,1
18873,40,2836,7317,0,0,0,0,1,1
18874,40,2838,7324;9623,0,0,0,1,1,2
18875,40,2839,3268;7325;11797,0,0,0,3,0,3
18876,40,2846,7338;7344,0,0,0,1,1,2
18877,40,2848,7348,0,0,0,0,1,1
18878,40,2850,7351,0,0,0,0,1,1
18879,40,2851,7355,0,0,0,1,0,1
18880,40,2854,7363,0,0,0,0,1,1
18881,40,2855,8080,0,0,0,0,1,1
18882,40,2861,4364;6063,0,0,0,0,2,2
18883,40,2862,2908;7380,0,0,0,0,2,2
18884,40,2863,3718;9946,0,0,0,2,0,2
18885,40,2866,1750;5602,0,0,0,1,1,2
18886,40,2867,7395,0,0,0,1,0,1
18887,40,2869,4577;7399,0,0,0,2,0,2
18888,40,2870,7400;7401,0,0,0,1,1,2
18889,40,2874,1613;7415,0,0,0,0,2,2
18890,40,2877,7424,0,0,0,0,1,1
18891,40,2878,7427,0,0,0,0,1,1
18892,40,2882,7439;7440;13751;14343,0,1,1,2,0,4
18893,40,2883,7442,0,0,0,0,1,1
18894,40,2886,7450,0,0,0,0,1,1
18895,40,2893,7467,0,0,0,0,1,1
18896,40,2894,7468,0,0,0,0,1,1
18897,40,2895,7941,0,0,0,0,1,1
18898,40,2896,7471;7472,0,0,0,1,1,2
18899,40,2899,7480,0,0,0,0,1,1
18900,40,2900,7482,0,0,0,0,1,1
18901,40,2903,7489,0,0,0,0,1,1
18902,40,2907,3005;7501,0,0,0,0,2,2
18903,40,2908,6837;7504;12096,0,0,0,3,0,3
18904,40,2909,7507,0,0,0,0,1,1
18905,40,2915,1853;7526,0,0,0,0,2,2
18906,40,2921,7542,0,0,0,0,1,1
18907,40,2932,7573,0,0,0,0,1,1
18908,40,2937,7581,0,0,0,0,1,1
18909,40,2940,1947;7589,0,0,0,0,2,2
18910,40,2943,7598,0,0,0,0,1,1
18911,40,2944,1569;1894,0,0,0,0,2,2
18912,40,2947,5322;7607,0,0,0,1,1,2
18913,40,2957,7635,0,0,0,0,1,1
18914,40,2959,3224,0,0,0,0,1,1
18915,40,2962,7644;7646,0,0,0,0,2,2
18916,40,2963,7648,0,0,0,0,1,1
18917,40,2964,7649;7650,0,0,0,0,2,2
18918,40,2965,3072;9299,0,0,0,0,2,2
18919,40,2969,7664,0,0,0,0,1,1
18920,40,2970,7666,0,0,0,0,1,1
18921,40,2971,9333,0,0,0,0,1,1
18922,40,2972,7668;7670,0,0,0,0,2,2
18923,40,2975,1490;7680,0,0,0,0,2,2
18924,40,2976,7685,0,0,0,0,1,1
18925,40,2978,7687,0,0,0,0,1,1
18926,40,2980,7693,0,0,0,0,1,1
18927,40,2981,7694,0,0,0,0,1,1
18928,40,2982,7699;7700,0,0,0,0,2,2
18929,40,2983,7702;8838,0,0,0,0,2,2
18930,40,2985,7707;7708,0,0,0,0,2,2
18931,40,2990,779;7718,0,0,0,0,2,2
18932,40,2997,4168;7737,0,0,0,0,2,2
18933,40,2999,7743,0,0,0,0,1,1
18934,40,3000,7745,0,0,0,0,1,1
18935,40,3004,7755,0,0,0,0,1,1
18936,40,3006,4084,0,0,0,0,1,1
18937,40,3009,7665;7766;13273;13412,0,0,2,2,0,4
18938,40,3010,1019;7767,0,0,0,0,2,2
18939,40,3011,6543;7769,0,0,0,0,2,2
18940,40,3013,4818;7772,0,0,0,1,1,2
18941,40,3014,7774,0,0,0,0,1,1
18942,40,3015,97;5461,0,0,0,0,2,2
18943,40,3016,7779;8613,0,0,0,0,2,2
18944,40,3017,7782;7784,0,0,0,0,2,2
18945,40,3021,6078;7792;11673;12298,0,0,0,4,0,4
18946,40,3022,175;219;12342;12946;13580;13752;13998,0,0,4,3,0,7
18947,40,3023,7795,0,0,0,0,1,1
18948,40,3024,883;7797,0,0,0,0,2,2
18949,40,3026,7800;9969,0,0,0,0,2,2
18950,40,3027,7805,0,0,0,0,1,1
18951,40,3028,5858;7807;10933,0,0,0,2,1,3
18952,40,3029,7810,0,0,0,0,1,1
18953,40,3031,7817,0,0,0,0,1,1
18954,40,3040,7845,0,0,0,0,1,1
18955,40,3045,7854;9657;10476,0,0,0,1,2,3
18956,40,3046,963;7858,0,0,0,0,2,2
18957,40,3052,7875;9170,0,0,0,0,2,2
18958,40,3053,6398;7876,0,0,0,0,2,2
18959,40,3056,3028;7881;12479;13099,0,0,1,3,0,4
18960,40,3057,7883,0,0,0,0,1,1
18961,40,3059,7886,0,0,0,0,1,1
18962,40,3060,7887;7888,0,0,0,0,2,2
18963,40,3061,7892,0,0,0,0,1,1
18964,40,3062,7157;7896,0,0,0,2,0,2
18965,40,3063,7898,0,0,0,0,1,1
18966,40,3065,7903;8139,0,0,0,0,2,2
18967,40,3070,2747;7915,0,0,0,1,1,2
18968,40,3071,7916,0,0,0,0,1,1
18969,40,3072,3335;3382,0,0,0,2,0,2
18970,40,3076,7931,0,0,0,0,1,1
18971,40,3077,7934,0,0,0,0,1,1
18972,40,3078,4188;7937;12402,0,0,0,3,0,3
18973,40,3079,292,0,0,0,0,1,1
18974,40,3083,7951,0,0,0,0,1,1
18975,40,3085,7953;7954,0,0,0,0,2,2
18976,40,3087,7956,0,0,0,0,1,1
18977,40,3098,7985,0,0,0,0,1,1
18978,40,3100,2932;7987;10876,0,0,0,3,0,3
18979,40,3101,7159,0,0,0,0,1,1
18980,40,3102,7996;7997,0,0,0,1,1,2
18981,40,3104,8001,0,0,0,0,1,1
18982,40,3109,7321;8011;11490,0,0,0,2,1,3
18983,40,3112,3792;4434;12090,0,0,0,3,0,3
18984,40,3113,8021,0,0,0,0,1,1
18985,40,3115,8032,0,0,0,0,1,1
18986,40,3120,8048;8051,0,0,0,1,1,2
18987,40,3122,8056,0,0,0,0,1,1
18988,40,3123,7639;8058,0,0,0,0,2,2
18989,40,3126,8240,0,0,0,0,1,1
18990,40,3127,8066,0,0,0,0,1,1
18991,40,3137,5548;8085,0,0,0,2,0,2
18992,40,3138,8088,0,0,0,0,1,1
18993,40,3142,8098;10801,0,0,0,1,1,2
18994,40,3146,8105,0,0,0,0,1,1
18995,40,3147,8108,0,0,0,0,1,1
18996,40,3148,8112,0,0,0,0,1,1
18997,40,3150,8118;9822,0,0,0,0,2,2
18998,40,3154,8131,0,0,0,0,1,1
18999,40,3156,8136,0,0,0,0,1,1
19000,40,3157,8138,0,0,0,0,1,1
19001,40,3158,3189;8141,0,0,0,0,2,2
19002,40,3159,9391;10656,0,0,0,1,1,2
19003,40,3160,5207;8147,0,0,0,0,2,2
19004,40,3161,8152,0,0,0,0,1,1
19005,40,3163,7350;8156,0,0,0,1,1,2
19006,40,3164,8157;8158,0,0,0,0,2,2
19007,40,3167,8162,0,0,0,0,1,1
19008,40,3168,8166,0,0,0,0,1,1
19009,40,3172,8179,0,0,0,0,1,1
19010,40,3178,8193,0,0,0,0,1,1
19011,40,3181,8651,0,0,0,0,1,1
19012,40,3182,8203;8437,0,0,0,0,2,2
19013,40,3188,8212,0,0,0,0,1,1
19014,40,3189,6757;7416,0,0,0,2,0,2
19015,40,3191,1943;12207;13957,0,0,1,2,0,3
19016,40,3192,8223,0,0,0,0,1,1
19017,40,3195,8231,0,0,0,0,1,1
19018,40,3198,6783;11952,0,0,0,2,0,2
19019,40,3199,8239,0,0,0,1,0,1
19020,40,3201,5578;8241,0,0,0,2,0,2
19021,40,3202,884,0,0,0,0,1,1
19022,40,3204,4970;8245;10916,0,0,0,1,2,3
19023,40,3205,8247;9597,0,0,0,0,2,2
19024,40,3206,8250;8251,0,0,0,0,2,2
19025,40,3207,8255;8882,0,0,0,0,2,2
19026,40,3208,8257,0,0,0,0,1,1
19027,40,3212,3254;8263,0,0,0,0,2,2
19028,40,3216,8275;9828,0,0,0,0,2,2
19029,40,3217,8279,0,0,0,0,1,1
19030,40,3221,8294,0,0,0,0,1,1
19031,40,3227,1178;8305;10990,0,0,0,1,2,3
19032,40,3228,8309,0,0,0,0,1,1
19033,40,3231,2682;8545,0,0,0,0,2,2
19034,40,3233,5052,0,0,0,0,1,1
19035,40,3236,3509;8334,0,0,0,1,1,2
19036,40,3237,4370,0,0,0,1,0,1
19037,40,3242,8349,0,0,0,0,1,1
19038,40,3243,3295;8350;10438;11280,0,0,0,4,0,4
19039,40,3244,8353,0,0,0,0,1,1
19040,40,3246,466;2608,0,0,0,0,2,2
19041,40,3247,7676;8357,0,0,0,2,0,2
19042,40,3248,8359,0,0,0,0,1,1
19043,40,3250,8366;8367,0,0,0,0,2,2
19044,40,3251,8369;8370,0,0,0,0,2,2
19045,40,3252,8371,0,0,0,0,1,1
19046,40,3256,8381,0,0,0,0,1,1
19047,40,3258,1695;8387,0,0,0,1,1,2
19048,40,3259,8390,0,0,0,0,1,1
19049,40,3260,4582;8393,0,0,0,2,0,2
19050,40,3261,8522,0,0,0,0,1,1
19051,40,3262,4988,0,0,0,0,1,1
19052,40,3264,8404,0,0,0,0,1,1
19053,40,3267,8414,0,0,0,0,1,1
19054,40,3268,8418,0,0,0,1,0,1
19055,40,3270,8422,0,0,0,0,1,1
19056,40,3272,8428,0,0,0,0,1,1
19057,40,3276,8435;9461,0,0,0,0,2,2
19058,40,3279,6648,0,0,0,0,1,1
19059,40,3281,8447,0,0,0,0,1,1
19060,40,3283,8451;8452,0,0,0,0,2,2
19061,40,3286,8460,0,0,0,0,1,1
19062,40,3287,8462;8463,0,0,0,0,2,2
19063,40,3288,7493;8464,0,0,0,2,0,2
19064,40,3290,5814;8474;14183,0,1,0,2,0,3
19065,40,3291,8475,0,0,0,0,1,1
19066,40,3296,416,0,0,0,0,1,1
19067,40,3297,8496,0,0,0,0,1,1
19068,40,3301,4041;8506,0,0,0,0,2,2
19069,40,3303,8508;8509,0,0,0,0,2,2
19070,40,3304,8510,0,0,0,0,1,1
19071,40,3305,5351;8513,0,0,0,0,2,2
19072,40,3312,2312,0,0,0,0,1,1
19073,40,3316,8159;8542,0,0,0,1,1,2
19074,40,3318,8550;8551,0,0,0,0,2,2
19075,40,3319,7453;8554;12469,0,0,0,3,0,3
19076,40,3320,8911,0,0,0,0,1,1
19077,40,3322,8563,0,0,0,0,1,1
19078,40,3323,893;8427,0,0,0,0,2,2
19079,40,3324,8569,0,0,0,0,1,1
19080,40,3332,8582,0,0,0,0,1,1
19081,40,3335,8588,0,0,0,0,1,1
19082,40,3336,8593,0,0,0,0,1,1
19083,40,3338,8599;8600,0,0,0,0,2,2
19084,40,3341,8607,0,0,0,0,1,1
19085,40,3342,8084,0,0,0,0,1,1
19086,40,3343,5070;8611;11050,0,0,0,3,0,3
19087,40,3345,8614,0,0,0,0,1,1
19088,40,3346,8621,0,0,0,0,1,1
19089,40,3350,8635,0,0,0,0,1,1
19090,40,3351,8636,0,0,0,0,1,1
19091,40,3353,8645,0,0,0,0,1,1
19092,40,3354,8647,0,0,0,0,1,1
19093,40,3356,8653,0,0,0,0,1,1
19094,40,3357,8655,0,0,0,0,1,1
19095,40,3358,5276;8658,0,0,0,0,2,2
19096,40,3360,8660,0,0,0,0,1,1
19097,40,3362,8666,0,0,0,0,1,1
19098,40,3367,5040;8681;12541;13507;14078,0,0,3,2,0,5
19099,40,3369,372,0,0,0,0,1,1
19100,40,3370,8686,0,0,0,0,1,1
19101,40,3372,8690,0,0,0,0,1,1
19102,40,3376,8702;8708,0,0,0,0,2,2
19103,40,3379,8706,0,0,0,0,1,1
19104,40,3383,8721;10243;13210;13876;13982,0,0,3,2,0,5
19105,40,3384,7919;8722,0,0,0,0,2,2
19106,40,3386,8726,0,0,0,0,1,1
19107,40,3387,4517;8728;11418,0,0,0,1,2,3
19108,40,3392,8736,0,0,0,0,1,1
19109,40,3394,442,0,0,0,0,1,1
19110,40,3398,2163;8755,0,0,0,1,1,2
19111,40,3400,8761;8762,0,0,0,0,2,2
19112,40,3404,8773;8774;10994,0,0,0,1,2,3
19113,40,3405,8775,0,0,0,0,1,1
19114,40,3406,413;7657,0,0,0,2,0,2
19115,40,3407,7977;8783;8784,0,0,0,1,2,3
19116,40,3411,4273;8790,0,0,0,2,0,2
19117,40,3415,8802,0,0,0,0,1,1
19118,40,3416,7490;8804;11247;11569,0,0,0,4,0,4
19119,40,3418,8813,0,0,0,0,1,1
19120,40,3421,8825,0,0,0,0,1,1
19121,40,3422,8828;9393,0,0,0,1,1,2
19122,40,3423,8832,0,0,0,0,1,1
19123,40,3425,8835,0,0,0,0,1,1
19124,40,3426,8842,0,0,0,0,1,1
19125,40,3427,6799;8844,0,0,0,1,1,2
19126,40,3431,8852,0,0,0,0,1,1
19127,40,3435,2524;10321;13015;14238,0,1,1,2,0,4
19128,40,3436,2310,0,0,0,0,1,1
19129,40,3438,8868,0,0,0,0,1,1
19130,40,3440,8873,0,0,0,0,1,1
19131,40,3442,8875,0,0,0,0,1,1
19132,40,3446,8883,0,0,0,0,1,1
19133,40,3447,122,0,0,0,0,1,1
19134,40,3448,8892,0,0,0,1,0,1
19135,40,3449,8895;10858,0,0,0,2,0,2
19136,40,3450,8897,0,0,0,0,1,1
19137,40,3452,8906,0,0,0,0,1,1
19138,40,3453,8907,0,0,0,0,1,1
19139,40,3456,8915,0,0,0,0,1,1
19140,40,3457,8917,0,0,0,0,1,1
19141,40,3458,8919,0,0,0,0,1,1
19142,40,3459,8920,0,0,0,0,1,1
19143,40,3461,8926,0,0,0,0,1,1
19144,40,3464,7124,0,0,0,0,1,1
19145,40,3467,8942,0,0,0,0,1,1
19146,40,3470,3635;8952,0,0,0,0,2,2
19147,40,3475,8965,0,0,0,0,1,1
19148,40,3476,8969,0,0,0,0,1,1
19149,40,3477,8970,0,0,0,0,1,1
19150,40,3479,2009;8978;12597;12744;13207;13777,0,0,4,2,0,6
19151,40,3486,3039;8993,0,0,0,0,2,2
19152,40,3488,4131;9000,0,0,0,0,2,2
19153,40,3490,9005,0,0,0,0,1,1
19154,40,3491,9010,0,0,0,0,1,1
19155,40,3493,6383;9014,0,0,0,0,2,2
19156,40,3494,9018,0,0,0,0,1,1
19157,40,3495,9020,0,0,0,0,1,1
19158,40,3496,9023,0,0,0,0,1,1
19159,40,3498,9026;9784,0,0,0,0,2,2
19160,40,3501,9030,0,0,0,0,1,1
19161,40,3502,9529,0,0,0,0,1,1
19162,40,3504,9038,0,0,0,0,1,1
19163,40,3505,588,0,0,0,0,1,1
19164,40,3507,2885;9050,0,0,0,0,2,2
19165,40,3510,4880;9055,0,0,0,0,2,2
19166,40,3512,310;9060,0,0,0,0,2,2
19167,40,3515,9065,0,0,0,0,1,1
19168,40,3516,8076;9067,0,0,0,1,1,2
19169,40,3517,324;9070,0,0,0,0,2,2
19170,40,3518,9073,0,0,0,0,1,1
19171,40,3519,2383;9076;12485,0,0,0,3,0,3
19172,40,3520,9079,0,0,0,0,1,1
19173,40,3523,1865;8979,0,0,0,0,2,2
19174,40,3524,3655;9089,0,0,0,0,2,2
19175,40,3525,9092,0,0,0,0,1,1
19176,40,3526,9093,0,0,0,0,1,1
19177,40,3528,9100,0,0,0,0,1,1
19178,40,3529,9107,0,0,0,0,1,1
19179,40,3532,4380,0,0,0,0,1,1
19180,40,3534,9122,0,0,0,0,1,1
19181,40,3536,9129,0,0,0,0,1,1
19182,40,3537,4530;9131,0,0,0,0,2,2
19183,40,3540,9140,0,0,0,0,1,1
19184,40,3543,9146,0,0,0,0,1,1
19185,40,3546,4797;9152,0,0,0,1,1,2
19186,40,3550,9167,0,0,0,1,0,1
19187,40,3555,9176,0,0,0,0,1,1
19188,40,3559,9183;9184;11634,0,0,0,2,1,3
19189,40,3560,9185;9186,0,0,0,0,2,2
19190,40,3563,9193;9864,0,0,0,0,2,2
19191,40,3565,9199,0,0,0,0,1,1
19192,40,3566,9200;9201,0,0,0,0,2,2
19193,40,3569,9206;9209,0,0,0,0,2,2
19194,40,3570,8724;9212,0,0,0,0,2,2
19195,40,3572,1827,0,0,0,0,1,1
19196,40,3576,9236,0,0,0,0,1,1
19197,40,3580,10284;10502;12749;14191,0,1,1,2,0,4
19198,40,3581,5875;9248,0,0,0,0,2,2
19199,40,3582,9250,0,0,0,0,1,1
19200,40,3587,9261;9262,0,0,0,0,2,2
19201,40,3588,6572;9264,0,0,0,0,2,2
19202,40,3589,9268,0,0,0,0,1,1
19203,40,3592,9274,0,0,0,0,1,1
19204,40,3594,1351;2231;2240;6102;12017;12103;12231;12400;12581;12849,0,0,2,8,0,10
19205,40,3595,2478,0,0,0,0,1,1
19206,40,3596,9283,0,0,0,0,1,1
19207,40,3597,9286;9658,0,0,0,0,2,2
19208,40,3603,9295;12301,0,0,0,2,0,2
19209,40,3605,3373;9301,0,0,0,2,0,2
19210,40,3606,9304,0,0,0,0,1,1
19211,40,3608,9307,0,0,0,0,1,1
19212,40,3611,9312;9313,0,0,0,0,2,2
19213,40,3612,3533;9315,0,0,0,0,2,2
19214,40,3613,3739;9319;11717,0,0,0,1,2,3
19215,40,3621,9341,0,0,0,0,1,1
19216,40,3623,9345,0,0,0,0,1,1
19217,40,3624,9346,0,0,0,0,1,1
19218,40,3625,9349,0,0,0,0,1,1
19219,40,3629,4789;9363,0,0,0,0,2,2
19220,40,3630,9366,0,0,0,0,1,1
19221,40,3631,9372;9373,0,0,0,0,2,2
19222,40,3632,9375,0,0,0,0,1,1
19223,40,3634,5684,0,0,0,1,0,1
19224,40,3636,9382,0,0,0,0,1,1
19225,40,3637,9384,0,0,0,1,0,1
19226,40,3639,4032;9386,0,0,0,0,2,2
19227,40,3641,695;9395,0,0,0,0,2,2
19228,40,3643,4233;9399,0,0,0,0,2,2
19229,40,3645,9404;9405,0,0,0,0,2,2
19230,40,3646,9407,0,0,0,0,1,1
19231,40,3647,9409,0,0,0,0,1,1
19232,40,3649,9416,0,0,0,0,1,1
19233,40,3651,10992;13393;14293,0,1,1,1,0,3
19234,40,3659,9445,0,0,0,0,1,1
19235,40,3662,9452,0,0,0,0,1,1
19236,40,3666,9470,0,0,0,0,1,1
19237,40,3673,3643;9479,0,0,0,0,2,2
19238,40,3674,9483,0,0,0,0,1,1
19239,40,3680,9498,0,0,0,0,1,1
19240,40,3682,9503,0,0,0,0,1,1
19241,40,3684,9508;12397,0,0,0,1,1,2
19242,40,3685,9509,0,0,0,0,1,1
19243,40,3686,9512,0,0,0,0,1,1
19244,40,3687,1473;9517;11934,0,0,0,3,0,3
19245,40,3688,9521;12032,0,0,0,2,0,2
19246,40,3690,9524;9525,0,0,0,0,2,2
19247,40,3691,9530,0,0,0,0,1,1
19248,40,3693,2022;9535,0,0,0,0,2,2
19249,40,3694,9537,0,0,0,0,1,1
19250,40,3696,4346,0,0,0,0,1,1
19251,40,3698,9546,0,0,0,0,1,1
19252,40,3699,9548;9549,0,0,0,0,2,2
19253,40,3701,6021;9552,0,0,0,2,0,2
19254,40,3703,9555,0,0,0,0,1,1
19255,40,3704,6766;9560,0,0,0,0,2,2
19256,40,3706,9568,0,0,0,0,1,1
19257,40,3707,9569,0,0,0,0,1,1
19258,40,3708,9574,0,0,0,0,1,1
19259,40,3713,6535;9587,0,0,0,2,0,2
19260,40,3716,5560;5633,0,0,0,0,2,2
19261,40,3718,9601,0,0,0,0,1,1
19262,40,3719,7523;9604,0,0,0,1,1,2
19263,40,3723,9614;9615,0,0,0,0,2,2
19264,40,3724,9618,0,0,0,0,1,1
19265,40,3725,625;9619,0,0,0,2,0,2
19266,40,3726,69;9620;11558,0,0,0,2,1,3
19267,40,3727,9624,0,0,0,0,1,1
19268,40,3730,9632,0,0,0,0,1,1
19269,40,3731,9633,0,0,0,0,1,1
19270,40,3732,9635;9636,0,0,0,0,2,2
19271,40,3736,279,0,0,0,1,0,1
19272,40,3737,9646,0,0,0,0,1,1
19273,40,3742,5298,0,0,0,0,1,1
19274,40,3743,9662,0,0,0,0,1,1
19275,40,3744,1420;9663,0,0,0,0,2,2
19276,40,3748,9673,0,0,0,0,1,1
19277,40,3749,9676,0,0,0,1,0,1
19278,40,3753,9691,0,0,0,0,1,1
19279,40,3756,592;9701,0,0,0,0,2,2
19280,40,3760,9711,0,0,0,0,1,1
19281,40,3761,763;9713,0,0,0,2,0,2
19282,40,3770,9738,0,0,0,0,1,1
19283,40,3771,1663;9742;11573;12517,0,0,1,3,0,4
19284,40,3772,9744,0,0,0,0,1,1
19285,40,3774,8132;9809,0,0,0,2,0,2
19286,40,3776,9754;9755,0,0,0,0,2,2
19287,40,3780,9766,0,0,0,0,1,1
19288,40,3781,7005;9771,0,0,0,0,2,2
19289,40,3782,7170;9772,0,0,0,0,2,2
19290,40,3783,9774;9775,0,0,0,0,2,2
19291,40,3784,1605;9778;10165,0,0,0,3,0,3
19292,40,3786,9785,0,0,0,0,1,1
19293,40,3787,9789,0,0,0,0,1,1
19294,40,3792,1199;9803,0,0,0,1,1,2
19295,40,3793,9805,0,0,0,0,1,1
19296,40,3797,9815,0,0,0,1,0,1
19297,40,3800,9823,0,0,0,0,1,1
19298,40,3803,5108,0,0,0,0,1,1
19299,40,3809,908;4044,0,0,0,2,0,2
19300,40,3810,9856,0,0,0,0,1,1
19301,40,3812,5357,0,0,0,0,1,1
19302,40,3813,799;9863,0,0,0,0,2,2
19303,40,3817,4396;9870;11019,0,0,0,3,0,3
19304,40,3820,9876,0,0,0,0,1,1
19305,40,3823,3901;9891,0,0,0,2,0,2
19306,40,3825,9573;9897;12225,0,0,0,3,0,3
19307,40,3827,552;9900,0,0,0,1,1,2
19308,40,3828,2280,0,0,0,0,1,1
19309,40,3829,9904,0,0,0,0,1,1
19310,40,3831,1666;9907;12468,0,0,0,3,0,3
19311,40,3833,4806;9915;11119,0,0,0,3,0,3
19312,40,3835,9917,0,0,0,0,1,1
19313,40,3839,5026;9931,0,0,0,1,1,2
19314,40,3841,1878;9934,0,0,0,0,2,2
19315,40,3844,9943,0,0,0,0,1,1
19316,40,3845,9949,0,0,0,0,1,1
19317,40,3847,7578,0,0,0,0,1,1
19318,40,3849,9956,0,0,0,0,1,1
19319,40,3851,9959,0,0,0,0,1,1
19320,40,3853,9964,0,0,0,0,1,1
19321,40,3856,9972,0,0,0,0,1,1
19322,40,3859,9981,0,0,0,0,1,1
19323,40,3861,8834;9988,0,0,0,0,2,2
19324,40,3862,9991,0,0,0,0,1,1
19325,40,3863,9992,0,0,0,0,1,1
19326,40,3864,6561,0,0,0,1,0,1
19327,40,3865,10002,0,0,0,0,1,1
19328,40,3867,106,0,0,0,0,1,1
19329,40,3868,143,0,0,0,0,1,1
19330,40,3869,2017,0,0,0,1,0,1
19331,40,3870,434;3065,0,0,0,0,2,2
19332,40,3871,6059,0,0,0,0,1,1
19333,40,3872,586;4306,0,0,0,0,2,2
19334,40,3878,828;2133,0,0,0,0,2,2
19335,40,3884,1783,0,0,0,0,1,1
19336,40,3888,2126;4971,0,0,0,0,2,2
19337,40,3889,2130,0,0,0,0,1,1
19338,40,3892,1924;2443,0,0,0,0,2,2
19339,40,3893,2526,0,0,0,0,1,1
19340,40,3895,672;5600;11583,0,0,0,3,0,3
19341,40,3896,2762;8312,0,0,0,0,2,2
19342,40,3900,1736;2942,0,0,0,0,2,2
19343,40,3901,3325,0,0,0,0,1,1
19344,40,3902,2716;9127,0,0,0,0,2,2
19345,40,3903,550;3613,0,0,0,0,2,2
19346,40,3906,259,0,0,0,0,1,1
19347,40,3907,4000;7516,0,0,0,1,1,2
19348,40,3910,528;4243,0,0,0,0,2,2
19349,40,3912,22,0,0,0,1,0,1
19350,40,3914,3302,0,0,0,0,1,1
19351,40,3915,7517,0,0,0,0,1,1
19352,40,3918,5235;5972;10535,0,0,0,1,2,3
19353,40,3922,9925,0,0,0,0,1,1
19354,40,3923,5700;6778,0,0,0,0,2,2
19355,40,3924,5754,0,0,0,0,1,1
19356,40,3925,1922;5769;11854,0,0,0,2,1,3
19357,40,3928,5771;6143;10913,0,0,0,3,0,3
19358,40,3929,6147,0,0,0,1,0,1
19359,40,3930,3750;6306;11555,0,0,0,3,0,3
19360,40,3932,7011;9303,0,0,0,0,2,2
19361,40,3935,7253;9154,0,0,0,0,2,2
19362,40,3937,4885;7904,0,0,0,0,2,2
19363,40,3938,6703,0,0,0,0,1,1
19364,40,3939,8096,0,0,0,0,1,1
19365,40,3943,6985;8378;11393;11722,0,0,0,4,0,4
19366,40,3947,5801;8851,0,0,0,0,2,2
19367,40,3948,8890;10571,0,0,0,1,1,2
19368,40,3949,8983,0,0,0,0,1,1
19369,40,3953,7529;9328,0,0,0,1,1,2
19370,40,3954,8870;9347,0,0,0,0,2,2
19371,40,3956,2282;9811,0,0,0,0,2,2
19372,40,3958,5653,0,0,0,0,1,1
19373,40,3959,4667;7129,0,0,0,0,2,2
19374,40,3960,1065;3338,365,0,0,2,0,2
19375,40,3963,534,365,0,0,1,0,1
19376,40,3966,1075,365,0,0,0,1,1
19377,40,3968,787;12313,365,0,0,2,0,2
19378,40,3969,875,365,0,0,0,1,1
19379,40,3970,1014;8026,365,0,0,1,1,2
19380,40,3971,1054;8368,365,0,0,0,2,2
19381,40,3973,1346,365,0,0,0,1,1
19382,40,3976,738;4524,365,0,0,0,2,2
19383,40,3978,2219;6446,365,0,0,0,2,2
19384,40,3979,1699;7926;12257,365,0,0,3,0,3
19385,40,3980,1317;1745,365,0,0,2,0,2
19386,40,3982,4927;9021,365,0,0,2,0,2
19387,40,3985,2308,365,0,0,0,1,1
19388,40,3986,224;2407,365,0,0,0,2,2
19389,40,3987,2451;9480;11390,365,0,0,2,1,3
19390,40,3988,2468,365,0,0,1,0,1
19391,40,3989,2490,365,0,0,0,1,1
19392,40,3990,2612;6130,365,0,0,0,2,2
19393,40,3991,1023,365,0,0,1,0,1
19394,40,3994,3586;4917,365,0,0,2,0,2
19395,40,4000,7768,365,0,0,0,1,1
19396,40,4002,1318;3468;10514,365,0,0,3,0,3
19397,40,4005,2141;5085,365,0,0,2,0,2
19398,40,4008,5132;9871,365,0,0,0,2,2
19399,40,4009,8455,365,0,0,1,0,1
19400,40,4013,1950;5587,365,0,0,0,2,2
19401,40,4014,5691;9642;11960;12341,365,0,0,4,0,4
19402,40,4015,5757;6067,365,0,0,1,1,2
19403,40,4016,860,365,0,0,0,1,1
19404,40,4017,6077;9716,365,0,0,0,2,2
19405,40,4020,6281;7836;10240;12010,365,0,0,4,0,4
19406,40,4023,1896;1899,365,0,0,0,2,2
19407,40,4025,6533,365,0,0,0,1,1
19408,40,4027,299;5671,365,0,0,0,2,2
19409,40,4029,2070;6863;12104,365,0,0,3,0,3
19410,40,4030,5360,365,0,0,0,1,1
19411,40,4031,4554;7058,365,0,0,1,1,2
19412,40,4032,40;7071,365,0,0,0,2,2
19413,40,4033,1681;8114,365,0,0,0,2,2
19414,40,4037,7547;7751,365,0,0,0,2,2
19415,40,4039,9939,365,0,0,0,1,1
19416,40,4040,2930;8249;11915,365,0,0,3,0,3
19417,40,4041,6769;7871,365,0,0,2,0,2
19418,40,4042,5370;8089,365,0,0,0,2,2
19419,40,4044,8304;8860,365,0,0,0,2,2
19420,40,4054,1556;9326,365,0,0,0,2,2
19421,40,4056,1617;9538,365,0,0,0,2,2
19422,40,4058,9559,365,0,0,0,1,1
19423,40,4060,2606;6330;11495;12466,365,0,0,4,0,4
19424,40,4061,178;9790,365,0,0,2,0,2
19425,40,4062,590;9825,365,0,0,2,0,2
19426,40,4063,1634;7849;10655,365,0,0,3,0,3
19427,40,4065,5878;9948,365,0,0,1,1,2
19428,40,4066,8756,730,0,0,1,0,1
19429,40,4067,45;5438,730,0,0,2,0,2
19430,40,4072,302;5123,730,0,0,0,2,2
19431,40,4074,2525,730,0,0,0,1,1
19432,40,4076,3811;5525;11324;11624,730,0,0,4,0,4
19433,40,4077,578;705,730,0,0,2,0,2
19434,40,4078,792;7539,730,0,0,2,0,2
19435,40,4080,4985,730,0,0,0,1,1
19436,40,4082,973;8946,730,0,0,0,2,2
19437,40,4083,3322,730,0,0,0,1,1
19438,40,4084,4197;10710,730,0,0,2,0,2
19439,40,4085,1246;9449,730,0,0,2,0,2
19440,40,4087,1523,730,0,0,0,1,1
19441,40,4088,1688,730,0,0,0,1,1
19442,40,4089,1728,730,0,0,0,1,1
19443,40,4090,3785;6917,730,0,0,0,2,2
19444,40,4091,5280,730,0,0,0,1,1
19445,40,4095,8801;9996,730,0,0,0,2,2
19446,40,4099,2663;5877,730,0,0,0,2,2
19447,40,4101,2743,730,0,0,0,1,1
19448,40,4102,2825;9500,730,0,0,2,0,2
19449,40,4104,1209;2879,730,0,0,0,2,2
19450,40,4105,3143,730,0,0,0,1,1
19451,40,4108,593;3354,730,0,0,0,2,2
19452,40,4109,4399,730,0,0,1,0,1
19453,40,4110,78;6164,730,0,0,2,0,2
19454,40,4112,3549,730,0,0,0,1,1
19455,40,4116,3868,730,0,0,0,1,1
19456,40,4117,702;3878,730,0,0,0,2,2
19457,40,4119,4115,730,0,0,0,1,1
19458,40,4121,4384;5605,730,0,0,2,0,2
19459,40,4124,5546;10826,730,0,0,2,0,2
19460,40,4125,4539,730,0,0,0,1,1
19461,40,4128,7587;8925,730,0,0,0,2,2
19462,40,4129,4485;4761,730,0,0,0,2,2
19463,40,4133,4648;4923,730,0,0,0,2,2
19464,40,4138,5305,730,0,0,0,1,1
19465,40,4140,1205;5362,730,0,0,0,2,2
19466,40,4141,5411,730,0,0,0,1,1
19467,40,4143,8434,730,0,0,0,1,1
19468,40,4145,3829;5640,730,0,0,0,2,2
19469,40,4148,2850,730,0,0,0,1,1
19470,40,4149,9428,730,0,0,1,0,1
19471,40,4150,7236,730,0,0,1,0,1
19472,40,4153,3700;7077,730,0,0,2,0,2
19473,40,4154,3069;6454,730,0,0,2,0,2
19474,40,4155,1741;7353;12572,730,0,1,2,0,3
19475,40,4156,2576;3291,730,0,0,2,0,2
19476,40,4158,4381;8997;12112,730,0,0,3,0,3
19477,40,4159,7249,730,0,0,0,1,1
19478,40,4160,329;7367,730,0,0,2,0,2
19479,40,4162,5571;7722;11951;12406,730,0,0,4,0,4
19480,40,4163,35;7857,730,0,0,0,2,2
19481,40,4166,6452,730,0,0,1,0,1
19482,40,4168,4600;8252,730,0,0,2,0,2
19483,40,4169,8374,730,0,0,0,1,1
19484,40,4173,5451;8595,730,0,0,2,0,2
19485,40,4175,8929,730,0,0,0,1,1
19486,40,4176,8730;8937,730,0,0,0,2,2
19487,40,4181,1920,730,0,0,0,1,1
19488,40,4186,5918;9786,730,0,0,2,0,2
19489,40,4188,5212;9944,730,0,0,1,1,2
19490,40,4189,7425,1095,0,0,0,1,1
19491,40,4190,12;6735,1095,0,0,2,0,2
19492,40,4192,176,1095,0,0,0,1,1
19493,40,4195,296;6278,1095,0,0,2,0,2
19494,40,4197,9145;12107,1095,0,0,2,0,2
19495,40,4198,8992,1095,0,0,0,1,1
19496,40,4199,9351,1095,0,0,1,0,1
19497,40,4200,517;1250,1095,0,0,2,0,2
19498,40,4201,628,1095,0,0,0,1,1
19499,40,4203,1187,1095,0,0,0,1,1
19500,40,4204,5699;8276,1095,0,0,2,0,2
19501,40,4205,7567;8744;12054,1095,0,0,3,0,3
19502,40,4207,1099;4046;12228,1095,0,0,3,0,3
19503,40,4208,1514,1095,0,0,0,1,1
19504,40,4209,4207,1095,0,0,0,1,1
19505,40,4215,1980;6447,1095,0,0,0,2,2
19506,40,4218,3971,1095,0,0,0,1,1
19507,40,4219,1009,1095,0,0,0,1,1
19508,40,4220,2156;4500,1095,0,0,2,0,2
19509,40,4221,2171;2427,1095,0,0,0,2,2
19510,40,4222,844;2591,1095,0,0,0,2,2
19511,40,4223,2417;2655;11977;13062,1095,0,1,3,0,4
19512,40,4227,3044,1095,0,0,0,1,1
19513,40,4228,3165;4045;12277,1095,0,0,3,0,3
19514,40,4229,9097,1095,0,0,1,0,1
19515,40,4230,205;3377;10373,1095,0,0,3,0,3
19516,40,4233,1207;3540;11508,1095,0,0,3,0,3
19517,40,4234,3625;8771,1095,0,0,0,2,2
19518,40,4236,4559;6458;11046,1095,0,0,3,0,3
19519,40,4239,4048;6224,1095,0,0,0,2,2
19520,40,4240,7569;11680,1095,0,0,2,0,2
19521,40,4242,2059;11575,1095,0,0,2,0,2
19522,40,4243,1116;4274,1095,0,0,2,0,2
19523,40,4244,4336,1095,0,0,1,0,1
19524,40,4248,4528;4874;11659,1095,0,0,3,0,3
19525,40,4250,4626,1095,0,0,0,1,1
19526,40,4251,4762;6396,1095,0,0,0,2,2
19527,40,4252,4802,1095,0,0,0,1,1
19528,40,4253,2995;4898;11534;11702,1095,0,0,4,0,4
19529,40,4254,3062;4954,1095,0,0,2,0,2
19530,40,4255,236;5420,1095,0,0,2,0,2
19531,40,4257,467;5017;10556,1095,0,0,3,0,3
19532,40,4263,2179;11562;12021;12600,1095,0,1,3,0,4
19533,40,4266,4510;5573;13313,1095,0,1,2,0,3
19534,40,4268,3812;9390;10929,1095,0,0,3,0,3
19535,40,4272,6721,1095,0,0,0,1,1
19536,40,4276,3038;6588,1095,0,0,0,2,2
19537,40,4282,7213,1095,0,0,0,1,1
19538,40,4283,1071;7318,1095,0,0,0,2,2
19539,40,4286,6481,1095,0,0,1,0,1
19540,40,4288,2281,1095,0,0,0,1,1
19541,40,4289,11984,1095,0,0,1,0,1
19542,40,4290,6390;12429,1095,0,0,2,0,2
19543,40,4292,1235;7882;10823;11193;12206,1095,0,0,5,0,5
19544,40,4296,4209;8277,1095,0,0,2,0,2
19545,40,4297,8284;11917,1095,0,0,2,0,2
19546,40,4298,6246;8469,1095,0,0,2,0,2
19547,40,4301,8596,1095,0,0,1,0,1
19548,40,4303,1372;4505,1095,0,0,2,0,2
19549,40,4304,951;6626;12232,1095,0,0,3,0,3
19550,40,4305,36;8859;12148;12451,1095,0,0,4,0,4
19551,40,4306,2279;8902,1095,0,0,2,0,2
19552,40,4307,3583,1095,0,0,0,1,1
19553,40,4309,9830,1095,0,0,0,1,1
19554,40,4312,4533;9600,1095,0,0,0,2,2
19555,40,4314,9700,1095,0,0,0,1,1
19556,40,4315,9777,1095,0,0,1,0,1
19557,40,4317,6595;9882,1095,0,0,2,0,2
19558,40,4318,7601;9898,1095,0,0,2,0,2
19559,40,4319,4605;9910,1095,0,0,0,2,2
19560,40,4321,158;8211,1460,0,0,2,0,2
19561,40,4322,7497;10738,1460,0,0,2,0,2
19562,40,4324,336;9831,1460,0,0,0,2,2
19563,40,4328,1925;9017;12619,1460,0,1,2,0,3
19564,40,4336,1055;1212;12253,1460,0,0,3,0,3
19565,40,4337,5871;8306,1460,0,0,2,0,2
19566,40,4338,1230;6819,1460,0,0,2,0,2
19567,40,4339,1251;7466,1460,0,0,2,0,2
19568,40,4342,1447;3895,1460,0,0,2,0,2
19569,40,4344,1603;4770,1460,0,0,2,0,2
19570,40,4345,1732,1460,0,0,1,0,1
19571,40,4348,2723,1460,0,0,1,0,1
19572,40,4352,2355;3239,1460,0,0,2,0,2
19573,40,4353,2380,1460,0,0,0,1,1
19574,40,4354,929;2766;13578,1460,0,1,2,0,3
19575,40,4358,2744,1460,0,0,0,1,1
19576,40,4362,8315,1460,0,0,0,1,1
19577,40,4364,3432;11012,1460,0,0,2,0,2
19578,40,4365,2892;3639;11794,1460,0,0,3,0,3
19579,40,4366,3548;5906,1460,0,0,1,1,2
19580,40,4369,3944;5603,1460,0,0,2,0,2
19581,40,4371,7;9645;12209,1460,0,0,3,0,3
19582,40,4373,3985,1460,0,0,1,0,1
19583,40,4375,4005,1460,0,0,0,1,1
19584,40,4376,5977,1460,0,0,0,1,1
19585,40,4379,4827;9455;12028,1460,0,0,3,0,3
19586,40,4381,2030,1460,0,0,0,1,1
19587,40,4382,8516;11653,1460,0,0,2,0,2
19588,40,4383,8425,1460,0,0,1,0,1
19589,40,4385,4030;7019,1460,0,0,2,0,2
19590,40,4386,643;7925,1460,0,0,2,0,2
19591,40,4387,1487;6326,1460,0,0,0,2,2
19592,40,4389,5542;5562,1460,0,0,0,2,2
19593,40,4390,3597;5695,1460,0,0,0,2,2
19594,40,4391,5811;9257,1460,0,0,2,0,2
19595,40,4392,6038;6516,1460,0,0,0,2,2
19596,40,4394,864;8985,1460,0,0,2,0,2
19597,40,4395,2765;6308;12526,1460,0,1,2,0,3
19598,40,4397,6334;9169,1460,0,0,2,0,2
19599,40,4399,6406;8168,1460,0,0,2,0,2
19600,40,4401,6493;12312;12587,1460,0,1,2,0,3
19601,40,4404,2922;4942,1460,0,0,0,2,2
19602,40,4406,6854;9196,1460,0,0,2,0,2
19603,40,4409,6993;7852,1460,0,0,0,2,2
19604,40,4410,4916,1460,0,0,0,1,1
19605,40,4411,4318;7066,1460,0,0,1,1,2
19606,40,4412,1740,1460,0,0,0,1,1
19607,40,4413,6710,1460,0,0,0,1,1
19608,40,4414,7274;9495,1460,0,0,0,2,2
19609,40,4415,1376;8123;12564,1460,0,1,2,0,3
19610,40,4416,5970;12048,1460,0,0,2,0,2
19611,40,4418,9119,1460,0,0,0,1,1
19612,40,4419,2628;7534,1460,0,0,2,0,2
19613,40,4420,360;7603,1460,0,0,2,0,2
19614,40,4421,1548;4949;12248;12427,1460,0,0,4,0,4
19615,40,4422,3922;6191,1460,0,0,2,0,2
19616,40,4423,4170;7692,1460,0,0,2,0,2
19617,40,4425,3157;7834,1460,0,0,0,2,2
19618,40,4426,7838;8120;11333,1460,0,0,2,1,3
19619,40,4427,2750;5248;11315;11603,1460,0,0,4,0,4
19620,40,4429,1383;8401,1460,0,0,0,2,2
19621,40,4432,979;8262,1460,0,0,0,2,2
19622,40,4433,2414;8399,1460,0,0,0,2,2
19623,40,4434,202,1460,0,0,0,1,1
19624,40,4435,8729,1460,0,0,0,1,1
19625,40,4436,583;8830,1460,0,0,2,0,2
19626,40,4437,797;8843,1460,0,0,1,1,2
19627,40,4438,5982;8904;12605,1460,0,1,2,0,3
19628,40,4440,9159;9243,1460,0,0,0,2,2
19629,40,4441,5261;6781;11820,1460,0,0,3,0,3
19630,40,4443,8546;9544,1460,0,0,0,2,2
19631,40,4447,679;870;11600;11708,1460,0,0,4,0,4
19632,40,4448,9401;9963,1460,0,0,2,0,2
19633,40,4449,183;9947,1825,0,0,2,0,2
19634,40,4450,271;6489,1825,0,0,2,0,2
19635,40,4451,430;8332,1825,0,0,2,0,2
19636,40,4453,752;3493;11335,1825,0,0,3,0,3
19637,40,4454,1006;3563,1825,0,0,0,2,2
19638,40,4455,355;12134,1825,0,0,2,0,2
19639,40,4457,6920;9078,1825,0,0,2,0,2
19640,40,4458,1169;8331;11793;12924,1825,0,1,3,0,4
19641,40,4459,356;4398,1825,0,0,2,0,2
19642,40,4460,1546,1825,0,0,0,1,1
19643,40,4461,1769,1825,0,0,1,0,1
19644,40,4462,1836;4116,1825,0,0,0,2,2
19645,40,4464,1988,1825,0,0,0,1,1
19646,40,4469,609,1825,0,0,0,1,1
19647,40,4471,2864;3674,1825,0,0,2,0,2
19648,40,4472,3004;4015;12381,1825,0,0,3,0,3
19649,40,4474,1263;6285;12647,1825,0,1,2,0,3
19650,40,4475,2935;3544,1825,0,0,0,2,2
19651,40,4482,4178;4444,1825,0,0,0,2,2
19652,40,4483,1936;6197,1825,0,0,2,0,2
19653,40,4485,732,1825,0,0,0,1,1
19654,40,4487,4506;6064,1825,0,0,2,0,2
19655,40,4489,8087;11625,1825,0,0,2,0,2
19656,40,4491,2687;4823,1825,0,0,0,2,2
19657,40,4493,4939;9207,1825,0,0,1,1,2
19658,40,4494,3259;5419;12377;12822,1825,0,1,3,0,4
19659,40,4499,8392,1825,0,0,0,1,1
19660,40,4500,3695;5617;11974,1825,0,0,3,0,3
19661,40,4501,5636;6259,1825,0,0,0,2,2
19662,40,4502,5715;7801;12633,1825,0,1,2,0,3
19663,40,4503,8741;11979;12244,1825,0,0,3,0,3
19664,40,4504,5774;9357,1825,0,0,2,0,2
19665,40,4507,5949;9015,1825,0,0,2,0,2
19666,40,4508,6001;7585,1825,0,0,2,0,2
19667,40,4510,6211,1825,0,0,1,0,1
19668,40,4511,6213;7412,1825,0,0,0,2,2
19669,40,4515,6239;6602;11733,1825,0,0,3,0,3
19670,40,4519,1332,1825,0,0,1,0,1
19671,40,4520,7235;9930;11194,1825,0,0,3,0,3
19672,40,4523,6354;7508;13527;13833,1825,0,2,2,0,4
19673,40,4525,203;7683;11414;11605,1825,0,0,4,0,4
19674,40,4526,6689;7691,1825,0,0,2,0,2
19675,40,4527,6782;11367,1825,0,0,2,0,2
19676,40,4528,7989,1825,0,0,1,0,1
19677,40,4531,3522,1825,0,0,0,1,1
19678,40,4536,1213;11715;12081,1825,0,0,3,0,3
19679,40,4537,8543;11241,1825,0,0,2,0,2
19680,40,4538,3397;8617,1825,0,0,2,0,2
19681,40,4539,1216;8680;11724,1825,0,0,3,0,3
19682,40,4541,3539;6953,1825,0,0,2,0,2
19683,40,4542,10;8092,1825,0,0,2,0,2
19684,40,4544,706;3672;11682,1825,0,0,3,0,3
19685,40,4546,1123;9187;11959,1825,0,0,3,0,3
19686,40,4548,3865;5613,1825,0,0,2,0,2
19687,40,4550,3218,1825,0,0,1,0,1
19688,40,4553,9955,1825,0,0,0,1,1
19689,40,4554,6453;8466,1825,0,0,2,0,2
19690,40,4555,6394;9329,1825,0,0,0,2,2
19691,40,4557,3374;5159;9519;10875;12470,2190,0,0,5,0,5
19692,40,4558,2741;11649,2190,0,0,2,0,2
19693,40,4560,3449;3518;11516;11903;12540,2190,0,1,4,0,5
19694,40,4562,7404;12421;12907,2190,0,1,2,0,3
19695,40,4564,773;1814,2190,0,0,2,0,2
19696,40,4567,1151;11949,2190,0,0,2,0,2
19697,40,4568,3419,2190,0,0,1,0,1
19698,40,4569,561;1776,2190,0,0,2,0,2
19699,40,4570,1873;7659,2190,0,0,0,2,2
19700,40,4571,5189,2190,0,0,0,1,1
19701,40,4572,1962;5554,2190,0,0,2,0,2
19702,40,4573,2007;3758;11813;12551,2190,0,1,3,0,4
19703,40,4574,707,2190,0,0,0,1,1
19704,40,4576,603;3012;11781,2190,0,0,3,0,3
19705,40,4577,642,2190,0,0,1,0,1
19706,40,4579,2742;5939;12611;13114,2190,0,2,2,0,4
19707,40,4581,2949;3960,2190,0,0,2,0,2
19708,40,4582,2971;4061;12187,2190,0,0,3,0,3
19709,40,4583,10001,2190,0,0,0,1,1
19710,40,4586,3174;3931;11146,2190,0,0,1,2,3
19711,40,4587,3355;8456;12295,2190,0,0,3,0,3
19712,40,4588,3467,2190,0,0,1,0,1
19713,40,4589,3167,2190,0,0,0,1,1
19714,40,4592,3740;6788,2190,0,0,0,2,2
19715,40,4594,3066;5865,2190,0,0,0,2,2
19716,40,4595,2998,2190,0,0,0,1,1
19717,40,4596,3962;9721;11765,2190,0,0,3,0,3
19718,40,4599,3128,2190,0,0,0,1,1
19719,40,4602,4373;8806,2190,0,0,2,0,2
19720,40,4603,5616;9221;11858,2190,0,0,3,0,3
19721,40,4604,3621;7704;11893;12328,2190,0,0,4,0,4
19722,40,4605,64;4486,2190,0,0,2,0,2
19723,40,4606,4511;8561;12724,2190,0,1,2,0,3
19724,40,4607,1032;4527;12780,2190,0,1,2,0,3
19725,40,4609,3402;4735;11258,2190,0,0,3,0,3
19726,40,4610,3869;4888,2190,0,0,2,0,2
19727,40,4612,9628,2190,0,0,0,1,1
19728,40,4613,5269,2190,0,0,0,1,1
19729,40,4618,903;6544,2190,0,0,2,0,2
19730,40,4619,3644,2190,0,0,0,1,1
19731,40,4620,1238;5849;12681,2190,0,1,2,0,3
19732,40,4622,5905;8226,2190,0,0,2,0,2
19733,40,4623,5799;6074,2190,0,0,2,0,2
19734,40,4624,1074;6170,2190,0,0,2,0,2
19735,40,4625,6311,2190,0,0,1,0,1
19736,40,4626,1165,2190,0,0,1,0,1
19737,40,4628,9909,2190,0,0,0,1,1
19738,40,4629,2178;6968,2190,0,0,1,1,2
19739,40,4632,7047,2190,0,0,0,1,1
19740,40,4634,7141,2190,0,0,1,0,1
19741,40,4635,3193;7238;10944;11775,2190,0,0,4,0,4
19742,40,4638,2208;7844;11748,2190,0,0,1,2,3
19743,40,4641,3813,2190,0,0,1,0,1
19744,40,4642,15,2190,0,0,0,1,1
19745,40,4644,4553;7723;12456;13572,2190,0,1,3,0,4
19746,40,4646,2010;8470,2190,0,0,2,0,2
19747,40,4647,7180;8492,2190,0,0,2,0,2
19748,40,4648,8604;9232,2190,0,0,2,0,2
19749,40,4650,8707,2190,0,0,0,1,1
19750,40,4651,2679,2190,0,0,0,1,1
19751,40,4652,3708;8797;11279;11918,2190,0,0,4,0,4
19752,40,4655,8083;9112,2190,0,0,2,0,2
19753,40,4658,2559;9424;12074;12146;12615;13073,2190,0,2,4,0,6
19754,40,4659,873;9510,2190,0,0,2,0,2
19755,40,4660,3160,2190,0,0,0,1,1
19756,40,4662,9727;12095,2190,0,0,2,0,2
19757,40,4663,513;9817;11647,2190,0,0,3,0,3
19758,40,4664,8230;9202,2190,0,0,0,2,2
19759,40,4666,179;3387,2555,0,0,2,0,2
19760,40,4668,1584;3463;12417,2555,0,0,3,0,3
19761,40,4669,1386;6111;12039,2555,0,0,3,0,3
19762,40,4671,6070,2555,0,0,1,0,1
19763,40,4673,7899;9165,2555,0,0,2,0,2
19764,40,4677,1824;2840;11001,2555,0,0,3,0,3
19765,40,4678,2306,2555,0,0,0,1,1
19766,40,4679,5086,2555,0,0,1,0,1
19767,40,4680,1910;4965,2555,0,0,0,2,2
19768,40,4681,1957;9812,2555,0,0,0,2,2
19769,40,4683,2345;4027,2555,0,0,0,2,2
19770,40,4684,2436,2555,0,0,0,1,1
19771,40,4686,5025;7418;12097,2555,0,0,3,0,3
19772,40,4689,2901;8853,2555,0,0,2,0,2
19773,40,4694,3407;8977;12819;12947,2555,0,2,2,0,4
19774,40,4695,1861;3567,2555,0,0,0,2,2
19775,40,4700,3491;3847,2555,0,0,0,2,2
19776,40,4701,932;3879;11175;13215,2555,0,1,3,0,4
19777,40,4702,4035;9189,2555,0,0,2,0,2
19778,40,4703,110;7808,2555,0,0,2,0,2
19779,40,4705,4111;8070,2555,0,0,0,2,2
19780,40,4707,4149;4628;11899,2555,0,0,3,0,3
19781,40,4708,3362;4694,2555,0,0,2,0,2
19782,40,4709,5328;8674;11632,2555,0,0,3,0,3
19783,40,4712,8189,2555,0,0,0,1,1
19784,40,4713,1068;4891,2555,0,0,0,2,2
19785,40,4719,5133;7928;11861,2555,0,0,3,0,3
19786,40,4721,5289;9564,2555,0,0,0,2,2
19787,40,4722,5319,2555,0,0,0,1,1
19788,40,4725,4978;5547,2555,0,0,2,0,2
19789,40,4728,733;5843,2555,0,0,0,2,2
19790,40,4729,5870;8396;13193,2555,0,1,2,0,3
19791,40,4730,2787;6036;12055,2555,0,0,3,0,3
19792,40,4731,6139;9138,2555,0,0,2,0,2
19793,40,4732,1122,2555,0,0,1,0,1
19794,40,4733,5134;6184,2555,0,0,2,0,2
19795,40,4734,6187;9799;11777,2555,0,0,3,0,3
19796,40,4735,6313;8589;12695,2555,0,1,2,0,3
19797,40,4736,6318;9951;11819,2555,0,0,3,0,3
19798,40,4740,6973,2555,0,0,1,0,1
19799,40,4741,4051;6999;12025,2555,0,0,3,0,3
19800,40,4742,2891;11264;12719,2555,0,1,2,0,3
19801,40,4745,404;8822;12260;12932,2555,0,1,3,0,4
19802,40,4746,7574;8148,2555,0,0,0,2,2
19803,40,4747,7151;7276;13224,2555,0,1,2,0,3
19804,40,4749,490;7776;11574;11866;12035;12154,2555,0,0,6,0,6
19805,40,4750,2418;7867,2555,0,0,2,0,2
19806,40,4751,8388;9843;12094,2555,0,0,3,0,3
19807,40,4753,2232;8642;11669;12918;14033,2555,0,2,3,0,5
19808,40,4755,8128,2555,0,0,0,1,1
19809,40,4756,7461;8144;12522,2555,0,1,2,0,3
19810,40,4757,6464;8268,2555,0,0,2,0,2
19811,40,4759,3022;9995;11352,2555,0,0,1,2,3
19812,40,4760,2058;8376,2555,0,0,2,0,2
19813,40,4762,8560,2555,0,0,1,0,1
19814,40,4763,8712;9998;11916;12639,2555,0,1,3,0,4
19815,40,4765,4073,2555,0,0,1,0,1
19816,40,4766,6723,2555,0,0,0,1,1
19817,40,4767,3381;8893;11337;11874,2555,0,0,4,0,4
19818,40,4769,6526;8966,2555,0,0,2,0,2
19819,40,4770,9246;9392;12359;13035,2555,0,1,3,0,4
19820,40,4773,2580;4543;12249,2555,0,0,3,0,3
19821,40,4774,6006;8781,2555,0,0,1,1,2
19822,40,4775,7913;9687,2555,0,0,2,0,2
19823,40,4776,9762,2555,0,0,1,0,1
19824,40,4777,8675;9837,2555,0,0,2,0,2
19825,40,4779,54;4449;11089;12215,2920,0,0,4,0,4
19826,40,4781,147;4668,2920,0,0,2,0,2
19827,40,4783,2837,2920,0,0,0,1,1
19828,40,4785,475;2092;12337;12845,2920,0,1,3,0,4
19829,40,4786,537;5063;12184;12602;12755,2920,0,2,3,0,5
19830,40,4787,5429,2920,0,0,0,1,1
19831,40,4793,4103;11735;12083,2920,0,0,3,0,3
19832,40,4794,2656;9045;12661,2920,0,1,2,0,3
19833,40,4800,1653;8619,2920,0,0,2,0,2
19834,40,4801,1882,2920,0,0,1,0,1
19835,40,4803,1935;6581,2920,0,0,2,0,2
19836,40,4804,2091;8628,2920,0,0,2,0,2
19837,40,4805,2500,2920,0,0,1,0,1
19838,40,4806,4094,2920,0,0,0,1,1
19839,40,4807,1217;7525;11580;12584,2920,0,1,3,0,4
19840,40,4808,7553,2920,0,0,1,0,1
19841,40,4809,4953;8177,2920,0,0,2,0,2
19842,40,4810,2717;6094,2920,0,0,0,2,2
19843,40,4811,1010;1575;11540;12595,2920,0,1,3,0,4
19844,40,4816,2798;3116;12863,2920,0,1,2,0,3
19845,40,4817,3173;6554;11633;12168;12436;13314,2920,0,1,5,0,6
19846,40,4818,1784,2920,0,0,0,1,1
19847,40,4819,3277;3860;12315;13261,2920,0,1,3,0,4
19848,40,4820,2033;4950;12546,2920,0,1,2,0,3
19849,40,4821,7874;8740,2920,0,0,2,0,2
19850,40,4822,2001;3486,2920,0,0,0,2,2
19851,40,4823,3523;7488;12172;13032,2920,0,1,3,0,4
19852,40,4824,686;3566,2920,0,0,2,0,2
19853,40,4826,3754,2920,0,0,0,1,1
19854,40,4827,3772;9603,2920,0,0,0,2,2
19855,40,4832,4102;8169,2920,0,0,2,0,2
19856,40,4834,4280;11785,2920,0,0,2,0,2
19857,40,4835,4293;5737;11905,2920,0,0,3,0,3
19858,40,4836,4509;9739;12476;12678;13118,2920,0,2,3,0,5
19859,40,4837,6420;8375;13177,2920,0,1,2,0,3
19860,40,4838,4619;9208,2920,0,0,2,0,2
19861,40,4839,3675;6971,2920,0,0,2,0,2
19862,40,4841,4795;8125,2920,0,0,0,2,2
19863,40,4843,7732;8629;10917;11518;11782;11814;12418,2920,0,0,7,0,7
19864,40,4844,5073,2920,0,0,0,1,1
19865,40,4845,1652;5181;11501;12002,2920,0,0,4,0,4
19866,40,4847,4009;5286,2920,0,0,0,2,2
19867,40,4849,5366;7185,2920,0,0,2,0,2
19868,40,4850,1788;5410;11846;12173,2920,0,0,4,0,4
19869,40,4851,5443,2920,0,0,1,0,1
19870,40,4852,8050,2920,0,0,1,0,1
19871,40,4856,6194;10998,2920,0,0,1,1,2
19872,40,4858,6405;12303,2920,0,0,2,0,2
19873,40,4859,6434;7690,2920,0,0,2,0,2
19874,40,4861,3749;9417;12509;12923,2920,0,2,2,0,4
19875,40,4862,6696;9352,2920,0,0,2,0,2
19876,40,4864,6751;7503,2920,0,0,2,0,2
19877,40,4866,1974,2920,0,0,1,0,1
19878,40,4868,3531;7403,2920,0,0,2,0,2
19879,40,4871,1157;1328;12856,2920,0,1,2,0,3
19880,40,4872,5679;7733;12275,2920,0,0,3,0,3
19881,40,4875,397;7992;11698,2920,0,0,3,0,3
19882,40,4876,6827;8043,2920,0,0,1,1,2
19883,40,4877,6774;8317;11756;11987,2920,0,0,4,0,4
19884,40,4879,3633;3709;12276;12416,2920,0,0,4,0,4
19885,40,4880,8228,2920,0,0,0,1,1
19886,40,4881,974;8344,2920,0,0,0,2,2
19887,40,4882,4924;13125,2920,0,1,1,0,2
19888,40,4883,6995;8502;11178;11908,2920,0,0,4,0,4
19889,40,4885,2800;8514;12004,2920,0,0,3,0,3
19890,40,4886,4022;8568,2920,0,0,2,0,2
19891,40,4887,5278;8573,2920,0,0,2,0,2
19892,40,4888,8283;8584,2920,0,0,2,0,2
19893,40,4889,5606;8623;11818,2920,0,0,3,0,3
19894,40,4893,8823;12954,2920,0,1,1,0,2
19895,40,4894,8552;9378;12321,2920,0,0,3,0,3
19896,40,4895,6845;9068;12607;13352,2920,0,2,2,0,4
19897,40,4896,7901;9088,2920,0,0,0,2,2
19898,40,4897,9174,2920,0,0,0,1,1
19899,40,4901,3698;8122;12182;12390;12683,2920,0,1,4,0,5
19900,40,4902,1640;6158;12360,2920,0,0,3,0,3
19901,40,4903,4348,2920,0,0,0,1,1
19902,40,4906,1115;5024;12349;12903,2920,0,1,3,0,4
19903,40,4907,6661;8270;11666,2920,0,0,3,0,3
19904,40,4908,7245,2920,0,0,0,1,1
19905,40,4909,3092;7409,2920,0,0,0,2,2
19906,40,4911,153;4308;11056;12523,3285,0,1,3,0,4
19907,40,4912,959;3315;12884,3285,0,1,2,0,3
19908,40,4913,4499;9684;11310;11553,3285,0,0,4,0,4
19909,40,4914,4586;6981;11604,3285,0,0,3,0,3
19910,40,4916,286;7261,3285,0,0,0,2,2
19911,40,4918,349;3748;11202,3285,0,0,3,0,3
19912,40,4921,75;159;11864,3285,0,0,3,0,3
19913,40,4923,630;1344;11118;12798,3285,0,1,3,0,4
19914,40,4927,536;853,3285,0,0,2,0,2
19915,40,4928,3343,3285,0,0,0,1,1
19916,40,4930,6743;9041;12178;12941,3285,0,1,3,0,4
19917,40,4931,1153,3285,0,0,0,1,1
19918,40,4932,1296,3285,0,0,1,0,1
19919,40,4933,293;4548,3285,0,0,2,0,2
19920,40,4934,1340,3285,0,0,0,1,1
19921,40,4935,8688;9588,3285,0,0,2,0,2
19922,40,4937,1561;6028,3285,0,0,0,2,2
19923,40,4938,2433;3802;11998;12258,3285,0,0,4,0,4
19924,40,4939,1900,3285,0,0,0,1,1
19925,40,4940,4043;7744;12333,3285,0,0,3,0,3
19926,40,4941,2843;11293;11891,3285,0,0,3,0,3
19927,40,4944,2120,3285,0,0,0,1,1
19928,40,4945,2189;3717;11171;11803,3285,0,0,4,0,4
19929,40,4947,2462;3469;12262,3285,0,0,3,0,3
19930,40,4950,2670;11857,3285,0,0,2,0,2
19931,40,4951,2817;3850;12590,3285,0,1,2,0,3
19932,40,4952,5099,3285,0,0,0,1,1
19933,40,4953,4457,3285,0,0,0,1,1
19934,40,4956,3560;8099,3285,0,0,2,0,2
19935,40,4957,3596,3285,0,0,0,1,1
19936,40,4958,9819;11517,3285,0,0,2,0,2
19937,40,4963,239;3976;11076;11568,3285,0,0,4,0,4
19938,40,4965,4961,3285,0,0,0,1,1
19939,40,4967,4259;7330,3285,0,0,2,0,2
19940,40,4968,4416;8022,3285,0,0,0,2,2
19941,40,4969,4637;7679;12121,3285,0,0,3,0,3
19942,40,4972,4165;5044;12123;13188,3285,0,1,3,0,4
19943,40,4974,2014;5296;12713;12770,3285,0,2,2,0,4
19944,40,4978,5702;5780,3285,0,0,0,2,2
19945,40,4979,5708,3285,0,0,0,1,1
19946,40,4981,74;7275;12181,3285,0,0,3,0,3
19947,40,4983,2289,3285,0,0,1,0,1
19948,40,4984,6126,3285,0,0,0,1,1
19949,40,4987,5692;6188;12507;13024,3285,0,2,2,0,4
19950,40,4989,1525;9188;12133;12355,3285,0,0,4,0,4
19951,40,4992,6503;8527;12106,3285,0,0,3,0,3
19952,40,4993,6586;12131;12319,3285,0,0,3,0,3
19953,40,4994,6622;9251,3285,0,0,0,2,2
19954,40,4996,8836,3285,0,0,0,1,1
19955,40,4998,5160;7078;12267,3285,0,0,3,0,3
19956,40,5000,240;1692;12403;12801,3285,0,1,3,0,4
19957,40,5002,3117;7332;12442,3285,0,0,3,0,3
19958,40,5003,2594;7343;12679,3285,0,1,2,0,3
19959,40,5004,1572;7357;11792;11936;12127,3285,0,0,5,0,5
19960,40,5005,8229,3285,0,0,0,1,1
19961,40,5006,2508;6701;12311,3285,0,0,3,0,3
19962,40,5007,4873;7872,3285,0,0,2,0,2
19963,40,5010,8759;9665;13074;13368,3285,0,2,2,0,4
19964,40,5011,1609;11953;13151,3285,0,1,2,0,3
19965,40,5015,8318;8814;11968,3285,0,0,3,0,3
19966,40,5016,6736;8815;12709;12992,3285,0,2,2,0,4
19967,40,5017,4737;7966,3285,0,0,0,2,2
19968,40,5018,3833;6948;11435,3285,0,0,3,0,3
19969,40,5019,2681;9008,3285,0,0,2,0,2
19970,40,5020,8899;9114,3285,0,0,2,0,2
19971,40,5022,5031;9596;11671,3285,0,0,3,0,3
19972,40,5023,4034;8592;12210,3285,0,0,3,0,3
19973,40,5025,7627;9787,3285,0,0,2,0,2
19974,40,5029,616;3132;11961;12389;12730,3285,0,1,4,0,5
19975,40,5030,71;1693,3650,0,0,2,0,2
19976,40,5031,146;9032,3650,0,0,2,0,2
19977,40,5033,1252;4400;11357;11561,3650,0,0,4,0,4
19978,40,5034,216;801;12264,3650,0,0,3,0,3
19979,40,5038,116;891,3650,0,0,2,0,2
19980,40,5039,1061,3650,0,0,1,0,1
19981,40,5040,1288;8020;12928;13503,3650,0,2,2,0,4
19982,40,5042,1407;3799,3650,0,0,0,2,2
19983,40,5043,5216;11539,3650,0,0,2,0,2
19984,40,5044,1654;6604,3650,0,0,2,0,2
19985,40,5046,1789;3202,3650,0,0,2,0,2
19986,40,5048,1915,3650,0,0,0,1,1
19987,40,5050,2117;3103;11627;12016;12585,3650,0,1,4,0,5
19988,40,5051,2145;8957,3650,0,0,0,2,2
19989,40,5053,6918;8624;12718,3650,0,1,2,0,3
19990,40,5054,1599;9423;11257;11710;11839;12459;12640,3650,0,1,6,0,7
19991,40,5055,1236;4279;11308;12796;13508,3650,0,2,3,0,5
19992,40,5056,2651;9336;11909;11983,3650,0,0,4,0,4
19993,40,5057,2445;2676,3650,0,0,0,2,2
19994,40,5058,5716;9848,3650,0,0,2,0,2
19995,40,5060,2390;2851,3650,0,0,0,2,2
19996,40,5062,685;3395;11880;12832,3650,0,1,3,0,4
19997,40,5064,2887;5008;11564,3650,0,0,3,0,3
19998,40,5065,1147;3437;13608;13690,3650,0,2,2,0,4
19999,40,5068,2693;3704;11394;12166;12291,3650,0,0,5,0,5
20000,40,5069,1321;8807;12197,3650,0,0,3,0,3
20001,40,5070,584;7203;12256;12592,3650,0,1,3,0,4
20002,40,5072,6295;7391,3650,0,0,2,0,2
20003,40,5074,2053;6012,3650,0,0,1,1,2
20004,40,5075,4129;6108;12586,3650,0,1,2,0,3
20005,40,5078,3380;5394;11153;12574;12799,3650,0,2,3,0,5
20006,40,5079,4595;7739;11444,3650,0,0,3,0,3
20007,40,5081,4771;8497;12220,3650,0,0,3,0,3
20008,40,5084,2556;9226;12353;12423,3650,0,0,4,0,4
20009,40,5085,4964,3650,0,0,0,1,1
20010,40,5086,2805;5046,3650,0,0,2,0,2
20011,40,5087,5295,3650,0,0,0,1,1
20012,40,5088,5318;6688;12716;12976;14042,3650,0,3,2,0,5
20013,40,5089,4252;6792;12078;12702;12904;13040,3650,0,3,3,0,6
20014,40,5091,503;7969;12612;12669;12982,3650,0,3,2,0,5
20015,40,5092,80;5619,3650,0,0,2,0,2
20016,40,5093,5661;9484;12677,3650,0,1,2,0,3
20017,40,5094,4368;12643;12901;13094,3650,0,3,1,0,4
20018,40,5097,4828;5863;12138,3650,0,0,3,0,3
20019,40,5100,933;3125,3650,0,0,2,0,2
20020,40,5101,8407;8785;12498;12823,3650,0,2,2,0,4
20021,40,5102,524;6215,3650,0,0,0,2,2
20022,40,5103,1714;4693;12290,3650,0,0,3,0,3
20023,40,5108,4655;9768;11578;12387;12748;13010,3650,0,2,4,0,6
20024,40,5109,2881;9134;12072,3650,0,0,3,0,3
20025,40,5110,6238;7520;12717;13271;13478,3650,0,3,2,0,5
20026,40,5112,6629;6675;11527;11705,3650,0,0,4,0,4
20027,40,5115,7192;9166,3650,0,0,2,0,2
20028,40,5116,4680;4979;12422,3650,0,0,3,0,3
20029,40,5117,7294;11330,3650,0,0,2,0,2
20030,40,5118,7306;9418;11892;12335,3650,0,0,4,0,4
20031,40,5119,890;4799;12565;12807,3650,0,2,2,0,4
20032,40,5120,7398;9118;12493;12705;13602,3650,0,2,3,0,5
20033,40,5121,3678;7460,3650,0,0,2,0,2
20034,40,5122,5532;7623,3650,0,0,0,2,2
20035,40,5123,2795;7746,3650,0,0,2,0,2
20036,40,5124,2544;8133;12486,3650,0,0,3,0,3
20037,40,5127,8072;9577,3650,0,0,0,2,2
20038,40,5128,2215;8538;12505;12769,3650,0,2,2,0,4
20039,40,5130,1592;8572;11859,3650,0,0,3,0,3
20040,40,5133,8857;9714,3650,0,0,2,0,2
20041,40,5134,1100;8858;12340;12686;12837,3650,0,2,3,0,5
20042,40,5135,721;4514;12908,3650,0,1,2,0,3
20043,40,5136,4141,3650,0,0,1,0,1
20044,40,5138,9798;13441,3650,0,1,1,0,2
20045,40,5140,4053;5441;12057,3650,0,0,3,0,3
20046,40,5141,3790;6509,3650,0,0,0,2,2
20047,40,5142,3219;4723;12729,3650,0,1,2,0,3
20048,40,5143,8934,3650,0,0,1,0,1
20049,40,5144,8340;9429,3650,0,0,1,1,2
20050,40,5146,3612;5709;13007,3650,0,1,2,0,3
20051,40,5147,3716,3650,0,0,1,0,1
20052,40,5149,9708,3650,0,0,0,1,1
20053,40,5150,4859;7073;12323;12457;12665;12835;13221,3650,0,3,4,0,7
20054,40,5151,43;12370;12510,4015,0,1,2,0,3
20055,40,5152,107;5458;11995,4015,0,0,3,0,3
20056,40,5153,112;7143;11688,4015,0,0,3,0,3
20057,40,5154,188;2456,4015,0,0,2,0,2
20058,40,5155,217;771;12102;12386;13069,4015,0,1,4,0,5
20059,40,5156,8936,4015,0,0,0,1,1
20060,40,5157,284,4015,0,0,0,1,1
20061,40,5158,4810;5749;12222,4015,0,0,3,0,3
20062,40,5160,4236,4015,0,0,0,1,1
20063,40,5161,3;390;12919,4015,0,1,2,0,3
20064,40,5162,2499,4015,0,0,1,0,1
20065,40,5167,945;7495,4015,0,0,2,0,2
20066,40,5168,1016;6196,4015,0,0,2,0,2
20067,40,5169,1086,4015,0,0,0,1,1
20068,40,5170,1096;7826;12201;12450;13112,4015,0,1,4,0,5
20069,40,5172,1846;6951,4015,0,0,2,0,2
20070,40,5173,6400,4015,0,0,0,1,1
20071,40,5176,2359;2648,4015,0,0,2,0,2
20072,40,5177,2372;5302;12810;12906,4015,0,2,2,0,4
20073,40,5179,2637;4275,4015,0,0,0,2,2
20074,40,5182,6517,4015,0,0,0,1,1
20075,40,5183,1648;3208;12373,4015,0,0,3,0,3
20076,40,5184,3309;8039;12334;13139,4015,0,1,3,0,4
20077,40,5185,3363;11885;12071;12532,4015,0,1,3,0,4
20078,40,5187,3475;7696;11754;12044;13147,4015,0,1,4,0,5
20079,40,5188,3595;4855;11725,4015,0,0,3,0,3
20080,40,5189,3685;4887,4015,0,0,0,2,2
20081,40,5190,3726;7998,4015,0,0,2,0,2
20082,40,5191,2421,4015,0,0,0,1,1
20083,40,5192,3741;5043;12435,4015,0,0,3,0,3
20084,40,5193,3873;9033;11789;12330,4015,0,0,4,0,4
20085,40,5194,2230,4015,0,0,0,1,1
20086,40,5195,4267;4713,4015,0,0,2,0,2
20087,40,5198,4934;6327,4015,0,0,0,2,2
20088,40,5200,4613;4764,4015,0,0,0,2,2
20089,40,5202,1505;8780,4015,0,0,2,0,2
20090,40,5203,977,4015,0,0,1,0,1
20091,40,5204,5035,4015,0,0,0,1,1
20092,40,5205,760;3934;11347;11536,4015,0,0,4,0,4
20093,40,5207,1536;6339;11774,4015,0,0,3,0,3
20094,40,5208,5290,4015,0,0,0,1,1
20095,40,5209,5401,4015,0,0,0,1,1
20096,40,5210,3417;3696;11610;12122,4015,0,0,4,0,4
20097,40,5211,5485;9298,4015,0,0,0,2,2
20098,40,5212,5588,4015,0,0,0,1,1
20099,40,5214,5764;6638,4015,0,0,0,2,2
20100,40,5215,3738;4654;11982,4015,0,0,3,0,3
20101,40,5218,5378;9874,4015,0,0,2,0,2
20102,40,5219,5981;6112;12188,4015,0,0,3,0,3
20103,40,5221,2481;6284;11823;12372;12623,4015,0,1,4,0,5
20104,40,5222,6319;7138,4015,0,0,2,0,2
20105,40,5223,278,4015,0,0,1,0,1
20106,40,5224,6404;11787;12007;12538,4015,0,1,3,0,4
20107,40,5225,6492,4015,0,0,0,1,1
20108,40,5226,4755;6531;11635;11904;12310,4015,0,0,5,0,5
20109,40,5228,6605;8365;12836;13098,4015,0,2,2,0,4
20110,40,5229,7150;12391;13072,4015,0,1,2,0,3
20111,40,5230,1163;9499;11537;11811;12026;12603,4015,0,1,5,0,6
20112,40,5231,6480;6555;12273;12552;13226,4015,0,2,3,0,5
20113,40,5233,1774;2356;11828;12050;12320,4015,0,0,5,0,5
20114,40,5235,6728;7050;12407;12868,4015,0,1,3,0,4
20115,40,5236,573,4015,0,0,0,1,1
20116,40,5237,2654;7121;11919;11973;12518,4015,0,1,4,0,5
20117,40,5238,765;7127;11169;12536;13370,4015,0,2,3,0,5
20118,40,5239,7222,4015,0,0,1,0,1
20119,40,5240,7521;11408;12027,4015,0,0,3,0,3
20120,40,5244,5442;7777;11970;12289,4015,0,0,4,0,4
20121,40,5246,7843,4015,0,0,0,1,1
20122,40,5247,9776;9926,4015,0,0,2,0,2
20123,40,5250,2815;8149;12269;12905,4015,0,1,3,0,4
20124,40,5252,2986;8248,4015,0,0,0,2,2
20125,40,5253,3386,4015,0,0,1,0,1
20126,40,5255,7621;8515;13038;13384;13464,4015,0,3,2,0,5
20127,40,5260,1766;8932;12235;12508,4015,0,1,3,0,4
20128,40,5261,6603;8986;11622;12287,4015,0,0,4,0,4
20129,40,5263,1649;9643,4015,0,0,2,0,2
20130,40,5264,639;9069,4015,0,0,2,0,2
20131,40,5266,2475;6353,4015,0,0,2,0,2
20132,40,5267,2008;12471;12722,4015,0,1,2,0,3
20133,40,5272,2493;8650;11851;12408;12900,4015,0,1,4,0,5
20134,40,5277,674;4963;11577;12268;13258;13958,4380,0,2,4,0,6
20135,40,5281,4248,4380,0,0,0,1,1
20136,40,5283,3530;9940;12343;12596;12861,4380,0,2,3,0,5
20137,40,5284,79;1477;11822,4380,0,0,3,0,3
20138,40,5286,1787;3930;11888,4380,0,0,3,0,3
20139,40,5287,1805,4380,0,0,0,1,1
20140,40,5289,4307,4380,0,0,1,0,1
20141,40,5290,2100,4380,0,0,0,1,1
20142,40,5292,2880;9844;12773;13182,4380,0,2,2,0,4
20143,40,5296,3394;6797,4380,0,0,0,2,2
20144,40,5298,2384;3520;13082,4380,0,1,2,0,3
20145,40,5301,1933;8539;11402;12237;12576;13281;13564,4380,0,3,4,0,7
20146,40,5302,7237;7705,4380,0,0,2,0,2
20147,40,5303,1399;3994,4380,0,0,2,0,2
20148,40,5305,4021;7176,4380,0,0,2,0,2
20149,40,5306,3691;8442;11844;12579,4380,0,1,3,0,4
20150,40,5307,4271;5572;12339;12766;13190,4380,0,2,3,0,5
20151,40,5308,2694;9227,4380,0,0,2,0,2
20152,40,5311,7669,4380,0,0,0,1,1
20153,40,5314,4726,4380,0,0,0,1,1
20154,40,5315,4899;4931,4380,0,0,2,0,2
20155,40,5317,5001;7921;11318,4380,0,0,3,0,3
20156,40,5319,1304;7212,4380,0,0,2,0,2
20157,40,5320,5615;6290;11723;12309;12789;13132,4380,0,2,4,0,6
20158,40,5321,6171,4380,0,0,0,1,1
20159,40,5323,892;7072,4380,0,0,2,0,2
20160,40,5324,3045;7729;12870;13171,4380,0,2,2,0,4
20161,40,5325,6694;9621,4380,0,0,2,0,2
20162,40,5326,714;6857;12483;12571,4380,0,1,3,0,4
20163,40,5328,2816;7172,4380,0,0,2,0,2
20164,40,5329,9168,4380,0,0,0,1,1
20165,40,5331,7604;7698,4380,0,0,2,0,2
20166,40,5336,5968;9007;11943;12352,4380,0,0,4,0,4
20167,40,5337,9369;9501,4380,0,0,2,0,2
20168,40,5341,3207;8519;12383,4380,0,0,3,0,3
20169,40,5342,8657,4380,0,0,0,1,1
20170,40,5344,7323,4380,0,0,1,0,1
20171,40,5345,479;8808;12398,4380,0,0,3,0,3
20172,40,5346,7894;8845;11939;12392;12689,4380,0,1,4,0,5
20173,40,5349,6881,4380,0,0,0,1,1
20174,40,5351,5396;7499;12251;12577;13202,4380,0,2,3,0,5
20175,40,5353,572;9605,4380,0,0,0,2,2
20176,40,5355,2620;9666;11582;12047,4380,0,0,4,0,4
20177,40,5356,5936;9694;12655;12877,4380,0,2,2,0,4
20178,40,5357,7948,4380,0,0,1,0,1
20179,40,5358,9862,4380,0,0,0,1,1
20180,40,5360,38;7419;11767,4745,0,0,3,0,3
20181,40,5365,3753;8912;13103,4745,0,1,2,0,3
20182,40,5368,838;7128;11305;11965;12880,4745,0,1,4,0,5
20183,40,5370,7158;11954;12952,4745,0,1,2,0,3
20184,40,5371,3011,4745,0,0,1,0,1
20185,40,5372,5377;6652,4745,0,0,2,0,2
20186,40,5373,1301;6407,4745,0,0,2,0,2
20187,40,5375,1500;2395;12911,4745,0,1,2,0,3
20188,40,5377,1537;1726;12490;12974,4745,0,1,3,0,4
20189,40,5378,831,4745,0,0,0,1,1
20190,40,5379,2239;8520;12076;12844,4745,0,1,3,0,4
20191,40,5380,3574;13184,4745,0,1,1,0,2
20192,40,5383,4576;9225;12284;12878,4745,0,1,3,0,4
20193,40,5384,182;2581;12346;12384;13380,4745,0,1,4,0,5
20194,40,5385,9009;9692,4745,0,0,2,0,2
20195,40,5388,8291;9389;12145;12917,4745,0,1,3,0,4
20196,40,5390,3164;5741,4745,0,0,2,0,2
20197,40,5391,2294,4745,0,0,1,0,1
20198,40,5392,2027;3986;11780;14252,4745,1,0,3,0,4
20199,40,5393,7173,4745,0,0,0,1,1
20200,40,5394,2031;8649;12573,4745,0,1,2,0,3
20201,40,5395,1451;6053;12772,4745,0,1,2,0,3
20202,40,5396,3615;9680;12270;12425,4745,0,0,4,0,4
20203,40,5398,7695,4745,0,0,0,1,1
20204,40,5399,2789;9728;11736;12286;14334,4745,1,0,4,0,5
20205,40,5402,3524,4745,0,0,1,0,1
20206,40,5403,4756;7889,4745,0,0,2,0,2
20207,40,5404,2834;4908,4745,0,0,2,0,2
20208,40,5405,617;2788;12271,4745,0,0,3,0,3
20209,40,5407,5105;7554,4745,0,0,2,0,2
20210,40,5409,3161;5489,4745,0,0,2,0,2
20211,40,5411,3356;12530;12817,4745,0,2,1,0,3
20212,40,5412,2669;4851;12953;13311;13941,4745,0,3,2,0,5
20213,40,5413,9482,4745,0,0,0,1,1
20214,40,5415,5779;11543;11895,4745,0,0,3,0,3
20215,40,5416,5789;5964;12399,4745,0,0,3,0,3
20216,40,5418,3429;6110;12226;12480,4745,0,0,4,0,4
20217,40,5419,5202;6117;12129;12925,4745,0,1,3,0,4
20218,40,5421,1441,4745,0,0,0,1,1
20219,40,5424,6950;9764;12125;12356;12768;13392,4745,0,2,4,0,6
20220,40,5427,6904,4745,0,0,1,0,1
20221,40,5428,6861;8590,4745,0,0,2,0,2
20222,40,5429,5409;7012;11521,4745,0,0,3,0,3
20223,40,5431,1141;1966;12218;12922;13325;13414,4745,0,3,3,0,6
20224,40,5432,3003;5792;12351;12913;13122,4745,0,2,3,0,5
20225,40,5434,7994;9245;12869;13217;13921,4745,0,3,2,0,5
20226,40,5435,3078;8037;11989;12441,4745,0,0,4,0,4
20227,40,5436,2776,4745,0,0,0,1,1
20228,40,5438,1698;8638,4745,0,0,2,0,2
20229,40,5440,6530;8796;13233,4745,0,1,2,0,3
20230,40,5441,2799;8798;12366,4745,0,0,3,0,3
20231,40,5442,5735;8799;12385;13227,4745,0,1,3,0,4
20232,40,5444,9066,4745,0,0,0,1,1
20233,40,5445,9419;9608;12037;13439,4745,0,1,3,0,4
20234,40,5446,4689;9783;12347;12382,4745,0,0,4,0,4
20235,40,5447,658,4745,0,0,0,1,1
20236,40,5448,5535,4745,0,0,0,1,1
20237,40,5451,6764;6820;12376,5110,0,0,3,0,3
20238,40,5452,388,5110,0,0,0,1,1
20239,40,5453,6363;8494;12777;13394,5110,0,2,2,0,4
20240,40,5454,444;11786;11963,5110,0,0,3,0,3
20241,40,5456,540,5110,0,0,0,1,1
20242,40,5458,709;7431,5110,0,0,0,2,2
20243,40,5459,920;8894;12593;13351,5110,0,2,2,0,4
20244,40,5461,8827;9215;11847;12474;12838;13100,5110,0,2,4,0,6
20245,40,5462,1161;2364;12059;13137,5110,0,1,3,0,4
20246,40,5465,1364;12046;12588;13262,5110,0,2,2,0,4
20247,40,5466,3312;9228,5110,0,0,0,2,2
20248,40,5467,1427;4690;12367;12975;13379,5110,0,2,3,0,5
20249,40,5468,1450;2959;11887;12174;12473,5110,0,0,5,0,5
20250,40,5469,4268;8336,5110,0,0,2,0,2
20251,40,5472,1771;5072,5110,0,0,2,0,2
20252,40,5474,8167,5110,0,0,1,0,1
20253,40,5476,6567;9485;12185;12582,5110,0,1,3,0,4
20254,40,5478,5201,5110,0,0,1,0,1
20255,40,5481,6885;7211;12599,5110,0,1,2,0,3
20256,40,5483,3951;4062;11747,5110,0,0,3,0,3
20257,40,5484,1179;5490,5110,0,0,2,0,2
20258,40,5485,8711;9571;12513,5110,0,1,2,0,3
20259,40,5486,4374,5110,0,0,1,0,1
20260,40,5487,4435;5395,5110,0,0,2,0,2
20261,40,5488,2547;4333,5110,0,0,0,2,2
20262,40,5489,3923,5110,0,0,0,1,1
20263,40,5490,4581;6296;11601;12636,5110,0,1,3,0,4
20264,40,5491,2063;6252;11923;12733;13133,5110,0,2,3,0,5
20265,40,5492,3376;5196;12130;12338,5110,0,0,4,0,4
20266,40,5496,1706;9651;11623;11912;12430;13026,5110,0,1,5,0,6
20267,40,5498,953;5630;13113,5110,0,1,2,0,3
20268,40,5499,5100;5662;13027,5110,0,1,2,0,3
20269,40,5501,5809;7697;12300;12987,5110,0,1,3,0,4
20270,40,5502,3471;6240,5110,0,0,2,0,2
20271,40,5506,4070;8779;12219,5110,0,0,3,0,3
20272,40,5507,5659;9827;11994;12299;12654,5110,0,1,4,0,5
20273,40,5508,4379;9040,5110,0,0,2,0,2
20274,40,5509,6959;9558,5110,0,0,0,2,2
20275,40,5510,7027,5110,0,0,0,1,1
20276,40,5511,4594;7043,5110,0,0,2,0,2
20277,40,5512,4442,5110,0,0,0,1,1
20278,40,5513,1339;7672;12246;12580,5110,0,1,3,0,4
20279,40,5515,9339,5110,0,0,1,0,1
20280,40,5516,8746;9561;13473,5110,0,1,2,0,3
20281,40,5522,3155;7681;12413,5110,0,0,3,0,3
20282,40,5523,2165;2377,5110,0,0,0,2,2
20283,40,5528,5459;9332;12890;13198,5110,0,2,2,0,4
20284,40,5529,2516;4479,5110,0,0,2,0,2
20285,40,5530,2983,5110,0,0,0,1,1
20286,40,5531,7244,5110,0,0,0,1,1
20287,40,5533,3573;9649;11798;11948;12139;13498,5110,0,1,5,0,6
20288,40,5534,431;9693;13870,5110,0,1,2,0,3
20289,40,5536,113;13460,5475,0,1,1,0,2
20290,40,5537,1064;3477;12375;12514,5475,0,1,3,0,4
20291,40,5540,327;445,5475,0,0,0,2,2
20292,40,5541,462,5475,0,0,0,1,1
20293,40,5542,798;2737,5475,0,0,0,2,2
20294,40,5543,6495,5475,0,0,0,1,1
20295,40,5546,967,5475,0,0,0,1,1
20296,40,5549,1343;8406;12217;12824,5475,0,1,3,0,4
20297,40,5550,37;2394;12113;12854,5475,0,1,3,0,4
20298,40,5552,5234,5475,0,0,0,1,1
20299,40,5553,1544;3945;12239;12278;12818,5475,0,1,4,0,5
20300,40,5555,1670;6127;13448;13566;14650,5475,1,2,2,0,5
20301,40,5558,5021;5114,5475,0,0,2,0,2
20302,40,5560,574;7481;12544;12731,5475,0,2,2,0,4
20303,40,5561,1930;3367;12221;14179,5475,1,0,3,0,4
20304,40,5564,2175;12171;12477;12539;12698;13264,5475,0,3,3,0,6
20305,40,5565,393;2321;11685,5475,0,0,3,0,3
20306,40,5566,4057;5367;12446;12670;12939,5475,0,2,3,0,5
20307,40,5567,2498;12324,5475,0,0,2,0,2
20308,40,5569,2667;8086,5475,0,0,0,2,2
20309,40,5570,3458;5806;11958;12110;13068,5475,0,1,4,0,5
20310,40,5572,1522;2996;12200;13131,5475,0,1,3,0,4
20311,40,5573,212;3120;11985,5475,0,0,3,0,3
20312,40,5574,3121;7509,5475,0,0,2,0,2
20313,40,5575,5869;9637;12325;13000,5475,0,1,3,0,4
20314,40,5576,470;1608;12447,5475,0,0,3,0,3
20315,40,5578,3359;11584;12943;13545;14189,5475,1,2,2,0,5
20316,40,5579,3503;6809;12191;12898;13267;13502,5475,0,3,3,0,6
20317,40,5580,2976;3578;11753;12101,5475,0,0,4,0,4
20318,40,5581,3710;6791;12411,5475,0,0,3,0,3
20319,40,5582,3885,5475,0,0,0,1,1
20320,40,5584,7964;12409;13195,5475,0,1,2,0,3
20321,40,5585,5047;7785;12986,5475,0,1,2,0,3
20322,40,5586,4085;9285,5475,0,0,2,0,2
20323,40,5588,1751;9230;12620;12967,5475,0,2,2,0,4
20324,40,5592,4587;9722;11557,5475,0,0,3,0,3
20325,40,5594,4601;8135,5475,0,0,2,0,2
20326,40,5595,4700;11570;12714;12891;13683,5475,0,3,2,0,5
20327,40,5596,4832;7016;12618;12894,5475,0,2,2,0,4
20328,40,5597,4850;7818,5475,0,0,2,0,2
20329,40,5598,4913,5475,0,0,0,1,1
20330,40,5599,3136;5156;12667,5475,0,1,2,0,3
20331,40,5602,1428;2876;11629;12843;14072,5475,0,2,3,0,5
20332,40,5605,4955;5892;11655;12443;13337,5475,0,1,4,0,5
20333,40,5607,4401,5475,0,0,1,0,1
20334,40,5608,49;6133;12993,5475,0,1,2,0,3
20335,40,5610,6202;6839;11978;13454;14126,5475,1,1,3,0,5
20336,40,5611,2123;7555;13105;13739,5475,0,2,2,0,4
20337,40,5614,2434;6624;12345;12560;12746,5475,0,2,3,0,5
20338,40,5615,1499;7340,5475,0,0,2,0,2
20339,40,5618,6466;7024;12368;12558,5475,0,1,3,0,4
20340,40,5619,3046;7383;12820;13088,5475,0,2,2,0,4
20341,40,5620,3156;7373;13909,5475,0,1,2,0,3
20342,40,5623,4153;7638,5475,0,0,0,2,2
20343,40,5624,1387;3308;12227,5475,0,0,3,0,3
20344,40,5625,7794;13819,5475,0,1,1,0,2
20345,40,5627,6003;8047;12472;12874,5475,0,1,3,0,4
20346,40,5628,793;8010;12108;12699;12897,5475,0,2,3,0,5
20347,40,5629,2783;9816;12659,5475,0,1,2,0,3
20348,40,5630,169;8302;12062;12775;13886,5475,0,2,3,0,5
20349,40,5632,6847;8483,5475,0,0,2,0,2
20350,40,5633,6292;8633,5475,0,0,0,2,2
20351,40,5634,8641;8826;11830;12176,5475,0,0,4,0,4
20352,40,5635,5241;6088,5475,0,0,2,0,2
20353,40,5636,6229;9006,5475,0,0,2,0,2
20354,40,5637,4544;5991;12502;12635,5475,0,2,2,0,4
20355,40,5639,3337;9400;12557;13049;13462;13901,5475,0,4,2,0,6
20356,40,5641,1060,5475,0,0,0,1,1
20357,40,5642,440;9664;13030,5475,0,1,2,0,3
20358,40,5643,5553;9689;12193,5475,0,0,3,0,3
20359,40,5644,4075;8556;13403;14154,5475,1,1,2,0,4
20360,40,5645,3428;8591;12899;13255,5475,0,2,2,0,4
20361,40,5647,631;9853;12876;13305;13628,5475,0,3,2,0,5
20362,40,5648,5329;9976;11784;12497,5475,0,1,3,0,4
20363,40,5649,612;1045;12786,5840,0,1,2,0,3
20364,40,5652,120;1929;12893;13440,5840,0,2,2,0,4
20365,40,5655,840,5840,0,0,0,1,1
20366,40,5656,378;1847;11862,5840,0,0,3,0,3
20367,40,5657,1366;8490,5840,0,0,0,2,2
20368,40,5658,8743,5840,0,0,0,1,1
20369,40,5660,863;6750,5840,0,0,2,0,2
20370,40,5661,461;10030;13050,5840,0,1,2,0,3
20371,40,5663,2234;4617;13275;13511;13760,5840,0,3,2,0,5
20372,40,5664,6183;6331;12487;13119,5840,0,1,3,0,4
20373,40,5665,1267;11749;12079;12848,5840,0,1,3,0,4
20374,40,5667,829;1746;11926;12741;12942;13346,5840,0,3,3,0,6
20375,40,5668,3400;8110;12354,5840,0,0,3,0,3
20376,40,5669,1727;7709;11646;12005;13017;13727;14454,5840,1,2,4,0,7
20377,40,5670,163;1770;12082;13398;13480,5840,0,2,3,0,5
20378,40,5674,2233;2523;11999,5840,0,0,3,0,3
20379,40,5677,3233;7500;12084;12379;13289;13907,5840,0,2,4,0,6
20380,40,5678,2365;10105;12778,5840,0,1,2,0,3
20381,40,5681,3029;7634;12162;12604;13463,5840,0,2,3,0,5
20382,40,5683,3209;10012;12444;12668;13053;13601;14513,5840,1,3,3,0,7
20383,40,5685,2271;11873;12492;12684;13034;13551,5840,0,3,3,0,6
20384,40,5686,10015;10040;12281;12666;13078,5840,0,2,3,0,5
20385,40,5687,6309;12475;12951,5840,0,1,2,0,3
20386,40,5689,1667;3146;12051;12297;13037,5840,0,1,4,0,5
20387,40,5690,2404;3968;12519,5840,0,1,2,0,3
20388,40,5691,4020;7278,5840,0,0,0,2,2
20389,40,5692,9726;9854,5840,0,0,2,0,2
20390,40,5694,4317;8489,5840,0,0,0,2,2
20391,40,5697,4752;12529;13633,5840,0,2,1,0,3
20392,40,5698,987;9589;12553,5840,0,1,2,0,3
20393,40,5699,4846;12020;12374;13945;14057,5840,0,2,3,0,5
20394,40,5701,5064;12706;14297,5840,1,1,1,0,3
20395,40,5703,651;5227,5840,0,0,0,2,2
20396,40,5704,2300;5228;12511,5840,0,1,2,0,3
20397,40,5705,10045;13076;13881,5840,0,2,1,0,3
20398,40,5706,5311;8409;11807;12693,5840,0,1,3,0,4
20399,40,5707,5382;6905;12186;12700;13194,5840,0,2,3,0,5
20400,40,5708,4074;5425;12549;12850;13048,5840,0,3,2,0,5
20401,40,5709,5436;11663,5840,0,0,2,0,2
20402,40,5710,81;7193;12336;12534,5840,0,1,3,0,4
20403,40,5711,5793;10113;12118;12644,5840,0,1,3,0,4
20404,40,5712,250;5805;12077;13111,5840,0,1,3,0,4
20405,40,5714,5985;9454;12033;12401,5840,0,0,4,0,4
20406,40,5716,6114;10027;13493;14395,5840,1,1,2,0,4
20407,40,5717,6119,5840,0,0,0,1,1
20408,40,5718,6122,5840,0,0,0,1,1
20409,40,5720,6582;13108,5840,0,1,1,0,2
20410,40,5721,6668,5840,0,0,0,1,1
20411,40,5722,6699;8220;12452;13109,5840,0,1,3,0,4
20412,40,5723,1987;8922;12064,5840,0,0,3,0,3
20413,40,5726,119;7197,5840,0,0,2,0,2
20414,40,5727,6222;7372,5840,0,0,2,0,2
20415,40,5728,6071;12804;13512;13540,5840,0,3,1,0,4
20416,40,5732,786;7789;12743;13180;14635,5840,1,2,2,0,5
20417,40,5737,8288;12790;13090;13495,5840,0,3,1,0,4
20418,40,5738,5988;11972;12348,5840,0,0,3,0,3
20419,40,5739,6571;8421;13340;13840,5840,0,2,2,0,4
20420,40,5740,7156;9220;12410;12547,5840,0,1,3,0,4
20421,40,5741,3083,5840,0,0,0,1,1
20422,40,5742,480;12216;12621;12855;13664,5840,0,3,2,0,5
20423,40,5744,1415;2245,5840,0,0,2,0,2
20424,40,5746,4945;9150;12842,5840,0,1,2,0,3
20425,40,5747,8967,5840,0,0,1,0,1
20426,40,5748,7316;9037;12467;13518,5840,0,1,3,0,4
20427,40,5750,4748;9211;12512;12866;13312;13611,5840,0,4,2,0,6
20428,40,5754,2210;3725,5840,0,0,2,0,2
20429,40,5761,242,6205,0,0,0,1,1
20430,40,5763,319;7765;12245,6205,0,0,3,0,3
20431,40,5764,386;10063;11956;13085;13214,6205,0,2,3,0,5
20432,40,5765,477;2370;12344;12432;13287,6205,0,1,4,0,5
20433,40,5766,4385;9514;12006;12431;12495,6205,0,1,4,0,5
20434,40,5767,803;12968;13705,6205,0,2,1,0,3
20435,40,5769,1507,6205,0,0,0,1,1
20436,40,5770,982;12058;12332;12434,6205,0,0,4,0,4
20437,40,5772,4147;9606;12317;12388;13429,6205,0,1,4,0,5
20438,40,5773,10049;10166;11852,6205,0,0,3,0,3
20439,40,5774,1314;3201;12448;12734;13240,6205,0,2,3,0,5
20440,40,5775,1697,6205,0,0,0,1,1
20441,40,5776,44;1837;13444;13685,6205,0,2,2,0,4
20442,40,5779,7341;12066,6205,0,0,2,0,2
20443,40,5781,7068,6205,0,0,1,0,1
20444,40,5782,7168,6205,0,0,0,1,1
20445,40,5783,2316;3883,6205,0,0,2,0,2
20446,40,5784,4736;7914;12609;12879;13239,6205,0,3,2,0,5
20447,40,5785,2689;2738;13205;13415,6205,0,2,2,0,4
20448,40,5786,2690,6205,0,0,0,1,1
20449,40,5787,632;4285;11766,6205,0,0,3,0,3
20450,40,5788,6135,6205,0,0,0,1,1
20451,40,5789,3231;8493,6205,0,0,2,0,2
20452,40,5792,3320,6205,0,0,0,1,1
20453,40,5793,3375;4856;12265;12687;12892,6205,0,2,3,0,5
20454,40,5794,3420;12762;13620,6205,0,2,1,0,3
20455,40,5795,3591;10076;12961;13084,6205,0,2,2,0,4
20456,40,5796,3841;10112;13141;13288,6205,0,2,2,0,4
20457,40,5798,3995;6773;12395;12791,6205,0,1,3,0,4
20458,40,5799,4154,6205,0,0,0,1,1
20459,40,5800,4218,6205,0,0,1,0,1
20460,40,5801,9116,6205,0,0,0,1,1
20461,40,5802,2728;4516;13201;13285,6205,0,2,2,0,4
20462,40,5803,2842;9197;13101;13269,6205,0,2,2,0,4
20463,40,5805,6166;8498;11947;12169;12594,6205,0,1,4,0,5
20464,40,5806,3111;4757;12653,6205,0,1,2,0,3
20465,40,5808,4867;9667;12481;13647,6205,0,1,3,0,4
20466,40,5810,4952,6205,0,0,0,1,1
20467,40,5812,1369,6205,0,0,0,1,1
20468,40,5813,5184,6205,0,0,0,1,1
20469,40,5814,5297;7995;13529,6205,0,1,2,0,3
20470,40,5815,5334,6205,0,0,0,1,1
20471,40,5816,5480;12972;13859,6205,0,2,1,0,3
20472,40,5818,5642;11872;12591,6205,0,1,2,0,3
20473,40,5819,9765;12199;12437;13127,6205,0,1,3,0,4
20474,40,5820,5899;6982;11837;12170,6205,0,0,4,0,4
20475,40,5821,3601;5901;12282;12556;12758,6205,0,2,3,0,5
20476,40,5822,3366;5929;12641;13142,6205,0,2,2,0,4
20477,40,5824,3961;6192;12194,6205,0,0,3,0,3
20478,40,5825,2729;6262;13282;13488,6205,0,2,2,0,4
20479,40,5828,4329,6205,0,0,0,1,1
20480,40,5829,2146;6632;13434,6205,0,1,2,0,3
20481,40,5830,6369;13404;13899,6205,0,2,1,0,3
20482,40,5831,4225;6375,6205,0,0,0,2,2
20483,40,5832,6461;14188,6205,1,0,1,0,2
20484,40,5833,1026;8146;12691;13001,6205,0,2,2,0,4
20485,40,5834,4714;9681,6205,0,0,2,0,2
20486,40,5837,6838,6205,0,0,1,0,1
20487,40,5839,5260;10053;12496;13064;13347,6205,0,3,2,0,5
20488,40,5840,2760;7040;11950;12782;13250;13746,6205,0,3,3,0,6
20489,40,5841,7081,6205,0,0,0,1,1
20490,40,5842,1623;7097;13055;13492,6205,0,2,2,0,4
20491,40,5843,1313;7110;12041;12195;12566;13702,6205,0,2,4,0,6
20492,40,5844,7174,6205,0,0,0,1,1
20493,40,5847,2062;7402;12439;13744,6205,0,1,3,0,4
20494,40,5848,1478;7747;12143;12363;12674,6205,0,1,4,0,5
20495,40,5849,1467;7793;12255;12756;13219;13435,6205,0,3,3,0,6
20496,40,5850,3575;7927,6205,0,0,2,0,2
20497,40,5853,5674;9003;12314,6205,0,0,3,0,3
20498,40,5854,8398;8511,6205,0,0,0,2,2
20499,40,5858,4669;9266;12132;12327,6205,0,0,4,0,4
20500,40,5859,9210;9782;12049;12329;12613,6205,0,1,4,0,5
20501,40,5860,9082;9425;12962,6205,0,1,2,0,3
20502,40,5861,2354;9756,6205,0,0,2,0,2
20503,40,5864,5860;12649;13004,6205,0,2,1,0,3
20504,40,5867,93;10246;12177;14005;14539,6570,1,1,3,0,5
20505,40,5869,562;10232;11932;13330,6570,0,1,3,0,4
20506,40,5870,294;652;12404;12622;13187,6570,0,2,3,0,5
20507,40,5871,361;9686,6570,0,0,2,0,2
20508,40,5873,7762;9736;13145;13431;13599;13878;14287,6570,1,4,2,0,7
20509,40,5874,1092;13117,6570,0,1,1,0,2
20510,40,5876,1231;13555;13970,6570,0,2,1,0,3
20511,40,5878,1545;10122;12250,6570,0,0,3,0,3
20512,40,5879,1564;2250;12236;12419,6570,0,0,4,0,4
20513,40,5885,10187;10349;12875;13997,6570,0,2,2,0,4
20514,40,5886,921;7728;12543;12688,6570,0,2,2,0,4
20515,40,5888,2818;10142;13091;13784;13991,6570,0,3,2,0,5
20516,40,5889,2868,6570,0,0,0,1,1
20517,40,5890,2919;9139;12455;12984;13544,6570,0,2,3,0,5
20518,40,5891,2963;6991,6570,0,0,2,0,2
20519,40,5892,1144;2964;12662;12999,6570,0,2,2,0,4
20520,40,5893,960;5331;12156;12813;13374,6570,0,2,3,0,5
20521,40,5894,1027;3058;12211;12732,6570,0,1,3,0,4
20522,40,5895,3118;8862;12088;12369;13736,6570,0,1,4,0,5
20523,40,5897,2950;3145;12738,6570,0,1,2,0,3
20524,40,5898,3255;7025,6570,0,0,2,0,2
20525,40,5899,3266;8698;12929;13120,6570,0,2,2,0,4
20526,40,5900,2322;8273;12503;12642,6570,0,2,2,0,4
20527,40,5901,6091,6570,0,0,0,1,1
20528,40,5902,3472;12034;12294;12761;13071;13917,6570,0,3,3,0,6
20529,40,5905,1833,6570,0,0,0,1,1
20530,40,5906,4052,6570,0,0,0,1,1
20531,40,5908,4192,6570,0,0,0,1,1
20532,40,5910,6933,6570,0,0,1,0,1
20533,40,5912,604;4960;13519;13678,6570,0,2,2,0,4
20534,40,5919,4219;9688;12307;13252;13550,6570,0,2,3,0,5
20535,40,5922,5626,6570,0,0,0,1,1
20536,40,5923,10089;11865;12852,6570,0,1,2,0,3
20537,40,5924,5711,6570,0,0,0,1,1
20538,40,5925,277;5723;11942;12438;12990;13965,6570,0,2,4,0,6
20539,40,5927,5743;10020;12725;13868,6570,0,2,2,0,4
20540,40,5929,6565,6570,0,0,0,1,1
20541,40,5931,1694;7780;13447,6570,0,1,2,0,3
20542,40,5932,5195;6914,6570,0,0,2,0,2
20543,40,5933,6233;12065,6570,0,0,2,0,2
20544,40,5934,2159;8703;12024;12266,6570,0,0,4,0,4
20545,40,5935,6393;10214;12350,6570,0,0,3,0,3
20546,40,5936,6483,6570,0,0,0,1,1
20547,40,5937,6520,6570,0,0,0,1,1
20548,40,5940,6593,6570,0,0,0,1,1
20549,40,5941,2295;7030,6570,0,0,2,0,2
20550,40,5943,1458;4678,6570,0,0,2,0,2
20551,40,5944,3638,6570,0,0,0,1,1
20552,40,5945,5726;8297;12283;13129,6570,0,1,3,0,4
20553,40,5946,774;7510;12937;13459,6570,0,2,2,0,4
20554,40,5947,10283;10319;12179;12697;12747;13838,6570,0,3,3,0,6
20555,40,5948,4677;12292;12454;12657;13786,6570,0,2,3,0,5
20556,40,5949,7029;7939;12224;13021,6570,0,1,3,0,4
20557,40,5951,8266,6570,0,0,1,0,1
20558,40,5953,4476;12533;12800;13548;13770,6570,0,4,1,0,5
20559,40,5954,2409,6570,0,0,0,1,1
20560,40,5956,334;8886;13479;13697,6570,0,2,2,0,4
20561,40,5958,8646,6570,0,0,0,1,1
20562,40,5959,3418;7394,6570,0,0,2,0,2
20563,40,5960,3055;8840;13248;13406,6570,0,2,2,0,4
20564,40,5962,3478;9099;13506,6570,0,1,2,0,3
20565,40,5963,9151;10158;12362;13013;14588,6570,1,1,3,0,5
20566,40,5964,2256;2870;12261;12752;13110,6570,0,2,3,0,5
20567,40,5965,7712;9162;13196,6570,0,1,2,0,3
20568,40,5966,3794;5084;12056;12651;13674,6570,0,2,3,0,5
20569,40,5968,6693;9394;13186;13445,6570,0,2,2,0,4
20570,40,5970,665;6536;13079;13295,6570,0,2,2,0,4
20571,40,5971,9563;10299;12153;13301;13731,6570,0,2,3,0,5
20572,40,5973,2893;9626;12158;12921;13728,6570,0,2,3,0,5
20573,40,5974,9682,6570,0,0,0,1,1
20574,40,5975,2264;9696,6570,0,0,2,0,2
20575,40,5976,2539;9710;13334;13948,6570,0,2,2,0,4
20576,40,5977,6056;9720;12426;12794,6570,0,1,3,0,4
20577,40,5979,9793,6570,0,0,0,1,1
20578,40,5982,48;6986,6935,0,0,2,0,2
20579,40,5983,96;5379,6935,0,0,2,0,2
20580,40,5985,316;4630;13096,6935,0,1,2,0,3
20581,40,5988,688;1826,6935,0,0,0,2,2
20582,40,5990,1050,6935,0,0,1,0,1
20583,40,5991,2703;9331,6935,0,0,0,2,2
20584,40,5993,1111;9507,6935,0,0,2,0,2
20585,40,5994,1637;7163;12561,6935,0,1,2,0,3
20586,40,5995,1682;10155;13236;13635;13903,6935,0,3,2,0,5
20587,40,5997,1904;6325,6935,0,0,2,0,2
20588,40,5998,5798,6935,0,0,1,0,1
20589,40,5999,1940;2069,6935,0,0,2,0,2
20590,40,6001,4704;6990;12213;12542;13143;13541;14313,6935,1,3,3,0,7
20591,40,6003,2242,6935,0,0,0,1,1
20592,40,6004,2410,6935,0,0,0,1,1
20593,40,6005,2494;5016;12973,6935,0,1,2,0,3
20594,40,6009,3521,6935,0,0,0,1,1
20595,40,6010,3776;12933,6935,0,1,1,0,2
20596,40,6011,3820;5937;13251;14292,6935,1,1,2,0,4
20597,40,6015,1422,6935,0,0,0,1,1
20598,40,6017,4833;8701;12694;12944,6935,0,2,2,0,4
20599,40,6020,5032;10081;13774,6935,0,1,2,0,3
20600,40,6021,7177;7550;12710;13167,6935,0,2,2,0,4
20601,40,6022,1305;3341;12371;12994;13328,6935,0,2,3,0,5
20602,40,6023,5643;8998;12935;13092,6935,0,2,2,0,4
20603,40,6028,6155;7444;14143,6935,1,0,2,0,3
20604,40,6030,3679;6208;12765,6935,0,1,2,0,3
20605,40,6034,8176,6935,0,0,1,0,1
20606,40,6035,3977;4257;12802;13018,6935,0,2,2,0,4
20607,40,6037,2068;10031;13659;14360,6935,1,1,2,0,4
20608,40,6038,2032;7054,6935,0,0,2,0,2
20609,40,6043,10367;10526;12460;13178,6935,0,1,3,0,4
20610,40,6044,7591,6935,0,0,0,1,1
20611,40,6048,7183;8358,6935,0,0,0,2,2
20612,40,6049,8553;10034;12965;13022,6935,0,2,2,0,4
20613,40,6051,895;8996,6935,0,0,2,0,2
20614,40,6052,9046;12690;13199,6935,0,2,1,0,3
20615,40,6054,1775;9256,6935,0,0,2,0,2
20616,40,6056,9520;10308;12484;13231;13466;13771,6935,0,3,3,0,6
20617,40,6060,9810,6935,0,0,0,1,1
20618,40,6061,9984,6935,0,0,0,1,1
20619,40,6062,2896;10003;13954;14259,6935,1,1,2,0,4
20620,40,6063,10383;12259;12728;12938,6935,0,2,2,0,4
20621,40,6064,10044;10328;12624;12795;14129,6935,1,2,2,0,5
20622,40,6065,10086;10491;13363;13785;14168,6935,1,2,2,0,5
20623,40,6066,10093;10184;13472,6935,0,1,2,0,3
20624,40,6067,10036;10098;12959,6935,0,1,2,0,3
20625,40,6068,10115;12241,6935,0,0,2,0,2
20626,40,6069,94;10018;13307;13723,7300,0,2,2,0,4
20627,40,6070,4808,7300,0,0,0,1,1
20628,40,6071,493;6389;13437,7300,0,1,2,0,3
20629,40,6072,3246;13189;14255,7300,1,1,1,0,3
20630,40,6073,545;10484;12779;13020,7300,0,2,2,0,4
20631,40,6074,546;10407;12205;12812;12910,7300,0,2,3,0,5
20632,40,6075,7311;12736;12839;13126;13615,7300,0,4,1,0,5
20633,40,6076,1334;13423,7300,0,1,1,0,2
20634,40,6077,1461;10201,7300,0,0,2,0,2
20635,40,6078,1472;10287;12060;12263;12989,7300,0,1,4,0,5
20636,40,6079,1797;10218;12831;13093;13247;13486,7300,0,4,2,0,6
20637,40,6082,1093;2442;13499;13708,7300,0,2,2,0,4
20638,40,6085,10078;10084;13083,7300,0,1,2,0,3
20639,40,6086,87;7310;12393;12630;13458,7300,0,2,3,0,5
20640,40,6089,3408,7300,0,0,0,1,1
20641,40,6090,3424;5917;13116,7300,0,1,2,0,3
20642,40,6091,3476;6967,7300,0,0,2,0,2
20643,40,6092,1630;3492;12198;12318;12521,7300,0,1,4,0,5
20644,40,6093,3600;10069;12740;13089;13329,7300,0,3,2,0,5
20645,40,6096,1944;5521,7300,0,0,2,0,2
20646,40,6097,8163,7300,0,0,0,1,1
20647,40,6099,3807,7300,0,0,0,1,1
20648,40,6100,3481;10065;12491;12528;12816;13326;14170;14387,7300,2,3,3,0,8
20649,40,6101,4023;9923;13067;13338;13616,7300,0,3,2,0,5
20650,40,6102,4106;10371;12190;12808;13104,7300,0,2,3,0,5
20651,40,6103,7624,7300,0,0,0,1,1
20652,40,6105,3141;9709;12638,7300,0,1,2,0,3
20653,40,6106,4777,7300,0,0,0,1,1
20654,40,6107,10347;10480;12119;12164;12889;13526,7300,0,2,4,0,6
20655,40,6108,4948,7300,0,0,0,1,1
20656,40,6109,1056;4959;13274,7300,0,1,2,0,3
20657,40,6111,5097;8109;13822,7300,0,1,2,0,3
20658,40,6113,2948;5161;13494;13680;14346,7300,1,2,2,0,5
20659,40,6114,5170;7993;12815;13081,7300,0,2,2,0,4
20660,40,6115,3388;5402;12548,7300,0,1,2,0,3
20661,40,6117,5676,7300,0,0,0,1,1
20662,40,6120,5788;8198;12598;13042;13908,7300,0,3,2,0,5
20663,40,6121,5850;9654;12304;12499;12895;13344,7300,0,3,3,0,6
20664,40,6122,494;5930;13130;13286,7300,0,2,2,0,4
20665,40,6123,8723,7300,0,0,1,0,1
20666,40,6124,7465,7300,0,0,1,0,1
20667,40,6126,6490;10322;12160;13028;13929;14633,7300,1,2,3,0,6
20668,40,6127,6849;7098;12478;12628;13158,7300,0,2,3,0,5
20669,40,6129,5175;10188;13276,7300,0,1,2,0,3
20670,40,6131,4016;7570,7300,0,0,2,0,2
20671,40,6132,7606,7300,0,0,0,1,1
20672,40,6133,4571;7622;13257;13560;14379,7300,1,2,2,0,5
20673,40,6134,7809,7300,0,0,1,0,1
20674,40,6137,8121,7300,0,0,0,1,1
20675,40,6141,3946,7300,0,0,0,1,1
20676,40,6142,8618,7300,0,0,1,0,1
20677,40,6143,8805,7300,0,0,0,1,1
20678,40,6148,6754;9028,7300,0,0,0,2,2
20679,40,6149,2438;3673,7300,0,0,2,0,2
20680,40,6151,249,7300,0,0,0,1,1
20681,40,6154,3834;9879;12616;12763;13016,7300,0,3,2,0,5
20682,40,6155,9887;10386;12721;12966;13140;14023;14416,7300,1,4,2,0,7
20683,40,6157,10019;10257;12163;12254;12883;13536,7300,0,2,4,0,6
20684,40,6159,10043;10475;12394;14117,7300,1,0,3,0,4
20685,40,6160,10050;10056;12846,7300,0,1,2,0,3
20686,40,6161,10055;12531,7300,0,1,1,0,2
20687,40,6163,10064;10083;12927;13216;13408,7300,0,3,2,0,5
20688,40,6164,10107;10439;12516;12834;13237;13461;14564,7300,1,4,2,0,7
20689,40,6165,10121;10295;12288;13595;13773;14495,7300,1,2,3,0,6
20690,40,6166,10117;10132;13537;14160,7300,1,1,2,0,4
20691,40,6167,10175;10384;12152;12569,7300,0,1,3,0,4
20692,40,6168,10178;10329;12537;13173;13428,7300,0,3,2,0,5
20693,40,6169,10203;10275;12720;12871;13883;14707,7300,1,3,2,0,6
20694,40,6170,228;10205;12754;13405;13992,7300,0,3,2,0,5
20695,40,6171,10224;12610;13080;14392,7300,1,2,1,0,4
20696,40,6172,10197;10400;12792;13362;13662,7300,0,3,2,0,5
20697,40,6173,10124;10219;12727,7300,0,1,2,0,3
20698,40,6174,405;10075;12527;12830;13033,7665,0,3,2,0,5
20699,40,6175,448;10094;13411;13799,7665,0,2,2,0,4
20700,40,6177,653;12663;12851,7665,0,2,1,0,3
20701,40,6182,6744;10111;14087,7665,1,0,2,0,3
20702,40,6184,1108,7665,0,0,0,1,1
20703,40,6185,2268;10033;12797;14236,7665,1,1,2,0,4
20704,40,6187,1628,7665,0,0,0,1,1
20705,40,6188,6560;13531;13839,7665,0,2,1,0,3
20706,40,6189,2015;9518;13593;13985,7665,0,2,2,0,4
20707,40,6193,2960;5137;12500;12886,7665,0,2,2,0,4
20708,40,6197,3126;6015;12960;13225,7665,0,2,2,0,4
20709,40,6198,3240;3978,7665,0,0,2,0,2
20710,40,6199,3318;3874;12805;12914;14248,7665,1,2,2,0,5
20711,40,6201,4056;5258,7665,0,0,2,0,2
20712,40,6203,4221;10060;13451,7665,0,1,2,0,3
20713,40,6207,303,7665,0,0,0,1,1
20714,40,6209,5245;8271,7665,0,0,2,0,2
20715,40,6210,5277;9371,7665,0,0,2,0,2
20716,40,6212,1142,7665,0,0,0,1,1
20717,40,6213,6159;8278;13153;13450;13981;14272,7665,1,3,2,0,6
20718,40,6214,6261;9888;12859;13012,7665,0,2,2,0,4
20719,40,6216,896;3234;12608;13046,7665,0,2,2,0,4
20720,40,6220,6542;7179,7665,0,0,0,2,2
20721,40,6222,262;7255,7665,0,0,2,0,2
20722,40,6223,9580;12708;12996;13562,7665,0,3,1,0,4
20723,40,6224,4169;7671,7665,0,0,2,0,2
20724,40,6225,1013;3887,7665,0,0,0,2,2
20725,40,6226,7724;10395;13753;14030,7665,0,2,2,0,4
20726,40,6229,613;8145;13057;13373;13418;13711,7665,0,4,2,0,6
20727,40,6230,8272,7665,0,0,1,0,1
20728,40,6235,8874,7665,0,0,0,1,1
20729,40,6237,5760,7665,0,0,0,1,1
20730,40,6239,3629,7665,0,0,0,1,1
20731,40,6242,4824,7665,0,0,0,1,1
20732,40,6243,10024;10306;12949;13157;13436,7665,0,3,2,0,5
20733,40,6244,8877;10354;12957;13407;13734,7665,0,3,2,0,5
20734,40,6245,8201;10119;13106;13885,7665,0,2,2,0,4
20735,40,6246,4868;10163;12568;12793;13036;13788;14071,7665,0,5,2,0,7
20736,40,6247,1468;10164;12361;13709;14028,7665,0,2,3,0,5
20737,40,6248,10168;12285;14623,7665,1,0,2,0,3
20738,40,6249,10209;10511;12535;14012,7665,0,2,2,0,4
20739,40,6250,10227;10432;12322;12589;12995;13928,7665,0,3,3,0,6
20740,40,6251,10217;10377;12652;13206;13333;13871,7665,0,4,2,0,6
20741,40,6252,10248;10291;12865;13107;13661,7665,0,3,2,0,5
20742,40,6253,10255;10296;12656;12888;13115,7665,0,3,2,0,5
20743,40,6254,10262;10530;12504;12634;13066;13372,7665,0,4,2,0,6
20744,40,6255,10265;10594;12494;12745;13742;14219,7665,1,3,2,0,6
20745,40,6256,10486;13390;14142,7665,1,1,1,0,3
20746,40,6257,10292;10482;12433;12675;12840;13937,7665,0,3,3,0,6
20747,40,6258,10312;10364;13395;13959,7665,0,2,2,0,4
20748,40,6259,10537;12380,7665,0,0,2,0,2
20749,40,6260,10332;10565;13425;14049;14190,7665,1,2,2,0,5
20750,40,6261,10080;12461;13170;13420,8030,0,2,2,0,4
20751,40,6264,523,8030,0,0,0,1,1
20752,40,6266,975,8030,0,0,0,1,1
20753,40,6267,1049;12916;13263;13468;13687,8030,0,4,1,0,5
20754,40,6268,7592,8030,0,0,1,0,1
20755,40,6269,1242;10101,8030,0,0,2,0,2
20756,40,6271,4294,8030,0,0,0,1,1
20757,40,6272,2085;10156;13487;13861,8030,0,2,2,0,4
20758,40,6273,1218;2013,8030,0,0,2,0,2
20759,40,6274,2067;6649,8030,0,0,2,0,2
20760,40,6278,936,8030,0,0,1,0,1
20761,40,6279,2871;5736,8030,0,0,2,0,2
20762,40,6280,4152,8030,0,0,0,1,1
20763,40,6282,3370,8030,0,0,0,1,1
20764,40,6285,1990;6444,8030,0,0,2,0,2
20765,40,6287,2285;4315,8030,0,0,2,0,2
20766,40,6288,3127;4809;12915;13191;13894;14354,8030,1,3,2,0,6
20767,40,6289,5246,8030,0,0,0,1,1
20768,40,6290,5333;6519,8030,0,0,0,2,2
20769,40,6291,148;5364,8030,0,0,0,2,2
20770,40,6292,5725,8030,0,0,0,1,1
20771,40,6296,5926,8030,0,0,0,1,1
20772,40,6302,2598;13516,8030,0,1,1,0,2
20773,40,6305,5430,8030,0,0,0,1,1
20774,40,6306,7645,8030,0,0,0,1,1
20775,40,6311,7293,8030,0,0,1,0,1
20776,40,6314,2301;9562,8030,0,0,2,0,2
20777,40,6315,9267;10180;12645;13719,8030,0,2,2,0,4
20778,40,6316,1720;9231;14001,8030,0,1,2,0,3
20779,40,6319,10042;10141;13097;13327;13465;14206;14567,8030,2,3,2,0,7
20780,40,6320,3952,8030,0,0,1,0,1
20781,40,6321,10067,8030,0,0,1,0,1
20782,40,6322,10021;10071;14036;14131,8030,1,1,2,0,4
20783,40,6324,10104;12885;13747;13837,8030,0,3,1,0,4
20784,40,6325,10058;10140;12673,8030,0,1,2,0,3
20785,40,6326,10106;10160;13123;13339;13610,8030,0,3,2,0,5
20786,40,6327,10807;10861;12826;13208;14233,8030,1,2,2,0,5
20787,40,6328,10157;10225;12931;13673,8030,0,2,2,0,4
20788,40,6329,10073;10226;13211;13653,8030,0,2,2,0,4
20789,40,6330,10223;10234;12723;13290,8030,0,2,2,0,4
20790,40,6332,10236;10281;12759;12985;13128,8030,0,3,2,0,5
20791,40,6333,10256,8030,0,0,1,0,1
20792,40,6335,10252;10272;13353;14493,8030,1,1,2,0,4
20793,40,6336,10309;10463;13609;13826,8030,0,2,2,0,4
20794,40,6337,10314;10453;12671;13148;14678,8030,1,2,2,0,5
20795,40,6338,10316;10374;13175;13457,8030,0,2,2,0,4
20796,40,6339,10446;10790;13588;14748,8030,1,1,2,0,4
20797,40,6340,10348;10398;12364;12997;13467,8030,0,2,3,0,5
20798,40,6341,10382;12862;13054;13302,8030,0,3,1,0,4
20799,40,6342,10391;10412;12601;13474;13763;14530,8030,1,3,2,0,6
20800,40,6343,10397;10403;13209;13574,8030,0,2,2,0,4
20801,40,6347,383;6336;12440;12858,8395,0,1,3,0,4
20802,40,6348,476;3859;12757,8395,0,1,2,0,3
20803,40,6349,549;4645,8395,0,0,0,2,2
20804,40,6350,2221,8395,0,0,0,1,1
20805,40,6351,5027;10038;13452,8395,0,1,2,0,3
20806,40,6352,1035;2121;13383;14018,8395,0,2,2,0,4
20807,40,6354,1308;9986;13144;13500;14067,8395,0,3,2,0,5
20808,40,6356,2784;8052;12882;14080,8395,0,2,2,0,4
20809,40,6357,1388;10032;13453;14649,8395,1,1,2,0,4
20810,40,6358,1493;10562;13944;14480,8395,1,1,2,0,4
20811,40,6361,2169;3214,8395,0,0,2,0,2
20812,40,6362,2534;12525;12767,8395,0,2,1,0,3
20813,40,6363,3260,8395,0,0,0,1,1
20814,40,6365,4629;8903,8395,0,0,2,0,2
20815,40,6367,8449,8395,0,0,0,1,1
20816,40,6368,6470;6525;12712;13005;13321,8395,0,3,2,0,5
20817,40,6369,3403;10211;12692;14412,8395,1,1,2,0,4
20818,40,6370,7760,8395,0,0,0,1,1
20819,40,6373,6332,8395,0,0,0,1,1
20820,40,6374,3969;10305;12711;13355;13631;13699,8395,0,4,2,0,6
20821,40,6376,6873;7102,8395,0,0,2,0,2
20822,40,6380,4468,8395,0,0,0,1,1
20823,40,6381,8057;12701;13455,8395,0,2,1,0,3
20824,40,6382,4860,8395,0,0,1,0,1
20825,40,6383,10245;12980;13242,8395,0,2,1,0,3
20826,40,6384,4946;10241;13298;13636,8395,0,2,2,0,4
20827,40,6385,5169,8395,0,0,0,1,1
20828,40,6386,4845;10216;13121;13650,8395,0,2,2,0,4
20829,40,6391,6955;9317;12646;13483,8395,0,2,2,0,4
20830,40,6396,1658,8395,0,0,0,1,1
20831,40,6397,8307,8395,0,0,1,0,1
20832,40,6398,8372,8395,0,0,1,0,1
20833,40,6399,1632;8564,8395,0,0,1,1,2
20834,40,6400,9128;9370,8395,0,0,2,0,2
20835,40,6404,4304;9735;13471;13729;14565,8395,1,2,2,0,5
20836,40,6407,253,8395,0,0,0,1,1
20837,40,6408,10011;10353;12909;13810;14167,8395,1,2,2,0,5
20838,40,6409,10238;10465;13720;14125,8395,1,1,2,0,4
20839,40,6410,10074;10126;13489,8395,0,1,2,0,3
20840,40,6412,9365;10088;12555;14283,8395,1,1,2,0,4
20841,40,6413,10096;10210;13521,8395,0,1,2,0,3
20842,40,6414,2751;10097;12936;13542;14250,8395,1,2,2,0,5
20843,40,6415,5186;10114;13366,8395,0,1,2,0,3
20844,40,6417,10523;13172;14336,8395,1,1,1,0,3
20845,40,6418,10521;10553;12550;12680;13803,8395,0,3,2,0,5
20846,40,6419,10144;10372;12764;14052,8395,0,2,2,0,4
20847,40,6421,10149;10251;12833;13357;13806,8395,0,3,2,0,5
20848,40,6422,3247;10170;12707;13246;13416,8395,0,3,2,0,5
20849,40,6423,10193;10498;12506;14045,8395,0,2,2,0,4
20850,40,6424,10109;10208;12751;13419;13688;14457,8395,1,3,2,0,6
20851,40,6426,10215;10269;12614;12785;12988;14464,8395,1,3,2,0,6
20852,40,6427,10134;10591;12617;12828;13522;14721,8395,1,3,2,0,6
20853,40,6428,10333;10727;12583;12979;13303;13775,8395,0,4,2,0,6
20854,40,6429,10152;10351;12562;13583,8395,0,2,2,0,4
20855,40,6430,10228;10359;12945;13510,8395,0,2,2,0,4
20856,40,6431,10007;10380;12881;14075,8395,0,2,2,0,4
20857,40,6432,10336;10431;12977;13546,8395,0,2,2,0,4
20858,40,6433,10434;10472;12704;14605,8395,1,1,2,0,4
20859,40,6434,10350;10436;12515;14184,8395,1,1,2,0,4
20860,40,6435,10325;10449;13559;14544,8395,1,1,2,0,4
20861,40,6436,10290;10450;12660;13718,8395,0,2,2,0,4
20862,40,6437,10574;10754;12672,8395,0,1,2,0,3
20863,40,6438,10578;10788;12783;14149,8395,1,1,2,0,4
20864,40,6439,8013,8760,0,0,1,0,1
20865,40,6440,10344;10381;12814;13935,8760,0,2,2,0,4
20866,40,6444,350,8760,0,0,1,0,1
20867,40,6446,10085;13604;13748,8760,0,2,1,0,3
20868,40,6447,1345;5433;13888;14230,8760,1,1,2,0,4
20869,40,6448,1565;10399;12860;13443;13889;14333,8760,1,3,2,0,6
20870,40,6451,7086;8661,8760,0,0,0,2,2
20871,40,6452,9751;12625;13163,8760,0,2,1,0,3
20872,40,6454,7037;10102;12847;13626;13715,8760,0,3,2,0,5
20873,40,6457,2972,8760,0,0,1,0,1
20874,40,6459,3070;6612;12760;13044,8760,0,2,2,0,4
20875,40,6461,3241;10099;13535;14200,8760,1,1,2,0,4
20876,40,6462,3267;14197,8760,1,0,1,0,2
20877,40,6464,347;3759;13192,8760,0,1,2,0,3
20878,40,6465,5840,8760,0,0,0,1,1
20879,40,6466,5775;10183;13477;14202,8760,1,1,2,0,4
20880,40,6467,2246;4148,8760,0,0,2,0,2
20881,40,6470,2700;3457,8760,0,0,2,0,2
20882,40,6472,8954,8760,0,0,0,1,1
20883,40,6481,6494,8760,0,0,1,0,1
20884,40,6483,1705;6654;12771;13025,8760,0,2,2,0,4
20885,40,6485,8238,8760,0,0,1,0,1
20886,40,6488,5013,8760,0,0,1,0,1
20887,40,6489,8626,8760,0,0,0,1,1
20888,40,6490,3731;5590;12753,8760,0,1,2,0,3
20889,40,6491,7972;9849;13268,8760,0,1,2,0,3
20890,40,6492,4210;8033,8760,0,0,2,0,2
20891,40,6493,8065;8878;13230,8760,0,1,2,0,3
20892,40,6494,8324,8760,0,0,1,0,1
20893,40,6495,8384,8760,0,0,1,0,1
20894,40,6496,199;8526,8760,0,0,2,0,2
20895,40,6499,8921,8760,0,0,0,1,1
20896,40,6501,4990;9506;12637;12742;13213,8760,0,3,2,0,5
20897,40,6503,9788;10035;13456;13700;13830;14613,8760,1,3,2,0,6
20898,40,6504,10025;10310;13388;13624;14034,8760,0,3,2,0,5
20899,40,6505,10195;12821;13008;13389,8760,0,3,1,0,4
20900,40,6506,10066;10138;13259;13424;13805;14361,8760,1,3,2,0,6
20901,40,6507,10330,8760,0,0,1,0,1
20902,40,6508,10167;10250;13539;14059;14342,8760,1,2,2,0,5
20903,40,6509,10233;10579;13568;13989;14108;14489,8760,2,2,2,0,6
20904,40,6511,10735;12650,8760,0,1,1,0,2
20905,40,6513,10501;10668;13481;14105;14385,8760,2,1,2,0,5
20906,40,6514,10023;10118;13181;13794,8760,0,2,2,0,4
20907,40,6515,10128;10411;12969;13543,8760,0,2,2,0,4
20908,40,6516,10423;10741;12685;13047;13818,8760,0,3,2,0,5
20909,40,6517,10176;10425;13162;14009,8760,0,2,2,0,4
20910,40,6518,10427;10674;12735;12978;13256;13682,8760,0,4,2,0,6
20911,40,6519,10428;10590;14089;14453,8760,2,0,2,0,4
20912,40,6520,10461;12827;12930;14054,8760,0,3,1,0,4
20913,40,6521,10494;10895;12626;13059,8760,0,2,2,0,4
20914,40,6522,878;10068;13585,8760,0,1,2,0,3
20915,40,6523,10513;10850;12631,8760,0,1,2,0,3
20916,40,6524,10517;10661;12726;12774;13735;13986,8760,0,4,2,0,6
20917,40,6525,10519;12658;13299;13898;13979,8760,0,4,1,0,5
20918,40,6526,10524;10797;12737;13829;14037;14351,8760,1,3,2,0,6
20919,40,6527,10355;10534;13520;14314,8760,1,1,2,0,4
20920,40,6528,10339;10547;13003;13706;13849;14362,8760,1,3,2,0,6
20921,40,6529,10324;10563;13867;14102,8760,1,1,2,0,4
20922,40,6530,10658;10838;12664;13220,8760,0,2,2,0,4
20923,40,6531,10583;10671;12715;12781;13006;13956,8760,0,4,2,0,6
20924,40,6532,10274;10595;12784;13779,8760,0,2,2,0,4
20925,40,6533,10597;12934;14011,8760,0,2,1,0,3
20926,40,6534,2735,9125,0,0,0,1,1
20927,40,6538,802;837,9125,0,0,2,0,2
20928,40,6539,1001;4272,9125,0,0,2,0,2
20929,40,6541,10424;10455;12696;13387;13449,9125,0,3,2,0,5
20930,40,6542,3137;12853;13232;13926,9125,0,3,1,0,4
20931,40,6543,1059;9769,9125,0,0,2,0,2
20932,40,6546,7119,9125,0,0,1,0,1
20933,40,6552,2567;2937,9125,0,0,1,1,2
20934,40,6553,6680,9125,0,0,0,1,1
20935,40,6557,10108;10254;13294;13756,9125,0,2,2,0,4
20936,40,6558,1590,9125,0,0,0,1,1
20937,40,6561,3507;7856,9125,0,0,2,0,2
20938,40,6563,8269;8389,9125,0,0,2,0,2
20939,40,6564,7115;10159;12676;13377;13581,9125,0,3,2,0,5
20940,40,6568,5522;10182;14048;14647,9125,1,1,2,0,4
20941,40,6571,10177;13218,9125,0,1,1,0,2
20942,40,6574,367;7346;12829;13485,9125,0,2,2,0,4
20943,40,6575,5109,9125,0,0,0,1,1
20944,40,6578,1668;2920,9125,0,0,2,0,2
20945,40,6580,2429,9125,0,0,0,1,1
20946,40,6581,8395,9125,0,0,0,1,1
20947,40,6582,8659,9125,0,0,0,1,1
20948,40,6584,10621;10696;12809;13331;13684;13873,9125,0,4,2,0,6
20949,40,6587,10153;13361;14069;14560,9125,1,2,1,0,4
20950,40,6589,447;10100;13310;14651,9125,1,1,2,0,4
20951,40,6590,10127;10467;12825;14119,9125,1,1,2,0,4
20952,40,6591,10967;12956;13385;13896;14147,9125,1,3,1,0,5
20953,40,6592,10485;13356;13710,9125,0,2,1,0,3
20954,40,6593,10005;10194;13164,9125,0,1,2,0,3
20955,40,6594,1164;10202;13222;13482,9125,0,2,2,0,4
20956,40,6595,10207;13324;13667,9125,0,2,1,0,3
20957,40,6596,10539;13892;14619,9125,1,1,1,0,3
20958,40,6597,10146;10396;12788;13570,9125,0,2,2,0,4
20959,40,6598,10220;10481;12739;13942,9125,0,2,2,0,4
20960,40,6599,10268;10368;13292;14499;14719,9125,2,1,2,0,5
20961,40,6600,10409;10558;13234;14051,9125,0,2,2,0,4
20962,40,6601,10435;10628;13649;14177;14357,9125,2,1,2,0,5
20963,40,6602,10440;10947;13179,9125,0,1,2,0,3
20964,40,6603,10447;10639;13077;13912;14731,9125,1,2,2,0,5
20965,40,6604,10540;10636;14062;14497,9125,1,1,2,0,4
20966,40,6605,10466;10650;13168;13569;14427,9125,1,2,2,0,5
20967,40,6606,10497;10605;13778;14241,9125,1,1,2,0,4
20968,40,6607,10798;10988;12955;13515;13630;13858;14133,9125,1,4,2,0,7
20969,40,6608,10739;10762;12811,9125,0,1,2,0,3
20970,40,6609,10418;10536;12787;13815;14031,9125,0,3,2,0,5
20971,40,6611,10587;10866;12776,9125,0,1,2,0,3
20972,40,6612,10627;12803;13061;13402;14469,9125,1,3,1,0,5
20973,40,6613,10469;10601;13980;14207;14643,9125,2,1,2,0,5
20974,40,6614,10533;10610;13238;13874;14315;14451,9125,2,2,2,0,6
20975,40,6615,10608;10955;12896;13475,9125,0,2,2,0,4
20976,40,6616,10613;10623;13360;14074,9125,0,2,2,0,4
20977,40,6617,10624;10763;12971;13525;13823,9125,0,3,2,0,5
20978,40,6618,10280;10625;12841;13266;14243,9125,1,2,2,0,5
20979,40,6619,10646;10848;14370,9125,1,0,2,0,3
20980,40,6620,10542;10657;12867;14401;14556,9125,2,1,2,0,5
20981,40,6621,10495;10675;13161;13963;14328,9125,1,2,2,0,5
20982,40,6622,10677;10842;13613;14152,9125,1,1,2,0,4
20983,40,6623,10626;10679;13679;14172,9125,1,1,2,0,4
20984,40,6624,10692;10873;14356,9125,1,0,2,0,3
20985,40,6625,10695;10716;13284;13469;13969;14434,9125,1,3,2,0,6
20986,40,6629,723,9490,0,0,0,1,1
20987,40,6630,909,9490,0,0,1,0,1
20988,40,6631,6587;7496,9490,0,0,2,0,2
20989,40,6633,1631,9490,0,0,0,1,1
20990,40,6635,307,9490,0,0,0,1,1
20991,40,6636,1952,9490,0,0,1,0,1
20992,40,6637,1689;8129,9490,0,0,0,2,2
20993,40,6639,877;1840,9490,0,0,2,0,2
20994,40,6640,4011,9490,0,0,0,1,1
20995,40,6646,3713;8150;13176,9490,0,1,2,0,3
20996,40,6648,452,9490,0,0,1,0,1
20997,40,6652,4815,9490,0,0,1,0,1
20998,40,6653,4589;7241,9490,0,0,0,2,2
20999,40,6657,2953;9204,9490,0,0,0,2,2
21000,40,6660,6660;8408;12864;13135,9490,0,2,2,0,4
21001,40,6661,6801,9490,0,0,0,1,1
21002,40,6664,1021,9490,0,0,0,1,1
21003,40,6665,7396,9490,0,0,1,0,1
21004,40,6666,3849,9490,0,0,1,0,1
21005,40,6667,1140;7485,9490,0,0,2,0,2
21006,40,6668,1192;7561,9490,0,0,2,0,2
21007,40,6669,7720;8154,9490,0,0,1,1,2
21008,40,6671,9826,9490,0,0,1,0,1
21009,40,6673,6469;8697;13138;13524,9490,0,2,2,0,4
21010,40,6675,247;3019;13797,9490,0,1,2,0,3
21011,40,6677,9117,9490,0,0,1,0,1
21012,40,6680,9113,9490,0,0,1,0,1
21013,40,6682,10009,9490,0,0,1,0,1
21014,40,6684,10300;10457;13011;13283;13936,9490,0,3,2,0,5
21015,40,6686,10143;10489;13365;13491,9490,0,2,2,0,4
21016,40,6687,10253;10510;12926;13045;13249;13410,9490,0,4,2,0,6
21017,40,6688,10162;10508;14114;14594,9490,2,0,2,0,4
21018,40,6689,10171;10615;13571;14176;14478,9490,2,1,2,0,5
21019,40,6690,10190;10267;13399,9490,0,1,2,0,3
21020,40,6691,10285;10376;13391;13943;14208,9490,1,2,2,0,5
21021,40,6693,10039;10340;13031;13853,9490,0,2,2,0,4
21022,40,6694,7530;10192;13134;14667,9490,1,1,2,0,4
21023,40,6695,10443;10515;13438;13724;14032;14409,9490,1,3,2,0,6
21024,40,6696,10196;10445;13260;14103,9490,1,1,2,0,4
21025,40,6697,1051;9098,9490,0,0,2,0,2
21026,40,6698,10459;10504;13270;14004;14118,9490,1,2,2,0,5
21027,40,6699,10474;10881;13204;13594;14555,9490,1,2,2,0,5
21028,40,6700,10573;12912;14323,9490,1,1,1,0,3
21029,40,6701,10493;10792;13417;14178,9490,1,1,2,0,4
21030,40,6702,10123;10503;13254;13426,9490,0,2,2,0,4
21031,40,6703,10320;10546;13563;13974,9490,0,2,2,0,4
21032,40,6704,10555;10645;13070;13183;13978,9490,0,3,2,0,5
21033,40,6705,10560;10564;14081;14187,9490,1,1,2,0,4
21034,40,6706,10576;10799;13149;13971;14382,9490,1,2,2,0,5
21035,40,6707,10297;10577;13265;13814;14025;14253,9490,1,3,2,0,6
21036,40,6708,10293;10585;13065;13245;13532;13809,9490,0,4,2,0,6
21037,40,6709,10580;10592;13812;14620,9490,1,1,2,0,4
21038,40,6710,10528;10604;13432;13946;14398,9490,1,2,2,0,5
21039,40,6711,10419;10609;13382;13902,9490,0,2,2,0,4
21040,40,6712,10611;10885;13842;14625,9490,1,1,2,0,4
21041,40,6713,10259;10616;13766;14285;14468,9490,2,1,2,0,5
21042,40,6714,10632;10687;13056;13634;14260,9490,1,2,2,0,5
21043,40,6715,10640;10769;12940;13396;13413;13587,9490,0,4,2,0,6
21044,40,6716,10483;10827;13553;14266,9490,1,1,2,0,4
21045,40,6717,10337;10670;13160;13619;14477,9490,1,2,2,0,5
21046,40,6718,10676;10731;12970;13934;14044,9490,0,3,2,0,5
21047,40,6719,10681;10825;12887;13367;13692;14017;14344,9490,1,4,2,0,7
21048,40,6720,10700;10752;13354,9490,0,1,2,0,3
21049,40,6721,10713;11010;13165;13644,9490,0,2,2,0,4
21050,40,6722,10720;11053;13159;13534;13646;13802;13995,9490,0,5,2,0,7
21051,40,6723,10733;10977;12963;14438,9490,1,1,2,0,4
21052,40,6724,10878;12872;13291,9490,0,2,1,0,3
21053,40,6725,10791;10821;12991;13244;14229;14430,9490,2,2,2,0,6
21054,40,6727,458,9855,0,0,0,1,1
21055,40,6728,5731;10421;13703;14268,9855,1,1,2,0,4
21056,40,6729,879;3198,9855,0,0,2,0,2
21057,40,6730,4189,9855,0,0,1,0,1
21058,40,6731,5967;8417,9855,0,0,2,0,2
21059,40,6732,1981,9855,0,0,0,1,1
21060,40,6736,9238,9855,0,0,1,0,1
21061,40,6738,1247;2621,9855,0,0,2,0,2
21062,40,6739,3087,9855,0,0,1,0,1
21063,40,6740,3122;8949,9855,0,0,2,0,2
21064,40,6743,6347;6537,9855,0,0,2,0,2
21065,40,6744,3561;10079;13831,9855,0,1,2,0,3
21066,40,6749,4448;9364;13375,9855,0,1,2,0,3
21067,40,6750,3842;4470,9855,0,0,2,0,2
21068,40,6754,4956,9855,0,0,1,0,1
21069,40,6755,2265,9855,0,0,1,0,1
21070,40,6756,684;9103,9855,0,0,2,0,2
21071,40,6757,5187;10048;14110;14681,9855,2,0,2,0,4
21072,40,6765,5864;7893,9855,0,0,2,0,2
21073,40,6766,4258;8567,9855,0,0,2,0,2
21074,40,6767,460;8763,9855,0,0,2,0,2
21075,40,6769,5231;9281,9855,0,0,2,0,2
21076,40,6772,2273;9985,9855,0,0,2,0,2
21077,40,6773,2910;10029;13348;14306,9855,1,1,2,0,4
21078,40,6774,10430;14224;14523,9855,2,0,1,0,3
21079,40,6775,4471;10239;13280;13772;13966,9855,0,3,2,0,5
21080,40,6776,10230;10264;13552;13993;14321,9855,1,2,2,0,5
21081,40,6777,10266;10315;13051;13350;14000,9855,0,3,2,0,5
21082,40,6778,10294;10548;13318;13621;14043,9855,0,3,2,0,5
21083,40,6779,6443;10304;13320;14203;14479,9855,2,1,2,0,5
21084,40,6780,10341;10532;13228;14312,9855,1,1,2,0,4
21085,40,6781,10091;10362;13277;13598;14586,9855,1,2,2,0,5
21086,40,6782,10365;10490;13293;13627,9855,0,2,2,0,4
21087,40,6783,10037;10366;13433;13561,9855,0,2,2,0,4
21088,40,6784,10352;10369;13397;14040,9855,0,2,2,0,4
21089,40,6785,10358;10402;13409;13910,9855,0,2,2,0,4
21090,40,6786,10464;13343;13975,9855,0,2,1,0,3
21091,40,6787,10072;10506;13174;13769,9855,0,2,2,0,4
21092,40,6788,10702;10968;13229;13677;13795,9855,0,3,2,0,5
21093,40,6789,10456;10853;14158;14277,9855,2,0,2,0,4
21094,40,6790,10909;13095;14455;14750,9855,2,1,1,0,4
21095,40,6791,10145;10545;13345;13939,9855,0,2,2,0,4
21096,40,6792,10488;10588;13152;13657;13865;14368,9855,1,3,2,0,6
21097,40,6793,10529;10871;13039;14640,9855,1,1,2,0,4
21098,40,6794,10584;13573;14085,9855,1,1,1,0,3
21099,40,6796,10620;10975;13060;13371,9855,0,2,2,0,4
21100,40,6797,10630;10701;14146;14440,9855,2,0,2,0,4
21101,40,6798,10393;10631;13029;13575;13665;14165,9855,1,3,2,0,6
21102,40,6799,10648;10892;13278;14174,9855,1,1,2,0,4
21103,40,6800,10654;10758;13235;14086;14569,9855,2,1,2,0,5
21104,40,6801,10603;10669;13087;14106,9855,1,1,2,0,4
21105,40,6802,10634;10703;13041;14371,9855,1,1,2,0,4
21106,40,6803,10551;10705;13241;14061;14220,9855,1,2,2,0,5
21107,40,6804,11130;11185;13369;13640;13757;13860,9855,0,4,2,0,6
21108,40,6805,10747;11004;13023;13637;13973,9855,0,3,2,0,5
21109,40,6806,10734;10779;14016;14700,9855,1,1,2,0,4
21110,40,6807,10690;10785;13614;14135;14688,9855,2,1,2,0,5
21111,40,6808,10499;10795;13243;14271;14576,9855,2,1,2,0,5
21112,40,6809,10442;10812;13722;14345,9855,1,1,2,0,4
21113,40,6810,10816;11110;13014;13386,9855,0,2,2,0,4
21114,40,6811,10836;11025;13002;13497;14050;14741,9855,1,3,2,0,6
21115,40,6812,10847;13086;14327;14710,9855,2,1,1,0,4
21116,40,6813,10879;10889;13185;13656;13953;14325,9855,1,3,2,0,6
21117,40,6814,10899;10970;13200;13781;14107;14630,9855,2,2,2,0,6
21118,40,6815,10903;11197;13359;13642,9855,0,2,2,0,4
21119,40,6816,84,10220,0,0,1,0,1
21120,40,6817,232,10220,0,0,0,1,1
21121,40,6820,8643,10220,0,0,1,0,1
21122,40,6821,718,10220,0,0,0,1,1
21123,40,6823,3289;4475,10220,0,0,2,0,2
21124,40,6824,1892,10220,0,0,0,1,1
21125,40,6826,5257,10220,0,0,1,0,1
21126,40,6827,2464,10220,0,0,0,1,1
21127,40,6828,2625,10220,0,0,1,0,1
21128,40,6829,162,10220,0,0,0,1,1
21129,40,6833,4525,10220,0,0,0,1,1
21130,40,6834,6107;9883,10220,0,0,2,0,2
21131,40,6835,5969,10220,0,0,1,0,1
21132,40,6838,2878,10220,0,0,1,0,1
21133,40,6839,414,10220,0,0,1,0,1
21134,40,6840,6002;10286;13349;14561,10220,1,1,2,0,4
21135,40,6841,6212;6702,10220,0,0,2,0,2
21136,40,6842,89;5128;13342,10220,0,1,2,0,3
21137,40,6843,6348;10189;13891,10220,0,1,2,0,3
21138,40,6846,6848;7295,10220,0,0,2,0,2
21139,40,6849,4542,10220,0,0,1,0,1
21140,40,6850,7101,10220,0,0,1,0,1
21141,40,6851,2497,10220,0,0,0,1,1
21142,40,6859,1471,10220,0,0,1,0,1
21143,40,6860,10150;10282;13323;14101,10220,1,1,2,0,4
21144,40,6861,10017;10572;13253;14198,10220,1,1,2,0,4
21145,40,6862,865;7890,10220,0,0,2,0,2
21146,40,6863,10136;10289;13401;14695,10220,1,1,2,0,4
21147,40,6865,10130;10385;13341;13880,10220,0,2,2,0,4
21148,40,6867,10062;10222;13852;13955,10220,0,2,2,0,4
21149,40,6869,10326;10375;13197;13847,10220,0,2,2,0,4
21150,40,6870,10470;10730;13758;14141;14487,10220,2,1,2,0,5
21151,40,6871,10370;10784;13726;14056,10220,0,2,2,0,4
21152,40,6872,10276;10569;13927;14572,10220,1,1,2,0,4
21153,40,6873,10664;10685;13212;13733,10220,0,2,2,0,4
21154,40,6874,10244;10728;14537,10220,1,0,2,0,3
21155,40,6875,10392;10688;13308;13911;14505,10220,1,2,2,0,5
21156,40,6876,10694;13701;14270;14578,10220,2,1,1,0,4
21157,40,6877,11023;11243;13154;13768;13918,10220,0,3,2,0,5
21158,40,6878,10198;10800;13567,10220,0,1,2,0,3
21159,40,6879,10840;10934;13297,10220,0,1,2,0,3
21160,40,6880,10723;10888;13150;13796;14024,10220,0,3,2,0,5
21161,40,6881,10898;10907;13446;13582;14269;14606,10220,2,2,2,0,6
21162,40,6882,10932;11086;13592;13730;14060,10220,0,3,2,0,5
21163,40,6883,10948;11131;13315;13612;13887;14122;14702,10220,2,3,2,0,7
21164,40,6884,10956;11152;13279;13603,10220,0,2,2,0,4
21165,40,6885,10961;11195;13743;14386,10220,1,1,2,0,4
21166,40,6886,10776;11088;13223;13504;14151;14593,10220,2,2,2,0,6
21167,40,6887,10896;10984;13272;14445,10220,1,1,2,0,4
21168,40,6888,10771;10995;13792;14743,10220,1,1,2,0,4
21169,40,6889,11137;13875,10220,0,1,1,0,2
21170,40,6890,11000;11144;14035,10220,0,1,2,0,3
21171,40,6892,387,10585,0,0,0,1,1
21172,40,6895,804;10026;13864;14658,10585,1,1,2,0,4
21173,40,6896,806,10585,0,0,0,1,1
21174,40,6897,3798;13484;13625,10585,0,2,1,0,3
21175,40,6898,1485,10585,0,0,1,0,1
21176,40,6899,1803,10585,0,0,1,0,1
21177,40,6900,10133;13317,10585,0,1,1,0,2
21178,40,6901,2147,10585,0,0,0,1,1
21179,40,6907,6970,10585,0,0,1,0,1
21180,40,6909,357,10585,0,0,1,0,1
21181,40,6910,4124;4871,10585,0,0,0,2,2
21182,40,6911,2389;5174,10585,0,0,2,0,2
21183,40,6913,1719;5365,10585,0,0,2,0,2
21184,40,6915,7191,10585,0,0,1,0,1
21185,40,6916,9086,10585,0,0,0,1,1
21186,40,6921,3690;9797,10585,0,0,2,0,2
21187,40,6922,10008;10247;13376;13605,10585,0,2,2,0,4
21188,40,6924,10249;10683;14498;14690,10585,2,0,2,0,4
21189,40,6925,10013;10408;13694;14039,10585,0,2,2,0,4
21190,40,6926,10389,10585,0,0,1,0,1
21191,40,6927,10452;10782;13319;14402,10585,1,1,2,0,4
21192,40,6928,10185;10405;13427;14258,10585,1,1,2,0,4
21193,40,6929,10417;10718;14372;14708,10585,2,0,2,0,4
21194,40,6930,10507,10585,0,0,1,0,1
21195,40,6931,10462;10531;13332;13698;14472,10585,1,2,2,0,5
21196,40,6932,10567;10637;13695;14574,10585,1,1,2,0,4
21197,40,6933,10665;10859;13304;14456,10585,1,1,2,0,4
21198,40,6934,10004;10070;14223,10585,1,0,2,0,3
21199,40,6935,10709;10759;13745;14337,10585,1,1,2,0,4
21200,40,6936,10811;11058,10585,0,0,2,0,2
21201,40,6937,10641;10822;13732;14330;14577,10585,2,1,2,0,5
21202,40,6938,10832;11060;13704;14053,10585,0,2,2,0,4
21203,40,6939,10487;10833;13300,10585,0,1,2,0,3
21204,40,6940,10841;10868;13622,10585,0,1,2,0,3
21205,40,6941,10843;10857;13721;14672,10585,1,1,2,0,4
21206,40,6943,10864;10921;13490;14082;14332,10585,2,1,2,0,5
21207,40,6944,10426;10867;13990;14521,10585,1,1,2,0,4
21208,40,6945,10783;10887;13381;14132,10585,1,1,2,0,4
21209,40,6946,10849;10891;13738;14100,10585,1,1,2,0,4
21210,40,6947,10912;11344;14254,10585,1,0,2,0,3
21211,40,6948,10926;11552,10585,0,0,2,0,2
21212,40,6949,10770;11132;13789;13854;14689,10585,1,2,2,0,5
21213,40,6950,10893;11147;14068;14575,10585,1,1,2,0,4
21214,40,6951,10996;11018;13762;14355;14476,10585,2,1,2,0,5
21215,40,6952,10714;11045;14745,10585,1,0,2,0,3
21216,40,6953,11047;11274;13787;13848;14461,10585,1,2,2,0,5
21217,40,6954,10635;11054;13924;14020,10585,0,2,2,0,4
21218,40,6955,11069,10585,0,0,1,0,1
21219,40,6956,11051;11080;13791;14275,10585,1,1,2,0,4
21220,40,6957,11095;11343;13968;14350,10585,1,1,2,0,4
21221,40,6959,134,10950,0,0,0,1,1
21222,40,6960,368,10950,0,0,0,1,1
21223,40,6961,489;8831,10950,0,0,2,0,2
21224,40,6962,988;10010;13316,10950,0,1,2,0,3
21225,40,6963,1191,10950,0,0,1,0,1
21226,40,6968,2422,10950,0,0,1,0,1
21227,40,6969,2455,10950,0,0,1,0,1
21228,40,6970,2543,10950,0,0,1,0,1
21229,40,6972,1923;4377,10950,0,0,0,2,2
21230,40,6975,636;8824,10950,0,0,2,0,2
21231,40,6976,2774,10950,0,0,1,0,1
21232,40,6977,3438,10950,0,0,1,0,1
21233,40,6978,3450,10950,0,0,1,0,1
21234,40,6980,8760;9077,10950,0,0,2,0,2
21235,40,6981,5301,10950,0,0,1,0,1
21236,40,6983,2244;8987,10950,0,0,2,0,2
21237,40,6985,3517;9043,10950,0,0,2,0,2
21238,40,6990,5604;7986,10950,0,0,2,0,2
21239,40,6991,6408,10950,0,0,1,0,1
21240,40,6993,8106,10950,0,0,1,0,1
21241,40,6994,9102,10950,0,0,1,0,1
21242,40,6996,7320,10950,0,0,0,1,1
21243,40,6998,10213,10950,0,0,1,0,1
21244,40,6999,10231;10606;13530;14273;14720,10950,2,1,2,0,5
21245,40,7000,10154;10311;13538;14038;14153,10950,1,2,2,0,5
21246,40,7002,136;10095;13960,10950,0,1,2,0,3
21247,40,7003,10378;10413;13421;13651,10950,0,2,2,0,4
21248,40,7005,10394;10557;13672;13947,10950,0,2,2,0,4
21249,40,7006,10550,10950,0,0,1,0,1
21250,40,7007,10186;10420;14104;14310,10950,2,0,2,0,4
21251,40,7008,10698,10950,0,0,1,0,1
21252,40,7009,10743;10756;13476;13591;13904;14353,10950,1,3,2,0,6
21253,40,7010,10744;11037;13496;13557;14093;14319;14738,10950,3,2,2,0,7
21254,40,7012,10764;10805;13681;14073,10950,0,2,2,0,4
21255,40,7013,10765;10924;13430;14407,10950,1,1,2,0,4
21256,40,7014,10342;10793;13513;14483,10950,1,1,2,0,4
21257,40,7015,10642;10796;14163;14417,10950,2,0,2,0,4
21258,40,7016,10927;11268;13470;13725;14096,10950,1,2,2,0,5
21259,40,7017,10693;10808;13755;14691,10950,1,1,2,0,4
21260,40,7018,10817;10987;13652;13862,10950,0,2,2,0,4
21261,40,7019,10845;11168;14473,10950,1,0,2,0,3
21262,40,7020,10789;10883;13528;13940,10950,0,2,2,0,4
21263,40,7021,10950;11093;14545,10950,1,0,2,0,3
21264,40,7022,10953;11296;13400;13712,10950,0,2,2,0,4
21265,40,7023,10958;11077;13834;14166,10950,1,1,2,0,4
21266,40,7024,10972;11174;13505;13660;13872;14307,10950,1,3,2,0,6
21267,40,7025,10755;10851;14246;14595,10950,2,0,2,0,4
21268,40,7026,10979;11284;13856,10950,0,1,2,0,3
21269,40,7027,10638;10981;14365,10950,1,0,2,0,3
21270,40,7028,10989;11122;13517;13607;14676,10950,1,2,2,0,5
21271,40,7029,11005;11460;13577;13671;14403,10950,1,2,2,0,5
21272,40,7030,10919;11006;14390;14546,10950,2,0,2,0,4
21273,40,7032,11035;11248;13817;14218,10950,1,1,2,0,4
21274,40,7033,11036;11048;14300;14585,10950,2,0,2,0,4
21275,40,7034,11041;11170;13884;14065;14428;14712,10950,2,2,2,0,6
21276,40,7035,11059;11462;13584;13923;14559;14660,10950,2,2,2,0,6
21277,40,7036,11392;11415;13648;13893;14393,10950,1,2,2,0,5
21278,40,7037,11068;11326;13663;14008;14465,10950,1,2,2,0,5
21279,40,7038,11298;14058,10950,0,1,1,0,2
21280,40,7039,11099;13618;13890;14616,10950,1,2,1,0,4
21281,40,7040,11102;11374;14744,10950,1,0,2,0,3
21282,40,7041,10824;11103;13827,10950,0,1,2,0,3
21283,40,7042,11281;13596;13759;14318,10950,1,2,1,0,4
21284,40,7043,11126;11441;13638,10950,0,1,2,0,3
21285,40,7044,11055;11128;13824;14211;14396,10950,2,1,2,0,5
21286,40,7045,10928;11029;14421;14612,10950,2,0,2,0,4
21287,40,7046,11159;13696;14013,10950,0,2,1,0,3
21288,40,7047,10942;11145;13914,10950,0,1,2,0,3
21289,40,7048,11154;11299;14618,10950,1,0,2,0,3
21290,40,7049,11162;11251;14471,10950,1,0,2,0,3
21291,40,7050,11165;11409;13565;13807;14458,10950,1,2,2,0,5
21292,40,7051,11187;11339;13639;14335;14627,10950,2,1,2,0,5
21293,40,7052,11188;11261;13501;13717;14514,10950,1,2,2,0,5
21294,40,7053,3832,11315,0,0,1,0,1
21295,40,7054,554;3133,11315,0,0,2,0,2
21296,40,7055,661,11315,0,0,0,1,1
21297,40,7057,926,11315,0,0,0,1,1
21298,40,7059,1284,11315,0,0,1,0,1
21299,40,7060,6254,11315,0,0,0,1,1
21300,40,7063,5598,11315,0,0,0,1,1
21301,40,7064,3795,11315,0,0,1,0,1
21302,40,7065,3863;10242;14021;14596,11315,1,1,2,0,4
21303,40,7066,3940;6856,11315,0,0,2,0,2
21304,40,7067,4092,11315,0,0,1,0,1
21305,40,7068,4290,11315,0,0,1,0,1
21306,40,7069,10429;10478;13523;14730,11315,1,1,2,0,4
21307,40,7070,4535,11315,0,0,1,0,1
21308,40,7071,2692,11315,0,0,1,0,1
21309,40,7073,4812,11315,0,0,0,1,1
21310,40,7075,3256;6370,11315,0,0,2,0,2
21311,40,7080,711;8622,11315,0,0,2,0,2
21312,40,7081,7223,11315,0,0,1,0,1
21313,40,7082,5557;7410;13655;13828,11315,0,2,2,0,4
21314,40,7083,7445;10179;13930;14339,11315,1,1,2,0,4
21315,40,7089,9704,11315,0,0,0,1,1
21316,40,7091,4151,11315,0,0,1,0,1
21317,40,7092,9987,11315,0,0,1,0,1
21318,40,7093,10006;10388;13617;13950;14551,11315,1,2,2,0,5
21319,40,7095,9247;10279;13782;14055,11315,0,2,2,0,4
21320,40,7096,10135;10137;13556;14113,11315,1,1,2,0,4
21321,40,7097,8839,11315,0,0,1,0,1
21322,40,7098,10313;13590;14609,11315,1,1,1,0,3
21323,40,7099,10360;10404;13589;13913,11315,0,2,2,0,4
21324,40,7100,10441;10897;13737;14341,11315,1,1,2,0,4
21325,40,7101,10454;10794;14175,11315,1,0,2,0,3
21326,40,7102,10361;13932;14002,11315,0,2,1,0,3
21327,40,7103,10505;10761;14358,11315,1,0,2,0,3
21328,40,7104,10543;10742;13961;14261,11315,1,1,2,0,4
21329,40,7105,11073;11277;13600;14047,11315,0,2,2,0,4
21330,40,7107,10617;11034;13669;13977;14510,11315,1,2,2,0,5
21331,40,7108,10629;10991;13576;14548;14729,11315,2,1,2,0,5
21332,40,7110,10766;11061;14162;14363;14709,11315,3,0,2,0,5
21333,40,7111,10778;10802;13707;14077;14432,11315,1,2,2,0,5
21334,40,7112,10844;14227;14538;14679,11315,3,0,1,0,4
21335,40,7113,10862;10935;13693;14244,11315,1,1,2,0,4
21336,40,7114,10719;10901;14582,11315,1,0,2,0,3
21337,40,7115,10914;11087;13798;14084,11315,1,1,2,0,4
21338,40,7116,10777;10930;13825;14210,11315,1,1,2,0,4
21339,40,7117,10775;10931;13632;14470,11315,1,1,2,0,4
21340,40,7118,10936;11158;13597;13850;14573,11315,1,2,2,0,5
21341,40,7119,10943;11267;13554;14279;14737,11315,2,1,2,0,5
21342,40,7120,10549;10974;13586;14022;14193;14598,11315,2,2,2,0,6
21343,40,7121,10810;10976;13841;14749,11315,1,1,2,0,4
21344,40,7123,11007;13844;14196,11315,1,1,1,0,3
21345,40,7124,11067,11315,0,0,1,0,1
21346,40,7125,11526;14215;14225,11315,2,0,1,0,3
21347,40,7126,10925;11084;14425,11315,1,0,2,0,3
21348,40,7127,10815;11101;13988;14265,11315,1,1,2,0,4
21349,40,7128,10699;11105;14079;14484,11315,1,1,2,0,4
21350,40,7129,11218;14010;14724,11315,1,1,1,0,3
21351,40,7130,10969;11156;13783,11315,0,1,2,0,3
21352,40,7131,11082,11315,0,0,1,0,1
21353,40,7132,11033;11179;13641;13750;14296;14512,11315,2,2,2,0,6
21354,40,7133,11186;11189;14324,11315,1,0,2,0,3
21355,40,7134,11233;13579,11315,0,1,1,0,2
21356,40,7135,11113;11249;13813;14474,11315,1,1,2,0,4
21357,40,7136,11246;11271;13964;14111;14637,11315,2,1,2,0,5
21358,40,7137,11013;11278;13645;13895;13962,11315,0,3,2,0,5
21359,40,7140,5738;9161;13933,11680,0,1,2,0,3
21360,40,7141,3150;5549,11680,0,0,1,1,2
21361,40,7142,3276,11680,0,0,1,0,1
21362,40,7144,1158,11680,0,0,1,0,1
21363,40,7149,4515;10298;13999,11680,0,1,2,0,3
21364,40,7150,8753,11680,0,0,0,1,1
21365,40,7151,3886;4295;13897;14506,11680,1,1,2,0,4
21366,40,7152,6719,11680,0,0,1,0,1
21367,40,7154,6923,11680,0,0,0,1,1
21368,40,7155,7443,11680,0,0,1,0,1
21369,40,7157,8732,11680,0,0,0,1,1
21370,40,7158,9271,11680,0,0,0,1,1
21371,40,7159,5526;8100,11680,0,0,2,0,2
21372,40,7160,6805;9729;14571,11680,1,0,2,0,3
21373,40,7163,6620,11680,0,0,0,1,1
21374,40,7165,9316;10237;13675;14171,11680,1,1,2,0,4
21375,40,7167,9741;14374;14715,11680,2,0,1,0,3
21376,40,7168,10125;10191;13668;13919;14322,11680,1,2,2,0,5
21377,40,7169,10181;10356;13846;14099;14429,11680,2,1,2,0,5
21378,40,7170,10148;10363;13905;14144,11680,1,1,2,0,4
21379,40,7171,10327;10496;13780;14515,11680,1,1,2,0,4
21380,40,7172,10512;14115;14756,11680,2,0,1,0,3
21381,40,7173,10477;10586;14150,11680,1,0,2,0,3
21382,40,7174,10509;11240;14195,11680,1,0,2,0,3
21383,40,7175,10554;10835;14663,11680,1,0,2,0,3
21384,40,7176,10479;10593;13931,11680,0,1,2,0,3
21385,40,7177,10643;10712;13765;13800;14422,11680,1,2,2,0,5
21386,40,7178,10649;10973;14088;14488,11680,2,0,2,0,4
21387,40,7179,10673;11222;13857;14295,11680,1,1,2,0,4
21388,40,7180,10834;11062;14159;14331;14671,11680,3,0,2,0,5
21389,40,7181,10757;11015;14492,11680,1,0,2,0,3
21390,40,7182,10559;10773;13916,11680,0,1,2,0,3
21391,40,7183,10471;10780;14380,11680,1,0,2,0,3
21392,40,7184,10786;11024;14029;14148,11680,1,1,2,0,4
21393,40,7185,10869;10915;14592,11680,1,0,2,0,3
21394,40,7186,10659;10880;14216,11680,1,0,2,0,3
21395,40,7187,10884;11227;13740;14027,11680,0,2,2,0,4
21396,40,7188,10945;11063;14408;14752,11680,2,0,2,0,4
21397,40,7189,10938;13816;14282,11680,1,1,1,0,3
21398,40,7190,10451;10954;13691;14614,11680,1,1,2,0,4
21399,40,7191,10964;11216;14508,11680,1,0,2,0,3
21400,40,7192,11149;13713;14257,11680,1,1,1,0,3
21401,40,7193,10874;10982;13761;13879;14503,11680,1,2,2,0,5
21402,40,7194,11040;11694;13801;14136,11680,1,1,2,0,4
21403,40,7195,11079;11496;13676,11680,0,1,2,0,3
21404,40,7196,10890;11112;14063;14490,11680,1,1,2,0,4
21405,40,7197,11049;11136;13843,11680,0,1,2,0,3
21406,40,7198,11155;11586;13749;13952;14094;14685,11680,2,2,2,0,6
21407,40,7199,10957,11680,0,0,1,0,1
21408,40,7200,10729;10870;14641,11680,1,0,2,0,3
21409,40,7201,11211;14426,11680,1,0,1,0,2
21410,40,7202,11213;11369;14138;14442;14528,11680,3,0,2,0,5
21411,40,7203,11238;11692;14304,11680,1,0,2,0,3
21412,40,7204,11242;11689;14041;14519,11680,1,1,2,0,4
21413,40,7206,11109;11256;13808;14436,11680,1,1,2,0,4
21414,40,7207,11259;11288;14134,11680,1,0,2,0,3
21415,40,7208,11297;11550;14317,11680,1,0,2,0,3
21416,40,7209,11142;11301;14091;14542,11680,2,0,2,0,4
21417,40,7210,10906;11303;14015;14209,11680,1,1,2,0,4
21418,40,7211,10410;11329;13670;14240,11680,1,1,2,0,4
21419,40,7212,11331;11587;13855;14120,11680,1,1,2,0,4
21420,40,7213,11200;11346;13686;14095;14439,11680,2,1,2,0,5
21421,40,7214,11353;11630;14123;14636,11680,2,0,2,0,4
21422,40,7215,11366;13764;13877;13984;14531,11680,1,3,1,0,5
21423,40,7216,11224;14460;14558,11680,2,0,1,0,3
21424,40,7217,11381;11430;13689,11680,0,1,2,0,3
21425,40,7218,11387;11571,11680,0,0,2,0,2
21426,40,7220,1526;2875,12045,0,0,2,0,2
21427,40,7224,1633;3880,12045,0,0,2,0,2
21428,40,7225,3730,12045,0,0,1,0,1
21429,40,7228,1622,12045,0,0,1,0,1
21430,40,7232,8931,12045,0,0,1,0,1
21431,40,7234,2855;9750;13716;14164,12045,1,1,2,0,4
21432,40,7237,5528,12045,0,0,0,1,1
21433,40,7238,4101,12045,0,0,1,0,1
21434,40,7239,4235,12045,0,0,1,0,1
21435,40,7240,9042,12045,0,0,1,0,1
21436,40,7241,5913,12045,0,0,0,1,1
21437,40,7242,5959,12045,0,0,0,1,1
21438,40,7243,170;9838,12045,0,0,2,0,2
21439,40,7247,7315,12045,0,0,1,0,1
21440,40,7248,7802,12045,0,0,1,0,1
21441,40,7249,8616,12045,0,0,1,0,1
21442,40,7251,5980,12045,0,0,0,1,1
21443,40,7253,4523,12045,0,0,1,0,1
21444,40,7254,9406,12045,0,0,1,0,1
21445,40,7257,10041,12045,0,0,1,0,1
21446,40,7258,2775,12045,0,0,1,0,1
21447,40,7259,8612;10263;13821;14481;14580,12045,2,1,2,0,5
21448,40,7260,10278,12045,0,0,1,0,1
21449,40,7262,10379,12045,0,0,1,0,1
21450,40,7264,10527,12045,0,0,1,0,1
21451,40,7266,10575;10614;13882;14600,12045,1,1,2,0,4
21452,40,7267,10618;11183;14364;14547,12045,2,0,2,0,4
21453,40,7268,10622;10902;13900;14694,12045,1,1,2,0,4
21454,40,7269,10473;10666;13804;14610,12045,1,1,2,0,4
21455,40,7270,10541;13811;14534,12045,1,1,1,0,3
21456,40,7271,10682;11116;13869;14500,12045,1,1,2,0,4
21457,40,7272,10544,12045,0,0,1,0,1
21458,40,7273,10602;10722;14299;14389,12045,2,0,2,0,4
21459,40,7274,10651;10749;13938;14413,12045,1,1,2,0,4
21460,40,7275,10750;14213;14608,12045,2,0,1,0,3
21461,40,7276,10753;14204,12045,1,0,1,0,2
21462,40,7278,10803;10831;14046,12045,0,1,2,0,3
21463,40,7279,10809;11362;14316,12045,1,0,2,0,3
21464,40,7280,10854;11273;14199;14420;14631;14753,12045,4,0,2,0,6
21465,40,7282,10633;10894;14217;14589,12045,2,0,2,0,4
21466,40,7283,10905;10980;13793,12045,0,1,2,0,3
21467,40,7286,10946;11206;14201,12045,1,0,2,0,3
21468,40,7287,10959;11135;13866;14019;14590,12045,1,2,2,0,5
21469,40,7288,10960;11057;14369;14654,12045,2,0,2,0,4
21470,40,7289,10997;11091;14247;14581,12045,2,0,2,0,4
21471,40,7290,11016;11292;14280,12045,1,0,2,0,3
21472,40,7292,11074;11442;14662,12045,1,0,2,0,3
21473,40,7293,11141;13820,12045,0,1,1,0,2
21474,40,7294,11026;11157;14391,12045,1,0,2,0,3
21475,40,7295,10986;11203;14447,12045,1,0,2,0,3
21476,40,7296,11205,12045,0,0,1,0,1
21477,40,7297,11208;11228;13832;14182,12045,1,1,2,0,4
21478,40,7298,11209;11320;13925;14288,12045,1,1,2,0,4
21479,40,7299,11232;11597;13906;14642,12045,1,1,2,0,4
21480,40,7300,11225;11234;13845;14525,12045,1,1,2,0,4
21481,40,7301,11204;11307;14303,12045,1,0,2,0,3
21482,40,7305,11294;13922;14725,12045,1,1,1,0,3
21483,40,7306,11309;11465;14309,12045,1,0,2,0,3
21484,40,7307,11328;11528;14157,12045,1,0,2,0,3
21485,40,7308,11349;11773;13835;14347;14482,12045,2,1,2,0,5
21486,40,7309,11350;11372;13915;14212;14507;14659,12045,3,1,2,0,6
21487,40,7310,11117;11356;13951,12045,0,1,2,0,3
21488,40,7311,11270;11379;14155,12045,1,0,2,0,3
21489,40,7312,11544;14452,12045,1,0,1,0,2
21490,40,7313,11751;13851;14450,12045,1,1,1,0,3
21491,40,7314,11405;11457;14026,12045,0,1,2,0,3
21492,40,7315,11377;11424;14549,12045,1,0,2,0,3
21493,40,7316,11432;11637;13863;13967,12045,0,2,2,0,4
21494,40,7317,11433;11469;14294,12045,1,0,2,0,3
21495,40,7318,11447;11478;14726,12045,1,0,2,0,3
21496,40,7319,11458;11588,12045,0,0,2,0,2
21497,40,7320,11192;11468;14090,12045,1,0,2,0,3
21498,40,7321,11459;11481,12045,0,0,2,0,2
21499,40,7322,11423;11482;14375;14727,12045,2,0,2,0,4
21500,40,7323,10151;13790,12410,0,1,1,0,2
21501,40,7324,50;6641,12410,0,0,2,0,2
21502,40,7325,160,12410,0,0,1,0,1
21503,40,7326,330;4474,12410,0,0,2,0,2
21504,40,7329,1136,12410,0,0,1,0,1
21505,40,7330,1307,12410,0,0,1,0,1
21506,40,7333,6653,12410,0,0,1,0,1
21507,40,7334,2975,12410,0,0,1,0,1
21508,40,7335,6718;8679,12410,0,0,2,0,2
21509,40,7339,4862,12410,0,0,1,0,1
21510,40,7341,6616,12410,0,0,1,0,1
21511,40,7342,5330,12410,0,0,1,0,1
21512,40,7343,7787,12410,0,0,0,1,1
21513,40,7345,6101,12410,0,0,1,0,1
21514,40,7346,3086,12410,0,0,1,0,1
21515,40,7347,7596,12410,0,0,1,0,1
21516,40,7348,4142;5210,12410,0,0,1,1,2
21517,40,7349,2168,12410,0,0,1,0,1
21518,40,7351,7815,12410,0,0,1,0,1
21519,40,7352,5249;6879,12410,0,0,2,0,2
21520,40,7353,7990,12410,0,0,1,0,1
21521,40,7354,5810,12410,0,0,1,0,1
21522,40,7356,5166;7051,12410,0,0,2,0,2
21523,40,7358,9412,12410,0,0,0,1,1
21524,40,7359,9957,12410,0,0,0,1,1
21525,40,7360,10061,12410,0,0,1,0,1
21526,40,7361,56;10116;14014,12410,0,1,2,0,3
21527,40,7363,10221,12410,0,0,1,0,1
21528,40,7364,10318;10401;13987;14553,12410,1,1,2,0,4
21529,40,7365,10460;10619;14092;14424,12410,2,0,2,0,4
21530,40,7366,10301;10415;14419,12410,1,0,2,0,3
21531,40,7367,10684,12410,0,0,1,0,1
21532,40,7368,10745,12410,0,0,1,0,1
21533,40,7369,10721;10760,12410,0,0,2,0,2
21534,40,7370,10772;11039;13983;14298;14404,12410,2,1,2,0,5
21535,40,7371,11207;14449,12410,1,0,1,0,2
21536,40,7372,10787;11028;14463;14740,12410,2,0,2,0,4
21537,40,7373,10820;14475,12410,1,0,1,0,2
21538,40,7375,10647,12410,0,0,1,0,1
21539,40,7376,10911,12410,0,0,1,0,1
21540,40,7377,10612;10937;14267;14535,12410,2,0,2,0,4
21541,40,7378,11065;11506;14562,12410,1,0,2,0,3
21542,40,7379,11020;11217;14214;14410,12410,2,0,2,0,4
21543,40,7380,11030;11334;14599;14728,12410,2,0,2,0,4
21544,40,7381,11475,12410,0,0,1,0,1
21545,40,7382,10697;11092;14359;14400,12410,2,0,2,0,4
21546,40,7383,11269;11312;14448;14755,12410,2,0,2,0,4
21547,40,7384,11124;11467;14130,12410,1,0,2,0,3
21548,40,7385,11177;11422;14070,12410,0,1,2,0,3
21549,40,7386,11181;14066;14443,12410,1,1,1,0,3
21550,40,7387,11220;11376;14326,12410,1,0,2,0,3
21551,40,7388,11223;11613;14467,12410,1,0,2,0,3
21552,40,7389,11244;11549;14584;14699,12410,2,0,2,0,4
21553,40,7390,11262;11384;13949;14520,12410,1,1,2,0,4
21554,40,7391,11263;11615;14664,12410,1,0,2,0,3
21555,40,7392,11003;11265;13996,12410,0,1,2,0,3
21556,40,7393,11295;11825;14185;14739,12410,2,0,2,0,4
21557,40,7394,11313;11316;14232;14692,12410,2,0,2,0,4
21558,40,7395,11327;11529,12410,0,0,2,0,2
21559,40,7396,11359,12410,0,0,1,0,1
21560,40,7397,11412;11438;13972,12410,0,1,2,0,3
21561,40,7398,11306;14161;14394;14491,12410,3,0,1,0,4
21562,40,7399,10951;11436;14006,12410,0,1,2,0,3
21563,40,7400,11287;11452;14751,12410,1,0,2,0,3
21564,40,7401,11382;11486;14446,12410,1,0,2,0,3
21565,40,7402,11497;11598,12410,0,0,2,0,2
21566,40,7403,11493;11503,12410,0,0,2,0,2
21567,40,7404,11611;11809;13994;14302;14579,12410,2,1,2,0,5
21568,40,7405,11660;14128,12410,1,0,1,0,2
21569,40,7406,11545,12410,0,0,1,0,1
21570,40,7407,11163;11687,12410,0,0,2,0,2
21571,40,7408,11535;11589;14735,12410,1,0,2,0,3
21572,40,7409,11302;11593;14418,12410,1,0,2,0,3
21573,40,7411,2361,12775,0,0,1,0,1
21574,40,7414,6707,12775,0,0,1,0,1
21575,40,7415,3107;3184,12775,0,0,2,0,2
21576,40,7418,2330;2360,12775,0,0,2,0,2
21577,40,7420,5449,12775,0,0,1,0,1
21578,40,7421,5756,12775,0,0,0,1,1
21579,40,7422,5974,12775,0,0,1,0,1
21580,40,7424,7039;7405,12775,0,0,2,0,2
21581,40,7425,6,12775,0,0,1,0,1
21582,40,7426,931;9572,12775,0,0,2,0,2
21583,40,7427,4229;7304,12775,0,0,2,0,2
21584,40,7429,7385,12775,0,0,1,0,1
21585,40,7430,181,12775,0,0,1,0,1
21586,40,7431,8236,12775,0,0,0,1,1
21587,40,7433,8696,12775,0,0,1,0,1
21588,40,7436,10077;10338;14098;14278,12775,2,0,2,0,4
21589,40,7438,10302,12775,0,0,1,0,1
21590,40,7439,10090,12775,0,0,1,0,1
21591,40,7441,10161;10566,12775,0,0,2,0,2
21592,40,7444,10561,12775,0,0,1,0,1
21593,40,7445,10433;10652;14116;14338;14415,12775,3,0,2,0,5
21594,40,7446,10346;10663;14097;14533,12775,2,0,2,0,4
21595,40,7447,10737;10886;14205;14697,12775,2,0,2,0,4
21596,40,7449,10406;10904;14286;14383,12775,2,0,2,0,4
21597,40,7450,10922;11236;14373;14723,12775,2,0,2,0,4
21598,40,7451,10949;11266;14221,12775,1,0,2,0,3
21599,40,7452,11032;11428;14352,12775,1,0,2,0,3
21600,40,7453,11043;11160;14173;14423,12775,2,0,2,0,4
21601,40,7454,11085;11214;14532,12775,1,0,2,0,3
21602,40,7455,11090;11283;14124,12775,1,0,2,0,3
21603,40,7456,10852;11107;14156;14639,12775,2,0,2,0,4
21604,40,7457,11108;11563,12775,0,0,2,0,2
21605,40,7458,11021;11134;14180;14281,12775,2,0,2,0,4
21606,40,7459,11138;11143;14276,12775,1,0,2,0,3
21607,40,7460,11190,12775,0,0,1,0,1
21608,40,7461,11210;11902;14251,12775,1,0,2,0,3
21609,40,7462,11253;11448,12775,0,0,2,0,2
21610,40,7464,11199;11272;14181,12775,1,0,2,0,3
21611,40,7465,11654;11759;14112;14441,12775,2,0,2,0,4
21612,40,7466,11096;11461;14646,12775,1,0,2,0,3
21613,40,7467,11901;14127,12775,1,0,1,0,2
21614,40,7468,11345;11639;14139;14231;14583,12775,3,0,2,0,5
21615,40,7469,11361;11693;14137;14348;14554,12775,3,0,2,0,5
21616,40,7470,11370;11619;14340;14543,12775,2,0,2,0,4
21617,40,7471,11380;11920;14083;14652,12775,2,0,2,0,4
21618,40,7472,11397;11522;14121,12775,1,0,2,0,3
21619,40,7473,11398;11651;14290,12775,1,0,2,0,3
21620,40,7474,11120;11399;14194,12775,1,0,2,0,3
21621,40,7475,11404;11969,12775,0,0,2,0,2
21622,40,7476,11386;11411,12775,0,0,2,0,2
21623,40,7477,11252;11431;14669,12775,1,0,2,0,3
21624,40,7478,11928;14502,12775,1,0,1,0,2
21625,40,7479,11454;11662;14645,12775,1,0,2,0,3
21626,40,7480,11488;11500;14526,12775,1,0,2,0,3
21627,40,7481,11017,12775,0,0,1,0,1
21628,40,7482,11505;11509;14557,12775,1,0,2,0,3
21629,40,7483,11255;11510;14301;14733,12775,2,0,2,0,4
21630,40,7484,11511;11707,12775,0,0,2,0,2
21631,40,7485,11514,12775,0,0,1,0,1
21632,40,7486,11519;11614;14145,12775,1,0,2,0,3
21633,40,7487,11533;11741;14192;14540,12775,2,0,2,0,4
21634,40,7488,11538;11832;14186,12775,1,0,2,0,3
21635,40,7489,11360;11640;14486,12775,1,0,2,0,3
21636,40,7490,11670;11804;14109,12775,1,0,2,0,3
21637,40,7491,11581;11683,12775,0,0,2,0,2
21638,40,7492,11,13140,0,0,1,0,1
21639,40,7495,2967,13140,0,0,0,1,1
21640,40,7496,1352,13140,0,0,1,0,1
21641,40,7497,7920,13140,0,0,1,0,1
21642,40,7498,5087;6637,13140,0,0,2,0,2
21643,40,7499,6875,13140,0,0,1,0,1
21644,40,7500,488,13140,0,0,1,0,1
21645,40,7501,3061;8014,13140,0,0,2,0,2
21646,40,7502,3215,13140,0,0,1,0,1
21647,40,7505,1515;2342,13140,0,0,2,0,2
21648,40,7507,810,13140,0,0,1,0,1
21649,40,7508,7257,13140,0,0,1,0,1
21650,40,7509,1586,13140,0,0,1,0,1
21651,40,7511,10087;10343;14222,13140,1,0,2,0,3
21652,40,7512,218,13140,0,0,1,0,1
21653,40,7518,10689;14289;14518,13140,2,0,1,0,3
21654,40,7519,10525;11044;14746,13140,1,0,2,0,3
21655,40,7520,10680,13140,0,0,1,0,1
21656,40,7521,10468,13140,0,0,1,0,1
21657,40,7522,10667;11071;14711,13140,1,0,2,0,3
21658,40,7523,11182;14264,13140,1,0,1,0,2
21659,40,7524,10607;10708;14399,13140,1,0,2,0,3
21660,40,7525,10740;14274;14674,13140,2,0,1,0,3
21661,40,7526,11011,13140,0,0,1,0,1
21662,40,7527,10830;10837;14291,13140,1,0,2,0,3
21663,40,7528,10918,13140,0,0,1,0,1
21664,40,7529,10920;10941;14256,13140,1,0,2,0,3
21665,40,7530,11014;14517;14701,13140,2,0,1,0,3
21666,40,7531,11022;11151;14405,13140,1,0,2,0,3
21667,40,7532,11031;11226;14665,13140,1,0,2,0,3
21668,40,7533,11064,13140,0,0,1,0,1
21669,40,7534,11078;11443;14462;14587,13140,2,0,2,0,4
21670,40,7535,11161;11425;14284,13140,1,0,2,0,3
21671,40,7536,11167;11407;14320,13140,1,0,2,0,3
21672,40,7537,11173;11684;14411,13140,1,0,2,0,3
21673,40,7538,11176;11453;14262;14621,13140,2,0,2,0,4
21674,40,7539,11038;11180;14226;14661,13140,2,0,2,0,4
21675,40,7540,11201;11479,13140,0,0,2,0,2
21676,40,7541,11254;11752,13140,0,0,2,0,2
21677,40,7542,11237;11290;14696,13140,1,0,2,0,3
21678,40,7543,11291;11498;14629,13140,1,0,2,0,3
21679,40,7544,11042;11311;14228;14615,13140,2,0,2,0,4
21680,40,7545,11097;11123,13140,0,0,2,0,2
21681,40,7546,10962;11341;14381,13140,1,0,2,0,3
21682,40,7547,11358,13140,0,0,1,0,1
21683,40,7548,11420;11889;14305,13140,1,0,2,0,3
21684,40,7549,11446,13140,0,0,1,0,1
21685,40,7550,11464;11652;14349,13140,1,0,2,0,3
21686,40,7551,11466;11480;14511,13140,1,0,2,0,3
21687,40,7552,11879;14249,13140,1,0,1,0,2
21688,40,7553,11504;14736,13140,1,0,1,0,2
21689,40,7554,11507;11672;14414,13140,1,0,2,0,3
21690,40,7555,11512,13140,0,0,1,0,1
21691,40,7556,11547;12003,13140,0,0,2,0,2
21692,40,7557,11551;11980;14366,13140,1,0,2,0,3
21693,40,7558,11559;14234,13140,1,0,1,0,2
21694,40,7559,11567;11938;14245;14529,13140,2,0,2,0,4
21695,40,7560,11231;11579,13140,0,0,2,0,2
21696,40,7561,11595,13140,0,0,1,0,1
21697,40,7562,11616;11931;14604,13140,1,0,2,0,3
21698,40,7563,11631;12068,13140,0,0,2,0,2
21699,40,7564,11721;14237,13140,1,0,1,0,2
21700,40,7565,11375;11657;14263,13140,1,0,2,0,3
21701,40,7566,11674,13140,0,0,1,0,1
21702,40,7567,11691;11700;14509,13140,1,0,2,0,3
21703,40,7568,11711;12086,13140,0,0,2,0,2
21704,40,7569,11602;11712;14242,13140,1,0,2,0,3
21705,40,7570,11650;11742;14235,13140,1,0,2,0,3
21706,40,7571,11763;11878,13140,0,0,2,0,2
21707,40,7572,11713;11783;14329;14657,13140,2,0,2,0,4
21708,40,7573,11665;11800;14308,13140,1,0,2,0,3
21709,40,7576,839,13505,0,0,1,0,1
21710,40,7578,1655,13505,0,0,1,0,1
21711,40,7580,2176,13505,0,0,1,0,1
21712,40,7581,871;2180,13505,0,0,2,0,2
21713,40,7584,3185,13505,0,0,1,0,1
21714,40,7585,4109,13505,0,0,1,0,1
21715,40,7586,4369,13505,0,0,1,0,1
21716,40,7587,135;6601,13505,0,0,2,0,2
21717,40,7588,1901,13505,0,0,1,0,1
21718,40,7589,6936;7216,13505,0,0,2,0,2
21719,40,7590,3351;5504,13505,0,0,2,0,2
21720,40,7593,2965,13505,0,0,1,0,1
21721,40,7595,511,13505,0,0,1,0,1
21722,40,7598,9818,13505,0,0,1,0,1
21723,40,7600,8747,13505,0,0,1,0,1
21724,40,7601,9431,13505,0,0,1,0,1
21725,40,7602,8757;9214,13505,0,0,2,0,2
21726,40,7604,10022,13505,0,0,1,0,1
21727,40,7605,10082,13505,0,0,1,0,1
21728,40,7607,10172,13505,0,0,1,0,1
21729,40,7608,10273;10653;14522,13505,1,0,2,0,3
21730,40,7609,10014,13505,0,0,1,0,1
21731,40,7611,10206,13505,0,0,1,0,1
21732,40,7613,10520,13505,0,0,1,0,1
21733,40,7614,10199,13505,0,0,1,0,1
21734,40,7615,11083;11115;14444,13505,1,0,2,0,3
21735,40,7616,10518,13505,0,0,1,0,1
21736,40,7617,10686;10725;14682,13505,1,0,2,0,3
21737,40,7618,10724,13505,0,0,1,0,1
21738,40,7619,10726;11364;14722,13505,1,0,2,0,3
21739,40,7620,10768,13505,0,0,1,0,1
21740,40,7621,10814;10952;14466,13505,1,0,2,0,3
21741,40,7622,10983,13505,0,0,1,0,1
21742,40,7624,11139;11795,13505,0,0,2,0,2
21743,40,7625,10882;11239;14367,13505,1,0,2,0,3
21744,40,7626,11317;11760;14607,13505,1,0,2,0,3
21745,40,7627,11354,13505,0,0,1,0,1
21746,40,7628,11419;11863,13505,0,0,2,0,2
21747,40,7629,11421;11585;14377;14706,13505,2,0,2,0,4
21748,40,7630,11426;11788;14437,13505,1,0,2,0,3
21749,40,7631,11363;11439,13505,0,0,2,0,2
21750,40,7632,11440;11935;14705,13505,1,0,2,0,3
21751,40,7633,11445;11576;14406,13505,1,0,2,0,3
21752,40,7634,11451;11848,13505,0,0,2,0,2
21753,40,7635,11456;11471;14670,13505,1,0,2,0,3
21754,40,7636,11473;12053;14732,13505,1,0,2,0,3
21755,40,7637,11276;11474;14734,13505,1,0,2,0,3
21756,40,7638,11476;11638;14628,13505,1,0,2,0,3
21757,40,7639,11485;11492,13505,0,0,2,0,2
21758,40,7640,11523;11842;14570,13505,1,0,2,0,3
21759,40,7641,11094,13505,0,0,1,0,1
21760,40,7642,11599;11921;14388,13505,1,0,2,0,3
21761,40,7643,11608;11876,13505,0,0,2,0,2
21762,40,7644,11621;12111;14433,13505,1,0,2,0,3
21763,40,7645,11643;11817,13505,0,0,2,0,2
21764,40,7646,11489;11644,13505,0,0,2,0,2
21765,40,7647,11676;11886;14516,13505,1,0,2,0,3
21766,40,7648,11678;12000;14485,13505,1,0,2,0,3
21767,40,7649,11706;12069;14632,13505,1,0,2,0,3
21768,40,7650,11714;12087;14384;14683,13505,2,0,2,0,4
21769,40,7651,11727;11877,13505,0,0,2,0,2
21770,40,7652,11470;11734;14435,13505,1,0,2,0,3
21771,40,7653,11750;12274,13505,0,0,2,0,2
21772,40,7654,11762;11778;14431;14591;14673,13505,3,0,2,0,5
21773,40,7655,11769;11810;14617,13505,1,0,2,0,3
21774,40,7656,11771;12023;14397,13505,1,0,2,0,3
21775,40,7657,11790;12135;14680,13505,1,0,2,0,3
21776,40,7658,11808,13505,0,0,1,0,1
21777,40,7659,11815;14376,13505,1,0,1,0,2
21778,40,7660,11833,13505,0,0,1,0,1
21779,40,7661,11696;11834;14459,13505,1,0,2,0,3
21780,40,7662,11410;11840;14496;14718,13505,2,0,2,0,4
21781,40,7663,11855;11981;14677,13505,1,0,2,0,3
21782,40,7664,11868;12175,13505,0,0,2,0,2
21783,40,7665,11870;12029,13505,0,0,2,0,2
21784,40,7666,11883;12067;14378,13505,1,0,2,0,3
21785,40,7667,11966,13505,0,0,1,0,1
21786,40,7671,958,13870,0,0,1,0,1
21787,40,7672,1152;6275,13870,0,0,2,0,2
21788,40,7673,9639,13870,0,0,1,0,1
21789,40,7674,2702,13870,0,0,1,0,1
21790,40,7676,2108,13870,0,0,1,0,1
21791,40,7677,2385,13870,0,0,1,0,1
21792,40,7678,2980,13870,0,0,1,0,1
21793,40,7682,5710,13870,0,0,1,0,1
21794,40,7683,4456,13870,0,0,1,0,1
21795,40,7684,8338,13870,0,0,1,0,1
21796,40,7685,4854,13870,0,0,1,0,1
21797,40,7686,5002,13870,0,0,1,0,1
21798,40,7688,3140;5432,13870,0,0,2,0,2
21799,40,7689,5698,13870,0,0,1,0,1
21800,40,7690,1486,13870,0,0,1,0,1
21801,40,7691,5787,13870,0,0,1,0,1
21802,40,7692,6947;7382,13870,0,0,2,0,2
21803,40,7693,1889;7036,13870,0,0,2,0,2
21804,40,7694,13,13870,0,0,1,0,1
21805,40,7695,3872,13870,0,0,1,0,1
21806,40,7697,986,13870,0,0,1,0,1
21807,40,7698,348,13870,0,0,1,0,1
21808,40,7699,2369,13870,0,0,1,0,1
21809,40,7700,952;8718,13870,0,0,2,0,2
21810,40,7702,29;1883,13870,0,0,2,0,2
21811,40,7703,10261;10856;14666,13870,1,0,2,0,3
21812,40,7704,10422;10552;14568,13870,1,0,2,0,3
21813,40,7706,10678;10963;14494,13870,1,0,2,0,3
21814,40,7707,10706;10900,13870,0,0,2,0,2
21815,40,7708,10662;10715;14550,13870,1,0,2,0,3
21816,40,7710,10813,13870,0,0,1,0,1
21817,40,7711,10335;10829;14624,13870,1,0,2,0,3
21818,40,7712,10978,13870,0,0,1,0,1
21819,40,7713,10855;14668,13870,1,0,1,0,2
21820,40,7714,10863,13870,0,0,1,0,1
21821,40,7715,10993,13870,0,0,1,0,1
21822,40,7716,11075;14644,13870,1,0,1,0,2
21823,40,7717,11104,13870,0,0,1,0,1
21824,40,7718,10965,13870,0,0,1,0,1
21825,40,7719,11114,13870,0,0,1,0,1
21826,40,7720,11230,13870,0,0,1,0,1
21827,40,7721,11127;11245;14566,13870,1,0,2,0,3
21828,40,7722,11286;11737,13870,0,0,2,0,2
21829,40,7723,10872,13870,0,0,1,0,1
21830,40,7724,11300,13870,0,0,1,0,1
21831,40,7725,11427;11618,13870,0,0,2,0,2
21832,40,7726,11111;11314;14563,13870,1,0,2,0,3
21833,40,7727,11338;11607;14655,13870,1,0,2,0,3
21834,40,7728,11355;11385;14504,13870,1,0,2,0,3
21835,40,7729,11389;11609;14611,13870,1,0,2,0,3
21836,40,7730,11403;11729,13870,0,0,2,0,2
21837,40,7731,11499,13870,0,0,1,0,1
21838,40,7732,11520;11996,13870,0,0,2,0,2
21839,40,7733,11524;14634,13870,1,0,1,0,2
21840,40,7734,11530;11914,13870,0,0,2,0,2
21841,40,7735,11592;11628,13870,0,0,2,0,2
21842,40,7736,11594;11728,13870,0,0,2,0,2
21843,40,7737,11606;12085,13870,0,0,2,0,2
21844,40,7738,11641;11821;14603,13870,1,0,2,0,3
21845,40,7739,11645;11731;14747,13870,1,0,2,0,3
21846,40,7740,11658;11667,13870,0,0,2,0,2
21847,40,7741,11417;11679;14675,13870,1,0,2,0,3
21848,40,7742,11532;11690;14597,13870,1,0,2,0,3
21849,40,7743,11321;11697,13870,0,0,2,0,2
21850,40,7744,11701,13870,0,0,1,0,1
21851,40,7745,11732;12042,13870,0,0,2,0,2
21852,40,7746,11739,13870,0,0,1,0,1
21853,40,7747,11764;11779,13870,0,0,2,0,2
21854,40,7748,11770;12302,13870,0,0,2,0,2
21855,40,7749,11806;12114;14524,13870,1,0,2,0,3
21856,40,7750,11743;11826;14536,13870,1,0,2,0,3
21857,40,7751,11827;11924;14656,13870,1,0,2,0,3
21858,40,7752,11843;12019;14601,13870,1,0,2,0,3
21859,40,7753,11850;11869;14501,13870,1,0,2,0,3
21860,40,7754,11856;12204;14638,13870,1,0,2,0,3
21861,40,7755,11835;11867;14541;14693,13870,2,0,2,0,4
21862,40,7756,11406;11881,13870,0,0,2,0,2
21863,40,7757,11704;11882;14602,13870,1,0,2,0,3
21864,40,7758,11661;11906,13870,0,0,2,0,2
21865,40,7759,11925;12203;14714,13870,1,0,2,0,3
21866,40,7760,11930;12014;14527,13870,1,0,2,0,3
21867,40,7761,11940;12043,13870,0,0,2,0,2
21868,40,7762,11566;11941,13870,0,0,2,0,2
21869,40,7763,11945;11988;14622,13870,1,0,2,0,3
21870,40,7764,11997;12308,13870,0,0,2,0,2
21871,40,7765,11699;12011,13870,0,0,2,0,2
21872,40,7766,12015;12098,13870,0,0,2,0,2
21873,40,7767,65,14235,0,0,1,0,1
21874,40,7768,326,14235,0,0,1,0,1
21875,40,7770,5963,14235,0,0,1,0,1
21876,40,7771,1104,14235,0,0,1,0,1
21877,40,7772,5962,14235,0,0,1,0,1
21878,40,7774,3346,14235,0,0,1,0,1
21879,40,7775,2366,14235,0,0,1,0,1
21880,40,7776,2865,14235,0,0,1,0,1
21881,40,7777,2203;3151,14235,0,0,2,0,2
21882,40,7780,9056,14235,0,0,1,0,1
21883,40,7781,5244,14235,0,0,1,0,1
21884,40,7782,5390,14235,0,0,1,0,1
21885,40,7783,7300,14235,0,0,1,0,1
21886,40,7785,6022,14235,0,0,1,0,1
21887,40,7786,898,14235,0,0,1,0,1
21888,40,7787,6098;6761,14235,0,0,2,0,2
21889,40,7788,7819,14235,0,0,1,0,1
21890,40,7789,6054,14235,0,0,1,0,1
21891,40,7790,6465,14235,0,0,1,0,1
21892,40,7791,6628,14235,0,0,1,0,1
21893,40,7793,8040,14235,0,0,1,0,1
21894,40,7794,8187,14235,0,0,1,0,1
21895,40,7795,3502,14235,0,0,1,0,1
21896,40,7796,9420,14235,0,0,1,0,1
21897,40,7797,9677,14235,0,0,1,0,1
21898,40,7798,9740,14235,0,0,1,0,1
21899,40,7799,10129;14684,14235,1,0,1,0,2
21900,40,7801,10229,14235,0,0,1,0,1
21901,40,7802,10334;10660;14648,14235,1,0,2,0,3
21902,40,7803,10444,14235,0,0,1,0,1
21903,40,7805,10492,14235,0,0,1,0,1
21904,40,7807,10581;10746;14703,14235,1,0,2,0,3
21905,40,7808,10691;11106;14717,14235,1,0,2,0,3
21906,40,7809,10522,14235,0,0,1,0,1
21907,40,7810,10448,14235,0,0,1,0,1
21908,40,7811,10570,14235,0,0,1,0,1
21909,40,7812,10767,14235,0,0,1,0,1
21910,40,7813,10923;11221;14742,14235,1,0,2,0,3
21911,40,7814,10174,14235,0,0,1,0,1
21912,40,7816,10781;11129,14235,0,0,2,0,2
21913,40,7817,11140;11463,14235,0,0,2,0,2
21914,40,7818,10751,14235,0,0,1,0,1
21915,40,7819,11191;14754,14235,1,0,1,0,2
21916,40,7820,11215;11450;14653,14235,1,0,2,0,3
21917,40,7821,11164;11285,14235,0,0,2,0,2
21918,40,7822,11304;11484,14235,0,0,2,0,2
21919,40,7823,11325;12052,14235,0,0,2,0,2
21920,40,7824,11340;11591,14235,0,0,2,0,2
21921,40,7825,11100;11342,14235,0,0,2,0,2
21922,40,7826,11250;11371,14235,0,0,2,0,2
21923,40,7827,11401;11449,14235,0,0,2,0,2
21924,40,7828,11565,14235,0,0,1,0,1
21925,40,7829,11513;11791,14235,0,0,2,0,2
21926,40,7830,11373;11515;14704,14235,1,0,2,0,3
21927,40,7831,11636;11910,14235,0,0,2,0,2
21928,40,7832,11648;12137,14235,0,0,2,0,2
21929,40,7833,11677;12234;14687,14235,1,0,2,0,3
21930,40,7834,11554;11993,14235,0,0,2,0,2
21931,40,7835,11716;12326,14235,0,0,2,0,2
21932,40,7836,11719,14235,0,0,1,0,1
21933,40,7837,11726,14235,0,0,1,0,1
21934,40,7838,11907;12424,14235,0,0,2,0,2
21935,40,7839,11755;12144,14235,0,0,2,0,2
21936,40,7840,11761;11913,14235,0,0,2,0,2
21937,40,7841,11772;11900,14235,0,0,2,0,2
21938,40,7842,11776;12008,14235,0,0,2,0,2
21939,40,7843,11437;11799,14235,0,0,2,0,2
21940,40,7844,11816;12142,14235,0,0,2,0,2
21941,40,7845,11836;12126,14235,0,0,2,0,2
21942,40,7846,11860;12357,14235,0,0,2,0,2
21943,40,7847,11957,14235,0,0,1,0,1
21944,40,7848,11845;11971;14716,14235,1,0,2,0,3
21945,40,7849,11894;11975,14235,0,0,2,0,2
21946,40,7850,11976;12279;14713,14235,1,0,2,0,3
21947,40,7851,11990;12331,14235,0,0,2,0,2
21948,40,7852,12009;12223,14235,0,0,2,0,2
21949,40,7853,12018;12272,14235,0,0,2,0,2
21950,40,7854,12036;12151;14686,14235,1,0,2,0,3
21951,40,7855,12038;12149,14235,0,0,2,0,2
21952,40,7856,12045,14235,0,0,1,0,1
21953,40,7857,12073;12305,14235,0,0,2,0,2
21954,40,7858,12012;12075,14235,0,0,2,0,2
21955,40,7859,12099;12208,14235,0,0,2,0,2
21956,40,7860,11560;12117,14235,0,0,2,0,2
21957,40,7861,9648,14600,0,0,1,0,1
21958,40,7863,320,14600,0,0,1,0,1
21959,40,7864,5479,14600,0,0,1,0,1
21960,40,7866,944,14600,0,0,1,0,1
21961,40,7867,1535,14600,0,0,1,0,1
21962,40,7868,6625,14600,0,0,1,0,1
21963,40,7869,3401,14600,0,0,1,0,1
21964,40,7870,3406,14600,0,0,1,0,1
21965,40,7871,8214,14600,0,0,1,0,1
21966,40,7872,5353,14600,0,0,1,0,1
21967,40,7873,5460,14600,0,0,1,0,1
21968,40,7874,6169,14600,0,0,1,0,1
21969,40,7875,6949,14600,0,0,1,0,1
21970,40,7876,2291,14600,0,0,1,0,1
21971,40,7877,939,14600,0,0,1,0,1
21972,40,7878,6823,14600,0,0,1,0,1
21973,40,7879,8473,14600,0,0,1,0,1
21974,40,7880,5703,14600,0,0,1,0,1
21975,40,7881,9467,14600,0,0,1,0,1
21976,40,7882,379,14600,0,0,1,0,1
21977,40,7883,5310,14600,0,0,1,0,1
21978,40,7884,10110,14600,0,0,1,0,1
21979,40,7886,10054,14600,0,0,1,0,1
21980,40,7887,10200;10317,14600,0,0,2,0,2
21981,40,7888,10288,14600,0,0,1,0,1
21982,40,7889,10323,14600,0,0,1,0,1
21983,40,7890,10582,14600,0,0,1,0,1
21984,40,7891,10596,14600,0,0,1,0,1
21985,40,7892,10599,14600,0,0,1,0,1
21986,40,7893,10600,14600,0,0,1,0,1
21987,40,7894,10357,14600,0,0,1,0,1
21988,40,7895,10846,14600,0,0,1,0,1
21989,40,7896,10910;11383,14600,0,0,2,0,2
21990,40,7897,10717,14600,0,0,1,0,1
21991,40,7898,11027;11494,14600,0,0,2,0,2
21992,40,7899,11070,14600,0,0,1,0,1
21993,40,7900,10704,14600,0,0,1,0,1
21994,40,7901,11196,14600,0,0,1,0,1
21995,40,7902,10828,14600,0,0,1,0,1
21996,40,7903,11121,14600,0,0,1,0,1
21997,40,7904,11348;11668,14600,0,0,2,0,2
21998,40,7905,11289;11365,14600,0,0,2,0,2
21999,40,7906,11378,14600,0,0,1,0,1
22000,40,7907,11388,14600,0,0,1,0,1
22001,40,7908,11396;11434,14600,0,0,2,0,2
22002,40,7909,11400,14600,0,0,1,0,1
22003,40,7910,11487;11531,14600,0,0,2,0,2
22004,40,7911,11525,14600,0,0,1,0,1
22005,40,7912,11590;11664,14600,0,0,2,0,2
22006,40,7913,11596;11838,14600,0,0,2,0,2
22007,40,7914,11620,14600,0,0,1,0,1
22008,40,7915,11483;11675,14600,0,0,2,0,2
22009,40,7916,11718;11944,14600,0,0,2,0,2
22010,40,7917,11656,14600,0,0,1,0,1
22011,40,7918,11740;11927,14600,0,0,2,0,2
22012,40,7919,11745;12196,14600,0,0,2,0,2
22013,40,7920,11831;12378,14600,0,0,2,0,2
22014,40,7921,11841,14600,0,0,1,0,1
22015,40,7922,11416;11849,14600,0,0,2,0,2
22016,40,7923,11890;12022,14600,0,0,2,0,2
22017,40,7924,11368;11896,14600,0,0,2,0,2
22018,40,7925,11955;12167,14600,0,0,2,0,2
22019,40,7926,11964;12040,14600,0,0,2,0,2
22020,40,7927,11911,14600,0,0,1,0,1
22021,40,7928,11967,14600,0,0,1,0,1
22022,40,7929,11992;12489,14600,0,0,2,0,2
22023,40,7930,11746;12001,14600,0,0,2,0,2
22024,40,7931,12030;12161,14600,0,0,2,0,2
22025,40,7932,11491;12031,14600,0,0,2,0,2
22026,40,7933,12063;12202,14600,0,0,2,0,2
22027,40,7934,12089;12100,14600,0,0,2,0,2
22028,40,7935,11884;12091,14600,0,0,2,0,2
22029,40,7936,12013;12092,14600,0,0,2,0,2
22030,40,7937,12093;12165,14600,0,0,2,0,2
22031,40,7938,12109;12464,14600,0,0,2,0,2
22032,40,7939,12115;12462,14600,0,0,2,0,2
22033,40,7940,11929;12116,14600,0,0,2,0,2
22034,40,7941,11805;12128,14600,0,0,2,0,2
22035,40,7942,12140;12147,14600,0,0,2,0,2
22036,40,7943,12150;12183,14600,0,0,2,0,2
22037,40,7944,11933;12155,14600,0,0,2,0,2
22038,40,7945,12180;12449,14600,0,0,2,0,2
22039,40,7946,12141;12212,14600,0,0,2,0,2
22040,40,7947,11757;12230,14600,0,0,2,0,2
22041,40,7948,11946;12233,14600,0,0,2,0,2
22042,40,7949,12120;12240,14600,0,0,2,0,2
22043,40,7950,12243;12554,14600,0,1,1,0,2
22044,50,1,4,0,0,0,0,1,1
22045,50,2,272;1571,0,0,0,1,1,2
22046,50,4,4337;7947;13509,0,0,0,3,0,3
22047,50,8,25,0,0,0,0,1,1
22048,50,9,28,0,0,0,0,1,1
22049,50,13,39,0,0,0,0,1,1
22050,50,14,41,0,0,0,0,1,1
22051,50,16,51;916,0,0,0,0,2,2
22052,50,19,61;6642;13124;13296,0,0,0,4,0,4
22053,50,20,62;11812,0,0,0,1,1,2
22054,50,22,70;6007,0,0,0,0,2,2
22055,50,25,9436,0,0,0,0,1,1
22056,50,30,95,0,0,0,0,1,1
22057,50,33,99,0,0,0,0,1,1
22058,50,38,117;11319,0,0,0,1,1,2
22059,50,43,131,0,0,0,0,1,1
22060,50,53,154,0,0,0,0,1,1
22061,50,54,5310;10092;13836;13976,0,0,2,2,0,4
22062,50,55,3627,0,0,0,0,1,1
22063,50,56,164;576,0,0,0,0,2,2
22064,50,57,166,0,0,0,0,1,1
22065,50,60,173,0,0,0,0,1,1
22066,50,61,180;8253;11686,0,0,0,1,2,3
22067,50,63,189;1979;11626,0,0,0,2,1,3
22068,50,65,193,0,0,0,0,1,1
22069,50,66,195;9410,0,0,0,0,2,2
22070,50,69,207,0,0,0,0,1,1
22071,50,71,209;2759,0,0,0,0,2,2
22072,50,74,221;3903,0,0,0,0,2,2
22073,50,82,244,0,0,0,0,1,1
22074,50,90,261,0,0,0,0,1,1
22075,50,118,332;2314,0,0,0,0,2,2
22076,50,124,344,0,0,0,0,1,1
22077,50,127,352;2748,0,0,0,0,2,2
22078,50,128,354,0,0,0,0,1,1
22079,50,129,358;359,0,0,0,0,2,2
22080,50,130,362,0,0,0,0,1,1
22081,50,132,3661,0,0,0,0,1,1
22082,50,137,2331,0,0,0,0,1,1
22083,50,138,382;8031,0,0,0,0,2,2
22084,50,139,385,0,0,0,0,1,1
22085,50,140,5755;8879;11066,0,0,0,1,2,3
22086,50,142,4408,0,0,0,0,1,1
22087,50,144,396;8055;11556,0,0,0,1,2,3
22088,50,147,401;1424,0,0,0,0,2,2
22089,50,151,406;411,0,0,0,0,2,2
22090,50,156,418,0,0,0,0,1,1
22091,50,158,426,0,0,0,0,1,1
22092,50,159,427;428,0,0,0,0,2,2
22093,50,162,435,0,0,0,0,1,1
22094,50,163,438,0,0,0,0,1,1
22095,50,173,2878;3238,0,0,0,2,0,2
22096,50,178,487;756;1287;2555,0,0,0,2,2,4
22097,50,179,492,0,0,0,0,1,1
22098,50,183,500;6198,0,0,0,0,2,2
22099,50,184,502,0,0,0,0,1,1
22100,50,185,505;9616,0,0,0,0,2,2
22101,50,194,531,0,0,0,0,1,1
22102,50,197,7514,0,0,0,0,1,1
22103,50,207,568;6413;9356,0,0,0,1,2,3
22104,50,230,4407,0,0,0,0,1,1
22105,50,231,622,0,0,0,0,1,1
22106,50,233,624,0,0,0,0,1,1
22107,50,235,629,0,0,0,0,1,1
22108,50,236,634,0,0,0,0,1,1
22109,50,240,644,0,0,0,0,1,1
22110,50,246,9833,0,0,0,0,1,1
22111,50,254,676,0,0,0,0,1,1
22112,50,258,689;9242,0,0,0,0,2,2
22113,50,269,710,0,0,0,0,1,1
22114,50,271,666,0,0,0,0,1,1
22115,50,274,722;1809,0,0,0,0,2,2
22116,50,280,740;10169,0,0,0,2,0,2
22117,50,289,758,0,0,0,0,1,1
22118,50,291,4861;4889,0,0,0,0,2,2
22119,50,295,767,0,0,0,0,1,1
22120,50,300,782,0,0,0,0,1,1
22121,50,304,794;795;3699;4487;4649;8124;12229,0,0,0,2,5,7
22122,50,305,796,0,0,0,0,1,1
22123,50,306,1945,0,0,0,0,1,1
22124,50,308,807,0,0,0,0,1,1
22125,50,310,812,0,0,0,0,1,1
22126,50,313,818;5690,0,0,0,0,2,2
22127,50,314,820,0,0,0,0,1,1
22128,50,324,847;2441,0,0,0,0,2,2
22129,50,327,854,0,0,0,0,1,1
22130,50,329,5094,0,0,0,0,1,1
22131,50,332,869,0,0,0,0,1,1
22132,50,334,876,0,0,0,0,1,1
22133,50,335,9878,0,0,0,0,1,1
22134,50,340,894;2674,0,0,0,0,2,2
22135,50,348,7109,0,0,0,0,1,1
22136,50,352,925,0,0,0,0,1,1
22137,50,354,930;8984,0,0,0,0,2,2
22138,50,361,948;4291,0,0,0,0,2,2
22139,50,365,965,0,0,0,0,1,1
22140,50,376,1000,0,0,0,0,1,1
22141,50,378,1005,0,0,0,0,1,1
22142,50,393,10260;13558;14140;14552,0,0,2,2,0,4
22143,50,394,1046;9576,0,0,0,0,2,2
22144,50,398,1058;3444,0,0,0,0,2,2
22145,50,410,1082,0,0,0,0,1,1
22146,50,411,1083;9414,0,0,0,0,2,2
22147,50,414,1089,0,0,0,0,1,1
22148,50,420,1106;1107;1181,0,0,0,1,2,3
22149,50,423,1112,0,0,0,0,1,1
22150,50,428,1124,0,0,0,0,1,1
22151,50,434,9613,0,0,0,0,1,1
22152,50,435,5845,0,0,0,0,1,1
22153,50,437,902;5742,0,0,0,2,0,2
22154,50,445,1176,0,0,0,0,1,1
22155,50,447,4088;11133,0,0,0,1,1,2
22156,50,449,8981,0,0,0,0,1,1
22157,50,451,1185,0,0,0,0,1,1
22158,50,453,1190,0,0,0,0,1,1
22159,50,455,1196,0,0,0,0,1,1
22160,50,457,1201,0,0,0,0,1,1
22161,50,461,1211,0,0,0,0,1,1
22162,50,464,1221,0,0,0,0,1,1
22163,50,478,421;1260;13514;15018,0,0,1,3,0,4
22164,50,480,1266;13666,0,0,0,2,0,2
22165,50,483,1276,0,0,0,0,1,1
22166,50,484,1277,0,0,0,0,1,1
22167,50,487,321;1283,0,0,0,0,2,2
22168,50,488,7429,0,0,0,0,1,1
22169,50,497,1315;1316,0,0,0,0,2,2
22170,50,503,1329,0,0,0,0,1,1
22171,50,504,4117,0,0,0,0,1,1
22172,50,507,1338,0,0,0,0,1,1
22173,50,513,1359;8111;13009,0,0,0,3,0,3
22174,50,515,1365;3043,0,0,0,0,2,2
22175,50,518,1373,0,0,0,0,1,1
22176,50,519,4925;8864,0,0,0,0,2,2
22177,50,531,1400;1401,0,0,0,0,2,2
22178,50,534,1405,0,0,0,0,1,1
22179,50,542,6846,0,0,0,0,1,1
22180,50,545,1435;1436,0,0,0,0,2,2
22181,50,550,1444;9792,0,0,0,0,2,2
22182,50,552,1452,0,0,0,1,0,1
22183,50,553,4314;12070,0,0,0,1,1,2
22184,50,555,1456;4134,0,0,0,0,2,2
22185,50,556,1459,0,0,0,0,1,1
22186,50,558,1464,0,0,0,0,1,1
22187,50,560,922;1469,0,0,0,0,2,2
22188,50,562,1475;9911,0,0,0,0,2,2
22189,50,565,1483,0,0,0,0,1,1
22190,50,568,1495,0,0,0,0,1,1
22191,50,569,1497;5273,0,0,0,0,2,2
22192,50,571,1502;2502,0,0,0,0,2,2
22193,50,573,1506;3919,0,0,0,0,2,2
22194,50,574,3027,0,0,0,0,1,1
22195,50,577,1517,0,0,0,0,1,1
22196,50,579,1521,0,0,0,0,1,1
22197,50,580,2722,0,0,0,0,1,1
22198,50,582,1529;3538;12606,0,0,0,1,2,3
22199,50,584,1538;2068;13658,0,0,0,3,0,3
22200,50,585,1540,0,0,0,0,1,1
22201,50,587,3263,0,0,0,0,1,1
22202,50,590,1553;9321,0,0,0,0,2,2
22203,50,592,1558,0,0,0,0,1,1
22204,50,593,1560;7464,0,0,0,0,2,2
22205,50,594,1563,0,0,0,0,1,1
22206,50,595,1566,0,0,0,0,1,1
22207,50,605,1594,0,0,0,0,1,1
22208,50,607,1596;4276,0,0,0,0,2,2
22209,50,608,1597;1598,0,0,0,0,2,2
22210,50,610,4471,0,0,0,1,0,1
22211,50,614,1618;1619;6335;9513;13654,0,0,0,5,0,5
22212,50,615,1620;4140,0,0,0,0,2,2
22213,50,622,1638,0,0,0,0,1,1
22214,50,624,1643,0,0,0,0,1,1
22215,50,625,2480;2605;6631;11738,0,0,0,1,3,4
22216,50,628,2835,0,0,0,0,1,1
22217,50,630,1661,0,0,0,0,1,1
22218,50,633,1671;1808;13422,0,0,0,3,0,3
22219,50,634,5117,0,0,0,0,1,1
22220,50,639,1685,0,0,0,0,1,1
22221,50,641,1690,0,0,0,0,1,1
22222,50,642,6683;8308,0,0,0,0,2,2
22223,50,643,1702;2093,0,0,0,1,1,2
22224,50,644,1704,0,0,0,0,1,1
22225,50,648,1715;8540,0,0,0,0,2,2
22226,50,649,1717,0,0,0,0,1,1
22227,50,650,1723,0,0,0,0,1,1
22228,50,653,1733,0,0,0,0,1,1
22229,50,656,1742,0,0,0,0,1,1
22230,50,658,1748;1749,0,0,0,0,2,2
22231,50,661,648;1756;12563;13156,0,0,0,4,0,4
22232,50,673,2802;5867,0,0,0,0,2,2
22233,50,682,1810,0,0,0,0,1,1
22234,50,684,1812,0,0,0,0,1,1
22235,50,692,1829;1830,0,0,0,0,2,2
22236,50,696,697,0,0,0,0,1,1
22237,50,698,1843;7783,0,0,0,0,2,2
22238,50,709,2257,0,0,0,0,1,1
22239,50,716,1881;4064,0,0,0,0,2,2
22240,50,720,1891;8224,0,0,0,0,2,2
22241,50,721,1893,0,0,0,0,1,1
22242,50,728,1914;4775,0,0,0,0,2,2
22243,50,729,1916,0,0,0,0,1,1
22244,50,736,4838;7667,0,0,0,0,2,2
22245,50,738,4187;4283,0,0,0,0,2,2
22246,50,747,8274,0,0,0,0,1,1
22247,50,749,1963;7142,0,0,0,2,0,2
22248,50,750,1964;1965,0,0,0,0,2,2
22249,50,752,1970;10985,0,0,0,1,1,2
22250,50,753,4405,0,0,0,0,1,1
22251,50,758,8951,0,0,0,0,1,1
22252,50,759,1993,0,0,0,0,1,1
22253,50,762,1997;2251,0,0,0,0,2,2
22254,50,768,2006,0,0,0,0,1,1
22255,50,769,2012,0,0,0,0,1,1
22256,50,770,2016,0,0,0,0,1,1
22257,50,773,2026;8792,0,0,0,0,2,2
22258,50,782,9477,0,0,0,0,1,1
22259,50,784,8991,0,0,0,0,1,1
22260,50,787,2064,0,0,0,0,1,1
22261,50,791,2073,0,0,0,0,1,1
22262,50,794,2080;2889,0,0,0,0,2,2
22263,50,797,1432;10103;10235;10271;10331;13019;13169;13358;13606;13714;14239;14626,0,0,2,10,0,12
22264,50,798,2088,0,0,0,0,1,1
22265,50,803,2103;5953,0,0,0,0,2,2
22266,50,806,2110,0,0,0,0,1,1
22267,50,816,2129,0,0,0,0,1,1
22268,50,817,2138;6351,0,0,0,0,2,2
22269,50,818,2142;4743;13058,0,0,0,3,0,3
22270,50,819,2143,0,0,0,0,1,1
22271,50,821,2148,0,0,0,0,1,1
22272,50,822,9867,0,0,0,0,1,1
22273,50,826,2157;2158,0,0,0,0,2,2
22274,50,828,2162,0,0,0,0,1,1
22275,50,833,6345,0,0,0,0,1,1
22276,50,852,655;2225;5323,0,0,0,0,3,3
22277,50,857,2238;6207,0,0,0,0,2,2
22278,50,864,2263;6046,0,0,0,0,2,2
22279,50,870,2072,0,0,0,0,1,1
22280,50,871,4707;9224,0,0,0,0,2,2
22281,50,873,1683;2287,0,0,0,0,2,2
22282,50,877,2299,0,0,0,0,1,1
22283,50,878,2303;7272,0,0,0,0,2,2
22284,50,885,2315,0,0,0,0,1,1
22285,50,886,1583;2320,0,0,0,0,2,2
22286,50,888,2328,0,0,0,0,1,1
22287,50,892,2335,0,0,0,0,1,1
22288,50,893,2338,0,0,0,0,1,1
22289,50,895,2344,0,0,0,0,1,1
22290,50,897,1371;4675;4722,0,0,0,1,2,3
22291,50,902,2367,0,0,0,0,1,1
22292,50,904,2374,0,0,0,0,1,1
22293,50,919,2415;9413,0,0,0,0,2,2
22294,50,932,2449;4793,0,0,0,2,0,2
22295,50,935,2454,0,0,0,0,1,1
22296,50,937,777,0,0,0,0,1,1
22297,50,940,2471,0,0,0,0,1,1
22298,50,941,2476,0,0,0,1,0,1
22299,50,953,2513;4920,0,0,0,0,2,2
22300,50,962,4320;11898,0,0,0,1,1,2
22301,50,966,308,0,0,0,0,1,1
22302,50,967,2216;2550,0,0,0,0,2,2
22303,50,969,2554,0,0,0,0,1,1
22304,50,970,2558,0,0,0,0,1,1
22305,50,972,2564;4002,0,0,0,0,2,2
22306,50,977,2114;2574,0,0,0,0,2,2
22307,50,985,6767,0,0,0,0,1,1
22308,50,987,1367,0,0,0,0,1,1
22309,50,988,2599,0,0,0,0,1,1
22310,50,989,7829,0,0,0,0,1,1
22311,50,994,2613;4625;11332,0,0,0,1,2,3
22312,50,995,2614,0,0,0,0,1,1
22313,50,1001,2630,0,0,0,0,1,1
22314,50,1005,623,0,0,0,0,1,1
22315,50,1013,2658,0,0,0,0,1,1
22316,50,1018,2668,0,0,0,0,1,1
22317,50,1025,2691,0,0,0,0,1,1
22318,50,1029,2699;2701;5135;9102;12948;13075,0,0,0,6,0,6
22319,50,1036,2872,0,0,0,0,1,1
22320,50,1037,2712;6695,0,0,0,0,2,2
22321,50,1048,2749;8479,0,0,0,0,2,2
22322,50,1059,2773;8322;12405,0,0,0,1,2,3
22323,50,1063,7331,0,0,0,0,1,1
22324,50,1070,2810;2811;2812;3041,0,0,0,0,4,4
22325,50,1071,2814,0,0,0,0,1,1
22326,50,1072,2819,0,0,0,0,1,1
22327,50,1073,2821,0,0,0,0,1,1
22328,50,1074,5628;11897,0,0,0,1,1,2
22329,50,1076,2829,0,0,0,0,1,1
22330,50,1077,1700;3346;13920,0,0,1,2,0,3
22331,50,1086,2856;2857,0,0,0,0,2,2
22332,50,1088,8362,0,0,0,0,1,1
22333,50,1093,2054;3190,0,0,0,0,2,2
22334,50,1094,2882,0,0,0,0,1,1
22335,50,1096,264;9488,0,0,0,0,2,2
22336,50,1098,2622;3436,0,0,0,0,2,2
22337,50,1101,2897;7116,0,0,0,0,2,2
22338,50,1102,2898,0,0,0,0,1,1
22339,50,1109,2911;9702,0,0,0,0,2,2
22340,50,1111,2915,0,0,0,0,1,1
22341,50,1113,2918;3342,0,0,0,0,2,2
22342,50,1123,2941,0,0,0,0,1,1
22343,50,1128,2956,0,0,0,0,1,1
22344,50,1129,2958,0,0,0,0,1,1
22345,50,1130,6384,0,0,0,0,1,1
22346,50,1134,2973;2974,0,0,0,0,2,2
22347,50,1136,2982,0,0,0,0,1,1
22348,50,1142,1440,0,0,0,0,1,1
22349,50,1152,3024,0,0,0,0,1,1
22350,50,1166,8867;9852,0,0,0,0,2,2
22351,50,1168,3076,0,0,0,0,1,1
22352,50,1170,3080,0,0,0,0,1,1
22353,50,1180,3105;6564,0,0,0,0,2,2
22354,50,1181,3109;3110,0,0,0,0,2,2
22355,50,1185,745;6539,0,0,0,0,2,2
22356,50,1186,1946,0,0,0,0,1,1
22357,50,1191,3138,0,0,0,0,1,1
22358,50,1193,3144,0,0,0,0,1,1
22359,50,1194,3148,0,0,0,0,1,1
22360,50,1198,4330,0,0,0,0,1,1
22361,50,1202,3169,0,0,0,0,1,1
22362,50,1208,3181,0,0,0,0,1,1
22363,50,1210,3187;6504,0,0,0,0,2,2
22364,50,1216,3206,0,0,0,0,1,1
22365,50,1217,1368;3210,0,0,0,0,2,2
22366,50,1220,3220,0,0,0,0,1,1
22367,50,1225,3237,0,0,0,0,1,1
22368,50,1229,520,0,0,0,0,1,1
22369,50,1232,9435,0,0,0,0,1,1
22370,50,1233,3258,0,0,0,0,1,1
22371,50,1236,7414,0,0,0,0,1,1
22372,50,1245,3285,0,0,0,0,1,1
22373,50,1250,3294,0,0,0,0,1,1
22374,50,1251,3298;4522,0,0,0,1,1,2
22375,50,1272,3344,0,0,0,0,1,1
22376,50,1273,3347,0,0,0,0,1,1
22377,50,1274,3349;3467,0,0,0,0,2,2
22378,50,1280,3369,0,0,0,0,1,1
22379,50,1285,3384,0,0,0,0,1,1
22380,50,1287,3396,0,0,0,0,1,1
22381,50,1290,9895,0,0,0,0,1,1
22382,50,1291,3410,0,0,0,0,1,1
22383,50,1292,3411;6378,0,0,0,0,2,2
22384,50,1293,887;3412,0,0,0,0,2,2
22385,50,1297,3423,0,0,0,0,1,1
22386,50,1299,3427,0,0,0,0,1,1
22387,50,1306,3448,0,0,0,0,1,1
22388,50,1308,3455;6035,0,0,0,0,2,2
22389,50,1315,3474;5508,0,0,0,0,2,2
22390,50,1320,3487,0,0,0,0,1,1
22391,50,1326,3501,0,0,0,0,1,1
22392,50,1327,3505,0,0,0,0,1,1
22393,50,1331,3511;3512,0,0,0,0,2,2
22394,50,1332,497;3514,0,0,0,0,2,2
22395,50,1337,3526;5957,0,0,0,0,2,2
22396,50,1339,3534,0,0,0,0,1,1
22397,50,1347,3554;3555,0,0,0,0,2,2
22398,50,1354,3576,0,0,0,0,1,1
22399,50,1359,3592,0,0,0,1,0,1
22400,50,1363,3603,0,0,0,0,1,1
22401,50,1367,3611,0,0,0,0,1,1
22402,50,1373,3623,0,0,0,0,1,1
22403,50,1391,3668;6607,0,0,0,0,2,2
22404,50,1394,3680,0,0,0,0,1,1
22405,50,1395,3682;5103,0,0,0,0,2,2
22406,50,1397,3687,0,0,0,0,1,1
22407,50,1400,3694,0,0,0,0,1,1
22408,50,1401,3697,0,0,0,0,1,1
22409,50,1403,3703;7711,0,0,0,0,2,2
22410,50,1407,3714,0,0,0,0,1,1
22411,50,1411,3723,0,0,0,0,1,1
22412,50,1412,3729,0,0,0,0,1,1
22413,50,1414,3735,0,0,0,1,0,1
22414,50,1415,8430,0,0,0,0,1,1
22415,50,1416,3676;9990,0,0,0,0,2,2
22416,50,1419,3745,0,0,0,0,1,1
22417,50,1420,3747,0,0,0,0,1,1
22418,50,1421,3751,0,0,0,0,1,1
22419,50,1425,6156,0,0,0,0,1,1
22420,50,1426,3763,0,0,0,0,1,1
22421,50,1427,132;2804;3766;3767;3768;7815,0,0,0,0,6,6
22422,50,1430,7615;7900,0,0,0,0,2,2
22423,50,1432,9143,0,0,0,0,1,1
22424,50,1434,3781,0,0,0,0,1,1
22425,50,1437,3788,0,0,0,0,1,1
22426,50,1439,2739;3793,0,0,0,0,2,2
22427,50,1440,3797;7474,0,0,0,0,2,2
22428,50,1444,3808;4190,0,0,0,0,2,2
22429,50,1445,3810,0,0,0,0,1,1
22430,50,1446,3814,0,0,0,0,1,1
22431,50,1452,3828,0,0,0,0,1,1
22432,50,1457,3845,0,0,0,0,1,1
22433,50,1458,3848;8580,0,0,0,0,2,2
22434,50,1459,3851,0,0,0,0,1,1
22435,50,1461,3856,0,0,0,0,1,1
22436,50,1475,3893,0,0,0,0,1,1
22437,50,1476,3897,0,0,0,0,1,1
22438,50,1481,3908,0,0,0,0,1,1
22439,50,1501,3966,0,0,0,0,1,1
22440,50,1502,3970,0,0,0,0,1,1
22441,50,1504,885,0,0,0,0,1,1
22442,50,1506,4423;9919,0,0,0,0,2,2
22443,50,1508,3983;3984,0,0,0,0,2,2
22444,50,1511,3992,0,0,0,0,1,1
22445,50,1514,3999;7359,0,0,0,0,2,2
22446,50,1515,4001,0,0,0,0,1,1
22447,50,1527,4029;5177,0,0,0,0,2,2
22448,50,1531,4038;8751,0,0,0,0,2,2
22449,50,1533,761,0,0,0,0,1,1
22450,50,1535,4050;9463,0,0,0,0,2,2
22451,50,1541,137,0,0,0,0,1,1
22452,50,1542,4069,0,0,0,0,1,1
22453,50,1543,4072,0,0,0,0,1,1
22454,50,1544,4077,0,0,0,0,1,1
22455,50,1551,4091;4093;5890;10016;13549;13767;14007,0,0,1,6,0,7
22456,50,1555,4098;9106,0,0,0,0,2,2
22457,50,1556,4099,0,0,0,0,1,1
22458,50,1557,4104,0,0,0,0,1,1
22459,50,1558,5222,0,0,0,0,1,1
22460,50,1572,4135;10748,0,0,0,1,1,2
22461,50,1576,4143,0,0,0,0,1,1
22462,50,1577,2396;4150,0,0,0,2,0,2
22463,50,1581,4157;4158,0,0,0,0,2,2
22464,50,1583,4161,0,0,0,0,1,1
22465,50,1586,4171,0,0,0,0,1,1
22466,50,1588,4175,0,0,0,0,1,1
22467,50,1598,7907;9748,0,0,0,0,2,2
22468,50,1600,4204,0,0,0,0,1,1
22469,50,1601,4205;7021,0,0,0,0,2,2
22470,50,1609,4227,0,0,0,0,1,1
22471,50,1611,4232,0,0,0,0,1,1
22472,50,1616,4240,0,0,0,0,1,1
22473,50,1618,4246,0,0,0,0,1,1
22474,50,1621,4253;4490,0,0,0,0,2,2
22475,50,1622,4255,0,0,0,0,1,1
22476,50,1628,4270,0,0,0,0,1,1
22477,50,1630,4284;6157,0,0,0,0,2,2
22478,50,1633,1647,0,0,0,0,1,1
22479,50,1634,589;4292,0,0,0,0,2,2
22480,50,1636,4299,0,0,0,0,1,1
22481,50,1641,4311,0,0,0,0,1,1
22482,50,1643,4316,0,0,0,0,1,1
22483,50,1644,728,0,0,0,0,1,1
22484,50,1647,4323,0,0,0,0,1,1
22485,50,1653,4492;8321,0,0,0,0,2,2
22486,50,1658,4344,0,0,0,0,1,1
22487,50,1665,4358,0,0,0,0,1,1
22488,50,1672,4376,0,0,0,0,1,1
22489,50,1674,4382,0,0,0,0,1,1
22490,50,1675,4387,0,0,0,0,1,1
22491,50,1677,4391,0,0,0,0,1,1
22492,50,1687,2913;4419,0,0,0,0,2,2
22493,50,1692,4428,0,0,0,0,1,1
22494,50,1697,4437;4438,0,0,0,0,2,2
22495,50,1702,4446;4447,0,0,0,0,2,2
22496,50,1705,2861;4455,0,0,0,0,2,2
22497,50,1707,4461,0,0,0,0,1,1
22498,50,1713,4472,0,0,0,0,1,1
22499,50,1715,1577;4481;13166;13623,0,0,0,4,0,4
22500,50,1718,4491;9047,0,0,0,0,2,2
22501,50,1719,4494,0,0,0,0,1,1
22502,50,1723,4504,0,0,0,0,1,1
22503,50,1724,4508,0,0,0,0,1,1
22504,50,1728,4521,0,0,0,0,1,1
22505,50,1729,1549;4452,0,0,0,0,2,2
22506,50,1730,4526,0,0,0,0,1,1
22507,50,1731,805,0,0,0,0,1,1
22508,50,1734,6082,0,0,0,0,1,1
22509,50,1736,4538,0,0,0,0,1,1
22510,50,1737,4541,0,0,0,0,1,1
22511,50,1738,4545,0,0,0,0,1,1
22512,50,1745,4560,0,0,0,0,1,1
22513,50,1747,4565,0,0,0,0,1,1
22514,50,1752,4578,0,0,0,0,1,1
22515,50,1756,4588,0,0,0,0,1,1
22516,50,1768,1820;4627,0,0,0,0,2,2
22517,50,1769,3108;4633;4634;14064,0,0,1,3,0,4
22518,50,1770,4636,0,0,0,0,1,1
22519,50,1773,4643,0,0,0,0,1,1
22520,50,1777,4653;5058,0,0,0,0,2,2
22521,50,1787,4673,0,0,0,0,1,1
22522,50,1790,4682,0,0,0,0,1,1
22523,50,1791,4684,0,0,0,0,1,1
22524,50,1798,4702,0,0,0,0,1,1
22525,50,1799,4706,0,0,0,0,1,1
22526,50,1806,4725,0,0,0,0,1,1
22527,50,1807,4727;8028,0,0,0,0,2,2
22528,50,1811,4734,0,0,0,0,1,1
22529,50,1812,4739,0,0,0,0,1,1
22530,50,1815,8062,0,0,0,0,1,1
22531,50,1817,4753,0,0,0,0,1,1
22532,50,1822,10147;10212;13052;13336,0,0,0,4,0,4
22533,50,1825,4776;5146,0,0,0,0,2,2
22534,50,1827,4780,0,0,0,0,1,1
22535,50,1829,4783,0,0,0,0,1,1
22536,50,1831,4785;7734,0,0,0,0,2,2
22537,50,1834,4788;11681,0,0,0,1,1,2
22538,50,1842,4813,0,0,0,0,1,1
22539,50,1844,4816,0,0,0,0,1,1
22540,50,1846,1541;2005;3023,0,0,0,0,3,3
22541,50,1848,9958,0,0,0,0,1,1
22542,50,1851,4830,0,0,0,0,1,1
22543,50,1855,2806,0,0,0,0,1,1
22544,50,1856,4844,0,0,0,0,1,1
22545,50,1859,3099;4853,0,0,0,0,2,2
22546,50,1862,4870;8764,0,0,0,0,2,2
22547,50,1866,4879;8171,0,0,0,0,2,2
22548,50,1867,4883,0,0,0,1,0,1
22549,50,1869,3963;4892;13335;14169,0,0,1,3,0,4
22550,50,1875,7013,0,0,0,0,1,1
22551,50,1878,4910,0,0,0,0,1,1
22552,50,1882,4922,0,0,0,0,1,1
22553,50,1884,4659,0,0,0,0,1,1
22554,50,1885,3981,0,0,0,0,1,1
22555,50,1886,4556,0,0,0,0,1,1
22556,50,1887,4936,0,0,0,0,1,1
22557,50,1898,3364;4975,0,0,0,0,2,2
22558,50,1900,4981,0,0,0,0,1,1
22559,50,1906,4992,0,0,0,0,1,1
22560,50,1914,5012,0,0,0,0,1,1
22561,50,1915,680;5014,0,0,0,0,2,2
22562,50,1917,5022,0,0,0,0,1,1
22563,50,1919,1494,0,0,0,0,1,1
22564,50,1922,5033;5034,0,0,0,0,2,2
22565,50,1923,7428,0,0,0,0,1,1
22566,50,1924,9914,0,0,0,0,1,1
22567,50,1926,5042,0,0,0,0,1,1
22568,50,1930,5055,0,0,0,0,1,1
22569,50,1934,5066,0,0,0,0,1,1
22570,50,1935,5067,0,0,0,0,1,1
22571,50,1937,1919,0,0,0,0,1,1
22572,50,1942,713,0,0,0,0,1,1
22573,50,1943,5088,0,0,0,0,1,1
22574,50,1946,5095,0,0,0,0,1,1
22575,50,1948,5102;5314,0,0,0,0,2,2
22576,50,1954,5116,0,0,0,0,1,1
22577,50,1961,4017;11148,0,0,0,1,1,2
22578,50,1966,5139;9360,0,0,0,0,2,2
22579,50,1972,5155,0,0,0,0,1,1
22580,50,1974,5163,0,0,0,0,1,1
22581,50,1975,5165;8716,0,0,0,0,2,2
22582,50,1978,5172,0,0,0,0,1,1
22583,50,1980,5179;8446,0,0,0,0,2,2
22584,50,1982,9439,0,0,0,0,1,1
22585,50,1983,419;5185,0,0,0,0,2,2
22586,50,1984,1239;5190;5192,0,0,0,1,2,3
22587,50,1986,2978;4983,0,0,0,0,2,2
22588,50,1994,5217,0,0,0,0,1,1
22589,50,2000,5233,0,0,0,0,1,1
22590,50,2001,5237,0,0,0,0,1,1
22591,50,2004,4803,0,0,0,0,1,1
22592,50,2005,3119;5247,0,0,0,0,2,2
22593,50,2006,5251;5824;10598,0,0,0,1,2,3
22594,50,2018,5274,0,0,0,0,1,1
22595,50,2022,5285,0,0,0,0,1,1
22596,50,2024,5291,0,0,0,0,1,1
22597,50,2025,8731,0,0,0,0,1,1
22598,50,2028,2323;9655;9749;13776;14076,0,0,1,4,0,5
22599,50,2031,5309,0,0,0,0,1,1
22600,50,2033,5315;6176,0,0,0,0,2,2
22601,50,2036,5321,0,0,0,0,1,1
22602,50,2039,5325,0,0,0,0,1,1
22603,50,2040,5327,0,0,0,0,1,1
22604,50,2041,5332;6514,0,0,0,0,2,2
22605,50,2042,730;4991,0,0,0,0,2,2
22606,50,2043,5335;8525,0,0,0,0,2,2
22607,50,2045,5338,0,0,0,0,1,1
22608,50,2057,3831,0,0,0,0,1,1
22609,50,2058,5767,0,0,0,0,1,1
22610,50,2063,5383,0,0,0,0,1,1
22611,50,2065,4615;5388,0,0,0,0,2,2
22612,50,2066,5392;11009,0,0,0,1,1,2
22613,50,2067,1095;5393,0,0,0,0,2,2
22614,50,2071,5404,0,0,0,0,1,1
22615,50,2078,2486;5422,0,0,0,0,2,2
22616,50,2079,5423;5424,0,0,0,0,2,2
22617,50,2080,5427;6732;11617,0,0,0,1,2,3
22618,50,2083,5437,0,0,0,1,0,1
22619,50,2089,5454,0,0,0,0,1,1
22620,50,2090,5457,0,0,0,0,1,1
22621,50,2093,5463,0,0,0,0,1,1
22622,50,2096,5468,0,0,0,0,1,1
22623,50,2106,5465,0,0,0,0,1,1
22624,50,2111,5666;11730,0,0,0,1,1,2
22625,50,2113,459,0,0,0,0,1,1
22626,50,2118,5518,0,0,0,0,1,1
22627,50,2120,5524,0,0,0,0,1,1
22628,50,2126,3305;5534,0,0,0,0,2,2
22629,50,2134,5555,0,0,0,0,1,1
22630,50,2142,1375;5448,0,0,0,0,2,2
22631,50,2143,5580,0,0,0,0,1,1
22632,50,2145,4602;5582;12703,0,0,0,1,2,3
22633,50,2152,5596,0,0,0,0,1,1
22634,50,2157,5608,0,0,0,0,1,1
22635,50,2159,4395;5000,0,0,0,0,2,2
22636,50,2165,5009;5627,0,0,0,0,2,2
22637,50,2166,5631,0,0,0,0,1,1
22638,50,2170,5641;9920,0,0,0,0,2,2
22639,50,2173,5648,0,0,0,0,1,1
22640,50,2174,5651,0,0,0,0,1,1
22641,50,2175,5654,0,0,0,0,1,1
22642,50,2177,5658,0,0,0,0,1,1
22643,50,2181,7457,0,0,0,0,1,1
22644,50,2185,5675,0,0,0,0,1,1
22645,50,2186,7001,0,0,0,0,1,1
22646,50,2194,5694;7933,0,0,0,0,2,2
22647,50,2197,1416;9526,0,0,0,0,2,2
22648,50,2198,6592,0,0,0,0,1,1
22649,50,2199,5712,0,0,0,0,1,1
22650,50,2212,5748;11235,0,0,0,1,1,2
22651,50,2219,5766;12520;12750;13136,0,0,0,4,0,4
22652,50,2230,5796;7089,0,0,0,0,2,2
22653,50,2235,4550,0,0,0,0,1,1
22654,50,2237,8644,0,0,0,0,1,1
22655,50,2242,5821,0,0,0,0,1,1
22656,50,2243,5822,0,0,0,0,1,1
22657,50,2244,9894,0,0,0,0,1,1
22658,50,2247,5832,0,0,0,0,1,1
22659,50,2264,5722;5868,0,0,0,0,2,2
22660,50,2265,5872,0,0,0,0,1,1
22661,50,2274,5887,0,0,0,0,1,1
22662,50,2277,5896;9554,0,0,0,0,2,2
22663,50,2282,3085;5909,0,0,0,0,2,2
22664,50,2283,5910,0,0,0,0,1,1
22665,50,2286,3010;3955,0,0,0,0,2,2
22666,50,2290,3910;5925,0,0,0,0,2,2
22667,50,2294,5934,0,0,0,0,1,1
22668,50,2298,5944,0,0,0,0,1,1
22669,50,2299,5946,0,0,0,0,1,1
22670,50,2301,5951;9192,0,0,0,0,2,2
22671,50,2302,3389;5955,0,0,0,0,2,2
22672,50,2305,4156;5960,0,0,0,0,2,2
22673,50,2312,5984,0,0,0,0,1,1
22674,50,2314,5888;5989,0,0,0,0,2,2
22675,50,2319,4224,0,0,0,0,1,1
22676,50,2320,2089;9937,0,0,0,0,2,2
22677,50,2329,6027,0,0,0,0,1,1
22678,50,2331,6032,0,0,0,0,1,1
22679,50,2334,6039;7609,0,0,0,0,2,2
22680,50,2336,6043;6044,0,0,0,0,2,2
22681,50,2341,6049,0,0,0,0,1,1
22682,50,2342,6052;7093,0,0,0,0,2,2
22683,50,2343,1360;6055;14311,0,0,1,2,0,3
22684,50,2349,6065,0,0,0,0,1,1
22685,50,2350,1842,0,0,0,0,1,1
22686,50,2355,6085,0,0,0,1,0,1
22687,50,2361,6095;6096,0,0,0,0,2,2
22688,50,2362,6097,0,0,0,0,1,1
22689,50,2367,6113;6811,0,0,0,0,2,2
22690,50,2380,6141,0,0,0,0,1,1
22691,50,2384,5478;6150,0,0,0,0,2,2
22692,50,2385,8328;10131,0,0,0,2,0,2
22693,50,2388,6162,0,0,0,0,1,1
22694,50,2392,6174,0,0,0,0,1,1
22695,50,2393,6175,0,0,0,0,1,1
22696,50,2395,6180;10589,0,0,0,1,1,2
22697,50,2396,6181,0,0,0,0,1,1
22698,50,2399,6193,0,0,0,0,1,1
22699,50,2407,6214,0,0,0,0,1,1
22700,50,2408,6217,0,0,0,0,1,1
22701,50,2418,6241,0,0,0,0,1,1
22702,50,2422,6251,0,0,0,0,1,1
22703,50,2429,6272,0,0,0,1,0,1
22704,50,2430,6274,0,0,0,0,1,1
22705,50,2435,6291,0,0,0,0,1,1
22706,50,2441,681,0,0,0,0,1,1
22707,50,2445,6317,0,0,0,0,1,1
22708,50,2446,6321,0,0,0,0,1,1
22709,50,2447,6324,0,0,0,0,1,1
22710,50,2451,4821;6333,0,0,0,0,2,2
22711,50,2453,3652;6342,0,0,0,1,1,2
22712,50,2454,9496,0,0,0,0,1,1
22713,50,2463,6366,0,0,0,0,1,1
22714,50,2468,6379,0,0,0,0,1,1
22715,50,2470,6382;10046;13741;15296,0,0,1,3,0,4
22716,50,2477,4440,0,0,0,0,1,1
22717,50,2479,6402;6403,0,0,0,0,2,2
22718,50,2480,6409,0,0,0,0,1,1
22719,50,2490,1831;6431,0,0,0,0,2,2
22720,50,2494,6439,0,0,0,0,1,1
22721,50,2495,298;6441,0,0,0,0,2,2
22722,50,2497,5601;6448,0,0,0,0,2,2
22723,50,2499,6457,0,0,0,0,1,1
22724,50,2500,6459,0,0,0,0,1,1
22725,50,2501,9927;12964;13378,0,0,0,3,0,3
22726,50,2508,6477,0,0,0,0,1,1
22727,50,2510,6482,0,0,0,0,1,1
22728,50,2514,6491,0,0,0,0,1,1
22729,50,2516,6497,0,0,0,0,1,1
22730,50,2521,1042;6506,0,0,0,0,2,2
22731,50,2528,6521,0,0,0,0,1,1
22732,50,2534,6633,0,0,0,0,1,1
22733,50,2540,213;8627,0,0,0,2,0,2
22734,50,2544,191,0,0,0,0,1,1
22735,50,2549,6575;7930,0,0,0,0,2,2
22736,50,2554,1516;6585,0,0,0,0,2,2
22737,50,2555,6591,0,0,0,0,1,1
22738,50,2556,6594,0,0,0,0,1,1
22739,50,2559,6599,0,0,0,0,1,1
22740,50,2563,6610;8565,0,0,0,0,2,2
22741,50,2567,6618;6619,0,0,0,0,2,2
22742,50,2570,6630,0,0,0,0,1,1
22743,50,2571,6634,0,0,0,0,1,1
22744,50,2572,950;1986;6636;7682,0,0,0,0,4,4
22745,50,2574,5900;6643,0,0,0,0,2,2
22746,50,2577,6650,0,0,0,0,1,1
22747,50,2578,6655,0,0,0,0,1,1
22748,50,2579,6657,0,0,0,0,1,1
22749,50,2581,6663,0,0,0,0,1,1
22750,50,2589,2706,0,0,0,0,1,1
22751,50,2595,6697,0,0,0,0,1,1
22752,50,2603,6729,0,0,0,1,0,1
22753,50,2604,949,0,0,0,0,1,1
22754,50,2606,6737;6738,0,0,0,0,2,2
22755,50,2610,6746,0,0,0,0,1,1
22756,50,2615,6756,0,0,0,0,1,1
22757,50,2619,1139;6770;11720;12902,0,0,0,4,0,4
22758,50,2631,6802,0,0,0,0,1,1
22759,50,2638,11089;11184;14003;15067,0,0,2,2,0,4
22760,50,2641,6824,0,0,0,0,1,1
22761,50,2642,6825,0,0,0,0,1,1
22762,50,2643,6829,0,0,0,0,1,1
22763,50,2650,6853,0,0,0,0,1,1
22764,50,2652,6860,0,0,0,0,1,1
22765,50,2653,811;6862;6867,0,0,0,0,3,3
22766,50,2657,6876,0,0,0,0,1,1
22767,50,2658,2545;5191;5479;6878;6880;9355;13364;13629,0,0,0,5,3,8
22768,50,2674,6913,0,0,0,0,1,1
22769,50,2675,6915,0,0,0,0,1,1
22770,50,2681,3235,0,0,0,0,1,1
22771,50,2685,6939,0,0,0,0,1,1
22772,50,2690,3442;6952,0,0,0,0,2,2
22773,50,2699,6969,0,0,0,0,1,1
22774,50,2705,4691,0,0,0,0,1,1
22775,50,2717,9064,0,0,0,0,1,1
22776,50,2718,7028,0,0,0,0,1,1
22777,50,2719,5113;7034;7035;8443,0,0,0,0,4,4
22778,50,2723,7045,0,0,0,0,1,1
22779,50,2725,7048;9808,0,0,0,0,2,2
22780,50,2735,7074,0,0,0,0,1,1
22781,50,2736,7075;7076,0,0,0,0,2,2
22782,50,2742,7091,0,0,0,0,1,1
22783,50,2744,7094,0,0,0,0,1,1
22784,50,2745,7096,0,0,0,0,1,1
22785,50,2746,7100,0,0,0,0,1,1
22786,50,2751,6428,0,0,0,0,1,1
22787,50,2759,10244;10711;14698;15287,0,0,2,2,0,4
22788,50,2760,7137,0,0,0,0,1,1
22789,50,2761,7139,0,0,0,0,1,1
22790,50,2764,7149;7613,0,0,0,0,2,2
22791,50,2769,1760;7162,0,0,0,0,2,2
22792,50,2770,6765;7164,0,0,0,0,2,2
22793,50,2771,2671,0,0,0,0,1,1
22794,50,2772,5919;7167,0,0,0,0,2,2
22795,50,2773,7296,0,0,0,0,1,1
22796,50,2785,7199,0,0,0,0,1,1
22797,50,2797,7228;7229,0,0,0,0,2,2
22798,50,2809,7252,0,0,0,0,1,1
22799,50,2814,7263,0,0,0,0,1,1
22800,50,2815,7266,0,0,0,0,1,1
22801,50,2817,8082,0,0,0,0,1,1
22802,50,2818,7270,0,0,0,0,1,1
22803,50,2819,7273,0,0,0,0,1,1
22804,50,2820,7277;9362,0,0,0,0,2,2
22805,50,2824,7286,0,0,0,0,1,1
22806,50,2829,9899,0,0,0,0,1,1
22807,50,2832,7307;8672,0,0,0,1,1,2
22808,50,2833,6965,0,0,0,0,1,1
22809,50,2838,9623,0,0,0,0,1,1
22810,50,2839,3268,0,0,0,0,1,1
22811,50,2846,7338,0,0,0,0,1,1
22812,50,2851,7355,0,0,0,0,1,1
22813,50,2854,7363,0,0,0,0,1,1
22814,50,2855,8080,0,0,0,0,1,1
22815,50,2862,2908,0,0,0,0,1,1
22816,50,2863,9946,0,0,0,0,1,1
22817,50,2866,1750;5602,0,0,0,0,2,2
22818,50,2867,7395,0,0,0,1,0,1
22819,50,2869,4577;7399,0,0,0,0,2,2
22820,50,2870,7400;7401,0,0,0,0,2,2
22821,50,2874,1613,0,0,0,0,1,1
22822,50,2878,7427,0,0,0,0,1,1
22823,50,2882,4535;7439;7440;13751;14343,0,0,1,4,0,5
22824,50,2886,7450,0,0,0,0,1,1
22825,50,2893,7467,0,0,0,0,1,1
22826,50,2894,7468,0,0,0,0,1,1
22827,50,2896,7471;7472,0,0,0,0,2,2
22828,50,2899,7480,0,0,0,0,1,1
22829,50,2900,7482,0,0,0,0,1,1
22830,50,2907,3005;7501,0,0,0,0,2,2
22831,50,2908,6837;7504,0,0,0,0,2,2
22832,50,2915,7526,0,0,0,0,1,1
22833,50,2921,7542,0,0,0,0,1,1
22834,50,2932,7573,0,0,0,0,1,1
22835,50,2940,1947,0,0,0,0,1,1
22836,50,2944,1569;1894,0,0,0,0,2,2
22837,50,2947,7607,0,0,0,0,1,1
22838,50,2964,7650,0,0,0,0,1,1
22839,50,2965,3072;9299,0,0,0,0,2,2
22840,50,2969,7664,0,0,0,0,1,1
22841,50,2971,9333,0,0,0,0,1,1
22842,50,2975,1490;7680,0,0,0,0,2,2
22843,50,2980,7693,0,0,0,0,1,1
22844,50,2982,7699;7700,0,0,0,0,2,2
22845,50,2983,7702;8838,0,0,0,0,2,2
22846,50,2985,7708,0,0,0,0,1,1
22847,50,2997,4168;7737,0,0,0,0,2,2
22848,50,3009,1307;7665;13273;13412,0,0,0,4,0,4
22849,50,3010,1019;7767,0,0,0,0,2,2
22850,50,3011,6543;7769,0,0,0,0,2,2
22851,50,3013,4818;7772,0,0,0,0,2,2
22852,50,3014,7774,0,0,0,0,1,1
22853,50,3017,7782,0,0,0,0,1,1
22854,50,3021,6078;7792;11673,0,0,0,1,2,3
22855,50,3022,175;219;12946;13580;13752;13998,0,0,1,5,0,6
22856,50,3024,883;7797,0,0,0,0,2,2
22857,50,3026,7800,0,0,0,0,1,1
22858,50,3028,5858;7807,0,0,0,0,2,2
22859,50,3029,7810,0,0,0,0,1,1
22860,50,3031,7817,0,0,0,0,1,1
22861,50,3045,7854;9657;10476,0,0,0,1,2,3
22862,50,3046,7858,0,0,0,0,1,1
22863,50,3052,7875;9170,0,0,0,0,2,2
22864,50,3053,6398,0,0,0,0,1,1
22865,50,3056,3028;7881;13099,0,0,0,3,0,3
22866,50,3057,7883,0,0,0,0,1,1
22867,50,3061,7892,0,0,0,0,1,1
22868,50,3062,7157;7896,0,0,0,0,2,2
22869,50,3065,8139,0,0,0,0,1,1
22870,50,3070,2747;7915,0,0,0,0,2,2
22871,50,3071,7916,0,0,0,0,1,1
22872,50,3072,3335;3382,0,0,0,0,2,2
22873,50,3078,4188;7937;12402,0,0,0,1,2,3
22874,50,3083,7951,0,0,0,0,1,1
22875,50,3085,7953,0,0,0,0,1,1
22876,50,3098,7985,0,0,0,0,1,1
22877,50,3100,2932;7987,0,0,0,0,2,2
22878,50,3102,7997,0,0,0,0,1,1
22879,50,3104,8001,0,0,0,0,1,1
22880,50,3109,7321;8011,0,0,0,0,2,2
22881,50,3112,3792;4434,0,0,0,0,2,2
22882,50,3120,8051,0,0,0,1,0,1
22883,50,3122,8056,0,0,0,0,1,1
22884,50,3137,8085,0,0,0,0,1,1
22885,50,3142,8098,0,0,0,0,1,1
22886,50,3147,8108,0,0,0,0,1,1
22887,50,3148,8112,0,0,0,0,1,1
22888,50,3150,9822,0,0,0,0,1,1
22889,50,3154,8131,0,0,0,0,1,1
22890,50,3157,8138,0,0,0,0,1,1
22891,50,3158,8141,0,0,0,0,1,1
22892,50,3159,9391,0,0,0,0,1,1
22893,50,3160,5207;8147,0,0,0,0,2,2
22894,50,3163,7350,0,0,0,0,1,1
22895,50,3164,8157;8158,0,0,0,0,2,2
22896,50,3168,8166,0,0,0,0,1,1
22897,50,3178,8193,0,0,0,0,1,1
22898,50,3182,8203,0,0,0,0,1,1
22899,50,3189,6757;7416,0,0,0,0,2,2
22900,50,3191,1943;13957,0,0,1,1,0,2
22901,50,3195,8231,0,0,0,0,1,1
22902,50,3198,6783,0,0,0,0,1,1
22903,50,3199,8239,0,0,0,0,1,1
22904,50,3201,5578;8241,0,0,0,0,2,2
22905,50,3202,884,0,0,0,0,1,1
22906,50,3204,8245,0,0,0,0,1,1
22907,50,3205,8247,0,0,0,0,1,1
22908,50,3206,8250,0,0,0,0,1,1
22909,50,3207,8255;8882,0,0,0,0,2,2
22910,50,3212,3254,0,0,0,0,1,1
22911,50,3221,8294,0,0,0,0,1,1
22912,50,3227,1178;8305,0,0,0,0,2,2
22913,50,3231,8545,0,0,0,0,1,1
22914,50,3233,5052,0,0,0,0,1,1
22915,50,3236,3509;8334,0,0,0,0,2,2
22916,50,3237,4370,0,0,0,0,1,1
22917,50,3242,8349,0,0,0,0,1,1
22918,50,3243,3295;8350,0,0,0,0,2,2
22919,50,3246,2608,0,0,0,0,1,1
22920,50,3247,7676;8357,0,0,0,0,2,2
22921,50,3248,8359,0,0,0,0,1,1
22922,50,3252,8371,0,0,0,0,1,1
22923,50,3256,8381,0,0,0,0,1,1
22924,50,3258,8387,0,0,0,0,1,1
22925,50,3260,4582;8393,0,0,0,0,2,2
22926,50,3261,8522,0,0,0,0,1,1
22927,50,3262,4988,0,0,0,0,1,1
22928,50,3279,6648,0,0,0,0,1,1
22929,50,3287,8462,0,0,0,0,1,1
22930,50,3288,8464,0,0,0,0,1,1
22931,50,3290,5814;8474;14183,0,0,1,2,0,3
22932,50,3291,8475,0,0,0,0,1,1
22933,50,3297,8496,0,0,0,0,1,1
22934,50,3301,8506,0,0,0,0,1,1
22935,50,3303,8509,0,0,0,0,1,1
22936,50,3305,5351,0,0,0,0,1,1
22937,50,3316,8159;8542,0,0,0,0,2,2
22938,50,3318,8550;8551,0,0,0,0,2,2
22939,50,3323,893;8427,0,0,0,0,2,2
22940,50,3324,8569,0,0,0,0,1,1
22941,50,3332,8582,0,0,0,0,1,1
22942,50,3335,8588,0,0,0,0,1,1
22943,50,3336,8593,0,0,0,0,1,1
22944,50,3338,8599;8600,0,0,0,0,2,2
22945,50,3343,5070;8611;11050,0,0,0,1,2,3
22946,50,3351,8636,0,0,0,0,1,1
22947,50,3353,8645,0,0,0,0,1,1
22948,50,3358,5276,0,0,0,0,1,1
22949,50,3367,8681;13507;14078,0,0,1,2,0,3
22950,50,3369,372,0,0,0,0,1,1
22951,50,3370,8686,0,0,0,0,1,1
22952,50,3376,8708,0,0,0,0,1,1
22953,50,3379,8706,0,0,0,0,1,1
22954,50,3383,8721;10243;13876;13982,0,0,2,2,0,4
22955,50,3384,7919;8722,0,0,0,0,2,2
22956,50,3387,4517;8728,0,0,0,0,2,2
22957,50,3398,2163;8755,0,0,0,0,2,2
22958,50,3400,8761;8762,0,0,0,0,2,2
22959,50,3404,8773,0,0,0,0,1,1
22960,50,3406,7657,0,0,0,0,1,1
22961,50,3407,7977;8783;8784,0,0,0,1,2,3
22962,50,3411,4273;8790,0,0,0,0,2,2
22963,50,3416,7490;8804,0,0,0,0,2,2
22964,50,3422,9393,0,0,0,0,1,1
22965,50,3423,8832,0,0,0,0,1,1
22966,50,3426,8842,0,0,0,0,1,1
22967,50,3427,6799;8844,0,0,0,0,2,2
22968,50,3435,2524;10321;13015;14238,0,0,1,3,0,4
22969,50,3436,2310,0,0,0,0,1,1
22970,50,3438,8868,0,0,0,0,1,1
22971,50,3446,8883,0,0,0,0,1,1
22972,50,3449,8895,0,0,0,0,1,1
22973,50,3452,8906,0,0,0,0,1,1
22974,50,3467,8942,0,0,0,0,1,1
22975,50,3470,3635;8952,0,0,0,0,2,2
22976,50,3475,8965,0,0,0,0,1,1
22977,50,3476,8969,0,0,0,0,1,1
22978,50,3477,8970,0,0,0,0,1,1
22979,50,3479,2009;8978;13207;13777,0,0,0,4,0,4
22980,50,3486,8993,0,0,0,0,1,1
22981,50,3488,9000,0,0,0,0,1,1
22982,50,3493,9014,0,0,0,0,1,1
22983,50,3495,9020,0,0,0,0,1,1
22984,50,3498,9026;9784,0,0,0,0,2,2
22985,50,3502,9529,0,0,0,0,1,1
22986,50,3507,2885;9050,0,0,0,0,2,2
22987,50,3510,9055,0,0,0,0,1,1
22988,50,3512,310,0,0,0,0,1,1
22989,50,3515,9065,0,0,0,0,1,1
22990,50,3516,8076,0,0,0,1,0,1
22991,50,3517,324;9070,0,0,0,0,2,2
22992,50,3519,2383;9076,0,0,0,0,2,2
22993,50,3523,8979,0,0,0,0,1,1
22994,50,3532,4380,0,0,0,0,1,1
22995,50,3537,9131,0,0,0,0,1,1
22996,50,3543,9146,0,0,0,0,1,1
22997,50,3546,9152,0,0,0,0,1,1
22998,50,3550,9167,0,0,0,0,1,1
22999,50,3555,9176,0,0,0,0,1,1
23000,50,3559,9183;9184,0,0,0,0,2,2
23001,50,3560,9185,0,0,0,0,1,1
23002,50,3566,9200;9201,0,0,0,0,2,2
23003,50,3569,9209,0,0,0,0,1,1
23004,50,3570,9212,0,0,0,0,1,1
23005,50,3576,9236,0,0,0,0,1,1
23006,50,3580,10284;10502;12749;14191,0,0,1,3,0,4
23007,50,3581,5875;9248,0,0,0,0,2,2
23008,50,3582,9250,0,0,0,0,1,1
23009,50,3587,9261,0,0,0,0,1,1
23010,50,3588,9264,0,0,0,0,1,1
23011,50,3592,9274,0,0,0,0,1,1
23012,50,3594,1351;2231;2240;5395;12400,0,0,0,4,1,5
23013,50,3597,9286;9658,0,0,0,0,2,2
23014,50,3603,9295;12301,0,0,0,1,1,2
23015,50,3605,3373;9301,0,0,0,0,2,2
23016,50,3606,9304,0,0,0,0,1,1
23017,50,3611,9312;9313,0,0,0,0,2,2
23018,50,3612,9315,0,0,0,0,1,1
23019,50,3613,9319;11717,0,0,0,1,1,2
23020,50,3623,9345,0,0,0,0,1,1
23021,50,3625,9349,0,0,0,0,1,1
23022,50,3630,9366,0,0,0,0,1,1
23023,50,3631,9372,0,0,0,0,1,1
23024,50,3636,9382,0,0,0,0,1,1
23025,50,3639,4032;9386,0,0,0,0,2,2
23026,50,3643,4233;9399,0,0,0,0,2,2
23027,50,3645,9405,0,0,0,0,1,1
23028,50,3646,9407,0,0,0,0,1,1
23029,50,3647,9409,0,0,0,0,1,1
23030,50,3649,9416,0,0,0,0,1,1
23031,50,3651,10538;10992;13393;14293;14775,0,0,2,3,0,5
23032,50,3662,9452,0,0,0,0,1,1
23033,50,3666,9470,0,0,0,0,1,1
23034,50,3673,9479,0,0,0,0,1,1
23035,50,3674,9483,0,0,0,0,1,1
23036,50,3684,9508,0,0,0,0,1,1
23037,50,3686,9512,0,0,0,0,1,1
23038,50,3687,9517;11934,0,0,0,1,1,2
23039,50,3688,9521;12032,0,0,0,1,1,2
23040,50,3690,9525,0,0,0,0,1,1
23041,50,3693,2022,0,0,0,0,1,1
23042,50,3696,4346,0,0,0,0,1,1
23043,50,3698,9546,0,0,0,0,1,1
23044,50,3699,9549,0,0,0,0,1,1
23045,50,3701,6021;9552,0,0,0,0,2,2
23046,50,3704,6766;9560,0,0,0,0,2,2
23047,50,3706,9568,0,0,0,0,1,1
23048,50,3713,6535;9587,0,0,0,0,2,2
23049,50,3716,5633,0,0,0,0,1,1
23050,50,3718,9601,0,0,0,0,1,1
23051,50,3719,7523;9604,0,0,0,0,2,2
23052,50,3723,9615,0,0,0,0,1,1
23053,50,3724,9618,0,0,0,0,1,1
23054,50,3725,625;9619,0,0,0,0,2,2
23055,50,3726,69;9620,0,0,0,0,2,2
23056,50,3730,9632,0,0,0,0,1,1
23057,50,3736,279,0,0,0,0,1,1
23058,50,3737,9646,0,0,0,0,1,1
23059,50,3742,5298,0,0,0,0,1,1
23060,50,3744,9663,0,0,0,0,1,1
23061,50,3749,9676,0,0,0,0,1,1
23062,50,3760,9711,0,0,0,0,1,1
23063,50,3761,763;9713,0,0,0,0,2,2
23064,50,3770,9738,0,0,0,0,1,1
23065,50,3771,1663;9742,0,0,0,2,0,2
23066,50,3774,8132;9809,0,0,0,0,2,2
23067,50,3776,9754;9755,0,0,0,0,2,2
23068,50,3780,9766,0,0,0,0,1,1
23069,50,3781,7005,0,0,0,0,1,1
23070,50,3782,9772,0,0,0,0,1,1
23071,50,3784,1605;9778;10165,0,0,0,1,2,3
23072,50,3786,9785,0,0,0,0,1,1
23073,50,3792,1199;9803,0,0,0,0,2,2
23074,50,3797,9815,0,0,0,0,1,1
23075,50,3809,4044,0,0,0,0,1,1
23076,50,3813,799,0,0,0,0,1,1
23077,50,3817,4396;9870;11019,0,0,0,1,2,3
23078,50,3820,9876,0,0,0,0,1,1
23079,50,3823,3901;9891,0,0,0,2,0,2
23080,50,3825,9897,0,0,0,0,1,1
23081,50,3827,552;9900,0,0,0,0,2,2
23082,50,3831,1666;9907,0,0,0,0,2,2
23083,50,3833,4806;9915,0,0,0,0,2,2
23084,50,3839,5026;9931,0,0,0,0,2,2
23085,50,3841,1878;9934,0,0,0,0,2,2
23086,50,3844,9943,0,0,0,0,1,1
23087,50,3847,7578,0,0,0,0,1,1
23088,50,3849,9956,0,0,0,0,1,1
23089,50,3853,9964,0,0,0,0,1,1
23090,50,3861,8834;9988,0,0,0,0,2,2
23091,50,3863,9992,0,0,0,0,1,1
23092,50,3864,6561;10390;15193,0,0,1,2,0,3
23093,50,3865,10002,0,0,0,0,1,1
23094,50,3869,2017,0,0,0,0,1,1
23095,50,3870,434,0,0,0,0,1,1
23096,50,3871,6059,0,0,0,0,1,1
23097,50,3872,4306,0,0,0,0,1,1
23098,50,3878,2133,0,0,0,0,1,1
23099,50,3884,1783,0,0,0,0,1,1
23100,50,3888,2126;4971,0,0,0,0,2,2
23101,50,3889,2130,0,0,0,0,1,1
23102,50,3892,1924;2443,0,0,0,0,2,2
23103,50,3895,672;5600;11583,0,0,0,1,2,3
23104,50,3900,1736,0,0,0,0,1,1
23105,50,3902,2716;9127,0,0,0,0,2,2
23106,50,3907,4000;7516,0,0,0,0,2,2
23107,50,3910,4243,0,0,0,0,1,1
23108,50,3912,22,0,0,0,0,1,1
23109,50,3915,7517,0,0,0,0,1,1
23110,50,3918,5235;5972;10535,0,0,0,1,2,3
23111,50,3922,9925,0,0,0,0,1,1
23112,50,3923,6778,0,0,0,0,1,1
23113,50,3925,1922;5769,0,0,0,0,2,2
23114,50,3928,5771;6143,0,0,0,0,2,2
23115,50,3929,6147,0,0,0,0,1,1
23116,50,3930,3750;6306,0,0,0,0,2,2
23117,50,3932,9303,0,0,0,0,1,1
23118,50,3935,9154,0,0,0,0,1,1
23119,50,3937,7904,0,0,0,0,1,1
23120,50,3938,6703,0,0,0,0,1,1
23121,50,3943,6985;8378;11393,0,0,0,1,2,3
23122,50,3947,5801;8851,0,0,0,0,2,2
23123,50,3953,7529;9328,0,0,0,0,2,2
23124,50,3954,9347,0,0,0,0,1,1
23125,50,3958,5653,0,0,0,0,1,1
23126,50,3960,1065;3338,365,0,0,0,2,2
23127,50,3963,534,365,0,0,0,1,1
23128,50,3968,787;12313,365,0,0,1,1,2
23129,50,3970,1014;8026,365,0,0,0,2,2
23130,50,3971,1054;8368,365,0,0,0,2,2
23131,50,3973,1346,365,0,0,0,1,1
23132,50,3976,738;4524,365,0,0,0,2,2
23133,50,3978,2219,365,0,0,0,1,1
23134,50,3979,1699;7926,365,0,0,0,2,2
23135,50,3980,1317;1745,365,0,0,0,2,2
23136,50,3982,4927;9021,365,0,0,0,2,2
23137,50,3986,224;2407,365,0,0,0,2,2
23138,50,3987,2451;9480,365,0,0,0,2,2
23139,50,3990,2612,365,0,0,0,1,1
23140,50,3991,1023,365,0,0,0,1,1
23141,50,3994,3586;4917,365,0,0,0,2,2
23142,50,4002,1318;3468,365,0,0,0,2,2
23143,50,4005,2141;5085,365,0,0,0,2,2
23144,50,4008,5132;9871,365,0,0,0,2,2
23145,50,4009,8455,365,0,0,0,1,1
23146,50,4014,5691;9642,365,0,0,0,2,2
23147,50,4015,5757,365,0,0,0,1,1
23148,50,4017,9716,365,0,0,0,1,1
23149,50,4020,6281;7836,365,0,0,0,2,2
23150,50,4023,1899,365,0,0,0,1,1
23151,50,4027,299;5671,365,0,0,0,2,2
23152,50,4029,2070;6863,365,0,0,0,2,2
23153,50,4031,4554;7058,365,0,0,0,2,2
23154,50,4032,40;7071,365,0,0,0,2,2
23155,50,4033,1681,365,0,0,0,1,1
23156,50,4039,9939,365,0,0,0,1,1
23157,50,4040,2930;8249,365,0,0,0,2,2
23158,50,4041,6769;7871,365,0,0,0,2,2
23159,50,4042,5370,365,0,0,0,1,1
23160,50,4044,8304;8860,365,0,0,0,2,2
23161,50,4054,1556,365,0,0,0,1,1
23162,50,4056,9538,365,0,0,0,1,1
23163,50,4060,2606;6330;11495;12466,365,0,0,2,2,4
23164,50,4061,178;9790,365,0,0,0,2,2
23165,50,4062,590;9825,365,0,0,0,2,2
23166,50,4063,1634;7849,365,0,0,0,2,2
23167,50,4065,9948,365,0,0,0,1,1
23168,50,4067,45,730,0,0,0,1,1
23169,50,4072,302;5123,730,0,0,0,2,2
23170,50,4074,2525,730,0,0,0,1,1
23171,50,4076,5525,730,0,0,0,1,1
23172,50,4077,578;705,730,0,0,0,2,2
23173,50,4078,792;7539,730,0,0,0,2,2
23174,50,4082,8946,730,0,0,0,1,1
23175,50,4084,4197,730,0,0,0,1,1
23176,50,4085,1246;9449,730,0,0,0,2,2
23177,50,4089,1728,730,0,0,0,1,1
23178,50,4095,8801;9996,730,0,0,0,2,2
23179,50,4099,5877,730,0,0,0,1,1
23180,50,4102,9500,730,0,0,0,1,1
23181,50,4104,1209;2879,730,0,0,0,2,2
23182,50,4105,3143,730,0,0,0,1,1
23183,50,4108,593,730,0,0,0,1,1
23184,50,4109,4399,730,0,0,0,1,1
23185,50,4110,78;6164,730,0,0,0,2,2
23186,50,4116,3868,730,0,0,0,1,1
23187,50,4117,3878,730,0,0,0,1,1
23188,50,4121,4384;5605,730,0,0,0,2,2
23189,50,4124,5546;10826,730,0,0,1,1,2
23190,50,4128,8925,730,0,0,0,1,1
23191,50,4129,4485,730,0,0,0,1,1
23192,50,4133,4648,730,0,0,0,1,1
23193,50,4138,5305,730,0,0,0,1,1
23194,50,4143,8434,730,0,0,0,1,1
23195,50,4145,5640,730,0,0,0,1,1
23196,50,4149,9428,730,0,0,0,1,1
23197,50,4150,7236,730,0,0,0,1,1
23198,50,4153,3700;7077,730,0,0,0,2,2
23199,50,4154,3069;6454,730,0,0,0,2,2
23200,50,4155,1741;7353,730,0,0,0,2,2
23201,50,4156,2576;3291,730,0,0,0,2,2
23202,50,4158,4381;12112,730,0,0,1,1,2
23203,50,4160,329;7367,730,0,0,0,2,2
23204,50,4162,5571,730,0,0,0,1,1
23205,50,4163,35;7857,730,0,0,0,2,2
23206,50,4166,6452,730,0,0,0,1,1
23207,50,4168,4600;8252,730,0,0,0,2,2
23208,50,4169,8374,730,0,0,0,1,1
23209,50,4173,5451;8595,730,0,0,0,2,2
23210,50,4181,1920,730,0,0,0,1,1
23211,50,4186,5918,730,0,0,0,1,1
23212,50,4188,5212;9944,730,0,0,0,2,2
23213,50,4189,7425,1095,0,0,0,1,1
23214,50,4190,12;6735,1095,0,0,0,2,2
23215,50,4195,296;6278,1095,0,0,0,2,2
23216,50,4197,9145,1095,0,0,0,1,1
23217,50,4198,8992,1095,0,0,0,1,1
23218,50,4200,517;1250,1095,0,0,0,2,2
23219,50,4204,5699;8276,1095,0,0,0,2,2
23220,50,4205,7567;8744;12054,1095,0,0,1,2,3
23221,50,4207,1099;4046,1095,0,0,0,2,2
23222,50,4208,1514,1095,0,0,0,1,1
23223,50,4209,4207,1095,0,0,0,1,1
23224,50,4215,1980;6447,1095,0,0,0,2,2
23225,50,4219,1009,1095,0,0,0,1,1
23226,50,4220,4500,1095,0,0,0,1,1
23227,50,4222,844,1095,0,0,0,1,1
23228,50,4223,2417;2655,1095,0,0,0,2,2
23229,50,4228,3165;4045,1095,0,0,0,2,2
23230,50,4230,3377;10373,1095,0,0,1,1,2
23231,50,4233,1207;3540,1095,0,0,0,2,2
23232,50,4234,8771,1095,0,0,0,1,1
23233,50,4236,4559;6458,1095,0,0,0,2,2
23234,50,4240,7569;11680,1095,0,0,1,1,2
23235,50,4242,2059,1095,0,0,0,1,1
23236,50,4243,1116;4274,1095,0,0,0,2,2
23237,50,4244,4336,1095,0,0,0,1,1
23238,50,4248,4528;4874,1095,0,0,0,2,2
23239,50,4250,4626,1095,0,0,0,1,1
23240,50,4251,6396,1095,0,0,0,1,1
23241,50,4253,2995;4898,1095,0,0,1,1,2
23242,50,4254,3062;4954,1095,0,0,0,2,2
23243,50,4255,5420,1095,0,0,0,1,1
23244,50,4257,467;5017;10556,1095,0,0,1,2,3
23245,50,4263,2179;12600,1095,0,0,1,1,2
23246,50,4266,4510;5573,1095,0,0,1,1,2
23247,50,4268,3812;9390,1095,0,0,0,2,2
23248,50,4276,3038;6588,1095,0,0,0,2,2
23249,50,4283,1071;7318,1095,0,0,0,2,2
23250,50,4288,2281,1095,0,0,0,1,1
23251,50,4289,11984;12134;15956,1095,1,0,2,0,3
23252,50,4290,6390,1095,0,0,0,1,1
23253,50,4292,1235;7882,1095,0,0,0,2,2
23254,50,4296,4209;8277,1095,0,0,0,2,2
23255,50,4297,8284,1095,0,0,0,1,1
23256,50,4298,6246,1095,0,0,0,1,1
23257,50,4301,8596,1095,0,0,0,1,1
23258,50,4303,1372;4505,1095,0,0,0,2,2
23259,50,4304,951;12232,1095,0,0,1,1,2
23260,50,4305,36;8859,1095,0,0,1,1,2
23261,50,4306,8902,1095,0,0,0,1,1
23262,50,4307,3583,1095,0,0,0,1,1
23263,50,4309,9830,1095,0,0,0,1,1
23264,50,4312,9600,1095,0,0,0,1,1
23265,50,4315,9777,1095,0,0,0,1,1
23266,50,4317,6595;9882,1095,0,0,1,1,2
23267,50,4318,7601,1095,0,0,0,1,1
23268,50,4319,4605;9910,1095,0,0,0,2,2
23269,50,4321,158;8211,1460,0,0,0,2,2
23270,50,4322,7497,1460,0,0,0,1,1
23271,50,4324,336;9831,1460,0,0,0,2,2
23272,50,4328,1925;12619,1460,0,0,1,1,2
23273,50,4336,1055;1212,1460,0,0,0,2,2
23274,50,4337,5871;8306,1460,0,0,0,2,2
23275,50,4339,1251;7466,1460,0,0,0,2,2
23276,50,4342,3895,1460,0,0,0,1,1
23277,50,4344,1603;4770,1460,0,0,1,1,2
23278,50,4345,1732,1460,0,0,0,1,1
23279,50,4348,2723,1460,0,0,0,1,1
23280,50,4352,2355,1460,0,0,0,1,1
23281,50,4353,2380,1460,0,0,0,1,1
23282,50,4354,929;2766;13578,1460,0,0,2,1,3
23283,50,4362,8315,1460,0,0,0,1,1
23284,50,4364,3432;11012,1460,0,0,1,1,2
23285,50,4365,3639,1460,0,0,0,1,1
23286,50,4366,3548;5906,1460,0,0,0,2,2
23287,50,4369,3944,1460,0,0,0,1,1
23288,50,4371,7;9645;12209,1460,0,0,1,2,3
23289,50,4379,4827,1460,0,0,0,1,1
23290,50,4381,2030,1460,0,0,0,1,1
23291,50,4385,4030;7019,1460,0,0,0,2,2
23292,50,4386,643;7925,1460,0,0,0,2,2
23293,50,4389,5542;5562,1460,0,0,0,2,2
23294,50,4390,5695,1460,0,0,0,1,1
23295,50,4391,5811;9257,1460,0,0,0,2,2
23296,50,4392,6038;6516,1460,0,0,0,2,2
23297,50,4394,864;8985,1460,0,0,1,1,2
23298,50,4395,2765;6308,1460,0,0,1,1,2
23299,50,4397,6334,1460,0,0,0,1,1
23300,50,4399,6406;8168,1460,0,0,0,2,2
23301,50,4401,6493;12587,1460,0,0,1,1,2
23302,50,4404,4942,1460,0,0,0,1,1
23303,50,4406,6854;9196,1460,0,0,0,2,2
23304,50,4409,7852,1460,0,0,0,1,1
23305,50,4410,4916,1460,0,0,0,1,1
23306,50,4411,4318;7066,1460,0,0,0,2,2
23307,50,4412,1740,1460,0,0,0,1,1
23308,50,4413,6710,1460,0,0,0,1,1
23309,50,4414,9495,1460,0,0,0,1,1
23310,50,4415,1376;8123;12564,1460,0,0,2,1,3
23311,50,4419,2628;7534,1460,0,0,0,2,2
23312,50,4420,360;7603,1460,0,0,0,2,2
23313,50,4421,1548;4949,1460,0,0,1,1,2
23314,50,4422,3922;6191,1460,0,0,1,1,2
23315,50,4423,4170;7692,1460,0,0,0,2,2
23316,50,4426,7838;8120,1460,0,0,0,2,2
23317,50,4427,2750;5248,1460,0,0,1,1,2
23318,50,4429,1383;8401,1460,0,0,0,2,2
23319,50,4432,979,1460,0,0,0,1,1
23320,50,4433,8399,1460,0,0,0,1,1
23321,50,4436,583;8830,1460,0,0,0,2,2
23322,50,4437,8843,1460,0,0,0,1,1
23323,50,4438,5982;8904,1460,0,0,0,2,2
23324,50,4440,9159;9243,1460,0,0,0,2,2
23325,50,4441,5261,1460,0,0,0,1,1
23326,50,4447,679;870,1460,0,0,2,0,2
23327,50,4448,9401;9963,1460,0,0,0,2,2
23328,50,4449,183;9947,1825,0,0,0,2,2
23329,50,4450,271;6489,1825,0,0,0,2,2
23330,50,4451,511;8332,1825,0,0,1,1,2
23331,50,4453,752;3493;11335,1825,0,0,1,2,3
23332,50,4454,1006;3563,1825,0,0,0,2,2
23333,50,4455,355,1825,0,0,0,1,1
23334,50,4457,6920;9078,1825,0,0,0,2,2
23335,50,4458,1169;8331,1825,0,0,1,1,2
23336,50,4459,356;4398,1825,0,0,1,1,2
23337,50,4460,1546,1825,0,0,0,1,1
23338,50,4461,1769,1825,0,0,0,1,1
23339,50,4462,1836;4116,1825,0,0,0,2,2
23340,50,4464,1988,1825,0,0,0,1,1
23341,50,4471,2864;3674,1825,0,0,0,2,2
23342,50,4472,3004;4015;12381,1825,0,0,1,2,3
23343,50,4474,1263;6285;12647,1825,0,0,3,0,3
23344,50,4482,4178,1825,0,0,0,1,1
23345,50,4483,1936;6197,1825,0,0,0,2,2
23346,50,4487,4506;6064,1825,0,0,0,2,2
23347,50,4489,8087,1825,0,0,0,1,1
23348,50,4491,2687,1825,0,0,0,1,1
23349,50,4493,4939,1825,0,0,0,1,1
23350,50,4494,3259;5419,1825,0,0,0,2,2
23351,50,4500,3695;5617,1825,0,0,0,2,2
23352,50,4502,5715;7801,1825,0,0,0,2,2
23353,50,4503,8560;8741,1825,0,0,2,0,2
23354,50,4504,5774;9357,1825,0,0,0,2,2
23355,50,4507,5949;9015,1825,0,0,1,1,2
23356,50,4508,6001,1825,0,0,0,1,1
23357,50,4510,6211,1825,0,0,0,1,1
23358,50,4515,6239;11733,1825,0,0,1,1,2
23359,50,4519,1332,1825,0,0,0,1,1
23360,50,4520,7235;9930;11194,1825,0,0,1,2,3
23361,50,4523,6354;7508;13527;13833,1825,0,1,2,1,4
23362,50,4525,7683;11605,1825,0,0,1,1,2
23363,50,4526,6689,1825,0,0,0,1,1
23364,50,4527,1122,1825,0,0,0,1,1
23365,50,4528,7989,1825,0,0,0,1,1
23366,50,4536,11715;12081;12138;12555;16167,1825,1,0,4,0,5
23367,50,4537,8543,1825,0,0,0,1,1
23368,50,4538,3397;8617,1825,0,0,0,2,2
23369,50,4539,1216;8680,1825,0,0,0,2,2
23370,50,4541,3539;6953,1825,0,0,0,2,2
23371,50,4542,10;8092,1825,0,0,0,2,2
23372,50,4544,3672,1825,0,0,1,0,1
23373,50,4546,9187,1825,0,0,0,1,1
23374,50,4548,3865;5613,1825,0,0,0,2,2
23375,50,4554,6453;8466,1825,0,0,2,0,2
23376,50,4555,9329,1825,0,0,0,1,1
23377,50,4557,2980;5159,2190,0,0,1,1,2
23378,50,4558,2741,2190,0,0,0,1,1
23379,50,4560,3449;3518,2190,0,0,1,1,2
23380,50,4562,7300;7404,2190,0,0,1,1,2
23381,50,4564,773;1814,2190,0,0,0,2,2
23382,50,4567,1151;6719,2190,0,0,1,1,2
23383,50,4569,561;7068,2190,0,0,1,1,2
23384,50,4570,1873,2190,0,0,0,1,1
23385,50,4572,1962;5554,2190,0,0,0,2,2
23386,50,4573,3758,2190,0,0,1,0,1
23387,50,4576,603;3012,2190,0,0,1,1,2
23388,50,4577,642,2190,0,0,1,0,1
23389,50,4579,2742;5939;12611,2190,0,0,1,2,3
23390,50,4581,2949;3960,2190,0,0,0,2,2
23391,50,4582,2971;4061,2190,0,0,0,2,2
23392,50,4583,10001,2190,0,0,0,1,1
23393,50,4586,3174;3931,2190,0,0,0,2,2
23394,50,4587,8456,2190,0,0,0,1,1
23395,50,4589,3167,2190,0,0,0,1,1
23396,50,4592,3740;6788,2190,0,0,0,2,2
23397,50,4594,3066,2190,0,0,0,1,1
23398,50,4595,2998,2190,0,0,0,1,1
23399,50,4596,3962;9721,2190,0,0,0,2,2
23400,50,4602,8806,2190,0,0,1,0,1
23401,50,4603,5616;9221,2190,0,0,0,2,2
23402,50,4604,3621;7704,2190,0,0,1,1,2
23403,50,4605,64;4486,2190,0,0,1,1,2
23404,50,4606,4511;8561,2190,0,0,2,0,2
23405,50,4607,1032;4527,2190,0,0,1,1,2
23406,50,4609,3402;4735,2190,0,0,0,2,2
23407,50,4610,3869;4888,2190,0,0,1,1,2
23408,50,4618,903;6544,2190,0,0,0,2,2
23409,50,4620,1238;5849;12681,2190,0,0,1,2,3
23410,50,4622,5905,2190,0,0,1,0,1
23411,50,4623,5799;6074,2190,0,0,0,2,2
23412,50,4624,1074;6170,2190,0,0,0,2,2
23413,50,4625,6311,2190,0,0,0,1,1
23414,50,4626,1165,2190,0,0,0,1,1
23415,50,4628,9909,2190,0,0,0,1,1
23416,50,4629,2178;6968,2190,0,0,0,2,2
23417,50,4635,3193;7238;10944,2190,0,0,2,1,3
23418,50,4638,7844;11748,2190,0,0,1,1,2
23419,50,4641,3813,2190,0,0,0,1,1
23420,50,4642,15,2190,0,0,0,1,1
23421,50,4644,4553;6139;12456;13572,2190,0,0,3,1,4
23422,50,4646,2010;8470,2190,0,0,1,1,2
23423,50,4647,7180,2190,0,0,0,1,1
23424,50,4648,8604;9232,2190,0,0,0,2,2
23425,50,4650,8707,2190,0,0,0,1,1
23426,50,4652,3708;8797,2190,0,0,0,2,2
23427,50,4655,8083,2190,0,0,0,1,1
23428,50,4658,2559;9424,2190,0,0,1,1,2
23429,50,4659,9510,2190,0,0,0,1,1
23430,50,4660,3160,2190,0,0,0,1,1
23431,50,4662,9727,2190,0,0,0,1,1
23432,50,4663,513;9817;11647,2190,0,0,1,2,3
23433,50,4664,8230;9202,2190,0,0,0,2,2
23434,50,4666,179;3387,2555,0,0,0,2,2
23435,50,4668,1584,2555,0,0,1,0,1
23436,50,4669,1386;6111,2555,0,0,2,0,2
23437,50,4671,6070;7488,2555,0,0,2,0,2
23438,50,4673,9165,2555,0,0,0,1,1
23439,50,4677,1824,2555,0,0,1,0,1
23440,50,4680,4965,2555,0,0,0,1,1
23441,50,4683,2345,2555,0,0,0,1,1
23442,50,4686,5025;7222,2555,0,0,2,0,2
23443,50,4689,2901;8853,2555,0,0,1,1,2
23444,50,4694,3407;8977,2555,0,0,1,1,2
23445,50,4700,3847,2555,0,0,0,1,1
23446,50,4701,932;11175,2555,0,0,2,0,2
23447,50,4702,4035;9189,2555,0,0,2,0,2
23448,50,4703,110;7808,2555,0,0,1,1,2
23449,50,4705,4111;8070,2555,0,0,0,2,2
23450,50,4707,4149;4628,2555,0,0,2,0,2
23451,50,4708,3362;4694,2555,0,0,0,2,2
23452,50,4709,5328;8674,2555,0,0,2,0,2
23453,50,4713,4891,2555,0,0,0,1,1
23454,50,4719,5133;7928;11861,2555,0,0,1,2,3
23455,50,4721,5289,2555,0,0,0,1,1
23456,50,4722,5319,2555,0,0,0,1,1
23457,50,4725,5547,2555,0,0,0,1,1
23458,50,4729,5870;8396;13193,2555,0,0,3,0,3
23459,50,4730,2787,2555,0,0,1,0,1
23460,50,4731,9138,2555,0,0,0,1,1
23461,50,4733,5134;6184,2555,0,0,1,1,2
23462,50,4734,9799,2555,0,0,1,0,1
23463,50,4735,6313;8589,2555,0,0,1,1,2
23464,50,4736,6318;9951,2555,0,0,0,2,2
23465,50,4740,6973;9406,2555,0,0,1,1,2
23466,50,4741,4051;6999,2555,0,0,0,2,2
23467,50,4742,958;2891,2555,0,0,2,0,2
23468,50,4745,404;8822,2555,0,0,1,1,2
23469,50,4746,7574,2555,0,0,0,1,1
23470,50,4747,7151;7276;13224,2555,0,0,3,0,3
23471,50,4749,490;7776,2555,0,0,2,0,2
23472,50,4750,2418;7867,2555,0,0,2,0,2
23473,50,4751,8388,2555,0,0,1,0,1
23474,50,4753,2232;8642;14033,2555,0,1,1,1,3
23475,50,4756,7461;8144,2555,0,0,1,1,2
23476,50,4757,6464;8268,2555,0,0,1,1,2
23477,50,4759,3022;9995,2555,0,0,0,2,2
23478,50,4760,2058;8376,2555,0,0,2,0,2
23479,50,4763,8712,2555,0,0,0,1,1
23480,50,4765,4073,2555,0,0,0,1,1
23481,50,4767,8893,2555,0,0,1,0,1
23482,50,4769,6526;8966,2555,0,0,1,1,2
23483,50,4770,9246;9392,2555,0,0,2,0,2
23484,50,4773,2580;4543,2555,0,0,2,0,2
23485,50,4774,6006;8781,2555,0,0,0,2,2
23486,50,4775,9687,2555,0,0,1,0,1
23487,50,4776,9762,2555,0,0,0,1,1
23488,50,4777,8675;9837,2555,0,0,0,2,2
23489,50,4779,54;4449;12215,2920,0,0,1,2,3
23490,50,4781,147;4668,2920,0,0,0,2,2
23491,50,4785,475;2092,2920,0,0,1,1,2
23492,50,4786,537;5063,2920,0,0,2,0,2
23493,50,4787,5429,2920,0,0,0,1,1
23494,50,4793,11555;11735;12083;14953;14970;15587;15978,2920,2,2,3,0,7
23495,50,4794,2656;9045;12661,2920,0,0,3,0,3
23496,50,4801,1882,2920,0,0,0,1,1
23497,50,4803,1935,2920,0,0,1,0,1
23498,50,4804,2091;8628,2920,0,0,0,2,2
23499,50,4805,2500;3215,2920,0,0,2,0,2
23500,50,4807,1217;7525;11580,2920,0,0,3,0,3
23501,50,4808,3977;7553,2920,0,0,2,0,2
23502,50,4809,4953;8177,2920,0,0,2,0,2
23503,50,4811,1010;1575,2920,0,0,1,1,2
23504,50,4816,2798;3116,2920,0,0,1,1,2
23505,50,4817,3173;6554;12168;13314,2920,0,0,4,0,4
23506,50,4818,1784,2920,0,0,0,1,1
23507,50,4819,3277;3860;13261,2920,0,0,1,2,3
23508,50,4820,2033;4950,2920,0,0,1,1,2
23509,50,4821,7874;8740,2920,0,0,0,2,2
23510,50,4823,3523;6918;12172,2920,0,0,3,0,3
23511,50,4827,9603,2920,0,0,0,1,1
23512,50,4832,4102;8169,2920,0,0,0,2,2
23513,50,4834,4280,2920,0,0,0,1,1
23514,50,4835,5737;11905,2920,0,0,1,1,2
23515,50,4836,4509;9739,2920,0,0,2,0,2
23516,50,4837,6420;8375,2920,0,0,1,1,2
23517,50,4838,9208,2920,0,0,0,1,1
23518,50,4839,3675;6971,2920,0,0,0,2,2
23519,50,4843,7732;8629,2920,0,0,2,0,2
23520,50,4844,5073,2920,0,0,0,1,1
23521,50,4845,1652;5181;11501,2920,0,0,3,0,3
23522,50,4847,4009;5286,2920,0,0,0,2,2
23523,50,4849,5366;7185,2920,0,0,1,1,2
23524,50,4850,1788;12173,2920,0,0,1,1,2
23525,50,4851,5443,2920,0,0,0,1,1
23526,50,4852,8050,2920,0,0,0,1,1
23527,50,4856,6194,2920,0,0,0,1,1
23528,50,4858,863;6405,2920,0,0,1,1,2
23529,50,4859,6434;7690,2920,0,0,0,2,2
23530,50,4861,3749;9417;12923,2920,0,0,3,0,3
23531,50,4862,6696;9352,2920,0,0,0,2,2
23532,50,4864,6751;7503,2920,0,0,2,0,2
23533,50,4866,1974,2920,0,0,0,1,1
23534,50,4868,3531;7403,2920,0,0,0,2,2
23535,50,4871,1157;1328;12856,2920,0,0,3,0,3
23536,50,4872,5679;7733,2920,0,0,0,2,2
23537,50,4875,1486;7992,2920,0,0,1,1,2
23538,50,4876,6827,2920,0,0,0,1,1
23539,50,4877,6774;8317,2920,0,0,0,2,2
23540,50,4879,3633;3709,2920,0,0,0,2,2
23541,50,4881,974;8344,2920,0,0,0,2,2
23542,50,4882,4924;5810;13125,2920,0,0,2,1,3
23543,50,4883,6995;8502;11178,2920,0,0,2,1,3
23544,50,4885,2800,2920,0,0,0,1,1
23545,50,4886,4022;8568,2920,0,0,0,2,2
23546,50,4887,5278;8573,2920,0,0,2,0,2
23547,50,4888,8283;8584,2920,0,0,2,0,2
23548,50,4889,5606;8623,2920,0,0,1,1,2
23549,50,4893,8643;8823,2920,0,0,2,0,2
23550,50,4894,9378,2920,0,0,0,1,1
23551,50,4895,6845;9068;13352,2920,0,0,2,1,3
23552,50,4901,3716;8122,2920,0,0,1,1,2
23553,50,4902,1640;6158,2920,0,0,1,1,2
23554,50,4903,4348,2920,0,0,0,1,1
23555,50,4906,5024;12903,2920,0,0,2,0,2
23556,50,4907,8270,2920,0,0,1,0,1
23557,50,4909,3092,2920,0,0,0,1,1
23558,50,4911,153;4308;11056;12523,3285,0,0,4,0,4
23559,50,4912,959;3315,3285,0,0,1,1,2
23560,50,4913,4499;9684,3285,0,0,0,2,2
23561,50,4914,4586;6981,3285,0,0,2,0,2
23562,50,4918,349;3748,3285,0,0,2,0,2
23563,50,4921,75;159,3285,0,0,2,0,2
23564,50,4923,630;1344;12798,3285,0,0,3,0,3
23565,50,4927,536;853,3285,0,0,0,2,2
23566,50,4930,6743;9041;12941,3285,0,0,3,0,3
23567,50,4931,1153,3285,0,0,0,1,1
23568,50,4933,293;4548,3285,0,0,0,2,2
23569,50,4935,8688;9588,3285,0,0,2,0,2
23570,50,4937,1561;6028,3285,0,0,0,2,2
23571,50,4938,2433;3802;11998,3285,0,0,3,0,3
23572,50,4940,4043;7744,3285,0,0,1,1,2
23573,50,4941,2843,3285,0,0,0,1,1
23574,50,4945,2189,3285,0,0,1,0,1
23575,50,4947,2462;3469;12262,3285,0,0,1,2,3
23576,50,4950,2670;11857,3285,0,0,1,1,2
23577,50,4951,3850,3285,0,0,0,1,1
23578,50,4952,5099,3285,0,0,0,1,1
23579,50,4956,3560;8099,3285,0,0,1,1,2
23580,50,4958,9819,3285,0,0,1,0,1
23581,50,4963,3976,3285,0,0,0,1,1
23582,50,4965,4961,3285,0,0,0,1,1
23583,50,4967,4259;7330,3285,0,0,0,2,2
23584,50,4969,4637;7679,3285,0,0,1,1,2
23585,50,4972,4165;5044;12123;13188,3285,0,0,3,1,4
23586,50,4974,2014;12770,3285,0,0,2,0,2
23587,50,4978,5780,3285,0,0,0,1,1
23588,50,4981,74;7275,3285,0,0,2,0,2
23589,50,4983,2289,3285,0,0,0,1,1
23590,50,4987,5692;6188;13024,3285,0,0,3,0,3
23591,50,4989,4854;9188,3285,0,0,1,1,2
23592,50,4992,6503;8527;12106,3285,0,0,2,1,3
23593,50,4993,6586,3285,0,0,0,1,1
23594,50,4996,8836,3285,0,0,0,1,1
23595,50,4998,5160;7078,3285,0,0,1,1,2
23596,50,5000,240;1692,3285,0,0,2,0,2
23597,50,5002,3117;7332,3285,0,0,2,0,2
23598,50,5003,2594;7343;12679,3285,0,0,1,2,3
23599,50,5004,1572;7357,3285,0,0,2,0,2
23600,50,5005,8229,3285,0,0,0,1,1
23601,50,5006,6701,3285,0,0,0,1,1
23602,50,5007,4873;7872,3285,0,0,0,2,2
23603,50,5010,8759;9665;13074;13368,3285,0,0,4,0,4
23604,50,5011,1609;6494;13151,3285,0,0,3,0,3
23605,50,5015,8318;8814,3285,0,0,0,2,2
23606,50,5016,6736;8815,3285,0,0,1,1,2
23607,50,5017,4737;7966,3285,0,0,0,2,2
23608,50,5018,3833;6948,3285,0,0,0,2,2
23609,50,5019,2681;9008,3285,0,0,2,0,2
23610,50,5020,8899;9114,3285,0,0,1,1,2
23611,50,5022,5031;9596,3285,0,0,2,0,2
23612,50,5023,4034;8592,3285,0,0,2,0,2
23613,50,5025,7627,3285,0,0,0,1,1
23614,50,5029,616;3132;12389,3285,0,0,2,1,3
23615,50,5030,1693,3650,0,0,0,1,1
23616,50,5031,146,3650,0,0,0,1,1
23617,50,5033,1252;4400,3650,0,0,0,2,2
23618,50,5034,216;801,3650,0,0,2,0,2
23619,50,5038,116;891,3650,0,0,0,2,2
23620,50,5039,1061,3650,0,0,0,1,1
23621,50,5040,1288;8020;13503,3650,0,0,3,0,3
23622,50,5042,1407,3650,0,0,0,1,1
23623,50,5043,5216,3650,0,0,0,1,1
23624,50,5044,1654;6604,3650,0,0,2,0,2
23625,50,5046,3202,3650,0,0,1,0,1
23626,50,5050,2117;3103;11627,3650,0,0,1,2,3
23627,50,5051,2145,3650,0,0,0,1,1
23628,50,5053,8624,3650,0,0,1,0,1
23629,50,5054,1599;9423,3650,0,0,2,0,2
23630,50,5055,1236;2168;12796;13508,3650,0,0,4,0,4
23631,50,5056,810;9336,3650,0,0,2,0,2
23632,50,5058,9848,3650,0,0,0,1,1
23633,50,5060,2390;2851,3650,0,0,0,2,2
23634,50,5062,3395;12832,3650,0,0,1,1,2
23635,50,5064,2887;5008,3650,0,0,0,2,2
23636,50,5065,1147;3437;13608;13690,3650,0,0,4,0,4
23637,50,5068,3704;12291,3650,0,0,2,0,2
23638,50,5069,1321;8807,3650,0,0,1,1,2
23639,50,5070,584;7203,3650,0,0,1,1,2
23640,50,5074,2053;6012,3650,0,0,0,2,2
23641,50,5075,4129;6108,3650,0,0,0,2,2
23642,50,5078,3380;5394;12574;12799,3650,0,0,4,0,4
23643,50,5079,4595;7739,3650,0,0,2,0,2
23644,50,5081,4771;8497,3650,0,0,2,0,2
23645,50,5084,9226,3650,0,0,1,0,1
23646,50,5088,5318;6688;14042,3650,0,1,2,0,3
23647,50,5089,4252;6792;12702;12904,3650,0,0,4,0,4
23648,50,5091,503;7969;12982,3650,0,0,3,0,3
23649,50,5092,80;5619,3650,0,0,0,2,2
23650,50,5093,6949;9484;12677,3650,0,0,1,2,3
23651,50,5094,4368;5353,3650,0,0,2,0,2
23652,50,5097,5863,3650,0,0,0,1,1
23653,50,5100,933;3125,3650,0,0,1,1,2
23654,50,5101,8407;8785;12823,3650,0,0,3,0,3
23655,50,5102,6215,3650,0,0,0,1,1
23656,50,5103,1714;4693;12290,3650,0,0,3,0,3
23657,50,5108,4655;9768;11578,3650,0,0,3,0,3
23658,50,5109,2881;12072,3650,0,0,2,0,2
23659,50,5110,6238;7520;13271;13478,3650,0,0,4,0,4
23660,50,5112,6629,3650,0,0,1,0,1
23661,50,5115,9166,3650,0,0,0,1,1
23662,50,5116,4680;4979,3650,0,0,1,1,2
23663,50,5117,2180;7294,3650,0,0,0,2,2
23664,50,5118,7306;12335,3650,0,0,2,0,2
23665,50,5119,890;4799,3650,0,0,1,1,2
23666,50,5120,7398;9118,3650,0,0,2,0,2
23667,50,5121,3678;7460,3650,0,0,2,0,2
23668,50,5122,5532,3650,0,0,0,1,1
23669,50,5123,2795;7746,3650,0,0,0,2,2
23670,50,5124,2544;8133;12486,3650,0,0,2,1,3
23671,50,5127,8072;9577,3650,0,0,0,2,2
23672,50,5128,2215;8538;12505;12769,3650,0,0,3,1,4
23673,50,5130,8572;11859,3650,0,0,2,0,2
23674,50,5133,8857,3650,0,0,0,1,1
23675,50,5134,1100;8858,3650,0,0,1,1,2
23676,50,5135,721;4514;12908,3650,0,0,3,0,3
23677,50,5136,4141,3650,0,0,0,1,1
23678,50,5138,5969;9798;13441,3650,0,0,3,0,3
23679,50,5140,4053;5441;12057,3650,0,0,1,2,3
23680,50,5142,3219;4723,3650,0,0,2,0,2
23681,50,5143,8934,3650,0,0,0,1,1
23682,50,5144,8340;9429,3650,0,0,0,2,2
23683,50,5146,3612;5709;13007,3650,0,0,2,1,3
23684,50,5150,4859;7073;12457;12835;13221,3650,0,0,5,0,5
23685,50,5151,43,4015,0,0,0,1,1
23686,50,5152,107;5458,4015,0,0,1,1,2
23687,50,5153,112;7143,4015,0,0,1,1,2
23688,50,5154,188;2456,4015,0,0,0,2,2
23689,50,5155,217;771;12102;13069,4015,0,0,4,0,4
23690,50,5158,4810;5749;12222,4015,0,0,1,2,3
23691,50,5162,2499,4015,0,0,0,1,1
23692,50,5167,945;7495,4015,0,0,0,2,2
23693,50,5168,1016,4015,0,0,0,1,1
23694,50,5169,1086,4015,0,0,0,1,1
23695,50,5170,1096;7826,4015,0,0,2,0,2
23696,50,5176,2359;2648,4015,0,0,0,2,2
23697,50,5177,2372;5302;12810,4015,0,0,3,0,3
23698,50,5179,4275,4015,0,0,0,1,1
23699,50,5182,6517,4015,0,0,0,1,1
23700,50,5183,1648;3208;12373,4015,0,0,1,2,3
23701,50,5184,3309;8039;13139,4015,0,0,3,0,3
23702,50,5185,1304;3363;11885,4015,0,0,3,0,3
23703,50,5188,3595,4015,0,0,1,0,1
23704,50,5189,3685;4887,4015,0,0,0,2,2
23705,50,5190,3726;7998,4015,0,0,0,2,2
23706,50,5191,2421,4015,0,0,0,1,1
23707,50,5192,3741;5043,4015,0,0,2,0,2
23708,50,5193,3873;9033;11789,4015,0,0,3,0,3
23709,50,5195,4267;4713,4015,0,0,1,1,2
23710,50,5198,6327,4015,0,0,0,1,1
23711,50,5200,4613,4015,0,0,0,1,1
23712,50,5202,1505;8780,4015,0,0,1,1,2
23713,50,5203,977,4015,0,0,0,1,1
23714,50,5205,760;3934,4015,0,0,0,2,2
23715,50,5207,1536;6339,4015,0,0,0,2,2
23716,50,5208,5290,4015,0,0,0,1,1
23717,50,5210,3417;3696,4015,0,0,2,0,2
23718,50,5211,9298,4015,0,0,0,1,1
23719,50,5212,5588,4015,0,0,0,1,1
23720,50,5214,5764;6638,4015,0,0,0,2,2
23721,50,5215,3738;4654;11982,4015,0,0,3,0,3
23722,50,5218,5378;9874,4015,0,0,0,2,2
23723,50,5219,5981;6112,4015,0,0,2,0,2
23724,50,5221,2481;6284,4015,0,0,1,1,2
23725,50,5222,6319;7138,4015,0,0,0,2,2
23726,50,5224,1471;6404,4015,0,0,2,0,2
23727,50,5226,4755;6531;11904,4015,0,0,3,0,3
23728,50,5228,8365;13098,4015,0,0,2,0,2
23729,50,5229,4699;7150;12391;13072,4015,0,0,4,0,4
23730,50,5230,1163,4015,0,0,1,0,1
23731,50,5231,6480;6555;12273;12552;13226,4015,0,0,5,0,5
23732,50,5233,1774;2356;12320,4015,0,0,3,0,3
23733,50,5235,6728;7050;12868,4015,0,0,1,2,3
23734,50,5237,2654;12518,4015,0,0,2,0,2
23735,50,5238,765;7127;13370,4015,0,0,3,0,3
23736,50,5240,7521;8616,4015,0,0,1,1,2
23737,50,5244,5442;7777,4015,0,0,2,0,2
23738,50,5247,9776;9926,4015,0,0,1,1,2
23739,50,5250,2815;8149,4015,0,0,2,0,2
23740,50,5252,8248,4015,0,0,0,1,1
23741,50,5253,3386,4015,0,0,0,1,1
23742,50,5255,3475;7621;11754;13147;13384;13464,4015,0,0,6,0,6
23743,50,5260,1766;8932;12508,4015,0,0,3,0,3
23744,50,5261,6603;8986;12287,4015,0,0,3,0,3
23745,50,5263,1649,4015,0,0,1,0,1
23746,50,5264,639;9069,4015,0,0,2,0,2
23747,50,5266,2475;6353,4015,0,0,2,0,2
23748,50,5267,2008;6970;12722,4015,0,0,3,0,3
23749,50,5272,2493;8650;12900,4015,0,0,3,0,3
23750,50,5277,674;4963;12268;13258;13958,4380,0,1,4,0,5
23751,50,5283,3530;9940;12343,4380,0,0,3,0,3
23752,50,5284,79;1477,4380,0,0,2,0,2
23753,50,5286,1787;3930,4380,0,0,2,0,2
23754,50,5289,4307;8931,4380,0,0,1,1,2
23755,50,5296,3394;6797,4380,0,0,0,2,2
23756,50,5298,3520;13082,4380,0,0,2,0,2
23757,50,5301,1933;8539;13564,4380,0,0,3,0,3
23758,50,5302,7705,4380,0,0,0,1,1
23759,50,5303,1399;3994,4380,0,0,0,2,2
23760,50,5305,4021;7176,4380,0,0,2,0,2
23761,50,5306,3691;8442,4380,0,0,2,0,2
23762,50,5307,4271;7939;12339;13190,4380,0,0,4,0,4
23763,50,5308,2694;9227,4380,0,0,2,0,2
23764,50,5314,4726,4380,0,0,0,1,1
23765,50,5315,4899;4931,4380,0,0,0,2,2
23766,50,5317,7921,4380,0,0,0,1,1
23767,50,5319,3730;7212,4380,0,0,2,0,2
23768,50,5320,5615;11723;13132,4380,0,0,3,0,3
23769,50,5323,892;7072,4380,0,0,0,2,2
23770,50,5324,3045;7729,4380,0,0,2,0,2
23771,50,5325,6694;9621,4380,0,0,0,2,2
23772,50,5326,714;6857;12483,4380,0,0,3,0,3
23773,50,5328,2816,4380,0,0,1,0,1
23774,50,5331,7604;7698,4380,0,0,1,1,2
23775,50,5336,5968;9007,4380,0,0,2,0,2
23776,50,5337,9369;9501,4380,0,0,0,2,2
23777,50,5341,3207;8519,4380,0,0,2,0,2
23778,50,5344,944;7323,4380,0,0,2,0,2
23779,50,5345,479;8808,4380,0,0,2,0,2
23780,50,5346,8845,4380,0,0,1,0,1
23781,50,5349,6881,4380,0,0,0,1,1
23782,50,5351,5396;7499;12251,4380,0,0,3,0,3
23783,50,5353,9605,4380,0,0,0,1,1
23784,50,5355,2620;9666;11582,4380,0,0,3,0,3
23785,50,5356,5936;9694;12877,4380,0,0,3,0,3
23786,50,5357,7948,4380,0,0,0,1,1
23787,50,5358,9862,4380,0,0,0,1,1
23788,50,5360,38;7419,4745,0,0,0,2,2
23789,50,5365,3753;8912;13103,4745,0,0,3,0,3
23790,50,5368,838;12880,4745,0,0,2,0,2
23791,50,5370,2085;7158,4745,0,0,2,0,2
23792,50,5371,3011,4745,0,0,0,1,1
23793,50,5372,6652,4745,0,0,0,1,1
23794,50,5373,1301;6407,4745,0,0,0,2,2
23795,50,5375,1500;2395;12911,4745,0,0,3,0,3
23796,50,5377,1537;1726,4745,0,0,2,0,2
23797,50,5378,831,4745,0,0,0,1,1
23798,50,5379,2239;8520;12844,4745,0,0,3,0,3
23799,50,5380,3574,4745,0,0,1,0,1
23800,50,5383,4576;12284;12878,4745,0,0,3,0,3
23801,50,5384,182;2581;12346;13380,4745,0,0,4,0,4
23802,50,5385,9009;9692,4745,0,0,0,2,2
23803,50,5388,8291;9389;12145;12917,4745,0,0,4,0,4
23804,50,5390,3164;5741,4745,0,0,0,2,2
23805,50,5391,2294,4745,0,0,0,1,1
23806,50,5392,1522;14252,4745,0,1,1,0,2
23807,50,5394,2031;8649;12573,4745,0,0,3,0,3
23808,50,5395,1451,4745,0,0,1,0,1
23809,50,5396,3615;9680;12425,4745,0,0,3,0,3
23810,50,5398,7695,4745,0,0,0,1,1
23811,50,5399,2789;8273;14334,4745,0,1,2,0,3
23812,50,5402,3524,4745,0,0,0,1,1
23813,50,5403,4756;7889,4745,0,0,0,2,2
23814,50,5404,2834;4908,4745,0,0,1,1,2
23815,50,5405,617;2788,4745,0,0,0,2,2
23816,50,5407,5105;7554,4745,0,0,2,0,2
23817,50,5409,3161;5489,4745,0,0,0,2,2
23818,50,5411,3337;3356;12530;12817,4745,0,0,4,0,4
23819,50,5412,2669;12953;13941,4745,0,1,2,0,3
23820,50,5415,5779;11543,4745,0,0,2,0,2
23821,50,5416,5789;5964,4745,0,0,2,0,2
23822,50,5418,3429;6110,4745,0,0,0,2,2
23823,50,5419,5202;6117,4745,0,0,2,0,2
23824,50,5421,1441,4745,0,0,0,1,1
23825,50,5424,6950;9764,4745,0,0,2,0,2
23826,50,5427,6904,4745,0,0,1,0,1
23827,50,5428,8590,4745,0,0,0,1,1
23828,50,5429,5409;7012,4745,0,0,0,2,2
23829,50,5431,1141;1966;12922;13325;13414,4745,0,0,5,0,5
23830,50,5432,3003;5792;12351;12913;13122,4745,0,0,5,0,5
23831,50,5434,7994;9245;12869;13217;13921,4745,0,1,4,0,5
23832,50,5435,3078;8037,4745,0,0,2,0,2
23833,50,5436,2776,4745,0,0,0,1,1
23834,50,5438,1698;8638,4745,0,0,2,0,2
23835,50,5440,6530;8796;13233,4745,0,0,1,2,3
23836,50,5441,2799;8798;12366,4745,0,0,2,1,3
23837,50,5442,3713;5735;13227,4745,0,0,3,0,3
23838,50,5445,9419;9608;13439,4745,0,0,3,0,3
23839,50,5446,4689;9783,4745,0,0,2,0,2
23840,50,5447,658,4745,0,0,0,1,1
23841,50,5451,6820,5110,0,0,1,0,1
23842,50,5453,6363;8494;12777,5110,0,0,3,0,3
23843,50,5454,444;9339;11786,5110,0,0,3,0,3
23844,50,5458,7431,5110,0,0,0,1,1
23845,50,5459,920;8894;12593;13351,5110,0,0,4,0,4
23846,50,5461,8827;9215;13100,5110,0,0,3,0,3
23847,50,5462,1161;2364,5110,0,0,2,0,2
23848,50,5465,1104;1364;12588,5110,0,0,3,0,3
23849,50,5466,3312,5110,0,0,0,1,1
23850,50,5467,1427;6707,5110,0,0,2,0,2
23851,50,5468,1450;2959,5110,0,0,2,0,2
23852,50,5469,4268;8336,5110,0,0,2,0,2
23853,50,5472,1771;5072,5110,0,0,2,0,2
23854,50,5474,3419;8167,5110,0,0,1,1,2
23855,50,5476,6567;9485;12582,5110,0,0,3,0,3
23856,50,5478,5201,5110,0,0,0,1,1
23857,50,5481,6885;7211;12599,5110,0,0,2,1,3
23858,50,5483,3951;4062,5110,0,0,0,2,2
23859,50,5484,5490,5110,0,0,0,1,1
23860,50,5485,8711;12513,5110,0,0,1,1,2
23861,50,5486,4374,5110,0,0,0,1,1
23862,50,5487,4435,5110,0,0,1,0,1
23863,50,5488,4333,5110,0,0,0,1,1
23864,50,5489,3923,5110,0,0,0,1,1
23865,50,5490,4581;11601,5110,0,0,2,0,2
23866,50,5491,6252,5110,0,0,1,0,1
23867,50,5492,3376;5196,5110,0,0,2,0,2
23868,50,5496,1706;9651,5110,0,0,1,1,2
23869,50,5498,953;5630;13113,5110,0,0,3,0,3
23870,50,5499,5100;5662;13027,5110,0,0,3,0,3
23871,50,5501,5809;6605;12987,5110,0,0,3,0,3
23872,50,5502,3471;6240,5110,0,0,0,2,2
23873,50,5506,4070;8779,5110,0,0,1,1,2
23874,50,5507,5659;9827;12299,5110,0,0,3,0,3
23875,50,5508,4379;9040,5110,0,0,0,2,2
23876,50,5509,6959;9558,5110,0,0,0,2,2
23877,50,5510,7027,5110,0,0,0,1,1
23878,50,5511,4594;7043,5110,0,0,0,2,2
23879,50,5513,1339;7672,5110,0,0,1,1,2
23880,50,5516,8746;9561;13473,5110,0,0,3,0,3
23881,50,5522,7681,5110,0,0,1,0,1
23882,50,5523,2165,5110,0,0,0,1,1
23883,50,5528,1045;5459;12890,5110,0,0,3,0,3
23884,50,5529,4479,5110,0,0,0,1,1
23885,50,5533,3573;9649;13498,5110,0,0,2,1,3
23886,50,5534,431;9693;13870,5110,0,1,2,0,3
23887,50,5536,113;13460,5475,0,0,2,0,2
23888,50,5537,1064;3477;12375,5475,0,0,2,1,3
23889,50,5540,327;445,5475,0,0,0,2,2
23890,50,5542,798,5475,0,0,0,1,1
23891,50,5546,967,5475,0,0,0,1,1
23892,50,5549,1343;8406;12824,5475,0,0,2,1,3
23893,50,5550,37;2394,5475,0,0,1,1,2
23894,50,5552,5234,5475,0,0,0,1,1
23895,50,5553,1544;3945,5475,0,0,2,0,2
23896,50,5555,1670;6127;13448;13566;14650,5475,0,1,4,0,5
23897,50,5558,5021;5114,5475,0,0,0,2,2
23898,50,5560,574;7481;12544,5475,0,0,3,0,3
23899,50,5561,1930;3367;14179,5475,0,1,2,0,3
23900,50,5564,2175;12477,5475,0,0,2,0,2
23901,50,5565,393;2321,5475,0,0,1,1,2
23902,50,5566,4057;5367;12939,5475,0,0,3,0,3
23903,50,5567,2498;7993,5475,0,0,2,0,2
23904,50,5569,8086,5475,0,0,0,1,1
23905,50,5570,3458;13068,5475,0,0,2,0,2
23906,50,5572,2996;12200,5475,0,0,2,0,2
23907,50,5573,212;3120,5475,0,0,2,0,2
23908,50,5574,3121;7509,5475,0,0,1,1,2
23909,50,5575,5869;9637;13000,5475,0,0,3,0,3
23910,50,5576,470;1608,5475,0,0,2,0,2
23911,50,5578,3359;13545;14189,5475,0,1,2,0,3
23912,50,5579,3503;6809;12898;13267;13502,5475,0,0,5,0,5
23913,50,5580,2976;3578,5475,0,0,2,0,2
23914,50,5581,3710;6791,5475,0,0,2,0,2
23915,50,5582,3885,5475,0,0,0,1,1
23916,50,5584,7964;9677;12409,5475,0,0,1,2,3
23917,50,5585,5047;7785;12986,5475,0,0,3,0,3
23918,50,5586,4085;9285,5475,0,0,0,2,2
23919,50,5588,1751;9230;12620,5475,0,0,3,0,3
23920,50,5592,4587;9722,5475,0,0,2,0,2
23921,50,5594,4601;8135,5475,0,0,1,1,2
23922,50,5595,4700;11570;13683,5475,0,0,3,0,3
23923,50,5596,4832;7016,5475,0,0,2,0,2
23924,50,5597,4850;7818,5475,0,0,0,2,2
23925,50,5599,3136;5156,5475,0,0,2,0,2
23926,50,5602,1428;2876;12843;14072,5475,0,1,3,0,4
23927,50,5605,4955;5892;13337,5475,0,0,3,0,3
23928,50,5607,4401,5475,0,0,0,1,1
23929,50,5608,49;6133;12993,5475,0,0,1,2,3
23930,50,5610,4656;6839;13454;14126,5475,0,1,3,0,4
23931,50,5611,2123;7555;13105;13739,5475,0,0,4,0,4
23932,50,5614,2434;6624;12345;12560,5475,0,0,4,0,4
23933,50,5615,1499;7340,5475,0,0,0,2,2
23934,50,5618,6295;7024,5475,0,0,1,1,2
23935,50,5619,3046;7383;12820,5475,0,0,3,0,3
23936,50,5620,3156;7697;13909,5475,0,1,2,0,3
23937,50,5623,4153;7638,5475,0,0,0,2,2
23938,50,5624,1387;3308,5475,0,0,1,1,2
23939,50,5625,7794;13819,5475,0,1,1,0,2
23940,50,5628,793;8010;12108,5475,0,0,3,0,3
23941,50,5629,2783;2839;12659,5475,0,0,3,0,3
23942,50,5630,169;8302;13886,5475,0,1,2,0,3
23943,50,5632,6847;8483,5475,0,0,0,2,2
23944,50,5633,6292,5475,0,0,0,1,1
23945,50,5634,8641,5475,0,0,1,0,1
23946,50,5635,5241;6088,5475,0,0,2,0,2
23947,50,5636,6229,5475,0,0,0,1,1
23948,50,5637,4544;5991,5475,0,0,2,0,2
23949,50,5639,1485;9400;12557;13049;13462;13901,5475,0,1,5,0,6
23950,50,5641,1060,5475,0,0,0,1,1
23951,50,5642,440;9664;13030,5475,0,0,2,1,3
23952,50,5643,5553;9689,5475,0,0,2,0,2
23953,50,5644,4075;8556;13403;14154,5475,0,1,3,0,4
23954,50,5645,3428;4285;12899,5475,0,0,3,0,3
23955,50,5647,631;9853;13305;13628,5475,0,0,4,0,4
23956,50,5648,9976,5475,0,0,1,0,1
23957,50,5649,612,5840,0,0,1,0,1
23958,50,5652,120;1929;12893;13440,5840,0,0,4,0,4
23959,50,5655,840,5840,0,0,0,1,1
23960,50,5656,378;1847,5840,0,0,2,0,2
23961,50,5660,6750,5840,0,0,0,1,1
23962,50,5661,461;10030,5840,0,0,2,0,2
23963,50,5663,2234;4617;13275;13511;13760,5840,0,0,5,0,5
23964,50,5664,6183;6331,5840,0,0,2,0,2
23965,50,5665,1267;4845;11749;12079,5840,0,0,4,0,4
23966,50,5667,1746;6465;13346,5840,0,0,3,0,3
23967,50,5668,3400;8110;12354,5840,0,0,3,0,3
23968,50,5669,7709;13727;14454,5840,0,1,2,0,3
23969,50,5670,163;12082;13398;13480,5840,0,0,4,0,4
23970,50,5677,3233;7500;12084;12379;13907,5840,0,1,4,0,5
23971,50,5678,2365;10105,5840,0,0,2,0,2
23972,50,5681,3029;7634;13463,5840,0,0,3,0,3
23973,50,5683,3209;10012;12444;13601;14513,5840,0,1,4,0,5
23974,50,5685,2271;12492;13551,5840,0,0,3,0,3
23975,50,5686,9056;10040;13078,5840,0,0,3,0,3
23976,50,5687,3071;6309,5840,0,0,2,0,2
23977,50,5689,1667;3146;15598,5840,1,0,2,0,3
23978,50,5690,2404;3968,5840,0,0,2,0,2
23979,50,5691,4020,5840,0,0,0,1,1
23980,50,5692,9726,5840,0,0,0,1,1
23981,50,5694,8489,5840,0,0,0,1,1
23982,50,5697,3840;4752;13633,5840,0,0,3,0,3
23983,50,5698,4101;9589;12553,5840,0,0,3,0,3
23984,50,5699,4846;13945;14057,5840,0,2,1,0,3
23985,50,5701,5064;14297,5840,0,1,1,0,2
23986,50,5703,651;5227,5840,0,0,0,2,2
23987,50,5704,5228;12511,5840,0,0,2,0,2
23988,50,5705,10045;13881,5840,0,1,1,0,2
23989,50,5706,5311;8409,5840,0,0,2,0,2
23990,50,5707,5382;6905;12186;13194,5840,0,0,4,0,4
23991,50,5708,4074;5425,5840,0,0,2,0,2
23992,50,5709,5436,5840,0,0,1,0,1
23993,50,5710,81;7193,5840,0,0,2,0,2
23994,50,5711,7766;10113;12644,5840,0,0,3,0,3
23995,50,5712,250;12077;13111,5840,0,0,3,0,3
23996,50,5714,5985;9454;12033,5840,0,0,3,0,3
23997,50,5716,6911;10027;14395,5840,0,1,2,0,3
23998,50,5720,986;6582;13108,5840,0,0,1,2,3
23999,50,5722,6699;8220;13109,5840,0,0,3,0,3
24000,50,5723,1987;8922;12064,5840,0,0,2,1,3
24001,50,5726,119;7197,5840,0,0,2,0,2
24002,50,5727,6222;7372,5840,0,0,0,2,2
24003,50,5728,6071;8338;13512;13540,5840,0,0,4,0,4
24004,50,5732,786;8047;12472;12874;13180;14635,5840,0,1,5,0,6
24005,50,5737,8288,5840,0,0,1,0,1
24006,50,5738,5988;11972,5840,0,0,2,0,2
24007,50,5739,6571;8421;13840,5840,0,1,2,0,3
24008,50,5740,7156;9220;12410,5840,0,0,3,0,3
24009,50,5741,3083,5840,0,0,0,1,1
24010,50,5742,480;2880;13182;13664,5840,0,0,4,0,4
24011,50,5744,1415;2245,5840,0,0,0,2,2
24012,50,5746,4945;9150;12842,5840,0,0,3,0,3
24013,50,5747,8967,5840,0,0,1,0,1
24014,50,5748,7316;9037,5840,0,0,2,0,2
24015,50,5750,9211;12512;13312;13611,5840,0,0,4,0,4
24016,50,5754,2210;3725,5840,0,0,0,2,2
24017,50,5761,242,6205,0,0,0,1,1
24018,50,5763,319;7765;12245,6205,0,0,3,0,3
24019,50,5764,386;10063;13214,6205,0,0,3,0,3
24020,50,5765,477;2370;12432;13287,6205,0,0,4,0,4
24021,50,5766,4385;9514;12006,6205,0,0,3,0,3
24022,50,5767,803;13705,6205,0,0,2,0,2
24023,50,5770,982;12058,6205,0,0,2,0,2
24024,50,5772,4147;9606,6205,0,0,2,0,2
24025,50,5773,10049;10166,6205,0,0,2,0,2
24026,50,5774,3201;12448;13240,6205,0,0,3,0,3
24027,50,5776,44;10061;13444;13685,6205,0,0,4,0,4
24028,50,5779,5002;7341,6205,0,0,2,0,2
24029,50,5782,7168,6205,0,0,0,1,1
24030,50,5783,2316;3883,6205,0,0,0,2,2
24031,50,5784,7914;13239,6205,0,0,2,0,2
24032,50,5785,2689;2738;13415,6205,0,0,3,0,3
24033,50,5786,2690,6205,0,0,0,1,1
24034,50,5787,632;9709,6205,0,0,2,0,2
24035,50,5788,6135,6205,0,0,0,1,1
24036,50,5789,3231;8493,6205,0,0,0,2,2
24037,50,5793,3375;4856,6205,0,0,2,0,2
24038,50,5794,3420;12762;13620,6205,0,0,3,0,3
24039,50,5795,3591;10076,6205,0,0,2,0,2
24040,50,5796,3841;10112;13141;13288,6205,0,0,4,0,4
24041,50,5798,3995;6773,6205,0,0,2,0,2
24042,50,5800,4218,6205,0,0,0,1,1
24043,50,5802,4516;13285,6205,0,0,2,0,2
24044,50,5803,2842;9197;13269,6205,0,0,3,0,3
24045,50,5805,6166;8498;12169,6205,0,0,3,0,3
24046,50,5806,4757;12653,6205,0,0,2,0,2
24047,50,5808,4867;9667;12481;13647,6205,0,0,4,0,4
24048,50,5810,4952,6205,0,0,0,1,1
24049,50,5813,5184,6205,0,0,0,1,1
24050,50,5814,5297;7995,6205,0,0,2,0,2
24051,50,5816,5480;13859,6205,0,1,1,0,2
24052,50,5818,5642;12591,6205,0,0,2,0,2
24053,50,5819,3185;9765;12437;13127,6205,0,0,4,0,4
24054,50,5820,5899,6205,0,0,0,1,1
24055,50,5821,3601;12556,6205,0,0,2,0,2
24056,50,5822,3366;5929,6205,0,0,2,0,2
24057,50,5824,3961,6205,0,0,0,1,1
24058,50,5825,2729;6262;13282;13488,6205,0,0,4,0,4
24059,50,5829,2146;6632;13434,6205,0,0,3,0,3
24060,50,5830,6369;13404,6205,0,0,2,0,2
24061,50,5831,6375,6205,0,0,0,1,1
24062,50,5832,6461;14188,6205,0,1,1,0,2
24063,50,5833,1026;8146;13001,6205,0,0,3,0,3
24064,50,5834,4714;9681,6205,0,0,2,0,2
24065,50,5837,6838,6205,0,0,1,0,1
24066,50,5839,5260;10053;13064;13347,6205,0,0,4,0,4
24067,50,5840,2760;7040;11950;12782;13746,6205,0,0,5,0,5
24068,50,5842,1623;7097;13055,6205,0,0,3,0,3
24069,50,5843,1313;7110;13702,6205,0,0,3,0,3
24070,50,5844,7174,6205,0,0,0,1,1
24071,50,5847,2062;7402;13744,6205,0,0,3,0,3
24072,50,5848,1478;7747;12363,6205,0,0,3,0,3
24073,50,5849,1467;7793;12756;13219;13435,6205,0,0,5,0,5
24074,50,5850,3575;7927,6205,0,0,0,2,2
24075,50,5853,5674;9003,6205,0,0,2,0,2
24076,50,5854,8511,6205,0,0,0,1,1
24077,50,5858,9266;12327,6205,0,0,2,0,2
24078,50,5859,7802;9210,6205,0,0,2,0,2
24079,50,5860,9425,6205,0,0,1,0,1
24080,50,5861,5963;9756,6205,0,0,1,1,2
24081,50,5864,11;5860;12649,6205,0,0,3,0,3
24082,50,5867,93;10246;12177;14005;14539,6570,0,2,3,0,5
24083,50,5869,562;10232,6570,0,0,2,0,2
24084,50,5870,294;652;13187,6570,0,0,3,0,3
24085,50,5871,361;9686,6570,0,0,0,2,2
24086,50,5873,7762;9736;13431;13599;13878;14287,6570,0,2,4,0,6
24087,50,5874,1092;13117,6570,0,0,2,0,2
24088,50,5876,1231;13555;13970,6570,0,1,2,0,3
24089,50,5878,1545;10122;12250,6570,0,0,3,0,3
24090,50,5879,1564;2250,6570,0,0,2,0,2
24091,50,5885,10187;10349;12875;13997,6570,0,1,3,0,4
24092,50,5886,921;7728,6570,0,0,2,0,2
24093,50,5888,10142;13784;13991,6570,0,1,2,0,3
24094,50,5890,2919;9139;13544,6570,0,0,3,0,3
24095,50,5891,2963;6991,6570,0,0,2,0,2
24096,50,5892,2964,6570,0,0,1,0,1
24097,50,5893,960;1191;13374,6570,0,0,3,0,3
24098,50,5894,1027;3058;12211;12732,6570,0,0,4,0,4
24099,50,5895,3118;8862;13736,6570,0,0,3,0,3
24100,50,5897,2950;3145,6570,0,0,2,0,2
24101,50,5898,3255;7025,6570,0,0,0,2,2
24102,50,5899,3266;8698,6570,0,0,2,0,2
24103,50,5900,2322;12503,6570,0,0,2,0,2
24104,50,5901,6091,6570,0,0,0,1,1
24105,50,5902,3472;13917,6570,0,1,1,0,2
24106,50,5905,1833,6570,0,0,0,1,1
24107,50,5910,6933,6570,0,0,0,1,1
24108,50,5912,604;4960;13519;13678,6570,0,0,4,0,4
24109,50,5919,4219;9688,6570,0,0,2,0,2
24110,50,5923,5040;10089;11865;12852,6570,0,0,4,0,4
24111,50,5924,5711,6570,0,0,0,1,1
24112,50,5925,277;5723;13965,6570,0,1,2,0,3
24113,50,5931,1694;7780;13447,6570,0,0,3,0,3
24114,50,5932,5195;6914,6570,0,0,0,2,2
24115,50,5933,6233;12065,6570,0,0,2,0,2
24116,50,5934,2159;8703,6570,0,0,2,0,2
24117,50,5935,6393;10214,6570,0,0,2,0,2
24118,50,5937,6520,6570,0,0,0,1,1
24119,50,5941,2295;7030,6570,0,0,0,2,2
24120,50,5943,1458;4678,6570,0,0,0,2,2
24121,50,5945,5726;8297,6570,0,0,2,0,2
24122,50,5946,7510;13459,6570,0,0,2,0,2
24123,50,5947,10283;10319;12179;13838,6570,0,1,3,0,4
24124,50,5948,4677;5329;12292;12454;12657;13786,6570,0,0,6,0,6
24125,50,5949,1136;7029;13021,6570,0,0,3,0,3
24126,50,5951,8266,6570,0,0,0,1,1
24127,50,5953,4476;7781;13548;13770,6570,0,0,4,0,4
24128,50,5954,2409,6570,0,0,0,1,1
24129,50,5956,334;8886;13479;13697,6570,0,0,4,0,4
24130,50,5959,3418;7394,6570,0,0,1,1,2
24131,50,5960,3055;8840;13248;13406,6570,0,0,4,0,4
24132,50,5962,3478;9099;13506,6570,0,0,3,0,3
24133,50,5963,9151;10158;13013;14588,6570,0,1,3,0,4
24134,50,5964,2256;2870,6570,0,0,2,0,2
24135,50,5965,9162;13196,6570,0,0,2,0,2
24136,50,5966,3794;5084;12651;13674,6570,0,0,4,0,4
24137,50,5968,6616;6693;13445,6570,0,0,3,0,3
24138,50,5970,268;665;13079,6570,0,0,3,0,3
24139,50,5971,9563;10299;12153;13301;13731,6570,0,0,5,0,5
24140,50,5973,2893;9626;12921;13728,6570,0,0,4,0,4
24141,50,5974,9682,6570,0,0,0,1,1
24142,50,5975,2264;9696,6570,0,0,0,2,2
24143,50,5976,2539;9710;13334;13948,6570,0,1,3,0,4
24144,50,5977,6056;9720;12794,6570,0,0,3,0,3
24145,50,5979,9793,6570,0,0,0,1,1
24146,50,5982,6986,6935,0,0,0,1,1
24147,50,5983,96;5379,6935,0,0,0,2,2
24148,50,5985,316;4630;13096,6935,0,0,3,0,3
24149,50,5988,1826,6935,0,0,0,1,1
24150,50,5993,9507,6935,0,0,0,1,1
24151,50,5994,7163,6935,0,0,1,0,1
24152,50,5995,10155;13236;13635;13903,6935,0,1,3,0,4
24153,50,5997,1904;6325,6935,0,0,0,2,2
24154,50,5998,5798,6935,0,0,1,0,1
24155,50,5999,1940;2069,6935,0,0,2,0,2
24156,50,6001,4704;6990;13143;13541;14313,6935,0,1,4,0,5
24157,50,6003,2242,6935,0,0,0,1,1
24158,50,6004,2410,6935,0,0,0,1,1
24159,50,6005,2494;5016,6935,0,0,2,0,2
24160,50,6010,2354;3776;12933,6935,0,0,3,0,3
24161,50,6011,3820;5937;13251;14292,6935,0,1,3,0,4
24162,50,6017,4833;8701,6935,0,0,2,0,2
24163,50,6020,5032;10081,6935,0,0,2,0,2
24164,50,6021,320;7177;13167,6935,0,0,3,0,3
24165,50,6022,1305;3341;13328,6935,0,0,3,0,3
24166,50,6023,5643;8998,6935,0,0,2,0,2
24167,50,6028,6155;7444;14143,6935,0,1,2,0,3
24168,50,6030,3679;6208;12765,6935,0,0,3,0,3
24169,50,6034,8176,6935,0,0,0,1,1
24170,50,6035,2972;4257;13018,6935,0,0,3,0,3
24171,50,6037,1565;10031;14360,6935,0,1,2,0,3
24172,50,6038,2032;7054,6935,0,0,2,0,2
24173,50,6043,10367;10526,6935,0,0,2,0,2
24174,50,6048,7183;8358,6935,0,0,0,2,2
24175,50,6049,8553;10034;12965,6935,0,0,3,0,3
24176,50,6051,895;8996,6935,0,0,0,2,2
24177,50,6052,3517;9046;13199,6935,0,0,3,0,3
24178,50,6054,1775;9256,6935,0,0,0,2,2
24179,50,6056,10308;12484;13466;13771,6935,0,0,4,0,4
24180,50,6061,9984,6935,0,0,0,1,1
24181,50,6062,2896;10003;13954;14259,6935,0,2,2,0,4
24182,50,6063,10082;10383,6935,0,0,2,0,2
24183,50,6064,10044;10328;12795;14129;15028,6935,0,2,3,0,5
24184,50,6065,10086;10491;13785;14168,6935,0,1,3,0,4
24185,50,6066,10093;10184,6935,0,0,2,0,2
24186,50,6067,10036;10098;12959,6935,0,0,3,0,3
24187,50,6068,1747;10115;12241,6935,0,0,3,0,3
24188,50,6069,10018;13723,7300,0,0,2,0,2
24189,50,6070,4808,7300,0,0,0,1,1
24190,50,6071,493;6389;13437,7300,0,0,3,0,3
24191,50,6072,1727;3246;14255,7300,0,1,2,0,3
24192,50,6073,545;10484;14831,7300,0,1,2,0,3
24193,50,6074,546;10407,7300,0,0,2,0,2
24194,50,6075,7311;12736;12839;13615,7300,0,0,4,0,4
24195,50,6076,1334;7712;13423,7300,0,0,3,0,3
24196,50,6077,1461;10201,7300,0,0,2,0,2
24197,50,6078,1472;10287,7300,0,0,2,0,2
24198,50,6079,1797;10218;12831;13247;13486;14956,7300,0,1,5,0,6
24199,50,6082,1093;2442;13499;13708,7300,0,0,4,0,4
24200,50,6085,10078;10084,7300,0,0,2,0,2
24201,50,6086,87;7310;12393;12630;13458,7300,0,0,5,0,5
24202,50,6089,3408,7300,0,0,0,1,1
24203,50,6090,3424;5917;13116,7300,0,0,3,0,3
24204,50,6091,3476;6967,7300,0,0,2,0,2
24205,50,6092,3492,7300,0,0,1,0,1
24206,50,6093,3600;10069;13089;13329,7300,0,0,4,0,4
24207,50,6097,8163,7300,0,0,0,1,1
24208,50,6099,3807,7300,0,0,0,1,1
24209,50,6100,10065;12528;14170;14387,7300,0,2,2,0,4
24210,50,6101,4023;9923;13067;13338;13616,7300,0,0,5,0,5
24211,50,6102,4106;10371;12808;13104,7300,0,0,4,0,4
24212,50,6103,7624,7300,0,0,0,1,1
24213,50,6105,3141,7300,0,0,1,0,1
24214,50,6107,10347;10480;13526;15252,7300,0,1,3,0,4
24215,50,6109,1056;4959;13274,7300,0,0,3,0,3
24216,50,6111,5097;13822,7300,0,1,1,0,2
24217,50,6113,2948;5161;13494;13680;14346,7300,0,1,4,0,5
24218,50,6114,5170;8892;13081,7300,0,0,3,0,3
24219,50,6115,3388;5402;12548,7300,0,0,3,0,3
24220,50,6120,6628;8198;13042;13908,7300,0,1,3,0,4
24221,50,6121,5850;9654;12304;13344,7300,0,0,4,0,4
24222,50,6122,5930;13130;13286,7300,0,0,3,0,3
24223,50,6123,8723,7300,0,0,0,1,1
24224,50,6126,10322;10345;13929;14633,7300,0,2,2,0,4
24225,50,6127,6849;7098,7300,0,0,2,0,2
24226,50,6129,5175;10188;13276,7300,0,0,3,0,3
24227,50,6131,4016;7570,7300,0,0,0,2,2
24228,50,6132,7606,7300,0,0,0,1,1
24229,50,6133,4571;7622;13560;14379,7300,0,1,3,0,4
24230,50,6134,7809,7300,0,0,0,1,1
24231,50,6137,8121,7300,0,0,0,1,1
24232,50,6141,3946,7300,0,0,0,1,1
24233,50,6148,6754;9028,7300,0,0,0,2,2
24234,50,6149,2438;3673,7300,0,0,0,2,2
24235,50,6151,249,7300,0,0,0,1,1
24236,50,6154,2543;9879;13016,7300,0,0,3,0,3
24237,50,6155,9887;10386;13140;14023;14416;15356,7300,0,3,3,0,6
24238,50,6157,10019;10257;12163;13536,7300,0,0,4,0,4
24239,50,6159,10043;10475;12394;14117;15185,7300,0,2,3,0,5
24240,50,6161,9042;10055,7300,0,0,2,0,2
24241,50,6163,10064;10083,7300,0,0,2,0,2
24242,50,6164,10439;13461;14564;15341,7300,0,2,2,0,4
24243,50,6165,10121;10295;13595;13773;14495,7300,0,1,4,0,5
24244,50,6166,10132;10136;14160,7300,0,1,2,0,3
24245,50,6167,10384;12569,7300,0,0,2,0,2
24246,50,6168,10329;10448;13173,7300,0,0,3,0,3
24247,50,6169,10203;10275;13883;14707,7300,0,2,2,0,4
24248,50,6170,228;10205;13405;13992,7300,0,1,3,0,4
24249,50,6171,10213;10224;12610;14392,7300,0,1,3,0,4
24250,50,6172,10197;10400;13362;13662,7300,0,0,4,0,4
24251,50,6173,10124;10219;12727,7300,0,0,3,0,3
24252,50,6174,405;10075;13033,7665,0,0,3,0,3
24253,50,6175,5460;10094;13411;13799,7665,0,1,3,0,4
24254,50,6177,653;2108,7665,0,0,2,0,2
24255,50,6182,6744;10111;14087;14884,7665,0,2,2,0,4
24256,50,6185,2268;10033;14236,7665,0,1,2,0,3
24257,50,6188,6560;13531;13839,7665,0,1,2,0,3
24258,50,6189,2015;9518;13593;13985,7665,0,1,3,0,4
24259,50,6193,2960;5137;12500,7665,0,0,3,0,3
24260,50,6197,3126;6015;13225,7665,0,0,3,0,3
24261,50,6198,3240;3978,7665,0,0,0,2,2
24262,50,6199,3318;3874;12805;14248,7665,0,1,3,0,4
24263,50,6201,4056;5258,7665,0,0,2,0,2
24264,50,6203,4221;10060;13451,7665,0,0,3,0,3
24265,50,6209,5245;8271,7665,0,0,0,2,2
24266,50,6210,5277;9371,7665,0,0,0,2,2
24267,50,6212,1142,7665,0,0,0,1,1
24268,50,6213,6159;8278;13153;13450;13981;14272,7665,0,2,4,0,6
24269,50,6214,6261;9888,7665,0,0,2,0,2
24270,50,6216,896;13046,7665,0,0,2,0,2
24271,50,6220,6542;7179,7665,0,0,0,2,2
24272,50,6222,262;7255,7665,0,0,0,2,2
24273,50,6223,9580;12708;13562,7665,0,0,3,0,3
24274,50,6224,4169;7671,7665,0,0,0,2,2
24275,50,6225,1013,7665,0,0,0,1,1
24276,50,6226,7724;10395;13753;14030,7665,0,1,3,0,4
24277,50,6229,613;8145;13418;13711,7665,0,0,4,0,4
24278,50,6230,8272,7665,0,0,1,0,1
24279,50,6237,5760,7665,0,0,0,1,1
24280,50,6239,3629,7665,0,0,0,1,1
24281,50,6242,4824,7665,0,0,0,1,1
24282,50,6243,10024;10306;12949;13157,7665,0,0,4,0,4
24283,50,6244,8877;10354;12957;13407;13734,7665,0,0,5,0,5
24284,50,6245,10119;13106;13885,7665,0,1,2,0,3
24285,50,6246,4868;10163;12793;13788;14071;15260,7665,0,2,4,0,6
24286,50,6247,1468;10164;12361;13709;14028,7665,0,1,4,0,5
24287,50,6248,1284;10168;14623;14972,7665,0,2,2,0,4
24288,50,6249,10511;10621;12535;14012,7665,0,1,3,0,4
24289,50,6250,10227;10432;12322;12995;13928,7665,0,1,4,0,5
24290,50,6251,10217;10377;13206;13333;13871,7665,0,1,4,0,5
24291,50,6252,10248;10291;12865;13661,7665,0,0,4,0,4
24292,50,6253,10255;10296;12656;13115,7665,0,0,4,0,4
24293,50,6254,10262;10530;12634;13372,7665,0,0,4,0,4
24294,50,6255,10265;10594;12494;13742;14219,7665,0,1,4,0,5
24295,50,6256,10206;10486;13390;14142,7665,0,1,3,0,4
24296,50,6257,10292;10482;12433;12675;13937,7665,0,1,4,0,5
24297,50,6258,10312;10364;13959,7665,0,1,2,0,3
24298,50,6259,10537;10570;15408,7665,0,1,2,0,3
24299,50,6260,10332;10565;13425;14049;14190,7665,0,2,3,0,5
24300,50,6261,10080;13170,8030,0,0,2,0,2
24301,50,6264,523,8030,0,0,0,1,1
24302,50,6266,975,8030,0,0,0,1,1
24303,50,6267,1049;12916;13687,8030,0,0,3,0,3
24304,50,6268,7592,8030,0,0,0,1,1
24305,50,6269,1242;10101,8030,0,0,2,0,2
24306,50,6272,839;10156;13487;13861,8030,0,1,3,0,4
24307,50,6273,1218,8030,0,0,1,0,1
24308,50,6274,2067;6649,8030,0,0,0,2,2
24309,50,6278,936,8030,0,0,0,1,1
24310,50,6279,2871;5736,8030,0,0,2,0,2
24311,50,6282,3370,8030,0,0,0,1,1
24312,50,6285,1990;6444,8030,0,0,2,0,2
24313,50,6287,2285;4315,8030,0,0,0,2,2
24314,50,6288,3127;4809;12915;13191;13894;14354,8030,0,2,4,0,6
24315,50,6289,5246,8030,0,0,0,1,1
24316,50,6290,5333;6519,8030,0,0,0,2,2
24317,50,6291,148;5364,8030,0,0,0,2,2
24318,50,6292,5725,8030,0,0,0,1,1
24319,50,6296,5926,8030,0,0,0,1,1
24320,50,6302,2598;13516,8030,0,0,2,0,2
24321,50,6305,5430,8030,0,0,0,1,1
24322,50,6306,7645,8030,0,0,0,1,1
24323,50,6311,7293,8030,0,0,0,1,1
24324,50,6314,2301;9562,8030,0,0,0,2,2
24325,50,6315,9267;10180;12645;13719,8030,0,0,4,0,4
24326,50,6316,1720;9231;14001,8030,0,1,2,0,3
24327,50,6319,10042;10141;13327;14206;14567,8030,0,2,3,0,5
24328,50,6320,3952,8030,0,0,1,0,1
24329,50,6322,10021;10071;14036;14131,8030,0,2,2,0,4
24330,50,6324,10091;10104;12885;13747;13837,8030,0,1,4,0,5
24331,50,6325,4092;10140,8030,0,0,2,0,2
24332,50,6326,10106;10160;13610,8030,0,0,3,0,3
24333,50,6327,10807;10861;13208;14233;14950,8030,0,2,3,0,5
24334,50,6328,10157;10225;13673,8030,0,0,3,0,3
24335,50,6329,10073;10226;13211;13653,8030,0,0,4,0,4
24336,50,6330,10223;10234;12723,8030,0,0,3,0,3
24337,50,6332,10236;10281;12759;12985;13128,8030,0,0,5,0,5
24338,50,6335,10272;13353;14493,8030,0,1,2,0,3
24339,50,6336,10309;10463;13826,8030,0,1,2,0,3
24340,50,6337,10453;12671;14678;15619,8030,1,1,2,0,4
24341,50,6338,10316;10374;13175;13457,8030,0,0,4,0,4
24342,50,6339,10446;10790;13588;14748,8030,0,1,3,0,4
24343,50,6340,10199;10398;12364;13467,8030,0,0,4,0,4
24344,50,6341,10382;13054;13302,8030,0,0,3,0,3
24345,50,6342,10391;10412;12601;13474;13763;14530,8030,0,1,5,0,6
24346,50,6343,10397;10403;13209;13574,8030,0,0,4,0,4
24347,50,6347,383;6336,8395,0,0,2,0,2
24348,50,6348,476;3859,8395,0,0,2,0,2
24349,50,6349,549;4645,8395,0,0,0,2,2
24350,50,6350,2221,8395,0,0,0,1,1
24351,50,6351,5027;10038;13452,8395,0,0,3,0,3
24352,50,6352,2121;14018,8395,0,1,1,0,2
24353,50,6354,1308;9986;13500;14067,8395,0,1,3,0,4
24354,50,6356,2784;8052;14080,8395,0,1,2,0,3
24355,50,6357,1388;10032;13453;14649,8395,0,1,3,0,4
24356,50,6358,1493;10562;13944;14480,8395,0,2,2,0,4
24357,50,6361,2169;3214,8395,0,0,0,2,2
24358,50,6362,2534;4151;12525;12767,8395,0,0,4,0,4
24359,50,6365,4629;8903,8395,0,0,0,2,2
24360,50,6368,6470;12712;13321,8395,0,0,3,0,3
24361,50,6369,10211;12692;14412,8395,0,1,2,0,3
24362,50,6373,6332,8395,0,0,0,1,1
24363,50,6374,10305;13631;13699,8395,0,0,3,0,3
24364,50,6376,6873;7102,8395,0,0,0,2,2
24365,50,6381,8057;13455,8395,0,0,2,0,2
24366,50,6382,4860,8395,0,0,1,0,1
24367,50,6383,10152;10245;12980;15444,8395,0,1,3,0,4
24368,50,6384,4946;10241;13298;13636,8395,0,0,4,0,4
24369,50,6386,10216;13650,8395,0,0,2,0,2
24370,50,6391,6955;9317;13483,8395,0,0,3,0,3
24371,50,6397,8307,8395,0,0,1,0,1
24372,50,6398,8372,8395,0,0,1,0,1
24373,50,6399,1632;8564,8395,0,0,0,2,2
24374,50,6400,9128;9370,8395,0,0,0,2,2
24375,50,6404,4304;6601;13729;14565,8395,0,1,3,0,4
24376,50,6408,10353;13810;14167,8395,0,2,1,0,3
24377,50,6409,10238;10465;13720;14125,8395,0,1,3,0,4
24378,50,6410,10074;10126;16153,8395,1,0,2,0,3
24379,50,6412,10088;14283,8395,0,1,1,0,2
24380,50,6413,10210;13521,8395,0,0,2,0,2
24381,50,6414,2751;10097;13542;14250,8395,0,1,3,0,4
24382,50,6415,5186;10114;13366,8395,0,0,3,0,3
24383,50,6417,10523;10544;13172;14336;14998,8395,0,2,3,0,5
24384,50,6418,10521;13803;15015,8395,0,2,1,0,3
24385,50,6419,10144;10372;14052,8395,0,1,2,0,3
24386,50,6421,5992;10149;12833;13357;13806,8395,0,1,4,0,5
24387,50,6422,3247;10170;12707;13246;13416,8395,0,0,5,0,5
24388,50,6423,10193;10498;12506;14045,8395,0,1,3,0,4
24389,50,6424,10109;10208;13419;14457,8395,0,1,3,0,4
24390,50,6426,10215;12988;14464,8395,0,1,2,0,3
24391,50,6427,10134;10591;12828;13522;14721,8395,0,1,4,0,5
24392,50,6428,10333;10727;13775,8395,0,0,3,0,3
24393,50,6429,10351;13583,8395,0,0,2,0,2
24394,50,6430,7856;10359;13510,8395,0,0,3,0,3
24395,50,6431,10007;10380;14075,8395,0,1,2,0,3
24396,50,6432,10336;10431;13546,8395,0,0,3,0,3
24397,50,6433,10434;10472;14605,8395,0,1,2,0,3
24398,50,6434,10436;12515;14184,8395,0,1,2,0,3
24399,50,6435,10325;10449;13559;14544,8395,0,1,3,0,4
24400,50,6436,10290;10450;12660;13718;15306,8395,0,1,4,0,5
24401,50,6437,10717;10754;15261,8395,0,1,2,0,3
24402,50,6438,10578;10788;14149;14810,8395,0,2,2,0,4
24403,50,6439,8013,8760,0,0,0,1,1
24404,50,6440,10344;10381;13935,8760,0,1,2,0,3
24405,50,6444,350,8760,0,0,0,1,1
24406,50,6446,10085;10090;13604;13748,8760,0,0,4,0,4
24407,50,6447,1345;5433;13888;14230,8760,0,2,2,0,4
24408,50,6448,10014;10399;12860;13443;13889;14333,8760,0,2,4,0,6
24409,50,6451,8661,8760,0,0,0,1,1
24410,50,6452,8839;9751;13163,8760,0,0,3,0,3
24411,50,6454,7037;10102;12847;13626;13715,8760,0,0,5,0,5
24412,50,6459,3070;6612;13044,8760,0,0,3,0,3
24413,50,6461,3241;10099;13535;14200,8760,0,1,3,0,4
24414,50,6462,1050;3267;14197,8760,0,1,2,0,3
24415,50,6464,347;3759,8760,0,0,1,1,2
24416,50,6465,5840,8760,0,0,0,1,1
24417,50,6466,10183;13477;14202,8760,0,1,2,0,3
24418,50,6467,2246,8760,0,0,0,1,1
24419,50,6470,2700;3457,8760,0,0,0,2,2
24420,50,6483,1705;6654;13025,8760,0,0,3,0,3
24421,50,6488,5013,8760,0,0,0,1,1
24422,50,6490,3731;5590;12753,8760,0,0,3,0,3
24423,50,6491,7972,8760,0,0,1,0,1
24424,50,6492,4210;8033,8760,0,0,0,2,2
24425,50,6493,8065;8878;13230,8760,0,0,3,0,3
24426,50,6495,7465;8384,8760,0,0,0,2,2
24427,50,6496,199;8526,8760,0,0,0,2,2
24428,50,6501,4990;9506;13213,8760,0,0,3,0,3
24429,50,6503,10035;13456;13700;13830;14613,8760,0,2,3,0,5
24430,50,6504,10020;10025;13624;13868;14034,8760,0,2,3,0,5
24431,50,6505,10195;10288;13389,8760,0,0,3,0,3
24432,50,6506,10066;10138;13259;13424;13805;14361;15101,8760,0,3,4,0,7
24433,50,6508,10167;10250;14059;14342,8760,0,2,2,0,4
24434,50,6509,10233;10579;13568;13989;14108;14489,8760,0,3,3,0,6
24435,50,6511,10698;10735;15835,8760,1,0,2,0,3
24436,50,6513,10501;10668;13481;14105;14385;14946,8760,0,3,3,0,6
24437,50,6514,10023;10118;13794;14804,8760,0,2,2,0,4
24438,50,6515,10128;10411;12969;13543;15143,8760,0,1,4,0,5
24439,50,6516,10423;10741;13047;13818,8760,0,1,3,0,4
24440,50,6517,10176;10425;13162;14009,8760,0,1,3,0,4
24441,50,6518,10427;10674;12978;13256;13682,8760,0,0,5,0,5
24442,50,6519,10428;10590;14089;14453,8760,0,2,2,0,4
24443,50,6520,10461;10507;12827;14054,8760,0,1,3,0,4
24444,50,6521,10494;10895,8760,0,0,2,0,2
24445,50,6522,9849;10068;13585,8760,0,0,3,0,3
24446,50,6523,10513;10850;12631;15012,8760,0,1,3,0,4
24447,50,6524,10517;10661;12726;12774;13735;13986,8760,0,1,5,0,6
24448,50,6525,10276;10519;13898;13979,8760,0,2,2,0,4
24449,50,6526,10524;10797;13829;14037;14351,8760,0,3,2,0,5
24450,50,6527,10534;13520;14314,8760,0,1,2,0,3
24451,50,6528,10339;10547;13003;13706;13849;14362,8760,0,2,4,0,6
24452,50,6529,10324;10563;13867;14102,8760,0,2,2,0,4
24453,50,6530,10348;10838,8760,0,0,2,0,2
24454,50,6531,10583;10671;12781;13006;13956,8760,0,1,4,0,5
24455,50,6532,10274;10595;13779,8760,0,0,3,0,3
24456,50,6533,10221;10597;14011,8760,0,1,2,0,3
24457,50,6538,802,9125,0,0,0,1,1
24458,50,6539,1001;4272,9125,0,0,0,2,2
24459,50,6541,10424;10455;12696;13387,9125,0,0,4,0,4
24460,50,6542,2965;3137;12853;13232;13926,9125,0,1,4,0,5
24461,50,6543,1059;9769,9125,0,0,0,2,2
24462,50,6552,2567;2937,9125,0,0,0,2,2
24463,50,6553,6680,9125,0,0,0,1,1
24464,50,6557,10108;10254;13756,9125,0,0,3,0,3
24465,50,6558,1590,9125,0,0,0,1,1
24466,50,6561,3507,9125,0,0,1,0,1
24467,50,6563,8269;8389,9125,0,0,0,2,2
24468,50,6564,7115;10159;12676;13377;13581,9125,0,0,5,0,5
24469,50,6568,10256;14048;14647,9125,0,2,1,0,3
24470,50,6571,7443;10177;13218,9125,0,0,3,0,3
24471,50,6574,367;7346,9125,0,0,2,0,2
24472,50,6575,5109,9125,0,0,0,1,1
24473,50,6578,1668;2920,9125,0,0,2,0,2
24474,50,6580,2429,9125,0,0,0,1,1
24475,50,6582,8659,9125,0,0,0,1,1
24476,50,6584,10662;10696;13331;13684;13873,9125,0,1,4,0,5
24477,50,6587,10057;10153;14069;14560,9125,0,2,2,0,4
24478,50,6589,9247;10100;14651,9125,0,1,2,0,3
24479,50,6590,10127;10467;14119,9125,0,1,2,0,3
24480,50,6591,10783;10967;12956;13385;13896;14147,9125,0,2,4,0,6
24481,50,6592,10229;10485;13356;13710;15394,9125,0,1,4,0,5
24482,50,6593,10005;10194;13164,9125,0,0,3,0,3
24483,50,6594,1164;10202;13222,9125,0,0,3,0,3
24484,50,6595,9520;10207;13667,9125,0,0,3,0,3
24485,50,6596,10054;10539;13892;14619,9125,0,2,2,0,4
24486,50,6597,10146;10396;13570,9125,0,0,3,0,3
24487,50,6598,10389;10481;13942,9125,0,1,2,0,3
24488,50,6599,10268;10368;13292;14499;14719,9125,0,2,3,0,5
24489,50,6600,10409;10558;13234;14051;14873,9125,0,2,3,0,5
24490,50,6601,10435;10628;13649;14177;14357,9125,0,2,3,0,5
24491,50,6602,10864;10947;13179;14800;15892,9125,1,1,3,0,5
24492,50,6603,10639;13077;13912;14731,9125,0,2,2,0,4
24493,50,6604,10540;10672;14062;14497,9125,0,2,2,0,4
24494,50,6605,10466;10650;13168;13569,9125,0,0,4,0,4
24495,50,6606,10605;13778;14241,9125,0,1,2,0,3
24496,50,6607,10988;13515;13858;14133;14837;15268;15348;15814,9125,1,5,2,0,8
24497,50,6608,10739;10762;15307;15866,9125,1,1,2,0,4
24498,50,6609,10357;10418;12787;13815;14031,9125,0,2,3,0,5
24499,50,6611,10587;10866;15058,9125,0,1,2,0,3
24500,50,6612,10379;10627;13402;14469,9125,0,1,3,0,4
24501,50,6613,10123;10601;13980;14207;14643,9125,0,3,2,0,5
24502,50,6614,10533;10610;13238;13874;14315;14451;14866;15167,9125,0,5,3,0,8
24503,50,6615,10955;12896;13475;15439,9125,0,1,3,0,4
24504,50,6616,10613;10623;13360;14074;14942,9125,0,2,3,0,5
24505,50,6617,10624;10763;12971;13525;13823,9125,0,1,4,0,5
24506,50,6618,10280;10625;12841;13266;14243,9125,0,1,4,0,5
24507,50,6619,10646;10848;14370;15132,9125,0,2,2,0,4
24508,50,6620,10657;12867;14401;14556,9125,0,2,2,0,4
24509,50,6621,10495;10675;13963;14328,9125,0,2,2,0,4
24510,50,6622,10677;10842;14152;15045;15270,9125,0,3,2,0,5
24511,50,6623,10626;10679;13679;14172;15338,9125,0,2,3,0,5
24512,50,6624,10692;10873;14356;15284,9125,0,2,2,0,4
24513,50,6625,10695;13284;13469;13969;14434,9125,0,2,3,0,5
24514,50,6631,6587;7496,9490,0,0,0,2,2
24515,50,6637,1689;8129,9490,0,0,0,2,2
24516,50,6639,877;1840,9490,0,0,2,0,2
24517,50,6640,4011,9490,0,0,0,1,1
24518,50,6646,8150,9490,0,0,1,0,1
24519,50,6648,452,9490,0,0,0,1,1
24520,50,6652,4815,9490,0,0,0,1,1
24521,50,6653,7241,9490,0,0,0,1,1
24522,50,6657,2953,9490,0,0,0,1,1
24523,50,6660,2833;8408,9490,0,0,2,0,2
24524,50,6661,6801,9490,0,0,0,1,1
24525,50,6664,1021,9490,0,0,0,1,1
24526,50,6667,1140;7485,9490,0,0,0,2,2
24527,50,6668,1192;7561,9490,0,0,2,0,2
24528,50,6669,7720;8154,9490,0,0,0,2,2
24529,50,6671,9826,9490,0,0,1,0,1
24530,50,6673,6469;8697;13138;13524,9490,0,0,4,0,4
24531,50,6675,247;3019;13797,9490,0,1,2,0,3
24532,50,6677,8425;9117,9490,0,0,1,1,2
24533,50,6680,9113,9490,0,0,0,1,1
24534,50,6682,10009,9490,0,0,1,0,1
24535,50,6684,10300;10457;13011;13936,9490,0,1,3,0,4
24536,50,6686,10143;10489;13365;13491,9490,0,0,4,0,4
24537,50,6687,10253;10510;12926;13410,9490,0,0,4,0,4
24538,50,6688,10251;10508;14114;14594;15019,9490,0,3,2,0,5
24539,50,6689,10171;10615;13571;14176;14478,9490,0,2,3,0,5
24540,50,6690,10190;10267;13399,9490,0,0,3,0,3
24541,50,6691,10285;10376;14208,9490,0,1,2,0,3
24542,50,6693,10039;13031;13853,9490,0,1,2,0,3
24543,50,6694,7530;10192;13134;14667,9490,0,1,3,0,4
24544,50,6695,10350;10515;13438;13724;14032;14409,9490,0,2,4,0,6
24545,50,6696,10196;10445;13260;14103,9490,0,1,3,0,4
24546,50,6697,9098,9490,0,0,1,0,1
24547,50,6698,10459;10504;14004;14118,9490,0,2,2,0,4
24548,50,6699,10636;10881;13594;14555,9490,0,1,3,0,4
24549,50,6700,10573;10596;12912;14323,9490,0,1,3,0,4
24550,50,6701,10493;10792;13417;14178;14906;15043,9490,0,3,3,0,6
24551,50,6702,10503;13426,9490,0,0,2,0,2
24552,50,6703,10320;10546;13563;13974;14865,9490,0,2,3,0,5
24553,50,6704,10555;10645;13070;13978,9490,0,1,3,0,4
24554,50,6705,10560;10564;14081;14187,9490,0,2,2,0,4
24555,50,6706,10576;10799;13149;13971;14382,9490,0,2,3,0,5
24556,50,6707,10577;13814;14025;14253,9490,0,3,1,0,4
24557,50,6708,10585;13065;13245;13809,9490,0,1,3,0,4
24558,50,6709,10580;10592;13812;14620;14986,9490,0,3,2,0,5
24559,50,6710,10528;10604;13946;14398,9490,0,2,2,0,4
24560,50,6711,10419;13902,9490,0,1,1,0,2
24561,50,6712,10611;10885;13842;14625,9490,0,2,2,0,4
24562,50,6713,10259;10616;13766;14285;14468,9490,0,2,3,0,5
24563,50,6714,10632;10687;13056;13634;14260,9490,0,1,4,0,5
24564,50,6715,10640;10769;12940;13413,9490,0,0,4,0,4
24565,50,6716,10483;10827;13553;14266,9490,0,1,3,0,4
24566,50,6717,10337;10670;13619;14477;15050,9490,0,2,3,0,5
24567,50,6718,10676;10731;13934;14044;15170,9490,0,3,2,0,5
24568,50,6719,10681;10825;13367;13692;14017;14344;15130;15800,9490,1,3,4,0,8
24569,50,6720,10700;13354;14983,9490,0,1,2,0,3
24570,50,6721,10713;11010;13644;15423,9490,0,1,3,0,4
24571,50,6722,10720;11053;13534;13646;13802;13995,9490,0,2,4,0,6
24572,50,6723,10977;14438;14835;15617,9490,1,2,1,0,4
24573,50,6724,10804;10878,9490,0,0,2,0,2
24574,50,6725,10791;10821;13244;14229;14430,9490,0,2,3,0,5
24575,50,6727,458,9855,0,0,0,1,1
24576,50,6728,10421;14268,9855,0,1,1,0,2
24577,50,6729,879;3198,9855,0,0,0,2,2
24578,50,6731,5967;8417,9855,0,0,0,2,2
24579,50,6736,9238,9855,0,0,0,1,1
24580,50,6738,1247;2621,9855,0,0,0,2,2
24581,50,6739,3087,9855,0,0,1,0,1
24582,50,6740,8949,9855,0,0,1,0,1
24583,50,6743,6347;6537,9855,0,0,0,2,2
24584,50,6744,3561;10079;13831,9855,0,1,2,0,3
24585,50,6749,4448;9364,9855,0,0,2,0,2
24586,50,6750,3842;4470,9855,0,0,2,0,2
24587,50,6754,4956,9855,0,0,1,0,1
24588,50,6755,2265,9855,0,0,0,1,1
24589,50,6756,684;9103,9855,0,0,0,2,2
24590,50,6757,3403;10048;14110;14681,9855,0,2,2,0,4
24591,50,6765,5864;7893,9855,0,0,0,2,2
24592,50,6766,4258;8567,9855,0,0,0,2,2
24593,50,6767,460;8763,9855,0,0,0,2,2
24594,50,6769,5231;9281,9855,0,0,0,2,2
24595,50,6772,2273;9985,9855,0,0,0,2,2
24596,50,6773,2910;10029;14306,9855,0,1,2,0,3
24597,50,6774,10303;10430;14224;14523,9855,0,2,2,0,4
24598,50,6775,10239;13280;13772;13966,9855,0,1,3,0,4
24599,50,6776,10230;10264;13552;13993;14321,9855,0,2,3,0,5
24600,50,6777,10266;10315;13051;13350;14000,9855,0,1,4,0,5
24601,50,6778,10294;10548;14043,9855,0,1,2,0,3
24602,50,6779,6443;10304;14203;14479;15289,9855,0,3,2,0,5
24603,50,6780,10341;10532;13228;14312;14783;15156,9855,0,3,3,0,6
24604,50,6781,10362;13277;13598;14586,9855,0,1,3,0,4
24605,50,6782,10365;13627,9855,0,0,2,0,2
24606,50,6783,10037;10366;13433;13561,9855,0,0,4,0,4
24607,50,6784,10352;10369;13397;14040,9855,0,1,3,0,4
24608,50,6785,10358;10402;13910,9855,0,1,2,0,3
24609,50,6786,10323;10464;13975;15529,9855,1,1,2,0,4
24610,50,6787,10506;13769,9855,0,0,2,0,2
24611,50,6788,10702;10968;13229;13677;13795,9855,0,1,4,0,5
24612,50,6789,10456;10853;14158;14277,9855,0,2,2,0,4
24613,50,6790,10647;10909;14455;14750;14780,9855,0,3,2,0,5
24614,50,6791,10240;10545;13345;13939,9855,0,1,3,0,4
24615,50,6792,10488;10588;13152;13657;13865;14368,9855,0,2,4,0,6
24616,50,6793,10529;10871;14640,9855,0,1,2,0,3
24617,50,6794,10584;13573;14085,9855,0,1,2,0,3
24618,50,6796,10620;13060,9855,0,0,2,0,2
24619,50,6797,10630;10701;14146;14440,9855,0,2,2,0,4
24620,50,6798,10220;10631;13575;13665;14165,9855,0,1,4,0,5
24621,50,6799,10648;10892;13278;14174;15569,9855,1,1,3,0,5
24622,50,6800,10654;10758;13235;14086;14569,9855,0,2,3,0,5
24623,50,6801,10447;10669;14106;15189,9855,0,2,2,0,4
24624,50,6802,10703;13041;14371,9855,0,1,2,0,3
24625,50,6803,10551;10705;14061;14220;14803;15049;15453,9855,0,5,2,0,7
24626,50,6804,11130;11185;13369;13640;13757;13860,9855,0,1,5,0,6
24627,50,6805,10747;11004;13637;13973;15710,9855,1,1,3,0,5
24628,50,6806,10734;10779;14016;14700,9855,0,2,2,0,4
24629,50,6807,10707;10785;13614;14135;14688,9855,0,2,3,0,5
24630,50,6808,10499;10795;13243;14271;14576,9855,0,2,3,0,5
24631,50,6809,10442;10812;13722;14345,9855,0,1,3,0,4
24632,50,6810,10816;11110;13386;15151,9855,0,1,3,0,4
24633,50,6811,10836;11025;13002;13497;14050;14741,9855,0,2,4,0,6
24634,50,6812,10600;10847;14327;14710;15083,9855,0,3,2,0,5
24635,50,6813,10889;13953;14325,9855,0,2,1,0,3
24636,50,6814,10899;10970;13200;13781;14107;14630,9855,0,2,4,0,6
24637,50,6815,10903;11197;13359;13642;15715;16051,9855,2,0,4,0,6
24638,50,6816,84,10220,0,0,1,0,1
24639,50,6817,232,10220,0,0,0,1,1
24640,50,6821,718,10220,0,0,0,1,1
24641,50,6823,3289;4475,10220,0,0,0,2,2
24642,50,6827,2464,10220,0,0,0,1,1
24643,50,6828,2625,10220,0,0,1,0,1
24644,50,6829,162,10220,0,0,0,1,1
24645,50,6833,4525,10220,0,0,0,1,1
24646,50,6834,6107;9883,10220,0,0,0,2,2
24647,50,6839,414,10220,0,0,0,1,1
24648,50,6840,6002;10286;13349;14561,10220,0,1,3,0,4
24649,50,6841,6212;6702,10220,0,0,2,0,2
24650,50,6842,89;5128;13342,10220,0,0,3,0,3
24651,50,6843,6348;10189;13891,10220,0,1,2,0,3
24652,50,6846,6848;7295,10220,0,0,2,0,2
24653,50,6849,1296;4542,10220,0,0,1,1,2
24654,50,6850,7101,10220,0,0,1,0,1
24655,50,6851,2497,10220,0,0,0,1,1
24656,50,6860,10150;10282;13323;14101,10220,0,1,3,0,4
24657,50,6861,10017;10572;14198,10220,0,1,2,0,3
24658,50,6862,865;7890,10220,0,0,2,0,2
24659,50,6863,10289;13401;14695,10220,0,1,2,0,3
24660,50,6865,7344;10385;13880,10220,0,1,2,0,3
24661,50,6867,10062;10222;13852;13955,10220,0,2,2,0,4
24662,50,6869,10375;13197;13847,10220,0,1,2,0,3
24663,50,6870,10603;10730;13758;14141;14487,10220,0,2,3,0,5
24664,50,6871,10370;10784;13726;14056,10220,0,1,3,0,4
24665,50,6872,10569;13927;14572;16136,10220,1,2,1,0,4
24666,50,6873,10664;10685;13212;13733,10220,0,0,4,0,4
24667,50,6874,10728;14537;14995,10220,0,2,1,0,3
24668,50,6875,10392;10688;13911;14505;14959,10220,0,3,2,0,5
24669,50,6876,10694;10787;13701;14270;14578;15575,10220,1,2,3,0,6
24670,50,6877,11243;13768;13918,10220,0,1,2,0,3
24671,50,6878,10198;10800;13567;14772,10220,0,1,3,0,4
24672,50,6879,10934;14966;15460,10220,0,2,1,0,3
24673,50,6880,10723;10888;13796;14024,10220,0,2,2,0,4
24674,50,6881,10898;10907;13582;14269;14606,10220,0,2,3,0,5
24675,50,6882,10932;11086;13592;13730;14060,10220,0,1,4,0,5
24676,50,6883,10948;11131;13315;13612;13887;14122;14702;15221,10220,0,4,4,0,8
24677,50,6884,11152;13279;13603,10220,0,0,3,0,3
24678,50,6885,10961;11195;13743;14386;15558,10220,1,1,3,0,5
24679,50,6886,10776;11088;13223;13504;14151;14593;14947,10220,0,3,4,0,7
24680,50,6887,10896;10984;13272;14445;15413,10220,0,2,3,0,5
24681,50,6888,10771;10995;13792;14743;15194,10220,0,3,2,0,5
24682,50,6889,11137;13875;15122,10220,0,2,1,0,3
24683,50,6890,11144;14035;15247,10220,0,2,1,0,3
24684,50,6892,387,10585,0,0,0,1,1
24685,50,6895,804;10026;13864;14658,10585,0,2,2,0,4
24686,50,6896,806,10585,0,0,0,1,1
24687,50,6897,1382;3798;13484;13625,10585,0,0,4,0,4
24688,50,6899,1803,10585,0,0,1,0,1
24689,50,6900,94;10133;13317,10585,0,0,3,0,3
24690,50,6901,2147,10585,0,0,0,1,1
24691,50,6909,357,10585,0,0,0,1,1
24692,50,6910,4124;4871,10585,0,0,0,2,2
24693,50,6911,2389;5174,10585,0,0,2,0,2
24694,50,6913,1719;5365,10585,0,0,0,2,2
24695,50,6921,3690;9797,10585,0,0,0,2,2
24696,50,6922,10050;10247;12846;13376;13605;14799,10585,0,1,5,0,6
24697,50,6924,10249;10683;14498;14690;15000;15249,10585,0,4,2,0,6
24698,50,6925,10013;10408;13694;14039;15282,10585,0,2,3,0,5
24699,50,6927,10452;10782;13319;14402,10585,0,1,3,0,4
24700,50,6928,10185;10405;13427;14258;14918,10585,0,2,3,0,5
24701,50,6929,10718;14372;14708,10585,0,2,1,0,3
24702,50,6931,10462;10531;13332;13698;14472,10585,0,1,4,0,5
24703,50,6932,10567;10637;13695;14574;15009,10585,0,2,3,0,5
24704,50,6933,10665;10859;14456,10585,0,1,2,0,3
24705,50,6934,10004;10070;14223,10585,0,1,2,0,3
24706,50,6935,10709;10759;13745;14337;15106,10585,0,2,3,0,5
24707,50,6936,10857;11058;14767;15071,10585,0,2,2,0,4
24708,50,6937,10641;10822;13732;14330;14577,10585,0,2,3,0,5
24709,50,6938,10832;11060;13704;14053;14758,10585,0,2,3,0,5
24710,50,6939,10487;10833;13300;15426,10585,0,1,3,0,4
24711,50,6940,10841;10868;13622;14807,10585,0,1,3,0,4
24712,50,6941,10843;13721;14672,10585,0,1,2,0,3
24713,50,6943,10921;13490;14082;14332,10585,0,2,2,0,4
24714,50,6944,10426;10867;13990;14521,10585,0,2,2,0,4
24715,50,6945,10887;13381;14132;14836,10585,0,2,2,0,4
24716,50,6946,10849;10891;13738;14100;14899;15486,10585,1,2,3,0,6
24717,50,6947,10912;11344;14254;15030,10585,0,2,2,0,4
24718,50,6948,10926;11552;15079;15428,10585,0,2,2,0,4
24719,50,6949,10770;11132;13789;13854;14689,10585,0,2,3,0,5
24720,50,6950,10893;11147;14068;14575;15369,10585,0,3,2,0,5
24721,50,6951,10996;11018;13762;14355;14476;15041;15405,10585,0,4,3,0,7
24722,50,6952,10714;11045;14745;14761;15883,10585,1,2,2,0,5
24723,50,6953,11047;11274;13787;13848;14461;16177,10585,1,2,3,0,6
24724,50,6954,11054;11258;13924;14020;15503,10585,1,2,2,0,5
24725,50,6956,11080;13791;14275,10585,0,2,1,0,3
24726,50,6957,11095;11343;13968;14350;14900;16104,10585,1,3,2,0,6
24727,50,6960,368,10950,0,0,0,1,1
24728,50,6961,489;8831,10950,0,0,0,2,2
24729,50,6962,10010;13316,10950,0,0,2,0,2
24730,50,6968,2422,10950,0,0,0,1,1
24731,50,6969,2455,10950,0,0,0,1,1
24732,50,6972,4377,10950,0,0,0,1,1
24733,50,6975,636;8824,10950,0,0,0,2,2
24734,50,6977,3438,10950,0,0,0,1,1
24735,50,6980,8760;9077,10950,0,0,0,2,2
24736,50,6981,5301,10950,0,0,1,0,1
24737,50,6983,2244;8987,10950,0,0,0,2,2
24738,50,6985,9043,10950,0,0,1,0,1
24739,50,6990,5604;7986,10950,0,0,0,2,2
24740,50,6991,5684;6408,10950,0,0,0,2,2
24741,50,6993,5086,10950,0,0,0,1,1
24742,50,6996,7320,10950,0,0,0,1,1
24743,50,6999,2774;10231;13530;14273;14720,10950,0,2,3,0,5
24744,50,7000,10154;10311;13538;14038;14153;15298,10950,0,3,3,0,6
24745,50,7002,10095;13960,10950,0,1,1,0,2
24746,50,7003,10378;13421;13651,10950,0,0,3,0,3
24747,50,7005,10394;10557;13672;13947,10950,0,1,3,0,4
24748,50,7007,10186;10420;14104;14310,10950,0,2,2,0,4
24749,50,7009,10743;10756;13476;13591;13904;14353,10950,0,2,4,0,6
24750,50,7010,11037;13496;13557;14093;14319;14738,10950,0,3,3,0,6
24751,50,7012,10764;10805;13681;14073,10950,0,1,3,0,4
24752,50,7013,10924;13430;14407;14877,10950,0,2,2,0,4
24753,50,7014,10342;10793;13513;14483;14760;15940,10950,1,2,3,0,6
24754,50,7015,10642;10796;14163;14417,10950,0,2,2,0,4
24755,50,7016,10927;11268;13725;14096;16024,10950,1,1,3,0,5
24756,50,7017,10693;10808;14691;15207,10950,0,2,2,0,4
24757,50,7018,10817;13652;13862;14815,10950,0,2,2,0,4
24758,50,7019,10845;11168;14473;14852;15308,10950,0,3,2,0,5
24759,50,7020,10789;10883;13528;13940;15293;15949,10950,1,2,3,0,6
24760,50,7021,10950;11093;14545;14802,10950,0,2,2,0,4
24761,50,7022,10953;11296;13400;13712;15183,10950,0,1,4,0,5
24762,50,7023,11077;13834;14166,10950,0,2,1,0,3
24763,50,7024,10972;11174;13505;13872;14307,10950,0,2,3,0,5
24764,50,7025,10755;10851;14246;14595,10950,0,2,2,0,4
24765,50,7026,10979;11284;13856;14990,10950,0,2,2,0,4
24766,50,7027,10981;14365,10950,0,1,1,0,2
24767,50,7028,10989;11122;14676,10950,0,1,2,0,3
24768,50,7029,11005;11460;13671;14403,10950,0,1,3,0,4
24769,50,7030,10919;11006;14390;14546;15577,10950,1,2,2,0,5
24770,50,7032,11035;11248;13817;14218,10950,0,2,2,0,4
24771,50,7033,11036;11048;14300;14585,10950,0,2,2,0,4
24772,50,7034,11041;11170;13884;14065;14428;14712;15145;15774,10950,1,5,2,0,8
24773,50,7035,11059;11462;13584;13923;14559;14660,10950,0,3,3,0,6
24774,50,7036,11392;11415;13648;13893;14393;14999,10950,0,3,3,0,6
24775,50,7037,11068;11326;13663;14008;14465,10950,0,2,3,0,5
24776,50,7038,11298;14058;14941,10950,0,2,1,0,3
24777,50,7039,11099;13618;13890;14616,10950,0,2,2,0,4
24778,50,7040,11102;11374;14744;15180;15606,10950,1,2,2,0,5
24779,50,7041,10824;11103;13827;15109,10950,0,2,2,0,4
24780,50,7042,11281;13596;13759;14318,10950,0,1,3,0,4
24781,50,7043,11126;11441;16150,10950,1,0,2,0,3
24782,50,7044,11055;11128;13824;14211;14396;15225,10950,0,4,2,0,6
24783,50,7045,10928;11029;14421;14612;15748,10950,1,2,2,0,5
24784,50,7046,10966;11159;13696;14013;15290,10950,0,2,3,0,5
24785,50,7047,10942;11145;13914;15123,10950,0,2,2,0,4
24786,50,7048,11154;11299;14618;15073;16068,10950,1,2,2,0,5
24787,50,7049,11162;11251;14471;14849,10950,0,2,2,0,4
24788,50,7050,11165;11409;13565;13807;14458,10950,0,2,3,0,5
24789,50,7051,11187;11339;13639;14335;14627,10950,0,2,3,0,5
24790,50,7052,11188;11261;13501;13717;14514;15961,10950,1,1,4,0,6
24791,50,7053,3832,11315,0,0,0,1,1
24792,50,7054,554;3133,11315,0,0,0,2,2
24793,50,7057,926,11315,0,0,0,1,1
24794,50,7060,6254,11315,0,0,0,1,1
24795,50,7063,5598,11315,0,0,0,1,1
24796,50,7064,3795,11315,0,0,0,1,1
24797,50,7065,3863;10242;14021;14596,11315,0,2,2,0,4
24798,50,7066,3940;6856,11315,0,0,0,2,2
24799,50,7068,3222;4290,11315,0,0,0,2,2
24800,50,7069,10293;10429;14730;15345,11315,0,2,2,0,4
24801,50,7071,2692,11315,0,0,0,1,1
24802,50,7075,3256;6370,11315,0,0,2,0,2
24803,50,7080,711;8622,11315,0,0,0,2,2
24804,50,7081,7223,11315,0,0,1,0,1
24805,50,7082,5557;7410;13828,11315,0,1,2,0,3
24806,50,7083,7445;10179;13930;14339,11315,0,2,2,0,4
24807,50,7092,9987,11315,0,0,1,0,1
24808,50,7093,10388;13617;13950;14551,11315,0,2,2,0,4
24809,50,7095,10279;10326;13782;14055;14854,11315,0,2,3,0,5
24810,50,7096,10135;10137;13556;14113,11315,0,1,3,0,4
24811,50,7098,10313;10330;13590;14609,11315,0,1,3,0,4
24812,50,7099,10360;10404;13589;13913,11315,0,1,3,0,4
24813,50,7100,10441;10897;13737;14341;15626,11315,1,1,3,0,5
24814,50,7101,10454;10794;14175;15021,11315,0,2,2,0,4
24815,50,7102,10361;13932;14002,11315,0,2,1,0,3
24816,50,7103,10505;10761;14358;14871,11315,0,2,2,0,4
24817,50,7104,10543;10742;13961;14261;15013,11315,0,3,2,0,5
24818,50,7105,10806;11277;13600;14047,11315,0,1,3,0,4
24819,50,7107,10617;11034;13977;14510,11315,0,2,2,0,4
24820,50,7108,10629;10991;13576;14548;14729;15137,11315,0,3,3,0,6
24821,50,7110,10766;11061;14162;14363;14709,11315,0,3,2,0,5
24822,50,7111,10778;10802;13707;14077;14432;14914,11315,0,3,3,0,6
24823,50,7112,10561;10844;14227;14538;14679;16033,11315,1,3,2,0,6
24824,50,7113,10862;10935;13693;14244;15202,11315,0,2,3,0,5
24825,50,7114,10719;10901;14582;15179,11315,0,2,2,0,4
24826,50,7115,10914;11087;13798;14084,11315,0,2,2,0,4
24827,50,7116,10777;10930;13825;14210;15407,11315,0,3,2,0,5
24828,50,7117,10775;10931;14470,11315,0,1,2,0,3
24829,50,7118,10936;11158;13597;13850;14573,11315,0,2,3,0,5
24830,50,7119,10943;11267;13554;14279;14737;15006,11315,0,3,3,0,6
24831,50,7120,10549;10974;13586;14022;14193;14598,11315,0,3,3,0,6
24832,50,7121,10810;10976;13841;14749,11315,0,2,2,0,4
24833,50,7123,10990;11007;13844;14196;15437,11315,0,3,2,0,5
24834,50,7124,11067,11315,0,0,1,0,1
24835,50,7125,11526;14215;14225;14878;15363,11315,0,4,1,0,5
24836,50,7126,11084;14425;14794;15636,11315,1,2,1,0,4
24837,50,7127,10815;11101;13988;14265,11315,0,2,2,0,4
24838,50,7128,10699;11105;14079;14484;15061,11315,0,3,2,0,5
24839,50,7129,10993;11218;14010;14724,11315,0,2,2,0,4
24840,50,7130,10969;11156;13783;14967,11315,0,1,3,0,4
24841,50,7132,11033;11179;13641;13750;14296;14512,11315,0,2,4,0,6
24842,50,7133,11186;11189;14324;15589,11315,1,1,2,0,4
24843,50,7134,11233;13579;15017,11315,0,1,2,0,3
24844,50,7135,11113;11249;13813;14474;15149,11315,0,3,2,0,5
24845,50,7136,11271;13964;14111;14637,11315,0,3,1,0,4
24846,50,7137,11013;11278;13645;13895;13962;15373,11315,0,3,3,0,6
24847,50,7140,5738;9161;13933,11680,0,1,2,0,3
24848,50,7141,3150;5549,11680,0,0,0,2,2
24849,50,7142,3276,11680,0,0,1,0,1
24850,50,7144,1158,11680,0,0,1,0,1
24851,50,7149,4515;10298;13999,11680,0,1,2,0,3
24852,50,7151,3886;4295;13897;14506,11680,0,2,2,0,4
24853,50,7154,6923,11680,0,0,0,1,1
24854,50,7158,9271,11680,0,0,0,1,1
24855,50,7159,5526;8100,11680,0,0,2,0,2
24856,50,7160,6805;9729;14571,11680,0,1,2,0,3
24857,50,7163,6620,11680,0,0,0,1,1
24858,50,7165,9316;10237;13675;14171;14969,11680,0,2,3,0,5
24859,50,7167,160;9741;14374;14715,11680,0,2,2,0,4
24860,50,7168,10125;10191;13668;13919;14322,11680,0,2,3,0,5
24861,50,7169,10356;10468;13846;14099;14429,11680,0,3,2,0,5
24862,50,7170,10148;10363;13905;14144,11680,0,2,2,0,4
24863,50,7171,10327;10496;13780;14515,11680,0,1,3,0,4
24864,50,7172,10161;10512;14115;14756,11680,0,2,2,0,4
24865,50,7173,10477;10586;14150;14934,11680,0,2,2,0,4
24866,50,7174,10509;11240;14195;14763,11680,0,2,2,0,4
24867,50,7175,10819;10835;14663;15007,11680,0,2,2,0,4
24868,50,7176,10479;10593;13931;14996;15138,11680,0,3,2,0,5
24869,50,7177,10643;10712;13765;13800;14422;14885,11680,0,3,3,0,6
24870,50,7178,10649;10973;14088;14488;14963,11680,0,3,2,0,5
24871,50,7179,10673;11222;13857;14295,11680,0,2,2,0,4
24872,50,7180,10834;11062;14159;14331;14671,11680,0,3,2,0,5
24873,50,7181,10983;11015;14492;14797;15670,11680,1,2,2,0,5
24874,50,7182,10559;10773;13916;14973,11680,0,2,2,0,4
24875,50,7183,10471;10780;14380;15551,11680,1,1,2,0,4
24876,50,7184,10786;11024;14029;14148,11680,0,2,2,0,4
24877,50,7185,10732;10869;14592;14904,11680,0,2,2,0,4
24878,50,7186,10659;10880;14216;15010;15988,11680,1,2,2,0,5
24879,50,7187,10884;13740;14027,11680,0,1,2,0,3
24880,50,7188,10945;11063;14408;14752,11680,0,2,2,0,4
24881,50,7189,10550;10938;13816;14282;14864;15435,11680,0,4,2,0,6
24882,50,7190,10451;10954;13691;14614;16146,11680,1,1,3,0,5
24883,50,7191,10964;11216;14508;15032;15846,11680,1,2,2,0,5
24884,50,7192,10994;11149;13713;14257,11680,0,1,3,0,4
24885,50,7193,10751;10982;13761;13879;14503;15026,11680,0,3,3,0,6
24886,50,7194,11040;11694;13801;14136;15152;15242;15634,11680,1,4,2,0,7
24887,50,7195,11079;11496;13676;15757,11680,1,0,3,0,4
24888,50,7196,10890;11112;14063;14490,11680,0,2,2,0,4
24889,50,7197,11049;11136;13843;15406;15692,11680,1,2,2,0,5
24890,50,7198,11586;13749;13952;14094;14685;15140;16092,11680,1,4,2,0,7
24891,50,7199,10957;11352;15214;15350;15879,11680,1,2,2,0,5
24892,50,7200,10571;10870;14641;15105,11680,0,2,2,0,4
24893,50,7201,11211;14426;14894,11680,0,2,1,0,3
24894,50,7202,11213;11369;14138;14442;14528,11680,0,3,2,0,5
24895,50,7203,11238;11692;14304;15223;15580;15752,11680,2,2,2,0,6
24896,50,7204,11242;11689;14041;14519,11680,0,2,2,0,4
24897,50,7206,11256;13808;14436,11680,0,2,1,0,3
24898,50,7207,11259;11288;14134;15052;15494,11680,1,2,2,0,5
24899,50,7208,11297;11550;14317;15724;16071,11680,2,1,2,0,5
24900,50,7209,11142;11301;14091;14542;15100;15283,11680,0,4,2,0,6
24901,50,7210,10906;11303;14015;14209;15036,11680,0,3,2,0,5
24902,50,7211,10410;11329;13670;14240;14765,11680,0,2,3,0,5
24903,50,7212,11331;11587;13855;14120;14952;15084;15380;15717,11680,1,5,2,0,8
24904,50,7213,11200;11346;13686;14095;14439;15004,11680,0,3,3,0,6
24905,50,7214,11353;11630;14123;14636,11680,0,2,2,0,4
24906,50,7215,10840;11366;13764;13877;13984;14531;15155,11680,0,4,3,0,7
24907,50,7216,11224;14460;14558,11680,0,2,1,0,3
24908,50,7217,11381;11430;13689;14863;15074,11680,0,2,3,0,5
24909,50,7218,11387;11571;15022;15446;15726,11680,1,2,2,0,5
24910,50,7220,1526;2875,12045,0,0,0,2,2
24911,50,7224,1633;3880,12045,0,0,0,2,2
24912,50,7228,1622,12045,0,0,1,0,1
24913,50,7234,2855;9750;13716;14164,12045,0,1,3,0,4
24914,50,7237,5528,12045,0,0,0,1,1
24915,50,7241,5913,12045,0,0,0,1,1
24916,50,7242,5959,12045,0,0,0,1,1
24917,50,7243,170;9838,12045,0,0,2,0,2
24918,50,7247,7315,12045,0,0,1,0,1
24919,50,7251,5980,12045,0,0,0,1,1
24920,50,7253,4523,12045,0,0,1,0,1
24921,50,7258,2775,12045,0,0,1,0,1
24922,50,7259,10263;13821;14481;14580,12045,0,3,1,0,4
24923,50,7260,10635;11002;14893;15053;15400,12045,0,3,2,0,5
24924,50,7264,10527,12045,0,0,1,0,1
24925,50,7266,10575;10614;13882;14600,12045,0,2,2,0,4
24926,50,7267,10618;11183;14364;14547;14979,12045,0,3,2,0,5
24927,50,7268,10622;10902;13900;14694;15750,12045,1,2,2,0,5
24928,50,7269,10473;10666;13804;14610;14890,12045,0,3,2,0,5
24929,50,7270,10478;10541;13811;14534,12045,0,2,2,0,4
24930,50,7271,10682;11116;13869;14500;15037,12045,0,3,2,0,5
24931,50,7273,10602;10722;14299;14389,12045,0,2,2,0,4
24932,50,7274,10651;10749;13938;14413,12045,0,2,2,0,4
24933,50,7275,10750;14213;14608,12045,0,2,1,0,3
24934,50,7276,10753;10801;14204;15266,12045,0,2,2,0,4
24935,50,7278,10803;10831;14046;14994;15235,12045,0,3,2,0,5
24936,50,7279,10809;11362;14316;14886;15027;15286;15922,12045,1,4,2,0,7
24937,50,7280,10854;11273;14199;14420;14631;14753;15596,12045,1,4,2,0,7
24938,50,7282,10514;10894;14217;14589,12045,0,2,2,0,4
24939,50,7283,10905;13793;14851;14915;15324,12045,0,4,1,0,5
24940,50,7286,10946;11206;14201;15297,12045,0,2,2,0,4
24941,50,7287,10959;11135;13866;14019;14590,12045,0,3,2,0,5
24942,50,7288,11057;14369;14654,12045,0,2,1,0,3
24943,50,7289,10997;11091;14247;14581;15302,12045,0,3,2,0,5
24944,50,7290,11016;11292;14280;15141;15679,12045,1,2,2,0,5
24945,50,7292,11074;11442;14662,12045,0,1,2,0,3
24946,50,7293,10658;11141;13820;15480,12045,1,1,2,0,4
24947,50,7294,11026;11157;14391;14891;15779,12045,1,2,2,0,5
24948,50,7295,10986;11203;14447;15142,12045,0,2,2,0,4
24949,50,7296,11205,12045,0,0,1,0,1
24950,50,7297,11208;11228;13832;14182;15573,12045,1,2,2,0,5
24951,50,7298,11209;11320;13925;14288;15139,12045,0,3,2,0,5
24952,50,7299,11232;11597;13906;14642;15150;15562,12045,1,3,2,0,6
24953,50,7300,11225;11234;13845;14525;14785;15488,12045,1,3,2,0,6
24954,50,7301,11204;11307;14303;14989;15450,12045,0,3,2,0,5
24955,50,7305,11064;11294;13922;14725;15001,12045,0,3,2,0,5
24956,50,7306,11309;11465;14309;14769;15184;15572;16182,12045,2,3,2,0,7
24957,50,7307,11328;11528;14157;15011;15902,12045,1,2,2,0,5
24958,50,7308,11773;13835;14347;14482,12045,0,3,1,0,4
24959,50,7309,11350;13915;14212;14507;14659;15059;15325;15712,12045,1,6,1,0,8
24960,50,7310,11117;11356;13951;15110,12045,0,2,2,0,4
24961,50,7311,11270;11379;14155;14875;15070,12045,0,3,2,0,5
24962,50,7312,11544;14452;14840;15334,12045,0,3,1,0,4
24963,50,7313,11751;11970;14450;15250,12045,0,2,2,0,4
24964,50,7314,11405;11457;14026;15993,12045,1,1,2,0,4
24965,50,7315,11377;11424;14549;15673,12045,1,1,2,0,4
24966,50,7316,11432;11637;13863;13967;15188;15343,12045,0,4,2,0,6
24967,50,7317,11433;11469;14294;15054;15349;15886,12045,1,3,2,0,6
24968,50,7318,11447;11478;14726;16103,12045,1,1,2,0,4
24969,50,7319,11458;11588;14759;15913,12045,1,1,2,0,4
24970,50,7320,11468;14090;16038,12045,1,1,1,0,3
24971,50,7321,11388;11481;14842;15962,12045,1,1,2,0,4
24972,50,7322,11423;11482;14375;14727;14812;15410;15485,12045,1,4,2,0,7
24973,50,7323,2975;10151;13790;15014;15323,12410,0,3,2,0,5
24974,50,7326,330;4474,12410,0,0,0,2,2
24975,50,7335,6718;8679,12410,0,0,1,1,2
24976,50,7339,4862,12410,0,0,1,0,1
24977,50,7343,7787,12410,0,0,0,1,1
24978,50,7346,3086,12410,0,0,0,1,1
24979,50,7347,6344;7121,12410,0,0,2,0,2
24980,50,7348,4142;5210,12410,0,0,0,2,2
24981,50,7352,5249;6879,12410,0,0,2,0,2
24982,50,7353,3504;7990,12410,0,0,2,0,2
24983,50,7356,5166;7051,12410,0,0,0,2,2
24984,50,7358,9412,12410,0,0,0,1,1
24985,50,7359,9957,12410,0,0,0,1,1
24986,50,7361,56;10116;14014,12410,0,1,2,0,3
24987,50,7364,10318;10401;13987;14553,12410,0,2,2,0,4
24988,50,7365,10460;10619;14092;14424;15361,12410,0,3,2,0,5
24989,50,7366,10301;10415;14419;14829,12410,0,2,2,0,4
24990,50,7367,11337;14916;15259,12410,0,2,1,0,3
24991,50,7368,10745;11310;15906;15982,12410,2,0,2,0,4
24992,50,7369,10721;10760;14782;15209;15600,12410,1,2,2,0,5
24993,50,7370,10772;11039;13983;14298;14404;14805,12410,0,4,2,0,6
24994,50,7371,10704;11207;14449;15002,12410,0,2,2,0,4
24995,50,7372,11028;11073;14463;14740;15785;16011,12410,2,2,2,0,6
24996,50,7373,10820;14475;15304,12410,0,2,1,0,3
24997,50,7376,10911;11198;15340;15631,12410,1,1,2,0,4
24998,50,7377,10612;10937;14267;14535;15700,12410,1,2,2,0,5
24999,50,7378,11223;11506;14562;15134;15432,12410,0,3,2,0,5
25000,50,7379,11020;11217;14214;14410,12410,0,2,2,0,4
25001,50,7380,11030;14599;14728,12410,0,2,1,0,3
25002,50,7381,10949;11475;14845;15162;15239,12410,0,3,2,0,5
25003,50,7382,10929;11092;14359;14400,12410,0,2,2,0,4
25004,50,7383,11269;11312;14448;14755,12410,0,2,2,0,4
25005,50,7384,11124;11467;14130;15895,12410,1,1,2,0,4
25006,50,7385,11422;14070;15865,12410,1,1,1,0,3
25007,50,7386,11181;11257;14066;14443,12410,0,2,2,0,4
25008,50,7387,11220;11376;14326;14857,12410,0,2,2,0,4
25009,50,7388,11562;11613;14467;15125,12410,0,2,2,0,4
25010,50,7389,11244;11549;14584;14699;14795;15430,12410,0,4,2,0,6
25011,50,7390,11262;11384;13949;14520,12410,0,2,2,0,4
25012,50,7391,11263;11615;14664;14911,12410,0,2,2,0,4
25013,50,7392,11003;11265;13996;14779,12410,0,2,2,0,4
25014,50,7393,11825;14185;14739,12410,0,2,1,0,3
25015,50,7394,11100;11313;14232;14692,12410,0,2,2,0,4
25016,50,7395,11327;11529;14924;15211;15424,12410,0,3,2,0,5
25017,50,7397,11412;11438;13972;15496,12410,1,1,2,0,4
25018,50,7398,11023;11306;14161;14394;14491,12410,0,3,2,0,5
25019,50,7399,10951;11436;14006;15616;15944;16188,12410,3,1,2,0,6
25020,50,7400,11287;11452;14751;14917;15326,12410,0,3,2,0,5
25021,50,7401,11382;11486;14446;15094;15205,12410,0,3,2,0,5
25022,50,7402,11497;11598;14984;15622;15942,12410,2,1,2,0,5
25023,50,7403,11493;11503;14971;15385,12410,0,2,2,0,4
25024,50,7404,11611;11809;13994;14302;14579,12410,0,3,2,0,5
25025,50,7405,11660;14128;15862,12410,1,1,1,0,3
25026,50,7407,11163;11687;14867;15271;15491;16036;16084,12410,3,2,2,0,7
25027,50,7408,11535;11589;14735;15623,12410,1,1,2,0,4
25028,50,7409,11302;11593;14418;15103;15384;15667,12410,1,3,2,0,6
25029,50,7411,2361,12775,0,0,1,0,1
25030,50,7415,3184,12775,0,0,0,1,1
25031,50,7418,2330;2360,12775,0,0,2,0,2
25032,50,7420,5449,12775,0,0,1,0,1
25033,50,7422,5974,12775,0,0,0,1,1
25034,50,7424,7039;7405,12775,0,0,2,0,2
25035,50,7425,6,12775,0,0,0,1,1
25036,50,7426,931;9572,12775,0,0,0,2,2
25037,50,7427,4229;7304,12775,0,0,2,0,2
25038,50,7429,7385,12775,0,0,1,0,1
25039,50,7430,181,12775,0,0,0,1,1
25040,50,7431,8236,12775,0,0,0,1,1
25041,50,7436,10338;14098;14278,12775,0,2,1,0,3
25042,50,7438,10302,12775,0,0,1,0,1
25043,50,7441,10470;10566;14770;15182,12775,0,2,2,0,4
25044,50,7445,10433;10652;14116;14338;14415,12775,0,3,2,0,5
25045,50,7446,10346;10663;14097;14533;15429,12775,0,3,2,0,5
25046,50,7447,10737;10886;14205;14697,12775,0,2,2,0,4
25047,50,7449,10406;10660;14286;14383;14648;14796;15025;15376,12775,0,6,2,0,8
25048,50,7450,11081;11236;14373;14723;16050,12775,1,2,2,0,5
25049,50,7451,11008;11266;14221;14964,12775,0,2,2,0,4
25050,50,7452,11032;11428;14352;14826;14902;15574;15967,12775,2,3,2,0,7
25051,50,7453,10980;11160;14173;14423;15082,12775,0,3,2,0,5
25052,50,7454,11085;11214;14532;14861;14982,12775,0,3,2,0,5
25053,50,7455,11090;11283;14124;15229,12775,0,2,2,0,4
25054,50,7456,10852;11107;14156;14639;15111,12775,0,3,2,0,5
25055,50,7457,11108;11563;14879;15827,12775,1,1,2,0,4
25056,50,7458,11021;11134;14180;14281;14788,12775,0,3,2,0,5
25057,50,7459,11138;11143;14276;15068,12775,0,2,2,0,4
25058,50,7461,11210;11902;14251;15591,12775,1,1,2,0,4
25059,50,7462,11253;11448;14766;15392,12775,0,2,2,0,4
25060,50,7464,11199;11272;14181;15165,12775,0,2,2,0,4
25061,50,7465,11654;11759;14112;14441;14844,12775,0,3,2,0,5
25062,50,7466,11096;11461;14646;15566;15767,12775,2,1,2,0,5
25063,50,7467,11901;14127,12775,0,1,1,0,2
25064,50,7468,11345;11639;14139;14231;14583;15016,12775,0,4,2,0,6
25065,50,7469,11361;11693;14137;14348;14554;14974,12775,0,4,2,0,6
25066,50,7470,11619;11813;14340;14543;15300,12775,0,3,2,0,5
25067,50,7471,11380;11920;14083;14652;15459,12775,0,3,2,0,5
25068,50,7472,11397;11522;14121;14938,12775,0,2,2,0,4
25069,50,7473,11370;11651;14290;16003,12775,1,1,2,0,4
25070,50,7474,11399;14194;15789,12775,1,1,1,0,3
25071,50,7475,11404;11969;15601,12775,1,0,2,0,3
25072,50,7476,11386;11411;14841;15763,12775,1,1,2,0,4
25073,50,7477,11252;11431;14669;15312;15464,12775,0,3,2,0,5
25074,50,7478,11928;14502,12775,0,1,1,0,2
25075,50,7479,11454;11662;14645;15164;15217,12775,0,3,2,0,5
25076,50,7480,11488;11500;14526;14762,12775,0,2,2,0,4
25077,50,7482,11505;11509;14557;15595;15772,12775,2,1,2,0,5
25078,50,7483,11255;11510;14301;14733;15404;15536,12775,1,3,2,0,6
25079,50,7484,11511;11707;14903;15481;15674;15756,12775,3,1,2,0,6
25080,50,7485,11514;12025;14888;15389;15557;15731,12775,2,2,2,0,6
25081,50,7486,11330;11614;14145;15527,12775,1,1,2,0,4
25082,50,7487,11741;14192;14540;14931,12775,0,3,1,0,4
25083,50,7488,11538;11832;14186;15163;15820,12775,1,2,2,0,5
25084,50,7489,11360;11640;14486;15522,12775,1,1,2,0,4
25085,50,7490,11670;11804;14109;15946,12775,1,1,2,0,4
25086,50,7491,11581;11683;14965;15098;15381,12775,0,3,2,0,5
25087,50,7495,2967,13140,0,0,0,1,1
25088,50,7496,1352,13140,0,0,0,1,1
25089,50,7497,7920,13140,0,0,0,1,1
25090,50,7498,5087;6637,13140,0,0,0,2,2
25091,50,7499,6875,13140,0,0,1,0,1
25092,50,7500,488,13140,0,0,0,1,1
25093,50,7501,8014,13140,0,0,0,1,1
25094,50,7505,1515;2342,13140,0,0,0,2,2
25095,50,7509,1586,13140,0,0,0,1,1
25096,50,7511,10087;10343;14222;14774,13140,0,2,2,0,4
25097,50,7512,218,13140,0,0,1,0,1
25098,50,7518,10689;14289;14518;14940,13140,0,3,1,0,4
25099,50,7519,10525;11044;14746;14830,13140,0,2,2,0,4
25100,50,7520,10680;10876;15076;15422,13140,0,2,2,0,4
25101,50,7522,10667;11071;14711;14898;15267,13140,0,3,2,0,5
25102,50,7523,10863;11182;14264;15652;16140,13140,2,1,2,0,5
25103,50,7524,10607;10708;14399;15222,13140,0,2,2,0,4
25104,50,7525,10740;14274;14674,13140,0,2,1,0,3
25105,50,7526,11011,13140,0,0,1,0,1
25106,50,7527,10830;10837;14978,13140,0,1,2,0,3
25107,50,7529,10920;10941;14256;14818,13140,0,2,2,0,4
25108,50,7530,11014;11190;14517;14701,13140,0,2,2,0,4
25109,50,7531,11022;11151;14405;14816,13140,0,2,2,0,4
25110,50,7532,11031;11226;14665;14908,13140,0,2,2,0,4
25111,50,7534,11078;11443;14462;14587;14929;16049,13140,1,3,2,0,6
25112,50,7535,11161;11425;14284;15072;15278;16040,13140,1,3,2,0,6
25113,50,7536,11167;11407;14320;15620,13140,1,1,2,0,4
25114,50,7537,11173;11684;14411;15552;15654,13140,2,1,2,0,5
25115,50,7538,11176;14262;14621;14822,13140,0,3,1,0,4
25116,50,7539,11038;11180;14226;14661;14962;15483;15804,13140,2,3,2,0,7
25117,50,7540,11201;11479;14862;16190,13140,1,1,2,0,4
25118,50,7541,11254;11752;15279;15514;15810,13140,2,1,2,0,5
25119,50,7542,11237;11290;14696;14781;15434,13140,0,3,2,0,5
25120,50,7543,11291;11498;14629;15335;15371,13140,0,3,2,0,5
25121,50,7544,11042;11311;14228;14615;14856,13140,0,3,2,0,5
25122,50,7545,11097;11123;14817;15443,13140,0,2,2,0,4
25123,50,7546,10962;11341;14381;14957,13140,0,2,2,0,4
25124,50,7547,11358,13140,0,0,1,0,1
25125,50,7548,11420;11889;14305;14907,13140,0,2,2,0,4
25126,50,7550,11464;11652;14349;14936;15538,13140,1,2,2,0,5
25127,50,7551,11466;11480;14511;15821,13140,1,1,2,0,4
25128,50,7552,11625;11879;14249;14776;15746,13140,1,2,2,0,5
25129,50,7553,11017;11504;14736;15521,13140,1,1,2,0,4
25130,50,7554,11507;11672;14414;14919;15477;15989,13140,1,3,2,0,6
25131,50,7555,11512;15008;15889,13140,1,1,1,0,3
25132,50,7556,11547;12003;15023;15240;15630;15920,13140,2,2,2,0,6
25133,50,7557,11551;11980;14366,13140,0,1,2,0,3
25134,50,7558,11351;11559;14234;15586,13140,1,1,2,0,4
25135,50,7559,11567;11938;14245;14529;14809;15475,13140,0,4,2,0,6
25136,50,7560,11414;11579;14921;15465;16174,13140,1,2,2,0,5
25137,50,7561,11595;14793;15093;15457,13140,0,3,1,0,4
25138,50,7562,11446;11616;14604;15020;15684,13140,1,2,2,0,5
25139,50,7563,11803;12068;15749;16027,13140,2,0,2,0,4
25140,50,7564,11304;11721;14237;14943;15375,13140,0,3,2,0,5
25141,50,7565,11657;14263;14792;15181,13140,0,3,1,0,4
25142,50,7567,11691;11700;14509;15121;15853,13140,1,2,2,0,5
25143,50,7568,11711;12086;14777;15234;15511;15994,13140,2,2,2,0,6
25144,50,7569,11712;11887;14242;15658;15799,13140,2,1,2,0,5
25145,50,7570,11650;11742;14235;15178,13140,0,2,2,0,4
25146,50,7571,11763;11878;15254,13140,0,1,2,0,3
25147,50,7572,11713;11783;14329;14657;15005;15612,13140,1,3,2,0,6
25148,50,7573,11665;11800;14308;15455;15758,13140,1,2,2,0,5
25149,50,7578,1655,13505,0,0,0,1,1
25150,50,7580,2176,13505,0,0,1,0,1
25151,50,7581,871,13505,0,0,0,1,1
25152,50,7585,7391,13505,0,0,1,0,1
25153,50,7588,1901,13505,0,0,0,1,1
25154,50,7589,6936;7216,13505,0,0,0,2,2
25155,50,7590,3351;5504,13505,0,0,0,2,2
25156,50,7598,1653;9818,13505,0,0,2,0,2
25157,50,7600,8747,13505,0,0,0,1,1
25158,50,7601,9431,13505,0,0,0,1,1
25159,50,7602,8757;9214,13505,0,0,0,2,2
25160,50,7607,10172;10387;15092;15231,13505,0,2,2,0,4
25161,50,7608,10273;10653;14522;14814;14913,13505,0,3,2,0,5
25162,50,7613,10520,13505,0,0,1,0,1
25163,50,7615,11115;14444;14784;15687,13505,1,2,1,0,4
25164,50,7616,10518,13505,0,0,1,0,1
25165,50,7617,10686;10725;14682;15797,13505,1,1,2,0,4
25166,50,7618,10724,13505,0,0,1,0,1
25167,50,7619,10726;11364;14722;14887,13505,0,2,2,0,4
25168,50,7620,10768,13505,0,0,1,0,1
25169,50,7621,10814;10952;14466;14883,13505,0,2,2,0,4
25170,50,7624,11139;11795;15066;15829;16017,13505,2,1,2,0,5
25171,50,7625,10882;11239;14367;15200;16154,13505,1,2,2,0,5
25172,50,7626,11317;11760;14607;15166;15925,13505,1,2,2,0,5
25173,50,7627,11354;11703;15362;15971,13505,1,1,2,0,4
25174,50,7628,11419;11863;15342,13505,0,1,2,0,3
25175,50,7629,11421;11585;14377;14706;14976;15388,13505,0,4,2,0,6
25176,50,7630,11426;11788;14437;15313;16112,13505,1,2,2,0,5
25177,50,7631,11363;11439;14948;15682,13505,1,1,2,0,4
25178,50,7632,11440;11935;14705;15203;15500;15741,13505,2,2,2,0,6
25179,50,7633,11576;11666;14406;15607,13505,1,1,2,0,4
25180,50,7634,11848;15320;15975,13505,1,1,1,0,3
25181,50,7635,11456;11471;14670,13505,0,1,2,0,3
25182,50,7636,11473;12053;14732;15733;15965,13505,2,1,2,0,5
25183,50,7637,11474;11491;14734;14869;15042,13505,0,3,2,0,5
25184,50,7638,11476;11638;14628;15347,13505,0,2,2,0,4
25185,50,7639,11485;11492;15038;16161,13505,1,1,2,0,4
25186,50,7640,11523;11842;14570;15848,13505,1,1,2,0,4
25187,50,7641,11094;11357;15351;15633,13505,1,1,2,0,4
25188,50,7642,11599;11796;14388;15257;15806,13505,1,2,2,0,5
25189,50,7643,11608;11876;14850;15108;15292,13505,0,3,2,0,5
25190,50,7644,11621;12111;14433;15357,13505,0,2,2,0,4
25191,50,7645,11817;15177,13505,0,1,1,0,2
25192,50,7646,11489;11644;14773;15456;15560,13505,1,2,2,0,5
25193,50,7647,11886;14516;15233,13505,0,2,1,0,3
25194,50,7648,12000;14485;15095;15462;15608,13505,1,3,1,0,5
25195,50,7649,12017;12069;14632;15046,13505,0,2,2,0,4
25196,50,7650,11714;12087;14384;14683;14930;15396,13505,0,4,2,0,6
25197,50,7651,11727;11877;14870;15832,13505,1,1,2,0,4
25198,50,7652,11470;11734;14435;16035,13505,1,1,2,0,4
25199,50,7653,11750;12274;14813;15174;15641;15831,13505,2,2,2,0,6
25200,50,7654,11762;11778;14431;14591,13505,0,2,2,0,4
25201,50,7655,11769;11810;14617;14926;15893,13505,1,2,2,0,5
25202,50,7656,11771;12023;14397;16093,13505,1,1,2,0,4
25203,50,7657,12135;14680;15135;15241,13505,0,3,1,0,4
25204,50,7658,11656;11808;14858;15187;15379,13505,0,3,2,0,5
25205,50,7659,11584;11815;14376,13505,0,1,2,0,3
25206,50,7660,11833;11999;14820;15694;16019,13505,2,1,2,0,5
25207,50,7661,11834;14459;15327,13505,0,2,1,0,3
25208,50,7662,11410;11840;14496;14718,13505,0,2,2,0,4
25209,50,7663,11855;11981;14677;16151,13505,1,1,2,0,4
25210,50,7664,11868;12175;15314,13505,0,1,2,0,3
25211,50,7665,12029;14823;14920;15131;15816,13505,1,3,1,0,5
25212,50,7666,11883;12067;14378;15472;16002,13505,1,2,2,0,5
25213,50,7667,11545;11966;15264,13505,0,1,2,0,3
25214,50,7672,6275;14838,13870,0,1,1,0,2
25215,50,7673,9639,13870,0,0,1,0,1
25216,50,7677,2385,13870,0,0,0,1,1
25217,50,7682,5390;5710,13870,0,0,2,0,2
25218,50,7683,4456,13870,0,0,1,0,1
25219,50,7689,5698,13870,0,0,1,0,1
25220,50,7691,5787,13870,0,0,1,0,1
25221,50,7692,6947;7382,13870,0,0,0,2,2
25222,50,7693,1889;7036,13870,0,0,1,1,2
25223,50,7694,13,13870,0,0,1,0,1
25224,50,7695,3872,13870,0,0,0,1,1
25225,50,7698,348,13870,0,0,0,1,1
25226,50,7699,2369,13870,0,0,1,0,1
25227,50,7700,952;8718,13870,0,0,0,2,2
25228,50,7702,1883,13870,0,0,1,0,1
25229,50,7703,10261;10856;14666;14922;15419;16031,13870,1,3,2,0,6
25230,50,7704,10422;10552;14568;14901,13870,0,2,2,0,4
25231,50,7706,10963;14494;14954;15512,13870,1,2,1,0,4
25232,50,7707,10900;11065;14768;15227,13870,0,2,2,0,4
25233,50,7708,10162;10715;14550;15085,13870,0,2,2,0,4
25234,50,7711,10335;10829;14624;15128,13870,0,2,2,0,4
25235,50,7712,10978;11557;15173;15517;15825,13870,2,1,2,0,5
25236,50,7713,10855;14668;15317;15648,13870,1,2,1,0,4
25237,50,7716,10444;11075;14644;14874;15489,13870,1,2,2,0,5
25238,50,7717,11336;11632;15057;16032,13870,1,1,2,0,4
25239,50,7718,10965,13870,0,0,1,0,1
25240,50,7719,11114;11963;15417;15730,13870,1,1,2,0,4
25241,50,7720,11230;11402;15115;15508;15659,13870,2,1,2,0,5
25242,50,7721,11127;11245;14566;15031,13870,0,2,2,0,4
25243,50,7722,11286;11737;15040,13870,0,1,2,0,3
25244,50,7723,11001;11171;15090;15656;16135,13870,2,1,2,0,5
25245,50,7724,11300,13870,0,0,1,0,1
25246,50,7725,11427;11618;14977;15564,13870,1,1,2,0,4
25247,50,7726,11314;14563;14892;15927,13870,1,2,1,0,4
25248,50,7727,11338;11607;14655;14889;15583;15604,13870,2,2,2,0,6
25249,50,7728,11355;11385;14504;14847;16123,13870,1,2,2,0,5
25250,50,7729,11568;11609;14611;16132,13870,1,1,2,0,4
25251,50,7730,11403;11729;15077;15206;16015,13870,1,2,2,0,5
25252,50,7731,11499;14789;15288;15454;16041,13870,1,3,1,0,5
25253,50,7732,11674;11996;14876;15792,13870,1,1,2,0,4
25254,50,7733,11524;14634;14853;15418,13870,0,3,1,0,4
25255,50,7734,11530;11914;15056,13870,0,1,2,0,3
25256,50,7735,11592;11628;14949;16022,13870,1,1,2,0,4
25257,50,7736,11594;11728;15285;15565;16062,13870,2,1,2,0,5
25258,50,7737,11606;12085;14882;15624,13870,1,1,2,0,4
25259,50,7738,11641;11821;14603;15828,13870,1,1,2,0,4
25260,50,7739,11645;11731;14747;15809,13870,1,1,2,0,4
25261,50,7740,11658;11667;14806;15530,13870,1,1,2,0,4
25262,50,7741,11417;11679;14675;14927;16056,13870,1,2,2,0,5
25263,50,7742,11532;11690;14597;15691,13870,1,1,2,0,4
25264,50,7743,11321;11697;14786;15316;15721,13870,1,2,2,0,5
25265,50,7744,11701;11792;14798;14925;15191;15504,13870,1,3,2,0,6
25266,50,7745,11732;12042;15161;15332;16107,13870,1,2,2,0,5
25267,50,7746,11739;11775;14992;16163,13870,1,1,2,0,4
25268,50,7747,11779;14819;15336;15771,13870,1,2,1,0,4
25269,50,7748,11770;12302;15727,13870,1,0,2,0,3
25270,50,7749,11806;12114;14524;15416,13870,0,2,2,0,4
25271,50,7750,11743;14536;15153,13870,0,2,1,0,3
25272,50,7751,11764;11924;14656,13870,0,1,2,0,3
25273,50,7752,11843;12019;14601;15265,13870,0,2,2,0,4
25274,50,7753,11850;11869;14501;15172;15253;16048,13870,1,3,2,0,6
25275,50,7754,11856;12204;14638;14905;15999,13870,1,2,2,0,5
25276,50,7755,11709;11835;14541;14693;15220,13870,0,3,2,0,5
25277,50,7756,11881;14980;15168;16114,13870,1,2,1,0,4
25278,50,7757,11704;14602;16054,13870,1,1,1,0,3
25279,50,7758,11661;11906;15160;15919,13870,1,1,2,0,4
25280,50,7759,12203;14714;14939;15921,13870,1,2,1,0,4
25281,50,7760,11930;12014;14527,13870,0,1,2,0,3
25282,50,7761,11940;12043;15230;15570,13870,1,1,2,0,4
25283,50,7762,11566;11941;15126,13870,0,1,2,0,3
25284,50,7763,11819;11945;14622;15039;15353;15484,13870,1,3,2,0,6
25285,50,7764,11997;12308;15531;15884,13870,2,0,2,0,4
25286,50,7765,11699;12011;14944;15542,13870,1,1,2,0,4
25287,50,7766,12015;12098;15926,13870,1,0,2,0,3
25288,50,7767,65;3849,14235,0,0,0,2,2
25289,50,7768,326;7141,14235,0,0,0,2,2
25290,50,7772,5962;8854,14235,0,0,2,0,2
25291,50,7775,2366,14235,0,0,0,1,1
25292,50,7776,2865,14235,0,0,1,0,1
25293,50,7777,2203;3151,14235,0,0,0,2,2
25294,50,7781,5244,14235,0,0,1,0,1
25295,50,7785,6022,14235,0,0,0,1,1
25296,50,7786,898,14235,0,0,1,0,1
25297,50,7787,6098;6761,14235,0,0,0,2,2
25298,50,7788,7819,14235,0,0,0,1,1
25299,50,7789,6054,14235,0,0,1,0,1
25300,50,7793,8040,14235,0,0,1,0,1
25301,50,7794,8187,14235,0,0,0,1,1
25302,50,7796,9420,14235,0,0,1,0,1
25303,50,7798,2247;9740,14235,0,0,2,0,2
25304,50,7799,10129;14684,14235,0,1,1,0,2
25305,50,7805,10492,14235,0,0,1,0,1
25306,50,7807,10581;10746;14703;14860,14235,0,2,2,0,4
25307,50,7808,10691;11106;14717;15567,14235,1,1,2,0,4
25308,50,7809,10522,14235,0,0,1,0,1
25309,50,7810,10913;15064;15219;15366,14235,0,3,1,0,4
25310,50,7812,10706;10939;14897;15035,14235,0,2,2,0,4
25311,50,7813,10923;11221;14742;14955,14235,0,2,2,0,4
25312,50,7814,10174;10774;15078;15781,14235,1,1,2,0,4
25313,50,7816,10781;11129;14827;15255,14235,0,2,2,0,4
25314,50,7817,11140;11463;14880;15734,14235,1,1,2,0,4
25315,50,7819,11191;14754;15330,14235,0,2,1,0,3
25316,50,7820,11215;11450;14653;15685,14235,1,1,2,0,4
25317,50,7821,11164;11285;14791;15096;15441,14235,0,3,2,0,5
25318,50,7822,11322;11484;14988;15968,14235,1,1,2,0,4
25319,50,7823,11325;12052;15136;15390;15513,14235,1,2,2,0,5
25320,50,7824,11340;11591;14832;14985;15273;15543,14235,1,3,2,0,6
25321,50,7825,10757;11342;14811;14895;15867,14235,1,2,2,0,5
25322,50,7826,11250;11371;14833;15198;15776,14235,1,2,2,0,5
25323,50,7827,11401;11449;14801;15213;15411,14235,0,3,2,0,5
25324,50,7828,11565;11574;15346;15751,14235,1,1,2,0,4
25325,50,7829,11169;11513;14981;15269;15553;15678,14235,2,2,2,0,6
25326,50,7830,11069;11373;14704;14848,14235,0,2,2,0,4
25327,50,7831,11910;11911;14824;15208;16028,14235,1,2,2,0,5
25328,50,7832,11648;12137;15436;15905,14235,1,1,2,0,4
25329,50,7833,12076;12234;14687;14951,14235,0,2,2,0,4
25330,50,7834,11993;15506,14235,1,0,1,0,2
25331,50,7835,11716;12326;14825;14896;16039,14235,1,2,2,0,5
25332,50,7836,11719;11965;15729;16121,14235,2,0,2,0,4
25333,50,7837,11726,14235,0,0,1,0,1
25334,50,7838,11907;12424;14975;15467;15808,14235,1,2,2,0,5
25335,50,7839,11755;12144;15364;15856;16193,14235,2,1,2,0,5
25336,50,7840,11761;11913;15370,14235,0,1,2,0,3
25337,50,7841,11772;11900;15409;15880;16045,14235,2,1,2,0,5
25338,50,7842,11776;12008;15216,14235,0,1,2,0,3
25339,50,7843,11437;11799;15048;15992,14235,1,1,2,0,4
25340,50,7844,11874;12142;14968;15677,14235,1,1,2,0,4
25341,50,7845,11836;12126;15147,14235,0,1,2,0,3
25342,50,7846,11860;12357;14808;15190,14235,0,2,2,0,4
25343,50,7847,11957;12105;15463;15871,14235,1,1,2,0,4
25344,50,7848,11845;11971;14716;15605;15976,14235,2,1,2,0,5
25345,50,7849,11894;11975;15773,14235,1,0,2,0,3
25346,50,7850,11976;12279;14713;15374;15644,14235,1,2,2,0,5
25347,50,7851,11990;12331;14828;15116,14235,0,2,2,0,4
25348,50,7852,12009;12223;14923;15415;16079,14235,1,2,2,0,5
25349,50,7853,12018;12272;15367;15833,14235,1,1,2,0,4
25350,50,7854,12151;14686;14846,14235,0,2,1,0,3
25351,50,7855,12149;15697;15858,14235,2,0,1,0,3
25352,50,7857,12073;12305;16052,14235,1,0,2,0,3
25353,50,7858,12012;12075;15398;15482;15875,14235,2,1,2,0,5
25354,50,7859,12208;15281,14235,0,1,1,0,2
25355,50,7860,11560;12117;14987;15120;15277,14235,0,3,2,0,5
25356,50,7861,9648,14600,0,0,0,1,1
25357,50,7867,1535,14600,0,0,0,1,1
25358,50,7868,6625,14600,0,0,0,1,1
25359,50,7869,3401,14600,0,0,1,0,1
25360,50,7870,3406,14600,0,0,0,1,1
25361,50,7871,8214,14600,0,0,0,1,1
25362,50,7874,6169,14600,0,0,0,1,1
25363,50,7876,2291,14600,0,0,0,1,1
25364,50,7877,939,14600,0,0,0,1,1
25365,50,7878,6823,14600,0,0,1,0,1
25366,50,7879,8473,14600,0,0,1,0,1
25367,50,7880,5703,14600,0,0,0,1,1
25368,50,7881,9467,14600,0,0,1,0,1
25369,50,7884,10110,14600,0,0,1,0,1
25370,50,7887,10200;15470,14600,0,1,1,0,2
25371,50,7892,10599,14600,0,0,1,0,1
25372,50,7895,10846;10877,14600,0,0,2,0,2
25373,50,7896,10910;11383;14843;15029,14600,0,2,2,0,4
25374,50,7898,11027;11494;14855;15403,14600,0,2,2,0,4
25375,50,7901,10956;11196;14790;14932,14600,0,2,2,0,4
25376,50,7902,10828;11046;15114;15245;15903,14600,1,2,2,0,5
25377,50,7903,11121,14600,0,0,1,0,1
25378,50,7904,11348;11668;14859;15089;15442,14600,0,3,2,0,5
25379,50,7905,11289;11365;14839;15063;16191,14600,1,2,2,0,5
25380,50,7908,11396;11434;14868;15585;15701,14600,2,1,2,0,5
25381,50,7909,11275;11400;15777,14600,1,0,2,0,3
25382,50,7910,11487;11531;14787;15280;15556,14600,1,2,2,0,5
25383,50,7911,11525,14600,0,0,1,0,1
25384,50,7912,11590;11664;14997;15524;15766,14600,2,1,2,0,5
25385,50,7913,11596;11838;15365;16037,14600,1,1,2,0,4
25386,50,7914,11708;15097;15466,14600,0,2,1,0,3
25387,50,7915,11561;11675;15331;15754,14600,1,1,2,0,4
25388,50,7916,11718;15129;15823;16067,14600,2,1,1,0,4
25389,50,7918,11740;11927;16073,14600,1,0,2,0,3
25390,50,7919,11745;12196;14958;15212,14600,0,2,2,0,4
25391,50,7920,11831;12378;14834;15248,14600,0,2,2,0,4
25392,50,7921,11841;12340;15344;15655,14600,1,1,2,0,4
25393,50,7922,11416;11849;14928;16158,14600,1,1,2,0,4
25394,50,7923,12022;14771;15427;15665,14600,1,2,1,0,4
25395,50,7924,11368;11896;15414;15705,14600,1,1,2,0,4
25396,50,7925,11955;12167;15568;16006,14600,2,0,2,0,4
25397,50,7926,11964;12040;15201;15420,14600,0,2,2,0,4
25398,50,7928,11967;12314;15987,14600,1,0,2,0,3
25399,50,7929,12489;15933,14600,1,0,1,0,2
25400,50,7930,12001;15113;15711,14600,1,1,1,0,3
25401,50,7931,12161;16152,14600,1,0,1,0,2
25402,50,7932,11880;12031;14764;15047;15433;15803,14600,1,3,2,0,6
25403,50,7933,12063;12202;15159;15614;15770,14600,2,1,2,0,5
25404,50,7934,12089;12100;14960;15133;15874,14600,1,2,2,0,5
25405,50,7935,11884;12091;15525;16184,14600,2,0,2,0,4
25406,50,7936,12013;12092;15765;16094,14600,2,0,2,0,4
25407,50,7937,12093;12165;15864,14600,1,0,2,0,3
25408,50,7938,12109;12464;15088,14600,0,1,2,0,3
25409,50,7939,12115;12462,14600,0,0,2,0,2
25410,50,7940,11929;12116;15318;15451;15688,14600,1,2,2,0,5
25411,50,7941,11805;12128;15590;15686;15869,14600,3,0,2,0,5
25412,50,7942,12140;12147;15668;15877,14600,2,0,2,0,4
25413,50,7943,12150;12183;14909;15112,14600,0,2,2,0,4
25414,50,7944,11933;12155;14778;15176;15550,14600,1,2,2,0,5
25415,50,7945,12166;12449;15146;15546,14600,1,1,2,0,4
25416,50,7946,11798;12141;15372;15930,14600,1,1,2,0,4
25417,50,7947,11757;12230;15855,14600,1,0,2,0,3
25418,50,7948,11946;12233;15315;15402,14600,0,2,2,0,4
25419,50,7949,12120;12240;15638,14600,1,0,2,0,3
25420,50,7950,12554;14757;15719,14600,1,1,1,0,3
25421,50,7955,2979,14965,0,0,1,0,1
25422,50,7960,5432;7191,14965,0,0,0,2,2
25423,50,7961,8226,14965,0,0,0,1,1
25424,50,7962,6490,14965,0,0,1,0,1
25425,50,7963,6602;9351,14965,0,0,0,2,2
25426,50,7967,413;6819,14965,0,0,0,2,2
25427,50,7968,430;5970,14965,0,0,0,2,2
25428,50,7969,8799,14965,0,0,1,0,1
25429,50,7971,1525,14965,0,0,0,1,1
25430,50,7972,9782,14965,0,0,1,0,1
25431,50,7975,9573,14965,0,0,0,1,1
25432,50,7977,10317,14965,0,0,1,0,1
25433,50,7984,10574;10710;15124;15395,14965,0,2,2,0,4
25434,50,7986,10874;10908;15055;15258;15709,14965,1,2,2,0,5
25435,50,7987,11394;14933;15263;16175,14965,1,2,1,0,4
25436,50,7989,10813;11076;14881;15033,14965,0,2,2,0,4
25437,50,7990,11536;15087;15547,14965,1,1,1,0,3
25438,50,7992,11435;11710;15195;15528,14965,1,1,2,0,4
25439,50,7993,11539;11573;14910;15931,14965,1,1,2,0,4
25440,50,7994,11564;11604;15075;15890,14965,1,1,2,0,4
25441,50,7995,11553;11631;15158;15399,14965,0,2,2,0,4
25442,50,7996,11633;12239;15337;15811;16116,14965,2,1,2,0,5
25443,50,7997,11864;15294;15986,14965,1,1,1,0,3
25444,50,7998,11893;11943;15107;16122,14965,1,1,2,0,4
25445,50,7999,11612;11724;15196;16096,14965,1,1,2,0,4
25446,50,8000,11780;12317;15896;16100,14965,2,0,2,0,4
25447,50,8001,11534;11801;15003;15863;16025,14965,2,1,2,0,5
25448,50,8002,11858;12493;14993;15813;16005,14965,2,1,2,0,5
25449,50,8003,11871;12730;15099;15354;16023,14965,1,2,2,0,5
25450,50,8004,11847;11903;15391,14965,0,1,2,0,3
25451,50,8005,11882;12125;15393;16008,14965,1,1,2,0,4
25452,50,8006,11753;11961;15119;15928,14965,1,1,2,0,4
25453,50,8007,11973;15199,14965,0,1,1,0,2
25454,50,8008,11983;12097;15507,14965,1,0,2,0,3
25455,50,8009,11985;12162;15535;16144,14965,2,0,2,0,4
25456,50,8010,12107;12158;15274;15755,14965,1,1,2,0,4
25457,50,8011,12027;12131;15594;15660;16185,14965,3,0,2,0,5
25458,50,8012,12207;12459;15169;15689,14965,1,1,2,0,4
25459,50,8013,12178;12217;15588,14965,1,0,2,0,3
25460,50,8014,12103;12221;15144;16012,14965,1,1,2,0,4
25461,50,8015,12226;12353;15852;16172,14965,2,0,2,0,4
25462,50,8016,12256;12396;15310;15775,14965,1,1,2,0,4
25463,50,8017,12264;12344;14991;15272;15657;15984;16069,14965,3,2,2,0,7
25464,50,8018,12271;12629;15197;15791,14965,1,1,2,0,4
25465,50,8019,12286;12603;14961;15262,14965,0,2,2,0,4
25466,50,8020,12490;12665;14937;15359;15716,14965,1,2,2,0,5
25467,50,8021,12325;12596;14945;15226;15782,14965,1,2,2,0,5
25468,50,8022,12218;16171,14965,1,0,1,0,2
25469,50,8023,12330;12440;14935;15246;15932,14965,1,2,2,0,5
25470,50,8024,12225;12648,14965,0,0,2,0,2
25471,50,8025,12349,14965,0,0,1,0,1
25472,50,8026,12352;12370;14872;15117,14965,0,2,2,0,4
25473,50,8027,12303;12355;15091;15204,14965,0,2,2,0,4
25474,50,8028,3450,15330,0,0,0,1,1
25475,50,8029,686,15330,0,0,0,1,1
25476,50,8030,1230,15330,0,0,0,1,1
25477,50,8031,2339;10414;14912;15175,15330,0,2,2,0,4
25478,50,8032,2350;3140,15330,0,0,0,2,2
25479,50,8034,3239,15330,0,0,0,1,1
25480,50,8035,205,15330,0,0,0,1,1
25481,50,8036,706,15330,0,0,0,1,1
25482,50,8037,3566,15330,0,0,0,1,1
25483,50,8039,7723,15330,0,0,1,0,1
25484,50,8040,2805,15330,0,0,0,1,1
25485,50,8041,3374,15330,0,0,0,1,1
25486,50,8042,5330;7119,15330,0,0,0,2,2
25487,50,8043,7722,15330,0,0,0,1,1
25488,50,8045,6101,15330,0,0,1,0,1
25489,50,8046,8756;9843,15330,0,0,0,2,2
25490,50,8049,5661;6481,15330,0,0,0,2,2
25491,50,8053,5716,15330,0,0,0,1,1
25492,50,8054,57,15330,0,0,1,0,1
25493,50,8057,10015,15330,0,0,1,0,1
25494,50,8061,10416;10858;15051;15378,15330,0,2,2,0,4
25495,50,8063,10608,15330,0,0,1,0,1
25496,50,8064,10634;10655;15081;15397,15330,0,2,2,0,4
25497,50,8067,10767,15330,0,0,1,0,1
25498,50,8068,10765;10865,15330,0,0,2,0,2
25499,50,8069,10733;10940;15034;15401,15330,0,2,2,0,4
25500,50,8071,10998;11193;15104;15476;15554,15330,1,2,2,0,5
25501,50,8072,10860;11166;15086;15537,15330,1,1,2,0,4
25502,50,8073,11569;11653;15237;16085,15330,1,1,2,0,4
25503,50,8075,11349;11663;15309;15970,15330,1,1,2,0,4
25504,50,8076,11367;12146;15228,15330,0,1,2,0,3
25505,50,8077,11390;11521;15157;15753,15330,1,1,2,0,4
25506,50,8078,11408;11823;15218;15649;16046,15330,2,1,2,0,5
25507,50,8079,11153;11418;15065;15901,15330,1,1,2,0,4
25508,50,8080,10918;11490;15127,15330,0,1,2,0,3
25509,50,8081,11445;11829;15251;15708,15330,1,1,2,0,4
25510,50,8082,12044;15118;15244,15330,0,2,1,0,3
25511,50,8083,11260;11575;15069;15498;15850,15330,2,1,2,0,5
25512,50,8084,11610;12219;15474,15330,0,1,2,0,3
25513,50,8085,11315;11659;15154;15888,15330,1,1,2,0,4
25514,50,8086,11685;11915;15102;15882,15330,1,1,2,0,4
25515,50,8087,11472;11705;15186;15425;15610,15330,1,2,2,0,5
25516,50,8088,11247;11785;15329,15330,0,1,2,0,3
25517,50,8089,11818;12254;15322;15545;16055,15330,2,1,2,0,5
25518,50,8090,11844;11968;15171;15621,15330,1,1,2,0,4
25519,50,8091,11846;12048;15629,15330,1,0,2,0,3
25520,50,8092,11359;11558;15024;15192;15759,15330,1,2,2,0,5
25521,50,8094,11895;11908;15080;15468,15330,0,2,2,0,4
25522,50,8095,11921,15330,0,0,1,0,1
25523,50,8096,11937;15737,15330,1,0,1,0,2
25524,50,8097,11948;12403,15330,0,0,2,0,2
25525,50,8098,11952;15695,15330,1,0,1,0,2
25526,50,8099,11828;11958;15699;16156,15330,2,0,2,0,4
25527,50,8100,12323;15305;15510,15330,1,1,1,0,3
25528,50,8101,12028;12415;15386;15778,15330,1,1,2,0,4
25529,50,8102,11932;12278;15469;15609;16129,15330,2,1,2,0,5
25530,50,8103,12050;15830,15330,1,0,1,0,2
25531,50,8104,12060;12423;15044;15243,15330,0,2,2,0,4
25532,50,8105,11816,15330,0,0,1,0,1
25533,50,8106,12171;12488;15148;16043,15330,1,1,2,0,4
25534,50,8107,12176;12266;15807,15330,1,0,2,0,3
25535,50,8108,11888;12182;15582;16066,15330,2,0,2,0,4
25536,50,8109,12220;12714;15060;15328;15479,15330,1,2,2,0,5
25537,50,8110,11747;12224;15461;15548,15330,1,1,2,0,4
25538,50,8111,11677,15330,0,0,1,0,1
25539,50,8112,12066;12235;15963,15330,1,0,2,0,3
25540,50,8113,12139;12258;15311,15330,0,1,2,0,3
25541,50,8114,12159;12297;15937,15330,1,0,2,0,3
25542,50,8115,12306;12801,15330,0,0,2,0,2
25543,50,8116,11837;12374,15330,0,0,2,0,2
25544,50,8117,12397;15062;15805,15330,1,1,1,0,3
25545,50,8118,12441;12690;15523;15838,15330,2,0,2,0,4
25546,50,8119,11974;12450;15232;15448,15330,0,2,2,0,4
25547,50,8120,12088;12479;15352,15330,0,1,2,0,3
25548,50,8121,50;135,15695,0,0,2,0,2
25549,50,8122,829,15695,0,0,1,0,1
25550,50,8123,837,15695,0,0,0,1,1
25551,50,8124,3381,15695,0,0,1,0,1
25552,50,8126,7418,15695,0,0,1,0,1
25553,50,8127,5788;8618,15695,0,0,2,0,2
25554,50,8128,6003,15695,0,0,1,0,1
25555,50,8130,6187,15695,0,0,1,0,1
25556,50,8131,6202,15695,0,0,1,0,1
25557,50,8135,3061,15695,0,0,0,1,1
25558,50,8138,9643,15695,0,0,1,0,1
25559,50,8139,10047;10120,15695,0,0,2,0,2
25560,50,8140,878,15695,0,0,1,0,1
25561,50,8141,5793,15695,0,0,1,0,1
25562,50,8143,10278,15695,0,0,1,0,1
25563,50,8144,10536;10823,15695,0,0,2,0,2
25564,50,8146,10697,15695,0,0,1,0,1
25565,50,8148,11118;15276;15473,15695,0,2,1,0,3
25566,50,8149,10474;10656;15690,15695,1,0,2,0,3
25567,50,8151,11070;11429;15291,15695,0,1,2,0,3
25568,50,8152,10933,15695,0,0,1,0,1
25569,50,8154,10644;10971;15236;15355,15695,0,2,2,0,4
25570,50,8155,11072;11413;15210;15876,15695,1,1,2,0,4
25571,50,8156,11083;11219,15695,0,0,2,0,2
25572,50,8157,11295,15695,0,0,1,0,1
25573,50,8158,11316,15695,0,0,1,0,1
25574,50,8160,11398,15695,0,0,1,0,1
25575,50,8161,11787;15301;16047,15695,1,1,1,0,3
25576,50,8163,11791;12026;15739,15695,1,0,2,0,3
25577,50,8164,11862;12188,15695,0,0,2,0,2
25578,50,8165,11600;11629;15321;15518,15695,1,1,2,0,4
25579,50,8166,11508;11766;15215;15647,15695,1,1,2,0,4
25580,50,8167,11802;12321;15495;16162,15695,2,0,2,0,4
25581,50,8168,11892;11994;15599;15945;16108,15695,3,0,2,0,5
25582,50,8169,11527;11909;15319,15695,0,1,2,0,3
25583,50,8170,11931;12061;15683,15695,1,0,2,0,3
25584,50,8171,12034;12045;15383;15584;15812,15695,2,1,2,0,5
25585,50,8172,11991;12257;15603,15695,1,0,2,0,3
25586,50,8173,12016;12024;15387;15844,15695,1,1,2,0,4
25587,50,8174,12071;15445;15663;16000,15695,2,1,1,0,4
25588,50,8175,12090;12341;15934,15695,1,0,2,0,3
25589,50,8176,12318;15526;15801,15695,2,0,1,0,3
25590,50,8177,12101;12566,15695,0,0,2,0,2
25591,50,8178,12110;12546;15299;15478,15695,0,2,2,0,4
25592,50,8179,11960;12121;15549;15878;15990;16110,15695,4,0,2,0,6
25593,50,8180,11824;12136;15421;15579;16010,15695,2,1,2,0,5
25594,50,8182,12148;12316;15499,15695,1,0,2,0,3
25595,50,8183,12164;12350;15576;15873,15695,2,0,2,0,4
25596,50,8184,12227;12935,15695,0,0,2,0,2
25597,50,8185,12236;12387;16113,15695,1,0,2,0,3
25598,50,8186,12267;12688;15333;15593;15847,15695,2,1,2,0,5
25599,50,8187,12282;12608;15764;16147,15695,2,0,2,0,4
25600,50,8188,12319,15695,0,0,1,0,1
25601,50,8189,12328;12836;15224;15509,15695,1,1,2,0,4
25602,50,8190,12359;12891;15640,15695,1,0,2,0,3
25603,50,8191,12371;12755;16021;16083,15695,2,0,2,0,4
25604,50,8192,12536;15653;15822,15695,2,0,1,0,3
25605,50,8193,12311;12392;15412;15501;15736,15695,2,1,2,0,5
25606,50,8194,12377;12684;15295;15900,15695,1,1,2,0,4
25607,50,8195,12180;12436,15695,0,0,2,0,2
25608,50,8196,12473;13241;15539;15952,15695,2,0,2,0,4
25609,50,8197,12529;12901;15382;15723,15695,1,1,2,0,4
25610,50,8198,11992;12386,15695,0,0,2,0,2
25611,50,8199,12429;12496;15995,15695,1,0,2,0,3
25612,50,8200,12414;12516;15471;15613,15695,1,1,2,0,4
25613,50,8201,12526;12815;15275;15643,15695,1,1,2,0,4
25614,50,8202,12540;12612;15238;15666,15695,1,1,2,0,4
25615,50,8203,12385;12559;15256;15675,15695,1,1,2,0,4
25616,50,8204,12567;12804;16137,15695,1,0,2,0,3
25617,50,8205,12581;12635;15303;15671,15695,1,1,2,0,4
25618,50,8206,12586;12871,15695,0,0,2,0,2
25619,50,8207,11947;12598;16029,15695,1,0,2,0,3
25620,50,8208,12519;12604;15571;16098,15695,2,0,2,0,4
25621,50,8209,12194;12617;15339;15637;16044,15695,2,1,2,0,5
25622,50,8210,1051,16060,0,0,1,0,1
25623,50,8211,6782,16060,0,0,0,1,1
25624,50,8212,3463,16060,0,0,0,1,1
25625,50,8213,9017,16060,0,0,0,1,1
25626,50,8215,7000,16060,0,0,0,1,1
25627,50,8218,9735,16060,0,0,1,0,1
25628,50,8219,4369,16060,0,0,1,0,1
25629,50,8220,6421;8106,16060,0,0,2,0,2
25630,50,8221,6290;9519,16060,0,0,2,0,2
25631,50,8222,6114,16060,0,0,1,0,1
25632,50,8225,4736,16060,0,0,1,0,1
25633,50,8226,397,16060,0,0,0,1,1
25634,50,8227,8826,16060,0,0,0,1,1
25635,50,8228,2651,16060,0,0,1,0,1
25636,50,8230,5743;10307,16060,0,0,2,0,2
25637,50,8231,10041,16060,0,0,1,0,1
25638,50,8232,5522,16060,0,0,1,0,1
25639,50,8233,10096,16060,0,0,1,0,1
25640,50,8237,10443;10736,16060,0,0,2,0,2
25641,50,8239,10798,16060,0,0,1,0,1
25642,50,8241,10999,16060,0,0,1,0,1
25643,50,8243,10568,16060,0,0,1,0,1
25644,50,8244,11293;11777;15368;15740;16030,16060,2,1,2,0,5
25645,50,8245,11515,16060,0,0,1,0,1
25646,50,8246,11444;11736;15505;15841,16060,2,0,2,0,4
25647,50,8247,11519;12210,16060,0,0,2,0,2
25648,50,8249,11540;12035;15966,16060,1,0,2,0,3
25649,50,8251,11623;12078;15544;16105,16060,2,0,2,0,4
25650,50,8252,11098;11104;16124,16060,1,0,2,0,3
25651,50,8253,11635;11977;15516,16060,1,0,2,0,3
25652,50,8254,12132;15950,16060,1,0,1,0,2
25653,50,8255,11765;15377;15578;15661,16060,2,1,1,0,4
25654,50,8256,11784;11936;15627;15917,16060,2,0,2,0,4
25655,50,8257,11814;12021;15742,16060,1,0,2,0,3
25656,50,8258,11867;12124;15519;16118,16060,2,0,2,0,4
25657,50,8259,11451;11794;15760;16176,16060,2,0,2,0,4
25658,50,8260,11853,16060,0,0,1,0,1
25659,50,8261,11150;11202;15718;15948,16060,2,0,2,0,4
25660,50,8262,11956;12625,16060,0,0,2,0,2
25661,50,8263,11979;12720;15914,16060,1,0,2,0,3
25662,50,8264,11917;11989;15761,16060,1,0,2,0,3
25663,50,8265,12038,16060,0,0,1,0,1
25664,50,8266,12056;12873;15840,16060,1,0,2,0,3
25665,50,8267,11706;11875;15497;15943,16060,2,0,2,0,4
25666,50,8268,12096;12294;15985,16060,1,0,2,0,3
25667,50,8269,12099;12495;15438;15592,16060,1,1,2,0,4
25668,50,8270,11872;11949;15490,16060,1,0,2,0,3
25669,50,8271,12010;12129;15597,16060,1,0,2,0,3
25670,50,8272,11797;12184;15532;16145,16060,2,0,2,0,4
25671,50,8273,12005;12195;15818;16082,16060,2,0,2,0,4
25672,50,8275,12231;15502;15843,16060,2,0,1,0,3
25673,50,8276,12246;12260;16004;16170,16060,2,0,2,0,4
25674,50,8277,12296;12434;15449;16164,16060,1,1,2,0,4
25675,50,8278,12745;15358;15561,16060,1,1,1,0,3
25676,50,8279,12289;12367;15898,16060,1,0,2,0,3
25677,50,8280,12382;12407;15642;16009,16060,2,0,2,0,4
25678,50,8281,12384;13097;15447,16060,0,1,2,0,3
25679,50,8282,12408;12963;15440;15533,16060,1,1,2,0,4
25680,50,8283,12417;12735,16060,0,0,2,0,2
25681,50,8284,12420;12517;15563;15747;15857,16060,3,0,2,0,5
25682,50,8285,12238;12427;15744,16060,1,0,2,0,3
25683,50,8286,12206;12460;15680;16138,16060,2,0,2,0,4
25684,50,8287,12719;16148,16060,1,0,1,0,2
25685,50,8288,12368;12579,16060,0,0,2,0,2
25686,50,8289,12411;12584;15458;16013,16060,1,1,2,0,4
25687,50,8290,12594;12791;15520;15728,16060,2,0,2,0,4
25688,50,8291,12113;12615;15802,16060,1,0,2,0,3
25689,50,8292,12623;12776;15713;15918,16060,2,0,2,0,4
25690,50,8293,12662;12825;16179,16060,1,0,2,0,3
25691,50,8294,12416;12664,16060,0,0,2,0,2
25692,50,8295,12685;12693,16060,0,0,2,0,2
25693,50,8296,12687,16060,0,0,1,0,1
25694,50,8297,12652;12698;15360;15872,16060,1,1,2,0,4
25695,50,8298,12701;13084;15431;15826,16060,1,1,2,0,4
25696,50,8299,12705,16060,0,0,1,0,1
25697,50,8300,12718;12897;15452;15720,16060,1,1,2,0,4
25698,50,8301,12607;12729;15615;16109,16060,2,0,2,0,4
25699,50,8302,12672;12737;15859;16018,16060,2,0,2,0,4
25700,50,8303,5805,16425,0,0,1,0,1
25701,50,8304,448,16425,0,0,1,0,1
25702,50,8306,2013,16425,0,0,0,1,1
25703,50,8308,6102,16425,0,0,1,0,1
25704,50,8309,29,16425,0,0,1,0,1
25705,50,8310,9816,16425,0,0,1,0,1
25706,50,8312,2027;6641,16425,0,0,2,0,2
25707,50,8315,6675,16425,0,0,1,0,1
25708,50,8316,3,16425,0,0,1,0,1
25709,50,8317,6982,16425,0,0,0,1,1
25710,50,8318,7550,16425,0,0,1,0,1
25711,50,8319,9332,16425,0,0,1,0,1
25712,50,8320,10006,16425,0,0,1,0,1
25713,50,8325,10209,16425,0,0,1,0,1
25714,50,8327,10554;11146,16425,0,0,2,0,2
25715,50,8329,10678,16425,0,0,1,0,1
25716,50,8330,10752,16425,0,0,1,0,1
25717,50,8333,10872;10875;15625;16020,16425,2,0,2,0,4
25718,50,8335,10922,16425,0,0,1,0,1
25719,50,8336,11000;11333;15935,16425,1,0,2,0,3
25720,50,8337,11052,16425,0,0,1,0,1
25721,50,8338,11483;12059;16099,16425,1,0,2,0,3
25722,50,8339,11537;11642;15559;15651,16425,2,0,2,0,4
25723,50,8340,11542;15534;15693,16425,2,0,1,0,3
25724,50,8341,11671;15541;15909,16425,2,0,1,0,3
25725,50,8342,11916;12469,16425,0,0,2,0,2
25726,50,8343,11988,16425,0,0,1,0,1
25727,50,8344,11959,16425,0,0,1,0,1
25728,50,8345,12030;12281,16425,0,0,2,0,2
25729,50,8347,12037;12047;15904,16425,1,0,2,0,3
25730,50,8348,12130;12269;15618;15793,16425,2,0,2,0,4
25731,50,8349,12199;12851;15887;16178,16425,2,0,2,0,4
25732,50,8350,12154;12228;16131,16425,1,0,2,0,3
25733,50,8351,12242,16425,0,0,1,0,1
25734,50,8352,12640;12646,16425,0,0,2,0,2
25735,50,8353,12255;12497,16425,0,0,2,0,2
25736,50,8354,12253;12307;16186,16425,1,0,2,0,3
25737,50,8355,12324;13154,16425,0,0,2,0,2
25738,50,8356,12524;13008,16425,0,0,2,0,2
25739,50,8357,12360;12446;15702;15997;16057,16425,3,0,2,0,5
25740,50,8358,12160;12362,16425,0,0,2,0,2
25741,50,8359,12395;12829;15664;15957,16425,2,0,2,0,4
25742,50,8360,12412;12792,16425,0,0,2,0,2
25743,50,8361,12451;12834,16425,0,0,2,0,2
25744,50,8362,12197;12521,16425,0,0,2,0,2
25745,50,8363,12312;12531;15492;15953,16425,2,0,2,0,4
25746,50,8364,12534;12674;15672;15788,16425,2,0,2,0,4
25747,50,8365,12545;12859;15487;15794,16425,2,0,2,0,4
25748,50,8366,12213;12550;15735;15980,16425,2,0,2,0,4
25749,50,8367,12570;15639;15907,16425,2,0,1,0,3
25750,50,8368,12214;12575;15939,16425,1,0,2,0,3
25751,50,8369,12453;12585,16425,0,0,2,0,2
25752,50,8370,12602;12639,16425,0,0,2,0,2
25753,50,8371,12613;12854,16425,0,0,2,0,2
25754,50,8372,12650;16102,16425,1,0,1,0,2
25755,50,8373,12626;12822,16425,0,0,2,0,2
25756,50,8374,12633;12973,16425,0,0,2,0,2
25757,50,8375,12636;12974;15555;15947,16425,2,0,2,0,4
25758,50,8376,12670;13379;15783,16425,1,0,2,0,3
25759,50,8377,12713;13198;15515;15635;16026,16425,3,0,2,0,5
25760,50,8378,12738;12920;15493;15703;15938,16425,3,0,2,0,5
25761,50,8379,12746;13048,16425,0,0,2,0,2
25762,50,8380,12572;15923,16425,1,0,1,0,2
25763,50,8381,12174;12761,16425,0,0,2,0,2
25764,50,8382,12616;12780,16425,0,0,2,0,2
25765,50,8383,12783;13085;15540,16425,1,0,2,0,3
25766,50,8384,12785;16080,16425,1,0,1,0,2
25767,50,8385,12356;12786;15581;15646,16425,2,0,2,0,4
25768,50,8386,12788;13004;15991;16141,16425,2,0,2,0,4
25769,50,8387,12743;12790;15738;15842,16425,2,0,2,0,4
25770,50,8388,12802,16425,0,0,1,0,1
25771,50,8389,12807;13264;15704;16063,16425,2,0,2,0,4
25772,50,8390,12752;12864;15628;15796;15911,16425,3,0,2,0,5
25773,50,8391,390,16790,0,0,1,0,1
25774,50,8392,1682,16790,0,0,1,0,1
25775,50,8393,1944,16790,0,0,1,0,1
25776,50,8394,6036,16790,0,0,0,1,1
25777,50,8395,4855,16790,0,0,0,1,1
25778,50,8396,2007,16790,0,0,0,1,1
25779,50,8397,4828,16790,0,0,1,0,1
25780,50,8398,9394,16790,0,0,1,0,1
25781,50,8399,5572,16790,0,0,1,0,1
25782,50,8401,4109,16790,0,0,1,0,1
25783,50,8402,7596,16790,0,0,1,0,1
25784,50,8403,8515,16790,0,0,1,0,1
25785,50,8404,5521;9082,16790,0,0,2,0,2
25786,50,8406,10107,16790,0,0,1,0,1
25787,50,8407,10058,16790,0,0,1,0,1
25788,50,8408,10008,16790,0,0,1,0,1
25789,50,8409,10440;10738;15854,16790,1,0,2,0,3
25790,50,8411,10606,16790,0,0,1,0,1
25791,50,8412,10393,16790,0,0,1,0,1
25792,50,8413,10684,16790,0,0,1,0,1
25793,50,8416,11082,16790,0,0,1,0,1
25794,50,8417,11043,16790,0,0,1,0,1
25795,50,8418,11231,16790,0,0,1,0,1
25796,50,8419,11324;15611;15974,16790,2,0,1,0,3
25797,50,8421,11279;11725;15681,16790,1,0,2,0,3
25798,50,8423,11622,16790,0,0,1,0,1
25799,50,8424,11669,16790,0,0,1,0,1
25800,50,8425,11624;15669;16101,16790,2,0,1,0,3
25801,50,8426,11702;12293;15714,16790,1,0,2,0,3
25802,50,8427,11620,16790,0,0,1,0,1
25803,50,8428,11502;11722;15662;15891,16790,2,0,2,0,4
25804,50,8429,11318;11767;15650;15817,16790,2,0,2,0,4
25805,50,8430,11477;11866;15645;15972,16790,2,0,2,0,4
25806,50,8431,11793,16790,0,0,1,0,1
25807,50,8432,11643,16790,0,0,1,0,1
25808,50,8433,11830;12062;15819,16790,1,0,2,0,3
25809,50,8434,11852;12143;16160,16790,1,0,2,0,3
25810,50,8435,11891;12285;15885,16790,1,0,2,0,3
25811,50,8436,11636,16790,0,0,1,0,1
25812,50,8437,11939;12133;15698,16790,1,0,2,0,3
25813,50,8438,11919;11954;15769;16060,16790,2,0,2,0,4
25814,50,8439,11987;15696,16790,1,0,1,0,2
25815,50,8441,12002,16790,0,0,1,0,1
25816,50,8442,12418;15632,16790,1,0,1,0,2
25817,50,8443,12190;12605;16091,16790,1,0,2,0,3
25818,50,8444,12189;12193;16157,16790,1,0,2,0,3
25819,50,8445,12243;12277;15870,16790,1,0,2,0,3
25820,50,8446,11854;12244;16149,16790,1,0,2,0,3
25821,50,8447,12248;12642,16790,0,0,2,0,2
25822,50,8448,12185;12265;16075,16790,1,0,2,0,3
25823,50,8449,11942;12298;15839,16790,1,0,2,0,3
25824,50,8450,12315;12667,16790,0,0,2,0,2
25825,50,8451,12332;12369,16790,0,0,2,0,2
25826,50,8452,12376;13257,16790,0,0,2,0,2
25827,50,8453,12380;12401,16790,0,0,2,0,2
25828,50,8454,12388;13150,16790,0,0,2,0,2
25829,50,8455,12104,16790,0,0,1,0,1
25830,50,8456,12157;12419,16790,0,0,2,0,2
25831,50,8457,12439;12680;15602;15845,16790,2,0,2,0,4
25832,50,8458,12455;16053;16074,16790,2,0,1,0,3
25833,50,8459,12478;12697;15958,16790,1,0,2,0,3
25834,50,8460,12501;12892,16790,0,0,2,0,2
25835,50,8461,12170;12514;15981,16790,1,0,2,0,3
25836,50,8462,12541;12669;15743,16790,1,0,2,0,3
25837,50,8463,12542;12981,16790,0,0,2,0,2
25838,50,8464,12551;13158,16790,0,0,2,0,2
25839,50,8465,12499;12565;15676,16790,1,0,2,0,3
25840,50,8466,13029;15732;16090,16790,2,0,1,0,3
25841,50,8467,11962;12589,16790,0,0,2,0,2
25842,50,8468,12310;12590;15954,16790,1,0,2,0,3
25843,50,8469,12561;12686,16790,0,0,2,0,2
25844,50,8470,12733;13186;15787;16125,16790,2,0,2,0,4
25845,50,8471,12413;12742;15762,16790,1,0,2,0,3
25846,50,8472,12654;12775,16790,0,0,2,0,2
25847,50,8473,12039;12803;15722;15868,16790,2,0,2,0,4
25848,50,8474,12628;12812;15894,16790,1,0,2,0,3
25849,50,8475,12818;12945;16192,16790,1,0,2,0,3
25850,50,8476,12830;12955;15706;15960,16790,2,0,2,0,4
25851,50,8477,12609;12837;15908,16790,1,0,2,0,3
25852,50,8478,12840;13057,16790,0,0,2,0,2
25853,50,8479,12849;12894,16790,0,0,2,0,2
25854,50,8480,12716;12858;16086,16790,1,0,2,0,3
25855,50,8481,12430;12861,16790,0,0,2,0,2
25856,50,8482,12863;13293;15979,16790,1,0,2,0,3
25857,50,8483,12866;12905;15836,16790,1,0,2,0,3
25858,50,8484,12879;13110;15707;15881,16790,2,0,2,0,4
25859,50,8485,12886;13340,16790,0,0,2,0,2
25860,50,8486,12919;13371,16790,0,0,2,0,2
25861,50,8487,12527;12924;16088,16790,1,0,2,0,3
25862,50,8488,12927;13318;15725,16790,1,0,2,0,3
25863,50,8489,12928;13363;15745;16097,16790,2,0,2,0,4
25864,50,8490,12731;12942,16790,0,0,2,0,2
25865,50,8491,12943;13283;15861,16790,1,0,2,0,3
25866,50,8492,12977;13210;15897;16078,16790,2,0,2,0,4
25867,50,8494,1770;8418,17155,0,0,2,0,2
25868,50,8495,6581,17155,0,0,0,1,1
25869,50,8496,1035,17155,0,0,1,0,1
25870,50,8497,2384,17155,0,0,1,0,1
25871,50,8498,3717,17155,0,0,1,0,1
25872,50,8499,2300;8238,17155,0,0,2,0,2
25873,50,8500,6661,17155,0,0,1,0,1
25874,50,8501,8201,17155,0,0,1,0,1
25875,50,8503,5187,17155,0,0,1,0,1
25876,50,8505,10011,17155,0,0,1,0,1
25877,50,8506,5775,17155,0,0,1,0,1
25878,50,8507,10228,17155,0,0,1,0,1
25879,50,8509,10175;10438,17155,0,0,2,0,2
25880,50,8510,10145,17155,0,0,1,0,1
25881,50,8511,10609,17155,0,0,1,0,1
25882,50,8512,10716,17155,0,0,1,0,1
25883,50,8514,10811,17155,0,0,1,0,1
25884,50,8515,10729,17155,0,0,1,0,1
25885,50,8516,11229;11756;15834;16064,17155,2,0,2,0,4
25886,50,8518,11246,17155,0,0,1,0,1
25887,50,8519,11177;11264,17155,0,0,2,0,2
25888,50,8520,11577,17155,0,0,1,0,1
25889,50,8521,11603,17155,0,0,1,0,1
25890,50,8522,11826,17155,0,0,1,0,1
25891,50,8523,11781;11926;16061,17155,1,0,2,0,3
25892,50,8524,11899;12020;15780,17155,1,0,2,0,3
25893,50,8525,11572;11695;15912;16058,17155,2,0,2,0,4
25894,50,8526,12046;12119;15910,17155,1,0,2,0,3
25895,50,8527,12127;12259;15824,17155,1,0,2,0,3
25896,50,8528,11790,17155,0,0,1,0,1
25897,50,8529,11978,17155,0,0,1,0,1
25898,50,8530,12156;15955,17155,1,0,1,0,2
25899,50,8531,12192;12855,17155,0,0,2,0,2
25900,50,8532,12198;12509;15768,17155,1,0,2,0,3
25901,50,8533,12205;12470;16070,17155,1,0,2,0,3
25902,50,8534,12261;12270;16034;16165,17155,2,0,2,0,4
25903,50,8535,12275;12715;15786;16134,17155,2,0,2,0,4
25904,50,8536,12280;12428;15851,17155,1,0,2,0,3
25905,50,8537,12337,17155,0,0,1,0,1
25906,50,8538,12348;12643;15790,17155,1,0,2,0,3
25907,50,8539,12399;12532;16194,17155,1,0,2,0,3
25908,50,8540,12152;12406;15849;16183,17155,2,0,2,0,4
25909,50,8541,12426;12747,17155,0,0,2,0,2
25910,50,8542,12431,17155,0,0,1,0,1
25911,50,8543,12442,17155,0,0,1,0,1
25912,50,8544,12465;12485;16189,17155,1,0,2,0,3
25913,50,8546,12507;12778,17155,0,0,2,0,2
25914,50,8547,12510;13465;15973,17155,1,0,2,0,3
25915,50,8548,12537,17155,0,0,1,0,1
25916,50,8549,12539;16126,17155,1,0,1,0,2
25917,50,8550,12961;15815,17155,1,0,1,0,2
25918,50,8551,12333;12595;16001,17155,1,0,2,0,3
25919,50,8552,12614,17155,0,0,1,0,1
25920,50,8553,12621;12906,17155,0,0,2,0,2
25921,50,8554,12622,17155,0,0,1,0,1
25922,50,8555,12390;12624,17155,0,0,2,0,2
25923,50,8556,12637;13050;15798,17155,1,0,2,0,3
25924,50,8557,12463;12678;16014,17155,1,0,2,0,3
25925,50,8558,12682;12741,17155,0,0,2,0,2
25926,50,8559,12700;13391;16095,17155,1,0,2,0,3
25927,50,8560,12276;12728;15915,17155,1,0,2,0,3
25928,50,8561,12734;13290;15837,17155,1,0,2,0,3
25929,50,8562,12744;12967,17155,0,0,2,0,2
25930,50,8563,12757;13204,17155,0,0,2,0,2
25931,50,8564,13265,17155,0,0,1,0,1
25932,50,8565,12806;12883,17155,0,0,2,0,2
25933,50,8566,12813;13355;15964;16076,17155,2,0,2,0,4
25934,50,8567,12872,17155,0,0,1,0,1
25935,50,8568,12889;13263;15969,17155,1,0,2,0,3
25936,50,8569,12476,17155,0,0,1,0,1
25937,50,8570,12918;13159;16077,17155,1,0,2,0,3
25938,50,8571,12931,17155,0,0,1,0,1
25939,50,8572,12932;13192,17155,0,0,2,0,2
25940,50,8573,12751;12934,17155,0,0,2,0,2
25941,50,8574,12938;12990,17155,0,0,2,0,2
25942,50,8575,12930;12952,17155,0,0,2,0,2
25943,50,8576,12663;12960;16133,17155,1,0,2,0,3
25944,50,8577,12592;12641,17155,0,0,2,0,2
25945,50,8578,12972;13409,17155,0,0,2,0,2
25946,50,8579,12989;13495;15860,17155,1,0,2,0,3
25947,50,8580,12816;12997;16128,17155,1,0,2,0,3
25948,50,8581,12925;13020;16181,17155,1,0,2,0,3
25949,50,8582,12365;13028,17155,0,0,2,0,2
25950,50,8583,13039;13114;15899,17155,1,0,2,0,3
25951,50,8584,12724;13059;15784,17155,1,0,2,0,3
25952,50,8585,12772;13063,17155,0,0,2,0,2
25953,50,8586,12951;13071;16042,17155,1,0,2,0,3
25954,50,8587,13101;13306,17155,0,0,2,0,2
25955,50,8588,13102;13133,17155,0,0,2,0,2
25956,50,8589,13107;13307;15795,17155,1,0,2,0,3
25957,50,8590,13135;13202,17155,0,0,2,0,2
25958,50,8591,3834,17520,0,0,1,0,1
25959,50,8592,1592,17520,0,0,1,0,1
25960,50,8594,2840,17520,0,0,0,1,1
25961,50,8595,2728,17520,0,0,1,0,1
25962,50,8596,5901,17520,0,0,1,0,1
25963,50,8597,6053,17520,0,0,1,0,1
25964,50,8598,1152,17520,0,0,1,0,1
25965,50,8599,7172,17520,0,0,1,0,1
25966,50,8600,3155,17520,0,0,0,1,1
25967,50,8602,6660,17520,0,0,0,1,1
25968,50,8603,9365,17520,0,0,1,0,1
25969,50,8604,9728,17520,0,0,1,0,1
25970,50,8605,9788,17520,0,0,1,0,1
25971,50,8606,3481,17520,0,0,1,0,1
25972,50,8607,136,17520,0,0,1,0,1
25973,50,8608,447,17520,0,0,1,0,1
25974,50,8609,10130,17520,0,0,1,0,1
25975,50,8611,10252,17520,0,0,1,0,1
25976,50,8612,10542,17520,0,0,1,0,1
25977,50,8613,10582,17520,0,0,1,0,1
25978,50,8614,10987,17520,0,0,1,0,1
25979,50,8616,11227,17520,0,0,1,0,1
25980,50,8617,11308,17520,0,0,1,0,1
25981,50,8618,11453,17520,0,0,1,0,1
25982,50,8619,11459,17520,0,0,1,0,1
25983,50,8620,11518,17520,0,0,1,0,1
25984,50,8621,11634;11822;15936;16072,17520,2,0,2,0,4
25985,50,8623,11455;11782;15929;16180,17520,2,0,2,0,4
25986,50,8624,11839,17520,0,0,1,0,1
25987,50,8625,11516;11873;15941;16173,17520,2,0,2,0,4
25988,50,8627,11851,17520,0,0,1,0,1
25989,50,8628,11995,17520,0,0,1,0,1
25990,50,8629,11890;12051,17520,0,0,2,0,2
25991,50,8630,12041;12309;15983,17520,1,0,2,0,3
25992,50,8631,12049;12421,17520,0,0,2,0,2
25993,50,8632,12055;12764;16169,17520,1,0,2,0,3
25994,50,8633,11744,17520,0,0,1,0,1
25995,50,8634,11918;12201,17520,0,0,2,0,2
25996,50,8635,11923;11925;16166,17520,1,0,2,0,3
25997,50,8636,12181;12263;16065,17520,1,0,2,0,3
25998,50,8637,12358,17520,0,0,1,0,1
25999,50,8638,12435,17520,0,0,1,0,1
26000,50,8639,12438;12725,17520,0,0,2,0,2
26001,50,8640,12467;12814;16016,17520,1,0,2,0,3
26002,50,8641,12480;13040,17520,0,0,2,0,2
26003,50,8642,11922,17520,0,0,1,0,1
26004,50,8643,12491;12838,17520,0,0,2,0,2
26005,50,8644,12498;12522,17520,0,0,2,0,2
26006,50,8645,12533;12821;15951,17520,1,0,2,0,3
26007,50,8646,12543,17520,0,0,1,0,1
26008,50,8647,12549;12695,17520,0,0,2,0,2
26009,50,8648,12562;13341,17520,0,0,2,0,2
26010,50,8649,12576;12638,17520,0,0,2,0,2
26011,50,8650,12627;13252,17520,0,0,2,0,2
26012,50,8651,12283,17520,0,0,1,0,1
26013,50,8652,12504;12655,17520,0,0,2,0,2
26014,50,8653,12666;12709;15916,17520,1,0,2,0,3
26015,50,8654,12771;12882,17520,0,0,2,0,2
26016,50,8655,12779;13146,17520,0,0,2,0,2
26017,50,8656,12797,17520,0,0,1,0,1
26018,50,8657,12826;13181,17520,0,0,2,0,2
26019,50,8658,12848;12870;15959,17520,1,0,2,0,3
26020,50,8659,12888;13533,17520,0,0,2,0,2
26021,50,8660,12909;13091,17520,0,0,2,0,2
26022,50,8661,12910;13313,17520,0,0,2,0,2
26023,50,8662,12914;13270,17520,0,0,2,0,2
26024,50,8663,12694;12936,17520,0,0,2,0,2
26025,50,8664,13005;13609;15924,17520,1,0,2,0,3
26026,50,8665,13014;13176;15977,17520,1,0,2,0,3
26027,50,8666,12580;12758,17520,0,0,2,0,2
26028,50,8667,13034;13482;15996,17520,1,0,2,0,3
26029,50,8668,12996;13037;16127,17520,1,0,2,0,3
26030,50,8669,13045;13550,17520,0,0,2,0,2
26031,50,8670,13061;13632,17520,0,0,2,0,2
26032,50,8671,13066;13621;16187,17520,1,0,2,0,3
26033,50,8672,13076;13537,17520,0,0,2,0,2
26034,50,8673,13087;13178,17520,0,0,2,0,2
26035,50,8674,13160;13517;16007;16142,17520,2,0,2,0,4
26036,50,8675,13165;13394,17520,0,0,2,0,2
26037,50,8676,13185;13268,17520,0,0,2,0,2
26038,50,8677,12994;13189;16059,17520,1,0,2,0,3
26039,50,8678,13023;13201;15998,17520,1,0,2,0,3
26040,50,8679,13205;13255;16106,17520,1,0,2,0,3
26041,50,8680,13231;13489,17520,0,0,2,0,2
26042,50,8681,379,17885,0,0,1,0,1
26043,50,8682,774,17885,0,0,1,0,1
26044,50,8683,1637,17885,0,0,1,0,1
26045,50,8684,9225,17885,0,0,1,0,1
26046,50,8686,6536,17885,0,0,1,0,1
26047,50,8687,7324;7396,17885,0,0,2,0,2
26048,50,8688,8109,17885,0,0,1,0,1
26049,50,8690,4669,17885,0,0,1,0,1
26050,50,8691,988,17885,0,0,1,0,1
26051,50,8692,10072,17885,0,0,1,0,1
26052,50,8693,7257,17885,0,0,1,0,1
26053,50,8694,10181,17885,0,0,1,0,1
26054,50,8696,10297,17885,0,0,1,0,1
26055,50,8697,10077,17885,0,0,1,0,1
26056,50,8698,10340,17885,0,0,1,0,1
26057,50,8702,10917,17885,0,0,1,0,1
26058,50,8703,10638,17885,0,0,1,0,1
26059,50,8704,11051,17885,0,0,1,0,1
26060,50,8705,10925,17885,0,0,1,0,1
26061,50,8707,11241,17885,0,0,1,0,1
26062,50,8708,11305,17885,0,0,1,0,1
26063,50,8709,11111,17885,0,0,1,0,1
26064,50,8710,11323;11682;16155,17885,1,0,2,0,3
26065,50,8711,11125,17885,0,0,1,0,1
26066,50,8712,11372;11811,17885,0,0,2,0,2
26067,50,8713,11276,17885,0,0,1,0,1
26068,50,8714,11520;12122,17885,0,0,2,0,2
26069,50,8715,11602,17885,0,0,1,0,1
26070,50,8716,11688,17885,0,0,1,0,1
26071,50,8717,11944,17885,0,0,1,0,1
26072,50,8718,11280,17885,0,0,1,0,1
26073,50,8719,11746,17885,0,0,1,0,1
26074,50,8720,11758;12007;16130,17885,1,0,2,0,3
26075,50,8721,11827,17885,0,0,1,0,1
26076,50,8722,11951;12118;16143,17885,1,0,2,0,3
26077,50,8723,11986;16139,17885,1,0,1,0,2
26078,50,8724,12036,17885,0,0,1,0,1
26079,50,8725,12212,17885,0,0,1,0,1
26080,50,8726,12216;12721;16168,17885,1,0,2,0,3
26081,50,8727,12329,17885,0,0,1,0,1
26082,50,8728,12237;12571,17885,0,0,2,0,2
26083,50,8729,12295;12577;16089,17885,1,0,2,0,3
26084,50,8730,12300;12445;16159,17885,1,0,2,0,3
26085,50,8731,12094,17885,0,0,1,0,1
26086,50,8732,12338,17885,0,0,1,0,1
26087,50,8733,12372;13012,17885,0,0,2,0,2
26088,50,8734,12474;12475;16111,17885,1,0,2,0,3
26089,50,8735,12080;12482,17885,0,0,2,0,2
26090,50,8736,12502;12970;16115,17885,1,0,2,0,3
26091,50,8737,12558;12947,17885,0,0,2,0,2
26092,50,8738,12597,17885,0,0,1,0,1
26093,50,8739,12632,17885,0,0,1,0,1
26094,50,8740,12658;12862,17885,0,0,2,0,2
26095,50,8741,12683,17885,0,0,1,0,1
26096,50,8742,12404;12691;16195,17885,1,0,2,0,3
26097,50,8743,12717,17885,0,0,1,0,1
26098,50,8744,12739;13383,17885,0,0,2,0,2
26099,50,8745,12740;13123,17885,0,0,2,0,2
26100,50,8746,12760,17885,0,0,1,0,1
26101,50,8747,12784,17885,0,0,1,0,1
26102,50,8748,12766;12976,17885,0,0,2,0,2
26103,50,8749,12773;13184,17885,0,0,2,0,2
26104,50,8750,12876;13630,17885,0,0,2,0,2
26105,50,8751,12887;13643,17885,0,0,2,0,2
26106,50,8752,12937,17885,0,0,1,0,1
26107,50,8753,12954,17885,0,0,1,0,1
26108,50,8754,12618;12975,17885,0,0,2,0,2
26109,50,8755,12422;12984;16087,17885,1,0,2,0,3
26110,50,8756,12991;13043;16117,17885,1,0,2,0,3
26111,50,8757,12992;13010,17885,0,0,2,0,2
26112,50,8758,13017;13432,17885,0,0,2,0,2
26113,50,8759,13062;13659,17885,0,0,2,0,2
26114,50,8760,12944;13094,17885,0,0,2,0,2
26115,50,8761,13112;13118,17885,0,0,2,0,2
26116,50,8762,13220,17885,0,0,1,0,1
26117,50,8763,13121;13755;16120,17885,1,0,2,0,3
26118,50,8764,13131,17885,0,0,1,0,1
26119,50,8765,13142;13602,17885,0,0,2,0,2
26120,50,8766,13148,17885,0,0,1,0,1
26121,50,8767,13086;13155,17885,0,0,2,0,2
26122,50,8768,13083;13174,17885,0,0,2,0,2
26123,50,8769,13183;13281,17885,0,0,2,0,2
26124,50,8770,13195;13408,17885,0,0,2,0,2
26125,50,8771,13215,17885,0,0,1,0,1
26126,50,8772,13119,17885,0,0,1,0,1
26127,50,8773,12968;13242,17885,0,0,2,0,2
26128,50,8774,13073;13250,17885,0,0,2,0,2
26129,50,8775,13120;13253,17885,0,0,2,0,2
26130,50,8776,13289,17885,0,0,1,0,1
26131,50,8777,12907;13291,17885,0,0,2,0,2
26132,50,8778,13295;13395,17885,0,0,2,0,2
26133,50,8779,13299;13613,17885,0,0,2,0,2
26134,50,8780,13303,17885,0,0,1,0,1
26135,50,8781,13308;13656,17885,0,0,2,0,2
26136,50,8782,13144;13309,17885,0,0,2,0,2
26137,50,8783,13310;13518,17885,0,0,2,0,2
26138,50,8784,13326;13468,17885,0,0,2,0,2
26139,50,8785,13343;13703;16081,17885,1,0,2,0,3
26140,50,8786,13373;13669;16119,17885,1,0,2,0,3
26141,50,8787,12706;13382,17885,0,0,2,0,2
26142,50,8788,13320;13396,17885,0,0,2,0,2
26143,50,8789,1044,18250,0,0,1,0,1
26144,50,8790,1630,18250,0,0,1,0,1
26145,50,8791,4851,18250,0,0,1,0,1
26146,50,8792,1144,18250,0,0,1,0,1
26147,50,8793,1314,18250,0,0,1,0,1
26148,50,8794,3234,18250,0,0,1,0,1
26149,50,8795,5731,18250,0,0,1,0,1
26150,50,8796,7894,18250,0,0,1,0,1
26151,50,8797,9418,18250,0,0,1,0,1
26152,50,8798,4748,18250,0,0,1,0,1
26153,50,8800,10117,18250,0,0,1,0,1
26154,50,8801,10204,18250,0,0,1,0,1
26155,50,8802,8612,18250,0,0,1,0,1
26156,50,8803,10314,18250,0,0,1,0,1
26157,50,8804,10334,18250,0,0,1,0,1
26158,50,8805,10490,18250,0,0,1,0,1
26159,50,8806,10413,18250,0,0,1,0,1
26160,50,8807,10497,18250,0,0,1,0,1
26161,50,8808,10553,18250,0,0,1,0,1
26162,50,8809,10744,18250,0,0,1,0,1
26163,50,8810,10960,18250,0,0,1,0,1
26164,50,8811,11119,18250,0,0,1,0,1
26165,50,8812,11192,18250,0,0,1,0,1
26166,50,8813,11334,18250,0,0,1,0,1
26167,50,8814,11406,18250,0,0,1,0,1
26168,50,8815,11533,18250,0,0,1,0,1
26169,50,8816,11517;11541,18250,0,0,2,0,2
26170,50,8817,11554,18250,0,0,1,0,1
26171,50,8818,11698,18250,0,0,1,0,1
26172,50,8819,11646,18250,0,0,1,0,1
26173,50,8820,11649,18250,0,0,1,0,1
26174,50,8821,11655,18250,0,0,1,0,1
26175,50,8822,11375,18250,0,0,1,0,1
26176,50,8823,11676,18250,0,0,1,0,1
26177,50,8824,11678,18250,0,0,1,0,1
26178,50,8825,11774,18250,0,0,1,0,1
26179,50,8826,11347;11820,18250,0,0,2,0,2
26180,50,8827,11696,18250,0,0,1,0,1
26181,50,8828,11870,18250,0,0,1,0,1
26182,50,8829,11912;12004,18250,0,0,2,0,2
26183,50,8830,12074;12187,18250,0,0,2,0,2
26184,50,8831,11953,18250,0,0,1,0,1
26185,50,8832,12252;12336,18250,0,0,2,0,2
26186,50,8833,12342,18250,0,0,1,0,1
26187,50,8834,12247;12347,18250,0,0,2,0,2
26188,50,8835,12383;12452,18250,0,0,2,0,2
26189,50,8836,12443,18250,0,0,1,0,1
26190,50,8837,12447;13324,18250,0,0,2,0,2
26191,50,8838,12288;12471,18250,0,0,2,0,2
26192,50,8839,12398;12487,18250,0,0,2,0,2
26193,50,8840,12191;12538,18250,0,0,2,0,2
26194,50,8841,12754,18250,0,0,1,0,1
26195,50,8842,12578;12881,18250,0,0,2,0,2
26196,50,8843,12583;13126,18250,0,0,2,0,2
26197,50,8844,12668;13035,18250,0,0,2,0,2
26198,50,8845,12689;13038,18250,0,0,2,0,2
26199,50,8846,12249;12699,18250,0,0,2,0,2
26200,50,8847,12704;12768,18250,0,0,2,0,2
26201,50,8848,12710;13420,18250,0,0,2,0,2
26202,50,8849,12334;12711,18250,0,0,2,0,2
26203,50,8850,12568,18250,0,0,1,0,1
26204,50,8851,12789;12800,18250,0,0,2,0,2
26205,50,8852,12809,18250,0,0,1,0,1
26206,50,8853,12811;13053,18250,0,0,2,0,2
26207,50,8854,12850;13470,18250,0,0,2,0,2
26208,50,8855,12884;13203,18250,0,0,2,0,2
26209,50,8856,12819;12958,18250,0,0,2,0,2
26210,50,8857,12461;12966,18250,0,0,2,0,2
26211,50,8858,12983;13436,18250,0,0,2,0,2
26212,50,8859,12999;13449,18250,0,0,2,0,2
26213,50,8860,12763;13022,18250,0,0,2,0,2
26214,50,8861,12962;13026,18250,0,0,2,0,2
26215,50,8862,12748;13032,18250,0,0,2,0,2
26216,50,8863,12950;13036,18250,0,0,2,0,2
26217,50,8864,13080;13388,18250,0,0,2,0,2
26218,50,8865,12979;13090,18250,0,0,2,0,2
26219,50,8866,13088;13092,18250,0,0,2,0,2
26220,50,8867,13095;13638,18250,0,0,2,0,2
26221,50,8868,12998;13129,18250,0,0,2,0,2
26222,50,8869,13137;13375,18250,0,0,2,0,2
26223,50,8870,13145;13297,18250,0,0,2,0,2
26224,50,8871,13171;13688,18250,0,0,2,0,2
26225,50,8872,13161;13177,18250,0,0,2,0,2
26226,50,8873,13216;13655,18250,0,0,2,0,2
26227,50,8874,13237;13428,18250,0,0,2,0,2
26228,50,8875,13249;13330,18250,0,0,2,0,2
26229,50,8876,13254;13294,18250,0,0,2,0,2
26230,50,8877,13262;13361,18250,0,0,2,0,2
26231,50,8878,13304;13311,18250,0,0,2,0,2
26232,50,8879,12857;13339,18250,0,0,2,0,2
26233,50,8880,13348;13899,18250,0,1,1,0,2
26234,50,8881,13392;13660,18250,0,0,2,0,2
26235,50,8882,13429;13587,18250,0,0,2,0,2
26236,50,8883,13442;13943,18250,0,1,1,0,2
26237,50,8884,13446;13539,18250,0,0,2,0,2
26238,50,8885,12547;13471,18250,0,0,2,0,2
26239,50,8886,13093;13472,18250,0,0,2,0,2
26240,50,8887,13485;13851,18250,0,1,1,0,2
26241,50,8888,13492;13774,18250,0,0,2,0,2
26242,50,8889,13493;13577,18250,0,0,2,0,2
26243,50,8890,13523,18250,0,0,1,0,1
26244,50,8891,13529,18250,0,0,1,0,1
26245,50,8892,13532,18250,0,0,1,0,1
26246,60,1,4,0,0,0,0,1,1
26247,60,2,272;1571,0,0,0,0,2,2
26248,60,4,4337;7947,0,0,0,2,0,2
26249,60,16,51;916,0,0,0,0,2,2
26250,60,19,61;6642,0,0,0,1,1,2
26251,60,22,70,0,0,0,0,1,1
26252,60,33,99,0,0,0,0,1,1
26253,60,38,117,0,0,0,0,1,1
26254,60,54,5310;10092;13976,0,0,0,3,0,3
26255,60,56,164;576,0,0,0,0,2,2
26256,60,61,180;8253,0,0,0,0,2,2
26257,60,63,189;1979,0,0,0,0,2,2
26258,60,66,195,0,0,0,0,1,1
26259,60,71,2759,0,0,0,0,1,1
26260,60,127,2748,0,0,0,0,1,1
26261,60,128,354,0,0,0,0,1,1
26262,60,132,3661,0,0,0,0,1,1
26263,60,138,8031,0,0,0,0,1,1
26264,60,140,11066,0,0,0,1,0,1
26265,60,144,8055,0,0,0,0,1,1
26266,60,147,401;1424,0,0,0,0,2,2
26267,60,151,411,0,0,0,0,1,1
26268,60,173,2878;3238,0,0,0,0,2,2
26269,60,178,487;756;1287;2555,0,0,0,0,4,4
26270,60,179,492,0,0,0,0,1,1
26271,60,183,500,0,0,0,0,1,1
26272,60,184,502,0,0,0,0,1,1
26273,60,185,505;9616,0,0,0,0,2,2
26274,60,207,568;6413;9356,0,0,0,0,3,3
26275,60,231,622,0,0,0,0,1,1
26276,60,233,624,0,0,0,0,1,1
26277,60,235,629,0,0,0,0,1,1
26278,60,240,644,0,0,0,0,1,1
26279,60,258,689,0,0,0,0,1,1
26280,60,274,722;1809,0,0,0,0,2,2
26281,60,280,740;10169,0,0,0,2,0,2
26282,60,291,4861,0,0,0,0,1,1
26283,60,304,794;795;3699;4649;8124,0,0,0,0,5,5
26284,60,305,796,0,0,0,0,1,1
26285,60,310,812,0,0,0,0,1,1
26286,60,313,5690,0,0,0,0,1,1
26287,60,314,820,0,0,0,0,1,1
26288,60,324,847;2441,0,0,0,0,2,2
26289,60,329,5094,0,0,0,0,1,1
26290,60,332,869,0,0,0,0,1,1
26291,60,335,9878,0,0,0,0,1,1
26292,60,352,925,0,0,0,0,1,1
26293,60,354,8984,0,0,0,0,1,1
26294,60,361,948;4291,0,0,0,0,2,2
26295,60,365,965,0,0,0,0,1,1
26296,60,376,1000,0,0,0,0,1,1
26297,60,378,1005,0,0,0,0,1,1
26298,60,393,8862;10260;13558;14552,0,0,0,4,0,4
26299,60,411,9414,0,0,0,0,1,1
26300,60,420,1106;1107;1181,0,0,0,0,3,3
26301,60,437,902;5742,0,0,0,0,2,2
26302,60,447,4088,0,0,0,0,1,1
26303,60,451,1185,0,0,0,0,1,1
26304,60,453,1190,0,0,0,0,1,1
26305,60,478,421;1260;15018,0,0,0,1,2,3
26306,60,487,321;1283,0,0,0,0,2,2
26307,60,488,7429,0,0,0,0,1,1
26308,60,513,1359;8111;13009,0,0,0,1,2,3
26309,60,515,1365,0,0,0,0,1,1
26310,60,518,1373,0,0,0,0,1,1
26311,60,519,4925;8864,0,0,0,0,2,2
26312,60,534,1405,0,0,0,0,1,1
26313,60,542,6846,0,0,0,0,1,1
26314,60,545,1435,0,0,0,0,1,1
26315,60,552,1452,0,0,0,0,1,1
26316,60,553,4314,0,0,0,0,1,1
26317,60,555,1456;4134,0,0,0,0,2,2
26318,60,558,1464,0,0,0,0,1,1
26319,60,562,1475,0,0,0,0,1,1
26320,60,565,1483,0,0,0,0,1,1
26321,60,569,5273,0,0,0,0,1,1
26322,60,571,2502,0,0,0,0,1,1
26323,60,573,3919,0,0,0,0,1,1
26324,60,574,3027,0,0,0,0,1,1
26325,60,582,1529,0,0,0,0,1,1
26326,60,584,1538;2068,0,0,0,1,1,2
26327,60,590,1553;9321,0,0,0,0,2,2
26328,60,592,1558,0,0,0,0,1,1
26329,60,593,1560;7464,0,0,0,0,2,2
26330,60,605,1594,0,0,0,0,1,1
26331,60,607,4276,0,0,0,0,1,1
26332,60,608,1598,0,0,0,0,1,1
26333,60,610,3507;4471,0,0,0,1,1,2
26334,60,614,1618;1619;9513,0,0,0,2,1,3
26335,60,615,1620;4140,0,0,0,0,2,2
26336,60,624,1643,0,0,0,0,1,1
26337,60,625,2480;2605;6631,0,0,0,0,3,3
26338,60,630,1661,0,0,0,0,1,1
26339,60,633,1671;1808,0,0,0,2,0,2
26340,60,634,5117,0,0,0,0,1,1
26341,60,641,1690,0,0,0,0,1,1
26342,60,643,1702;2093,0,0,0,0,2,2
26343,60,648,1715;8540,0,0,0,0,2,2
26344,60,653,1733,0,0,0,0,1,1
26345,60,661,648;1756,0,0,0,0,2,2
26346,60,682,1810,0,0,0,0,1,1
26347,60,684,1812,0,0,0,0,1,1
26348,60,698,1843;7783,0,0,0,0,2,2
26349,60,716,1881;4064,0,0,0,0,2,2
26350,60,720,1891;8224,0,0,0,0,2,2
26351,60,728,1914;4775,0,0,0,0,2,2
26352,60,736,4838,0,0,0,0,1,1
26353,60,738,4187;4283,0,0,0,0,2,2
26354,60,747,8274,0,0,0,0,1,1
26355,60,749,1963;7142,0,0,0,0,2,2
26356,60,750,1965,0,0,0,0,1,1
26357,60,752,1970,0,0,0,0,1,1
26358,60,758,8951,0,0,0,0,1,1
26359,60,759,1993,0,0,0,0,1,1
26360,60,768,2006,0,0,0,0,1,1
26361,60,770,2016,0,0,0,0,1,1
26362,60,782,9477,0,0,0,0,1,1
26363,60,787,2064,0,0,0,0,1,1
26364,60,797,10103;10121;10252;10271;10331;13606;14239;14495;14626,0,0,0,9,0,9
26365,60,806,2110,0,0,0,0,1,1
26366,60,818,2142;4743,0,0,0,0,2,2
26367,60,821,2148,0,0,0,0,1,1
26368,60,822,9867,0,0,0,0,1,1
26369,60,852,655;2225,0,0,0,0,2,2
26370,60,857,2238,0,0,0,0,1,1
26371,60,864,2263,0,0,0,0,1,1
26372,60,871,9224,0,0,0,0,1,1
26373,60,878,2303;7272,0,0,0,0,2,2
26374,60,886,1583;2320,0,0,0,0,2,2
26375,60,895,2344,0,0,0,0,1,1
26376,60,897,1371;4722,0,0,0,0,2,2
26377,60,902,2367,0,0,0,0,1,1
26378,60,904,2374,0,0,0,0,1,1
26379,60,919,2415;9413,0,0,0,0,2,2
26380,60,932,2449;4793,0,0,0,0,2,2
26381,60,941,2476,0,0,0,1,0,1
26382,60,953,4920,0,0,0,0,1,1
26383,60,962,4320;11898,0,0,0,1,1,2
26384,60,967,2216,0,0,0,0,1,1
26385,60,972,2564,0,0,0,0,1,1
26386,60,977,2574,0,0,0,0,1,1
26387,60,985,6767,0,0,0,0,1,1
26388,60,989,7829,0,0,0,0,1,1
26389,60,994,2613;4625;11332,0,0,0,1,2,3
26390,60,995,2614,0,0,0,0,1,1
26391,60,1013,2658,0,0,0,0,1,1
26392,60,1029,2699;2701;5135;9102,0,0,0,0,4,4
26393,60,1036,2872,0,0,0,0,1,1
26394,60,1048,8479,0,0,0,0,1,1
26395,60,1059,2773;8322,0,0,0,0,2,2
26396,60,1070,2810;2811;2812;3041,0,0,0,0,4,4
26397,60,1073,2821,0,0,0,0,1,1
26398,60,1074,5628,0,0,0,0,1,1
26399,60,1076,2829,0,0,0,0,1,1
26400,60,1077,1700;3346,0,0,0,1,1,2
26401,60,1086,2856,0,0,0,0,1,1
26402,60,1096,264,0,0,0,0,1,1
26403,60,1098,2622,0,0,0,0,1,1
26404,60,1109,2911,0,0,0,0,1,1
26405,60,1113,2918;3342,0,0,0,0,2,2
26406,60,1129,2958,0,0,0,0,1,1
26407,60,1130,6384,0,0,0,0,1,1
26408,60,1152,3024,0,0,0,0,1,1
26409,60,1166,8867,0,0,0,0,1,1
26410,60,1168,3076,0,0,0,0,1,1
26411,60,1170,3080,0,0,0,0,1,1
26412,60,1180,6564,0,0,0,0,1,1
26413,60,1181,3109,0,0,0,0,1,1
26414,60,1185,6539,0,0,0,0,1,1
26415,60,1193,3144,0,0,0,0,1,1
26416,60,1202,3169,0,0,0,0,1,1
26417,60,1210,3187;6504,0,0,0,0,2,2
26418,60,1216,3206,0,0,0,0,1,1
26419,60,1220,3220,0,0,0,0,1,1
26420,60,1232,9435,0,0,0,0,1,1
26421,60,1236,7414,0,0,0,0,1,1
26422,60,1250,3294,0,0,0,0,1,1
26423,60,1251,3298;4522,0,0,0,0,2,2
26424,60,1274,3349,0,0,0,0,1,1
26425,60,1280,3369,0,0,0,0,1,1
26426,60,1285,3384,0,0,0,0,1,1
26427,60,1287,3396,0,0,0,0,1,1
26428,60,1292,3411;6378,0,0,0,0,2,2
26429,60,1297,3423,0,0,0,0,1,1
26430,60,1306,3448,0,0,0,0,1,1
26431,60,1308,3455;6035,0,0,0,0,2,2
26432,60,1315,3474;5508,0,0,0,0,2,2
26433,60,1331,3512,0,0,0,0,1,1
26434,60,1332,3514,0,0,0,0,1,1
26435,60,1339,3534,0,0,0,0,1,1
26436,60,1347,3554,0,0,0,0,1,1
26437,60,1359,3592,0,0,0,0,1,1
26438,60,1363,3603,0,0,0,0,1,1
26439,60,1367,3611,0,0,0,0,1,1
26440,60,1391,3668,0,0,0,0,1,1
26441,60,1395,3682;5103,0,0,0,0,2,2
26442,60,1397,3687,0,0,0,0,1,1
26443,60,1403,3703;7711,0,0,0,0,2,2
26444,60,1414,3735,0,0,0,1,0,1
26445,60,1416,3676,0,0,0,0,1,1
26446,60,1426,3763,0,0,0,0,1,1
26447,60,1427,132;2804;3766;3767;3768,0,0,0,0,5,5
26448,60,1432,9143,0,0,0,0,1,1
26449,60,1437,3788,0,0,0,0,1,1
26450,60,1444,3808,0,0,0,0,1,1
26451,60,1457,3845,0,0,0,0,1,1
26452,60,1458,3848,0,0,0,0,1,1
26453,60,1475,3893,0,0,0,0,1,1
26454,60,1501,3966,0,0,0,0,1,1
26455,60,1506,9919,0,0,0,0,1,1
26456,60,1508,3983,0,0,0,0,1,1
26457,60,1514,7359,0,0,0,0,1,1
26458,60,1541,137,0,0,0,0,1,1
26459,60,1551,4091;4093;5890;10016,0,0,0,2,2,4
26460,60,1555,9106,0,0,0,0,1,1
26461,60,1558,5222,0,0,0,0,1,1
26462,60,1572,4135,0,0,0,0,1,1
26463,60,1577,2396;4150,0,0,0,1,1,2
26464,60,1583,4161,0,0,0,0,1,1
26465,60,1586,4171,0,0,0,0,1,1
26466,60,1588,4175,0,0,0,0,1,1
26467,60,1598,7907,0,0,0,0,1,1
26468,60,1600,4204,0,0,0,0,1,1
26469,60,1601,4205;7021,0,0,0,0,2,2
26470,60,1618,4246,0,0,0,0,1,1
26471,60,1621,4253,0,0,0,0,1,1
26472,60,1628,4270,0,0,0,0,1,1
26473,60,1630,6157,0,0,0,0,1,1
26474,60,1634,589,0,0,0,0,1,1
26475,60,1641,4311,0,0,0,0,1,1
26476,60,1653,4492,0,0,0,0,1,1
26477,60,1658,4344,0,0,0,0,1,1
26478,60,1687,2913;4419,0,0,0,0,2,2
26479,60,1702,4446,0,0,0,0,1,1
26480,60,1705,2861,0,0,0,0,1,1
26481,60,1707,4461,0,0,0,0,1,1
26482,60,1713,4472,0,0,0,0,1,1
26483,60,1715,1577;4481;13166;13623,0,0,0,2,2,4
26484,60,1718,4491;9047,0,0,0,0,2,2
26485,60,1719,4494,0,0,0,0,1,1
26486,60,1728,4521,0,0,0,0,1,1
26487,60,1729,1549,0,0,0,0,1,1
26488,60,1737,4541,0,0,0,0,1,1
26489,60,1769,2032;4633;4634,0,0,0,1,2,3
26490,60,1787,4673,0,0,0,0,1,1
26491,60,1790,4682,0,0,0,0,1,1
26492,60,1799,4706,0,0,0,0,1,1
26493,60,1811,4734,0,0,0,0,1,1
26494,60,1822,10147;10212,0,0,0,2,0,2
26495,60,1825,5146,0,0,0,0,1,1
26496,60,1831,7734,0,0,0,0,1,1
26497,60,1834,4788,0,0,0,0,1,1
26498,60,1846,1541;2005,0,0,0,0,2,2
26499,60,1855,2806,0,0,0,0,1,1
26500,60,1859,3099;4853,0,0,0,0,2,2
26501,60,1862,4870;8764,0,0,0,0,2,2
26502,60,1866,4879;8171,0,0,0,0,2,2
26503,60,1869,3963,0,0,0,0,1,1
26504,60,1885,3981,0,0,0,0,1,1
26505,60,1898,3364;4975,0,0,0,0,2,2
26506,60,1906,4992,0,0,0,0,1,1
26507,60,1915,680;5014,0,0,0,0,2,2
26508,60,1919,1494,0,0,0,0,1,1
26509,60,1922,5033;5034,0,0,0,0,2,2
26510,60,1923,7428,0,0,0,0,1,1
26511,60,1934,5066,0,0,0,0,1,1
26512,60,1937,1919,0,0,0,0,1,1
26513,60,1942,713,0,0,0,0,1,1
26514,60,1948,5102;5314,0,0,0,0,2,2
26515,60,1954,5116,0,0,0,0,1,1
26516,60,1961,4017,0,0,0,0,1,1
26517,60,1974,5163,0,0,0,0,1,1
26518,60,1978,5172,0,0,0,0,1,1
26519,60,1983,419,0,0,0,0,1,1
26520,60,1984,1239;5192,0,0,0,0,2,2
26521,60,1986,2978;4983,0,0,0,0,2,2
26522,60,1994,5217,0,0,0,0,1,1
26523,60,2005,5247,0,0,0,0,1,1
26524,60,2006,5251;5824,0,0,0,0,2,2
26525,60,2018,5274,0,0,0,0,1,1
26526,60,2022,5285,0,0,0,0,1,1
26527,60,2025,8731,0,0,0,0,1,1
26528,60,2028,2323;9749,0,0,0,1,1,2
26529,60,2031,5309,0,0,0,0,1,1
26530,60,2033,5315,0,0,0,0,1,1
26531,60,2041,5332;6514,0,0,0,0,2,2
26532,60,2042,730;4991,0,0,0,0,2,2
26533,60,2045,5338,0,0,0,0,1,1
26534,60,2057,3831,0,0,0,0,1,1
26535,60,2065,4615,0,0,0,0,1,1
26536,60,2067,5393,0,0,0,0,1,1
26537,60,2078,5422,0,0,0,0,1,1
26538,60,2079,5423;5424,0,0,0,0,2,2
26539,60,2080,5427;6732,0,0,0,0,2,2
26540,60,2083,5437,0,0,0,0,1,1
26541,60,2093,5463,0,0,0,0,1,1
26542,60,2096,5468,0,0,0,0,1,1
26543,60,2106,5465,0,0,0,0,1,1
26544,60,2111,5666,0,0,0,0,1,1
26545,60,2118,5518,0,0,0,0,1,1
26546,60,2142,1375;5448,0,0,0,0,2,2
26547,60,2143,5580,0,0,0,0,1,1
26548,60,2145,5582,0,0,0,0,1,1
26549,60,2159,5000,0,0,0,0,1,1
26550,60,2165,5009;5627,0,0,0,0,2,2
26551,60,2166,5631,0,0,0,0,1,1
26552,60,2170,5641;9920,0,0,0,0,2,2
26553,60,2175,5654,0,0,0,0,1,1
26554,60,2185,5675,0,0,0,0,1,1
26555,60,2186,7001,0,0,0,0,1,1
26556,60,2197,1416;9526,0,0,0,0,2,2
26557,60,2198,6592,0,0,0,0,1,1
26558,60,2212,5748,0,0,0,0,1,1
26559,60,2219,5766,0,0,0,1,0,1
26560,60,2230,7089,0,0,0,0,1,1
26561,60,2243,5822,0,0,0,0,1,1
26562,60,2247,5832,0,0,0,0,1,1
26563,60,2264,5868,0,0,0,0,1,1
26564,60,2274,5887,0,0,0,0,1,1
26565,60,2286,3010;3955,0,0,0,0,2,2
26566,60,2290,3910;5925,0,0,0,0,2,2
26567,60,2301,5951,0,0,0,0,1,1
26568,60,2302,3389;5955,0,0,0,0,2,2
26569,60,2312,5984,0,0,0,0,1,1
26570,60,2314,5989,0,0,0,0,1,1
26571,60,2320,2089,0,0,0,0,1,1
26572,60,2329,6027,0,0,0,0,1,1
26573,60,2336,6043;6044,0,0,0,0,2,2
26574,60,2342,6052;7093,0,0,0,0,2,2
26575,60,2343,1360;14311,0,0,0,2,0,2
26576,60,2349,6065,0,0,0,0,1,1
26577,60,2355,6085,0,0,0,1,0,1
26578,60,2367,6811,0,0,0,0,1,1
26579,60,2384,5478,0,0,0,0,1,1
26580,60,2395,6180,0,0,0,0,1,1
26581,60,2399,6193,0,0,0,0,1,1
26582,60,2407,6214,0,0,0,0,1,1
26583,60,2429,6272,0,0,0,1,0,1
26584,60,2445,6317,0,0,0,0,1,1
26585,60,2451,4821;6333,0,0,0,0,2,2
26586,60,2453,6342,0,0,0,0,1,1
26587,60,2454,9496,0,0,0,0,1,1
26588,60,2463,6366,0,0,0,0,1,1
26589,60,2468,6379,0,0,0,0,1,1
26590,60,2470,6382;10046;15296,0,0,1,2,0,3
26591,60,2490,1831;6431,0,0,0,0,2,2
26592,60,2495,298;6441,0,0,0,0,2,2
26593,60,2497,5601;6448,0,0,0,0,2,2
26594,60,2501,9927,0,0,0,1,0,1
26595,60,2521,1042,0,0,0,0,1,1
26596,60,2540,213;8627,0,0,0,0,2,2
26597,60,2544,191,0,0,0,0,1,1
26598,60,2549,6575;7930,0,0,0,0,2,2
26599,60,2554,1516;6585,0,0,0,0,2,2
26600,60,2567,6619,0,0,0,0,1,1
26601,60,2570,6630,0,0,0,0,1,1
26602,60,2571,6634,0,0,0,0,1,1
26603,60,2572,1986;6636;7682,0,0,0,0,3,3
26604,60,2574,5900,0,0,0,0,1,1
26605,60,2581,6663,0,0,0,0,1,1
26606,60,2604,949,0,0,0,0,1,1
26607,60,2606,6737,0,0,0,0,1,1
26608,60,2619,1139;12902,0,0,0,1,1,2
26609,60,2638,11089;11184;14003;15067,0,0,0,4,0,4
26610,60,2643,6829,0,0,0,0,1,1
26611,60,2653,811;6867,0,0,0,0,2,2
26612,60,2658,2545;5191;5479;6878;6880,0,0,0,1,4,5
26613,60,2681,3235,0,0,0,0,1,1
26614,60,2699,6969,0,0,0,0,1,1
26615,60,2718,7028,0,0,0,0,1,1
26616,60,2719,5113;7034;7035;8443,0,0,0,0,4,4
26617,60,2725,7048;9808,0,0,0,0,2,2
26618,60,2735,7074,0,0,0,0,1,1
26619,60,2736,7075;7076,0,0,0,0,2,2
26620,60,2744,7094,0,0,0,0,1,1
26621,60,2745,7096,0,0,0,0,1,1
26622,60,2759,10244;10711;15287,0,0,1,2,0,3
26623,60,2761,7139,0,0,0,0,1,1
26624,60,2764,7613,0,0,0,0,1,1
26625,60,2769,7162,0,0,0,0,1,1
26626,60,2770,6765;7164,0,0,0,0,2,2
26627,60,2772,7167,0,0,0,0,1,1
26628,60,2797,7228,0,0,0,0,1,1
26629,60,2809,7252,0,0,0,0,1,1
26630,60,2820,7277;9362,0,0,0,0,2,2
26631,60,2824,7286,0,0,0,0,1,1
26632,60,2829,9899,0,0,0,0,1,1
26633,60,2832,7307;8672,0,0,0,0,2,2
26634,60,2838,9623,0,0,0,0,1,1
26635,60,2851,7355,0,0,0,0,1,1
26636,60,2855,8080,0,0,0,0,1,1
26637,60,2863,9946,0,0,0,0,1,1
26638,60,2866,5602,0,0,0,0,1,1
26639,60,2867,7395,0,0,0,0,1,1
26640,60,2869,4577;7399,0,0,0,0,2,2
26641,60,2870,7401,0,0,0,0,1,1
26642,60,2882,4535;7439;7440,0,0,0,2,1,3
26643,60,2894,7468,0,0,0,0,1,1
26644,60,2896,7472,0,0,0,0,1,1
26645,60,2900,7482,0,0,0,0,1,1
26646,60,2908,6837;7504,0,0,0,0,2,2
26647,60,2915,7526,0,0,0,0,1,1
26648,60,2964,7650,0,0,0,0,1,1
26649,60,2965,3072,0,0,0,0,1,1
26650,60,2985,7708,0,0,0,0,1,1
26651,60,2997,4168;7737,0,0,0,0,2,2
26652,60,3009,1307;7665,0,0,0,2,0,2
26653,60,3010,1019,0,0,0,0,1,1
26654,60,3011,7769,0,0,0,0,1,1
26655,60,3013,7772,0,0,0,0,1,1
26656,60,3021,6078,0,0,0,0,1,1
26657,60,3022,175;219;13752;13998,0,0,0,3,1,4
26658,60,3028,5858;7807,0,0,0,0,2,2
26659,60,3031,7817,0,0,0,0,1,1
26660,60,3045,7854,0,0,0,0,1,1
26661,60,3046,7858,0,0,0,0,1,1
26662,60,3052,7875,0,0,0,0,1,1
26663,60,3056,3028,0,0,0,0,1,1
26664,60,3062,7157,0,0,0,0,1,1
26665,60,3065,8139,0,0,0,0,1,1
26666,60,3070,2747,0,0,0,0,1,1
26667,60,3072,3335;3382,0,0,0,0,2,2
26668,60,3078,4188;7937,0,0,0,0,2,2
26669,60,3083,7951,0,0,0,0,1,1
26670,60,3100,2932;7987,0,0,0,0,2,2
26671,60,3109,7321,0,0,0,0,1,1
26672,60,3112,3792;4434,0,0,0,0,2,2
26673,60,3120,8051,0,0,0,0,1,1
26674,60,3122,8056,0,0,0,0,1,1
26675,60,3137,8085,0,0,0,0,1,1
26676,60,3142,8098,0,0,0,0,1,1
26677,60,3147,8108,0,0,0,0,1,1
26678,60,3158,8141,0,0,0,0,1,1
26679,60,3164,8157;8158,0,0,0,0,2,2
26680,60,3168,8166,0,0,0,0,1,1
26681,60,3189,6757;7416,0,0,0,0,2,2
26682,60,3191,1943;13957,0,0,0,1,1,2
26683,60,3198,6783,0,0,0,0,1,1
26684,60,3199,8239,0,0,0,0,1,1
26685,60,3201,8241,0,0,0,0,1,1
26686,60,3202,884,0,0,0,0,1,1
26687,60,3205,8247,0,0,0,0,1,1
26688,60,3212,3254,0,0,0,0,1,1
26689,60,3227,1178;8305,0,0,0,0,2,2
26690,60,3236,8334,0,0,0,0,1,1
26691,60,3237,4370,0,0,0,0,1,1
26692,60,3242,8349,0,0,0,0,1,1
26693,60,3243,3295,0,0,0,0,1,1
26694,60,3258,8387,0,0,0,0,1,1
26695,60,3260,4582;8393,0,0,0,0,2,2
26696,60,3288,8464,0,0,0,0,1,1
26697,60,3290,5814;8474;14183,0,0,0,2,1,3
26698,60,3297,8496,0,0,0,0,1,1
26699,60,3305,5351,0,0,0,0,1,1
26700,60,3316,8159;8542,0,0,0,0,2,2
26701,60,3318,8551,0,0,0,0,1,1
26702,60,3323,8427,0,0,0,0,1,1
26703,60,3343,5070;8611,0,0,0,0,2,2
26704,60,3369,372,0,0,0,0,1,1
26705,60,3383,10243;13876,0,0,0,2,0,2
26706,60,3384,8722,0,0,0,0,1,1
26707,60,3398,2163;8755,0,0,0,0,2,2
26708,60,3404,8773,0,0,0,0,1,1
26709,60,3406,7657,0,0,0,0,1,1
26710,60,3407,8784,0,0,0,0,1,1
26711,60,3411,4273,0,0,0,0,1,1
26712,60,3416,7490;8804,0,0,0,0,2,2
26713,60,3422,9393,0,0,0,0,1,1
26714,60,3426,8842,0,0,0,0,1,1
26715,60,3435,10321,0,0,0,1,0,1
26716,60,3438,8868,0,0,0,0,1,1
26717,60,3446,8883,0,0,0,0,1,1
26718,60,3449,8895,0,0,0,0,1,1
26719,60,3479,2009;8978,0,0,0,1,1,2
26720,60,3512,310,0,0,0,0,1,1
26721,60,3516,8076,0,0,0,1,0,1
26722,60,3517,324;9070,0,0,0,0,2,2
26723,60,3519,2383;9076,0,0,0,0,2,2
26724,60,3550,9167,0,0,0,0,1,1
26725,60,3555,9176,0,0,0,0,1,1
26726,60,3559,9184,0,0,0,0,1,1
26727,60,3576,9236,0,0,0,0,1,1
26728,60,3580,10284;10502,0,0,0,2,0,2
26729,60,3587,9261,0,0,0,0,1,1
26730,60,3592,9274,0,0,0,0,1,1
26731,60,3594,1351;2231;5395,0,0,0,0,3,3
26732,60,3603,9295,0,0,0,0,1,1
26733,60,3605,3373;9301,0,0,0,0,2,2
26734,60,3611,9313,0,0,0,0,1,1
26735,60,3612,9315,0,0,0,0,1,1
26736,60,3613,9319;11717,0,0,0,1,1,2
26737,60,3625,9349,0,0,0,0,1,1
26738,60,3639,4032,0,0,0,0,1,1
26739,60,3645,9405,0,0,0,0,1,1
26740,60,3646,9407,0,0,0,0,1,1
26741,60,3651,10538;10992;14293;14775,0,0,0,4,0,4
26742,60,3666,9470,0,0,0,0,1,1
26743,60,3686,9512,0,0,0,0,1,1
26744,60,3687,9517,0,0,0,0,1,1
26745,60,3688,9521,0,0,0,0,1,1
26746,60,3699,9549,0,0,0,0,1,1
26747,60,3701,6021,0,0,0,0,1,1
26748,60,3704,6766,0,0,0,0,1,1
26749,60,3713,6535;9587,0,0,0,0,2,2
26750,60,3716,5633,0,0,0,0,1,1
26751,60,3719,7523,0,0,0,0,1,1
26752,60,3724,9618,0,0,0,0,1,1
26753,60,3725,625;9619,0,0,0,0,2,2
26754,60,3726,9620,0,0,0,0,1,1
26755,60,3736,279,0,0,0,0,1,1
26756,60,3744,9663,0,0,0,0,1,1
26757,60,3761,763;9713,0,0,0,0,2,2
26758,60,3770,9738,0,0,0,0,1,1
26759,60,3771,1663;9742,0,0,0,2,0,2
26760,60,3774,8132,0,0,0,0,1,1
26761,60,3780,9766,0,0,0,0,1,1
26762,60,3784,1605;9778,0,0,0,0,2,2
26763,60,3792,1199,0,0,0,0,1,1
26764,60,3809,4044,0,0,0,0,1,1
26765,60,3817,9870,0,0,0,0,1,1
26766,60,3823,3901,0,0,0,1,0,1
26767,60,3825,9897,0,0,0,0,1,1
26768,60,3827,552;9900,0,0,0,0,2,2
26769,60,3831,1666,0,0,0,0,1,1
26770,60,3833,4806,0,0,0,0,1,1
26771,60,3839,5026;9931,0,0,0,0,2,2
26772,60,3841,9934,0,0,0,0,1,1
26773,60,3861,8834;9988,0,0,0,0,2,2
26774,60,3864,6561;10390;15193,0,0,1,2,0,3
26775,60,3869,2017,0,0,0,0,1,1
26776,60,3871,6059,0,0,0,0,1,1
26777,60,3872,4306,0,0,0,0,1,1
26778,60,3884,1783,0,0,0,0,1,1
26779,60,3888,4971,0,0,0,0,1,1
26780,60,3889,2130,0,0,0,0,1,1
26781,60,3892,1924,0,0,0,0,1,1
26782,60,3895,5600,0,0,0,0,1,1
26783,60,3907,7516,0,0,0,0,1,1
26784,60,3912,22,0,0,0,0,1,1
26785,60,3915,7517,0,0,0,0,1,1
26786,60,3918,5235;5972,0,0,0,0,2,2
26787,60,3922,9925,0,0,0,0,1,1
26788,60,3925,5769,0,0,0,0,1,1
26789,60,3928,5771;6143,0,0,0,0,2,2
26790,60,3929,6147,0,0,0,0,1,1
26791,60,3930,3750;6306,0,0,0,0,2,2
26792,60,3943,6985,0,0,0,0,1,1
26793,60,3953,7529;9328,0,0,0,0,2,2
26794,60,3954,9347,0,0,0,0,1,1
26795,60,3958,5653,0,0,0,0,1,1
26796,60,3960,1065,365,0,0,0,1,1
26797,60,3963,534,365,0,0,0,1,1
26798,60,3968,787,365,0,0,0,1,1
26799,60,3970,1014,365,0,0,0,1,1
26800,60,3971,1054,365,0,0,0,1,1
26801,60,3976,738,365,0,0,0,1,1
26802,60,3979,7926,365,0,0,0,1,1
26803,60,3980,1317;1745,365,0,0,0,2,2
26804,60,3982,4927;9021,365,0,0,0,2,2
26805,60,3987,9480,365,0,0,0,1,1
26806,60,3991,1023,365,0,0,0,1,1
26807,60,3994,3586,365,0,0,0,1,1
26808,60,4002,1318;3468,365,0,0,0,2,2
26809,60,4005,2141;5085,365,0,0,0,2,2
26810,60,4008,5132,365,0,0,0,1,1
26811,60,4009,8455,365,0,0,0,1,1
26812,60,4014,5691;9642,365,0,0,0,2,2
26813,60,4015,5757,365,0,0,0,1,1
26814,60,4020,6281,365,0,0,0,1,1
26815,60,4023,1899,365,0,0,0,1,1
26816,60,4027,299;5671,365,0,0,0,2,2
26817,60,4029,2070;6863,365,0,0,0,2,2
26818,60,4031,7058,365,0,0,0,1,1
26819,60,4032,40;7071,365,0,0,0,2,2
26820,60,4039,9939,365,0,0,0,1,1
26821,60,4040,2930;8249,365,0,0,0,2,2
26822,60,4041,6769;7871,365,0,0,0,2,2
26823,60,4044,8304,365,0,0,0,1,1
26824,60,4054,1556,365,0,0,0,1,1
26825,60,4060,2606;6330;11495,365,0,0,1,2,3
26826,60,4061,178,365,0,0,0,1,1
26827,60,4062,590;9825,365,0,0,0,2,2
26828,60,4063,1634;7849,365,0,0,0,2,2
26829,60,4065,9948,365,0,0,0,1,1
26830,60,4067,45,730,0,0,0,1,1
26831,60,4072,5123,730,0,0,0,1,1
26832,60,4076,5525,730,0,0,0,1,1
26833,60,4077,578;705,730,0,0,0,2,2
26834,60,4078,792,730,0,0,0,1,1
26835,60,4082,8946,730,0,0,0,1,1
26836,60,4084,4197,730,0,0,0,1,1
26837,60,4085,1246,730,0,0,0,1,1
26838,60,4095,8801;9996,730,0,0,0,2,2
26839,60,4102,9500,730,0,0,0,1,1
26840,60,4104,2879,730,0,0,0,1,1
26841,60,4109,4399,730,0,0,0,1,1
26842,60,4110,78,730,0,0,0,1,1
26843,60,4116,3868,730,0,0,0,1,1
26844,60,4121,4384;5605,730,0,0,0,2,2
26845,60,4124,5546,730,0,0,0,1,1
26846,60,4128,8925,730,0,0,0,1,1
26847,60,4133,4648,730,0,0,0,1,1
26848,60,4149,9428,730,0,0,0,1,1
26849,60,4153,7077,730,0,0,0,1,1
26850,60,4154,3069;6454,730,0,0,0,2,2
26851,60,4155,1741;7353,730,0,0,0,2,2
26852,60,4156,2576;3291,730,0,0,0,2,2
26853,60,4158,4381,730,0,0,0,1,1
26854,60,4160,329,730,0,0,0,1,1
26855,60,4162,5571,730,0,0,0,1,1
26856,60,4163,35,730,0,0,0,1,1
26857,60,4166,6452,730,0,0,0,1,1
26858,60,4168,4600;8252,730,0,0,0,2,2
26859,60,4173,5451;8595,730,0,0,0,2,2
26860,60,4188,5212;9944,730,0,0,0,2,2
26861,60,4190,6735,1095,0,0,0,1,1
26862,60,4195,296;6278,1095,0,0,0,2,2
26863,60,4197,9145,1095,0,0,0,1,1
26864,60,4200,517;1250,1095,0,0,0,2,2
26865,60,4204,5699;8276,1095,0,0,0,2,2
26866,60,4205,7567;8744;12054,1095,0,0,1,2,3
26867,60,4207,1099;4046,1095,0,0,0,2,2
26868,60,4219,1009,1095,0,0,0,1,1
26869,60,4222,844,1095,0,0,0,1,1
26870,60,4223,2417;2655,1095,0,0,0,2,2
26871,60,4228,3165;4045,1095,0,0,0,2,2
26872,60,4230,3377,1095,0,0,0,1,1
26873,60,4233,1207;3540,1095,0,0,0,2,2
26874,60,4236,4559;6458,1095,0,0,0,2,2
26875,60,4240,7569,1095,0,0,0,1,1
26876,60,4242,2059,1095,0,0,0,1,1
26877,60,4243,4274,1095,0,0,0,1,1
26878,60,4244,4336,1095,0,0,0,1,1
26879,60,4248,4874,1095,0,0,0,1,1
26880,60,4253,2995,1095,0,0,0,1,1
26881,60,4254,3062;4954,1095,0,0,0,2,2
26882,60,4255,5420,1095,0,0,0,1,1
26883,60,4257,467;5017;10556,1095,0,0,1,2,3
26884,60,4263,2179,1095,0,0,0,1,1
26885,60,4266,5573,1095,0,0,0,1,1
26886,60,4268,9390,1095,0,0,0,1,1
26887,60,4276,6588,1095,0,0,0,1,1
26888,60,4288,2281,1095,0,0,0,1,1
26889,60,4289,11984;12134;15956;16309,1095,0,2,2,0,4
26890,60,4290,6390,1095,0,0,0,1,1
26891,60,4292,1235;7882,1095,0,0,0,2,2
26892,60,4296,4209;8277,1095,0,0,0,2,2
26893,60,4297,8284,1095,0,0,0,1,1
26894,60,4298,6246,1095,0,0,0,1,1
26895,60,4301,8596,1095,0,0,0,1,1
26896,60,4303,1372;4505,1095,0,0,0,2,2
26897,60,4304,11594;12232;17195,1095,1,0,2,0,3
26898,60,4305,36;8859,1095,0,0,0,2,2
26899,60,4306,8902,1095,0,0,0,1,1
26900,60,4309,9830,1095,0,0,0,1,1
26901,60,4315,9777,1095,0,0,0,1,1
26902,60,4317,6595;9882,1095,0,0,0,2,2
26903,60,4318,7601,1095,0,0,0,1,1
26904,60,4319,9910,1095,0,0,0,1,1
26905,60,4321,8211,1460,0,0,0,1,1
26906,60,4322,7497,1460,0,0,0,1,1
26907,60,4324,336,1460,0,0,0,1,1
26908,60,4328,1925;12619,1460,0,0,1,1,2
26909,60,4336,1212,1460,0,0,0,1,1
26910,60,4337,5871;8306,1460,0,0,0,2,2
26911,60,4339,1251;7466,1460,0,0,0,2,2
26912,60,4342,3895,1460,0,0,0,1,1
26913,60,4344,4770,1460,0,0,0,1,1
26914,60,4345,1732,1460,0,0,0,1,1
26915,60,4348,2723,1460,0,0,0,1,1
26916,60,4352,2355,1460,0,0,0,1,1
26917,60,4354,929;2766,1460,0,0,0,2,2
26918,60,4362,8315,1460,0,0,0,1,1
26919,60,4364,11012,1460,0,0,1,0,1
26920,60,4365,3639,1460,0,0,0,1,1
26921,60,4366,3548;5906,1460,0,0,0,2,2
26922,60,4369,3944,1460,0,0,0,1,1
26923,60,4371,7;9645;12209,1460,0,0,1,2,3
26924,60,4379,4827,1460,0,0,0,1,1
26925,60,4385,7019,1460,0,0,0,1,1
26926,60,4386,643;7925,1460,0,0,0,2,2
26927,60,4389,5542;5562,1460,0,0,0,2,2
26928,60,4391,5811;9257,1460,0,0,0,2,2
26929,60,4394,864;8985,1460,0,0,0,2,2
26930,60,4395,2765;6308,1460,0,0,0,2,2
26931,60,4397,6334,1460,0,0,0,1,1
26932,60,4399,6406;8168,1460,0,0,0,2,2
26933,60,4401,6493,1460,0,0,0,1,1
26934,60,4406,9196,1460,0,0,0,1,1
26935,60,4411,4318;7066,1460,0,0,0,2,2
26936,60,4412,1740,1460,0,0,0,1,1
26937,60,4415,1376;8123,1460,0,0,0,2,2
26938,60,4419,2628;7534,1460,0,0,0,2,2
26939,60,4420,360;7603,1460,0,0,0,2,2
26940,60,4421,4949,1460,0,0,0,1,1
26941,60,4422,3922;6191,1460,0,0,0,2,2
26942,60,4423,4170;7692,1460,0,0,0,2,2
26943,60,4426,8120,1460,0,0,0,1,1
26944,60,4427,2750;5248,1460,0,0,0,2,2
26945,60,4436,583,1460,0,0,0,1,1
26946,60,4438,8904,1460,0,0,0,1,1
26947,60,4440,9159;9243,1460,0,0,0,2,2
26948,60,4441,5261,1460,0,0,0,1,1
26949,60,4447,679,1460,0,0,0,1,1
26950,60,4448,9963,1460,0,0,0,1,1
26951,60,4449,183;9947,1825,0,0,0,2,2
26952,60,4450,271;6489,1825,0,0,0,2,2
26953,60,4451,511,1825,0,0,0,1,1
26954,60,4453,752;3493,1825,0,0,0,2,2
26955,60,4455,355,1825,0,0,0,1,1
26956,60,4457,6920,1825,0,0,0,1,1
26957,60,4458,1169;8331,1825,0,0,0,2,2
26958,60,4459,356;4398,1825,0,0,0,2,2
26959,60,4461,1769,1825,0,0,0,1,1
26960,60,4464,1988,1825,0,0,0,1,1
26961,60,4471,2864;3674,1825,0,0,0,2,2
26962,60,4472,3004;4015;12381,1825,0,0,1,2,3
26963,60,4474,1263;6285;12647,1825,0,0,1,2,3
26964,60,4482,4178,1825,0,0,0,1,1
26965,60,4483,6197,1825,0,0,0,1,1
26966,60,4487,4506;6064,1825,0,0,0,2,2
26967,60,4489,8087,1825,0,0,0,1,1
26968,60,4494,3259;5419,1825,0,0,0,2,2
26969,60,4500,3695;5617,1825,0,0,0,2,2
26970,60,4502,5715;7801,1825,0,0,0,2,2
26971,60,4503,8741,1825,0,0,0,1,1
26972,60,4504,5774;9357,1825,0,0,0,2,2
26973,60,4507,5949;9015,1825,0,0,0,2,2
26974,60,4508,6001,1825,0,0,0,1,1
26975,60,4515,6239,1825,0,0,0,1,1
26976,60,4519,1332,1825,0,0,0,1,1
26977,60,4520,7235,1825,0,0,0,1,1
26978,60,4523,6354,1825,0,0,0,1,1
26979,60,4526,6689,1825,0,0,0,1,1
26980,60,4527,1122,1825,0,0,0,1,1
26981,60,4528,7989,1825,0,0,0,1,1
26982,60,4536,11715;12138;12555;16167;16243;16547;16799,1825,0,4,3,0,7
26983,60,4537,8543,1825,0,0,0,1,1
26984,60,4538,3397;8617,1825,0,0,0,2,2
26985,60,4539,1216,1825,0,0,0,1,1
26986,60,4541,3539;6953,1825,0,0,0,2,2
26987,60,4542,10;8092,1825,0,0,0,2,2
26988,60,4544,3672,1825,0,0,0,1,1
26989,60,4546,9187,1825,0,0,0,1,1
26990,60,4548,5613,1825,0,0,0,1,1
26991,60,4554,8466,1825,0,0,0,1,1
26992,60,4557,5159,2190,0,0,0,1,1
26993,60,4560,3449;3518,2190,0,0,0,2,2
26994,60,4562,7300;7404,2190,0,0,0,2,2
26995,60,4564,773;1814,2190,0,0,0,2,2
26996,60,4567,1151;6719,2190,0,0,0,2,2
26997,60,4569,561;7068,2190,0,0,0,2,2
26998,60,4572,1962;5554,2190,0,0,0,2,2
26999,60,4573,3758,2190,0,0,0,1,1
27000,60,4576,603;3012,2190,0,0,0,2,2
27001,60,4577,642,2190,0,0,0,1,1
27002,60,4579,2742;5939,2190,0,0,0,2,2
27003,60,4581,2949;3960,2190,0,0,0,2,2
27004,60,4582,2971;4061,2190,0,0,0,2,2
27005,60,4586,3174,2190,0,0,0,1,1
27006,60,4587,8456,2190,0,0,0,1,1
27007,60,4592,3740,2190,0,0,0,1,1
27008,60,4596,3962;9721,2190,0,0,0,2,2
27009,60,4602,8806,2190,0,0,0,1,1
27010,60,4603,5616;9221,2190,0,0,0,2,2
27011,60,4604,3621;7704,2190,0,0,0,2,2
27012,60,4605,64;4486,2190,0,0,0,2,2
27013,60,4606,4511;8561,2190,0,0,0,2,2
27014,60,4607,1032,2190,0,0,0,1,1
27015,60,4609,3402,2190,0,0,0,1,1
27016,60,4610,4888,2190,0,0,0,1,1
27017,60,4618,903;6544,2190,0,0,0,2,2
27018,60,4620,1238;5849,2190,0,0,0,2,2
27019,60,4622,5905,2190,0,0,0,1,1
27020,60,4623,5799,2190,0,0,0,1,1
27021,60,4624,1074;6170,2190,0,0,0,2,2
27022,60,4625,6311,2190,0,0,0,1,1
27023,60,4626,1165,2190,0,0,0,1,1
27024,60,4635,3193;7238,2190,0,0,0,2,2
27025,60,4638,7844;11748,2190,0,0,1,1,2
27026,60,4641,3813,2190,0,0,0,1,1
27027,60,4644,6139,2190,0,0,0,1,1
27028,60,4646,2010;8470,2190,0,0,0,2,2
27029,60,4647,7180,2190,0,0,0,1,1
27030,60,4648,8604;9232,2190,0,0,0,2,2
27031,60,4650,8707,2190,0,0,0,1,1
27032,60,4652,3708;8797,2190,0,0,0,2,2
27033,60,4658,2559;9424,2190,0,0,0,2,2
27034,60,4659,9510,2190,0,0,0,1,1
27035,60,4662,9727,2190,0,0,0,1,1
27036,60,4663,513;9817,2190,0,0,0,2,2
27037,60,4666,179;3387,2555,0,0,0,2,2
27038,60,4668,1584,2555,0,0,0,1,1
27039,60,4669,1386,2555,0,0,0,1,1
27040,60,4671,6070,2555,0,0,0,1,1
27041,60,4673,9165,2555,0,0,0,1,1
27042,60,4677,1824,2555,0,0,0,1,1
27043,60,4683,2345,2555,0,0,0,1,1
27044,60,4686,5025;7222,2555,0,0,0,2,2
27045,60,4689,2901;8853,2555,0,0,0,2,2
27046,60,4694,3407;8977,2555,0,0,0,2,2
27047,60,4701,932,2555,0,0,0,1,1
27048,60,4702,4035;9189,2555,0,0,0,2,2
27049,60,4703,110;7808,2555,0,0,0,2,2
27050,60,4705,4111,2555,0,0,0,1,1
27051,60,4707,4149;4628,2555,0,0,0,2,2
27052,60,4708,3362;4694,2555,0,0,0,2,2
27053,60,4709,5328;8674,2555,0,0,0,2,2
27054,60,4719,5133;11861,2555,0,0,1,1,2
27055,60,4725,5547,2555,0,0,0,1,1
27056,60,4729,5870;8396,2555,0,0,0,2,2
27057,60,4730,2787,2555,0,0,0,1,1
27058,60,4731,9138,2555,0,0,0,1,1
27059,60,4733,5134;6184,2555,0,0,0,2,2
27060,60,4734,9799,2555,0,0,0,1,1
27061,60,4735,8589,2555,0,0,0,1,1
27062,60,4736,9951,2555,0,0,0,1,1
27063,60,4740,6973;9406,2555,0,0,0,2,2
27064,60,4741,4051,2555,0,0,0,1,1
27065,60,4742,958;2891,2555,0,0,0,2,2
27066,60,4745,404;8822,2555,0,0,0,2,2
27067,60,4747,7151;7276,2555,0,0,0,2,2
27068,60,4749,490;7776,2555,0,0,0,2,2
27069,60,4750,2418;7867,2555,0,0,0,2,2
27070,60,4751,8388,2555,0,0,0,1,1
27071,60,4753,2232;8642,2555,0,0,0,2,2
27072,60,4756,7461;8144,2555,0,0,0,2,2
27073,60,4757,6464;8268,2555,0,0,0,2,2
27074,60,4759,3022;9995,2555,0,0,0,2,2
27075,60,4760,2058;8376,2555,0,0,0,2,2
27076,60,4763,8712,2555,0,0,0,1,1
27077,60,4765,4073,2555,0,0,0,1,1
27078,60,4767,8893,2555,0,0,0,1,1
27079,60,4769,6526;8966,2555,0,0,0,2,2
27080,60,4770,9246;9392,2555,0,0,0,2,2
27081,60,4773,2580;4543,2555,0,0,0,2,2
27082,60,4774,6006,2555,0,0,0,1,1
27083,60,4775,9687,2555,0,0,0,1,1
27084,60,4776,9762,2555,0,0,0,1,1
27085,60,4777,9837,2555,0,0,0,1,1
27086,60,4779,54;4449,2920,0,0,0,2,2
27087,60,4781,147;4668,2920,0,0,0,2,2
27088,60,4785,475;2092,2920,0,0,0,2,2
27089,60,4786,537;5063,2920,0,0,0,2,2
27090,60,4793,11555;11735;12083;14953;14970;15587;15978;16403;16567;16621,2920,0,5,5,0,10
27091,60,4794,2656;12661,2920,0,0,1,1,2
27092,60,4801,1882,2920,0,0,0,1,1
27093,60,4803,1935,2920,0,0,0,1,1
27094,60,4804,2091;8628,2920,0,0,0,2,2
27095,60,4805,2500;3215,2920,0,0,0,2,2
27096,60,4807,1217;7525,2920,0,0,0,2,2
27097,60,4808,3977;7553,2920,0,0,0,2,2
27098,60,4809,4953;8177,2920,0,0,0,2,2
27099,60,4811,1010;1575,2920,0,0,0,2,2
27100,60,4816,2798;3116,2920,0,0,0,2,2
27101,60,4817,12168;12456;13314,2920,0,0,3,0,3
27102,60,4818,1784,2920,0,0,0,1,1
27103,60,4819,3277;3860,2920,0,0,0,2,2
27104,60,4820,2033;4950,2920,0,0,0,2,2
27105,60,4821,7874;8740,2920,0,0,0,2,2
27106,60,4823,3523,2920,0,0,0,1,1
27107,60,4832,4102;8169,2920,0,0,0,2,2
27108,60,4834,4280,2920,0,0,0,1,1
27109,60,4836,4509;9739,2920,0,0,0,2,2
27110,60,4837,6420,2920,0,0,0,1,1
27111,60,4839,3675;6971,2920,0,0,0,2,2
27112,60,4843,7732;8629,2920,0,0,0,2,2
27113,60,4845,1652;5181;11501,2920,0,0,1,2,3
27114,60,4849,5366;7185,2920,0,0,0,2,2
27115,60,4850,1788,2920,0,0,0,1,1
27116,60,4851,5443,2920,0,0,0,1,1
27117,60,4852,8050,2920,0,0,0,1,1
27118,60,4856,6194,2920,0,0,0,1,1
27119,60,4858,863,2920,0,0,0,1,1
27120,60,4859,7690,2920,0,0,0,1,1
27121,60,4861,3749,2920,0,0,0,1,1
27122,60,4862,9352,2920,0,0,0,1,1
27123,60,4864,6751;7503,2920,0,0,0,2,2
27124,60,4866,1974,2920,0,0,0,1,1
27125,60,4868,7403,2920,0,0,0,1,1
27126,60,4871,1328,2920,0,0,0,1,1
27127,60,4872,5679;7733,2920,0,0,0,2,2
27128,60,4875,1486;7992,2920,0,0,0,2,2
27129,60,4876,6827,2920,0,0,0,1,1
27130,60,4877,6774;8317,2920,0,0,0,2,2
27131,60,4879,3633;3709,2920,0,0,0,2,2
27132,60,4881,974;8344,2920,0,0,0,2,2
27133,60,4882,4924;5810,2920,0,0,0,2,2
27134,60,4883,6995;8502,2920,0,0,0,2,2
27135,60,4885,2800,2920,0,0,0,1,1
27136,60,4887,5278;8573,2920,0,0,0,2,2
27137,60,4888,8283;8584,2920,0,0,0,2,2
27138,60,4889,8623,2920,0,0,0,1,1
27139,60,4893,8643;8823,2920,0,0,0,2,2
27140,60,4894,9378,2920,0,0,0,1,1
27141,60,4895,6845;13352,2920,0,0,1,1,2
27142,60,4901,3716,2920,0,0,0,1,1
27143,60,4902,6158,2920,0,0,0,1,1
27144,60,4906,5024;12903,2920,0,0,1,1,2
27145,60,4907,8270,2920,0,0,0,1,1
27146,60,4911,153;4308;12523,3285,0,0,1,2,3
27147,60,4912,959;3315,3285,0,0,0,2,2
27148,60,4913,4499;9684,3285,0,0,0,2,2
27149,60,4914,4586;6981,3285,0,0,0,2,2
27150,60,4918,349;3748,3285,0,0,0,2,2
27151,60,4921,75;159,3285,0,0,0,2,2
27152,60,4923,630;1344,3285,0,0,0,2,2
27153,60,4927,536;853,3285,0,0,0,2,2
27154,60,4930,6743;9041,3285,0,0,0,2,2
27155,60,4933,293;4548,3285,0,0,0,2,2
27156,60,4935,8688;9588,3285,0,0,0,2,2
27157,60,4937,1561,3285,0,0,0,1,1
27158,60,4938,2433;3802,3285,0,0,0,2,2
27159,60,4940,4043;7744,3285,0,0,0,2,2
27160,60,4941,2843,3285,0,0,0,1,1
27161,60,4945,2189,3285,0,0,0,1,1
27162,60,4947,2462,3285,0,0,0,1,1
27163,60,4950,2670,3285,0,0,0,1,1
27164,60,4951,3850,3285,0,0,0,1,1
27165,60,4956,3560,3285,0,0,0,1,1
27166,60,4967,7330,3285,0,0,0,1,1
27167,60,4969,4637;7679,3285,0,0,0,2,2
27168,60,4972,4165;5044,3285,0,0,0,2,2
27169,60,4974,2014,3285,0,0,0,1,1
27170,60,4981,74;7275,3285,0,0,0,2,2
27171,60,4987,5692;6188,3285,0,0,0,2,2
27172,60,4989,4854;9188,3285,0,0,0,2,2
27173,60,4992,6503;8527,3285,0,0,0,2,2
27174,60,4993,6586,3285,0,0,0,1,1
27175,60,4998,5160,3285,0,0,0,1,1
27176,60,5000,240;1692,3285,0,0,0,2,2
27177,60,5002,3117;7332,3285,0,0,0,2,2
27178,60,5003,2594;7343,3285,0,0,0,2,2
27179,60,5004,1572;7357,3285,0,0,0,2,2
27180,60,5007,4873;7872,3285,0,0,0,2,2
27181,60,5010,8759;9665;13074,3285,0,0,1,2,3
27182,60,5011,1609;6494,3285,0,0,0,2,2
27183,60,5015,8318;8814,3285,0,0,0,2,2
27184,60,5016,6736;8815,3285,0,0,0,2,2
27185,60,5018,3833,3285,0,0,0,1,1
27186,60,5019,2681;9008,3285,0,0,0,2,2
27187,60,5020,9114,3285,0,0,0,1,1
27188,60,5022,5031,3285,0,0,0,1,1
27189,60,5023,4034,3285,0,0,0,1,1
27190,60,5025,7627,3285,0,0,0,1,1
27191,60,5029,616;3132;12389,3285,0,0,1,2,3
27192,60,5030,1693,3650,0,0,0,1,1
27193,60,5033,1252;4400,3650,0,0,0,2,2
27194,60,5034,216;801,3650,0,0,0,2,2
27195,60,5038,116;891,3650,0,0,0,2,2
27196,60,5039,1061,3650,0,0,0,1,1
27197,60,5040,1288;8020,3650,0,0,0,2,2
27198,60,5043,5216,3650,0,0,0,1,1
27199,60,5044,6604,3650,0,0,0,1,1
27200,60,5046,3202,3650,0,0,0,1,1
27201,60,5050,3103;11627,3650,0,0,1,1,2
27202,60,5053,8624,3650,0,0,0,1,1
27203,60,5054,9423,3650,0,0,0,1,1
27204,60,5055,1236,3650,0,0,0,1,1
27205,60,5056,810;9336,3650,0,0,0,2,2
27206,60,5058,9848,3650,0,0,0,1,1
27207,60,5060,2390,3650,0,0,0,1,1
27208,60,5062,3395,3650,0,0,0,1,1
27209,60,5064,2887;5008,3650,0,0,0,2,2
27210,60,5065,1147;3437;13608,3650,0,0,1,2,3
27211,60,5068,3704,3650,0,0,0,1,1
27212,60,5069,1321;8807,3650,0,0,0,2,2
27213,60,5070,584;7203,3650,0,0,0,2,2
27214,60,5074,6012,3650,0,0,0,1,1
27215,60,5075,4129,3650,0,0,0,1,1
27216,60,5078,3380,3650,0,0,0,1,1
27217,60,5079,4595;7739,3650,0,0,0,2,2
27218,60,5081,4771;8497,3650,0,0,0,2,2
27219,60,5084,9226,3650,0,0,0,1,1
27220,60,5088,5318;6688,3650,0,0,0,2,2
27221,60,5089,4252;6792;12702,3650,0,0,1,2,3
27222,60,5091,7969,3650,0,0,0,1,1
27223,60,5093,6949;9484;12677,3650,0,0,1,2,3
27224,60,5094,4368;5353,3650,0,0,0,2,2
27225,60,5097,5863,3650,0,0,0,1,1
27226,60,5100,933;3125,3650,0,0,0,2,2
27227,60,5101,8407;8785,3650,0,0,0,2,2
27228,60,5102,6215,3650,0,0,0,1,1
27229,60,5103,1714,3650,0,0,0,1,1
27230,60,5108,4655;9768,3650,0,0,0,2,2
27231,60,5109,2881;12072,3650,0,0,1,1,2
27232,60,5110,6238;7520,3650,0,0,0,2,2
27233,60,5112,6629,3650,0,0,0,1,1
27234,60,5115,9166,3650,0,0,0,1,1
27235,60,5116,4680;4979,3650,0,0,0,2,2
27236,60,5117,2180;7294,3650,0,0,0,2,2
27237,60,5118,7306;12335,3650,0,0,1,1,2
27238,60,5119,4799,3650,0,0,0,1,1
27239,60,5120,7398;9118,3650,0,0,0,2,2
27240,60,5121,3678,3650,0,0,0,1,1
27241,60,5122,5532,3650,0,0,0,1,1
27242,60,5123,2795;7746,3650,0,0,0,2,2
27243,60,5124,2544;8133,3650,0,0,0,2,2
27244,60,5127,9577,3650,0,0,0,1,1
27245,60,5128,2215;8538,3650,0,0,0,2,2
27246,60,5130,8572,3650,0,0,0,1,1
27247,60,5133,8857,3650,0,0,0,1,1
27248,60,5134,1100;8858,3650,0,0,0,2,2
27249,60,5135,721;4514,3650,0,0,0,2,2
27250,60,5136,4141,3650,0,0,0,1,1
27251,60,5138,5969;9798;13441,3650,0,0,1,2,3
27252,60,5140,4053;5441,3650,0,0,0,2,2
27253,60,5142,4723,3650,0,0,0,1,1
27254,60,5143,8934,3650,0,0,0,1,1
27255,60,5144,8340,3650,0,0,0,1,1
27256,60,5146,3612;5709,3650,0,0,0,2,2
27257,60,5150,7073,3650,0,0,0,1,1
27258,60,5151,43,4015,0,0,0,1,1
27259,60,5152,107;5458,4015,0,0,0,2,2
27260,60,5153,112;7143,4015,0,0,0,2,2
27261,60,5154,188;2456,4015,0,0,0,2,2
27262,60,5155,217;771;12102;13069,4015,0,0,2,2,4
27263,60,5158,4810;5749,4015,0,0,0,2,2
27264,60,5162,2499,4015,0,0,0,1,1
27265,60,5167,945;7495,4015,0,0,0,2,2
27266,60,5168,1016,4015,0,0,0,1,1
27267,60,5170,1096,4015,0,0,0,1,1
27268,60,5176,2359;2648,4015,0,0,0,2,2
27269,60,5177,5302;12810,4015,0,0,1,1,2
27270,60,5183,1648;3208,4015,0,0,0,2,2
27271,60,5184,3309,4015,0,0,0,1,1
27272,60,5185,1304;3363,4015,0,0,0,2,2
27273,60,5188,3595,4015,0,0,0,1,1
27274,60,5190,3726;7998,4015,0,0,0,2,2
27275,60,5192,3741;5043,4015,0,0,0,2,2
27276,60,5193,3873;9033,4015,0,0,0,2,2
27277,60,5195,4267;4713,4015,0,0,0,2,2
27278,60,5200,4613,4015,0,0,0,1,1
27279,60,5202,1505;8780,4015,0,0,0,2,2
27280,60,5203,977,4015,0,0,0,1,1
27281,60,5205,760;3934,4015,0,0,0,2,2
27282,60,5207,1536;6339,4015,0,0,0,2,2
27283,60,5208,5290,4015,0,0,0,1,1
27284,60,5210,3417;3696,4015,0,0,0,2,2
27285,60,5211,9298,4015,0,0,0,1,1
27286,60,5214,5764,4015,0,0,0,1,1
27287,60,5215,4654,4015,0,0,0,1,1
27288,60,5218,9874,4015,0,0,0,1,1
27289,60,5219,5981;6112,4015,0,0,0,2,2
27290,60,5221,2481;6284,4015,0,0,0,2,2
27291,60,5222,6319;7138,4015,0,0,0,2,2
27292,60,5224,1471;6404,4015,0,0,0,2,2
27293,60,5226,4755;6531,4015,0,0,0,2,2
27294,60,5228,8365,4015,0,0,0,1,1
27295,60,5229,7150;13072,4015,0,0,1,1,2
27296,60,5230,1163,4015,0,0,0,1,1
27297,60,5231,6480;6555;12273,4015,0,0,1,2,3
27298,60,5233,1774;2356,4015,0,0,0,2,2
27299,60,5235,6728;12868,4015,0,0,1,1,2
27300,60,5237,2654,4015,0,0,0,1,1
27301,60,5238,765;7127,4015,0,0,0,2,2
27302,60,5240,7521;8616,4015,0,0,0,2,2
27303,60,5244,5442;7777,4015,0,0,0,2,2
27304,60,5247,9776;9926,4015,0,0,0,2,2
27305,60,5250,2815;8149,4015,0,0,0,2,2
27306,60,5252,8248,4015,0,0,0,1,1
27307,60,5253,3386,4015,0,0,0,1,1
27308,60,5255,3475;7621;13147,4015,0,0,1,2,3
27309,60,5260,1766;8932,4015,0,0,0,2,2
27310,60,5261,6603;8986,4015,0,0,0,2,2
27311,60,5263,1649,4015,0,0,0,1,1
27312,60,5264,639;9069,4015,0,0,0,2,2
27313,60,5266,2475;6353,4015,0,0,0,2,2
27314,60,5267,2008;6970,4015,0,0,0,2,2
27315,60,5272,2493;8650,4015,0,0,0,2,2
27316,60,5277,674;4963,4380,0,0,0,2,2
27317,60,5283,3530;9940;12343,4380,0,0,1,2,3
27318,60,5284,79;1477,4380,0,0,0,2,2
27319,60,5286,1787;3930,4380,0,0,0,2,2
27320,60,5289,4307;8931,4380,0,0,0,2,2
27321,60,5298,3520,4380,0,0,0,1,1
27322,60,5301,1933;8539,4380,0,0,0,2,2
27323,60,5302,7705,4380,0,0,0,1,1
27324,60,5303,1399;3994,4380,0,0,0,2,2
27325,60,5305,4021;7176,4380,0,0,0,2,2
27326,60,5306,3691;8442,4380,0,0,0,2,2
27327,60,5307,4271;7939;13190,4380,0,0,1,2,3
27328,60,5308,2694;9227,4380,0,0,0,2,2
27329,60,5315,4899;4931,4380,0,0,0,2,2
27330,60,5319,3730,4380,0,0,0,1,1
27331,60,5320,5615,4380,0,0,0,1,1
27332,60,5324,3045,4380,0,0,0,1,1
27333,60,5325,6694;9621,4380,0,0,0,2,2
27334,60,5326,714;6857;12483,4380,0,0,1,2,3
27335,60,5328,2816,4380,0,0,0,1,1
27336,60,5336,5968;9007,4380,0,0,0,2,2
27337,60,5337,9369;9501,4380,0,0,0,2,2
27338,60,5341,3207;8519,4380,0,0,0,2,2
27339,60,5344,944;7323,4380,0,0,0,2,2
27340,60,5345,479;8808,4380,0,0,0,2,2
27341,60,5346,8845,4380,0,0,0,1,1
27342,60,5351,7499,4380,0,0,0,1,1
27343,60,5353,9605,4380,0,0,0,1,1
27344,60,5355,2620;9666,4380,0,0,0,2,2
27345,60,5356,5936;9694,4380,0,0,0,2,2
27346,60,5357,7948,4380,0,0,0,1,1
27347,60,5360,38;7419,4745,0,0,0,2,2
27348,60,5365,3753;8912,4745,0,0,0,2,2
27349,60,5368,838,4745,0,0,0,1,1
27350,60,5370,2085;7158,4745,0,0,1,1,2
27351,60,5371,3011,4745,0,0,0,1,1
27352,60,5372,6652,4745,0,0,0,1,1
27353,60,5373,1301;6407,4745,0,0,0,2,2
27354,60,5375,1500,4745,0,0,0,1,1
27355,60,5377,1537;1726,4745,0,0,0,2,2
27356,60,5379,2239;8520;12844,4745,0,0,1,2,3
27357,60,5380,3574,4745,0,0,0,1,1
27358,60,5383,4576;12284,4745,0,0,1,1,2
27359,60,5384,182;2581;12346;13380,4745,0,0,2,2,4
27360,60,5385,9009;9692,4745,0,0,0,2,2
27361,60,5388,8291;9389,4745,0,0,0,2,2
27362,60,5390,3164;5741,4745,0,0,0,2,2
27363,60,5391,2294,4745,0,0,0,1,1
27364,60,5392,1522,4745,0,0,0,1,1
27365,60,5394,2031;8649,4745,0,0,0,2,2
27366,60,5395,1451,4745,0,0,0,1,1
27367,60,5396,3615;9680,4745,0,0,0,2,2
27368,60,5398,7695,4745,0,0,0,1,1
27369,60,5399,2789;8273,4745,0,0,0,2,2
27370,60,5402,3524,4745,0,0,0,1,1
27371,60,5403,7889,4745,0,0,0,1,1
27372,60,5404,2834;4908,4745,0,0,0,2,2
27373,60,5405,617;2788,4745,0,0,0,2,2
27374,60,5407,5105,4745,0,0,0,1,1
27375,60,5409,3161;5489,4745,0,0,0,2,2
27376,60,5411,3356,4745,0,0,1,0,1
27377,60,5412,2669;13941,4745,0,0,1,1,2
27378,60,5415,5779;11543,4745,0,0,1,1,2
27379,60,5416,5964,4745,0,0,0,1,1
27380,60,5418,3429;6110,4745,0,0,0,2,2
27381,60,5419,5202;6117,4745,0,0,0,2,2
27382,60,5424,6950;9764,4745,0,0,0,2,2
27383,60,5427,6904,4745,0,0,0,1,1
27384,60,5428,8590,4745,0,0,0,1,1
27385,60,5429,5409;7012,4745,0,0,0,2,2
27386,60,5431,1141;1966;13325;13414,4745,0,0,2,2,4
27387,60,5432,3003;5792,4745,0,0,0,2,2
27388,60,5434,7994;9245;13921,4745,0,0,1,2,3
27389,60,5435,3078;8037,4745,0,0,0,2,2
27390,60,5438,1698;8638,4745,0,0,0,2,2
27391,60,5440,6530;8796,4745,0,0,0,2,2
27392,60,5441,8798,4745,0,0,0,1,1
27393,60,5442,3713;5735;13227,4745,0,0,1,2,3
27394,60,5445,9419;9608;13439,4745,0,0,1,2,3
27395,60,5446,4689;9783,4745,0,0,0,2,2
27396,60,5453,6363;8494,5110,0,0,1,1,2
27397,60,5454,444;9339;11786,5110,0,0,1,2,3
27398,60,5459,920;8894,5110,0,0,0,2,2
27399,60,5461,8827;9215,5110,0,0,0,2,2
27400,60,5462,1161;2364,5110,0,0,0,2,2
27401,60,5465,1104;1364,5110,0,0,0,2,2
27402,60,5467,1427;6707,5110,0,0,0,2,2
27403,60,5468,1450,5110,0,0,0,1,1
27404,60,5469,4268;8336,5110,0,0,0,2,2
27405,60,5472,1771;5072,5110,0,0,0,2,2
27406,60,5474,3419;8167,5110,0,0,0,2,2
27407,60,5476,6567;9485,5110,0,0,0,2,2
27408,60,5478,5201,5110,0,0,0,1,1
27409,60,5481,6885;12599,5110,0,0,1,1,2
27410,60,5483,3951;4062,5110,0,0,0,2,2
27411,60,5484,5490,5110,0,0,0,1,1
27412,60,5485,8711;12513,5110,0,0,1,1,2
27413,60,5487,4435,5110,0,0,0,1,1
27414,60,5489,3923,5110,0,0,0,1,1
27415,60,5490,4581,5110,0,0,0,1,1
27416,60,5491,6252,5110,0,0,0,1,1
27417,60,5492,3376,5110,0,0,0,1,1
27418,60,5496,1706;9651,5110,0,0,0,2,2
27419,60,5498,953;5630,5110,0,0,0,2,2
27420,60,5499,5100;5662,5110,0,0,0,2,2
27421,60,5501,5809;6605;12987,5110,0,0,1,2,3
27422,60,5502,3471;6240,5110,0,0,0,2,2
27423,60,5506,8779,5110,0,0,0,1,1
27424,60,5507,5659;9827,5110,0,0,1,1,2
27425,60,5508,9040,5110,0,0,0,1,1
27426,60,5509,6959,5110,0,0,0,1,1
27427,60,5511,4594;7043,5110,0,0,0,2,2
27428,60,5513,1339,5110,0,0,0,1,1
27429,60,5516,8746;9561,5110,0,0,0,2,2
27430,60,5522,7681,5110,0,0,0,1,1
27431,60,5528,1045;5459,5110,0,0,2,0,2
27432,60,5533,3573;13498,5110,0,0,1,1,2
27433,60,5534,431;9693,5110,0,0,0,2,2
27434,60,5536,113;5187;13460,5475,0,0,1,2,3
27435,60,5537,1064,5475,0,0,0,1,1
27436,60,5540,445,5475,0,0,0,1,1
27437,60,5549,1343;8406,5475,0,0,0,2,2
27438,60,5550,37,5475,0,0,0,1,1
27439,60,5552,5234,5475,0,0,0,1,1
27440,60,5553,1544;3945,5475,0,0,0,2,2
27441,60,5555,1670;6127;13566;14650,5475,0,0,3,1,4
27442,60,5558,5021;5114,5475,0,0,0,2,2
27443,60,5560,574;4883;12544,5475,0,0,3,0,3
27444,60,5561,1930;3367,5475,0,0,1,1,2
27445,60,5564,2175,5475,0,0,0,1,1
27446,60,5565,393;2321,5475,0,0,0,2,2
27447,60,5566,5367,5475,0,0,1,0,1
27448,60,5567,2498;7993,5475,0,0,0,2,2
27449,60,5569,8086,5475,0,0,0,1,1
27450,60,5570,2728;3458,5475,0,0,1,1,2
27451,60,5572,2996,5475,0,0,0,1,1
27452,60,5573,212;3120,5475,0,0,0,2,2
27453,60,5574,7509,5475,0,0,0,1,1
27454,60,5575,5869;9637,5475,0,0,0,2,2
27455,60,5576,470;1608,5475,0,0,0,2,2
27456,60,5578,14189;14315;16782,5475,0,1,2,0,3
27457,60,5579,6809;8372;12898,5475,0,0,3,0,3
27458,60,5580,2976;3578,5475,0,0,1,1,2
27459,60,5581,3710;6791,5475,0,0,0,2,2
27460,60,5584,7964;9677;12409,5475,0,0,1,2,3
27461,60,5585,5047;7785,5475,0,0,0,2,2
27462,60,5586,4085;9285,5475,0,0,0,2,2
27463,60,5588,1751;9230,5475,0,0,0,2,2
27464,60,5592,4587,5475,0,0,0,1,1
27465,60,5594,4601;8135,5475,0,0,0,2,2
27466,60,5595,4700;11570,5475,0,0,1,1,2
27467,60,5596,4832;7016,5475,0,0,1,1,2
27468,60,5597,4850;7818,5475,0,0,0,2,2
27469,60,5602,1428;2876,5475,0,0,2,0,2
27470,60,5605,4955;5892,5475,0,0,0,2,2
27471,60,5607,4401,5475,0,0,0,1,1
27472,60,5608,49,5475,0,0,0,1,1
27473,60,5610,4656;6839;13454,5475,0,0,2,1,3
27474,60,5611,2123;7555;13105,5475,0,0,2,1,3
27475,60,5614,2434;6624,5475,0,0,0,2,2
27476,60,5615,1499;7340,5475,0,0,0,2,2
27477,60,5618,6295;7024,5475,0,0,0,2,2
27478,60,5619,3046;7383,5475,0,0,1,1,2
27479,60,5620,3156;7697,5475,0,0,1,1,2
27480,60,5623,4153;7638,5475,0,0,0,2,2
27481,60,5624,1387;3308,5475,0,0,0,2,2
27482,60,5625,7794,5475,0,0,0,1,1
27483,60,5628,793;8010,5475,0,0,0,2,2
27484,60,5629,2783,5475,0,0,0,1,1
27485,60,5632,6847,5475,0,0,0,1,1
27486,60,5634,8641,5475,0,0,0,1,1
27487,60,5635,5241;6088,5475,0,0,0,2,2
27488,60,5636,6229,5475,0,0,0,1,1
27489,60,5637,4544;5991,5475,0,0,1,1,2
27490,60,5639,1485;9400;12557;13049,5475,0,0,2,2,4
27491,60,5641,1060,5475,0,0,0,1,1
27492,60,5642,440,5475,0,0,0,1,1
27493,60,5643,5553;9689,5475,0,0,0,2,2
27494,60,5644,8556;13403,5475,0,0,1,1,2
27495,60,5645,3428;4285;12899,5475,0,0,1,2,3
27496,60,5647,631;9853,5475,0,0,1,1,2
27497,60,5648,9976,5475,0,0,0,1,1
27498,60,5649,612,5840,0,0,0,1,1
27499,60,5652,120;1929,5840,0,0,0,2,2
27500,60,5656,378;1847,5840,0,0,0,2,2
27501,60,5660,6750,5840,0,0,0,1,1
27502,60,5661,8201;10030,5840,0,0,2,0,2
27503,60,5663,2234;13760,5840,0,0,2,0,2
27504,60,5664,6183;6331,5840,0,0,0,2,2
27505,60,5665,1267;4845,5840,0,0,1,1,2
27506,60,5667,1746;6465,5840,0,0,0,2,2
27507,60,5668,3400;8110,5840,0,0,0,2,2
27508,60,5669,7709;13727,5840,0,0,2,0,2
27509,60,5670,163;3503;13480,5840,0,0,1,2,3
27510,60,5677,3233;7500,5840,0,0,0,2,2
27511,60,5678,2365;10105,5840,0,0,1,1,2
27512,60,5681,3029;7634,5840,0,0,1,1,2
27513,60,5683,3209;10012;14513,5840,0,0,3,0,3
27514,60,5685,2271;12492,5840,0,0,2,0,2
27515,60,5686,9056;10040,5840,0,0,2,0,2
27516,60,5687,3071;6309,5840,0,0,0,2,2
27517,60,5689,1667;3146;15598,5840,0,1,1,1,3
27518,60,5690,2404;3968,5840,0,0,0,2,2
27519,60,5692,9726,5840,0,0,0,1,1
27520,60,5697,3840;4752,5840,0,0,0,2,2
27521,60,5698,4101;9589,5840,0,0,0,2,2
27522,60,5699,379;4846;13945,5840,0,0,1,2,3
27523,60,5701,5064,5840,0,0,0,1,1
27524,60,5704,5228;12511,5840,0,0,2,0,2
27525,60,5705,1158;10045,5840,0,0,2,0,2
27526,60,5706,5311;8409,5840,0,0,1,1,2
27527,60,5707,5382;6905,5840,0,0,0,2,2
27528,60,5708,4074;5425,5840,0,0,1,1,2
27529,60,5709,2775;5436,5840,0,0,2,0,2
27530,60,5710,81;7193,5840,0,0,0,2,2
27531,60,5711,7766;10113;12644,5840,0,0,2,1,3
27532,60,5712,250;13111,5840,0,0,1,1,2
27533,60,5714,5985;9454;12033,5840,0,0,1,2,3
27534,60,5716,6911;10027,5840,0,0,2,0,2
27535,60,5720,986;6582;13108,5840,0,0,1,2,3
27536,60,5722,6699;8220,5840,0,0,0,2,2
27537,60,5723,1987;8922,5840,0,0,0,2,2
27538,60,5726,119;7197,5840,0,0,0,2,2
27539,60,5727,6222;7372,5840,0,0,0,2,2
27540,60,5728,6071;8338;13540,5840,0,0,2,1,3
27541,60,5732,8047;12472,5840,0,0,1,1,2
27542,60,5738,5988,5840,0,0,0,1,1
27543,60,5739,6571;8421,5840,0,0,2,0,2
27544,60,5740,7156;9220,5840,0,0,0,2,2
27545,60,5742,480;2880,5840,0,0,0,2,2
27546,60,5744,2245,5840,0,0,0,1,1
27547,60,5746,4945;9150,5840,0,0,1,1,2
27548,60,5747,8967,5840,0,0,0,1,1
27549,60,5748,7316;9037,5840,0,0,1,1,2
27550,60,5750,9211;12512;13312,5840,0,0,3,0,3
27551,60,5754,3725,5840,0,0,0,1,1
27552,60,5763,319;7765,6205,0,0,1,1,2
27553,60,5764,386;10063,6205,0,0,2,0,2
27554,60,5765,477;2370,6205,0,0,2,0,2
27555,60,5766,4385;9514,6205,0,0,1,1,2
27556,60,5767,803,6205,0,0,0,1,1
27557,60,5770,982,6205,0,0,0,1,1
27558,60,5772,4147;9606,6205,0,0,0,2,2
27559,60,5774,3201,6205,0,0,0,1,1
27560,60,5776,44;10061;13444,6205,0,0,3,0,3
27561,60,5779,5002;7341,6205,0,0,0,2,2
27562,60,5783,2316;3883,6205,0,0,0,2,2
27563,60,5784,7914,6205,0,0,0,1,1
27564,60,5785,2689,6205,0,0,0,1,1
27565,60,5787,632;9709,6205,0,0,0,2,2
27566,60,5789,3231;8493,6205,0,0,0,2,2
27567,60,5793,3375,6205,0,0,0,1,1
27568,60,5794,1944;3420,6205,0,0,0,2,2
27569,60,5795,3591;10076,6205,0,0,2,0,2
27570,60,5796,3841;10112;13288,6205,0,0,2,1,3
27571,60,5798,3995;6773,6205,0,0,0,2,2
27572,60,5800,4218,6205,0,0,0,1,1
27573,60,5802,4516;13285,6205,0,0,2,0,2
27574,60,5803,2842;9197,6205,0,0,1,1,2
27575,60,5805,6166;8498,6205,0,0,0,2,2
27576,60,5806,4757,6205,0,0,0,1,1
27577,60,5808,4867;9667;12481;13647,6205,0,0,3,1,4
27578,60,5814,5297;7995,6205,0,0,0,2,2
27579,60,5816,5480;13859,6205,0,0,2,0,2
27580,60,5818,5642,6205,0,0,0,1,1
27581,60,5819,3185;9765;12437,6205,0,0,3,0,3
27582,60,5820,5899,6205,0,0,0,1,1
27583,60,5821,3601,6205,0,0,1,0,1
27584,60,5822,3366;5929,6205,0,0,2,0,2
27585,60,5824,3961,6205,0,0,0,1,1
27586,60,5825,2729;6262;13282,6205,0,0,3,0,3
27587,60,5829,2146;6632,6205,0,0,1,1,2
27588,60,5830,6369,6205,0,0,1,0,1
27589,60,5831,6375,6205,0,0,0,1,1
27590,60,5832,6461;8799,6205,0,0,1,1,2
27591,60,5833,1026;8146,6205,0,0,0,2,2
27592,60,5834,4714;9681,6205,0,0,0,2,2
27593,60,5839,5260;10053,6205,0,0,1,1,2
27594,60,5840,2760;7040,6205,0,0,1,1,2
27595,60,5842,1623;7097,6205,0,0,1,1,2
27596,60,5843,1313;7110,6205,0,0,0,2,2
27597,60,5847,2062;7402,6205,0,0,0,2,2
27598,60,5848,1478;7747;12363,6205,0,0,1,2,3
27599,60,5849,5156;7793,6205,0,0,0,2,2
27600,60,5850,3575;7927,6205,0,0,0,2,2
27601,60,5853,5674;9003,6205,0,0,0,2,2
27602,60,5858,7561;9266,6205,0,0,0,2,2
27603,60,5859,7802;9210,6205,0,0,0,2,2
27604,60,5860,9425,6205,0,0,1,0,1
27605,60,5861,5963;9756,6205,0,0,0,2,2
27606,60,5864,11;5860,6205,0,0,0,2,2
27607,60,5867,93;10246;12177,6570,0,0,3,0,3
27608,60,5869,562;10232,6570,0,0,2,0,2
27609,60,5870,294;652;13187,6570,0,0,1,2,3
27610,60,5871,361;9686,6570,0,0,0,2,2
27611,60,5873,7762;9736;14287,6570,0,0,3,0,3
27612,60,5874,1092,6570,0,0,0,1,1
27613,60,5876,1231;9332,6570,0,0,1,1,2
27614,60,5878,1545;10122;12250,6570,0,0,3,0,3
27615,60,5879,1564,6570,0,0,1,0,1
27616,60,5885,10187;10349;12875,6570,0,0,3,0,3
27617,60,5886,921;7728,6570,0,0,0,2,2
27618,60,5888,13991,6570,0,0,1,0,1
27619,60,5890,2919;9139,6570,0,0,0,2,2
27620,60,5891,2963,6570,0,0,0,1,1
27621,60,5893,960;1191,6570,0,0,2,0,2
27622,60,5894,1027;3058;12211,6570,0,0,2,1,3
27623,60,5895,3118,6570,0,0,1,0,1
27624,60,5897,2950;3145,6570,0,0,0,2,2
27625,60,5898,3255;7025,6570,0,0,0,2,2
27626,60,5899,8698,6570,0,0,1,0,1
27627,60,5900,2322;12503,6570,0,0,1,1,2
27628,60,5901,6091,6570,0,0,0,1,1
27629,60,5910,6933,6570,0,0,0,1,1
27630,60,5919,4219,6570,0,0,0,1,1
27631,60,5923,5040;10089,6570,0,0,1,1,2
27632,60,5925,277;5723,6570,0,0,0,2,2
27633,60,5931,1694;7780,6570,0,0,1,1,2
27634,60,5932,5195;6914,6570,0,0,0,2,2
27635,60,5933,6233;10077,6570,0,0,2,0,2
27636,60,5934,2159;8703,6570,0,0,1,1,2
27637,60,5935,878;10214,6570,0,0,2,0,2
27638,60,5941,2295;7030,6570,0,0,0,2,2
27639,60,5943,4678,6570,0,0,0,1,1
27640,60,5945,8297,6570,0,0,0,1,1
27641,60,5946,2369;7510;13459,6570,0,0,2,1,3
27642,60,5947,10283;10319;13838,6570,0,0,3,0,3
27643,60,5948,4677;5329,6570,0,0,1,1,2
27644,60,5949,1136;7029,6570,0,0,0,2,2
27645,60,5951,8266,6570,0,0,0,1,1
27646,60,5953,4476;7781;13770,6570,0,0,3,0,3
27647,60,5956,7481;8886;13697,6570,0,0,2,1,3
27648,60,5959,7394,6570,0,0,0,1,1
27649,60,5960,3055;8840;13248,6570,0,0,2,1,3
27650,60,5962,3478;9099,6570,0,0,2,0,2
27651,60,5963,9151;10158,6570,0,0,1,1,2
27652,60,5964,2256;2870,6570,0,0,1,1,2
27653,60,5966,3794;5084,6570,0,0,0,2,2
27654,60,5968,6616;6693;13445,6570,0,0,1,2,3
27655,60,5970,268;665,6570,0,0,1,1,2
27656,60,5971,9563;10299,6570,0,0,2,0,2
27657,60,5973,604;9626;12921;13728,6570,0,0,3,1,4
27658,60,5975,2264;9696,6570,0,0,0,2,2
27659,60,5976,2539;9710,6570,0,0,1,1,2
27660,60,5977,6056;9720;12794,6570,0,0,1,2,3
27661,60,5983,5379,6935,0,0,0,1,1
27662,60,5985,316;4630,6935,0,0,0,2,2
27663,60,5988,1826,6935,0,0,0,1,1
27664,60,5993,9507,6935,0,0,0,1,1
27665,60,5994,7163,6935,0,0,0,1,1
27666,60,5995,5698;10155;13635;13903,6935,0,0,4,0,4
27667,60,5997,1904,6935,0,0,0,1,1
27668,60,5998,5798,6935,0,0,0,1,1
27669,60,5999,1940;2069,6935,0,0,1,1,2
27670,60,6001,4704;6990;13541;14313,6935,0,0,4,0,4
27671,60,6003,2242,6935,0,0,0,1,1
27672,60,6005,2494;5016,6935,0,0,0,2,2
27673,60,6011,5937,6935,0,0,1,0,1
27674,60,6017,4833;8701,6935,0,0,2,0,2
27675,60,6020,5032,6935,0,0,1,0,1
27676,60,6021,320;7177;13167,6935,0,0,2,1,3
27677,60,6022,1305;3341;13328,6935,0,0,2,1,3
27678,60,6023,5643;8998,6935,0,0,1,1,2
27679,60,6028,6155;7444;14143,6935,0,0,1,2,3
27680,60,6030,3679,6935,0,0,0,1,1
27681,60,6034,8176,6935,0,0,0,1,1
27682,60,6035,2972;4257,6935,0,0,0,2,2
27683,60,6037,1565;10031;14360,6935,0,0,3,0,3
27684,60,6038,7054,6935,0,0,1,0,1
27685,60,6043,10367;10526,6935,0,0,2,0,2
27686,60,6048,7183,6935,0,0,0,1,1
27687,60,6051,8996,6935,0,0,0,1,1
27688,60,6052,3517;9046,6935,0,0,0,2,2
27689,60,6054,1775,6935,0,0,0,1,1
27690,60,6056,10308,6935,0,0,1,0,1
27691,60,6062,2896;10003,6935,0,0,2,0,2
27692,60,6063,10082;10383,6935,0,0,2,0,2
27693,60,6064,10044;10328;12795;14129;15028,6935,0,0,5,0,5
27694,60,6065,10086;10491;13785,6935,0,0,3,0,3
27695,60,6066,10093;10184,6935,0,0,2,0,2
27696,60,6067,10036;10098,6935,0,0,2,0,2
27697,60,6068,1747;10115,6935,0,0,2,0,2
27698,60,6069,10018;10058,7300,0,0,2,0,2
27699,60,6071,493;6389;13437,7300,0,0,2,1,3
27700,60,6072,1727;3246;14255,7300,0,0,3,0,3
27701,60,6073,545;10484;14831,7300,0,0,3,0,3
27702,60,6074,546;10407,7300,0,0,2,0,2
27703,60,6075,7311;12736,7300,0,0,1,1,2
27704,60,6076,1334;7712;13423,7300,0,0,1,2,3
27705,60,6077,1461;10201,7300,0,0,2,0,2
27706,60,6079,10218;13486;14956,7300,0,0,3,0,3
27707,60,6082,1093;2442,7300,0,0,0,2,2
27708,60,6085,10078;10084,7300,0,0,2,0,2
27709,60,6086,87;7310,7300,0,0,1,1,2
27710,60,6090,3424,7300,0,0,0,1,1
27711,60,6091,3476;6967,7300,0,0,0,2,2
27712,60,6092,3492,7300,0,0,0,1,1
27713,60,6093,3600;10069,7300,0,0,1,1,2
27714,60,6099,3807,7300,0,0,0,1,1
27715,60,6100,10065;14170;14387,7300,0,0,3,0,3
27716,60,6101,9923;13338,7300,0,0,2,0,2
27717,60,6102,4106;10371,7300,0,0,2,0,2
27718,60,6105,3141,7300,0,0,0,1,1
27719,60,6107,10347;10480;15252,7300,0,1,2,0,3
27720,60,6109,1056;4959,7300,0,0,0,2,2
27721,60,6111,5097;13822,7300,0,0,2,0,2
27722,60,6113,2948;5161,7300,0,0,1,1,2
27723,60,6114,5170;8892,7300,0,0,0,2,2
27724,60,6115,3388;5402,7300,0,0,0,2,2
27725,60,6120,6628;8198,7300,0,0,0,2,2
27726,60,6121,5850;9654,7300,0,0,0,2,2
27727,60,6122,5930,7300,0,0,0,1,1
27728,60,6123,8723,7300,0,0,0,1,1
27729,60,6126,10322;10345,7300,0,0,2,0,2
27730,60,6127,6849;7098,7300,0,0,1,1,2
27731,60,6129,5175;10188,7300,0,0,2,0,2
27732,60,6131,4016;7570,7300,0,0,0,2,2
27733,60,6132,7606,7300,0,0,0,1,1
27734,60,6133,13560,7300,0,0,1,0,1
27735,60,6134,7809,7300,0,0,0,1,1
27736,60,6137,8121,7300,0,0,0,1,1
27737,60,6149,2438;3673,7300,0,0,0,2,2
27738,60,6154,2543;9879,7300,0,0,0,2,2
27739,60,6155,9887;10386;14023;15356,7300,0,1,3,0,4
27740,60,6157,10019;10257,7300,0,0,2,0,2
27741,60,6159,10043;10475;15185,7300,0,0,3,0,3
27742,60,6161,9042;10055,7300,0,0,1,1,2
27743,60,6163,10064;10083,7300,0,0,2,0,2
27744,60,6164,10439;14564;15341,7300,0,1,2,0,3
27745,60,6166,10132,7300,0,0,1,0,1
27746,60,6168,10329;10448,7300,0,0,2,0,2
27747,60,6169,4571;10203,7300,0,0,1,1,2
27748,60,6170,228;10205;13992,7300,0,0,2,1,3
27749,60,6171,10213;10224,7300,0,0,2,0,2
27750,60,6172,10400,7300,0,0,1,0,1
27751,60,6173,10219,7300,0,0,1,0,1
27752,60,6174,10075,7665,0,0,1,0,1
27753,60,6175,5460;10094,7665,0,0,1,1,2
27754,60,6177,653;2108,7665,0,0,1,1,2
27755,60,6182,6744;10111;14884,7665,0,0,3,0,3
27756,60,6185,2268;14236,7665,0,0,1,1,2
27757,60,6188,6560,7665,0,0,1,0,1
27758,60,6189,2015;9518;13985,7665,0,0,3,0,3
27759,60,6193,2960;5137,7665,0,0,0,2,2
27760,60,6197,3126;6015,7665,0,0,1,1,2
27761,60,6198,3240;3978,7665,0,0,0,2,2
27762,60,6199,3318;3874;14248,7665,0,0,2,1,3
27763,60,6201,4056;5258,7665,0,0,1,1,2
27764,60,6203,4221;10060,7665,0,0,2,0,2
27765,60,6209,5245;8271,7665,0,0,0,2,2
27766,60,6210,5277;9371,7665,0,0,0,2,2
27767,60,6213,8278;13981;14272,7665,0,0,3,0,3
27768,60,6214,9888,7665,0,0,1,0,1
27769,60,6216,896;13046,7665,0,0,1,1,2
27770,60,6220,7179,7665,0,0,0,1,1
27771,60,6222,262;7255,7665,0,0,0,2,2
27772,60,6223,1044;9580,7665,0,0,2,0,2
27773,60,6224,4169;7671,7665,0,0,0,2,2
27774,60,6226,7724;10395;13753,7665,0,0,3,0,3
27775,60,6229,613;8145;13418,7665,0,0,3,0,3
27776,60,6230,8272,7665,0,0,0,1,1
27777,60,6237,5760,7665,0,0,0,1,1
27778,60,6243,10024;10306,7665,0,0,2,0,2
27779,60,6244,10354;13407,7665,0,0,2,0,2
27780,60,6245,10090;10119;13885,7665,0,0,3,0,3
27781,60,6246,4868;10377;13788;15260,7665,0,1,3,0,4
27782,60,6247,10164;13709,7665,0,0,2,0,2
27783,60,6248,10101;10168;14623;14972,7665,0,0,4,0,4
27784,60,6249,10209;10511,7665,0,0,2,0,2
27785,60,6250,10432,7665,0,0,1,0,1
27786,60,6252,10248;10291,7665,0,0,2,0,2
27787,60,6253,10255;10296;13115,7665,0,0,3,0,3
27788,60,6254,10530,7665,0,0,1,0,1
27789,60,6255,10265;10594;14219,7665,0,0,3,0,3
27790,60,6256,10206;10486,7665,0,0,2,0,2
27791,60,6257,10292;10482;13937,7665,0,0,3,0,3
27792,60,6258,10312;10364,7665,0,0,2,0,2
27793,60,6259,10537;10570;15408,7665,0,1,2,0,3
27794,60,6260,10332;10565;14049,7665,0,0,3,0,3
27795,60,6261,10008;10080,8030,0,0,2,0,2
27796,60,6266,975,8030,0,0,0,1,1
27797,60,6267,1049;8328;13687,8030,0,0,3,0,3
27798,60,6268,7592,8030,0,0,0,1,1
27799,60,6269,1242,8030,0,0,1,0,1
27800,60,6272,839;10156,8030,0,0,2,0,2
27801,60,6273,1218,8030,0,0,0,1,1
27802,60,6274,2067;6649,8030,0,0,0,2,2
27803,60,6278,936,8030,0,0,0,1,1
27804,60,6279,2871;5736,8030,0,0,0,2,2
27805,60,6285,1990;6444,8030,0,0,0,2,2
27806,60,6287,4315,8030,0,0,0,1,1
27807,60,6288,3127;13191,8030,0,0,2,0,2
27808,60,6290,6519,8030,0,0,0,1,1
27809,60,6292,5725,8030,0,0,0,1,1
27810,60,6302,2598,8030,0,0,0,1,1
27811,60,6311,7293,8030,0,0,0,1,1
27812,60,6314,2301;9562,8030,0,0,0,2,2
27813,60,6315,9267;10180,8030,0,0,2,0,2
27814,60,6316,1720;9231,8030,0,0,0,2,2
27815,60,6319,10042;10141;14206,8030,0,0,3,0,3
27816,60,6322,10021;10071,8030,0,0,2,0,2
27817,60,6324,10091;10104;13747,8030,0,0,3,0,3
27818,60,6325,4092,8030,0,0,1,0,1
27819,60,6327,10807;10861;14233;14950,8030,0,0,4,0,4
27820,60,6329,10073;10226,8030,0,0,2,0,2
27821,60,6330,10223;10234;12723,8030,0,0,3,0,3
27822,60,6332,1051;10236;13128,8030,0,0,3,0,3
27823,60,6335,10272,8030,0,0,1,0,1
27824,60,6336,10309;10463,8030,0,0,2,0,2
27825,60,6337,10314;10453;12671;15619,8030,0,1,3,0,4
27826,60,6338,10316;10374,8030,0,0,2,0,2
27827,60,6339,10446;10790;14748,8030,0,0,3,0,3
27828,60,6340,10199;10398,8030,0,0,2,0,2
27829,60,6341,10382,8030,0,0,1,0,1
27830,60,6342,10412,8030,0,0,1,0,1
27831,60,6343,10015;10403;13574,8030,0,0,3,0,3
27832,60,6347,383;6336,8395,0,0,2,0,2
27833,60,6348,476;3859,8395,0,0,0,2,2
27834,60,6351,10038;13452,8395,0,0,2,0,2
27835,60,6352,2121,8395,0,0,1,0,1
27836,60,6354,1308;13500,8395,0,0,1,1,2
27837,60,6356,2784;8052,8395,0,0,1,1,2
27838,60,6357,169;1388;13886,8395,0,0,3,0,3
27839,60,6358,1493;10562;14480,8395,0,0,3,0,3
27840,60,6361,2169;3214,8395,0,0,0,2,2
27841,60,6362,2534;4151;12525;12767,8395,0,0,2,2,4
27842,60,6365,4629;8903,8395,0,0,0,2,2
27843,60,6368,5917;6470,8395,0,0,1,1,2
27844,60,6369,10120;10211,8395,0,0,2,0,2
27845,60,6373,6332,8395,0,0,0,1,1
27846,60,6374,8109;10305,8395,0,0,1,1,2
27847,60,6376,6873;7102,8395,0,0,0,2,2
27848,60,6381,8057,8395,0,0,1,0,1
27849,60,6382,4860,8395,0,0,0,1,1
27850,60,6383,10152;10245;15444,8395,0,1,2,0,3
27851,60,6384,4946;10241,8395,0,0,2,0,2
27852,60,6391,9317,8395,0,0,0,1,1
27853,60,6399,1632,8395,0,0,0,1,1
27854,60,6400,9370,8395,0,0,0,1,1
27855,60,6404,4304;6601;14565,8395,0,0,2,1,3
27856,60,6408,10353;13810,8395,0,0,2,0,2
27857,60,6410,10126;16153,8395,0,1,1,0,2
27858,60,6412,6114;10088;14283,8395,0,0,3,0,3
27859,60,6413,6823;10210;13521,8395,0,0,2,1,3
27860,60,6414,2751;10097;14250,8395,0,0,3,0,3
27861,60,6415,5186;10114,8395,0,0,1,1,2
27862,60,6417,10523;10544;14998,8395,0,0,3,0,3
27863,60,6418,10521;13803;15015,8395,0,0,3,0,3
27864,60,6419,10144;10372,8395,0,0,2,0,2
27865,60,6421,5992;10149;13357,8395,0,0,3,0,3
27866,60,6422,3247;10170;12707;13416,8395,0,0,4,0,4
27867,60,6423,10193;10498;12506,8395,0,0,3,0,3
27868,60,6424,10109;10208;13419,8395,0,0,3,0,3
27869,60,6426,10153;10215;14464,8395,0,0,3,0,3
27870,60,6427,10134;10591;14721,8395,0,0,3,0,3
27871,60,6428,10333;10727;13775,8395,0,0,3,0,3
27872,60,6430,7856;10359,8395,0,0,2,0,2
27873,60,6431,10007;10380;14075,8395,0,0,3,0,3
27874,60,6432,10336;10431,8395,0,0,2,0,2
27875,60,6433,10434;10472;14605,8395,0,0,3,0,3
27876,60,6434,10436,8395,0,0,1,0,1
27877,60,6435,10325;10449;13559,8395,0,0,3,0,3
27878,60,6436,10290;10450;12660;15306,8395,0,1,3,0,4
27879,60,6437,10717;10754;15261,8395,0,1,2,0,3
27880,60,6438,10578;10788;14149;14810,8395,0,0,4,0,4
27881,60,6439,8013,8760,0,0,0,1,1
27882,60,6440,10344;10646;13935,8760,0,0,3,0,3
27883,60,6446,9655;10085;13604,8760,0,0,3,0,3
27884,60,6447,1345;5433,8760,0,0,2,0,2
27885,60,6448,10014;10399,8760,0,0,2,0,2
27886,60,6452,8839;9751,8760,0,0,2,0,2
27887,60,6459,3070;6612,8760,0,0,0,2,2
27888,60,6461,3241;10099;13535,8760,0,0,3,0,3
27889,60,6462,1050;3267,8760,0,0,1,1,2
27890,60,6464,347;3759,8760,0,0,0,2,2
27891,60,6466,5522;10183,8760,0,0,2,0,2
27892,60,6467,2246,8760,0,0,0,1,1
27893,60,6470,3457,8760,0,0,0,1,1
27894,60,6483,1705;6654;13025,8760,0,0,1,2,3
27895,60,6488,5013,8760,0,0,0,1,1
27896,60,6490,3731;5590;12753,8760,0,0,1,2,3
27897,60,6491,7972,8760,0,0,0,1,1
27898,60,6492,8033,8760,0,0,0,1,1
27899,60,6493,8065;8878,8760,0,0,0,2,2
27900,60,6495,7465,8760,0,0,0,1,1
27901,60,6496,199;8526,8760,0,0,0,2,2
27902,60,6501,4990;9506;13213,8760,0,0,2,1,3
27903,60,6503,4456;10035;13456;13830;14613,8760,0,0,5,0,5
27904,60,6504,10020;10025;13868;14034,8760,0,0,4,0,4
27905,60,6505,10195;10288;13389,8760,0,0,3,0,3
27906,60,6506,10066;10138;13259;13805;15101,8760,0,0,5,0,5
27907,60,6508,10167;10250;14342,8760,0,0,3,0,3
27908,60,6509,10579;13568,8760,0,0,2,0,2
27909,60,6511,10735;15835,8760,0,1,1,0,2
27910,60,6513,10501;10668;13481;14946,8760,0,0,4,0,4
27911,60,6514,10023;10118;13794,8760,0,0,3,0,3
27912,60,6515,10411;15143,8760,0,0,2,0,2
27913,60,6516,10423;10741;13818,8760,0,0,3,0,3
27914,60,6517,10176;10425,8760,0,0,2,0,2
27915,60,6518,10427;10674,8760,0,0,2,0,2
27916,60,6519,10590,8760,0,0,1,0,1
27917,60,6520,10461;10505;14054,8760,0,0,3,0,3
27918,60,6521,10494;10895,8760,0,0,2,0,2
27919,60,6522,9849;10068,8760,0,0,2,0,2
27920,60,6523,10513;10850;15012,8760,0,0,3,0,3
27921,60,6524,10517;10661;12774,8760,0,0,3,0,3
27922,60,6525,10276;13898,8760,0,0,2,0,2
27923,60,6526,10524;10797;13829;14037;14351,8760,0,0,5,0,5
27924,60,6527,10507;10534;14314,8760,0,0,3,0,3
27925,60,6528,10339;10547;13003,8760,0,0,3,0,3
27926,60,6529,10563;14102,8760,0,0,2,0,2
27927,60,6531,10671;13956,8760,0,0,2,0,2
27928,60,6532,10274;10595;13779,8760,0,0,3,0,3
27929,60,6533,10350;10597;14011,8760,0,0,3,0,3
27930,60,6538,802,9125,0,0,0,1,1
27931,60,6539,1001;4272,9125,0,0,0,2,2
27932,60,6541,10424;10455;13387,9125,0,0,3,0,3
27933,60,6542,2965;3137;13232,9125,0,0,2,1,3
27934,60,6543,1059;9769,9125,0,0,0,2,2
27935,60,6552,2937,9125,0,0,0,1,1
27936,60,6557,10108;10254;13756,9125,0,0,3,0,3
27937,60,6563,8269;8389,9125,0,0,0,2,2
27938,60,6564,7115;10159,9125,0,0,2,0,2
27939,60,6571,7443;10177,9125,0,0,1,1,2
27940,60,6574,367;7346,9125,0,0,0,2,2
27941,60,6578,1668;2920,9125,0,0,2,0,2
27942,60,6584,10662;10696;13873,9125,0,0,3,0,3
27943,60,6589,9247;10100,9125,0,0,2,0,2
27944,60,6590,10467,9125,0,0,1,0,1
27945,60,6591,10783;10967;13385;14147,9125,0,0,4,0,4
27946,60,6592,10229;10485;15394,9125,0,1,2,0,3
27947,60,6593,10194,9125,0,0,1,0,1
27948,60,6594,1164;10202,9125,0,0,2,0,2
27949,60,6595,10207;13667,9125,0,0,2,0,2
27950,60,6596,10539;14619,9125,0,0,2,0,2
27951,60,6597,10146;10396;13570,9125,0,0,3,0,3
27952,60,6598,10389;10481,9125,0,0,2,0,2
27953,60,6599,10268;10368;13292;14499,9125,0,0,4,0,4
27954,60,6600,10409;10558;13234;14873,9125,0,0,4,0,4
27955,60,6601,10435;10628,9125,0,0,2,0,2
27956,60,6602,10864;10947;15892,9125,0,1,2,0,3
27957,60,6603,10639,9125,0,0,1,0,1
27958,60,6604,10540;10672,9125,0,0,2,0,2
27959,60,6605,10466;10650;13168,9125,0,0,3,0,3
27960,60,6606,10317;10605,9125,0,0,2,0,2
27961,60,6607,10919;10988;14133;14837;15268;15348;15814,9125,0,3,4,0,7
27962,60,6608,10739;10762;15307;15866,9125,0,2,2,0,4
27963,60,6609,10418;14031,9125,0,0,2,0,2
27964,60,6611,10866;11009,9125,0,0,2,0,2
27965,60,6612,10627;13402;14469,9125,0,0,3,0,3
27966,60,6613,10123;10601;14643,9125,0,0,3,0,3
27967,60,6614,10428;10610;14866;15167,9125,0,0,4,0,4
27968,60,6615,10691;10955;13475;15439;15567,9125,0,2,3,0,5
27969,60,6616,10568;10623;13360;14074;14942,9125,0,0,5,0,5
27970,60,6617,10624;10763,9125,0,0,2,0,2
27971,60,6618,10280;10625;12841,9125,0,0,3,0,3
27972,60,6619,10848;14370;15132,9125,0,0,3,0,3
27973,60,6620,10490;10657;14401;14556,9125,0,0,4,0,4
27974,60,6621,10495;10675,9125,0,0,2,0,2
27975,60,6622,10677;10842;15045;15270,9125,0,1,3,0,4
27976,60,6623,10626;10679;14172;15338,9125,0,1,3,0,4
27977,60,6624,10873;14356;15284,9125,0,1,2,0,3
27978,60,6625,10520;10695,9125,0,0,2,0,2
27979,60,6631,6587;7496,9490,0,0,0,2,2
27980,60,6637,1689;8129,9490,0,0,0,2,2
27981,60,6639,877;1840,9490,0,0,0,2,2
27982,60,6646,8150,9490,0,0,1,0,1
27983,60,6653,7241,9490,0,0,0,1,1
27984,60,6657,2953,9490,0,0,0,1,1
27985,60,6660,2833;8408,9490,0,0,0,2,2
27986,60,6667,1140,9490,0,0,0,1,1
27987,60,6668,1192,9490,0,0,0,1,1
27988,60,6671,9826,9490,0,0,0,1,1
27989,60,6673,6469;8697;13524,9490,0,0,2,1,3
27990,60,6675,3019,9490,0,0,1,0,1
27991,60,6677,8425;9117,9490,0,0,0,2,2
27992,60,6680,9113,9490,0,0,0,1,1
27993,60,6682,10009,9490,0,0,1,0,1
27994,60,6684,10300;10457,9490,0,0,2,0,2
27995,60,6686,10217;10489;13365,9490,0,0,3,0,3
27996,60,6687,10253;10510,9490,0,0,2,0,2
27997,60,6688,10251;10508;14114;14594;15019,9490,0,0,5,0,5
27998,60,6689,10171;10615;14176,9490,0,0,3,0,3
27999,60,6690,10190;10267;13399,9490,0,0,3,0,3
28000,60,6691,10285;10376,9490,0,0,2,0,2
28001,60,6693,2979;10039,9490,0,0,1,1,2
28002,60,6694,7530;10192;14667,9490,0,0,3,0,3
28003,60,6695,10515,9490,0,0,1,0,1
28004,60,6696,10196;10445;13260,9490,0,0,3,0,3
28005,60,6698,10459;10504,9490,0,0,2,0,2
28006,60,6699,10636;10881,9490,0,0,2,0,2
28007,60,6700,10573;10596,9490,0,0,2,0,2
28008,60,6701,10493;10792;14906;15043,9490,0,0,4,0,4
28009,60,6702,10503,9490,0,0,1,0,1
28010,60,6703,10320;10546;13563;13974;14865,9490,0,0,5,0,5
28011,60,6704,10497;10645,9490,0,0,2,0,2
28012,60,6705,10560;10564,9490,0,0,2,0,2
28013,60,6706,10576;10799;13149,9490,0,0,3,0,3
28014,60,6707,10577,9490,0,0,1,0,1
28015,60,6708,10585;13065,9490,0,0,2,0,2
28016,60,6709,10580;10592;14620;14986,9490,0,0,4,0,4
28017,60,6710,10528;10604;13946,9490,0,0,3,0,3
28018,60,6711,10419,9490,0,0,1,0,1
28019,60,6712,10611;10885;14625,9490,0,0,3,0,3
28020,60,6713,10259;10616;14285,9490,0,0,3,0,3
28021,60,6714,10240;10687;13056;14260,9490,0,0,4,0,4
28022,60,6715,10640,9490,0,0,1,0,1
28023,60,6716,10827;14266,9490,0,0,2,0,2
28024,60,6717,10337;10670;15050,9490,0,0,3,0,3
28025,60,6718,10676;10731;15170,9490,0,0,3,0,3
28026,60,6719,10825;13367;14017;14344;15130;15800,9490,0,1,5,0,6
28027,60,6720,10406;10700;14983,9490,0,0,3,0,3
28028,60,6721,11010;15423,9490,0,1,1,0,2
28029,60,6722,10720;11053;13646;13802;13995,9490,0,0,5,0,5
28030,60,6723,10413;10977;15617,9490,0,1,2,0,3
28031,60,6724,10804;10878,9490,0,0,2,0,2
28032,60,6725,10791;10821,9490,0,0,2,0,2
28033,60,6728,10373;10421;14268,9855,0,0,3,0,3
28034,60,6729,3198,9855,0,0,0,1,1
28035,60,6731,5967;8417,9855,0,0,0,2,2
28036,60,6738,1247;2621,9855,0,0,0,2,2
28037,60,6739,3087,9855,0,0,0,1,1
28038,60,6740,8949,9855,0,0,0,1,1
28039,60,6743,6347;6537,9855,0,0,0,2,2
28040,60,6744,3561,9855,0,0,1,0,1
28041,60,6749,4448;9364,9855,0,0,0,2,2
28042,60,6750,3842,9855,0,0,1,0,1
28043,60,6754,4956,9855,0,0,1,0,1
28044,60,6755,2265,9855,0,0,0,1,1
28045,60,6756,684;9103,9855,0,0,0,2,2
28046,60,6757,29;10048;14681,9855,0,0,3,0,3
28047,60,6765,5864;7893,9855,0,0,0,2,2
28048,60,6766,4258;8567,9855,0,0,0,2,2
28049,60,6767,460;8763,9855,0,0,0,2,2
28050,60,6772,9985,9855,0,0,0,1,1
28051,60,6773,10029;10127;14306,9855,0,0,3,0,3
28052,60,6774,10303;10430,9855,0,0,2,0,2
28053,60,6775,6729;10239,9855,0,0,1,1,2
28054,60,6776,10225;10230;13552;13993;14321,9855,0,0,5,0,5
28055,60,6777,10266;10315,9855,0,0,2,0,2
28056,60,6778,10294;10548,9855,0,0,2,0,2
28057,60,6779,10174;10304;15289,9855,0,1,2,0,3
28058,60,6780,10341;10532;14783;15156,9855,0,0,4,0,4
28059,60,6781,9728;10362;13277,9855,0,0,2,1,3
28060,60,6782,10145;10365;13627,9855,0,0,3,0,3
28061,60,6783,10037;10366;13433,9855,0,0,3,0,3
28062,60,6784,10352;10369;13397;14040,9855,0,0,4,0,4
28063,60,6785,10358;10402,9855,0,0,2,0,2
28064,60,6786,10323;10464;15529,9855,0,1,2,0,3
28065,60,6787,10197;10506;13769,9855,0,0,3,0,3
28066,60,6788,10702;10968,9855,0,0,2,0,2
28067,60,6789,10456;10853;14277,9855,0,0,3,0,3
28068,60,6790,10647;10909;14455;14750;14780,9855,0,0,5,0,5
28069,60,6791,10545,9855,0,0,1,0,1
28070,60,6792,10488;10588,9855,0,0,2,0,2
28071,60,6793,10529;10871;14640,9855,0,0,3,0,3
28072,60,6794,10334;10584;14085,9855,0,0,3,0,3
28073,60,6797,10630;10701,9855,0,0,2,0,2
28074,60,6798,10220;10631,9855,0,0,2,0,2
28075,60,6799,10648;10892;13278;14174;15569,9855,0,1,4,0,5
28076,60,6800,10654;10758;14569,9855,0,0,3,0,3
28077,60,6801,10447;10669;15189,9855,0,0,3,0,3
28078,60,6802,10518;10703;14371,9855,0,0,3,0,3
28079,60,6803,10551;10705;14803;15049;15453,9855,0,1,4,0,5
28080,60,6804,11130;11185;13757;13860,9855,0,0,4,0,4
28081,60,6805,11004;13973;15710,9855,0,1,2,0,3
28082,60,6806,14016;14404,9855,0,0,2,0,2
28083,60,6807,10707;10785;14688,9855,0,0,3,0,3
28084,60,6808,10499;10795;14271,9855,0,0,3,0,3
28085,60,6809,10442;10812,9855,0,0,2,0,2
28086,60,6810,10816;11110;15151,9855,0,0,3,0,3
28087,60,6811,10836;11025;14741,9855,0,0,3,0,3
28088,60,6812,10600;10847;14710;15083,9855,0,0,4,0,4
28089,60,6813,10749;10889,9855,0,0,2,0,2
28090,60,6814,10899;10970,9855,0,0,2,0,2
28091,60,6815,10903;11197;15715;16051,9855,0,2,2,0,4
28092,60,6823,3289;4475,10220,0,0,0,2,2
28093,60,6828,2625,10220,0,0,0,1,1
28094,60,6834,6107;9883,10220,0,0,0,2,2
28095,60,6839,414,10220,0,0,0,1,1
28096,60,6840,6002;10286;14561,10220,0,0,3,0,3
28097,60,6841,6212;6702,10220,0,0,1,1,2
28098,60,6842,5128;13342,10220,0,0,1,1,2
28099,60,6843,6348;10189,10220,0,0,2,0,2
28100,60,6846,7295,10220,0,0,1,0,1
28101,60,6849,1296;4542,10220,0,0,0,2,2
28102,60,6850,7101,10220,0,0,0,1,1
28103,60,6860,10128;10282;13323,10220,0,0,3,0,3
28104,60,6862,7890,10220,0,0,1,0,1
28105,60,6863,10289;14695,10220,0,0,2,0,2
28106,60,6865,7344;10385,10220,0,0,1,1,2
28107,60,6867,10062;13955,10220,0,0,2,0,2
28108,60,6869,10110;10375;13197;13847,10220,0,0,4,0,4
28109,60,6870,10603;10730;14141,10220,0,0,3,0,3
28110,60,6871,10370;10784,10220,0,0,2,0,2
28111,60,6872,10228;16136,10220,0,1,1,0,2
28112,60,6873,10664;10685,10220,0,0,2,0,2
28113,60,6874,10728;14995,10220,0,0,2,0,2
28114,60,6875,10688;13911;14505;14959,10220,0,0,4,0,4
28115,60,6876,10694;10787;13701;14270;15575,10220,0,1,4,0,5
28116,60,6877,11243,10220,0,0,1,0,1
28117,60,6878,10198;10800;13567;14772,10220,0,0,4,0,4
28118,60,6879,10613;10934;14966;15460,10220,0,1,3,0,4
28119,60,6880,10888;10935;13796;14024;14244;15202,10220,0,1,5,0,6
28120,60,6881,10898;10907,10220,0,0,2,0,2
28121,60,6882,11086;13592;14060,10220,0,0,3,0,3
28122,60,6883,10948;14122;15221,10220,0,1,2,0,3
28123,60,6884,11152,10220,0,0,1,0,1
28124,60,6885,10961;11195;13743;14386;15558,10220,0,1,4,0,5
28125,60,6886,10776;11088;13504;14593;14947,10220,0,0,5,0,5
28126,60,6887,10896;10984;13272;15413,10220,0,1,3,0,4
28127,60,6888,10379;10771;15194,10220,0,1,2,0,3
28128,60,6889,11067;11137;13875;15122,10220,0,0,4,0,4
28129,60,6890,11144;11227;15247,10220,0,1,2,0,3
28130,60,6892,387,10585,0,0,0,1,1
28131,60,6895,804;10026,10585,0,0,1,1,2
28132,60,6897,1382;3798,10585,0,0,0,2,2
28133,60,6899,1803,10585,0,0,0,1,1
28134,60,6900,94;10133,10585,0,0,2,0,2
28135,60,6909,357,10585,0,0,0,1,1
28136,60,6911,2389;5174,10585,0,0,0,2,2
28137,60,6913,1719;5365,10585,0,0,0,2,2
28138,60,6921,3690,10585,0,0,0,1,1
28139,60,6922,10247;12846;13376;14799,10585,0,0,4,0,4
28140,60,6924,10249;10683;14498;14690;15000;15249,10585,0,1,5,0,6
28141,60,6925,10013;10408;15282,10585,0,1,2,0,3
28142,60,6927,10452;10782;13319,10585,0,0,3,0,3
28143,60,6928,10185;10405;14258;14918,10585,0,0,4,0,4
28144,60,6929,10221;10718;14708,10585,0,0,3,0,3
28145,60,6931,10462;10531;14472,10585,0,0,3,0,3
28146,60,6932,10567;10637;14574;15009,10585,0,0,4,0,4
28147,60,6933,10665;10859,10585,0,0,2,0,2
28148,60,6934,10004;10070,10585,0,0,2,0,2
28149,60,6935,10709;10759;15106,10585,0,0,3,0,3
28150,60,6936,10857;11058;15071,10585,0,0,3,0,3
28151,60,6937,10822;14577,10585,0,0,2,0,2
28152,60,6938,11047;11060;14053,10585,0,0,3,0,3
28153,60,6939,10487;10833;15426,10585,0,1,2,0,3
28154,60,6940,10841;10868;13622;14807,10585,0,0,4,0,4
28155,60,6941,10651;10843;14672,10585,0,0,3,0,3
28156,60,6943,10921;10925;14082,10585,0,0,3,0,3
28157,60,6944,10426;10867,10585,0,0,2,0,2
28158,60,6945,10535;10887;14836,10585,0,0,3,0,3
28159,60,6946,10527;10849;14899;15486,10585,0,1,3,0,4
28160,60,6947,11280;11344;14254;15030,10585,0,0,4,0,4
28161,60,6948,10926;11552;15079;15428,10585,0,1,3,0,4
28162,60,6949,10770;11132,10585,0,0,2,0,2
28163,60,6950,10893;11147;14575;15369,10585,0,1,3,0,4
28164,60,6951,10996;11018;13762;15041;15405,10585,0,1,4,0,5
28165,60,6952,10714;11045;14745;15883,10585,0,1,3,0,4
28166,60,6953,11274;11318;13848;14461;16177,10585,0,1,4,0,5
28167,60,6954,11054;11111;15503,10585,0,1,2,0,3
28168,60,6956,10684;11080,10585,0,0,2,0,2
28169,60,6957,11095;11343;13968;14350;14900;16104,10585,0,1,5,0,6
28170,60,6961,8831,10950,0,0,0,1,1
28171,60,6962,10010,10950,0,0,1,0,1
28172,60,6968,2422,10950,0,0,0,1,1
28173,60,6969,2455,10950,0,0,0,1,1
28174,60,6972,4377,10950,0,0,0,1,1
28175,60,6975,636;8824,10950,0,0,0,2,2
28176,60,6977,3438,10950,0,0,0,1,1
28177,60,6981,5301,10950,0,0,0,1,1
28178,60,6983,8987,10950,0,0,0,1,1
28179,60,6990,5604,10950,0,0,0,1,1
28180,60,6991,5684;6408,10950,0,0,0,2,2
28181,60,6999,2774;10231;14273;14720,10950,0,0,4,0,4
28182,60,7000,10154;10311;14153;15298,10950,0,1,3,0,4
28183,60,7002,3472;13917,10950,0,0,2,0,2
28184,60,7003,10011;10378;13651,10950,0,0,3,0,3
28185,60,7005,10394;10557;13672,10950,0,0,3,0,3
28186,60,7007,10186;10420,10950,0,0,2,0,2
28187,60,7009,10756,10950,0,0,1,0,1
28188,60,7010,11037;11194;13496;13557;14319;14738,10950,0,0,6,0,6
28189,60,7012,10764;10805;13681;14073,10950,0,0,4,0,4
28190,60,7013,10891;10924;14407;14877,10950,0,0,4,0,4
28191,60,7014,10342;10793;14760;15940,10950,0,1,3,0,4
28192,60,7015,10642;10796;14163,10950,0,0,3,0,3
28193,60,7016,10927;11268;14096;16024,10950,0,1,3,0,4
28194,60,7017,10693;10808;14691;15207,10950,0,1,3,0,4
28195,60,7018,10817;10922;14815,10950,0,0,3,0,3
28196,60,7019,11133;11168;14852;15308,10950,0,1,3,0,4
28197,60,7020,10789;10883;15293;15949,10950,0,2,2,0,4
28198,60,7021,10950;11093;14545;14802,10950,0,0,4,0,4
28199,60,7022,11296;15183,10950,0,0,2,0,2
28200,60,7023,10912;11077;13834,10950,0,0,3,0,3
28201,60,7024,10972;11174;13505;13872,10950,0,0,4,0,4
28202,60,7025,10755;10851;14246,10950,0,0,3,0,3
28203,60,7026,10979;11284;14990,10950,0,0,3,0,3
28204,60,7028,10989;11122;14676,10950,0,0,3,0,3
28205,60,7029,11005;11460;13671;14403,10950,0,0,4,0,4
28206,60,7030,11006;14546;15577,10950,0,1,2,0,3
28207,60,7032,11035;11248;13817,10950,0,0,3,0,3
28208,60,7033,11036;11048;14300,10950,0,0,3,0,3
28209,60,7034,11041;11170;13884;14428;14712;15145;15774,10950,0,1,6,0,7
28210,60,7035,11462;13584;14559,10950,0,0,3,0,3
28211,60,7036,11415;13648;13893;14393;14999,10950,0,0,5,0,5
28212,60,7037,11068;11326;13663,10950,0,0,3,0,3
28213,60,7038,10999;11298;14941,10950,0,0,3,0,3
28214,60,7039,10716;11099,10950,0,0,2,0,2
28215,60,7040,11300;11374;14744;15180;15606,10950,0,1,4,0,5
28216,60,7041,10824;11103,10950,0,0,2,0,2
28217,60,7042,11043;11281,10950,0,0,2,0,2
28218,60,7043,11126;11441;16150,10950,0,1,2,0,3
28219,60,7044,11055;11128;14396;15225,10950,0,1,3,0,4
28220,60,7045,10928;11029;14421;14612;15748,10950,0,1,4,0,5
28221,60,7046,10966;11159;14013;15290,10950,0,1,3,0,4
28222,60,7047,10786;11145;15123,10950,0,0,3,0,3
28223,60,7048,11154;11299;15073;16068,10950,0,1,3,0,4
28224,60,7049,11251,10950,0,0,1,0,1
28225,60,7050,11165;11409,10950,0,0,2,0,2
28226,60,7051,11339;13639;14335,10950,0,0,3,0,3
28227,60,7052,11056;11261;14514;15961,10950,0,1,3,0,4
28228,60,7054,554;3133,11315,0,0,0,2,2
28229,60,7057,926,11315,0,0,0,1,1
28230,60,7060,6254,11315,0,0,0,1,1
28231,60,7065,3863;10242;14596,11315,0,0,3,0,3
28232,60,7068,3222;4290,11315,0,0,0,2,2
28233,60,7069,10293;10429;14730;15345,11315,0,1,3,0,4
28234,60,7071,2692,11315,0,0,0,1,1
28235,60,7075,3256;6370,11315,0,0,0,2,2
28236,60,7081,7223,11315,0,0,0,1,1
28237,60,7082,5557;7410,11315,0,0,2,0,2
28238,60,7083,7445;10179,11315,0,0,2,0,2
28239,60,7092,9987,11315,0,0,0,1,1
28240,60,7093,10348;10388,11315,0,0,2,0,2
28241,60,7095,10279;14854,11315,0,0,2,0,2
28242,60,7096,10135;10137,11315,0,0,2,0,2
28243,60,7098,10313;14609,11315,0,0,2,0,2
28244,60,7099,10360,11315,0,0,1,0,1
28245,60,7100,10441;10897;15626,11315,0,1,2,0,3
28246,60,7101,10794;14175;15021,11315,0,0,3,0,3
28247,60,7102,10361;13932;14700,11315,0,0,3,0,3
28248,60,7103,10638;10761;14358;14871,11315,0,0,4,0,4
28249,60,7104,10598;10742;13961,11315,0,0,3,0,3
28250,60,7105,10806;11277;14047,11315,0,0,3,0,3
28251,60,7107,10384;10617;13977;14510;16430,11315,0,1,4,0,5
28252,60,7108,10629;10991;14729;15137,11315,0,0,4,0,4
28253,60,7110,10743;11061;14162;14709,11315,0,0,4,0,4
28254,60,7111,10778;10802;14914,11315,0,0,3,0,3
28255,60,7112,10561;10844;14538;14679;16033,11315,0,1,4,0,5
28256,60,7114,10719;10901;14582;15179,11315,0,0,4,0,4
28257,60,7115,10914;11087;13798,11315,0,0,3,0,3
28258,60,7116,10777;10930;14210;15407,11315,0,1,3,0,4
28259,60,7117,10801;10931,11315,0,0,2,0,2
28260,60,7118,10936;11158,11315,0,0,2,0,2
28261,60,7119,10943;11267;14737;15006,11315,0,0,4,0,4
28262,60,7120,10549;10974;13586;14598,11315,0,0,4,0,4
28263,60,7121,10810;10976,11315,0,0,2,0,2
28264,60,7123,10990;11007;14196;15437,11315,0,1,3,0,4
28265,60,7125,11526;14878;15363,11315,0,1,2,0,3
28266,60,7126,11051;11084;14794;15636,11315,0,1,3,0,4
28267,60,7127,10815;11101;13988;14265,11315,0,0,4,0,4
28268,60,7128,10699;11105;14484;15061,11315,0,0,4,0,4
28269,60,7129,11218;11334;14010;14724,11315,0,0,4,0,4
28270,60,7130,10969;11156;14967,11315,0,0,3,0,3
28271,60,7132,11033;11179;13750;14296;14512,11315,0,0,5,0,5
28272,60,7133,11186;11189;14324;15589,11315,0,1,3,0,4
28273,60,7134,11233;15017,11315,0,0,2,0,2
28274,60,7135,11113;11249;14474;15149;16464,11315,0,1,4,0,5
28275,60,7136,10768;11271;13964;14111,11315,0,0,4,0,4
28276,60,7137,11013;11278;13645;15373,11315,0,1,3,0,4
28277,60,7140,5738;9161,11680,0,0,1,1,2
28278,60,7141,3150;5549,11680,0,0,0,2,2
28279,60,7149,10017;10298;13999,11680,0,0,3,0,3
28280,60,7151,3886;4295,11680,0,0,1,1,2
28281,60,7159,5526;8100,11680,0,0,0,2,2
28282,60,7160,6805;9729,11680,0,0,0,2,2
28283,60,7165,9316;10237;13675;14969,11680,0,0,3,1,4
28284,60,7167,160;9741;14374,11680,0,0,2,1,3
28285,60,7168,10125;10191;13668,11680,0,0,3,0,3
28286,60,7169,10356;10468,11680,0,0,2,0,2
28287,60,7170,10148;10363,11680,0,0,2,0,2
28288,60,7171,10327;10496;13780;14515,11680,0,0,4,0,4
28289,60,7172,10161;10512;14115;14756,11680,0,0,4,0,4
28290,60,7173,10477;10586;14934,11680,0,0,3,0,3
28291,60,7174,10509;11240,11680,0,0,2,0,2
28292,60,7175,10819;10835;14663;15007,11680,0,0,4,0,4
28293,60,7176,10479;10593;14996;15138,11680,0,0,4,0,4
28294,60,7177,10643;10712;13765;13800;14422;14885,11680,0,0,6,0,6
28295,60,7178,10973;14488;14963,11680,0,0,3,0,3
28296,60,7179,10673;11222;13857;14295,11680,0,0,4,0,4
28297,60,7180,10834;11062;14159;14671,11680,0,0,4,0,4
28298,60,7181,10862;11015;14797;15670,11680,0,1,3,0,4
28299,60,7182,10559;10773;14973,11680,0,0,3,0,3
28300,60,7183,10471;10780;15551,11680,0,1,2,0,3
28301,60,7184,10832;11024;14148,11680,0,0,3,0,3
28302,60,7185,10732;10869;14904,11680,0,0,3,0,3
28303,60,7186,10659;10880;15010;15988,11680,0,1,3,0,4
28304,60,7187,10632;10884;14027,11680,0,0,3,0,3
28305,60,7188,10945;11063;14408;14752,11680,0,0,4,0,4
28306,60,7189,10550;10938;14864;15435,11680,0,1,3,0,4
28307,60,7190,10451;10954;13691;14614;16146,11680,0,1,4,0,5
28308,60,7191,10964;11216;14508;15032;15846,11680,0,1,4,0,5
28309,60,7192,10994;11149;14257,11680,0,0,3,0,3
28310,60,7193,10751;10982;15026,11680,0,0,3,0,3
28311,60,7194,11040;11694;14136;15152;15242;15634,11680,0,2,4,0,6
28312,60,7195,11079;11496;15757,11680,0,1,2,0,3
28313,60,7196,10890;11112;14490,11680,0,0,3,0,3
28314,60,7197,11049;11136;15406;15692,11680,0,2,2,0,4
28315,60,7198,11032;11586;14685;15140;16092,11680,0,1,4,0,5
28316,60,7199,11289;11352;15214;15350;15879,11680,0,3,2,0,5
28317,60,7200,10752;10870;14641;15105,11680,0,0,4,0,4
28318,60,7201,11121;11211;14426;14894,11680,0,0,4,0,4
28319,60,7202,11213;11369;14442,11680,0,0,3,0,3
28320,60,7203,11238;11692;14304;15223;15580;15752,11680,0,3,3,0,6
28321,60,7204,11242;11689;14519;16879,11680,1,0,3,0,4
28322,60,7206,11256;14436,11680,0,0,2,0,2
28323,60,7207,11259;11288;15052;15494,11680,0,1,3,0,4
28324,60,7208,11297;11550;15724;16071;16412,11680,0,3,2,0,5
28325,60,7209,11142;11301;14542;15100,11680,0,0,4,0,4
28326,60,7210,10906;11303;14209;15036,11680,0,0,4,0,4
28327,60,7211,10410;11329;13670;14240;14765,11680,0,0,5,0,5
28328,60,7212,11331;11587;14120;14952;15084;15380;15717,11680,0,2,5,0,7
28329,60,7213,11200;11346;13686;14439;15004,11680,0,0,5,0,5
28330,60,7214,11353;11630;14636;16269,11680,0,1,3,0,4
28331,60,7215,10840;11366;13764;15155,11680,0,0,4,0,4
28332,60,7216,11224;14460;14558,11680,0,0,3,0,3
28333,60,7217,11381;11430;14863;15074,11680,0,0,4,0,4
28334,60,7218,11387;11571;15022;15446;15726,11680,0,2,3,0,5
28335,60,7220,1526;2875,12045,0,0,0,2,2
28336,60,7224,1633;3880,12045,0,0,0,2,2
28337,60,7228,1622,12045,0,0,0,1,1
28338,60,7234,2855;9750,12045,0,0,1,1,2
28339,60,7243,170;9838,12045,0,0,0,2,2
28340,60,7247,7315,12045,0,0,0,1,1
28341,60,7253,4523,12045,0,0,1,0,1
28342,60,7259,10263;10404;14481;14580,12045,0,0,4,0,4
28343,60,7260,10635;11002;15053;15400,12045,0,1,3,0,4
28344,60,7266,10575;10614,12045,0,0,2,0,2
28345,60,7267,11183;14979,12045,0,0,2,0,2
28346,60,7268,10622;10902;14694;15750,12045,0,1,3,0,4
28347,60,7269,10666;14610;14890,12045,0,0,3,0,3
28348,60,7270,10541,12045,0,0,1,0,1
28349,60,7271,10682;11116;13869;15037,12045,0,0,4,0,4
28350,60,7273,10602;10722;14299;14389,12045,0,0,4,0,4
28351,60,7275,10478;10750;14213,12045,0,0,3,0,3
28352,60,7276,10460;10753;15266,12045,0,1,2,0,3
28353,60,7278,10803;10831;14994;15235,12045,0,1,3,0,4
28354,60,7279,10809;14886;15027;15286;15922;16477,12045,0,3,3,0,6
28355,60,7280,10854;11273;14199;14420;14631;15596,12045,0,1,5,0,6
28356,60,7282,10514;10894;14217;14589,12045,0,0,4,0,4
28357,60,7283,10905;14851;14915;15324,12045,0,1,3,0,4
28358,60,7286,11206;11308;14201;15297,12045,0,1,3,0,4
28359,60,7287,10959;11135;14019;14590,12045,0,0,4,0,4
28360,60,7288,11057;11059;14654,12045,0,0,3,0,3
28361,60,7289,10997;11091;15302,12045,0,1,2,0,3
28362,60,7290,11016;11292;14280;15141;15679,12045,0,1,4,0,5
28363,60,7292,11442;14662;16206,12045,0,1,2,0,3
28364,60,7293,10658;11141;13820;15480,12045,0,1,3,0,4
28365,60,7294,11157;14391;14891;15779,12045,0,1,3,0,4
28366,60,7295,10986;11203;14447;15142,12045,0,0,4,0,4
28367,60,7296,11205;11556;16872,12045,1,0,2,0,3
28368,60,7297,11208;11228;13832;15573,12045,0,1,3,0,4
28369,60,7298,11209;11320;13925,12045,0,0,3,0,3
28370,60,7299,11279;11597;13906;14642;15150;15562,12045,0,1,5,0,6
28371,60,7300,11069;11225;14785;15488,12045,0,1,3,0,4
28372,60,7301,11204;11307;14303;14989;15450,12045,0,1,4,0,5
28373,60,7305,11064;11294;14725;15001,12045,0,0,4,0,4
28374,60,7306,11309;11465;14309;15184;15572;16182;16865,12045,1,2,4,0,7
28375,60,7307,11328;11528;14157;15011;15902,12045,0,1,4,0,5
28376,60,7308,11720;11773;13835;14347;14482,12045,0,0,5,0,5
28377,60,7309,11350;13915;14507;14659;15059;15325;15712,12045,0,2,5,0,7
28378,60,7310,11119;11356;15110;16359,12045,0,1,3,0,4
28379,60,7311,11270;11379;14875;15070,12045,0,0,4,0,4
28380,60,7312,11544;14452;14840;15334,12045,0,1,3,0,4
28381,60,7313,11751;11970;14450;15250;16519,12045,0,2,3,0,5
28382,60,7314,11405;11457;15993;16455,12045,0,2,2,0,4
28383,60,7315,11377;11424;15673,12045,0,1,2,0,3
28384,60,7316,11637;11681;15188;15343,12045,0,1,3,0,4
28385,60,7317,11433;11469;14294;15054;15349;15886,12045,0,2,4,0,6
28386,60,7318,11447;11478;14726;16103,12045,0,1,3,0,4
28387,60,7319,11458;11518;14759;15913,12045,0,1,3,0,4
28388,60,7320,11468;14090;16038,12045,0,1,2,0,3
28389,60,7321,11388;11481;15962,12045,0,1,2,0,3
28390,60,7322,11423;11482;14727;14812;15410;15485,12045,0,2,4,0,6
28391,60,7323,2975;10151;15014;15323,12410,0,1,3,0,4
28392,60,7326,330;4474,12410,0,0,0,2,2
28393,60,7335,8679,12410,0,0,0,1,1
28394,60,7346,3086,12410,0,0,0,1,1
28395,60,7347,6344;7121,12410,0,0,0,2,2
28396,60,7348,4142,12410,0,0,0,1,1
28397,60,7352,5249,12410,0,0,0,1,1
28398,60,7353,3504;7990,12410,0,0,0,2,2
28399,60,7361,3481;10116,12410,0,0,2,0,2
28400,60,7364,10130;10318;13987;14553,12410,0,0,4,0,4
28401,60,7365,10619;14424;15361,12410,0,1,2,0,3
28402,60,7366,10301;10415;14419;14829,12410,0,0,4,0,4
28403,60,7367,11337;14916;15259,12410,0,1,2,0,3
28404,60,7368,10745;11310;15906;15982,12410,0,2,2,0,4
28405,60,7369,10721;10760;14782;15209;15600,12410,0,2,3,0,5
28406,60,7370,11039;14298,12410,0,0,2,0,2
28407,60,7371,10704;11207;15002,12410,0,0,3,0,3
28408,60,7372,11028;11073;14463;15785;16011,12410,0,2,3,0,5
28409,60,7373,10587;10820;14475;15304,12410,0,1,3,0,4
28410,60,7376,11198;15340;15631,12410,0,2,1,0,3
28411,60,7377,10612;10937;14267;14535;15700,12410,0,1,4,0,5
28412,60,7378,11223;11506;14562;15134;15432,12410,0,1,4,0,5
28413,60,7379,11020;11217;14410,12410,0,0,3,0,3
28414,60,7380,10917;11030;14728,12410,0,0,3,0,3
28415,60,7381,11475;15162;15239,12410,0,1,2,0,3
28416,60,7382,10929;11092;14400,12410,0,0,3,0,3
28417,60,7383,11312;16517,12410,0,1,1,0,2
28418,60,7384,11124;11467;15895,12410,0,1,2,0,3
28419,60,7385,11422;11519;15865,12410,0,1,2,0,3
28420,60,7386,11181,12410,0,0,1,0,1
28421,60,7387,11220;11376,12410,0,0,2,0,2
28422,60,7388,11393;11613;14467;15125,12410,0,0,4,0,4
28423,60,7389,11549;14699;14795;15430,12410,0,1,3,0,4
28424,60,7390,11262;11384;14520,12410,0,0,3,0,3
28425,60,7391,11263;11615;14664;14911,12410,0,0,4,0,4
28426,60,7392,11003;11265,12410,0,0,2,0,2
28427,60,7393,11686;11825;14185;14739,12410,0,0,4,0,4
28428,60,7394,11100;11313;14692,12410,0,0,3,0,3
28429,60,7395,11327;11529;14924;15211;15424,12410,0,2,3,0,5
28430,60,7397,11438;13972;15496;16315,12410,0,2,2,0,4
28431,60,7398,11023;11306;14491,12410,0,0,3,0,3
28432,60,7399,10951;11436;15616;15944;16188,12410,0,3,2,0,5
28433,60,7400,11452;11472;14751;14917;15326;17166,12410,1,1,4,0,6
28434,60,7401,11382;11486;15094;15205,12410,0,1,3,0,4
28435,60,7402,11497;11598;14984;15622;15942;16248,12410,0,3,3,0,6
28436,60,7403,11258;11503;14971;15385,12410,0,1,3,0,4
28437,60,7404,11611;11809;13994;14579,12410,0,0,4,0,4
28438,60,7405,11647;11660;15862,12410,0,1,2,0,3
28439,60,7407,11163;11687;14867;15271;15491;16036;16084,12410,0,4,3,0,7
28440,60,7408,11535;11589;15623,12410,0,1,2,0,3
28441,60,7409,11302;11593;15103;15384;15667,12410,0,2,3,0,5
28442,60,7415,3184,12775,0,0,0,1,1
28443,60,7418,2330,12775,0,0,0,1,1
28444,60,7420,5449,12775,0,0,0,1,1
28445,60,7422,5974,12775,0,0,0,1,1
28446,60,7424,7405,12775,0,0,0,1,1
28447,60,7425,6,12775,0,0,0,1,1
28448,60,7426,931;9572,12775,0,0,0,2,2
28449,60,7427,4229;7304,12775,0,0,1,1,2
28450,60,7429,7385,12775,0,0,0,1,1
28451,60,7430,181,12775,0,0,0,1,1
28452,60,7431,8236,12775,0,0,0,1,1
28453,60,7436,10338;14098,12775,0,0,2,0,2
28454,60,7441,10470;10566;14770;15182,12775,0,0,4,0,4
28455,60,7445,10652;14116;14338,12775,0,0,3,0,3
28456,60,7446,10346;10663;14533;15429,12775,0,1,3,0,4
28457,60,7447,10256;10737;14647;14697,12775,0,0,4,0,4
28458,60,7449,10583;10660;14286;14383;14648;14796;15376,12775,0,1,6,0,7
28459,60,7450,11081;11236;14373;16050,12775,0,1,3,0,4
28460,60,7451,11266;14221;14964,12775,0,0,3,0,3
28461,60,7452,10886;11428;14826;14902;15574;15967;16670,12775,0,3,4,0,7
28462,60,7453,10980;11160;14173;14423;15082,12775,0,0,5,0,5
28463,60,7454,11085;11214;14861;14982,12775,0,0,4,0,4
28464,60,7455,11090;11283,12775,0,0,2,0,2
28465,60,7456,10852;11107;14156;14639;15111,12775,0,0,5,0,5
28466,60,7457,11108;11563;14879;15827,12775,0,1,3,0,4
28467,60,7458,11021;11134;14180;14281;14788,12775,0,0,5,0,5
28468,60,7459,11138;15068,12775,0,0,2,0,2
28469,60,7461,11210;11902;15591;17335,12775,1,1,2,0,4
28470,60,7462,11253;11448;14766;15392,12775,0,1,3,0,4
28471,60,7464,11199;11272;15165,12775,0,0,3,0,3
28472,60,7465,11654;11759;14844,12775,0,0,3,0,3
28473,60,7466,11096;11461;15566;15767,12775,0,2,2,0,4
28474,60,7467,11358;11901;14127;16525,12775,0,1,3,0,4
28475,60,7468,11345;11639;14583;15016,12775,0,0,4,0,4
28476,60,7469,11361;11693;14137;14348;14554;14974,12775,0,0,6,0,6
28477,60,7470,11619;11813;14543;15300,12775,0,1,3,0,4
28478,60,7471,11380;11920;15459;16496,12775,0,2,2,0,4
28479,60,7472,11397;11522;14938,12775,0,0,3,0,3
28480,60,7473,11370;11651;16003,12775,0,1,2,0,3
28481,60,7474,11315;11399;15789,12775,0,1,2,0,3
28482,60,7475,11404;11969;15601;16237;16602,12775,0,3,2,0,5
28483,60,7476,11386;11411;14841;15763,12775,0,1,3,0,4
28484,60,7477,11252;11431;15312;15464,12775,0,2,2,0,4
28485,60,7478,11790;11928;14502;16266,12775,0,1,3,0,4
28486,60,7479,11491;11662;15164;15217,12775,0,1,3,0,4
28487,60,7480,11488;11500;14526,12775,0,0,3,0,3
28488,60,7482,11505;11509;14557;15595;15772,12775,0,2,3,0,5
28489,60,7484,11511;11707;14903;15481;15674;15756;16712,12775,0,4,3,0,7
28490,60,7485,11514;12025;14888;15389;15557;15731,12775,0,3,3,0,6
28491,60,7486,11330;11614;15527,12775,0,1,2,0,3
28492,60,7487,11741;14540;14931,12775,0,0,3,0,3
28493,60,7488,11832;15163;15820,12775,0,1,2,0,3
28494,60,7489,11360;11640;14486;15522;16263,12775,0,2,3,0,5
28495,60,7490,11670;11804;14109;15946,12775,0,1,3,0,4
28496,60,7491,11581;11683;15098;15381,12775,0,1,3,0,4
28497,60,7495,2967,13140,0,0,0,1,1
28498,60,7496,1352,13140,0,0,0,1,1
28499,60,7497,7920,13140,0,0,0,1,1
28500,60,7498,5087;6637,13140,0,0,0,2,2
28501,60,7499,6875,13140,0,0,0,1,1
28502,60,7500,488,13140,0,0,0,1,1
28503,60,7501,8014,13140,0,0,0,1,1
28504,60,7505,1515;2342,13140,0,0,0,2,2
28505,60,7509,1586,13140,0,0,0,1,1
28506,60,7511,10087;10343;14774,13140,0,0,3,0,3
28507,60,7512,218,13140,0,0,1,0,1
28508,60,7518,10689;14518;14940,13140,0,0,3,0,3
28509,60,7519,10525;11044;14746;14830,13140,0,0,4,0,4
28510,60,7520,10680;10876;15076;15422,13140,0,1,3,0,4
28511,60,7522,10667;11071;14711;14898;15267,13140,0,1,4,0,5
28512,60,7523,10863;11182;14264;15652;16140,13140,0,2,3,0,5
28513,60,7524,10607;10708;15222,13140,0,1,2,0,3
28514,60,7525,10740;14674,13140,0,0,2,0,2
28515,60,7527,10830;10837;14978;16311,13140,0,1,3,0,4
28516,60,7529,10433;10920;14818,13140,0,0,3,0,3
28517,60,7530,11014;11190;14701,13140,0,0,3,0,3
28518,60,7531,11022;11151;14405,13140,0,0,3,0,3
28519,60,7532,11031;11226;14665;14908,13140,0,0,4,0,4
28520,60,7534,11078;11443;14587;14929;16049,13140,0,1,4,0,5
28521,60,7535,11161;11425;15072;15278;16040,13140,0,2,3,0,5
28522,60,7536,11167;11407;15620,13140,0,1,2,0,3
28523,60,7537,11173;11684;14411;15552;15654,13140,0,2,3,0,5
28524,60,7538,11176;14621,13140,0,0,2,0,2
28525,60,7539,11038;11180;14226;14962;15483;15804;16748,13140,0,3,4,0,7
28526,60,7540,11201;11479;16190,13140,0,1,2,0,3
28527,60,7541,11254;11752;15279;15514;15810;16387,13140,0,4,2,0,6
28528,60,7542,11237;11290;14696;14781;15434,13140,0,1,4,0,5
28529,60,7543,11291;11498;14629;15335;15371,13140,0,2,3,0,5
28530,60,7544,11042;11311;14228;14856,13140,0,0,4,0,4
28531,60,7545,11097;14817;15443,13140,0,1,2,0,3
28532,60,7546,10962;11341;14381;14957,13140,0,0,4,0,4
28533,60,7548,11420;11889;14907;16717,13140,0,1,3,0,4
28534,60,7550,11918;14349;14936;15538,13140,0,1,3,0,4
28535,60,7551,11466;11480;14511;15821,13140,0,1,3,0,4
28536,60,7552,11625;11879;14249;14776;15746,13140,0,1,4,0,5
28537,60,7553,11017;11504;14736;15521;16423,13140,0,2,3,0,5
28538,60,7554,10941;11507;14919;15477;15989,13140,0,2,3,0,5
28539,60,7555,11512;15008;15889,13140,0,1,2,0,3
28540,60,7556,12003;15023;15240;15630;15920,13140,0,3,2,0,5
28541,60,7557,11551;11980;14366;16623;16825,13140,0,2,3,0,5
28542,60,7558,11351;11559;14234;15586,13140,0,1,3,0,4
28543,60,7559,11567;11938;14529;14809;15475,13140,0,1,4,0,5
28544,60,7560,11414;11579;14921;15465;16174,13140,0,2,3,0,5
28545,60,7561,11595;14793;15093;15457,13140,0,1,3,0,4
28546,60,7562,11446;11616;14604;15020;15684,13140,0,1,4,0,5
28547,60,7563,11803;12068;15749;16027;16775,13140,0,3,2,0,5
28548,60,7564,11304;11721;14237;15375;16329,13140,0,2,3,0,5
28549,60,7565,11657;14792;15181,13140,0,0,3,0,3
28550,60,7567,11691;11700;14509;15121;15853,13140,0,1,4,0,5
28551,60,7568,11711;12086;14777;15234;15511;15994,13140,0,3,3,0,6
28552,60,7569,11712;11887;15658;15799,13140,0,2,2,0,4
28553,60,7570,11650;11742;15178;16690,13140,0,1,3,0,4
28554,60,7571,11763;11878;15254;16274,13140,0,2,2,0,4
28555,60,7572,11713;11783;15612,13140,0,1,2,0,3
28556,60,7573,11665;11800;15455;15758,13140,0,2,2,0,4
28557,60,7578,1655,13505,0,0,0,1,1
28558,60,7580,2176,13505,0,0,0,1,1
28559,60,7585,7391,13505,0,0,0,1,1
28560,60,7589,6936;7216,13505,0,0,0,2,2
28561,60,7590,5504,13505,0,0,0,1,1
28562,60,7598,1653;9818,13505,0,0,0,2,2
28563,60,7601,9431,13505,0,0,0,1,1
28564,60,7602,8757;9214,13505,0,0,0,2,2
28565,60,7607,10302;10387;15092;15231,13505,0,1,3,0,4
28566,60,7608,10273;10653;14814;14913,13505,0,0,4,0,4
28567,60,7615,10729;11115;14444;14784;15687,13505,0,1,4,0,5
28568,60,7617,10686;10725;15797,13505,0,1,2,0,3
28569,60,7618,10724,13505,0,0,1,0,1
28570,60,7619,10726;11364;14722;14887,13505,0,0,4,0,4
28571,60,7621,10814;14883,13505,0,0,2,0,2
28572,60,7624,11419;11795;15066;15829;16017,13505,0,2,3,0,5
28573,60,7625,10882;11239;14367;15200;16154,13505,0,2,3,0,5
28574,60,7626,11317;11760;14607;15166;15925,13505,0,1,4,0,5
28575,60,7627,11354;11703;15362;15971,13505,0,2,2,0,4
28576,60,7628,11622;11863;15342;16328,13505,0,2,2,0,4
28577,60,7629,11421;11585;14377;14706;14976;15388,13505,0,1,5,0,6
28578,60,7630,11788;14437;15313;16112;16260,13505,0,3,2,0,5
28579,60,7631,11363;11439;14948;15682,13505,0,1,3,0,4
28580,60,7632,11440;11935;15203;15500;15741,13505,0,3,2,0,5
28581,60,7633,11576;11666;15607;16601,13505,0,2,2,0,4
28582,60,7634,11515;11848;15320;15975,13505,0,2,2,0,4
28583,60,7635,11456;11471;14670;16273;16795,13505,0,2,3,0,5
28584,60,7636,11473;12053;14732;15965,13505,0,1,3,0,4
28585,60,7637,10987;11474;14734;14869;15042;16836,13505,0,1,5,0,6
28586,60,7638,11476;11638;15347,13505,0,1,2,0,3
28587,60,7639,11485;11492;15038;16161,13505,0,1,3,0,4
28588,60,7640,11523;11842;14570;15848;16358,13505,0,2,3,0,5
28589,60,7641,11094;11357;15351;15633;16442,13505,0,3,2,0,5
28590,60,7642,11599;11796;14388;15257;15806,13505,0,2,3,0,5
28591,60,7643,11876;12081;14850;15108;15292,13505,0,1,4,0,5
28592,60,7644,12111;14433;15357,13505,0,1,2,0,3
28593,60,7645,11817;11944;15177;16510;16982,13505,1,1,3,0,5
28594,60,7646,11489;11644;14773;15456;15560,13505,0,2,3,0,5
28595,60,7647,11774;11886;15233,13505,0,1,2,0,3
28596,60,7648,11698;15095;15462;15608,13505,0,2,2,0,4
28597,60,7649,11726;12069;14632;15046;17033,13505,1,0,4,0,5
28598,60,7650,11714;12087;14384;15396,13505,0,1,3,0,4
28599,60,7651,11727;11877;14870;15832,13505,0,1,3,0,4
28600,60,7652,11470;11734;16035;16277,13505,0,2,2,0,4
28601,60,7653,11750;12274;15174;15641;15831;16786,13505,0,3,3,0,6
28602,60,7654,11762;11778;14431;14591;16685,13505,0,1,4,0,5
28603,60,7655,11769;11810;14617;14926;15893,13505,0,1,4,0,5
28604,60,7656,11771;12023;16093,13505,0,1,2,0,3
28605,60,7657,11953;12135;14680;15135;15241,13505,0,1,4,0,5
28606,60,7658,11656;11808;14858;15187;15379,13505,0,1,4,0,5
28607,60,7659,11678;11815;16249;16999,13505,1,1,2,0,4
28608,60,7660,11833;11999;14820;15694;16019,13505,0,2,3,0,5
28609,60,7661,11620;11834;15327;16835,13505,0,2,2,0,4
28610,60,7662,11410;11840;14718,13505,0,0,3,0,3
28611,60,7663,11855;11981;16151,13505,0,1,2,0,3
28612,60,7664,11868;12175;15314;16558;17053,13505,1,2,2,0,5
28613,60,7665,11982;12029;14920;15131;15816,13505,0,1,4,0,5
28614,60,7666,11883;12067;15472;16002;17301,13505,1,2,2,0,5
28615,60,7667,11545;11966;15264,13505,0,1,2,0,3
28616,60,7672,6275;14838,13870,0,0,1,1,2
28617,60,7682,5390,13870,0,0,0,1,1
28618,60,7691,5787,13870,0,0,0,1,1
28619,60,7692,6947;7382,13870,0,0,0,2,2
28620,60,7693,1889;7036,13870,0,0,0,2,2
28621,60,7694,13,13870,0,0,0,1,1
28622,60,7695,3872,13870,0,0,0,1,1
28623,60,7698,348,13870,0,0,0,1,1
28624,60,7700,952,13870,0,0,0,1,1
28625,60,7702,1883,13870,0,0,0,1,1
28626,60,7703,10856;14666;14922;15419;16031,13870,0,2,3,0,5
28627,60,7704,10422;10552;14568;14901,13870,0,0,4,0,4
28628,60,7706,10697;10963;14494;14954;15512,13870,0,1,4,0,5
28629,60,7707,10900;11065;15227,13870,0,1,2,0,3
28630,60,7708,10162;10715;14550;15085,13870,0,0,4,0,4
28631,60,7711,10335;10829;15128,13870,0,0,3,0,3
28632,60,7712,11557;15173;15517;15825,13870,0,2,2,0,4
28633,60,7713,10641;10855;15317;15648,13870,0,2,2,0,4
28634,60,7716,11075;14644;14874;15489,13870,0,1,3,0,4
28635,60,7717,11632;15057;16032,13870,0,1,2,0,3
28636,60,7719,11114;11963;15417;15730;16312,13870,0,3,2,0,5
28637,60,7720,11230;11402;15115;15508;15659;16220,13870,0,3,3,0,6
28638,60,7721,11127;11245;14566;15031,13870,0,0,4,0,4
28639,60,7722,11286;11737;15040;16292,13870,0,1,3,0,4
28640,60,7723,11001;11171;15090;15656;16135,13870,0,2,3,0,5
28641,60,7725,11427;11618;14977;15564,13870,0,1,3,0,4
28642,60,7726,11102;11314;14892;15927,13870,0,1,3,0,4
28643,60,7727,11338;11607;14889;15583;15604,13870,0,2,3,0,5
28644,60,7728,11355;11385;14504;14847;16123,13870,0,1,4,0,5
28645,60,7729,11568;11609;16132,13870,0,1,2,0,3
28646,60,7730,11729;11905;15077;15206;16015,13870,0,2,3,0,5
28647,60,7731,11499;15288;15454;16041,13870,0,3,1,0,4
28648,60,7732,11674;11996;14876;15792;16268;16645,13870,0,3,3,0,6
28649,60,7733,11524;14634;14853;15418,13870,0,1,3,0,4
28650,60,7734,11530;11914;16231;16507,13870,0,2,2,0,4
28651,60,7735,11592;11628;14949;16022,13870,0,1,3,0,4
28652,60,7736,11728;15285;15565;16062,13870,0,3,1,0,4
28653,60,7737,12085;12099;14882;15624;16203,13870,0,2,3,0,5
28654,60,7738,11641;11821;14603;15828,13870,0,1,3,0,4
28655,60,7739,11645;11731;15809;16750,13870,0,2,2,0,4
28656,60,7740,11658;11667;14806;15530,13870,0,1,3,0,4
28657,60,7741,11232;11679;14675;14927;16056;16454,13870,0,2,4,0,6
28658,60,7742,11532;11690;14597;15691;16342,13870,0,2,3,0,5
28659,60,7743,11321;11697;15316;15721,13870,0,2,2,0,4
28660,60,7744,11701;11792;14798;14925;15191;15504;16524;17001,13870,1,2,5,0,8
28661,60,7745,11732;12042;15161;15332;16107,13870,0,2,3,0,5
28662,60,7746,11739;11775;14992;16163,13870,0,1,3,0,4
28663,60,7747,11316;11779;15336;15771;16591,13870,0,3,2,0,5
28664,60,7748,11770;12302;15727;16337;17028,13870,1,2,2,0,5
28665,60,7749,11806;12114;14524;15416,13870,0,1,3,0,4
28666,60,7750,11502;11743;15153,13870,0,0,3,0,3
28667,60,7751,11764;11924,13870,0,0,2,0,2
28668,60,7752,11843;12019;14601,13870,0,0,3,0,3
28669,60,7753,11850;11869;14501;15172;15253;16048;16386,13870,0,3,4,0,7
28670,60,7754,11856;12204;14905;15999,13870,0,1,3,0,4
28671,60,7755,11709;11835;14541;14693;15220;16440,13870,0,2,4,0,6
28672,60,7756,11723;11881;14980;15168;16114,13870,0,1,4,0,5
28673,60,7757,11406;11704;14602;16054;16896,13870,1,1,3,0,5
28674,60,7758,11661;11906;15160;15919,13870,0,1,3,0,4
28675,60,7759,11908;12203;14714;14939;15080;15468;15921,13870,0,2,5,0,7
28676,60,7760,11930;12014;14527,13870,0,0,3,0,3
28677,60,7761,11940;12043;15230;15570,13870,0,2,2,0,4
28678,60,7762,11566;11941;15126,13870,0,0,3,0,3
28679,60,7763,11819;11945;15039;15353;15484;16988,13870,1,2,3,0,6
28680,60,7764,11845;12308;15531;15884,13870,0,2,2,0,4
28681,60,7765,11699;12011;14944;15542;16393;16494,13870,0,3,3,0,6
28682,60,7766,12015;12098;15926;16259,13870,0,2,2,0,4
28683,60,7767,65;3849,14235,0,0,0,2,2
28684,60,7768,7141,14235,0,0,0,1,1
28685,60,7772,5962;8854,14235,0,0,0,2,2
28686,60,7776,2865,14235,0,0,0,1,1
28687,60,7777,2203;3151,14235,0,0,0,2,2
28688,60,7785,6022,14235,0,0,0,1,1
28689,60,7787,6761,14235,0,0,0,1,1
28690,60,7788,7819,14235,0,0,0,1,1
28691,60,7789,6054,14235,0,0,0,1,1
28692,60,7793,8040,14235,0,0,1,0,1
28693,60,7794,8187,14235,0,0,0,1,1
28694,60,7796,9420,14235,0,0,0,1,1
28695,60,7798,2247;9740,14235,0,0,0,2,2
28696,60,7799,10129;14684,14235,0,0,2,0,2
28697,60,7807,10581;10746;14703;14860,14235,0,0,4,0,4
28698,60,7809,10522,14235,0,0,1,0,1
28699,60,7810,10913;15064;15219;15366,14235,0,2,2,0,4
28700,60,7812,10939;11082;14897;15035;16504,14235,0,1,4,0,5
28701,60,7813,10923;11221;14742;14955;16304,14235,0,1,4,0,5
28702,60,7814,10533;10774;15078;15781,14235,0,1,3,0,4
28703,60,7816,11129;14827;15255,14235,0,1,2,0,3
28704,60,7817,11463;14880;15734,14235,0,1,2,0,3
28705,60,7819,11011;11191;14754;15330,14235,0,1,3,0,4
28706,60,7820,11450;14653;15685,14235,0,1,2,0,3
28707,60,7821,11164;11285;14791;15096;15441,14235,0,1,4,0,5
28708,60,7822,11322;11484;14988;15968,14235,0,1,3,0,4
28709,60,7823,12052;15136;15390;15513,14235,0,2,2,0,4
28710,60,7824,11340;11591;14985;15273;15543,14235,0,2,3,0,5
28711,60,7825,10757;11342;14811;14895;15867,14235,0,1,4,0,5
28712,60,7826,11250;11371;14833;15198;15776,14235,0,2,3,0,5
28713,60,7827,11401;11449;14801;15213;15411,14235,0,2,3,0,5
28714,60,7828,11565;11574;15346;15751;16390,14235,0,3,2,0,5
28715,60,7829,11169;11513;14981;15269;15553;15678,14235,0,3,3,0,6
28716,60,7830,11373;11464;14704;14848,14235,0,0,4,0,4
28717,60,7831,11910;11911;14824;15208;16028;16828,14235,0,3,3,0,6
28718,60,7832,11648;12137;15436;15905,14235,0,2,2,0,4
28719,60,7833,12234;14687;14951;16385;16639,14235,0,2,3,0,5
28720,60,7834,11993;12080;15506,14235,0,1,2,0,3
28721,60,7835,11716;12326;14825;14896;16039;16275;16405;17098,14235,1,3,4,0,8
28722,60,7836,11719;11965;15729;16121,14235,0,2,2,0,4
28723,60,7838,12424;14975;15467;15808;16450,14235,0,3,2,0,5
28724,60,7839,11755;12144;15364;15856;16193,14235,0,3,2,0,5
28725,60,7840,11761;11913;15370;16452,14235,0,2,2,0,4
28726,60,7841,11900;15409;15880;16045;16411,14235,0,4,1,0,5
28727,60,7842,11776;12008;15216,14235,0,1,2,0,3
28728,60,7843,11437;11799;15048;15992,14235,0,1,3,0,4
28729,60,7844,11874;12142;14968;15677;17177,14235,1,1,3,0,5
28730,60,7845,11836;12126;15147;16362,14235,0,1,3,0,4
28731,60,7846,11860;12357;14808;15190,14235,0,0,4,0,4
28732,60,7847,12105;15463;15871;16238,14235,0,3,1,0,4
28733,60,7848,11688;11971;14716;15605;15976,14235,0,2,3,0,5
28734,60,7849,11894;11975;15773,14235,0,1,2,0,3
28735,60,7850,11976;14713;15374;15644,14235,0,2,2,0,4
28736,60,7851,11990;12331;15116;16265,14235,0,1,3,0,4
28737,60,7852,12009;12223;14923;15415;16079;16731,14235,0,3,3,0,6
28738,60,7853,12018;12272;15367;15833;16380;17435,14235,1,3,2,0,6
28739,60,7854,11853;12151;14686;14846,14235,0,0,4,0,4
28740,60,7855,11921;12149;15697;15858,14235,0,2,2,0,4
28741,60,7857,12073;12305;16052;16686,14235,0,2,2,0,4
28742,60,7858,11673;12075;15398;15482;15875,14235,0,3,2,0,5
28743,60,7859,12208;15281;17220,14235,1,1,1,0,3
28744,60,7860,11560;12117;14987;15120;15277;16302,14235,0,2,4,0,6
28745,60,7861,9648,14600,0,0,0,1,1
28746,60,7867,1535,14600,0,0,0,1,1
28747,60,7868,6625,14600,0,0,0,1,1
28748,60,7869,3401,14600,0,0,0,1,1
28749,60,7871,8214,14600,0,0,0,1,1
28750,60,7874,6169,14600,0,0,0,1,1
28751,60,7876,2291,14600,0,0,0,1,1
28752,60,7877,939,14600,0,0,0,1,1
28753,60,7887,9520;10200;15470,14600,0,1,2,0,3
28754,60,7892,10599;10985,14600,0,0,2,0,2
28755,60,7895,10877,14600,0,0,1,0,1
28756,60,7896,10910;11383;14843;15029,14600,0,0,4,0,4
28757,60,7898,11027;11494;14855;15403,14600,0,1,3,0,4
28758,60,7901,10956;14790;14932,14600,0,0,3,0,3
28759,60,7902,10828;11046;15114;15245;15903,14600,0,2,3,0,5
28760,60,7904,11348;11668;14859;15089;15442,14600,0,1,4,0,5
28761,60,7905,10952;11365;14839;15063;16191,14600,0,1,4,0,5
28762,60,7908,11396;11434;14868;15585;15701,14600,0,2,3,0,5
28763,60,7909,11275;15777,14600,0,1,1,0,2
28764,60,7910,11487;11531;15556,14600,0,1,2,0,3
28765,60,7912,11590;11664;14997;15524;15766,14600,0,2,3,0,5
28766,60,7913,11596;11838;15365;16037;16953,14600,1,2,2,0,5
28767,60,7914,11708;12076;15097;15466;16250,14600,0,2,3,0,5
28768,60,7915,11561;11675;15754,14600,0,1,2,0,3
28769,60,7916,11610;11718;15129;15823;16067,14600,0,2,3,0,5
28770,60,7918,11740;11927;16073;16813,14600,0,2,2,0,4
28771,60,7919,12196;14958;15212,14600,0,1,2,0,3
28772,60,7920,11831;12378;14834;15248;16527,14600,0,2,3,0,5
28773,60,7921,11841;12340;15344;15655,14600,0,2,2,0,4
28774,60,7922,11416;11849;14928;16158,14600,0,1,3,0,4
28775,60,7923,12022;12036;14771;15427;15665,14600,0,2,3,0,5
28776,60,7924,11368;11896;15414;15705,14600,0,2,2,0,4
28777,60,7925,11992;12167;15568;16006,14600,0,2,2,0,4
28778,60,7926,11964;12040;15201;15420;16229,14600,0,3,2,0,5
28779,60,7928,11967;12314;15987;16708,14600,0,2,2,0,4
28780,60,7929,11903;12489;15933;16297;16946,14600,1,2,2,0,5
28781,60,7930,11730;12001;15113;15711;16256;16843,14600,0,3,3,0,6
28782,60,7931,12161;12478;16152;16461,14600,0,2,2,0,4
28783,60,7932,11880;12031;14764;15047;15433;15803,14600,0,2,4,0,6
28784,60,7933,12063;12202;15159;15614;15770;16414,14600,0,3,3,0,6
28785,60,7934,12089;12100;14960;15133;15874,14600,0,1,4,0,5
28786,60,7935,11884;12091;15525;16184;16768,14600,0,3,2,0,5
28787,60,7936,12013;12092;15765;16094,14600,0,2,2,0,4
28788,60,7937,12093;12165;15864;16429;16801,14600,0,3,2,0,5
28789,60,7938,12464;15088;16441,14600,0,1,2,0,3
28790,60,7939,11947;12462;16949;17413,14600,2,0,2,0,4
28791,60,7940,11929;12116;15318;15451;15688,14600,0,3,2,0,5
28792,60,7941,11626;12128;15590;15686;15869;16882;17139,14600,2,3,2,0,7
28793,60,7942,12140;12147;15668;15877,14600,0,2,2,0,4
28794,60,7943,12183;14909;15112;16515,14600,0,1,3,0,4
28795,60,7944,11933;12155;15176;15550,14600,0,1,3,0,4
28796,60,7945,12290;12449;15146;15546;16531,14600,0,2,3,0,5
28797,60,7946,11798;12141;15372;15930;17219,14600,1,2,2,0,5
28798,60,7947,11757;12230;15855;16409,14600,0,2,2,0,4
28799,60,7948,11946;12233;15315;15402,14600,0,2,2,0,4
28800,60,7949,12120;12240;15638;16404,14600,0,2,2,0,4
28801,60,7950,12554;12658;14757;15719;16774,14600,0,2,3,0,5
28802,60,7960,5432,14965,0,0,0,1,1
28803,60,7961,8226,14965,0,0,0,1,1
28804,60,7962,6490;10160,14965,0,0,2,0,2
28805,60,7963,9351,14965,0,0,0,1,1
28806,60,7967,6819,14965,0,0,0,1,1
28807,60,7968,430;5970,14965,0,0,0,2,2
28808,60,7971,1525,14965,0,0,0,1,1
28809,60,7975,9573,14965,0,0,0,1,1
28810,60,7984,10574;10710;15124;15395,14965,0,1,3,0,4
28811,60,7986,10874;10908;15055;15258;15709,14965,0,2,3,0,5
28812,60,7987,11117;11394;14933;15263;16175,14965,0,2,3,0,5
28813,60,7989,10813;11076;14881;15033,14965,0,0,4,0,4
28814,60,7990,11162;11536;15087;15547,14965,0,1,3,0,4
28815,60,7992,11192;11710;15195;15528;16571;16680,14965,0,4,2,0,6
28816,60,7993,11539;11573;14910;15931;16233,14965,0,2,3,0,5
28817,60,7994,11564;11604;15075;15890,14965,0,1,3,0,4
28818,60,7995,10911;11553;15158;15399,14965,0,1,3,0,4
28819,60,7996,12239;15337;15811;16116;16438;17022,14965,1,4,1,0,6
28820,60,7997,11857;11864;15294;15986,14965,0,2,2,0,4
28821,60,7998,11617;11943;15107;16122;16695,14965,0,2,3,0,5
28822,60,7999,11319;11612;15196;16096,14965,0,2,2,0,4
28823,60,8000,11780;12317;15896;16100;16341,14965,0,3,2,0,5
28824,60,8001,11534;11801;15863;16025,14965,0,2,2,0,4
28825,60,8002,11858;12493;14993;15813;16005;16891,14965,1,2,3,0,6
28826,60,8003,11871;12730;15354;16023;16667,14965,0,3,2,0,5
28827,60,8004,11847;15391;16410,14965,0,2,1,0,3
28828,60,8005,11922;12125;15393;16008;16535;16744,14965,0,4,2,0,6
28829,60,8006,11753;11961;15119;15928;16330;16726,14965,0,3,3,0,6
28830,60,8007,11973;15199;16682;16773,14965,0,3,1,0,4
28831,60,8008,11983;12097;15507;16382,14965,0,2,2,0,4
28832,60,8009,11985;12162;15535;16144;17381,14965,1,2,2,0,5
28833,60,8010,11602;12107;15274;15755;16305,14965,0,3,2,0,5
28834,60,8011,12027;12131;15594;15660;16185,14965,0,3,2,0,5
28835,60,8012,12207;12459;15169;15689,14965,0,1,3,0,4
28836,60,8013,12217;15588;17299,14965,1,1,1,0,3
28837,60,8014,12103;12221;15144;16012,14965,0,1,3,0,4
28838,60,8015,12226;12353;15852;16172,14965,0,2,2,0,4
28839,60,8016,12256;15310;15775;16568;16749,14965,0,4,1,0,5
28840,60,8017,12264;12344;14991;15272;15657;15984;16069;16348,14965,0,5,3,0,8
28841,60,8018,12629;15197;15791;17122;17389,14965,2,2,1,0,5
28842,60,8019,12286;12603;14961;15262,14965,0,1,3,0,4
28843,60,8020,12490;12665;14937;15359;15716,14965,0,2,3,0,5
28844,60,8021,12596;14945;15226;15782;16704,14965,0,3,2,0,5
28845,60,8022,12218;12435;16171;16310,14965,0,2,2,0,4
28846,60,8023,12330;14935;15246;15932;16371,14965,0,3,2,0,5
28847,60,8024,12225;12648;16676;17073;17322,14965,2,1,2,0,5
28848,60,8025,12349;12756;16994;17194,14965,2,0,2,0,4
28849,60,8026,12370;14872;15117;16608,14965,0,1,3,0,4
28850,60,8027,12303;12355;15091;15204;16379,14965,0,2,3,0,5
28851,60,8028,3450,15330,0,0,0,1,1
28852,60,8029,686,15330,0,0,0,1,1
28853,60,8030,1230,15330,0,0,0,1,1
28854,60,8031,2339;10414;14912;15175,15330,0,0,4,0,4
28855,60,8032,2350;3140,15330,0,0,0,2,2
28856,60,8034,3239,15330,0,0,0,1,1
28857,60,8035,205,15330,0,0,0,1,1
28858,60,8036,706,15330,0,0,0,1,1
28859,60,8041,3374,15330,0,0,0,1,1
28860,60,8042,7119,15330,0,0,0,1,1
28861,60,8043,7722,15330,0,0,0,1,1
28862,60,8045,6101,15330,0,0,0,1,1
28863,60,8046,8756;9843,15330,0,0,0,2,2
28864,60,8049,5661;6481,15330,0,0,0,2,2
28865,60,8053,5716,15330,0,0,0,1,1
28866,60,8054,57,15330,0,0,0,1,1
28867,60,8061,10416;10858;15051;15378,15330,0,1,3,0,4
28868,60,8063,10608,15330,0,0,1,0,1
28869,60,8064,10634;10655;15081;15397,15330,0,1,3,0,4
28870,60,8067,10767,15330,0,0,1,0,1
28871,60,8068,10765;10865,15330,0,0,2,0,2
28872,60,8069,10733;10940;15034;15401,15330,0,1,3,0,4
28873,60,8071,10998;11193;15104;15476;15554,15330,0,2,3,0,5
28874,60,8072,10860;11166;15086;15537,15330,0,1,3,0,4
28875,60,8073,11569;11653;15237;16085,15330,0,2,2,0,4
28876,60,8075,11349;11663;15309;15970,15330,0,2,2,0,4
28877,60,8076,11367;12146;15228;17047,15330,1,1,2,0,4
28878,60,8077,11390;11521;15157;15753;16427,15330,0,2,3,0,5
28879,60,8078,11408;11823;15218;15649;16046,15330,0,3,2,0,5
28880,60,8079,11418;11454;15065;15901,15330,0,1,3,0,4
28881,60,8080,11246;11490;15127;16316,15330,0,1,3,0,4
28882,60,8081,11445;11510;15251;15404;15536;15708;16862,15330,0,5,2,0,7
28883,60,8082,12044;15118;15244;16424;16762,15330,0,3,2,0,5
28884,60,8083,11260;11575;15069;15498;15850,15330,0,2,3,0,5
28885,60,8084,12219;15474;16610,15330,0,2,1,0,3
28886,60,8085,11659;15154;15888,15330,0,1,2,0,3
28887,60,8086,11839;11915;15102;15882;16957,15330,1,1,3,0,5
28888,60,8087,11705;15186;15425;15610,15330,0,2,2,0,4
28889,60,8088,11247;11785;15329;16347,15330,0,2,2,0,4
28890,60,8089,11818;12254;15322;15545;16055,15330,0,3,2,0,5
28891,60,8090,11844;11968;15171;15621;16703,15330,0,2,3,0,5
28892,60,8091,11846;12048;15629;16289,15330,0,2,2,0,4
28893,60,8092,11359;11558;15024;15192;15759,15330,0,2,3,0,5
28894,60,8096,11789;11937;15737;16368,15330,0,2,2,0,4
28895,60,8097,11948;12403;16671;16902,15330,1,1,2,0,4
28896,60,8098,11747;11952;15695;17209,15330,1,1,2,0,4
28897,60,8099,11828;11958;15699;16156;16326,15330,0,3,2,0,5
28898,60,8100,12323;15510;16993,15330,1,1,1,0,3
28899,60,8101,12028;12415;15386;15778;16928;17141,15330,2,2,2,0,6
28900,60,8102,11932;15469;15609;16129,15330,0,3,1,0,4
28901,60,8103,11959;12050;15830;16619,15330,0,2,2,0,4
28902,60,8104,12060;12423;15044;15243,15330,0,1,3,0,4
28903,60,8106,12171;12488;15148;16043,15330,0,1,3,0,4
28904,60,8107,12176;12266;15807;16437,15330,0,2,2,0,4
28905,60,8108,11888;12182;15582;16066;16604,15330,0,3,2,0,5
28906,60,8109,12220;12714;15060;15328;15479,15330,0,2,3,0,5
28907,60,8110,12224;12241;15461;15548,15330,0,2,2,0,4
28908,60,8111,11677;12032,15330,0,0,2,0,2
28909,60,8112,12066;12235;15963;16279;16428,15330,0,3,2,0,5
28910,60,8113,12139;12258;15311;16857;17016,15330,1,2,2,0,5
28911,60,8114,12297;15937;16306,15330,0,2,1,0,3
28912,60,8115,12306;12801;16244;16803;17014,15330,1,2,2,0,5
28913,60,8116,11837;12374;16252;16791;17135,15330,1,2,2,0,5
28914,60,8117,12397;15062;15805,15330,0,1,2,0,3
28915,60,8118,12441;12690;15523;15838,15330,0,2,2,0,4
28916,60,8119,11974;12450;15232;15448;16560,15330,0,3,2,0,5
28917,60,8120,12088;12479;15352;16367;16895,15330,1,2,2,0,5
28918,60,8121,50;135,15695,0,0,0,2,2
28919,60,8122,829,15695,0,0,0,1,1
28920,60,8123,837,15695,0,0,0,1,1
28921,60,8124,3381,15695,0,0,0,1,1
28922,60,8126,7418,15695,0,0,0,1,1
28923,60,8127,5788;8618,15695,0,0,0,2,2
28924,60,8128,6003,15695,0,0,0,1,1
28925,60,8130,6187,15695,0,0,0,1,1
28926,60,8131,6202,15695,0,0,0,1,1
28927,60,8135,3061,15695,0,0,0,1,1
28928,60,8139,10047,15695,0,0,1,0,1
28929,60,8143,10278,15695,0,0,1,0,1
28930,60,8144,10444;10823,15695,0,0,2,0,2
28931,60,8148,11118;15276;15473,15695,0,2,1,0,3
28932,60,8149,10474;10656;15690,15695,0,1,2,0,3
28933,60,8151,11070;11429;15291;16307,15695,0,2,2,0,4
28934,60,8152,10933,15695,0,0,1,0,1
28935,60,8154,10644;10971;15236;15355,15695,0,2,2,0,4
28936,60,8155,11072;11413;15210;15876,15695,0,2,2,0,4
28937,60,8156,11083;11219;16357,15695,0,1,2,0,3
28938,60,8157,11295,15695,0,0,1,0,1
28939,60,8160,11398,15695,0,0,1,0,1
28940,60,8161,11787;15301;16047;16376,15695,0,3,1,0,4
28941,60,8163,12026;15739;16719,15695,0,2,1,0,3
28942,60,8164,11862;12188;16264;16448,15695,0,2,2,0,4
28943,60,8165,11215;11600;15321;15518,15695,0,2,2,0,4
28944,60,8166,11508;11766;15215;15647,15695,0,2,2,0,4
28945,60,8167,11802;12321;15495;16162;16421;16663,15695,0,4,2,0,6
28946,60,8168,11892;11994;15599;15945;16108,15695,0,3,2,0,5
28947,60,8169,11909;15319;16210;16705,15695,0,3,1,0,4
28948,60,8170,11931;12061;15683;16221,15695,0,2,2,0,4
28949,60,8171,12034;12045;15383;15584;15812;16985,15695,1,3,2,0,6
28950,60,8172,11991;12257;15603;16501,15695,0,2,2,0,4
28951,60,8173,12016;12024;15387;15844;16207,15695,0,3,2,0,5
28952,60,8174,12038;12071;15445;15663;16000,15695,0,3,2,0,5
28953,60,8175,12249;12341;15934;16234;16724;17072,15695,1,3,2,0,6
28954,60,8176,12212;12318;15526;15801,15695,0,2,2,0,4
28955,60,8177,12101;12566;16418;16972;17444,15695,2,1,2,0,5
28956,60,8178,12110;12546;15299;15478;16687,15695,0,3,2,0,5
28957,60,8179,11960;12121;15549;15878;15990;16110,15695,0,4,2,0,6
28958,60,8180,11824;12136;15421;15579;16010,15695,0,3,2,0,5
28959,60,8182,12148;12316;15499;16651;16940,15695,1,2,2,0,5
28960,60,8183,12350;15576;15873,15695,0,2,1,0,3
28961,60,8184,12227;12935;16983;17206,15695,2,0,2,0,4
28962,60,8185,12236;12387;16113;16294,15695,0,2,2,0,4
28963,60,8186,12267;12688;15333;15593;15847,15695,0,3,2,0,5
28964,60,8187,12608;15764;16147,15695,0,2,1,0,3
28965,60,8188,12319,15695,0,0,1,0,1
28966,60,8189,12836;15224;15509,15695,0,2,1,0,3
28967,60,8190,12359;12891;15640;16550;17200,15695,1,2,2,0,5
28968,60,8191,12371;12755;16021;16083;16755,15695,0,3,2,0,5
28969,60,8192,12288;12536;15653;15822;16280,15695,0,3,2,0,5
28970,60,8193,12311;12392;15412;15501;15736;16505,15695,0,4,2,0,6
28971,60,8194,12377;12684;15295;15900;16557,15695,0,3,2,0,5
28972,60,8195,12436;16627;16939,15695,1,1,1,0,3
28973,60,8196,12473;13241;15539;15952,15695,0,2,2,0,4
28974,60,8197,12529;12901;15382;15723,15695,0,2,2,0,4
28975,60,8198,12287;12386;16320;16407;16577;16617,15695,0,4,2,0,6
28976,60,8199,12429;12496;15995;16300,15695,0,2,2,0,4
28977,60,8200,12414;12516;15471;15613,15695,0,2,2,0,4
28978,60,8201,12815;12839;15275;15643;16284,15695,0,3,2,0,5
28979,60,8202,12304;12540;15238;15666;16911,15695,1,2,2,0,5
28980,60,8203,12385;12559;15256;15675,15695,0,2,2,0,4
28981,60,8204,12432;12567;16137;16396,15695,0,2,2,0,4
28982,60,8205,12635;15303;15671;17407,15695,1,2,1,0,4
28983,60,8206,12586;12871;16961,15695,1,0,2,0,3
28984,60,8207,12595;12598;16029;16609,15695,0,2,2,0,4
28985,60,8208,12519;12604;15571;16098;16761,15695,0,3,2,0,5
28986,60,8209,12194;12617;15339;15637;16044;16592;16688;17085;17187,15695,2,5,2,0,9
28987,60,8211,6782,16060,0,0,0,1,1
28988,60,8213,9017,16060,0,0,0,1,1
28989,60,8215,7000,16060,0,0,0,1,1
28990,60,8218,9735,16060,0,0,1,0,1
28991,60,8219,4369,16060,0,0,0,1,1
28992,60,8220,6421;8106,16060,0,0,0,2,2
28993,60,8221,9519,16060,0,0,0,1,1
28994,60,8225,4736,16060,0,0,0,1,1
28995,60,8226,397,16060,0,0,0,1,1
28996,60,8227,8826,16060,0,0,0,1,1
28997,60,8230,5743;10307,16060,0,0,2,0,2
28998,60,8231,10041;10476,16060,0,0,2,0,2
28999,60,8233,10096,16060,0,0,1,0,1
29000,60,8237,10443;10736,16060,0,0,2,0,2
29001,60,8244,11293;11777;15368;15740;16030,16060,0,3,2,0,5
29002,60,8246,11736;15505;15841;16859,16060,0,3,1,0,4
29003,60,8247,12210;12866;16344;17090,16060,1,1,2,0,4
29004,60,8249,11649;12035;15966;16561,16060,0,2,2,0,4
29005,60,8251,12078;15544;16105,16060,0,2,1,0,3
29006,60,8252,11098;11104;16124;16540,16060,0,2,2,0,4
29007,60,8253,11635;11977;15516;16338;16542,16060,0,3,2,0,5
29008,60,8254,11957;12132;15950;16630,16060,0,2,2,0,4
29009,60,8255,11765;15377;15578;15661;16251,16060,0,4,1,0,5
29010,60,8256,11784;11936;15627;15917;16597,16060,0,3,2,0,5
29011,60,8257,11814;12021;15742;16468;17344,16060,1,2,2,0,5
29012,60,8258,11867;12124;15519;16118;17002,16060,1,2,2,0,5
29013,60,8259,11451;11794;15760;16176;16402;16784,16060,0,4,2,0,6
29014,60,8261,11202;15718;15948,16060,0,2,1,0,3
29015,60,8262,12625;12769;16495;16804,16060,0,2,2,0,4
29016,60,8263,11979;12720;15914;16211;16841,16060,0,3,2,0,5
29017,60,8264,11917;11989;15761;16709,16060,0,2,2,0,4
29018,60,8266,12056;12873;15840;16453;16499;16886;17390,16060,2,3,2,0,7
29019,60,8267,11875;15497;15943;16433,16060,0,3,1,0,4
29020,60,8268,12096;12294;15985;16616,16060,0,2,2,0,4
29021,60,8269,12495;12705;15438;15592,16060,0,2,2,0,4
29022,60,8270,11872;11949;15490;16241;16920,16060,1,2,2,0,5
29023,60,8271,12010;12129;15597;16299,16060,0,2,2,0,4
29024,60,8272,12184;15532;16145,16060,0,2,1,0,3
29025,60,8273,12005;12195;15818;16082,16060,0,2,2,0,4
29026,60,8275,12231;12251;15502;15843;16293,16060,0,3,2,0,5
29027,60,8276,12260;16004;16170;17433,16060,1,2,1,0,4
29028,60,8277,12296;12434;15449;16164,16060,0,2,2,0,4
29029,60,8278,12745;15358;15561;16631;17326,16060,1,3,1,0,5
29030,60,8279,12289;12367;15898;16479,16060,0,2,2,0,4
29031,60,8280,12382;12407;15642;16009;16730,16060,0,3,2,0,5
29032,60,8281,12384;13097;15447;16518,16060,0,2,2,0,4
29033,60,8282,12408;12963;15440;15533;16975,16060,1,2,2,0,5
29034,60,8283,12735;17005;17244,16060,2,0,1,0,3
29035,60,8284,12420;12517;15563;15747;15857;16819,16060,0,4,2,0,6
29036,60,8285,12238;12427;15744;16456,16060,0,2,2,0,4
29037,60,8286,12206;12460;15680;16138;16545,16060,0,3,2,0,5
29038,60,8287,12541;12719;16148;16431;16661;16783,16060,0,4,2,0,6
29039,60,8288,12368;12579;16399;16765;17368,16060,1,2,2,0,5
29040,60,8289,12411;12584;15458;16013;16230;16990,16060,1,3,2,0,6
29041,60,8290,12620;12791;15520;15728;16564;17050,16060,1,3,2,0,6
29042,60,8291,12113;12615;15802;16325;16657,16060,0,3,2,0,5
29043,60,8292,12623;12776;15713;15918;16485,16060,0,3,2,0,5
29044,60,8293,12662;12825;16179;16262;16915,16060,1,2,2,0,5
29045,60,8294,12416;12664;16215;16714;17217,16060,1,2,2,0,5
29046,60,8295,12685;12693;16747;17373,16060,1,1,2,0,4
29047,60,8296,12687,16060,0,0,1,0,1
29048,60,8297,12652;12698;15360;15872;16863,16060,0,3,2,0,5
29049,60,8298,12701;13084;15431;15826;16276,16060,0,3,2,0,5
29050,60,8300,12718;15452;15720;16728,16060,0,3,1,0,4
29051,60,8301,12729;15615;16109;16905,16060,1,2,1,0,4
29052,60,8302,11865;12737;15859;16018;16615,16060,0,3,2,0,5
29053,60,8303,5805,16425,0,0,0,1,1
29054,60,8304,448,16425,0,0,1,0,1
29055,60,8306,2013,16425,0,0,0,1,1
29056,60,8308,6102,16425,0,0,0,1,1
29057,60,8310,9816,16425,0,0,0,1,1
29058,60,8312,2027;6641,16425,0,0,0,2,2
29059,60,8315,6675,16425,0,0,0,1,1
29060,60,8316,3,16425,0,0,0,1,1
29061,60,8317,6982,16425,0,0,0,1,1
29062,60,8318,7550,16425,0,0,0,1,1
29063,60,8320,10006;10465,16425,0,0,2,0,2
29064,60,8327,10554;11146;16576,16425,0,1,2,0,3
29065,60,8333,10872;10875;15625;16020,16425,0,2,2,0,4
29066,60,8336,11000;11333;15935;16213,16425,0,2,2,0,4
29067,60,8337,11052,16425,0,0,1,0,1
29068,60,8338,11483;12059;16099;16570,16425,0,2,2,0,4
29069,60,8339,11537;11642;15559;15651,16425,0,2,2,0,4
29070,60,8340,11403;11542;15534;15693;16225,16425,0,3,2,0,5
29071,60,8341,11412;11671;15541;15909,16425,0,2,2,0,4
29072,60,8342,11916;12057;16955;17152,16425,2,0,2,0,4
29073,60,8345,12030;12281;16205;16625;17162,16425,1,2,2,0,5
29074,60,8347,12037;12047;15904;16239;16648,16425,0,3,2,0,5
29075,60,8348,12130;12269;15618;15793;16820,16425,0,3,2,0,5
29076,60,8349,12199;12851;15887;16178;16270,16425,0,3,2,0,5
29077,60,8350,12064;12228;16131;16473,16425,0,2,2,0,4
29078,60,8351,12242;12820;16718;16978;17173,16425,2,1,2,0,5
29079,60,8352,12640;12646;16420;16815,16425,0,2,2,0,4
29080,60,8353,12255;12497;16488;17020,16425,1,1,2,0,4
29081,60,8354,12307;16186;16654,16425,0,2,1,0,3
29082,60,8355,12324;13154,16425,0,0,2,0,2
29083,60,8356,13008;13130;16506;16675;17414,16425,1,2,2,0,5
29084,60,8357,12360;12446;15702;15997;16057;16281;16697;16924;17148,16425,2,5,2,0,9
29085,60,8358,12160;12362;16240;16658,16425,0,2,2,0,4
29086,60,8359,12395;12829;15664;15957;16528,16425,0,3,2,0,5
29087,60,8360,12412;12792;16209;16434;16534;17164,16425,1,3,2,0,6
29088,60,8361,12451;12834;16960,16425,1,0,2,0,3
29089,60,8362,12197;12521;16585;16722,16425,0,2,2,0,4
29090,60,8363,12312;12531;15492;15953,16425,0,2,2,0,4
29091,60,8364,12534;12674;15672;15788;16451;17083;17230,16425,2,3,2,0,7
29092,60,8365,12545;12859;15487;15794;16340,16425,0,3,2,0,5
29093,60,8366,12213;12550;15735;15980,16425,0,2,2,0,4
29094,60,8367,12570;15639;15907,16425,0,2,1,0,3
29095,60,8368,12214;12575;15939;17035,16425,1,1,2,0,4
29096,60,8369,12453;12585;16470;16539,16425,0,2,2,0,4
29097,60,8370,12602;12639;16656;17224,16425,1,1,2,0,4
29098,60,8371,12613;12854;16354;16992,16425,1,1,2,0,4
29099,60,8372,12630;12650;16102;16589;16823,16425,0,3,2,0,5
29100,60,8373,12626;12822;16640,16425,0,1,2,0,3
29101,60,8374,12633;12973;16938;17386,16425,2,0,2,0,4
29102,60,8375,12974;15555;15947;16871,16425,1,2,1,0,4
29103,60,8376,12670;13379;15783;16465;16831,16425,0,3,2,0,5
29104,60,8377,12943;13198;15515;15635;16026;16716,16425,0,4,2,0,6
29105,60,8378,12738;12920;15493;15703;15938;16662;16907;17211,16425,2,4,2,0,8
29106,60,8379,12746;13048;16736;17201;17443,16425,2,1,2,0,5
29107,60,8380,12572;15923;16406,16425,0,2,1,0,3
29108,60,8381,12229;12761;17174,16425,1,0,2,0,3
29109,60,8382,12616;12780;17132,16425,1,0,2,0,3
29110,60,8383,12783;13085;15540;16721,16425,0,2,2,0,4
29111,60,8384,12785;16080;16332;16860,16425,0,3,1,0,4
29112,60,8385,12356;12786;15581;15646,16425,0,2,2,0,4
29113,60,8386,12788;13004;15991;16141;16439;16974,16425,1,3,2,0,6
29114,60,8387,12743;12790;15738;15842,16425,0,2,2,0,4
29115,60,8388,12518;12802;17017,16425,1,0,2,0,3
29116,60,8389,12828;13264;15704;16063,16425,0,2,2,0,4
29117,60,8390,12864;15628;15796;15911;16290;16941,16425,1,4,1,0,6
29118,60,8391,390,16790,0,0,0,1,1
29119,60,8394,6036,16790,0,0,0,1,1
29120,60,8395,4855,16790,0,0,0,1,1
29121,60,8396,2007,16790,0,0,0,1,1
29122,60,8397,4828,16790,0,0,0,1,1
29123,60,8399,5572,16790,0,0,0,1,1
29124,60,8401,4109,16790,0,0,0,1,1
29125,60,8402,7596,16790,0,0,0,1,1
29126,60,8404,5521;9082,16790,0,0,1,1,2
29127,60,8406,10107;10287,16790,0,0,2,0,2
29128,60,8409,10440;10738;15854,16790,0,1,2,0,3
29129,60,8411,10606;10748,16790,0,0,2,0,2
29130,60,8412,10393;10944,16790,0,0,2,0,2
29131,60,8419,11125;11324;15611;15974,16790,0,2,2,0,4
29132,60,8421,11725;15681;16202,16790,0,2,1,0,3
29133,60,8425,11426;11624;15669;16101,16790,0,2,2,0,4
29134,60,8426,11702;12293;15714;16643,16790,0,2,2,0,4
29135,60,8428,11669;11722;15662;15891;17418,16790,1,2,2,0,5
29136,60,8429,11767;12090;15650;15817;16699,16790,0,3,2,0,5
29137,60,8430,11477;11866;15645;15972,16790,0,2,2,0,4
29138,60,8431,11793;12082;17110;17363,16790,2,0,2,0,4
29139,60,8433,12062;15819;16638,16790,0,2,1,0,3
29140,60,8434,11852;12143;16160;16492;16847,16790,0,3,2,0,5
29141,60,8435,11891;12285;15885;16483,16790,0,2,2,0,4
29142,60,8436,11636,16790,0,0,1,0,1
29143,60,8437,12133;15698;16548,16790,0,2,1,0,3
29144,60,8438,11919;11954;15769;16060;16700,16790,0,3,2,0,5
29145,60,8439,11754;11987;15696;17202,16790,1,1,2,0,4
29146,60,8441,12002;12444;17215;17293,16790,2,0,2,0,4
29147,60,8442,12418;15632;16536,16790,0,2,1,0,3
29148,60,8443,12190;12605;16091;17415,16790,1,1,2,0,4
29149,60,8444,12189;12193;16157;16350,16790,0,2,2,0,4
29150,60,8445,12277;15870;16352,16790,0,2,1,0,3
29151,60,8446,11854;12244;16149;16392,16790,0,2,2,0,4
29152,60,8447,12248;12642;16706;17119,16790,1,1,2,0,4
29153,60,8448,12185;12265;16075;16581,16790,0,2,2,0,4
29154,60,8449,11942;12298;15839;16364,16790,0,2,2,0,4
29155,60,8450,12315;12667;16555;17419,16790,1,1,2,0,4
29156,60,8451,12332;12369;16296;16538,16790,0,2,2,0,4
29157,60,8452,12376;13257;16833;17081,16790,1,1,2,0,4
29158,60,8453,12372;12380;16226;16578,16790,0,2,2,0,4
29159,60,8454,12989;13150,16790,0,0,2,0,2
29160,60,8455,12104;12611;17420,16790,1,0,2,0,3
29161,60,8456,12157;12419;16271;16509,16790,0,2,2,0,4
29162,60,8457,12439;12680;15602;15845;16790,16790,0,3,2,0,5
29163,60,8458,12455;16053;16074,16790,0,2,1,0,3
29164,60,8459,12697;13096;15958;16734;17461,16790,1,2,2,0,5
29165,60,8460,12501;12892;16929;17203,16790,2,0,2,0,4
29166,60,8461,12514;12573;15981;16287,16790,0,2,2,0,4
29167,60,8463,12542;12981;16253;16606;17112,16790,1,2,2,0,5
29168,60,8464,12551;13158,16790,0,0,2,0,2
29169,60,8465,12565;15676;16977,16790,1,1,1,0,3
29170,60,8466,13029;13300;15732;16090;16498,16790,0,3,2,0,5
29171,60,8467,11962;12589;16374;16931,16790,1,1,2,0,4
29172,60,8468,12590;12681;15954;16212;16802,16790,0,3,2,0,5
29173,60,8469,12561;12686;16222;16771,16790,0,2,2,0,4
29174,60,8470,12823;13186;15787;16125,16790,0,2,2,0,4
29175,60,8471,12742;15762;17107,16790,1,1,1,0,3
29176,60,8472,12654;12775;17429,16790,1,0,2,0,3
29177,60,8473,12039;12803;15722;15868,16790,0,2,2,0,4
29178,60,8474,12628;15894;16727,16790,0,2,1,0,3
29179,60,8475,12818;12945;16192,16790,0,1,2,0,3
29180,60,8476,12830;12955;15706;15960,16790,0,2,2,0,4
29181,60,8477,12609;12837;15908;16372,16790,0,2,2,0,4
29182,60,8478,12840;13057;16582,16790,0,1,2,0,3
29183,60,8479,12597;12894;17059;17243,16790,2,0,2,0,4
29184,60,8480,12364;12858;16086;16986,16790,1,1,2,0,4
29185,60,8481,12430;12861;17190,16790,1,0,2,0,3
29186,60,8482,12863;13293;15979;17095;17465,16790,2,1,2,0,5
29187,60,8483,12779;12905;15836;16314,16790,0,2,2,0,4
29188,60,8484,12879;13110;15707;15881;16472;17078,16790,1,3,2,0,6
29189,60,8485,12886;13340;16613;16779;17094,16790,1,2,2,0,5
29190,60,8486,12919;13371,16790,0,0,2,0,2
29191,60,8487,12527;12924;16088;16503;17350,16790,1,2,2,0,5
29192,60,8488,12927;13318;15725;16636,16790,0,2,2,0,4
29193,60,8489,12928;13363;15745;16097,16790,0,2,2,0,4
29194,60,8490,12731;12942;16829;17383,16790,1,1,2,0,4
29195,60,8491,13208;13283;15861;16641;17069,16790,1,2,2,0,5
29196,60,8492,12977;13210;15897;16078,16790,0,2,2,0,4
29197,60,8494,1770;8418,17155,0,0,0,2,2
29198,60,8495,6581,17155,0,0,0,1,1
29199,60,8496,1035,17155,0,0,1,0,1
29200,60,8497,2384,17155,0,0,0,1,1
29201,60,8498,3717,17155,0,0,0,1,1
29202,60,8499,8238,17155,0,0,0,1,1
29203,60,8506,5775;8553,17155,0,0,2,0,2
29204,60,8509,10175;10438,17155,0,0,2,0,2
29205,60,8514,10811;10826,17155,0,0,2,0,2
29206,60,8516,11229;11756;15834;16064;16467,17155,0,3,2,0,5
29207,60,8519,11264;16267,17155,0,1,1,0,2
29208,60,8520,11577,17155,0,0,1,0,1
29209,60,8521,12070;17207;17253,17155,2,0,1,0,3
29210,60,8523,11781;11926;16061,17155,0,1,2,0,3
29211,60,8524,11899;12020;15780,17155,0,1,2,0,3
29212,60,8525,11572;11695;15912;16058,17155,0,2,2,0,4
29213,60,8526,12119;15910;16514,17155,0,2,1,0,3
29214,60,8527,12127;12259;15824;16200,17155,0,2,2,0,4
29215,60,8529,11978,17155,0,0,1,0,1
29216,60,8530,12156;15955;16324;16417,17155,0,3,1,0,4
29217,60,8531,12192;12855;17464,17155,1,0,2,0,3
29218,60,8532,12198;12509;15768;17039,17155,1,1,2,0,4
29219,60,8533,12205;12470;16070;16594;16698;16890,17155,1,3,2,0,6
29220,60,8534,12261;12270;16034;16165;16884,17155,1,2,2,0,5
29221,60,8535,12275;12715;15786;16134;16398,17155,0,3,2,0,5
29222,60,8536,12280;12428;15851;16291,17155,0,2,2,0,4
29223,60,8537,12079;16478;16745,17155,0,2,1,0,3
29224,60,8538,12348;12643;15790;16587,17155,0,2,2,0,4
29225,60,8539,12399;12532;16194;16652,17155,0,2,2,0,4
29226,60,8540,12152;12406;15849;16183;17204,17155,1,2,2,0,5
29227,60,8541,12426;12747;16436;17440,17155,1,1,2,0,4
29228,60,8542,12431;12712;16739;17298,17155,1,1,2,0,4
29229,60,8543,12442;12770;17007;17285,17155,2,0,2,0,4
29230,60,8544,12465;12485;16189;16677,17155,0,2,2,0,4
29231,60,8546,12778;16760;17458,17155,1,1,1,0,3
29232,60,8547,12510;13465;15973;17075,17155,1,1,2,0,4
29233,60,8548,12339;12537;16459,17155,0,1,2,0,3
29234,60,8549,12539;12733;16126;16758,17155,0,2,2,0,4
29235,60,8550,12961;13230;15815;16322,17155,0,2,2,0,4
29236,60,8551,12245;12333;16001;16796;17103,17155,1,2,2,0,5
29237,60,8552,12614,17155,0,0,1,0,1
29238,60,8553,12906;16245;16635,17155,0,2,1,0,3
29239,60,8554,12622;13214;16622;16818;17011,17155,1,2,2,0,5
29240,60,8555,12624;16408;17019,17155,1,1,1,0,3
29241,60,8556,12637;13050;15798;16397,17155,0,2,2,0,4
29242,60,8557,12463;12678;16014;16278;16883,17155,1,2,2,0,5
29243,60,8558,12682;12741;16227;16444;17430,17155,1,2,2,0,5
29244,60,8559,12700;13391;16095;16463;17009,17155,1,2,2,0,5
29245,60,8560,12610;12728;15915;16626,17155,0,2,2,0,4
29246,60,8561,12734;13290;15837;16580,17155,0,2,2,0,4
29247,60,8562,12744;12967;16932;17003;17459,17155,3,0,2,0,5
29248,60,8563,12757;13204;17460,17155,1,0,2,0,3
29249,60,8564,12782;13265;16603;16757,17155,0,2,2,0,4
29250,60,8565,12806;12883;16584;16840,17155,0,2,2,0,4
29251,60,8566,12813;13355;15964;16076;16689,17155,0,3,2,0,5
29252,60,8567,13398,17155,0,0,1,0,1
29253,60,8568,13263;15969;16327,17155,0,2,1,0,3
29254,60,8569,12476;12896;16391;16543,17155,0,2,2,0,4
29255,60,8570,12878;13159;16077;16679;16826;16959;17218,17155,2,3,2,0,7
29256,60,8571,12931;13170;17417,17155,1,0,2,0,3
29257,60,8572,12932;13192;16880,17155,1,0,2,0,3
29258,60,8573,12751;12934;16767;17068,17155,1,1,2,0,4
29259,60,8574,12938;12990;17183,17155,1,0,2,0,3
29260,60,8575,12930;12952;16295;16489;16956,17155,1,2,2,0,5
29261,60,8576,12663;12960;16133;16224;16853,17155,0,3,2,0,5
29262,60,8577,12592;12641;16400;16666;16877,17155,1,2,2,0,5
29263,60,8578,12972;13409;16445;16574,17155,0,2,2,0,4
29264,60,8579,13495;15860;16381;16556,17155,0,3,1,0,4
29265,60,8580,12816;12997;16128;16335,17155,0,2,2,0,4
29266,60,8581,12925;13020;16181;16997,17155,1,1,2,0,4
29267,60,8582,12365;13028;16772;16943,17155,1,1,2,0,4
29268,60,8583,13039;13114;15899;17038,17155,1,1,2,0,4
29269,60,8584,12739;13059;15784;17030,17155,1,1,2,0,4
29270,60,8585,12772;13063;16742,17155,0,1,2,0,3
29271,60,8586,12951;13071;16042;16807,17155,0,2,2,0,4
29272,60,8587,13306,17155,0,0,1,0,1
29273,60,8588,13102;13133;16598,17155,0,1,2,0,3
29274,60,8589,13107;13307;15795;16596;16824,17155,0,3,2,0,5
29275,60,8590,13135;13202;16930,17155,1,0,2,0,3
29276,60,8591,3834,17520,0,0,0,1,1
29277,60,8594,2840,17520,0,0,0,1,1
29278,60,8596,5901,17520,0,0,0,1,1
29279,60,8597,6053,17520,0,0,0,1,1
29280,60,8598,1152,17520,0,0,1,0,1
29281,60,8599,7172,17520,0,0,0,1,1
29282,60,8600,3155,17520,0,0,0,1,1
29283,60,8603,9365;10157,17520,0,0,2,0,2
29284,60,8605,9788,17520,0,0,1,0,1
29285,60,8607,136;10165,17520,0,0,2,0,2
29286,60,8608,447,17520,0,0,0,1,1
29287,60,8612,10542,17520,0,0,1,0,1
29288,60,8613,10582,17520,0,0,1,0,1
29289,60,8621,11634;11822;15936;16072,17520,0,2,2,0,4
29290,60,8623,11455;11782;15929;16180;16308,17520,0,3,2,0,5
29291,60,8625,11516;11873;15941;16173,17520,0,2,2,0,4
29292,60,8627,11851,17520,0,0,1,0,1
29293,60,8628,11995;12393;17021;17223;17456,17520,3,0,2,0,5
29294,60,8629,11890;12051;16236;16511;17481,17520,1,2,2,0,5
29295,60,8630,12041;12309;15983;16553,17520,0,2,2,0,4
29296,60,8631,12049;12421;16303;16817,17520,0,2,2,0,4
29297,60,8632,12764;16169;16573;16614,17520,0,3,1,0,4
29298,60,8633,11744;12327;16634;16810,17520,0,2,2,0,4
29299,60,8634,12201;16365;16965,17520,1,1,1,0,3
29300,60,8635,11923;11925;16166;16443;16987,17520,1,2,2,0,5
29301,60,8636,12181;12263;16065;16487,17520,0,2,2,0,4
29302,60,8637,12358,17520,0,0,1,0,1
29303,60,8639,12438;12725;16586;16851;17343,17520,1,2,2,0,5
29304,60,8640,12467;12814;16016;17351,17520,1,1,2,0,4
29305,60,8641,12799;13040;16812;16984,17520,1,1,2,0,4
29306,60,8643,12491;12838;16355;16856,17520,0,2,2,0,4
29307,60,8644,12282;12522;16565;17102,17520,1,1,2,0,4
29308,60,8645,12533;12821;15951;17225,17520,1,1,2,0,4
29309,60,8646,12543,17520,0,0,1,0,1
29310,60,8647,12549;12695;16530;16660,17520,0,2,2,0,4
29311,60,8648,12562;13341;17312;17428,17520,2,0,2,0,4
29312,60,8649,12576;12638;16208;17049,17520,1,1,2,0,4
29313,60,8650,12627;13252;16808;17151,17520,1,1,2,0,4
29314,60,8651,12283;12457;17116;17154,17520,2,0,2,0,4
29315,60,8652,12504;12655;16533;17057,17520,1,1,2,0,4
29316,60,8653,12666;12709;15916;17034;17346,17520,2,1,2,0,5
29317,60,8654,12771;12882;16373;17062;17432,17520,2,1,2,0,5
29318,60,8655,13146;16962,17520,1,0,1,0,2
29319,60,8656,12515;12797;16214;17046;17473,17520,2,1,2,0,5
29320,60,8657,12826;13181;16388;17150,17520,1,1,2,0,4
29321,60,8658,12848;15959;16583;16973,17520,1,2,1,0,4
29322,60,8659,12888;13533,17520,0,0,2,0,2
29323,60,8660,12909;13091;16546;16839,17520,0,2,2,0,4
29324,60,8661,12910;13313,17520,0,0,2,0,2
29325,60,8662,12914;13270;16370;17175,17520,1,1,2,0,4
29326,60,8663,12694;12936;17172;17410,17520,2,0,2,0,4
29327,60,8664,13005;13609;15924;16469;16674;17255,17520,1,3,2,0,6
29328,60,8665,13014;13176;15977;17348,17520,1,1,2,0,4
29329,60,8666,12758;17412,17520,1,0,1,0,2
29330,60,8667,13482;13612;15996;16333,17520,0,2,2,0,4
29331,60,8668,12996;13037;16127;16629;17452,17520,1,2,2,0,5
29332,60,8669,13045;13550,17520,0,0,2,0,2
29333,60,8670,13061;13632,17520,0,0,2,0,2
29334,60,8671,12808;13621;16187;17270,17520,1,1,2,0,4
29335,60,8672,13076;13537,17520,0,0,2,0,2
29336,60,8673,13087;13178;17157,17520,1,0,2,0,3
29337,60,8674,13160;13517;16007;16142;16242,17520,0,3,2,0,5
29338,60,8675,13141;13394;16317;17291;17379,17520,2,1,2,0,5
29339,60,8676,13185;13268;16321;16605,17520,0,2,2,0,4
29340,60,8677,12994;13189;16059,17520,0,1,2,0,3
29341,60,8678,13023;13201;15998,17520,0,1,2,0,3
29342,60,8679,13205;13255;16106;16903,17520,1,1,2,0,4
29343,60,8680,13231;13489;16235;17105;17137,17520,2,1,2,0,5
29344,60,8683,1637,17885,0,0,0,1,1
29345,60,8684,9225,17885,0,0,0,1,1
29346,60,8686,6536,17885,0,0,0,1,1
29347,60,8687,7324,17885,0,0,0,1,1
29348,60,8690,4669,17885,0,0,0,1,1
29349,60,8691,988,17885,0,0,0,1,1
29350,60,8692,10072,17885,0,0,1,0,1
29351,60,8696,10297,17885,0,0,1,0,1
29352,60,8698,10340,17885,0,0,1,0,1
29353,60,8707,11241;16286;16723,17885,0,2,1,0,3
29354,60,8708,11305;11885;16415;16579,17885,0,2,2,0,4
29355,60,8710,11323;11682;16155;16217,17885,0,2,2,0,4
29356,60,8712,11372;11811;16198;16339,17885,0,2,2,0,4
29357,60,8713,11580;16707;16764,17885,0,2,1,0,3
29358,60,8714,11520;12122;16204;16590,17885,0,2,2,0,4
29359,60,8719,11746,17885,0,0,1,0,1
29360,60,8720,11758;12007;16130;16196;16684;16792,17885,0,4,2,0,6
29361,60,8721,11827;12077;16966;17232,17885,2,0,2,0,4
29362,60,8722,11951;12118;16143,17885,0,1,2,0,3
29363,60,8723,11986;16139;17231,17885,1,1,1,0,3
29364,60,8726,12216;12721;16168;16914,17885,1,1,2,0,4
29365,60,8727,12329;12530;17184;17371,17885,2,0,2,0,4
29366,60,8728,12237;12571;16466;16893;17169,17885,2,1,2,0,5
29367,60,8729,12295;12577;16089;16696;16800,17885,0,3,2,0,5
29368,60,8730,12300;12445;16159;16298,17885,0,2,2,0,4
29369,60,8732,12338,17885,0,0,1,0,1
29370,60,8733,13012;16673;16906,17885,1,1,1,0,3
29371,60,8734,12474;12475;16111;16541;17048;17378,17885,2,2,2,0,6
29372,60,8735,12055;12482;16232;16849,17885,0,2,2,0,4
29373,60,8736,12502;12970;16115;16282;16669;16830;17118,17885,1,4,2,0,7
29374,60,8737,12558;12947;16814;17138,17885,1,1,2,0,4
29375,60,8739,12486;12632;16998;17391,17885,2,0,2,0,4
29376,60,8740,12862;16246;16549;16844,17885,0,3,1,0,4
29377,60,8742,12404;12691;16195;16334;16480,17885,0,3,2,0,5
29378,60,8743,12683;12717;16566;16805;17384,17885,1,2,2,0,5
29379,60,8744,12631;13383,17885,0,0,2,0,2
29380,60,8745,12740;13123;15743;17130,17885,1,1,2,0,4
29381,60,8746,12760;13068;16868,17885,1,0,2,0,3
29382,60,8747,12784;12980,17885,0,0,2,0,2
29383,60,8748,12766;12976;16383;16683,17885,0,2,2,0,4
29384,60,8749,12773;13184,17885,0,0,2,0,2
29385,60,8750,13062;13630;16366;16981,17885,1,1,2,0,4
29386,60,8751,12887;13643;16740,17885,0,1,2,0,3
29387,60,8752,12937;16247;16916,17885,1,1,1,0,3
29388,60,8753,12954,17885,0,0,1,0,1
29389,60,8754,12618;12975;16544;17472,17885,1,1,2,0,4
29390,60,8755,12422;16087;16794,17885,0,2,1,0,3
29391,60,8756,12991;13043;16117,17885,0,1,2,0,3
29392,60,8757,12992;13010;17406,17885,1,0,2,0,3
29393,60,8758,13017;13432,17885,0,0,2,0,2
29394,60,8759,13271;13659,17885,0,0,2,0,2
29395,60,8760,12944;13094,17885,0,0,2,0,2
29396,60,8761,13112;13118;16462;17121,17885,1,1,2,0,4
29397,60,8762,13220;13266;16301;16522;17434,17885,1,2,2,0,5
29398,60,8763,13121;13755;16120;16375;17471,17885,1,2,2,0,5
29399,60,8764,12477;13131;17129,17885,1,0,2,0,3
29400,60,8765,13142;13602;16258;16554;16921;17212,17885,2,2,2,0,6
29401,60,8766,13148,17885,0,0,1,0,1
29402,60,8767,13155,17885,0,0,1,0,1
29403,60,8768,12959;13174;16497;16781,17885,0,2,2,0,4
29404,60,8769,13183;13281;16811;17045,17885,1,1,2,0,4
29405,60,8770,13195;16854,17885,0,1,1,0,2
29406,60,8771,13215,17885,0,0,1,0,1
29407,60,8772,13119;13483;16377,17885,0,1,2,0,3
29408,60,8773,12968;13242,17885,0,0,2,0,2
29409,60,8774,13073;13250;16336;16475;17416,17885,1,2,2,0,5
29410,60,8775,13018;13253;16228;16361,17885,0,2,2,0,4
29411,60,8777,12907;13291;17193;17479,17885,2,0,2,0,4
29412,60,8778,13295;13395;16785;17161,17885,1,1,2,0,4
29413,60,8779,13299;13613;16288;17055;17239,17885,2,1,2,0,5
29414,60,8780,13303;17325,17885,1,0,1,0,2
29415,60,8781,13656;13742,17885,0,0,2,0,2
29416,60,8782,13144;13309;16257,17885,0,1,2,0,3
29417,60,8783,13310;13518;16858;17347,17885,1,1,2,0,4
29418,60,8784,13326;13468;17284,17885,1,0,2,0,3
29419,60,8785,13529;13703;16081,17885,0,1,2,0,3
29420,60,8786,13373;13669;16119;16460;17092;17392,17885,2,2,2,0,6
29421,60,8787,12706;13382;16691;16933;17238,17885,2,1,2,0,5
29422,60,8788,13320;13396;16323;16925,17885,1,1,2,0,4
29423,60,8790,1630,18250,0,0,0,1,1
29424,60,8791,4851,18250,0,0,0,1,1
29425,60,8793,1314,18250,0,0,0,1,1
29426,60,8794,3234,18250,0,0,0,1,1
29427,60,8795,2964;5731,18250,0,0,1,1,2
29428,60,8796,7894;8288,18250,0,0,0,2,2
29429,60,8797,9098;9418,18250,0,0,0,2,2
29430,60,8798,4748,18250,0,0,1,0,1
29431,60,8800,10117,18250,0,0,1,0,1
29432,60,8801,10131;10204,18250,0,0,2,0,2
29433,60,8808,10553,18250,0,0,1,0,1
29434,60,8809,10744,18250,0,0,1,0,1
29435,60,8811,10981,18250,0,0,1,0,1
29436,60,8815,11533;11582;16395;16672,18250,0,2,2,0,4
29437,60,8816,11517;11541;16201;16664,18250,0,2,2,0,4
29438,60,8817,11554,18250,0,0,1,0,1
29439,60,8819,11646,18250,0,0,1,0,1
29440,60,8821,11655,18250,0,0,1,0,1
29441,60,8823,11676,18250,0,0,1,0,1
29442,60,8825,12084;16474;16632,18250,0,2,1,0,3
29443,60,8826,11347;11820;16199;16523,18250,0,2,2,0,4
29444,60,8827,11696,18250,0,0,1,0,1
29445,60,8828,11870,18250,0,0,1,0,1
29446,60,8829,11912;12004;16218;16821;17117,18250,1,2,2,0,5
29447,60,8830,12074;12187;16255;16898,18250,1,1,2,0,4
29448,60,8832,12252;12336;16261;16874,18250,1,1,2,0,4
29449,60,8833,12342;12556;16360;16861,18250,0,2,2,0,4
29450,60,8834,12247;12347;16254;16595,18250,0,2,2,0,4
29451,60,8835,12383;12452;16529;16618;17091,18250,1,2,2,0,5
29452,60,8836,12186;12443;16600;16733,18250,0,2,2,0,4
29453,60,8837,12447;13324,18250,0,0,2,0,2
29454,60,8838,12471;16272;16575;17077,18250,1,2,1,0,4
29455,60,8839,12398;12487;16842;17056,18250,1,1,2,0,4
29456,60,8840,12538;16422;16647,18250,0,2,1,0,3
29457,60,8841,12754;13569;17463,18250,1,0,2,0,3
29458,60,8842,12578;12881;17221,18250,1,0,2,0,3
29459,60,8843,12583;13126;17411,18250,1,0,2,0,3
29460,60,8844,12668;13035;16447;17024,18250,1,1,2,0,4
29461,60,8845,12689;13038;16838,18250,0,1,2,0,3
29462,60,8846,12699;12749;16644;17274,18250,1,1,2,0,4
29463,60,8847,12704;12768;16346;16778,18250,0,2,2,0,4
29464,60,8848,12710;13420;16711;17010,18250,1,1,2,0,4
29465,60,8849,12334;12711;16319;17186,18250,1,1,2,0,4
29466,60,8850,12986;17236,18250,1,0,1,0,2
29467,60,8851,12789;12800;16649;17120,18250,1,1,2,0,4
29468,60,8852,12809;13469,18250,0,0,2,0,2
29469,60,8853,12811;13053;16356;17476,18250,1,1,2,0,4
29470,60,8854,12850;13470;16313;16607,18250,0,2,2,0,4
29471,60,8855,12884;13203;16834;17437,18250,1,1,2,0,4
29472,60,8856,12819;12958;17245,18250,1,0,2,0,3
29473,60,8857,12461;12966;17261,18250,1,0,2,0,3
29474,60,8858,12983;13436;16216;17240,18250,1,1,2,0,4
29475,60,8859,13449;16416;16665,18250,0,2,1,0,3
29476,60,8860,12763;13022;17104,18250,1,0,2,0,3
29477,60,8861,12962;13026;16976;17179,18250,2,0,2,0,4
29478,60,8862,12748;13032;16593;17467,18250,1,1,2,0,4
29479,60,8863,12950;13036;17307,18250,1,0,2,0,3
29480,60,8864,13388;16650;16908,18250,1,1,1,0,3
29481,60,8865,12979;13090;16797,18250,0,1,2,0,3
29482,60,8866,13088;13092;16351;16611,18250,0,2,2,0,4
29483,60,8867,13021;13638;16345;17182,18250,1,1,2,0,4
29484,60,8868,12998;13129;16283;17044,18250,1,1,2,0,4
29485,60,8869,13137;13375;16588;16678,18250,0,2,2,0,4
29486,60,8870,13297;17192,18250,1,0,1,0,2
29487,60,8871,13171;13688;16318,18250,0,1,2,0,3
29488,60,8872,13161;13177,18250,0,0,2,0,2
29489,60,8873,13216;13655;16389;17228,18250,1,1,2,0,4
29490,60,8874,13428;16223;16493,18250,0,2,1,0,3
29491,60,8875,13249;13330;16996;17213,18250,2,0,2,0,4
29492,60,8876,13289;13294,18250,0,0,2,0,2
29493,60,8877,13361;17216;17431,18250,2,0,1,0,3
29494,60,8878,13304;13311;17394,18250,1,0,2,0,3
29495,60,8879,12857;13339;17249,18250,1,0,2,0,3
29496,60,8880,13348;13899;16502;17252;17442,18250,2,1,2,0,5
29497,60,8881,13392;13660,18250,0,0,2,0,2
29498,60,8882,13429;13587;16948,18250,1,0,2,0,3
29499,60,8883,13442;13943;16432;16754;16963;17040,18250,2,2,2,0,6
29500,60,8884,13446;13539;16537;17025;17257,18250,2,1,2,0,5
29501,60,8885,12547;13471;16219;17123,18250,1,1,2,0,4
29502,60,8886,13138;13472;16197;16394,18250,0,2,2,0,4
29503,60,8887,13485;13851;16331;16846,18250,0,2,2,0,4
29504,60,8888,13774;16285,18250,0,1,1,0,2
29505,60,8889,13493;14002;17353,18250,1,0,2,0,3
29506,60,8890,13523;16446;16646;17297,18250,1,2,1,0,4
29507,60,8892,13329;13532;17292,18250,1,0,2,0,3
29508,60,8895,89;6838,18615,0,0,0,2,2
29509,60,8896,6261,18615,0,0,0,1,1
29510,60,8898,7396,18615,0,0,0,1,1
29511,60,8904,10698,18615,0,0,1,0,1
29512,60,8906,10775;11175;17082,18615,1,0,2,0,3
29513,60,8907,10949,18615,0,0,1,0,1
29514,60,8908,11019;11178;16702,18615,0,1,2,0,3
29515,60,8911,11435,18615,0,0,1,0,1
29516,60,8912,11444;11897;17336,18615,1,0,2,0,3
29517,60,8913,10918,18615,0,0,1,0,1
29518,60,8915,11749;12012;16426;16620,18615,0,2,2,0,4
29519,60,8916,11830,18615,0,0,1,0,1
29520,60,8918,11882;12574;16520;16655,18615,0,2,2,0,4
29521,60,8919,11998;12727;16715;17036,18615,1,1,2,0,4
29522,60,8920,11680;12006;16425,18615,0,1,2,0,3
29523,60,8921,12017,18615,0,0,1,0,1
29524,60,8923,12046;12564;16867,18615,1,0,2,0,3
29525,60,8926,11578;12268;16349;16789;17454,18615,1,2,2,0,5
29526,60,8927,12563;16516;16770,18615,0,2,1,0,3
29527,60,8928,12179;12366;16552;16751,18615,0,2,2,0,4
29528,60,8930,12115,18615,0,0,1,0,1
29529,60,8931,12798;17235,18615,1,0,1,0,2
29530,60,8932,12593;12726;16989;17214,18615,2,0,2,0,4
29531,60,8934,12911;13103,18615,0,0,2,0,2
29532,60,8935,12659;16937;17306,18615,2,0,1,0,3
29533,60,8936,12553;12679;16419;16476,18615,0,2,2,0,4
29534,60,8937,12696;13474;17180,18615,1,0,2,0,3
29535,60,8939,12552;12777;16343,18615,0,1,2,0,3
29536,60,8940,13209;17131,18615,1,0,1,0,2
29537,60,8941,12805;12956;16995;17264,18615,2,0,2,0,4
29538,60,8942,12817;13019,18615,0,0,2,0,2
29539,60,8943,12827;13246;16624;16922,18615,1,1,2,0,4
29540,60,8944,12732;12842;17385,18615,1,0,2,0,3
29541,60,8945,12843;14379;16642,18615,0,1,2,0,3
29542,60,8946,12847;16710,18615,0,1,1,0,2
29543,60,8947,13070;17457,18615,1,0,1,0,2
29544,60,8948,12560;12908;17275,18615,1,0,2,0,3
29545,60,8949,12926;16822;17310,18615,1,1,1,0,3
29546,60,8950,12948;13666;16363,18615,0,1,2,0,3
29547,60,8951,11988;12978;17205,18615,1,0,2,0,3
29548,60,8953,13002;13455;17140,18615,1,0,2,0,3
29549,60,8954,13027;13169;16737,18615,0,1,2,0,3
29550,60,8955,13034,18615,0,0,1,0,1
29551,60,8956,13047;13506;17388,18615,1,0,2,0,3
29552,60,8957,13075,18615,0,0,1,0,1
29553,60,8958,13109;13842;16384;17271;17447,18615,2,1,2,0,5
29554,60,8959,13134;13508;17188,18615,1,0,2,0,3
29555,60,8960,13163;13172;16378;17176,18615,1,1,2,0,4
29556,60,8961,13083,18615,0,0,1,0,1
29557,60,8962,13175;13736;16471;17012;17319,18615,2,1,2,0,5
29558,60,8963,13484;16947;17266,18615,2,0,1,0,3
29559,60,8964,13408;14014,18615,0,0,2,0,2
29560,60,8965,13219;13918;16482;17424,18615,1,1,2,0,4
29561,60,8966,12904;13240;17251,18615,1,0,2,0,3
29562,60,8967,13254;13963;17404,18615,1,0,2,0,3
29563,60,8968,13006;13332;17364,18615,1,0,2,0,3
29564,60,8969,13337;13366;16457;16967,18615,1,1,2,0,4
29565,60,8970,13127;13343;16599;16729;17262,18615,1,2,2,0,5
29566,60,8971,13350;13354;17127;17402,18615,2,0,2,0,4
29567,60,8972,13067;13384;16653;17165;17470,18615,2,1,2,0,5
29568,60,8973,13386;13417;16369;16759;17234,18615,1,2,2,0,5
29569,60,8974,13165,18615,0,0,1,0,1
29570,60,8976,13599,18615,0,0,1,0,1
29571,60,8977,13856;16970;17013,18615,2,0,1,0,3
29572,60,8978,13499;14044;16559;16798,18615,0,2,2,0,4
29573,60,8979,13054;13453,18615,0,0,2,0,2
29574,60,8980,13511;16637;17332,18615,1,1,1,0,3
29575,60,8981,13520;13778;16449;16725;17222,18615,1,2,2,0,5
29576,60,8982,13545;13583;17282,18615,1,0,2,0,3
29577,60,8983,13218;13554;17305,18615,1,0,2,0,3
29578,60,8984,13269;13562;17066,18615,1,0,2,0,3
29579,60,8985,13564;13704;16413,18615,0,1,2,0,3
29580,60,8986,13573;13678;16353,18615,0,1,2,0,3
29581,60,8987,13098;13585,18615,0,0,2,0,2
29582,60,8988,13296;13616;16458;16864;17178,18615,1,2,2,0,5
29583,60,8989,13784;13883;16435;17043,18615,1,1,2,0,4
29584,60,8990,13626;14032;16401;16777;17071,18615,1,2,2,0,5
29585,60,8991,13629;13650;17357,18615,1,0,2,0,3
29586,60,8992,13637;13761;16513;16980,18615,1,1,2,0,4
29587,60,8993,13528;13644;17477,18615,1,0,2,0,3
29588,60,8994,13488;13657;16746,18615,0,1,2,0,3
29589,60,8995,13194;13658;17058,18615,1,0,2,0,3
29590,60,8996,3136;9043,18980,0,0,0,2,2
29591,60,8998,4856,18980,0,0,0,1,1
29592,60,8999,4470,18980,0,0,0,1,1
29593,60,9000,3776;9722,18980,0,0,0,2,2
29594,60,9003,5027,18980,0,0,0,1,1
29595,60,9004,10057;10351,18980,0,0,2,0,2
29596,60,9005,1472,18980,0,0,1,0,1
29597,60,9006,4515,18980,0,0,1,0,1
29598,60,9007,10181,18980,0,0,1,0,1
29599,60,9008,10397;10572,18980,0,0,2,0,2
29600,60,9012,10734,18980,0,0,1,0,1
29601,60,9017,11050;11335;16551;16693,18980,0,2,2,0,4
29602,60,9020,11525,18980,0,0,1,0,1
29603,60,9021,11631,18980,0,0,1,0,1
29604,60,9023,11685,18980,0,0,1,0,1
29605,60,9024,11733;12163;16486;16732,18980,0,2,2,0,4
29606,60,9026,11955,18980,0,0,1,0,1
29607,60,9027,12108;12852;17099,18980,1,0,2,0,3
29608,60,9028,11805,18980,0,0,1,0,1
29609,60,9029,11601;12173;16491;16900,18980,1,1,2,0,4
29610,60,9033,12153;12299;16500;16668,18980,0,2,2,0,4
29611,60,9034,11904;12322;16521;16845,18980,0,2,2,0,4
29612,60,9036,12391;12917;16991;17259,18980,2,0,2,0,4
29613,60,9037,12400;12893;16572;16735;16885,18980,1,2,2,0,5
29614,60,9038,12401;12985;17146;17462,18980,2,0,2,0,4
29615,60,9039,12065;12508;16481,18980,0,1,2,0,3
29616,60,9040,12548;13244;16484;16776;17337,18980,1,2,2,0,5
29617,60,9041,12569;13258,18980,0,0,2,0,2
29618,60,9042,12824;17032,18980,1,0,1,0,2
29619,60,9045,12796;13497;17242,18980,1,0,2,0,3
29620,60,9046,12716;13001;17015,18980,1,0,2,0,3
29621,60,9048,13353;13501,18980,0,0,2,0,2
29622,60,9049,12969;17067,18980,1,0,1,0,2
29623,60,9050,12890;13041,18980,0,0,2,0,2
29624,60,9051,12971;13052;16816,18980,0,1,2,0,3
29625,60,9052,13077;13596;16612,18980,0,1,2,0,3
29626,60,9053,13101,18980,0,0,1,0,1
29627,60,9054,13031;13139;17080,18980,1,0,2,0,3
29628,60,9055,13086,18980,0,0,1,0,1
29629,60,9056,12933;13182;16848;16934;17018,18980,2,1,2,0,5
29630,60,9057,13217;13346,18980,0,0,2,0,2
29631,60,9058,13221;13913;17478,18980,1,0,2,0,3
29632,60,9059,13223;16512,18980,0,1,1,0,2
29633,60,9060,12957;13225;17109;17227,18980,2,0,2,0,4
29634,60,9061,13226;13593;17323,18980,1,0,2,0,3
29635,60,9062,13256;16788,18980,0,1,1,0,2
29636,60,9063,13267;13578;16809,18980,0,1,2,0,3
29637,60,9064,13276,18980,0,0,1,0,1
29638,60,9065,13145;13707,18980,0,0,2,0,2
29639,60,9066,13301;13766;17369,18980,1,0,2,0,3
29640,60,9067,13351;13826;16532;17370,18980,1,1,2,0,4
29641,60,9068,13372;13457;17466,18980,1,0,2,0,3
29642,60,9069,13605;13715;17060,18980,1,0,2,0,3
29643,60,9070,13055;13430,18980,0,0,2,0,2
29644,60,9071,13443;13514;16633;17268,18980,1,1,2,0,4
29645,60,9072,13509;13636,18980,0,0,2,0,2
29646,60,9073,13458;13580,18980,0,0,2,0,2
29647,60,9074,13461;13591;17352,18980,1,0,2,0,3
29648,60,9075,13100;13448;16569;17126,18980,1,1,2,0,4
29649,60,9076,13136;13491;16878,18980,1,0,2,0,3
29650,60,9077,13534,18980,0,0,1,0,1
29651,60,9078,13576;13814;16936,18980,1,0,2,0,3
29652,60,9079,13617;13996;16713;16766;17254,18980,1,2,2,0,5
29653,60,9080,13610;13705;17000,18980,1,0,2,0,3
29654,60,9081,12876,18980,0,0,1,0,1
29655,60,9082,13179;13641;17256,18980,1,0,2,0,3
29656,60,9083,13081;13642,18980,0,0,2,0,2
29657,60,9084,13693;16490;17308,18980,1,1,1,0,3
29658,60,9085,13713;13749;16927,18980,1,0,2,0,3
29659,60,9086,13716;16701,18980,0,1,1,0,2
29660,60,9087,13233;13729;16562;16969;17356,18980,2,1,2,0,5
29661,60,9088,13733;13930;16526;17446,18980,1,1,2,0,4
29662,60,9089,13763;13824;17113,18980,1,0,2,0,3
29663,60,9090,13767;14057;16563;16873;17158,18980,2,1,2,0,5
29664,60,9091,13503;13938;16508,18980,0,1,2,0,3
29665,60,9092,334,19345,0,0,1,0,1
29666,60,9093,10216,19345,0,0,1,0,1
29667,60,9094,1266;2893,19345,0,0,0,2,2
29668,60,9096,10281,19345,0,0,1,0,1
29669,60,9102,10957,19345,0,0,1,0,1
29670,60,9103,10960,19345,0,0,1,0,1
29671,60,9106,10781,19345,0,0,1,0,1
29672,60,9107,11187,19345,0,0,1,0,1
29673,60,9108,10993,19345,0,0,1,0,1
29674,60,9111,11540,19345,0,0,1,0,1
29675,60,9115,11724,19345,0,0,1,0,1
29676,60,9118,11893,19345,0,0,1,0,1
29677,60,9120,12246,19345,0,0,1,0,1
29678,60,9121,12313;12373;17111,19345,1,0,2,0,3
29679,60,9122,12375;12949;16806;16869,19345,1,1,2,0,4
29680,60,9123,12433;16889;17042,19345,2,0,1,0,3
29681,60,9124,12440;12520;17427,19345,1,0,2,0,3
29682,60,9125,12480;12676;16692,19345,0,1,2,0,3
29683,60,9127,12606;13099;16950,19345,1,0,2,0,3
29684,60,9128,12612,19345,0,0,1,0,1
29685,60,9129,12222;12634;16753;17199,19345,1,1,2,0,4
29686,60,9130,12672,19345,0,0,1,0,1
29687,60,9131,12405;12413;16899;17450,19345,2,0,2,0,4
29688,60,9132,12507;13015;17197,19345,1,0,2,0,3
29689,60,9133,13143;17191,19345,1,0,1,0,2
29690,60,9134,12832;12877;17226,19345,1,0,2,0,3
29691,60,9135,13316,19345,0,0,1,0,1
29692,60,9136,12965;14204;16628;16913;17403,19345,2,1,2,0,5
29693,60,9137,13106;17006;17354,19345,2,0,1,0,3
29694,60,9138,13116;13611,19345,0,0,2,0,2
29695,60,9139,13280,19345,0,0,1,0,1
29696,60,9140,13808;13950;17361,19345,1,0,2,0,3
29697,60,9141,13315;13958;16887;17133;17468,19345,3,0,2,0,5
29698,60,9142,13334;16954;17051,19345,2,0,1,0,3
29699,60,9143,13335;13336,19345,0,0,2,0,2
29700,60,9144,13058;13345,19345,0,0,2,0,2
29701,60,9145,13359;14046;17229;17294,19345,2,0,2,0,4
29702,60,9146,13362;13940,19345,0,0,2,0,2
29703,60,9147,13066;13390,19345,0,0,2,0,2
29704,60,9148,13393;13717,19345,0,0,2,0,2
29705,60,9149,13400;14152;16720;17355,19345,1,1,2,0,4
29706,60,9150,13401;13936;17233;17439,19345,2,0,2,0,4
29707,60,9151,13415;16850;17101,19345,1,1,1,0,3
29708,60,9152,13467;14339;16743;16952;17125,19345,2,1,2,0,5
29709,60,9153,13487;17026,19345,1,0,1,0,2
29710,60,9154,13519;13980;17087;17143,19345,2,0,2,0,4
29711,60,9155,13549;14070;16919;17421,19345,2,0,2,0,4
29712,60,9156,13588;14041;17330,19345,1,0,2,0,3
29713,60,9157,14063;14188,19345,0,0,2,0,2
29714,60,9158,13699;16659,19345,0,1,1,0,2
29715,60,9159,13649;13664,19345,0,0,2,0,2
29716,60,9160,13673;13748;17314,19345,1,0,2,0,3
29717,60,9161,13464;13677,19345,0,0,2,0,2
29718,60,9162,13447;13695;16866,19345,1,0,2,0,3
29719,60,9163,13196;13412,19345,0,0,2,0,2
29720,60,9164,13714;17168,19345,1,0,1,0,2
29721,60,9165,13723;13878,19345,0,0,2,0,2
29722,60,9166,13724;13732;16923,19345,1,0,2,0,3
29723,60,9167,13531;13740;16917,19345,1,0,2,0,3
29724,60,9168,13801;16944,19345,1,0,1,0,2
29725,60,9169,13238;13768,19345,0,0,2,0,2
29726,60,9170,13431;13771;16681,19345,0,1,2,0,3
29727,60,9171,13772;16694,19345,0,1,1,0,2
29728,60,9172,13782;13858,19345,0,0,2,0,2
29729,60,9173,13790;13892;16787,19345,0,1,2,0,3
29730,60,9174,13247;13792;17397,19345,1,0,2,0,3
29731,60,9175,13793;13849,19345,0,0,2,0,2
29732,60,9176,13823;17287,19345,1,0,1,0,2
29733,60,9177,13527;13845;16763;17237,19345,1,1,2,0,4
29734,60,9178,13881;13979;16897;17023,19345,2,0,2,0,4
29735,60,9179,13984,19345,0,0,1,0,1
29736,60,9180,13804;13894,19345,0,0,2,0,2
29737,60,9181,13901;13919;17382,19345,1,0,2,0,3
29738,60,9182,247,19710,0,0,0,1,1
29739,60,9183,4809,19710,0,0,0,1,1
29740,60,9184,3952,19710,0,0,0,1,1
29741,60,9185,4075,19710,0,0,0,1,1
29742,60,9187,6055,19710,0,0,0,1,1
29743,60,9189,7039,19710,0,0,0,1,1
29744,60,9193,10106,19710,0,0,1,0,1
29745,60,9194,10233,19710,0,0,1,0,1
29746,60,9195,10238,19710,0,0,1,0,1
29747,60,9199,10706,19710,0,0,1,0,1
29748,60,9200,10620;10838,19710,0,0,2,0,2
29749,60,9201,11123,19710,0,0,1,0,1
29750,60,9204,11816,19710,0,0,1,0,1
29751,60,9205,11562,19710,0,0,1,0,1
29752,60,9206,11643,19710,0,0,1,0,1
29753,60,9207,11139,19710,0,0,1,0,1
29754,60,9208,11605,19710,0,0,1,0,1
29755,60,9210,12178,19710,0,0,1,0,1
29756,60,9211,11997;12145;17483,19710,1,0,2,0,3
29757,60,9212,12164,19710,0,0,1,0,1
29758,60,9213,12675;16837;17029,19710,1,1,1,0,3
29759,60,9214,12276,19710,0,0,1,0,1
29760,60,9216,12526;12703;16926;17097,19710,2,0,2,0,4
29761,60,9217,12835;12922;16904;17114,19710,2,0,2,0,4
29762,60,9219,13117;13676;17247,19710,1,0,2,0,3
29763,60,9220,12656;13011,19710,0,0,2,0,2
29764,60,9221,13024;13124;16958;17096;17181;17480,19710,4,0,2,0,6
29765,60,9222,13044;13275,19710,0,0,2,0,2
29766,60,9223,12621;13162;16892,19710,1,0,2,0,3
29767,60,9224,13120,19710,0,0,1,0,1
29768,60,9225,12528,19710,0,0,1,0,1
29769,60,9226,13349;13665;16935,19710,1,0,2,0,3
29770,60,9227,13369;13515,19710,0,0,2,0,2
29771,60,9228,13553,19710,0,0,1,0,1
29772,60,9230,13080,19710,0,0,1,0,1
29773,60,9231,14069;14155;16741,19710,0,1,2,0,3
29774,60,9232,13450;13582;17380,19710,1,0,2,0,3
29775,60,9233,13426;13477,19710,0,0,2,0,2
29776,60,9234,13542;13924;17290,19710,1,0,2,0,3
29777,60,9235,13421;13551,19710,0,0,2,0,2
29778,60,9236,13555;14110;16855;17342,19710,1,1,2,0,4
29779,60,9237,13435;13598;16894,19710,1,0,2,0,3
29780,60,9238,13440;13601;17358,19710,1,0,2,0,3
29781,60,9239,13624;14138,19710,0,0,2,0,2
29782,60,9240,13640;13870,19710,0,0,2,0,2
29783,60,9241,13633;13654;16793;17241,19710,1,1,2,0,4
29784,60,9242,13689;14337;16875;17303,19710,2,0,2,0,4
29785,60,9243,13694,19710,0,0,1,0,1
29786,60,9244,13618;13791,19710,0,0,2,0,2
29787,60,9245,13702;17279,19710,1,0,1,0,2
29788,60,9246,13413;13708;16852;17064;17449,19710,2,1,2,0,5
29789,60,9247,13712,19710,0,0,1,0,1
29790,60,9248,13425,19710,0,0,1,0,1
29791,60,9249,13741;14042;16752;17079,19710,1,1,2,0,4
29792,60,9250,14362;16918;17331,19710,2,0,1,0,3
29793,60,9251,13530;13811;17004;17296,19710,2,0,2,0,4
29794,60,9252,13840;14462;16827,19710,0,1,2,0,3
29795,60,9253,14365;16780;17263,19710,1,1,1,0,3
29796,60,9254,13850;14089;16832;17100;17281,19710,2,1,2,0,5
29797,60,9255,13890;14158;17333,19710,1,0,2,0,3
29798,60,9256,13907;17376,19710,1,0,1,0,2
29799,60,9257,13236;13914,19710,0,0,2,0,2
29800,60,9258,13926,19710,0,0,1,0,1
29801,60,9259,13947;14106;16910;17448,19710,2,0,2,0,4
29802,60,9260,13948,19710,0,0,1,0,1
29803,60,9261,13971;14100;16756;17324,19710,1,1,2,0,4
29804,60,9262,13990;14028;16769;17070,19710,1,1,2,0,4
29805,60,9263,14029;14097,19710,0,0,2,0,2
29806,60,9264,14035;14058,19710,0,0,2,0,2
29807,60,9265,13615;13944,19710,0,0,2,0,2
29808,60,9266,13871;14078;17076,19710,1,0,2,0,3
29809,60,9267,14080;14451;16738,19710,0,1,2,0,3
29810,60,9268,1284,20075,0,0,1,0,1
29811,60,9270,3108,20075,0,0,0,1,1
29812,60,9271,774,20075,0,0,0,1,1
29813,60,9273,7257,20075,0,0,0,1,1
29814,60,9274,10034,20075,0,0,1,0,1
29815,60,9276,10005,20075,0,0,1,0,1
29816,60,9277,10166,20075,0,0,1,0,1
29817,60,9278,10054,20075,0,0,1,0,1
29818,60,9279,10143,20075,0,0,1,0,1
29819,60,9281,10401,20075,0,0,1,0,1
29820,60,9282,10381,20075,0,0,1,0,1
29821,60,9290,10798,20075,0,0,1,0,1
29822,60,9294,11143,20075,0,0,1,0,1
29823,60,9296,11255,20075,0,0,1,0,1
29824,60,9301,11629,20075,0,0,1,0,1
29825,60,9302,11745;12123,20075,0,0,2,0,2
29826,60,9303,11538,20075,0,0,1,0,1
29827,60,9305,11738;12106;16888;17374,20075,2,0,2,0,4
29828,60,9306,12154;12500,20075,0,0,2,0,2
29829,60,9307,12158,20075,0,0,1,0,1
29830,60,9308,12166,20075,0,0,1,0,1
29831,60,9309,12169;12653;16912;17399,20075,2,0,2,0,4
29832,60,9313,12724;13078;17396,20075,1,0,2,0,3
29833,60,9314,12588,20075,0,0,1,0,1
29834,60,9315,12853;17086,20075,1,0,1,0,2
29835,60,9316,12993;13411;16881;17170,20075,2,0,2,0,4
29836,60,9317,13033;13556,20075,0,0,2,0,2
29837,60,9318,12916;13051;16870;17155,20075,2,0,2,0,4
29838,60,9319,12833;13229;17115,20075,1,0,2,0,3
29839,60,9320,13239;16964,20075,1,0,1,0,2
29840,60,9321,13634;17163,20075,1,0,1,0,2
29841,60,9323,13364;14171;17052,20075,1,0,2,0,3
29842,60,9324,12953,20075,0,0,1,0,1
29843,60,9325,13206;13575,20075,0,0,2,0,2
29844,60,9326,13536;13594,20075,0,0,2,0,2
29845,60,9327,14359,20075,0,0,1,0,1
29846,60,9328,13690,20075,0,0,1,0,1
29847,60,9329,13706;14191,20075,0,0,2,0,2
29848,60,9330,13710;13744,20075,0,0,2,0,2
29849,60,9331,13516;13719;16971,20075,1,0,2,0,3
29850,60,9332,13730;14030;17329;17409,20075,2,0,2,0,4
29851,60,9333,13759;14443;16951,20075,1,0,2,0,3
29852,60,9334,13628;13789,20075,0,0,2,0,2
29853,60,9335,13797;14186;16942;17167,20075,2,0,2,0,4
29854,60,9336,13799,20075,0,0,1,0,1
29855,60,9337,13839;17041,20075,1,0,1,0,2
29856,60,9338,13854;14121,20075,0,0,2,0,2
29857,60,9339,13783;13877,20075,0,0,2,0,2
29858,60,9340,13888;14130,20075,0,0,2,0,2
29859,60,9341,13867;13908;17065;17277,20075,2,0,2,0,4
29860,60,9342,13910;14312,20075,0,0,2,0,2
29861,60,9343,13912,20075,0,0,1,0,1
29862,60,9344,13812;13922;16909,20075,1,0,2,0,3
29863,60,9345,13548;13927;17295,20075,1,0,2,0,3
29864,60,9346,13152;13933,20075,0,0,2,0,2
29865,60,9347,13773,20075,0,0,1,0,1
29866,60,9348,13951;14282,20075,0,0,2,0,2
29867,60,9349,13735;13954,20075,0,0,2,0,2
29868,60,9350,13909;14009;17340,20075,1,0,2,0,3
29869,60,9351,14020;14225,20075,0,0,2,0,2
29870,60,9352,14052;14179;17367,20075,1,0,2,0,3
29871,60,9353,13891;14099;17093;17445,20075,2,0,2,0,4
29872,60,9354,14105;14473;16979,20075,1,0,2,0,3
29873,60,9355,14112;14530;16901;17425,20075,2,0,2,0,4
29874,60,9356,13679;14119;17153,20075,1,0,2,0,3
29875,60,9357,13816;14125,20075,0,0,2,0,2
29876,60,9358,14140;14584;16968,20075,1,0,2,0,3
29877,60,9359,14144,20075,0,0,1,0,1
29878,60,9360,13561;14154,20075,0,0,2,0,2
29879,60,9361,14178;14369;16945,20075,1,0,2,0,3
29880,60,9362,14128;14181;16876;17286,20075,2,0,2,0,4
29881,60,9363,13895;14198,20075,0,0,2,0,2
29882,60,9364,14218,20075,0,0,1,0,1
29883,60,9365,2910,20440,0,0,1,0,1
29884,60,9366,4023,20440,0,0,1,0,1
29885,60,9367,5793,20440,0,0,1,0,1
29886,60,9368,7037,20440,0,0,1,0,1
29887,60,9369,10124,20440,0,0,1,0,1
29888,60,9370,10172,20440,0,0,1,0,1
29889,60,9371,10275,20440,0,0,1,0,1
29890,60,9373,10222,20440,0,0,1,0,1
29891,60,9377,10692,20440,0,0,1,0,1
29892,60,9378,10766,20440,0,0,1,0,1
29893,60,9381,10942,20440,0,0,1,0,1
29894,60,9382,10946,20440,0,0,1,0,1
29895,60,9384,10965,20440,0,0,1,0,1
29896,60,9386,11392,20440,0,0,1,0,1
29897,60,9387,11417,20440,0,0,1,0,1
29898,60,9388,11588,20440,0,0,1,0,1
29899,60,9391,11606,20440,0,0,1,0,1
29900,60,9392,11621,20440,0,0,1,0,1
29901,60,9394,11603,20440,0,0,1,0,1
29902,60,9398,12150,20440,0,0,1,0,1
29903,60,9399,12253,20440,0,0,1,0,1
29904,60,9400,12279,20440,0,0,1,0,1
29905,60,9401,12325,20440,0,0,1,0,1
29906,60,9402,12345;12394,20440,0,0,2,0,2
29907,60,9403,12351;12505;17054;17317,20440,2,0,2,0,4
29908,60,9404,12425;12454;17106;17280,20440,2,0,2,0,4
29909,60,9405,12804;13016,20440,0,0,2,0,2
29910,60,9406,12466;12582;17031;17198,20440,2,0,2,0,4
29911,60,9407,12594,20440,0,0,1,0,1
29912,60,9408,12601;12869;17027;17334,20440,2,0,2,0,4
29913,60,9409,12645;13572,20440,0,0,2,0,2
29914,60,9410,12484;12750;17089,20440,1,0,2,0,3
29915,60,9412,12494;12765;17283,20440,1,0,2,0,3
29916,60,9413,12793,20440,0,0,1,0,1
29917,60,9414,12885,20440,0,0,1,0,1
29918,60,9415,12939;13104;17441,20440,1,0,2,0,3
29919,60,9416,12995,20440,0,0,1,0,1
29920,60,9417,13007;13013;17147,20440,1,0,2,0,3
29921,60,9418,12524,20440,0,0,1,0,1
29922,60,9419,13042;13193,20440,0,0,2,0,2
29923,60,9421,12722;13064,20440,0,0,2,0,2
29924,60,9422,13151;13298,20440,0,0,2,0,2
29925,60,9423,13273;17276,20440,1,0,1,0,2
29926,60,9424,13200;13212;17482,20440,1,0,2,0,3
29927,60,9425,13262,20440,0,0,1,0,1
29928,60,9426,13331;13522,20440,0,0,2,0,2
29929,60,9427,13377;14025,20440,0,0,2,0,2
29930,60,9428,12900;13438,20440,0,0,2,0,2
29931,60,9429,13463,20440,0,0,1,0,1
29932,60,9430,13507;14169,20440,0,0,2,0,2
29933,60,9431,13525;13620;17088,20440,1,0,2,0,3
29934,60,9432,13308,20440,0,0,1,0,1
29935,60,9433,13327;13698;17365,20440,1,0,2,0,3
29936,60,9434,13720,20440,0,0,1,0,1
29937,60,9435,13722;14184;17339,20440,1,0,2,0,3
29938,60,9436,13731;14068,20440,0,0,2,0,2
29939,60,9437,13473;13806;17196;17426,20440,2,0,2,0,4
29940,60,9438,13813;14168,20440,0,0,2,0,2
29941,60,9439,13787;13821,20440,0,0,2,0,2
29942,60,9440,13825;14167;17061;17210,20440,2,0,2,0,4
29943,60,9441,13833;14318,20440,0,0,2,0,2
29944,60,9442,13844;14071,20440,0,0,2,0,2
29945,60,9443,13865;14390,20440,0,0,2,0,2
29946,60,9444,13880;14235;17315,20440,1,0,2,0,3
29947,60,9445,13887;13934;17267,20440,1,0,2,0,3
29948,60,9446,13889;14124,20440,0,0,2,0,2
29949,60,9447,13900;14330;17328,20440,1,0,2,0,3
29950,60,9448,13902,20440,0,0,1,0,1
29951,60,9449,13904;13920,20440,0,0,2,0,2
29952,60,9450,13923;14329;17145;17393,20440,2,0,2,0,4
29953,60,9451,13931;14363,20440,0,0,2,0,2
29954,60,9452,13942;14343,20440,0,0,2,0,2
29955,60,9454,13967;14412;17469,20440,1,0,2,0,3
29956,60,9455,13970;14652;17037,20440,1,0,2,0,3
29957,60,9456,13975;14320;17320,20440,1,0,2,0,3
29958,60,9457,14006;14677;17084,20440,1,0,2,0,3
29959,60,9458,14018;14086,20440,0,0,2,0,2
29960,60,9459,14039;14503;17124,20440,1,0,2,0,3
29961,60,9460,14050;14182;17208,20440,1,0,2,0,3
29962,60,9461,14055;14592,20440,0,0,2,0,2
29963,60,9462,14059;14465;17008,20440,1,0,2,0,3
29964,60,9463,13777;14076,20440,0,0,2,0,2
29965,60,9464,14088,20440,0,0,1,0,1
29966,60,9465,14107;14537,20440,0,0,2,0,2
29967,60,9466,14113;14497;17272,20440,1,0,2,0,3
29968,60,9467,14134;14539;17063,20440,1,0,2,0,3
29969,60,9468,14145;14468;17108;17318,20440,2,0,2,0,4
29970,60,9469,13404,20440,0,0,1,0,1
29971,60,9470,14160;14161,20440,0,0,2,0,2
29972,60,9471,14177;14747,20440,0,0,2,0,2
29973,60,9472,13837;14192;17246,20440,1,0,2,0,3
29974,60,9473,14215;14458,20440,0,0,2,0,2
29975,60,9474,14216;14376;17302,20440,1,0,2,0,3
29976,60,9475,14224;14242,20440,0,0,2,0,2
29977,60,9476,13863;14243,20440,0,0,2,0,2
29978,60,9477,14256;14611,20440,0,0,2,0,2
29979,60,9478,13738;14269;17474,20440,1,0,2,0,3
29980,60,9479,13809;14292,20440,0,0,2,0,2
29981,60,9480,14317;14354,20440,0,0,2,0,2
29982,60,9481,14323;14435;17074;17269,20440,2,0,2,0,4
29983,60,9482,14340;14638,20440,0,0,2,0,2
29984,60,9484,6208;10102,20805,0,0,2,0,2
29985,60,9487,10543,20805,0,0,1,0,1
29986,60,9488,10571,20805,0,0,1,0,1
29987,60,9489,10649,20805,0,0,1,0,1
29988,60,9491,10772,20805,0,0,1,0,1
29989,60,9493,10681,20805,0,0,1,0,1
29990,60,9494,10261,20805,0,0,1,0,1
29991,60,9496,10932,20805,0,0,1,0,1
29992,60,9497,10618,20805,0,0,1,0,1
29993,60,9498,11235;11583,20805,0,0,2,0,2
29994,60,9500,11269,20805,0,0,1,0,1
29995,60,9501,11400,20805,0,0,1,0,1
29996,60,9503,11074,20805,0,0,1,0,1
29997,60,9504,11608,20805,0,0,1,0,1
29998,60,9505,11672,20805,0,0,1,0,1
29999,60,9508,11907,20805,0,0,1,0,1
30000,60,9509,11950;12172;17185;17300,20805,2,0,2,0,4
30001,60,9513,12320;17265;17438,20805,2,0,1,0,3
30002,60,9514,12174,20805,0,0,1,0,1
30003,60,9515,12058;12112,20805,0,0,2,0,2
30004,60,9516,12499,20805,0,0,1,0,1
30005,60,9517,12600,20805,0,0,1,0,1
30006,60,9518,12591;12657;17136,20805,1,0,2,0,3
30007,60,9520,12759;13378;17134,20805,1,0,2,0,3
30008,60,9521,12807,20805,0,0,1,0,1
30009,60,9522,12849,20805,0,0,1,0,1
30010,60,9523,12874;13125;17400,20805,1,0,2,0,3
30011,60,9525,12636,20805,0,0,1,0,1
30012,60,9527,13082;17189;17475,20805,2,0,1,0,3
30013,60,9528,13347,20805,0,0,1,0,1
30014,60,9529,13157,20805,0,0,1,0,1
30015,60,9530,13180;13819,20805,0,0,2,0,2
30016,60,9531,13140;13211,20805,0,0,2,0,2
30017,60,9532,13188;13237,20805,0,0,2,0,2
30018,60,9533,13302;14334,20805,0,0,2,0,2
30019,60,9534,13030;13305;17455,20805,1,0,2,0,3
30020,60,9535,13356;13510;17171;17345,20805,2,0,2,0,4
30021,60,9536,12872,20805,0,0,1,0,1
30022,60,9537,13405;14205,20805,0,0,2,0,2
30023,60,9538,13368;13410;17273,20805,1,0,2,0,3
30024,60,9539,13451;13962,20805,0,0,2,0,2
30025,60,9540,13579;14308,20805,0,0,2,0,2
30026,60,9541,13492;13739,20805,0,0,2,0,2
30027,60,9542,13546;14126;17387,20805,1,0,2,0,3
30028,60,9543,13571;13581,20805,0,0,2,0,2
30029,60,9544,13597;14252,20805,0,0,2,0,2
30030,60,9545,13095;13173,20805,0,0,2,0,2
30031,60,9546,13662;13807,20805,0,0,2,0,2
30032,60,9547,13406;13684,20805,0,0,2,0,2
30033,60,9548,13776;14038,20805,0,0,2,0,2
30034,60,9549,13815;14446;17288,20805,1,0,2,0,3
30035,60,9550,13680;13836,20805,0,0,2,0,2
30036,60,9551,13841,20805,0,0,1,0,1
30037,60,9552,13852;14139,20805,0,0,2,0,2
30038,60,9553,13855,20805,0,0,1,0,1
30039,60,9554,13879;14276,20805,0,0,2,0,2
30040,60,9555,13862;13882,20805,0,0,2,0,2
30041,60,9556,14000;17156,20805,1,0,1,0,2
30042,60,9557,14449,20805,0,0,1,0,1
30043,60,9558,14043;14072;17321,20805,1,0,2,0,3
30044,60,9559,13952;14048;17159,20805,1,0,2,0,3
30045,60,9560,14051;14108,20805,0,0,2,0,2
30046,60,9561,14066;14595,20805,0,0,2,0,2
30047,60,9562,14005;14118,20805,0,0,2,0,2
30048,60,9563,13696;14132,20805,0,0,2,0,2
30049,60,9564,13317;14146,20805,0,0,2,0,2
30050,60,9565,14150;14845,20805,0,0,2,0,2
30051,60,9566,13953;14151;17309,20805,1,0,2,0,3
30052,60,9567,14093;14193;17160,20805,1,0,2,0,3
30053,60,9568,13565;14194,20805,0,0,2,0,2
30054,60,9569,14197,20805,0,0,1,0,1
30055,60,9570,14202;14214,20805,0,0,2,0,2
30056,60,9571,13916;14230,20805,0,0,2,0,2
30057,60,9572,14232;14661,20805,0,0,2,0,2
30058,60,9573,14245;14500;17304,20805,1,0,2,0,3
30059,60,9574,14247;14532;17142,20805,1,0,2,0,3
30060,60,9575,14123;14253,20805,0,0,2,0,2
30061,60,9576,14289,20805,0,0,1,0,1
30062,60,9577,14637,20805,0,0,1,0,1
30063,60,9578,14395;14822;17359,20805,1,0,2,0,3
30064,60,9579,14061;14418;17258,20805,1,0,2,0,3
30065,60,9580,14456;14678,20805,0,0,2,0,2
30066,60,9581,14457;14705;17149,20805,1,0,2,0,3
30067,60,9582,14212;14459,20805,0,0,2,0,2
30068,60,9583,14483;14563;17144,20805,1,0,2,0,3
30069,60,9584,14487;14800;17128,20805,1,0,2,0,3
30070,60,9585,10074,21170,0,0,1,0,1
30071,60,9587,10150,21170,0,0,1,0,1
30072,60,9588,8721,21170,0,0,1,0,1
30073,60,9589,10326,21170,0,0,1,0,1
30074,60,9590,8877,21170,0,0,1,0,1
30075,60,9591,10483,21170,0,0,1,0,1
30076,60,9592,10589,21170,0,0,1,0,1
30077,60,9593,10747,21170,0,0,1,0,1
30078,60,9594,10845,21170,0,0,1,0,1
30079,60,9596,11257,21170,0,0,1,0,1
30080,60,9598,11287,21170,0,0,1,0,1
30081,60,9599,11453,21170,0,0,1,0,1
30082,60,9602,11772,21170,0,0,1,0,1
30083,60,9603,11791,21170,0,0,1,0,1
30084,60,9604,11934,21170,0,0,1,0,1
30085,60,9605,11972;17451,21170,1,0,1,0,2
30086,60,9606,11812,21170,0,0,1,0,1
30087,60,9607,11623,21170,0,0,1,0,1
30088,60,9608,12170;12912,21170,0,0,2,0,2
30089,60,9609,12180,21170,0,0,1,0,1
30090,60,9611,12301,21170,0,0,1,0,1
30091,60,9612,12352,21170,0,0,1,0,1
30092,60,9613,12262;12361;17289;17395,21170,2,0,2,0,4
30093,60,9614,12388,21170,0,0,1,0,1
30094,60,9615,12984;13526,21170,0,0,2,0,2
30095,60,9616,12448,21170,0,0,1,0,1
30096,60,9617,12498;13251,21170,0,0,2,0,2
30097,60,9619,12812,21170,0,0,1,0,1
30098,60,9620,12271,21170,0,0,1,0,1
30099,60,9621,12649;12923,21170,0,0,2,0,2
30100,60,9623,12752,21170,0,0,1,0,1
30101,60,9624,12870,21170,0,0,1,0,1
30102,60,9626,12880,21170,0,0,1,0,1
30103,60,9627,12913;12940;17278,21170,1,0,2,0,3
30104,60,9628,12946;13603,21170,0,0,2,0,2
30105,60,9629,12982;13333;17436,21170,1,0,2,0,3
30106,60,9631,13287,21170,0,0,1,0,1
30107,60,9632,12918,21170,0,0,1,0,1
30108,60,9633,13199;13490,21170,0,0,2,0,2
30109,60,9634,12781,21170,0,0,1,0,1
30110,60,9635,12889,21170,0,0,1,0,1
30111,60,9636,13374,21170,0,0,1,0,1
30112,60,9637,13286,21170,0,0,1,0,1
30113,60,9638,13284;13427,21170,0,0,2,0,2
30114,60,9639,13462,21170,0,0,1,0,1
30115,60,9641,13502;14375,21170,0,0,2,0,2
30116,60,9642,13513;13929;17327,21170,1,0,2,0,3
30117,60,9644,13544;14262,21170,0,0,2,0,2
30118,60,9645,13589,21170,0,0,1,0,1
30119,60,9646,13590;14223,21170,0,0,2,0,2
30120,60,9647,13595;13828,21170,0,0,2,0,2
30121,60,9648,13344;13619,21170,0,0,2,0,2
30122,60,9649,13631;13866,21170,0,0,2,0,2
30123,60,9650,13422;13661,21170,0,0,2,0,2
30124,60,9651,14382;17250,21170,1,0,1,0,2
30125,60,9652,13751;13896,21170,0,0,2,0,2
30126,60,9653,13831;14259;17366,21170,1,0,2,0,3
30127,60,9654,13478,21170,0,0,1,0,1
30128,60,9655,13983;14368,21170,0,0,2,0,2
30129,60,9656,13543;13989,21170,0,0,2,0,2
30130,60,9657,13538;14026,21170,0,0,2,0,2
30131,60,9658,14045;14448,21170,0,0,2,0,2
30132,60,9659,13959;14056,21170,0,0,2,0,2
30133,60,9660,14067;14361,21170,0,0,2,0,2
30134,60,9661,14522;14828,21170,0,0,2,0,2
30135,60,9662,13853;14092;17248,21170,1,0,2,0,3
30136,60,9663,14135;14346;17311,21170,1,0,2,0,3
30137,60,9664,13864;14164,21170,0,0,2,0,2
30138,60,9665,14166;14707;17341,21170,1,0,2,0,3
30139,60,9666,13928;14203;17338,21170,1,0,2,0,3
30140,60,9667,14229;14477,21170,0,0,2,0,2
30141,60,9668,14238;14585;17313,21170,1,0,2,0,3
30142,60,9669,14301;14572,21170,0,0,2,0,2
30143,60,9670,14322;14733,21170,0,0,2,0,2
30144,60,9671,14101;14353,21170,0,0,2,0,2
30145,60,9672,14357;14804,21170,0,0,2,0,2
30146,60,9673,13746;13861,21170,0,0,2,0,2
30147,60,9674,14380;14943;17453,21170,1,0,2,0,3
30148,60,9675,14399;14606,21170,0,0,2,0,2
30149,60,9676,14414;14415,21170,0,0,2,0,2
30150,60,9677,14429;14719,21170,0,0,2,0,2
30151,60,9678,14434,21170,0,0,1,0,1
30152,60,9679,14438;14479,21170,0,0,2,0,2
30153,60,9680,14440,21170,0,0,1,0,1
30154,60,9681,14471;14768,21170,0,0,2,0,2
30155,60,9682,14251;14485,21170,0,0,2,0,2
30156,60,9683,14263;14506;17316,21170,1,0,2,0,3
30157,60,9684,14525,21170,0,0,1,0,1
30158,60,9685,14534;14761;17260,21170,1,0,2,0,3
30159,60,9686,14397;14547,21170,0,0,2,0,2
30160,60,9687,14551;14823,21170,0,0,2,0,2
30161,60,9688,14227;14555,21170,0,0,2,0,2
30162,60,9689,14576;15013;17349,21170,1,0,2,0,3
30163,60,9690,14588,21170,0,0,1,0,1
30164,60,9691,14478;14608,21170,0,0,2,0,2
30165,60,9692,14616;14930;17375,21170,1,0,2,0,3
30166,60,9693,10050,21535,0,0,1,0,1
30167,60,9694,10079,21535,0,0,1,0,1
30168,60,9696,10357,21535,0,0,1,0,1
30169,60,9697,10536,21535,0,0,1,0,1
30170,60,9699,11026,21535,0,0,1,0,1
30171,60,9700,11231,21535,0,0,1,0,1
30172,60,9701,11244,21535,0,0,1,0,1
30173,60,9702,11177,21535,0,0,1,0,1
30174,60,9703,11008,21535,0,0,1,0,1
30175,60,9704,11325,21535,0,0,1,0,1
30176,60,9706,11493,21535,0,0,1,0,1
30177,60,9708,11706,21535,0,0,1,0,1
30178,60,9709,11939,21535,0,0,1,0,1
30179,60,9710,11797,21535,0,0,1,0,1
30180,60,9711,12191,21535,0,0,1,0,1
30181,60,9712,12200;12215;17401,21535,1,0,2,0,3
30182,60,9713,12396,21535,0,0,1,0,1
30183,60,9714,12328,21535,0,0,1,0,1
30184,60,9715,12094;12410,21535,0,0,2,0,2
30185,60,9716,12109,21535,0,0,1,0,1
30186,60,9717,12535,21535,0,0,1,0,1
30187,60,9718,12390,21535,0,0,1,0,1
30188,60,9719,12581,21535,0,0,1,0,1
30189,60,9720,12692;13243;17408,21535,1,0,2,0,3
30190,60,9721,12607,21535,0,0,1,0,1
30191,60,9722,12787,21535,0,0,1,0,1
30192,60,9723,12865,21535,0,0,1,0,1
30193,60,9724,12860,21535,0,0,1,0,1
30194,60,9725,12964,21535,0,0,1,0,1
30195,60,9726,12568;12988,21535,0,0,2,0,2
30196,60,9727,13060;13512,21535,0,0,2,0,2
30197,60,9728,13079,21535,0,0,1,0,1
30198,60,9729,13093,21535,0,0,1,0,1
30199,60,9730,12915,21535,0,0,1,0,1
30200,60,9731,13153;13245,21535,0,0,2,0,2
30201,60,9732,12941,21535,0,0,1,0,1
30202,60,9733,13274;13725,21535,0,0,2,0,2
30203,60,9734,13279;13758,21535,0,0,2,0,2
30204,60,9735,12713,21535,0,0,1,0,1
30205,60,9736,13089,21535,0,0,1,0,1
30206,60,9737,12867,21535,0,0,1,0,1
30207,60,9738,13358;13960,21535,0,0,2,0,2
30208,60,9739,13381,21535,0,0,1,0,1
30209,60,9740,13424,21535,0,0,1,0,1
30210,60,9741,12999,21535,0,0,1,0,1
30211,60,9742,13466;14077,21535,0,0,2,0,2
30212,60,9743,13370;14033,21535,0,0,2,0,2
30213,60,9744,13600;14278;17423,21535,1,0,2,0,3
30214,60,9745,13683;14065,21535,0,0,2,0,2
30215,60,9746,13726;14698,21535,0,0,2,0,2
30216,60,9747,13700;13795,21535,0,0,2,0,2
30217,60,9748,13235,21535,0,0,1,0,1
30218,60,9749,13614;13843,21535,0,0,2,0,2
30219,60,9750,13897;14425;17405,21535,1,0,2,0,3
30220,60,9751,13737,21535,0,0,1,0,1
30221,60,9752,13949;14517,21535,0,0,2,0,2
30222,60,9753,13494;13965,21535,0,0,2,0,2
30223,60,9754,13969;14627,21535,0,0,2,0,2
30224,60,9755,13978;14328,21535,0,0,2,0,2
30225,60,9756,13986;14441,21535,0,0,2,0,2
30226,60,9757,13966;14004,21535,0,0,2,0,2
30227,60,9758,14008;14117,21535,0,0,2,0,2
30228,60,9759,14021,21535,0,0,1,0,1
30229,60,9760,13734;14081,21535,0,0,2,0,2
30230,60,9761,14083;14965,21535,0,0,2,0,2
30231,60,9762,14104;14767,21535,0,0,2,0,2
30232,60,9763,13692;14142,21535,0,0,2,0,2
30233,60,9764,14165;14409,21535,0,0,2,0,2
30234,60,9765,14187;14548,21535,0,0,2,0,2
30235,60,9766,14207;14571,21535,0,0,2,0,2
30236,60,9767,14208;14336,21535,0,0,2,0,2
30237,60,9768,14211,21535,0,0,1,0,1
30238,60,9769,14015;14220,21535,0,0,2,0,2
30239,60,9770,14241;14549;17377,21535,1,0,2,0,3
30240,60,9771,14261;14578;17360,21535,1,0,2,0,3
30241,60,9772,14012;14279,21535,0,0,2,0,2
30242,60,9773,14307;14789,21535,0,0,2,0,2
30243,60,9774,14325;14849,21535,0,0,2,0,2
30244,60,9775,14327;14378,21535,0,0,2,0,2
30245,60,9776,14341;14763,21535,0,0,2,0,2
30246,60,9777,14352;14630,21535,0,0,2,0,2
30247,60,9778,14372;14857,21535,0,0,2,0,2
30248,60,9779,14385;14406,21535,0,0,2,0,2
30249,60,9780,14398;14521,21535,0,0,2,0,2
30250,60,9781,14288;14413,21535,0,0,2,0,2
30251,60,9782,14316;14417;17372,21535,1,0,2,0,3
30252,60,9783,14275;14453,21535,0,0,2,0,2
30253,60,9784,14103;14470,21535,0,0,2,0,2
30254,60,9785,15139,21535,0,0,1,0,1
30255,60,9786,14493;15058,21535,0,0,2,0,2
30256,60,9787,14496;14645;17398,21535,1,0,2,0,3
30257,60,9788,14516;14618,21535,0,0,2,0,2
30258,60,9789,14523,21535,0,0,1,0,1
30259,60,9790,14544;14646,21535,0,0,2,0,2
30260,60,9791,14331;14573,21535,0,0,2,0,2
30261,60,9792,14064;14581,21535,0,0,2,0,2
30262,60,9793,14091;14615,21535,0,0,2,0,2
30263,60,9794,14633;14779,21535,0,0,2,0,2
30264,60,9795,14651;15099,21535,0,0,2,0,2
30265,60,9796,14454;14655,21535,0,0,2,0,2
30266,60,9797,14326;14658,21535,0,0,2,0,2
30267,60,9798,14660;14723;17362,21535,1,0,2,0,3
30268,60,9799,14731;14786;17422,21535,1,0,2,0,3
30269,60,9800,14735;14816,21535,0,0,2,0,2
30270,60,9801,14743;14842,21535,0,0,2,0,2
30271,60,9802,10262,21900,0,0,1,0,1
30272,60,9803,10330,21900,0,0,1,0,1
30273,60,9804,10392,21900,0,0,1,0,1
30274,60,9805,10391,21900,0,0,1,0,1
30275,60,9806,10473,21900,0,0,1,0,1
30276,60,9807,10454,21900,0,0,1,0,1
30277,60,9808,10846,21900,0,0,1,0,1
30278,60,9809,10492,21900,0,0,1,0,1
30279,60,9810,10953,21900,0,0,1,0,1
30280,60,9812,10713,21900,0,0,1,0,1
30281,60,9813,10609,21900,0,0,1,0,1
30282,60,9814,11140,21900,0,0,1,0,1
30283,60,9815,11148,21900,0,0,1,0,1
30284,60,9816,11234,21900,0,0,1,0,1
30285,60,9817,11276,21900,0,0,1,0,1
30286,60,9818,11375,21900,0,0,1,0,1
30287,60,9819,11459,21900,0,0,1,0,1
30288,60,9820,11547,21900,0,0,1,0,1
30289,60,9821,11826,21900,0,0,1,0,1
30290,60,9822,11633,21900,0,0,1,0,1
30291,60,9823,12243,21900,0,0,1,0,1
30292,60,9824,12159,21900,0,0,1,0,1
30293,60,9825,12354,21900,0,0,1,0,1
30294,60,9826,12379;12708,21900,0,0,2,0,2
30295,60,9827,12402;13132,21900,0,0,2,0,2
30296,60,9828,12417,21900,0,0,1,0,1
30297,60,9829,12310,21900,0,0,1,0,1
30298,60,9830,12587,21900,0,0,1,0,1
30299,60,9831,12580,21900,0,0,1,0,1
30300,60,9832,12762;13000,21900,0,0,2,0,2
30301,60,9833,12337,21900,0,0,1,0,1
30302,60,9834,12292,21900,0,0,1,0,1
30303,60,9835,12856,21900,0,0,1,0,1
30304,60,9836,12831,21900,0,0,1,0,1
30305,60,9837,13113;13711,21900,0,0,2,0,2
30306,60,9838,13122,21900,0,0,1,0,1
30307,60,9839,13222;13652,21900,0,0,2,0,2
30308,60,9840,13207;13224,21900,0,0,2,0,2
30309,60,9841,13228,21900,0,0,1,0,1
30310,60,9842,12651;13261,21900,0,0,2,0,2
30311,60,9843,13164,21900,0,0,1,0,1
30312,60,9844,13434;13781,21900,0,0,2,0,2
30313,60,9845,13321;13476,21900,0,0,2,0,2
30314,60,9846,13479,21900,0,0,1,0,1
30315,60,9847,13156;13625,21900,0,0,2,0,2
30316,60,9848,13674,21900,0,0,1,0,1
30317,60,9849,13682;14432,21900,0,0,2,0,2
30318,60,9850,13653;13718,21900,0,0,2,0,2
30319,60,9851,13786;14274,21900,0,0,2,0,2
30320,60,9852,13745;14305,21900,0,0,2,0,2
30321,60,9853,13685;13827,21900,0,0,2,0,2
30322,60,9854,13905,21900,0,0,1,0,1
30323,60,9855,14131,21900,0,0,1,0,1
30324,60,9856,13997;14190,21900,0,0,2,0,2
30325,60,9857,14001;14200,21900,0,0,2,0,2
30326,60,9858,13874;14022,21900,0,0,2,0,2
30327,60,9859,14036;14222,21900,0,0,2,0,2
30328,60,9860,13982;14062,21900,0,0,2,0,2
30329,60,9861,14084,21900,0,0,1,0,1
30330,60,9862,14087;14762,21900,0,0,2,0,2
30331,60,9863,14094;14758,21900,0,0,2,0,2
30332,60,9864,13939;14095,21900,0,0,2,0,2
30333,60,9865,14007;14195,21900,0,0,2,0,2
30334,60,9866,14231,21900,0,0,1,0,1
30335,60,9867,14284;15025,21900,0,0,2,0,2
30336,60,9868,14297;14394,21900,0,0,2,0,2
30337,60,9869,14302;14893,21900,0,0,2,0,2
30338,60,9870,14310;14832,21900,0,0,2,0,2
30339,60,9871,14332;15003,21900,0,0,2,0,2
30340,60,9872,14290;14345,21900,0,0,2,0,2
30341,60,9873,14333;14355,21900,0,0,2,0,2
30342,60,9874,14079;14364,21900,0,0,2,0,2
30343,60,9875,13721,21900,0,0,1,0,1
30344,60,9876,14392;14600,21900,0,0,2,0,2
30345,60,9877,14402,21900,0,0,1,0,1
30346,60,9878,14416;14753,21900,0,0,2,0,2
30347,60,9879,13846;14430,21900,0,0,2,0,2
30348,60,9880,14466,21900,0,0,1,0,1
30349,60,9881,14476;14813,21900,0,0,2,0,2
30350,60,9882,14489,21900,0,0,1,0,1
30351,60,9883,14492;14835,21900,0,0,2,0,2
30352,60,9884,14528;14819,21900,0,0,2,0,2
30353,60,9885,14531;15331,21900,0,1,1,0,2
30354,60,9886,14536,21900,0,0,1,0,1
30355,60,9887,14560;14689,21900,0,0,2,0,2
30356,60,9888,14567;14755,21900,0,0,2,0,2
30357,60,9889,14586;15109,21900,0,0,2,0,2
30358,60,9890,14599;14622,21900,0,0,2,0,2
30359,60,9891,14624,21900,0,0,1,0,1
30360,60,9892,14628;14656,21900,0,0,2,0,2
30361,60,9893,14445;14635,21900,0,0,2,0,2
30362,60,9894,14657;14668,21900,0,0,2,0,2
30363,60,9895,14669;15005,21900,0,0,2,0,2
30364,60,9896,14682;15229,21900,0,1,1,0,2
30365,60,9897,14683;14702,21900,0,0,2,0,2
30366,60,9898,14715;15280,21900,0,1,1,0,2
30367,60,9899,14740;15056,21900,0,0,2,0,2
30368,60,9900,14717;14749,21900,0,0,2,0,2
30369,60,9901,14769;15265,21900,0,1,1,0,2
30370,60,9902,14778;15283,21900,0,1,1,0,2
30371,60,9903,14787;15305,21900,0,1,1,0,2
30372,60,9904,14649;14805,21900,0,0,2,0,2
30373,70,1,4,0,0,0,0,1,1
30374,70,2,1571,0,0,0,0,1,1
30375,70,4,4337;7947,0,0,0,0,2,2
30376,70,19,61;6642,0,0,0,0,2,2
30377,70,33,99,0,0,0,0,1,1
30378,70,54,10092,0,0,0,0,1,1
30379,70,56,164,0,0,0,0,1,1
30380,70,61,180;8253,0,0,0,0,2,2
30381,70,63,189,0,0,0,0,1,1
30382,70,127,2748,0,0,0,0,1,1
30383,70,140,11066;11181,0,0,0,2,0,2
30384,70,144,8055,0,0,0,0,1,1
30385,70,173,2878;3238,0,0,0,0,2,2
30386,70,178,1287;2555,0,0,0,0,2,2
30387,70,179,492,0,0,0,0,1,1
30388,70,183,500,0,0,0,0,1,1
30389,70,185,9616,0,0,0,0,1,1
30390,70,207,568;6413;9356,0,0,0,0,3,3
30391,70,231,622,0,0,0,0,1,1
30392,70,280,740;10169,0,0,0,0,2,2
30393,70,291,4861,0,0,0,0,1,1
30394,70,304,794;795;3699;8124,0,0,0,0,4,4
30395,70,324,847;2441,0,0,0,0,2,2
30396,70,354,8984,0,0,0,0,1,1
30397,70,361,948;4291,0,0,0,0,2,2
30398,70,376,1000,0,0,0,0,1,1
30399,70,393,10260,0,0,0,0,1,1
30400,70,411,9414,0,0,0,0,1,1
30401,70,420,1106;1107,0,0,0,0,2,2
30402,70,437,902;5742,0,0,0,0,2,2
30403,70,478,1260,0,0,0,0,1,1
30404,70,513,1359;8111,0,0,0,0,2,2
30405,70,519,8864,0,0,0,0,1,1
30406,70,542,6846,0,0,0,0,1,1
30407,70,552,1452,0,0,0,0,1,1
30408,70,582,1529,0,0,0,0,1,1
30409,70,584,1538;2068,0,0,0,0,2,2
30410,70,590,9321,0,0,0,0,1,1
30411,70,592,1558,0,0,0,0,1,1
30412,70,593,1560;7464,0,0,0,0,2,2
30413,70,608,1598,0,0,0,0,1,1
30414,70,610,3507,0,0,0,0,1,1
30415,70,614,1618;1619;9513;10411,0,0,0,0,4,4
30416,70,615,4140,0,0,0,0,1,1
30417,70,624,1643,0,0,0,0,1,1
30418,70,633,1671;1808,0,0,0,0,2,2
30419,70,634,5117,0,0,0,0,1,1
30420,70,643,1702;2093,0,0,0,0,2,2
30421,70,648,1715,0,0,0,0,1,1
30422,70,661,648;1756,0,0,0,0,2,2
30423,70,682,1810,0,0,0,0,1,1
30424,70,716,1881;4064,0,0,0,0,2,2
30425,70,720,8224,0,0,0,0,1,1
30426,70,728,1914,0,0,0,0,1,1
30427,70,738,4283,0,0,0,0,1,1
30428,70,749,1963;7142,0,0,0,0,2,2
30429,70,759,1993,0,0,0,0,1,1
30430,70,768,2006,0,0,0,0,1,1
30431,70,782,9477,0,0,0,0,1,1
30432,70,797,10103;10121;10271;10331;13606;14239;14495,0,0,0,3,4,7
30433,70,818,2142,0,0,0,0,1,1
30434,70,822,9867,0,0,0,0,1,1
30435,70,878,7272,0,0,0,0,1,1
30436,70,886,1583;2320,0,0,0,0,2,2
30437,70,904,2374,0,0,0,0,1,1
30438,70,932,2449,0,0,0,0,1,1
30439,70,941,2476,0,0,0,0,1,1
30440,70,977,2574,0,0,0,0,1,1
30441,70,994,2613,0,0,0,0,1,1
30442,70,1029,2699;2701;5135;9102,0,0,0,0,4,4
30443,70,1059,2773,0,0,0,0,1,1
30444,70,1070,2810;2811;2812;3041,0,0,0,0,4,4
30445,70,1074,5628,0,0,0,0,1,1
30446,70,1077,1700;3346,0,0,0,0,2,2
30447,70,1166,8867,0,0,0,0,1,1
30448,70,1168,3076,0,0,0,0,1,1
30449,70,1170,3080,0,0,0,0,1,1
30450,70,1210,3187,0,0,0,0,1,1
30451,70,1220,3220,0,0,0,0,1,1
30452,70,1251,3298,0,0,0,0,1,1
30453,70,1274,3349,0,0,0,0,1,1
30454,70,1292,3411,0,0,0,0,1,1
30455,70,1297,3423,0,0,0,0,1,1
30456,70,1306,3448,0,0,0,0,1,1
30457,70,1315,3474,0,0,0,0,1,1
30458,70,1359,3592,0,0,0,0,1,1
30459,70,1391,3668,0,0,0,0,1,1
30460,70,1403,7711,0,0,0,0,1,1
30461,70,1414,3735,0,0,0,0,1,1
30462,70,1427,3767;3768,0,0,0,0,2,2
30463,70,1457,3845,0,0,0,0,1,1
30464,70,1501,3966,0,0,0,0,1,1
30465,70,1551,4091;4093,0,0,0,0,2,2
30466,70,1577,2396,0,0,0,0,1,1
30467,70,1598,7907,0,0,0,0,1,1
30468,70,1601,4205;7021,0,0,0,0,2,2
30469,70,1687,2913,0,0,0,0,1,1
30470,70,1715,1577,0,0,0,0,1,1
30471,70,1718,9047,0,0,0,0,1,1
30472,70,1737,4541,0,0,0,0,1,1
30473,70,1769,2032;4633;4634,0,0,0,0,3,3
30474,70,1822,10147;10212,0,0,0,0,2,2
30475,70,1831,7734,0,0,0,0,1,1
30476,70,1846,2005,0,0,0,0,1,1
30477,70,1859,4853,0,0,0,0,1,1
30478,70,1866,8171,0,0,0,0,1,1
30479,70,1869,3963,0,0,0,0,1,1
30480,70,1922,5034,0,0,0,0,1,1
30481,70,1948,5102;5314,0,0,0,0,2,2
30482,70,1986,4983,0,0,0,0,1,1
30483,70,2028,2323;9749,0,0,0,0,2,2
30484,70,2041,5332,0,0,0,0,1,1
30485,70,2042,730,0,0,0,0,1,1
30486,70,2067,5393,0,0,0,0,1,1
30487,70,2080,5427,0,0,0,0,1,1
30488,70,2083,5437,0,0,0,0,1,1
30489,70,2093,5463,0,0,0,0,1,1
30490,70,2106,5465,0,0,0,0,1,1
30491,70,2111,5666,0,0,0,0,1,1
30492,70,2197,1416;9526,0,0,0,0,2,2
30493,70,2212,5748,0,0,0,0,1,1
30494,70,2219,5766,0,0,0,0,1,1
30495,70,2264,5868,0,0,0,0,1,1
30496,70,2274,5887,0,0,0,0,1,1
30497,70,2286,3955,0,0,0,0,1,1
30498,70,2290,5925,0,0,0,0,1,1
30499,70,2314,5989,0,0,0,0,1,1
30500,70,2343,1360,0,0,0,0,1,1
30501,70,2355,6085,0,0,0,0,1,1
30502,70,2429,6272,0,0,0,0,1,1
30503,70,2453,6342,0,0,0,0,1,1
30504,70,2463,6366,0,0,0,0,1,1
30505,70,2470,6382,0,0,0,0,1,1
30506,70,2501,9927,0,0,0,0,1,1
30507,70,2540,213;8627,0,0,0,0,2,2
30508,70,2549,7930,0,0,0,0,1,1
30509,70,2572,1986;7682,0,0,0,0,2,2
30510,70,2574,5900,0,0,0,0,1,1
30511,70,2604,949,0,0,0,0,1,1
30512,70,2619,1139,0,0,0,0,1,1
30513,70,2638,11089;11184,0,0,0,2,0,2
30514,70,2643,6829,0,0,0,0,1,1
30515,70,2653,6867,0,0,0,0,1,1
30516,70,2658,2545;5479;6878,0,0,0,0,3,3
30517,70,2719,7034;8443,0,0,0,0,2,2
30518,70,2725,9808,0,0,0,0,1,1
30519,70,2759,10244;10711,0,0,0,1,1,2
30520,70,2761,7139,0,0,0,0,1,1
30521,70,2797,7228,0,0,0,0,1,1
30522,70,2820,7277,0,0,0,0,1,1
30523,70,2832,7307,0,0,0,0,1,1
30524,70,2851,7355,0,0,0,0,1,1
30525,70,2867,7395,0,0,0,0,1,1
30526,70,2869,4577;7399,0,0,0,0,2,2
30527,70,2882,7439;7440,0,0,0,0,2,2
30528,70,2896,7472,0,0,0,0,1,1
30529,70,2908,6837;7504,0,0,0,0,2,2
30530,70,3009,7665,0,0,0,0,1,1
30531,70,3013,7772,0,0,0,0,1,1
30532,70,3022,175;219,0,0,0,0,2,2
30533,70,3056,3028,0,0,0,0,1,1
30534,70,3070,2747,0,0,0,0,1,1
30535,70,3072,3335;3382,0,0,0,0,2,2
30536,70,3109,7321,0,0,0,0,1,1
30537,70,3112,3792;4434,0,0,0,0,2,2
30538,70,3120,8051,0,0,0,0,1,1
30539,70,3147,8108,0,0,0,0,1,1
30540,70,3164,8158,0,0,0,0,1,1
30541,70,3191,1943,0,0,0,0,1,1
30542,70,3199,8239,0,0,0,0,1,1
30543,70,3201,8241,0,0,0,0,1,1
30544,70,3227,8305,0,0,0,0,1,1
30545,70,3236,8334,0,0,0,0,1,1
30546,70,3290,5814;8474,0,0,0,0,2,2
30547,70,3316,8159,0,0,0,0,1,1
30548,70,3383,10243;10483,0,0,0,0,2,2
30549,70,3398,2163,0,0,0,0,1,1
30550,70,3406,7657,0,0,0,0,1,1
30551,70,3407,8784,0,0,0,0,1,1
30552,70,3411,4273,0,0,0,0,1,1
30553,70,3416,8804,0,0,0,0,1,1
30554,70,3422,9393,0,0,0,0,1,1
30555,70,3435,10321,0,0,0,0,1,1
30556,70,3449,8895,0,0,0,0,1,1
30557,70,3479,8978,0,0,0,0,1,1
30558,70,3516,8076,0,0,0,0,1,1
30559,70,3517,324;9070,0,0,0,0,2,2
30560,70,3519,2383,0,0,0,0,1,1
30561,70,3550,9167,0,0,0,0,1,1
30562,70,3580,10284;10502,0,0,0,0,2,2
30563,70,3594,1351;2231,0,0,0,0,2,2
30564,70,3603,9295,0,0,0,0,1,1
30565,70,3605,9301,0,0,0,0,1,1
30566,70,3613,9319,0,0,0,0,1,1
30567,70,3651,10538;10992,0,0,0,1,1,2
30568,70,3688,9521,0,0,0,0,1,1
30569,70,3699,9549,0,0,0,0,1,1
30570,70,3701,6021,0,0,0,0,1,1
30571,70,3725,625;9619,0,0,0,0,2,2
30572,70,3761,9713,0,0,0,0,1,1
30573,70,3771,1663;9742,0,0,0,0,2,2
30574,70,3784,9778,0,0,0,0,1,1
30575,70,3817,9870,0,0,0,0,1,1
30576,70,3823,3901,0,0,0,0,1,1
30577,70,3825,9897,0,0,0,0,1,1
30578,70,3827,9900,0,0,0,0,1,1
30579,70,3861,8834,0,0,0,0,1,1
30580,70,3864,10390,0,0,0,0,1,1
30581,70,3872,4306,0,0,0,0,1,1
30582,70,3892,1924,0,0,0,0,1,1
30583,70,3912,22,0,0,0,0,1,1
30584,70,3918,5972,0,0,0,0,1,1
30585,70,3928,6143,0,0,0,0,1,1
30586,70,3929,6147,0,0,0,0,1,1
30587,70,3930,3750,0,0,0,0,1,1
30588,70,3960,1065,365,0,0,0,1,1
30589,70,3971,1054,365,0,0,0,1,1
30590,70,3976,738,365,0,0,0,1,1
30591,70,3980,1745,365,0,0,0,1,1
30592,70,3982,9021,365,0,0,0,1,1
30593,70,3991,1023,365,0,0,0,1,1
30594,70,4002,1318;3468,365,0,0,0,2,2
30595,70,4005,5085,365,0,0,0,1,1
30596,70,4009,8455,365,0,0,0,1,1
30597,70,4014,9642,365,0,0,0,1,1
30598,70,4015,5757,365,0,0,0,1,1
30599,70,4020,6281,365,0,0,0,1,1
30600,70,4029,6863,365,0,0,0,1,1
30601,70,4040,2930;8249,365,0,0,0,2,2
30602,70,4041,7871,365,0,0,0,1,1
30603,70,4060,6330,365,0,0,0,1,1
30604,70,4062,590,365,0,0,0,1,1
30605,70,4063,7849,365,0,0,0,1,1
30606,70,4067,45,730,0,0,0,1,1
30607,70,4076,5525,730,0,0,0,1,1
30608,70,4077,578;705,730,0,0,0,2,2
30609,70,4078,792,730,0,0,0,1,1
30610,70,4085,1246,730,0,0,0,1,1
30611,70,4095,8801,730,0,0,0,1,1
30612,70,4102,9500,730,0,0,0,1,1
30613,70,4109,4399,730,0,0,0,1,1
30614,70,4121,4384,730,0,0,0,1,1
30615,70,4149,9428,730,0,0,0,1,1
30616,70,4153,7077,730,0,0,0,1,1
30617,70,4154,3069,730,0,0,0,1,1
30618,70,4155,1741,730,0,0,0,1,1
30619,70,4168,4600;8252,730,0,0,0,2,2
30620,70,4173,5451;8595,730,0,0,0,2,2
30621,70,4188,9944,730,0,0,0,1,1
30622,70,4190,6735,1095,0,0,0,1,1
30623,70,4195,296,1095,0,0,0,1,1
30624,70,4197,9145,1095,0,0,0,1,1
30625,70,4200,517;1250,1095,0,0,0,2,2
30626,70,4204,5699;8276,1095,0,0,0,2,2
30627,70,4207,1099;4046,1095,0,0,0,2,2
30628,70,4223,2417;2655,1095,0,0,0,2,2
30629,70,4228,3165,1095,0,0,0,1,1
30630,70,4236,4559,1095,0,0,0,1,1
30631,70,4240,7569,1095,0,0,0,1,1
30632,70,4243,4274,1095,0,0,0,1,1
30633,70,4244,4336,1095,0,0,0,1,1
30634,70,4248,4874,1095,0,0,0,1,1
30635,70,4254,3062,1095,0,0,0,1,1
30636,70,4255,5420,1095,0,0,0,1,1
30637,70,4257,467;5017,1095,0,0,0,2,2
30638,70,4263,2179,1095,0,0,0,1,1
30639,70,4266,5573,1095,0,0,0,1,1
30640,70,4289,11984;12134;15956;16309,1095,0,0,4,0,4
30641,70,4290,6390,1095,0,0,0,1,1
30642,70,4292,7882,1095,0,0,0,1,1
30643,70,4296,8277,1095,0,0,0,1,1
30644,70,4297,8284,1095,0,0,0,1,1
30645,70,4301,8596,1095,0,0,0,1,1
30646,70,4303,1372,1095,0,0,0,1,1
30647,70,4304,12011;12232;17195;17534,1095,0,2,2,0,4
30648,70,4305,36,1095,0,0,0,1,1
30649,70,4317,6595,1095,0,0,0,1,1
30650,70,4318,7601,1095,0,0,0,1,1
30651,70,4319,9910,1095,0,0,0,1,1
30652,70,4328,1925,1460,0,0,0,1,1
30653,70,4336,1212,1460,0,0,0,1,1
30654,70,4337,8306,1460,0,0,0,1,1
30655,70,4339,1251,1460,0,0,0,1,1
30656,70,4344,4770,1460,0,0,0,1,1
30657,70,4345,1732,1460,0,0,0,1,1
30658,70,4352,2355,1460,0,0,0,1,1
30659,70,4365,3639,1460,0,0,0,1,1
30660,70,4366,5906,1460,0,0,0,1,1
30661,70,4369,3944,1460,0,0,0,1,1
30662,70,4371,7;9645,1460,0,0,0,2,2
30663,70,4385,7019,1460,0,0,0,1,1
30664,70,4386,643,1460,0,0,0,1,1
30665,70,4391,5811;9257,1460,0,0,0,2,2
30666,70,4394,864,1460,0,0,0,1,1
30667,70,4395,2765,1460,0,0,0,1,1
30668,70,4397,6334,1460,0,0,0,1,1
30669,70,4399,8168,1460,0,0,0,1,1
30670,70,4401,6493,1460,0,0,0,1,1
30671,70,4406,9196,1460,0,0,0,1,1
30672,70,4415,8123,1460,0,0,0,1,1
30673,70,4420,7603,1460,0,0,0,1,1
30674,70,4421,4949,1460,0,0,0,1,1
30675,70,4422,3922;6191,1460,0,0,0,2,2
30676,70,4423,4170;7692,1460,0,0,0,2,2
30677,70,4427,2750,1460,0,0,0,1,1
30678,70,4436,583,1460,0,0,0,1,1
30679,70,4441,5261,1460,0,0,0,1,1
30680,70,4449,9947,1825,0,0,0,1,1
30681,70,4450,6489,1825,0,0,0,1,1
30682,70,4451,511,1825,0,0,0,1,1
30683,70,4458,8331,1825,0,0,0,1,1
30684,70,4459,356,1825,0,0,0,1,1
30685,70,4461,1769,1825,0,0,0,1,1
30686,70,4472,4015;12381,1825,0,0,1,1,2
30687,70,4487,6064,1825,0,0,0,1,1
30688,70,4489,8087,1825,0,0,0,1,1
30689,70,4494,5419,1825,0,0,0,1,1
30690,70,4500,3695;5617,1825,0,0,0,2,2
30691,70,4502,7801,1825,0,0,0,1,1
30692,70,4504,9357,1825,0,0,0,1,1
30693,70,4507,9015,1825,0,0,0,1,1
30694,70,4515,6239,1825,0,0,0,1,1
30695,70,4520,7235,1825,0,0,0,1,1
30696,70,4523,6354,1825,0,0,0,1,1
30697,70,4526,6689,1825,0,0,0,1,1
30698,70,4528,7989,1825,0,0,0,1,1
30699,70,4536,11715;12138;12177;12555;16167;16547;16799,1825,0,1,6,0,7
30700,70,4537,8543,1825,0,0,0,1,1
30701,70,4538,3397;8617,1825,0,0,0,2,2
30702,70,4539,1216,1825,0,0,0,1,1
30703,70,4541,3539;6953,1825,0,0,0,2,2
30704,70,4557,5159,2190,0,0,0,1,1
30705,70,4560,3449,2190,0,0,0,1,1
30706,70,4562,7300,2190,0,0,0,1,1
30707,70,4564,773,2190,0,0,0,1,1
30708,70,4567,6719,2190,0,0,0,1,1
30709,70,4569,561,2190,0,0,0,1,1
30710,70,4572,1962,2190,0,0,0,1,1
30711,70,4573,3758,2190,0,0,0,1,1
30712,70,4576,603,2190,0,0,0,1,1
30713,70,4577,642,2190,0,0,0,1,1
30714,70,4579,2742;5939,2190,0,0,0,2,2
30715,70,4581,2949,2190,0,0,0,1,1
30716,70,4587,8456,2190,0,0,0,1,1
30717,70,4592,3740,2190,0,0,0,1,1
30718,70,4596,3962,2190,0,0,0,1,1
30719,70,4604,3621,2190,0,0,0,1,1
30720,70,4605,4486,2190,0,0,0,1,1
30721,70,4606,4511;8561,2190,0,0,0,2,2
30722,70,4607,1032,2190,0,0,0,1,1
30723,70,4610,4888,2190,0,0,0,1,1
30724,70,4620,5849,2190,0,0,0,1,1
30725,70,4622,5905,2190,0,0,0,1,1
30726,70,4623,5799,2190,0,0,0,1,1
30727,70,4624,6170,2190,0,0,0,1,1
30728,70,4625,6311,2190,0,0,0,1,1
30729,70,4626,1165,2190,0,0,0,1,1
30730,70,4646,2010;8470,2190,0,0,0,2,2
30731,70,4647,7180,2190,0,0,0,1,1
30732,70,4648,9232,2190,0,0,0,1,1
30733,70,4658,2559,2190,0,0,0,1,1
30734,70,4659,9510,2190,0,0,0,1,1
30735,70,4662,9727,2190,0,0,0,1,1
30736,70,4666,179;3387,2555,0,0,0,2,2
30737,70,4668,1584,2555,0,0,0,1,1
30738,70,4669,1386,2555,0,0,0,1,1
30739,70,4671,6070,2555,0,0,0,1,1
30740,70,4677,1824,2555,0,0,0,1,1
30741,70,4686,5025;7222,2555,0,0,0,2,2
30742,70,4689,8853,2555,0,0,0,1,1
30743,70,4694,3407,2555,0,0,0,1,1
30744,70,4702,4035,2555,0,0,0,1,1
30745,70,4703,110;7808,2555,0,0,0,2,2
30746,70,4707,4149;4628,2555,0,0,0,2,2
30747,70,4708,4694,2555,0,0,0,1,1
30748,70,4709,5328;8674,2555,0,0,0,2,2
30749,70,4719,5133;11861,2555,0,0,1,1,2
30750,70,4725,5547,2555,0,0,0,1,1
30751,70,4729,8396,2555,0,0,0,1,1
30752,70,4730,2787,2555,0,0,0,1,1
30753,70,4733,6184,2555,0,0,0,1,1
30754,70,4734,9799,2555,0,0,0,1,1
30755,70,4735,8589,2555,0,0,0,1,1
30756,70,4740,9406,2555,0,0,0,1,1
30757,70,4742,958;2891,2555,0,0,0,2,2
30758,70,4745,8822,2555,0,0,0,1,1
30759,70,4747,7151,2555,0,0,0,1,1
30760,70,4749,7776,2555,0,0,0,1,1
30761,70,4750,2418;7867,2555,0,0,0,2,2
30762,70,4753,2232;8642,2555,0,0,0,2,2
30763,70,4756,7461;8144,2555,0,0,0,2,2
30764,70,4757,6464,2555,0,0,0,1,1
30765,70,4759,3022,2555,0,0,0,1,1
30766,70,4760,2058,2555,0,0,0,1,1
30767,70,4763,8712,2555,0,0,0,1,1
30768,70,4765,4073,2555,0,0,0,1,1
30769,70,4767,8893,2555,0,0,0,1,1
30770,70,4769,6526;8966,2555,0,0,0,2,2
30771,70,4770,9246;9392,2555,0,0,0,2,2
30772,70,4773,4543,2555,0,0,0,1,1
30773,70,4775,9687,2555,0,0,0,1,1
30774,70,4777,9837,2555,0,0,0,1,1
30775,70,4779,54,2920,0,0,0,1,1
30776,70,4781,147,2920,0,0,0,1,1
30777,70,4785,475;2092,2920,0,0,0,2,2
30778,70,4786,5063,2920,0,0,0,1,1
30779,70,4793,11555;11735;12083;16403;16567;16621,2920,0,1,5,0,6
30780,70,4794,2656,2920,0,0,0,1,1
30781,70,4803,1935,2920,0,0,0,1,1
30782,70,4804,2091,2920,0,0,0,1,1
30783,70,4805,2500,2920,0,0,0,1,1
30784,70,4807,1217;7525,2920,0,0,0,2,2
30785,70,4808,7553,2920,0,0,0,1,1
30786,70,4809,4953;8177,2920,0,0,0,2,2
30787,70,4811,1575,2920,0,0,0,1,1
30788,70,4816,2798;3116,2920,0,0,0,2,2
30789,70,4817,12168;12456;13314;14003;18033;18458,2920,1,1,4,0,6
30790,70,4819,3277,2920,0,0,0,1,1
30791,70,4820,2033;4950,2920,0,0,0,2,2
30792,70,4823,3523,2920,0,0,0,1,1
30793,70,4832,4102;8169,2920,0,0,0,2,2
30794,70,4836,4509;9739,2920,0,0,0,2,2
30795,70,4839,3675;6971,2920,0,0,0,2,2
30796,70,4843,7732;8629,2920,0,0,0,2,2
30797,70,4845,5181,2920,0,0,0,1,1
30798,70,4849,5366,2920,0,0,0,1,1
30799,70,4850,1788,2920,0,0,0,1,1
30800,70,4858,863,2920,0,0,0,1,1
30801,70,4861,3749,2920,0,0,0,1,1
30802,70,4862,9352,2920,0,0,0,1,1
30803,70,4864,6751;7503,2920,0,0,0,2,2
30804,70,4868,7403,2920,0,0,0,1,1
30805,70,4872,5679;7733,2920,0,0,0,2,2
30806,70,4875,7992,2920,0,0,0,1,1
30807,70,4876,6827,2920,0,0,0,1,1
30808,70,4879,3633;3709,2920,0,0,0,2,2
30809,70,4881,974,2920,0,0,0,1,1
30810,70,4882,4924,2920,0,0,0,1,1
30811,70,4883,8502,2920,0,0,0,1,1
30812,70,4887,8573,2920,0,0,0,1,1
30813,70,4888,8283;8584,2920,0,0,0,2,2
30814,70,4893,8643;8823,2920,0,0,0,2,2
30815,70,4895,6845,2920,0,0,0,1,1
30816,70,4902,6158,2920,0,0,0,1,1
30817,70,4906,5024,2920,0,0,0,1,1
30818,70,4907,8270,2920,0,0,0,1,1
30819,70,4911,153;4308,3285,0,0,0,2,2
30820,70,4912,959,3285,0,0,0,1,1
30821,70,4913,4499;9684,3285,0,0,0,2,2
30822,70,4914,4586;6981,3285,0,0,0,2,2
30823,70,4918,349;3748,3285,0,0,0,2,2
30824,70,4923,630;1344,3285,0,0,0,2,2
30825,70,4930,9041,3285,0,0,0,1,1
30826,70,4933,293,3285,0,0,0,1,1
30827,70,4935,8688,3285,0,0,0,1,1
30828,70,4937,1561,3285,0,0,0,1,1
30829,70,4938,2433;3802,3285,0,0,0,2,2
30830,70,4940,4043,3285,0,0,0,1,1
30831,70,4941,2843,3285,0,0,0,1,1
30832,70,4945,2189,3285,0,0,0,1,1
30833,70,4950,2670,3285,0,0,0,1,1
30834,70,4951,3850,3285,0,0,0,1,1
30835,70,4956,3560,3285,0,0,0,1,1
30836,70,4967,7330,3285,0,0,0,1,1
30837,70,4969,4637;7679,3285,0,0,0,2,2
30838,70,4972,4165,3285,0,0,0,1,1
30839,70,4974,2014,3285,0,0,0,1,1
30840,70,4981,74;7275,3285,0,0,0,2,2
30841,70,4987,5692;6188,3285,0,0,0,2,2
30842,70,4992,6503;8527,3285,0,0,0,2,2
30843,70,4993,6586,3285,0,0,0,1,1
30844,70,4998,5160,3285,0,0,0,1,1
30845,70,5000,240,3285,0,0,0,1,1
30846,70,5002,3117,3285,0,0,0,1,1
30847,70,5003,2594,3285,0,0,0,1,1
30848,70,5004,1572;7357,3285,0,0,0,2,2
30849,70,5010,8759;9665,3285,0,0,0,2,2
30850,70,5011,1609;6494,3285,0,0,0,2,2
30851,70,5015,8814,3285,0,0,0,1,1
30852,70,5016,6736,3285,0,0,0,1,1
30853,70,5018,3833,3285,0,0,0,1,1
30854,70,5019,2681;9008,3285,0,0,0,2,2
30855,70,5020,9114,3285,0,0,0,1,1
30856,70,5022,5031,3285,0,0,0,1,1
30857,70,5023,4034,3285,0,0,0,1,1
30858,70,5025,7627,3285,0,0,0,1,1
30859,70,5029,616;3132,3285,0,0,0,2,2
30860,70,5030,1693,3650,0,0,0,1,1
30861,70,5033,4400,3650,0,0,0,1,1
30862,70,5034,216;801,3650,0,0,0,2,2
30863,70,5038,891,3650,0,0,0,1,1
30864,70,5039,1061,3650,0,0,0,1,1
30865,70,5040,1288,3650,0,0,0,1,1
30866,70,5043,5216,3650,0,0,0,1,1
30867,70,5044,6604,3650,0,0,0,1,1
30868,70,5046,3202,3650,0,0,0,1,1
30869,70,5050,3103,3650,0,0,0,1,1
30870,70,5053,8624,3650,0,0,0,1,1
30871,70,5054,9423,3650,0,0,0,1,1
30872,70,5055,1236,3650,0,0,0,1,1
30873,70,5056,810;9336,3650,0,0,0,2,2
30874,70,5058,9848,3650,0,0,0,1,1
30875,70,5062,3395,3650,0,0,0,1,1
30876,70,5064,5008,3650,0,0,0,1,1
30877,70,5065,1147;3437;13608,3650,0,0,1,2,3
30878,70,5068,3704,3650,0,0,0,1,1
30879,70,5069,1321;8807,3650,0,0,0,2,2
30880,70,5070,584;7203,3650,0,0,0,2,2
30881,70,5074,6012,3650,0,0,0,1,1
30882,70,5075,4129,3650,0,0,0,1,1
30883,70,5078,3380,3650,0,0,0,1,1
30884,70,5079,4595;7739,3650,0,0,0,2,2
30885,70,5081,4771;8497,3650,0,0,0,2,2
30886,70,5084,9226,3650,0,0,0,1,1
30887,70,5088,6688,3650,0,0,0,1,1
30888,70,5089,6792;12702,3650,0,0,1,1,2
30889,70,5091,7969,3650,0,0,0,1,1
30890,70,5093,6949,3650,0,0,0,1,1
30891,70,5094,4368,3650,0,0,0,1,1
30892,70,5097,5863,3650,0,0,0,1,1
30893,70,5100,933;3125,3650,0,0,0,2,2
30894,70,5101,8407,3650,0,0,0,1,1
30895,70,5108,4655;9768,3650,0,0,0,2,2
30896,70,5109,2881,3650,0,0,0,1,1
30897,70,5110,6238;7520,3650,0,0,0,2,2
30898,70,5112,6629,3650,0,0,0,1,1
30899,70,5115,9166,3650,0,0,0,1,1
30900,70,5116,4979,3650,0,0,0,1,1
30901,70,5117,2180;7294,3650,0,0,0,2,2
30902,70,5118,7306;12335,3650,0,0,1,1,2
30903,70,5120,7398,3650,0,0,0,1,1
30904,70,5123,2795;7746,3650,0,0,0,2,2
30905,70,5124,8133,3650,0,0,0,1,1
30906,70,5128,2215;8538,3650,0,0,0,2,2
30907,70,5130,8572,3650,0,0,0,1,1
30908,70,5133,8857,3650,0,0,0,1,1
30909,70,5134,1100,3650,0,0,0,1,1
30910,70,5135,721;4514,3650,0,0,0,2,2
30911,70,5138,5969,3650,0,0,0,1,1
30912,70,5140,5441,3650,0,0,0,1,1
30913,70,5142,4723,3650,0,0,0,1,1
30914,70,5146,5709,3650,0,0,0,1,1
30915,70,5150,7073,3650,0,0,0,1,1
30916,70,5151,43,4015,0,0,0,1,1
30917,70,5152,107;5458,4015,0,0,0,2,2
30918,70,5153,7143,4015,0,0,0,1,1
30919,70,5155,771,4015,0,0,0,1,1
30920,70,5158,4810;5749,4015,0,0,0,2,2
30921,70,5167,945;7495,4015,0,0,0,2,2
30922,70,5168,1016,4015,0,0,0,1,1
30923,70,5170,1096,4015,0,0,0,1,1
30924,70,5176,2359,4015,0,0,0,1,1
30925,70,5177,12810;18000,4015,0,1,1,0,2
30926,70,5183,3208,4015,0,0,0,1,1
30927,70,5184,3309,4015,0,0,0,1,1
30928,70,5185,1304,4015,0,0,0,1,1
30929,70,5188,3595,4015,0,0,0,1,1
30930,70,5190,3726;7998,4015,0,0,0,2,2
30931,70,5192,3741;5043,4015,0,0,0,2,2
30932,70,5193,9033,4015,0,0,0,1,1
30933,70,5195,4713,4015,0,0,0,1,1
30934,70,5202,1505,4015,0,0,0,1,1
30935,70,5203,977,4015,0,0,0,1,1
30936,70,5205,760;3934,4015,0,0,0,2,2
30937,70,5210,3417;3696,4015,0,0,0,2,2
30938,70,5214,5764,4015,0,0,0,1,1
30939,70,5215,4654,4015,0,0,0,1,1
30940,70,5218,9874,4015,0,0,0,1,1
30941,70,5219,6112,4015,0,0,0,1,1
30942,70,5221,6284,4015,0,0,0,1,1
30943,70,5222,7138,4015,0,0,0,1,1
30944,70,5224,6404,4015,0,0,0,1,1
30945,70,5226,4755,4015,0,0,0,1,1
30946,70,5228,8365,4015,0,0,0,1,1
30947,70,5229,7150,4015,0,0,0,1,1
30948,70,5230,1163,4015,0,0,0,1,1
30949,70,5231,6480;6555,4015,0,0,0,2,2
30950,70,5233,1774,4015,0,0,0,1,1
30951,70,5237,2654,4015,0,0,0,1,1
30952,70,5238,765;7127,4015,0,0,0,2,2
30953,70,5240,7521;8616,4015,0,0,0,2,2
30954,70,5244,5442;7777,4015,0,0,0,2,2
30955,70,5247,9776;9926,4015,0,0,0,2,2
30956,70,5250,2815;8149,4015,0,0,0,2,2
30957,70,5255,7621,4015,0,0,0,1,1
30958,70,5260,1766;8932,4015,0,0,0,2,2
30959,70,5261,6603,4015,0,0,0,1,1
30960,70,5263,1649,4015,0,0,0,1,1
30961,70,5264,639;9069,4015,0,0,0,2,2
30962,70,5266,2475,4015,0,0,0,1,1
30963,70,5267,2008;6970,4015,0,0,0,2,2
30964,70,5272,2493,4015,0,0,0,1,1
30965,70,5277,674;4963,4380,0,0,0,2,2
30966,70,5283,3530;12343,4380,0,0,1,1,2
30967,70,5284,79,4380,0,0,0,1,1
30968,70,5289,4307;8931,4380,0,0,0,2,2
30969,70,5298,3520,4380,0,0,0,1,1
30970,70,5301,1933;8539,4380,0,0,0,2,2
30971,70,5302,7705,4380,0,0,0,1,1
30972,70,5303,1399,4380,0,0,0,1,1
30973,70,5305,4021;7176,4380,0,0,0,2,2
30974,70,5306,8442,4380,0,0,0,1,1
30975,70,5307,4271,4380,0,0,0,1,1
30976,70,5308,2694;9227,4380,0,0,0,2,2
30977,70,5319,3730,4380,0,0,0,1,1
30978,70,5320,5615,4380,0,0,0,1,1
30979,70,5324,3045,4380,0,0,0,1,1
30980,70,5325,6694,4380,0,0,0,1,1
30981,70,5326,714;6857,4380,0,0,0,2,2
30982,70,5328,2816,4380,0,0,0,1,1
30983,70,5336,5968,4380,0,0,0,1,1
30984,70,5337,9369;9501,4380,0,0,0,2,2
30985,70,5341,3207;8519,4380,0,0,0,2,2
30986,70,5344,944;7323,4380,0,0,0,2,2
30987,70,5346,8845,4380,0,0,0,1,1
30988,70,5351,7499,4380,0,0,0,1,1
30989,70,5355,2620;9666,4380,0,0,0,2,2
30990,70,5356,9694,4380,0,0,0,1,1
30991,70,5360,7419,4745,0,0,0,1,1
30992,70,5365,3753,4745,0,0,0,1,1
30993,70,5368,838,4745,0,0,0,1,1
30994,70,5370,7158,4745,0,0,0,1,1
30995,70,5371,3011,4745,0,0,0,1,1
30996,70,5377,1537;1726,4745,0,0,0,2,2
30997,70,5379,2239;8520,4745,0,0,0,2,2
30998,70,5384,182;2581,4745,0,0,0,2,2
30999,70,5385,9009;9692,4745,0,0,0,2,2
31000,70,5388,8291;9389,4745,0,0,0,2,2
31001,70,5391,2294,4745,0,0,0,1,1
31002,70,5394,2031;8649,4745,0,0,0,2,2
31003,70,5395,1451,4745,0,0,0,1,1
31004,70,5396,3615;9680,4745,0,0,0,2,2
31005,70,5399,2789;8273,4745,0,0,0,2,2
31006,70,5402,3524,4745,0,0,0,1,1
31007,70,5404,2834;4908,4745,0,0,0,2,2
31008,70,5405,2788,4745,0,0,0,1,1
31009,70,5407,5105,4745,0,0,0,1,1
31010,70,5409,3161;5489,4745,0,0,0,2,2
31011,70,5411,3356,4745,0,0,0,1,1
31012,70,5412,2669;13941,4745,0,0,1,1,2
31013,70,5416,5964,4745,0,0,0,1,1
31014,70,5418,3429;6110,4745,0,0,0,2,2
31015,70,5419,5202,4745,0,0,0,1,1
31016,70,5424,6950;9764,4745,0,0,0,2,2
31017,70,5427,6904,4745,0,0,0,1,1
31018,70,5429,7012,4745,0,0,0,1,1
31019,70,5431,1141;1966,4745,0,0,0,2,2
31020,70,5432,3003;5792,4745,0,0,0,2,2
31021,70,5434,7994;9245,4745,0,0,0,2,2
31022,70,5435,3078;8037,4745,0,0,0,2,2
31023,70,5438,1698;8638,4745,0,0,0,2,2
31024,70,5441,8798,4745,0,0,0,1,1
31025,70,5442,3713;5735,4745,0,0,0,2,2
31026,70,5446,4689;9783,4745,0,0,0,2,2
31027,70,5453,6363,5110,0,0,0,1,1
31028,70,5454,444,5110,0,0,0,1,1
31029,70,5459,920;8894,5110,0,0,0,2,2
31030,70,5462,2364,5110,0,0,0,1,1
31031,70,5465,1104;1364,5110,0,0,0,2,2
31032,70,5467,1427,5110,0,0,0,1,1
31033,70,5468,1450,5110,0,0,0,1,1
31034,70,5469,4268,5110,0,0,0,1,1
31035,70,5472,1771;5072,5110,0,0,0,2,2
31036,70,5474,8167,5110,0,0,0,1,1
31037,70,5476,6567;9485,5110,0,0,0,2,2
31038,70,5481,6885,5110,0,0,0,1,1
31039,70,5483,3951;4062,5110,0,0,0,2,2
31040,70,5484,5490,5110,0,0,0,1,1
31041,70,5487,4435,5110,0,0,0,1,1
31042,70,5489,3923,5110,0,0,0,1,1
31043,70,5490,4581,5110,0,0,0,1,1
31044,70,5491,6252,5110,0,0,0,1,1
31045,70,5492,3376,5110,0,0,0,1,1
31046,70,5496,9651,5110,0,0,0,1,1
31047,70,5498,953;5630,5110,0,0,0,2,2
31048,70,5499,5100;5662,5110,0,0,0,2,2
31049,70,5501,5809;6605,5110,0,0,0,2,2
31050,70,5502,3471;6240,5110,0,0,0,2,2
31051,70,5507,5659;9827,5110,0,0,0,2,2
31052,70,5508,9040,5110,0,0,0,1,1
31053,70,5511,4594,5110,0,0,0,1,1
31054,70,5516,8746,5110,0,0,0,1,1
31055,70,5522,7681,5110,0,0,0,1,1
31056,70,5528,1045;5459,5110,0,0,0,2,2
31057,70,5533,3573;13498,5110,0,0,1,1,2
31058,70,5534,9693,5110,0,0,0,1,1
31059,70,5536,113;5187,5475,0,0,0,2,2
31060,70,5537,1064,5475,0,0,0,1,1
31061,70,5549,1343,5475,0,0,0,1,1
31062,70,5553,1544;3945,5475,0,0,0,2,2
31063,70,5555,1670;6127,5475,0,0,0,2,2
31064,70,5558,5114,5475,0,0,0,1,1
31065,70,5560,4883,5475,0,0,0,1,1
31066,70,5561,1930;3367,5475,0,0,0,2,2
31067,70,5564,2175,5475,0,0,0,1,1
31068,70,5565,2321,5475,0,0,0,1,1
31069,70,5566,5367,5475,0,0,0,1,1
31070,70,5567,2498;7993,5475,0,0,0,2,2
31071,70,5570,2728;3458,5475,0,0,0,2,2
31072,70,5572,2996,5475,0,0,0,1,1
31073,70,5573,212;3120,5475,0,0,0,2,2
31074,70,5575,9637,5475,0,0,0,1,1
31075,70,5576,1608,5475,0,0,0,1,1
31076,70,5578,14189;14315;16782;17721;18631,5475,1,2,2,0,5
31077,70,5579,6809;8372;12898,5475,0,0,1,2,3
31078,70,5580,3578,5475,0,0,0,1,1
31079,70,5581,3710;6791,5475,0,0,0,2,2
31080,70,5584,7964;9677;12409,5475,0,0,1,2,3
31081,70,5585,5047;7785,5475,0,0,0,2,2
31082,70,5586,9285,5475,0,0,0,1,1
31083,70,5588,1751,5475,0,0,0,1,1
31084,70,5592,4587,5475,0,0,0,1,1
31085,70,5594,8135,5475,0,0,0,1,1
31086,70,5595,4700,5475,0,0,0,1,1
31087,70,5596,7016,5475,0,0,0,1,1
31088,70,5602,1428;2876,5475,0,0,0,2,2
31089,70,5605,4955;5892,5475,0,0,0,2,2
31090,70,5607,4401,5475,0,0,0,1,1
31091,70,5610,4656;6839,5475,0,0,0,2,2
31092,70,5611,2123,5475,0,0,0,1,1
31093,70,5614,2434,5475,0,0,0,1,1
31094,70,5615,7340,5475,0,0,0,1,1
31095,70,5618,6295;7024,5475,0,0,0,2,2
31096,70,5619,3046;7383,5475,0,0,0,2,2
31097,70,5620,3156;7697,5475,0,0,0,2,2
31098,70,5623,4153,5475,0,0,0,1,1
31099,70,5624,1387,5475,0,0,0,1,1
31100,70,5625,7794,5475,0,0,0,1,1
31101,70,5628,8010,5475,0,0,0,1,1
31102,70,5629,2783,5475,0,0,0,1,1
31103,70,5632,6847,5475,0,0,0,1,1
31104,70,5634,8641,5475,0,0,0,1,1
31105,70,5635,5241;6088,5475,0,0,0,2,2
31106,70,5636,6229,5475,0,0,0,1,1
31107,70,5637,4544,5475,0,0,0,1,1
31108,70,5639,1485;9400;12557,5475,0,0,1,2,3
31109,70,5643,5553,5475,0,0,0,1,1
31110,70,5644,8556,5475,0,0,0,1,1
31111,70,5645,3428;4285,5475,0,0,0,2,2
31112,70,5647,631;9853,5475,0,0,0,2,2
31113,70,5648,9976,5475,0,0,0,1,1
31114,70,5649,612,5840,0,0,0,1,1
31115,70,5652,120,5840,0,0,0,1,1
31116,70,5656,378;1847,5840,0,0,0,2,2
31117,70,5660,6750,5840,0,0,0,1,1
31118,70,5661,8201;10030,5840,0,0,0,2,2
31119,70,5663,13760;17977,5840,0,1,1,0,2
31120,70,5664,6183,5840,0,0,0,1,1
31121,70,5665,1267;4845,5840,0,0,0,2,2
31122,70,5667,1746;6465,5840,0,0,0,2,2
31123,70,5668,3400;8110,5840,0,0,0,2,2
31124,70,5669,7709,5840,0,0,0,1,1
31125,70,5670,163;3503,5840,0,0,0,2,2
31126,70,5677,3233;7500,5840,0,0,0,2,2
31127,70,5678,10105,5840,0,0,0,1,1
31128,70,5681,3029;7634,5840,0,0,0,2,2
31129,70,5683,10012;14513,5840,0,0,1,1,2
31130,70,5685,2271,5840,0,0,0,1,1
31131,70,5686,9056;10040,5840,0,0,0,2,2
31132,70,5687,6309,5840,0,0,0,1,1
31133,70,5689,1667;3146,5840,0,0,0,2,2
31134,70,5690,3968,5840,0,0,0,1,1
31135,70,5692,9726,5840,0,0,0,1,1
31136,70,5697,3840;4752,5840,0,0,0,2,2
31137,70,5699,379;4846;13945,5840,0,0,1,2,3
31138,70,5701,5064,5840,0,0,0,1,1
31139,70,5704,5228,5840,0,0,0,1,1
31140,70,5705,10045,5840,0,0,0,1,1
31141,70,5706,5311;8409,5840,0,0,0,2,2
31142,70,5707,5382;6905,5840,0,0,0,2,2
31143,70,5708,5425,5840,0,0,0,1,1
31144,70,5709,2775;5436,5840,0,0,0,2,2
31145,70,5710,81;7193,5840,0,0,0,2,2
31146,70,5711,7766;10113,5840,0,0,0,2,2
31147,70,5714,5985,5840,0,0,0,1,1
31148,70,5716,6911,5840,0,0,0,1,1
31149,70,5720,986;6582,5840,0,0,0,2,2
31150,70,5722,6699;8220,5840,0,0,0,2,2
31151,70,5723,1987,5840,0,0,0,1,1
31152,70,5726,7197,5840,0,0,0,1,1
31153,70,5728,6071;8338,5840,0,0,0,2,2
31154,70,5732,8047,5840,0,0,0,1,1
31155,70,5739,6571,5840,0,0,0,1,1
31156,70,5740,7156;9220,5840,0,0,0,2,2
31157,70,5742,480,5840,0,0,0,1,1
31158,70,5746,4945;9150,5840,0,0,0,2,2
31159,70,5747,8967,5840,0,0,0,1,1
31160,70,5748,9037,5840,0,0,0,1,1
31161,70,5750,9211,5840,0,0,0,1,1
31162,70,5754,3725,5840,0,0,0,1,1
31163,70,5763,319;7765,6205,0,0,0,2,2
31164,70,5764,10063,6205,0,0,0,1,1
31165,70,5765,477;2370,6205,0,0,0,2,2
31166,70,5766,4385;9514,6205,0,0,0,2,2
31167,70,5767,803,6205,0,0,0,1,1
31168,70,5770,982,6205,0,0,0,1,1
31169,70,5772,4147;9606,6205,0,0,0,2,2
31170,70,5776,44;10061;13444,6205,0,0,1,2,3
31171,70,5779,5002;7341,6205,0,0,0,2,2
31172,70,5784,7914,6205,0,0,0,1,1
31173,70,5785,2689,6205,0,0,0,1,1
31174,70,5787,632;9709,6205,0,0,0,2,2
31175,70,5789,3231,6205,0,0,0,1,1
31176,70,5794,1944,6205,0,0,0,1,1
31177,70,5795,3591,6205,0,0,0,1,1
31178,70,5796,3841;10112,6205,0,0,0,2,2
31179,70,5798,3995;6773,6205,0,0,0,2,2
31180,70,5800,4218,6205,0,0,0,1,1
31181,70,5802,4516,6205,0,0,0,1,1
31182,70,5803,9197,6205,0,0,0,1,1
31183,70,5805,6166;8498,6205,0,0,0,2,2
31184,70,5806,4757,6205,0,0,0,1,1
31185,70,5808,4867;9667,6205,0,0,0,2,2
31186,70,5814,5297;7995,6205,0,0,0,2,2
31187,70,5816,5480,6205,0,0,0,1,1
31188,70,5818,5642,6205,0,0,0,1,1
31189,70,5819,9765,6205,0,0,0,1,1
31190,70,5820,5899,6205,0,0,0,1,1
31191,70,5821,3601,6205,0,0,0,1,1
31192,70,5822,3366;5929,6205,0,0,0,2,2
31193,70,5824,3961,6205,0,0,0,1,1
31194,70,5825,2729;6262,6205,0,0,0,2,2
31195,70,5829,2146;6632,6205,0,0,0,2,2
31196,70,5830,6369,6205,0,0,0,1,1
31197,70,5832,6461;8799,6205,0,0,0,2,2
31198,70,5833,1026;8146,6205,0,0,0,2,2
31199,70,5834,9681,6205,0,0,0,1,1
31200,70,5839,5260;10053,6205,0,0,0,2,2
31201,70,5840,2760,6205,0,0,0,1,1
31202,70,5842,1623;7097,6205,0,0,0,2,2
31203,70,5843,1313;7110,6205,0,0,0,2,2
31204,70,5847,2062;7402,6205,0,0,0,2,2
31205,70,5848,1478;7747,6205,0,0,0,2,2
31206,70,5849,5156;7793,6205,0,0,0,2,2
31207,70,5850,3575;7927,6205,0,0,0,2,2
31208,70,5853,5674,6205,0,0,0,1,1
31209,70,5858,9266,6205,0,0,0,1,1
31210,70,5859,7802;9210,6205,0,0,0,2,2
31211,70,5860,9425,6205,0,0,0,1,1
31212,70,5861,9756,6205,0,0,0,1,1
31213,70,5864,11;5860,6205,0,0,0,2,2
31214,70,5867,93;10246,6570,0,0,0,2,2
31215,70,5869,10232,6570,0,0,0,1,1
31216,70,5870,294;652,6570,0,0,0,2,2
31217,70,5873,7762,6570,0,0,0,1,1
31218,70,5874,1092,6570,0,0,0,1,1
31219,70,5876,1231;9332,6570,0,0,0,2,2
31220,70,5878,1545;10122,6570,0,0,0,2,2
31221,70,5879,1564,6570,0,0,0,1,1
31222,70,5885,10187;10349,6570,0,0,0,2,2
31223,70,5886,921;7728,6570,0,0,0,2,2
31224,70,5890,2919;9139,6570,0,0,0,2,2
31225,70,5891,2963,6570,0,0,0,1,1
31226,70,5893,960;1191,6570,0,0,0,2,2
31227,70,5894,1027;3058;12211,6570,0,0,1,2,3
31228,70,5895,3118,6570,0,0,0,1,1
31229,70,5897,2950,6570,0,0,0,1,1
31230,70,5898,3255,6570,0,0,0,1,1
31231,70,5899,8698,6570,0,0,0,1,1
31232,70,5900,2322;12503,6570,0,0,1,1,2
31233,70,5910,6933,6570,0,0,0,1,1
31234,70,5919,4219,6570,0,0,0,1,1
31235,70,5923,5040;10089,6570,0,0,0,2,2
31236,70,5925,277;5723,6570,0,0,0,2,2
31237,70,5931,7780,6570,0,0,0,1,1
31238,70,5932,5195,6570,0,0,0,1,1
31239,70,5933,6233;10077,6570,0,0,0,2,2
31240,70,5934,2159;8703,6570,0,0,0,2,2
31241,70,5935,878;10214,6570,0,0,0,2,2
31242,70,5941,7030,6570,0,0,0,1,1
31243,70,5945,8297,6570,0,0,0,1,1
31244,70,5946,2369;7510,6570,0,0,0,2,2
31245,70,5947,10283;10319,6570,0,0,0,2,2
31246,70,5948,4677,6570,0,0,0,1,1
31247,70,5949,1136;7029,6570,0,0,0,2,2
31248,70,5951,8266,6570,0,0,0,1,1
31249,70,5953,4476;7781,6570,0,0,0,2,2
31250,70,5956,7481;8886,6570,0,0,0,2,2
31251,70,5959,7394,6570,0,0,0,1,1
31252,70,5960,3055,6570,0,0,0,1,1
31253,70,5962,9099,6570,0,0,0,1,1
31254,70,5963,9151;10158,6570,0,0,0,2,2
31255,70,5964,2870,6570,0,0,0,1,1
31256,70,5966,3794;5084,6570,0,0,0,2,2
31257,70,5968,6616;6693,6570,0,0,0,2,2
31258,70,5970,665,6570,0,0,0,1,1
31259,70,5971,9563;10299,6570,0,0,0,2,2
31260,70,5973,604;9626,6570,0,0,0,2,2
31261,70,5975,2264,6570,0,0,0,1,1
31262,70,5976,2539;9710,6570,0,0,0,2,2
31263,70,5977,6056;9720;12794,6570,0,0,1,2,3
31264,70,5985,316;4630,6935,0,0,0,2,2
31265,70,5988,1826,6935,0,0,0,1,1
31266,70,5995,5698;10155,6935,0,0,0,2,2
31267,70,5998,5798,6935,0,0,0,1,1
31268,70,5999,1940;2069,6935,0,0,0,2,2
31269,70,6001,4704;6990,6935,0,0,0,2,2
31270,70,6005,2494;5016,6935,0,0,0,2,2
31271,70,6011,5937,6935,0,0,0,1,1
31272,70,6017,4833;8701,6935,0,0,0,2,2
31273,70,6020,5032,6935,0,0,0,1,1
31274,70,6021,320;7177,6935,0,0,0,2,2
31275,70,6022,13328,6935,0,0,1,0,1
31276,70,6023,5643;8998,6935,0,0,0,2,2
31277,70,6028,6155;7444,6935,0,0,0,2,2
31278,70,6030,3679,6935,0,0,0,1,1
31279,70,6034,8176,6935,0,0,0,1,1
31280,70,6035,2972;4257,6935,0,0,0,2,2
31281,70,6037,1565;10031;14360,6935,0,0,1,2,3
31282,70,6038,7054,6935,0,0,0,1,1
31283,70,6043,10367;10526,6935,0,0,0,2,2
31284,70,6052,3517;9046,6935,0,0,0,2,2
31285,70,6054,1775,6935,0,0,0,1,1
31286,70,6056,10308,6935,0,0,0,1,1
31287,70,6062,2896;10003,6935,0,0,0,2,2
31288,70,6063,10082,6935,0,0,0,1,1
31289,70,6064,10044;10328;12795;15028,6935,0,0,2,2,4
31290,70,6065,10491,6935,0,0,0,1,1
31291,70,6066,10093;10184,6935,0,0,0,2,2
31292,70,6067,10036;10098,6935,0,0,0,2,2
31293,70,6068,1747;10115,6935,0,0,0,2,2
31294,70,6069,10018;10058,7300,0,0,0,2,2
31295,70,6071,6389,7300,0,0,0,1,1
31296,70,6072,1727;3246,7300,0,0,0,2,2
31297,70,6073,10484;14831,7300,0,0,1,1,2
31298,70,6074,546;10407,7300,0,0,0,2,2
31299,70,6075,7311,7300,0,0,0,1,1
31300,70,6076,1334;7712,7300,0,0,0,2,2
31301,70,6077,1461;10201,7300,0,0,0,2,2
31302,70,6079,10218,7300,0,0,0,1,1
31303,70,6082,1093;2442,7300,0,0,0,2,2
31304,70,6085,10078;10084,7300,0,0,0,2,2
31305,70,6086,87;7310,7300,0,0,0,2,2
31306,70,6091,6967,7300,0,0,0,1,1
31307,70,6092,3492,7300,0,0,0,1,1
31308,70,6093,3600;10069,7300,0,0,0,2,2
31309,70,6100,10065,7300,0,0,0,1,1
31310,70,6101,9923,7300,0,0,0,1,1
31311,70,6102,4106;10371,7300,0,0,0,2,2
31312,70,6107,10347;10480;15252,7300,0,0,1,2,3
31313,70,6109,1056;4959,7300,0,0,0,2,2
31314,70,6111,5097,7300,0,0,0,1,1
31315,70,6113,2948;5161,7300,0,0,0,2,2
31316,70,6114,5170;8892,7300,0,0,0,2,2
31317,70,6115,3388;5402,7300,0,0,0,2,2
31318,70,6120,6628;8198,7300,0,0,0,2,2
31319,70,6121,5850;9654,7300,0,0,0,2,2
31320,70,6122,5930,7300,0,0,0,1,1
31321,70,6126,10322;10345,7300,0,0,0,2,2
31322,70,6127,6849;7098,7300,0,0,0,2,2
31323,70,6129,5175;10188,7300,0,0,0,2,2
31324,70,6131,4016;7570,7300,0,0,0,2,2
31325,70,6137,8121,7300,0,0,0,1,1
31326,70,6149,3673,7300,0,0,0,1,1
31327,70,6154,2543;9879,7300,0,0,0,2,2
31328,70,6155,10386,7300,0,0,0,1,1
31329,70,6157,10019,7300,0,0,0,1,1
31330,70,6159,10043;10475;15185,7300,0,0,1,2,3
31331,70,6161,9042;10055,7300,0,0,0,2,2
31332,70,6163,10064;10083,7300,0,0,0,2,2
31333,70,6164,10439;15341,7300,0,0,1,1,2
31334,70,6166,10132,7300,0,0,0,1,1
31335,70,6168,10329;10448,7300,0,0,0,2,2
31336,70,6169,4571;10203,7300,0,0,0,2,2
31337,70,6170,228;10205,7300,0,0,0,2,2
31338,70,6171,10224,7300,0,0,0,1,1
31339,70,6172,10400,7300,0,0,0,1,1
31340,70,6173,10219,7300,0,0,0,1,1
31341,70,6174,10075,7665,0,0,0,1,1
31342,70,6175,5460;10094,7665,0,0,0,2,2
31343,70,6177,653;2108,7665,0,0,0,2,2
31344,70,6182,6744;10111,7665,0,0,0,2,2
31345,70,6188,6560,7665,0,0,0,1,1
31346,70,6189,2015;9518,7665,0,0,0,2,2
31347,70,6193,5137,7665,0,0,0,1,1
31348,70,6197,3126;6015,7665,0,0,0,2,2
31349,70,6198,3240,7665,0,0,0,1,1
31350,70,6199,3318;3874,7665,0,0,0,2,2
31351,70,6201,4056;5258,7665,0,0,0,2,2
31352,70,6203,4221;10060,7665,0,0,0,2,2
31353,70,6209,5245,7665,0,0,0,1,1
31354,70,6210,9371,7665,0,0,0,1,1
31355,70,6213,14272;18558,7665,1,0,1,0,2
31356,70,6214,9888,7665,0,0,0,1,1
31357,70,6216,896,7665,0,0,0,1,1
31358,70,6222,262;7255,7665,0,0,0,2,2
31359,70,6223,1044;9580,7665,0,0,0,2,2
31360,70,6224,4169;7671,7665,0,0,0,2,2
31361,70,6226,7724;10395,7665,0,0,0,2,2
31362,70,6229,613;8145;13418,7665,0,0,1,2,3
31363,70,6230,8272,7665,0,0,0,1,1
31364,70,6243,10024;10306,7665,0,0,0,2,2
31365,70,6244,10354,7665,0,0,0,1,1
31366,70,6245,10090;10119,7665,0,0,0,2,2
31367,70,6246,4868;10377,7665,0,0,0,2,2
31368,70,6247,10164;13709,7665,0,0,1,1,2
31369,70,6248,10101;10168,7665,0,0,0,2,2
31370,70,6249,10209,7665,0,0,0,1,1
31371,70,6250,10432;10543,7665,0,0,0,2,2
31372,70,6252,10248,7665,0,0,0,1,1
31373,70,6253,10255;10296;13115,7665,0,0,1,2,3
31374,70,6254,10530,7665,0,0,0,1,1
31375,70,6255,10265;10594,7665,0,0,0,2,2
31376,70,6256,10486,7665,0,0,0,1,1
31377,70,6257,10292;10482,7665,0,0,0,2,2
31378,70,6258,10312;10364,7665,0,0,0,2,2
31379,70,6259,10537;10570,7665,0,0,0,2,2
31380,70,6260,10332;10565,7665,0,0,0,2,2
31381,70,6261,10008;10080,8030,0,0,0,2,2
31382,70,6267,1049,8030,0,0,0,1,1
31383,70,6272,839;10156,8030,0,0,0,2,2
31384,70,6273,1218,8030,0,0,0,1,1
31385,70,6274,6649,8030,0,0,0,1,1
31386,70,6278,936,8030,0,0,0,1,1
31387,70,6279,2871;5736,8030,0,0,0,2,2
31388,70,6285,1990;6444,8030,0,0,0,2,2
31389,70,6287,4315,8030,0,0,0,1,1
31390,70,6288,3127,8030,0,0,0,1,1
31391,70,6311,7293,8030,0,0,0,1,1
31392,70,6314,2301;9562,8030,0,0,0,2,2
31393,70,6315,9267;10180,8030,0,0,0,2,2
31394,70,6316,1720;9231,8030,0,0,0,2,2
31395,70,6319,10042;10141,8030,0,0,0,2,2
31396,70,6322,10021;10071,8030,0,0,0,2,2
31397,70,6324,10091;10104;13747,8030,0,0,1,2,3
31398,70,6325,4092,8030,0,0,0,1,1
31399,70,6327,10807;10861,8030,0,0,2,0,2
31400,70,6329,10073,8030,0,0,0,1,1
31401,70,6330,10223;10234;12723,8030,0,0,1,2,3
31402,70,6332,1051;10236,8030,0,0,0,2,2
31403,70,6335,10272,8030,0,0,0,1,1
31404,70,6336,10309;10463,8030,0,0,0,2,2
31405,70,6337,10314;10453;15619,8030,0,0,1,2,3
31406,70,6338,10316;10374,8030,0,0,0,2,2
31407,70,6339,10446;10790,8030,0,0,1,1,2
31408,70,6340,10398,8030,0,0,0,1,1
31409,70,6341,10382,8030,0,0,0,1,1
31410,70,6342,10412,8030,0,0,0,1,1
31411,70,6343,10015;10403,8030,0,0,0,2,2
31412,70,6347,383;6336,8395,0,0,0,2,2
31413,70,6351,10038,8395,0,0,0,1,1
31414,70,6352,2121,8395,0,0,0,1,1
31415,70,6354,1308,8395,0,0,0,1,1
31416,70,6356,2784;8052,8395,0,0,0,2,2
31417,70,6357,169,8395,0,0,0,1,1
31418,70,6358,1493;10562,8395,0,0,0,2,2
31419,70,6361,2169,8395,0,0,0,1,1
31420,70,6362,2534;4151,8395,0,0,0,2,2
31421,70,6365,4629,8395,0,0,0,1,1
31422,70,6368,6470,8395,0,0,0,1,1
31423,70,6369,10120;10211,8395,0,0,0,2,2
31424,70,6374,10305,8395,0,0,0,1,1
31425,70,6376,7102,8395,0,0,0,1,1
31426,70,6381,8057,8395,0,0,0,1,1
31427,70,6382,4860,8395,0,0,0,1,1
31428,70,6383,10152;10245,8395,0,0,0,2,2
31429,70,6384,4946;10241,8395,0,0,0,2,2
31430,70,6391,9317,8395,0,0,0,1,1
31431,70,6399,1632,8395,0,0,0,1,1
31432,70,6404,4304;6601,8395,0,0,0,2,2
31433,70,6408,10353,8395,0,0,0,1,1
31434,70,6410,10126;16153,8395,0,0,1,1,2
31435,70,6412,6114;10088,8395,0,0,0,2,2
31436,70,6413,6823;10210,8395,0,0,0,2,2
31437,70,6414,2751;10097,8395,0,0,0,2,2
31438,70,6415,5186;10114,8395,0,0,0,2,2
31439,70,6417,10523,8395,0,0,0,1,1
31440,70,6418,10521;13803,8395,0,0,1,1,2
31441,70,6419,10144;10372,8395,0,0,0,2,2
31442,70,6421,5992;10149,8395,0,0,0,2,2
31443,70,6422,3247;10170,8395,0,0,0,2,2
31444,70,6423,10193;10498,8395,0,0,0,2,2
31445,70,6424,10109;10208;13419,8395,0,0,1,2,3
31446,70,6426,10153;10215,8395,0,0,0,2,2
31447,70,6427,10591,8395,0,0,0,1,1
31448,70,6428,10333;10727,8395,0,0,1,1,2
31449,70,6430,7856;10359,8395,0,0,0,2,2
31450,70,6431,10007;10380,8395,0,0,0,2,2
31451,70,6432,10336;10431,8395,0,0,0,2,2
31452,70,6433,10434;10472,8395,0,0,0,2,2
31453,70,6434,10436,8395,0,0,0,1,1
31454,70,6435,10325;10449,8395,0,0,0,2,2
31455,70,6436,10290;12660,8395,0,0,1,1,2
31456,70,6437,10717,8395,0,0,1,0,1
31457,70,6438,10578;10788;14149,8395,0,0,2,1,3
31458,70,6439,8013,8760,0,0,0,1,1
31459,70,6440,10344;10646,8760,0,0,0,2,2
31460,70,6446,10085,8760,0,0,0,1,1
31461,70,6447,1345;5433,8760,0,0,0,2,2
31462,70,6448,10399,8760,0,0,0,1,1
31463,70,6452,8839;9751,8760,0,0,0,2,2
31464,70,6459,3070;6612,8760,0,0,0,2,2
31465,70,6461,3241;10099,8760,0,0,0,2,2
31466,70,6462,1050;3267,8760,0,0,0,2,2
31467,70,6464,347,8760,0,0,0,1,1
31468,70,6466,5522;10183,8760,0,0,0,2,2
31469,70,6467,2246,8760,0,0,0,1,1
31470,70,6483,6654,8760,0,0,0,1,1
31471,70,6488,5013,8760,0,0,0,1,1
31472,70,6490,3731;5590;12753,8760,0,0,1,2,3
31473,70,6491,7972,8760,0,0,0,1,1
31474,70,6492,8033,8760,0,0,0,1,1
31475,70,6493,8065,8760,0,0,0,1,1
31476,70,6495,7465,8760,0,0,0,1,1
31477,70,6496,8526,8760,0,0,0,1,1
31478,70,6501,4990;9506,8760,0,0,0,2,2
31479,70,6503,4456;10035;14613,8760,0,0,1,2,3
31480,70,6504,10020;10025,8760,0,0,0,2,2
31481,70,6505,10195;10288,8760,0,0,0,2,2
31482,70,6506,10066;10138;13259,8760,0,0,1,2,3
31483,70,6508,10167;10250,8760,0,0,0,2,2
31484,70,6509,10579,8760,0,0,0,1,1
31485,70,6511,10735;10747,8760,0,0,2,0,2
31486,70,6513,10501;10668,8760,0,0,0,2,2
31487,70,6514,10023;10118,8760,0,0,0,2,2
31488,70,6516,10423;13818,8760,0,0,1,1,2
31489,70,6517,10176;10425,8760,0,0,0,2,2
31490,70,6518,10427;10674,8760,0,0,0,2,2
31491,70,6519,10590,8760,0,0,0,1,1
31492,70,6520,10461;10505,8760,0,0,0,2,2
31493,70,6521,10494;10895,8760,0,0,1,1,2
31494,70,6522,9849;10068,8760,0,0,0,2,2
31495,70,6523,10513;10850,8760,0,0,1,1,2
31496,70,6524,10517;10661,8760,0,0,0,2,2
31497,70,6525,10276,8760,0,0,0,1,1
31498,70,6526,10524;10797;14351,8760,0,0,2,1,3
31499,70,6527,10507;10534,8760,0,0,0,2,2
31500,70,6528,10547,8760,0,0,0,1,1
31501,70,6529,10563,8760,0,0,0,1,1
31502,70,6531,10671,8760,0,0,0,1,1
31503,70,6532,10595;13779,8760,0,0,1,1,2
31504,70,6533,10350;10597,8760,0,0,0,2,2
31505,70,6538,802,9125,0,0,0,1,1
31506,70,6539,4272,9125,0,0,0,1,1
31507,70,6541,10424;10455;13387,9125,0,0,1,2,3
31508,70,6542,2965;3137,9125,0,0,0,2,2
31509,70,6543,1059;9769,9125,0,0,0,2,2
31510,70,6557,10108;10254,9125,0,0,0,2,2
31511,70,6563,8269,9125,0,0,0,1,1
31512,70,6564,10159,9125,0,0,0,1,1
31513,70,6571,7443;10177,9125,0,0,0,2,2
31514,70,6574,367;7346,9125,0,0,0,2,2
31515,70,6578,1668;2920,9125,0,0,0,2,2
31516,70,6584,10662;10696,9125,0,0,1,1,2
31517,70,6589,10100,9125,0,0,0,1,1
31518,70,6591,10783;10967;14147,9125,0,0,3,0,3
31519,70,6592,10229;10485,9125,0,0,0,2,2
31520,70,6593,10194,9125,0,0,0,1,1
31521,70,6594,10202,9125,0,0,0,1,1
31522,70,6595,10207,9125,0,0,0,1,1
31523,70,6596,10539;10542;14619,9125,0,0,1,2,3
31524,70,6597,10146;10396,9125,0,0,0,2,2
31525,70,6598,10389;10481,9125,0,0,0,2,2
31526,70,6599,10268;10368,9125,0,0,0,2,2
31527,70,6600,10409;10558;13234,9125,0,0,1,2,3
31528,70,6601,10435;10628,9125,0,0,0,2,2
31529,70,6602,10864;10947,9125,0,0,2,0,2
31530,70,6603,10392;10639,9125,0,0,0,2,2
31531,70,6604,10540;10672,9125,0,0,0,2,2
31532,70,6605,10466;10650,9125,0,0,0,2,2
31533,70,6606,10317;10605,9125,0,0,0,2,2
31534,70,6607,10919;10988;15268;15814,9125,0,0,4,0,4
31535,70,6608,10739;10762,9125,0,0,2,0,2
31536,70,6609,10278;10418,9125,0,0,0,2,2
31537,70,6611,10866;11009,9125,0,0,2,0,2
31538,70,6612,10627,9125,0,0,0,1,1
31539,70,6613,10123;10601,9125,0,0,0,2,2
31540,70,6614,10428;10610;15167,9125,0,0,1,2,3
31541,70,6615,10955,9125,0,0,1,0,1
31542,70,6616,10568;10623;14074,9125,0,0,1,2,3
31543,70,6617,10624;10763,9125,0,0,1,1,2
31544,70,6618,10280;10625,9125,0,0,0,2,2
31545,70,6619,10848,9125,0,0,1,0,1
31546,70,6620,10490;10657;14556,9125,0,0,1,2,3
31547,70,6621,10495;10675,9125,0,0,0,2,2
31548,70,6622,10677;15270,9125,0,0,1,1,2
31549,70,6623,10626;10679,9125,0,0,0,2,2
31550,70,6624,10681;10873,9125,0,0,1,1,2
31551,70,6631,6587,9490,0,0,0,1,1
31552,70,6639,877;1840,9490,0,0,0,2,2
31553,70,6646,8150,9490,0,0,0,1,1
31554,70,6660,8408,9490,0,0,0,1,1
31555,70,6667,1140,9490,0,0,0,1,1
31556,70,6668,1192,9490,0,0,0,1,1
31557,70,6671,9826,9490,0,0,0,1,1
31558,70,6673,6469;8697,9490,0,0,0,2,2
31559,70,6675,3019,9490,0,0,0,1,1
31560,70,6677,8425;9117,9490,0,0,0,2,2
31561,70,6680,9113,9490,0,0,0,1,1
31562,70,6682,10009,9490,0,0,0,1,1
31563,70,6684,10300;10457,9490,0,0,0,2,2
31564,70,6686,10217;10489,9490,0,0,0,2,2
31565,70,6687,10253;10510,9490,0,0,0,2,2
31566,70,6688,10508;14594,9490,0,0,1,1,2
31567,70,6689,10171;10615,9490,0,0,0,2,2
31568,70,6690,10190;10267,9490,0,0,0,2,2
31569,70,6691,10285;10376,9490,0,0,0,2,2
31570,70,6693,10039,9490,0,0,0,1,1
31571,70,6694,7530;10192,9490,0,0,0,2,2
31572,70,6696,10196;10445,9490,0,0,0,2,2
31573,70,6698,10459;10504,9490,0,0,0,2,2
31574,70,6700,10573;10596,9490,0,0,0,2,2
31575,70,6701,10493;10792,9490,0,0,1,1,2
31576,70,6702,10503,9490,0,0,0,1,1
31577,70,6703,10320;10546;13974,9490,0,0,1,2,3
31578,70,6704,10497;10645,9490,0,0,0,2,2
31579,70,6705,10560;10564,9490,0,0,0,2,2
31580,70,6706,10576;10799;13149,9490,0,0,2,1,3
31581,70,6707,10577,9490,0,0,0,1,1
31582,70,6708,10585,9490,0,0,0,1,1
31583,70,6709,10580;10592,9490,0,0,0,2,2
31584,70,6710,10528;10604;13946,9490,0,0,1,2,3
31585,70,6711,10419,9490,0,0,0,1,1
31586,70,6712,10618;10885;14625,9490,0,0,2,1,3
31587,70,6713,10259;10616;14285,9490,0,0,1,2,3
31588,70,6714,10240;10687,9490,0,0,0,2,2
31589,70,6715,10640,9490,0,0,0,1,1
31590,70,6716,10827,9490,0,0,1,0,1
31591,70,6717,10337;10670,9490,0,0,0,2,2
31592,70,6718,10731,9490,0,0,1,0,1
31593,70,6719,10473;13367;14017;15130,9490,0,0,3,1,4
31594,70,6720,10406;10700,9490,0,0,1,1,2
31595,70,6721,10789;11010,9490,0,0,2,0,2
31596,70,6722,11053;13646;13802,9490,0,0,3,0,3
31597,70,6723,10413;10977,9490,0,0,1,1,2
31598,70,6725,10791;10821,9490,0,0,2,0,2
31599,70,6728,10373;14268,9855,0,0,1,1,2
31600,70,6729,3198,9855,0,0,0,1,1
31601,70,6731,8417,9855,0,0,0,1,1
31602,70,6738,2621,9855,0,0,0,1,1
31603,70,6740,8949,9855,0,0,0,1,1
31604,70,6743,6347,9855,0,0,0,1,1
31605,70,6749,4448;9364,9855,0,0,0,2,2
31606,70,6754,4956,9855,0,0,0,1,1
31607,70,6756,684;9103,9855,0,0,0,2,2
31608,70,6757,14681;15177;18367,9855,1,0,2,0,3
31609,70,6765,5864;7893,9855,0,0,0,2,2
31610,70,6766,4258;8567,9855,0,0,0,2,2
31611,70,6767,460;8763,9855,0,0,0,2,2
31612,70,6772,9985,9855,0,0,0,1,1
31613,70,6773,10029,9855,0,0,0,1,1
31614,70,6774,10303;10430,9855,0,0,0,2,2
31615,70,6775,6729;10239,9855,0,0,0,2,2
31616,70,6776,10225;10230;13993,9855,0,0,1,2,3
31617,70,6777,10266;10315,9855,0,0,0,2,2
31618,70,6778,10294,9855,0,0,0,1,1
31619,70,6779,10174;10304,9855,0,0,0,2,2
31620,70,6780,10341;10532,9855,0,0,0,2,2
31621,70,6781,10362;13277,9855,0,0,1,1,2
31622,70,6782,10145;10365,9855,0,0,0,2,2
31623,70,6783,10037;10366,9855,0,0,0,2,2
31624,70,6784,10352;10369,9855,0,0,0,2,2
31625,70,6785,10358;10402,9855,0,0,0,2,2
31626,70,6786,10323;10464;15529,9855,0,0,1,2,3
31627,70,6787,10197;10506,9855,0,0,0,2,2
31628,70,6789,10456;10853,9855,0,0,1,1,2
31629,70,6790,10647;10909,9855,0,0,1,1,2
31630,70,6791,10545,9855,0,0,0,1,1
31631,70,6792,10488;10588,9855,0,0,0,2,2
31632,70,6793,10529;10871,9855,0,0,1,1,2
31633,70,6794,10584;14085,9855,0,0,1,1,2
31634,70,6797,10630;10701,9855,0,0,1,1,2
31635,70,6798,10220;10631,9855,0,0,0,2,2
31636,70,6799,10648;10892;14174,9855,0,0,2,1,3
31637,70,6800,10654;10758,9855,0,0,1,1,2
31638,70,6801,10669,9855,0,0,0,1,1
31639,70,6802,10518;10703,9855,0,0,1,1,2
31640,70,6803,10551;10705,9855,0,0,1,1,2
31641,70,6804,11130;11185;13757,9855,0,0,3,0,3
31642,70,6805,11004;11052;13973,9855,0,0,3,0,3
31643,70,6806,14011;14404,9855,0,0,2,0,2
31644,70,6807,10707;10785,9855,0,0,2,0,2
31645,70,6808,10582;10795,9855,0,0,1,1,2
31646,70,6809,10442;10812,9855,0,0,1,1,2
31647,70,6810,10816;11110,9855,0,0,2,0,2
31648,70,6811,11025,9855,0,0,1,0,1
31649,70,6812,10600;10847,9855,0,0,1,1,2
31650,70,6813,10749;10889,9855,0,0,2,0,2
31651,70,6814,10899;10970,9855,0,0,2,0,2
31652,70,6815,10903;11197;15715,9855,0,0,3,0,3
31653,70,6823,3289;4475,10220,0,0,0,2,2
31654,70,6828,2625,10220,0,0,0,1,1
31655,70,6834,9883,10220,0,0,0,1,1
31656,70,6839,414,10220,0,0,0,1,1
31657,70,6840,6002;10286;14561,10220,0,0,1,2,3
31658,70,6841,6212,10220,0,0,0,1,1
31659,70,6842,5128,10220,0,0,0,1,1
31660,70,6843,6348;10189,10220,0,0,0,2,2
31661,70,6846,7295,10220,0,0,0,1,1
31662,70,6850,7101,10220,0,0,0,1,1
31663,70,6860,10128;10282,10220,0,0,0,2,2
31664,70,6862,7890,10220,0,0,0,1,1
31665,70,6863,10289;14695,10220,0,0,1,1,2
31666,70,6865,10385,10220,0,0,0,1,1
31667,70,6869,10375,10220,0,0,0,1,1
31668,70,6870,10603;10730;14141,10220,0,0,2,1,3
31669,70,6871,10370;10784,10220,0,0,1,1,2
31670,70,6872,10228;16136,10220,0,0,1,1,2
31671,70,6873,10664;10685,10220,0,0,0,2,2
31672,70,6874,10728;14995,10220,0,0,2,0,2
31673,70,6875,10688;10713;14959,10220,0,0,2,1,3
31674,70,6876,10694;10787,10220,0,0,1,1,2
31675,70,6878,10800,10220,0,0,1,0,1
31676,70,6879,10613;10934;15460,10220,0,0,2,1,3
31677,70,6880,10888;10935;13796,10220,0,0,3,0,3
31678,70,6881,10898;10907,10220,0,0,2,0,2
31679,70,6882,11086,10220,0,0,1,0,1
31680,70,6883,10766;10948,10220,0,0,2,0,2
31681,70,6884,10960;11152,10220,0,0,2,0,2
31682,70,6885,10961;11195;14386,10220,0,0,3,0,3
31683,70,6886,10776;11088;14593,10220,0,0,3,0,3
31684,70,6887,10896;10984,10220,0,0,2,0,2
31685,70,6888,10771;15194,10220,0,0,2,0,2
31686,70,6889,11067;11137,10220,0,0,2,0,2
31687,70,6890,11144;15247,10220,0,0,2,0,2
31688,70,6895,804;10026,10585,0,0,0,2,2
31689,70,6897,1382;3798,10585,0,0,0,2,2
31690,70,6899,1803,10585,0,0,0,1,1
31691,70,6900,94,10585,0,0,0,1,1
31692,70,6909,357,10585,0,0,0,1,1
31693,70,6911,2389,10585,0,0,0,1,1
31694,70,6913,1719;5365,10585,0,0,0,2,2
31695,70,6922,10247;14799,10585,0,0,1,1,2
31696,70,6924,10249;10683;15000,10585,0,0,1,2,3
31697,70,6925,10013;10408;15282,10585,0,0,1,2,3
31698,70,6927,10452;10782,10585,0,0,1,1,2
31699,70,6928,10185;10405;14258;14918,10585,0,0,2,2,4
31700,70,6929,10221;10718;14708,10585,0,0,2,1,3
31701,70,6931,10462;10531,10585,0,0,0,2,2
31702,70,6932,10567;10637,10585,0,0,0,2,2
31703,70,6933,10665;10859,10585,0,0,1,1,2
31704,70,6934,10004;10070,10585,0,0,0,2,2
31705,70,6935,10709;10759,10585,0,0,2,0,2
31706,70,6936,10857;11058;15071,10585,0,0,3,0,3
31707,70,6937,10589;10822,10585,0,0,1,1,2
31708,70,6939,10487;10833,10585,0,0,1,1,2
31709,70,6940,10841,10585,0,0,1,0,1
31710,70,6941,10843,10585,0,0,1,0,1
31711,70,6943,10921;10925,10585,0,0,2,0,2
31712,70,6944,10426;10867,10585,0,0,1,1,2
31713,70,6945,10535;10887,10585,0,0,1,1,2
31714,70,6946,10527;10849;15486,10585,0,0,2,1,3
31715,70,6947,11280;11344,10585,0,0,2,0,2
31716,70,6948,10926;11552;15079;15428,10585,0,0,4,0,4
31717,70,6949,10770;11132,10585,0,0,2,0,2
31718,70,6950,10893;11147;14575;15369,10585,0,0,4,0,4
31719,70,6951,10996;11018,10585,0,0,2,0,2
31720,70,6952,10714;11045;15883,10585,0,0,3,0,3
31721,70,6953,11274;11318;13848;16177,10585,0,0,4,0,4
31722,70,6954,10806;11054;15503,10585,0,0,3,0,3
31723,70,6956,11080,10585,0,0,1,0,1
31724,70,6957,11095;11343;16104,10585,0,0,3,0,3
31725,70,6961,8831,10950,0,0,0,1,1
31726,70,6962,10010,10950,0,0,0,1,1
31727,70,6977,3438,10950,0,0,0,1,1
31728,70,6981,5301,10950,0,0,0,1,1
31729,70,6990,5604,10950,0,0,0,1,1
31730,70,6991,6408,10950,0,0,0,1,1
31731,70,6999,2774;10231,10950,0,0,0,2,2
31732,70,7000,10154;10311;14153,10950,0,0,1,2,3
31733,70,7002,3472,10950,0,0,0,1,1
31734,70,7003,10011;10378,10950,0,0,0,2,2
31735,70,7005,10394;10557;13672,10950,0,0,1,2,3
31736,70,7007,10186;10420,10950,0,0,0,2,2
31737,70,7009,10756,10950,0,0,1,0,1
31738,70,7010,11037;11194;13496;13557,10950,0,0,4,0,4
31739,70,7012,10764;10805;14073,10950,0,0,3,0,3
31740,70,7013,10924;11074,10950,0,0,2,0,2
31741,70,7014,10342;10793;15940,10950,0,0,2,1,3
31742,70,7015,10796,10950,0,0,1,0,1
31743,70,7016,11268,10950,0,0,1,0,1
31744,70,7017,10693;10808,10950,0,0,1,1,2
31745,70,7018,10817;10922,10950,0,0,2,0,2
31746,70,7019,11133;11168,10950,0,0,2,0,2
31747,70,7020,10883;15949,10950,0,0,2,0,2
31748,70,7021,11093;14802,10950,0,0,2,0,2
31749,70,7022,11140;11296;15183,10950,0,0,3,0,3
31750,70,7023,10912;11077,10950,0,0,2,0,2
31751,70,7024,10972;11174;13872,10950,0,0,3,0,3
31752,70,7025,10755;10851;14246,10950,0,0,3,0,3
31753,70,7028,10989;11122;14676,10950,0,0,3,0,3
31754,70,7029,11005;11460,10950,0,0,2,0,2
31755,70,7030,10772;11006;14546;15577,10950,0,0,4,0,4
31756,70,7032,11035;11248,10950,0,0,2,0,2
31757,70,7033,11036;11048,10950,0,0,2,0,2
31758,70,7034,11041;11170;13884;15774,10950,0,0,4,0,4
31759,70,7035,11231;11462,10950,0,0,2,0,2
31760,70,7036,11415,10950,0,0,1,0,1
31761,70,7037,11068;11326,10950,0,0,2,0,2
31762,70,7038,10999;11298,10950,0,0,2,0,2
31763,70,7039,10716;11099,10950,0,0,2,0,2
31764,70,7040,11102;11374;15180;15606,10950,0,0,4,0,4
31765,70,7041,10824;11103,10950,0,0,2,0,2
31766,70,7042,11043;11281,10950,0,0,2,0,2
31767,70,7043,11126;11441;16150,10950,0,0,3,0,3
31768,70,7044,11055;11128;14396,10950,0,0,3,0,3
31769,70,7045,11029,10950,0,0,1,0,1
31770,70,7046,10966;11159,10950,0,0,2,0,2
31771,70,7048,11154;11299;16068,10950,0,0,3,0,3
31772,70,7049,11012;11251,10950,0,0,2,0,2
31773,70,7050,11165;11409,10950,0,0,2,0,2
31774,70,7051,11070;11339,10950,0,0,2,0,2
31775,70,7052,10953;11261;14514;15961,10950,0,0,4,0,4
31776,70,7054,554,11315,0,0,0,1,1
31777,70,7065,3863;10242;14596,11315,0,0,1,2,3
31778,70,7068,4290,11315,0,0,0,1,1
31779,70,7069,10293;10429;14730;15345,11315,0,0,2,2,4
31780,70,7071,2692,11315,0,0,0,1,1
31781,70,7075,3256;6370,11315,0,0,0,2,2
31782,70,7081,7223,11315,0,0,0,1,1
31783,70,7082,7410,11315,0,0,0,1,1
31784,70,7083,7445;10179,11315,0,0,0,2,2
31785,70,7092,9987,11315,0,0,0,1,1
31786,70,7093,10348;10388,11315,0,0,0,2,2
31787,70,7095,10279,11315,0,0,0,1,1
31788,70,7096,10135;10137,11315,0,0,0,2,2
31789,70,7098,10313;14609,11315,0,0,1,1,2
31790,70,7099,10360,11315,0,0,0,1,1
31791,70,7100,10441;10897,11315,0,0,1,1,2
31792,70,7101,10553;10794,11315,0,0,1,1,2
31793,70,7102,10361;13932;14700,11315,0,0,2,1,3
31794,70,7103,10638;10761,11315,0,0,1,1,2
31795,70,7104,10598;10742,11315,0,0,1,1,2
31796,70,7105,11023;11277,11315,0,0,2,0,2
31797,70,7107,10384;10617;14510;16430,11315,0,0,2,2,4
31798,70,7108,10991,11315,0,0,1,0,1
31799,70,7110,10743;11061,11315,0,0,2,0,2
31800,70,7111,10778;10802;14914,11315,0,0,3,0,3
31801,70,7112,10561;10844;14679;16033,11315,0,0,3,1,4
31802,70,7114,10901;14582,11315,0,0,2,0,2
31803,70,7115,10914;11087,11315,0,0,2,0,2
31804,70,7116,10930;15407,11315,0,0,2,0,2
31805,70,7117,10801;10931,11315,0,0,2,0,2
31806,70,7118,10936;11158,11315,0,0,2,0,2
31807,70,7119,10943;11267;15006,11315,0,0,3,0,3
31808,70,7120,10910;10974,11315,0,0,2,0,2
31809,70,7121,10810;10976,11315,0,0,2,0,2
31810,70,7123,10990;11007,11315,0,0,2,0,2
31811,70,7125,11244;11526,11315,0,0,2,0,2
31812,70,7126,11051;11084,11315,0,0,2,0,2
31813,70,7127,10815;14265,11315,0,0,2,0,2
31814,70,7128,10699;11105,11315,0,0,2,0,2
31815,70,7130,10969,11315,0,0,1,0,1
31816,70,7132,11136;11179;14296;15692,11315,0,0,4,0,4
31817,70,7133,11186;11189,11315,0,0,2,0,2
31818,70,7135,10949;11249;16464,11315,0,0,3,0,3
31819,70,7136,10768;11271;14111,11315,0,0,3,0,3
31820,70,7137,11013;11278;15373,11315,0,0,3,0,3
31821,70,7140,5738;9161,11680,0,0,0,2,2
31822,70,7141,3150,11680,0,0,0,1,1
31823,70,7149,10017;10298;13999,11680,0,0,1,2,3
31824,70,7151,4295,11680,0,0,0,1,1
31825,70,7159,5526;8100,11680,0,0,0,2,2
31826,70,7160,6805;9729,11680,0,0,0,2,2
31827,70,7165,9316;10237,11680,0,0,0,2,2
31828,70,7167,9741,11680,0,0,0,1,1
31829,70,7168,10125;10191,11680,0,0,0,2,2
31830,70,7169,10356;10468,11680,0,0,0,2,2
31831,70,7170,10148;10363,11680,0,0,0,2,2
31832,70,7171,10496,11680,0,0,0,1,1
31833,70,7172,10161;10512,11680,0,0,0,2,2
31834,70,7173,10477;10586;14934,11680,0,0,1,2,3
31835,70,7174,10509;11240,11680,0,0,1,1,2
31836,70,7175,10819;10835;14663,11680,0,0,3,0,3
31837,70,7176,10479;10593,11680,0,0,0,2,2
31838,70,7177,10643;10712;13800;14885,11680,0,0,3,1,4
31839,70,7178,10973,11680,0,0,1,0,1
31840,70,7179,11222,11680,0,0,1,0,1
31841,70,7180,10834;11062,11680,0,0,2,0,2
31842,70,7181,10862;11015,11680,0,0,2,0,2
31843,70,7182,10559;10773,11680,0,0,1,1,2
31844,70,7183,10471;10780,11680,0,0,1,1,2
31845,70,7184,10832,11680,0,0,1,0,1
31846,70,7185,10732;10869,11680,0,0,2,0,2
31847,70,7186,10659;10880;15988,11680,0,0,2,1,3
31848,70,7187,10632;10884,11680,0,0,1,1,2
31849,70,7188,10945;11063,11680,0,0,2,0,2
31850,70,7189,10938;10998,11680,0,0,2,0,2
31851,70,7190,10451;10954;16146,11680,0,0,2,1,3
31852,70,7191,11216,11680,0,0,1,0,1
31853,70,7192,10994;11149,11680,0,0,2,0,2
31854,70,7193,10804;10982,11680,0,0,2,0,2
31855,70,7194,11040;11694;15242,11680,0,0,3,0,3
31856,70,7195,11496;15757,11680,0,0,2,0,2
31857,70,7196,11112,11680,0,0,1,0,1
31858,70,7198,11032;11586;14685;15140;16092,11680,0,0,5,0,5
31859,70,7199,11139;11352;15214;15879,11680,0,0,4,0,4
31860,70,7200,10752;10870,11680,0,0,2,0,2
31861,70,7201,11121;11211,11680,0,0,2,0,2
31862,70,7202,11213;11369;14442,11680,0,0,3,0,3
31863,70,7203,11238;11692,11680,0,0,2,0,2
31864,70,7204,11334;11689;16879,11680,0,1,2,0,3
31865,70,7206,11256;11562,11680,0,0,2,0,2
31866,70,7207,11259;11288,11680,0,0,2,0,2
31867,70,7208,11392;11550;15724;16071;16412,11680,0,0,5,0,5
31868,70,7209,11142;11285;14542;15100,11680,0,0,4,0,4
31869,70,7210,10906;11303,11680,0,0,2,0,2
31870,70,7211,10410;11329;13670;14765,11680,0,0,3,1,4
31871,70,7212,11587;14952;15717,11680,0,0,3,0,3
31872,70,7213,11200;15004,11680,0,0,2,0,2
31873,70,7214,11353;11630;16269,11680,0,0,3,0,3
31874,70,7215,10840;11366;15155,11680,0,0,3,0,3
31875,70,7216,11224;14460,11680,0,0,2,0,2
31876,70,7217,11381;11430,11680,0,0,2,0,2
31877,70,7218,11387;11571;15446,11680,0,0,3,0,3
31878,70,7220,1526;2875,12045,0,0,0,2,2
31879,70,7228,1622,12045,0,0,0,1,1
31880,70,7234,2855;9750,12045,0,0,0,2,2
31881,70,7243,170;9838,12045,0,0,0,2,2
31882,70,7247,7315,12045,0,0,0,1,1
31883,70,7253,4523,12045,0,0,0,1,1
31884,70,7259,10263;10404,12045,0,0,0,2,2
31885,70,7260,10635;11002,12045,0,0,1,1,2
31886,70,7266,10575;10614,12045,0,0,0,2,2
31887,70,7267,11183;11346;14979,12045,0,0,3,0,3
31888,70,7268,10622;10902;15750,12045,0,0,2,1,3
31889,70,7269,10666,12045,0,0,0,1,1
31890,70,7270,10541,12045,0,0,0,1,1
31891,70,7271,10682;11116;13869,12045,0,0,2,1,3
31892,70,7273,10602;10722;14389,12045,0,0,2,1,3
31893,70,7275,10478;10750,12045,0,0,1,1,2
31894,70,7276,10753;15266,12045,0,0,2,0,2
31895,70,7278,10803;10831;14994,12045,0,0,3,0,3
31896,70,7279,10809;16477,12045,0,0,2,0,2
31897,70,7280,10854;11273;14199;14420,12045,0,0,4,0,4
31898,70,7282,10514;10894,12045,0,0,1,1,2
31899,70,7283,10905;14851;15324,12045,0,0,3,0,3
31900,70,7286,11206;11308,12045,0,0,2,0,2
31901,70,7287,10959;11135;14019,12045,0,0,3,0,3
31902,70,7288,11057;11059,12045,0,0,2,0,2
31903,70,7289,11091,12045,0,0,1,0,1
31904,70,7290,11016;11292,12045,0,0,2,0,2
31905,70,7292,11442,12045,0,0,1,0,1
31906,70,7293,10658;11141,12045,0,0,1,1,2
31907,70,7294,11157;15779,12045,0,0,2,0,2
31908,70,7295,10986;11203,12045,0,0,2,0,2
31909,70,7296,11321;11556;16872,12045,0,1,2,0,3
31910,70,7297,11208;11228;15573,12045,0,0,3,0,3
31911,70,7298,11209;11320,12045,0,0,2,0,2
31912,70,7299,11279;11597;15562,12045,0,0,3,0,3
31913,70,7300,11225;15488,12045,0,0,2,0,2
31914,70,7301,11204;11307;14303,12045,0,0,3,0,3
31915,70,7305,11064;11294;14725;15001,12045,0,0,4,0,4
31916,70,7306,11465;11495;15572;16865,12045,0,1,3,0,4
31917,70,7307,11328;11528,12045,0,0,2,0,2
31918,70,7308,11720;11773;14347,12045,0,0,3,0,3
31919,70,7309,10918;11350,12045,0,0,2,0,2
31920,70,7310,11119;11356;16359,12045,0,0,3,0,3
31921,70,7311,11270;11379,12045,0,0,2,0,2
31922,70,7312,11493;11544,12045,0,0,2,0,2
31923,70,7313,11751;11970;16519,12045,0,0,3,0,3
31924,70,7314,11405;11457;15993;16455,12045,0,0,4,0,4
31925,70,7315,11377;11424;15673,12045,0,0,3,0,3
31926,70,7316,11637;11681;15343,12045,0,0,3,0,3
31927,70,7317,11257;11469,12045,0,0,2,0,2
31928,70,7318,11447;11478;14726,12045,0,0,3,0,3
31929,70,7319,11458;11518;14759;15913,12045,0,0,4,0,4
31930,70,7320,11468;11581;16038,12045,0,0,3,0,3
31931,70,7321,11481,12045,0,0,1,0,1
31932,70,7322,11349;11482;14812;15485,12045,0,0,4,0,4
31933,70,7323,2975;10151;15323,12410,0,0,1,2,3
31934,70,7326,330;4474,12410,0,0,0,2,2
31935,70,7335,8679,12410,0,0,0,1,1
31936,70,7346,3086,12410,0,0,0,1,1
31937,70,7347,6344;7121,12410,0,0,0,2,2
31938,70,7348,4142,12410,0,0,0,1,1
31939,70,7352,5249,12410,0,0,0,1,1
31940,70,7353,7990,12410,0,0,0,1,1
31941,70,7361,3481;10116,12410,0,0,0,2,2
31942,70,7364,10130;10318,12410,0,0,0,2,2
31943,70,7365,10619;14424,12410,0,0,1,1,2
31944,70,7366,10301;10415,12410,0,0,0,2,2
31945,70,7367,10868;11337;15259,12410,0,0,3,0,3
31946,70,7368,10745;11310;15906,12410,0,0,3,0,3
31947,70,7369,10721;10760;15600,12410,0,0,3,0,3
31948,70,7370,10964;11039,12410,0,0,2,0,2
31949,70,7371,10951;11207,12410,0,0,2,0,2
31950,70,7372,11028;11073;16011,12410,0,0,3,0,3
31951,70,7373,10587;10820,12410,0,0,1,1,2
31952,70,7376,11198;11375;15340;15631,12410,0,0,4,0,4
31953,70,7377,10612;10937;14535,12410,0,0,2,1,3
31954,70,7378,11223;11506,12410,0,0,2,0,2
31955,70,7379,11217;14410,12410,0,0,2,0,2
31956,70,7380,10917;11030,12410,0,0,2,0,2
31957,70,7381,11475,12410,0,0,1,0,1
31958,70,7382,10929;11092,12410,0,0,2,0,2
31959,70,7383,10968;11312;16517,12410,0,0,3,0,3
31960,70,7384,11124;11467,12410,0,0,2,0,2
31961,70,7385,11422;11519;15865,12410,0,0,3,0,3
31962,70,7387,11220;11376,12410,0,0,2,0,2
31963,70,7388,11393;11613;15125,12410,0,0,3,0,3
31964,70,7389,11205;11549,12410,0,0,2,0,2
31965,70,7390,11262,12410,0,0,1,0,1
31966,70,7391,11263;11615,12410,0,0,2,0,2
31967,70,7392,11003;11265,12410,0,0,2,0,2
31968,70,7393,11686;11825,12410,0,0,2,0,2
31969,70,7394,11100;11313,12410,0,0,2,0,2
31970,70,7395,11327;11529;15211,12410,0,0,3,0,3
31971,70,7397,11113;11438,12410,0,0,2,0,2
31972,70,7399,11436;16188,12410,0,0,2,0,2
31973,70,7400,11452;14751;17166,12410,0,1,2,0,3
31974,70,7401,11382;11486,12410,0,0,2,0,2
31975,70,7402,11497;11598;16248,12410,0,0,3,0,3
31976,70,7403,11276;11503,12410,0,0,2,0,2
31977,70,7404,11611;11809,12410,0,0,2,0,2
31978,70,7405,11647;11660;15862,12410,0,0,3,0,3
31979,70,7407,11163;11687;15271;16036;16084,12410,0,0,5,0,5
31980,70,7408,11535;11589,12410,0,0,2,0,2
31981,70,7409,11302;11593,12410,0,0,2,0,2
31982,70,7418,2330,12775,0,0,0,1,1
31983,70,7424,7405,12775,0,0,0,1,1
31984,70,7425,6,12775,0,0,0,1,1
31985,70,7426,931;9572,12775,0,0,0,2,2
31986,70,7427,4229;7304,12775,0,0,0,2,2
31987,70,7429,7385,12775,0,0,0,1,1
31988,70,7430,181,12775,0,0,0,1,1
31989,70,7436,10338,12775,0,0,0,1,1
31990,70,7441,10470;10566;14770;15182,12775,0,0,2,2,4
31991,70,7445,10652;14116,12775,0,0,1,1,2
31992,70,7446,10346;10663;14533,12775,0,0,1,2,3
31993,70,7447,10737,12775,0,0,1,0,1
31994,70,7449,10583;10660;15376,12775,0,0,1,2,3
31995,70,7450,11081;11236,12775,0,0,2,0,2
31996,70,7451,10781;11266,12775,0,0,2,0,2
31997,70,7452,11428;11570;14826;15574;15967;16670,12775,0,1,5,0,6
31998,70,7453,10980;11160,12775,0,0,2,0,2
31999,70,7454,11085,12775,0,0,1,0,1
32000,70,7455,11283,12775,0,0,1,0,1
32001,70,7456,11107,12775,0,0,1,0,1
32002,70,7457,11108;11563,12775,0,0,2,0,2
32003,70,7459,11138;15068,12775,0,0,2,0,2
32004,70,7461,11210;11902;15591;17335,12775,0,1,3,0,4
32005,70,7462,11253;11448;15392,12775,0,0,3,0,3
32006,70,7464,11199;11272;15165,12775,0,0,3,0,3
32007,70,7465,11654;11759;14844,12775,0,0,3,0,3
32008,70,7466,11096;11461,12775,0,0,2,0,2
32009,70,7467,11901;16525,12775,0,0,2,0,2
32010,70,7468,11345;11639,12775,0,0,2,0,2
32011,70,7469,11361;11693,12775,0,0,2,0,2
32012,70,7470,11619;11813;14543,12775,0,0,3,0,3
32013,70,7471,11380;11920;15459;16496,12775,0,0,4,0,4
32014,70,7472,11397;11522;14938,12775,0,0,3,0,3
32015,70,7473,11370;11651;16003,12775,0,0,3,0,3
32016,70,7475,11404;11969;15601;16237,12775,0,0,4,0,4
32017,70,7476,11386;11411,12775,0,0,2,0,2
32018,70,7477,11252;11431;15312,12775,0,0,3,0,3
32019,70,7478,11928;16266,12775,0,0,2,0,2
32020,70,7479,11491;11662;15164,12775,0,0,3,0,3
32021,70,7480,11488;11500,12775,0,0,2,0,2
32022,70,7482,11505;11509,12775,0,0,2,0,2
32023,70,7484,11511;11707;15481;15756;16712,12775,0,1,4,0,5
32024,70,7485,11514;12025;15389,12775,0,0,3,0,3
32025,70,7486,11330;11614,12775,0,0,2,0,2
32026,70,7487,11724;11741;14931,12775,0,0,3,0,3
32027,70,7488,11740;11832;15163;15820,12775,0,0,4,0,4
32028,70,7489,11360;11640;15522;16263,12775,0,0,4,0,4
32029,70,7490,11804;14109;15946,12775,0,0,3,0,3
32030,70,7491,11683,12775,0,0,1,0,1
32031,70,7496,1352,13140,0,0,0,1,1
32032,70,7498,5087;6637,13140,0,0,0,2,2
32033,70,7509,1586,13140,0,0,0,1,1
32034,70,7511,10087;10343,13140,0,0,0,2,2
32035,70,7512,218,13140,0,0,0,1,1
32036,70,7518,10689,13140,0,0,0,1,1
32037,70,7519,10525;11044;14830,13140,0,0,2,1,3
32038,70,7520,10680;10876,13140,0,0,1,1,2
32039,70,7522,10667;11071;15267,13140,0,0,2,1,3
32040,70,7523,10863;11182;16140,13140,0,0,3,0,3
32041,70,7524,10607;10708,13140,0,0,1,1,2
32042,70,7525,10340;10740,13140,0,0,1,1,2
32043,70,7527,10830;10837;16311,13140,0,0,3,0,3
32044,70,7529,10433;10920,13140,0,0,1,1,2
32045,70,7530,11014;11190,13140,0,0,2,0,2
32046,70,7531,11022;11151;14405,13140,0,0,3,0,3
32047,70,7532,11226,13140,0,0,1,0,1
32048,70,7534,11078;11443,13140,0,0,2,0,2
32049,70,7535,11161;11425;16040,13140,0,0,3,0,3
32050,70,7536,11167;11407;15620,13140,0,0,3,0,3
32051,70,7537,11173;11684;15654,13140,0,0,3,0,3
32052,70,7538,10492;11176,13140,0,0,1,1,2
32053,70,7539,11038;11180;15804;16748,13140,0,1,3,0,4
32054,70,7540,11479,13140,0,0,1,0,1
32055,70,7541,11696;11752;15279;15514;16387,13140,0,0,5,0,5
32056,70,7542,11237,13140,0,0,1,0,1
32057,70,7543,11291;11498;15371,13140,0,0,3,0,3
32058,70,7544,11042;11311,13140,0,0,2,0,2
32059,70,7545,10698;11097,13140,0,0,2,0,2
32060,70,7546,10962;11341;14957,13140,0,0,3,0,3
32061,70,7548,11420;11889;16717,13140,0,1,2,0,3
32062,70,7550,11918;15538,13140,0,0,2,0,2
32063,70,7551,11466;11480,13140,0,0,2,0,2
32064,70,7552,11625;11879;14776,13140,0,0,3,0,3
32065,70,7553,11017;11504;14736;16423,13140,0,0,4,0,4
32066,70,7554,11507,13140,0,0,1,0,1
32067,70,7555,11304;11512,13140,0,0,2,0,2
32068,70,7556,12003;15240;15630,13140,0,0,3,0,3
32069,70,7557,11551;11980;14366;16623;16825,13140,0,2,3,0,5
32070,70,7558,11187;11559;15586,13140,0,0,3,0,3
32071,70,7559,11567;11938,13140,0,0,2,0,2
32072,70,7560,11414;11579;15465;16174,13140,0,0,4,0,4
32073,70,7561,11595,13140,0,0,1,0,1
32074,70,7562,11446;11616;15684,13140,0,0,3,0,3
32075,70,7563,11803;12068;16775,13140,0,1,2,0,3
32076,70,7564,11398;11721,13140,0,0,2,0,2
32077,70,7565,11629;11657;14792,13140,0,0,3,0,3
32078,70,7567,11691;11700;15121,13140,0,0,3,0,3
32079,70,7568,12086;15234;15994,13140,0,0,3,0,3
32080,70,7569,11712;11887;15799,13140,0,0,3,0,3
32081,70,7570,11650;11742;16690,13140,0,1,2,0,3
32082,70,7571,11763;11878;15254;16274,13140,0,0,4,0,4
32083,70,7572,11325;11783,13140,0,0,2,0,2
32084,70,7573,11665;11800;15455,13140,0,0,3,0,3
32085,70,7578,1655,13505,0,0,0,1,1
32086,70,7580,2176,13505,0,0,0,1,1
32087,70,7589,6936;7216,13505,0,0,0,2,2
32088,70,7590,5504,13505,0,0,0,1,1
32089,70,7598,1653;9818,13505,0,0,0,2,2
32090,70,7601,9431,13505,0,0,0,1,1
32091,70,7607,10302;10387;15231,13505,0,0,1,2,3
32092,70,7608,10273;10653,13505,0,0,0,2,2
32093,70,7615,10729;11115,13505,0,0,2,0,2
32094,70,7617,10686;10725;15797,13505,0,0,2,1,3
32095,70,7618,10724,13505,0,0,1,0,1
32096,70,7619,10726;11364,13505,0,0,2,0,2
32097,70,7621,10814,13505,0,0,1,0,1
32098,70,7624,11419;11795;15829;16017,13505,0,0,4,0,4
32099,70,7625,10882;11239,13505,0,0,2,0,2
32100,70,7626,11317;11760;15925,13505,0,0,3,0,3
32101,70,7627,11354;11703,13505,0,0,2,0,2
32102,70,7628,11622;11863;16328,13505,0,0,3,0,3
32103,70,7629,11421;11585,13505,0,0,2,0,2
32104,70,7630,11627;11788;16112;16260,13505,0,0,4,0,4
32105,70,7631,11439,13505,0,0,1,0,1
32106,70,7632,11935;15741,13505,0,0,2,0,2
32107,70,7633,11576;11666;15607;16601,13505,0,0,4,0,4
32108,70,7634,11848;15320,13505,0,0,2,0,2
32109,70,7635,11456;11471;16795,13505,0,1,2,0,3
32110,70,7636,11473;12053;15965,13505,0,0,3,0,3
32111,70,7637,10987;11474;14734;15042;16836,13505,0,1,4,0,5
32112,70,7638,11476;11638,13505,0,0,2,0,2
32113,70,7639,11485;11492;16161,13505,0,0,3,0,3
32114,70,7640,11523;11842;14570,13505,0,0,3,0,3
32115,70,7641,11094;11357;16442,13505,0,0,3,0,3
32116,70,7642,11796;15806,13505,0,0,2,0,2
32117,70,7643,11828;11876;14850,13505,0,0,3,0,3
32118,70,7644,11603;12111;15357,13505,0,0,3,0,3
32119,70,7645,11817;11944;16510;16982,13505,0,1,3,0,4
32120,70,7646,11489;11644;14773,13505,0,0,3,0,3
32121,70,7647,11774;11886,13505,0,0,2,0,2
32122,70,7648,11698;15608,13505,0,0,2,0,2
32123,70,7649,11726;12069;15046;17033,13505,0,1,3,0,4
32124,70,7650,12087;15396,13505,0,0,2,0,2
32125,70,7651,11877;14870;15832,13505,0,0,3,0,3
32126,70,7652,11470;11734;16277,13505,0,0,3,0,3
32127,70,7653,11750;12274;16786,13505,0,1,2,0,3
32128,70,7654,11762;11778;16685,13505,0,1,2,0,3
32129,70,7655,11769;14926;15893,13505,0,0,3,0,3
32130,70,7656,11771;12023;16093,13505,0,0,3,0,3
32131,70,7657,11953;12135,13505,0,0,2,0,2
32132,70,7658,11656;11808;15379,13505,0,0,3,0,3
32133,70,7659,11678;11815;16249;16999,13505,0,1,3,0,4
32134,70,7660,11833;11999;15694;16019,13505,0,0,4,0,4
32135,70,7661,11620;11834;15327;16835,13505,0,1,3,0,4
32136,70,7663,11855;11981,13505,0,0,2,0,2
32137,70,7664,11868;12175;16558;17053,13505,0,1,3,0,4
32138,70,7665,11982;12029,13505,0,0,2,0,2
32139,70,7666,12067;17301,13505,0,1,1,0,2
32140,70,7667,11545;11966;15264,13505,0,0,3,0,3
32141,70,7672,6275;14838,13870,0,0,1,1,2
32142,70,7682,5390,13870,0,0,0,1,1
32143,70,7691,5787,13870,0,0,0,1,1
32144,70,7692,6947;7382,13870,0,0,0,2,2
32145,70,7693,1889,13870,0,0,0,1,1
32146,70,7694,13,13870,0,0,0,1,1
32147,70,7695,3872,13870,0,0,0,1,1
32148,70,7698,348,13870,0,0,0,1,1
32149,70,7700,952,13870,0,0,0,1,1
32150,70,7702,1883,13870,0,0,0,1,1
32151,70,7703,10856,13870,0,0,1,0,1
32152,70,7704,10422;10552,13870,0,0,0,2,2
32153,70,7706,10697;10963;14954;15512,13870,0,0,4,0,4
32154,70,7707,10900;11065,13870,0,0,2,0,2
32155,70,7708,10162;10715,13870,0,0,1,1,2
32156,70,7711,10335;10829,13870,0,0,1,1,2
32157,70,7712,11101;11557;15173;15517;15825,13870,0,0,5,0,5
32158,70,7713,10641;10855;15317,13870,0,0,2,1,3
32159,70,7717,11632;11655;16032,13870,0,0,3,0,3
32160,70,7719,11114;11963;15730,13870,0,0,3,0,3
32161,70,7720,11402;15115;15659;16220,13870,0,0,4,0,4
32162,70,7721,11127;11245,13870,0,0,2,0,2
32163,70,7722,11538;11737;16292,13870,0,0,3,0,3
32164,70,7723,11001;11171;15656;16135,13870,0,0,4,0,4
32165,70,7725,11427;11618,13870,0,0,2,0,2
32166,70,7726,11314,13870,0,0,1,0,1
32167,70,7727,11338;11607,13870,0,0,2,0,2
32168,70,7728,11355;11385;16123,13870,0,0,3,0,3
32169,70,7729,11568;11609,13870,0,0,2,0,2
32170,70,7730,11729;11905;15077;16015,13870,0,0,4,0,4
32171,70,7731,11177;11499;15288;16041,13870,0,0,4,0,4
32172,70,7732,11674;11996;15792;16268,13870,0,0,4,0,4
32173,70,7733,11524;14853,13870,0,0,2,0,2
32174,70,7734,11530;11914;16231;16507,13870,0,0,4,0,4
32175,70,7735,11592;11628;16022,13870,0,0,3,0,3
32176,70,7736,11300;11728;15285;16062,13870,0,0,4,0,4
32177,70,7737,12085;15624;16203,13870,0,0,3,0,3
32178,70,7738,11641;11821;15828,13870,0,0,3,0,3
32179,70,7739,11645;11731;16750,13870,0,1,2,0,3
32180,70,7740,11658,13870,0,0,1,0,1
32181,70,7741,11679;16056;16454,13870,0,0,3,0,3
32182,70,7742,11532;11690;15691;16342,13870,0,0,4,0,4
32183,70,7744,11701;11792;16524;17001,13870,0,1,3,0,4
32184,70,7745,11732;12042;16107,13870,0,0,3,0,3
32185,70,7746,11739;11775;16163,13870,0,0,3,0,3
32186,70,7747,11779;16591,13870,0,0,2,0,2
32187,70,7748,12170;12302;15727;16337;17028,13870,0,1,4,0,5
32188,70,7749,11806;12114,13870,0,0,2,0,2
32189,70,7750,11502;11743,13870,0,0,2,0,2
32190,70,7751,11764;11924,13870,0,0,2,0,2
32191,70,7752,11843;12019;14601,13870,0,0,3,0,3
32192,70,7753,11069;11869;14501;16048;16386,13870,0,0,5,0,5
32193,70,7754,11856;12204;15999,13870,0,0,3,0,3
32194,70,7755,11709;11835;16440,13870,0,0,3,0,3
32195,70,7756,11723;11881;14980;16114,13870,0,0,4,0,4
32196,70,7757,11406;11704;16896,13870,0,1,2,0,3
32197,70,7758,11661;11906;15919,13870,0,0,3,0,3
32198,70,7759,11908;12203;15080;15921,13870,0,0,4,0,4
32199,70,7760,11930;12014,13870,0,0,2,0,2
32200,70,7761,11940;12043;15570,13870,0,0,3,0,3
32201,70,7762,11606;11941;15126,13870,0,0,3,0,3
32202,70,7763,11922;11945;15039;15353;16988,13870,0,1,4,0,5
32203,70,7764,11845;12308;15531;15884,13870,0,0,4,0,4
32204,70,7765,11699;14944;16393;16494,13870,0,0,4,0,4
32205,70,7766,12015;12098;16259,13870,0,0,3,0,3
32206,70,7767,65;3849,14235,0,0,0,2,2
32207,70,7768,7141,14235,0,0,0,1,1
32208,70,7772,5962;8854,14235,0,0,0,2,2
32209,70,7777,2203,14235,0,0,0,1,1
32210,70,7787,6761,14235,0,0,0,1,1
32211,70,7789,6054,14235,0,0,0,1,1
32212,70,7793,8040,14235,0,0,0,1,1
32213,70,7798,2247;9740,14235,0,0,0,2,2
32214,70,7799,10129,14235,0,0,0,1,1
32215,70,7807,10581;10746;14860,14235,0,0,2,1,3
32216,70,7809,10522,14235,0,0,0,1,1
32217,70,7810,10673;10913;15366,14235,0,0,2,1,3
32218,70,7812,10939;11082;16504,14235,0,0,3,0,3
32219,70,7813,10923;11221,14235,0,0,2,0,2
32220,70,7814,10499;10774;15078;15781,14235,0,0,3,1,4
32221,70,7816,11129;14827,14235,0,0,2,0,2
32222,70,7817,11463;14880;15734,14235,0,0,3,0,3
32223,70,7819,11191;15330,14235,0,0,2,0,2
32224,70,7820,11450;14653,14235,0,0,2,0,2
32225,70,7821,11111;11164;15096,14235,0,0,3,0,3
32226,70,7822,11322;11484;14988,14235,0,0,3,0,3
32227,70,7823,11757;12052;15513,14235,0,0,3,0,3
32228,70,7824,11340;11591;14985,14235,0,0,3,0,3
32229,70,7825,10757;11342;15867,14235,0,0,3,0,3
32230,70,7826,11250;11371;15198;15776,14235,0,0,4,0,4
32231,70,7827,11401,14235,0,0,1,0,1
32232,70,7828,11565;11574;15751;16390,14235,0,0,4,0,4
32233,70,7829,11169;11513;15553,14235,0,0,3,0,3
32234,70,7830,11373;11464;14848,14235,0,0,3,0,3
32235,70,7831,11910;15208;16028;16828,14235,0,1,3,0,4
32236,70,7832,12137;15905,14235,0,0,2,0,2
32237,70,7833,12234;16385;16639,14235,0,1,2,0,3
32238,70,7834,11993;12080,14235,0,0,2,0,2
32239,70,7835,11716;12326;14896;16039;16405;17098,14235,0,1,5,0,6
32240,70,7836,11719;11965,14235,0,0,2,0,2
32241,70,7838,12352;12424;14975,14235,0,0,3,0,3
32242,70,7839,11755;12144;15364;15856;16193,14235,0,0,5,0,5
32243,70,7840,15370,14235,0,0,1,0,1
32244,70,7841,11631;11900;15409;15880;16045;16411,14235,0,0,6,0,6
32245,70,7842,11776;12008,14235,0,0,2,0,2
32246,70,7843,11437;11799;15992,14235,0,0,3,0,3
32247,70,7844,11874;12142;17177,14235,0,1,2,0,3
32248,70,7845,11836;12126;15147,14235,0,0,3,0,3
32249,70,7846,11860;12357;15190,14235,0,0,3,0,3
32250,70,7847,12105;15871;16238,14235,0,0,3,0,3
32251,70,7848,11688;11971;14716;15605;15976,14235,0,0,5,0,5
32252,70,7849,11894;11975;15773,14235,0,0,3,0,3
32253,70,7850,11870;15644,14235,0,0,2,0,2
32254,70,7851,11990;12331,14235,0,0,2,0,2
32255,70,7852,12009;12223;15415;16079;16731,14235,0,1,4,0,5
32256,70,7853,12018;12272;15367;15833;16380;17435,14235,0,1,5,0,6
32257,70,7854,11853;12151;14846,14235,0,0,3,0,3
32258,70,7855,12149;15697,14235,0,0,2,0,2
32259,70,7857,12073;12305;16052;16686,14235,0,1,3,0,4
32260,70,7858,11673;12075;15875,14235,0,0,3,0,3
32261,70,7859,12208;17220,14235,0,1,1,0,2
32262,70,7860,11560;12117;14987;16302,14235,0,0,4,0,4
32263,70,7867,1535,14600,0,0,0,1,1
32264,70,7887,10200;15470,14600,0,0,1,1,2
32265,70,7892,10599;10985,14600,0,0,1,1,2
32266,70,7895,10556;10877,14600,0,0,1,1,2
32267,70,7898,11494;15403,14600,0,0,2,0,2
32268,70,7901,10956;11233;14790;14932,14600,0,0,4,0,4
32269,70,7902,10828;11046;15903,14600,0,0,3,0,3
32270,70,7904,11348;11668;15089,14600,0,0,3,0,3
32271,70,7905,10952;11365;14839;16191,14600,0,0,4,0,4
32272,70,7908,11396;11434;15701,14600,0,0,3,0,3
32273,70,7909,10845;11275;15777,14600,0,0,3,0,3
32274,70,7910,11487,14600,0,0,1,0,1
32275,70,7912,11590;11664,14600,0,0,2,0,2
32276,70,7913,11838;16037;16953,14600,0,1,2,0,3
32277,70,7914,11708;12076;16250,14600,0,0,3,0,3
32278,70,7915,11561;11675,14600,0,0,2,0,2
32279,70,7916,11610;11718;16067,14600,0,0,3,0,3
32280,70,7918,11927;16073;16813,14600,0,1,2,0,3
32281,70,7919,11717;12196,14600,0,0,2,0,2
32282,70,7920,11831;12378;16527,14600,0,0,3,0,3
32283,70,7921,11841;12340;15344,14600,0,0,3,0,3
32284,70,7922,11416;11849;14928;16158,14600,0,0,4,0,4
32285,70,7923,12022;12036,14600,0,0,2,0,2
32286,70,7924,11368;11896;15705,14600,0,0,3,0,3
32287,70,7925,11992;12167;16006,14600,0,0,3,0,3
32288,70,7926,11964;12040,14600,0,0,2,0,2
32289,70,7928,11967;12314;15987;16708,14600,0,1,3,0,4
32290,70,7929,11903;12489;15933;16297;16946,14600,0,1,4,0,5
32291,70,7930,11730;12001;16256;16843,14600,0,1,3,0,4
32292,70,7931,12161;16461,14600,0,0,2,0,2
32293,70,7932,11880;12031;15803,14600,0,0,3,0,3
32294,70,7933,12063;12202;16414,14600,0,0,3,0,3
32295,70,7934,12089;12100;14960;15133,14600,0,0,4,0,4
32296,70,7935,12091;15525;16184;16768,14600,0,1,3,0,4
32297,70,7936,12013;12092;16094,14600,0,0,3,0,3
32298,70,7937,12093;16429;16801,14600,0,1,2,0,3
32299,70,7938,12464;16441,14600,0,0,2,0,2
32300,70,7939,11947;12462;16949;17413,14600,0,2,2,0,4
32301,70,7940,12037;12116;15318;15451;15688,14600,0,0,5,0,5
32302,70,7941,12128;15590;15686;16882;17139,14600,0,2,3,0,5
32303,70,7942,12140;12147;15668;15877,14600,0,0,4,0,4
32304,70,7943,11830;12183;14909;16515,14600,0,0,4,0,4
32305,70,7944,11933;12155,14600,0,0,2,0,2
32306,70,7945,12449;15546;16531;17628,14600,0,1,3,0,4
32307,70,7946,11798;12141;15930;17219,14600,0,1,3,0,4
32308,70,7947,11846;12230;16409,14600,0,0,3,0,3
32309,70,7948,11946;12233,14600,0,0,2,0,2
32310,70,7949,12120;12240;16404,14600,0,0,3,0,3
32311,70,7950,12554;12658;15719;16774;18098,14600,1,1,3,0,5
32312,70,7961,8226,14965,0,0,0,1,1
32313,70,7962,6490;10160,14965,0,0,0,2,2
32314,70,7963,9351,14965,0,0,0,1,1
32315,70,7967,6819,14965,0,0,0,1,1
32316,70,7968,5970,14965,0,0,0,1,1
32317,70,7984,10574;10710,14965,0,0,1,1,2
32318,70,7986,10874;10908;15709,14965,0,0,3,0,3
32319,70,7987,11117;11394;16175,14965,0,0,3,0,3
32320,70,7989,10813;11076,14965,0,0,2,0,2
32321,70,7990,11162;11536;15087,14965,0,0,3,0,3
32322,70,7992,11192;11710;16571;16680,14965,0,1,3,0,4
32323,70,7993,11539;11573;15931,14965,0,0,3,0,3
32324,70,7994,11564;11604;15890,14965,0,0,3,0,3
32325,70,7995,10911;11553;15158;15399,14965,0,0,4,0,4
32326,70,7996,12239;12258;16438;17022,14965,0,1,3,0,4
32327,70,7997,11864,14965,0,0,1,0,1
32328,70,7998,11617;11943;16695,14965,0,1,2,0,3
32329,70,7999,11319;11612;16096,14965,0,0,3,0,3
32330,70,8000,11780;12317;16100,14965,0,0,3,0,3
32331,70,8001,11534;11801;16025,14965,0,0,3,0,3
32332,70,8002,11858;12493;15813;16005;16891,14965,0,1,4,0,5
32333,70,8003,11871;12730;16023;16667,14965,0,1,3,0,4
32334,70,8004,11847;11978;16410,14965,0,0,3,0,3
32335,70,8005,11818;12125;15393;16008;16535;16744,14965,0,1,5,0,6
32336,70,8006,11961;16726,14965,0,1,1,0,2
32337,70,8007,11973;12066;16682;16773,14965,0,2,2,0,4
32338,70,8008,11983;16382,14965,0,0,2,0,2
32339,70,8009,11985;12162;15535;17381,14965,0,1,3,0,4
32340,70,8010,11602;12107;16305,14965,0,0,3,0,3
32341,70,8011,12027;12131,14965,0,0,2,0,2
32342,70,8012,12207;12459;15169,14965,0,0,3,0,3
32343,70,8013,12217;12599;15588;17299,14965,0,1,3,0,4
32344,70,8014,12103;12221;16012,14965,0,0,3,0,3
32345,70,8015,12226;12353;15852;16172,14965,0,0,4,0,4
32346,70,8016,12256;16568;16749,14965,0,1,2,0,3
32347,70,8017,12264;12344;15657;16069;16348;18295,14965,1,0,5,0,6
32348,70,8018,12629;15791;17122;17389,14965,0,2,2,0,4
32349,70,8019,12286;12603,14965,0,0,2,0,2
32350,70,8020,12490;12665;14937;15716,14965,0,0,4,0,4
32351,70,8021,12596;14945;15782;16704,14965,0,1,3,0,4
32352,70,8022,12218;12435;16171;16310,14965,0,0,4,0,4
32353,70,8023,12118;12330;15932;16371,14965,0,0,4,0,4
32354,70,8024,12225;12648;16676;17073;17322,14965,0,3,2,0,5
32355,70,8025,12349;12756;16994;17194;18075,14965,1,2,2,0,5
32356,70,8026,12370;16608,14965,0,1,1,0,2
32357,70,8027,12303;12355,14965,0,0,2,0,2
32358,70,8028,3450,15330,0,0,0,1,1
32359,70,8029,686,15330,0,0,0,1,1
32360,70,8031,2339;10414,15330,0,0,0,2,2
32361,70,8032,3140,15330,0,0,0,1,1
32362,70,8042,7119,15330,0,0,0,1,1
32363,70,8043,7722,15330,0,0,0,1,1
32364,70,8045,6101,15330,0,0,0,1,1
32365,70,8046,9843,15330,0,0,0,1,1
32366,70,8054,57,15330,0,0,0,1,1
32367,70,8061,10858;15051,15330,0,0,2,0,2
32368,70,8063,10608;10823,15330,0,0,1,1,2
32369,70,8064,10634;15397,15330,0,0,1,1,2
32370,70,8067,10767,15330,0,0,1,0,1
32371,70,8068,10865,15330,0,0,1,0,1
32372,70,8069,10733;10940;15401,15330,0,0,3,0,3
32373,70,8071,10942;11193;15554,15330,0,0,3,0,3
32374,70,8072,10860;11166;15086;15537,15330,0,0,4,0,4
32375,70,8073,11569;11653,15330,0,0,2,0,2
32376,70,8075,11646;11663;15970,15330,0,0,3,0,3
32377,70,8076,11367;12146;16452;17047,15330,0,1,3,0,4
32378,70,8077,11390;11521;15157;15753;16427,15330,0,0,5,0,5
32379,70,8078,11823;15218;16046,15330,0,0,3,0,3
32380,70,8079,11418;11454;15065;15901,15330,0,0,4,0,4
32381,70,8080,11490;16316,15330,0,0,2,0,2
32382,70,8081,11445;11510;15536;15708;16862,15330,0,1,4,0,5
32383,70,8082,11594;12044;15118;15244;16424;16762,15330,0,1,5,0,6
32384,70,8083,11260;11575;15498;15850,15330,0,0,4,0,4
32385,70,8084,11621;12219;16610,15330,0,1,2,0,3
32386,70,8085,11659;15154,15330,0,0,2,0,2
32387,70,8086,11839;11915;15102;16957,15330,0,1,3,0,4
32388,70,8087,11301;11705,15330,0,0,2,0,2
32389,70,8088,11247;11785;15329,15330,0,0,3,0,3
32390,70,8089,11770;12254;16055,15330,0,0,3,0,3
32391,70,8090,11844;11968;15621;16703,15330,0,1,3,0,4
32392,70,8091,12048;15629;16289;17876,15330,0,1,3,0,4
32393,70,8092,11359;11558;15192;15759,15330,0,0,4,0,4
32394,70,8096,11789;11937;15737;16368,15330,0,0,4,0,4
32395,70,8097,11948;12403;16671;16902,15330,0,2,2,0,4
32396,70,8098,11747;11952;17209,15330,0,1,2,0,3
32397,70,8099,11958;15699;16156,15330,0,0,3,0,3
32398,70,8100,12174;12323;16993,15330,0,1,2,0,3
32399,70,8101,12028;12415;15778;16928;17141,15330,0,2,3,0,5
32400,70,8102,11932;16129,15330,0,0,2,0,2
32401,70,8103,11959;12050;16619;17683,15330,0,2,2,0,4
32402,70,8104,12060;15243,15330,0,0,2,0,2
32403,70,8106,12171;12488;16043,15330,0,0,3,0,3
32404,70,8107,12266;12284;15807;16437,15330,0,0,4,0,4
32405,70,8108,11888;12182;16604,15330,0,0,3,0,3
32406,70,8109,12220;12714;15479,15330,0,0,3,0,3
32407,70,8110,12224;12241;15548,15330,0,0,3,0,3
32408,70,8111,11677;12032,15330,0,0,2,0,2
32409,70,8112,12235;15963;16428,15330,0,0,3,0,3
32410,70,8113,12017;12139;16857;17016,15330,0,2,2,0,4
32411,70,8114,12297;12516;16306,15330,0,0,3,0,3
32412,70,8115,12801;16244;16803;17014,15330,0,2,2,0,4
32413,70,8116,11837;12374;16791;17135,15330,0,2,2,0,4
32414,70,8117,12397;12426;15805,15330,0,0,3,0,3
32415,70,8118,12690,15330,0,0,1,0,1
32416,70,8119,11974;12450;15232;15448;16560,15330,0,0,5,0,5
32417,70,8120,12115;12479;15352;16367;16895,15330,0,1,4,0,5
32418,70,8121,50;135,15695,0,0,0,2,2
32419,70,8122,829,15695,0,0,0,1,1
32420,70,8123,837,15695,0,0,0,1,1
32421,70,8126,7418,15695,0,0,0,1,1
32422,70,8127,8618,15695,0,0,0,1,1
32423,70,8128,6003,15695,0,0,0,1,1
32424,70,8130,6187,15695,0,0,0,1,1
32425,70,8131,6202,15695,0,0,0,1,1
32426,70,8135,3061,15695,0,0,0,1,1
32427,70,8139,10047,15695,0,0,0,1,1
32428,70,8148,10649;11118;15276;15473,15695,0,0,3,1,4
32429,70,8149,10474;10656;15690,15695,0,0,1,2,3
32430,70,8151,11429;15291;16307,15695,0,0,3,0,3
32431,70,8152,10933,15695,0,0,1,0,1
32432,70,8154,10971;11123,15695,0,0,2,0,2
32433,70,8155,11072;11413;15876,15695,0,0,3,0,3
32434,70,8156,11083;11219;16357,15695,0,0,3,0,3
32435,70,8157,11295,15695,0,0,1,0,1
32436,70,8161,11787;15301;16376,15695,0,0,3,0,3
32437,70,8163,11596;12026;15739;16719,15695,0,1,3,0,4
32438,70,8164,12188;16448,15695,0,0,2,0,2
32439,70,8165,11215;11600;15518,15695,0,0,3,0,3
32440,70,8166,11508;11766,15695,0,0,2,0,2
32441,70,8167,11802;12321;16162;16421;16663,15695,0,1,4,0,5
32442,70,8168,11892;11994;15599;15945,15695,0,0,4,0,4
32443,70,8169,11772;11909;16210;16705,15695,0,1,3,0,4
32444,70,8170,11955;12061;15683;16221,15695,0,0,4,0,4
32445,70,8171,12045;15383;15812;16985,15695,0,1,3,0,4
32446,70,8172,11912;11991;15603;16501,15695,0,0,4,0,4
32447,70,8173,12024,15695,0,0,1,0,1
32448,70,8174,12038;12071;15445;15663,15695,0,0,4,0,4
32449,70,8175,12253;12341;15934;16234;16724;17072,15695,0,2,4,0,6
32450,70,8176,12212;12318;17657,15695,0,1,2,0,3
32451,70,8177,12101;12566;16418;16972;17444,15695,0,2,3,0,5
32452,70,8178,12110;12546;15299;16687;17706,15695,0,2,3,0,5
32453,70,8179,12121;12481;15878;16110,15695,0,0,4,0,4
32454,70,8180,11824;12136,15695,0,0,2,0,2
32455,70,8182,12148;12316;15499;16651;16940,15695,0,2,3,0,5
32456,70,8183,12312;12350;15873;15953,15695,0,0,4,0,4
32457,70,8184,12736;12935;16983;17206,15695,0,2,2,0,4
32458,70,8185,12236;12387;16113;16294,15695,0,0,4,0,4
32459,70,8186,12267;12688;15333;15593;15847,15695,0,0,5,0,5
32460,70,8187,12090;12608;15764,15695,0,0,3,0,3
32461,70,8188,12319;12644;17736;18312,15695,1,1,2,0,4
32462,70,8189,12812;12836;15224;15509,15695,0,0,4,0,4
32463,70,8190,12359;12891;15640;16550;17200;18061,15695,1,1,4,0,6
32464,70,8191,12371;12755;16021;16755,15695,0,1,3,0,4
32465,70,8192,12536;15653;16280,15695,0,0,3,0,3
32466,70,8193,12311;12392;15412;16505,15695,0,0,4,0,4
32467,70,8194,12377;12684;15295;15900;16557;17753,15695,0,1,5,0,6
32468,70,8195,11826;12436;16627;16939,15695,0,2,2,0,4
32469,70,8196,12473;13241,15695,0,0,2,0,2
32470,70,8197,12529;12901;15382;15723,15695,0,0,4,0,4
32471,70,8198,12386;16320;16407;16577;16617,15695,0,1,4,0,5
32472,70,8199,12496;15995,15695,0,0,2,0,2
32473,70,8200,12414;12581;15471,15695,0,0,3,0,3
32474,70,8201,12815;12839;15643;16284;17540,15695,0,1,4,0,5
32475,70,8202,12304;12540;16911;18011,15695,0,2,2,0,4
32476,70,8203,12385;12559,15695,0,0,2,0,2
32477,70,8204,12432;16137;16396,15695,0,0,3,0,3
32478,70,8205,12635;13074;17407,15695,0,1,2,0,3
32479,70,8206,12586;12871;16961,15695,0,1,2,0,3
32480,70,8207,12499;12598;16029;16609,15695,0,1,3,0,4
32481,70,8208,12519;12604;16098;16761;17898,15695,0,2,3,0,5
32482,70,8209,12194;12617;16044;16592;16688;17085;17187;17645,15695,0,4,4,0,8
32483,70,8218,9735,16060,0,0,0,1,1
32484,70,8220,6421;8106,16060,0,0,0,2,2
32485,70,8221,9519,16060,0,0,0,1,1
32486,70,8226,397,16060,0,0,0,1,1
32487,70,8230,5743;10307,16060,0,0,0,2,2
32488,70,8231,10476,16060,0,0,0,1,1
32489,70,8233,10096,16060,0,0,0,1,1
32490,70,8237,10443;10736,16060,0,0,1,1,2
32491,70,8244,11293;11777;15740;16030,16060,0,0,4,0,4
32492,70,8246,11736;11791;15841;16859,16060,0,1,3,0,4
32493,70,8247,12210;12866;17090,16060,0,1,2,0,3
32494,70,8249,11649;12035;15966;16561,16060,0,0,4,0,4
32495,70,8251,12078;16105,16060,0,0,2,0,2
32496,70,8252,11098;16540,16060,0,0,2,0,2
32497,70,8253,11977;15516;16338;16542,16060,0,0,4,0,4
32498,70,8254,11957;12132;15950;16630,16060,0,1,3,0,4
32499,70,8255,11765;16251,16060,0,0,2,0,2
32500,70,8256,11784;11936;15627;16597,16060,0,0,4,0,4
32501,70,8257,11814;12021;16468;17344,16060,0,1,3,0,4
32502,70,8258,11867;12124;15519;16118;17002,16060,0,1,4,0,5
32503,70,8259,11794;15760;16402;16784,16060,0,1,3,0,4
32504,70,8262,12625;16495;16804,16060,0,1,2,0,3
32505,70,8263,11979;12720;15914;16211;16841,16060,0,1,4,0,5
32506,70,8264,11917;11989;15761;16709,16060,0,1,3,0,4
32507,70,8266,12056;12873;15840;16453;16499;16886;17390,16060,0,2,5,0,7
32508,70,8267,11714;11875;15943;16433,16060,0,0,4,0,4
32509,70,8268,12096;12294;15985;16616,16060,0,1,3,0,4
32510,70,8269,12495;12705;15438,16060,0,0,3,0,3
32511,70,8270,11872;11949;15490;16241;16920,16060,0,1,4,0,5
32512,70,8271,12010;12129,16060,0,0,2,0,2
32513,70,8272,11636;12184;16145,16060,0,0,3,0,3
32514,70,8273,12005;12195;16082,16060,0,0,3,0,3
32515,70,8275,12231;15502;16293,16060,0,0,3,0,3
32516,70,8276,12260;16004;17433,16060,0,1,2,0,3
32517,70,8277,12296;12434;16164,16060,0,0,3,0,3
32518,70,8278,12619;12745;15358;16631;17326,16060,0,2,3,0,5
32519,70,8279,12289;12367;15898;16479,16060,0,0,4,0,4
32520,70,8280,12407;16009;16730,16060,0,1,2,0,3
32521,70,8281,12384;13097;16518,16060,0,0,3,0,3
32522,70,8282,12889;12963;16975,16060,0,1,2,0,3
32523,70,8283,12600;12735;17005;17244,16060,0,2,2,0,4
32524,70,8284,12420;12517;15747;16819,16060,0,1,3,0,4
32525,70,8285,12238;12427;15744;16456,16060,0,0,4,0,4
32526,70,8286,12206;12460;16545,16060,0,0,3,0,3
32527,70,8287,12541;12719;16148;16431;16661;16783;18113;18311,16060,2,2,4,0,8
32528,70,8288,12368;12579;16399;16765;17368,16060,0,2,3,0,5
32529,70,8289,12227;12411;15458;16013;16230;16990,16060,0,1,5,0,6
32530,70,8290,12620;12791;16564;17050,16060,0,1,3,0,4
32531,70,8291,12113;12615;15802;16325;16657,16060,0,1,4,0,5
32532,70,8292,12623;12776;15713;15918;16485,16060,0,0,5,0,5
32533,70,8293,12662;12825;16915,16060,0,1,2,0,3
32534,70,8294,12416;16215;16714;17217,16060,0,2,2,0,4
32535,70,8295,12685;12693;16747;17373,16060,0,2,2,0,4
32536,70,8297,12652;12698;16863,16060,0,1,2,0,3
32537,70,8298,13084;16276;18397,16060,1,0,2,0,3
32538,70,8300,12718;15452;16728,16060,0,1,2,0,3
32539,70,8301,12257;12729;16109;16905,16060,0,1,3,0,4
32540,70,8302,11865;12737;15859;16615,16060,0,1,3,0,4
32541,70,8303,5805,16425,0,0,0,1,1
32542,70,8308,6102,16425,0,0,0,1,1
32543,70,8312,2027;6641,16425,0,0,0,2,2
32544,70,8315,6675,16425,0,0,0,1,1
32545,70,8316,3,16425,0,0,0,1,1
32546,70,8318,7550,16425,0,0,0,1,1
32547,70,8320,10006;10465,16425,0,0,0,2,2
32548,70,8327,10554;11146;16576,16425,0,0,2,1,3
32549,70,8333,10872;10875;16020,16425,0,0,3,0,3
32550,70,8336,11000;11333;15935;16213,16425,0,0,4,0,4
32551,70,8338,11483;12059;16099;16570,16425,0,0,4,0,4
32552,70,8339,11537;11642;15559,16425,0,0,3,0,3
32553,70,8340,11542;15693;16225,16425,0,0,3,0,3
32554,70,8341,11671;15541;15909,16425,0,0,3,0,3
32555,70,8342,12057;16955;17152,16425,0,2,1,0,3
32556,70,8345,12030;12281;16205;16625;17162,16425,0,2,3,0,5
32557,70,8347,12047;16239;16648,16425,0,1,2,0,3
32558,70,8348,12130;12269;15618;15793;16820,16425,0,1,4,0,5
32559,70,8349,12199;12851;15887;16178;16270,16425,0,0,5,0,5
32560,70,8350,12064;12228;16473,16425,0,0,3,0,3
32561,70,8351,12242;12820;16718;16978;17173,16425,0,3,2,0,5
32562,70,8352,12640;12646;16420;16815;17677,16425,0,2,3,0,5
32563,70,8353,12255;12497;16488;17020,16425,0,1,3,0,4
32564,70,8354,12166;12307;16654,16425,0,1,2,0,3
32565,70,8355,12846;13154,16425,0,0,2,0,2
32566,70,8356,13008;13130;16506;16675;17414,16425,0,2,3,0,5
32567,70,8357,12360;12446;15702;15997;16281;16697;16924;17148,16425,0,3,5,0,8
32568,70,8358,12160;12362;16240;16658,16425,0,1,3,0,4
32569,70,8359,12395;12829;15957;16528,16425,0,0,4,0,4
32570,70,8360,12412;12792;16209;16434;16534;17164,16425,0,1,5,0,6
32571,70,8361,12451;12834;16960,16425,0,1,2,0,3
32572,70,8362,12197;12521;16585;16722,16425,0,1,3,0,4
32573,70,8364,12534;12674;15672;15788;16451;17083;17230,16425,0,2,5,0,7
32574,70,8365,12859;16340,16425,0,0,2,0,2
32575,70,8366,12213;12550;15735;15980,16425,0,0,4,0,4
32576,70,8367,12511;12570;15639;15907,16425,0,0,4,0,4
32577,70,8368,12214;12575;15939;17035,16425,0,1,3,0,4
32578,70,8369,12453;12585;16470;16539,16425,0,0,4,0,4
32579,70,8370,12602;12639;16656;17224,16425,0,2,2,0,4
32580,70,8371,12854;16354;16992,16425,0,1,2,0,3
32581,70,8372,12630;12650;16102;16589;16823,16425,0,1,4,0,5
32582,70,8373,12626;12822;16640,16425,0,1,2,0,3
32583,70,8374,12973;16938;17386;18049,16425,1,2,1,0,4
32584,70,8375,12423;12974;16871,16425,0,1,2,0,3
32585,70,8376,12670;13379;15783;16465;16831,16425,0,1,4,0,5
32586,70,8377,12943;13198;16026;17783,16425,0,1,3,0,4
32587,70,8378,12738;12920;15493;16662;16907;17211,16425,0,3,3,0,6
32588,70,8379,12746;13048;16736;17201;17443;18219,16425,1,3,2,0,6
32589,70,8380,12417;12572;15923;16406,16425,0,0,4,0,4
32590,70,8381,12229;12761;17174,16425,0,1,2,0,3
32591,70,8382,12616;12780;17132;17583,16425,0,2,2,0,4
32592,70,8383,12954;13085;16721,16425,0,1,2,0,3
32593,70,8384,12396;12785;16080;16332;16860,16425,0,1,4,0,5
32594,70,8385,12786;15646,16425,0,0,2,0,2
32595,70,8386,12788;13004;15991;16141;16439;16974,16425,0,1,5,0,6
32596,70,8387,12743;12790;15842,16425,0,0,3,0,3
32597,70,8388,12518;12802;17017;17489,16425,0,2,2,0,4
32598,70,8389,13264;15704;16063,16425,0,0,3,0,3
32599,70,8390,12864;15796;15911;16290;16941;17864,16425,0,2,4,0,6
32600,70,8391,390,16790,0,0,0,1,1
32601,70,8397,4828,16790,0,0,0,1,1
32602,70,8399,5572,16790,0,0,0,1,1
32603,70,8402,7596,16790,0,0,0,1,1
32604,70,8404,5521,16790,0,0,0,1,1
32605,70,8406,10107;10287,16790,0,0,0,2,2
32606,70,8409,10440;10738,16790,0,0,1,1,2
32607,70,8411,10606;10748,16790,0,0,1,1,2
32608,70,8412,10692;10944,16790,0,0,1,1,2
32609,70,8419,11125;11324;15611;15974,16790,0,0,4,0,4
32610,70,8421,11725;11816;16202,16790,0,0,3,0,3
32611,70,8425,11426;11624;16101,16790,0,0,3,0,3
32612,70,8426,11702;12293;16643,16790,0,1,2,0,3
32613,70,8428,11669;11722;17418,16790,0,1,2,0,3
32614,70,8429,11767;15817;16699,16790,0,1,2,0,3
32615,70,8430,11477;11866,16790,0,0,2,0,2
32616,70,8431,11793;12082;17110;17363,16790,0,2,2,0,4
32617,70,8433,12062;16638,16790,0,1,1,0,2
32618,70,8434,11852;12143;16492;16847,16790,0,1,3,0,4
32619,70,8435,11891;12285;15885,16790,0,0,3,0,3
32620,70,8437,12133;15698;16548,16790,0,0,3,0,3
32621,70,8438,11954;16700,16790,0,1,1,0,2
32622,70,8439,11754;11987;17202,16790,0,1,2,0,3
32623,70,8441,12150;12444;17215;17293,16790,0,2,2,0,4
32624,70,8442,12418;12713;16536,16790,0,0,3,0,3
32625,70,8443,12190;12605;16091;17415,16790,0,1,3,0,4
32626,70,8444,11676;12193;16157;16350,16790,0,0,4,0,4
32627,70,8445,12277;12328;15870;16352,16790,0,0,4,0,4
32628,70,8446,11854;12244;16149;16392,16790,0,0,4,0,4
32629,70,8447,12248;12642;16706;17119,16790,0,2,2,0,4
32630,70,8448,12185;12265;16075;16581,16790,0,0,4,0,4
32631,70,8449,12298;12351;16364,16790,0,0,3,0,3
32632,70,8450,12315;12667;16555;17419,16790,0,1,3,0,4
32633,70,8451,12332;12369;16538,16790,0,0,3,0,3
32634,70,8452,12376;13257;16833;17081,16790,0,2,2,0,4
32635,70,8453,12372;12380;16226,16790,0,0,3,0,3
32636,70,8454,12989;13150,16790,0,0,2,0,2
32637,70,8455,12104;12611;17420;17859,16790,0,2,2,0,4
32638,70,8456,12419;16509,16790,0,0,2,0,2
32639,70,8457,12439;12680;15602;15845;16790,16790,0,1,4,0,5
32640,70,8458,12158;12455;16053;16074,16790,0,0,4,0,4
32641,70,8459,12697;15958;16734;17461,16790,0,2,2,0,4
32642,70,8460,12501;12892;16929;17203,16790,0,2,2,0,4
32643,70,8461,12514;12573;16287,16790,0,0,3,0,3
32644,70,8463,12542;12981;16606;17112;17617,16790,0,2,3,0,5
32645,70,8464,13158;17684,16790,0,1,1,0,2
32646,70,8465,12324;12565;16977,16790,0,1,2,0,3
32647,70,8466,13029;13300;15732;16090;16498,16790,0,0,5,0,5
32648,70,8467,11962;12589;16374;16931,16790,0,1,3,0,4
32649,70,8468,12590;12681;15954;16212;16802,16790,0,1,4,0,5
32650,70,8469,12561;12686;16771,16790,0,1,2,0,3
32651,70,8470,13186;17916,16790,0,1,1,0,2
32652,70,8471,12382;12742;15762;17107,16790,0,1,3,0,4
32653,70,8472,12654;12775;17429,16790,0,1,2,0,3
32654,70,8473,12039;12803;17673,16790,0,1,2,0,3
32655,70,8474,12628;16727;17913,16790,0,2,1,0,3
32656,70,8475,12818;16192,16790,0,0,2,0,2
32657,70,8476,12830;12955;15960;17649;17843,16790,0,2,3,0,5
32658,70,8477,12609;12837;16372,16790,0,0,3,0,3
32659,70,8478,13057;16582;17532,16790,0,1,2,0,3
32660,70,8479,12597;12894;17059;17243;17845,16790,0,3,2,0,5
32661,70,8480,12364;12858;16086;16986;18608,16790,1,1,3,0,5
32662,70,8481,12430;12861;17190;17975,16790,0,2,2,0,4
32663,70,8482,12863;13293;15979;17095;17465,16790,0,2,3,0,5
32664,70,8483,12779;12905;15836;16314,16790,0,0,4,0,4
32665,70,8484,12879;13110;15707;16472;17078,16790,0,1,4,0,5
32666,70,8485,12886;13340;16613;16779;17094;18043,16790,0,4,2,0,6
32667,70,8486,12919;13371;17660;17703,16790,0,2,2,0,4
32668,70,8487,12527;12924;16088;16503;17350,16790,0,1,4,0,5
32669,70,8488,12927;13318;15725;16636,16790,0,1,3,0,4
32670,70,8489,12928;13363;15745,16790,0,0,3,0,3
32671,70,8490,12942;16829;17383,16790,0,2,1,0,3
32672,70,8491,13208;13283;15861;16641;17069,16790,0,2,3,0,5
32673,70,8492,12977;13210;16078;17729,16790,0,1,3,0,4
32674,70,8494,1770;8418,17155,0,0,0,2,2
32675,70,8495,6581,17155,0,0,0,1,1
32676,70,8496,1035,17155,0,0,0,1,1
32677,70,8498,3717,17155,0,0,0,1,1
32678,70,8499,8238,17155,0,0,0,1,1
32679,70,8506,5775;8553,17155,0,0,0,2,2
32680,70,8509,10175;10438,17155,0,0,0,2,2
32681,70,8514,10826,17155,0,0,1,0,1
32682,70,8516,11756;16467,17155,0,0,2,0,2
32683,70,8519,11264;16267,17155,0,0,2,0,2
32684,70,8521,12070;17207;17253,17155,0,2,1,0,3
32685,70,8523,11781;11926;16061,17155,0,0,3,0,3
32686,70,8524,11899;12020;15780,17155,0,0,3,0,3
32687,70,8525,11572;11695,17155,0,0,2,0,2
32688,70,8526,12119;15910;16514,17155,0,0,3,0,3
32689,70,8527,12127;12259;16200,17155,0,0,3,0,3
32690,70,8530,12156;12246,17155,0,0,2,0,2
32691,70,8531,12192;12855;17464;17720;17907,17155,0,3,2,0,5
32692,70,8532,12198;12509;15768;17039,17155,0,1,3,0,4
32693,70,8533,12205;12470;16070;16594;16698;16890,17155,0,2,4,0,6
32694,70,8534,12261;12270;16034;16165;16884,17155,0,1,4,0,5
32695,70,8535,12275;12715;16134;16398,17155,0,0,4,0,4
32696,70,8536,12280;12428;15851;16291,17155,0,0,4,0,4
32697,70,8537,11672;12079;16478;16745,17155,0,1,3,0,4
32698,70,8538,12348;12643;15790;16587,17155,0,0,4,0,4
32699,70,8539,12399;12532;16194;16652,17155,0,1,3,0,4
32700,70,8540,12152;16183;17204,17155,0,1,2,0,3
32701,70,8541,12292;12747;16436;17440,17155,0,1,3,0,4
32702,70,8542,12431;12712;16739;17298,17155,0,2,2,0,4
32703,70,8543,12770;17007;17285,17155,0,2,1,0,3
32704,70,8544,12465;12485;16677,17155,0,1,2,0,3
32705,70,8546,12671;12778;16760;17458,17155,0,2,2,0,4
32706,70,8547,12510;13465;15973;17075;17603,17155,0,2,3,0,5
32707,70,8548,12339;12537;16459,17155,0,0,3,0,3
32708,70,8549,12539;12733;16758,17155,0,1,2,0,3
32709,70,8550,12961;13230;16322;17526,17155,0,1,3,0,4
32710,70,8551,12245;12333;16796;17103,17155,0,2,2,0,4
32711,70,8553,12498;12906;16245;16635,17155,0,1,3,0,4
32712,70,8554,12622;13214;16622;16818;17011,17155,0,3,2,0,5
32713,70,8555,12180;12624;16408;17019,17155,0,1,3,0,4
32714,70,8556,12637;13050;16397,17155,0,0,3,0,3
32715,70,8557,12463;12678;16014;16278;16883,17155,0,1,4,0,5
32716,70,8558,12741;16227;16444;17430,17155,0,1,3,0,4
32717,70,8559,12700;13391;16463;17009;18127,17155,1,1,3,0,5
32718,70,8560,12610;12728;16626,17155,0,1,2,0,3
32719,70,8561,12734;13290;16580;18063,17155,1,0,3,0,4
32720,70,8562,12744;12967;16932;17003;17459,17155,0,3,2,0,5
32721,70,8563,12757;13204;17460,17155,0,1,2,0,3
32722,70,8564,12782;13265;16603;16757,17155,0,1,3,0,4
32723,70,8565,12806;12883;16584;16840;17773,17155,0,2,3,0,5
32724,70,8566,12813;13355;16076;16689,17155,0,1,3,0,4
32725,70,8567,13398;13579;17669;18123,17155,1,1,2,0,4
32726,70,8568,12915;13263;15969,17155,0,0,3,0,3
32727,70,8569,12476;12896;16391;16543,17155,0,0,4,0,4
32728,70,8570,12878;13159;16077;16679;16826;16959;17218,17155,0,4,3,0,7
32729,70,8571,12931;13170;17417;17935,17155,0,2,2,0,4
32730,70,8572,12932;13192;16880;18121,17155,1,1,2,0,4
32731,70,8573,12751;12934;16767;17068;17694,17155,0,3,2,0,5
32732,70,8574,12938;12990;17183;18500,17155,1,1,2,0,4
32733,70,8575,12930;12968;16295;16956,17155,0,1,3,0,4
32734,70,8576,12663;12960;16133;16224;16853;17719,17155,0,2,4,0,6
32735,70,8577,12592;12641;16400;16666;16877,17155,0,2,3,0,5
32736,70,8578,12972;13409;16445;16574,17155,0,0,4,0,4
32737,70,8579,13495;16381;16556;17756,17155,0,1,3,0,4
32738,70,8580,12997;16335,17155,0,0,2,0,2
32739,70,8581,12925;13020;16997,17155,0,1,2,0,3
32740,70,8582,12987;13028;16772;16943,17155,0,2,2,0,4
32741,70,8583,13039;13114;17038;17698;18199,17155,1,2,2,0,5
32742,70,8584,12739;13059;17030;17709;18091,17155,1,2,2,0,5
32743,70,8585,12772;13063;16742,17155,0,1,2,0,3
32744,70,8586,12951;13071;16042;16807,17155,0,1,3,0,4
32745,70,8587,13306,17155,0,0,1,0,1
32746,70,8588,12811;13133;16598;17539,17155,0,1,3,0,4
32747,70,8589,13107;13307;15795;16596;16824,17155,0,1,4,0,5
32748,70,8590,13135;13202;16930,17155,0,1,2,0,3
32749,70,8591,3834,17520,0,0,0,1,1
32750,70,8594,2840,17520,0,0,0,1,1
32751,70,8596,5901,17520,0,0,0,1,1
32752,70,8598,1152,17520,0,0,0,1,1
32753,70,8600,3155,17520,0,0,0,1,1
32754,70,8603,9365;10157,17520,0,0,0,2,2
32755,70,8607,136;10165,17520,0,0,0,2,2
32756,70,8608,447,17520,0,0,0,1,1
32757,70,8621,11634;11822;15936;16072,17520,0,0,4,0,4
32758,70,8623,11782;16308,17520,0,0,2,0,2
32759,70,8625,11516;11873,17520,0,0,2,0,2
32760,70,8627,11697;11851,17520,0,0,2,0,2
32761,70,8628,11995;12393;17021;17223;17456,17520,0,3,2,0,5
32762,70,8629,12051;12054;16236;16511;17481,17520,0,1,4,0,5
32763,70,8630,11635;12041;15983;16553,17520,0,0,4,0,4
32764,70,8631,12049;12421;16303;16817,17520,0,1,3,0,4
32765,70,8632,12764;16573;16614,17520,0,1,2,0,3
32766,70,8633,11744;12327;16634;16810,17520,0,2,2,0,4
32767,70,8634,12201;16365;16965,17520,0,1,2,0,3
32768,70,8635,11923;12034;16166;16443;16987,17520,0,1,4,0,5
32769,70,8636,12181;12263;16487,17520,0,0,3,0,3
32770,70,8637,12358;12363,17520,0,0,2,0,2
32771,70,8639,12438;12725;16586;16851;17343,17520,0,2,3,0,5
32772,70,8640,12814;16016;17351,17520,0,1,2,0,3
32773,70,8641,12799;13040;16812;16984,17520,0,2,2,0,4
32774,70,8643,12491;12838;16355;16856,17520,0,1,3,0,4
32775,70,8644,12282;12522;16565;17102,17520,0,1,3,0,4
32776,70,8645,12821;17225,17520,0,1,1,0,2
32777,70,8647,12549;16530;16660,17520,0,1,2,0,3
32778,70,8648,12562;13341;17312;17428;18607,17520,1,2,2,0,5
32779,70,8649,12576;12638;16208;17049,17520,0,1,3,0,4
32780,70,8650,12627;13252;16808;17151,17520,0,2,2,0,4
32781,70,8651,12283;12457;17116;17154,17520,0,2,2,0,4
32782,70,8652,12276;12655;16533;17057;17614,17520,0,2,3,0,5
32783,70,8653,12300;12709;17034;17346,17520,0,2,2,0,4
32784,70,8654,12771;12882;16373;17062;17432,17520,0,2,3,0,5
32785,70,8655,12890;13146;16962,17520,0,1,2,0,3
32786,70,8656,12515;12797;16214;17046;17473,17520,0,2,3,0,5
32787,70,8657,13181;16388;17150,17520,0,1,2,0,3
32788,70,8658,12848;15959;16583;16973,17520,0,1,3,0,4
32789,70,8659,13533;18147,17520,1,0,1,0,2
32790,70,8660,12909;13091;16546;16839,17520,0,1,3,0,4
32791,70,8661,12672;13313;17765;18006,17520,0,2,2,0,4
32792,70,8662,12914;13270;16370;17175,17520,0,1,3,0,4
32793,70,8663,12309;12936;17172;17410;17652,17520,0,3,2,0,5
32794,70,8664,13005;13609;16469;16674;17255,17520,0,2,3,0,5
32795,70,8665,13014;13176;15977;17348,17520,0,1,3,0,4
32796,70,8666,12758;12921;17412;18160,17520,1,1,2,0,4
32797,70,8667,13482;13612;15996;16333;17948,17520,0,1,4,0,5
32798,70,8668,12781;12996;16629;17452;17536,17520,0,3,2,0,5
32799,70,8669,13045;13550;18234,17520,1,0,2,0,3
32800,70,8670,13622;13632,17520,0,0,2,0,2
32801,70,8671,12808;13621;16187;17270;18003,17520,0,2,3,0,5
32802,70,8672,13076;13537;18104,17520,1,0,2,0,3
32803,70,8673,13087;13178;17157,17520,0,1,2,0,3
32804,70,8674,13160;13517;16142;16242,17520,0,0,4,0,4
32805,70,8675,13141;13394;16317;17291;17379,17520,0,2,3,0,5
32806,70,8676,13185;13268;16321;16605,17520,0,0,4,0,4
32807,70,8677,12994;13189;17602,17520,0,1,2,0,3
32808,70,8678,13023;13201;15998;17543;17810,17520,0,2,3,0,5
32809,70,8679,13205;13255;16106;16903;18002,17520,0,2,3,0,5
32810,70,8680,13231;13489;16235;17105;17137;17812,17520,0,3,3,0,6
32811,70,8683,1637,17885,0,0,0,1,1
32812,70,8684,9225,17885,0,0,0,1,1
32813,70,8686,6536,17885,0,0,0,1,1
32814,70,8687,7324,17885,0,0,0,1,1
32815,70,8690,4669,17885,0,0,0,1,1
32816,70,8691,988,17885,0,0,0,1,1
32817,70,8692,10072,17885,0,0,0,1,1
32818,70,8696,10297,17885,0,0,0,1,1
32819,70,8707,11241;16286;16723,17885,0,1,2,0,3
32820,70,8708,11305;11885;16415;16579,17885,0,0,4,0,4
32821,70,8710,11323;11682;16155,17885,0,0,3,0,3
32822,70,8712,11372;11811;16198;16339,17885,0,0,4,0,4
32823,70,8713,11315;11580;16707;16764,17885,0,2,2,0,4
32824,70,8714,11520;12122;16204;16590,17885,0,0,4,0,4
32825,70,8720,11758;12007;16196;16684;16792,17885,0,2,3,0,5
32826,70,8721,11827;12077;16966;17232,17885,0,2,2,0,4
32827,70,8722,11951;16143,17885,0,0,2,0,2
32828,70,8723,11543;11986;16139;17231,17885,0,1,3,0,4
32829,70,8726,12216;12721;16168;16914,17885,0,1,3,0,4
32830,70,8727,12329;12530;17184;17371;17963,17885,0,3,2,0,5
32831,70,8728,12237;12571;16466;16893;17169;17598,17885,0,3,3,0,6
32832,70,8729,12472;12577;16089;16696;16800,17885,0,2,3,0,5
32833,70,8730,12445;16159;16298,17885,0,0,3,0,3
32834,70,8733,13012;16673;16906,17885,0,2,1,0,3
32835,70,8734,12474;12475;16111;16541;17048;17378,17885,0,2,4,0,6
32836,70,8735,12055;12482;16232;16849,17885,0,1,3,0,4
32837,70,8736,12502;12970;16115;16282;16669;16830;17118;18077,17885,1,3,4,0,8
32838,70,8737,12558;12947;16814;17138,17885,0,2,2,0,4
32839,70,8739,12486;12632;16998;17391,17885,0,2,2,0,4
32840,70,8740,12862;16549;16844,17885,0,1,2,0,3
32841,70,8742,12404;12691;16195;16480,17885,0,0,4,0,4
32842,70,8743,12683;12717;16566;16805;17384,17885,0,2,3,0,5
32843,70,8744,13383,17885,0,0,1,0,1
32844,70,8745,12740;13123;15743;17130;17990,17885,0,2,3,0,5
32845,70,8746,12760;13068;16868;17997,17885,0,2,2,0,4
32846,70,8747,12823;12980;17546,17885,0,1,2,0,3
32847,70,8748,12766;12976;16383;16683,17885,0,1,3,0,4
32848,70,8749,12773;13184,17885,0,0,2,0,2
32849,70,8750,13062;13630;16366;16981;17699,17885,0,2,3,0,5
32850,70,8751,12887;13643;16740;17638,17885,0,2,2,0,4
32851,70,8752,12937;16247;16916,17885,0,1,2,0,3
32852,70,8754,12618;12975;16544;17472,17885,0,1,3,0,4
32853,70,8755,12099;12422;16794,17885,0,1,2,0,3
32854,70,8756,12991;13043;17766,17885,0,1,2,0,3
32855,70,8757,12992;13010;17406,17885,0,1,2,0,3
32856,70,8758,13017;13432;17881;18205,17885,1,1,2,0,4
32857,70,8759,13659;17556,17885,0,1,1,0,2
32858,70,8760,12944;13094;17591,17885,0,1,2,0,3
32859,70,8761,13112;13118;16462;17121,17885,0,1,3,0,4
32860,70,8762,13220;16301;16522;17434,17885,0,1,3,0,4
32861,70,8763,13121;13755;16120;17471,17885,0,1,3,0,4
32862,70,8764,12477;13131;17129;17676;17784,17885,0,3,2,0,5
32863,70,8765,13142;13602;16554;16921;17212;17862;18487,17885,1,3,3,0,7
32864,70,8766,13148;13403;18238,17885,1,0,2,0,3
32865,70,8767,12767;13155;18340,17885,1,0,2,0,3
32866,70,8768,12959;13174;16497;16781;17892,17885,0,2,3,0,5
32867,70,8769,13183;16811;17045,17885,0,2,1,0,3
32868,70,8770,12904;13195;16854,17885,0,1,2,0,3
32869,70,8771,13215;13647;18483,17885,1,0,2,0,3
32870,70,8772,13119;13483;16377;17486,17885,0,1,3,0,4
32871,70,8773,13242,17885,0,0,1,0,1
32872,70,8774,13073;13250;16336;16475;17416,17885,0,1,4,0,5
32873,70,8775,13018;13253;16228;16361;17960,17885,0,1,4,0,5
32874,70,8777,12907;13291;17193;17479,17885,0,2,2,0,4
32875,70,8778,13295;13395;16785;17161,17885,0,2,2,0,4
32876,70,8779,13299;13613;16288;17055;17239;17743,17885,0,3,3,0,6
32877,70,8780,13007;13303;17325;17725;18435,17885,1,2,2,0,5
32878,70,8781,13656;17695;18209,17885,1,1,1,0,3
32879,70,8782,13144;13309;16257;18528,17885,1,0,3,0,4
32880,70,8783,13310;13518;16858;17347;17554;18110,17885,1,3,2,0,6
32881,70,8784,13326;13468;17284;17557;18292,17885,1,2,2,0,5
32882,70,8785,13703;16081;17599;17858,17885,0,2,2,0,4
32883,70,8786,13417;13669;16460;17092;17392,17885,0,2,3,0,5
32884,70,8787,12706;13382;16691;16933;17238,17885,0,3,2,0,5
32885,70,8788,13320;13396;16323;16925;17755,17885,0,2,3,0,5
32886,70,8790,1630,18250,0,0,0,1,1
32887,70,8791,4851,18250,0,0,0,1,1
32888,70,8793,1314,18250,0,0,0,1,1
32889,70,8794,3234,18250,0,0,0,1,1
32890,70,8795,2964;5731,18250,0,0,0,2,2
32891,70,8796,7894,18250,0,0,0,1,1
32892,70,8797,9098;9418,18250,0,0,0,2,2
32893,70,8798,4748,18250,0,0,0,1,1
32894,70,8800,10117,18250,0,0,0,1,1
32895,70,8801,10131;10204,18250,0,0,0,2,2
32896,70,8815,11533;11582;16395;16672,18250,0,1,3,0,4
32897,70,8816,11517;11541;16664,18250,0,1,2,0,3
32898,70,8825,12084;16474;16632,18250,0,1,2,0,3
32899,70,8826,11347;11820;16199;16523,18250,0,0,4,0,4
32900,70,8829,11605;12004;16821;17117,18250,0,2,2,0,4
32901,70,8830,12074;12187;16255;16898,18250,0,1,3,0,4
32902,70,8832,12252;12336;16261;16874,18250,0,1,3,0,4
32903,70,8833,12338;12556;16861,18250,0,1,2,0,3
32904,70,8834,12247;12347;16254;16595,18250,0,0,4,0,4
32905,70,8835,12383;12452;16529;17091,18250,0,1,3,0,4
32906,70,8836,12186;12443;16600;16733,18250,0,1,3,0,4
32907,70,8837,12447;13324;17895;18050,18250,1,1,2,0,4
32908,70,8838,12016;12471;16272;16575;17077,18250,0,1,4,0,5
32909,70,8839,12398;12487;16842;17056;18254,18250,1,2,2,0,5
32910,70,8840,12334;12538;16422;16647,18250,0,1,3,0,4
32911,70,8841,12754;13569;17463;18141;18597,18250,2,1,2,0,5
32912,70,8842,12578;12881;17221;18076,18250,1,1,2,0,4
32913,70,8843,13126;17411;18004,18250,0,2,1,0,3
32914,70,8844,12668;13035;16447;17024;17899,18250,0,2,3,0,5
32915,70,8845,12689;13038;16838;17523,18250,0,2,2,0,4
32916,70,8846,12699;12749;16644;17274,18250,0,2,2,0,4
32917,70,8847,12704;12768;16346;16778,18250,0,1,3,0,4
32918,70,8848,12710;13420;16711;17010,18250,0,2,2,0,4
32919,70,8849,12325;12711;16319;17186,18250,0,1,3,0,4
32920,70,8850,12543;12986;17236,18250,0,1,2,0,3
32921,70,8851,12789;12800;16649;17120;17524,18250,0,3,2,0,5
32922,70,8852,12809;13469;17689,18250,0,1,2,0,3
32923,70,8853,12584;13053;16356;17476,18250,0,1,3,0,4
32924,70,8854,13470;16313;16607;17506;17814;18170;18445,18250,2,3,2,0,7
32925,70,8855,12884;13203;16834;17437,18250,0,2,2,0,4
32926,70,8856,12819;12958;17245,18250,0,1,2,0,3
32927,70,8857,12461;12966;17261;17782,18250,0,2,2,0,4
32928,70,8858,12983;13436;16216;17240;18226,18250,1,1,3,0,5
32929,70,8859,12872;13449;16416;16665;18549,18250,1,1,3,0,5
32930,70,8860,13022;17104,18250,0,1,1,0,2
32931,70,8861,12962;13026;16976;17179,18250,0,2,2,0,4
32932,70,8862,13032;16593;17467,18250,0,1,2,0,3
32933,70,8863,12950;13036;17307,18250,0,1,2,0,3
32934,70,8864,12867;13388;16650;16908;18300,18250,1,2,2,0,5
32935,70,8865,12979;13090;16797,18250,0,1,2,0,3
32936,70,8866,13088;13092;16351;16611;18493,18250,1,1,3,0,5
32937,70,8867,13021;13638;16345;17182,18250,0,1,3,0,4
32938,70,8868,12998;13129;16283;17044,18250,0,1,3,0,4
32939,70,8869,13137;13375;16588;16678;18323,18250,1,1,3,0,5
32940,70,8870,13217;13297;17192;17750,18250,0,2,2,0,4
32941,70,8871,13171;13688;16318,18250,0,0,3,0,3
32942,70,8872,12953;13161;17723,18250,0,1,2,0,3
32943,70,8873,13216;13655;16389;17228;17640,18250,0,2,3,0,5
32944,70,8874,13360;13428;16223;16493;18072;18495,18250,2,0,4,0,6
32945,70,8875,13249;13330;16996;17213,18250,0,2,2,0,4
32946,70,8876,13289;13294;17650,18250,0,1,2,0,3
32947,70,8877,12784;13361;17216;17431;17915,18250,0,3,2,0,5
32948,70,8878,13304;13311;17394,18250,0,1,2,0,3
32949,70,8879,12857;13339;17249;17512;18169,18250,1,2,2,0,5
32950,70,8880,13348;13899;16502;17252;17442;17606;17983,18250,0,4,3,0,7
32951,70,8881,13392;13660;17849,18250,0,1,2,0,3
32952,70,8882,13587;14058;16948;17502;17587,18250,0,3,2,0,5
32953,70,8883,13359;13943;16432;16754;16963;17040;18096,18250,1,3,3,0,7
32954,70,8884,13539;16537;17025;17257;17642;18466,18250,1,3,2,0,6
32955,70,8885,12547;13471;16219;17123,18250,0,1,3,0,4
32956,70,8886,12964;13472;16197;16394;17855,18250,0,1,4,0,5
32957,70,8887,13485;13851;16331;16846,18250,0,1,3,0,4
32958,70,8888,13774;13868;16285;17575;17866,18250,0,2,3,0,5
32959,70,8889,13493;14002;17353;17844,18250,0,2,2,0,4
32960,70,8890,12903;13523;16446;16646;17297;17803,18250,0,3,3,0,6
32961,70,8892,13329;13532;17292;18223,18250,1,1,2,0,4
32962,70,8895,89;6838,18615,0,0,0,2,2
32963,70,8896,6261,18615,0,0,0,1,1
32964,70,8906,11175;11408;17082,18615,0,1,2,0,3
32965,70,8908,11019;11178;16702,18615,0,1,2,0,3
32966,70,8912,11444;11897;17336;17656,18615,0,2,2,0,4
32967,70,8915,11749;16426;16620,18615,0,1,2,0,3
32968,70,8918,11882;12574;16520;16655,18615,0,1,3,0,4
32969,70,8919,11998;12727;16715;17036,18615,0,2,2,0,4
32970,70,8920,11680;12006;16425,18615,0,0,3,0,3
32971,70,8923,12046;12564;16867,18615,0,1,2,0,3
32972,70,8926,11578;12268;16349;16789;17454,18615,0,2,3,0,5
32973,70,8927,12191;12563;16516;16770,18615,0,1,3,0,4
32974,70,8928,12179;12366;16552;16751,18615,0,1,3,0,4
32975,70,8931,12798;12856;17235;17542,18615,0,2,2,0,4
32976,70,8932,12593;12726;16989;17214,18615,0,2,2,0,4
32977,70,8934,12911;13103;17569,18615,0,1,2,0,3
32978,70,8935,12178;12659;16937;17306,18615,0,2,2,0,4
32979,70,8936,12553;12679;16419;16476,18615,0,0,4,0,4
32980,70,8937,12696;13474;17180;18128,18615,1,1,2,0,4
32981,70,8939,12552;12777;16343,18615,0,0,3,0,3
32982,70,8940,12957;13209;17131;17633;17830,18615,0,3,2,0,5
32983,70,8941,12805;16995;17264,18615,0,2,1,0,3
32984,70,8942,13019;13266;17555,18615,0,1,2,0,3
32985,70,8943,12827;13246;16624;16922;17802;17951,18615,0,4,2,0,6
32986,70,8944,12732;12842;17385,18615,0,1,2,0,3
32987,70,8945,12523;12843;14379;16642;17805,18615,0,2,3,0,5
32988,70,8946,12847;16710;17949,18615,0,2,1,0,3
32989,70,8947,13070;17457;17841;18118,18615,1,2,1,0,4
32990,70,8948,12560;12908;17275;17969,18615,0,2,2,0,4
32991,70,8949,12865;12926;16822;17310,18615,0,2,2,0,4
32992,70,8950,12885;13666;16363,18615,0,0,3,0,3
32993,70,8951,11988;12978;17205;17485,18615,0,2,2,0,4
32994,70,8953,13002;13455;17140;18232,18615,1,1,2,0,4
32995,70,8954,13027;13169;16737;17490,18615,0,2,2,0,4
32996,70,8956,13047;13506;17388,18615,0,1,2,0,3
32997,70,8957,13075;13213;17840,18615,0,1,2,0,3
32998,70,8958,13109;13842;16384;17271;17447,18615,0,2,3,0,5
32999,70,8959,13134;13508;17188,18615,0,1,2,0,3
33000,70,8960,13163;13172;16378;17176;18259,18615,1,1,3,0,5
33001,70,8962,13175;13736;16471;17012;17319,18615,0,2,3,0,5
33002,70,8963,13191;13484;16947;17266;17733,18615,0,3,2,0,5
33003,70,8964,13408;14014;17679;17884,18615,0,2,2,0,4
33004,70,8965,13918;16482;17424;17887;18321,18615,1,2,2,0,5
33005,70,8966,13240;17251;17600;17940,18615,0,3,1,0,4
33006,70,8967,13254;13963;17404;17734;18527,18615,1,2,2,0,5
33007,70,8968,13006;13332;17364;17570;18485,18615,1,2,2,0,5
33008,70,8969,13337;13366;16457;16967,18615,0,1,3,0,4
33009,70,8970,13127;13343;16599;16729;17262,18615,0,2,3,0,5
33010,70,8971,13350;13354;17127;17402,18615,0,2,2,0,4
33011,70,8972,13067;13384;16653;17165;17470;18126,18615,1,3,2,0,6
33012,70,8973,13386;16369;16759;17234,18615,0,2,2,0,4
33013,70,8974,13407;18265,18615,1,0,1,0,2
33014,70,8976,13599;13663;17525;18272,18615,1,1,2,0,4
33015,70,8977,13752;13856;16970;17013,18615,0,2,2,0,4
33016,70,8978,14044;16559;16798;18175,18615,1,1,2,0,4
33017,70,8979,13054;13453,18615,0,0,2,0,2
33018,70,8980,13046;13511;16637;17332;17873,18615,0,3,2,0,5
33019,70,8981,13520;13778;16449;16725;17222;17571,18615,0,3,3,0,6
33020,70,8982,13545;13583;17282;17796,18615,0,2,2,0,4
33021,70,8983,13218;13554;17305;17769,18615,0,2,2,0,4
33022,70,8984,13269;13562;17066;18471,18615,1,1,2,0,4
33023,70,8985,13564;13704;16413,18615,0,0,3,0,3
33024,70,8986,13573;16353,18615,0,0,2,0,2
33025,70,8987,13025;13585;18281,18615,1,0,2,0,3
33026,70,8988,13616;16458;16864;17178;18065,18615,1,2,2,0,5
33027,70,8989,13784;13883;16435;17043,18615,0,1,3,0,4
33028,70,8990,14032;16401;16777;17071;17619;18060,18615,1,3,2,0,6
33029,70,8991,13629;13650;17357;17527;18362;18546,18615,2,2,2,0,6
33030,70,8992,13095;13637;16513;16980;17790,18615,0,2,3,0,5
33031,70,8993,13528;13644;17477;18097,18615,1,1,2,0,4
33032,70,8994,13563;13657;16746;17504;18547,18615,1,2,2,0,5
33033,70,8995,13194;13658;17058;17968;18469,18615,1,2,2,0,5
33034,70,8996,3136;9043,18980,0,0,0,2,2
33035,70,8998,4856,18980,0,0,0,1,1
33036,70,8999,4470,18980,0,0,0,1,1
33037,70,9000,3776;9722,18980,0,0,0,2,2
33038,70,9003,5027,18980,0,0,0,1,1
33039,70,9004,10057;10351,18980,0,0,0,2,2
33040,70,9005,1472,18980,0,0,0,1,1
33041,70,9006,4515,18980,0,0,0,1,1
33042,70,9007,10181,18980,0,0,0,1,1
33043,70,9008,10397;10572,18980,0,0,0,2,2
33044,70,9012,10734;11243,18980,0,0,2,0,2
33045,70,9017,11050;11335;16693,18980,0,1,2,0,3
33046,70,9020,11525,18980,0,0,1,0,1
33047,70,9023,11685,18980,0,0,1,0,1
33048,70,9024,11733;12163;16486;16732,18980,0,1,3,0,4
33049,70,9027,12108;12852;17099,18980,0,1,2,0,3
33050,70,9028,11805;12209,18980,0,0,2,0,2
33051,70,9029,11601;12173;16491;16900,18980,0,1,3,0,4
33052,70,9033,12153;12299;16500;16668,18980,0,1,3,0,4
33053,70,9034,11904;12322;16521;16845,18980,0,1,3,0,4
33054,70,9036,12391;12917;16991;17259,18980,0,2,2,0,4
33055,70,9037,12400;12893;16572;16735;16885;17647,18980,0,3,3,0,6
33056,70,9038,12401;12985;17146;17462;17775,18980,0,3,2,0,5
33057,70,9039,12508;16481,18980,0,0,2,0,2
33058,70,9040,12548;13244;16484;16776;17337,18980,0,2,3,0,5
33059,70,9041,13258;17621,18980,0,1,1,0,2
33060,70,9042,12793;12824;17032,18980,0,1,2,0,3
33061,70,9045,12796;13497;17242;17906,18980,0,2,2,0,4
33062,70,9046,12716;13001;17015,18980,0,1,2,0,3
33063,70,9048,13353;13501;17592,18980,0,1,2,0,3
33064,70,9049,12528;12969;17067;17528;17971,18980,0,3,2,0,5
33065,70,9050,12525;13041;17623;17686,18980,0,2,2,0,4
33066,70,9051,12971;13052;16816,18980,0,1,2,0,3
33067,70,9052,13077;13596;16612;17655;18145,18980,1,2,2,0,5
33068,70,9053,13056;13101,18980,0,0,2,0,2
33069,70,9054,13031;13139;17080;17537,18980,0,2,2,0,4
33070,70,9055,13086;13687;17989,18980,0,1,2,0,3
33071,70,9056,13182;16848;16934;17018,18980,0,3,1,0,4
33072,70,9058,13221;13913;17478,18980,0,1,2,0,3
33073,70,9059,13223;13315;16512,18980,0,0,3,0,3
33074,70,9060,12769;13225;17109;17227;18353,18980,1,2,2,0,5
33075,70,9061,13226;13593;17323,18980,0,1,2,0,3
33076,70,9062,13256;13286;16788;17500,18980,0,2,2,0,4
33077,70,9063,13267;13578;16809,18980,0,1,2,0,3
33078,70,9064,13276;13667;18107,18980,1,0,2,0,3
33079,70,9065,13145;13707;18124,18980,1,0,2,0,3
33080,70,9066,13301;13766;17369,18980,0,1,2,0,3
33081,70,9067,13826;16532;17370;18638,18980,1,1,2,0,4
33082,70,9068,13372;13457;17466,18980,0,1,2,0,3
33083,70,9069,13605;13715;17060,18980,0,1,2,0,3
33084,70,9070,13055;13430,18980,0,0,2,0,2
33085,70,9071,13514;16633;17268;18529,18980,1,2,1,0,4
33086,70,9072,13636;13756;18021;18480,18980,1,1,2,0,4
33087,70,9073,13458;13580;17661,18980,0,1,2,0,3
33088,70,9074,13461;13591;17352,18980,0,1,2,0,3
33089,70,9075,13100;13448;16569;17126,18980,0,1,3,0,4
33090,70,9076,13136;13491;16878;17572;17798,18980,0,3,2,0,5
33091,70,9077,13319;13534;17616;17905;18515,18980,1,2,2,0,5
33092,70,9078,13576;16936,18980,0,1,1,0,2
33093,70,9079,13617;13996;16713;16766;17254;17930,18980,0,4,2,0,6
33094,70,9080,13610;13705;17000,18980,0,1,2,0,3
33095,70,9081,12876,18980,0,0,1,0,1
33096,70,9082,13179;13641;17256,18980,0,1,2,0,3
33097,70,9083,13081;13642;17484,18980,0,1,2,0,3
33098,70,9084,13693;13841;16490;17308;17521,18980,0,2,3,0,5
33099,70,9085,13713;13749;16927,18980,0,1,2,0,3
33100,70,9086,13716;13893;16701,18980,0,1,2,0,3
33101,70,9087,13233;13729;16562;16969;17356;17625,18980,0,3,3,0,6
33102,70,9088,13930;16526;17446,18980,0,1,2,0,3
33103,70,9089,13763;13824;17113;17531;17861,18980,0,3,2,0,5
33104,70,9090,13767;14057;16563;16873;17158,18980,0,2,3,0,5
33105,70,9091,13503;13938;16508;17792;18005,18980,0,2,3,0,5
33106,70,9092,334,19345,0,0,0,1,1
33107,70,9093,10216,19345,0,0,0,1,1
33108,70,9094,1266,19345,0,0,0,1,1
33109,70,9102,10957,19345,0,0,1,0,1
33110,70,9108,10993;11145,19345,0,0,2,0,2
33111,70,9111,11540,19345,0,0,1,0,1
33112,70,9118,11893,19345,0,0,1,0,1
33113,70,9121,12313;12373;17111;17565;17636;17954,19345,0,4,2,0,6
33114,70,9122,12375;12949;16806;16869;17981,19345,0,3,2,0,5
33115,70,9123,12356;12433;16889;17042,19345,0,2,2,0,4
33116,70,9124,12440;12520;17427;17715,19345,0,2,2,0,4
33117,70,9125,12480;12676;16692;17497,19345,0,2,2,0,4
33118,70,9127,12606;13099;16950,19345,0,1,2,0,3
33119,70,9128,12612,19345,0,0,1,0,1
33120,70,9129,12222;12634;16753;17199,19345,0,2,2,0,4
33121,70,9131,12413;16899;17450,19345,0,2,1,0,3
33122,70,9132,12507;13015;17197;18022,19345,0,2,2,0,4
33123,70,9133,12337;13143;17191;17747,19345,0,2,2,0,4
33124,70,9134,12832;17226,19345,0,1,1,0,2
33125,70,9135,13232;13316;17624;18146,19345,1,1,2,0,4
33126,70,9136,13863;14204;16913;17403,19345,0,2,2,0,4
33127,70,9137,13037;13106;17006;17354,19345,0,2,2,0,4
33128,70,9138,13611;17685,19345,0,1,1,0,2
33129,70,9139,12831;13280,19345,0,0,2,0,2
33130,70,9140,13808;13950;17361;18240,19345,1,1,2,0,4
33131,70,9141,13958;16887;17133;17468;17880,19345,0,4,1,0,5
33132,70,9142,13083;13334;16954;17051,19345,0,2,2,0,4
33133,70,9143,13335;13336;17574,19345,0,1,2,0,3
33134,70,9145,14046;17229;17294;17700,19345,0,3,1,0,4
33135,70,9146,13940;18505,19345,1,0,1,0,2
33136,70,9147,13066;13390;17629;18204,19345,1,1,2,0,4
33137,70,9148,13429;13717;17972,19345,0,1,2,0,3
33138,70,9149,13400;14152;16720;17355;18393,19345,1,2,2,0,5
33139,70,9150,13401;13936;17233;17439,19345,0,2,2,0,4
33140,70,9151,13098;13415;16850;17101;17774,19345,0,3,2,0,5
33141,70,9152,13467;14339;16743;16952;17125;17799,19345,0,4,2,0,6
33142,70,9153,13487;17026,19345,0,1,1,0,2
33143,70,9154,13519;13980;17087;17143,19345,0,2,2,0,4
33144,70,9155,14070;16919;17421;17726,19345,0,3,1,0,4
33145,70,9156,13588;14041;17330;17494,19345,0,2,2,0,4
33146,70,9157,14063;14188;18276,19345,1,0,2,0,3
33147,70,9158,13433;13699;16659,19345,0,1,2,0,3
33148,70,9159,13649;13664;17664,19345,0,1,2,0,3
33149,70,9160,13673;17314;17558;17708,19345,0,3,1,0,4
33150,70,9161,13464;13677;17507,19345,0,1,2,0,3
33151,70,9162,13447;13695;16866,19345,0,1,2,0,3
33152,70,9163,13196;13412,19345,0,0,2,0,2
33153,70,9164,13278;13714;17168,19345,0,1,2,0,3
33154,70,9165,13723;13878;17547;18564,19345,1,1,2,0,4
33155,70,9166,13373;13732;16923,19345,0,1,2,0,3
33156,70,9167,13531;13740;16917;17495;17965,19345,0,3,2,0,5
33157,70,9168,13323;13801;16944;17852;18048,19345,1,2,2,0,5
33158,70,9169,13768;17807,19345,0,1,1,0,2
33159,70,9170,13431;13771;16681,19345,0,1,2,0,3
33160,70,9171,13325;13772;16694;18212;18322,19345,2,1,2,0,5
33161,70,9172,13858;17817;18187;18371,19345,2,1,1,0,4
33162,70,9173,13790;13892;16787;18112,19345,1,1,2,0,4
33163,70,9174,13247;13792;17397,19345,0,1,2,0,3
33164,70,9175,13793;13849;17678;17979;18387,19345,1,2,2,0,5
33165,70,9176,13823;17287;17605,19345,0,2,1,0,3
33166,70,9177,13527;13845;16763;17237;17604,19345,0,3,2,0,5
33167,70,9178,13881;13979;16897;17023;18375,19345,1,2,2,0,5
33168,70,9179,13984;14196;17687;18517,19345,1,1,2,0,4
33169,70,9180,13804;13894;17752,19345,0,1,2,0,3
33170,70,9181,13901;13919;17382;17970,19345,0,2,2,0,4
33171,70,9184,3952,19710,0,0,0,1,1
33172,70,9185,4075,19710,0,0,0,1,1
33173,70,9187,6055,19710,0,0,0,1,1
33174,70,9189,7039,19710,0,0,0,1,1
33175,70,9193,10106,19710,0,0,0,1,1
33176,70,9194,10233,19710,0,0,0,1,1
33177,70,9195,10238,19710,0,0,0,1,1
33178,70,9199,10706,19710,0,0,1,0,1
33179,70,9200,10838,19710,0,0,1,0,1
33180,70,9206,11643,19710,0,0,1,0,1
33181,70,9211,11997;12145;17483,19710,0,1,2,0,3
33182,70,9212,12164,19710,0,0,1,0,1
33183,70,9213,12675;16837;17029,19710,0,2,1,0,3
33184,70,9216,12526;12703;16926;17097,19710,0,2,2,0,4
33185,70,9217,12835;12922;16904;17114,19710,0,2,2,0,4
33186,70,9219,13117;13676;17247;17794;18014,19710,0,3,2,0,5
33187,70,9220,12656;13011;17644;17780,19710,0,2,2,0,4
33188,70,9221,13024;13124;16958;17096;17181;17480,19710,0,4,2,0,6
33189,70,9222,13044;13275;17891;18355,19710,1,1,2,0,4
33190,70,9223,12621;13162;16892,19710,0,1,2,0,3
33191,70,9226,13349;13665;16935;18274;18524,19710,2,1,2,0,5
33192,70,9227,13369;13515;17552;17850,19710,0,2,2,0,4
33193,70,9228,13165;13553;17620;18484;18591,19710,2,1,2,0,5
33194,70,9230,13080,19710,0,0,1,0,1
33195,70,9231,14069;14155;16741,19710,0,1,2,0,3
33196,70,9232,13450;13582;17380,19710,0,1,2,0,3
33197,70,9233,13426;13477,19710,0,0,2,0,2
33198,70,9234,13542;13924;17290;17995,19710,0,2,2,0,4
33199,70,9235,13421;13551;17519,19710,0,1,2,0,3
33200,70,9236,14110;14207;16855;17342;17498;17702;18361,19710,1,4,2,0,7
33201,70,9237,13435;13598;16894;17631,19710,0,2,2,0,4
33202,70,9238,13440;13601;17358;18551,19710,1,1,2,0,4
33203,70,9239,13624;14138;17493;17713,19710,0,2,2,0,4
33204,70,9240,13640;13870;17705,19710,0,1,2,0,3
33205,70,9241,13633;13654;16793;17241;18389,19710,1,2,2,0,5
33206,70,9242,14337;14602;16875;17303;18231,19710,1,2,2,0,5
33207,70,9243,13694;14314,19710,0,0,2,0,2
33208,70,9244,13460;13791;18094,19710,1,0,2,0,3
33209,70,9245,13686;13702;17279;17667;18142,19710,1,2,2,0,5
33210,70,9246,13413;13708;16852;17064;17449;18584,19710,1,3,2,0,6
33211,70,9247,13712;14206;18045,19710,0,1,2,0,3
33212,70,9248,13425,19710,0,0,1,0,1
33213,70,9249,13741;14042;16752;17079;18143,19710,1,2,2,0,5
33214,70,9250,13674;14362;16918;17331;17767;18010,19710,0,4,2,0,6
33215,70,9251,13530;13811;17004;17296;18149,19710,1,2,2,0,5
33216,70,9252,13840;14462;16827;18407,19710,1,1,2,0,4
33217,70,9253,13832;14365;16780;17263,19710,0,2,2,0,4
33218,70,9254,13850;14089;16832;17100;17281;17853,19710,0,4,2,0,6
33219,70,9255,13890;14158;17333;17584,19710,0,2,2,0,4
33220,70,9256,13168;13907;17376;17627;18221,19710,1,2,2,0,5
33221,70,9257,13236;13914;17692;17956,19710,0,2,2,0,4
33222,70,9258,13926;17711;18108,19710,1,1,1,0,3
33223,70,9259,13947;16910;17448;17816,19710,0,3,1,0,4
33224,70,9260,13906;13948;17549;17728;18139,19710,1,2,2,0,5
33225,70,9261,13971;14100;16756;17324,19710,0,2,2,0,4
33226,70,9262,13990;14005;16769;17070,19710,0,2,2,0,4
33227,70,9263,14029;14097;18023,19710,0,1,2,0,3
33228,70,9264,14035;14047;17879,19710,0,1,2,0,3
33229,70,9265,13615;13944;18422,19710,1,0,2,0,3
33230,70,9266,13871;14078;17076;17710;18129,19710,1,2,2,0,5
33231,70,9267,14080;14451;16738;17901,19710,0,2,2,0,4
33232,70,9268,1284,20075,0,0,0,1,1
33233,70,9270,3108,20075,0,0,0,1,1
33234,70,9271,774,20075,0,0,0,1,1
33235,70,9273,7257,20075,0,0,0,1,1
33236,70,9274,10034,20075,0,0,0,1,1
33237,70,9276,10005,20075,0,0,0,1,1
33238,70,9277,10166,20075,0,0,0,1,1
33239,70,9278,10054,20075,0,0,0,1,1
33240,70,9279,10143,20075,0,0,0,1,1
33241,70,9281,10401,20075,0,0,0,1,1
33242,70,9282,10381,20075,0,0,0,1,1
33243,70,9290,10798,20075,0,0,1,0,1
33244,70,9294,11143;11284,20075,0,0,2,0,2
33245,70,9296,11255,20075,0,0,1,0,1
33246,70,9302,11745;12123,20075,0,0,2,0,2
33247,70,9305,11738;12106;16888;17374,20075,0,2,2,0,4
33248,70,9306,12154;12500;17541,20075,0,1,2,0,3
33249,70,9309,12169;12653;17399,20075,0,1,2,0,3
33250,70,9313,12724;13078;17396;18194,20075,1,1,2,0,4
33251,70,9314,12483;12588,20075,0,0,2,0,2
33252,70,9315,12853;17086,20075,0,1,1,0,2
33253,70,9316,12993;13411;16881;17170;18475,20075,1,2,2,0,5
33254,70,9317,13033;13556;17608,20075,0,1,2,0,3
33255,70,9318,12916;16870;17155,20075,0,2,1,0,3
33256,70,9319,12833;13229;17115;17567;17846,20075,0,3,2,0,5
33257,70,9320,13239;16964,20075,0,1,1,0,2
33258,70,9321,13634;17163;18151,20075,1,1,1,0,3
33259,70,9323,13769;14171;17052;17902;18440,20075,1,2,2,0,5
33260,70,9325,13575;17496;17834,20075,0,2,1,0,3
33261,70,9326,13594;18058;18617,20075,2,0,1,0,3
33262,70,9327,14359,20075,0,0,1,0,1
33263,70,9329,13706;14191;18372,20075,1,0,2,0,3
33264,70,9330,13710;13744;18025;18523,20075,1,1,2,0,4
33265,70,9331,13516;13719;16971;17886;18241,20075,1,2,2,0,5
33266,70,9332,13730;14030;17329;17409,20075,0,2,2,0,4
33267,70,9333,13759;14443;16951;18514,20075,1,1,2,0,4
33268,70,9334,13628;13789;17514;18333;18457,20075,2,1,2,0,5
33269,70,9335,13797;14186;16942;17167;18024;18502,20075,1,3,2,0,6
33270,70,9336,13799;14137;18335,20075,1,0,2,0,3
33271,70,9337,13548;13839;17041;17809;18228,20075,1,2,2,0,5
33272,70,9338,13854;14121;18189,20075,1,0,2,0,3
33273,70,9339,13783;13877;17561,20075,0,1,2,0,3
33274,70,9340,13888;14130;18570,20075,1,0,2,0,3
33275,70,9341,13867;13908;17065;17277;18582,20075,1,2,2,0,5
33276,70,9342,13910;14312;18627,20075,1,0,2,0,3
33277,70,9343,13748;13912;17795,20075,0,1,2,0,3
33278,70,9344,13812;16909;17626,20075,0,2,1,0,3
33279,70,9345,13690;13927;17295;17693,20075,0,2,2,0,4
33280,70,9346,13152;13933;18595,20075,1,0,2,0,3
33281,70,9347,13773,20075,0,0,1,0,1
33282,70,9348,13951;14282,20075,0,0,2,0,2
33283,70,9349,13735;13954;17857;18489,20075,1,1,2,0,4
33284,70,9350,13909;14009;17340;17672;18376,20075,1,2,2,0,5
33285,70,9351,13876;14225;18184,20075,1,0,2,0,3
33286,70,9352,14052;14179;17367;18346,20075,1,1,2,0,4
33287,70,9353,13891;14099;17093;17445,20075,0,2,2,0,4
33288,70,9354,14473;16979,20075,0,1,1,0,2
33289,70,9355,14112;14530;16901;17425;17737,20075,0,3,2,0,5
33290,70,9356,13679;17153,20075,0,1,1,0,2
33291,70,9357,13816;14125;18283,20075,1,0,2,0,3
33292,70,9358,14140;14584;16968;17509,20075,0,2,2,0,4
33293,70,9359,14114;14144;17924,20075,0,1,2,0,3
33294,70,9360,14154;17615;18442,20075,1,1,1,0,3
33295,70,9361,14178;14369;16945,20075,0,1,2,0,3
33296,70,9362,14128;14181;16876;17286,20075,0,2,2,0,4
33297,70,9363,13895;14198;18070;18571,20075,2,0,2,0,4
33298,70,9364,14218;14852,20075,0,0,2,0,2
33299,70,9365,2910,20440,0,0,0,1,1
33300,70,9366,4023,20440,0,0,0,1,1
33301,70,9367,5793,20440,0,0,0,1,1
33302,70,9368,7037,20440,0,0,0,1,1
33303,70,9369,10124,20440,0,0,0,1,1
33304,70,9370,10172,20440,0,0,0,1,1
33305,70,9371,10275,20440,0,0,0,1,1
33306,70,9373,10222,20440,0,0,0,1,1
33307,70,9382,10878;10946,20440,0,0,2,0,2
33308,70,9384,10965,20440,0,0,1,0,1
33309,70,9387,11417;11748,20440,0,0,2,0,2
33310,70,9388,11588,20440,0,0,1,0,1
33311,70,9400,12279;12492,20440,0,0,2,0,2
33312,70,9402,12345;12394;17579;17973,20440,0,2,2,0,4
33313,70,9403,12505;17054;17317,20440,0,2,1,0,3
33314,70,9404,12425;12454;17106;17280,20440,0,2,2,0,4
33315,70,9405,12804;13016;17573,20440,0,1,2,0,3
33316,70,9406,12466;12582;17031;17198,20440,0,2,2,0,4
33317,70,9407,12594;12902;17634,20440,0,1,2,0,3
33318,70,9408,12601;17027;17334,20440,0,2,1,0,3
33319,70,9409,12645;13572;17839,20440,0,1,2,0,3
33320,70,9410,12484;12750;17089,20440,0,1,2,0,3
33321,70,9412,12494;12765;17283,20440,0,1,2,0,3
33322,70,9415,12939;13104;17441;17688;18190,20440,1,2,2,0,5
33323,70,9416,12995;13197,20440,0,0,2,0,2
33324,70,9417,12870;13013;17147,20440,0,1,2,0,3
33325,70,9418,12524,20440,0,0,1,0,1
33326,70,9419,13042;13193;17635,20440,0,1,2,0,3
33327,70,9421,12722;13064;17553,20440,0,1,2,0,3
33328,70,9422,13151;13298;17878;18470,20440,1,1,2,0,4
33329,70,9423,13003;13273;17276;17665,20440,0,2,2,0,4
33330,70,9424,13200;13212;17482,20440,0,1,2,0,3
33331,70,9425,13262,20440,0,0,1,0,1
33332,70,9426,13331;13522;18373,20440,1,0,2,0,3
33333,70,9427,14025,20440,0,0,1,0,1
33334,70,9428,12900;13438;18498,20440,1,0,2,0,3
33335,70,9429,13463;13964;17882;18213,20440,1,1,2,0,4
33336,70,9430,13507;14169;18081,20440,1,0,2,0,3
33337,70,9431,13525;13620;17088;17563,20440,0,2,2,0,4
33338,70,9432,13308,20440,0,0,1,0,1
33339,70,9433,13327;13698;17365,20440,0,1,2,0,3
33340,70,9434,13720,20440,0,0,1,0,1
33341,70,9435,13722;14184;17339;17551,20440,0,2,2,0,4
33342,70,9436,13731;14068;17829,20440,0,1,2,0,3
33343,70,9437,13806;17196;17426;18501,20440,1,2,1,0,4
33344,70,9438,13813;14168;17947,20440,0,1,2,0,3
33345,70,9439,13821,20440,0,0,1,0,1
33346,70,9440,13825;14167;17061;17210;17581,20440,0,3,2,0,5
33347,70,9441,13833;14318;18105,20440,1,0,2,0,3
33348,70,9442,13844;14071;18277;18626,20440,2,0,2,0,4
33349,70,9443,14390;18036;18308,20440,1,1,1,0,3
33350,70,9444,14235;17315;17597,20440,0,2,1,0,3
33351,70,9445,13887;13934;17267;17745,20440,0,2,2,0,4
33352,70,9446,13889;14124;17717;17959;18051,20440,1,2,2,0,5
33353,70,9447,13900;14330;17328;18539,20440,1,1,2,0,4
33354,70,9448,13902;17735,20440,0,1,1,0,2
33355,70,9449,13904;13920;18437,20440,1,0,2,0,3
33356,70,9450,13923;14329;17145;17393;17800;17938,20440,0,4,2,0,6
33357,70,9451,13931;14363,20440,0,0,2,0,2
33358,70,9452,13942;14343;18152;18612,20440,2,0,2,0,4
33359,70,9454,13967;14412;17469;17611,20440,0,2,2,0,4
33360,70,9455,14486;14652;17037;18278,20440,1,1,2,0,4
33361,70,9456,13975;14320;17320;17988,20440,0,2,2,0,4
33362,70,9457,14677;17084;17545;17909;18399;18601,20440,2,3,1,0,6
33363,70,9458,14018;14086;17651;18468,20440,1,1,2,0,4
33364,70,9459,14503;17124,20440,0,1,1,0,2
33365,70,9460,14050;14182;17208,20440,0,1,2,0,3
33366,70,9461,14592,20440,0,0,1,0,1
33367,70,9462,13570;14465;17008,20440,0,1,2,0,3
33368,70,9463,13777;14076;18008;18162;18513,20440,2,1,2,0,5
33369,70,9464,14088;17670;17996,20440,0,2,1,0,3
33370,70,9465,14537;17896;18324,20440,1,1,1,0,3
33371,70,9466,14113;14497;17272;17838,20440,0,2,2,0,4
33372,70,9467,14134;14539;17063;18016,20440,0,2,2,0,4
33373,70,9468,14059;14468;17108;17318;18059,20440,1,2,2,0,5
33374,70,9469,13404,20440,0,0,1,0,1
33375,70,9470,14160;14161;17544;18336,20440,1,1,2,0,4
33376,70,9471,14177;14747;18229;18394;18599,20440,3,0,2,0,5
33377,70,9472,13837;14192;17246;17903,20440,0,2,2,0,4
33378,70,9473,14215;14458;18451,20440,1,0,2,0,3
33379,70,9474,14216;14376;17302;18166,20440,1,1,2,0,4
33380,70,9475,14224;14242;18598,20440,1,0,2,0,3
33381,70,9476,14243;18636,20440,1,0,1,0,2
33382,70,9477,14256;14611;17900;18305;18530,20440,2,1,2,0,5
33383,70,9478,13738;14269;17474;17888,20440,0,2,2,0,4
33384,70,9479,13809;14292;18215;18633,20440,2,0,2,0,4
33385,70,9480,14317;14354;17680,20440,0,1,2,0,3
33386,70,9481,14319;14435;17074;17269;18115,20440,1,2,2,0,5
33387,70,9482,14340;14638;17648;18133;18536,20440,2,1,2,0,5
33388,70,9484,10102,20805,0,0,0,1,1
33389,70,9488,10571,20805,0,0,0,1,1
33390,70,9494,10261,20805,0,0,0,1,1
33391,70,9496,10932,20805,0,0,1,0,1
33392,70,9498,11235;11583,20805,0,0,2,0,2
33393,70,9501,11400,20805,0,0,1,0,1
33394,70,9509,11925;12172;17185;17300,20805,0,2,2,0,4
33395,70,9513,11727;12320;17265;17438,20805,0,2,2,0,4
33396,70,9515,12058;12112,20805,0,0,2,0,2
33397,70,9518,12591;12657;17136;17639,20805,0,2,2,0,4
33398,70,9520,12759;13378;17134;18156,20805,1,1,2,0,4
33399,70,9522,12849,20805,0,0,1,0,1
33400,70,9523,12874;13125;17400,20805,0,1,2,0,3
33401,70,9525,12636;12841;17771,20805,0,1,2,0,3
33402,70,9527,12607;13082;17189;17475,20805,0,2,2,0,4
33403,70,9528,13347;13459;18347,20805,1,0,2,0,3
33404,70,9529,13157;13785,20805,0,0,2,0,2
33405,70,9530,13180;13819;17744;18342,20805,1,1,2,0,4
33406,70,9531,13140;13211,20805,0,0,2,0,2
33407,70,9532,13188;13237;17630,20805,0,1,2,0,3
33408,70,9533,13302;14334;17770,20805,0,1,2,0,3
33409,70,9534,13030;13346;17455;17596,20805,0,2,2,0,4
33410,70,9535,13356;13510;17171;17345;17701,20805,0,3,2,0,5
33411,70,9537,13405;14205;17851;18416,20805,1,1,2,0,4
33412,70,9538,13368;13410;17273;17491,20805,0,2,2,0,4
33413,70,9539,13451;13962;17804,20805,0,1,2,0,3
33414,70,9540,14115;14308;17828,20805,0,1,2,0,3
33415,70,9541,13492;13739;17757;18144;18257,20805,2,1,2,0,5
33416,70,9542,13546;14126;17387;17987;18197,20805,1,2,2,0,5
33417,70,9543,13571;13581;18216,20805,1,0,2,0,3
33418,70,9544,13597;14252;17594;17863,20805,0,2,2,0,4
33419,70,9545,12875;13173;17580;17833,20805,0,2,2,0,4
33420,70,9546,13662;13807;18235,20805,1,0,2,0,3
33421,70,9547,13441;13684;18125;18351;18634,20805,3,0,2,0,5
33422,70,9548,13776;14038;17822;18122,20805,1,1,2,0,4
33423,70,9549,14446;17288;17889,20805,0,2,1,0,3
33424,70,9550,13680;13836,20805,0,0,2,0,2
33425,70,9552,13852;14139;17984,20805,0,1,2,0,3
33426,70,9553,14162;17654,20805,0,1,1,0,2
33427,70,9554,13402;14276;17848;18244;18418,20805,2,1,2,0,5
33428,70,9555,13862;13882;17894,20805,0,1,2,0,3
33429,70,9556,13560;14000;17156;18046;18461,20805,1,2,2,0,5
33430,70,9557,13957;14449;17781,20805,0,1,2,0,3
33431,70,9558,14043;14072;17321;17515,20805,0,2,2,0,4
33432,70,9559,13952;14048;17159;17501;18518,20805,1,2,2,0,5
33433,70,9560,14051;14108;18359;18625,20805,2,0,2,0,4
33434,70,9561,14066;14595;18015;18270,20805,1,1,2,0,4
33435,70,9562,13454;14118;17671,20805,0,1,2,0,3
33436,70,9563,13696;14132;18348,20805,1,0,2,0,3
33437,70,9564,14146;17516;18042,20805,0,2,1,0,3
33438,70,9565,14845;17944;18236,20805,1,1,1,0,3
33439,70,9566,13953;14151;17309;17936;18301,20805,1,2,2,0,5
33440,70,9567,14093;14193;17160;18073;18428,20805,2,1,2,0,5
33441,70,9568,13565;14194;18099;18404,20805,2,0,2,0,4
33442,70,9569,14197;15122,20805,0,0,2,0,2
33443,70,9570,14202;14214;18605,20805,1,0,2,0,3
33444,70,9571,13916;14230,20805,0,0,2,0,2
33445,70,9572,14232;14661;18319,20805,1,0,2,0,3
33446,70,9573,14245;14500;17304;18182,20805,1,1,2,0,4
33447,70,9574,14247;14532;17142;17868;18027,20805,0,3,2,0,5
33448,70,9575,14253;17646;18100,20805,1,1,1,0,3
33449,70,9576,14289,20805,0,0,1,0,1
33450,70,9577,14637;14774;17999;18436,20805,1,1,2,0,4
33451,70,9578,14395;14822;17359;17682;18056,20805,1,2,2,0,5
33452,70,9579,14061;14418;17258,20805,0,1,2,0,3
33453,70,9580,14456;14678,20805,0,0,2,0,2
33454,70,9581,14705;17149;18026;18210,20805,1,2,1,0,4
33455,70,9582,14212;14459;17696,20805,0,1,2,0,3
33456,70,9583,14563;17144;18188,20805,1,1,1,0,3
33457,70,9584,14800;17128;17912;18057,20805,1,2,1,0,4
33458,70,9585,10074,21170,0,0,0,1,1
33459,70,9587,10150,21170,0,0,0,1,1
33460,70,9588,8721,21170,0,0,0,1,1
33461,70,9589,10326,21170,0,0,0,1,1
33462,70,9590,8877,21170,0,0,0,1,1
33463,70,9599,11453,21170,0,0,1,0,1
33464,70,9604,11934,21170,0,0,1,0,1
33465,70,9605,11972;12002;17451,21170,0,1,2,0,3
33466,70,9606,11812,21170,0,0,1,0,1
33467,70,9608,12614;12912;17533;17607,21170,0,2,2,0,4
33468,70,9613,12262;12361;17289;17395,21170,0,2,2,0,4
33469,70,9614,12388;12512;17722,21170,0,1,2,0,3
33470,70,9615,12984;13526,21170,0,0,2,0,2
33471,70,9616,12448;12506;17641;17813,21170,0,2,2,0,4
33472,70,9620,12271,21170,0,0,1,0,1
33473,70,9621,12649;12923;17487,21170,0,1,2,0,3
33474,70,9623,12752;12899;18227,21170,1,0,2,0,3
33475,70,9626,12880,21170,0,0,1,0,1
33476,70,9627,12913;12940;17278;17978,21170,0,2,2,0,4
33477,70,9628,13317;13603;17518,21170,0,1,2,0,3
33478,70,9629,12982;13333;17436,21170,0,1,2,0,3
33479,70,9631,13287;17520;18074,21170,1,1,1,0,3
33480,70,9632,12918;13635,21170,0,0,2,0,2
33481,70,9633,13199;13490;17762;18165,21170,1,1,2,0,4
33482,70,9638,13284;13427;17818,21170,0,1,2,0,3
33483,70,9641,13502;14375;17675,21170,0,1,2,0,3
33484,70,9642,13782;13929;17327,21170,0,1,2,0,3
33485,70,9644,13544;14262;17856,21170,0,1,2,0,3
33486,70,9645,13589;13762;18269,21170,1,0,2,0,3
33487,70,9646,13590;14223;18028;18415;18610,21170,2,1,2,0,5
33488,70,9647,13595;13828;17754,21170,0,1,2,0,3
33489,70,9648,13344;13619;17578;17837,21170,0,2,2,0,4
33490,70,9649,13631;13866,21170,0,0,2,0,2
33491,70,9650,13422;13661;17530;17976,21170,0,2,2,0,4
33492,70,9651,14145;14382;17250;17510,21170,0,2,2,0,4
33493,70,9652,13751;13896,21170,0,0,2,0,2
33494,70,9653,13831;14259;17366;17791,21170,0,2,2,0,4
33495,70,9654,13478;13552,21170,0,0,2,0,2
33496,70,9655,13983;14368,21170,0,0,2,0,2
33497,70,9656,13543;13989;17548;17768;18173,21170,1,2,2,0,5
33498,70,9657,13538;14026,21170,0,0,2,0,2
33499,70,9658,14045;14448;17691,21170,0,1,2,0,3
33500,70,9659,13959;14056,21170,0,0,2,0,2
33501,70,9660,14067;14361;17758;18117,21170,1,1,2,0,4
33502,70,9661,14522;14828;17749;18088,21170,1,1,2,0,4
33503,70,9662,13853;14092;17248,21170,0,1,2,0,3
33504,70,9663,13835;14346;17311;17919;18614,21170,1,2,2,0,5
33505,70,9664,13374;14164;17564,21170,0,1,2,0,3
33506,70,9665,14166;14707;17341;18446,21170,1,1,2,0,4
33507,70,9666,13928;14203;17338;17559,21170,0,2,2,0,4
33508,70,9667,14229;14477,21170,0,0,2,0,2
33509,70,9668,14585;17313;17674,21170,0,2,1,0,3
33510,70,9669,14572;14647;18331;18438,21170,2,0,2,0,4
33511,70,9670,14322;14733;17910,21170,0,1,2,0,3
33512,70,9671,14006;14353;18309,21170,1,0,2,0,3
33513,70,9672,14270;14804;17964,21170,0,1,2,0,3
33514,70,9673,13746;13861;18038,21170,0,1,2,0,3
33515,70,9674,14380;14943;17453;17659,21170,0,2,2,0,4
33516,70,9675,14399;14606,21170,0,0,2,0,2
33517,70,9676,14414;14415;17712;17993;18243;18593,21170,2,2,2,0,6
33518,70,9677,14429;14719;17825;18398,21170,1,1,2,0,4
33519,70,9678,14021;14434,21170,0,0,2,0,2
33520,70,9679,14438;14479;17499,21170,0,1,2,0,3
33521,70,9680,14440;14908;18431,21170,1,0,2,0,3
33522,70,9681,14471;14768;18303,21170,1,0,2,0,3
33523,70,9682,14054;14485;18102,21170,1,0,2,0,3
33524,70,9683,13618;14263;17316;17788,21170,0,2,2,0,4
33525,70,9684,14525;18101;18452,21170,2,0,1,0,3
33526,70,9685,14534;14761;17260;17681;17738,21170,0,3,2,0,5
33527,70,9686,14397;14547,21170,0,0,2,0,2
33528,70,9687,14551;14823;18390,21170,1,0,2,0,3
33529,70,9688,14227;14555;18267,21170,1,0,2,0,3
33530,70,9689,15013;17349;17772,21170,0,2,1,0,3
33531,70,9690,14588;18282;18574,21170,2,0,1,0,3
33532,70,9691,14478;14608;17922;18317,21170,1,1,2,0,4
33533,70,9692,14616;14930;17375;17929,21170,0,2,2,0,4
33534,70,9693,10050,21535,0,0,0,1,1
33535,70,9694,10079,21535,0,0,0,1,1
33536,70,9696,10357,21535,0,0,0,1,1
33537,70,9697,10536,21535,0,0,0,1,1
33538,70,9703,11008,21535,0,0,1,0,1
33539,70,9708,11706;12389,21535,0,0,2,0,2
33540,70,9710,11797;12033,21535,0,0,2,0,2
33541,70,9712,12200;12215;17401;17764,21535,0,2,2,0,4
33542,70,9715,12094;12410;17568;17622,21535,0,2,2,0,4
33543,70,9717,13128;18017,21535,0,1,1,0,2
33544,70,9718,12390,21535,0,0,1,0,1
33545,70,9720,12692;13243;17408,21535,0,1,2,0,3
33546,70,9722,12677;12787;17776;17874,21535,0,2,2,0,4
33547,70,9724,12860,21535,0,0,1,0,1
33548,70,9726,12568;12988;17522;17953,21535,0,2,2,0,4
33549,70,9727,13060;13512;17872;18298,21535,1,1,2,0,4
33550,70,9729,13093;13414;18068,21535,1,0,2,0,3
33551,70,9731,13153;13245,21535,0,0,2,0,2
33552,70,9732,12941;13251,21535,0,0,2,0,2
33553,70,9733,13725;17751,21535,0,1,1,0,2
33554,70,9734,13758;17601,21535,0,1,1,0,2
33555,70,9736,13089;13540,21535,0,0,2,0,2
33556,70,9738,13358;13960;17937;18185,21535,1,1,2,0,4
33557,70,9739,13381,21535,0,0,1,0,1
33558,70,9740,13424;13770;18341,21535,1,0,2,0,3
33559,70,9741,12999;13701;18237,21535,1,0,2,0,3
33560,70,9742,13880;14077;17492;18464,21535,1,1,2,0,4
33561,70,9743,13370;14033,21535,0,0,2,0,2
33562,70,9744,13600;14278;17423;18427,21535,1,1,2,0,4
33563,70,9745,13683;14065;17576;18429,21535,1,1,2,0,4
33564,70,9746,14698;14704;17588;17854;18337,21535,1,2,2,0,5
33565,70,9747,13700;13795;17505;17836,21535,0,2,2,0,4
33566,70,9748,13235,21535,0,0,1,0,1
33567,70,9749,13614;13843;17668;18255;18552,21535,2,1,2,0,5
33568,70,9750,13897;14425;17405;17962,21535,0,2,2,0,4
33569,70,9751,13737;13995,21535,0,0,2,0,2
33570,70,9752,13949;14517,21535,0,0,2,0,2
33571,70,9753,13494;13965,21535,0,0,2,0,2
33572,70,9754,13969;14627,21535,0,0,2,0,2
33573,70,9755,13978;14328;18148,21535,1,0,2,0,3
33574,70,9756,13986;14441;17731;18251,21535,1,1,2,0,4
33575,70,9757,13966;14004;17535;18062,21535,1,1,2,0,4
33576,70,9758,14008;14117;18488,21535,1,0,2,0,3
33577,70,9760,13734;14081;17560;17739,21535,0,2,2,0,4
33578,70,9761,14083;14965;17503;18140;18260;18572,21535,3,1,2,0,6
33579,70,9762,14767;18522,21535,1,0,1,0,2
33580,70,9763,13034;14142;18304,21535,1,0,2,0,3
33581,70,9764,14165;14409;18253,21535,1,0,2,0,3
33582,70,9765,14548,21535,0,0,1,0,1
33583,70,9766,14571;18082,21535,1,0,1,0,2
33584,70,9767,14208;14336;18334;18590,21535,2,0,2,0,4
33585,70,9768,14211,21535,0,0,1,0,1
33586,70,9769,13921;14220;17704,21535,0,1,2,0,3
33587,70,9770,14241;17377;17904;18448,21535,1,2,1,0,4
33588,70,9771,14261;14578;17360;17724;18478,21535,1,2,2,0,5
33589,70,9772,14012;17842,21535,0,1,1,0,2
33590,70,9773,14789;18426,21535,1,0,1,0,2
33591,70,9774,14325;14849;18472,21535,1,0,2,0,3
33592,70,9775,14327;14378;18040;18201,21535,1,1,2,0,4
33593,70,9776,14341;14763;18327,21535,1,0,2,0,3
33594,70,9777,14352;14630,21535,0,0,2,0,2
33595,70,9778,14372;14857;18013;18246;18384;18553,21535,3,1,2,0,6
33596,70,9779,14406;17593;17785;18233;18492,21535,2,2,1,0,5
33597,70,9780,14521;14540,21535,0,0,2,0,2
33598,70,9781,14288;14413;17716;18275,21535,1,1,2,0,4
33599,70,9782,14316;14417;17372;18476,21535,1,1,2,0,4
33600,70,9783,14275;14453,21535,0,0,2,0,2
33601,70,9784,14103;14470,21535,0,0,2,0,2
33602,70,9785,15139;17586;17741;18012,21535,0,3,1,0,4
33603,70,9786,15058,21535,0,0,1,0,1
33604,70,9787,14496;14645;17398;18067,21535,1,1,2,0,4
33605,70,9788,14516;14618;18400,21535,1,0,2,0,3
33606,70,9789,14228;14523;17974;18179,21535,1,1,2,0,4
33607,70,9790,14544;14646;18632,21535,1,0,2,0,3
33608,70,9791,14573;14617;18071,21535,1,0,2,0,3
33609,70,9792,14064;14581;18256,21535,1,0,2,0,3
33610,70,9793,14091;14615,21535,0,0,2,0,2
33611,70,9794,14633;14779;18168;18519,21535,2,0,2,0,4
33612,70,9795,14651;15099,21535,0,0,2,0,2
33613,70,9796,14454;14655;18222,21535,1,0,2,0,3
33614,70,9797,14326;14658;18602,21535,1,0,2,0,3
33615,70,9798,14660;14723;17362;17820;18106;18291,21535,2,2,2,0,6
33616,70,9799,14731;14786;17422,21535,0,1,2,0,3
33617,70,9800,14735;14816;17920;18193;18587,21535,2,1,2,0,5
33618,70,9801,14743;14842;18365,21535,1,0,2,0,3
33619,70,9802,10262,21900,0,0,0,1,1
33620,70,9803,10330,21900,0,0,0,1,1
33621,70,9805,10391,21900,0,0,0,1,1
33622,70,9807,10454,21900,0,0,0,1,1
33623,70,9813,10609,21900,0,0,0,1,1
33624,70,9815,11148,21900,0,0,1,0,1
33625,70,9816,11234,21900,0,0,1,0,1
33626,70,9819,11459,21900,0,0,1,0,1
33627,70,9820,11547,21900,0,0,1,0,1
33628,70,9822,11633,21900,0,0,1,0,1
33629,70,9823,12243,21900,0,0,1,0,1
33630,70,9824,12647;17746;17883,21900,0,2,1,0,3
33631,70,9825,12109;12354;17550;17760,21900,0,2,2,0,4
33632,70,9826,12379;12708;17618;17697,21900,0,2,2,0,4
33633,70,9827,12402;13132;17511,21900,0,1,2,0,3
33634,70,9829,12310,21900,0,0,1,0,1
33635,70,9830,12587,21900,0,0,1,0,1
33636,70,9831,12580;13111;17982,21900,0,1,2,0,3
33637,70,9832,12762;13000;17690,21900,0,1,2,0,3
33638,70,9837,13113;13711;17831,21900,0,1,2,0,3
33639,70,9839,13222;13652;17582;17911,21900,0,2,2,0,4
33640,70,9840,13207;13224,21900,0,0,2,0,2
33641,70,9841,13228;13397,21900,0,0,2,0,2
33642,70,9842,12651;13261;17658,21900,0,1,2,0,3
33643,70,9843,13164;13504,21900,0,0,2,0,2
33644,70,9844,13555;13781;18020,21900,0,1,2,0,3
33645,70,9845,13321;13476;17585;18001,21900,0,2,2,0,4
33646,70,9846,13439;13479;18556,21900,1,0,2,0,3
33647,70,9847,13156;13625;17529,21900,0,1,2,0,3
33648,70,9849,13682;14432;17801;18172;18363,21900,2,1,2,0,5
33649,70,9850,13653;13718;17718,21900,0,1,2,0,3
33650,70,9851,13786;14274,21900,0,0,2,0,2
33651,70,9852,13745;14305;17877,21900,0,1,2,0,3
33652,70,9853,13685;13827;17808;18225,21900,1,1,2,0,4
33653,70,9854,13905;13956;18439,21900,1,0,2,0,3
33654,70,9855,14131,21900,0,0,1,0,1
33655,70,9856,13997;14190;18054,21900,1,0,2,0,3
33656,70,9857,14001;14200;17513;18137,21900,1,1,2,0,4
33657,70,9858,13874;14022;18352;18534,21900,2,0,2,0,4
33658,70,9859,14036;14222;17488;17761;17885;18132,21900,1,3,2,0,6
33659,70,9860,13982;14062,21900,0,0,2,0,2
33660,70,9861,14084;14727;18078;18402,21900,2,0,2,0,4
33661,70,9862,14087;14762,21900,0,0,2,0,2
33662,70,9863,14758;17998;18409,21900,1,1,1,0,3
33663,70,9864,13939;14095;17538,21900,0,1,2,0,3
33664,70,9865,14007;14195;17835;18583,21900,1,1,2,0,4
33665,70,9866,14231,21900,0,0,1,0,1
33666,70,9867,14284;15025,21900,0,0,2,0,2
33667,70,9868,14297;14394;17589;17946,21900,0,2,2,0,4
33668,70,9869,14302;14893;17508;17867,21900,0,2,2,0,4
33669,70,9870,14832;18266,21900,1,0,1,0,2
33670,70,9871,15003;18310,21900,1,0,1,0,2
33671,70,9872,14290;14345;17985,21900,0,1,2,0,3
33672,70,9873,14333;14355;18271,21900,1,0,2,0,3
33673,70,9874,14183;14364;17727;18370,21900,1,1,2,0,4
33674,70,9875,13721;13788;17827,21900,0,1,2,0,3
33675,70,9876,14392;14463;18069;18580,21900,2,0,2,0,4
33676,70,9877,14402;14864,21900,0,0,2,0,2
33677,70,9878,14416;14753;17566,21900,0,1,2,0,3
33678,70,9879,13846;14430,21900,0,0,2,0,2
33679,70,9880,14466,21900,0,0,1,0,1
33680,70,9881,14788;14813;18296,21900,1,0,2,0,3
33681,70,9882,14489;14843;17759;18019,21900,0,2,2,0,4
33682,70,9883,14492,21900,0,0,1,0,1
33683,70,9884,14528;14819;17961;18087,21900,1,1,2,0,4
33684,70,9885,14531;15331;17562;18510,21900,1,1,2,0,4
33685,70,9886,14371;14536,21900,0,0,2,0,2
33686,70,9887,14560;14689;18507,21900,1,0,2,0,3
33687,70,9888,14567;14755;17950;18621,21900,1,1,2,0,4
33688,70,9889,15109,21900,0,0,1,0,1
33689,70,9890,14599;14622,21900,0,0,2,0,2
33690,70,9891,14624;15313;18297;18635,21900,2,0,2,0,4
33691,70,9892,14557;14628;17517;18083,21900,1,1,2,0,4
33692,70,9893,14445;14635,21900,0,0,2,0,2
33693,70,9894,14657;14668;17986,21900,0,1,2,0,3
33694,70,9895,14669;15005;18158;18430,21900,2,0,2,0,4
33695,70,9896,14682;15229,21900,0,0,2,0,2
33696,70,9897,14683;14702;17707,21900,0,1,2,0,3
33697,70,9898,14715;15280;17789;18079,21900,1,1,2,0,4
33698,70,9899,14740;15056,21900,0,0,2,0,2
33699,70,9900,14717;14749;18064;18268;18360,21900,3,0,2,0,5
33700,70,9901,14769;15265;17897;18432,21900,1,1,2,0,4
33701,70,9902,14778;15283;18449,21900,1,0,2,0,3
33702,70,9903,14787;15305;17577;17934;18214,21900,1,2,2,0,5
33703,70,9904,14649;14805;17610;18544,21900,1,1,2,0,4
33704,70,9905,10251;10881,22265,0,0,1,1,2
33705,70,9906,10327,22265,0,0,0,1,1
33706,70,9908,10751,22265,0,0,1,0,1
33707,70,9909,10533,22265,0,0,0,1,1
33708,70,9910,10444;10467,22265,0,0,0,2,2
33709,70,9911,10765;10981,22265,0,0,2,0,2
33710,70,9913,11011,22265,0,0,1,0,1
33711,70,9916,11286,22265,0,0,1,0,1
33712,70,9917,11309;11383,22265,0,0,2,0,2
33713,70,9920,11850,22265,0,0,1,0,1
33714,70,9925,12544;17847,22265,0,1,1,0,2
33715,70,9926,12249,22265,0,0,1,0,1
33716,70,9932,13009;13272;17612,22265,0,1,2,0,3
33717,70,9933,13049;13065;18018,22265,0,1,2,0,3
33718,70,9934,13147;13500;17865,22265,0,1,2,0,3
33719,70,9938,13456;14082;17732,22265,0,1,2,0,3
33720,70,9939,13521;13697;17914,22265,0,1,2,0,3
33721,70,9940,14250;18629,22265,1,0,1,0,2
33722,70,9941,13227;13604;17666,22265,0,1,2,0,3
33723,70,9942,13584;13728;17779,22265,0,1,2,0,3
33724,70,9943,13775;13838;17590,22265,0,1,2,0,3
33725,70,9944,13787;14311,22265,0,0,2,0,2
33726,70,9946,13810;13847;17826,22265,0,1,2,0,3
33727,70,9947,13864;13915,22265,0,0,2,0,2
33728,70,9948,14106;14338;18386,22265,1,0,2,0,3
33729,70,9949,13955;14626,22265,0,0,2,0,2
33730,70,9951,13668;13994,22265,0,0,2,0,2
33731,70,9952,14010;14201;18344,22265,1,0,2,0,3
33732,70,9953,13505;14159;17926,22265,0,1,2,0,3
33733,70,9954,14096;14541;17921,22265,0,1,2,0,3
33734,70,9955,14713,22265,0,0,1,0,1
33735,70,9956,13987;14170;18434,22265,1,0,2,0,3
33736,70,9957,14122;14254;17797,22265,0,1,2,0,3
33737,70,9958,14257;14724;17943,22265,0,1,2,0,3
33738,70,9959,14090;14180;18114,22265,1,0,2,0,3
33739,70,9960,14295;14883,22265,0,0,2,0,2
33740,70,9961,14301,22265,0,0,1,0,1
33741,70,9962,14309;14889;17662;18433,22265,1,1,2,0,4
33742,70,9964,14172;14349;17763,22265,0,1,2,0,3
33743,70,9965,14377;14900;17643,22265,0,1,2,0,3
33744,70,9966,14383;14703;18230;18620,22265,2,0,2,0,4
33745,70,9967,14388;14408;17609;18111;18509,22265,2,1,2,0,5
33746,70,9968,14398;14807;18066;18202,22265,2,0,2,0,4
33747,70,9969,14264;14464;17786;17932,22265,0,2,2,0,4
33748,70,9970,14476;14631,22265,0,0,2,0,2
33749,70,9971,14493;15031,22265,0,0,2,0,2
33750,70,9972,14507;15135,22265,0,0,2,0,2
33751,70,9973,14267;14553,22265,0,0,2,0,2
33752,70,9974,14569;14796;17663;17821;18343,22265,1,2,2,0,5
33753,70,9975,14580;14771;17637;17994;18356,22265,1,2,2,0,5
33754,70,9976,14324,22265,0,0,1,0,1
33755,70,9977,14335;14605,22265,0,0,2,0,2
33756,70,9978,14614;14950,22265,0,0,2,0,2
33757,70,9979,14632;15263,22265,0,0,2,0,2
33758,70,9980,14439;14640;18155,22265,1,0,2,0,3
33759,70,9981,14387;14670;17942;18516,22265,1,1,2,0,4
33760,70,9982,14411;14671;17740,22265,0,1,2,0,3
33761,70,9983,15220;18047;18368,22265,1,1,1,0,3
33762,70,9984,14422;14721;17653;18455;18541,22265,2,1,2,0,5
33763,70,9985,14421;14742,22265,0,0,2,0,2
33764,70,9986,14748,22265,0,0,1,0,1
33765,70,9987,14782;14869;18200,22265,1,0,2,0,3
33766,70,9988,14583;14803;18161;18447,22265,2,0,2,0,4
33767,70,9989,15179;15207,22265,0,0,2,0,2
33768,70,9990,14829;15142,22265,0,0,2,0,2
33769,70,9991,14488;14877,22265,0,0,2,0,2
33770,70,9992,14562;14879,22265,0,0,2,0,2
33771,70,9993,14745;14911;18250;18307,22265,2,0,2,0,4
33772,70,9994,14915;15230,22265,0,0,2,0,2
33773,70,9995,14729;15462;17632;17832;18208,22265,1,2,2,0,5
33774,70,9996,14936;14976;17941;18085,22265,1,1,2,0,4
33775,70,9997,14942;15083;17613;17824,22265,0,2,2,0,4
33776,70,9998,14718;14953,22265,0,0,2,0,2
33777,70,9999,14907;14964,22265,0,0,2,0,2
33778,70,10000,14688;14973,22265,0,0,2,0,2
33779,70,10001,14978;14981;17595;18092,22265,1,1,2,0,4
33780,70,10002,15016;15120,22265,0,0,2,0,2
33781,70,10003,15019;15152;17811;18192,22265,1,1,2,0,4
33782,70,10004,545,22630,0,0,0,1,1
33783,70,10005,10206,22630,0,0,0,1,1
33784,70,10006,10620,22630,0,0,0,1,1
33785,70,10007,10379,22630,0,0,0,1,1
33786,70,10011,11104,22630,0,0,1,0,1
33787,70,10014,11021;11332,22630,0,0,2,0,2
33788,70,10015,11306;11388,22630,0,0,2,0,2
33789,70,10016,11410,22630,0,0,1,0,1
33790,70,10017,11515,22630,0,0,1,0,1
33791,70,10019,11229,22630,0,0,1,0,1
33792,70,10024,11862,22630,0,0,1,0,1
33793,70,10025,11890,22630,0,0,1,0,1
33794,70,10026,11931;12250,22630,0,0,2,0,2
33795,70,10031,12441;12774;18030,22630,0,1,2,0,3
33796,70,10032,12504,22630,0,0,1,0,1
33797,70,10033,12595,22630,0,0,1,0,1
33798,70,10037,13072;13285;18163,22630,1,0,2,0,3
33799,70,10038,12783,22630,0,0,1,0,1
33800,70,10039,13069;13102,22630,0,0,2,0,2
33801,70,10040,13177,22630,0,0,1,0,1
33802,70,10041,12513;13166;17893;18109,22630,1,1,2,0,4
33803,70,10043,12910,22630,0,0,1,0,1
33804,70,10044,13385;13524,22630,0,0,2,0,2
33805,70,10045,13393,22630,0,0,1,0,1
33806,70,10046,13399;13639;17939,22630,0,1,2,0,3
33807,70,10047,13623;17869;18150,22630,1,1,1,0,3
33808,70,10048,13357;13480;17787,22630,0,1,2,0,3
33809,70,10049,13794;17730,22630,0,1,1,0,2
33810,70,10050,13423;13568;17875;18350,22630,1,1,2,0,4
33811,70,10051,13651;14060,22630,0,0,2,0,2
33812,70,10052,13271;13574;18392,22630,1,0,2,0,3
33813,70,10053,13671;14348;18395,22630,1,0,2,0,3
33814,70,10054,13857;13922;18550,22630,1,0,2,0,3
33815,70,10055,13834;14589,22630,0,0,2,0,2
33816,70,10056,13898;13985;17815;18380,22630,1,1,2,0,4
33817,70,10057,13937;14053;17925;18177,22630,1,1,2,0,4
33818,70,10058,13377,22630,0,0,1,0,1
33819,70,10059,14027;14603,22630,0,0,2,0,2
33820,70,10061,14143;14559;18093;18164,22630,2,0,2,0,4
33821,70,10062,14156,22630,0,0,1,0,1
33822,70,10063,14157;14712;18444,22630,1,0,2,0,3
33823,70,10064,14209;14590;18180;18604,22630,2,0,2,0,4
33824,70,10065,14244;14367;17945;18174,22630,1,1,2,0,4
33825,70,10066,14249;14306;17871;17955;18396;18477;18521,22630,3,2,2,0,7
33826,70,10067,14251,22630,0,0,1,0,1
33827,70,10068,14255;14491,22630,0,0,2,0,2
33828,70,10069,14293;14577;17957;18332,22630,1,1,2,0,4
33829,70,10071,14342;14554;17777;17933,22630,0,2,2,0,4
33830,70,10072,14356;14374,22630,0,0,2,0,2
33831,70,10073,14393;14565;18424;18640,22630,2,0,2,0,4
33832,70,10074,14400;14780;18293,22630,1,0,2,0,3
33833,70,10075,14598,22630,0,0,1,0,1
33834,70,10076,14452;15055;18053;18545,22630,2,0,2,0,4
33835,70,10077,13885;14455;18566,22630,1,0,2,0,3
33836,70,10078,14433;14502,22630,0,0,2,0,2
33837,70,10079,14148;14437,22630,0,0,2,0,2
33838,70,10081,14610;17958;18138,22630,1,1,1,0,3
33839,70,10082,14419;14597,22630,0,0,2,0,2
33840,70,10083,14607;15112,22630,0,0,2,0,2
33841,70,10084,14621;14884;18405,22630,1,0,2,0,3
33842,70,10085,14299;14623,22630,0,0,2,0,2
33843,70,10086,14656;14837;18586,22630,1,0,2,0,3
33844,70,10087,14684;15123;18034;18314,22630,1,1,2,0,4
33845,70,10088,14775;15136;17748,22630,0,1,2,0,3
33846,70,10089,14783;15475,22630,0,0,2,0,2
33847,70,10090,14784;15261;17793;18159,22630,1,1,2,0,4
33848,70,10091,15225;17778;17860;17952,22630,0,3,1,0,4
33849,70,10092,14566;14854,22630,0,0,2,0,2
33850,70,10093,14886;15449,22630,0,0,2,0,2
33851,70,10094,14013;14921,22630,0,0,2,0,2
33852,70,10095,14919;18032,22630,0,1,1,0,2
33853,70,10096,14990;15017;18116;18503,22630,2,0,2,0,4
33854,70,10097,14992,22630,0,0,1,0,1
33855,70,10098,14996;15297;17714;18055,22630,1,1,2,0,4
33856,70,10099,15186;15413,22630,0,0,2,0,2
33857,70,10100,14876;15007;18616,22630,1,0,2,0,3
33858,70,10101,14809;15023;18329,22630,1,0,2,0,3
33859,70,10102,14897;17742;18630,22630,1,1,1,0,3
33860,70,10103,15032,22630,0,0,1,0,1
33861,70,10104,15034;15239,22630,0,0,2,0,2
33862,70,10105,15064;15469,22630,0,0,2,0,2
33863,70,10106,14922;15075,22630,0,0,2,0,2
33864,70,10107,14694;15081;17890;18029;18459,22630,1,2,2,0,5
33865,70,10108,14672;15085;17931;18425,22630,1,1,2,0,4
33866,70,10109,15093;15245,22630,0,0,2,0,2
33867,70,10110,15111;15114;17823;18603,22630,1,1,2,0,4
33868,70,10111,14935;18576,22630,1,0,1,0,2
33869,70,10112,15161;15388,22630,0,0,2,0,2
33870,70,10113,15162;15273,22630,0,0,2,0,2
33871,70,10114,14856;15170,22630,0,0,2,0,2
33872,70,10115,14642;15176,22630,0,0,2,0,2
33873,70,10116,14955;15187,22630,0,0,2,0,2
33874,70,10117,10460,22995,0,0,0,1,1
33875,70,10118,10520,22995,0,0,0,1,1
33876,70,10119,10544,22995,0,0,0,1,1
33877,70,10120,10548;10702,22995,0,0,1,1,2
33878,70,10121,10611,22995,0,0,0,1,1
33879,70,10122,10886;11060,22995,0,0,2,0,2
33880,70,10125,10549,22995,0,0,0,1,1
33881,70,10126,11056,22995,0,0,1,0,1
33882,70,10127,11047,22995,0,0,1,0,1
33883,70,10128,10846,22995,0,0,1,0,1
33884,70,10130,11156,22995,0,0,1,0,1
33885,70,10131,10704,22995,0,0,1,0,1
33886,70,10132,11031,22995,0,0,1,0,1
33887,70,10133,11254,22995,0,0,1,0,1
33888,70,10134,11258,22995,0,0,1,0,1
33889,70,10135,11289,22995,0,0,1,0,1
33890,70,10137,11472,22995,0,0,1,0,1
33891,70,10139,11713;12072,22995,0,0,2,0,2
33892,70,10145,12176;12707;18207;18403,22995,2,0,2,0,4
33893,70,10148,12661;13108,22995,0,0,2,0,2
33894,70,10150,12817,22995,0,0,1,0,1
33895,70,10154,13122,22995,0,0,1,0,1
33896,70,10155,12583,22995,0,0,1,0,1
33897,70,10158,13338;14233;17980,22995,0,1,2,0,3
33898,70,10159,13351,22995,0,0,1,0,1
33899,70,10160,13416;13820,22995,0,0,2,0,2
33900,70,10162,13592;14136;18009;18325,22995,1,1,2,0,4
33901,70,10163,13061;13345;18239,22995,1,0,2,0,3
33902,70,10164,13689;13988;18294,22995,1,0,2,0,3
33903,70,10165,13558;13873;17923,22995,0,1,2,0,3
33904,70,10166,13362,22995,0,0,1,0,1
33905,70,10167,14024;14428,22995,0,0,2,0,2
33906,70,10168,13691;14031;18456,22995,1,0,2,0,3
33907,70,10169,13814;14040;18345;18592,22995,2,0,2,0,4
33908,70,10170,14104;14370;18548,22995,1,0,2,0,3
33909,70,10171,14107,22995,0,0,1,0,1
33910,70,10172,14163;14221;18119;18211,22995,2,0,2,0,4
33911,70,10173,14173;14176;17928;18511,22995,1,1,2,0,4
33912,70,10175,14020;14384;18044,22995,0,1,2,0,3
33913,70,10176,13743;14248;18391;18600,22995,2,0,2,0,4
33914,70,10177,14266;15400,22995,0,0,2,0,2
33915,70,10178,14280;14674,22995,0,0,2,0,2
33916,70,10179,14300;14538;18131;18195,22995,2,0,2,0,4
33917,70,10180,14310;14629,22995,0,0,2,0,2
33918,70,10181,14357;14744;18318,22995,1,0,2,0,3
33919,70,10182,14226;14887;18499,22995,1,0,2,0,3
33920,70,10183,13822;14467;18594,22995,1,0,2,0,3
33921,70,10184,14474;14515,22995,0,0,2,0,2
33922,70,10185,14480;15061;18622,22995,1,0,2,0,3
33923,70,10186,14498;15578,22995,0,0,2,0,2
33924,70,10187,14281;14505,22995,0,0,2,0,2
33925,70,10188,14520;14991;18181,22995,1,0,2,0,3
33926,70,10189,14545;15029,22995,0,0,2,0,2
33927,70,10190,14579,22995,0,0,1,0,1
33928,70,10191,14482;14591;18413,22995,1,0,2,0,3
33929,70,10192,14648;15041;18639,22995,1,0,2,0,3
33930,70,10193,14604;14667;18031;18354,22995,1,1,2,0,4
33931,70,10194,14693;14722;18496,22995,1,0,2,0,3
33932,70,10195,14037;14706;18366,22995,1,0,2,0,3
33933,70,10196,14287;14808,22995,0,0,2,0,2
33934,70,10197,14686;14863;18134,22995,1,0,2,0,3
33935,70,10198,14873;15020;18320,22995,1,0,2,0,3
33936,70,10199,15551;15561;17806;18299,22995,1,1,2,0,4
33937,70,10200,14881;14899;18052,22995,1,0,2,0,3
33938,70,10201,14675;14894;18203,22995,1,0,2,0,3
33939,70,10202,14910;15221;17908;17992;18264,22995,1,2,2,0,5
33940,70,10203,14925;15151,22995,0,0,2,0,2
33941,70,10204,14929;15290;17918;18357,22995,1,1,2,0,4
33942,70,10205,14971;15430;18379;18508,22995,2,0,2,0,4
33943,70,10206,14692;15002;18037;18198,22995,1,1,2,0,4
33944,70,10207,14947;15011;17991;18286,22995,1,1,2,0,4
33945,70,10208,15040;15595;17917,22995,0,1,2,0,3
33946,70,10209,14699;15050,22995,0,0,2,0,2
33947,70,10210,15066;15196,22995,0,0,2,0,2
33948,70,10211,15492,22995,0,0,1,0,1
33949,70,10212,15024;15560;18039;18287;18420,22995,2,1,2,0,5
33950,70,10213,15127,22995,0,0,1,0,1
33951,70,10214,14798;15166,22995,0,0,2,0,2
33952,70,10215,15195;15255;17870;18504,22995,1,1,2,0,4
33953,70,10216,15202;15524;17819;18588,22995,1,1,2,0,4
33954,70,10217,14834;15209;18279,22995,1,0,2,0,3
33955,70,10218,15241;15625,22995,0,0,2,0,2
33956,70,10219,15256;15636;17967;18358,22995,1,1,2,0,4
33957,70,10220,10256,23360,0,0,0,1,1
33958,70,10221,10744,23360,0,0,1,0,1
33959,70,10223,10777,23360,0,0,1,0,1
33960,70,10224,10629,23360,0,0,0,1,1
33961,70,10226,10695;10852,23360,0,0,1,1,2
33962,70,10232,11648,23360,0,0,1,0,1
33963,70,10236,12346;12437,23360,0,0,2,0,2
33964,70,10238,12850,23360,0,0,1,0,1
33965,70,10239,12948,23360,0,0,1,0,1
33966,70,10242,13475;13488,23360,0,0,2,0,2
33967,70,10243,13364,23360,0,0,1,0,1
33968,70,10244,13406,23360,0,0,1,0,1
33969,70,10245,13437;13648;18412,23360,1,0,2,0,3
33970,70,10246,13466,23360,0,0,1,0,1
33971,70,10247,13536;13935,23360,0,0,2,0,2
33972,70,10248,13627;13903;18157;18382,23360,2,0,2,0,4
33973,70,10249,14219;18414,23360,1,0,1,0,2
33974,70,10250,13805;13830;18035,23360,0,1,2,0,3
33975,70,10251,13780;13917;17966,23360,0,1,2,0,3
33976,70,10252,13875;13925;18328,23360,1,0,2,0,3
33977,70,10253,13981;14892;18589,23360,1,0,2,0,3
33978,70,10254,14039;14210;18568,23360,1,0,2,0,3
33979,70,10255,13817;13991;18167;18453,23360,2,0,2,0,4
33980,70,10256,14279;15212,23360,0,0,2,0,2
33981,70,10257,14283;15059,23360,0,0,2,0,2
33982,70,10258,14135,23360,0,0,1,0,1
33983,70,10259,14403;14714,23360,0,0,2,0,2
33984,70,10260,14323,23360,0,0,1,0,1
33985,70,10262,14504;14636;18103;18339,23360,2,0,2,0,4
33986,70,10263,14518;18130;18273,23360,2,0,1,0,3
33987,70,10264,14558;14939,23360,0,0,2,0,2
33988,70,10265,14643;15204,23360,0,0,2,0,2
33989,70,10266,14508;14781;18224;18315,23360,2,0,2,0,4
33990,70,10267,14795;15380,23360,0,0,2,0,2
33991,70,10268,14487;15223;18183;18482,23360,2,0,2,0,4
33992,70,10269,14815;15394;18007;18377,23360,1,1,2,0,4
33993,70,10270,14820;15217,23360,0,0,2,0,2
33994,70,10271,14874;15067,23360,0,0,2,0,2
33995,70,10272,14234;14882,23360,0,0,2,0,2
33996,70,10273,14895;14933,23360,0,0,2,0,2
33997,70,10274,15153;15206,23360,0,0,2,0,2
33998,70,10275,14634;14951,23360,0,0,2,0,2
33999,70,10276,14972;15439,23360,0,0,2,0,2
34000,70,10277,15045,23360,0,0,1,0,1
34001,70,10278,15052;15193,23360,0,0,2,0,2
34002,70,10279,15062;15819;18154,23360,1,0,2,0,3
34003,70,10280,14875;15074,23360,0,0,2,0,2
34004,70,10281,14912;15094,23360,0,0,2,0,2
34005,70,10282,15149,23360,0,0,1,0,1
34006,70,10283,14824;15113,23360,0,0,2,0,2
34007,70,10284,15150;15197,23360,0,0,2,0,2
34008,70,10285,14814;15589,23360,0,0,2,0,2
34009,70,10286,14836;15191;18196;18463;18555,23360,3,0,2,0,5
34010,70,10287,15203;15827;18041,23360,0,1,2,0,3
34011,70,10288,15210;15849,23360,0,0,2,0,2
34012,70,10289,15047;15539;18218;18419,23360,2,0,2,0,4
34013,70,10290,14659;15227;18289;18465,23360,2,0,2,0,4
34014,70,10291,14484;15260,23360,0,0,2,0,2
34015,70,10292,15310;15419,23360,0,0,2,0,2
34016,70,10293,15315;15809,23360,0,0,2,0,2
34017,70,10294,15316;15334;17927;18411,23360,1,1,2,0,4
34018,70,10295,14865;15348,23360,0,0,2,0,2
34019,70,10296,15356;15474;18565,23360,1,0,2,0,3
34020,70,10297,15119;15363,23360,0,0,2,0,2
34021,70,10298,15592;18135;18242;18526,23360,3,0,1,0,4
34022,70,10299,15416;15855,23360,0,0,2,0,2
34023,70,10300,15417;15667,23360,0,0,2,0,2
34024,70,10301,15418;15815,23360,0,0,2,0,2
34025,70,10302,15440;15712,23360,0,0,2,0,2
34026,70,10303,14861;15441,23360,0,0,2,0,2
34027,70,10304,14666;15447,23360,0,0,2,0,2
34028,70,10305,15457;15818;18369,23360,1,0,2,0,3
34029,70,10306,15325;15467,23360,0,0,2,0,2
34030,70,10307,10676,23725,0,0,0,1,1
34031,70,10308,10891,23725,0,0,1,0,1
34032,70,10309,10997;11134,23725,0,0,2,0,2
34033,70,10313,11403,23725,0,0,1,0,1
34034,70,10314,11351,23725,0,0,1,0,1
34035,70,10317,11623,23725,0,0,1,0,1
34036,70,10318,11921,23725,0,0,1,0,1
34037,70,10319,11566;12102,23725,0,0,2,0,2
34038,70,10320,11753,23725,0,0,1,0,1
34039,70,10321,12088,23725,0,0,1,0,1
34040,70,10322,11884,23725,0,0,1,0,1
34041,70,10323,11626,23725,0,0,1,0,1
34042,70,10325,12869,23725,0,0,1,0,1
34043,70,10326,12666,23725,0,0,1,0,1
34044,70,10327,12868;13167,23725,0,0,2,0,2
34045,70,10328,12952,23725,0,0,1,0,1
34046,70,10329,12408,23725,0,0,1,0,1
34047,70,10330,12365,23725,0,0,1,0,1
34048,70,10331,13190;13282,23725,0,0,2,0,2
34049,70,10333,13376;13765,23725,0,0,2,0,2
34050,70,10335,13462,23725,0,0,1,0,1
34051,70,10336,13288;13567;18258,23725,1,0,2,0,3
34052,70,10338,12946,23725,0,0,1,0,1
34053,70,10339,13486;13675;18249,23725,1,0,2,0,3
34054,70,10340,13753;13992;18186,23725,1,0,2,0,3
34055,70,10341,13761,23725,0,0,1,0,1
34056,70,10342,13829,23725,0,0,1,0,1
34057,70,10344,13911;13977,23725,0,0,2,0,2
34058,70,10346,14049;14407;18378,23725,1,0,2,0,3
34059,70,10348,13692,23725,0,0,1,0,1
34060,70,10350,14236;14373;18095,23725,1,0,2,0,3
34061,70,10352,14321;14754;18206,23725,1,0,2,0,3
34062,70,10353,14431;14757;18080,23725,1,0,2,0,3
34063,70,10354,14499;14833,23725,0,0,2,0,2
34064,70,10355,14481;14511,23725,0,0,2,0,2
34065,70,10356,14519,23725,0,0,1,0,1
34066,70,10357,14075;14550;18408;18554,23725,2,0,2,0,4
34067,70,10358,14023;14574;18441,23725,1,0,2,0,3
34068,70,10359,14650;14739;18136;18490,23725,2,0,2,0,4
34069,70,10360,14687;14691,23725,0,0,2,0,2
34070,70,10361,14461;14738;18532,23725,1,0,2,0,3
34071,70,10362,14756;18176,23725,1,0,1,0,2
34072,70,10363,14217;14810;18084,23725,1,0,2,0,3
34073,70,10364,15830,23725,0,0,1,0,1
34074,70,10365,15424,23725,0,0,1,0,1
34075,70,10366,14524;14858;18460,23725,1,0,2,0,3
34076,70,10367,14447;14868,23725,0,0,2,0,2
34077,70,10368,14871;15487,23725,0,0,2,0,2
34078,70,10369,14906;15097;18086;18417,23725,2,0,2,0,4
34079,70,10370,14913;18491,23725,1,0,1,0,2
34080,70,10371,14529;14924;18615,23725,1,0,2,0,3
34081,70,10372,14927;15200,23725,0,0,2,0,2
34082,70,10373,14568;14948;18618,23725,1,0,2,0,3
34083,70,10374,14966,23725,0,0,1,0,1
34084,70,10375,14332;14750,23725,0,0,2,0,2
34085,70,10376,14472;15010,23725,0,0,2,0,2
34086,70,10377,15027;15159;18089;18540,23725,2,0,2,0,4
34087,70,10378,14741;15036;18217,23725,1,0,2,0,3
34088,70,10379,15044;15048,23725,0,0,2,0,2
34089,70,10380,14968;15213,23725,0,0,2,0,2
34090,70,10381,15049;15233;18090;18262,23725,2,0,2,0,4
34091,70,10382,15057;15464;18479;18531,23725,2,0,2,0,4
34092,70,10383,15038;15088,23725,0,0,2,0,2
34093,70,10384,14961;15098;18280,23725,1,0,2,0,3
34094,70,10385,15106;15429,23725,0,0,2,0,2
34095,70,10386,14709;15137;18497,23725,1,0,2,0,3
34096,70,10387,15107;15138;18533,23725,1,0,2,0,3
34097,70,10388,15178;15189,23725,0,0,2,0,2
34098,70,10389,14587;14806,23725,0,0,2,0,2
34099,70,10390,15489;18263,23725,1,0,1,0,2
34100,70,10391,15309;15398;18573,23725,1,0,2,0,3
34101,70,10392,15311,23725,0,0,1,0,1
34102,70,10393,15181;15332,23725,0,0,2,0,2
34103,70,10394,15342;15480,23725,0,0,2,0,2
34104,70,10395,15308;18338;18637,23725,2,0,1,0,3
34105,70,10396,15349;15766;18261,23725,1,0,2,0,3
34106,70,10397,15362;15881,23725,0,0,2,0,2
34107,70,10398,15385;15695;18120;18284,23725,2,0,2,0,4
34108,70,10399,15390;15763,23725,0,0,2,0,2
34109,70,10400,15391,23725,0,0,1,0,1
34110,70,10401,15402;15839;18290,23725,1,0,2,0,3
34111,70,10402,15404;16007;18245;18581,23725,2,0,2,0,4
34112,70,10403,15101;15425,23725,0,0,2,0,2
34113,70,10404,15432;15858,23725,0,0,2,0,2
34114,70,10405,15453,23725,0,0,1,0,1
34115,70,10406,15184;15466,23725,0,0,2,0,2
34116,70,10407,15472;15848,23725,0,0,2,0,2
34117,70,10408,14986;15478,23725,0,0,2,0,2
34118,70,10409,15483;15749,23725,0,0,2,0,2
34119,70,10410,15500;18302,23725,1,0,1,0,2
34120,70,10411,15501;15941;18153,23725,1,0,2,0,3
34121,70,10412,15504;15675,23725,0,0,2,0,2
34122,70,10413,15235;15507;18560,23725,1,0,2,0,3
34123,70,10414,15508;15582,23725,0,0,2,0,2
34124,70,10415,15528;16031,23725,0,0,2,0,2
34125,70,10416,15543;15904;18619,23725,1,0,2,0,3
34126,70,10417,15547;15990,23725,0,0,2,0,2
34127,70,10418,15082;15550,23725,0,0,2,0,2
34128,70,10419,15431;15556,23725,0,0,2,0,2
34129,70,10420,15564;15568;18285,23725,1,0,2,0,3
34130,70,10421,15286;15597;18171;18313,23725,2,0,2,0,4
34131,70,10422,10811,24090,0,0,1,0,1
34132,70,10423,10644,24090,0,0,0,1,1
34133,70,10426,11049,24090,0,0,1,0,1
34134,70,10427,10775,24090,0,0,1,0,1
34135,70,10429,11232,24090,0,0,1,0,1
34136,70,10430,10979,24090,0,0,1,0,1
34137,70,10432,11399;11435,24090,0,0,2,0,2
34138,70,10433,11433,24090,0,0,1,0,1
34139,70,10438,11929,24090,0,0,1,0,1
34140,70,10439,12251,24090,0,0,1,0,1
34141,70,10440,11939,24090,0,0,1,0,1
34142,70,10442,12342,24090,0,0,1,0,1
34143,70,10444,12569,24090,0,0,1,0,1
34144,70,10446,12306,24090,0,0,1,0,1
34145,70,10448,12840,24090,0,0,1,0,1
34146,70,10449,13058;13452,24090,0,0,2,0,2
34147,70,10450,12826,24090,0,0,1,0,1
34148,70,10451,12933,24090,0,0,1,0,1
34149,70,10452,13206;13764,24090,0,0,2,0,2
34150,70,10453,13352;13886;18381,24090,1,0,2,0,3
34151,70,10455,13499,24090,0,0,1,0,1
34152,70,10457,13541;14213;18613,24090,1,0,2,0,3
34153,70,10458,13365;13727,24090,0,0,2,0,2
34154,70,10459,13742,24090,0,0,1,0,1
34155,70,10460,13238,24090,0,0,1,0,1
34156,70,10461,13513,24090,0,0,1,0,1
34157,70,10462,14494,24090,0,0,1,0,1
34158,70,10463,13972;14450;18220;18486,24090,2,0,2,0,4
34159,70,10467,14641;18248,24090,1,0,1,0,2
34160,70,10468,14840;18247;18624,24090,2,0,1,0,3
34161,70,10469,14286;14746;18288,24090,1,0,2,0,3
34162,70,10470,14304;14794;18606,24090,1,0,2,0,3
34163,70,10471,14313;14664;18330;18585,24090,2,0,2,0,4
34164,70,10472,14079,24090,0,0,1,0,1
34165,70,10474,14436;14512,24090,0,0,2,0,2
34166,70,10475,14526;15117,24090,0,0,2,0,2
34167,70,10476,13970,24090,0,0,1,0,1
34168,70,10477,14120,24090,0,0,1,0,1
34169,70,10478,14777;15420,24090,0,0,2,0,2
34170,70,10479,14793;15132,24090,0,0,2,0,2
34171,70,10480,14817;14999,24090,0,0,2,0,2
34172,70,10481,14855,24090,0,0,1,0,1
34173,70,10482,14391,24090,0,0,1,0,1
34174,70,10483,14903,24090,0,0,1,0,1
34175,70,10484,14956;14967,24090,0,0,2,0,2
34176,70,10485,14970,24090,0,0,1,0,1
34177,70,10486,14797;14997,24090,0,0,2,0,2
34178,70,10487,14998,24090,0,0,1,0,1
34179,70,10488,15009;15406,24090,0,0,2,0,2
34180,70,10489,14818;15014;18423,24090,1,0,2,0,3
34181,70,10490,15542,24090,0,0,1,0,1
34182,70,10491,14811;15043,24090,0,0,2,0,2
34183,70,10492,15091;15892,24090,0,0,2,0,2
34184,70,10493,15128;15246,24090,0,0,2,0,2
34185,70,10494,15129;15555,24090,0,0,2,0,2
34186,70,10495,15131;15375,24090,0,0,2,0,2
34187,70,10496,14993;15134,24090,0,0,2,0,2
34188,70,10497,15141;15786,24090,0,0,2,0,2
34189,70,10498,14982;15172,24090,0,0,2,0,2
34190,70,10499,15199,24090,0,0,1,0,1
34191,70,10500,15205;15294,24090,0,0,2,0,2
34192,70,10501,14984;15222,24090,0,0,2,0,2
34193,70,10502,15248;16050;18410,24090,1,0,2,0,3
34194,70,10503,14901;15250,24090,0,0,2,0,2
34195,70,10504,15275;15872,24090,0,0,2,0,2
34196,70,10505,15754;15844;18562,24090,1,0,2,0,3
34197,70,10506,15300;15696,24090,0,0,2,0,2
34198,70,10507,15306;15811,24090,0,0,2,0,2
34199,70,10508,15326;15628,24090,0,0,2,0,2
34200,70,10509,15249;15338,24090,0,0,2,0,2
34201,70,10510,15054;15339,24090,0,0,2,0,2
34202,70,10511,15361;15384,24090,0,0,2,0,2
34203,70,10512,15902;18364,24090,1,0,1,0,2
34204,70,10513,15421;15869;18520,24090,1,0,2,0,3
34205,70,10514,15257;15426,24090,0,0,2,0,2
34206,70,10515,15427;15650,24090,0,0,2,0,2
34207,70,10516,15008;15437;18252;18326,24090,2,0,2,0,4
34208,70,10517,15443;16103,24090,0,0,2,0,2
34209,70,10518,15350;15444,24090,0,0,2,0,2
34210,70,10519,15496;15622,24090,0,0,2,0,2
34211,70,10520,15506;15831;18406,24090,1,0,2,0,3
34212,70,10521,14962;15530;18178;18611,24090,2,0,2,0,4
34213,70,10522,15408;15581,24090,0,0,2,0,2
34214,70,10523,15012;15583,24090,0,0,2,0,2
34215,70,10524,15307;15598,24090,0,0,2,0,2
34216,70,10525,15262;15613;18569,24090,1,0,2,0,3
34217,70,10526,15615;16024;18561,24090,1,0,2,0,3
34218,70,10527,14898;15671,24090,0,0,2,0,2
34219,70,10528,15635;15655,24090,0,0,2,0,2
34220,70,10529,15647;15822,24090,0,0,2,0,2
34221,70,10530,15649;15891,24090,0,0,2,0,2
34222,70,10531,15660;15835,24090,0,0,2,0,2
34223,70,10532,15678;15926,24090,0,0,2,0,2
34224,70,10533,15680,24090,0,0,1,0,1
34225,70,10534,15540;15689;18191;18542,24090,2,0,2,0,4
34226,70,10535,10691,24455,0,0,0,1,1
34227,70,10536,10950,24455,0,0,1,0,1
34228,70,10538,10927,24455,0,0,1,0,1
34229,70,10540,11449,24455,0,0,1,0,1
34230,70,10541,11230,24455,0,0,1,0,1
34231,70,10542,11531,24455,0,0,1,0,1
34232,70,10543,11577,24455,0,0,1,0,1
34233,70,10544,11670,24455,0,0,1,0,1
34234,70,10545,12081,24455,0,0,1,0,1
34235,70,10548,12290;12844,24455,0,0,2,0,2
34236,70,10549,12442,24455,0,0,1,0,1
34237,70,10550,12467,24455,0,0,1,0,1
34238,70,10552,12631,24455,0,0,1,0,1
34239,70,10553,12682,24455,0,0,1,0,1
34240,70,10554,12694,24455,0,0,1,0,1
34241,70,10555,12888,24455,0,0,1,0,1
34242,70,10556,12956,24455,0,0,1,0,1
34243,70,10558,12701,24455,0,0,1,0,1
34244,70,10559,13342;13750;18535,24455,1,0,2,0,3
34245,70,10561,13138,24455,0,0,1,0,1
34246,70,10562,13529,24455,0,0,1,0,1
34247,70,10565,13248;13798;18401,24455,1,0,2,0,3
34248,70,10568,13859;14034,24455,0,0,2,0,2
34249,70,10570,14129;14654;18388;18525,24455,2,0,2,0,4
34250,70,10571,13561,24455,0,0,1,0,1
34251,70,10572,13998;14185,24455,0,0,2,0,2
34252,70,10573,14506,24455,0,0,1,0,1
34253,70,10574,14271;14509,24455,0,0,2,0,2
34254,70,10575,14101;14847,24455,0,0,2,0,2
34255,70,10576,14600,24455,0,0,1,0,1
34256,70,10577,14423,24455,0,0,1,0,1
34257,70,10578,14475;14564,24455,0,0,2,0,2
34258,70,10579,14490;14639,24455,0,0,2,0,2
34259,70,10580,14273;14644,24455,0,0,2,0,2
34260,70,10581,14690;14764,24455,0,0,2,0,2
34261,70,10582,14732;14890;18609,24455,1,0,2,0,3
34262,70,10583,14237;14711,24455,0,0,2,0,2
34263,70,10584,14728;14841,24455,0,0,2,0,2
34264,70,10585,14662;14791,24455,0,0,2,0,2
34265,70,10586,14859;15215;18454,24455,1,0,2,0,3
34266,70,10587,14175,24455,0,0,1,0,1
34267,70,10589,14940;15095,24455,0,0,2,0,2
34268,70,10590,14752;14958;18421;18579,24455,2,0,2,0,4
34269,70,10591,14983;15355,24455,0,0,2,0,2
34270,70,10592,14294,24455,0,0,1,0,1
34271,70,10593,14576,24455,0,0,1,0,1
34272,70,10594,15021;15092,24455,0,0,2,0,2
34273,70,10595,14866;15030,24455,0,0,2,0,2
34274,70,10596,14946,24455,0,0,1,0,1
34275,70,10597,15037;15569,24455,0,0,2,0,2
34276,70,10599,14916,24455,0,0,1,0,1
34277,70,10600,15103,24455,0,0,1,0,1
34278,70,10601,15108;15251,24455,0,0,2,0,2
34279,70,10602,15146;15148,24455,0,0,2,0,2
34280,70,10603,15168;15188,24455,0,0,2,0,2
34281,70,10604,15171;15360,24455,0,0,2,0,2
34282,70,10605,14665;15174,24455,0,0,2,0,2
34283,70,10606,15228;15677;18628,24455,1,0,2,0,3
34284,70,10607,15237;15742,24455,0,0,2,0,2
34285,70,10608,15296;16035;18494,24455,1,0,2,0,3
34286,70,10609,15302;15854,24455,0,0,2,0,2
34287,70,10610,15523;18385,24455,1,0,1,0,2
34288,70,10611,15372,24455,0,0,1,0,1
34289,70,10612,15374;15937,24455,0,0,2,0,2
34290,70,10613,15381;15386,24455,0,0,2,0,2
34291,70,10614,15434;15442,24455,0,0,2,0,2
34292,70,10615,14772;15454,24455,0,0,2,0,2
34293,70,10616,15494;15912,24455,0,0,2,0,2
34294,70,10617,15497;15505,24455,0,0,2,0,2
34295,70,10618,16152,24455,0,0,1,0,1
34296,70,10619,15304;15468,24455,0,0,2,0,2
34297,70,10620,15544;15594;18383,24455,1,0,2,0,3
34298,70,10622,15565;15669,24455,0,0,2,0,2
34299,70,10623,15584;15808,24455,0,0,2,0,2
34300,70,10624,15614;15895;18537,24455,1,0,2,0,3
34301,70,10625,15927,24455,0,0,1,0,1
34302,70,10626,15337;15642,24455,0,0,2,0,2
34303,70,10627,16182;18306;18462,24455,2,0,1,0,3
34304,70,10628,15681,24455,0,0,1,0,1
34305,70,10629,15700;16047;18506,24455,1,0,2,0,3
34306,70,10630,15495;15703;18349;18443,24455,2,0,2,0,4
34307,70,10631,15711,24455,0,0,1,0,1
34308,70,10632,15272;15714;18374;18559,24455,2,0,2,0,4
34309,70,10633,15721;15874,24455,0,0,2,0,2
34310,70,10634,15729;15736;18596,24455,1,0,2,0,3
34311,70,10635,15738;15868,24455,0,0,2,0,2
34312,70,10636,15752;16275;18473,24455,1,0,2,0,3
34313,70,10637,16330,24455,0,0,1,0,1
34314,70,10638,15770;18467,24455,1,0,1,0,2
34315,70,10639,15545;15772,24455,0,0,2,0,2
34316,70,10640,15789;16273;18316,24455,1,0,2,0,3
34317,70,10641,15798;15964,24455,0,0,2,0,2
34318,70,10642,15521;15826,24455,0,0,2,0,2
34319,70,10643,15837;16049,24455,0,0,2,0,2
34320,70,10644,15860;16173;18577,24455,1,0,2,0,3
34321,70,10645,15866;16243,24455,0,0,2,0,2
34322,70,10646,15882,24455,0,0,1,0,1
34323,70,10647,15395,24455,0,0,1,0,1
34324,70,10648,10684,24820,0,0,0,1,1
34325,70,10649,11214,24820,0,0,1,0,1
34326,70,10650,11246,24820,0,0,1,0,1
34327,70,10653,11451,24820,0,0,1,0,1
34328,70,10654,11331,24820,0,0,1,0,1
34329,70,10655,11746;11840,24820,0,0,2,0,2
34330,70,10656,11026,24820,0,0,1,0,1
34331,70,10657,11761,24820,0,0,1,0,1
34332,70,10658,11911,24820,0,0,1,0,1
34333,70,10662,12097,24820,0,0,1,0,1
34334,70,10664,12157,24820,0,0,1,0,1
34335,70,10665,12273,24820,0,0,1,0,1
34336,70,10666,11950,24820,0,0,1,0,1
34337,70,10667,12731,24820,0,0,1,0,1
34338,70,10669,12613,24820,0,0,1,0,1
34339,70,10670,12545,24820,0,0,1,0,1
34340,70,10671,12945,24820,0,0,1,0,1
34341,70,10672,12551,24820,0,0,1,0,1
34342,70,10673,13187;13645,24820,0,0,2,0,2
34343,70,10674,13509,24820,0,0,1,0,1
34344,70,10675,13678,24820,0,0,1,0,1
34345,70,10676,13559,24820,0,0,1,0,1
34346,70,10677,13473,24820,0,0,1,0,1
34347,70,10678,13860,24820,0,0,1,0,1
34348,70,10679,13879,24820,0,0,1,0,1
34349,70,10680,13733,24820,0,0,1,0,1
34350,70,10681,13961,24820,0,0,1,0,1
34351,70,10682,14098,24820,0,0,1,0,1
34352,70,10683,14102;14444,24820,0,0,2,0,2
34353,70,10684,14358,24820,0,0,1,0,1
34354,70,10686,14150,24820,0,0,1,0,1
34355,70,10687,14240,24820,0,0,1,0,1
34356,70,10688,14307,24820,0,0,1,0,1
34357,70,10689,14260;14344,24820,0,0,2,0,2
34358,70,10690,14401,24820,0,0,1,0,1
34359,70,10691,14381;14917,24820,0,0,2,0,2
34360,70,10692,14350,24820,0,0,1,0,1
34361,70,10694,14835,24820,0,0,1,0,1
34362,70,10695,14331,24820,0,0,1,0,1
34363,70,10696,14586,24820,0,0,1,0,1
34364,70,10697,14612;14737;18450,24820,1,0,2,0,3
34365,70,10698,14720;14969,24820,0,0,2,0,2
34366,70,10699,14760;18512,24820,1,0,1,0,2
34367,70,10700,14620;14878,24820,0,0,2,0,2
34368,70,10701,14923,24820,0,0,1,0,1
34369,70,10702,14949;15511,24820,0,0,2,0,2
34370,70,10703,14277;14977,24820,0,0,2,0,2
34371,70,10704,15015;15423,24820,0,0,2,0,2
34372,70,10705,15018;15298,24820,0,0,2,0,2
34373,70,10706,14989;15084,24820,0,0,2,0,2
34374,70,10707,15116;15580,24820,0,0,2,0,2
34375,70,10708,15144;15368,24820,0,0,2,0,2
34376,70,10709,15238;15484,24820,0,0,2,0,2
34377,70,10710,15414;18578,24820,1,0,1,0,2
34378,70,10711,15284;15676,24820,0,0,2,0,2
34379,70,10712,15289;15612,24820,0,0,2,0,2
34380,70,10713,15293;16312,24820,0,0,2,0,2
34381,70,10714,15072;15314;18543,24820,1,0,2,0,3
34382,70,10715,15322,24820,0,0,1,0,1
34383,70,10716,15328;15645,24820,0,0,2,0,2
34384,70,10717,15433,24820,0,0,1,0,1
34385,70,10718,15175;15336,24820,0,0,2,0,2
34386,70,10719,15346,24820,0,0,1,0,1
34387,70,10720,15377;15476,24820,0,0,2,0,2
34388,70,10721,15387;15661,24820,0,0,2,0,2
34389,70,10722,15269,24820,0,0,1,0,1
34390,70,10723,14891;15422,24820,0,0,2,0,2
34391,70,10724,15435;15456,24820,0,0,2,0,2
34392,70,10725,15436;15533,24820,0,0,2,0,2
34393,70,10726,15482;15810,24820,0,0,2,0,2
34394,70,10727,15060;15527,24820,0,0,2,0,2
34395,70,10729,15090,24820,0,0,1,0,1
34396,70,10730,15450;15563,24820,0,0,2,0,2
34397,70,10731,15566;15951,24820,0,0,2,0,2
34398,70,10732,15033;15576,24820,0,0,2,0,2
34399,70,10733,14867;15587,24820,0,0,2,0,2
34400,70,10734,15604;15920,24820,0,0,2,0,2
34401,70,10735,14872;15637,24820,0,0,2,0,2
34402,70,10736,15652;16179,24820,0,0,2,0,2
34403,70,10737,15658;16450,24820,0,0,2,0,2
34404,70,10738,15664,24820,0,0,1,0,1
34405,70,10739,15670;16027,24820,0,0,2,0,2
34406,70,10740,15685;15896,24820,0,0,2,0,2
34407,70,10741,15351;15726,24820,0,0,2,0,2
34408,70,10742,15771;15794,24820,0,0,2,0,2
34409,70,10743,15800;16362;18481,24820,1,0,2,0,3
34410,70,10744,15821;16186,24820,0,0,2,0,2
34411,70,10745,15857;16347,24820,0,0,2,0,2
34412,70,10746,15908,24820,0,0,1,0,1
34413,70,10747,15567;15917;18557,24820,1,0,2,0,3
34414,70,10748,15609;15922,24820,0,0,2,0,2
34415,70,10749,15938;16217;18567,24820,1,0,2,0,3
34416,70,10750,15952;16300,24820,0,0,2,0,2
34417,70,10751,15968;16299;18474,24820,1,0,2,0,3
34418,70,10752,15942;15982,24820,0,0,2,0,2
34419,70,10753,15787;15989,24820,0,0,2,0,2
34420,70,10754,16018;16189,24820,0,0,2,0,2
34421,70,10755,10720,25185,0,0,1,0,1
34422,70,10756,11079,25185,0,0,1,0,1
34423,70,10757,11384,25185,0,0,1,0,1
34424,70,10758,11412,25185,0,0,1,0,1
34425,70,10759,11201,25185,0,0,1,0,1
34426,70,10760,11027,25185,0,0,1,0,1
34427,70,10761,10941,25185,0,0,1,0,1
34428,70,10763,11501,25185,0,0,1,0,1
34429,70,10764,11819,25185,0,0,1,0,1
34430,70,10765,11907,25185,0,0,1,0,1
34431,70,10766,12478,25185,0,0,1,0,1
34432,70,10767,12189,25185,0,0,1,0,1
34433,70,10769,12287,25185,0,0,1,0,1
34434,70,10770,12664,25185,0,0,1,0,1
34435,70,10771,12429,25185,0,0,1,0,1
34436,70,10772,12288,25185,0,0,1,0,1
34437,70,10773,13105,25185,0,0,1,0,1
34438,70,10774,12807,25185,0,0,1,0,1
34439,70,10775,12816,25185,0,0,1,0,1
34440,70,10776,13079,25185,0,0,1,0,1
34441,70,10778,13116,25185,0,0,1,0,1
34442,70,10779,13120,25185,0,0,1,0,1
34443,70,10780,13281,25185,0,0,1,0,1
34444,70,10781,12828,25185,0,0,1,0,1
34445,70,10782,13292,25185,0,0,1,0,1
34446,70,10783,13312;13586;18563,25185,1,0,2,0,3
34447,70,10784,13380;13968,25185,0,0,2,0,2
34448,70,10785,13389;13976,25185,0,0,2,0,2
34449,70,10787,13442,25185,0,0,1,0,1
34450,70,10788,13443,25185,0,0,1,0,1
34451,70,10789,13445,25185,0,0,1,0,1
34452,70,10790,14119,25185,0,0,1,0,1
34453,70,10791,13724,25185,0,0,1,0,1
34454,70,10793,14028,25185,0,0,1,0,1
34455,70,10794,14015,25185,0,0,1,0,1
34456,70,10795,14123,25185,0,0,1,0,1
34457,70,10796,14127,25185,0,0,1,0,1
34458,70,10797,14016,25185,0,0,1,0,1
34459,70,10798,13855,25185,0,0,1,0,1
34460,70,10800,14385,25185,0,0,1,0,1
34461,70,10801,13815,25185,0,0,1,0,1
34462,70,10802,14680;15319,25185,0,0,2,0,2
34463,70,10803,13726,25185,0,0,1,0,1
34464,70,10804,14696;14710,25185,0,0,2,0,2
34465,70,10806,14941;15281,25185,0,0,2,0,2
34466,70,10807,14974,25185,0,0,1,0,1
34467,70,10808,15026;16169,25185,0,0,2,0,2
34468,70,10809,15035;15534,25185,0,0,2,0,2
34469,70,10810,15105;15110,25185,0,0,2,0,2
34470,70,10811,15076;15124,25185,0,0,2,0,2
34471,70,10812,15226,25185,0,0,1,0,1
34472,70,10813,15236;15722,25185,0,0,2,0,2
34473,70,10814,15253;15767,25185,0,0,2,0,2
34474,70,10815,15274;15638,25185,0,0,2,0,2
34475,70,10816,15053;15278,25185,0,0,2,0,2
34476,70,10817,15378;15824,25185,0,0,2,0,2
34477,70,10818,15219;15405,25185,0,0,2,0,2
34478,70,10819,15411;16130,25185,0,0,2,0,2
34479,70,10820,15558;15617,25185,0,0,2,0,2
34480,70,10821,15143;15477,25185,0,0,2,0,2
34481,70,10822,15549;16160,25185,0,0,2,0,2
34482,70,10823,15461;15552,25185,0,0,2,0,2
34483,70,10824,15575;16176,25185,0,0,2,0,2
34484,70,10825,15626;15863,25185,0,0,2,0,2
34485,70,10826,15916,25185,0,0,1,0,1
34486,70,10827,15359;15610,25185,0,0,2,0,2
34487,70,10828,15616,25185,0,0,1,0,1
34488,70,10829,15463,25185,0,0,1,0,1
34489,70,10830,15623,25185,0,0,1,0,1
34490,70,10831,14920;15634,25185,0,0,2,0,2
34491,70,10832,15641;15682,25185,0,0,2,0,2
34492,70,10833,15662;16252,25185,0,0,2,0,2
34493,70,10834,15665;15834,25185,0,0,2,0,2
34494,70,10835,15687;16119,25185,0,0,2,0,2
34495,70,10836,15706;16304,25185,0,0,2,0,2
34496,70,10837,15666;15718,25185,0,0,2,0,2
34497,70,10838,15816;16341,25185,0,0,2,0,2
34498,70,10839,15846;16327,25185,0,0,2,0,2
34499,70,10840,15557;15579,25185,0,0,2,0,2
34500,70,10841,15864;16329,25185,0,0,2,0,2
34501,70,10842,15886;16296,25185,0,0,2,0,2
34502,70,10843,15888;16334,25185,0,0,2,0,2
34503,70,10844,15899;16265;18538,25185,1,0,2,0,3
34504,70,10845,15633;15915;18575,25185,1,0,2,0,3
34505,70,10846,15928;15981,25185,0,0,2,0,2
34506,70,10847,15944,25185,0,0,1,0,1
34507,70,10848,15746;15947,25185,0,0,2,0,2
34508,70,10849,15948;16360,25185,0,0,2,0,2
34509,70,10850,15955;16083,25185,0,0,2,0,2
34510,70,10851,15972;16128,25185,0,0,2,0,2
34511,70,10852,16010;16578,25185,0,0,2,0,2
34512,70,10853,16051;16379,25185,0,0,2,0,2
34513,70,10854,16054;16058,25185,0,0,2,0,2
34514,70,10855,16057;16358,25185,0,0,2,0,2
34515,70,10856,15515;16059,25185,0,0,2,0,2
34516,70,10857,16066;16315,25185,0,0,2,0,2
34517,70,10858,16095;16154,25185,0,0,2,0,2
34518,70,10859,16116;16375,25185,0,0,2,0,2
34519,70,10860,15510;16117,25185,0,0,2,0,2
34520,70,10861,16108;16122,25185,0,0,2,0,2
34521,70,10862,16124;16551;18623,25185,1,0,2,0,3
34522,70,10863,16126;16233,25185,0,0,2,0,2
34523,70,10864,16138;16483,25185,0,0,2,0,2
34524,70,10865,16151;16262,25185,0,0,2,0,2
34525,70,10866,15520,25185,0,0,1,0,1
34526,70,10867,15769;16190,25185,0,0,2,0,2
34527,70,10868,11227,25550,0,0,1,0,1
34528,70,10869,11090,25550,0,0,1,0,1
34529,70,10870,11269,25550,0,0,1,0,1
34530,70,10871,11363,25550,0,0,1,0,1
34531,70,10872,11608,25550,0,0,1,0,1
34532,70,10873,11711,25550,0,0,1,0,1
34533,70,10875,11455,25550,0,0,1,0,1
34534,70,10876,11919,25550,0,0,1,0,1
34535,70,10877,12012,25550,0,0,1,0,1
34536,70,10878,12406,25550,0,0,1,0,1
34537,70,10880,11883,25550,0,0,1,0,1
34538,70,10881,12295,25550,0,0,1,0,1
34539,70,10882,11942,25550,0,0,1,0,1
34540,70,10883,12065,25550,0,0,1,0,1
34541,70,10884,12535,25550,0,0,1,0,1
34542,70,10885,12159,25550,0,0,1,0,1
34543,70,10886,12877,25550,0,0,1,0,1
34544,70,10887,13051,25550,0,0,1,0,1
34545,70,10888,12965,25550,0,0,1,0,1
34546,70,10889,12763,25550,0,0,1,0,1
34547,70,10890,12748,25550,0,0,1,0,1
34548,70,10891,13096,25550,0,0,1,0,1
34549,70,10892,13446,25550,0,0,1,0,1
34550,70,10893,13481,25550,0,0,1,0,1
34551,70,10895,13535;13681,25550,0,0,2,0,2
34552,70,10896,13296,25550,0,0,1,0,1
34553,70,10897,13274,25550,0,0,1,0,1
34554,70,10898,13279,25550,0,0,1,0,1
34555,70,10899,13219,25550,0,0,1,0,1
34556,70,10900,13626,25550,0,0,1,0,1
34557,70,10901,14055,25550,0,0,1,0,1
34558,70,10902,13549,25550,0,0,1,0,1
34559,70,10903,14298;14904,25550,0,0,2,0,2
34560,70,10904,14133,25550,0,0,1,0,1
34561,70,10905,13865,25550,0,0,1,0,1
34562,70,10906,14426,25550,0,0,1,0,1
34563,70,10907,14469;14785,25550,0,0,2,0,2
34564,70,10908,14105,25550,0,0,1,0,1
34565,70,10909,14527;14888,25550,0,0,2,0,2
34566,70,10910,14549,25550,0,0,1,0,1
34567,70,10911,14552;14902,25550,0,0,2,0,2
34568,70,10912,14483,25550,0,0,1,0,1
34569,70,10913,14701,25550,0,0,1,0,1
34570,70,10914,14457,25550,0,0,1,0,1
34571,70,10915,14094,25550,0,0,1,0,1
34572,70,10916,14825,25550,0,0,1,0,1
34573,70,10917,14697;14905,25550,0,0,2,0,2
34574,70,10918,15156,25550,0,0,1,0,1
34575,70,10919,15070,25550,0,0,1,0,1
34576,70,10920,15022,25550,0,0,1,0,1
34577,70,10921,14801;15063,25550,0,0,2,0,2
34578,70,10922,15104;15160,25550,0,0,2,0,2
34579,70,10923,15145;15201,25550,0,0,2,0,2
34580,70,10924,15216,25550,0,0,1,0,1
34581,70,10925,15277,25550,0,0,1,0,1
34582,70,10926,15303,25550,0,0,1,0,1
34583,70,10927,15321;15728,25550,0,0,2,0,2
34584,70,10928,15347;15731,25550,0,0,2,0,2
34585,70,10929,14766;15354,25550,0,0,2,0,2
34586,70,10930,15410,25550,0,0,1,0,1
34587,70,10931,15335,25550,0,0,1,0,1
34588,70,10932,15491,25550,0,0,1,0,1
34589,70,10933,15073,25550,0,0,1,0,1
34590,70,10934,15526;15853,25550,0,0,2,0,2
34591,70,10935,15585,25550,0,0,1,0,1
34592,70,10936,15287;15648,25550,0,0,2,0,2
34593,70,10937,15069;15651,25550,0,0,2,0,2
34594,70,10938,15674;15962,25550,0,0,2,0,2
34595,70,10939,15710;15897,25550,0,0,2,0,2
34596,70,10940,15720;16147,25550,0,0,2,0,2
34597,70,10941,15748;15986,25550,0,0,2,0,2
34598,70,10942,15292,25550,0,0,1,0,1
34599,70,10943,15365;15765,25550,0,0,2,0,2
34600,70,10944,15679;15775,25550,0,0,2,0,2
34601,70,10945,15532;15784,25550,0,0,2,0,2
34602,70,10946,15258;15801,25550,0,0,2,0,2
34603,70,10947,15823;16185,25550,0,0,2,0,2
34604,70,10948,15838;16132,25550,0,0,2,0,2
34605,70,10949,15889;16618,25550,0,1,1,0,2
34606,70,10950,15894;16125,25550,0,0,2,0,2
34607,70,10951,15596,25550,0,0,1,0,1
34608,70,10952,15929,25550,0,0,1,0,1
34609,70,10953,15971;16628,25550,0,1,1,0,2
34610,70,10954,15785;15975,25550,0,0,2,0,2
34611,70,10955,15984;16180,25550,0,0,2,0,2
34612,70,10956,15978;16000,25550,0,0,2,0,2
34613,70,10957,15632;16001,25550,0,0,2,0,2
34614,70,10958,16002;16417,25550,0,0,2,0,2
34615,70,10959,15843;16060,25550,0,0,2,0,2
34616,70,10960,16064;16097,25550,0,0,2,0,2
34617,70,10961,16087;16344,25550,0,0,2,0,2
34618,70,10962,15571;16121,25550,0,0,2,0,2
34619,70,10963,16131;16489,25550,0,0,2,0,2
34620,70,10964,16085;16170,25550,0,0,2,0,2
34621,70,10965,16201,25550,0,0,1,0,1
34622,70,10966,16206;16602,25550,0,0,2,0,2
34623,70,10967,16207,25550,0,0,1,0,1
34624,70,10968,16065;16218,25550,0,0,2,0,2
34625,70,10969,16222;16716,25550,0,1,1,0,2
34626,70,10970,15924;16246,25550,0,0,2,0,2
34627,70,10971,16144;16253,25550,0,0,2,0,2
34628,70,10972,16127;16264,25550,0,0,2,0,2
34629,70,10973,16271;16645,25550,0,1,1,0,2
34630,70,10974,16229;16279,25550,0,0,2,0,2
34631,70,10975,16324,25550,0,0,1,0,1
34632,70,10976,16326,25550,0,0,1,0,1
34633,70,10977,15755,25550,0,0,1,0,1
34634,80,1,4,0,0,0,0,1,1
34635,80,4,4337,0,0,0,0,1,1
34636,80,19,61;6642,0,0,0,0,2,2
34637,80,54,10092,0,0,0,0,1,1
34638,80,61,180,0,0,0,0,1,1
34639,80,140,11066;11181,0,0,0,0,2,2
34640,80,144,8055,0,0,0,0,1,1
34641,80,178,2555,0,0,0,0,1,1
34642,80,207,9356,0,0,0,0,1,1
34643,80,280,740;10169,0,0,0,0,2,2
34644,80,393,10260,0,0,0,0,1,1
34645,80,437,5742,0,0,0,0,1,1
34646,80,478,1260,0,0,0,0,1,1
34647,80,552,1452,0,0,0,0,1,1
34648,80,584,1538;2068,0,0,0,0,2,2
34649,80,610,3507,0,0,0,0,1,1
34650,80,614,1618;1619;10411,0,0,0,0,3,3
34651,80,749,1963;7142,0,0,0,0,2,2
34652,80,797,10103;10121;10271;10331,0,0,0,0,4,4
34653,80,818,2142,0,0,0,0,1,1
34654,80,941,2476,0,0,0,0,1,1
34655,80,1029,5135,0,0,0,0,1,1
34656,80,1077,1700;3346,0,0,0,0,2,2
34657,80,1251,3298,0,0,0,0,1,1
34658,80,1359,3592,0,0,0,0,1,1
34659,80,1414,3735,0,0,0,0,1,1
34660,80,1551,4091;4093,0,0,0,0,2,2
34661,80,1577,2396,0,0,0,0,1,1
34662,80,1715,1577,0,0,0,0,1,1
34663,80,1769,4633,0,0,0,0,1,1
34664,80,1822,10147,0,0,0,0,1,1
34665,80,2028,2323,0,0,0,0,1,1
34666,80,2083,5437,0,0,0,0,1,1
34667,80,2197,9526,0,0,0,0,1,1
34668,80,2343,1360,0,0,0,0,1,1
34669,80,2355,6085,0,0,0,0,1,1
34670,80,2453,6342,0,0,0,0,1,1
34671,80,2501,9927,0,0,0,0,1,1
34672,80,2540,213;8627,0,0,0,0,2,2
34673,80,2574,5900,0,0,0,0,1,1
34674,80,2638,11089;11184,0,0,0,0,2,2
34675,80,2658,2545,0,0,0,0,1,1
34676,80,2719,8443,0,0,0,0,1,1
34677,80,2759,10244;10711,0,0,0,0,2,2
34678,80,2869,4577,0,0,0,0,1,1
34679,80,2882,7439;7440,0,0,0,0,2,2
34680,80,3009,7665,0,0,0,0,1,1
34681,80,3022,219,0,0,0,0,1,1
34682,80,3191,1943,0,0,0,0,1,1
34683,80,3290,8474,0,0,0,0,1,1
34684,80,3383,10243;10483,0,0,0,0,2,2
34685,80,3435,10321,0,0,0,0,1,1
34686,80,3479,8978,0,0,0,0,1,1
34687,80,3519,2383,0,0,0,0,1,1
34688,80,3580,10284;10502,0,0,0,0,2,2
34689,80,3594,1351;2231,0,0,0,0,2,2
34690,80,3603,9295,0,0,0,0,1,1
34691,80,3651,10538;10992,0,0,0,0,2,2
34692,80,3771,9742,0,0,0,0,1,1
34693,80,3784,9778,0,0,0,0,1,1
34694,80,3823,3901,0,0,0,0,1,1
34695,80,3825,9897,0,0,0,0,1,1
34696,80,3864,10390,0,0,0,0,1,1
34697,80,3929,6147,0,0,0,0,1,1
34698,80,4015,5757,365,0,0,0,1,1
34699,80,4076,5525,730,0,0,0,1,1
34700,80,4173,5451,730,0,0,0,1,1
34701,80,4200,517,1095,0,0,0,1,1
34702,80,4243,4274,1095,0,0,0,1,1
34703,80,4289,11984;12134;16309,1095,0,0,3,0,3
34704,80,4290,6390,1095,0,0,0,1,1
34705,80,4301,8596,1095,0,0,0,1,1
34706,80,4304,12232;12295,1095,0,0,2,0,2
34707,80,4305,36,1095,0,0,0,1,1
34708,80,4328,1925,1460,0,0,0,1,1
34709,80,4369,3944,1460,0,0,0,1,1
34710,80,4371,7;9645,1460,0,0,0,2,2
34711,80,4420,7603,1460,0,0,0,1,1
34712,80,4449,9947,1825,0,0,0,1,1
34713,80,4451,511,1825,0,0,0,1,1
34714,80,4461,1769,1825,0,0,0,1,1
34715,80,4489,8087,1825,0,0,0,1,1
34716,80,4502,7801,1825,0,0,0,1,1
34717,80,4507,9015,1825,0,0,0,1,1
34718,80,4515,6239,1825,0,0,0,1,1
34719,80,4536,11715;12138;12177;12555;16799,1825,0,0,5,0,5
34720,80,4564,773,2190,0,0,0,1,1
34721,80,4567,6719,2190,0,0,0,1,1
34722,80,4569,561,2190,0,0,0,1,1
34723,80,4573,3758,2190,0,0,0,1,1
34724,80,4604,3621,2190,0,0,0,1,1
34725,80,4605,4486,2190,0,0,0,1,1
34726,80,4606,8561,2190,0,0,0,1,1
34727,80,4646,8470,2190,0,0,0,1,1
34728,80,4658,2559,2190,0,0,0,1,1
34729,80,4669,1386,2555,0,0,0,1,1
34730,80,4671,6070,2555,0,0,0,1,1
34731,80,4686,7222,2555,0,0,0,1,1
34732,80,4703,7808,2555,0,0,0,1,1
34733,80,4708,4694,2555,0,0,0,1,1
34734,80,4719,11861;12024,2555,0,0,2,0,2
34735,80,4730,2787,2555,0,0,0,1,1
34736,80,4733,6184,2555,0,0,0,1,1
34737,80,4745,8822,2555,0,0,0,1,1
34738,80,4756,7461;8144,2555,0,0,0,2,2
34739,80,4757,6464,2555,0,0,0,1,1
34740,80,4763,8712,2555,0,0,0,1,1
34741,80,4767,8893,2555,0,0,0,1,1
34742,80,4769,6526;8966,2555,0,0,0,2,2
34743,80,4770,9246,2555,0,0,0,1,1
34744,80,4793,11735;12083;16567,2920,0,0,3,0,3
34745,80,4794,2656,2920,0,0,0,1,1
34746,80,4803,1935,2920,0,0,0,1,1
34747,80,4805,2500,2920,0,0,0,1,1
34748,80,4807,7525,2920,0,0,0,1,1
34749,80,4809,4953,2920,0,0,0,1,1
34750,80,4816,2798,2920,0,0,0,1,1
34751,80,4817,12168;12456;13314;14003;18033;18458,2920,0,2,4,0,6
34752,80,4820,2033,2920,0,0,0,1,1
34753,80,4823,3523,2920,0,0,0,1,1
34754,80,4832,8169,2920,0,0,0,1,1
34755,80,4843,7732,2920,0,0,0,1,1
34756,80,4858,863,2920,0,0,0,1,1
34757,80,4864,6751,2920,0,0,0,1,1
34758,80,4872,5679;7733,2920,0,0,0,2,2
34759,80,4879,3633;3709,2920,0,0,0,2,2
34760,80,4882,4924,2920,0,0,0,1,1
34761,80,4883,8502,2920,0,0,0,1,1
34762,80,4887,8573,2920,0,0,0,1,1
34763,80,4888,8584,2920,0,0,0,1,1
34764,80,4893,8823,2920,0,0,0,1,1
34765,80,4895,6845,2920,0,0,0,1,1
34766,80,4902,6158,2920,0,0,0,1,1
34767,80,4911,4308,3285,0,0,0,1,1
34768,80,4918,349,3285,0,0,0,1,1
34769,80,4923,1344,3285,0,0,0,1,1
34770,80,4935,8688,3285,0,0,0,1,1
34771,80,4938,2433,3285,0,0,0,1,1
34772,80,4940,4043,3285,0,0,0,1,1
34773,80,4974,2014,3285,0,0,0,1,1
34774,80,4993,6586,3285,0,0,0,1,1
34775,80,5010,8759,3285,0,0,0,1,1
34776,80,5011,1609,3285,0,0,0,1,1
34777,80,5016,6736,3285,0,0,0,1,1
34778,80,5033,4400,3650,0,0,0,1,1
34779,80,5040,1288,3650,0,0,0,1,1
34780,80,5046,3202,3650,0,0,0,1,1
34781,80,5054,9423,3650,0,0,0,1,1
34782,80,5065,1147,3650,0,0,0,1,1
34783,80,5078,3380,3650,0,0,0,1,1
34784,80,5079,4595,3650,0,0,0,1,1
34785,80,5081,4771,3650,0,0,0,1,1
34786,80,5091,7969,3650,0,0,0,1,1
34787,80,5100,933,3650,0,0,0,1,1
34788,80,5108,4655,3650,0,0,0,1,1
34789,80,5110,6238,3650,0,0,0,1,1
34790,80,5116,4979,3650,0,0,0,1,1
34791,80,5118,7306;12335,3650,0,0,1,1,2
34792,80,5138,5969,3650,0,0,0,1,1
34793,80,5150,7073,3650,0,0,0,1,1
34794,80,5168,1016,4015,0,0,0,1,1
34795,80,5170,1096,4015,0,0,0,1,1
34796,80,5177,12604;12810;18000,4015,0,1,2,0,3
34797,80,5188,3595,4015,0,0,0,1,1
34798,80,5190,7998,4015,0,0,0,1,1
34799,80,5192,3741,4015,0,0,0,1,1
34800,80,5195,4713,4015,0,0,0,1,1
34801,80,5205,760,4015,0,0,0,1,1
34802,80,5219,6112,4015,0,0,0,1,1
34803,80,5224,6404,4015,0,0,0,1,1
34804,80,5233,1774,4015,0,0,0,1,1
34805,80,5238,765;7127,4015,0,0,0,2,2
34806,80,5244,5442,4015,0,0,0,1,1
34807,80,5250,2815;8149,4015,0,0,0,2,2
34808,80,5255,7621,4015,0,0,0,1,1
34809,80,5260,1766,4015,0,0,0,1,1
34810,80,5261,6603,4015,0,0,0,1,1
34811,80,5263,1649,4015,0,0,0,1,1
34812,80,5266,2475,4015,0,0,0,1,1
34813,80,5267,2008,4015,0,0,0,1,1
34814,80,5277,674;4963,4380,0,0,0,2,2
34815,80,5298,3520,4380,0,0,0,1,1
34816,80,5301,1933,4380,0,0,0,1,1
34817,80,5303,1399,4380,0,0,0,1,1
34818,80,5306,8442,4380,0,0,0,1,1
34819,80,5307,4271,4380,0,0,0,1,1
34820,80,5326,6857,4380,0,0,0,1,1
34821,80,5328,2816,4380,0,0,0,1,1
34822,80,5341,3207,4380,0,0,0,1,1
34823,80,5346,8845,4380,0,0,0,1,1
34824,80,5355,2620,4380,0,0,0,1,1
34825,80,5356,9694,4380,0,0,0,1,1
34826,80,5370,7158,4745,0,0,0,1,1
34827,80,5377,1537,4745,0,0,0,1,1
34828,80,5384,2581,4745,0,0,0,1,1
34829,80,5388,9389,4745,0,0,0,1,1
34830,80,5394,2031,4745,0,0,0,1,1
34831,80,5395,1451,4745,0,0,0,1,1
34832,80,5396,3615,4745,0,0,0,1,1
34833,80,5399,2789,4745,0,0,0,1,1
34834,80,5405,2788,4745,0,0,0,1,1
34835,80,5409,5489,4745,0,0,0,1,1
34836,80,5411,3356,4745,0,0,0,1,1
34837,80,5412,2669,4745,0,0,0,1,1
34838,80,5418,6110,4745,0,0,0,1,1
34839,80,5419,5202,4745,0,0,0,1,1
34840,80,5424,6950;9764,4745,0,0,0,2,2
34841,80,5431,1966,4745,0,0,0,1,1
34842,80,5432,3003;5792,4745,0,0,0,2,2
34843,80,5434,7994,4745,0,0,0,1,1
34844,80,5442,3713;5735,4745,0,0,0,2,2
34845,80,5446,4689;9783,4745,0,0,0,2,2
34846,80,5465,1104;1364,5110,0,0,0,2,2
34847,80,5467,1427,5110,0,0,0,1,1
34848,80,5469,4268,5110,0,0,0,1,1
34849,80,5472,1771,5110,0,0,0,1,1
34850,80,5476,6567;9485,5110,0,0,0,2,2
34851,80,5481,6885,5110,0,0,0,1,1
34852,80,5483,4062,5110,0,0,0,1,1
34853,80,5487,4435,5110,0,0,0,1,1
34854,80,5490,4581,5110,0,0,0,1,1
34855,80,5491,6252,5110,0,0,0,1,1
34856,80,5492,3376,5110,0,0,0,1,1
34857,80,5498,5630,5110,0,0,0,1,1
34858,80,5499,5100,5110,0,0,0,1,1
34859,80,5501,5809,5110,0,0,0,1,1
34860,80,5502,3471,5110,0,0,0,1,1
34861,80,5507,5659,5110,0,0,0,1,1
34862,80,5516,8746,5110,0,0,0,1,1
34863,80,5528,1045;5459,5110,0,0,0,2,2
34864,80,5533,3573;13498,5110,0,0,1,1,2
34865,80,5534,9693,5110,0,0,0,1,1
34866,80,5536,5187,5475,0,0,0,1,1
34867,80,5553,1544;3945,5475,0,0,0,2,2
34868,80,5555,6127,5475,0,0,0,1,1
34869,80,5560,4883,5475,0,0,0,1,1
34870,80,5561,1930;3367,5475,0,0,0,2,2
34871,80,5573,3120,5475,0,0,0,1,1
34872,80,5575,9637,5475,0,0,0,1,1
34873,80,5576,1608,5475,0,0,0,1,1
34874,80,5578,14189;14315;16782;17721;18631;18739,5475,0,2,4,0,6
34875,80,5579,6809;8372,5475,0,0,0,2,2
34876,80,5581,3710,5475,0,0,0,1,1
34877,80,5584,7964;9677;12409,5475,0,0,1,2,3
34878,80,5585,5047,5475,0,0,0,1,1
34879,80,5592,4587,5475,0,0,0,1,1
34880,80,5594,8135,5475,0,0,0,1,1
34881,80,5595,4700,5475,0,0,0,1,1
34882,80,5605,5892,5475,0,0,0,1,1
34883,80,5610,4656;6839,5475,0,0,0,2,2
34884,80,5611,2123,5475,0,0,0,1,1
34885,80,5614,2434,5475,0,0,0,1,1
34886,80,5619,3046,5475,0,0,0,1,1
34887,80,5620,3156;7697,5475,0,0,0,2,2
34888,80,5628,8010,5475,0,0,0,1,1
34889,80,5634,8641,5475,0,0,0,1,1
34890,80,5635,5241;6088,5475,0,0,0,2,2
34891,80,5639,9400;12557,5475,0,0,1,1,2
34892,80,5644,8556,5475,0,0,0,1,1
34893,80,5645,4285,5475,0,0,0,1,1
34894,80,5647,631;9853,5475,0,0,0,2,2
34895,80,5649,612,5840,0,0,0,1,1
34896,80,5652,120,5840,0,0,0,1,1
34897,80,5656,378;1847,5840,0,0,0,2,2
34898,80,5661,8201;10030,5840,0,0,0,2,2
34899,80,5663,13760;17977,5840,0,1,1,0,2
34900,80,5665,1267;4845,5840,0,0,0,2,2
34901,80,5669,7709,5840,0,0,0,1,1
34902,80,5670,3503,5840,0,0,0,1,1
34903,80,5678,10105,5840,0,0,0,1,1
34904,80,5681,3029,5840,0,0,0,1,1
34905,80,5683,10012,5840,0,0,0,1,1
34906,80,5685,2271,5840,0,0,0,1,1
34907,80,5686,9056;10040,5840,0,0,0,2,2
34908,80,5687,6309,5840,0,0,0,1,1
34909,80,5689,1667,5840,0,0,0,1,1
34910,80,5690,3968,5840,0,0,0,1,1
34911,80,5692,9726,5840,0,0,0,1,1
34912,80,5697,3840;4752,5840,0,0,0,2,2
34913,80,5701,5064,5840,0,0,0,1,1
34914,80,5704,5228,5840,0,0,0,1,1
34915,80,5705,10045,5840,0,0,0,1,1
34916,80,5706,8409,5840,0,0,0,1,1
34917,80,5707,6905,5840,0,0,0,1,1
34918,80,5708,5425,5840,0,0,0,1,1
34919,80,5709,2775;5436,5840,0,0,0,2,2
34920,80,5710,81;7193,5840,0,0,0,2,2
34921,80,5711,10113,5840,0,0,0,1,1
34922,80,5714,5985,5840,0,0,0,1,1
34923,80,5722,8220,5840,0,0,0,1,1
34924,80,5726,7197,5840,0,0,0,1,1
34925,80,5728,6071;8338,5840,0,0,0,2,2
34926,80,5732,8047,5840,0,0,0,1,1
34927,80,5739,6571,5840,0,0,0,1,1
34928,80,5740,9220,5840,0,0,0,1,1
34929,80,5742,480,5840,0,0,0,1,1
34930,80,5746,4945,5840,0,0,0,1,1
34931,80,5747,8967,5840,0,0,0,1,1
34932,80,5748,9037,5840,0,0,0,1,1
34933,80,5754,3725,5840,0,0,0,1,1
34934,80,5763,319;7765,6205,0,0,0,2,2
34935,80,5764,10063,6205,0,0,0,1,1
34936,80,5765,477,6205,0,0,0,1,1
34937,80,5766,9514,6205,0,0,0,1,1
34938,80,5767,803,6205,0,0,0,1,1
34939,80,5776,44;10061,6205,0,0,0,2,2
34940,80,5779,5002;7341,6205,0,0,0,2,2
34941,80,5785,2689,6205,0,0,0,1,1
34942,80,5787,632;9709,6205,0,0,0,2,2
34943,80,5795,3591,6205,0,0,0,1,1
34944,80,5796,10112,6205,0,0,0,1,1
34945,80,5800,4218,6205,0,0,0,1,1
34946,80,5803,9197,6205,0,0,0,1,1
34947,80,5805,8498,6205,0,0,0,1,1
34948,80,5806,4757,6205,0,0,0,1,1
34949,80,5814,5297,6205,0,0,0,1,1
34950,80,5818,5642,6205,0,0,0,1,1
34951,80,5821,3601,6205,0,0,0,1,1
34952,80,5822,5929,6205,0,0,0,1,1
34953,80,5824,3961,6205,0,0,0,1,1
34954,80,5825,6262,6205,0,0,0,1,1
34955,80,5829,2146,6205,0,0,0,1,1
34956,80,5830,6369,6205,0,0,0,1,1
34957,80,5833,1026;8146,6205,0,0,0,2,2
34958,80,5834,9681,6205,0,0,0,1,1
34959,80,5839,10053,6205,0,0,0,1,1
34960,80,5842,1623;7097,6205,0,0,0,2,2
34961,80,5843,1313,6205,0,0,0,1,1
34962,80,5847,2062,6205,0,0,0,1,1
34963,80,5848,7747,6205,0,0,0,1,1
34964,80,5849,5156,6205,0,0,0,1,1
34965,80,5853,5674,6205,0,0,0,1,1
34966,80,5859,7802,6205,0,0,0,1,1
34967,80,5860,9425,6205,0,0,0,1,1
34968,80,5867,93;10246,6570,0,0,0,2,2
34969,80,5869,10232,6570,0,0,0,1,1
34970,80,5870,294;652,6570,0,0,0,2,2
34971,80,5873,7762,6570,0,0,0,1,1
34972,80,5874,1092,6570,0,0,0,1,1
34973,80,5876,1231,6570,0,0,0,1,1
34974,80,5878,10122,6570,0,0,0,1,1
34975,80,5879,1564,6570,0,0,0,1,1
34976,80,5886,921,6570,0,0,0,1,1
34977,80,5890,2919,6570,0,0,0,1,1
34978,80,5891,2963,6570,0,0,0,1,1
34979,80,5893,960;1191,6570,0,0,0,2,2
34980,80,5895,3118,6570,0,0,0,1,1
34981,80,5899,8698,6570,0,0,0,1,1
34982,80,5919,4219,6570,0,0,0,1,1
34983,80,5923,5040;10089,6570,0,0,0,2,2
34984,80,5925,5723,6570,0,0,0,1,1
34985,80,5933,6233;10077,6570,0,0,0,2,2
34986,80,5934,2159,6570,0,0,0,1,1
34987,80,5935,878;10214,6570,0,0,0,2,2
34988,80,5945,8297,6570,0,0,0,1,1
34989,80,5947,10283;10319,6570,0,0,0,2,2
34990,80,5948,4677,6570,0,0,0,1,1
34991,80,5949,7029,6570,0,0,0,1,1
34992,80,5953,4476,6570,0,0,0,1,1
34993,80,5959,7394,6570,0,0,0,1,1
34994,80,5960,3055,6570,0,0,0,1,1
34995,80,5962,9099,6570,0,0,0,1,1
34996,80,5963,10158,6570,0,0,0,1,1
34997,80,5966,3794,6570,0,0,0,1,1
34998,80,5968,6693,6570,0,0,0,1,1
34999,80,5970,665,6570,0,0,0,1,1
35000,80,5971,10299,6570,0,0,0,1,1
35001,80,5973,9626,6570,0,0,0,1,1
35002,80,5976,2539,6570,0,0,0,1,1
35003,80,5977,6056,6570,0,0,0,1,1
35004,80,5985,316,6935,0,0,0,1,1
35005,80,5995,10155,6935,0,0,0,1,1
35006,80,5998,5798,6935,0,0,0,1,1
35007,80,5999,1940;2069,6935,0,0,0,2,2
35008,80,6001,4704,6935,0,0,0,1,1
35009,80,6005,5016,6935,0,0,0,1,1
35010,80,6017,4833;8701,6935,0,0,0,2,2
35011,80,6020,5032,6935,0,0,0,1,1
35012,80,6021,320;7177,6935,0,0,0,2,2
35013,80,6023,8998,6935,0,0,0,1,1
35014,80,6028,6155;7444,6935,0,0,0,2,2
35015,80,6030,3679,6935,0,0,0,1,1
35016,80,6037,10031,6935,0,0,0,1,1
35017,80,6038,7054,6935,0,0,0,1,1
35018,80,6043,10367,6935,0,0,0,1,1
35019,80,6052,3517;9046,6935,0,0,0,2,2
35020,80,6056,10308,6935,0,0,0,1,1
35021,80,6062,2896;10003,6935,0,0,0,2,2
35022,80,6063,10082,6935,0,0,0,1,1
35023,80,6064,10328,6935,0,0,0,1,1
35024,80,6066,10093,6935,0,0,0,1,1
35025,80,6067,10036;10098,6935,0,0,0,2,2
35026,80,6068,1747,6935,0,0,0,1,1
35027,80,6069,10018;10058,7300,0,0,0,2,2
35028,80,6071,6389,7300,0,0,0,1,1
35029,80,6072,1727;3246,7300,0,0,0,2,2
35030,80,6073,10484,7300,0,0,0,1,1
35031,80,6074,546;10407,7300,0,0,0,2,2
35032,80,6076,1334,7300,0,0,0,1,1
35033,80,6077,10201,7300,0,0,0,1,1
35034,80,6079,10218,7300,0,0,0,1,1
35035,80,6082,1093;2442,7300,0,0,0,2,2
35036,80,6085,10078;10084,7300,0,0,0,2,2
35037,80,6086,7310,7300,0,0,0,1,1
35038,80,6091,6967,7300,0,0,0,1,1
35039,80,6093,10069,7300,0,0,0,1,1
35040,80,6100,10065,7300,0,0,0,1,1
35041,80,6102,4106;10371,7300,0,0,0,2,2
35042,80,6107,10480,7300,0,0,0,1,1
35043,80,6111,5097,7300,0,0,0,1,1
35044,80,6113,5161,7300,0,0,0,1,1
35045,80,6114,5170,7300,0,0,0,1,1
35046,80,6115,5402,7300,0,0,0,1,1
35047,80,6121,5850;9654,7300,0,0,0,2,2
35048,80,6126,10322,7300,0,0,0,1,1
35049,80,6127,6849;7098,7300,0,0,0,2,2
35050,80,6129,5175;10188,7300,0,0,0,2,2
35051,80,6154,9879,7300,0,0,0,1,1
35052,80,6157,10019,7300,0,0,0,1,1
35053,80,6159,10475,7300,0,0,0,1,1
35054,80,6161,9042;10055,7300,0,0,0,2,2
35055,80,6163,10083,7300,0,0,0,1,1
35056,80,6164,10439;15341,7300,0,0,1,1,2
35057,80,6166,10132,7300,0,0,0,1,1
35058,80,6168,10329,7300,0,0,0,1,1
35059,80,6169,4571;10203,7300,0,0,0,2,2
35060,80,6170,10205,7300,0,0,0,1,1
35061,80,6171,10224,7300,0,0,0,1,1
35062,80,6172,10400,7300,0,0,0,1,1
35063,80,6173,10219,7300,0,0,0,1,1
35064,80,6174,10075,7665,0,0,0,1,1
35065,80,6175,5460;10094,7665,0,0,0,2,2
35066,80,6177,653,7665,0,0,0,1,1
35067,80,6182,6744;10111,7665,0,0,0,2,2
35068,80,6188,6560,7665,0,0,0,1,1
35069,80,6189,2015;9518,7665,0,0,0,2,2
35070,80,6193,5137,7665,0,0,0,1,1
35071,80,6197,3126,7665,0,0,0,1,1
35072,80,6199,3318,7665,0,0,0,1,1
35073,80,6213,14272;18558;19744,7665,1,1,1,0,3
35074,80,6214,9888,7665,0,0,0,1,1
35075,80,6216,896,7665,0,0,0,1,1
35076,80,6222,7255,7665,0,0,0,1,1
35077,80,6223,1044;9580,7665,0,0,0,2,2
35078,80,6226,7724;10395,7665,0,0,0,2,2
35079,80,6229,613;8145,7665,0,0,0,2,2
35080,80,6243,10024;10306,7665,0,0,0,2,2
35081,80,6244,10354,7665,0,0,0,1,1
35082,80,6245,10090,7665,0,0,0,1,1
35083,80,6246,4868;10377,7665,0,0,0,2,2
35084,80,6247,10164,7665,0,0,0,1,1
35085,80,6248,10168,7665,0,0,0,1,1
35086,80,6250,10432,7665,0,0,0,1,1
35087,80,6252,10248,7665,0,0,0,1,1
35088,80,6253,10255;10296,7665,0,0,0,2,2
35089,80,6254,10530,7665,0,0,0,1,1
35090,80,6255,10265;10594,7665,0,0,0,2,2
35091,80,6256,10486,7665,0,0,0,1,1
35092,80,6257,10292;10482,7665,0,0,0,2,2
35093,80,6258,10312,7665,0,0,0,1,1
35094,80,6259,10537,7665,0,0,0,1,1
35095,80,6260,10332;10565,7665,0,0,0,2,2
35096,80,6261,10008;10080,8030,0,0,0,2,2
35097,80,6279,2871,8030,0,0,0,1,1
35098,80,6287,4315,8030,0,0,0,1,1
35099,80,6315,9267;10180,8030,0,0,0,2,2
35100,80,6316,1720;9231,8030,0,0,0,2,2
35101,80,6319,10042;10141,8030,0,0,0,2,2
35102,80,6322,10021;10071,8030,0,0,0,2,2
35103,80,6324,10091;10104,8030,0,0,0,2,2
35104,80,6327,10861,8030,0,0,0,1,1
35105,80,6330,10234,8030,0,0,0,1,1
35106,80,6332,1051;10236,8030,0,0,0,2,2
35107,80,6335,10272,8030,0,0,0,1,1
35108,80,6336,10309;10463,8030,0,0,0,2,2
35109,80,6337,10314,8030,0,0,0,1,1
35110,80,6338,10316;10374,8030,0,0,0,2,2
35111,80,6339,10446;10790,8030,0,0,0,2,2
35112,80,6340,10398,8030,0,0,0,1,1
35113,80,6341,10382,8030,0,0,0,1,1
35114,80,6342,10412,8030,0,0,0,1,1
35115,80,6343,10015,8030,0,0,0,1,1
35116,80,6347,383,8395,0,0,0,1,1
35117,80,6351,10038,8395,0,0,0,1,1
35118,80,6354,1308,8395,0,0,0,1,1
35119,80,6356,8052,8395,0,0,0,1,1
35120,80,6357,169,8395,0,0,0,1,1
35121,80,6358,1493;10562,8395,0,0,0,2,2
35122,80,6362,2534;4151,8395,0,0,0,2,2
35123,80,6368,6470,8395,0,0,0,1,1
35124,80,6369,10120,8395,0,0,0,1,1
35125,80,6374,10305,8395,0,0,0,1,1
35126,80,6381,8057,8395,0,0,0,1,1
35127,80,6383,10152;10245,8395,0,0,0,2,2
35128,80,6384,10241,8395,0,0,0,1,1
35129,80,6391,9317,8395,0,0,0,1,1
35130,80,6404,4304,8395,0,0,0,1,1
35131,80,6408,10353,8395,0,0,0,1,1
35132,80,6410,10126,8395,0,0,0,1,1
35133,80,6412,6114;10088,8395,0,0,0,2,2
35134,80,6413,6823,8395,0,0,0,1,1
35135,80,6414,10097,8395,0,0,0,1,1
35136,80,6415,5186;10114,8395,0,0,0,2,2
35137,80,6417,10523,8395,0,0,0,1,1
35138,80,6418,13803,8395,0,0,1,0,1
35139,80,6419,10144,8395,0,0,0,1,1
35140,80,6421,10149,8395,0,0,0,1,1
35141,80,6422,10170,8395,0,0,0,1,1
35142,80,6423,10193,8395,0,0,0,1,1
35143,80,6424,10109;10208,8395,0,0,0,2,2
35144,80,6426,10153;10215,8395,0,0,0,2,2
35145,80,6427,10591,8395,0,0,0,1,1
35146,80,6428,10727,8395,0,0,0,1,1
35147,80,6430,10359,8395,0,0,0,1,1
35148,80,6431,10007;10380,8395,0,0,0,2,2
35149,80,6432,10336;10431,8395,0,0,0,2,2
35150,80,6433,10434;10472,8395,0,0,0,2,2
35151,80,6434,10436,8395,0,0,0,1,1
35152,80,6435,10325;10449,8395,0,0,0,2,2
35153,80,6436,12072;12660,8395,0,0,2,0,2
35154,80,6437,10717,8395,0,0,0,1,1
35155,80,6438,10578;10788,8395,0,0,0,2,2
35156,80,6440,10344;10646,8760,0,0,0,2,2
35157,80,6446,10085,8760,0,0,0,1,1
35158,80,6447,1345;5433,8760,0,0,0,2,2
35159,80,6448,10399,8760,0,0,0,1,1
35160,80,6452,8839;9751,8760,0,0,0,2,2
35161,80,6461,3241;10099,8760,0,0,0,2,2
35162,80,6462,3267,8760,0,0,0,1,1
35163,80,6466,5522;10183,8760,0,0,0,2,2
35164,80,6483,6654,8760,0,0,0,1,1
35165,80,6488,5013,8760,0,0,0,1,1
35166,80,6491,7972,8760,0,0,0,1,1
35167,80,6501,4990;9506,8760,0,0,0,2,2
35168,80,6503,4456,8760,0,0,0,1,1
35169,80,6504,10020,8760,0,0,0,1,1
35170,80,6505,10288,8760,0,0,0,1,1
35171,80,6506,10066;10138,8760,0,0,0,2,2
35172,80,6508,10167;10250,8760,0,0,0,2,2
35173,80,6509,10579,8760,0,0,0,1,1
35174,80,6511,10735;10747,8760,0,0,0,2,2
35175,80,6513,10501,8760,0,0,0,1,1
35176,80,6514,10118,8760,0,0,0,1,1
35177,80,6516,10423,8760,0,0,0,1,1
35178,80,6517,10176;10425,8760,0,0,0,2,2
35179,80,6518,10427;10674,8760,0,0,0,2,2
35180,80,6519,10590,8760,0,0,0,1,1
35181,80,6520,10461;10505,8760,0,0,0,2,2
35182,80,6521,10895,8760,0,0,0,1,1
35183,80,6522,9849;10068,8760,0,0,0,2,2
35184,80,6523,10513;10850,8760,0,0,0,2,2
35185,80,6524,10517;10661,8760,0,0,0,2,2
35186,80,6526,10797,8760,0,0,0,1,1
35187,80,6527,10507;10534,8760,0,0,0,2,2
35188,80,6528,10547,8760,0,0,0,1,1
35189,80,6529,10563,8760,0,0,0,1,1
35190,80,6531,10671,8760,0,0,0,1,1
35191,80,6532,10595,8760,0,0,0,1,1
35192,80,6533,10350;10597,8760,0,0,0,2,2
35193,80,6541,10455;13387,9125,0,0,1,1,2
35194,80,6542,2965;3137,9125,0,0,0,2,2
35195,80,6557,10108;10254,9125,0,0,0,2,2
35196,80,6564,10159,9125,0,0,0,1,1
35197,80,6571,7443;10177,9125,0,0,0,2,2
35198,80,6574,367;7346,9125,0,0,0,2,2
35199,80,6578,1668,9125,0,0,0,1,1
35200,80,6584,10662;10696,9125,0,0,0,2,2
35201,80,6589,10100,9125,0,0,0,1,1
35202,80,6592,10229;10485,9125,0,0,0,2,2
35203,80,6593,10194,9125,0,0,0,1,1
35204,80,6594,10202,9125,0,0,0,1,1
35205,80,6595,10207,9125,0,0,0,1,1
35206,80,6596,10539;10542,9125,0,0,0,2,2
35207,80,6597,10396,9125,0,0,0,1,1
35208,80,6598,10389;10481,9125,0,0,0,2,2
35209,80,6599,10268;10368,9125,0,0,0,2,2
35210,80,6601,10435;10628,9125,0,0,0,2,2
35211,80,6602,10864,9125,0,0,0,1,1
35212,80,6603,10392;10639,9125,0,0,0,2,2
35213,80,6604,10540;10672,9125,0,0,0,2,2
35214,80,6605,10466;10650,9125,0,0,0,2,2
35215,80,6606,10605,9125,0,0,0,1,1
35216,80,6607,10919;10988,9125,0,0,0,2,2
35217,80,6608,10739;10762,9125,0,0,0,2,2
35218,80,6609,10278;10418,9125,0,0,0,2,2
35219,80,6611,10866;11009,9125,0,0,0,2,2
35220,80,6612,10627,9125,0,0,0,1,1
35221,80,6613,10123;10601,9125,0,0,0,2,2
35222,80,6614,10610;15167,9125,0,0,1,1,2
35223,80,6615,10955,9125,0,0,0,1,1
35224,80,6616,10623,9125,0,0,0,1,1
35225,80,6617,10763,9125,0,0,0,1,1
35226,80,6618,10625,9125,0,0,0,1,1
35227,80,6619,10848,9125,0,0,0,1,1
35228,80,6620,10490;10657;14556,9125,0,0,1,2,3
35229,80,6621,10495;10675,9125,0,0,0,2,2
35230,80,6622,10677;15270,9125,0,0,1,1,2
35231,80,6623,10626;10679,9125,0,0,0,2,2
35232,80,6624,10681;10873,9125,0,0,0,2,2
35233,80,6646,8150,9490,0,0,0,1,1
35234,80,6660,8408,9490,0,0,0,1,1
35235,80,6668,1192,9490,0,0,0,1,1
35236,80,6673,6469;8697,9490,0,0,0,2,2
35237,80,6675,3019,9490,0,0,0,1,1
35238,80,6682,10009,9490,0,0,0,1,1
35239,80,6684,10457,9490,0,0,0,1,1
35240,80,6686,10217;10489,9490,0,0,0,2,2
35241,80,6687,10253;10510,9490,0,0,0,2,2
35242,80,6688,10508,9490,0,0,0,1,1
35243,80,6689,10171,9490,0,0,0,1,1
35244,80,6690,10190;10267,9490,0,0,0,2,2
35245,80,6691,10285;10376,9490,0,0,0,2,2
35246,80,6693,10039,9490,0,0,0,1,1
35247,80,6694,7530;10192,9490,0,0,0,2,2
35248,80,6696,10445,9490,0,0,0,1,1
35249,80,6698,10459,9490,0,0,0,1,1
35250,80,6700,10573;10596,9490,0,0,0,2,2
35251,80,6701,10493;10792,9490,0,0,0,2,2
35252,80,6702,10503,9490,0,0,0,1,1
35253,80,6703,10320;10546;13974,9490,0,0,1,2,3
35254,80,6704,10497;10645,9490,0,0,0,2,2
35255,80,6705,10560,9490,0,0,0,1,1
35256,80,6706,10576;10799,9490,0,0,0,2,2
35257,80,6707,10577,9490,0,0,0,1,1
35258,80,6708,10585,9490,0,0,0,1,1
35259,80,6709,10592,9490,0,0,0,1,1
35260,80,6710,10528;10604,9490,0,0,0,2,2
35261,80,6711,10419,9490,0,0,0,1,1
35262,80,6712,10618;10885,9490,0,0,0,2,2
35263,80,6713,10259;10616,9490,0,0,0,2,2
35264,80,6714,10240;10687,9490,0,0,0,2,2
35265,80,6715,10640,9490,0,0,0,1,1
35266,80,6716,10827,9490,0,0,0,1,1
35267,80,6717,10337;10670,9490,0,0,0,2,2
35268,80,6718,10731,9490,0,0,0,1,1
35269,80,6719,10473;14017,9490,0,0,1,1,2
35270,80,6720,10406;10700,9490,0,0,0,2,2
35271,80,6721,10789;11010,9490,0,0,0,2,2
35272,80,6722,11053,9490,0,0,0,1,1
35273,80,6723,10977,9490,0,0,0,1,1
35274,80,6725,10791;10821,9490,0,0,0,2,2
35275,80,6728,10373;14268,9855,0,0,1,1,2
35276,80,6749,4448;9364,9855,0,0,0,2,2
35277,80,6754,4956,9855,0,0,0,1,1
35278,80,6756,9103,9855,0,0,0,1,1
35279,80,6757,14681;15177;18367;19249,9855,0,2,2,0,4
35280,80,6765,7893,9855,0,0,0,1,1
35281,80,6773,10029,9855,0,0,0,1,1
35282,80,6774,10303;10430,9855,0,0,0,2,2
35283,80,6775,10239,9855,0,0,0,1,1
35284,80,6776,10225;10230,9855,0,0,0,2,2
35285,80,6777,10266,9855,0,0,0,1,1
35286,80,6778,10294,9855,0,0,0,1,1
35287,80,6779,10174;10304,9855,0,0,0,2,2
35288,80,6780,10341;10532,9855,0,0,0,2,2
35289,80,6781,10362;13277,9855,0,0,1,1,2
35290,80,6782,10145;10365,9855,0,0,0,2,2
35291,80,6783,10366,9855,0,0,0,1,1
35292,80,6784,10352,9855,0,0,0,1,1
35293,80,6785,10358,9855,0,0,0,1,1
35294,80,6786,10323;10464,9855,0,0,0,2,2
35295,80,6787,10197;10506,9855,0,0,0,2,2
35296,80,6789,10456;10853,9855,0,0,0,2,2
35297,80,6790,10647,9855,0,0,0,1,1
35298,80,6791,10545,9855,0,0,0,1,1
35299,80,6792,10488,9855,0,0,0,1,1
35300,80,6793,10529;10871,9855,0,0,0,2,2
35301,80,6794,10584;14085,9855,0,0,1,1,2
35302,80,6797,10630;10701,9855,0,0,0,2,2
35303,80,6798,10631,9855,0,0,0,1,1
35304,80,6799,10648;10892,9855,0,0,0,2,2
35305,80,6800,10654;10758,9855,0,0,0,2,2
35306,80,6801,10669,9855,0,0,0,1,1
35307,80,6802,10518;10703,9855,0,0,0,2,2
35308,80,6803,10551;10705,9855,0,0,0,2,2
35309,80,6804,11130;11185,9855,0,0,0,2,2
35310,80,6805,11004;11052,9855,0,0,0,2,2
35311,80,6806,14011;14404;18843,9855,0,1,2,0,3
35312,80,6807,10707;10785,9855,0,0,0,2,2
35313,80,6808,10582;10795,9855,0,0,0,2,2
35314,80,6809,10442,9855,0,0,0,1,1
35315,80,6810,10816;11110,9855,0,0,0,2,2
35316,80,6811,11025,9855,0,0,0,1,1
35317,80,6812,10600;10847,9855,0,0,0,2,2
35318,80,6813,10749;10889,9855,0,0,0,2,2
35319,80,6814,10899;10970,9855,0,0,0,2,2
35320,80,6815,10903;11197,9855,0,0,0,2,2
35321,80,6823,3289,10220,0,0,0,1,1
35322,80,6839,414,10220,0,0,0,1,1
35323,80,6840,10286,10220,0,0,0,1,1
35324,80,6842,5128,10220,0,0,0,1,1
35325,80,6843,6348;10189,10220,0,0,0,2,2
35326,80,6860,10128;10282,10220,0,0,0,2,2
35327,80,6862,7890,10220,0,0,0,1,1
35328,80,6863,10289,10220,0,0,0,1,1
35329,80,6865,10385,10220,0,0,0,1,1
35330,80,6870,10603,10220,0,0,0,1,1
35331,80,6871,10370;10784,10220,0,0,0,2,2
35332,80,6872,10228,10220,0,0,0,1,1
35333,80,6873,10685,10220,0,0,0,1,1
35334,80,6874,10728,10220,0,0,0,1,1
35335,80,6875,10688,10220,0,0,0,1,1
35336,80,6876,10694;10787,10220,0,0,0,2,2
35337,80,6878,10800,10220,0,0,0,1,1
35338,80,6879,10613,10220,0,0,0,1,1
35339,80,6880,10888;10935,10220,0,0,0,2,2
35340,80,6881,10898,10220,0,0,0,1,1
35341,80,6882,11086,10220,0,0,0,1,1
35342,80,6883,10766;10948,10220,0,0,0,2,2
35343,80,6884,10960;11152,10220,0,0,0,2,2
35344,80,6885,10961;11195,10220,0,0,0,2,2
35345,80,6886,10776;11088,10220,0,0,0,2,2
35346,80,6887,10896;10984,10220,0,0,0,2,2
35347,80,6888,10771,10220,0,0,0,1,1
35348,80,6889,11137,10220,0,0,0,1,1
35349,80,6890,11144,10220,0,0,0,1,1
35350,80,6895,804;10026,10585,0,0,0,2,2
35351,80,6897,3798,10585,0,0,0,1,1
35352,80,6900,94,10585,0,0,0,1,1
35353,80,6909,357,10585,0,0,0,1,1
35354,80,6924,10249;10683,10585,0,0,0,2,2
35355,80,6925,10013;10408,10585,0,0,0,2,2
35356,80,6927,10452;10782,10585,0,0,0,2,2
35357,80,6928,10185;14258,10585,0,0,1,1,2
35358,80,6929,10221,10585,0,0,0,1,1
35359,80,6931,10462;10531,10585,0,0,0,2,2
35360,80,6932,10567;10637,10585,0,0,0,2,2
35361,80,6933,10665;10859,10585,0,0,0,2,2
35362,80,6934,10004;10070,10585,0,0,0,2,2
35363,80,6935,10709;10759,10585,0,0,0,2,2
35364,80,6936,10857;11058,10585,0,0,0,2,2
35365,80,6937,10589;10822,10585,0,0,0,2,2
35366,80,6939,10487;10833,10585,0,0,0,2,2
35367,80,6940,10841,10585,0,0,0,1,1
35368,80,6941,10843,10585,0,0,0,1,1
35369,80,6943,10921;10925,10585,0,0,0,2,2
35370,80,6944,10867,10585,0,0,0,1,1
35371,80,6945,10535;10887,10585,0,0,0,2,2
35372,80,6946,10527;10849,10585,0,0,0,2,2
35373,80,6947,11280;11344,10585,0,0,0,2,2
35374,80,6948,10926;11552,10585,0,0,0,2,2
35375,80,6949,10770,10585,0,0,0,1,1
35376,80,6950,10893;11147,10585,0,0,0,2,2
35377,80,6951,10996;11018,10585,0,0,0,2,2
35378,80,6952,10714;11045,10585,0,0,0,2,2
35379,80,6953,11274,10585,0,0,0,1,1
35380,80,6954,10806;11054,10585,0,0,0,2,2
35381,80,6956,11080,10585,0,0,0,1,1
35382,80,6957,11095;11343;16104,10585,0,0,1,2,3
35383,80,6962,10010,10950,0,0,0,1,1
35384,80,6977,3438,10950,0,0,0,1,1
35385,80,6981,5301,10950,0,0,0,1,1
35386,80,6990,5604,10950,0,0,0,1,1
35387,80,6999,10231,10950,0,0,0,1,1
35388,80,7000,10311,10950,0,0,0,1,1
35389,80,7003,10378,10950,0,0,0,1,1
35390,80,7005,10394;10557,10950,0,0,0,2,2
35391,80,7007,10186;10420,10950,0,0,0,2,2
35392,80,7009,10756,10950,0,0,0,1,1
35393,80,7010,11037;11194;13496,10950,0,0,1,2,3
35394,80,7012,10764;10805,10950,0,0,0,2,2
35395,80,7013,10924;11074,10950,0,0,0,2,2
35396,80,7014,10342;10793,10950,0,0,0,2,2
35397,80,7015,10796,10950,0,0,0,1,1
35398,80,7017,10693;10808,10950,0,0,0,2,2
35399,80,7018,10922,10950,0,0,0,1,1
35400,80,7019,11168,10950,0,0,0,1,1
35401,80,7020,10883,10950,0,0,0,1,1
35402,80,7021,11093,10950,0,0,0,1,1
35403,80,7022,11140;11296,10950,0,0,0,2,2
35404,80,7023,10912;11077,10950,0,0,0,2,2
35405,80,7024,10972;11174;13872,10950,0,0,1,2,3
35406,80,7025,10851,10950,0,0,0,1,1
35407,80,7028,10989,10950,0,0,0,1,1
35408,80,7029,11005;11460,10950,0,0,0,2,2
35409,80,7030,10772;11006,10950,0,0,0,2,2
35410,80,7032,11035;11248,10950,0,0,0,2,2
35411,80,7033,11036,10950,0,0,0,1,1
35412,80,7034,11041,10950,0,0,0,1,1
35413,80,7035,11231;11462,10950,0,0,0,2,2
35414,80,7036,11415,10950,0,0,0,1,1
35415,80,7037,11068;11326,10950,0,0,0,2,2
35416,80,7038,11298,10950,0,0,0,1,1
35417,80,7039,10716;11099,10950,0,0,0,2,2
35418,80,7040,11102;11374;15606,10950,0,0,1,2,3
35419,80,7041,11103,10950,0,0,0,1,1
35420,80,7042,11043;11281,10950,0,0,0,2,2
35421,80,7043,11126;11441,10950,0,0,0,2,2
35422,80,7044,11055;11128,10950,0,0,0,2,2
35423,80,7045,11029,10950,0,0,0,1,1
35424,80,7046,10966;11159,10950,0,0,0,2,2
35425,80,7048,11154;11299;16068,10950,0,0,1,2,3
35426,80,7049,11012;11251,10950,0,0,0,2,2
35427,80,7050,11165;11409,10950,0,0,0,2,2
35428,80,7051,11339,10950,0,0,0,1,1
35429,80,7052,11261;14514;15961,10950,0,0,2,1,3
35430,80,7065,3863;10242,11315,0,0,0,2,2
35431,80,7069,10293;10429,11315,0,0,0,2,2
35432,80,7081,7223,11315,0,0,0,1,1
35433,80,7082,7410,11315,0,0,0,1,1
35434,80,7092,9987,11315,0,0,0,1,1
35435,80,7093,10388,11315,0,0,0,1,1
35436,80,7095,10279,11315,0,0,0,1,1
35437,80,7096,10135,11315,0,0,0,1,1
35438,80,7098,10313,11315,0,0,0,1,1
35439,80,7099,10360,11315,0,0,0,1,1
35440,80,7100,10441,11315,0,0,0,1,1
35441,80,7101,10553;10794,11315,0,0,0,2,2
35442,80,7102,10361,11315,0,0,0,1,1
35443,80,7103,10638;10761,11315,0,0,0,2,2
35444,80,7104,10598;10742,11315,0,0,0,2,2
35445,80,7105,11023;11277,11315,0,0,0,2,2
35446,80,7107,10384;10617;16430,11315,0,0,1,2,3
35447,80,7108,10991,11315,0,0,0,1,1
35448,80,7110,10743;11061,11315,0,0,0,2,2
35449,80,7111,10778;10802,11315,0,0,0,2,2
35450,80,7112,10561;10844;16033,11315,0,0,1,2,3
35451,80,7114,10901,11315,0,0,0,1,1
35452,80,7115,11087,11315,0,0,0,1,1
35453,80,7116,10930,11315,0,0,0,1,1
35454,80,7117,10801;10931,11315,0,0,0,2,2
35455,80,7118,10936;11158,11315,0,0,0,2,2
35456,80,7119,10943;11267,11315,0,0,0,2,2
35457,80,7120,10910;10974,11315,0,0,0,2,2
35458,80,7121,10810;10976,11315,0,0,0,2,2
35459,80,7123,10990;11007,11315,0,0,0,2,2
35460,80,7125,11244;11526,11315,0,0,0,2,2
35461,80,7126,11051;11084,11315,0,0,0,2,2
35462,80,7127,10815;14265,11315,0,0,1,1,2
35463,80,7128,10699;11105,11315,0,0,0,2,2
35464,80,7130,10969,11315,0,0,0,1,1
35465,80,7132,11136,11315,0,0,0,1,1
35466,80,7133,11186;11189,11315,0,0,0,2,2
35467,80,7135,10949;11249,11315,0,0,0,2,2
35468,80,7136,10768;11271,11315,0,0,0,2,2
35469,80,7137,11278;15373,11315,0,0,1,1,2
35470,80,7140,5738;9161,11680,0,0,0,2,2
35471,80,7149,10017;10298,11680,0,0,0,2,2
35472,80,7151,4295,11680,0,0,0,1,1
35473,80,7159,5526,11680,0,0,0,1,1
35474,80,7160,6805;9729,11680,0,0,0,2,2
35475,80,7165,9316,11680,0,0,0,1,1
35476,80,7167,9741,11680,0,0,0,1,1
35477,80,7168,10191,11680,0,0,0,1,1
35478,80,7169,10356;10468,11680,0,0,0,2,2
35479,80,7170,10363,11680,0,0,0,1,1
35480,80,7171,10496,11680,0,0,0,1,1
35481,80,7172,10161;10512,11680,0,0,0,2,2
35482,80,7174,11240,11680,0,0,0,1,1
35483,80,7175,10819;10835,11680,0,0,0,2,2
35484,80,7176,10479;10593,11680,0,0,0,2,2
35485,80,7177,10643;10712,11680,0,0,0,2,2
35486,80,7178,10973,11680,0,0,0,1,1
35487,80,7179,11222,11680,0,0,0,1,1
35488,80,7180,10834;11062,11680,0,0,0,2,2
35489,80,7181,10862;11015,11680,0,0,0,2,2
35490,80,7182,10559;10773,11680,0,0,0,2,2
35491,80,7183,10471;10780,11680,0,0,0,2,2
35492,80,7185,10732;10869,11680,0,0,0,2,2
35493,80,7186,10659;10880,11680,0,0,0,2,2
35494,80,7187,10632;10884,11680,0,0,0,2,2
35495,80,7188,10945;11063,11680,0,0,0,2,2
35496,80,7189,10938;10998,11680,0,0,0,2,2
35497,80,7190,10451;10954,11680,0,0,0,2,2
35498,80,7192,10994;11149,11680,0,0,0,2,2
35499,80,7193,10804;10982,11680,0,0,0,2,2
35500,80,7194,11040;11694,11680,0,0,0,2,2
35501,80,7195,11496;12099;15757,11680,0,0,2,1,3
35502,80,7196,11112,11680,0,0,0,1,1
35503,80,7198,11586;14685;15140,11680,0,0,2,1,3
35504,80,7199,11139;11352;15214,11680,0,0,1,2,3
35505,80,7200,10752;10870,11680,0,0,0,2,2
35506,80,7201,11121;11211,11680,0,0,0,2,2
35507,80,7202,11213;11369,11680,0,0,0,2,2
35508,80,7203,11238;11692,11680,0,0,0,2,2
35509,80,7204,11689;16879,11680,0,0,1,1,2
35510,80,7206,11256;11562,11680,0,0,0,2,2
35511,80,7207,11259;11288,11680,0,0,0,2,2
35512,80,7208,11392;11550;15724;16071,11680,0,0,2,2,4
35513,80,7209,11142;11285;14542,11680,0,0,1,2,3
35514,80,7210,10906;11303,11680,0,0,0,2,2
35515,80,7211,10410;13670,11680,0,0,1,1,2
35516,80,7212,11587;14952,11680,0,0,1,1,2
35517,80,7213,15004,11680,0,0,1,0,1
35518,80,7214,11353;11630,11680,0,0,0,2,2
35519,80,7215,10840;11366,11680,0,0,0,2,2
35520,80,7216,11224,11680,0,0,0,1,1
35521,80,7217,11381;11430,11680,0,0,0,2,2
35522,80,7218,11387;11571,11680,0,0,0,2,2
35523,80,7220,1526,12045,0,0,0,1,1
35524,80,7234,9750,12045,0,0,0,1,1
35525,80,7243,170,12045,0,0,0,1,1
35526,80,7247,7315,12045,0,0,0,1,1
35527,80,7259,10263;10404,12045,0,0,0,2,2
35528,80,7260,11002,12045,0,0,0,1,1
35529,80,7266,10575;10614,12045,0,0,0,2,2
35530,80,7267,11346,12045,0,0,0,1,1
35531,80,7268,10622;10902,12045,0,0,0,2,2
35532,80,7269,10666,12045,0,0,0,1,1
35533,80,7271,10682;11116,12045,0,0,0,2,2
35534,80,7273,10722;14389,12045,0,0,1,1,2
35535,80,7275,10478;10750,12045,0,0,0,2,2
35536,80,7276,10753;15266,12045,0,0,1,1,2
35537,80,7278,10831;14994,12045,0,0,1,1,2
35538,80,7279,10809,12045,0,0,0,1,1
35539,80,7280,10854;11273,12045,0,0,0,2,2
35540,80,7282,10514;10894,12045,0,0,0,2,2
35541,80,7283,10905,12045,0,0,0,1,1
35542,80,7286,11206;11308,12045,0,0,0,2,2
35543,80,7287,10959;11135,12045,0,0,0,2,2
35544,80,7288,11057;11059,12045,0,0,0,2,2
35545,80,7289,11091,12045,0,0,0,1,1
35546,80,7290,11016;11292,12045,0,0,0,2,2
35547,80,7292,11442,12045,0,0,0,1,1
35548,80,7293,10658;11141,12045,0,0,0,2,2
35549,80,7294,11157,12045,0,0,0,1,1
35550,80,7295,10986;11203,12045,0,0,0,2,2
35551,80,7296,11321;11556;16872,12045,0,0,1,2,3
35552,80,7297,11208,12045,0,0,0,1,1
35553,80,7298,11209;11320,12045,0,0,0,2,2
35554,80,7299,11279;11597,12045,0,0,0,2,2
35555,80,7300,11090;11225,12045,0,0,0,2,2
35556,80,7301,11307,12045,0,0,0,1,1
35557,80,7305,11294,12045,0,0,0,1,1
35558,80,7306,11465;11495;15572,12045,0,0,1,2,3
35559,80,7307,11328;11528,12045,0,0,0,2,2
35560,80,7308,11720;11773,12045,0,0,2,0,2
35561,80,7309,11350,12045,0,0,0,1,1
35562,80,7310,11119;11356,12045,0,0,0,2,2
35563,80,7311,11270;11379,12045,0,0,0,2,2
35564,80,7313,11751,12045,0,0,1,0,1
35565,80,7314,11405;11457,12045,0,0,0,2,2
35566,80,7315,11377,12045,0,0,0,1,1
35567,80,7316,11637;11681,12045,0,0,0,2,2
35568,80,7317,11257;11469,12045,0,0,0,2,2
35569,80,7318,11447;11478,12045,0,0,0,2,2
35570,80,7319,11458;11518,12045,0,0,0,2,2
35571,80,7320,11468,12045,0,0,0,1,1
35572,80,7321,11481,12045,0,0,0,1,1
35573,80,7322,11482,12045,0,0,0,1,1
35574,80,7323,2975;10151;15323,12410,0,0,1,2,3
35575,80,7335,8679,12410,0,0,0,1,1
35576,80,7347,6344,12410,0,0,0,1,1
35577,80,7352,5249,12410,0,0,0,1,1
35578,80,7353,7990,12410,0,0,0,1,1
35579,80,7361,3481,12410,0,0,0,1,1
35580,80,7364,10318,12410,0,0,0,1,1
35581,80,7365,10619;14424,12410,0,0,1,1,2
35582,80,7366,10415,12410,0,0,0,1,1
35583,80,7367,10868;11337;15259,12410,0,0,1,2,3
35584,80,7368,10745;11310,12410,0,0,0,2,2
35585,80,7369,10721;10760,12410,0,0,0,2,2
35586,80,7370,10964;11039,12410,0,0,0,2,2
35587,80,7371,10951,12410,0,0,0,1,1
35588,80,7372,11028,12410,0,0,0,1,1
35589,80,7373,10587;10820,12410,0,0,0,2,2
35590,80,7376,11198;11375,12410,0,0,0,2,2
35591,80,7377,10612;10937,12410,0,0,0,2,2
35592,80,7378,11223;11506,12410,0,0,0,2,2
35593,80,7379,11217,12410,0,0,0,1,1
35594,80,7380,10917;11030,12410,0,0,0,2,2
35595,80,7382,10929;11092,12410,0,0,0,2,2
35596,80,7383,10968;11312;16517,12410,0,0,1,2,3
35597,80,7384,11124;11467,12410,0,0,0,2,2
35598,80,7385,11422,12410,0,0,0,1,1
35599,80,7387,11220;11376,12410,0,0,0,2,2
35600,80,7388,11393;11613;15125,12410,0,0,1,2,3
35601,80,7389,11205;11549,12410,0,0,0,2,2
35602,80,7390,11262,12410,0,0,0,1,1
35603,80,7391,11263;11615,12410,0,0,0,2,2
35604,80,7392,11003;11265,12410,0,0,0,2,2
35605,80,7393,11686;11825,12410,0,0,1,1,2
35606,80,7394,11100;11313,12410,0,0,0,2,2
35607,80,7395,11529,12410,0,0,0,1,1
35608,80,7397,11113;11438,12410,0,0,0,2,2
35609,80,7399,11436;16188,12410,0,0,1,1,2
35610,80,7400,11079;11452;14751,12410,0,0,1,2,3
35611,80,7401,11382;11486,12410,0,0,0,2,2
35612,80,7402,11497;11598,12410,0,0,0,2,2
35613,80,7403,11276;11503,12410,0,0,0,2,2
35614,80,7404,11611;11809,12410,0,0,1,1,2
35615,80,7407,11163;11687,12410,0,0,0,2,2
35616,80,7408,11535;11589,12410,0,0,0,2,2
35617,80,7409,11302;11593,12410,0,0,0,2,2
35618,80,7424,7405,12775,0,0,0,1,1
35619,80,7430,181,12775,0,0,0,1,1
35620,80,7436,10338,12775,0,0,0,1,1
35621,80,7441,10470;10566,12775,0,0,0,2,2
35622,80,7445,10652,12775,0,0,0,1,1
35623,80,7446,10346;10663;14533,12775,0,0,1,2,3
35624,80,7449,10583;10660,12775,0,0,0,2,2
35625,80,7450,11081;11236,12775,0,0,0,2,2
35626,80,7451,10781;11266,12775,0,0,0,2,2
35627,80,7452,11428;11570;15574,12775,0,0,1,2,3
35628,80,7453,11160,12775,0,0,0,1,1
35629,80,7454,11085,12775,0,0,0,1,1
35630,80,7455,11283,12775,0,0,0,1,1
35631,80,7456,11107,12775,0,0,0,1,1
35632,80,7457,11108;11563,12775,0,0,0,2,2
35633,80,7459,11138,12775,0,0,0,1,1
35634,80,7461,11210;11902;17335,12775,0,0,2,1,3
35635,80,7462,11253;11448,12775,0,0,0,2,2
35636,80,7464,11199;11272,12775,0,0,0,2,2
35637,80,7465,11654;11759,12775,0,0,1,1,2
35638,80,7466,11096;11461,12775,0,0,0,2,2
35639,80,7467,11901;16525,12775,0,0,2,0,2
35640,80,7468,11345;11639,12775,0,0,0,2,2
35641,80,7469,11361;11693,12775,0,0,0,2,2
35642,80,7470,11619;11813;14543,12775,0,0,2,1,3
35643,80,7471,11380;11920;16496,12775,0,0,2,1,3
35644,80,7472,11397,12775,0,0,0,1,1
35645,80,7473,11370;11651,12775,0,0,0,2,2
35646,80,7475,11404;11969,12775,0,0,1,1,2
35647,80,7476,11386;11411,12775,0,0,0,2,2
35648,80,7477,11252;11431,12775,0,0,0,2,2
35649,80,7478,11928,12775,0,0,1,0,1
35650,80,7479,11491;11662,12775,0,0,0,2,2
35651,80,7480,11488;11500,12775,0,0,0,2,2
35652,80,7482,11505;11509,12775,0,0,0,2,2
35653,80,7484,11511;11707,12775,0,0,1,1,2
35654,80,7485,11514;12025,12775,0,0,1,1,2
35655,80,7486,11614,12775,0,0,0,1,1
35656,80,7487,11724,12775,0,0,1,0,1
35657,80,7488,11740;11832,12775,0,0,2,0,2
35658,80,7489,11360;11640,12775,0,0,0,2,2
35659,80,7490,11804,12775,0,0,1,0,1
35660,80,7491,11683,12775,0,0,0,1,1
35661,80,7498,5087,13140,0,0,0,1,1
35662,80,7511,10087,13140,0,0,0,1,1
35663,80,7512,218,13140,0,0,0,1,1
35664,80,7518,10689,13140,0,0,0,1,1
35665,80,7519,10525;11044,13140,0,0,0,2,2
35666,80,7520,10680;10876,13140,0,0,0,2,2
35667,80,7522,10667;11071,13140,0,0,0,2,2
35668,80,7523,10863;11182,13140,0,0,0,2,2
35669,80,7524,10607;10708,13140,0,0,0,2,2
35670,80,7525,10340;10740,13140,0,0,0,2,2
35671,80,7527,10830;10837,13140,0,0,0,2,2
35672,80,7529,10433;10920,13140,0,0,0,2,2
35673,80,7530,11014;11190,13140,0,0,0,2,2
35674,80,7531,11022;11151,13140,0,0,0,2,2
35675,80,7534,11078;11443,13140,0,0,0,2,2
35676,80,7535,11425;16040,13140,0,0,1,1,2
35677,80,7536,11167;11407,13140,0,0,0,2,2
35678,80,7537,11173;11684,13140,0,0,0,2,2
35679,80,7538,10492;11176,13140,0,0,0,2,2
35680,80,7539,11038;11180,13140,0,0,0,2,2
35681,80,7540,11479,13140,0,0,0,1,1
35682,80,7541,11752,13140,0,0,1,0,1
35683,80,7542,11237,13140,0,0,0,1,1
35684,80,7543,11498,13140,0,0,0,1,1
35685,80,7544,11042;11311,13140,0,0,0,2,2
35686,80,7545,10698;11097,13140,0,0,0,2,2
35687,80,7546,10962;11341,13140,0,0,0,2,2
35688,80,7548,11889,13140,0,0,1,0,1
35689,80,7551,11466;11480,13140,0,0,0,2,2
35690,80,7552,11625;11879,13140,0,0,1,1,2
35691,80,7553,11017;11504,13140,0,0,0,2,2
35692,80,7554,11507,13140,0,0,0,1,1
35693,80,7555,11304;11512,13140,0,0,0,2,2
35694,80,7556,11781;12003,13140,0,0,2,0,2
35695,80,7557,11551;11980;16825,13140,0,0,2,1,3
35696,80,7558,11559,13140,0,0,0,1,1
35697,80,7559,11567;11938,13140,0,0,1,1,2
35698,80,7560,11414;11579,13140,0,0,0,2,2
35699,80,7561,11595,13140,0,0,0,1,1
35700,80,7562,11446;11616;15684,13140,0,0,1,2,3
35701,80,7563,12068;16775,13140,0,0,2,0,2
35702,80,7564,11398;11721,13140,0,0,1,1,2
35703,80,7565,11629;11657,13140,0,0,0,2,2
35704,80,7567,11691;11700,13140,0,0,0,2,2
35705,80,7568,12086,13140,0,0,1,0,1
35706,80,7569,11712;11887,13140,0,0,2,0,2
35707,80,7570,11650;11742;16690,13140,0,0,2,1,3
35708,80,7571,11763;11878;15254,13140,0,0,3,0,3
35709,80,7572,11325;11783,13140,0,0,1,1,2
35710,80,7573,11665;11800;15455,13140,0,0,2,1,3
35711,80,7580,2176,13505,0,0,0,1,1
35712,80,7589,7216,13505,0,0,0,1,1
35713,80,7607,10302;10387;15231,13505,0,0,1,2,3
35714,80,7608,10273;10653,13505,0,0,0,2,2
35715,80,7615,10729;11115,13505,0,0,0,2,2
35716,80,7617,10686;10725,13505,0,0,0,2,2
35717,80,7619,10726;11364,13505,0,0,0,2,2
35718,80,7621,10814,13505,0,0,0,1,1
35719,80,7624,11419;11795,13505,0,0,1,1,2
35720,80,7625,11239,13505,0,0,0,1,1
35721,80,7626,11317;11760,13505,0,0,1,1,2
35722,80,7627,11354;11703,13505,0,0,1,1,2
35723,80,7628,11622;11863,13505,0,0,1,1,2
35724,80,7629,11421;11585,13505,0,0,0,2,2
35725,80,7630,11627;11788;16112;16260,13505,0,0,3,1,4
35726,80,7631,11439,13505,0,0,0,1,1
35727,80,7632,11525;11935,13505,0,0,1,1,2
35728,80,7633,11576;11666;15607,13505,0,0,1,2,3
35729,80,7634,11848;11890,13505,0,0,2,0,2
35730,80,7635,11456;11471,13505,0,0,0,2,2
35731,80,7636,12053;15965,13505,0,0,2,0,2
35732,80,7637,11474,13505,0,0,0,1,1
35733,80,7638,11638,13505,0,0,0,1,1
35734,80,7639,11485;11492,13505,0,0,0,2,2
35735,80,7640,11523;11842,13505,0,0,1,1,2
35736,80,7641,11094;11357;16442,13505,0,0,1,2,3
35737,80,7643,11828;11876;14850,13505,0,0,3,0,3
35738,80,7645,11761;11817;16982,13505,0,0,3,0,3
35739,80,7646,11489;11644,13505,0,0,0,2,2
35740,80,7647,11774;11886,13505,0,0,2,0,2
35741,80,7648,11698;12091,13505,0,0,1,1,2
35742,80,7649,12069;17033,13505,0,0,2,0,2
35743,80,7650,12087,13505,0,0,1,0,1
35744,80,7652,11470;11734,13505,0,0,1,1,2
35745,80,7653,11750;12274,13505,0,0,2,0,2
35746,80,7654,11762;11778,13505,0,0,2,0,2
35747,80,7655,11769,13505,0,0,1,0,1
35748,80,7656,11771;12023,13505,0,0,2,0,2
35749,80,7657,12135,13505,0,0,1,0,1
35750,80,7658,11808,13505,0,0,1,0,1
35751,80,7659,11815;16999,13505,0,0,2,0,2
35752,80,7660,11999;16019,13505,0,0,2,0,2
35753,80,7661,11620;11834,13505,0,0,1,1,2
35754,80,7663,11855;11981,13505,0,0,2,0,2
35755,80,7664,12175;16558,13505,0,0,2,0,2
35756,80,7665,12029,13505,0,0,1,0,1
35757,80,7666,11757;12067,13505,0,0,2,0,2
35758,80,7667,11966;15264,13505,0,0,2,0,2
35759,80,7672,6275;14838,13870,0,0,1,1,2
35760,80,7691,5787,13870,0,0,0,1,1
35761,80,7700,952,13870,0,0,0,1,1
35762,80,7703,10856,13870,0,0,0,1,1
35763,80,7704,10422;10552,13870,0,0,0,2,2
35764,80,7706,10697;10963;15512,13870,0,0,1,2,3
35765,80,7707,10900;11065,13870,0,0,0,2,2
35766,80,7708,10162;10715,13870,0,0,0,2,2
35767,80,7711,10829,13870,0,0,0,1,1
35768,80,7712,11101;11557,13870,0,0,0,2,2
35769,80,7713,10641;10855,13870,0,0,0,2,2
35770,80,7717,11632;11655,13870,0,0,0,2,2
35771,80,7719,11114;11963,13870,0,0,1,1,2
35772,80,7720,11402;11412;15659,13870,0,0,1,2,3
35773,80,7721,11127;11245,13870,0,0,0,2,2
35774,80,7722,11538;11737,13870,0,0,1,1,2
35775,80,7723,11001;11171,13870,0,0,0,2,2
35776,80,7725,11427;11618,13870,0,0,0,2,2
35777,80,7726,11314,13870,0,0,0,1,1
35778,80,7727,11338;11607,13870,0,0,0,2,2
35779,80,7728,11355;11385,13870,0,0,0,2,2
35780,80,7729,11568;11609,13870,0,0,0,2,2
35781,80,7730,11729;11905,13870,0,0,2,0,2
35782,80,7731,11177;11499,13870,0,0,0,2,2
35783,80,7732,11674;11996;16268,13870,0,0,2,1,3
35784,80,7733,11524,13870,0,0,0,1,1
35785,80,7734,11530;11914;16231,13870,0,0,2,1,3
35786,80,7736,11300;11728;16062,13870,0,0,2,1,3
35787,80,7737,12085;16203,13870,0,0,2,0,2
35788,80,7738,11641;11821;15828,13870,0,0,2,1,3
35789,80,7739,11645;11731,13870,0,0,1,1,2
35790,80,7740,11232;11658,13870,0,0,0,2,2
35791,80,7741,11623;11679,13870,0,0,0,2,2
35792,80,7742,11532;11690;16342,13870,0,0,1,2,3
35793,80,7744,11792;16524,13870,0,0,2,0,2
35794,80,7745,11732;12042,13870,0,0,2,0,2
35795,80,7746,11739;11775,13870,0,0,2,0,2
35796,80,7747,11779,13870,0,0,1,0,1
35797,80,7749,11806;12114,13870,0,0,2,0,2
35798,80,7750,11743,13870,0,0,1,0,1
35799,80,7751,11924,13870,0,0,1,0,1
35800,80,7752,11843;12019,13870,0,0,2,0,2
35801,80,7753,11069;11869;16048,13870,0,0,2,1,3
35802,80,7754,11856;12204,13870,0,0,2,0,2
35803,80,7755,11709;11835,13870,0,0,2,0,2
35804,80,7756,11881;16114,13870,0,0,2,0,2
35805,80,7757,11406;11704,13870,0,0,1,1,2
35806,80,7758,11661;11906,13870,0,0,1,1,2
35807,80,7759,11908;12203;15080,13870,0,0,3,0,3
35808,80,7761,11940;12043,13870,0,0,2,0,2
35809,80,7762,11606;11941,13870,0,0,1,1,2
35810,80,7763,11922;11945;15039;16988,13870,0,0,4,0,4
35811,80,7764,12002;12308;15531,13870,0,0,3,0,3
35812,80,7765,11699;16494,13870,0,0,1,1,2
35813,80,7766,12098,13870,0,0,1,0,1
35814,80,7789,6054,14235,0,0,0,1,1
35815,80,7799,10129,14235,0,0,0,1,1
35816,80,7807,10581;10746,14235,0,0,0,2,2
35817,80,7809,10522,14235,0,0,0,1,1
35818,80,7810,10673;10913,14235,0,0,0,2,2
35819,80,7812,10939;11082,14235,0,0,0,2,2
35820,80,7813,10923;11221,14235,0,0,0,2,2
35821,80,7814,10499;10774,14235,0,0,0,2,2
35822,80,7816,11129,14235,0,0,0,1,1
35823,80,7817,11463;11577;14880,14235,0,0,1,2,3
35824,80,7819,11191,14235,0,0,0,1,1
35825,80,7820,11450,14235,0,0,0,1,1
35826,80,7821,11111;11164,14235,0,0,0,2,2
35827,80,7822,11322;11484;14988,14235,0,0,1,2,3
35828,80,7823,12052,14235,0,0,1,0,1
35829,80,7824,11340;11591,14235,0,0,0,2,2
35830,80,7825,10757;11342,14235,0,0,0,2,2
35831,80,7826,11250;11371,14235,0,0,0,2,2
35832,80,7827,11401,14235,0,0,0,1,1
35833,80,7828,11565;11574,14235,0,0,0,2,2
35834,80,7829,11169;11513,14235,0,0,0,2,2
35835,80,7830,11373;11464;14848,14235,0,0,1,2,3
35836,80,7831,11711;11910,14235,0,0,2,0,2
35837,80,7832,12137;15905,14235,0,0,2,0,2
35838,80,7833,12234;16639,14235,0,0,2,0,2
35839,80,7834,11993;12080,14235,0,0,2,0,2
35840,80,7835,11716;12326;16039;16405,14235,0,0,4,0,4
35841,80,7836,11719;11965,14235,0,0,2,0,2
35842,80,7838,12352;12424,14235,0,0,2,0,2
35843,80,7839,11755;12144;15856;18058,14235,0,1,3,0,4
35844,80,7841,11631;11900,14235,0,0,1,1,2
35845,80,7842,11776;12008,14235,0,0,2,0,2
35846,80,7843,11437;11799,14235,0,0,1,1,2
35847,80,7844,12011;12142,14235,0,0,2,0,2
35848,80,7845,11836;15147,14235,0,0,2,0,2
35849,80,7846,12357,14235,0,0,1,0,1
35850,80,7848,11971,14235,0,0,1,0,1
35851,80,7849,11894;11975,14235,0,0,2,0,2
35852,80,7850,11870,14235,0,0,1,0,1
35853,80,7851,11990;12331,14235,0,0,2,0,2
35854,80,7852,12223,14235,0,0,1,0,1
35855,80,7853,12018;12272;17435,14235,0,0,3,0,3
35856,80,7854,11853;12151,14235,0,0,2,0,2
35857,80,7855,11918;12149,14235,0,0,2,0,2
35858,80,7857,12073;12305,14235,0,0,2,0,2
35859,80,7858,11673;12075,14235,0,0,1,1,2
35860,80,7859,12208,14235,0,0,1,0,1
35861,80,7860,11560;12117,14235,0,0,1,1,2
35862,80,7867,1535,14600,0,0,0,1,1
35863,80,7887,10200,14600,0,0,0,1,1
35864,80,7892,10985,14600,0,0,0,1,1
35865,80,7895,10556;10877,14600,0,0,0,2,2
35866,80,7898,11494,14600,0,0,0,1,1
35867,80,7901,10956;11233,14600,0,0,0,2,2
35868,80,7902,11046,14600,0,0,0,1,1
35869,80,7904,11348;11668,14600,0,0,0,2,2
35870,80,7905,10952;11365,14600,0,0,0,2,2
35871,80,7908,11396;11434,14600,0,0,0,2,2
35872,80,7909,11275,14600,0,0,0,1,1
35873,80,7910,11487,14600,0,0,0,1,1
35874,80,7912,11590;11664,14600,0,0,0,2,2
35875,80,7913,11838;16953,14600,0,0,2,0,2
35876,80,7914,11708;12076,14600,0,0,2,0,2
35877,80,7915,11561;11675,14600,0,0,0,2,2
35878,80,7916,11718,14600,0,0,1,0,1
35879,80,7918,11927,14600,0,0,1,0,1
35880,80,7919,11912;12196,14600,0,0,2,0,2
35881,80,7920,11831;12378,14600,0,0,2,0,2
35882,80,7921,11841;12340,14600,0,0,2,0,2
35883,80,7922,11416;11849;14928;17605,14600,0,0,3,1,4
35884,80,7923,12022;12036,14600,0,0,2,0,2
35885,80,7924,11368;11896,14600,0,0,1,1,2
35886,80,7925,11992;12167,14600,0,0,2,0,2
35887,80,7926,12040,14600,0,0,1,0,1
35888,80,7928,11967;12314;16708,14600,0,0,3,0,3
35889,80,7929,12406;12489;15933;16946,14600,0,0,4,0,4
35890,80,7930,11730;12001,14600,0,0,2,0,2
35891,80,7931,12161;12377,14600,0,0,2,0,2
35892,80,7932,11880;12031;15803,14600,0,0,3,0,3
35893,80,7933,12063;12202,14600,0,0,2,0,2
35894,80,7934,12089;15133,14600,0,0,2,0,2
35895,80,7936,12013;12092,14600,0,0,2,0,2
35896,80,7937,16429,14600,0,0,1,0,1
35897,80,7939,11947;12462;17413,14600,0,0,3,0,3
35898,80,7941,12128,14600,0,0,1,0,1
35899,80,7942,12140;12147,14600,0,0,2,0,2
35900,80,7943,11830;12183,14600,0,0,2,0,2
35901,80,7944,11933;12155,14600,0,0,2,0,2
35902,80,7945,12449;12587;17628,14600,0,0,3,0,3
35903,80,7946,11798;12141;17219,14600,0,0,3,0,3
35904,80,7947,11846;12230,14600,0,0,2,0,2
35905,80,7948,12233,14600,0,0,1,0,1
35906,80,7950,12554;12658;18098,14600,0,1,2,0,3
35907,80,7961,8226,14965,0,0,0,1,1
35908,80,7962,10160,14965,0,0,0,1,1
35909,80,7963,9351,14965,0,0,0,1,1
35910,80,7984,10574;10710,14965,0,0,0,2,2
35911,80,7986,10874;10908,14965,0,0,0,2,2
35912,80,7987,11117;11394,14965,0,0,0,2,2
35913,80,7989,10813;11076,14965,0,0,0,2,2
35914,80,7990,11162,14965,0,0,0,1,1
35915,80,7992,11710;11796;16680,14965,0,0,3,0,3
35916,80,7993,11539;11573,14965,0,0,0,2,2
35917,80,7994,11564;11604,14965,0,0,0,2,2
35918,80,7995,10911;11553,14965,0,0,0,2,2
35919,80,7996,12239;12258;17022,14965,0,0,3,0,3
35920,80,7997,11864,14965,0,0,1,0,1
35921,80,7998,11617;11943,14965,0,0,1,1,2
35922,80,7999,11319;11612,14965,0,0,0,2,2
35923,80,8000,11780;12317,14965,0,0,2,0,2
35924,80,8001,11534;11801;16025,14965,0,0,2,1,3
35925,80,8002,11858;12493,14965,0,0,2,0,2
35926,80,8003,12730,14965,0,0,1,0,1
35927,80,8004,11847;16410,14965,0,0,2,0,2
35928,80,8005,11818;12125;16008;16535,14965,0,0,4,0,4
35929,80,8006,11961;16726,14965,0,0,2,0,2
35930,80,8007,11973;12066;16773,14965,0,0,3,0,3
35931,80,8008,11983,14965,0,0,1,0,1
35932,80,8009,11985;12162,14965,0,0,2,0,2
35933,80,8010,11602;12107;16305,14965,0,0,2,1,3
35934,80,8012,12207;12459,14965,0,0,2,0,2
35935,80,8013,12217;12599;17299,14965,0,0,3,0,3
35936,80,8014,12103;12221,14965,0,0,2,0,2
35937,80,8015,12226;12353,14965,0,0,2,0,2
35938,80,8016,11862;12256,14965,0,0,2,0,2
35939,80,8017,12344;18295,14965,0,1,1,0,2
35940,80,8018,12543;12629;17122;17389,14965,0,0,4,0,4
35941,80,8019,12286;12603,14965,0,0,2,0,2
35942,80,8020,12490;12665,14965,0,0,2,0,2
35943,80,8022,12218;12435,14965,0,0,2,0,2
35944,80,8023,12118;12330,14965,0,0,2,0,2
35945,80,8024,12648,14965,0,0,1,0,1
35946,80,8025,12349;12756;17194;18075,14965,0,1,3,0,4
35947,80,8026,12251;12370,14965,0,0,2,0,2
35948,80,8027,12303;12355,14965,0,0,2,0,2
35949,80,8031,2339;10414,15330,0,0,0,2,2
35950,80,8032,3140,15330,0,0,0,1,1
35951,80,8042,7119,15330,0,0,0,1,1
35952,80,8061,10858;15051,15330,0,0,1,1,2
35953,80,8063,10608;10823,15330,0,0,0,2,2
35954,80,8064,10634,15330,0,0,0,1,1
35955,80,8067,10767,15330,0,0,0,1,1
35956,80,8068,10865,15330,0,0,0,1,1
35957,80,8069,10733;10940;15401,15330,0,0,1,2,3
35958,80,8071,10942;11193,15330,0,0,0,2,2
35959,80,8072,10860;11166,15330,0,0,0,2,2
35960,80,8073,11569;11653,15330,0,0,0,2,2
35961,80,8075,11646;11663,15330,0,0,0,2,2
35962,80,8076,11367;12146;17047,15330,0,0,2,1,3
35963,80,8077,11521,15330,0,0,0,1,1
35964,80,8078,11696;11823,15330,0,0,1,1,2
35965,80,8079,11418;11454;15065,15330,0,0,1,2,3
35966,80,8080,11490,15330,0,0,0,1,1
35967,80,8081,11445,15330,0,0,0,1,1
35968,80,8082,11594;12044;16762,15330,0,0,2,1,3
35969,80,8083,11260;11575,15330,0,0,0,2,2
35970,80,8084,11621;12219,15330,0,0,1,1,2
35971,80,8085,11659,15330,0,0,0,1,1
35972,80,8086,11915;16957,15330,0,0,2,0,2
35973,80,8087,11301;11705,15330,0,0,1,1,2
35974,80,8088,11785;15329,15330,0,0,2,0,2
35975,80,8089,12254,15330,0,0,1,0,1
35976,80,8090,11844;11968;15621,15330,0,0,3,0,3
35977,80,8091,12048;17876,15330,0,1,1,0,2
35978,80,8092,11359;11558;15759,15330,0,0,1,2,3
35979,80,8096,11789;11937,15330,0,0,2,0,2
35980,80,8097,11948;12403;16902,15330,0,0,3,0,3
35981,80,8098,11747;11952;17209,15330,0,0,3,0,3
35982,80,8099,11958,15330,0,0,1,0,1
35983,80,8100,12174;12323;16993,15330,0,0,3,0,3
35984,80,8101,12028;15778;16928,15330,0,0,3,0,3
35985,80,8102,11932,15330,0,0,1,0,1
35986,80,8103,11959;12050;16619;17683,15330,0,0,4,0,4
35987,80,8104,12060;15243,15330,0,0,2,0,2
35988,80,8106,12171;12488,15330,0,0,2,0,2
35989,80,8107,12266;12284,15330,0,0,2,0,2
35990,80,8108,11929;12182,15330,0,0,2,0,2
35991,80,8109,12220;12714,15330,0,0,2,0,2
35992,80,8110,12224;12241,15330,0,0,2,0,2
35993,80,8111,11677;12032,15330,0,0,1,1,2
35994,80,8112,12088;12235,15330,0,0,2,0,2
35995,80,8113,12139;17016,15330,0,0,2,0,2
35996,80,8115,12630;12801,15330,0,0,2,0,2
35997,80,8116,11837;12374;17135,15330,0,0,3,0,3
35998,80,8117,11839;12397,15330,0,0,2,0,2
35999,80,8119,11974;12450,15330,0,0,2,0,2
36000,80,8120,12267;12479;15352;16367,15330,0,0,4,0,4
36001,80,8121,50;135,15695,0,0,0,2,2
36002,80,8128,6003,15695,0,0,0,1,1
36003,80,8139,10047,15695,0,0,0,1,1
36004,80,8148,10649;11118;15276,15695,0,0,1,2,3
36005,80,8149,10474,15695,0,0,0,1,1
36006,80,8151,11429;16307,15695,0,0,1,1,2
36007,80,8152,10933,15695,0,0,0,1,1
36008,80,8154,10971;11123,15695,0,0,0,2,2
36009,80,8155,11072;11413,15695,0,0,0,2,2
36010,80,8156,11083;11219,15695,0,0,0,2,2
36011,80,8161,11787;15301,15695,0,0,2,0,2
36012,80,8163,11596;12026,15695,0,0,1,1,2
36013,80,8164,12188,15695,0,0,1,0,1
36014,80,8165,11215;11600,15695,0,0,0,2,2
36015,80,8167,12321;16421,15695,0,0,2,0,2
36016,80,8168,11892;11994,15695,0,0,2,0,2
36017,80,8169,11772;11909;16210;16705,15695,0,0,4,0,4
36018,80,8170,11635;12061;15683,15695,0,0,2,1,3
36019,80,8171,12045,15695,0,0,1,0,1
36020,80,8172,11991,15695,0,0,1,0,1
36021,80,8174,12038;12071,15695,0,0,2,0,2
36022,80,8175,12341,15695,0,0,1,0,1
36023,80,8176,12318;17657,15695,0,0,2,0,2
36024,80,8177,12101;12566;16972;17444,15695,0,0,4,0,4
36025,80,8178,12110;12546,15695,0,0,2,0,2
36026,80,8179,12121;12481,15695,0,0,2,0,2
36027,80,8180,11824;12136,15695,0,0,2,0,2
36028,80,8182,12148;12316;16651;16940,15695,0,0,4,0,4
36029,80,8183,12312;12350,15695,0,0,2,0,2
36030,80,8184,12935,15695,0,0,1,0,1
36031,80,8185,12236;16294,15695,0,0,2,0,2
36032,80,8186,12688;15333,15695,0,0,2,0,2
36033,80,8187,12090;12608,15695,0,0,2,0,2
36034,80,8188,12319;12644;17736;18312,15695,0,1,3,0,4
36035,80,8189,12812;12836;15509,15695,0,0,3,0,3
36036,80,8190,12891;16550;18061,15695,0,1,2,0,3
36037,80,8191,12755,15695,0,0,1,0,1
36038,80,8192,12536,15695,0,0,1,0,1
36039,80,8193,12392,15695,0,0,1,0,1
36040,80,8194,12287;12684;17753,15695,0,0,3,0,3
36041,80,8195,12240;12436,15695,0,0,2,0,2
36042,80,8196,12473;13241,15695,0,0,2,0,2
36043,80,8197,12529;12901;15382,15695,0,0,3,0,3
36044,80,8198,12365;12386,15695,0,0,2,0,2
36045,80,8199,12170;12496,15695,0,0,2,0,2
36046,80,8200,12414;12581,15695,0,0,2,0,2
36047,80,8201,12795;12815;17540,15695,0,0,3,0,3
36048,80,8202,12486;12540;16911;18011,15695,0,1,3,0,4
36049,80,8203,12385;12559,15695,0,0,2,0,2
36050,80,8204,12432,15695,0,0,1,0,1
36051,80,8205,12635;13074;17407,15695,0,0,3,0,3
36052,80,8206,12516;12871;16961,15695,0,0,3,0,3
36053,80,8208,12519;17898,15695,0,1,1,0,2
36054,80,8209,12194;12617;17085;17187;17645,15695,0,0,5,0,5
36055,80,8220,8106,16060,0,0,0,1,1
36056,80,8221,9519,16060,0,0,0,1,1
36057,80,8230,5743;10307,16060,0,0,0,2,2
36058,80,8231,10476,16060,0,0,0,1,1
36059,80,8233,10096,16060,0,0,0,1,1
36060,80,8237,10443;10736,16060,0,0,0,2,2
36061,80,8244,11293;11777,16060,0,0,1,1,2
36062,80,8246,11736;11791,16060,0,0,2,0,2
36063,80,8247,12210;12866;17090,16060,0,0,3,0,3
36064,80,8249,11649;12035,16060,0,0,1,1,2
36065,80,8251,11793;12078;16105,16060,0,0,3,0,3
36066,80,8252,11098,16060,0,0,0,1,1
36067,80,8253,11977,16060,0,0,1,0,1
36068,80,8254,11957;12132;16630,16060,0,0,3,0,3
36069,80,8256,11784;11936;16597,16060,0,0,3,0,3
36070,80,8257,11814;12021,16060,0,0,2,0,2
36071,80,8258,11867;12124,16060,0,0,2,0,2
36072,80,8259,11531;11794;15760,16060,0,0,2,1,3
36073,80,8262,12430;12625;16804,16060,0,0,3,0,3
36074,80,8263,12720;12807,16060,0,0,2,0,2
36075,80,8264,11917;11989,16060,0,0,2,0,2
36076,80,8266,12873;15840;16886;17390,16060,0,0,4,0,4
36077,80,8267,11714;11875;16433,16060,0,0,3,0,3
36078,80,8268,12096;12294;15985,16060,0,0,3,0,3
36079,80,8269,12495;12705,16060,0,0,2,0,2
36080,80,8270,11872;11949;16920,16060,0,0,3,0,3
36081,80,8271,12010;12129,16060,0,0,2,0,2
36082,80,8272,11636;12184,16060,0,0,1,1,2
36083,80,8273,12005;12195,16060,0,0,2,0,2
36084,80,8275,11860;12231,16060,0,0,2,0,2
36085,80,8276,12260;17433,16060,0,0,2,0,2
36086,80,8277,12296;12434,16060,0,0,2,0,2
36087,80,8278,12332;12745;17326,16060,0,0,3,0,3
36088,80,8279,12289;12367,16060,0,0,2,0,2
36089,80,8280,12407,16060,0,0,1,0,1
36090,80,8281,12384;13097,16060,0,0,2,0,2
36091,80,8282,12889;12963,16060,0,0,2,0,2
36092,80,8283,12600;12735,16060,0,0,2,0,2
36093,80,8284,12420;12517;16819,16060,0,0,3,0,3
36094,80,8285,12238;12427,16060,0,0,2,0,2
36095,80,8286,12460,16060,0,0,1,0,1
36096,80,8287,12719;12753;16148;18113;18311,16060,0,2,3,0,5
36097,80,8288,12368;12579;17368,16060,0,0,3,0,3
36098,80,8289,12227;12411;15458;16230,16060,0,0,4,0,4
36099,80,8290,12620;12791;16564;17050,16060,0,0,4,0,4
36100,80,8291,12615;16325,16060,0,0,2,0,2
36101,80,8292,12623;12776;15713,16060,0,0,3,0,3
36102,80,8293,12825,16060,0,0,1,0,1
36103,80,8294,12206;12416,16060,0,0,2,0,2
36104,80,8295,12685;12693;17373,16060,0,0,3,0,3
36105,80,8297,12652;12698,16060,0,0,2,0,2
36106,80,8298,13084;18397,16060,0,1,1,0,2
36107,80,8301,12257,16060,0,0,1,0,1
36108,80,8302,11865;12737;16615,16060,0,0,3,0,3
36109,80,8312,6641,16425,0,0,0,1,1
36110,80,8318,7550,16425,0,0,0,1,1
36111,80,8320,10006;10465,16425,0,0,0,2,2
36112,80,8327,10554;11146,16425,0,0,0,2,2
36113,80,8333,10872;10875;16020,16425,0,0,1,2,3
36114,80,8336,11000;11333,16425,0,0,0,2,2
36115,80,8338,11483;12059;16099,16425,0,0,2,1,3
36116,80,8339,11537;11642,16425,0,0,0,2,2
36117,80,8340,11410;11542,16425,0,0,0,2,2
36118,80,8341,11403;11671;15541;15909,16425,0,0,2,2,4
36119,80,8342,11515;12057;16955,16425,0,0,2,1,3
36120,80,8345,12030;12281,16425,0,0,2,0,2
36121,80,8347,12047;16239,16425,0,0,2,0,2
36122,80,8348,12269;15618;15793,16425,0,0,3,0,3
36123,80,8349,12199;12851,16425,0,0,2,0,2
36124,80,8350,12064;12228;16473,16425,0,0,3,0,3
36125,80,8351,12242;12820;16718;16978;17173,16425,0,0,5,0,5
36126,80,8352,12640;12646;17677,16425,0,0,3,0,3
36127,80,8353,12255;12497;17020,16425,0,0,3,0,3
36128,80,8354,12166;12307,16425,0,0,2,0,2
36129,80,8355,12846,16425,0,0,1,0,1
36130,80,8356,13008;17414,16425,0,0,2,0,2
36131,80,8357,12360;12446;15702,16425,0,0,3,0,3
36132,80,8358,12362,16425,0,0,1,0,1
36133,80,8359,12395;12829;15957,16425,0,0,3,0,3
36134,80,8360,12212;12792;17164,16425,0,0,3,0,3
36135,80,8361,12451;12834;16960,16425,0,0,3,0,3
36136,80,8362,12197;12521;16585,16425,0,0,3,0,3
36137,80,8364,12534;12674;15788;17230,16425,0,0,4,0,4
36138,80,8365,12859;16340,16425,0,0,2,0,2
36139,80,8366,12550;12946;15735,16425,0,0,3,0,3
36140,80,8367,12511;12570;15639,16425,0,0,3,0,3
36141,80,8368,12575,16425,0,0,1,0,1
36142,80,8369,12453;12585;16539,16425,0,0,3,0,3
36143,80,8370,12602;12639;17224,16425,0,0,3,0,3
36144,80,8371,12854;16354;16992,16425,0,0,3,0,3
36145,80,8372,12276,16425,0,0,1,0,1
36146,80,8373,12822,16425,0,0,1,0,1
36147,80,8374,12973;16938;17386;18049,16425,0,1,3,0,4
36148,80,8375,12423;12974;16871,16425,0,0,3,0,3
36149,80,8376,12670;13379;16465,16425,0,0,3,0,3
36150,80,8377,12943;13198;17783,16425,0,0,3,0,3
36151,80,8378,12738;12920;16662;16907;17211,16425,0,0,5,0,5
36152,80,8379,12746;13048;17443;18219,16425,0,1,3,0,4
36153,80,8380,12417;12572;15923,16425,0,0,3,0,3
36154,80,8381,12229;12761,16425,0,0,2,0,2
36155,80,8382,12616;12780;17132;17583,16425,0,0,4,0,4
36156,80,8383,12954;13085;16721,16425,0,0,3,0,3
36157,80,8384,12396;12785;16332,16425,0,0,3,0,3
36158,80,8385,12786;12816,16425,0,0,2,0,2
36159,80,8386,13004;13054;16974,16425,0,0,3,0,3
36160,80,8387,12743;12790,16425,0,0,2,0,2
36161,80,8388,12518;12802;17489,16425,0,0,3,0,3
36162,80,8389,13264,16425,0,0,1,0,1
36163,80,8390,12113;12864;17864,16425,0,1,2,0,3
36164,80,8397,4828,16790,0,0,0,1,1
36165,80,8404,5521,16790,0,0,0,1,1
36166,80,8406,10107,16790,0,0,0,1,1
36167,80,8409,10440,16790,0,0,0,1,1
36168,80,8411,10606;10748,16790,0,0,0,2,2
36169,80,8412,10692;10944,16790,0,0,0,2,2
36170,80,8419,11125;15611,16790,0,0,1,1,2
36171,80,8421,11725;11816,16790,0,0,2,0,2
36172,80,8425,11426;11624,16790,0,0,0,2,2
36173,80,8426,11702;12293;16643,16790,0,0,3,0,3
36174,80,8428,11669;11722;17418,16790,0,0,2,1,3
36175,80,8430,11477,16790,0,0,0,1,1
36176,80,8431,11851;12082,16790,0,0,2,0,2
36177,80,8433,11930;12062,16790,0,0,2,0,2
36178,80,8434,11852;12143,16790,0,0,2,0,2
36179,80,8435,11891;12285,16790,0,0,2,0,2
36180,80,8437,12133,16790,0,0,1,0,1
36181,80,8438,11802;12116,16790,0,0,2,0,2
36182,80,8439,11754;11987;17202,16790,0,0,3,0,3
36183,80,8441,12150;12444;17293,16790,0,0,3,0,3
36184,80,8442,12418;12713;16536,16790,0,0,3,0,3
36185,80,8443,12605;17415,16790,0,0,2,0,2
36186,80,8444,12193,16790,0,0,1,0,1
36187,80,8445,12277;12328;15870,16790,0,0,3,0,3
36188,80,8446,11854;12244,16790,0,0,2,0,2
36189,80,8447,12248;12642,16790,0,0,2,0,2
36190,80,8448,12185;12265;16581,16790,0,0,3,0,3
36191,80,8449,12298;12351,16790,0,0,2,0,2
36192,80,8450,12315;12667;17419,16790,0,0,3,0,3
36193,80,8452,12376;13257;17081,16790,0,0,3,0,3
36194,80,8453,12372;12380,16790,0,0,2,0,2
36195,80,8454,13150,16790,0,0,1,0,1
36196,80,8455,12611;17859,16790,0,1,1,0,2
36197,80,8456,11883;12419,16790,0,0,2,0,2
36198,80,8457,12439;12680,16790,0,0,2,0,2
36199,80,8458,12279;12455;16053,16790,0,0,3,0,3
36200,80,8459,12697;17461,16790,0,0,2,0,2
36201,80,8460,12501;12892;16929;17203,16790,0,0,4,0,4
36202,80,8461,12514;12573,16790,0,0,2,0,2
36203,80,8463,12542;12981;17112;17617,16790,0,0,4,0,4
36204,80,8464,13158;17684,16790,0,0,2,0,2
36205,80,8465,12324;12565,16790,0,0,2,0,2
36206,80,8466,13029;13300;16090,16790,0,0,3,0,3
36207,80,8467,11962;12589,16790,0,0,2,0,2
36208,80,8468,12590;12681;16212,16790,0,0,3,0,3
36209,80,8469,12561;12686,16790,0,0,2,0,2
36210,80,8470,12766;13186;17916,16790,0,1,2,0,3
36211,80,8471,12382;12742,16790,0,0,2,0,2
36212,80,8472,12654;12775,16790,0,0,2,0,2
36213,80,8473,12039;12803,16790,0,0,2,0,2
36214,80,8474,12628;16727;17913,16790,0,1,2,0,3
36215,80,8475,12160;12818,16790,0,0,2,0,2
36216,80,8476,12830;12955;17649;17843,16790,0,1,3,0,4
36217,80,8477,12609;12837,16790,0,0,2,0,2
36218,80,8478,12701;13057;16582;17532,16790,0,0,4,0,4
36219,80,8479,12700;12894;17243;17845,16790,0,1,3,0,4
36220,80,8480,12364;12858;18608,16790,0,1,2,0,3
36221,80,8481,12569;12861;17190;17975,16790,0,1,3,0,4
36222,80,8482,12863;13293;17465,16790,0,0,3,0,3
36223,80,8483,12779;12905,16790,0,0,2,0,2
36224,80,8484,12879;13439;15707;18556,16790,0,1,3,0,4
36225,80,8485,12886;13340;18043,16790,0,1,2,0,3
36226,80,8486,12919;13371;17660;17703,16790,0,0,4,0,4
36227,80,8487,12527;12924;16503;17350,16790,0,0,4,0,4
36228,80,8488,12672;13318,16790,0,0,2,0,2
36229,80,8489,12928;13363,16790,0,0,2,0,2
36230,80,8490,12876;12942;16829;17383,16790,0,0,4,0,4
36231,80,8491,16641;16853;19440,16790,1,0,2,0,3
36232,80,8492,12772;13210;17729,16790,0,0,3,0,3
36233,80,8494,1770;8418,17155,0,0,0,2,2
36234,80,8498,3717,17155,0,0,0,1,1
36235,80,8499,8238,17155,0,0,0,1,1
36236,80,8506,8553,17155,0,0,0,1,1
36237,80,8509,10438,17155,0,0,0,1,1
36238,80,8514,10826,17155,0,0,0,1,1
36239,80,8516,11756,17155,0,0,1,0,1
36240,80,8519,11264,17155,0,0,0,1,1
36241,80,8521,12070;17253,17155,0,0,2,0,2
36242,80,8523,11926;16061,17155,0,0,2,0,2
36243,80,8524,11899;12020,17155,0,0,2,0,2
36244,80,8525,11572;11695,17155,0,0,0,2,2
36245,80,8526,12119,17155,0,0,1,0,1
36246,80,8527,12127;12259;16200,17155,0,0,3,0,3
36247,80,8530,12156;12246,17155,0,0,2,0,2
36248,80,8531,12192;12855;17464;17720;17907,17155,0,1,4,0,5
36249,80,8532,12198;12509,17155,0,0,2,0,2
36250,80,8533,12205;12470,17155,0,0,2,0,2
36251,80,8534,12270;16165;16884,17155,0,0,3,0,3
36252,80,8535,12275;12715;16134,17155,0,0,3,0,3
36253,80,8536,12280;12428,17155,0,0,2,0,2
36254,80,8537,11672;12079;16745,17155,0,0,2,1,3
36255,80,8538,12348;12643;15790;16587,17155,0,0,4,0,4
36256,80,8539,12399,17155,0,0,1,0,1
36257,80,8540,12065;12152,17155,0,0,2,0,2
36258,80,8541,12292;12747,17155,0,0,2,0,2
36259,80,8542,12712;16739,17155,0,0,2,0,2
36260,80,8543,12551;12770;17007;17285,17155,0,0,4,0,4
36261,80,8544,12465;16677,17155,0,0,2,0,2
36262,80,8546,12671;12778;16760;17458,17155,0,0,4,0,4
36263,80,8547,13465;17603,17155,0,0,2,0,2
36264,80,8548,12339;12537,17155,0,0,2,0,2
36265,80,8549,12539;12733,17155,0,0,2,0,2
36266,80,8550,12961;13230;17526,17155,0,0,3,0,3
36267,80,8551,12245;12333;16796,17155,0,0,3,0,3
36268,80,8553,12562;12906,17155,0,0,2,0,2
36269,80,8554,12622;13214;16818,17155,0,0,3,0,3
36270,80,8555,12180;12624,17155,0,0,2,0,2
36271,80,8556,13050;16397,17155,0,0,2,0,2
36272,80,8557,12463;12678;16014,17155,0,0,3,0,3
36273,80,8558,12741,17155,0,0,1,0,1
36274,80,8559,13391;15452;16463;18127,17155,0,1,3,0,4
36275,80,8560,12610;12728,17155,0,0,2,0,2
36276,80,8561,12734;13290;18063,17155,0,1,2,0,3
36277,80,8562,12744;12967;17003;17459,17155,0,0,4,0,4
36278,80,8563,12757;13204;17460,17155,0,0,3,0,3
36279,80,8564,13034;13265,17155,0,0,2,0,2
36280,80,8565,12806;12883;17773,17155,0,0,3,0,3
36281,80,8566,12813;13355;16689,17155,0,0,3,0,3
36282,80,8567,13398;13579;17669;18123,17155,0,1,3,0,4
36283,80,8568,12915;13263;15969,17155,0,0,3,0,3
36284,80,8569,12476;12896;16543,17155,0,0,3,0,3
36285,80,8570,12878;13159;16959,17155,0,0,3,0,3
36286,80,8571,12931;13170;17417;17935,17155,0,1,3,0,4
36287,80,8572,12932;13192;18121,17155,0,1,2,0,3
36288,80,8573,12751;12934;17694,17155,0,0,3,0,3
36289,80,8574,12938;12990;17183;18500,17155,0,1,3,0,4
36290,80,8575,12930;12968;16956,17155,0,0,3,0,3
36291,80,8576,12663;12960;17719,17155,0,0,3,0,3
36292,80,8577,12592;12641;16400;16666,17155,0,0,4,0,4
36293,80,8578,13051;13409;16574,17155,0,0,3,0,3
36294,80,8579,13495;16556;17756,17155,0,0,3,0,3
36295,80,8581,12925;13020;16997,17155,0,0,3,0,3
36296,80,8582,12987;13028;16772,17155,0,0,3,0,3
36297,80,8583,13039;13114;17698;18199,17155,0,1,3,0,4
36298,80,8584,12739;13059;17030;17709;18091,17155,0,1,4,0,5
36299,80,8585,12213;13063;16742,17155,0,0,3,0,3
36300,80,8586,12951;13071;16807,17155,0,0,3,0,3
36301,80,8588,12811;13133;16598;17539,17155,0,0,4,0,4
36302,80,8589,13107;13307;16824,17155,0,0,3,0,3
36303,80,8590,13135;13202,17155,0,0,2,0,2
36304,80,8594,2840,17520,0,0,0,1,1
36305,80,8598,1152,17520,0,0,0,1,1
36306,80,8603,9365,17520,0,0,0,1,1
36307,80,8607,136;10165,17520,0,0,0,2,2
36308,80,8608,447,17520,0,0,0,1,1
36309,80,8621,11634;11822,17520,0,0,1,1,2
36310,80,8623,11782,17520,0,0,1,0,1
36311,80,8627,11697;11713,17520,0,0,1,1,2
36312,80,8628,12393;17021;17456,17520,0,0,3,0,3
36313,80,8629,12051;12054;16511;17481,17520,0,0,4,0,4
36314,80,8630,11647;12041;15983,17520,0,0,2,1,3
36315,80,8631,12049;12421,17520,0,0,2,0,2
36316,80,8632,12764;16614,17520,0,0,2,0,2
36317,80,8633,11744;12327;16634,17520,0,0,3,0,3
36318,80,8634,11764;12201,17520,0,0,2,0,2
36319,80,8635,11923;12034;16166,17520,0,0,3,0,3
36320,80,8636,12181;12263,17520,0,0,2,0,2
36321,80,8637,12358;12363,17520,0,0,2,0,2
36322,80,8639,12725,17520,0,0,1,0,1
36323,80,8640,12814;12956;17351,17520,0,0,3,0,3
36324,80,8641,13040;16984,17520,0,0,2,0,2
36325,80,8643,12491;12838;16355,17520,0,0,3,0,3
36326,80,8644,12282;12522;17102,17520,0,0,3,0,3
36327,80,8645,12273;12821;17225,17520,0,0,3,0,3
36328,80,8647,12549;16530,17520,0,0,2,0,2
36329,80,8648,13140;13341;17428;18607,17520,0,1,3,0,4
36330,80,8649,12576;12638,17520,0,0,2,0,2
36331,80,8650,12627;13252;17151,17520,0,0,3,0,3
36332,80,8651,12283;12457;17116;17154,17520,0,0,4,0,4
36333,80,8652,12655;16533;17614,17520,0,0,3,0,3
36334,80,8653,12300;12709;17346,17520,0,0,3,0,3
36335,80,8654,12771;12882;17432,17520,0,0,3,0,3
36336,80,8655,12890;13146,17520,0,0,2,0,2
36337,80,8656,12515;12797,17520,0,0,2,0,2
36338,80,8657,13116;13181;16388;17150,17520,0,0,4,0,4
36339,80,8658,12304;12848;16973,17520,0,0,3,0,3
36340,80,8659,12828;13533;18147,17520,0,1,2,0,3
36341,80,8660,12909;13091,17520,0,0,2,0,2
36342,80,8661,13313;13364;17765;18006,17520,0,1,3,0,4
36343,80,8662,12914;13270;17175,17520,0,0,3,0,3
36344,80,8663,12309;12936;17172;17652,17520,0,0,4,0,4
36345,80,8664,13005;13609;16469;17255,17520,0,0,4,0,4
36346,80,8665,13014;13176;15977;17348,17520,0,0,4,0,4
36347,80,8666,12758;12921;17412;18160,17520,0,1,3,0,4
36348,80,8667,13482;13612;17948,17520,0,1,2,0,3
36349,80,8668,12781;12996;17452,17520,0,0,3,0,3
36350,80,8669,13045;13550;18234,17520,0,1,2,0,3
36351,80,8670,13622;13632,17520,0,0,2,0,2
36352,80,8671,12808;17270;18003,17520,0,1,2,0,3
36353,80,8672,13076;13537;18104,17520,0,1,2,0,3
36354,80,8673,13087;13178,17520,0,0,2,0,2
36355,80,8674,13160;13517;16142,17520,0,0,3,0,3
36356,80,8675,13141;13394;17291;17379,17520,0,0,4,0,4
36357,80,8676,13268;16605,17520,0,0,2,0,2
36358,80,8677,12994;13189;17602,17520,0,0,3,0,3
36359,80,8678,13023;13201;17810,17520,0,1,2,0,3
36360,80,8679,13255;13272;16903;18002,17520,0,1,3,0,4
36361,80,8680,13231;13489;17105;17812,17520,0,1,3,0,4
36362,80,8683,1637,17885,0,0,0,1,1
36363,80,8684,9225,17885,0,0,0,1,1
36364,80,8691,988,17885,0,0,0,1,1
36365,80,8692,10072,17885,0,0,0,1,1
36366,80,8696,10297,17885,0,0,0,1,1
36367,80,8707,11241;16723,17885,0,0,1,1,2
36368,80,8708,11305;11885;16415,17885,0,0,2,1,3
36369,80,8710,11323;11682;16155,17885,0,0,1,2,3
36370,80,8712,11372;11811;16339,17885,0,0,2,1,3
36371,80,8713,16470;16707,17885,0,0,2,0,2
36372,80,8714,11520;12122,17885,0,0,1,1,2
36373,80,8720,11758;12007,17885,0,0,2,0,2
36374,80,8721,11827,17885,0,0,1,0,1
36375,80,8722,11295;11951;16143,17885,0,0,2,1,3
36376,80,8723,11543;11986,17885,0,0,1,1,2
36377,80,8726,12216;12721,17885,0,0,2,0,2
36378,80,8727,12329;12530;17184;17371;17963,17885,0,1,4,0,5
36379,80,8728,12237;12571;16466;16893;17169;17598,17885,0,0,6,0,6
36380,80,8729,12472;12577;16696,17885,0,0,3,0,3
36381,80,8730,12445,17885,0,0,1,0,1
36382,80,8733,12631;13012;16906,17885,0,0,3,0,3
36383,80,8734,12474;12475;17378,17885,0,0,3,0,3
36384,80,8735,12055;12482;16849,17885,0,0,3,0,3
36385,80,8736,12970;18077,17885,0,1,1,0,2
36386,80,8737,12545;12947;16814;17138,17885,0,0,4,0,4
36387,80,8739,12632;16998;17391,17885,0,0,3,0,3
36388,80,8740,12862;13115;16844,17885,0,0,3,0,3
36389,80,8742,12404;12691,17885,0,0,2,0,2
36390,80,8743,12683;16566;17384,17885,0,0,3,0,3
36391,80,8744,13383,17885,0,0,1,0,1
36392,80,8745,12467;13123;17990,17885,0,1,2,0,3
36393,80,8746,13068;13081;16868;17997,17885,0,1,3,0,4
36394,80,8747,12877;12980;17546,17885,0,0,3,0,3
36395,80,8748,12976;16683,17885,0,0,2,0,2
36396,80,8749,12773;13184,17885,0,0,2,0,2
36397,80,8750,13062;13630;17699,17885,0,0,3,0,3
36398,80,8751,13643;16740;17638,17885,0,0,3,0,3
36399,80,8752,12937;16916,17885,0,0,2,0,2
36400,80,8754,12618;12975;17472,17885,0,0,3,0,3
36401,80,8755,12422;12478,17885,0,0,2,0,2
36402,80,8756,12991;13043;17766,17885,0,0,3,0,3
36403,80,8757,12992;13010,17885,0,0,2,0,2
36404,80,8758,13079;13432;17881;18205,17885,0,2,2,0,4
36405,80,8759,13462;13659,17885,0,0,2,0,2
36406,80,8760,12944;13094;17591,17885,0,0,3,0,3
36407,80,8761,13118;17121,17885,0,0,2,0,2
36408,80,8762,13220;17434,17885,0,0,2,0,2
36409,80,8763,13121;13755;16120;17471,17885,0,0,4,0,4
36410,80,8764,13131;17676;17784,17885,0,0,3,0,3
36411,80,8765,13602;17212;17862;18487;19451,17885,1,2,2,0,5
36412,80,8766,13148;13403;18238;18648,17885,0,2,2,0,4
36413,80,8767,13155;18340,17885,0,1,1,0,2
36414,80,8768,13174;16781;17892,17885,0,1,2,0,3
36415,80,8769,13096;13183,17885,0,0,2,0,2
36416,80,8770,12904;13195;16854,17885,0,0,3,0,3
36417,80,8771,13024;13647;18483;19140,17885,0,2,2,0,4
36418,80,8772,13483;17486,17885,0,0,2,0,2
36419,80,8773,13242,17885,0,0,1,0,1
36420,80,8774,13250;16475;17416,17885,0,0,3,0,3
36421,80,8775,13253;17960,17885,0,1,1,0,2
36422,80,8777,12637;13291;17479,17885,0,0,3,0,3
36423,80,8778,13295;13395;16785;18738,17885,0,1,3,0,4
36424,80,8779,13299;13613;17743;18925,17885,0,1,3,0,4
36425,80,8780,13007;13303;17325;17725;18435,17885,0,1,4,0,5
36426,80,8781,13122;13656;17695;18209,17885,0,1,3,0,4
36427,80,8782,13144;18528,17885,0,1,1,0,2
36428,80,8783,12666;13518;17347;18110,17885,0,1,3,0,4
36429,80,8784,12888;13468;18292,17885,0,1,2,0,3
36430,80,8785,13321;13703;16081;17599;17858,17885,0,1,4,0,5
36431,80,8786,13669;17092;18885,17885,0,1,2,0,3
36432,80,8787,12706;13382;17238,17885,0,0,3,0,3
36433,80,8788,13320;13396;16925;17755,17885,0,0,4,0,4
36434,80,8791,4851,18250,0,0,0,1,1
36435,80,8794,3234,18250,0,0,0,1,1
36436,80,8797,9098;9418,18250,0,0,0,2,2
36437,80,8800,10117,18250,0,0,0,1,1
36438,80,8801,10131,18250,0,0,0,1,1
36439,80,8815,11582;16672,18250,0,0,1,1,2
36440,80,8816,11517,18250,0,0,0,1,1
36441,80,8825,12012;12084;16632,18250,0,0,3,0,3
36442,80,8826,11347;11820,18250,0,0,1,1,2
36443,80,8829,11605;12004,18250,0,0,1,1,2
36444,80,8830,12074;12187,18250,0,0,2,0,2
36445,80,8832,12252;12336;16261,18250,0,0,3,0,3
36446,80,8833,12338;12556,18250,0,0,2,0,2
36447,80,8834,12247;12347;16595,18250,0,0,3,0,3
36448,80,8835,12383;12452,18250,0,0,2,0,2
36449,80,8836,12186;12443;16600,18250,0,0,3,0,3
36450,80,8837,12447;13324;17895;18050,18250,0,2,2,0,4
36451,80,8838,12016;12471,18250,0,0,2,0,2
36452,80,8839,12398;12487;16842;17056;18254,18250,0,1,4,0,5
36453,80,8840,12538;12597,18250,0,0,2,0,2
36454,80,8841,12754;13569;17463;18141;18597;18918,18250,0,3,3,0,6
36455,80,8842,12881;18076,18250,0,1,1,0,2
36456,80,8843,12850;13126;17411;18004,18250,0,1,3,0,4
36457,80,8844,12668;13035;17024;17899,18250,0,1,3,0,4
36458,80,8845,13038;13093;17523,18250,0,0,3,0,3
36459,80,8846,12699;12749;17274,18250,0,0,3,0,3
36460,80,8847,12704,18250,0,0,1,0,1
36461,80,8848,12710;13420;16711;17010,18250,0,0,4,0,4
36462,80,8849,12702;12711;17186,18250,0,0,3,0,3
36463,80,8850,12986,18250,0,0,1,0,1
36464,80,8851,12789;17524,18250,0,0,2,0,2
36465,80,8852,12809;13469;17689,18250,0,0,3,0,3
36466,80,8853,12584;13053;17476,18250,0,0,3,0,3
36467,80,8854,13136;13470;17506;17814;18170;18445,18250,0,3,3,0,6
36468,80,8855,12884;13203;17437,18250,0,0,3,0,3
36469,80,8856,12694;12958;17245,18250,0,0,3,0,3
36470,80,8857,12461;12966;17261;17782,18250,0,0,4,0,4
36471,80,8858,12941;13436;18226,18250,0,1,2,0,3
36472,80,8859,12872;13449;18549,18250,0,1,2,0,3
36473,80,8860,12740;13022,18250,0,0,2,0,2
36474,80,8861,12962;13026;16976;17179,18250,0,0,4,0,4
36475,80,8862,12504;13032;17467,18250,0,0,3,0,3
36476,80,8863,12950;13036,18250,0,0,2,0,2
36477,80,8864,12867;13388;18300,18250,0,1,2,0,3
36478,80,8865,12979;13090,18250,0,0,2,0,2
36479,80,8866,13088;13092;16611;18493,18250,0,1,3,0,4
36480,80,8867,13021;13638;17182,18250,0,0,3,0,3
36481,80,8868,12998;13129,18250,0,0,2,0,2
36482,80,8869,13137;13375;18323,18250,0,1,2,0,3
36483,80,8870,13217;13297;17750,18250,0,0,3,0,3
36484,80,8871,13171;13688,18250,0,0,2,0,2
36485,80,8872,12953;13161;17723,18250,0,0,3,0,3
36486,80,8873,13112;13216;17640,18250,0,0,3,0,3
36487,80,8874,13360;13428;18072;18495,18250,0,2,2,0,4
36488,80,8875,13249;13330;16996,18250,0,0,3,0,3
36489,80,8876,13289;13294;17650,18250,0,0,3,0,3
36490,80,8877,12784;13361;17431;17915,18250,0,1,3,0,4
36491,80,8878,13304;13311;17394,18250,0,0,3,0,3
36492,80,8879,12959;13339;18169,18250,0,1,2,0,3
36493,80,8880,13348;13899;17606;17983,18250,0,1,3,0,4
36494,80,8881,13392;13660;17849,18250,0,1,2,0,3
36495,80,8882,13587;14058;16948;17502;17587,18250,0,0,5,0,5
36496,80,8883,13359;13943;16432;16754;18096,18250,0,1,4,0,5
36497,80,8884,13488;13539;17025;17257;17642;18466,18250,0,1,5,0,6
36498,80,8885,12547;13471,18250,0,0,2,0,2
36499,80,8886,13418;13472;17855,18250,0,1,2,0,3
36500,80,8887,13851,18250,0,0,1,0,1
36501,80,8888,13774;13868;17866,18250,0,1,2,0,3
36502,80,8889,13493;14002;17353;17844,18250,0,1,3,0,4
36503,80,8890,13120;13523;16646;17803,18250,0,0,4,0,4
36504,80,8892,13329;13532;17292;18223,18250,0,1,3,0,4
36505,80,8895,6838,18615,0,0,0,1,1
36506,80,8896,6261,18615,0,0,0,1,1
36507,80,8906,11175;11408,18615,0,0,0,2,2
36508,80,8908,11019;11178,18615,0,0,0,2,2
36509,80,8912,11444;11897;17656,18615,0,0,2,1,3
36510,80,8915,11749,18615,0,0,1,0,1
36511,80,8918,11882;12574;16520;16655,18615,0,0,4,0,4
36512,80,8919,11998;12727,18615,0,0,2,0,2
36513,80,8920,11680;12006,18615,0,0,1,1,2
36514,80,8923,12046;12564;16867,18615,0,0,3,0,3
36515,80,8926,12268;12337;16789;17454,18615,0,0,4,0,4
36516,80,8927,12191;12563,18615,0,0,2,0,2
36517,80,8928,12179;12366,18615,0,0,2,0,2
36518,80,8931,12798;12856;17235;17542,18615,0,0,4,0,4
36519,80,8932,12726,18615,0,0,1,0,1
36520,80,8934,12911;13103;17569,18615,0,0,3,0,3
36521,80,8935,12178;12659;17306,18615,0,0,3,0,3
36522,80,8936,12553;12679,18615,0,0,2,0,2
36523,80,8937,12696;13474;17180;18128,18615,0,1,3,0,4
36524,80,8939,12552;12777,18615,0,0,2,0,2
36525,80,8940,12957;13209;17131;17633;17830,18615,0,1,4,0,5
36526,80,8941,12805;17264,18615,0,0,2,0,2
36527,80,8942,13019;13266;17555,18615,0,0,3,0,3
36528,80,8943,12827;13246;16624;17802;17951,18615,0,1,4,0,5
36529,80,8944,12732;12842;17385,18615,0,0,3,0,3
36530,80,8945,12843;17805,18615,0,0,2,0,2
36531,80,8946,12847;17949,18615,0,1,1,0,2
36532,80,8947,12731;13070;17841;18118,18615,0,2,2,0,4
36533,80,8948,12560;12908;17275;17969,18615,0,1,3,0,4
36534,80,8949,12503;17310,18615,0,0,2,0,2
36535,80,8950,12885;13666;19413,18615,1,0,2,0,3
36536,80,8951,11988;12978;17205,18615,0,0,3,0,3
36537,80,8953,13002;13455;17140;18232,18615,0,1,3,0,4
36538,80,8954,13169;17490,18615,0,0,2,0,2
36539,80,8956,13047;13506;17388;18617,18615,0,1,3,0,4
36540,80,8957,13075;17840,18615,0,1,1,0,2
36541,80,8958,13109;13842;16384,18615,0,0,3,0,3
36542,80,8959,13134;13508,18615,0,0,2,0,2
36543,80,8960,13163;13172;17176;18259,18615,0,1,3,0,4
36544,80,8962,13175;13736;17319,18615,0,0,3,0,3
36545,80,8963,13191;13484,18615,0,0,2,0,2
36546,80,8964,14014;17679;17884,18615,0,1,2,0,3
36547,80,8965,13918;17887;18321,18615,0,2,1,0,3
36548,80,8966,13240;17251;17940,18615,0,1,2,0,3
36549,80,8967,13254;13963;17404;17734;18527,18615,0,1,4,0,5
36550,80,8968,13332;17364;17570;18485,18615,0,1,3,0,4
36551,80,8969,13366,18615,0,0,1,0,1
36552,80,8970,13127;13343;17262,18615,0,0,3,0,3
36553,80,8971,13350;13354;18765,18615,0,1,2,0,3
36554,80,8972,13067;13384;16653;17470;18126,18615,0,1,4,0,5
36555,80,8973,13377;13386;16369,18615,0,0,3,0,3
36556,80,8974,12972;13407;18265,18615,0,1,2,0,3
36557,80,8976,13599;13663;17525;18272,18615,0,1,3,0,4
36558,80,8977,13752;13856;16970;17013,18615,0,0,4,0,4
36559,80,8978,14044;16559;18175;18951,18615,0,2,2,0,4
36560,80,8979,13453;13606,18615,0,0,2,0,2
36561,80,8980,13046;13511;17332;17873;18852,18615,0,2,3,0,5
36562,80,8981,13520;13778;17571,18615,0,0,3,0,3
36563,80,8982,13442;13545;17282;17796,18615,0,0,4,0,4
36564,80,8983,13218;13554;17305;17769,18615,0,0,4,0,4
36565,80,8984,13269;13562;18471,18615,0,1,2,0,3
36566,80,8985,13564;13704;16413,18615,0,0,3,0,3
36567,80,8986,13138;13573,18615,0,0,2,0,2
36568,80,8987,13025;13585;18281;18700,18615,0,2,2,0,4
36569,80,8988,13616;13685;16864;17178;18065,18615,0,1,4,0,5
36570,80,8989,13784;13883;17043;18726,18615,0,1,3,0,4
36571,80,8990,14032;17071;18060,18615,0,1,2,0,3
36572,80,8991,13629;13650;18362;18546,18615,0,2,2,0,4
36573,80,8992,13637;16513;17790,18615,0,0,3,0,3
36574,80,8993,13528;13644;17477;18097;18858,18615,0,2,3,0,5
36575,80,8994,13563;13937;16746;17504;17925;18177;18547,18615,0,3,4,0,7
36576,80,8995,13262;13658;17058;17968;18469,18615,0,2,3,0,5
36577,80,8996,9043,18980,0,0,0,1,1
36578,80,8998,4856,18980,0,0,0,1,1
36579,80,9004,10351,18980,0,0,0,1,1
36580,80,9005,1472,18980,0,0,0,1,1
36581,80,9012,11243,18980,0,0,0,1,1
36582,80,9017,11050;11335;16693,18980,0,0,1,2,3
36583,80,9023,11685;11877,18980,0,0,1,1,2
36584,80,9024,11733;12163,18980,0,0,2,0,2
36585,80,9027,12108;12852;17099,18980,0,0,3,0,3
36586,80,9028,11805;12209,18980,0,0,2,0,2
36587,80,9029,11946;12173;16491;16900,18980,0,0,4,0,4
36588,80,9033,12153;12299;16500,18980,0,0,3,0,3
36589,80,9036,12391;12917;17259;18771,18980,0,1,3,0,4
36590,80,9037,12400;12893;17647,18980,0,0,3,0,3
36591,80,9038,12401;12985;17146;17462;17775,18980,0,0,5,0,5
36592,80,9039,12508,18980,0,0,1,0,1
36593,80,9040,12548;13244;16776,18980,0,0,3,0,3
36594,80,9041,12903;13258;17621,18980,0,0,3,0,3
36595,80,9042,12824,18980,0,0,1,0,1
36596,80,9045,12796;13497;17242;17906,18980,0,1,3,0,4
36597,80,9046,12716;13001,18980,0,0,2,0,2
36598,80,9048,13353;13501;17592,18980,0,0,3,0,3
36599,80,9049,12528;12969;17528;17971,18980,0,1,3,0,4
36600,80,9050,12525;13041;17623;17686,18980,0,0,4,0,4
36601,80,9051,12971;13052;16816,18980,0,0,3,0,3
36602,80,9052,13077;13596;16612;17655;18145,18980,0,1,4,0,5
36603,80,9053,13056;13101,18980,0,0,2,0,2
36604,80,9054,13031;13139;17080;17537,18980,0,0,4,0,4
36605,80,9055,13086;13687;17989,18980,0,1,2,0,3
36606,80,9056,13182;16848,18980,0,0,2,0,2
36607,80,9058,13221;13913;17478,18980,0,0,3,0,3
36608,80,9059,13223;13315,18980,0,0,2,0,2
36609,80,9060,13225;17109;18353,18980,0,1,2,0,3
36610,80,9061,13226;13593,18980,0,0,2,0,2
36611,80,9062,13095;13256,18980,0,0,2,0,2
36612,80,9063,13267;13578,18980,0,0,2,0,2
36613,80,9064,13667;18107,18980,0,1,1,0,2
36614,80,9065,13145;13707;18124,18980,0,1,2,0,3
36615,80,9066,13301;13766;17369,18980,0,0,3,0,3
36616,80,9067,13422;13826;17370;18638,18980,0,1,3,0,4
36617,80,9068,13372;13457;17466,18980,0,0,3,0,3
36618,80,9069,13027;13715;17060,18980,0,0,3,0,3
36619,80,9070,13055;13430,18980,0,0,2,0,2
36620,80,9071,12865;13514;17268;18529,18980,0,1,3,0,4
36621,80,9072,13636;18021;18480,18980,0,2,1,0,3
36622,80,9073,13458;13580;17661,18980,0,0,3,0,3
36623,80,9074,13461;13591;17352;19429,18980,1,0,3,0,4
36624,80,9075,13100;13448;17126,18980,0,0,3,0,3
36625,80,9076,13362;13491;17572;17798,18980,0,0,4,0,4
36626,80,9077,13319;13534;17905;18515,18980,0,2,2,0,4
36627,80,9078,13444;13576,18980,0,0,2,0,2
36628,80,9079,13617;13996;17930,18980,0,1,2,0,3
36629,80,9080,13610;13705,18980,0,0,2,0,2
36630,80,9082,13179;13641;18660,18980,0,1,2,0,3
36631,80,9083,13292;13642,18980,0,0,2,0,2
36632,80,9084,13693;13841;17521,18980,0,0,3,0,3
36633,80,9085,13713;13749,18980,0,0,2,0,2
36634,80,9086,13716;13893,18980,0,0,2,0,2
36635,80,9087,13233;13729;17625,18980,0,0,3,0,3
36636,80,9088,13761;13930;17446,18980,0,0,3,0,3
36637,80,9089,13763;17113;17531;17861,18980,0,1,3,0,4
36638,80,9090,14057;16873;17158,18980,0,0,3,0,3
36639,80,9091,13938;16508;17792;18005,18980,0,1,3,0,4
36640,80,9092,334,19345,0,0,0,1,1
36641,80,9093,10216,19345,0,0,0,1,1
36642,80,9094,1266,19345,0,0,0,1,1
36643,80,9102,10957,19345,0,0,0,1,1
36644,80,9108,10993;11145,19345,0,0,0,2,2
36645,80,9111,11540,19345,0,0,0,1,1
36646,80,9118,11893,19345,0,0,1,0,1
36647,80,9121,12097;12373;17111;17565;17636;17954,19345,0,1,5,0,6
36648,80,9122,12375;12949;17981,19345,0,1,2,0,3
36649,80,9123,12356;12433;16889,19345,0,0,3,0,3
36650,80,9124,12440;12520;17427;17715,19345,0,0,4,0,4
36651,80,9125,12480;12676;17497,19345,0,0,3,0,3
36652,80,9127,12606;13099,19345,0,0,2,0,2
36653,80,9129,12222;12634;17199,19345,0,0,3,0,3
36654,80,9131,12413;12598;16029,19345,0,0,3,0,3
36655,80,9132,12507;13015;17197;18022,19345,0,1,3,0,4
36656,80,9133,13143;17191,19345,0,0,2,0,2
36657,80,9134,16681;17226,19345,0,0,2,0,2
36658,80,9135,13232;13316;17624;18146,19345,0,1,3,0,4
36659,80,9136,14204;16913,19345,0,0,2,0,2
36660,80,9137,13037;13106;17006;17354,19345,0,0,4,0,4
36661,80,9138,13308;13611;17685,19345,0,0,3,0,3
36662,80,9139,12831;13280,19345,0,0,2,0,2
36663,80,9140,13808;13950;17361;18240,19345,0,1,3,0,4
36664,80,9141,13672;13958;16887;17468;17880,19345,0,1,4,0,5
36665,80,9142,13083;13334;17051,19345,0,0,3,0,3
36666,80,9143,13335;13336;17574,19345,0,0,3,0,3
36667,80,9145,14046;17294;17700,19345,0,0,3,0,3
36668,80,9146,13940;18505,19345,0,1,1,0,2
36669,80,9147,13066;13390;17629;18204,19345,0,1,3,0,4
36670,80,9148,13717;17972,19345,0,1,1,0,2
36671,80,9149,13400;14152;16720;17355;18393,19345,0,1,4,0,5
36672,80,9150,13401;13936;17439,19345,0,0,3,0,3
36673,80,9151,13415;17774,19345,0,0,2,0,2
36674,80,9152,14090;14339;16743;16952;17125;17799,19345,0,0,6,0,6
36675,80,9153,12952;13487,19345,0,0,2,0,2
36676,80,9154,13519;13980;18708,19345,0,1,2,0,3
36677,80,9155,14070;16919;17421;17726,19345,0,0,4,0,4
36678,80,9156,13588;14041;17330;17494,19345,0,0,4,0,4
36679,80,9157,14063;14188;18276;18693,19345,0,2,2,0,4
36680,80,9158,13433;13699;16659,19345,0,0,3,0,3
36681,80,9159,13649;13664;17664,19345,0,0,3,0,3
36682,80,9160,13561;13673;17558;17708,19345,0,0,4,0,4
36683,80,9161,13219;13677;17507,19345,0,0,3,0,3
36684,80,9162,13447;13695,19345,0,0,2,0,2
36685,80,9163,13412,19345,0,0,1,0,1
36686,80,9164,13278;13714;17168,19345,0,0,3,0,3
36687,80,9165,13723;13878;17547;18564;19415,19345,1,1,3,0,5
36688,80,9166,13373;13732;18659,19345,0,1,2,0,3
36689,80,9167,13531;13740;16917;17495;17965,19345,0,1,4,0,5
36690,80,9168,13323;13801;16944;17852;18048,19345,0,2,3,0,5
36691,80,9169,13768;14027;17807,19345,0,1,2,0,3
36692,80,9170,13431;13771,19345,0,0,2,0,2
36693,80,9171,13600;13772;18212;18322,19345,0,2,2,0,4
36694,80,9172,13858;17817;18187;18371,19345,0,3,1,0,4
36695,80,9173,13790;13892;18112,19345,0,1,2,0,3
36696,80,9174,13247;13792,19345,0,0,2,0,2
36697,80,9175,13793;13849;17678;17979;18387,19345,0,2,3,0,5
36698,80,9177,13527;13845;17604,19345,0,0,3,0,3
36699,80,9178,13979;14120;17023;18375,19345,0,1,3,0,4
36700,80,9179,13984;14196;18517,19345,0,1,2,0,3
36701,80,9180,13804;13894;17752,19345,0,0,3,0,3
36702,80,9181,13901;13919;17382;17970,19345,0,1,3,0,4
36703,80,9184,3952,19710,0,0,0,1,1
36704,80,9185,4075,19710,0,0,0,1,1
36705,80,9187,6055,19710,0,0,0,1,1
36706,80,9189,7039,19710,0,0,0,1,1
36707,80,9193,10106,19710,0,0,0,1,1
36708,80,9194,10233,19710,0,0,0,1,1
36709,80,9195,10238,19710,0,0,0,1,1
36710,80,9199,10706,19710,0,0,0,1,1
36711,80,9200,10838,19710,0,0,0,1,1
36712,80,9206,11643,19710,0,0,0,1,1
36713,80,9211,11997;12145;17483,19710,0,0,3,0,3
36714,80,9213,12288;12675;17029,19710,0,0,3,0,3
36715,80,9216,12526;12703,19710,0,0,2,0,2
36716,80,9217,12835;12922;16904,19710,0,0,3,0,3
36717,80,9219,13117;13676;17247;17794;18014,19710,0,1,4,0,5
36718,80,9220,12656;13011;17644;17780,19710,0,0,4,0,4
36719,80,9221,12387;13124;16958;17480,19710,0,0,4,0,4
36720,80,9222,13044;13275;17891;18355,19710,0,2,2,0,4
36721,80,9223,12621;13162;16892,19710,0,0,3,0,3
36722,80,9226,13349;13665;18274;18524,19710,0,2,2,0,4
36723,80,9227,13515;17552;17850;18754,19710,0,2,2,0,4
36724,80,9228,13165;13553;17620;18484;18591,19710,0,2,3,0,5
36725,80,9231,14069;14155,19710,0,0,2,0,2
36726,80,9232,13582;17380,19710,0,0,2,0,2
36727,80,9233,13426;13477,19710,0,0,2,0,2
36728,80,9234,13542;13924;17290;17995;18759,19710,0,2,3,0,5
36729,80,9235,13421;13551,19710,0,0,2,0,2
36730,80,9236,14110;14207;17342;17498;17702;18361,19710,0,1,5,0,6
36731,80,9237,13435;13598;17631,19710,0,0,3,0,3
36732,80,9238,13423;13440;17358;18551,19710,0,1,3,0,4
36733,80,9239,13624;14138;17713;18930,19710,0,1,3,0,4
36734,80,9241,13654;17241;18389,19710,0,1,2,0,3
36735,80,9242,14337;17303;18231;18750,19710,0,2,2,0,4
36736,80,9243,13694;14314;18784;19146,19710,0,2,2,0,4
36737,80,9244,13460;13791;18094,19710,0,1,2,0,3
36738,80,9245,13702;17279;17667;18142,19710,0,1,3,0,4
36739,80,9246,13413;13708;17064;17449;18584,19710,0,1,4,0,5
36740,80,9247,13712;14206;18045,19710,0,1,2,0,3
36741,80,9248,13425,19710,0,0,1,0,1
36742,80,9249,13741;14042;18143,19710,0,1,2,0,3
36743,80,9250,13674;14362;16918;17767;18010,19710,0,1,4,0,5
36744,80,9251,13530;13811;17004;17296;18149,19710,0,1,4,0,5
36745,80,9252,13840;14462;16827;18407,19710,0,1,3,0,4
36746,80,9253,13832;14365;17263;18681,19710,0,1,3,0,4
36747,80,9254,13850;14089;16832;17853,19710,0,1,3,0,4
36748,80,9255,13890;14158;17333;17584,19710,0,0,4,0,4
36749,80,9256,13907;17376;18221,19710,0,1,2,0,3
36750,80,9257,13236;13914;17692;17956,19710,0,1,3,0,4
36751,80,9258,13205;13926;17711;18108,19710,0,1,3,0,4
36752,80,9259,13947;14141;16910;17448;17816;18903,19710,0,2,4,0,6
36753,80,9260,13906;13948;17549;17728;18139,19710,0,1,4,0,5
36754,80,9261,13971;14100;17324,19710,0,0,3,0,3
36755,80,9262,13990;17070,19710,0,0,2,0,2
36756,80,9263,14097;18023;18890,19710,0,2,1,0,3
36757,80,9264,14035;14047;17879;18747,19710,0,2,2,0,4
36758,80,9265,13615;13944;18422,19710,0,1,2,0,3
36759,80,9266,13871;14078;17076;17710;18129,19710,0,1,4,0,5
36760,80,9267,14080;14451;17901,19710,0,1,2,0,3
36761,80,9270,3108,20075,0,0,0,1,1
36762,80,9277,10166,20075,0,0,0,1,1
36763,80,9279,10143,20075,0,0,0,1,1
36764,80,9281,10401,20075,0,0,0,1,1
36765,80,9282,10381,20075,0,0,0,1,1
36766,80,9290,10798,20075,0,0,0,1,1
36767,80,9294,11143;11284,20075,0,0,0,2,2
36768,80,9296,11255,20075,0,0,0,1,1
36769,80,9302,11745;12123,20075,0,0,2,0,2
36770,80,9305,11944;12106;16888,20075,0,0,3,0,3
36771,80,9306,12154;17541,20075,0,0,2,0,2
36772,80,9309,12169;12653;17399,20075,0,0,3,0,3
36773,80,9313,12724;13078;18194,20075,0,1,2,0,3
36774,80,9314,12483;12588,20075,0,0,2,0,2
36775,80,9315,12853;12933;17086,20075,0,0,3,0,3
36776,80,9316,12993;13411;17170;18475,20075,0,1,3,0,4
36777,80,9317,13033;13556;17608,20075,0,0,3,0,3
36778,80,9318,12626;12916;16870;17155,20075,0,0,4,0,4
36779,80,9319,12833;13229;17115,20075,0,0,3,0,3
36780,80,9321,13296;13634;17163;18151,20075,0,1,3,0,4
36781,80,9323,13769;14171;17902;18440;18697,20075,0,3,2,0,5
36782,80,9325,13325;13575;17834,20075,0,1,2,0,3
36783,80,9327,14359;19004,20075,0,1,1,0,2
36784,80,9329,13706;14191;18372;18979,20075,0,2,2,0,4
36785,80,9330,13710;18025;18523;19172,20075,0,3,1,0,4
36786,80,9331,13516;13719;16971;17886;18241,20075,0,2,3,0,5
36787,80,9332,13730;14030;17329;17409,20075,0,0,4,0,4
36788,80,9333,13759;14443;18514,20075,0,1,2,0,3
36789,80,9334,13628;13789;17514;18333;18457,20075,0,2,3,0,5
36790,80,9335,13797;14186;17167;18024;18502,20075,0,2,3,0,5
36791,80,9336,13799;14137;18335;19319,20075,1,1,2,0,4
36792,80,9337,13548;13839;17809;18228,20075,0,2,2,0,4
36793,80,9338,13854;14121;18189;19045,20075,0,2,2,0,4
36794,80,9339,13783;13877;17561,20075,0,0,3,0,3
36795,80,9340,13888;14130;18570,20075,0,1,2,0,3
36796,80,9341,13867;13908;18582,20075,0,1,2,0,3
36797,80,9342,13910;14312;18627;18869,20075,0,2,2,0,4
36798,80,9343,13748;13912;17795;19083,20075,0,1,3,0,4
36799,80,9344,13406;13812,20075,0,0,2,0,2
36800,80,9345,13690;13927;17295;17693,20075,0,0,4,0,4
36801,80,9346,13152;13933;18595,20075,0,1,2,0,3
36802,80,9348,13951;14282;19074,20075,0,1,2,0,3
36803,80,9349,13735;13954;17857;18489,20075,0,2,2,0,4
36804,80,9350,14009;17672;18376,20075,0,1,2,0,3
36805,80,9351,13876;14225;18184,20075,0,1,2,0,3
36806,80,9352,14052;17367;18346,20075,0,1,2,0,3
36807,80,9353,13891;14099;17093;17445,20075,0,0,4,0,4
36808,80,9354,14473;14546;16979;18682,20075,0,1,3,0,4
36809,80,9355,14366;14530;16901;17425;17737;18720;19160,20075,0,2,5,0,7
36810,80,9356,13679;13809;17153,20075,0,0,3,0,3
36811,80,9357,13816;14125;18283;19277,20075,0,2,2,0,4
36812,80,9358,14140;14584;17509,20075,0,0,3,0,3
36813,80,9359,14114;14144;17924,20075,0,1,2,0,3
36814,80,9360,13481;14154;17615;18442,20075,0,1,3,0,4
36815,80,9361,14178;14369;18775,20075,0,1,2,0,3
36816,80,9362,14128;14181;17286,20075,0,0,3,0,3
36817,80,9363,14198;18070;18571;19525,20075,1,2,1,0,4
36818,80,9364,14218;14852;19062;19681,20075,1,1,2,0,4
36819,80,9370,10172,20440,0,0,0,1,1
36820,80,9371,10275,20440,0,0,0,1,1
36821,80,9373,10222,20440,0,0,0,1,1
36822,80,9382,10878;10946,20440,0,0,0,2,2
36823,80,9384,10965,20440,0,0,0,1,1
36824,80,9387,11417;11748,20440,0,0,1,1,2
36825,80,9400,12492,20440,0,0,1,0,1
36826,80,9402,12345;12394;17579;17973,20440,0,1,3,0,4
36827,80,9403,12505;17317,20440,0,0,2,0,2
36828,80,9404,12425;12454,20440,0,0,2,0,2
36829,80,9405,13016;13215;17573,20440,0,0,3,0,3
36830,80,9406,12466;12582,20440,0,0,2,0,2
36831,80,9407,12902;17634,20440,0,0,2,0,2
36832,80,9408,12601;17334,20440,0,0,2,0,2
36833,80,9409,12645;13572;17839,20440,0,1,2,0,3
36834,80,9410,12484;12750,20440,0,0,2,0,2
36835,80,9412,12494;12765;17283,20440,0,0,3,0,3
36836,80,9415,12939;13104;17441;17688;18190,20440,0,1,4,0,5
36837,80,9416,12995;13197,20440,0,0,2,0,2
36838,80,9417,12870;13013;17147,20440,0,0,3,0,3
36839,80,9419,13042;13193,20440,0,0,2,0,2
36840,80,9421,13064;17553,20440,0,0,2,0,2
36841,80,9422,13151;13298;18470,20440,0,1,2,0,3
36842,80,9423,13003;13273;17276;17665,20440,0,0,4,0,4
36843,80,9424,13200;13212;17482,20440,0,0,3,0,3
36844,80,9425,13709,20440,0,0,1,0,1
36845,80,9426,13331;13522;18373,20440,0,1,2,0,3
36846,80,9428,12900;13438;18498,20440,0,1,2,0,3
36847,80,9429,13463;13964;17882;18213,20440,0,2,2,0,4
36848,80,9430,13897;14169;18081,20440,0,1,2,0,3
36849,80,9431,13525;13620;17088;17563;19066,20440,0,1,4,0,5
36850,80,9433,13327;13698;17365,20440,0,0,3,0,3
36851,80,9434,13720;14074;18793,20440,0,1,2,0,3
36852,80,9435,13722;14184;17339,20440,0,0,3,0,3
36853,80,9436,13731;14068;17829;18945,20440,0,2,2,0,4
36854,80,9437,13806;13855;17426;18501,20440,0,1,3,0,4
36855,80,9438,14168;17947,20440,0,1,1,0,2
36856,80,9439,13513;13821;19015,20440,0,1,2,0,3
36857,80,9440,13825;14167;17210;17581,20440,0,0,4,0,4
36858,80,9441,13833;14318;18105;18955;19309,20440,0,3,2,0,5
36859,80,9442,13393;13844;18277;18626,20440,0,2,2,0,4
36860,80,9443,14350;14390;18036;18308;18756;19013,20440,0,4,2,0,6
36861,80,9444,14235;14237;17315;17597,20440,0,0,4,0,4
36862,80,9445,13328;13934;17745,20440,0,0,3,0,3
36863,80,9446,13889;14124;17717;17959;18051;18947,20440,0,3,3,0,6
36864,80,9447,13900;14330;18539;18916,20440,0,2,2,0,4
36865,80,9448,13902;17735,20440,0,0,2,0,2
36866,80,9449,13920;18437,20440,0,1,1,0,2
36867,80,9450,13923;14329;17800;17938;18868,20440,0,2,3,0,5
36868,80,9451,13931;14363;18823;19287,20440,0,2,2,0,4
36869,80,9452,14066;14343;18152;18612,20440,0,2,2,0,4
36870,80,9454,14412;17469;17611;18996,20440,0,1,3,0,4
36871,80,9455,14486;14652;18278;18770,20440,0,2,2,0,4
36872,80,9456,13975;14320;17988;18780;18965,20440,0,3,2,0,5
36873,80,9457,14153;14677;17084;17909;18399;18601;19826,20440,1,3,3,0,7
36874,80,9458,13887;14086;17651;18468,20440,0,1,3,0,4
36875,80,9459,14150;14503;18817,20440,0,1,2,0,3
36876,80,9460,14050;14182;18724;18904,20440,0,2,2,0,4
36877,80,9461,14592,20440,0,0,1,0,1
36878,80,9462,13570;14465;19231,20440,0,1,2,0,3
36879,80,9463,13777;14076;18008;18162;18513,20440,0,3,2,0,5
36880,80,9464,14088;14119;17670;17996;18906,20440,0,2,3,0,5
36881,80,9465,14157;14537;18324,20440,0,1,2,0,3
36882,80,9466,14113;17838;19159,20440,0,2,1,0,3
36883,80,9467,14134;14539;18016,20440,0,1,2,0,3
36884,80,9468,14059;14468;17318;18059;18688,20440,0,2,3,0,5
36885,80,9469,13404,20440,0,0,1,0,1
36886,80,9470,14161;17544;18336,20440,0,1,2,0,3
36887,80,9471,14177;14747;18229;18394;18599;18879,20440,0,4,2,0,6
36888,80,9472,13837;14192;17246;17903,20440,0,1,3,0,4
36889,80,9473,14215;14458;18451;19048,20440,0,2,2,0,4
36890,80,9474,14216;14376;17302;18166;18706;18801;19771,20440,1,3,3,0,7
36891,80,9475,14147;14242;18598;18988;19230,20440,0,3,2,0,5
36892,80,9476,14243;18636,20440,0,1,1,0,2
36893,80,9477,14256;14611;17900;18305;18530;19078,20440,0,4,2,0,6
36894,80,9478,13738;14269;17474;17888,20440,0,1,3,0,4
36895,80,9479,13773;14292;18215;18633,20440,0,2,2,0,4
36896,80,9480,14317;14354;17680;19453,20440,1,0,3,0,4
36897,80,9481,14319;14435;17074;18115,20440,0,1,3,0,4
36898,80,9482,14638;17648;18133;18536;19738,20440,1,2,2,0,5
36899,80,9484,10102,20805,0,0,0,1,1
36900,80,9488,10571,20805,0,0,0,1,1
36901,80,9494,10261,20805,0,0,0,1,1
36902,80,9498,11235;11583,20805,0,0,0,2,2
36903,80,9501,11400,20805,0,0,0,1,1
36904,80,9509,11925;12172;17185,20805,0,0,3,0,3
36905,80,9513,12320;17265,20805,0,0,2,0,2
36906,80,9515,12058;12112,20805,0,0,2,0,2
36907,80,9518,12591;12657;17136;17639,20805,0,0,4,0,4
36908,80,9520,12983;13378;17134;18156,20805,0,1,3,0,4
36909,80,9522,12849,20805,0,0,1,0,1
36910,80,9523,12874;13125;17400,20805,0,0,3,0,3
36911,80,9525,12636;12841;17771,20805,0,0,3,0,3
36912,80,9527,12607;13082,20805,0,0,2,0,2
36913,80,9528,13459;18347,20805,0,1,1,0,2
36914,80,9529,13157;13785;19017,20805,0,1,2,0,3
36915,80,9530,13819;17744;18342,20805,0,1,2,0,3
36916,80,9532,13188;17630,20805,0,0,2,0,2
36917,80,9533,14334;17770;19051;19168,20805,0,2,2,0,4
36918,80,9534,13346;17455;17596,20805,0,0,3,0,3
36919,80,9535,13356;13510;17171;17345;17701,20805,0,0,5,0,5
36920,80,9537,13405;14205;17851;18416,20805,0,2,2,0,4
36921,80,9538,13368;17273;17491,20805,0,0,3,0,3
36922,80,9539,13451;13962;17804;19022;19539,20805,1,1,3,0,5
36923,80,9540,14115;14308;19385,20805,1,0,2,0,3
36924,80,9541,13492;13739;17757;18144;18257;18703,20805,0,3,3,0,6
36925,80,9542,13546;14126;17387;17987;18197,20805,0,2,3,0,5
36926,80,9543,13571;13581;18216,20805,0,1,2,0,3
36927,80,9544,14016;14252;17594;17863,20805,0,1,3,0,4
36928,80,9545,13173;17833,20805,0,1,1,0,2
36929,80,9546,13662;13807;18235,20805,0,1,2,0,3
36930,80,9547,13441;13684;18125;18351;18634,20805,0,3,2,0,5
36931,80,9548,13776;14038;17822;18122,20805,0,2,2,0,4
36932,80,9549,14285;14446;17889,20805,0,1,2,0,3
36933,80,9550,13836;18782,20805,0,1,1,0,2
36934,80,9552,13852;14139;17984,20805,0,1,2,0,3
36935,80,9553,14162;17654;18877,20805,0,1,2,0,3
36936,80,9554,13402;14276;17848;18244;18418;19040,20805,0,4,2,0,6
36937,80,9555,13862;13882;17894,20805,0,1,2,0,3
36938,80,9556,13274;14000;18046;18461,20805,0,2,2,0,4
36939,80,9557,13957;14449;17781,20805,0,0,3,0,3
36940,80,9558,14043;14072;17321;17515,20805,0,0,4,0,4
36941,80,9559,13952;14048;17159;17501;18518,20805,0,1,4,0,5
36942,80,9560,14051;14108;18359;18625,20805,0,2,2,0,4
36943,80,9561,14224;14595;18015;18270,20805,0,2,2,0,4
36944,80,9562,13454;14118;18806,20805,0,1,2,0,3
36945,80,9563,13696;14132;18348,20805,0,1,2,0,3
36946,80,9564,14146;17516;18042,20805,0,1,2,0,3
36947,80,9565,14845;17944;18236,20805,0,2,1,0,3
36948,80,9566,14151;17309;17936;18301;18689,20805,0,3,2,0,5
36949,80,9567,14093;14478;17160;18073;18428,20805,0,2,3,0,5
36950,80,9568,13742;14194;18099;18404,20805,0,2,2,0,4
36951,80,9569,14197;15122,20805,0,0,2,0,2
36952,80,9570,14202;14214;18605,20805,0,1,2,0,3
36953,80,9571,13916;14230;18645,20805,0,1,2,0,3
36954,80,9572,14232;14661;18319,20805,0,1,2,0,3
36955,80,9573,14245;14500;18182,20805,0,1,2,0,3
36956,80,9574,14247;14532;17868;18027;19464;19830,20805,2,2,2,0,6
36957,80,9575,13829;14253;17646;18100,20805,0,1,3,0,4
36958,80,9576,14098;14289;18777;19314,20805,1,1,2,0,4
36959,80,9577,14637;14774;17999;18436;19301,20805,0,3,2,0,5
36960,80,9578,14395;14822;17682;18056,20805,0,1,3,0,4
36961,80,9579,14061;14418;17258;18725,20805,0,1,3,0,4
36962,80,9580,14678;18665,20805,0,1,1,0,2
36963,80,9581,14529;14705;17149;18026;18210,20805,0,2,3,0,5
36964,80,9582,14212;14459;17696;18931,20805,0,1,3,0,4
36965,80,9583,14563;15000;18188,20805,0,1,2,0,3
36966,80,9584,14442;14800;17128;17912;18057;18936,20805,0,3,3,0,6
36967,80,9585,10074,21170,0,0,0,1,1
36968,80,9587,10150,21170,0,0,0,1,1
36969,80,9588,8721,21170,0,0,0,1,1
36970,80,9599,11453,21170,0,0,0,1,1
36971,80,9605,11972;17451,21170,0,0,2,0,2
36972,80,9606,11812;12381,21170,0,0,2,0,2
36973,80,9608,12614;12912;17607,21170,0,0,3,0,3
36974,80,9613,12262;12361;17289,21170,0,0,3,0,3
36975,80,9614,12388;12512;17722,21170,0,0,3,0,3
36976,80,9615,12984;13526,21170,0,0,2,0,2
36977,80,9616,12448;12506;17641;17813,21170,0,1,3,0,4
36978,80,9620,12271,21170,0,0,1,0,1
36979,80,9621,12649;12923;17487,21170,0,0,3,0,3
36980,80,9623,12752;12899;18227,21170,0,1,2,0,3
36981,80,9627,12913;12940;17278;17978,21170,0,1,3,0,4
36982,80,9628,13603;17518,21170,0,0,2,0,2
36983,80,9629,12982;13333;17436,21170,0,0,3,0,3
36984,80,9631,13281;13287;18074,21170,0,1,2,0,3
36985,80,9632,12918;13635,21170,0,0,2,0,2
36986,80,9633,13199;13490;17762;18165,21170,0,1,3,0,4
36987,80,9638,13284;13427;17818;18651,21170,0,2,2,0,4
36988,80,9641,13502;14375;17675;19047,21170,0,1,3,0,4
36989,80,9642,13782;13929,21170,0,0,2,0,2
36990,80,9644,13544;14262;17856,21170,0,1,2,0,3
36991,80,9645,13589;13762;18269,21170,0,1,2,0,3
36992,80,9646,14223;18028;18415;18610;18845;19250;19548,21170,1,5,1,0,7
36993,80,9647,13595;13828;17754;19294,21170,0,1,3,0,4
36994,80,9648,13344;17578;17837,21170,0,1,2,0,3
36995,80,9649,13631;13866;19192,21170,0,1,2,0,3
36996,80,9650,13661;17530;17976,21170,0,1,2,0,3
36997,80,9651,14145;14382;17510,21170,0,0,3,0,3
36998,80,9652,13751;13896,21170,0,0,2,0,2
36999,80,9653,13831;14259;17366;17791,21170,0,0,4,0,4
37000,80,9654,13478;13552,21170,0,0,2,0,2
37001,80,9655,14368;18647;19101,21170,0,2,1,0,3
37002,80,9656,13543;13989;17548;17768;18173;19614,21170,1,1,4,0,6
37003,80,9657,13538;14026;18802,21170,0,1,2,0,3
37004,80,9658,13981;14448;17691;18710,21170,0,1,3,0,4
37005,80,9659,13959;14056;18811;19336,21170,1,1,2,0,4
37006,80,9660,14067;14361;17758;18117,21170,0,1,3,0,4
37007,80,9661,14522;14828;17749;18088;19416,21170,1,1,3,0,5
37008,80,9662,14092,21170,0,0,1,0,1
37009,80,9663,14346;17311;17919;18614;18938,21170,0,3,2,0,5
37010,80,9664,14010;14164;17564,21170,0,0,3,0,3
37011,80,9665,14166;14707;17341;18446,21170,0,1,3,0,4
37012,80,9666,13928;14203;17338;17559,21170,0,0,4,0,4
37013,80,9667,14018;14229;19124,21170,0,1,2,0,3
37014,80,9668,14585;17313;17674,21170,0,0,3,0,3
37015,80,9669,14572;18331;18438,21170,0,2,1,0,3
37016,80,9670,14322;14733;17910;18900,21170,0,2,2,0,4
37017,80,9671,14006;14353;18309;18964,21170,0,2,2,0,4
37018,80,9672,14270;14804;17964;19275,21170,0,2,2,0,4
37019,80,9673,13746;13861;18038,21170,0,1,2,0,3
37020,80,9674,14943;17453;17659,21170,0,0,3,0,3
37021,80,9675,14399;14606;19305,21170,0,1,2,0,3
37022,80,9676,14414;14415;17712;17993;18243;18593;18732,21170,0,4,3,0,7
37023,80,9677,14429;14719;17825;18398;18803,21170,0,3,2,0,5
37024,80,9678,14021;14434;18723;18966,21170,0,2,2,0,4
37025,80,9679,14438;14479;18783;19052,21170,0,2,2,0,4
37026,80,9680,14797;14908;18431,21170,0,1,2,0,3
37027,80,9681,14768;18303;18910;19637,21170,1,2,1,0,4
37028,80,9682,14054;14485;18102;18922,21170,0,2,2,0,4
37029,80,9683,13618;14263,21170,0,0,2,0,2
37030,80,9684,14175;14525;18101;18452,21170,0,2,2,0,4
37031,80,9685,14534;14761;17260;17681;17738;19252,21170,0,1,5,0,6
37032,80,9686,14397;14547;19593,21170,1,0,2,0,3
37033,80,9687,14823;18390,21170,0,1,1,0,2
37034,80,9688,14227;14555;18267;18743,21170,0,2,2,0,4
37035,80,9689,15013;15119;17349;17772;18886,21170,0,1,4,0,5
37036,80,9690,14588;18282;18574;19450,21170,1,2,1,0,4
37037,80,9691,14608;17922;18317,21170,0,2,1,0,3
37038,80,9692,14616;14930;17929,21170,0,1,2,0,3
37039,80,9693,10050,21535,0,0,0,1,1
37040,80,9694,10079,21535,0,0,0,1,1
37041,80,9696,10357,21535,0,0,0,1,1
37042,80,9697,10536,21535,0,0,0,1,1
37043,80,9703,11008,21535,0,0,0,1,1
37044,80,9708,11706;12389,21535,0,0,2,0,2
37045,80,9710,12033,21535,0,0,1,0,1
37046,80,9712,12200;12215;17401;17764,21535,0,0,4,0,4
37047,80,9715,12094;12410;17568;17622,21535,0,0,4,0,4
37048,80,9717,12860;13128;18017,21535,0,1,2,0,3
37049,80,9718,12390,21535,0,0,1,0,1
37050,80,9720,13243,21535,0,0,1,0,1
37051,80,9722,12677;12787;17776;17874,21535,0,1,3,0,4
37052,80,9726,12619;12988;17522;17953,21535,0,1,3,0,4
37053,80,9727,13060;13512;17872;18298,21535,0,2,2,0,4
37054,80,9729,13414;18068,21535,0,1,1,0,2
37055,80,9731,13153;13245,21535,0,0,2,0,2
37056,80,9732,13251,21535,0,0,1,0,1
37057,80,9733,13640;13725;17705;17751,21535,0,0,4,0,4
37058,80,9734,13309;13758;17601,21535,0,0,3,0,3
37059,80,9736,13540,21535,0,0,1,0,1
37060,80,9738,13358;13960;17937;18185,21535,0,2,2,0,4
37061,80,9739,13381,21535,0,0,1,0,1
37062,80,9740,13770;18341,21535,0,1,1,0,2
37063,80,9741,12999;13701;18237,21535,0,1,2,0,3
37064,80,9742,13880;14077;18464,21535,0,1,2,0,3
37065,80,9743,13370;14033,21535,0,0,2,0,2
37066,80,9744,13724;14278;18427;18941,21535,0,2,2,0,4
37067,80,9745,13605;14065;17576;18429,21535,0,1,3,0,4
37068,80,9746,14698;14704;17854;18337;19262,21535,0,3,2,0,5
37069,80,9747,13700;13795;17836;18914,21535,0,2,2,0,4
37070,80,9748,13235,21535,0,0,1,0,1
37071,80,9749,13614;13843;17668;18255;18552,21535,0,2,3,0,5
37072,80,9750,14425;14549;17962,21535,0,1,2,0,3
37073,80,9751,13737;13995;18677;18818,21535,0,2,2,0,4
37074,80,9752,13949;14517,21535,0,0,2,0,2
37075,80,9753,13494;13965,21535,0,0,2,0,2
37076,80,9754,13969;14627;19108;19288,21535,0,2,2,0,4
37077,80,9755,13978;14328;18148,21535,0,1,2,0,3
37078,80,9756,13986;14441;17731;18251,21535,0,1,3,0,4
37079,80,9757,13966;14004;17535;18062,21535,0,1,3,0,4
37080,80,9758,14008;14117;18488,21535,0,1,2,0,3
37081,80,9760,14081;17560;17739,21535,0,0,3,0,3
37082,80,9761,14083;14965;17503;18140;18260;18572;19560,21535,1,3,3,0,7
37083,80,9762,14767;18522;19079,21535,0,2,1,0,3
37084,80,9763,14142;18304;18873,21535,0,2,1,0,3
37085,80,9764,14165;14409;18253;19021,21535,0,2,2,0,4
37086,80,9765,14112;14548,21535,0,0,2,0,2
37087,80,9766,14571;14720;18082;18649,21535,0,2,2,0,4
37088,80,9767,14208;14336;18334;18590,21535,0,2,2,0,4
37089,80,9768,14211;14726;19002,21535,0,1,2,0,3
37090,80,9769,13921;14220,21535,0,0,2,0,2
37091,80,9770,14179;14241;17377;17904;18448;18832,21535,0,3,3,0,6
37092,80,9771,14261;14578;17724;18478,21535,0,1,3,0,4
37093,80,9772,14012;17842;18963,21535,0,2,1,0,3
37094,80,9773,14028;14789;18426;19876,21535,1,1,2,0,4
37095,80,9774,14325;14849;18472;18976;19482,21535,1,2,2,0,5
37096,80,9775,13686;14378;18040;18201;19076,21535,0,3,2,0,5
37097,80,9776,14763;15028;18327;19009,21535,0,2,2,0,4
37098,80,9777,14239;14630,21535,0,0,2,0,2
37099,80,9778,14372;14857;18013;18246;18384;18553;18694,21535,0,5,2,0,7
37100,80,9779,14298;14406;17593;17785;18233;18492;19583,21535,1,2,4,0,7
37101,80,9780,14521;14540,21535,0,0,2,0,2
37102,80,9781,14288;14413;17716;18275;18736,21535,0,2,3,0,5
37103,80,9782,14316;14417;18476,21535,0,1,2,0,3
37104,80,9783,13726;14453;19286,21535,0,1,2,0,3
37105,80,9784,14103;14470;19178,21535,0,1,2,0,3
37106,80,9785,15139;17586;17741;18012;19397,21535,1,1,3,0,5
37107,80,9786,15058;19476;19742,21535,2,0,1,0,3
37108,80,9787,14496;14645;17398;18067;19634,21535,1,1,3,0,5
37109,80,9788,14618;18400;18774;18792,21535,0,3,1,0,4
37110,80,9789,14523;17974;18179;19328,21535,1,2,1,0,4
37111,80,9790,14544;14646;18632;18998,21535,0,2,2,0,4
37112,80,9791,14573;18071;18831,21535,0,2,1,0,3
37113,80,9792,14581;18256;18911,21535,0,2,1,0,3
37114,80,9793,14091;14615,21535,0,0,2,0,2
37115,80,9794,14633;14779;18168;18519;19028,21535,0,3,2,0,5
37116,80,9795,14860;15099,21535,0,0,2,0,2
37117,80,9796,14454;14655;18222;18932;19651,21535,1,2,2,0,5
37118,80,9797,14326;14658;18602;18913,21535,0,2,2,0,4
37119,80,9798,14660;14723;17362;17820;18106;18291;18745,21535,0,4,3,0,7
37120,80,9799,14731;14786;17422;18860,21535,0,1,3,0,4
37121,80,9800,14735;14816;17920;18193;18587,21535,0,3,2,0,5
37122,80,9801,14743;14842;18365;19359,21535,1,1,2,0,4
37123,80,9803,10330,21900,0,0,0,1,1
37124,80,9805,10391,21900,0,0,0,1,1
37125,80,9807,10454,21900,0,0,0,1,1
37126,80,9813,10609,21900,0,0,0,1,1
37127,80,9815,11148,21900,0,0,0,1,1
37128,80,9816,11234,21900,0,0,0,1,1
37129,80,9819,11459;11475,21900,0,0,0,2,2
37130,80,9820,11547,21900,0,0,0,1,1
37131,80,9822,11633,21900,0,0,0,1,1
37132,80,9824,12647;17746;17883,21900,0,1,2,0,3
37133,80,9825,12354;17550;17760,21900,0,0,3,0,3
37134,80,9826,12379;12708;17618;17697,21900,0,0,4,0,4
37135,80,9829,12310,21900,0,0,1,0,1
37136,80,9831,12580;13111;17982,21900,0,1,2,0,3
37137,80,9832,13000;17690,21900,0,0,2,0,2
37138,80,9837,13113;13711;17831,21900,0,1,2,0,3
37139,80,9839,13222;13652;17582;17911,21900,0,1,3,0,4
37140,80,9840,13207;13224,21900,0,0,2,0,2
37141,80,9841,13397,21900,0,0,1,0,1
37142,80,9842,12651;13261;17658,21900,0,0,3,0,3
37143,80,9843,13164;13504,21900,0,0,2,0,2
37144,80,9844,13555;13781;18020,21900,0,1,2,0,3
37145,80,9845,13476;17585;18001,21900,0,1,2,0,3
37146,80,9847,13156;13625;17529,21900,0,0,3,0,3
37147,80,9849,13682;14432;17801;18172;18363;19313,21900,0,3,3,0,6
37148,80,9850,13653;13718;17718,21900,0,0,3,0,3
37149,80,9851,13786;14274;19295,21900,0,1,2,0,3
37150,80,9852,13745;14305;17877,21900,0,1,2,0,3
37151,80,9853,13827;14079;17808;18225;19401,21900,1,2,2,0,5
37152,80,9854,13905;13956;18439,21900,0,1,2,0,3
37153,80,9855,14131,21900,0,0,1,0,1
37154,80,9856,13997;14190;18054,21900,0,1,2,0,3
37155,80,9857,14001;14200;18137;18862,21900,0,2,2,0,4
37156,80,9858,13874;14022;18352;18534,21900,0,2,2,0,4
37157,80,9859,14036;14222;17488;17885;18132,21900,0,2,3,0,5
37158,80,9860,13982;19291,21900,0,1,1,0,2
37159,80,9861,14084;14727;18078;18402;18889,21900,0,3,2,0,5
37160,80,9862,14087;14762;19207;19346,21900,1,1,2,0,4
37161,80,9863,14758;17998;18409;19282;19386,21900,1,3,1,0,5
37162,80,9864,13939;14095;17538,21900,0,0,3,0,3
37163,80,9865,14007;14195;17835;18583,21900,0,2,2,0,4
37164,80,9866,14734;14773;19138;19655,21900,1,1,2,0,4
37165,80,9867,14284;15025,21900,0,0,2,0,2
37166,80,9868,14297;14394;17589;17946;18844,21900,0,2,3,0,5
37167,80,9869,14302;14893;17867;18643,21900,0,2,2,0,4
37168,80,9870,14593;14832;18266;18702;19149,21900,0,3,2,0,5
37169,80,9871,15003;18310;19378,21900,1,1,1,0,3
37170,80,9872,14290;14345;17985;19644,21900,1,1,2,0,4
37171,80,9873,14333;14355;18271,21900,0,1,2,0,3
37172,80,9874,14296;14364;17727;18370,21900,0,1,3,0,4
37173,80,9875,13721;13788;17827,21900,0,1,2,0,3
37174,80,9876,14392;14463;18069;18580,21900,0,2,2,0,4
37175,80,9877,14402;14864;18851;19861,21900,1,1,2,0,4
37176,80,9878,14753;17566;18692;19225,21900,0,2,2,0,4
37177,80,9879,13846;14430;19173;19326,21900,1,1,2,0,4
37178,80,9881,14600;14813;18296;19153,21900,0,2,2,0,4
37179,80,9882,14843;17759;18019;18722;19561,21900,1,2,2,0,5
37180,80,9883,14492;14524;18712;19185,21900,0,2,2,0,4
37181,80,9884,14246;14819;17961;18087,21900,0,2,2,0,4
37182,80,9885,14531;15331;17562;18510;19214,21900,0,2,3,0,5
37183,80,9886,14371;14536;19244;19367,21900,1,1,2,0,4
37184,80,9887,14560;14689;18507;18809,21900,0,2,2,0,4
37185,80,9888,14567;14755;17950;18621,21900,0,2,2,0,4
37186,80,9889,15109,21900,0,0,1,0,1
37187,80,9890,14599;14622,21900,0,0,2,0,2
37188,80,9891,14624;15313;18297;18635,21900,0,2,2,0,4
37189,80,9892,13983;14628;17517;18083;19877,21900,1,1,3,0,5
37190,80,9893,14445;14635,21900,0,0,2,0,2
37191,80,9894,14657;14668;17986;18893,21900,0,2,2,0,4
37192,80,9895,14669;15005;18158;18430;18787,21900,0,3,2,0,5
37193,80,9896,14792;15229;19104;19405,21900,1,1,2,0,4
37194,80,9897,14683;14702;17707;18871,21900,0,1,3,0,4
37195,80,9898,14715;15280;17789;18079,21900,0,1,3,0,4
37196,80,9899,14740;15056;18962;19276,21900,0,2,2,0,4
37197,80,9900,14717;14749;18064;18268;18360;18737;18971;19662,21900,1,5,2,0,8
37198,80,9901,14927;15265;17897;18432;19012;19537,21900,1,3,2,0,6
37199,80,9902,14778;15283;18449;18870,21900,0,2,2,0,4
37200,80,9903,15305;17577;17934;18214;19695,21900,1,2,2,0,5
37201,80,9904,14649;14805;17610;18544,21900,0,1,3,0,4
37202,80,9905,10881,22265,0,0,0,1,1
37203,80,9906,10327,22265,0,0,0,1,1
37204,80,9909,10533,22265,0,0,0,1,1
37205,80,9910,10444,22265,0,0,0,1,1
37206,80,9911,10765;10981,22265,0,0,0,2,2
37207,80,9913,11011,22265,0,0,0,1,1
37208,80,9916,11286,22265,0,0,0,1,1
37209,80,9917,11309;11383,22265,0,0,0,2,2
37210,80,9920,11850,22265,0,0,1,0,1
37211,80,9925,12325;12544;17847,22265,0,1,2,0,3
37212,80,9932,13009;13119;17612,22265,0,0,3,0,3
37213,80,9933,13049;18018,22265,0,1,1,0,2
37214,80,9934,13147;13500;17865,22265,0,1,2,0,3
37215,80,9938,13456;14082;17732,22265,0,0,3,0,3
37216,80,9939,13521;13697;17914;18728;18880,22265,0,3,2,0,5
37217,80,9940,14250;14351;18629,22265,0,1,2,0,3
37218,80,9941,13227;13604;17666,22265,0,0,3,0,3
37219,80,9942,13584;13728;17779,22265,0,0,3,0,3
37220,80,9943,13775;13838;17590,22265,0,0,3,0,3
37221,80,9944,13787;14311;19082,22265,0,1,2,0,3
37222,80,9946,13810;13847;17826,22265,0,1,2,0,3
37223,80,9947,13864;13915;18744,22265,0,1,2,0,3
37224,80,9948,14106;14338;18386;19031,22265,0,2,2,0,4
37225,80,9949,13955;14626,22265,0,0,2,0,2
37226,80,9951,13668;13994;19393,22265,1,0,2,0,3
37227,80,9952,14201;18344,22265,0,1,1,0,2
37228,80,9953,13505;14159;17926;18861;19595,22265,1,2,2,0,5
37229,80,9954,14096;14541;17921;18766;19049;19518,22265,1,3,2,0,6
37230,80,9955,14713;19095;19733,22265,1,1,1,0,3
37231,80,9956,14170;18434,22265,0,1,1,0,2
37232,80,9957,14122;14254;17797,22265,0,0,3,0,3
37233,80,9958,14257;14724;17943;19321,22265,1,1,2,0,4
37234,80,9959,14105;14180;18114;19325,22265,1,1,2,0,4
37235,80,9960,14883;14920;18760;19024;19611,22265,1,2,2,0,5
37236,80,9961,14301;15320;19566;19657,22265,2,0,2,0,4
37237,80,9962,14309;14889;17662;18433,22265,0,1,3,0,4
37238,80,9964,14172;14349;17763;19267,22265,0,1,3,0,4
37239,80,9965,14377;14900;17643;18847;19368,22265,1,1,3,0,5
37240,80,9966,14383;14703;18230;18620,22265,0,2,2,0,4
37241,80,9967,14388;17609;18111;18509,22265,0,2,2,0,4
37242,80,9968,14398;14807;18066;18202;19039;19347,22265,1,3,2,0,6
37243,80,9969,14464;17786;17932,22265,0,1,2,0,3
37244,80,9970,14476;14631,22265,0,0,2,0,2
37245,80,9971,14493;15031,22265,0,0,2,0,2
37246,80,9972,14507;15135,22265,0,0,2,0,2
37247,80,9973,14553;19350;19709,22265,2,0,1,0,3
37248,80,9974,14569;14796;17663;17821;18343,22265,0,2,3,0,5
37249,80,9975,14694;14771;17637;17994;18356;18721;18984;19399,22265,1,4,3,0,8
37250,80,9976,14324,22265,0,0,1,0,1
37251,80,9977,14605,22265,0,0,1,0,1
37252,80,9979,14632;15263;18997;19273;19770,22265,1,2,2,0,5
37253,80,9980,14640;18155;19143,22265,0,2,1,0,3
37254,80,9981,14307;14670;17942;18516,22265,0,2,2,0,4
37255,80,9982,14411;14671;17740,22265,0,0,3,0,3
37256,80,9983,15220;15279;18047;18368;19402,22265,1,2,2,0,5
37257,80,9984,14422;14721;17653;18455;18541,22265,0,2,3,0,5
37258,80,9985,14421;14742;17069;19072,22265,0,1,3,0,4
37259,80,9987,14528;14869;18200;19279,22265,0,2,2,0,4
37260,80,9988,14583;14803;18161;18447;19414;19705,22265,2,2,2,0,6
37261,80,9989,15179;15207,22265,0,0,2,0,2
37262,80,9990,15142;15304;19270;19766,22265,1,1,2,0,4
37263,80,9991,14488;14877;19316,22265,1,0,2,0,3
37264,80,9992,14562;14879;18714;19570,22265,1,1,2,0,4
37265,80,9993,14911;18250;18307,22265,0,2,1,0,3
37266,80,9994,14915;15230,22265,0,0,2,0,2
37267,80,9995,14729;15462;17832;18208;19026,22265,0,3,2,0,5
37268,80,9996,14936;14976;17941;18085,22265,0,2,2,0,4
37269,80,9997,14942;15083;17613;17824;18644,22265,0,2,3,0,5
37270,80,9998,14718;14953;18927,22265,0,1,2,0,3
37271,80,9999,14907;14964;18711;19371,22265,1,1,2,0,4
37272,80,10000,14918;14973,22265,0,0,2,0,2
37273,80,10001,14978;14981;17595;18092;18849;19487,22265,1,2,3,0,6
37274,80,10002,15016;15120,22265,0,0,2,0,2
37275,80,10003,15019;15152;17811;18192;18954,22265,0,3,2,0,5
37276,80,10004,545,22630,0,0,0,1,1
37277,80,10006,10620,22630,0,0,0,1,1
37278,80,10011,11104,22630,0,0,0,1,1
37279,80,10014,11021;11332,22630,0,0,0,2,2
37280,80,10015,11306;11388,22630,0,0,0,2,2
37281,80,10019,11229,22630,0,0,0,1,1
37282,80,10026,12250,22630,0,0,1,0,1
37283,80,10031,12441;12774;18030,22630,0,1,2,0,3
37284,80,10033,12595,22630,0,0,1,0,1
37285,80,10037,13072;13285;18163,22630,0,1,2,0,3
37286,80,10038,12783,22630,0,0,1,0,1
37287,80,10039,13069;13102,22630,0,0,2,0,2
37288,80,10040,13177;13646,22630,0,0,2,0,2
37289,80,10041,12513;13166;17893;18109,22630,0,2,2,0,4
37290,80,10043,12910;13239,22630,0,0,2,0,2
37291,80,10044,13385;13524,22630,0,0,2,0,2
37292,80,10046,13639;17939,22630,0,1,1,0,2
37293,80,10047,13623;17869;18150,22630,0,2,1,0,3
37294,80,10048,13357;13480;17787,22630,0,0,3,0,3
37295,80,10049,13794;14174;17730,22630,0,0,3,0,3
37296,80,10050,13568;18350,22630,0,1,1,0,2
37297,80,10051,13651;14060,22630,0,0,2,0,2
37298,80,10052,13271;13574;18392,22630,0,1,2,0,3
37299,80,10053,13671;14348;18395,22630,0,1,2,0,3
37300,80,10054,13857;13922;18550,22630,0,1,2,0,3
37301,80,10055,13834;14589;19233;19530,22630,1,1,2,0,4
37302,80,10056,13898;13985;17815;18380,22630,0,2,2,0,4
37303,80,10061,14559;18093;18164;18679,22630,0,3,1,0,4
37304,80,10062,14156,22630,0,0,1,0,1
37305,80,10063,14712;14839;18444;18642,22630,0,2,2,0,4
37306,80,10064,14209;14590;18180;18604,22630,0,2,2,0,4
37307,80,10065,14244;14367;17945;18174,22630,0,2,2,0,4
37308,80,10066,14249;14306;17871;17955;18396;18477;18521,22630,0,5,2,0,7
37309,80,10068,14255;14491;18907;19307,22630,0,2,2,0,4
37310,80,10069,14293;14577;17957;18332,22630,0,2,2,0,4
37311,80,10071,14342;14554;17777;17933,22630,0,1,3,0,4
37312,80,10072,14356;14374;19658,22630,1,0,2,0,3
37313,80,10073,13879;14393;18424;18640;19144,22630,0,3,2,0,5
37314,80,10074,14400;14780;18293;18912;19137,22630,0,3,2,0,5
37315,80,10076,14452;15055;18053;18545,22630,0,2,2,0,4
37316,80,10077,13885;14455;18566;19259,22630,0,2,2,0,4
37317,80,10078,14433;14502,22630,0,0,2,0,2
37318,80,10079,14148;14437;19067,22630,0,1,2,0,3
37319,80,10081,14489;14610;17958;18138;18883,22630,0,3,2,0,5
37320,80,10082,14419;14597;18812;19148,22630,0,2,2,0,4
37321,80,10083,14607;15112,22630,0,0,2,0,2
37322,80,10084,14621;14884;18405;18830,22630,0,2,2,0,4
37323,80,10085,14299;14623;18709;18975,22630,0,2,2,0,4
37324,80,10086,14656;14837;18586;19721,22630,1,1,2,0,4
37325,80,10087,14684;15123;18034;18314,22630,0,2,2,0,4
37326,80,10088,14775;15136;17748;18800;19116,22630,0,2,3,0,5
37327,80,10089,14783;15475;19496;19685,22630,2,0,2,0,4
37328,80,10090,15261;15601;17793;18159;19134,22630,0,2,3,0,5
37329,80,10091,14736;15225;17778;17860;17952,22630,0,2,3,0,5
37330,80,10092,14566;14854;19154;19808,22630,1,1,2,0,4
37331,80,10093,15449;19046;19080;19241;19624,22630,1,3,1,0,5
37332,80,10094,14921;18661;19055,22630,0,2,1,0,3
37333,80,10095,14919;14958;18032;19129,22630,0,2,2,0,4
37334,80,10096,14687;14990;18116;18503,22630,0,2,2,0,4
37335,80,10097,14992;19339,22630,1,0,1,0,2
37336,80,10098,15297;17714;18055,22630,0,1,2,0,3
37337,80,10099,14770;15413,22630,0,0,2,0,2
37338,80,10100,15007;18616;18829,22630,0,2,1,0,3
37339,80,10101,14426;15023;18329;19023,22630,0,2,2,0,4
37340,80,10102,14897;17742;18630,22630,0,1,2,0,3
37341,80,10103,14759;15032,22630,0,0,2,0,2
37342,80,10104,15034;15239,22630,0,0,2,0,2
37343,80,10105,15064;15469,22630,0,0,2,0,2
37344,80,10106,15075;18676;19592,22630,1,1,1,0,3
37345,80,10107,15081;17890;18029;18459,22630,0,3,1,0,4
37346,80,10108,14672;15085;17931;18425,22630,0,2,2,0,4
37347,80,10109,15093;15245,22630,0,0,2,0,2
37348,80,10110,15111;15114;17823;18603;19112,22630,0,3,2,0,5
37349,80,10111,14107;14935;18576;19420,22630,1,1,2,0,4
37350,80,10112,15161;15388,22630,0,0,2,0,2
37351,80,10113,15162;15273;19038;19257,22630,0,2,2,0,4
37352,80,10114,15170;19299;19457,22630,1,1,1,0,3
37353,80,10115,14642;15176,22630,0,0,2,0,2
37354,80,10116,15187,22630,0,0,1,0,1
37355,80,10117,10460,22995,0,0,0,1,1
37356,80,10119,10544,22995,0,0,0,1,1
37357,80,10120,10548;10702,22995,0,0,0,2,2
37358,80,10121,10611,22995,0,0,0,1,1
37359,80,10122,10886;11060,22995,0,0,0,2,2
37360,80,10125,10549,22995,0,0,0,1,1
37361,80,10126,11056,22995,0,0,0,1,1
37362,80,10127,11047,22995,0,0,0,1,1
37363,80,10128,10846,22995,0,0,0,1,1
37364,80,10130,11156,22995,0,0,0,1,1
37365,80,10131,10704,22995,0,0,0,1,1
37366,80,10132,11031,22995,0,0,0,1,1
37367,80,10133,11254;11268,22995,0,0,0,2,2
37368,80,10134,11258,22995,0,0,0,1,1
37369,80,10135,11289,22995,0,0,0,1,1
37370,80,10137,11472,22995,0,0,0,1,1
37371,80,10145,12613;12707;18207;18403,22995,0,2,2,0,4
37372,80,10148,13108,22995,0,0,1,0,1
37373,80,10150,12817,22995,0,0,1,0,1
37374,80,10158,13338;14233;17980;18837,22995,0,2,2,0,4
37375,80,10159,13351;13779,22995,0,0,2,0,2
37376,80,10160,13416;13820;18657;18853,22995,0,2,2,0,4
37377,80,10162,13592;14136;18009;18325;19010,22995,0,3,2,0,5
37378,80,10163,13061;13345;18239;18684,22995,0,2,2,0,4
37379,80,10164,13689;13988;18294;18748,22995,0,2,2,0,4
37380,80,10165,13558;13873;17923;18772,22995,0,2,2,0,4
37381,80,10167,14024;14428,22995,0,0,2,0,2
37382,80,10168,13691;14031;18456;18848,22995,0,2,2,0,4
37383,80,10169,14040;18345;18592,22995,0,2,1,0,3
37384,80,10170,14370;18548;19184,22995,0,2,1,0,3
37385,80,10172,14163;14221;18119;18211,22995,0,2,2,0,4
37386,80,10173,14173;14176;17928;18511,22995,0,2,2,0,4
37387,80,10175,14020;14384;18044;19091,22995,0,2,2,0,4
37388,80,10176,13743;14248;18391;18600,22995,0,2,2,0,4
37389,80,10177,15400;19372;19474,22995,2,0,1,0,3
37390,80,10178,14674;18824;18944,22995,0,2,1,0,3
37391,80,10179,14300;14538;18131;18195,22995,0,2,2,0,4
37392,80,10180,14310;14629;18776;18919,22995,0,2,2,0,4
37393,80,10181,14357;14744;18318;18974;19827,22995,1,2,2,0,5
37394,80,10182,14887;15252;18499;19588,22995,1,1,2,0,4
37395,80,10183,13822;14467;18594;19000,22995,0,2,2,0,4
37396,80,10184,14474;14515;19630;19882,22995,2,0,2,0,4
37397,80,10185,14480;15061;18622;18790,22995,0,2,2,0,4
37398,80,10186,14498;15578;18815;18969;19363;19555,22995,2,2,2,0,6
37399,80,10187,14281;14505,22995,0,0,2,0,2
37400,80,10188,14520;14991;18181;19099;19444,22995,1,2,2,0,5
37401,80,10189,14545;15029,22995,0,0,2,0,2
37402,80,10190,14360;14579,22995,0,0,2,0,2
37403,80,10191,14482;14591;18413;18740,22995,0,2,2,0,4
37404,80,10192,14648;15041;18639;19110,22995,0,2,2,0,4
37405,80,10193,14604;14667;18031;18354;19195,22995,0,3,2,0,5
37406,80,10194,14693;14722;18496,22995,0,1,2,0,3
37407,80,10195,14037;14706;18366,22995,0,1,2,0,3
37408,80,10196,14808;19106;19526,22995,1,1,1,0,3
37409,80,10197,14686;14863;18134;18701,22995,0,2,2,0,4
37410,80,10198,14873;15199;18320;19329,22995,1,1,2,0,4
37411,80,10199,15551;17806;18299;18691;19125;19591,22995,1,4,1,0,6
37412,80,10200,14881;18052;18854,22995,0,2,1,0,3
37413,80,10201,14894;18203;18816;18970,22995,0,3,1,0,4
37414,80,10202,14910;15221;17908;17992;18264,22995,0,3,2,0,5
37415,80,10203,14925;15151;18834;19389;19468,22995,2,1,2,0,5
37416,80,10204,14929;15290;17918;18357;18675,22995,0,3,2,0,5
37417,80,10205,15108;15430;18379;18508;18794;19324,22995,1,3,2,0,6
37418,80,10206,14692;15002;18037;18198;18717,22995,0,3,2,0,5
37419,80,10207,14947;15011;17991;18286;19260,22995,0,3,2,0,5
37420,80,10208,15040;15595;17917,22995,0,1,2,0,3
37421,80,10209,15050;18757;19042;19499,22995,1,2,1,0,4
37422,80,10210,15066;15196;19357;19670,22995,2,0,2,0,4
37423,80,10211,14966;15492;18799,22995,0,1,2,0,3
37424,80,10212,15024;15560;18039;18287;18420;18735;19330,22995,1,4,2,0,7
37425,80,10213,15127,22995,0,0,1,0,1
37426,80,10214,15166,22995,0,0,1,0,1
37427,80,10215,15195;15255;17870;18504;18680;19558,22995,1,3,2,0,6
37428,80,10216,15202;15524;17819;18588,22995,0,2,2,0,4
37429,80,10217,14834;15209;18279;18882;19258,22995,0,3,2,0,5
37430,80,10218,15241;15625,22995,0,0,2,0,2
37431,80,10219,15256;15636;17967;18358,22995,0,2,2,0,4
37432,80,10221,10744,23360,0,0,0,1,1
37433,80,10223,10777,23360,0,0,0,1,1
37434,80,10226,10695;10852,23360,0,0,0,2,2
37435,80,10232,11648,23360,0,0,0,1,1
37436,80,10236,12346,23360,0,0,1,0,1
37437,80,10239,12948,23360,0,0,1,0,1
37438,80,10245,13437;13648;18412,23360,0,1,2,0,3
37439,80,10246,13466,23360,0,0,1,0,1
37440,80,10247,13536;13935;18749,23360,0,1,2,0,3
37441,80,10248,13903;18157;18382,23360,0,2,1,0,3
37442,80,10249,13860;14219;18414,23360,0,1,2,0,3
37443,80,10250,13805;13884;18035,23360,0,1,2,0,3
37444,80,10251,13780;13917;17966,23360,0,1,2,0,3
37445,80,10252,13875;18328,23360,0,1,1,0,2
37446,80,10253,14892;18589,23360,0,1,1,0,2
37447,80,10254,14210;14275;18568;19266,23360,0,2,2,0,4
37448,80,10255,13817;13991;18167;18453,23360,0,2,2,0,4
37449,80,10256,14279;15212;17287;18863;19165,23360,0,2,3,0,5
37450,80,10257,14283;15059,23360,0,0,2,0,2
37451,80,10258,14135,23360,0,0,1,0,1
37452,80,10259,14403;14714;18828;19361,23360,1,1,2,0,4
37453,80,10260,14323,23360,0,0,1,0,1
37454,80,10262,14504;14636;18103;18339,23360,0,2,2,0,4
37455,80,10263,14133;14518;18130;18273,23360,0,2,2,0,4
37456,80,10264,14558;14939;18822,23360,0,1,2,0,3
37457,80,10265,14643;15204;18669;18999;19096,23360,0,3,2,0,5
37458,80,10266,14508;14781;18224;18315;18797,23360,0,3,2,0,5
37459,80,10267,14795;15380;18867;18924,23360,0,2,2,0,4
37460,80,10268,14487;15223;18183;18482,23360,0,2,2,0,4
37461,80,10269,14815;15394;18007;18377;18671,23360,0,3,2,0,5
37462,80,10270,14820;15217;18934;19223,23360,0,2,2,0,4
37463,80,10271,14874;15067;18804,23360,0,1,2,0,3
37464,80,10272,14234;14882,23360,0,0,2,0,2
37465,80,10273,14895;14933;19568,23360,1,0,2,0,3
37466,80,10274,14576;15206;19493;19750,23360,2,0,2,0,4
37467,80,10275,14634;14951;19587,23360,1,0,2,0,3
37468,80,10276,14972;15439;18939;19089,23360,0,2,2,0,4
37469,80,10277,15045;15516,23360,0,0,2,0,2
37470,80,10278,15052;15193;19020;19248,23360,0,2,2,0,4
37471,80,10279,15062;15819;18154;18686;18915;19421;19775,23360,2,3,2,0,7
37472,80,10281,14912;15094,23360,0,0,2,0,2
37473,80,10283,14824;15113,23360,0,0,2,0,2
37474,80,10284,15150;15197,23360,0,0,2,0,2
37475,80,10285,14814;15589;19298;19417;19790,23360,2,1,2,0,5
37476,80,10286,14836;15191;18196;18463;18555,23360,0,3,2,0,5
37477,80,10287,15535;15827;18041;19034;19196,23360,0,3,2,0,5
37478,80,10288,15210;15849,23360,0,0,2,0,2
37479,80,10289,14682;15047;18218;18419;19471,23360,1,2,2,0,5
37480,80,10290,14659;15227;18289;18465;18713,23360,0,3,2,0,5
37481,80,10291,14347;15260;18672;18789;19088,23360,0,3,2,0,5
37482,80,10292,15310;15419;19212;19403,23360,1,1,2,0,4
37483,80,10293,15809;19215;19621;19867,23360,2,1,1,0,4
37484,80,10294,15316;15334;17927;18411;19018,23360,0,3,2,0,5
37485,80,10295,14865;15348;19762,23360,1,0,2,0,3
37486,80,10296,15322;15474;18565;18678;19432,23360,1,2,2,0,5
37487,80,10297,14987;15363,23360,0,0,2,0,2
37488,80,10298,15091;15592;18135;18242;18526,23360,0,3,2,0,5
37489,80,10299,15710;15855,23360,0,0,2,0,2
37490,80,10300,15667;19311;19344,23360,1,1,1,0,3
37491,80,10302,15440;15712,23360,0,0,2,0,2
37492,80,10303,14861;15441;19521;19726;19781,23360,3,0,2,0,5
37493,80,10304,14666;15447,23360,0,0,2,0,2
37494,80,10305,15457;15818;18369,23360,0,1,2,0,3
37495,80,10306,15325;15467;18696;18840;19373,23360,1,2,2,0,5
37496,80,10309,10997;11134,23725,0,0,0,2,2
37497,80,10314,11351,23725,0,0,0,1,1
37498,80,10318,11921,23725,0,0,1,0,1
37499,80,10319,11566;12102,23725,0,0,1,1,2
37500,80,10320,11753,23725,0,0,1,0,1
37501,80,10322,11884,23725,0,0,1,0,1
37502,80,10325,12869,23725,0,0,1,0,1
37503,80,10327,12868;13167,23725,0,0,2,0,2
37504,80,10331,13190;13282;18796,23725,0,1,2,0,3
37505,80,10333,13376;13765,23725,0,0,2,0,2
37506,80,10336,13288;13567;18258,23725,0,1,2,0,3
37507,80,10339,13486;13675;18249,23725,0,1,2,0,3
37508,80,10340,13753;13992;18186;18646,23725,0,2,2,0,4
37509,80,10344,13911;13977;19100,23725,0,1,2,0,3
37510,80,10346,14049;14407;18378;18673,23725,0,2,2,0,4
37511,80,10348,13692,23725,0,0,1,0,1
37512,80,10350,14236;14373;18095;18898,23725,0,2,2,0,4
37513,80,10352,14321;14754;18206;18769;19098,23725,0,3,2,0,5
37514,80,10353,14431;14757;18080;19454,23725,1,1,2,0,4
37515,80,10354,14499;14833;19392;19443,23725,2,0,2,0,4
37516,80,10355,14481;14511,23725,0,0,2,0,2
37517,80,10356,14519;14609,23725,0,0,2,0,2
37518,80,10357,14075;14550;18408;18554,23725,0,2,2,0,4
37519,80,10358,14023;14574;18441;18865;19620,23725,1,2,2,0,5
37520,80,10359,14650;14739;18136;18490;18990,23725,0,3,2,0,5
37521,80,10360,14129;14691;18650;19115;19736,23725,1,2,2,0,5
37522,80,10361,14461;14738;18532,23725,0,1,2,0,3
37523,80,10362,14756;18176;19293,23725,0,2,1,0,3
37524,80,10363,14472;14810;18084;18842,23725,0,2,2,0,4
37525,80,10364,15022;15830;18887;19107;19351,23725,1,2,2,0,5
37526,80,10365,15424,23725,0,0,1,0,1
37527,80,10366,14111;14858;18460;19033,23725,0,2,2,0,4
37528,80,10367,14447;14868;19354,23725,1,0,2,0,3
37529,80,10368,14871;15487;19179;19456,23725,1,1,2,0,4
37530,80,10369,15097;18086;18417;18894,23725,0,3,1,0,4
37531,80,10370,14817;14913;18491,23725,0,1,2,0,3
37532,80,10371,14924;18615;18698;19590,23725,1,2,1,0,4
37533,80,10372,15200;19113;19315,23725,1,1,1,0,3
37534,80,10373,14568;14948;18618,23725,0,1,2,0,3
37535,80,10375,14582;14750;18835,23725,0,1,2,0,3
37536,80,10376,15010;15205;18658,23725,0,1,2,0,3
37537,80,10377,15027;15159;18089;18540,23725,0,2,2,0,4
37538,80,10378,14741;15036;18217;18715;19253,23725,0,3,2,0,5
37539,80,10379,15044;15048;19504,23725,1,0,2,0,3
37540,80,10380,14968;15213;18821,23725,0,1,2,0,3
37541,80,10381,15049;15233;18090;18262,23725,0,2,2,0,4
37542,80,10382,15057;15464;18479;18531;18755;19006,23725,0,4,2,0,6
37543,80,10383,15038;15088,23725,0,0,2,0,2
37544,80,10384,14961;15098;18280;19268;19718,23725,1,2,2,0,5
37545,80,10385,15106;15429,23725,0,0,2,0,2
37546,80,10386,15137;18497;18687;19136,23725,0,3,1,0,4
37547,80,10387,15107;15138;18533,23725,0,1,2,0,3
37548,80,10389,14587;14806,23725,0,0,2,0,2
37549,80,10390,14998;15489;18263;19317,23725,1,1,2,0,4
37550,80,10391,15309;15398;18573;18791,23725,0,2,2,0,4
37551,80,10392,15311;15593;18758;18902;19508,23725,1,2,2,0,5
37552,80,10393,15181;15332;18707;18841,23725,0,2,2,0,4
37553,80,10394,15342;18850;19126;19200;19794,23725,1,3,1,0,5
37554,80,10395,15308;18338;18637;19627,23725,1,2,1,0,4
37555,80,10396,15766;18261;19191,23725,0,2,1,0,3
37556,80,10397,15881;18977;19572;19755,23725,2,1,1,0,4
37557,80,10398,15385;15695;18120;18284,23725,0,2,2,0,4
37558,80,10399,15390;15763;18690,23725,0,1,2,0,3
37559,80,10400,15391,23725,0,0,1,0,1
37560,80,10401,15402;15839;18290;19427,23725,1,1,2,0,4
37561,80,10402,16007;18245;18581;19622;19722,23725,2,2,1,0,5
37562,80,10403,15101;15425,23725,0,0,2,0,2
37563,80,10404,15432;15858;19064,23725,0,1,2,0,3
37564,80,10405,15192;15453;18986;19114;19381,23725,1,2,2,0,5
37565,80,10406,15184;15466,23725,0,0,2,0,2
37566,80,10407,15456;15848;18734,23725,0,1,2,0,3
37567,80,10408,15164;15478;19564;19789,23725,2,0,2,0,4
37568,80,10409,15483;15749;19203;19409,23725,1,1,2,0,4
37569,80,10410,14931;15500;18302,23725,0,1,2,0,3
37570,80,10411,15501;15941;18153;18995,23725,0,2,2,0,4
37571,80,10412,15504;15675;19607,23725,1,0,2,0,3
37572,80,10413,15507;18560;19044;19446,23725,1,2,1,0,4
37573,80,10414,15396;15582;18664;18926;19501,23725,1,2,2,0,5
37574,80,10415,15528;16031,23725,0,0,2,0,2
37575,80,10416,15543;15904;18619;19171,23725,0,2,2,0,4
37576,80,10417,15547;15990;19668,23725,1,0,2,0,3
37577,80,10418,15082;15550;18819;19412;19857,23725,2,1,2,0,5
37578,80,10419,15431;15556;18957;19802,23725,1,1,2,0,4
37579,80,10420,15564;15568;18285;18762;19065;19479,23725,1,3,2,0,6
37580,80,10421,15286;15597;18171;18313;19057,23725,0,3,2,0,5
37581,80,10422,10811,24090,0,0,0,1,1
37582,80,10423,10644,24090,0,0,0,1,1
37583,80,10426,11049,24090,0,0,0,1,1
37584,80,10427,10775,24090,0,0,0,1,1
37585,80,10430,10979,24090,0,0,0,1,1
37586,80,10432,11399;11435,24090,0,0,0,2,2
37587,80,10433,11433,24090,0,0,0,1,1
37588,80,10440,11939,24090,0,0,1,0,1
37589,80,10442,12342,24090,0,0,1,0,1
37590,80,10446,12306,24090,0,0,1,0,1
37591,80,10448,12840,24090,0,0,1,0,1
37592,80,10449,13058;13452,24090,0,0,2,0,2
37593,80,10450,12826,24090,0,0,1,0,1
37594,80,10452,13764;18973,24090,0,1,1,0,2
37595,80,10453,13352;13886;18381,24090,0,1,2,0,3
37596,80,10457,13541;14213;18613,24090,0,1,2,0,3
37597,80,10458,13399;13727,24090,0,0,2,0,2
37598,80,10462,14494,24090,0,0,1,0,1
37599,80,10463,14450;18220;18486,24090,0,2,1,0,3
37600,80,10467,14641;18248;18875,24090,0,2,1,0,3
37601,80,10468,14829;14840;18247;18624;19035,24090,0,3,2,0,5
37602,80,10469,14286;14746;18288;19646,24090,1,1,2,0,4
37603,80,10470,14304;14794;18606;19085,24090,0,2,2,0,4
37604,80,10471,14664;14665;18330;18585,24090,0,2,2,0,4
37605,80,10474,14512,24090,0,0,1,0,1
37606,80,10475,14526;15117,24090,0,0,2,0,2
37607,80,10476,13970,24090,0,0,1,0,1
37608,80,10478,14777;15420;19712;19887,24090,2,0,2,0,4
37609,80,10479,14916;15132,24090,0,0,2,0,2
37610,80,10480,14999,24090,0,0,1,0,1
37611,80,10481,14851;14855;18946;19425,24090,1,1,2,0,4
37612,80,10482,14391,24090,0,0,1,0,1
37613,80,10483,14903;15087,24090,0,0,2,0,2
37614,80,10484,14956;14967;18839;19729,24090,1,1,2,0,4
37615,80,10485,14970;18978,24090,0,1,1,0,2
37616,80,10486,14675;14997;18779,24090,0,1,2,0,3
37617,80,10488,15406,24090,0,0,1,0,1
37618,80,10489,14818;15014;18423;19213,24090,0,2,2,0,4
37619,80,10490,15070;15542;18656;19008;19707,24090,1,2,2,0,5
37620,80,10491,14811;15043;19208;19442,24090,1,1,2,0,4
37621,80,10492,15510;15892,24090,0,0,2,0,2
37622,80,10493,15246;18859;19111,24090,0,2,1,0,3
37623,80,10494,15129;15555;19337,24090,1,0,2,0,3
37624,80,10495,15131;15375,24090,0,0,2,0,2
37625,80,10496,14993;15134;18685;18967,24090,0,2,2,0,4
37626,80,10497,15141;15786;18985;19848,24090,1,1,2,0,4
37627,80,10498,14982;15172;19166,24090,0,1,2,0,3
37628,80,10500,15294;19127;19320,24090,1,1,1,0,3
37629,80,10501,15222;15367;19795,24090,1,0,2,0,3
37630,80,10502,15248;16050;18410;19332,24090,1,1,2,0,4
37631,80,10503,14901;15250;18917;19281,24090,0,2,2,0,4
37632,80,10504,15275;15872,24090,0,0,2,0,2
37633,80,10505,15754;15844;18562;19862,24090,1,1,2,0,4
37634,80,10506,15300;15696;18785;19118;19880,24090,1,2,2,0,5
37635,80,10507,15811,24090,0,0,1,0,1
37636,80,10508,15326;19398,24090,1,0,1,0,2
37637,80,10509,15249;15338;19362;19648,24090,2,0,2,0,4
37638,80,10510,15054;15339;18813;19059;19447,24090,1,2,2,0,5
37639,80,10511,15288;15361;18928;19384,24090,1,1,2,0,4
37640,80,10512,15755;15902;18364;19063;19713,24090,1,2,2,0,5
37641,80,10513,15421;15869;18520;18654,24090,0,2,2,0,4
37642,80,10514,15257;15426,24090,0,0,2,0,2
37643,80,10515,15427;15650;18641;19576,24090,1,1,2,0,4
37644,80,10516,15008;15437;18252;18326;19629,24090,1,2,2,0,5
37645,80,10517,16103,24090,0,0,1,0,1
37646,80,10518,15350;15444,24090,0,0,2,0,2
37647,80,10519,15496;15622,24090,0,0,2,0,2
37648,80,10520,15506;15831;18406;19650,24090,1,1,2,0,4
37649,80,10521,14962;15530;18178;18611;19333;19567,24090,2,2,2,0,6
37650,80,10522,15581;19218;19531;19812,24090,2,1,1,0,4
37651,80,10523,15012;15583;18929;19264,24090,0,2,2,0,4
37652,80,10524,15307;15598;18655;18798,24090,0,2,2,0,4
37653,80,10525,15262;15613;18569,24090,0,1,2,0,3
37654,80,10526,15615;16024;18561;18980,24090,0,2,2,0,4
37655,80,10527,15671;19873,24090,1,0,1,0,2
37656,80,10528,15635;15655,24090,0,0,2,0,2
37657,80,10529,15647;15822,24090,0,0,2,0,2
37658,80,10530,15649;15891;19470;19884,24090,2,0,2,0,4
37659,80,10531,15660;15835;19300,24090,0,1,2,0,3
37660,80,10532,15562;15926,24090,0,0,2,0,2
37661,80,10533,15680;15741;19103;19573,24090,1,1,2,0,4
37662,80,10534,15540;15689;18191;18542;19498,24090,1,2,2,0,5
37663,80,10535,10691,24455,0,0,0,1,1
37664,80,10536,10950,24455,0,0,0,1,1
37665,80,10538,10927,24455,0,0,0,1,1
37666,80,10540,11449,24455,0,0,0,1,1
37667,80,10541,11230,24455,0,0,0,1,1
37668,80,10544,11670;11767,24455,0,0,1,1,2
37669,80,10548,12290;12844,24455,0,0,2,0,2
37670,80,10559,13342;13750;18535,24455,0,1,2,0,3
37671,80,10562,13529,24455,0,0,1,0,1
37672,80,10565,13248;13798;18401,24455,0,1,2,0,3
37673,80,10568,13859;14034,24455,0,0,2,0,2
37674,80,10570,14654;14699;18388;18525;18695,24455,0,3,2,0,5
37675,80,10572,13998;14185,24455,0,0,2,0,2
37676,80,10573,15282;15678;19383;19569,24455,2,0,2,0,4
37677,80,10575,14847;18652;19239,24455,0,2,1,0,3
37678,80,10577,14423,24455,0,0,1,0,1
37679,80,10578,14475;14564,24455,0,0,2,0,2
37680,80,10579,14490;14639,24455,0,0,2,0,2
37681,80,10580,14273;14644;18899;19255,24455,0,2,2,0,4
37682,80,10581,14690;14764;18705,24455,0,1,2,0,3
37683,80,10582,14732;14890;18609;19204,24455,0,2,2,0,4
37684,80,10583,14711;18788,24455,0,1,1,0,2
37685,80,10584,14841;14844;18786;19507,24455,1,1,2,0,4
37686,80,10585,14662;14791;18753;19073,24455,0,2,2,0,4
37687,80,10586,15215;18454;18751;19653,24455,1,2,1,0,4
37688,80,10589,14940;19261,24455,0,1,1,0,2
37689,80,10590,14231;14752;18421;18579,24455,0,2,2,0,4
37690,80,10591,14983;15355;18674;18940;19292,24455,0,3,2,0,5
37691,80,10592,14294,24455,0,0,1,0,1
37692,80,10595,14866;15030;19377;19469,24455,2,0,2,0,4
37693,80,10596,14946;15096,24455,0,0,2,0,2
37694,80,10597,15037;15569;18814;19407;19768,24455,2,1,2,0,5
37695,80,10600,15103;15149,24455,0,0,2,0,2
37696,80,10601,15169;15251;19139;19235,24455,0,2,2,0,4
37697,80,10602,15146;15148,24455,0,0,2,0,2
37698,80,10603,15168;19535;19737,24455,2,0,1,0,3
37699,80,10604,15171;15360,24455,0,0,2,0,2
37700,80,10605,15174;19007;19145,24455,0,2,1,0,3
37701,80,10606,15228;15677;18628;18767,24455,0,2,2,0,4
37702,80,10607,15742;19081,24455,0,1,1,0,2
37703,80,10608,15296;16035;18494;18718;19176;19571,24455,1,3,2,0,6
37704,80,10609,15302;15854;18874,24455,0,1,2,0,3
37705,80,10610,15086;15523;18385;18855,24455,0,2,2,0,4
37706,80,10612,15374;15937;18909,24455,0,1,2,0,3
37707,80,10613,15386,24455,0,0,1,0,1
37708,80,10614,15442;18719;18827;19853,24455,1,2,1,0,4
37709,80,10615,14772;15454;18993;19348,24455,1,1,2,0,4
37710,80,10616,15494;15912,24455,0,0,2,0,2
37711,80,10617,15497;15505;18781;19043;19132,24455,0,3,2,0,5
37712,80,10618,16063;16152;18892;19037;19554,24455,1,2,2,0,5
37713,80,10619,15387;15468,24455,0,0,2,0,2
37714,80,10620,15544;15594;18383;18807;19175,24455,0,3,2,0,5
37715,80,10622,15565;15669;19029,24455,0,1,2,0,3
37716,80,10623,15584;15808;19290,24455,0,1,2,0,3
37717,80,10624,15895;18537;19162,24455,0,2,1,0,3
37718,80,10625,15927;19485;19793,24455,2,0,1,0,3
37719,80,10626,15642,24455,0,0,1,0,1
37720,80,10627,16182;18306;18462;19135,24455,0,3,1,0,4
37721,80,10628,15681,24455,0,0,1,0,1
37722,80,10629,15700;16047;18506;18716,24455,0,2,2,0,4
37723,80,10630,15495;15703;18349;18443,24455,0,2,2,0,4
37724,80,10631,15711,24455,0,0,1,0,1
37725,80,10632,15272;15714;18374;18559,24455,0,2,2,0,4
37726,80,10633,15721;15874;19147,24455,0,1,2,0,3
37727,80,10634,15729;15736;18596;18741,24455,0,2,2,0,4
37728,80,10635,15738;15868,24455,0,0,2,0,2
37729,80,10636,16275;18473;18795;19438,24455,1,2,1,0,4
37730,80,10637,16011;16330;19612,24455,1,0,2,0,3
37731,80,10638,15346;15770;18467,24455,0,1,2,0,3
37732,80,10639,15267;15772;18888;19674,24455,1,1,2,0,4
37733,80,10640,15789;16273;18316;18667;18857;19097,24455,0,4,2,0,6
37734,80,10641,15798;15964,24455,0,0,2,0,2
37735,80,10642,15521;15826,24455,0,0,2,0,2
37736,80,10643,15837;16049;19090,24455,0,1,2,0,3
37737,80,10644,15860;16173;18577;19061;19704,24455,1,2,2,0,5
37738,80,10645,15866;16243,24455,0,0,2,0,2
37739,80,10646,15688;15882,24455,0,0,2,0,2
37740,80,10647,15691;19495,24455,1,0,1,0,2
37741,80,10648,10684,24820,0,0,0,1,1
37742,80,10649,11214,24820,0,0,0,1,1
37743,80,10654,11331,24820,0,0,0,1,1
37744,80,10655,11746;11840,24820,0,0,2,0,2
37745,80,10658,11911,24820,0,0,1,0,1
37746,80,10664,12157,24820,0,0,1,0,1
37747,80,10666,11950;12343,24820,0,0,2,0,2
37748,80,10671,12945;13367,24820,0,0,2,0,2
37749,80,10673,13187;13645;18846,24820,0,1,2,0,3
37750,80,10674,13509,24820,0,0,1,0,1
37751,80,10675,13678,24820,0,0,1,0,1
37752,80,10676,13559;13941;19832,24820,1,0,2,0,3
37753,80,10677,13473,24820,0,0,1,0,1
37754,80,10683,14444;19365,24820,1,0,1,0,2
37755,80,10684,14358;19186,24820,0,1,1,0,2
37756,80,10687,14240,24820,0,0,1,0,1
37757,80,10689,14260;14344;18764;18935,24820,0,2,2,0,4
37758,80,10690,14401;14812;19232,24820,0,1,2,0,3
37759,80,10691,14381;14917;19001;19379,24820,1,1,2,0,4
37760,80,10695,14331;15006;19331,24820,1,0,2,0,3
37761,80,10696,14586;15021,24820,0,0,2,0,2
37762,80,10697,14160;14737;18450;18905,24820,0,2,2,0,4
37763,80,10699,14701;14760;18512;19084;19633,24820,1,2,2,0,5
37764,80,10700,14878;19355,24820,1,0,1,0,2
37765,80,10701,14923,24820,0,0,1,0,1
37766,80,10702,14971;15511;19123,24820,0,1,2,0,3
37767,80,10703,14977,24820,0,0,1,0,1
37768,80,10704,15218;15423;18866;19335,24820,1,1,2,0,4
37769,80,10705,15018;15298;19032;19155,24820,0,2,2,0,4
37770,80,10706,14989;15084,24820,0,0,2,0,2
37771,80,10707,14975;15580;18983;19093;19529,24820,1,2,2,0,5
37772,80,10708,15144;15368;19559,24820,1,0,2,0,3
37773,80,10709,15238;15484;19209,24820,0,1,2,0,3
37774,80,10710,15414;18578;18826;19130,24820,0,3,1,0,4
37775,80,10711,15676;19524;19730,24820,2,0,1,0,3
37776,80,10712,15289;15612;18666;19553,24820,1,1,2,0,4
37777,80,10713,15293;16312;18968,24820,0,1,2,0,3
37778,80,10714,15072;15314;18543;19036;19094,24820,0,3,2,0,5
37779,80,10715,15486;16044,24820,0,0,2,0,2
37780,80,10716,15328;15645;19109;19424,24820,1,1,2,0,4
37781,80,10717,14827;15433,24820,0,0,2,0,2
37782,80,10718,15175;15336;19338,24820,1,0,2,0,3
37783,80,10720,15377;15476;18972;19296;19871,24820,1,2,2,0,5
37784,80,10721,15661;18908;19087,24820,0,2,1,0,3
37785,80,10722,15102;15269;18987;19183,24820,0,2,2,0,4
37786,80,10723,15422;19151;19364,24820,1,1,1,0,3
37787,80,10724,15435;19016;19283,24820,0,2,1,0,3
37788,80,10725,15436;15533;19174;19527;19608,24820,2,1,2,0,5
37789,80,10726,15810;19060,24820,0,1,1,0,2
37790,80,10727,15060;15527;19056;19820,24820,1,1,2,0,4
37791,80,10729,15090,24820,0,0,1,0,1
37792,80,10730,15438;15450;18878;18959;19345,24820,1,2,2,0,5
37793,80,10731,15566;15951,24820,0,0,2,0,2
37794,80,10732,15033;18731;19221,24820,0,2,1,0,3
37795,80,10733,14867;15587;18704,24820,0,1,2,0,3
37796,80,10734,15750;15920;18991;19395,24820,1,1,2,0,4
37797,80,10735,14872;15637;19251;19889,24820,1,1,2,0,4
37798,80,10737,15658;16450;18653;19177,24820,0,2,2,0,4
37799,80,10738,15664,24820,0,0,1,0,1
37800,80,10739,15670;16027,24820,0,0,2,0,2
37801,80,10740,15685;15896,24820,0,0,2,0,2
37802,80,10741,15351;15726;18730;19563,24820,1,1,2,0,4
37803,80,10742,15771;15794,24820,0,0,2,0,2
37804,80,10743,15800;16362;18481;19121,24820,0,2,2,0,4
37805,80,10744,16101;16186;19638;19839,24820,2,0,2,0,4
37806,80,10745,15488;16347,24820,0,0,2,0,2
37807,80,10746,15908;16668,24820,0,0,2,0,2
37808,80,10747,15567;15917;18557;19436,24820,1,1,2,0,4
37809,80,10748,15652;15922;19878,24820,1,0,2,0,3
37810,80,10749,15299;16217;18567;19068,24820,0,2,2,0,4
37811,80,10750,15952;16300;19011,24820,0,1,2,0,3
37812,80,10751,15968;16299;18474;19227;19370,24820,1,2,2,0,5
37813,80,10752,15942;15982;19635,24820,1,0,2,0,3
37814,80,10753,15787;15989;19240,24820,0,1,2,0,3
37815,80,10754,16018;16189;18662;18994,24820,0,2,2,0,4
37816,80,10755,10720,25185,0,0,0,1,1
37817,80,10759,11201,25185,0,0,0,1,1
37818,80,10760,11027,25185,0,0,0,1,1
37819,80,10761,10941,25185,0,0,0,1,1
37820,80,10763,11501,25185,0,0,0,1,1
37821,80,10764,11819,25185,0,0,1,0,1
37822,80,10765,11907,25185,0,0,1,0,1
37823,80,10770,12664;13132,25185,0,0,2,0,2
37824,80,10771,12429,25185,0,0,1,0,1
37825,80,10783,13312;13586;18563,25185,0,1,2,0,3
37826,80,10784,13380;13968;18960,25185,0,1,2,0,3
37827,80,10785,13389;13976;18881;19102,25185,0,2,2,0,4
37828,80,10788,13443,25185,0,0,1,0,1
37829,80,10789,13445,25185,0,0,1,0,1
37830,80,10793,13557;13848;18808;19077,25185,0,2,2,0,4
37831,80,10794,14015,25185,0,0,1,0,1
37832,80,10795,14420;14885;19437,25185,1,0,2,0,3
37833,80,10796,14127;14410;19234,25185,0,1,2,0,3
37834,80,10800,14385;15412,25185,0,0,2,0,2
37835,80,10801,13815;14019,25185,0,0,2,0,2
37836,80,10802,14680;15319;18891;18953,25185,0,2,2,0,4
37837,80,10804,14696;14710;18752;19117,25185,0,2,2,0,4
37838,80,10806,14941;15281;19472,25185,1,0,2,0,3
37839,80,10807,14974;15118,25185,0,0,2,0,2
37840,80,10808,15026;16169,25185,0,0,2,0,2
37841,80,10809,15035;15534;18729,25185,0,1,2,0,3
37842,80,10810,15105;15110;19542;19625,25185,2,0,2,0,4
37843,80,10811,15076;15124,25185,0,0,2,0,2
37844,80,10812,15208;15226,25185,0,0,2,0,2
37845,80,10813,15236;15722,25185,0,0,2,0,2
37846,80,10814,15253;15767;19805,25185,1,0,2,0,3
37847,80,10815,15274;15638;18833,25185,0,1,2,0,3
37848,80,10816,15053;15278;19723,25185,1,0,2,0,3
37849,80,10817,15378;15824;18825;19069,25185,0,2,2,0,4
37850,80,10818,15219;15405;19543,25185,1,0,2,0,3
37851,80,10819,15411;16130;18856;19161;19565;19616,25185,2,2,2,0,6
37852,80,10820,15558;15617,25185,0,0,2,0,2
37853,80,10821,15143,25185,0,0,1,0,1
37854,80,10822,15549;16160;19714,25185,1,0,2,0,3
37855,80,10823,15461;15552,25185,0,0,2,0,2
37856,80,10824,15575;16176;19396;19466,25185,2,0,2,0,4
37857,80,10825,15626;15863;19778,25185,1,0,2,0,3
37858,80,10826,15916;16141;18943;19597,25185,1,1,2,0,4
37859,80,10827,15359;15610;18683;19180,25185,0,2,2,0,4
37860,80,10828,15616,25185,0,0,1,0,1
37861,80,10829,15463,25185,0,0,1,0,1
37862,80,10830,15623;15624;19327,25185,1,0,2,0,3
37863,80,10831,15634;19551;19584,25185,2,0,1,0,3
37864,80,10832,15641;15682;19580,25185,1,0,2,0,3
37865,80,10833,15662;16252;18727;19760,25185,1,1,2,0,4
37866,80,10834,15665;15834,25185,0,0,2,0,2
37867,80,10835,15687;16119;19692,25185,1,0,2,0,3
37868,80,10836,15706;16304;19490;19687,25185,2,0,2,0,4
37869,80,10837,15666;15718,25185,0,0,2,0,2
37870,80,10838,15816;16341,25185,0,0,2,0,2
37871,80,10839,16043;16327,25185,0,0,2,0,2
37872,80,10840,15557;15579;18668;18961,25185,0,2,2,0,4
37873,80,10841,15864;16329;19222,25185,0,1,2,0,3
37874,80,10842,15886;16296,25185,0,0,2,0,2
37875,80,10843,15888;16334;18876,25185,0,1,2,0,3
37876,80,10844,16265;18538;19426,25185,1,1,1,0,3
37877,80,10845,15633;15915;18575,25185,0,1,2,0,3
37878,80,10846,15928;15981,25185,0,0,2,0,2
37879,80,10847,15640;15944,25185,0,0,2,0,2
37880,80,10848,15746;15947;19297;19640,25185,1,1,2,0,4
37881,80,10849,16360;16749;18733;18933,25185,0,2,2,0,4
37882,80,10850,16083,25185,0,0,1,0,1
37883,80,10851,15972;16128;19404;19855,25185,2,0,2,0,4
37884,80,10852,16010;16578;18895;19182;19711,25185,1,2,2,0,5
37885,80,10853,16051;16379;19751,25185,1,0,2,0,3
37886,80,10854,16054;16058,25185,0,0,2,0,2
37887,80,10855,16057;16358;19141;19461,25185,1,1,2,0,4
37888,80,10856,15515;16059;19667,25185,1,0,2,0,3
37889,80,10857,16066;16315;19631,25185,1,0,2,0,3
37890,80,10858,16095;16154;19449,25185,1,0,2,0,3
37891,80,10859,16116;16375;18768;19475,25185,1,1,2,0,4
37892,80,10860,16117;19702;19829,25185,2,0,1,0,3
37893,80,10861,16108;16122;19739,25185,1,0,2,0,3
37894,80,10862,16124;16551;18623;18923,25185,0,2,2,0,4
37895,80,10863,16126;16233;18778;18901;19452,25185,1,2,2,0,5
37896,80,10864,16138;19341,25185,1,0,1,0,2
37897,80,10865,16151;16262,25185,0,0,2,0,2
37898,80,10866,15761;18948,25185,0,1,1,0,2
37899,80,10867,15769;16190,25185,0,0,2,0,2
37900,80,10868,11227,25550,0,0,0,1,1
37901,80,10870,11269,25550,0,0,0,1,1
37902,80,10871,11363,25550,0,0,0,1,1
37903,80,10872,11608,25550,0,0,0,1,1
37904,80,10875,11455,25550,0,0,0,1,1
37905,80,10876,11919,25550,0,0,1,0,1
37906,80,10882,11942,25550,0,0,1,0,1
37907,80,10884,12535,25550,0,0,1,0,1
37908,80,10888,12965;12997,25550,0,0,2,0,2
37909,80,10892,13446,25550,0,0,1,0,1
37910,80,10895,13535;13681,25550,0,0,2,0,2
37911,80,10898,13279,25550,0,0,1,0,1
37912,80,10900,13259;13626,25550,0,0,2,0,2
37913,80,10901,14055,25550,0,0,1,0,1
37914,80,10902,13475;13549,25550,0,0,2,0,2
37915,80,10903,14856;14904;18773;19224,25550,0,2,2,0,4
37916,80,10905,13865,25550,0,0,1,0,1
37917,80,10906,13683;14501,25550,0,0,2,0,2
37918,80,10907,14469;14785;19157;19613,25550,1,1,2,0,4
37919,80,10909,14527;14888,25550,0,0,2,0,2
37920,80,10911,14552;14902,25550,0,0,2,0,2
37921,80,10912,14483;14619,25550,0,0,2,0,2
37922,80,10914,14457,25550,0,0,1,0,1
37923,80,10915,14094,25550,0,0,1,0,1
37924,80,10916,14700;14825;19120,25550,0,1,2,0,3
37925,80,10917,14697;14905;19458,25550,1,0,2,0,3
37926,80,10918,15156;15180;19856,25550,1,0,2,0,3
37927,80,10921,15063;18761;19777,25550,1,1,1,0,3
37928,80,10922,15104;15160;19193;19522,25550,1,1,2,0,4
37929,80,10923,15145;15201;19380;19439,25550,2,0,2,0,4
37930,80,10924,15216;15303;19312;19511;19858,25550,2,1,2,0,5
37931,80,10925,15991;16284;19058,25550,0,1,2,0,3
37932,80,10927,15321;15728,25550,0,0,2,0,2
37933,80,10928,15347;15731;19596,25550,1,0,2,0,3
37934,80,10929,14766;15354;19477;19645,25550,2,0,2,0,4
37935,80,10930,15410;15940,25550,0,0,2,0,2
37936,80,10931,15335,25550,0,0,1,0,1
37937,80,10932,15537;19601;19818,25550,2,0,1,0,3
37938,80,10933,15073;15807;19422;19586,25550,2,0,2,0,4
37939,80,10934,15526;15853;19206;19661,25550,1,1,2,0,4
37940,80,10935,15585;15608,25550,0,0,2,0,2
37941,80,10936,15287;15648;19027;19465,25550,1,1,2,0,4
37942,80,10937,15069;15651;19847,25550,1,0,2,0,3
37943,80,10938,15674;15962;18805;18950,25550,0,2,2,0,4
37944,80,10939,15897;19342,25550,1,0,1,0,2
37945,80,10940,15720;16147;19581,25550,1,0,2,0,3
37946,80,10941,15748;15986;18810;18942,25550,0,2,2,0,4
37947,80,10942,15292,25550,0,0,1,0,1
37948,80,10943,15365;15765;19772,25550,1,0,2,0,3
37949,80,10944,15679;15775;19025,25550,0,1,2,0,3
37950,80,10945,15532;15784,25550,0,0,2,0,2
37951,80,10946,15258;15801;18836;18992;19246,25550,0,3,2,0,5
37952,80,10947,15823;16185;19197;19544;19735,25550,2,1,2,0,5
37953,80,10948,15838;16132;19170,25550,0,1,2,0,3
37954,80,10949,15889;16618;19054;19236,25550,0,2,2,0,4
37955,80,10950,15894;16125;19256;19803,25550,1,1,2,0,4
37956,80,10951,15330;15596;19819,25550,1,0,2,0,3
37957,80,10952,15929;15950,25550,0,0,2,0,2
37958,80,10953,15971;16628,25550,0,0,2,0,2
37959,80,10954,15785;15975,25550,0,0,2,0,2
37960,80,10955,15984;16180;19643,25550,1,0,2,0,3
37961,80,10956,15978;16000;19538;19881,25550,2,0,2,0,4
37962,80,10957,15632;16001;18746;19070;19800,25550,1,2,2,0,5
37963,80,10958,16002;16417;19864,25550,1,0,2,0,3
37964,80,10959,16060;19552,25550,1,0,1,0,2
37965,80,10960,16064;16097;19494;19579,25550,2,0,2,0,4
37966,80,10961,16344;19868,25550,1,0,1,0,2
37967,80,10962,15571;16121,25550,0,0,2,0,2
37968,80,10963,16131;16489;18763;19003,25550,0,2,2,0,4
37969,80,10964,16085;16170;18820;19105;19825,25550,1,2,2,0,5
37970,80,10965,16201;16644;19776,25550,1,0,2,0,3
37971,80,10966,16602;19473,25550,1,0,1,0,2
37972,80,10967,16207;16402,25550,0,0,2,0,2
37973,80,10968,16065;16218;18937,25550,0,1,2,0,3
37974,80,10969,16222;16716;19626,25550,1,0,2,0,3
37975,80,10970,15924;16246;18663,25550,0,1,2,0,3
37976,80,10971,16144;16253;18670,25550,0,1,2,0,3
37977,80,10972,16264;18699;19710,25550,1,1,1,0,3
37978,80,10973,16271;16645;19483,25550,1,0,2,0,3
37979,80,10974,16229;16279;19791,25550,1,0,2,0,3
37980,80,10975,16015;16324;18742;19041;19481,25550,1,2,2,0,5
37981,80,10976,15698;16326,25550,0,0,2,0,2
37982,80,10978,10918,25915,0,0,0,1,1
37983,80,10979,11493,25915,0,0,0,1,1
37984,80,10980,11327;11544,25915,0,0,0,2,2
37985,80,10981,11678,25915,0,0,0,1,1
37986,80,10986,12100,25915,0,0,1,0,1
37987,80,10987,12211,25915,0,0,1,0,1
37988,80,10994,12334,25915,0,0,1,0,1
37989,80,10995,12662;13149,25915,0,0,2,0,2
37990,80,11001,12594,25915,0,0,1,0,1
37991,80,11002,13213;13608,25915,0,0,2,0,2
37992,80,11003,12989,25915,0,0,1,0,1
37993,80,11004,12782,25915,0,0,1,0,1
37994,80,11006,13326,25915,0,0,1,0,1
37995,80,11008,13583;14025,25915,0,0,2,0,2
37996,80,11009,13365,25915,0,0,1,0,1
37997,80,11011,13824,25915,0,0,1,0,1
37998,80,11012,13853,25915,0,0,1,0,1
37999,80,11014,14053,25915,0,0,1,0,1
38000,80,11015,13503,25915,0,0,1,0,1
38001,80,11016,13993;14601,25915,0,0,2,0,2
38002,80,11018,14835;14945;19122,25915,0,1,2,0,3
38003,80,11019,13942,25915,0,0,1,0,1
38004,80,11020,13818;14386;19030,25915,0,1,2,0,3
38005,80,11021,14416,25915,0,0,1,0,1
38006,80,11024,14396;14570,25915,0,0,2,0,2
38007,80,11029,14799;15602,25915,0,0,2,0,2
38008,80,11030,14802;15121;19672;19748,25915,2,0,2,0,4
38009,80,11031,14831;14979;19219,25915,0,1,2,0,3
38010,80,11032,14708;14846;18896;18958,25915,0,2,2,0,4
38011,80,11033,14876;15693;19285;19663;19837,25915,2,1,2,0,5
38012,80,11034,14226,25915,0,0,1,0,1
38013,80,11036,14603;14745,25915,0,0,2,0,2
38014,80,11037,14776;14932;19014,25915,0,1,2,0,3
38015,80,11038,14937,25915,0,0,1,0,1
38016,80,11039,15182;15183,25915,0,0,2,0,2
38017,80,11040,15186,25915,0,0,1,0,1
38018,80,11041,15862;19850,25915,1,0,1,0,2
38019,80,11042,15548;15690;19675,25915,1,0,2,0,3
38020,80,11043,15465;15628,25915,0,0,2,0,2
38021,80,11044,16225;16232;19807,25915,1,0,2,0,3
38022,80,11045,15619;15732;19019;19167;19844,25915,1,2,2,0,5
38023,80,11046,15498;15739,25915,0,0,2,0,2
38024,80,11047,15744;15885;18897;19128,25915,0,2,2,0,4
38025,80,11048,15825;16468,25915,0,0,2,0,2
38026,80,11049,15577;15833;19169;19303;19532,25915,1,2,2,0,5
38027,80,11050,15295;15865;18884;18949;19577,25915,1,2,2,0,5
38028,80,11051,15867;15883;18952;19400,25915,1,1,2,0,4
38029,80,11052,15324;15875,25915,0,0,2,0,2
38030,80,11053,15876,25915,0,0,1,0,1
38031,80,11054,15907;15925;19280,25915,0,1,2,0,3
38032,80,11055,15910;16240;19408,25915,1,0,2,0,3
38033,80,11056,15911;16209;19746,25915,1,0,2,0,3
38034,80,11057,15959;16452,25915,0,0,2,0,2
38035,80,11058,15973;16428;19512;19727,25915,2,0,2,0,4
38036,80,11059,16106;16318;19284,25915,0,1,2,0,3
38037,80,11060,15376;16036;19278,25915,0,1,2,0,3
38038,80,11061,16037;16055;19433;19618,25915,2,0,2,0,4
38039,80,11062,16089;16411,25915,0,0,2,0,2
38040,80,11063,15768;16091,25915,0,0,2,0,2
38041,80,11064,16092;16107;19418;19769,25915,2,0,2,0,4
38042,80,11065,15291;16098,25915,0,0,2,0,2
38043,80,11066,16418,25915,0,0,1,0,1
38044,80,11067,16023;16118,25915,0,0,2,0,2
38045,80,11068,16137;16238;18872,25915,0,1,2,0,3
38046,80,11069,16149;16599;19217;19478,25915,1,1,2,0,4
38047,80,11070,16123;16172;19181,25915,0,1,2,0,3
38048,80,11072,16197;16601;18838;19448,25915,1,1,2,0,4
38049,80,11073,15701;16208,25915,0,0,2,0,2
38050,80,11074,16235;16412,25915,0,0,2,0,2
38051,80,11075,16650;18864;19199,25915,0,2,1,0,3
38052,80,11076,16861,25915,0,0,1,0,1
38053,80,11077,15762;16282,25915,0,0,2,0,2
38054,80,11078,16319;16687;19053;19187,25915,0,2,2,0,4
38055,80,11079,16251;16291;19188;19609,25915,1,1,2,0,4
38056,80,11080,16174;16333;19390;19828,25915,2,0,2,0,4
38057,80,11081,16338;16610,25915,0,0,2,0,2
38058,80,11082,16087;16586,25915,0,0,2,0,2
38059,80,11083,16317;16346;19860,25915,1,0,2,0,3
38060,80,11084,16348;16787,25915,0,0,2,0,2
38061,80,11085,16381;16544;19156;19238,25915,0,2,2,0,4
38062,80,11086,16392;16778;19366,25915,1,0,2,0,3
38063,80,11087,16404;16822;19005;19071;19484,25915,1,2,2,0,5
38064,80,11088,16353;16461,25915,0,0,2,0,2
38065,80,11089,15590;16471,25915,0,0,2,0,2
38066,80,11090,16368;16472;19133;19517,25915,1,1,2,0,4
38067,80,11091,11318;11766,26280,0,0,1,1,2
38068,80,11092,11473,26280,0,0,0,1,1
38069,80,11094,11519;11765,26280,0,0,1,1,2
38070,80,11095,11330,26280,0,0,0,1,1
38071,80,11097,11726,26280,0,0,1,0,1
38072,80,11098,11656,26280,0,0,0,1,1
38073,80,11103,11888,26280,0,0,1,0,1
38074,80,11105,11578,26280,0,0,0,1,1
38075,80,11110,12612,26280,0,0,1,0,1
38076,80,11113,12736,26280,0,0,1,0,1
38077,80,11114,12568,26280,0,0,1,0,1
38078,80,11120,12464;12692,26280,0,0,2,0,2
38079,80,11125,13565;13802,26280,0,0,2,0,2
38080,80,11127,13560,26280,0,0,1,0,1
38081,80,11130,14116;14613,26280,0,0,2,0,2
38082,80,11136,14295,26280,0,0,1,0,1
38083,80,11137,14575,26280,0,0,1,0,1
38084,80,11138,13302,26280,0,0,1,0,1
38085,80,11139,14379;14663;18921;19423,26280,1,1,2,0,4
38086,80,11140,14456,26280,0,0,1,0,1
38087,80,11141,14557;14995,26280,0,0,2,0,2
38088,80,11142,15268;15473;18956;19198;19641,26280,1,2,2,0,5
38089,80,11143,14748;15244;19349;19617,26280,2,0,2,0,4
38090,80,11144,14580,26280,0,0,1,0,1
38091,80,11145,14784;15173,26280,0,0,2,0,2
38092,80,11148,14891,26280,0,0,1,0,1
38093,80,11149,14013,26280,0,0,1,0,1
38094,80,11150,14954;14985,26280,0,0,2,0,2
38095,80,11151,14513;14960,26280,0,0,2,0,2
38096,80,11152,15539;15832;19782,26280,1,0,2,0,3
38097,80,11153,15077;19163;19411,26280,1,1,1,0,3
38098,80,11154,15078;15364;19716;19810,26280,2,0,2,0,4
38099,80,11157,14826;15165,26280,0,0,2,0,2
38100,80,11158,14695;15185;19226,26280,0,1,2,0,3
38101,80,11159,15194;19582;19831,26280,2,0,1,0,3
38102,80,11162,15315;15943,26280,0,0,2,0,2
38103,80,11163,14870;15353,26280,0,0,2,0,2
38104,80,11164,15383;15546,26280,0,0,2,0,2
38105,80,11165,15381,26280,0,0,1,0,1
38106,80,11166,15392;15890,26280,0,0,2,0,2
38107,80,11167,15630;19265;19834,26280,1,1,1,0,3
38108,80,11168,15399;15471;19269;19455,26280,1,1,2,0,4
38109,80,11169,15479;15643;18981;19242,26280,0,2,2,0,4
38110,80,11170,15508,26280,0,0,1,0,1
38111,80,11171,15499;15514,26280,0,0,2,0,2
38112,80,11172,15573;16187,26280,0,0,2,0,2
38113,80,11173,15490;15588;19075;19491,26280,1,1,2,0,4
38114,80,11174,16753,26280,0,0,1,0,1
38115,80,11176,15686;16337;19642,26280,1,0,2,0,3
38116,80,11177,15358;15705;19131;19814,26280,1,1,2,0,4
38117,80,11178,15709;16439;19152;19519,26280,1,1,2,0,4
38118,80,11179,15719;16168;19520,26280,1,0,2,0,3
38119,80,11180,16030;16323,26280,0,0,2,0,2
38120,80,11181,15776;15781;19164;19352,26280,1,1,2,0,4
38121,80,11182,15799;16589;19536,26280,1,0,2,0,3
38122,80,11183,15802;16288;19605,26280,1,0,2,0,3
38123,80,11184,15847;15936,26280,0,0,2,0,2
38124,80,11185,15472,26280,0,0,1,0,1
38125,80,11186,15089;15880;18982;19604,26280,1,1,2,0,4
38126,80,11187,15901;16547;18989;19302,26280,0,2,2,0,4
38127,80,11188,15906;16211;19050;19514;19822,26280,2,1,2,0,5
38128,80,11189,15673;15918;19304;19598,26280,1,1,2,0,4
38129,80,11190,15668;15930;19463,26280,1,0,2,0,3
38130,80,11191,15921;15932;19500;19599,26280,2,0,2,0,4
38131,80,11192,15804;15939;19150,26280,0,1,2,0,3
38132,80,11193,15988;16192,26280,0,0,2,0,2
38133,80,11194,15814;15992,26280,0,0,2,0,2
38134,80,11195,15485;15994,26280,0,0,2,0,2
38135,80,11196,15525;16017,26280,0,0,2,0,2
38136,80,11197,15993;16028;19247;19728,26280,1,1,2,0,4
38137,80,11199,16046;16220;19691,26280,1,0,2,0,3
38138,80,11200,16069;16464,26280,0,0,2,0,2
38139,80,11201,16078;16407;19310;19505,26280,1,1,2,0,4
38140,80,11202,16093;16383;19441;19666,26280,2,0,2,0,4
38141,80,11203,16045;16135;19142;19606,26280,1,1,2,0,4
38142,80,11204,16096;16512,26280,0,0,2,0,2
38143,80,11205,16100;16389;19306;19322,26280,1,1,2,0,4
38144,80,11206,15605;16110,26280,0,0,2,0,2
38145,80,11207,16094;16572;19603,26280,1,0,2,0,3
38146,80,11208,15851;16136;19194;19557;19885,26280,2,1,2,0,5
38147,80,11209,16145,26280,0,0,1,0,1
38148,80,11210,16159;16490,26280,0,0,2,0,2
38149,80,11211,16171;16425;19462;19720,26280,2,0,2,0,4
38150,80,11212,15631;16193,26280,0,0,2,0,2
38151,80,11213,16177;16221,26280,0,0,2,0,2
38152,80,11215,16274;16493;19245;19356;19600,26280,2,1,2,0,5
38153,80,11216,15627;16276;19382;19689,26280,2,0,2,0,4
38154,80,11217,15898;16280,26280,0,0,2,0,2
38155,80,11218,15277;15663,26280,0,0,2,0,2
38156,80,11219,16575,26280,0,0,1,0,1
38157,80,11220,16833;19460,26280,1,0,1,0,2
38158,80,11221,16303;16841;18920;19649;19754,26280,2,1,2,0,5
38159,80,11222,16331;16856,26280,0,0,2,0,2
38160,80,11223,16336;16671;19659,26280,1,0,2,0,3
38161,80,11224,15857;16385,26280,0,0,2,0,2
38162,80,11225,16086;16361,26280,0,0,2,0,2
38163,80,11226,16542,26280,0,0,1,0,1
38164,80,11227,16373;16514,26280,0,0,2,0,2
38165,80,11228,16335;16377,26280,0,0,2,0,2
38166,80,11229,16399;16426,26280,0,0,2,0,2
38167,80,11230,16416;16670;19388;19549,26280,2,0,2,0,4
38168,80,11231,16419;17000;19158;19654,26280,1,1,2,0,4
38169,80,11232,16453,26280,0,0,1,0,1
38170,80,11233,16467;16802,26280,0,0,2,0,2
38171,80,11234,16370;16478;19243;19434,26280,1,1,2,0,4
38172,80,11235,16504;16674,26280,0,0,2,0,2
38173,80,11236,16021;16509,26280,0,0,2,0,2
38174,80,11237,16527;16865;19749,26280,1,0,2,0,3
38175,80,11238,16554;16744,26280,0,0,2,0,2
38176,80,11239,10987,26645,0,0,0,1,1
38177,80,11240,11390,26645,0,0,0,1,1
38178,80,11241,11384,26645,0,0,0,1,1
38179,80,11242,11610,26645,0,0,0,1,1
38180,80,11244,11502,26645,0,0,0,1,1
38181,80,11245,11845,26645,0,0,1,0,1
38182,80,11246,11903,26645,0,0,1,0,1
38183,80,11254,12839,26645,0,0,1,0,1
38184,80,11258,12804,26645,0,0,1,0,1
38185,80,11260,12596;13206,26645,0,0,2,0,2
38186,80,11261,13237,26645,0,0,1,0,1
38187,80,11265,13374,26645,0,0,1,0,1
38188,80,11266,12759;13234,26645,0,0,2,0,2
38189,80,11267,13757;13999;19205,26645,0,1,2,0,3
38190,80,11269,13830,26645,0,0,1,0,1
38191,80,11270,13627,26645,0,0,1,0,1
38192,80,11271,13796;13932;19210,26645,0,1,2,0,3
38193,80,11272,13945,26645,0,0,1,0,1
38194,80,11274,13597,26645,0,0,1,0,1
38195,80,11275,14267,26645,0,0,1,0,1
38196,80,11276,14332,26645,0,0,1,0,1
38197,80,11277,14327,26645,0,0,1,0,1
38198,80,11279,14460;14535;19752,26645,1,0,2,0,3
38199,80,11280,14516,26645,0,0,1,0,1
38200,80,11281,14612;15154,26645,0,0,2,0,2
38201,80,11282,14788;14934,26645,0,0,2,0,2
38202,80,11283,14801;15372,26645,0,0,2,0,2
38203,80,11285,14765;14938,26645,0,0,2,0,2
38204,80,11286,15211,26645,0,0,1,0,1
38205,80,11288,15001;15271;19619,26645,1,0,2,0,3
38206,80,11290,15046;15893;19842,26645,1,0,2,0,3
38207,80,11291,15153;15815,26645,0,0,2,0,2
38208,80,11293,15318;15967;19092;19719,26645,1,1,2,0,4
38209,80,11294,15384,26645,0,0,1,0,1
38210,80,11295,15393,26645,0,0,1,0,1
38211,80,11296,15155;15409;19435,26645,1,0,2,0,3
38212,80,11298,14949;15493;19340;19753,26645,2,0,2,0,4
38213,80,11299,15443;15529;19190,26645,0,1,2,0,3
38214,80,11300,15536;15966;19852,26645,1,0,2,0,3
38215,80,11301,15451;15538;19308,26645,0,1,2,0,3
38216,80,11303,15591;15740;19821,26645,1,0,2,0,3
38217,80,11304,15417;15753,26645,0,0,2,0,2
38218,80,11305,15284;15777,26645,0,0,2,0,2
38219,80,11306,15395,26645,0,0,1,0,1
38220,80,11307,15730;15900;19533,26645,1,0,2,0,3
38221,80,11308,15389;15734;19254,26645,0,1,2,0,3
38222,80,11309,15756;15931,26645,0,0,2,0,2
38223,80,11310,15764;15845,26645,0,0,2,0,2
38224,80,11311,15841;16026;19211;19594,26645,1,1,2,0,4
38225,80,11312,15861,26645,0,0,1,0,1
38226,80,11313,15502;16052,26645,0,0,2,0,2
38227,80,11314,15919;16480,26645,0,0,2,0,2
38228,80,11315,15948,26645,0,0,1,0,1
38229,80,11316,15953,26645,0,0,1,0,1
38230,80,11317,16479,26645,0,0,1,0,1
38231,80,11318,15999;16237,26645,0,0,2,0,2
38232,80,11319,16006;16214;19289,26645,0,1,2,0,3
38233,80,11320,16016;16198;19545,26645,1,0,2,0,3
38234,80,11321,15949;16034,26645,0,0,2,0,2
38235,80,11322,16038;16088;19488,26645,1,0,2,0,3
38236,80,11323,16140;16603;19660,26645,1,0,2,0,3
38237,80,11324,16245,26645,0,0,1,0,1
38238,80,11325,15795;16250,26645,0,0,2,0,2
38239,80,11326,16167;16256;19731,26645,1,0,2,0,3
38240,80,11327,16266;16532;19724,26645,1,0,2,0,3
38241,80,11328,16067;16269,26645,0,0,2,0,2
38242,80,11329,16111;16272,26645,0,0,2,0,2
38243,80,11330,16277;16855;19374,26645,1,0,2,0,3
38244,80,11331,16283;16633;19428;19678,26645,2,0,2,0,4
38245,80,11332,16164,26645,0,0,1,0,1
38246,80,11333,16013;16398,26645,0,0,2,0,2
38247,80,11334,16420,26645,0,0,1,0,1
38248,80,11335,16157;16447;19677,26645,1,0,2,0,3
38249,80,11336,16223;16458;19747,26645,1,0,2,0,3
38250,80,11337,16495;16732,26645,0,0,2,0,2
38251,80,11338,16162;16506,26645,0,0,2,0,2
38252,80,11339,16519;16798;19875,26645,1,0,2,0,3
38253,80,11340,16378;16529;19846,26645,1,0,2,0,3
38254,80,11341,16560;19840,26645,1,0,1,0,2
38255,80,11342,16153;16561,26645,0,0,2,0,2
38256,80,11343,16569;16667,26645,0,0,2,0,2
38257,80,11344,16287;16576;19874,26645,1,0,2,0,3
38258,80,11345,16205;16577;19272;19523;19786,26645,2,1,2,0,5
38259,80,11346,16580;16695,26645,0,0,2,0,2
38260,80,11347,16555;16811;19323;19503;19725,26645,3,0,2,0,5
38261,80,11348,16321;16593;19647,26645,1,0,2,0,3
38262,80,11349,16606,26645,0,0,1,0,1
38263,80,11350,16607;17062;19086;19459,26645,1,1,2,0,4
38264,80,11351,16620;16878;19119;19673,26645,1,1,2,0,4
38265,80,11352,16622;16966;19684,26645,1,0,2,0,3
38266,80,11353,16629;17046;19189;19506,26645,1,1,2,0,4
38267,80,11354,16488;16635,26645,0,0,2,0,2
38268,80,11355,16594;16648;19202;19623,26645,1,1,2,0,4
38269,80,11356,16244,26645,0,0,1,0,1
38270,80,11357,16654;16701;19343;19509,26645,2,0,2,0,4
38271,80,11358,16409;16703,26645,0,0,2,0,2
38272,80,11359,16728,26645,0,0,1,0,1
38273,80,11360,11581,27010,0,0,0,1,1
38274,80,11362,11545,27010,0,0,0,1,1
38275,80,11367,12104;12322,27010,0,0,2,0,2
38276,80,11369,11603,27010,0,0,0,1,1
38277,80,11370,12126,27010,0,0,1,0,1
38278,80,11372,12176,27010,0,0,1,0,1
38279,80,11374,12120;12225,27010,0,0,2,0,2
38280,80,11375,12371,27010,0,0,1,0,1
38281,80,11378,12499,27010,0,0,1,0,1
38282,80,11380,12793,27010,0,0,1,0,1
38283,80,11381,12799,27010,0,0,1,0,1
38284,80,11385,13073,27010,0,0,1,0,1
38285,80,11386,13424,27010,0,0,1,0,1
38286,80,11389,13973;14510,27010,0,0,2,0,2
38287,80,11391,14073;14594,27010,0,0,2,0,2
38288,80,11392,14193,27010,0,0,1,0,1
38289,80,11394,14149,27010,0,0,1,0,1
38290,80,11395,14477,27010,0,0,1,0,1
38291,80,11397,14340;15157,27010,0,0,2,0,2
38292,80,11401,14926,27010,0,0,1,0,1
38293,80,11402,14725;19228,27010,0,1,1,0,2
38294,80,11404,14341;14509,27010,0,0,2,0,2
38295,80,11406,14906,27010,0,0,1,0,1
38296,80,11408,14944,27010,0,0,1,0,1
38297,80,11409,15015,27010,0,0,1,0,1
38298,80,11410,15017;15513;19610,27010,1,0,2,0,3
38299,80,11411,15518;19229;19516,27010,1,1,1,0,3
38300,80,11412,15092;15317,27010,0,0,2,0,2
38301,80,11413,14716;15071;19497;19792,27010,2,0,2,0,4
38302,80,11414,14798;14957,27010,0,0,2,0,2
38303,80,11415,15188,27010,0,0,1,0,1
38304,80,11417,14790;15234;19263;19445;19756,27010,2,1,2,0,5
38305,80,11418,15356,27010,0,0,1,0,1
38306,80,11419,15247;15357,27010,0,0,2,0,2
38307,80,11420,15362,27010,0,0,1,0,1
38308,80,11421,14853;15371,27010,0,0,2,0,2
38309,80,11423,16012,27010,0,0,1,0,1
38310,80,11424,15604,27010,0,0,1,0,1
38311,80,11425,15614;16350,27010,0,0,2,0,2
38312,80,11426,15629;16308;19419,27010,1,0,2,0,3
38313,80,11427,15415;15692;19854,27010,1,0,2,0,3
38314,80,11428,15656;15715;19676,27010,1,0,2,0,3
38315,80,11429,15725;15779,27010,0,0,2,0,2
38316,80,11430,15743;16537,27010,0,0,2,0,2
38317,80,11431,15704;15813,27010,0,0,2,0,2
38318,80,11432,15821,27010,0,0,1,0,1
38319,80,11433,15836;16263,27010,0,0,2,0,2
38320,80,11434,15780;15850;19761,27010,1,0,2,0,3
38321,80,11435,15877;16267,27010,0,0,2,0,2
38322,80,11436,15586,27010,0,0,1,0,1
38323,80,11437,15829;15934;19486;19849,27010,2,0,2,0,4
38324,80,11438,15956;16501,27010,0,0,2,0,2
38325,80,11439,15974;15980,27010,0,0,2,0,2
38326,80,11440,15820;15995,27010,0,0,2,0,2
38327,80,11441,15559;15996,27010,0,0,2,0,2
38328,80,11442,16042;16446;19783,27010,1,0,2,0,3
38329,80,11443,15903;16084;19652,27010,1,0,2,0,3
38330,80,11444,16115,27010,0,0,1,0,1
38331,80,11445,16492,27010,0,0,1,0,1
38332,80,11446,16669;19510,27010,1,0,1,0,2
38333,80,11447,16183;16215,27010,0,0,2,0,2
38334,80,11448,16199;17037,27010,0,0,2,0,2
38335,80,11449,16552;17065;19358,27010,1,0,2,0,3
38336,80,11450,16440,27010,0,0,1,0,1
38337,80,11451,16320,27010,0,0,1,0,1
38338,80,11452,16761,27010,0,0,1,0,1
38339,80,11453,16345;16759,27010,0,0,2,0,2
38340,80,11454,16352,27010,0,0,1,0,1
38341,80,11455,16376;16588,27010,0,0,2,0,2
38342,80,11456,16895;19201,27010,0,1,1,0,2
38343,80,11457,16322;16394,27010,0,0,2,0,2
38344,80,11458,16219;16422;19534;19696,27010,2,0,2,0,4
38345,80,11459,16434;16756,27010,0,0,2,0,2
38346,80,11460,16436;17204;19216,27010,0,1,2,0,3
38347,80,11461,15708;16460,27010,0,0,2,0,2
38348,80,11462,15997,27010,0,0,1,0,1
38349,80,11463,16485;16779,27010,0,0,2,0,2
38350,80,11464,16498;16751,27010,0,0,2,0,2
38351,80,11465,16445;16541,27010,0,0,2,0,2
38352,80,11466,16386;16553,27010,0,0,2,0,2
38353,80,11467,16316;16562;19360,27010,1,0,2,0,3
38354,80,11468,16270;16563;19528,27010,1,0,2,0,3
38355,80,11469,16568;16764,27010,0,0,2,0,2
38356,80,11470,16596,27010,0,0,1,0,1
38357,80,11471,16608;16930;19220;19431,27010,1,1,2,0,4
38358,80,11472,16623;16815,27010,0,0,2,0,2
38359,80,11473,16685;16786,27010,0,0,2,0,2
38360,80,11474,16694;17106;19492;19764,27010,2,0,2,0,4
38361,80,11475,16699;16875;19274;19410;19480,27010,2,1,2,0,5
38362,80,11476,16947;19271;19680,27010,1,1,1,0,3
38363,80,11477,16725;17068,27010,0,0,2,0,2
38364,80,11478,16980;19237;19547,27010,1,1,1,0,3
38365,80,11479,16522;16738;19732,27010,1,0,2,0,3
38366,80,11480,16765;17028,27010,0,0,2,0,2
38367,80,11481,16766;17119,27010,0,0,2,0,2
38368,80,11482,16343;16783,27010,0,0,2,0,2
38369,80,11483,16803;17015,27010,0,0,2,0,2
38370,80,11484,16302;16357;19759;19817,27010,2,0,2,0,4
38371,80,11485,16617;16837,27010,0,0,2,0,2
38372,80,11486,16557;16850,27010,0,0,2,0,2
38373,80,11487,11717,27375,0,0,1,0,1
38374,80,11489,11588,27375,0,0,0,1,1
38375,80,11490,11516,27375,0,0,0,1,1
38376,80,11492,11508,27375,0,0,0,1,1
38377,80,11493,11982,27375,0,0,1,0,1
38378,80,11496,12158,27375,0,0,1,0,1
38379,80,11498,12426,27375,0,0,1,0,1
38380,80,11500,12130;12297,27375,0,0,2,0,2
38381,80,11502,12800,27375,0,0,1,0,1
38382,80,11503,12819,27375,0,0,1,0,1
38383,80,11504,12898,27375,0,0,1,0,1
38384,80,11506,12788,27375,0,0,1,0,1
38385,80,11507,13017;13211,27375,0,0,2,0,2
38386,80,11509,12477,27375,0,0,1,0,1
38387,80,11510,13185,27375,0,0,1,0,1
38388,80,11511,13238,27375,0,0,1,0,1
38389,80,11513,13507,27375,0,0,1,0,1
38390,80,11518,13680,27375,0,0,1,0,1
38391,80,11520,14039,27375,0,0,1,0,1
38392,80,11525,14408;15190;19615,27375,1,0,2,0,3
38393,80,11526,14440,27375,0,0,1,0,1
38394,80,11527,14561;14676,27375,0,0,2,0,2
38395,80,11528,14614,27375,0,0,1,0,1
38396,80,11529,14653;15232;19391,27375,1,0,2,0,3
38397,80,11530,14387,27375,0,0,1,0,1
38398,80,11535,14793;15517;19809,27375,1,0,2,0,3
38399,80,11536,14709;14950;19866,27375,1,0,2,0,3
38400,80,11537,15178,27375,0,0,1,0,1
38401,80,11538,14984;15403,27375,0,0,2,0,2
38402,80,11539,15306,27375,0,0,1,0,1
38403,80,11540,15126;15343,27375,0,0,2,0,2
38404,80,11544,15561;15987,27375,0,0,2,0,2
38405,80,11546,15716;15782,27375,0,0,2,0,2
38406,80,11547,15792,27375,0,0,1,0,1
38407,80,11548,15796;15812,27375,0,0,2,0,2
38408,80,11549,15817,27375,0,0,1,0,1
38409,80,11550,15843;16249,27375,0,0,2,0,2
38410,80,11551,15871;16548;19799,27375,1,0,2,0,3
38411,80,11552,15609;15879,27375,0,0,2,0,2
38412,80,11553,15774;15946,27375,0,0,2,0,2
38413,80,11555,15717;16003,27375,0,0,2,0,2
38414,80,11556,16022;16179,27375,0,0,2,0,2
38415,80,11557,16074;16278;19745,27375,1,0,2,0,3
38416,80,11558,16079;16627,27375,0,0,2,0,2
38417,80,11560,15747;16158,27375,0,0,2,0,2
38418,80,11561,16184;16224,27375,0,0,2,0,2
38419,80,11562,15519;16194,27375,0,0,2,0,2
38420,80,11563,16213,27375,0,0,1,0,1
38421,80,11564,16216,27375,0,0,1,0,1
38422,80,11565,15938;16195;19556;19865,27375,2,0,2,0,4
38423,80,11566,16228;16364;19387;19699,27375,2,0,2,0,4
38424,80,11567,16234;16771,27375,0,0,2,0,2
38425,80,11568,15963;16236;19806,27375,1,0,2,0,3
38426,80,11569,16257,27375,0,0,1,0,1
38427,80,11570,16286;19369,27375,1,0,1,0,2
38428,80,11571,16005;16289;19562,27375,1,0,2,0,3
38429,80,11572,16226;16290,27375,0,0,2,0,2
38430,80,11573,16072;16310;19758,27375,1,0,2,0,3
38431,80,11574,16365,27375,0,0,1,0,1
38432,80,11575,16396;16821,27375,0,0,2,0,2
38433,80,11576,16454;16613;19375;19734,27375,2,0,2,0,4
38434,80,11577,16293;16456,27375,0,0,2,0,2
38435,80,11578,16009;16476;19376,27375,1,0,2,0,3
38436,80,11579,16254;16661,27375,0,0,2,0,2
38437,80,11580,16549,27375,0,0,1,0,1
38438,80,11581,16371;16510,27375,0,0,2,0,2
38439,80,11582,16372;16424,27375,0,0,2,0,2
38440,80,11583,16565,27375,0,0,1,0,1
38441,80,11584,16571;16609;19628;19804,27375,2,0,2,0,4
38442,80,11585,16631;17039,27375,0,0,2,0,2
38443,80,11586,16638;16812;19550;19665;19859,27375,3,0,2,0,5
38444,80,11587,16664;17188;19697,27375,1,0,2,0,3
38445,80,11588,16161;16427,27375,0,0,2,0,2
38446,80,11589,16676;17137;19513,27375,1,0,2,0,3
38447,80,11590,16686;17117,27375,0,0,2,0,2
38448,80,11591,16706;16709;19743,27375,1,0,2,0,3
38449,80,11592,16717,27375,0,0,1,0,1
38450,80,11593,16724;16934;19353,27375,1,0,2,0,3
38451,80,11594,16752;16755,27375,0,0,2,0,2
38452,80,11595,16763;16927;19318;19700,27375,2,0,2,0,4
38453,80,11596,16359;16768,27375,0,0,2,0,2
38454,80,11597,16845;17035;19394;19774,27375,2,0,2,0,4
38455,80,11598,16846;17002,27375,0,0,2,0,2
38456,80,11599,16281;17053,27375,0,0,2,0,2
38457,80,11600,16882;17101;19467;19602,27375,2,0,2,0,4
38458,80,11601,16883;17328;19334;19489,27375,2,0,2,0,4
38459,80,11602,16545;16891,27375,0,0,2,0,2
38460,80,11603,16894,27375,0,0,1,0,1
38461,80,11604,17087;19406;19540,27375,2,0,1,0,3
38462,80,11605,16792;16899,27375,0,0,2,0,2
38463,80,11606,16924,27375,0,0,1,0,1
38464,80,11607,16652;16932,27375,0,0,2,0,2
38465,80,11608,16526;16945,27375,0,0,2,0,2
38466,80,11609,16697;16951;19767,27375,1,0,2,0,3
38467,80,11610,16964;17055,27375,0,0,2,0,2
38468,80,11611,11953,27740,0,0,1,0,1
38469,80,11612,11688,27740,0,0,0,1,1
38470,80,11613,11738;11873,27740,0,0,2,0,2
38471,80,11614,12131,27740,0,0,1,0,1
38472,80,11615,11676,27740,0,0,0,1,1
38473,80,11616,12214,27740,0,0,1,0,1
38474,80,11617,12009,27740,0,0,1,0,1
38475,80,11621,12105;12408,27740,0,0,2,0,2
38476,80,11622,12583,27740,0,0,1,0,1
38477,80,11624,12748,27740,0,0,1,0,1
38478,80,11625,12760,27740,0,0,1,0,1
38479,80,11627,13142,27740,0,0,1,0,1
38480,80,11629,12907,27740,0,0,1,0,1
38481,80,11631,13419,27740,0,0,1,0,1
38482,80,11632,13467,27740,0,0,1,0,1
38483,80,11634,13925,27740,0,0,1,0,1
38484,80,11635,14062,27740,0,0,1,0,1
38485,80,11636,14109,27740,0,0,1,0,1
38486,80,11638,13835,27740,0,0,1,0,1
38487,80,11639,14183,27740,0,0,1,0,1
38488,80,11640,14228,27740,0,0,1,0,1
38489,80,11641,14303;14625,27740,0,0,2,0,2
38490,80,11643,14769;15189;19886,27740,1,0,2,0,3
38491,80,11644,15366,27740,0,0,1,0,1
38492,80,11645,14809;15599,27740,0,0,2,0,2
38493,80,11646,14217,27740,0,0,1,0,1
38494,80,11647,14899,27740,0,0,1,0,1
38495,80,11648,14830;14980;19664,27740,1,0,2,0,3
38496,80,11649,15068;15407;19872,27740,1,0,2,0,3
38497,80,11651,14495;15158,27740,0,0,2,0,2
38498,80,11653,15446;15745,27740,0,0,2,0,2
38499,80,11654,15545;16191;19701,27740,1,0,2,0,3
38500,80,11655,15337,27740,0,0,1,0,1
38501,80,11657,15237;15620;19757,27740,1,0,2,0,3
38502,80,11658,15198;15751;19823,27740,1,0,2,0,3
38503,80,11659,15797;16570,27740,0,0,2,0,2
38504,80,11660,15805;15998,27740,0,0,2,0,2
38505,80,11661,15955,27740,0,0,1,0,1
38506,80,11662,16750,27740,0,0,1,0,1
38507,80,11663,16073;16579,27740,0,0,2,0,2
38508,80,11664,16175;16801,27740,0,0,2,0,2
38509,80,11665,15672;16075,27740,0,0,2,0,2
38510,80,11666,16206,27740,0,0,1,0,1
38511,80,11667,16227;16523;19430,27740,1,0,2,0,3
38512,80,11668,16247,27740,0,0,1,0,1
38513,80,11669,16297,27740,0,0,1,0,1
38514,80,11670,16306;16859,27740,0,0,2,0,2
38515,80,11671,16328;17100;19639,27740,1,0,2,0,3
38516,80,11672,15859;16363,27740,0,0,2,0,2
38517,80,11673,16391;16448,27740,0,0,2,0,2
38518,80,11674,16393;16991,27740,0,0,2,0,2
38519,80,11675,16437;16774,27740,0,0,2,0,2
38520,80,11676,16441;17221,27740,0,0,2,0,2
38521,80,11677,16443;17072,27740,0,0,2,0,2
38522,80,11678,16156;16449;19669,27740,1,0,2,0,3
38523,80,11679,16451;16935,27740,0,0,2,0,2
38524,80,11680,16481,27740,0,0,1,0,1
38525,80,11681,15945,27740,0,0,1,0,1
38526,80,11682,16507;17038,27740,0,0,2,0,2
38527,80,11683,16521;16968;19838,27740,1,0,2,0,3
38528,80,11684,16640;16840,27740,0,0,2,0,2
38529,80,11685,16642;19779;19824,27740,2,0,1,0,3
38530,80,11686,16202;16675,27740,0,0,2,0,2
38531,80,11687,16678;16858,27740,0,0,2,0,2
38532,80,11688,16679;17408;19502,27740,1,0,2,0,3
38533,80,11689,16688;16820,27740,0,0,2,0,2
38534,80,11690,16178;16692,27740,0,0,2,0,2
38535,80,11691,16698;16869,27740,0,0,2,0,2
38536,80,11692,16712;16838,27740,0,0,2,0,2
38537,80,11693,16656,27740,0,0,1,0,1
38538,80,11694,16395;16741;19879,27740,1,0,2,0,3
38539,80,11696,16584;16733;19741,27740,1,0,2,0,3
38540,80,11697,17124;19578,27740,1,0,1,0,2
38541,80,11698,16835;17475,27740,0,0,2,0,2
38542,80,11699,16843;16986,27740,0,0,2,0,2
38543,80,11700,16860;17301;19632,27740,1,0,2,0,3
38544,80,11701,16877;17397;19715,27740,1,0,2,0,3
38545,80,11702,17357;19546,27740,1,0,1,0,2
38546,80,11703,16915;17157;19541,27740,1,0,2,0,3
38547,80,11704,16922;19679,27740,1,0,1,0,2
38548,80,11705,16691;16923;19703,27740,1,0,2,0,3
38549,80,11706,16735;16795,27740,0,0,2,0,2
38550,80,11707,16990;17322,27740,0,0,2,0,2
38551,80,11708,17001,27740,0,0,1,0,1
38552,80,11709,16914;17005;19836,27740,1,0,2,0,3
38553,80,11710,17009;17217,27740,0,0,2,0,2
38554,80,11711,17018;17048,27740,0,0,2,0,2
38555,80,11712,16592;17040,27740,0,0,2,0,2
38556,80,11713,17044;17337;19845,27740,1,0,2,0,3
38557,80,11714,16590;16897;19515,27740,1,0,2,0,3
38558,80,11715,17077;17181,27740,0,0,2,0,2
38559,80,11716,16936;17079,27740,0,0,2,0,2
38560,80,11717,17114;17308;19656,27740,1,0,2,0,3
38561,80,11718,11420,28105,0,0,0,1,1
38562,80,11719,11934,28105,0,0,1,0,1
38563,80,11720,11601,28105,0,0,0,1,1
38564,80,11721,12253,28105,0,0,1,0,1
38565,80,11722,12502,28105,0,0,1,0,1
38566,80,11723,12593,28105,0,0,1,0,1
38567,80,11725,11871,28105,0,0,1,0,1
38568,80,11727,12523,28105,0,0,1,0,1
38569,80,11728,12498,28105,0,0,1,0,1
38570,80,11730,12689;13306,28105,0,0,2,0,2
38571,80,11732,13105,28105,0,0,1,0,1
38572,80,11734,13479,28105,0,0,1,0,1
38573,80,11735,13813,28105,0,0,1,0,1
38574,80,11736,13904,28105,0,0,1,0,1
38575,80,11737,13881,28105,0,0,1,0,1
38576,80,11738,13814,28105,0,0,1,0,1
38577,80,11739,14101,28105,0,0,1,0,1
38578,80,11740,13953,28105,0,0,1,0,1
38579,80,11742,14602,28105,0,0,1,0,1
38580,80,11745,14352,28105,0,0,1,0,1
38581,80,11747,14898,28105,0,0,1,0,1
38582,80,11748,14909;14959,28105,0,0,2,0,2
38583,80,11750,14922;15327,28105,0,0,2,0,2
38584,80,11751,15130;15737,28105,0,0,2,0,2
38585,80,11752,15203,28105,0,0,1,0,1
38586,80,11754,14484,28105,0,0,1,0,1
38587,80,11755,14996;15312;19717,28105,1,0,2,0,3
38588,80,11756,15079;15344,28105,0,0,2,0,2
38589,80,11757,15370;15554;19787,28105,1,0,2,0,3
38590,80,11758,15418,28105,0,0,1,0,1
38591,80,11759,15434,28105,0,0,1,0,1
38592,80,11760,15448;15970,28105,0,0,2,0,2
38593,80,11761,14914;15470,28105,0,0,2,0,2
38594,80,11762,15460;16070,28105,0,0,2,0,2
38595,80,11763,16482;19796,28105,1,0,1,0,2
38596,80,11764,15379;15694,28105,0,0,2,0,2
38597,80,11765,15240;15806;19835,28105,1,0,2,0,3
38598,80,11766,15416,28105,0,0,1,0,1
38599,80,11767,15727;15873,28105,0,0,2,0,2
38600,80,11770,15954;16546,28105,0,0,2,0,2
38601,80,11771,15878,28105,0,0,1,0,1
38602,80,11772,16139;16414,28105,0,0,2,0,2
38603,80,11773,16146;16241,28105,0,0,2,0,2
38604,80,11774,16438,28105,0,0,1,0,1
38605,80,11775,16311;16714;19693,28105,1,0,2,0,3
38606,80,11777,16366;16637;19688,28105,1,0,2,0,3
38607,80,11778,16713;16909;19870,28105,1,0,2,0,3
38608,80,11779,16077;16457,28105,0,0,2,0,2
38609,80,11780,16474;16823,28105,0,0,2,0,2
38610,80,11781,16516;16540,28105,0,0,2,0,2
38611,80,11782,16573;16665,28105,0,0,2,0,2
38612,80,11783,16625;16722,28105,0,0,2,0,2
38613,80,11784,15913,28105,0,0,1,0,1
38614,80,11785,16647;17041;19740,28105,1,0,2,0,3
38615,80,11786,16731,28105,0,0,1,0,1
38616,80,11787,16734,28105,0,0,1,0,1
38617,80,11788,16736;17266;19671,28105,1,0,2,0,3
38618,80,11789,16737,28105,0,0,1,0,1
38619,80,11790,15958;16313,28105,0,0,2,0,2
38620,80,11791,16769;17098;19765,28105,1,0,2,0,3
38621,80,11792,16626;16777;19682,28105,1,0,2,0,3
38622,80,11793,16788;16857,28105,0,0,2,0,2
38623,80,11794,16390;16790,28105,0,0,2,0,2
38624,80,11795,16791;17423;19585,28105,1,0,2,0,3
38625,80,11796,16806,28105,0,0,1,0,1
38626,80,11797,16534;16809,28105,0,0,2,0,2
38627,80,11798,16826;17061,28105,0,0,2,0,2
38628,80,11799,16784;16831,28105,0,0,2,0,2
38629,80,11800,16836;16921,28105,0,0,2,0,2
38630,80,11801,17298,28105,0,0,1,0,1
38631,80,11802,16851;17420,28105,0,0,2,0,2
38632,80,11803,16863;17314,28105,0,0,2,0,2
38633,80,11804,16866,28105,0,0,1,0,1
38634,80,11805,16908;17240;19589;19706,28105,2,0,2,0,4
38635,80,11806,16401,28105,0,0,1,0,1
38636,80,11807,16939;17520,28105,0,0,2,0,2
38637,80,11808,16455;16969;19863,28105,1,0,2,0,3
38638,80,11809,16163;16975,28105,0,0,2,0,2
38639,80,11810,16995;17073,28105,0,0,2,0,2
38640,80,11811,17049,28105,0,0,1,0,1
38641,80,11812,17054,28105,0,0,1,0,1
38642,80,11813,17063;17429,28105,0,0,2,0,2
38643,80,11814,17083;17536;19843,28105,1,0,2,0,3
38644,80,11815,17095;17511;19636,28105,1,0,2,0,3
38645,80,11816,17096;17162,28105,0,0,2,0,2
38646,80,11817,16985;17108,28105,0,0,2,0,2
38647,80,11818,17110;17405,28105,0,0,2,0,2
38648,80,11819,17118;17152,28105,0,0,2,0,2
38649,80,11820,17142;17269;19575,28105,1,0,2,0,3
38650,80,11821,17161;17519,28105,0,0,2,0,2
38651,80,11822,17127;17193,28105,0,0,2,0,2
38652,80,11823,17216;17556,28105,0,0,2,0,2
38653,80,11824,17215;17222,28105,0,0,2,0,2
38654,80,11825,16805;17223;19574,28105,1,0,2,0,3
38655,80,11826,12037;12690,28470,0,0,2,0,2
38656,80,11827,11964,28470,0,0,1,0,1
38657,80,11828,12111;12115,28470,0,0,2,0,2
38658,80,11829,12017,28470,0,0,1,0,1
38659,80,11830,11874,28470,0,0,1,0,1
38660,80,11831,12189,28470,0,0,1,0,1
38661,80,11833,12109;12302,28470,0,0,2,0,2
38662,80,11834,12027,28470,0,0,1,0,1
38663,80,11835,11770,28470,0,0,1,0,1
38664,80,11836,12359,28470,0,0,1,0,1
38665,80,11837,11995,28470,0,0,1,0,1
38666,80,11838,12524,28470,0,0,1,0,1
38667,80,11839,12661,28470,0,0,1,0,1
38668,80,11840,12718,28470,0,0,1,0,1
38669,80,11841,12541,28470,0,0,1,0,1
38670,80,11842,12767,28470,0,0,1,0,1
38671,80,11843,12769,28470,0,0,1,0,1
38672,80,11844,12412,28470,0,0,1,0,1
38673,80,11845,12857,28470,0,0,1,0,1
38674,80,11846,12964,28470,0,0,1,0,1
38675,80,11849,13130,28470,0,0,1,0,1
38676,80,11850,12402,28470,0,0,1,0,1
38677,80,11851,13286,28470,0,0,1,0,1
38678,80,11852,13408,28470,0,0,1,0,1
38679,80,11853,13499,28470,0,0,1,0,1
38680,80,11854,13450,28470,0,0,1,0,1
38681,80,11859,13767,28470,0,0,1,0,1
38682,80,11860,13485,28470,0,0,1,0,1
38683,80,11861,13863,28470,0,0,1,0,1
38684,80,11862,13909,28470,0,0,1,0,1
38685,80,11863,13967,28470,0,0,1,0,1
38686,80,11864,14071,28470,0,0,1,0,1
38687,80,11865,14029,28470,0,0,1,0,1
38688,80,11866,14143,28470,0,0,1,0,1
38689,80,11868,13987,28470,0,0,1,0,1
38690,80,11869,13895,28470,0,0,1,0,1
38691,80,11870,14264,28470,0,0,1,0,1
38692,80,11871,14271,28470,0,0,1,0,1
38693,80,11873,14506;14896,28470,0,0,2,0,2
38694,80,11874,14551,28470,0,0,1,0,1
38695,80,11875,14280,28470,0,0,1,0,1
38696,80,11876,14679,28470,0,0,1,0,1
38697,80,11877,14728;14969,28470,0,0,2,0,2
38698,80,11878,14875,28470,0,0,1,0,1
38699,80,11879,14620,28470,0,0,1,0,1
38700,80,11880,14123,28470,0,0,1,0,1
38701,80,11881,14986,28470,0,0,1,0,1
38702,80,11883,14859,28470,0,0,1,0,1
38703,80,11884,15042;15242,28470,0,0,2,0,2
38704,80,11885,15340,28470,0,0,1,0,1
38705,80,11886,15404;15852,28470,0,0,2,0,2
38706,80,11887,15445,28470,0,0,1,0,1
38707,80,11888,15477,28470,0,0,1,0,1
38708,80,11889,15482,28470,0,0,1,0,1
38709,80,11890,15224;15503;19690;19785,28470,2,0,2,0,4
38710,80,11891,15563,28470,0,0,1,0,1
38711,80,11892,15570;16314,28470,0,0,2,0,2
38712,80,11893,15697;16082;19798,28470,1,0,2,0,3
38713,80,11894,15520,28470,0,0,1,0,1
38714,80,11895,15773,28470,0,0,1,0,1
38715,80,11896,15842;16129,28470,0,0,2,0,2
38716,80,11897,15846,28470,0,0,1,0,1
38717,80,11898,15887;16431,28470,0,0,2,0,2
38718,80,11900,15979;16351;19698;19811,28470,2,0,2,0,4
38719,80,11901,16056;16499;19797,28470,1,0,2,0,3
38720,80,11902,16242;16484,28470,0,0,2,0,2
38721,80,11903,16032;16248,28470,0,0,2,0,2
38722,80,11904,15960;16259,28470,0,0,2,0,2
38723,80,11905,16285;16780,28470,0,0,2,0,2
38724,80,11906,16380;17272,28470,0,0,2,0,2
38725,80,11907,16382;16406;19815,28470,1,0,2,0,3
38726,80,11908,16435;16710,28470,0,0,2,0,2
38727,80,11909,16459;17082,28470,0,0,2,0,2
38728,80,11910,16408;16502,28470,0,0,2,0,2
38729,80,11911,16515;16885;19773,28470,1,0,2,0,3
38730,80,11912,16538;16876,28470,0,0,2,0,2
38731,80,11913,16673;16702,28470,0,0,2,0,2
38732,80,11914,16682;16684,28470,0,0,2,0,2
38733,80,11915,16374;16730,28470,0,0,2,0,2
38734,80,11916,16747;16847,28470,0,0,2,0,2
38735,80,11917,16830;17375,28470,0,0,2,0,2
38736,80,11918,16890;17512,28470,0,0,2,0,2
38737,80,11919,16905;17008,28470,0,0,2,0,2
38738,80,11920,16880;16950,28470,0,0,2,0,2
38739,80,11921,16962,28470,0,0,1,0,1
38740,80,11922,16967,28470,0,0,1,0,1
38741,80,11923,16981;17440;19869,28470,1,0,2,0,3
38742,80,11924,16989;17424,28470,0,0,2,0,2
38743,80,11925,17496;19833,28470,1,0,1,0,2
38744,80,11926,17014;17499,28470,0,0,2,0,2
38745,80,11927,17402,28470,0,0,1,0,1
38746,80,11928,16444;17036,28470,0,0,2,0,2
38747,80,11929,17094;17508,28470,0,0,2,0,2
38748,80,11930,16931;17097,28470,0,0,2,0,2
38749,80,11931,16616;17104;19708,28470,1,0,2,0,3
38750,80,11932,17130;17575;19694,28470,1,0,2,0,3
38751,80,11933,17103;17148,28470,0,0,2,0,2
38752,80,11934,17011;17156,28470,0,0,2,0,2
38753,80,11935,16817;17189,28470,0,0,2,0,2
38754,80,11936,17192;17626;19780,28470,1,0,2,0,3
38755,80,11937,17198;17201,28470,0,0,2,0,2
38756,80,11938,17200;19763,28470,1,0,1,0,2
38757,80,11939,17208;17343,28470,0,0,2,0,2
38758,80,11940,16704;17227,28470,0,0,2,0,2
38759,80,11941,17231;17249,28470,0,0,2,0,2
38760,80,11942,17234;19883,28470,1,0,1,0,2
38761,80,11943,17244,28470,0,0,1,0,1
38762,80,11944,17256;17320;19683,28470,1,0,2,0,3
38763,80,11945,17089;17267,28470,0,0,2,0,2
38764,80,11946,17284;17673,28470,0,0,2,0,2
38765,80,11947,17297,28470,0,0,1,0,1
38766,80,11948,17312;17457,28470,0,0,2,0,2
38767,80,11949,17344;17492;19686,28470,1,0,2,0,3
38768,80,11950,12159,28835,0,0,1,0,1
38769,80,11951,12164,28835,0,0,1,0,1
38770,80,11952,11931,28835,0,0,1,0,1
38771,80,11953,12438,28835,0,0,1,0,1
38772,80,11955,12313,28835,0,0,1,0,1
38773,80,11956,12722,28835,0,0,1,0,1
38774,80,11957,12763,28835,0,0,1,0,1
38775,80,11958,12823,28835,0,0,1,0,1
38776,80,11959,12056,28835,0,0,1,0,1
38777,80,11960,12880,28835,0,0,1,0,1
38778,80,11961,12927,28835,0,0,1,0,1
38779,80,11962,12723,28835,0,0,1,0,1
38780,80,11963,12977,28835,0,0,1,0,1
38781,80,11964,13030,28835,0,0,1,0,1
38782,80,11965,13089,28835,0,0,1,0,1
38783,80,11966,13196,28835,0,0,1,0,1
38784,80,11967,13337,28835,0,0,1,0,1
38785,80,11968,13098,28835,0,0,1,0,1
38786,80,11969,13464,28835,0,0,1,0,1
38787,80,11970,13369,28835,0,0,1,0,1
38788,80,11971,13601,28835,0,0,1,0,1
38789,80,11972,13733,28835,0,0,1,0,1
38790,80,11973,13756,28835,0,0,1,0,1
38791,80,11974,13180,28835,0,0,1,0,1
38792,80,11975,13869,28835,0,0,1,0,1
38793,80,11976,13961,28835,0,0,1,0,1
38794,80,11977,14005,28835,0,0,1,0,1
38795,80,11978,14064,28835,0,0,1,0,1
38796,80,11979,14277,28835,0,0,1,0,1
38797,80,11980,14405,28835,0,0,1,0,1
38798,80,11981,13972,28835,0,0,1,0,1
38799,80,11982,14565;14598,28835,0,0,2,0,2
38800,80,11983,14647,28835,0,0,1,0,1
38801,80,11985,14688;15100,28835,0,0,2,0,2
38802,80,11986,14730,28835,0,0,1,0,1
38803,80,11987,14787,28835,0,0,1,0,1
38804,80,11988,15116,28835,0,0,1,0,1
38805,80,11989,15128,28835,0,0,1,0,1
38806,80,11990,15285;15553;19788,28835,1,0,2,0,3
38807,80,11991,15345;16150,28835,0,0,2,0,2
38808,80,11992,15369;16080,28835,0,0,2,0,2
38809,80,11993,15397,28835,0,0,1,0,1
38810,80,11994,14886,28835,0,0,1,0,1
38811,80,11995,15074;15235,28835,0,0,2,0,2
38812,80,11997,15699,28835,0,0,1,0,1
38813,80,11998,15791,28835,0,0,1,0,1
38814,80,11999,15481,28835,0,0,1,0,1
38815,80,12000,15600;16076,28835,0,0,2,0,2
38816,80,12001,16113,28835,0,0,1,0,1
38817,80,12002,15884,28835,0,0,1,0,1
38818,80,12003,15576,28835,0,0,1,0,1
38819,80,12004,15752,28835,0,0,1,0,1
38820,80,12006,15653;16301,28835,0,0,2,0,2
38821,80,12007,16133;16387,28835,0,0,2,0,2
38822,80,12008,16423;16949,28835,0,0,2,0,2
38823,80,12009,16196,28835,0,0,1,0,1
38824,80,12010,15644,28835,0,0,1,0,1
38825,80,12011,16483,28835,0,0,1,0,1
38826,80,12012,16356;16636,28835,0,0,2,0,2
38827,80,12013,16649;16983,28835,0,0,2,0,2
38828,80,12014,16660,28835,0,0,1,0,1
38829,80,12016,16700;17174,28835,0,0,2,0,2
38830,80,12017,16748;17218,28835,0,0,2,0,2
38831,80,12018,15654,28835,0,0,1,0,1
38832,80,12019,16758;17059,28835,0,0,2,0,2
38833,80,12020,16757,28835,0,0,1,0,1
38834,80,12021,16808;16874,28835,0,0,2,0,2
38835,80,12022,16349;16810,28835,0,0,2,0,2
38836,80,12023,16813;17213;19841,28835,1,0,2,0,3
38837,80,12024,16839,28835,0,0,1,0,1
38838,80,12025,16898,28835,0,0,1,0,1
38839,80,12027,16770;16926,28835,0,0,2,0,2
38840,80,12028,16942;17533,28835,0,0,2,0,2
38841,80,12029,16963;17527,28835,0,0,2,0,2
38842,80,12030,16987,28835,0,0,1,0,1
38843,80,12031,16994,28835,0,0,1,0,1
38844,80,12032,17017;17632,28835,0,0,2,0,2
38845,80,12033,17027;17551,28835,0,0,2,0,2
38846,80,12034,17032,28835,0,0,1,0,1
38847,80,12035,17034,28835,0,0,1,0,1
38848,80,12036,17052,28835,0,0,1,0,1
38849,80,12037,17057;17395,28835,0,0,2,0,2
38850,80,12038,17066;17381,28835,0,0,2,0,2
38851,80,12039,17067;17406,28835,0,0,2,0,2
38852,80,12040,17120;17687,28835,0,0,2,0,2
38853,80,12041,17123;17214,28835,0,0,2,0,2
38854,80,12042,17091;17143,28835,0,0,2,0,2
38855,80,12043,17144;17207,28835,0,0,2,0,2
38856,80,12044,16852;17166,28835,0,0,2,0,2
38857,80,12045,17177;17430;19888,28835,1,0,2,0,3
38858,80,12046,17232;17493,28835,0,0,2,0,2
38859,80,12047,17233;17557;19784,28835,1,0,2,0,3
38860,80,12048,17237;17704,28835,0,0,2,0,2
38861,80,12049,16954;17239,28835,0,0,2,0,2
38862,80,12050,16941,28835,0,0,1,0,1
38863,80,12051,16965;17248;19851,28835,1,0,2,0,3
38864,80,12052,17252;17281,28835,0,0,2,0,2
38865,80,12053,17288;17304;19801,28835,1,0,2,0,3
38866,80,12054,16477;17307,28835,0,0,2,0,2
38867,80,12055,17323;17580,28835,0,0,2,0,2
38868,80,12056,17331;17392,28835,0,0,2,0,2
38869,80,12057,16793;17336,28835,0,0,2,0,2
38870,80,12058,17356;17627,28835,0,0,2,0,2
38871,80,12059,17206;17372,28835,0,0,2,0,2
38872,80,12060,17271;17393;19816,28835,1,0,2,0,3
38873,80,12061,17438;17788,28835,0,0,2,0,2
38874,80,12062,17442;17671,28835,0,0,2,0,2
38875,80,12063,17450;17588,28835,0,0,2,0,2
38876,80,12064,17473;17619;19813,28835,1,0,2,0,3
38877,80,12065,12264,29200,0,0,1,0,1
38878,80,12066,11803,29200,0,0,1,0,1
38879,80,12067,12311,29200,0,0,1,0,1
38880,80,12068,12510,29200,0,0,1,0,1
38881,80,12069,12717,29200,0,0,1,0,1
38882,80,12070,12768,29200,0,0,1,0,1
38883,80,12071,12875,29200,0,0,1,0,1
38884,80,12072,12762,29200,0,0,1,0,1
38885,80,12073,13006,29200,0,0,1,0,1
38886,80,12074,12249,29200,0,0,1,0,1
38887,80,12076,13228,29200,0,0,1,0,1
38888,80,12077,13276,29200,0,0,1,0,1
38889,80,12078,13310,29200,0,0,1,0,1
38890,80,12079,13347,29200,0,0,1,0,1
38891,80,12080,13317,29200,0,0,1,0,1
38892,80,12081,12887,29200,0,0,1,0,1
38893,80,12082,13417,29200,0,0,1,0,1
38894,80,12083,13429,29200,0,0,1,0,1
38895,80,12084,13168,29200,0,0,1,0,1
38896,80,12085,13946,29200,0,0,1,0,1
38897,80,12086,13800,29200,0,0,1,0,1
38898,80,12087,14045,29200,0,0,1,0,1
38899,80,12088,13734,29200,0,0,1,0,1
38900,80,12089,14102,29200,0,0,1,0,1
38901,80,12090,14199,29200,0,0,1,0,1
38902,80,12091,14313,29200,0,0,1,0,1
38903,80,12092,14335,29200,0,0,1,0,1
38904,80,12093,14104,29200,0,0,1,0,1
38905,80,12094,14436,29200,0,0,1,0,1
38906,80,12095,14439,29200,0,0,1,0,1
38907,80,12096,14466,29200,0,0,1,0,1
38908,80,12097,14617,29200,0,0,1,0,1
38909,80,12098,14782,29200,0,0,1,0,1
38910,80,12100,14380,29200,0,0,1,0,1
38911,80,12101,15020,29200,0,0,1,0,1
38912,80,12102,15459,29200,0,0,1,0,1
38913,80,12103,15163,29200,0,0,1,0,1
38914,80,12104,14266,29200,0,0,1,0,1
38915,80,12105,15009,29200,0,0,1,0,1
38916,80,12106,15408,29200,0,0,1,0,1
38917,80,12107,15428,29200,0,0,1,0,1
38918,80,12108,15480,29200,0,0,1,0,1
38919,80,12109,15522,29200,0,0,1,0,1
38920,80,12110,15491,29200,0,0,1,0,1
38921,80,12111,15657;16204,29200,0,0,2,0,2
38922,80,12112,15723;15935,29200,0,0,2,0,2
38923,80,12113,15349,29200,0,0,1,0,1
38924,80,12114,15783;16041,29200,0,0,2,0,2
38925,80,12115,15899,29200,0,0,1,0,1
38926,80,12116,15914;16657,29200,0,0,2,0,2
38927,80,12117,15976,29200,0,0,1,0,1
38928,80,12118,16004;16862,29200,0,0,2,0,2
38929,80,12119,16102;16462,29200,0,0,2,0,2
38930,80,12120,15646;16109,29200,0,0,2,0,2
38931,80,12121,16403,29200,0,0,1,0,1
38932,80,12122,16127,29200,0,0,1,0,1
38933,80,12123,16295;16298,29200,0,0,2,0,2
38934,80,12124,16486;17107,29200,0,0,2,0,2
38935,80,12125,16505;16800,29200,0,0,2,0,2
38936,80,12126,16487;16518,29200,0,0,2,0,2
38937,80,12127,16528;16977,29200,0,0,2,0,2
38938,80,12128,16497,29200,0,0,1,0,1
38939,80,12129,16591;17133,29200,0,0,2,0,2
38940,80,12130,16604;16797,29200,0,0,2,0,2
38941,80,12131,16255;16621,29200,0,0,2,0,2
38942,80,12132,16663;17447,29200,0,0,2,0,2
38943,80,12133,16715;17236,29200,0,0,2,0,2
38944,80,12134,16658;16719,29200,0,0,2,0,2
38945,80,12135,16729;16933,29200,0,0,2,0,2
38946,80,12136,16828,29200,0,0,1,0,1
38947,80,12137,16834;17195,29200,0,0,2,0,2
38948,80,12138,15603,29200,0,0,1,0,1
38949,80,12139,16881,29200,0,0,1,0,1
38950,80,12140,16943;17220,29200,0,0,2,0,2
38951,80,12141,17012,29200,0,0,1,0,1
38952,80,12142,17019;17165,29200,0,0,2,0,2
38953,80,12143,16767;17042,29200,0,0,2,0,2
38954,80,12144,17045;17706,29200,0,0,2,0,2
38955,80,12145,17075,29200,0,0,1,0,1
38956,80,12146,17129;17359,29200,0,0,2,0,2
38957,80,12147,16794;17139,29200,0,0,2,0,2
38958,80,12148,17141,29200,0,0,1,0,1
38959,80,12149,17145;17327,29200,0,0,2,0,2
38960,80,12150,17196;17485,29200,0,0,2,0,2
38961,80,12151,17229,29200,0,0,1,0,1
38962,80,12152,17250,29200,0,0,1,0,1
38963,80,12153,17078;17254,29200,0,0,2,0,2
38964,80,12154,17277;17747,29200,0,0,2,0,2
38965,80,12155,17280;17875,29200,0,1,1,0,2
38966,80,12156,17228;17300,29200,0,0,2,0,2
38967,80,12157,16937;17316,29200,0,0,2,0,2
38968,80,12158,17360;17545,29200,0,0,2,0,2
38969,80,12159,17374,29200,0,0,1,0,1
38970,80,12160,17396;17616,29200,0,0,2,0,2
38971,80,12161,17403;17635,29200,0,0,2,0,2
38972,80,12162,17484;17896,29200,0,1,1,0,2
38973,80,12163,17500;17846,29200,0,1,1,0,2
38974,80,12164,17340;17505,29200,0,0,2,0,2
38975,80,12165,17513;17828,29200,0,1,1,0,2
38976,80,12166,17534;17733,29200,0,0,2,0,2
38977,80,12167,17543;17761,29200,0,0,2,0,2
38978,80,12168,17554;17600,29200,0,0,2,0,2
38979,80,12169,17567;17878,29200,0,1,1,0,2
38980,90,140,11066;11181,0,0,0,0,2,2
38981,90,280,10169,0,0,0,0,1,1
38982,90,584,1538,0,0,0,0,1,1
38983,90,614,1619;10411,0,0,0,0,2,2
38984,90,749,1963;7142,0,0,0,0,2,2
38985,90,797,10331,0,0,0,0,1,1
38986,90,1029,5135,0,0,0,0,1,1
38987,90,1077,1700,0,0,0,0,1,1
38988,90,1551,4093,0,0,0,0,1,1
38989,90,1715,1577,0,0,0,0,1,1
38990,90,1822,10147,0,0,0,0,1,1
38991,90,2028,2323,0,0,0,0,1,1
38992,90,2083,5437,0,0,0,0,1,1
38993,90,2343,1360,0,0,0,0,1,1
38994,90,2501,9927,0,0,0,0,1,1
38995,90,2638,11089;11184,0,0,0,0,2,2
38996,90,2759,10244;10711,0,0,0,0,2,2
38997,90,3009,7665,0,0,0,0,1,1
38998,90,3022,219,0,0,0,0,1,1
38999,90,3479,8978,0,0,0,0,1,1
39000,90,3580,10502,0,0,0,0,1,1
39001,90,3594,1351,0,0,0,0,1,1
39002,90,3651,10538;10992,0,0,0,0,2,2
39003,90,3823,3901,0,0,0,0,1,1
39004,90,4289,11984;12134,1095,0,0,0,2,2
39005,90,4304,12232;12295,1095,0,0,0,2,2
39006,90,4536,11715;12138;12177,1825,0,0,0,3,3
39007,90,4719,11861;12024,2555,0,0,0,2,2
39008,90,4793,11735;12083,2920,0,0,0,2,2
39009,90,4817,12168;12456;13314;14003;18458,2920,0,0,3,2,5
39010,90,5011,1609,3285,0,0,0,1,1
39011,90,5091,7969,3650,0,0,0,1,1
39012,90,5118,12335,3650,0,0,0,1,1
39013,90,5177,12604;12810;18000,4015,0,0,1,2,3
39014,90,5219,6112,4015,0,0,0,1,1
39015,90,5277,674;4963,4380,0,0,0,2,2
39016,90,5306,8442,4380,0,0,0,1,1
39017,90,5384,2581,4745,0,0,0,1,1
39018,90,5388,9389,4745,0,0,0,1,1
39019,90,5411,3356,4745,0,0,0,1,1
39020,90,5432,5792,4745,0,0,0,1,1
39021,90,5442,5735,4745,0,0,0,1,1
39022,90,5499,5100,5110,0,0,0,1,1
39023,90,5501,5809,5110,0,0,0,1,1
39024,90,5507,5659,5110,0,0,0,1,1
39025,90,5528,5459,5110,0,0,0,1,1
39026,90,5533,3573,5110,0,0,0,1,1
39027,90,5536,5187,5475,0,0,0,1,1
39028,90,5553,1544,5475,0,0,0,1,1
39029,90,5578,14189;14315;18631;18739,5475,0,0,4,0,4
39030,90,5579,6809,5475,0,0,0,1,1
39031,90,5584,12409,5475,0,0,0,1,1
39032,90,5585,5047,5475,0,0,0,1,1
39033,90,5619,3046,5475,0,0,0,1,1
39034,90,5628,8010,5475,0,0,0,1,1
39035,90,5639,12557,5475,0,0,0,1,1
39036,90,5647,631,5475,0,0,0,1,1
39037,90,5656,1847,5840,0,0,0,1,1
39038,90,5663,13760;13895,5840,0,0,2,0,2
39039,90,5665,1267;4845,5840,0,0,0,2,2
39040,90,5683,10012,5840,0,0,0,1,1
39041,90,5697,3840;4752,5840,0,0,0,2,2
39042,90,5707,6905,5840,0,0,0,1,1
39043,90,5709,5436,5840,0,0,0,1,1
39044,90,5711,10113,5840,0,0,0,1,1
39045,90,5747,8967,5840,0,0,0,1,1
39046,90,5763,319,6205,0,0,0,1,1
39047,90,5764,10063,6205,0,0,0,1,1
39048,90,5779,7341,6205,0,0,0,1,1
39049,90,5818,5642,6205,0,0,0,1,1
39050,90,5821,3601,6205,0,0,0,1,1
39051,90,5825,6262,6205,0,0,0,1,1
39052,90,5829,2146,6205,0,0,0,1,1
39053,90,5833,1026,6205,0,0,0,1,1
39054,90,5839,10053,6205,0,0,0,1,1
39055,90,5842,1623,6205,0,0,0,1,1
39056,90,5849,5156,6205,0,0,0,1,1
39057,90,5859,7802,6205,0,0,0,1,1
39058,90,5867,10246,6570,0,0,0,1,1
39059,90,5891,2963,6570,0,0,0,1,1
39060,90,5893,960;1191,6570,0,0,0,2,2
39061,90,5895,3118,6570,0,0,0,1,1
39062,90,5925,5723,6570,0,0,0,1,1
39063,90,5945,8297,6570,0,0,0,1,1
39064,90,5947,10283,6570,0,0,0,1,1
39065,90,5949,7029,6570,0,0,0,1,1
39066,90,5953,4476,6570,0,0,0,1,1
39067,90,5960,3055,6570,0,0,0,1,1
39068,90,5963,10158,6570,0,0,0,1,1
39069,90,5968,6693,6570,0,0,0,1,1
39070,90,5999,2069,6935,0,0,0,1,1
39071,90,6021,320,6935,0,0,0,1,1
39072,90,6038,7054,6935,0,0,0,1,1
39073,90,6043,10367,6935,0,0,0,1,1
39074,90,6056,10308,6935,0,0,0,1,1
39075,90,6064,10328,6935,0,0,0,1,1
39076,90,6066,10093,6935,0,0,0,1,1
39077,90,6067,10036;10098,6935,0,0,0,2,2
39078,90,6069,10018,7300,0,0,0,1,1
39079,90,6073,10484,7300,0,0,0,1,1
39080,90,6077,10201,7300,0,0,0,1,1
39081,90,6085,10084,7300,0,0,0,1,1
39082,90,6091,6967,7300,0,0,0,1,1
39083,90,6102,10371,7300,0,0,0,1,1
39084,90,6107,10480,7300,0,0,0,1,1
39085,90,6115,5402,7300,0,0,0,1,1
39086,90,6121,9654,7300,0,0,0,1,1
39087,90,6159,10475,7300,0,0,0,1,1
39088,90,6161,10055,7300,0,0,0,1,1
39089,90,6163,10083,7300,0,0,0,1,1
39090,90,6164,10439;15341,7300,0,0,1,1,2
39091,90,6166,10132,7300,0,0,0,1,1
39092,90,6168,10329,7300,0,0,0,1,1
39093,90,6170,10205,7300,0,0,0,1,1
39094,90,6172,10400,7300,0,0,0,1,1
39095,90,6175,10094,7665,0,0,0,1,1
39096,90,6177,653,7665,0,0,0,1,1
39097,90,6182,10111,7665,0,0,0,1,1
39098,90,6188,6560,7665,0,0,0,1,1
39099,90,6189,9518,7665,0,0,0,1,1
39100,90,6213,13700;14272;19744,7665,0,1,2,0,3
39101,90,6223,9580,7665,0,0,0,1,1
39102,90,6226,7724,7665,0,0,0,1,1
39103,90,6229,8145,7665,0,0,0,1,1
39104,90,6243,10306,7665,0,0,0,1,1
39105,90,6245,10090,7665,0,0,0,1,1
39106,90,6246,10377,7665,0,0,0,1,1
39107,90,6247,10164,7665,0,0,0,1,1
39108,90,6250,10432,7665,0,0,0,1,1
39109,90,6252,10248,7665,0,0,0,1,1
39110,90,6253,10255,7665,0,0,0,1,1
39111,90,6255,10594,7665,0,0,0,1,1
39112,90,6256,10486,7665,0,0,0,1,1
39113,90,6257,10292;10482,7665,0,0,0,2,2
39114,90,6258,10312,7665,0,0,0,1,1
39115,90,6260,10565,7665,0,0,0,1,1
39116,90,6315,10180,8030,0,0,0,1,1
39117,90,6316,1720;9231,8030,0,0,0,2,2
39118,90,6319,10042;10141,8030,0,0,0,2,2
39119,90,6324,10091,8030,0,0,0,1,1
39120,90,6327,10861,8030,0,0,0,1,1
39121,90,6332,10236,8030,0,0,0,1,1
39122,90,6335,10272,8030,0,0,0,1,1
39123,90,6336,10309;10463,8030,0,0,0,2,2
39124,90,6337,10314,8030,0,0,0,1,1
39125,90,6338,10316;10374,8030,0,0,0,2,2
39126,90,6339,10446,8030,0,0,0,1,1
39127,90,6341,10382,8030,0,0,0,1,1
39128,90,6342,10412,8030,0,0,0,1,1
39129,90,6351,10038,8395,0,0,0,1,1
39130,90,6358,1493;10562,8395,0,0,0,2,2
39131,90,6383,10152;10245,8395,0,0,0,2,2
39132,90,6384,10241,8395,0,0,0,1,1
39133,90,6391,9317,8395,0,0,0,1,1
39134,90,6408,10353,8395,0,0,0,1,1
39135,90,6412,10088,8395,0,0,0,1,1
39136,90,6414,10097,8395,0,0,0,1,1
39137,90,6417,10523,8395,0,0,0,1,1
39138,90,6418,13803,8395,0,0,1,0,1
39139,90,6419,10144,8395,0,0,0,1,1
39140,90,6421,10149,8395,0,0,0,1,1
39141,90,6424,10109;10208,8395,0,0,0,2,2
39142,90,6430,10359,8395,0,0,0,1,1
39143,90,6431,10380,8395,0,0,0,1,1
39144,90,6433,10472,8395,0,0,0,1,1
39145,90,6434,10436,8395,0,0,0,1,1
39146,90,6435,10325,8395,0,0,0,1,1
39147,90,6436,12072;12660,8395,0,0,0,2,2
39148,90,6438,10578,8395,0,0,0,1,1
39149,90,6440,10646,8760,0,0,0,1,1
39150,90,6446,10085,8760,0,0,0,1,1
39151,90,6447,5433,8760,0,0,0,1,1
39152,90,6448,10399,8760,0,0,0,1,1
39153,90,6501,9506,8760,0,0,0,1,1
39154,90,6504,10020,8760,0,0,0,1,1
39155,90,6506,10066;10138,8760,0,0,0,2,2
39156,90,6508,10167;10250,8760,0,0,0,2,2
39157,90,6509,10579,8760,0,0,0,1,1
39158,90,6511,10747,8760,0,0,0,1,1
39159,90,6516,10423,8760,0,0,0,1,1
39160,90,6519,10590,8760,0,0,0,1,1
39161,90,6520,10505,8760,0,0,0,1,1
39162,90,6521,10895,8760,0,0,0,1,1
39163,90,6523,10513;10850,8760,0,0,0,2,2
39164,90,6524,10517;10661,8760,0,0,0,2,2
39165,90,6526,10797,8760,0,0,0,1,1
39166,90,6527,10534,8760,0,0,0,1,1
39167,90,6528,10547,8760,0,0,0,1,1
39168,90,6529,10563,8760,0,0,0,1,1
39169,90,6532,10595,8760,0,0,0,1,1
39170,90,6533,10350;10597,8760,0,0,0,2,2
39171,90,6541,10455,9125,0,0,0,1,1
39172,90,6557,10254,9125,0,0,0,1,1
39173,90,6564,10159,9125,0,0,0,1,1
39174,90,6571,10177,9125,0,0,0,1,1
39175,90,6578,1668,9125,0,0,0,1,1
39176,90,6589,10100,9125,0,0,0,1,1
39177,90,6592,10229;10485,9125,0,0,0,2,2
39178,90,6593,10194,9125,0,0,0,1,1
39179,90,6595,10207,9125,0,0,0,1,1
39180,90,6598,10481,9125,0,0,0,1,1
39181,90,6601,10628,9125,0,0,0,1,1
39182,90,6603,10392;10639,9125,0,0,0,2,2
39183,90,6604,10540;10672,9125,0,0,0,2,2
39184,90,6605,10650,9125,0,0,0,1,1
39185,90,6607,10988,9125,0,0,0,1,1
39186,90,6608,10739;10762,9125,0,0,0,2,2
39187,90,6609,10278;10418,9125,0,0,0,2,2
39188,90,6611,10866;11009,9125,0,0,0,2,2
39189,90,6612,10627,9125,0,0,0,1,1
39190,90,6613,10601,9125,0,0,0,1,1
39191,90,6616,10623,9125,0,0,0,1,1
39192,90,6618,10625,9125,0,0,0,1,1
39193,90,6620,10657;14556,9125,0,0,1,1,2
39194,90,6621,10675,9125,0,0,0,1,1
39195,90,6622,10677,9125,0,0,0,1,1
39196,90,6623,10626,9125,0,0,0,1,1
39197,90,6624,10681;10873,9125,0,0,0,2,2
39198,90,6673,6469,9490,0,0,0,1,1
39199,90,6684,10457,9490,0,0,0,1,1
39200,90,6687,10253;10510,9490,0,0,0,2,2
39201,90,6688,10508,9490,0,0,0,1,1
39202,90,6690,10190,9490,0,0,0,1,1
39203,90,6691,10376,9490,0,0,0,1,1
39204,90,6694,7530,9490,0,0,0,1,1
39205,90,6696,10445,9490,0,0,0,1,1
39206,90,6698,10459,9490,0,0,0,1,1
39207,90,6701,10792,9490,0,0,0,1,1
39208,90,6702,10503,9490,0,0,0,1,1
39209,90,6703,10546;13974,9490,0,0,1,1,2
39210,90,6704,10645,9490,0,0,0,1,1
39211,90,6705,10560,9490,0,0,0,1,1
39212,90,6706,10576;10799,9490,0,0,0,2,2
39213,90,6708,10585,9490,0,0,0,1,1
39214,90,6709,10592,9490,0,0,0,1,1
39215,90,6710,10528;10604,9490,0,0,0,2,2
39216,90,6711,10419,9490,0,0,0,1,1
39217,90,6712,10618;10885,9490,0,0,0,2,2
39218,90,6713,10259;10616,9490,0,0,0,2,2
39219,90,6714,10687,9490,0,0,0,1,1
39220,90,6715,10640,9490,0,0,0,1,1
39221,90,6716,10827,9490,0,0,0,1,1
39222,90,6717,10670,9490,0,0,0,1,1
39223,90,6718,10731,9490,0,0,0,1,1
39224,90,6719,10473,9490,0,0,0,1,1
39225,90,6720,10700,9490,0,0,0,1,1
39226,90,6721,11010,9490,0,0,0,1,1
39227,90,6722,11053,9490,0,0,0,1,1
39228,90,6723,10977,9490,0,0,0,1,1
39229,90,6725,10821,9490,0,0,0,1,1
39230,90,6754,4956,9855,0,0,0,1,1
39231,90,6757,14681;15177;19249,9855,0,1,2,0,3
39232,90,6774,10303;10430,9855,0,0,0,2,2
39233,90,6778,10294,9855,0,0,0,1,1
39234,90,6780,10341;10532,9855,0,0,0,2,2
39235,90,6781,10362,9855,0,0,0,1,1
39236,90,6782,10365,9855,0,0,0,1,1
39237,90,6786,10464,9855,0,0,0,1,1
39238,90,6787,10506,9855,0,0,0,1,1
39239,90,6789,10853,9855,0,0,0,1,1
39240,90,6791,10545,9855,0,0,0,1,1
39241,90,6794,10584,9855,0,0,0,1,1
39242,90,6797,10630;10701,9855,0,0,0,2,2
39243,90,6799,10892,9855,0,0,0,1,1
39244,90,6800,10654;10758,9855,0,0,0,2,2
39245,90,6801,10669,9855,0,0,0,1,1
39246,90,6802,10518;10703,9855,0,0,0,2,2
39247,90,6803,10551;10705,9855,0,0,0,2,2
39248,90,6805,11004;11052,9855,0,0,0,2,2
39249,90,6806,14404;18843,9855,0,0,2,0,2
39250,90,6807,10707;10785,9855,0,0,0,2,2
39251,90,6808,10582,9855,0,0,0,1,1
39252,90,6809,10442,9855,0,0,0,1,1
39253,90,6811,11025,9855,0,0,0,1,1
39254,90,6812,10847,9855,0,0,0,1,1
39255,90,6813,10889,9855,0,0,0,1,1
39256,90,6814,10899;10970,9855,0,0,0,2,2
39257,90,6815,10903;11197,9855,0,0,0,2,2
39258,90,6843,6348;10189,10220,0,0,0,2,2
39259,90,6860,10128;10282,10220,0,0,0,2,2
39260,90,6865,10385,10220,0,0,0,1,1
39261,90,6871,10784,10220,0,0,0,1,1
39262,90,6872,10228,10220,0,0,0,1,1
39263,90,6874,10728,10220,0,0,0,1,1
39264,90,6876,10694,10220,0,0,0,1,1
39265,90,6880,10888,10220,0,0,0,1,1
39266,90,6881,10898,10220,0,0,0,1,1
39267,90,6883,10948,10220,0,0,0,1,1
39268,90,6885,11195,10220,0,0,0,1,1
39269,90,6886,11088,10220,0,0,0,1,1
39270,90,6888,10771,10220,0,0,0,1,1
39271,90,6889,11137,10220,0,0,0,1,1
39272,90,6890,11144,10220,0,0,0,1,1
39273,90,6924,10683,10585,0,0,0,1,1
39274,90,6925,10408,10585,0,0,0,1,1
39275,90,6927,10782,10585,0,0,0,1,1
39276,90,6931,10462,10585,0,0,0,1,1
39277,90,6932,10567,10585,0,0,0,1,1
39278,90,6935,10709,10585,0,0,0,1,1
39279,90,6936,10857;11058,10585,0,0,0,2,2
39280,90,6937,10589;10822,10585,0,0,0,2,2
39281,90,6939,10487;10833,10585,0,0,0,2,2
39282,90,6940,10841,10585,0,0,0,1,1
39283,90,6941,10843,10585,0,0,0,1,1
39284,90,6944,10867,10585,0,0,0,1,1
39285,90,6945,10535,10585,0,0,0,1,1
39286,90,6946,10849,10585,0,0,0,1,1
39287,90,6947,11280;11344,10585,0,0,0,2,2
39288,90,6949,10770,10585,0,0,0,1,1
39289,90,6950,10893;11147,10585,0,0,0,2,2
39290,90,6951,10996;11018,10585,0,0,0,2,2
39291,90,6952,10714;11045,10585,0,0,0,2,2
39292,90,6953,11274,10585,0,0,0,1,1
39293,90,6956,11080,10585,0,0,0,1,1
39294,90,6957,11095;11343,10585,0,0,0,2,2
39295,90,6962,10010,10950,0,0,0,1,1
39296,90,6981,5301,10950,0,0,0,1,1
39297,90,6999,10231,10950,0,0,0,1,1
39298,90,7003,10378,10950,0,0,0,1,1
39299,90,7005,10394;10557,10950,0,0,0,2,2
39300,90,7007,10420,10950,0,0,0,1,1
39301,90,7009,10756,10950,0,0,0,1,1
39302,90,7010,11194,10950,0,0,0,1,1
39303,90,7012,10805,10950,0,0,0,1,1
39304,90,7013,10924;11074,10950,0,0,0,2,2
39305,90,7014,10342;10793,10950,0,0,0,2,2
39306,90,7015,10796,10950,0,0,0,1,1
39307,90,7017,10808,10950,0,0,0,1,1
39308,90,7019,11168,10950,0,0,0,1,1
39309,90,7022,11140;11296,10950,0,0,0,2,2
39310,90,7023,10912;11077,10950,0,0,0,2,2
39311,90,7024,10972;11174,10950,0,0,0,2,2
39312,90,7025,10851,10950,0,0,0,1,1
39313,90,7029,11005;11460,10950,0,0,0,2,2
39314,90,7030,10772;11006,10950,0,0,0,2,2
39315,90,7032,11035;11248,10950,0,0,0,2,2
39316,90,7033,11036,10950,0,0,0,1,1
39317,90,7034,11041,10950,0,0,0,1,1
39318,90,7035,11462,10950,0,0,0,1,1
39319,90,7036,11415,10950,0,0,0,1,1
39320,90,7037,11326,10950,0,0,0,1,1
39321,90,7039,11099,10950,0,0,0,1,1
39322,90,7040,11102,10950,0,0,0,1,1
39323,90,7041,11103,10950,0,0,0,1,1
39324,90,7042,11281,10950,0,0,0,1,1
39325,90,7043,11126,10950,0,0,0,1,1
39326,90,7044,11055;11128,10950,0,0,0,2,2
39327,90,7045,11029,10950,0,0,0,1,1
39328,90,7046,11159,10950,0,0,0,1,1
39329,90,7048,11154;11299,10950,0,0,0,2,2
39330,90,7049,11251,10950,0,0,0,1,1
39331,90,7050,11165;11409,10950,0,0,0,2,2
39332,90,7051,11339,10950,0,0,0,1,1
39333,90,7052,11261;14514,10950,0,0,1,1,2
39334,90,7065,3863;10242,11315,0,0,0,2,2
39335,90,7082,7410,11315,0,0,0,1,1
39336,90,7093,10388,11315,0,0,0,1,1
39337,90,7095,10279,11315,0,0,0,1,1
39338,90,7099,10360,11315,0,0,0,1,1
39339,90,7100,10441,11315,0,0,0,1,1
39340,90,7101,10794,11315,0,0,0,1,1
39341,90,7102,10361,11315,0,0,0,1,1
39342,90,7103,10638,11315,0,0,0,1,1
39343,90,7104,10598,11315,0,0,0,1,1
39344,90,7105,11023;11277,11315,0,0,0,2,2
39345,90,7107,10617,11315,0,0,0,1,1
39346,90,7108,10991,11315,0,0,0,1,1
39347,90,7110,10743;11061,11315,0,0,0,2,2
39348,90,7111,10778;10802,11315,0,0,0,2,2
39349,90,7114,10901,11315,0,0,0,1,1
39350,90,7115,11087,11315,0,0,0,1,1
39351,90,7117,10931,11315,0,0,0,1,1
39352,90,7118,10936;11158,11315,0,0,0,2,2
39353,90,7119,10943,11315,0,0,0,1,1
39354,90,7120,10910;10974,11315,0,0,0,2,2
39355,90,7121,10976,11315,0,0,0,1,1
39356,90,7123,10990;11007,11315,0,0,0,2,2
39357,90,7125,11244;11526,11315,0,0,0,2,2
39358,90,7126,11051;11084,11315,0,0,0,2,2
39359,90,7127,10815,11315,0,0,0,1,1
39360,90,7128,10699;11105,11315,0,0,0,2,2
39361,90,7130,10969,11315,0,0,0,1,1
39362,90,7132,11136,11315,0,0,0,1,1
39363,90,7133,11186;11189,11315,0,0,0,2,2
39364,90,7135,10949;11249,11315,0,0,0,2,2
39365,90,7136,11271,11315,0,0,0,1,1
39366,90,7137,11278,11315,0,0,0,1,1
39367,90,7149,10298,11680,0,0,0,1,1
39368,90,7165,9316,11680,0,0,0,1,1
39369,90,7169,10356,11680,0,0,0,1,1
39370,90,7172,10512,11680,0,0,0,1,1
39371,90,7174,11240,11680,0,0,0,1,1
39372,90,7175,10835,11680,0,0,0,1,1
39373,90,7176,10593,11680,0,0,0,1,1
39374,90,7178,10973,11680,0,0,0,1,1
39375,90,7179,11222,11680,0,0,0,1,1
39376,90,7180,10834;11062,11680,0,0,0,2,2
39377,90,7181,10862;11015,11680,0,0,0,2,2
39378,90,7182,10559;10773,11680,0,0,0,2,2
39379,90,7183,10471;10780,11680,0,0,0,2,2
39380,90,7185,10732;10869,11680,0,0,0,2,2
39381,90,7186,10659;10880,11680,0,0,0,2,2
39382,90,7187,10884,11680,0,0,0,1,1
39383,90,7188,10945;11063,11680,0,0,0,2,2
39384,90,7189,10938,11680,0,0,0,1,1
39385,90,7190,10451;10954,11680,0,0,0,2,2
39386,90,7192,10994;11149,11680,0,0,0,2,2
39387,90,7193,10804;10982,11680,0,0,0,2,2
39388,90,7194,11694,11680,0,0,0,1,1
39389,90,7195,11496;12099,11680,0,0,0,2,2
39390,90,7196,11112,11680,0,0,0,1,1
39391,90,7198,11586,11680,0,0,0,1,1
39392,90,7199,11352,11680,0,0,0,1,1
39393,90,7200,10752;10870,11680,0,0,0,2,2
39394,90,7201,11121;11211,11680,0,0,0,2,2
39395,90,7202,11213,11680,0,0,0,1,1
39396,90,7203,11692,11680,0,0,0,1,1
39397,90,7204,11689;16879,11680,0,0,1,1,2
39398,90,7206,11256;11562,11680,0,0,0,2,2
39399,90,7207,11288,11680,0,0,0,1,1
39400,90,7208,11392;11550,11680,0,0,0,2,2
39401,90,7210,11303,11680,0,0,0,1,1
39402,90,7211,10410;13670,11680,0,0,1,1,2
39403,90,7212,11587,11680,0,0,0,1,1
39404,90,7213,15004;20025,11680,0,1,1,0,2
39405,90,7214,11353;11630,11680,0,0,0,2,2
39406,90,7215,11366,11680,0,0,0,1,1
39407,90,7216,11224,11680,0,0,0,1,1
39408,90,7218,11387;11571,11680,0,0,0,2,2
39409,90,7243,170,12045,0,0,0,1,1
39410,90,7259,10263,12045,0,0,0,1,1
39411,90,7260,11002,12045,0,0,0,1,1
39412,90,7266,10575;10614,12045,0,0,0,2,2
39413,90,7268,10622;10902,12045,0,0,0,2,2
39414,90,7269,10666,12045,0,0,0,1,1
39415,90,7275,10478,12045,0,0,0,1,1
39416,90,7276,10753,12045,0,0,0,1,1
39417,90,7278,10831,12045,0,0,0,1,1
39418,90,7279,10809,12045,0,0,0,1,1
39419,90,7280,10854;11273,12045,0,0,0,2,2
39420,90,7282,10894,12045,0,0,0,1,1
39421,90,7283,10905,12045,0,0,0,1,1
39422,90,7286,11206;11308,12045,0,0,0,2,2
39423,90,7287,11135,12045,0,0,0,1,1
39424,90,7288,11057;11059,12045,0,0,0,2,2
39425,90,7290,11292,12045,0,0,0,1,1
39426,90,7292,11442,12045,0,0,0,1,1
39427,90,7293,10658,12045,0,0,0,1,1
39428,90,7295,10986;11203,12045,0,0,0,2,2
39429,90,7296,11556,12045,0,0,0,1,1
39430,90,7297,11208,12045,0,0,0,1,1
39431,90,7298,11209;11320,12045,0,0,0,2,2
39432,90,7299,11279;11597,12045,0,0,0,2,2
39433,90,7300,11090;11225,12045,0,0,0,2,2
39434,90,7301,11307,12045,0,0,0,1,1
39435,90,7305,11294,12045,0,0,0,1,1
39436,90,7306,11495,12045,0,0,0,1,1
39437,90,7307,11328;11528,12045,0,0,0,2,2
39438,90,7308,11720;11773,12045,0,0,0,2,2
39439,90,7309,11350,12045,0,0,0,1,1
39440,90,7310,11119;11356,12045,0,0,0,2,2
39441,90,7311,11270;11379,12045,0,0,0,2,2
39442,90,7313,11751,12045,0,0,0,1,1
39443,90,7314,11405;11457,12045,0,0,0,2,2
39444,90,7315,11377,12045,0,0,0,1,1
39445,90,7316,11637;11681,12045,0,0,0,2,2
39446,90,7317,11469,12045,0,0,0,1,1
39447,90,7318,11447;11478,12045,0,0,0,2,2
39448,90,7319,11458;11518,12045,0,0,0,2,2
39449,90,7320,11468,12045,0,0,0,1,1
39450,90,7321,11481,12045,0,0,0,1,1
39451,90,7322,11482,12045,0,0,0,1,1
39452,90,7361,3481,12410,0,0,0,1,1
39453,90,7364,10318,12410,0,0,0,1,1
39454,90,7365,14424,12410,0,0,1,0,1
39455,90,7366,10415,12410,0,0,0,1,1
39456,90,7367,10868;11337,12410,0,0,0,2,2
39457,90,7368,11310,12410,0,0,0,1,1
39458,90,7369,10721;10760,12410,0,0,0,2,2
39459,90,7370,10964,12410,0,0,0,1,1
39460,90,7371,10951,12410,0,0,0,1,1
39461,90,7372,11028,12410,0,0,0,1,1
39462,90,7373,10587,12410,0,0,0,1,1
39463,90,7376,11198;11375,12410,0,0,0,2,2
39464,90,7377,10937,12410,0,0,0,1,1
39465,90,7378,11506,12410,0,0,0,1,1
39466,90,7379,11217,12410,0,0,0,1,1
39467,90,7380,10917;11030,12410,0,0,0,2,2
39468,90,7382,10929;11092,12410,0,0,0,2,2
39469,90,7383,11312,12410,0,0,0,1,1
39470,90,7384,11124,12410,0,0,0,1,1
39471,90,7385,11422,12410,0,0,0,1,1
39472,90,7387,11220;11376,12410,0,0,0,2,2
39473,90,7388,11613,12410,0,0,0,1,1
39474,90,7389,11205;11549,12410,0,0,0,2,2
39475,90,7390,11262,12410,0,0,0,1,1
39476,90,7391,11615,12410,0,0,0,1,1
39477,90,7392,11003;11265,12410,0,0,0,2,2
39478,90,7393,11686;11825,12410,0,0,0,2,2
39479,90,7394,11100;11313,12410,0,0,0,2,2
39480,90,7397,11438,12410,0,0,0,1,1
39481,90,7399,11436,12410,0,0,0,1,1
39482,90,7400,11079;11452,12410,0,0,0,2,2
39483,90,7401,11382;11486,12410,0,0,0,2,2
39484,90,7402,11497,12410,0,0,0,1,1
39485,90,7403,11503,12410,0,0,0,1,1
39486,90,7404,11611;11809,12410,0,0,0,2,2
39487,90,7407,11163;11687,12410,0,0,0,2,2
39488,90,7408,11535;11589,12410,0,0,0,2,2
39489,90,7409,11302;11593,12410,0,0,0,2,2
39490,90,7441,10470;10566,12775,0,0,0,2,2
39491,90,7446,10346;10663,12775,0,0,0,2,2
39492,90,7450,11081;11236,12775,0,0,0,2,2
39493,90,7451,11266,12775,0,0,0,1,1
39494,90,7452,11428;11570,12775,0,0,0,2,2
39495,90,7453,11160,12775,0,0,0,1,1
39496,90,7454,11085,12775,0,0,0,1,1
39497,90,7455,11283,12775,0,0,0,1,1
39498,90,7456,11107,12775,0,0,0,1,1
39499,90,7457,11108;11563,12775,0,0,0,2,2
39500,90,7459,11138,12775,0,0,0,1,1
39501,90,7461,11210;11902,12775,0,0,0,2,2
39502,90,7462,11448,12775,0,0,0,1,1
39503,90,7464,11199;11272,12775,0,0,0,2,2
39504,90,7465,11654;11759,12775,0,0,0,2,2
39505,90,7466,11096;11461,12775,0,0,0,2,2
39506,90,7467,11901,12775,0,0,0,1,1
39507,90,7468,11345;11639,12775,0,0,0,2,2
39508,90,7469,11361,12775,0,0,0,1,1
39509,90,7470,11619;11813,12775,0,0,0,2,2
39510,90,7471,11380;11920,12775,0,0,0,2,2
39511,90,7472,11397,12775,0,0,0,1,1
39512,90,7473,11651,12775,0,0,0,1,1
39513,90,7475,11404;11969,12775,0,0,0,2,2
39514,90,7476,11386;11411,12775,0,0,0,2,2
39515,90,7477,11252;11431,12775,0,0,0,2,2
39516,90,7478,11928,12775,0,0,0,1,1
39517,90,7479,11491;11662,12775,0,0,0,2,2
39518,90,7480,11488;11500,12775,0,0,0,2,2
39519,90,7482,11505;11509,12775,0,0,0,2,2
39520,90,7484,11511;11707,12775,0,0,0,2,2
39521,90,7485,11514;12025,12775,0,0,0,2,2
39522,90,7486,11614,12775,0,0,0,1,1
39523,90,7487,11724,12775,0,0,0,1,1
39524,90,7488,11740;11832,12775,0,0,0,2,2
39525,90,7489,11360;11640,12775,0,0,0,2,2
39526,90,7491,11683,12775,0,0,0,1,1
39527,90,7519,11044,13140,0,0,0,1,1
39528,90,7520,10680;10876,13140,0,0,0,2,2
39529,90,7522,10667;11071,13140,0,0,0,2,2
39530,90,7523,10863;11182,13140,0,0,0,2,2
39531,90,7524,10607,13140,0,0,0,1,1
39532,90,7525,10340;10740,13140,0,0,0,2,2
39533,90,7527,10837,13140,0,0,0,1,1
39534,90,7529,10920,13140,0,0,0,1,1
39535,90,7530,11014;11190,13140,0,0,0,2,2
39536,90,7531,11022;11151,13140,0,0,0,2,2
39537,90,7534,11078,13140,0,0,0,1,1
39538,90,7535,11425,13140,0,0,0,1,1
39539,90,7536,11167;11407,13140,0,0,0,2,2
39540,90,7537,11173;11684,13140,0,0,0,2,2
39541,90,7538,11176,13140,0,0,0,1,1
39542,90,7539,11038,13140,0,0,0,1,1
39543,90,7541,11752,13140,0,0,0,1,1
39544,90,7542,11237,13140,0,0,0,1,1
39545,90,7543,11498,13140,0,0,0,1,1
39546,90,7544,11311,13140,0,0,0,1,1
39547,90,7545,11097,13140,0,0,0,1,1
39548,90,7546,10962;11341,13140,0,0,0,2,2
39549,90,7548,11889,13140,0,0,0,1,1
39550,90,7551,11466;11480,13140,0,0,0,2,2
39551,90,7552,11625;11879,13140,0,0,0,2,2
39552,90,7553,11017;11504,13140,0,0,0,2,2
39553,90,7554,11507,13140,0,0,0,1,1
39554,90,7555,11304;11512,13140,0,0,0,2,2
39555,90,7556,12003,13140,0,0,0,1,1
39556,90,7557,11551;11980,13140,0,0,0,2,2
39557,90,7558,11559,13140,0,0,0,1,1
39558,90,7559,11938,13140,0,0,0,1,1
39559,90,7560,11414;11579,13140,0,0,0,2,2
39560,90,7561,11595,13140,0,0,0,1,1
39561,90,7562,11446;11616;15684,13140,0,0,1,2,3
39562,90,7563,12068,13140,0,0,0,1,1
39563,90,7564,11398,13140,0,0,0,1,1
39564,90,7565,11629;11657,13140,0,0,0,2,2
39565,90,7567,11691;11700,13140,0,0,0,2,2
39566,90,7568,12086,13140,0,0,0,1,1
39567,90,7569,11712;11887,13140,0,0,0,2,2
39568,90,7570,11650;11742,13140,0,0,0,2,2
39569,90,7571,11763,13140,0,0,0,1,1
39570,90,7572,11325;11783,13140,0,0,0,2,2
39571,90,7573,11665,13140,0,0,0,1,1
39572,90,7580,2176,13505,0,0,0,1,1
39573,90,7607,10387,13505,0,0,0,1,1
39574,90,7608,10653,13505,0,0,0,1,1
39575,90,7615,10729;11115,13505,0,0,0,2,2
39576,90,7617,10686;10725,13505,0,0,0,2,2
39577,90,7619,11364,13505,0,0,0,1,1
39578,90,7621,10814,13505,0,0,0,1,1
39579,90,7624,11419;11795,13505,0,0,0,2,2
39580,90,7625,11239,13505,0,0,0,1,1
39581,90,7626,11317;11760,13505,0,0,0,2,2
39582,90,7627,11354;11703,13505,0,0,0,2,2
39583,90,7628,11622;11863,13505,0,0,0,2,2
39584,90,7629,11421;11585,13505,0,0,0,2,2
39585,90,7630,11788,13505,0,0,0,1,1
39586,90,7631,11439,13505,0,0,0,1,1
39587,90,7632,11525;11935,13505,0,0,0,2,2
39588,90,7633,11576;11666,13505,0,0,0,2,2
39589,90,7634,11848;11890,13505,0,0,0,2,2
39590,90,7635,11456,13505,0,0,0,1,1
39591,90,7636,12053,13505,0,0,0,1,1
39592,90,7637,11474,13505,0,0,0,1,1
39593,90,7638,11638,13505,0,0,0,1,1
39594,90,7640,11523;11842,13505,0,0,0,2,2
39595,90,7641,11094;11357,13505,0,0,0,2,2
39596,90,7643,11828;11876,13505,0,0,0,2,2
39597,90,7645,11761;11817,13505,0,0,0,2,2
39598,90,7646,11489,13505,0,0,0,1,1
39599,90,7647,11774;11886,13505,0,0,0,2,2
39600,90,7648,11698;12091,13505,0,0,0,2,2
39601,90,7649,12069;17033,13505,0,0,1,1,2
39602,90,7650,12087,13505,0,0,0,1,1
39603,90,7652,11470;11734,13505,0,0,0,2,2
39604,90,7653,11750;12274,13505,0,0,0,2,2
39605,90,7654,11762;11778,13505,0,0,0,2,2
39606,90,7655,11769,13505,0,0,0,1,1
39607,90,7656,11771,13505,0,0,0,1,1
39608,90,7657,12135,13505,0,0,0,1,1
39609,90,7659,11815;16999,13505,0,0,1,1,2
39610,90,7660,11999,13505,0,0,0,1,1
39611,90,7661,11620;11834,13505,0,0,0,2,2
39612,90,7663,11855,13505,0,0,0,1,1
39613,90,7664,12175,13505,0,0,0,1,1
39614,90,7665,12029,13505,0,0,0,1,1
39615,90,7666,11757;12067,13505,0,0,0,2,2
39616,90,7667,11966,13505,0,0,0,1,1
39617,90,7672,14838,13870,0,0,1,0,1
39618,90,7691,5787,13870,0,0,0,1,1
39619,90,7704,10552,13870,0,0,0,1,1
39620,90,7706,15512,13870,0,0,1,0,1
39621,90,7707,10900,13870,0,0,0,1,1
39622,90,7708,10715,13870,0,0,0,1,1
39623,90,7711,10829,13870,0,0,0,1,1
39624,90,7712,11101;11557,13870,0,0,0,2,2
39625,90,7713,10641;10855,13870,0,0,0,2,2
39626,90,7717,11632;11655,13870,0,0,0,2,2
39627,90,7719,11114;11963,13870,0,0,0,2,2
39628,90,7720,11402;11412,13870,0,0,0,2,2
39629,90,7721,11127;11245,13870,0,0,0,2,2
39630,90,7722,11538,13870,0,0,0,1,1
39631,90,7725,11427;11618,13870,0,0,0,2,2
39632,90,7726,11314,13870,0,0,0,1,1
39633,90,7727,11338;11607,13870,0,0,0,2,2
39634,90,7728,11355;11385,13870,0,0,0,2,2
39635,90,7729,11609,13870,0,0,0,1,1
39636,90,7730,11729;11905,13870,0,0,0,2,2
39637,90,7731,11499,13870,0,0,0,1,1
39638,90,7732,11674;11996,13870,0,0,0,2,2
39639,90,7733,11524,13870,0,0,0,1,1
39640,90,7734,11530;11914;16231,13870,0,0,1,2,3
39641,90,7736,11300;11728,13870,0,0,0,2,2
39642,90,7737,16203;16239,13870,0,0,2,0,2
39643,90,7738,11641;11821,13870,0,0,0,2,2
39644,90,7739,11645;11731,13870,0,0,0,2,2
39645,90,7740,11232;11658,13870,0,0,0,2,2
39646,90,7741,11679,13870,0,0,0,1,1
39647,90,7742,11532;11690,13870,0,0,0,2,2
39648,90,7744,11792;16524,13870,0,0,1,1,2
39649,90,7745,11732;12042,13870,0,0,0,2,2
39650,90,7746,11739;11775,13870,0,0,0,2,2
39651,90,7747,11779,13870,0,0,0,1,1
39652,90,7749,11806;12114,13870,0,0,0,2,2
39653,90,7750,11743,13870,0,0,0,1,1
39654,90,7751,11924,13870,0,0,0,1,1
39655,90,7752,12019,13870,0,0,0,1,1
39656,90,7753,11069;11869,13870,0,0,0,2,2
39657,90,7754,11856;12204,13870,0,0,0,2,2
39658,90,7755,11709;11835,13870,0,0,0,2,2
39659,90,7756,11881,13870,0,0,0,1,1
39660,90,7757,11406;11704,13870,0,0,0,2,2
39661,90,7758,11661,13870,0,0,0,1,1
39662,90,7759,11908;12203;15080,13870,0,0,1,2,3
39663,90,7761,11940;12043,13870,0,0,0,2,2
39664,90,7762,11606;11941,13870,0,0,0,2,2
39665,90,7763,11922;11945,13870,0,0,0,2,2
39666,90,7764,12002;12308,13870,0,0,0,2,2
39667,90,7765,11699,13870,0,0,0,1,1
39668,90,7766,12098,13870,0,0,0,1,1
39669,90,7807,10581,14235,0,0,0,1,1
39670,90,7809,10522,14235,0,0,0,1,1
39671,90,7810,10913,14235,0,0,0,1,1
39672,90,7812,10939,14235,0,0,0,1,1
39673,90,7813,10923;11221,14235,0,0,0,2,2
39674,90,7814,10499;10774,14235,0,0,0,2,2
39675,90,7816,11129,14235,0,0,0,1,1
39676,90,7817,11463;11577,14235,0,0,0,2,2
39677,90,7821,11164,14235,0,0,0,1,1
39678,90,7822,11484;14988,14235,0,0,1,1,2
39679,90,7823,12052,14235,0,0,0,1,1
39680,90,7824,11340;11591,14235,0,0,0,2,2
39681,90,7825,11342,14235,0,0,0,1,1
39682,90,7826,11250;11371,14235,0,0,0,2,2
39683,90,7827,11401,14235,0,0,0,1,1
39684,90,7828,11565;11574,14235,0,0,0,2,2
39685,90,7829,11169;11513,14235,0,0,0,2,2
39686,90,7830,11464,14235,0,0,0,1,1
39687,90,7831,11711;11910,14235,0,0,0,2,2
39688,90,7832,12137;15905,14235,0,0,1,1,2
39689,90,7834,11993;12080,14235,0,0,0,2,2
39690,90,7835,11716;12326,14235,0,0,0,2,2
39691,90,7836,11719,14235,0,0,0,1,1
39692,90,7838,12352;12424,14235,0,0,0,2,2
39693,90,7839,11755;12144;18058,14235,0,0,1,2,3
39694,90,7841,11900,14235,0,0,0,1,1
39695,90,7842,11776;12008,14235,0,0,0,2,2
39696,90,7843,11799,14235,0,0,0,1,1
39697,90,7844,12011;12142,14235,0,0,0,2,2
39698,90,7845,11836,14235,0,0,0,1,1
39699,90,7846,12357,14235,0,0,0,1,1
39700,90,7848,11971,14235,0,0,0,1,1
39701,90,7849,11894;11975,14235,0,0,0,2,2
39702,90,7850,11870,14235,0,0,0,1,1
39703,90,7851,11990;12331,14235,0,0,0,2,2
39704,90,7852,12223,14235,0,0,0,1,1
39705,90,7853,12018;12272;17435,14235,0,0,1,2,3
39706,90,7854,11853;12151,14235,0,0,0,2,2
39707,90,7855,11918;12149,14235,0,0,0,2,2
39708,90,7857,12073;12305,14235,0,0,0,2,2
39709,90,7858,11673;12075,14235,0,0,0,2,2
39710,90,7859,12208;12249,14235,0,0,0,2,2
39711,90,7860,11560;12117,14235,0,0,0,2,2
39712,90,7892,10985,14600,0,0,0,1,1
39713,90,7895,10556;10877,14600,0,0,0,2,2
39714,90,7898,11494,14600,0,0,0,1,1
39715,90,7901,11233,14600,0,0,0,1,1
39716,90,7902,11046,14600,0,0,0,1,1
39717,90,7904,11348;11668,14600,0,0,0,2,2
39718,90,7905,11365,14600,0,0,0,1,1
39719,90,7908,11434,14600,0,0,0,1,1
39720,90,7909,11275,14600,0,0,0,1,1
39721,90,7910,11487,14600,0,0,0,1,1
39722,90,7912,11664,14600,0,0,0,1,1
39723,90,7913,11838,14600,0,0,0,1,1
39724,90,7914,11708;12076,14600,0,0,0,2,2
39725,90,7915,11675,14600,0,0,0,1,1
39726,90,7916,11718,14600,0,0,0,1,1
39727,90,7919,11912,14600,0,0,0,1,1
39728,90,7920,11831;12378,14600,0,0,0,2,2
39729,90,7921,11841;12340,14600,0,0,0,2,2
39730,90,7922,11416;11849,14600,0,0,0,2,2
39731,90,7923,12022,14600,0,0,0,1,1
39732,90,7924,11368;11896,14600,0,0,0,2,2
39733,90,7925,11992;12167,14600,0,0,0,2,2
39734,90,7926,12040,14600,0,0,0,1,1
39735,90,7928,11967;12314,14600,0,0,0,2,2
39736,90,7929,12406;12489,14600,0,0,0,2,2
39737,90,7930,11730;12001,14600,0,0,0,2,2
39738,90,7931,12161;12377,14600,0,0,0,2,2
39739,90,7932,11880;12031,14600,0,0,0,2,2
39740,90,7933,12063;12202,14600,0,0,0,2,2
39741,90,7934,12089,14600,0,0,0,1,1
39742,90,7936,12013;12092,14600,0,0,0,2,2
39743,90,7937,16429;16442;20635;20824,14600,2,0,2,0,4
39744,90,7941,12128,14600,0,0,0,1,1
39745,90,7942,12140;12147,14600,0,0,0,2,2
39746,90,7943,12183,14600,0,0,0,1,1
39747,90,7944,11933;12155,14600,0,0,0,2,2
39748,90,7945,12449;12587,14600,0,0,0,2,2
39749,90,7946,11798;12141,14600,0,0,0,2,2
39750,90,7947,11846;12230,14600,0,0,0,2,2
39751,90,7948,12233,14600,0,0,0,1,1
39752,90,7950,12554;12658;18098,14600,0,0,1,2,3
39753,90,7984,10710,14965,0,0,0,1,1
39754,90,7986,10874,14965,0,0,0,1,1
39755,90,7987,11117;11394,14965,0,0,0,2,2
39756,90,7990,11162,14965,0,0,0,1,1
39757,90,7992,11710;11796;16680,14965,0,0,1,2,3
39758,90,7994,11564;11604,14965,0,0,0,2,2
39759,90,7995,10911;11553,14965,0,0,0,2,2
39760,90,7996,12239;12258,14965,0,0,0,2,2
39761,90,7997,11864,14965,0,0,0,1,1
39762,90,7998,11617;11943,14965,0,0,0,2,2
39763,90,7999,11319;11612,14965,0,0,0,2,2
39764,90,8000,11780;12317,14965,0,0,0,2,2
39765,90,8001,11534;11801,14965,0,0,0,2,2
39766,90,8002,12493,14965,0,0,0,1,1
39767,90,8003,12730,14965,0,0,0,1,1
39768,90,8004,11847,14965,0,0,0,1,1
39769,90,8005,11818;12125;16535,14965,0,0,1,2,3
39770,90,8006,11961;16726,14965,0,0,1,1,2
39771,90,8007,11973;12066;16773,14965,0,0,1,2,3
39772,90,8008,11983,14965,0,0,0,1,1
39773,90,8009,11985;12162,14965,0,0,0,2,2
39774,90,8010,12107,14965,0,0,0,1,1
39775,90,8012,12207;12459,14965,0,0,0,2,2
39776,90,8013,12599,14965,0,0,0,1,1
39777,90,8014,12103;12221,14965,0,0,0,2,2
39778,90,8015,12226;12353,14965,0,0,0,2,2
39779,90,8016,12256,14965,0,0,0,1,1
39780,90,8017,12344;18295,14965,0,0,1,1,2
39781,90,8018,12543;12629,14965,0,0,0,2,2
39782,90,8019,12286;12603,14965,0,0,0,2,2
39783,90,8020,12490;12665,14965,0,0,0,2,2
39784,90,8022,12218;12435,14965,0,0,0,2,2
39785,90,8023,12118;12330,14965,0,0,0,2,2
39786,90,8024,12648,14965,0,0,0,1,1
39787,90,8025,12349,14965,0,0,0,1,1
39788,90,8026,12251;12370,14965,0,0,0,2,2
39789,90,8027,12355,14965,0,0,0,1,1
39790,90,8031,10414,15330,0,0,0,1,1
39791,90,8061,10858,15330,0,0,0,1,1
39792,90,8063,10608;10823,15330,0,0,0,2,2
39793,90,8067,10767,15330,0,0,0,1,1
39794,90,8069,10733;10940,15330,0,0,0,2,2
39795,90,8072,10860,15330,0,0,0,1,1
39796,90,8073,11569;11653,15330,0,0,0,2,2
39797,90,8075,11646;11663,15330,0,0,0,2,2
39798,90,8076,11367;12146,15330,0,0,0,2,2
39799,90,8077,11521,15330,0,0,0,1,1
39800,90,8078,11696;11823,15330,0,0,0,2,2
39801,90,8079,11418;11454;15065,15330,0,0,1,2,3
39802,90,8080,11490,15330,0,0,0,1,1
39803,90,8081,11445,15330,0,0,0,1,1
39804,90,8082,11594;12044,15330,0,0,0,2,2
39805,90,8083,11260;11575,15330,0,0,0,2,2
39806,90,8084,12219,15330,0,0,0,1,1
39807,90,8085,11659,15330,0,0,0,1,1
39808,90,8086,11915,15330,0,0,0,1,1
39809,90,8087,11301;11705,15330,0,0,0,2,2
39810,90,8090,11844;11968,15330,0,0,0,2,2
39811,90,8091,12048,15330,0,0,0,1,1
39812,90,8092,11359;11558;15759,15330,0,0,1,2,3
39813,90,8096,11789;11937,15330,0,0,0,2,2
39814,90,8097,11948;12403,15330,0,0,0,2,2
39815,90,8098,11747;11952,15330,0,0,0,2,2
39816,90,8099,11958,15330,0,0,0,1,1
39817,90,8100,12174,15330,0,0,0,1,1
39818,90,8101,12028,15330,0,0,0,1,1
39819,90,8102,11932,15330,0,0,0,1,1
39820,90,8103,11959;12050;17683,15330,0,0,1,2,3
39821,90,8104,12060,15330,0,0,0,1,1
39822,90,8106,12171;12488,15330,0,0,0,2,2
39823,90,8107,12266;12284,15330,0,0,0,2,2
39824,90,8108,11929;12182,15330,0,0,0,2,2
39825,90,8109,12714,15330,0,0,0,1,1
39826,90,8110,12241,15330,0,0,0,1,1
39827,90,8111,11677;12032,15330,0,0,0,2,2
39828,90,8112,12088;12235,15330,0,0,0,2,2
39829,90,8113,12139,15330,0,0,0,1,1
39830,90,8115,12630;12801,15330,0,0,0,2,2
39831,90,8116,11837;12374,15330,0,0,0,2,2
39832,90,8117,11839;12397,15330,0,0,0,2,2
39833,90,8119,11974;12450,15330,0,0,0,2,2
39834,90,8120,12479;15352;16367,15330,0,0,2,1,3
39835,90,8121,50;135,15695,0,0,0,2,2
39836,90,8148,10649;11118,15695,0,0,0,2,2
39837,90,8149,10474,15695,0,0,0,1,1
39838,90,8151,11429;16307,15695,0,0,1,1,2
39839,90,8152,10933,15695,0,0,0,1,1
39840,90,8154,10971;11123,15695,0,0,0,2,2
39841,90,8155,11072;11413,15695,0,0,0,2,2
39842,90,8156,11083;11219,15695,0,0,0,2,2
39843,90,8161,11787,15695,0,0,0,1,1
39844,90,8163,11596;12026,15695,0,0,0,2,2
39845,90,8164,12188,15695,0,0,0,1,1
39846,90,8165,11215;11600,15695,0,0,0,2,2
39847,90,8167,12321,15695,0,0,0,1,1
39848,90,8168,11892;11994,15695,0,0,0,2,2
39849,90,8169,11772;11909,15695,0,0,0,2,2
39850,90,8170,11635;12061,15695,0,0,0,2,2
39851,90,8171,12045,15695,0,0,0,1,1
39852,90,8172,11991,15695,0,0,0,1,1
39853,90,8174,12038;12071,15695,0,0,0,2,2
39854,90,8175,12341,15695,0,0,0,1,1
39855,90,8176,12318,15695,0,0,0,1,1
39856,90,8177,12101;12566,15695,0,0,0,2,2
39857,90,8178,12110;12546,15695,0,0,0,2,2
39858,90,8179,12121,15695,0,0,0,1,1
39859,90,8180,11824,15695,0,0,0,1,1
39860,90,8182,16651;16940;17336;20957,15695,1,0,3,0,4
39861,90,8183,12312;12350,15695,0,0,0,2,2
39862,90,8184,12935,15695,0,0,1,0,1
39863,90,8185,12236,15695,0,0,0,1,1
39864,90,8186,12688,15695,0,0,0,1,1
39865,90,8187,12090;12608,15695,0,0,0,2,2
39866,90,8188,12319;12644;17736;18312,15695,0,0,2,2,4
39867,90,8189,12812;12836;15509,15695,0,0,1,2,3
39868,90,8190,16550;20963,15695,1,0,1,0,2
39869,90,8191,12755,15695,0,0,0,1,1
39870,90,8192,12536,15695,0,0,0,1,1
39871,90,8193,12392,15695,0,0,0,1,1
39872,90,8194,12287;12684,15695,0,0,0,2,2
39873,90,8195,12240;12436,15695,0,0,0,2,2
39874,90,8196,12473;13241,15695,0,0,1,1,2
39875,90,8197,12529;12901,15695,0,0,1,1,2
39876,90,8198,12365;12386,15695,0,0,0,2,2
39877,90,8199,12496,15695,0,0,0,1,1
39878,90,8200,12414;12581,15695,0,0,0,2,2
39879,90,8201,12795;12815,15695,0,0,0,2,2
39880,90,8202,12486;12540;18011,15695,0,0,1,2,3
39881,90,8203,12385;12559,15695,0,0,0,2,2
39882,90,8204,12432,15695,0,0,0,1,1
39883,90,8205,13074,15695,0,0,1,0,1
39884,90,8206,12516;12871;16961,15695,0,0,2,1,3
39885,90,8208,12519,15695,0,0,0,1,1
39886,90,8209,12194;12617,15695,0,0,0,2,2
39887,90,8237,10443,16060,0,0,0,1,1
39888,90,8244,11293;11777,16060,0,0,0,2,2
39889,90,8246,11791,16060,0,0,0,1,1
39890,90,8247,12210;12866,16060,0,0,0,2,2
39891,90,8249,11649;12035,16060,0,0,0,2,2
39892,90,8251,11793;12078,16060,0,0,0,2,2
39893,90,8252,11098,16060,0,0,0,1,1
39894,90,8253,11977,16060,0,0,0,1,1
39895,90,8254,11957;12132,16060,0,0,0,2,2
39896,90,8256,11784;11936;16597,16060,0,0,1,2,3
39897,90,8257,11814;12021,16060,0,0,0,2,2
39898,90,8258,11867;12124,16060,0,0,0,2,2
39899,90,8259,11794;15760,16060,0,0,1,1,2
39900,90,8262,12430;12625;16804,16060,0,0,1,2,3
39901,90,8263,12720;12807,16060,0,0,0,2,2
39902,90,8264,11917,16060,0,0,0,1,1
39903,90,8266,12873;16886,16060,0,0,2,0,2
39904,90,8267,11714;11875,16060,0,0,0,2,2
39905,90,8268,12096;12294,16060,0,0,0,2,2
39906,90,8269,12495;12705,16060,0,0,0,2,2
39907,90,8270,11872;11949;16920,16060,0,0,1,2,3
39908,90,8271,12010;12129,16060,0,0,0,2,2
39909,90,8272,12184,16060,0,0,0,1,1
39910,90,8273,12005;12195,16060,0,0,0,2,2
39911,90,8275,11860,16060,0,0,0,1,1
39912,90,8276,12260,16060,0,0,0,1,1
39913,90,8277,12434,16060,0,0,0,1,1
39914,90,8278,12332;12745,16060,0,0,0,2,2
39915,90,8279,12289;12367,16060,0,0,0,2,2
39916,90,8280,12407,16060,0,0,0,1,1
39917,90,8281,12384,16060,0,0,0,1,1
39918,90,8282,12889;12963,16060,0,0,2,0,2
39919,90,8283,12735,16060,0,0,0,1,1
39920,90,8284,12420;12517;16819,16060,0,0,1,2,3
39921,90,8285,12238;12427,16060,0,0,0,2,2
39922,90,8286,12460,16060,0,0,0,1,1
39923,90,8287,12719;12753,16060,0,0,0,2,2
39924,90,8288,12368;12579;17368,16060,0,0,1,2,3
39925,90,8289,12227;15458,16060,0,0,1,1,2
39926,90,8290,12620;12791,16060,0,0,0,2,2
39927,90,8291,12359;12615,16060,0,0,0,2,2
39928,90,8292,12623;12776,16060,0,0,0,2,2
39929,90,8293,12825,16060,0,0,0,1,1
39930,90,8294,12206;12416,16060,0,0,0,2,2
39931,90,8295,12685,16060,0,0,0,1,1
39932,90,8297,12652;12698,16060,0,0,0,2,2
39933,90,8298,13084,16060,0,0,1,0,1
39934,90,8301,12257,16060,0,0,0,1,1
39935,90,8302,11865;12737,16060,0,0,0,2,2
39936,90,8320,10465,16425,0,0,0,1,1
39937,90,8327,10554;11146,16425,0,0,0,2,2
39938,90,8333,10872;10875,16425,0,0,0,2,2
39939,90,8336,11333,16425,0,0,0,1,1
39940,90,8338,11483;12059,16425,0,0,0,2,2
39941,90,8339,11537;11642,16425,0,0,0,2,2
39942,90,8340,11542,16425,0,0,0,1,1
39943,90,8341,11403;11671,16425,0,0,0,2,2
39944,90,8342,11515;12057,16425,0,0,0,2,2
39945,90,8345,12030;12281,16425,0,0,0,2,2
39946,90,8347,12047,16425,0,0,0,1,1
39947,90,8348,12269,16425,0,0,0,1,1
39948,90,8349,12851,16425,0,0,0,1,1
39949,90,8350,12064;12228,16425,0,0,0,2,2
39950,90,8351,12242;12820,16425,0,0,0,2,2
39951,90,8352,12640;12646,16425,0,0,0,2,2
39952,90,8353,12255;12497;17020,16425,0,0,1,2,3
39953,90,8354,12166;12307,16425,0,0,0,2,2
39954,90,8355,12846,16425,0,0,0,1,1
39955,90,8356,13008;13196,16425,0,0,2,0,2
39956,90,8357,12360;12446,16425,0,0,0,2,2
39957,90,8358,12362,16425,0,0,0,1,1
39958,90,8359,12395,16425,0,0,0,1,1
39959,90,8360,12212;12792;17164,16425,0,0,1,2,3
39960,90,8361,12451;12834,16425,0,0,0,2,2
39961,90,8362,16585,16425,0,0,1,0,1
39962,90,8364,12674,16425,0,0,0,1,1
39963,90,8365,12859;16340,16425,0,0,1,1,2
39964,90,8366,12550;12946;15735,16425,0,0,2,1,3
39965,90,8367,12570,16425,0,0,0,1,1
39966,90,8368,12575,16425,0,0,0,1,1
39967,90,8369,12453;16539,16425,0,0,1,1,2
39968,90,8370,12602;12639,16425,0,0,0,2,2
39969,90,8371,12723;12854,16425,0,0,0,2,2
39970,90,8372,12276,16425,0,0,0,1,1
39971,90,8373,12822,16425,0,0,0,1,1
39972,90,8374,12973,16425,0,0,1,0,1
39973,90,8375,12423;12974,16425,0,0,1,1,2
39974,90,8376,13379,16425,0,0,1,0,1
39975,90,8377,13198;13404,16425,0,0,2,0,2
39976,90,8378,12738;12920;16907,16425,0,0,2,1,3
39977,90,8379,12746;13048,16425,0,0,1,1,2
39978,90,8380,12417;12572,16425,0,0,0,2,2
39979,90,8381,12229;12761,16425,0,0,0,2,2
39980,90,8382,12616;12780,16425,0,0,0,2,2
39981,90,8383,12954;13085,16425,0,0,2,0,2
39982,90,8384,12396;12785,16425,0,0,0,2,2
39983,90,8385,12786,16425,0,0,0,1,1
39984,90,8386,13004;13054,16425,0,0,2,0,2
39985,90,8387,12790,16425,0,0,0,1,1
39986,90,8388,12518;12802,16425,0,0,0,2,2
39987,90,8389,13264,16425,0,0,1,0,1
39988,90,8390,12113;12864;17864,16425,0,0,1,2,3
39989,90,8411,10606;10748,16790,0,0,0,2,2
39990,90,8412,10692;10944,16790,0,0,0,2,2
39991,90,8419,15611,16790,0,0,1,0,1
39992,90,8421,11725;11816,16790,0,0,0,2,2
39993,90,8425,11426;11624,16790,0,0,0,2,2
39994,90,8426,11702;12293,16790,0,0,0,2,2
39995,90,8428,11669;11722,16790,0,0,0,2,2
39996,90,8431,12082,16790,0,0,0,1,1
39997,90,8433,11930;12062,16790,0,0,0,2,2
39998,90,8434,11852;12143,16790,0,0,0,2,2
39999,90,8435,11891;12285,16790,0,0,0,2,2
40000,90,8437,12133,16790,0,0,0,1,1
40001,90,8438,11802;12116,16790,0,0,0,2,2
40002,90,8439,11987,16790,0,0,0,1,1
40003,90,8441,12150;12444;17293,16790,0,0,1,2,3
40004,90,8442,12418;12713;16536,16790,0,0,1,2,3
40005,90,8443,12605;12766,16790,0,0,0,2,2
40006,90,8444,12193,16790,0,0,0,1,1
40007,90,8445,12277;12328,16790,0,0,0,2,2
40008,90,8446,11854;12244,16790,0,0,0,2,2
40009,90,8447,12642,16790,0,0,0,1,1
40010,90,8448,12185;12265,16790,0,0,0,2,2
40011,90,8449,12298;12351,16790,0,0,0,2,2
40012,90,8450,12315;12667,16790,0,0,0,2,2
40013,90,8452,12376;13257,16790,0,0,1,1,2
40014,90,8453,12372;12380,16790,0,0,0,2,2
40015,90,8455,12611;17859,16790,0,0,1,1,2
40016,90,8456,11883;12419,16790,0,0,0,2,2
40017,90,8457,12439,16790,0,0,0,1,1
40018,90,8458,12279;12455,16790,0,0,0,2,2
40019,90,8459,12454;12697,16790,0,0,0,2,2
40020,90,8460,12501;12892,16790,0,0,1,1,2
40021,90,8461,12514;12573,16790,0,0,0,2,2
40022,90,8463,12981,16790,0,0,1,0,1
40023,90,8464,13158,16790,0,0,1,0,1
40024,90,8465,12565,16790,0,0,0,1,1
40025,90,8466,13029;13300,16790,0,0,2,0,2
40026,90,8467,12589,16790,0,0,0,1,1
40027,90,8468,12590;12681,16790,0,0,0,2,2
40028,90,8469,12561;12686,16790,0,0,0,2,2
40029,90,8470,13186;17916,16790,0,0,2,0,2
40030,90,8471,12382;12742,16790,0,0,0,2,2
40031,90,8472,12654;12775,16790,0,0,0,2,2
40032,90,8473,12039;12803,16790,0,0,0,2,2
40033,90,8474,12628;17913,16790,0,0,1,1,2
40034,90,8475,12160;12818,16790,0,0,0,2,2
40035,90,8476,12955,16790,0,0,1,0,1
40036,90,8477,12609;12837,16790,0,0,0,2,2
40037,90,8478,12701;13057,16790,0,0,1,1,2
40038,90,8479,12700;12894,16790,0,0,1,1,2
40039,90,8480,12364;12858;18608,16790,0,0,1,2,3
40040,90,8481,12861;17190,16790,0,0,1,1,2
40041,90,8482,13293;13308,16790,0,0,2,0,2
40042,90,8484,12879;13439;18556,16790,0,0,3,0,3
40043,90,8485,12886;13340,16790,0,0,2,0,2
40044,90,8486,12919;13371,16790,0,0,2,0,2
40045,90,8487,12527;12924,16790,0,0,1,1,2
40046,90,8488,12672;13318,16790,0,0,1,1,2
40047,90,8489,12928;13363,16790,0,0,2,0,2
40048,90,8490,12942;16829;17383,16790,0,0,3,0,3
40049,90,8491,16641;16853;19440;20185,16790,0,2,2,0,4
40050,90,8492,12772,16790,0,0,0,1,1
40051,90,8506,8553,17155,0,0,0,1,1
40052,90,8514,10826,17155,0,0,0,1,1
40053,90,8516,11756,17155,0,0,0,1,1
40054,90,8519,11264,17155,0,0,0,1,1
40055,90,8521,12070;17253,17155,0,0,1,1,2
40056,90,8524,12020,17155,0,0,0,1,1
40057,90,8525,11572;11695,17155,0,0,0,2,2
40058,90,8526,12119,17155,0,0,0,1,1
40059,90,8527,12127;12259;16200,17155,0,0,1,2,3
40060,90,8530,12156;12246,17155,0,0,0,2,2
40061,90,8531,12192;12855;17907,17155,0,0,1,2,3
40062,90,8532,12509,17155,0,0,0,1,1
40063,90,8533,12205;12470,17155,0,0,0,2,2
40064,90,8534,12270,17155,0,0,0,1,1
40065,90,8535,12715,17155,0,0,0,1,1
40066,90,8536,12280;12428,17155,0,0,0,2,2
40067,90,8537,11672;12079,17155,0,0,0,2,2
40068,90,8538,12348;12643,17155,0,0,0,2,2
40069,90,8539,12399,17155,0,0,0,1,1
40070,90,8541,12292,17155,0,0,0,1,1
40071,90,8542,12712;16739,17155,0,0,1,1,2
40072,90,8543,12551;12770,17155,0,0,0,2,2
40073,90,8546,12671;12778;16760,17155,0,0,1,2,3
40074,90,8547,13377;13465;17603,17155,0,0,3,0,3
40075,90,8548,12339;12537,17155,0,0,0,2,2
40076,90,8549,12539;12733,17155,0,0,0,2,2
40077,90,8550,12961;13230,17155,0,0,2,0,2
40078,90,8551,12245;12333,17155,0,0,0,2,2
40079,90,8553,12562;12906,17155,0,0,1,1,2
40080,90,8554,12622;13214,17155,0,0,1,1,2
40081,90,8555,12180;12624,17155,0,0,0,2,2
40082,90,8556,12977;13050,17155,0,0,2,0,2
40083,90,8557,12463;12678,17155,0,0,0,2,2
40084,90,8559,13272;13391;15452;18127,17155,0,0,4,0,4
40085,90,8560,12610;12728,17155,0,0,0,2,2
40086,90,8561,12734;13290,17155,0,0,1,1,2
40087,90,8562,12744;12967,17155,0,0,1,1,2
40088,90,8563,13204,17155,0,0,1,0,1
40089,90,8564,13034;13265,17155,0,0,2,0,2
40090,90,8565,12806;12883,17155,0,0,1,1,2
40091,90,8566,12813;13355;18061,17155,0,0,2,1,3
40092,90,8567,13398;13579,17155,0,0,2,0,2
40093,90,8568,12915;13263,17155,0,0,2,0,2
40094,90,8569,12476;12896;16543,17155,0,0,2,1,3
40095,90,8570,12878;13159,17155,0,0,2,0,2
40096,90,8571,12931;13170;17417,17155,0,0,3,0,3
40097,90,8572,12932;13192;18121,17155,0,0,3,0,3
40098,90,8573,12751;12934,17155,0,0,1,1,2
40099,90,8574,12938;12990;18500,17155,0,0,3,0,3
40100,90,8575,12930;12968,17155,0,0,2,0,2
40101,90,8576,12960;17719,17155,0,0,2,0,2
40102,90,8577,12592;12641,17155,0,0,0,2,2
40103,90,8578,13051;13409,17155,0,0,2,0,2
40104,90,8581,12925;13020,17155,0,0,2,0,2
40105,90,8583,13039;13114,17155,0,0,2,0,2
40106,90,8584,12739;13059;17030,17155,0,0,2,1,3
40107,90,8585,12213;13063;16742,17155,0,0,2,1,3
40108,90,8586,13071,17155,0,0,1,0,1
40109,90,8588,12811;13133,17155,0,0,1,1,2
40110,90,8589,13107;13307,17155,0,0,2,0,2
40111,90,8598,1152,17520,0,0,0,1,1
40112,90,8603,9365,17520,0,0,0,1,1
40113,90,8607,10165,17520,0,0,0,1,1
40114,90,8608,447,17520,0,0,0,1,1
40115,90,8621,11634;11822,17520,0,0,0,2,2
40116,90,8623,11782,17520,0,0,0,1,1
40117,90,8627,11697;11713,17520,0,0,0,2,2
40118,90,8628,12393,17520,0,0,0,1,1
40119,90,8629,12054,17520,0,0,0,1,1
40120,90,8630,11647;12041,17520,0,0,0,2,2
40121,90,8631,12049;12421,17520,0,0,0,2,2
40122,90,8632,12764,17520,0,0,0,1,1
40123,90,8633,11744;12327,17520,0,0,0,2,2
40124,90,8634,11764;12201,17520,0,0,0,2,2
40125,90,8635,11923;12034;16166,17520,0,0,1,2,3
40126,90,8636,12181;12263,17520,0,0,0,2,2
40127,90,8637,12358;12363,17520,0,0,0,2,2
40128,90,8639,12725,17520,0,0,0,1,1
40129,90,8640,12814,17520,0,0,0,1,1
40130,90,8641,13040;16984,17520,0,0,2,0,2
40131,90,8643,12491;12838;16355,17520,0,0,1,2,3
40132,90,8644,12282;12522,17520,0,0,0,2,2
40133,90,8645,12273;12821;17225,17520,0,0,1,2,3
40134,90,8647,12549,17520,0,0,0,1,1
40135,90,8648,13140;13341;17428;18607,17520,0,0,4,0,4
40136,90,8649,12638,17520,0,0,0,1,1
40137,90,8650,12627;13252;17151,17520,0,0,2,1,3
40138,90,8651,12283;12457,17520,0,0,0,2,2
40139,90,8652,12655,17520,0,0,0,1,1
40140,90,8654,12771;12882,17520,0,0,1,1,2
40141,90,8655,12890;13146,17520,0,0,2,0,2
40142,90,8656,12515;12797,17520,0,0,0,2,2
40143,90,8657,13116;13181,17520,0,0,2,0,2
40144,90,8658,12304;12848;16973,17520,0,0,1,2,3
40145,90,8659,12828;13533,17520,0,0,1,1,2
40146,90,8660,12909;13091,17520,0,0,2,0,2
40147,90,8661,13313;13364,17520,0,0,2,0,2
40148,90,8662,12914;13270,17520,0,0,2,0,2
40149,90,8663,12309;12936,17520,0,0,1,1,2
40150,90,8664,13005;13609,17520,0,0,2,0,2
40151,90,8665,13014;13176;17348,17520,0,0,3,0,3
40152,90,8666,12758;12921;17412,17520,0,0,2,1,3
40153,90,8667,13482;13612;17948,17520,0,0,3,0,3
40154,90,8668,12781;12996,17520,0,0,1,1,2
40155,90,8669,13045;13550;18234,17520,0,0,3,0,3
40156,90,8670,13622;13632,17520,0,0,2,0,2
40157,90,8671,12808;12881;17270;18003;18076,17520,0,0,4,1,5
40158,90,8672,13076;13537,17520,0,0,2,0,2
40159,90,8673,13087;13178,17520,0,0,2,0,2
40160,90,8674,13517,17520,0,0,1,0,1
40161,90,8675,13141;13394;17291,17520,0,0,3,0,3
40162,90,8676,13268;16605,17520,0,0,2,0,2
40163,90,8677,12994;13189;17602,17520,0,0,3,0,3
40164,90,8678,13023;13201,17520,0,0,2,0,2
40165,90,8679,13255,17520,0,0,1,0,1
40166,90,8680,13489;17105,17520,0,0,2,0,2
40167,90,8696,10297,17885,0,0,0,1,1
40168,90,8707,11241,17885,0,0,0,1,1
40169,90,8708,11305;11885,17885,0,0,0,2,2
40170,90,8710,11323;11682,17885,0,0,0,2,2
40171,90,8712,11372;11811,17885,0,0,0,2,2
40172,90,8713,16470;16707;20656,17885,1,0,2,0,3
40173,90,8714,11520;12122,17885,0,0,0,2,2
40174,90,8720,11758;12007,17885,0,0,0,2,2
40175,90,8721,11827,17885,0,0,0,1,1
40176,90,8722,11295;16143,17885,0,0,1,1,2
40177,90,8723,11543;11986,17885,0,0,0,2,2
40178,90,8726,12216,17885,0,0,0,1,1
40179,90,8727,12530;17963,17885,0,0,1,1,2
40180,90,8728,12237;12571;16893,17885,0,0,1,2,3
40181,90,8729,12472;12577,17885,0,0,0,2,2
40182,90,8733,12631;13012,17885,0,0,1,1,2
40183,90,8734,12474;12475,17885,0,0,0,2,2
40184,90,8735,12055;12482,17885,0,0,0,2,2
40185,90,8736,12717;13415,17885,0,0,1,1,2
40186,90,8737,12947;17138,17885,0,0,2,0,2
40187,90,8739,12632,17885,0,0,0,1,1
40188,90,8740,12862;13115,17885,0,0,1,1,2
40189,90,8742,12404;12691,17885,0,0,0,2,2
40190,90,8743,17384,17885,0,0,1,0,1
40191,90,8744,13383,17885,0,0,1,0,1
40192,90,8745,13123,17885,0,0,1,0,1
40193,90,8746,13068;17997,17885,0,0,2,0,2
40194,90,8747,12877;12980,17885,0,0,2,0,2
40195,90,8749,12773;13184,17885,0,0,1,1,2
40196,90,8750,13062;13630,17885,0,0,2,0,2
40197,90,8751,12524;13643;17638,17885,0,0,2,1,3
40198,90,8754,12618;12975,17885,0,0,1,1,2
40199,90,8755,12478,17885,0,0,0,1,1
40200,90,8756,12991;13043,17885,0,0,2,0,2
40201,90,8757,12992;13010,17885,0,0,2,0,2
40202,90,8758,13079;13432;17881,17885,0,0,3,0,3
40203,90,8759,13462;13659,17885,0,0,2,0,2
40204,90,8760,12944;13094,17885,0,0,2,0,2
40205,90,8761,12718;13118,17885,0,0,1,1,2
40206,90,8762,13220,17885,0,0,1,0,1
40207,90,8763,13121;13755,17885,0,0,2,0,2
40208,90,8764,12767;13131;17676;17784,17885,0,0,3,1,4
40209,90,8765,13227;13602;18487;19451,17885,0,1,3,0,4
40210,90,8766,13403;18648,17885,0,0,2,0,2
40211,90,8767,13155,17885,0,0,1,0,1
40212,90,8768,13174;13185,17885,0,0,2,0,2
40213,90,8769,13096;13183,17885,0,0,2,0,2
40214,90,8770,13195;16854,17885,0,0,2,0,2
40215,90,8771,13024;13647;19140,17885,0,1,2,0,3
40216,90,8773,13242,17885,0,0,1,0,1
40217,90,8774,13250,17885,0,0,1,0,1
40218,90,8775,13180;13253;17960,17885,0,0,3,0,3
40219,90,8777,13003;13291;17479,17885,0,0,3,0,3
40220,90,8778,13295;13395;18738,17885,0,0,3,0,3
40221,90,8779,13299;13613,17885,0,0,2,0,2
40222,90,8780,13303;17725,17885,0,0,2,0,2
40223,90,8781,13122;13656,17885,0,0,2,0,2
40224,90,8782,13144;18528,17885,0,0,2,0,2
40225,90,8783,12666;13518;17347,17885,0,0,2,1,3
40226,90,8784,12888;13468;18292,17885,0,0,3,0,3
40227,90,8785,13321;13703;17599,17885,0,0,3,0,3
40228,90,8786,13369;13669;17092;18885,17885,0,0,4,0,4
40229,90,8787,12706;13382,17885,0,0,1,1,2
40230,90,8788,13320;13396;16925,17885,0,0,3,0,3
40231,90,8797,9098,18250,0,0,0,1,1
40232,90,8815,11582;16672,18250,0,0,1,1,2
40233,90,8816,11517,18250,0,0,0,1,1
40234,90,8825,12012;12084,18250,0,0,0,2,2
40235,90,8826,11347;11820,18250,0,0,0,2,2
40236,90,8829,11605;12004,18250,0,0,0,2,2
40237,90,8830,12074;12187,18250,0,0,0,2,2
40238,90,8832,12252;12336,18250,0,0,0,2,2
40239,90,8833,12338;12556,18250,0,0,0,2,2
40240,90,8834,12247;12347,18250,0,0,0,2,2
40241,90,8835,12383;12452,18250,0,0,0,2,2
40242,90,8836,12186;12443,18250,0,0,0,2,2
40243,90,8837,12447;13324;17895,18250,0,0,2,1,3
40244,90,8838,12016;12471,18250,0,0,0,2,2
40245,90,8839,12487,18250,0,0,0,1,1
40246,90,8840,12538;12597,18250,0,0,0,2,2
40247,90,8841,12754;13569;18141;18597;18918,18250,0,0,4,1,5
40248,90,8843,12850;13126,18250,0,0,1,1,2
40249,90,8844,12668;13035,18250,0,0,1,1,2
40250,90,8845,13038;13093,18250,0,0,2,0,2
40251,90,8846,12699,18250,0,0,0,1,1
40252,90,8848,12710;13420,18250,0,0,1,1,2
40253,90,8849,12702;17186,18250,0,0,1,1,2
40254,90,8851,12789,18250,0,0,0,1,1
40255,90,8852,12809,18250,0,0,0,1,1
40256,90,8853,12584;13053,18250,0,0,1,1,2
40257,90,8854,13470;17814;18170;18445,18250,0,0,4,0,4
40258,90,8855,12884,18250,0,0,1,0,1
40259,90,8856,12958,18250,0,0,1,0,1
40260,90,8857,12465;12966;17261,18250,0,0,2,1,3
40261,90,8858,12941;13436;18226,18250,0,0,3,0,3
40262,90,8859,12872;13449;18549,18250,0,0,3,0,3
40263,90,8860,13022,18250,0,0,1,0,1
40264,90,8861,12962;13026;16976,18250,0,0,3,0,3
40265,90,8862,12504;13032;17467,18250,0,0,2,1,3
40266,90,8863,12950;13036,18250,0,0,2,0,2
40267,90,8864,12867;13388,18250,0,0,2,0,2
40268,90,8865,13090,18250,0,0,1,0,1
40269,90,8866,13088;13092;18493,18250,0,0,3,0,3
40270,90,8867,13021;13638,18250,0,0,2,0,2
40271,90,8868,12998;13129,18250,0,0,2,0,2
40272,90,8869,13137;13375,18250,0,0,2,0,2
40273,90,8870,13217;13297,18250,0,0,2,0,2
40274,90,8871,13171;13688,18250,0,0,2,0,2
40275,90,8872,13161,18250,0,0,1,0,1
40276,90,8873,13112;13216;17640,18250,0,0,3,0,3
40277,90,8874,13360;13428,18250,0,0,2,0,2
40278,90,8875,13330,18250,0,0,1,0,1
40279,90,8876,13294;13496;17650,18250,0,0,3,0,3
40280,90,8877,12784;13361,18250,0,0,1,1,2
40281,90,8878,13304;13311,18250,0,0,2,0,2
40282,90,8879,12959;13339;18169,18250,0,0,3,0,3
40283,90,8880,13348;13899,18250,0,0,2,0,2
40284,90,8881,13392;13660,18250,0,0,2,0,2
40285,90,8882,13587,18250,0,0,1,0,1
40286,90,8883,13359;13943;18096,18250,0,0,3,0,3
40287,90,8884,13488;13539;17257;18466,18250,0,0,4,0,4
40288,90,8885,12547;13471,18250,0,0,1,1,2
40289,90,8887,13222;13851,18250,0,0,2,0,2
40290,90,8888,13774,18250,0,0,1,0,1
40291,90,8889,13493;14002;17844,18250,0,0,3,0,3
40292,90,8892,13329;13532;17292,18250,0,0,3,0,3
40293,90,8895,6838,18615,0,0,0,1,1
40294,90,8906,11175;11408,18615,0,0,0,2,2
40295,90,8908,11019;11178,18615,0,0,0,2,2
40296,90,8912,11444;11897,18615,0,0,0,2,2
40297,90,8915,11749,18615,0,0,0,1,1
40298,90,8918,11882;12574;16520,18615,0,0,1,2,3
40299,90,8919,11998;12727,18615,0,0,0,2,2
40300,90,8920,12006,18615,0,0,0,1,1
40301,90,8923,12046,18615,0,0,0,1,1
40302,90,8926,12337,18615,0,0,0,1,1
40303,90,8927,12191;12563,18615,0,0,0,2,2
40304,90,8928,12179;12366,18615,0,0,0,2,2
40305,90,8931,12798;12856,18615,0,0,0,2,2
40306,90,8932,12726,18615,0,0,0,1,1
40307,90,8934,12911;13103,18615,0,0,2,0,2
40308,90,8935,12178;12659,18615,0,0,0,2,2
40309,90,8936,12553;12679,18615,0,0,0,2,2
40310,90,8937,12696;13474;17180;18128,18615,0,0,3,1,4
40311,90,8940,12957;13209;17131;17633;17830,18615,0,0,5,0,5
40312,90,8941,12499;12805,18615,0,0,0,2,2
40313,90,8942,13019;13266;17555,18615,0,0,3,0,3
40314,90,8943,12827;13246,18615,0,0,1,1,2
40315,90,8944,12732;12842;17385,18615,0,0,1,2,3
40316,90,8945,12552;12843,18615,0,0,0,2,2
40317,90,8946,12847,18615,0,0,0,1,1
40318,90,8947,12731;13070,18615,0,0,1,1,2
40319,90,8948,12908;17969,18615,0,0,2,0,2
40320,90,8949,12503,18615,0,0,0,1,1
40321,90,8950,12885;13666;19413;19579,18615,0,2,2,0,4
40322,90,8951,11988;17205,18615,0,0,1,1,2
40323,90,8953,13455,18615,0,0,1,0,1
40324,90,8954,12651;13169,18615,0,0,1,1,2
40325,90,8956,13047;13506;18617,18615,0,0,3,0,3
40326,90,8958,13109;13842,18615,0,0,2,0,2
40327,90,8959,13134;13508,18615,0,0,2,0,2
40328,90,8960,13163;13172,18615,0,0,2,0,2
40329,90,8962,13175;13736,18615,0,0,2,0,2
40330,90,8963,13191;13484,18615,0,0,2,0,2
40331,90,8964,13066;14014;17884,18615,0,0,3,0,3
40332,90,8965,13918,18615,0,0,1,0,1
40333,90,8966,13240,18615,0,0,1,0,1
40334,90,8967,13254;13963;18527,18615,0,0,3,0,3
40335,90,8968,12799;13332;18485,18615,0,0,2,1,3
40336,90,8970,13127;13343,18615,0,0,2,0,2
40337,90,8971,13350;13354,18615,0,0,2,0,2
40338,90,8972,13067;13384,18615,0,0,2,0,2
40339,90,8973,12477;13386,18615,0,0,1,1,2
40340,90,8974,12972;13407,18615,0,0,2,0,2
40341,90,8976,13599;13663;18272,18615,0,0,3,0,3
40342,90,8977,13752;13856,18615,0,0,2,0,2
40343,90,8978,14044;18175;18951,18615,0,0,3,0,3
40344,90,8979,13453;13606,18615,0,0,2,0,2
40345,90,8980,13046;13511,18615,0,0,2,0,2
40346,90,8981,13778,18615,0,0,1,0,1
40347,90,8982,13442;13545,18615,0,0,2,0,2
40348,90,8983,13218;13554,18615,0,0,2,0,2
40349,90,8984,13562;18471,18615,0,0,2,0,2
40350,90,8985,13564;13704,18615,0,0,2,0,2
40351,90,8986,13573,18615,0,0,1,0,1
40352,90,8987,12989;13585;18700,18615,0,0,3,0,3
40353,90,8988,13616;13685;17178;18065,18615,0,0,4,0,4
40354,90,8989,13548;13883;18726,18615,0,0,3,0,3
40355,90,8990,14032,18615,0,0,1,0,1
40356,90,8991,13629;13650;18362;18546,18615,0,0,4,0,4
40357,90,8992,13499;13637,18615,0,0,2,0,2
40358,90,8993,13528;13644;18858,18615,0,0,3,0,3
40359,90,8994,13423;13937;18547,18615,0,0,3,0,3
40360,90,8995,13658,18615,0,0,1,0,1
40361,90,9012,11243,18980,0,0,0,1,1
40362,90,9017,11050;11335,18980,0,0,0,2,2
40363,90,9023,11877,18980,0,0,0,1,1
40364,90,9024,11733;12163,18980,0,0,0,2,2
40365,90,9027,12108;12852,18980,0,0,0,2,2
40366,90,9028,11805;12209,18980,0,0,0,2,2
40367,90,9029,11946;12173;16491,18980,0,0,1,2,3
40368,90,9033,12299,18980,0,0,0,1,1
40369,90,9036,12391;12917;18771,18980,0,0,2,1,3
40370,90,9037,12400;12893,18980,0,0,1,1,2
40371,90,9038,12401,18980,0,0,0,1,1
40372,90,9039,12508,18980,0,0,0,1,1
40373,90,9040,12548;13244,18980,0,0,1,1,2
40374,90,9041,13258,18980,0,0,1,0,1
40375,90,9042,12595;12824,18980,0,0,0,2,2
40376,90,9045,12796;13497;17906,18980,0,0,2,1,3
40377,90,9046,13001,18980,0,0,1,0,1
40378,90,9048,13353;13501,18980,0,0,2,0,2
40379,90,9049,12528;12969;17971,18980,0,0,2,1,3
40380,90,9050,12525;13041,18980,0,0,1,1,2
40381,90,9052,13077;13596;17655;18145,18980,0,0,4,0,4
40382,90,9053,13056;13101,18980,0,0,2,0,2
40383,90,9054,13031;13139,18980,0,0,2,0,2
40384,90,9055,13086;13687;17989,18980,0,0,3,0,3
40385,90,9056,12943;13182,18980,0,0,2,0,2
40386,90,9058,13221;13913;17478,18980,0,0,3,0,3
40387,90,9059,13223;13315,18980,0,0,2,0,2
40388,90,9060,13098;13483;18353,18980,0,0,3,0,3
40389,90,9061,13226,18980,0,0,1,0,1
40390,90,9062,13256,18980,0,0,1,0,1
40391,90,9063,13267;13578,18980,0,0,2,0,2
40392,90,9066,13301;13766;17369,18980,0,0,3,0,3
40393,90,9067,13422;13826;18638,18980,0,0,3,0,3
40394,90,9068,13372;13457,18980,0,0,2,0,2
40395,90,9069,13027;13715;17060,18980,0,0,3,0,3
40396,90,9070,13055;13430,18980,0,0,2,0,2
40397,90,9071,13514;18529,18980,0,0,2,0,2
40398,90,9072,13344;13636;17578;17837;18480,18980,0,0,5,0,5
40399,90,9073,13458;13580,18980,0,0,2,0,2
40400,90,9074,13461;13591;19429,18980,0,1,2,0,3
40401,90,9075,13100;13448,18980,0,0,2,0,2
40402,90,9076,13362;13491,18980,0,0,2,0,2
40403,90,9077,13534;17905,18980,0,0,2,0,2
40404,90,9078,13444;13576,18980,0,0,2,0,2
40405,90,9079,13617;13996,18980,0,0,2,0,2
40406,90,9080,13705,18980,0,0,1,0,1
40407,90,9082,13179;13641;18660,18980,0,0,3,0,3
40408,90,9083,13640;13642,18980,0,0,2,0,2
40409,90,9084,13693;13841,18980,0,0,2,0,2
40410,90,9085,13713,18980,0,0,1,0,1
40411,90,9086,13716;13893,18980,0,0,2,0,2
40412,90,9087,13233;13729;17625,18980,0,0,3,0,3
40413,90,9088,13761;13930;17446,18980,0,0,3,0,3
40414,90,9089,13467;13763;17861,18980,0,0,3,0,3
40415,90,9090,13445;14057,18980,0,0,2,0,2
40416,90,9091,13904;13938;16508;18005,18980,0,0,4,0,4
40417,90,9092,334,19345,0,0,0,1,1
40418,90,9108,10993;11145,19345,0,0,0,2,2
40419,90,9111,11540,19345,0,0,0,1,1
40420,90,9118,11893,19345,0,0,0,1,1
40421,90,9121,12097,19345,0,0,0,1,1
40422,90,9122,12375;12949;17981,19345,0,0,2,1,3
40423,90,9123,12356;12433,19345,0,0,0,2,2
40424,90,9124,12440;12520,19345,0,0,0,2,2
40425,90,9125,12480;12676,19345,0,0,0,2,2
40426,90,9127,12606;13099,19345,0,0,1,1,2
40427,90,9129,12222;12634;17199,19345,0,0,1,2,3
40428,90,9131,12413;12598,19345,0,0,0,2,2
40429,90,9132,12199;13015,19345,0,0,1,1,2
40430,90,9133,13143;17191,19345,0,0,2,0,2
40431,90,9134,16681;17226;20101;20782,19345,1,1,2,0,4
40432,90,9135,13232;13316,19345,0,0,2,0,2
40433,90,9136,13800;14204,19345,0,0,2,0,2
40434,90,9137,13037;13106,19345,0,0,2,0,2
40435,90,9138,13454;13611,19345,0,0,2,0,2
40436,90,9139,12831;13280,19345,0,0,1,1,2
40437,90,9140,13808,19345,0,0,1,0,1
40438,90,9141,13672;13958,19345,0,0,2,0,2
40439,90,9142,13334,19345,0,0,1,0,1
40440,90,9143,13335;13336,19345,0,0,2,0,2
40441,90,9145,13509;14046;17700,19345,0,0,3,0,3
40442,90,9146,13940,19345,0,0,1,0,1
40443,90,9147,13138;13390,19345,0,0,2,0,2
40444,90,9148,13446;13717,19345,0,0,2,0,2
40445,90,9149,13400;14152;16720;18393,19345,0,0,4,0,4
40446,90,9150,13401;13936,19345,0,0,2,0,2
40447,90,9152,14090;14339;17125,19345,0,0,3,0,3
40448,90,9153,12952;13487,19345,0,0,2,0,2
40449,90,9154,13980;14115;18708,19345,0,0,3,0,3
40450,90,9155,14070;16919,19345,0,0,2,0,2
40451,90,9156,13588;14041;17494,19345,0,0,3,0,3
40452,90,9157,14063;14188;18276;18693,19345,0,0,4,0,4
40453,90,9158,13699,19345,0,0,1,0,1
40454,90,9159,13649,19345,0,0,1,0,1
40455,90,9160,13561;13673,19345,0,0,2,0,2
40456,90,9161,13219;13677,19345,0,0,2,0,2
40457,90,9162,13447;13695,19345,0,0,2,0,2
40458,90,9164,13278;13714;17168,19345,0,0,3,0,3
40459,90,9165,13723;13878;18564;19415,19345,0,1,3,0,4
40460,90,9166,13373;13732;18659,19345,0,0,3,0,3
40461,90,9167,13531;13740,19345,0,0,2,0,2
40462,90,9168,13323;13801,19345,0,0,2,0,2
40463,90,9169,13768,19345,0,0,1,0,1
40464,90,9170,13431;13771,19345,0,0,2,0,2
40465,90,9171,13600;13772;18322,19345,0,0,3,0,3
40466,90,9172,13654;13858;17817;18371,19345,0,0,4,0,4
40467,90,9173,13790;13892;18112,19345,0,0,3,0,3
40468,90,9174,13792,19345,0,0,1,0,1
40469,90,9175,13793;13849;18387,19345,0,0,3,0,3
40470,90,9177,13527;13845,19345,0,0,2,0,2
40471,90,9178,13979;14120,19345,0,0,2,0,2
40472,90,9180,13894,19345,0,0,1,0,1
40473,90,9181,13901;13919;17970,19345,0,0,3,0,3
40474,90,9185,4075,19710,0,0,0,1,1
40475,90,9189,7039,19710,0,0,0,1,1
40476,90,9194,10233,19710,0,0,0,1,1
40477,90,9199,10706,19710,0,0,0,1,1
40478,90,9200,10838,19710,0,0,0,1,1
40479,90,9211,11997;12145;17483,19710,0,0,1,2,3
40480,90,9213,12288;12675,19710,0,0,0,2,2
40481,90,9216,12703,19710,0,0,0,1,1
40482,90,9217,12835;12922;16904,19710,0,0,2,1,3
40483,90,9219,13117;13676,19710,0,0,2,0,2
40484,90,9220,12656;13011;17644,19710,0,0,2,1,3
40485,90,9221,12387;13124,19710,0,0,1,1,2
40486,90,9222,13120;13275;18355,19710,0,0,3,0,3
40487,90,9223,12621;13162;16892,19710,0,0,2,1,3
40488,90,9226,13665;13678;18524,19710,0,0,3,0,3
40489,90,9227,13466;13515;17552;18754,19710,0,0,4,0,4
40490,90,9228,13165;13553;18484;18591,19710,0,0,4,0,4
40491,90,9232,12680;13582,19710,0,0,1,1,2
40492,90,9233,13426;13477,19710,0,0,2,0,2
40493,90,9234,13542;13924;18759,19710,0,0,3,0,3
40494,90,9235,13421;13551,19710,0,0,2,0,2
40495,90,9236,14110;14207;17498;17702;18361,19710,0,0,5,0,5
40496,90,9237,13435;13598,19710,0,0,2,0,2
40497,90,9238,13277;13440;18551,19710,0,0,3,0,3
40498,90,9239,13624;14138;18930,19710,0,0,3,0,3
40499,90,9242,14327;14337;17303;18231;18750,19710,0,0,5,0,5
40500,90,9243,14314;19146,19710,0,1,1,0,2
40501,90,9244,13460;13791,19710,0,0,2,0,2
40502,90,9245,13702,19710,0,0,1,0,1
40503,90,9246,13413;13708;18584,19710,0,0,3,0,3
40504,90,9247,13712;14206;18045,19710,0,0,3,0,3
40505,90,9249,14042;18143,19710,0,0,2,0,2
40506,90,9250,13674;14362;17767,19710,0,0,3,0,3
40507,90,9251,13231;13530,19710,0,0,2,0,2
40508,90,9252,14462;14466;18407,19710,0,0,3,0,3
40509,90,9253,13832;14365;18681,19710,0,0,3,0,3
40510,90,9254,14089;17853,19710,0,0,2,0,2
40511,90,9255,13830;14158,19710,0,0,2,0,2
40512,90,9256,13907;14013;18221,19710,0,0,3,0,3
40513,90,9257,13236;13914,19710,0,0,2,0,2
40514,90,9258,13205;13926,19710,0,0,2,0,2
40515,90,9259,13947;14141;17448;18903,19710,0,0,4,0,4
40516,90,9260,13906;13948;17549;17728;18139,19710,0,0,5,0,5
40517,90,9261,13971;17324,19710,0,0,2,0,2
40518,90,9262,13824;13990,19710,0,0,2,0,2
40519,90,9263,14097;14264;18890,19710,0,0,3,0,3
40520,90,9264,14035;14047;17879;18747,19710,0,0,4,0,4
40521,90,9265,13813;13944;18422,19710,0,0,3,0,3
40522,90,9266,13871;14078,19710,0,0,2,0,2
40523,90,9267,14080;14451,19710,0,0,2,0,2
40524,90,9277,10166,20075,0,0,0,1,1
40525,90,9282,10381,20075,0,0,0,1,1
40526,90,9290,10798,20075,0,0,0,1,1
40527,90,9294,11143;11284,20075,0,0,0,2,2
40528,90,9296,11255,20075,0,0,0,1,1
40529,90,9302,11745;12123,20075,0,0,0,2,2
40530,90,9305,11944;12106,20075,0,0,0,2,2
40531,90,9306,12154,20075,0,0,0,1,1
40532,90,9309,12169;12653,20075,0,0,0,2,2
40533,90,9313,12724;13078;18194,20075,0,0,2,1,3
40534,90,9314,12483;12588,20075,0,0,0,2,2
40535,90,9315,12853;17086,20075,0,0,1,1,2
40536,90,9316,12993;13411,20075,0,0,2,0,2
40537,90,9317,13033;13556,20075,0,0,2,0,2
40538,90,9318,12626;12916;16870,20075,0,0,2,1,3
40539,90,9319,13229,20075,0,0,1,0,1
40540,90,9321,13296;13634,20075,0,0,2,0,2
40541,90,9323,13769;14171;18440;18697,20075,0,0,4,0,4
40542,90,9325,13325;13575,20075,0,0,2,0,2
40543,90,9327,14325;14359;19004,20075,0,0,3,0,3
40544,90,9329,13706;14191;18372;18979,20075,0,0,4,0,4
40545,90,9330,13710;18523;19172,20075,0,1,2,0,3
40546,90,9331,13516;13719;16971,20075,0,0,3,0,3
40547,90,9332,13730;14030;17409,20075,0,0,3,0,3
40548,90,9333,13942;14443,20075,0,0,2,0,2
40549,90,9334,13789;18333,20075,0,0,2,0,2
40550,90,9335,13797;14186,20075,0,0,2,0,2
40551,90,9336,13799;14137;18335;19319,20075,0,1,3,0,4
40552,90,9337,13839;13853;18228,20075,0,0,3,0,3
40553,90,9338,13854;14121;19045,20075,0,0,3,0,3
40554,90,9339,13783;13877,20075,0,0,2,0,2
40555,90,9340,13888;14130;18570,20075,0,0,3,0,3
40556,90,9341,13908;18582,20075,0,0,2,0,2
40557,90,9342,14312;18869,20075,0,0,2,0,2
40558,90,9343,13912;14053;19083,20075,0,1,2,0,3
40559,90,9344,13406;13812,20075,0,0,2,0,2
40560,90,9345,13927;17295,20075,0,0,2,0,2
40561,90,9346,13152;13933;18595,20075,0,0,3,0,3
40562,90,9348,13951;14282;19074,20075,0,1,2,0,3
40563,90,9349,13735;13954;18489,20075,0,0,3,0,3
40564,90,9350,13680;14009,20075,0,0,2,0,2
40565,90,9351,13876;14225;18184,20075,0,0,3,0,3
40566,90,9352,13692;14052,20075,0,0,2,0,2
40567,90,9353,14099,20075,0,0,1,0,1
40568,90,9354,14473;14546;18682,20075,0,0,3,0,3
40569,90,9355,14107;14530;16901;18720;19160,20075,0,1,4,0,5
40570,90,9356,13679;13809,20075,0,0,2,0,2
40571,90,9357,13816;14125;19277,20075,0,1,2,0,3
40572,90,9358,14584,20075,0,0,1,0,1
40573,90,9359,14114;17924,20075,0,0,2,0,2
40574,90,9360,13481;14154;18442,20075,0,0,3,0,3
40575,90,9361,14178;14369;18775,20075,0,0,3,0,3
40576,90,9362,14128;14181,20075,0,0,2,0,2
40577,90,9363,13796;14198;18571;19525,20075,0,1,3,0,4
40578,90,9364,14852;19062;19681,20075,0,2,1,0,3
40579,90,9382,10878;10946,20440,0,0,0,2,2
40580,90,9384,10965,20440,0,0,0,1,1
40581,90,9387,11417;11748,20440,0,0,0,2,2
40582,90,9400,12492,20440,0,0,0,1,1
40583,90,9402,12345;12394;17973,20440,0,0,1,2,3
40584,90,9403,12505,20440,0,0,0,1,1
40585,90,9404,12425,20440,0,0,0,1,1
40586,90,9405,13016;13215,20440,0,0,2,0,2
40587,90,9406,12466;12582,20440,0,0,0,2,2
40588,90,9407,12779;12902,20440,0,0,1,1,2
40589,90,9408,12601,20440,0,0,0,1,1
40590,90,9409,13044;13572,20440,0,0,2,0,2
40591,90,9410,12484;12750,20440,0,0,0,2,2
40592,90,9412,12765,20440,0,0,0,1,1
40593,90,9415,12939;13104;17441;18190,20440,0,0,4,0,4
40594,90,9417,12870;13013,20440,0,0,2,0,2
40595,90,9419,13042;13193,20440,0,0,2,0,2
40596,90,9421,12670;13064,20440,0,0,1,1,2
40597,90,9422,13151;13298;18470,20440,0,0,3,0,3
40598,90,9423,13273;17665,20440,0,0,2,0,2
40599,90,9424,13200;13212,20440,0,0,2,0,2
40600,90,9425,13709,20440,0,0,1,0,1
40601,90,9426,13331;13522;18373,20440,0,0,3,0,3
40602,90,9428,12900;13438;18498,20440,0,0,3,0,3
40603,90,9429,13463;13964,20440,0,0,2,0,2
40604,90,9430,13897;14169,20440,0,0,2,0,2
40605,90,9431,13525;13620;19066,20440,0,1,2,0,3
40606,90,9433,13327;13698,20440,0,0,2,0,2
40607,90,9434,13720;14074;18793,20440,0,0,3,0,3
40608,90,9435,13722;14184,20440,0,0,2,0,2
40609,90,9436,13731;14068;17829;18945,20440,0,0,4,0,4
40610,90,9437,13806;13855;18501,20440,0,0,3,0,3
40611,90,9438,14168;17947,20440,0,0,2,0,2
40612,90,9439,13734;13821;19015,20440,0,0,3,0,3
40613,90,9440,13825;14167,20440,0,0,2,0,2
40614,90,9441,14318;18105;18955;19309,20440,0,1,3,0,4
40615,90,9442,13601;13844,20440,0,0,2,0,2
40616,90,9443,14350;14390;18036;18308;18756;19013,20440,0,0,6,0,6
40617,90,9444,14235;14237;17315,20440,0,0,3,0,3
40618,90,9445,13328;13934,20440,0,0,2,0,2
40619,90,9446,13276;14124;18051;18947,20440,0,0,4,0,4
40620,90,9447,14288;14330;18539;18916,20440,0,0,4,0,4
40621,90,9449,13920;18437,20440,0,0,2,0,2
40622,90,9450,13923;17800;18868,20440,0,0,3,0,3
40623,90,9451,13931;14363;18823;19287,20440,0,1,3,0,4
40624,90,9452,14234;14343;18152,20440,0,0,3,0,3
40625,90,9454,13835;14412;18996,20440,0,0,3,0,3
40626,90,9455,14486;14652,20440,0,0,2,0,2
40627,90,9456,13975;14320;17988;18780;18965,20440,0,0,5,0,5
40628,90,9457,14153;14677;18399;18601;19826,20440,0,1,4,0,5
40629,90,9458,14086;18468,20440,0,0,2,0,2
40630,90,9459,14150;14503;18817,20440,0,0,3,0,3
40631,90,9460,14050;14182;18724;18904,20440,0,0,4,0,4
40632,90,9462,13570;14465;19231,20440,0,1,2,0,3
40633,90,9463,13777;14076;18008;18513,20440,0,0,4,0,4
40634,90,9464,14088;14119;18906,20440,0,0,3,0,3
40635,90,9465,14157;14537;18324,20440,0,0,3,0,3
40636,90,9466,14113;19159,20440,0,1,1,0,2
40637,90,9467,14539,20440,0,0,1,0,1
40638,90,9468,14059;14468;18059;18688,20440,0,0,4,0,4
40639,90,9470,13784;14161,20440,0,0,2,0,2
40640,90,9471,14436;14747;18229;18599;18879,20440,0,0,5,0,5
40641,90,9472,13837,20440,0,0,1,0,1
40642,90,9473,14215;14458;18451;19048,20440,0,0,4,0,4
40643,90,9474,14376;18801;19771,20440,0,1,2,0,3
40644,90,9475,14147;14242;18988;19230,20440,0,1,3,0,4
40645,90,9476,13909;14243;18636,20440,0,0,3,0,3
40646,90,9477,14256;14611;18305;19078,20440,0,1,3,0,4
40647,90,9478,13738;14269,20440,0,0,2,0,2
40648,90,9479,13773;14292;18633,20440,0,0,3,0,3
40649,90,9480,14317;14354;19453,20440,0,1,2,0,3
40650,90,9481,14319;14435;17074,20440,0,0,3,0,3
40651,90,9482,14244;14638;18536;19738,20440,0,1,3,0,4
40652,90,9484,10102,20805,0,0,0,1,1
40653,90,9498,11235;11583,20805,0,0,0,2,2
40654,90,9501,11400,20805,0,0,0,1,1
40655,90,9509,11925;12172,20805,0,0,0,2,2
40656,90,9513,12320,20805,0,0,0,1,1
40657,90,9515,12058;12112,20805,0,0,0,2,2
40658,90,9518,12591;12657,20805,0,0,0,2,2
40659,90,9520,12983;13378,20805,0,0,2,0,2
40660,90,9522,12849,20805,0,0,0,1,1
40661,90,9523,12819;13125,20805,0,0,1,1,2
40662,90,9525,12636;12841;17771,20805,0,0,1,2,3
40663,90,9528,13459;13560,20805,0,0,2,0,2
40664,90,9529,13157;13785;19017,20805,0,0,3,0,3
40665,90,9530,12999;13819;17744,20805,0,0,3,0,3
40666,90,9532,12594;13188,20805,0,0,1,1,2
40667,90,9533,14094;14334;17770;19051;19168,20805,0,1,4,0,5
40668,90,9534,13346,20805,0,0,1,0,1
40669,90,9535,13356;13510;17701,20805,0,0,3,0,3
40670,90,9537,13405;14205;18416,20805,0,0,3,0,3
40671,90,9538,13082;13368,20805,0,0,2,0,2
40672,90,9539,13451;13962;19022;19539,20805,0,1,3,0,4
40673,90,9540,14011;14308;19385,20805,0,1,2,0,3
40674,90,9541,13492;13739;18144;18257;18703,20805,0,0,5,0,5
40675,90,9542,13546;14126;17987,20805,0,0,3,0,3
40676,90,9543,13581,20805,0,0,1,0,1
40677,90,9544,14016;14252;17594;17863,20805,0,0,4,0,4
40678,90,9545,13173;17833,20805,0,0,2,0,2
40679,90,9546,13662;13807,20805,0,0,2,0,2
40680,90,9547,13441;13684;18125;18351;18634,20805,0,0,5,0,5
40681,90,9548,13776;14038,20805,0,0,2,0,2
40682,90,9549,13840;14446,20805,0,0,2,0,2
40683,90,9550,13836;18782,20805,0,0,2,0,2
40684,90,9552,13881;14139,20805,0,0,2,0,2
40685,90,9553,14162;18877,20805,0,0,2,0,2
40686,90,9554,14276;17848;18418;19040,20805,0,0,4,0,4
40687,90,9555,13168;13882;17894,20805,0,0,3,0,3
40688,90,9556,14000;14064,20805,0,0,2,0,2
40689,90,9557,13957;14449,20805,0,0,2,0,2
40690,90,9558,14043;14072,20805,0,0,2,0,2
40691,90,9559,13952;14048;18518,20805,0,0,3,0,3
40692,90,9560,14051;14108;18359;18625,20805,0,0,4,0,4
40693,90,9561,14595;18015;18270,20805,0,0,3,0,3
40694,90,9562,14118;18806,20805,0,0,2,0,2
40695,90,9563,13696;14132,20805,0,0,2,0,2
40696,90,9564,13733;14146;17516,20805,0,0,3,0,3
40697,90,9565,14845;17944,20805,0,0,2,0,2
40698,90,9566,14151;17936;18301;18689,20805,0,0,4,0,4
40699,90,9567,14093;14478;18073;18428;19970,20805,0,1,4,0,5
40700,90,9568,13742;14194;18404,20805,0,0,3,0,3
40701,90,9569,14529;15122,20805,0,0,2,0,2
40702,90,9570,14202;14214;18605,20805,0,0,3,0,3
40703,90,9571,13916;14230;18645,20805,0,0,3,0,3
40704,90,9572,14232;14661,20805,0,0,2,0,2
40705,90,9573,13865;14500;18182,20805,0,0,3,0,3
40706,90,9574,14247;14532;18027;19464;19830,20805,0,2,3,0,5
40707,90,9575,13829;14253;18100,20805,0,0,3,0,3
40708,90,9576,14289;18777;19314,20805,0,1,2,0,3
40709,90,9577,14602;14637;17999;18436;19301,20805,0,1,4,0,5
40710,90,9578,14395;14822;18056,20805,0,0,3,0,3
40711,90,9579,14061;14418,20805,0,0,2,0,2
40712,90,9580,14304;14678;18665,20805,0,0,3,0,3
40713,90,9581,14705;18026;18210,20805,0,0,3,0,3
40714,90,9582,14212;14459;18931,20805,0,0,3,0,3
40715,90,9583,14285;14563;18188,20805,0,0,3,0,3
40716,90,9584,14778;14800;17912;18057;18936,20805,0,0,5,0,5
40717,90,9585,10074,21170,0,0,0,1,1
40718,90,9587,10150,21170,0,0,0,1,1
40719,90,9599,11453,21170,0,0,0,1,1
40720,90,9605,11972,21170,0,0,0,1,1
40721,90,9606,11812;12381,21170,0,0,0,2,2
40722,90,9608,12912,21170,0,0,1,0,1
40723,90,9613,12262;12361,21170,0,0,0,2,2
40724,90,9614,12388;12512,21170,0,0,0,2,2
40725,90,9615,12984;13526,21170,0,0,2,0,2
40726,90,9616,12448;12506,21170,0,0,0,2,2
40727,90,9620,12271,21170,0,0,0,1,1
40728,90,9621,12649;12923,21170,0,0,1,1,2
40729,90,9623,12752;12899;18227,21170,0,0,2,1,3
40730,90,9627,12913;12940,21170,0,0,2,0,2
40731,90,9628,13603,21170,0,0,1,0,1
40732,90,9629,12982;13333,21170,0,0,2,0,2
40733,90,9631,13281;18074,21170,0,0,2,0,2
40734,90,9632,12918;13635,21170,0,0,2,0,2
40735,90,9633,13199;13490,21170,0,0,2,0,2
40736,90,9638,13284;13427;17818,21170,0,0,3,0,3
40737,90,9641,13502;14375;19047,21170,0,0,3,0,3
40738,90,9642,13782;13929,21170,0,0,2,0,2
40739,90,9644,14262;17856;20262,21170,0,1,2,0,3
40740,90,9645,13589;13762;18269,21170,0,0,3,0,3
40741,90,9646,13450;14223;18415;18610;18845;19250;19548,21170,0,2,5,0,7
40742,90,9647,13828;17754;19294,21170,0,1,2,0,3
40743,90,9649,13631;13866;19192,21170,0,1,2,0,3
40744,90,9651,14382,21170,0,0,1,0,1
40745,90,9652,13751;13896,21170,0,0,2,0,2
40746,90,9653,13479;13675;17791,21170,0,0,3,0,3
40747,90,9654,13478;13552,21170,0,0,2,0,2
40748,90,9655,14027;14368;18647;19101,21170,0,1,3,0,4
40749,90,9656,13543;13989;18173;19614,21170,0,1,3,0,4
40750,90,9657,14026;18802,21170,0,0,2,0,2
40751,90,9658,13981;14448;17691;18710,21170,0,0,4,0,4
40752,90,9659,13959;14056;18811;19336,21170,0,1,3,0,4
40753,90,9660,14067;18117,21170,0,0,2,0,2
40754,90,9661,14828;19416,21170,0,1,1,0,2
40755,90,9662,14092,21170,0,0,1,0,1
40756,90,9663,14346;17311;18614;18938,21170,0,0,4,0,4
40757,90,9664,14010;14164;17564,21170,0,0,3,0,3
40758,90,9665,14166;14707;18446,21170,0,0,3,0,3
40759,90,9666,13928;14203;17338;17559,21170,0,0,4,0,4
40760,90,9667,14018;14229;19124,21170,0,1,2,0,3
40761,90,9668,14585,21170,0,0,1,0,1
40762,90,9669,14572;18438,21170,0,0,2,0,2
40763,90,9670,14322;14733;18900,21170,0,0,3,0,3
40764,90,9671,13748;14353;18964,21170,0,0,3,0,3
40765,90,9672,14804;17964;19275,21170,0,1,2,0,3
40766,90,9673,13538;13861;18038,21170,0,0,3,0,3
40767,90,9674,14943,21170,0,0,1,0,1
40768,90,9675,14193;14399;19305,21170,0,1,2,0,3
40769,90,9676,14414;14415;17993;18243;18593;18732,21170,0,0,6,0,6
40770,90,9677,14429;14719;18398;18803,21170,0,0,4,0,4
40771,90,9678,14021;14434;18723;18966,21170,0,0,4,0,4
40772,90,9679,14438;14479;19052,21170,0,0,3,0,3
40773,90,9680,14797;14908,21170,0,0,2,0,2
40774,90,9681,14736;14768;18303;18910;19637,21170,0,1,4,0,5
40775,90,9682,14062;14485;18922,21170,0,0,3,0,3
40776,90,9683,14263,21170,0,0,1,0,1
40777,90,9684,14175;14525;18101,21170,0,0,3,0,3
40778,90,9685,14534;14761;19252;20212,21170,0,2,2,0,4
40779,90,9686,14483;14547;19593,21170,0,1,2,0,3
40780,90,9687,14823;18390;20008,21170,0,1,2,0,3
40781,90,9688,14227;14555;18267,21170,0,0,3,0,3
40782,90,9689,15013;17349;18886,21170,0,0,3,0,3
40783,90,9690,14045;14588;18574;19450,21170,0,1,3,0,4
40784,90,9691,14475;14608;17922,21170,0,0,3,0,3
40785,90,9692,14616;14930,21170,0,0,2,0,2
40786,90,9693,10050,21535,0,0,0,1,1
40787,90,9694,10079,21535,0,0,0,1,1
40788,90,9696,10357,21535,0,0,0,1,1
40789,90,9697,10536,21535,0,0,0,1,1
40790,90,9708,11706;12389,21535,0,0,0,2,2
40791,90,9710,12033,21535,0,0,0,1,1
40792,90,9712,12200;12215,21535,0,0,0,2,2
40793,90,9715,12094,21535,0,0,0,1,1
40794,90,9717,12860;13128,21535,0,0,1,1,2
40795,90,9718,12390,21535,0,0,0,1,1
40796,90,9720,13243,21535,0,0,1,0,1
40797,90,9722,12677;12787;17776,21535,0,0,1,2,3
40798,90,9726,12619;12988;17953,21535,0,0,2,1,3
40799,90,9727,13512,21535,0,0,1,0,1
40800,90,9729,12762;13414;18068,21535,0,0,2,1,3
40801,90,9731,13153;13245,21535,0,0,2,0,2
40802,90,9732,13251,21535,0,0,1,0,1
40803,90,9733,13408;13725,21535,0,0,2,0,2
40804,90,9734,13758,21535,0,0,1,0,1
40805,90,9736,12887;13540,21535,0,0,2,0,2
40806,90,9738,13358;13960;18185,21535,0,0,3,0,3
40807,90,9739,13381;13412,21535,0,0,2,0,2
40808,90,9740,13627;13770;18341,21535,0,0,3,0,3
40809,90,9741,13073;13701,21535,0,0,2,0,2
40810,90,9742,13880;14077;18464,21535,0,0,3,0,3
40811,90,9743,14033,21535,0,0,1,0,1
40812,90,9744,13724;14278;18941,21535,0,0,3,0,3
40813,90,9745,13605;14065,21535,0,0,2,0,2
40814,90,9746,14698;14704;18337;19262,21535,0,1,3,0,4
40815,90,9747,13795;18914,21535,0,0,2,0,2
40816,90,9748,13235,21535,0,0,1,0,1
40817,90,9749,13614;13843;17668;18255;18552,21535,0,0,5,0,5
40818,90,9750,14425;14549;17962,21535,0,0,3,0,3
40819,90,9751,13737;13995;18818,21535,0,0,3,0,3
40820,90,9752,13949;14517,21535,0,0,2,0,2
40821,90,9753,13494;13965,21535,0,0,2,0,2
40822,90,9754,14627;19108;19288,21535,0,2,1,0,3
40823,90,9755,14328;18148,21535,0,0,2,0,2
40824,90,9756,13986;14441,21535,0,0,2,0,2
40825,90,9757,14004;18062,21535,0,0,2,0,2
40826,90,9758,14117;18488,21535,0,0,2,0,2
40827,90,9760,13286;14081,21535,0,0,2,0,2
40828,90,9761,14083;14965;18140;18260;18572;19560;20059,21535,0,2,5,0,7
40829,90,9762,14767;18522;19079,21535,0,1,2,0,3
40830,90,9763,13507;14142;18304,21535,0,0,3,0,3
40831,90,9764,14165;14409;19021,21535,0,0,3,0,3
40832,90,9765,14112;14548,21535,0,0,2,0,2
40833,90,9766,14066;14571;18082;18649,21535,0,0,4,0,4
40834,90,9767,14149;14336;18590,21535,0,0,3,0,3
40835,90,9768,14211;14726;19002,21535,0,0,3,0,3
40836,90,9769,13921;14220,21535,0,0,2,0,2
40837,90,9770,14179;14241;17904;18448;18832,21535,0,0,5,0,5
40838,90,9771,14261;14578;17724;18478,21535,0,0,4,0,4
40839,90,9772,13852;14012;17842;18963,21535,0,0,4,0,4
40840,90,9773,14028;14789;19876,21535,0,1,2,0,3
40841,90,9774,14849;18976;19482,21535,0,1,2,0,3
40842,90,9775,13686;14378;18201;19076,21535,0,1,3,0,4
40843,90,9776,14763;15028;18327;19009,21535,0,0,4,0,4
40844,90,9777,14239;14630,21535,0,0,2,0,2
40845,90,9778,14372;14857;18013;18384;18553,21535,0,0,5,0,5
40846,90,9779,14298;14406;17785;18492;19583,21535,0,1,4,0,5
40847,90,9780,14521;14540,21535,0,0,2,0,2
40848,90,9781,14413;18275;18736,21535,0,0,3,0,3
40849,90,9782,14316;14417;18476,21535,0,0,3,0,3
40850,90,9783,13726;14453;19286,21535,0,1,2,0,3
40851,90,9784,14103;14470;19178,21535,0,1,2,0,3
40852,90,9785,15139;19397,21535,0,1,1,0,2
40853,90,9786,15058;19476;19742,21535,0,2,1,0,3
40854,90,9787,14496;14645;19634,21535,0,1,2,0,3
40855,90,9788,14456;14618;18774;18792,21535,0,0,4,0,4
40856,90,9789,14523;17974;19328,21535,0,1,2,0,3
40857,90,9790,14544;18632;18998,21535,0,0,3,0,3
40858,90,9791,14573;14586;18071;18831,21535,0,0,4,0,4
40859,90,9792,14085;14581;18256,21535,0,0,3,0,3
40860,90,9793,14091;14615,21535,0,0,2,0,2
40861,90,9794,14633;14779;18519;19028,21535,0,0,4,0,4
40862,90,9795,14860;15099,21535,0,0,2,0,2
40863,90,9796,14454;18932;19651,21535,0,1,2,0,3
40864,90,9797,14326;14658;18602;18913,21535,0,0,4,0,4
40865,90,9798,14660;14723;17820;18745,21535,0,0,4,0,4
40866,90,9799,14731;14786;18860,21535,0,0,3,0,3
40867,90,9800,14735;14816;18193,21535,0,0,3,0,3
40868,90,9801,14743;14842;18365;19359,21535,0,1,3,0,4
40869,90,9807,10454,21900,0,0,0,1,1
40870,90,9815,11148,21900,0,0,0,1,1
40871,90,9819,11459;11475,21900,0,0,0,2,2
40872,90,9820,11547,21900,0,0,0,1,1
40873,90,9822,11633,21900,0,0,0,1,1
40874,90,9824,12647,21900,0,0,0,1,1
40875,90,9825,12354;17760,21900,0,0,1,1,2
40876,90,9826,12708,21900,0,0,0,1,1
40877,90,9831,12580;13111,21900,0,0,1,1,2
40878,90,9832,13000,21900,0,0,1,0,1
40879,90,9837,13113;13711;17831,21900,0,0,3,0,3
40880,90,9839,13279;13652;17582,21900,0,0,3,0,3
40881,90,9840,13207;13224,21900,0,0,2,0,2
40882,90,9841,13397,21900,0,0,1,0,1
40883,90,9842,13261,21900,0,0,1,0,1
40884,90,9843,13164;13504,21900,0,0,2,0,2
40885,90,9844,13555;13781;18020,21900,0,0,3,0,3
40886,90,9845,13476;13536,21900,0,0,2,0,2
40887,90,9847,13156;13625;17529,21900,0,0,3,0,3
40888,90,9849,13682;14432;18172;18363;19313,21900,0,1,4,0,5
40889,90,9850,13653;13718,21900,0,0,2,0,2
40890,90,9851,13786;14274;19295,21900,0,1,2,0,3
40891,90,9852,13745;14305,21900,0,0,2,0,2
40892,90,9853,13827;14079;17808;19401,21900,0,1,3,0,4
40893,90,9854,13956;18439,21900,0,0,2,0,2
40894,90,9856,13997;14190,21900,0,0,2,0,2
40895,90,9857,14001;14200;18862,21900,0,0,3,0,3
40896,90,9858,13874;18352;18534,21900,0,0,3,0,3
40897,90,9859,14036;14222;17885;18132,21900,0,0,4,0,4
40898,90,9861,14084;14727;18889,21900,0,0,3,0,3
40899,90,9862,14516;14762;19207;19346,21900,0,2,2,0,4
40900,90,9863,14758;18409;19282;19386,21900,0,2,2,0,4
40901,90,9864,13939;14095,21900,0,0,2,0,2
40902,90,9865,14007;14195;18583,21900,0,0,3,0,3
40903,90,9866,14105;14773;19138;19655,21900,0,2,2,0,4
40904,90,9867,15025,21900,0,0,1,0,1
40905,90,9868,14297;14394;18844,21900,0,0,3,0,3
40906,90,9869,14302;14893;18643;20299,21900,0,1,3,0,4
40907,90,9870,14593;14832;18266;18702;19149,21900,0,1,4,0,5
40908,90,9871,14226;15003;18310;19378,21900,0,1,3,0,4
40909,90,9872,14290;14345;19644,21900,0,1,2,0,3
40910,90,9873,14333;14355;18271,21900,0,0,3,0,3
40911,90,9874,14296;14364;18370,21900,0,0,3,0,3
40912,90,9875,13788,21900,0,0,1,0,1
40913,90,9876,14463;18069;18580,21900,0,0,3,0,3
40914,90,9877,14197;14864;18851;19861;20032,21900,0,2,3,0,5
40915,90,9878,13869;14753;17566;18692;19225,21900,0,1,4,0,5
40916,90,9879,13846;14430;19173;19326,21900,0,2,2,0,4
40917,90,9881,14600;14813;18296;19153,21900,0,1,3,0,4
40918,90,9882,14843;15051;19561;19987,21900,0,2,2,0,4
40919,90,9883,14492;14524;18712;19185,21900,0,1,3,0,4
40920,90,9884,14819;17961,21900,0,0,2,0,2
40921,90,9885,14531;15331;18510;19214,21900,0,1,3,0,4
40922,90,9886,14371;14641;18875;19244;19367,21900,0,2,3,0,5
40923,90,9887,14560;14689;18809,21900,0,0,3,0,3
40924,90,9888,14472;14567;18621,21900,0,0,3,0,3
40925,90,9890,14599;14622,21900,0,0,2,0,2
40926,90,9891,14624;15313;18297;18635,21900,0,0,4,0,4
40927,90,9892,13983;14628;19877,21900,0,1,2,0,3
40928,90,9893,14445;14635,21900,0,0,2,0,2
40929,90,9894,14657;14668;18893,21900,0,0,3,0,3
40930,90,9895,14669;15005;18430;18787,21900,0,0,4,0,4
40931,90,9896,15229;19104;19405,21900,0,2,1,0,3
40932,90,9897,14683;17707;18871,21900,0,0,3,0,3
40933,90,9898,14715;15280;17789;18079,21900,0,0,4,0,4
40934,90,9899,14740;15056;18962;19276,21900,0,1,3,0,4
40935,90,9900,14717;14749;18064;18268;18360;18737;19662,21900,0,1,6,0,7
40936,90,9901,14927;15265;17897;18432;19012;19537,21900,0,1,5,0,6
40937,90,9902,15283;18870,21900,0,0,2,0,2
40938,90,9903,15305;19695,21900,0,1,1,0,2
40939,90,9904,14649;17610;18544,21900,0,0,3,0,3
40940,90,9905,10881,22265,0,0,0,1,1
40941,90,9909,10533,22265,0,0,0,1,1
40942,90,9910,10444,22265,0,0,0,1,1
40943,90,9911,10765,22265,0,0,0,1,1
40944,90,9913,11011,22265,0,0,0,1,1
40945,90,9917,11309;11383,22265,0,0,0,2,2
40946,90,9925,12325;12544,22265,0,0,0,2,2
40947,90,9932,13009;13119;17612,22265,0,0,3,0,3
40948,90,9933,13049,22265,0,0,1,0,1
40949,90,9934,13147;13500,22265,0,0,2,0,2
40950,90,9938,13456;14082;17732,22265,0,0,3,0,3
40951,90,9939,13521;13697;17914;18728;18880,22265,0,0,5,0,5
40952,90,9940,14250;18629,22265,0,0,2,0,2
40953,90,9941,13604;17666,22265,0,0,2,0,2
40954,90,9942,13728,22265,0,0,1,0,1
40955,90,9943,13775,22265,0,0,1,0,1
40956,90,9944,13787;14311;19082,22265,0,1,2,0,3
40957,90,9946,13810;13847,22265,0,0,2,0,2
40958,90,9947,13864;13915;18744,22265,0,0,3,0,3
40959,90,9948,14106;14338;18386;19031,22265,0,0,4,0,4
40960,90,9949,13955;14626,22265,0,0,2,0,2
40961,90,9951,13994;19393,22265,0,1,1,0,2
40962,90,9952,13922;14201;18344,22265,0,0,3,0,3
40963,90,9953,13505;14159;19595,22265,0,1,2,0,3
40964,90,9954,14541;18766;19049;19518,22265,0,1,3,0,4
40965,90,9955,14258;14713;19095;19733,22265,0,2,2,0,4
40966,90,9956,13759;14170,22265,0,0,2,0,2
40967,90,9957,14122;14254,22265,0,0,2,0,2
40968,90,9958,14257;14724;19321;20127,22265,0,2,2,0,4
40969,90,9959,14180;14344;19325,22265,0,1,2,0,3
40970,90,9960,14883;14920;18760;19024;19611,22265,0,1,4,0,5
40971,90,9961,14301;15320;19566;19657,22265,0,2,2,0,4
40972,90,9962,14309;14889;18433,22265,0,0,3,0,3
40973,90,9964,14172;14349;17763;19267,22265,0,1,3,0,4
40974,90,9965,14377;14900;18847;19368,22265,0,1,3,0,4
40975,90,9966,14383;14703;18230,22265,0,0,3,0,3
40976,90,9967,14156;14388;18509,22265,0,0,3,0,3
40977,90,9968,14398;14807;18202;19039;19347,22265,0,1,4,0,5
40978,90,9969,14464;17786,22265,0,0,2,0,2
40979,90,9970,14476;14631,22265,0,0,2,0,2
40980,90,9971,14493;15031,22265,0,0,2,0,2
40981,90,9972,14507;15135,22265,0,0,2,0,2
40982,90,9973,14553;19350;19709,22265,0,2,1,0,3
40983,90,9974,14569;14796,22265,0,0,2,0,2
40984,90,9975,14771;18356;18721;18984;19399,22265,0,1,4,0,5
40985,90,9979,14632;15263;18997;19273;19770,22265,0,2,3,0,5
40986,90,9980,14640;15178;19143,22265,0,1,2,0,3
40987,90,9981,14307;14670,22265,0,0,2,0,2
40988,90,9982,14411;14671;17740,22265,0,0,3,0,3
40989,90,9983,15220;15231;18047;19402,22265,0,1,3,0,4
40990,90,9984,14422;14721;18541,22265,0,0,3,0,3
40991,90,9985,14421;14742;17069;19072,22265,0,1,3,0,4
40992,90,9987,14528;14869;19279,22265,0,1,2,0,3
40993,90,9988,14583;14803;19414;19705,22265,0,2,2,0,4
40994,90,9990,15142;15304;19270;19766,22265,0,2,2,0,4
40995,90,9991,14488;14877;19316,22265,0,1,2,0,3
40996,90,9992,14562;14879;19570;19974,22265,0,2,2,0,4
40997,90,9993,14542;14911;18250,22265,0,0,3,0,3
40998,90,9995,14729;15462;17832;19026,22265,0,0,4,0,4
40999,90,9996,14936,22265,0,0,1,0,1
41000,90,9997,15083;18644,22265,0,0,2,0,2
41001,90,9998,14718;14953;18927,22265,0,0,3,0,3
41002,90,9999,14907;14964;18711;19371,22265,0,1,3,0,4
41003,90,10000,14918;14973,22265,0,0,2,0,2
41004,90,10001,14978;14981;17595;18849;19487,22265,0,1,4,0,5
41005,90,10002,15016;15120,22265,0,0,2,0,2
41006,90,10003,15019;15152;18192;18954,22265,0,0,4,0,4
41007,90,10014,11021;11332,22630,0,0,0,2,2
41008,90,10015,11306,22630,0,0,0,1,1
41009,90,10019,11229,22630,0,0,0,1,1
41010,90,10026,12250,22630,0,0,0,1,1
41011,90,10031,12441;12774;18030,22630,0,0,1,2,3
41012,90,10037,12898;13285,22630,0,0,2,0,2
41013,90,10038,12783,22630,0,0,0,1,1
41014,90,10039,13069,22630,0,0,1,0,1
41015,90,10043,13239,22630,0,0,1,0,1
41016,90,10044,13385;13524,22630,0,0,2,0,2
41017,90,10046,13595;13639,22630,0,0,2,0,2
41018,90,10047,13105;13623;18150,22630,0,0,3,0,3
41019,90,10048,13357;13480;17787,22630,0,0,3,0,3
41020,90,10049,13794;14174,22630,0,0,2,0,2
41021,90,10050,13317;13568;18350,22630,0,0,3,0,3
41022,90,10051,13651;14060,22630,0,0,2,0,2
41023,90,10052,13393;13574;18392,22630,0,0,3,0,3
41024,90,10053,14348;18395,22630,0,0,2,0,2
41025,90,10054,13615;13857;18550,22630,0,0,3,0,3
41026,90,10055,13834;14589;19233;19530,22630,0,2,2,0,4
41027,90,10056,13898;17815;18380,22630,0,0,3,0,3
41028,90,10061,14477;14559;18093;18679,22630,0,0,4,0,4
41029,90,10063,14712;14839,22630,0,0,2,0,2
41030,90,10064,14209;14590,22630,0,0,2,0,2
41031,90,10065,14217;14367;17945,22630,0,0,3,0,3
41032,90,10066,14249;14306;18477;18521,22630,0,0,4,0,4
41033,90,10068,14255;14491;18907;19307,22630,0,1,3,0,4
41034,90,10069,14293;14577;18332,22630,0,0,3,0,3
41035,90,10071,14342;17777;17933,22630,0,0,3,0,3
41036,90,10072,14374;19658,22630,0,1,1,0,2
41037,90,10073,13879;14393;18424;18640;19144,22630,0,1,4,0,5
41038,90,10074,14780;18912;19137,22630,0,1,2,0,3
41039,90,10076,14452;15055,22630,0,0,2,0,2
41040,90,10077,13885;14455;18566;19259,22630,0,1,3,0,4
41041,90,10078,14433;14502,22630,0,0,2,0,2
41042,90,10079,14148;14437;19067,22630,0,1,2,0,3
41043,90,10081,14489;14610,22630,0,0,2,0,2
41044,90,10082,14280;14419;18812;19148,22630,0,1,3,0,4
41045,90,10083,14607;15112,22630,0,0,2,0,2
41046,90,10084,14884;18830;19963,22630,0,1,2,0,3
41047,90,10085,14299;14623;18709;18975,22630,0,0,4,0,4
41048,90,10086,14837;18586;19721,22630,0,1,2,0,3
41049,90,10087,14684;15123;18314;20099,22630,0,1,3,0,4
41050,90,10088,15136;18800;19116,22630,0,1,2,0,3
41051,90,10089,14783;15475;19496;19685;20535,22630,1,2,2,0,5
41052,90,10090,15261;15601;17793;18159;19134;20007,22630,0,2,4,0,6
41053,90,10091,14295;15225;17860,22630,0,0,3,0,3
41054,90,10092,14566;14854;19154;19808,22630,0,2,2,0,4
41055,90,10093,14886;15449;19046;19080;19241;19624;20092,22630,0,4,3,0,7
41056,90,10094,14921;18661;19055,22630,0,0,3,0,3
41057,90,10095,14919;14958;19129,22630,0,1,2,0,3
41058,90,10096,14687;14990;18503,22630,0,0,3,0,3
41059,90,10097,14992;19339;19955,22630,0,2,1,0,3
41060,90,10098,15297;18055,22630,0,0,2,0,2
41061,90,10099,14770;15413;20050;20245,22630,0,2,2,0,4
41062,90,10100,14647;15007;18616;18829,22630,0,0,4,0,4
41063,90,10101,14426;15023;18329;19023,22630,0,0,4,0,4
41064,90,10102,14708;14897;18630,22630,0,0,3,0,3
41065,90,10103,14759;15166,22630,0,0,2,0,2
41066,90,10104,15034;15239,22630,0,0,2,0,2
41067,90,10105,15064;15469,22630,0,0,2,0,2
41068,90,10106,15075;18676;19592,22630,0,1,2,0,3
41069,90,10107,15081;15147;18029;18459,22630,0,0,4,0,4
41070,90,10108,14983;15085;17931;18425,22630,0,0,4,0,4
41071,90,10109,15093;19910,22630,0,1,1,0,2
41072,90,10110,15111;15114;18603;19112,22630,0,1,3,0,4
41073,90,10111,14352;14935;19420,22630,0,1,2,0,3
41074,90,10112,15198;15388,22630,0,0,2,0,2
41075,90,10113,14646;15273;19038;19257,22630,0,1,3,0,4
41076,90,10114,15170;15230;19299;19457,22630,0,2,2,0,4
41077,90,10115,15176,22630,0,0,1,0,1
41078,90,10119,10544,22995,0,0,0,1,1
41079,90,10120,10702,22995,0,0,0,1,1
41080,90,10121,10611,22995,0,0,0,1,1
41081,90,10122,10886;11060,22995,0,0,0,2,2
41082,90,10125,10549,22995,0,0,0,1,1
41083,90,10126,11056,22995,0,0,0,1,1
41084,90,10127,11047,22995,0,0,0,1,1
41085,90,10128,10846,22995,0,0,0,1,1
41086,90,10131,10704,22995,0,0,0,1,1
41087,90,10132,11031,22995,0,0,0,1,1
41088,90,10133,11254;11268,22995,0,0,0,2,2
41089,90,10134,11258,22995,0,0,0,1,1
41090,90,10135,11289,22995,0,0,0,1,1
41091,90,10145,12613;12707;18403,22995,0,0,1,2,3
41092,90,10150,12817,22995,0,0,0,1,1
41093,90,10158,13338;14233;17980;18837,22995,0,0,4,0,4
41094,90,10160,13416;13820;18657;18853,22995,0,0,4,0,4
41095,90,10162,13592;14136;18325;19010,22995,0,0,4,0,4
41096,90,10163,13061;13345;18239;18684,22995,0,0,4,0,4
41097,90,10164,13689;13988;18294;18748,22995,0,0,4,0,4
41098,90,10165,13558;13873;18772,22995,0,0,3,0,3
41099,90,10167,14024;14428,22995,0,0,2,0,2
41100,90,10168,13691;14031;18456;18848,22995,0,0,4,0,4
41101,90,10169,13433;14040;18345;18592,22995,0,0,4,0,4
41102,90,10170,13597;14370;19184,22995,0,1,2,0,3
41103,90,10172,14163;14221;18119;18211,22995,0,0,4,0,4
41104,90,10173,14173;14176;17928;18511,22995,0,0,4,0,4
41105,90,10175,14020;14384,22995,0,0,2,0,2
41106,90,10176,14248;18391;18600,22995,0,0,3,0,3
41107,90,10177,15400;19372;19474,22995,0,2,1,0,3
41108,90,10178,14416;14674;18944,22995,0,0,3,0,3
41109,90,10179,14300;14538;18195,22995,0,0,3,0,3
41110,90,10180,14629;18776;18919,22995,0,0,3,0,3
41111,90,10181,13925;14744;18318;18974;19827,22995,0,1,4,0,5
41112,90,10182,14887;15252;19588,22995,0,1,2,0,3
41113,90,10183,13822;14467;18594;19000,22995,0,0,4,0,4
41114,90,10184,13814;13984;19630;19882,22995,0,2,2,0,4
41115,90,10185,14480;15061;18790,22995,0,0,3,0,3
41116,90,10186,14498;15578;18815;18969;19363;19555;20037;20521,22995,1,3,4,0,8
41117,90,10187,14281;14505,22995,0,0,2,0,2
41118,90,10188,14520;14991;18181;19099;19444,22995,0,2,3,0,5
41119,90,10189,14545;15029,22995,0,0,2,0,2
41120,90,10190,14579,22995,0,0,1,0,1
41121,90,10191,14482;14591;18413;18740,22995,0,0,4,0,4
41122,90,10192,14855;15041;19110,22995,0,1,2,0,3
41123,90,10193,14101;14667;19195,22995,0,1,2,0,3
41124,90,10194,14693;14722,22995,0,0,2,0,2
41125,90,10195,14636;14706;18366,22995,0,0,3,0,3
41126,90,10196,14808;19106;19526,22995,0,2,1,0,3
41127,90,10197,14686;14863;18701,22995,0,0,3,0,3
41128,90,10198,14873;15199;19329,22995,0,1,2,0,3
41129,90,10199,15551;17806;18299;18691;19125;19591,22995,0,2,4,0,6
41130,90,10200,14881;15128;18854,22995,0,0,3,0,3
41131,90,10201,14894;18816;18970,22995,0,0,3,0,3
41132,90,10202,15221;18264,22995,0,0,2,0,2
41133,90,10203,14925;15151;18834;19389;19468,22995,0,2,3,0,5
41134,90,10204,14929;15290;18675,22995,0,0,3,0,3
41135,90,10205,15108;15430;18379;18508;18794;19324,22995,0,1,5,0,6
41136,90,10206,14692;15002;18037;18717,22995,0,0,4,0,4
41137,90,10207,14774;15011;17991;19260,22995,0,1,3,0,4
41138,90,10208,15040;15595,22995,0,0,2,0,2
41139,90,10209,15050;18757;19042;19499,22995,0,1,3,0,4
41140,90,10210,15066;15196;19357;19670,22995,0,2,2,0,4
41141,90,10211,14966;15492;18799,22995,0,0,3,0,3
41142,90,10212,15024;15560;18039;18287;19330,22995,0,1,4,0,5
41143,90,10213,15127,22995,0,0,1,0,1
41144,90,10215,15195;18504;18680;19558,22995,0,1,3,0,4
41145,90,10216,15202;15524;18588,22995,0,0,3,0,3
41146,90,10217,15209;18882;19258;19927,22995,0,2,2,0,4
41147,90,10218,15241;15625,22995,0,0,2,0,2
41148,90,10219,15256;15636;18358,22995,0,0,3,0,3
41149,90,10226,10852,23360,0,0,0,1,1
41150,90,10232,11648,23360,0,0,0,1,1
41151,90,10236,12346,23360,0,0,0,1,1
41152,90,10239,12948,23360,0,0,1,0,1
41153,90,10245,13437;13648;18412,23360,0,0,3,0,3
41154,90,10247,13935;14208,23360,0,0,2,0,2
41155,90,10248,13425;13903;18382,23360,0,0,3,0,3
41156,90,10249,13860;14219;18414,23360,0,0,3,0,3
41157,90,10250,13805;13884;18035,23360,0,0,3,0,3
41158,90,10251,13917;17966,23360,0,0,2,0,2
41159,90,10252,13419;13875,23360,0,0,2,0,2
41160,90,10253,14777;14892;18589,23360,0,0,3,0,3
41161,90,10254,14210;14275;18568;19266,23360,0,1,3,0,4
41162,90,10255,13817;13991,23360,0,0,2,0,2
41163,90,10256,14279;15212;18863;19165,23360,0,1,3,0,4
41164,90,10257,14283;15059;19917;20125,23360,0,2,2,0,4
41165,90,10258,14135,23360,0,0,1,0,1
41166,90,10259,14442;14714;18828;19361,23360,0,1,3,0,4
41167,90,10260,14323,23360,0,0,1,0,1
41168,90,10262,14504;14734;18339,23360,0,0,3,0,3
41169,90,10263,14518;18273,23360,0,0,2,0,2
41170,90,10264,14939;18822,23360,0,0,2,0,2
41171,90,10265,14787;15204;18669;18999;19096,23360,0,1,4,0,5
41172,90,10266,14508;14781;18315;18797,23360,0,0,4,0,4
41173,90,10267,14795;15380;18924,23360,0,0,3,0,3
41174,90,10268,14487;15223;18183;18482;19494,23360,0,1,4,0,5
41175,90,10269,15394;15480;18671,23360,0,0,3,0,3
41176,90,10270,14820;15217;18934;19223,23360,0,1,3,0,4
41177,90,10271,14874;15067;18804;19988,23360,0,1,3,0,4
41178,90,10273,14895;14933;19568,23360,0,1,2,0,3
41179,90,10274,14576;15206;19493;19750,23360,0,2,2,0,4
41180,90,10275,14634;14951;19587,23360,0,1,2,0,3
41181,90,10276,14972;15439;18939;19089;19982,23360,0,2,3,0,5
41182,90,10277,15045;15516,23360,0,0,2,0,2
41183,90,10278,15052;15193;19020;19248,23360,0,1,3,0,4
41184,90,10279,15062;15819;18686;19421;19775,23360,0,2,3,0,5
41185,90,10281,14912;15094,23360,0,0,2,0,2
41186,90,10283,14824;15113,23360,0,0,2,0,2
41187,90,10284,15150;15197,23360,0,0,2,0,2
41188,90,10285,14814;15589;19298;19417;19790;19998,23360,0,4,2,0,6
41189,90,10286,14836;15191;18463,23360,0,0,3,0,3
41190,90,10287,15535;15827;19034;19196,23360,0,1,3,0,4
41191,90,10288,15210;15849;20486,23360,1,0,2,0,3
41192,90,10289,14682;15047;18218;19471,23360,0,1,3,0,4
41193,90,10290,14659;15227;18713,23360,0,0,3,0,3
41194,90,10291,14347;15260;18672;18789;19088,23360,0,1,4,0,5
41195,90,10292,15310;15419;19212;19403;20061,23360,0,3,2,0,5
41196,90,10293,15809;19215;19621;19867,23360,0,3,1,0,4
41197,90,10294,15334;18411;19018,23360,0,0,3,0,3
41198,90,10295,15348;19762;19945;20304,23360,0,3,1,0,4
41199,90,10296,15322;15474;18678;19432,23360,0,1,3,0,4
41200,90,10297,14987;15363,23360,0,0,2,0,2
41201,90,10298,15091;15592;18135;18242;18526,23360,0,0,5,0,5
41202,90,10299,15710;15855;20131,23360,0,1,2,0,3
41203,90,10300,15203;15667;19311;19344,23360,0,2,2,0,4
41204,90,10302,15440;15712,23360,0,0,2,0,2
41205,90,10303,14861;15441;19521;19726;19781,23360,0,3,2,0,5
41206,90,10305,15457;15818;18369,23360,0,0,3,0,3
41207,90,10306,14679;15467;18696;18840;19373,23360,0,1,4,0,5
41208,90,10309,10997;11134,23725,0,0,0,2,2
41209,90,10314,11351,23725,0,0,0,1,1
41210,90,10318,11921,23725,0,0,0,1,1
41211,90,10319,11566;12102,23725,0,0,0,2,2
41212,90,10320,11753,23725,0,0,0,1,1
41213,90,10325,12869,23725,0,0,1,0,1
41214,90,10327,12868;13167,23725,0,0,2,0,2
41215,90,10331,12826;13282;18796,23725,0,0,2,1,3
41216,90,10333,13376;13765,23725,0,0,2,0,2
41217,90,10336,13288;13567,23725,0,0,2,0,2
41218,90,10340,13753;13992;18646,23725,0,0,3,0,3
41219,90,10344,13911;13977;19100,23725,0,1,2,0,3
41220,90,10346,14407;18673,23725,0,0,2,0,2
41221,90,10350,14236;18898,23725,0,0,2,0,2
41222,90,10352,14321;14754;18769;19098,23725,0,1,3,0,4
41223,90,10353,14431;14757;18080;19454,23725,0,1,3,0,4
41224,90,10354,14499;14833;19392;19443,23725,0,2,2,0,4
41225,90,10355,14511,23725,0,0,1,0,1
41226,90,10356,14519;14609,23725,0,0,2,0,2
41227,90,10357,14075;14550;18554,23725,0,0,3,0,3
41228,90,10358,14324;14574;18441;18865;19620,23725,0,1,4,0,5
41229,90,10359,14650;14739;18136;18990,23725,0,0,4,0,4
41230,90,10360,14129;14691;18650;19115;19736,23725,0,2,3,0,5
41231,90,10361,14461;14738,23725,0,0,2,0,2
41232,90,10362,14439;14756;18176;19293,23725,0,1,3,0,4
41233,90,10363,14810;18084;18842,23725,0,0,3,0,3
41234,90,10364,15022;15830;18887;19107;19351,23725,0,2,3,0,5
41235,90,10365,15301;15424,23725,0,0,2,0,2
41236,90,10366,14111;14858;18460,23725,0,0,3,0,3
41237,90,10367,14447;14868;19354,23725,0,1,2,0,3
41238,90,10368,15487;16322;19179;19456;19971,23725,0,3,2,0,5
41239,90,10369,15097;18894,23725,0,0,2,0,2
41240,90,10370,14913;18491,23725,0,0,2,0,2
41241,90,10371,14924;19590,23725,0,1,1,0,2
41242,90,10372,15200;15270;19113;19315,23725,0,2,2,0,4
41243,90,10373,14568;14948;20252,23725,0,1,2,0,3
41244,90,10375,14582;14750;18835,23725,0,0,3,0,3
41245,90,10376,15010;15205;18658,23725,0,0,3,0,3
41246,90,10377,15027;15159;18540;20508,23725,1,0,3,0,4
41247,90,10378,15036;18217;18715;19253,23725,0,1,3,0,4
41248,90,10379,15044;15048;19504;20219,23725,0,2,2,0,4
41249,90,10380,14968;18821,23725,0,0,2,0,2
41250,90,10381,15049;15233,23725,0,0,2,0,2
41251,90,10382,15464;18531;18755;19006,23725,0,0,4,0,4
41252,90,10383,15038;20289,23725,0,1,1,0,2
41253,90,10384,14961;15098;18280;19268;19718,23725,0,2,3,0,5
41254,90,10385,15429,23725,0,0,1,0,1
41255,90,10386,15137;18497;19136,23725,0,1,2,0,3
41256,90,10387,15107;15138;18533,23725,0,0,3,0,3
41257,90,10389,14587;14806,23725,0,0,2,0,2
41258,90,10390,14998;15489;18263;19317,23725,0,1,3,0,4
41259,90,10391,15309;15398;18573;18791,23725,0,0,4,0,4
41260,90,10392,15092;15311;18758;18902;19508,23725,0,1,4,0,5
41261,90,10393,15181;15332;18707;18841,23725,0,0,4,0,4
41262,90,10394,15342;18850;19126;19200;19794,23725,0,3,2,0,5
41263,90,10395,15276;15308;18338;19627,23725,0,1,3,0,4
41264,90,10396,15766;18261;19191,23725,0,1,2,0,3
41265,90,10397,14944;15881;18977;19572;19755,23725,0,2,3,0,5
41266,90,10398,15695;18284,23725,0,0,2,0,2
41267,90,10399,15390;15763,23725,0,0,2,0,2
41268,90,10400,15391,23725,0,0,1,0,1
41269,90,10401,15402;15839;19427,23725,0,1,2,0,3
41270,90,10402,15973;16007;18245;18581;19622;19722,23725,0,2,4,0,6
41271,90,10403,15101;15425,23725,0,0,2,0,2
41272,90,10404,15432;15858;19064,23725,0,1,2,0,3
41273,90,10405,15192;15453;18986;19114;19381,23725,0,2,3,0,5
41274,90,10406,15184;15466,23725,0,0,2,0,2
41275,90,10407,15456;15848,23725,0,0,2,0,2
41276,90,10408,15164;15478;19564;19789,23725,0,2,2,0,4
41277,90,10409,15483;15749;19203;19409,23725,0,2,2,0,4
41278,90,10410,14931;15500;18302;20076;20253,23725,0,2,3,0,5
41279,90,10411,15501;15941;18995,23725,0,0,3,0,3
41280,90,10412,15504;15675;19607;20242,23725,0,2,2,0,4
41281,90,10413,15507;15664;18560;19044;19446,23725,0,1,4,0,5
41282,90,10414,15396;15582;18926;19501,23725,0,1,3,0,4
41283,90,10415,16031;20442,23725,1,0,1,0,2
41284,90,10416,15654;15904;18619;19171,23725,0,1,3,0,4
41285,90,10417,15547;15990;19668;20287,23725,0,2,2,0,4
41286,90,10418,15359;15550;18819;19412;19857,23725,0,2,3,0,5
41287,90,10419,15556;18957;19802,23725,0,1,2,0,3
41288,90,10420,15564;15568;18285;18762;19479,23725,0,1,4,0,5
41289,90,10421,15286;15597;18313;19057,23725,0,1,3,0,4
41290,90,10422,10811,24090,0,0,0,1,1
41291,90,10423,10644,24090,0,0,0,1,1
41292,90,10430,10979,24090,0,0,0,1,1
41293,90,10432,11435,24090,0,0,0,1,1
41294,90,10433,11433,24090,0,0,0,1,1
41295,90,10440,11939,24090,0,0,0,1,1
41296,90,10442,12342,24090,0,0,0,1,1
41297,90,10446,12306,24090,0,0,0,1,1
41298,90,10448,12840,24090,0,0,0,1,1
41299,90,10449,13058;13452,24090,0,0,2,0,2
41300,90,10452,13764;18973,24090,0,0,2,0,2
41301,90,10453,13352;13886,24090,0,0,2,0,2
41302,90,10457,14213,24090,0,0,1,0,1
41303,90,10458,13399;13727,24090,0,0,2,0,2
41304,90,10462,14039;14494,24090,0,0,2,0,2
41305,90,10463,14313;14450;18220,24090,0,0,3,0,3
41306,90,10468,14829;14840;18624;19035,24090,0,0,4,0,4
41307,90,10469,14286;14746;19646,24090,0,1,2,0,3
41308,90,10470,14551;14794;18606;19085,24090,0,1,3,0,4
41309,90,10471,14104;14664;18585,24090,0,0,3,0,3
41310,90,10478,15420;19712;19887,24090,0,2,1,0,3
41311,90,10479,14916;15132,24090,0,0,2,0,2
41312,90,10481,14851;15000;18946;19425,24090,0,1,3,0,4
41313,90,10482,14391,24090,0,0,1,0,1
41314,90,10483,14903;15087,24090,0,0,2,0,2
41315,90,10484,14956;14967;18839;19729,24090,0,1,3,0,4
41316,90,10485,14970;14986;18978,24090,0,0,3,0,3
41317,90,10486,14675;14997;18779,24090,0,0,3,0,3
41318,90,10488,15406,24090,0,0,1,0,1
41319,90,10489,14818;15014;18423;19213,24090,0,1,3,0,4
41320,90,10490,15070;15542;18656;19008;19707,24090,0,1,4,0,5
41321,90,10491,14811;15043;19208;19442,24090,0,2,2,0,4
41322,90,10492,15892;20370,24090,0,1,1,0,2
41323,90,10493,15246;15267;18859;19111,24090,0,1,3,0,4
41324,90,10494,14891;15555;19337;20342,24090,0,2,2,0,4
41325,90,10495,15131;15375,24090,0,0,2,0,2
41326,90,10496,14993;15134;18685;18967,24090,0,0,4,0,4
41327,90,10497,15141;15786;18985;19848,24090,0,1,3,0,4
41328,90,10498,14982;15172;19166,24090,0,1,2,0,3
41329,90,10500,15294;19127;19320,24090,0,2,1,0,3
41330,90,10501,15222;15367;19795,24090,0,1,2,0,3
41331,90,10502,15248;16050;18410;19332;20649,24090,1,1,3,0,5
41332,90,10503,15250;18917;19281,24090,0,1,2,0,3
41333,90,10504,15275;15872,24090,0,0,2,0,2
41334,90,10505,15754;15844;19862,24090,0,1,2,0,3
41335,90,10506,15696;18785;19118;19880,24090,0,2,2,0,4
41336,90,10507,15811,24090,0,0,1,0,1
41337,90,10508,15326;19398;20209,24090,0,2,1,0,3
41338,90,10509,15249;15338;19362;19648,24090,0,2,2,0,4
41339,90,10510,14940;15339;18813;19261;19447,24090,0,2,3,0,5
41340,90,10511,15361;15604;18928;19384;20536,24090,1,1,3,0,5
41341,90,10512,15105;15902;18364;19063;19713,24090,0,2,3,0,5
41342,90,10513,15421;15869;18520;18654,24090,0,0,4,0,4
41343,90,10514,15257;15426,24090,0,0,2,0,2
41344,90,10515,15427;15650;18641;19576,24090,0,1,3,0,4
41345,90,10516,15008;15437;18252;18326;19629,24090,0,1,4,0,5
41346,90,10517,15586;16103;20254,24090,0,1,2,0,3
41347,90,10518,15350;15444,24090,0,0,2,0,2
41348,90,10519,15496;15622,24090,0,0,2,0,2
41349,90,10520,15506;15831;18406;19650,24090,0,1,3,0,4
41350,90,10521,14962;15530;18611;19333;19567;20029,24090,0,3,3,0,6
41351,90,10522,14720;15581;19218;19531;19812,24090,0,3,2,0,5
41352,90,10523,15012;15583;18929;19264,24090,0,1,3,0,4
41353,90,10524,15307;15598;18798,24090,0,0,3,0,3
41354,90,10525,15262;15613;19983,24090,0,1,2,0,3
41355,90,10526,15615;16024;18980,24090,0,0,3,0,3
41356,90,10527,15436;15671;19873,24090,0,1,2,0,3
41357,90,10528,15635;15655,24090,0,0,2,0,2
41358,90,10529,15757;15822,24090,0,0,2,0,2
41359,90,10530,15649;15891;19470;19884;20164,24090,0,3,2,0,5
41360,90,10531,15660;15835;19300,24090,0,1,2,0,3
41361,90,10532,15562;15926,24090,0,0,2,0,2
41362,90,10533,15680;15741;19103;19573,24090,0,2,2,0,4
41363,90,10534,15540;15689;18191;18542;19498,24090,0,1,4,0,5
41364,90,10536,10950,24455,0,0,0,1,1
41365,90,10540,11449,24455,0,0,0,1,1
41366,90,10541,11230,24455,0,0,0,1,1
41367,90,10544,11670;11767,24455,0,0,0,2,2
41368,90,10559,13342;13750;18535,24455,0,0,3,0,3
41369,90,10562,13529,24455,0,0,1,0,1
41370,90,10565,13798,24455,0,0,1,0,1
41371,90,10568,13859,24455,0,0,1,0,1
41372,90,10570,14654;18388;18525;18695,24455,0,0,4,0,4
41373,90,10572,13998;14185,24455,0,0,2,0,2
41374,90,10573,15282;15678;19383;19569,24455,0,2,2,0,4
41375,90,10575,14847;18652;19239,24455,0,1,2,0,3
41376,90,10578,14564,24455,0,0,1,0,1
41377,90,10579,14490;14639,24455,0,0,2,0,2
41378,90,10580,14273;14644;18899;19255,24455,0,1,3,0,4
41379,90,10581,14690;14764;18705,24455,0,0,3,0,3
41380,90,10582,14732;14890;19204,24455,0,1,2,0,3
41381,90,10583,14277;14711;18788,24455,0,0,3,0,3
41382,90,10584,14841;14844;19507,24455,0,1,2,0,3
41383,90,10585,14662;14791;18753;19073,24455,0,1,3,0,4
41384,90,10586,15215;15727;18751;19653,24455,0,1,3,0,4
41385,90,10590,14457;14752;18421,24455,0,0,3,0,3
41386,90,10591,15355;18940;19292,24455,0,1,2,0,3
41387,90,10592,14294;14605,24455,0,0,2,0,2
41388,90,10595,14866;15030;19377;19469,24455,0,2,2,0,4
41389,90,10596,14946;15096,24455,0,0,2,0,2
41390,90,10597,15037;15569;18814;19407;19768;19916,24455,0,3,3,0,6
41391,90,10600,15103;15149;20279,24455,0,1,2,0,3
41392,90,10601,15169;15251;19139;19235,24455,0,2,2,0,4
41393,90,10602,15146;15148,24455,0,0,2,0,2
41394,90,10603,15168;19535;19737,24455,0,2,1,0,3
41395,90,10604,15171;15360,24455,0,0,2,0,2
41396,90,10605,14898;15174;19007;19145,24455,0,1,3,0,4
41397,90,10606,15228;15677;18767;20527,24455,1,0,3,0,4
41398,90,10607,15742;19081;20922,24455,1,1,1,0,3
41399,90,10608,15296;16035;18718;19176;19571,24455,0,2,3,0,5
41400,90,10609,15302;15854;18874,24455,0,0,3,0,3
41401,90,10610,15086;15523;18855,24455,0,0,3,0,3
41402,90,10612,15374;15937;18909;20016,24455,0,1,3,0,4
41403,90,10613,15386;20248,24455,0,1,1,0,2
41404,90,10614,15442;18719;18827;19853,24455,0,1,3,0,4
41405,90,10615,14772;15454;18993;19348,24455,0,1,3,0,4
41406,90,10616,15494;15912,24455,0,0,2,0,2
41407,90,10617,15497;15505;18781;19043;19132,24455,0,1,4,0,5
41408,90,10618,16063;16152;18892;19037;19554,24455,0,1,4,0,5
41409,90,10619,15468,24455,0,0,1,0,1
41410,90,10620,15544;15594;18383;18807;19175,24455,0,1,4,0,5
41411,90,10622,15565;15669;19029,24455,0,0,3,0,3
41412,90,10623,15584;15808;19290,24455,0,1,2,0,3
41413,90,10624,15895;18537;19162,24455,0,1,2,0,3
41414,90,10625,15362;15927;19485;19793,24455,0,2,2,0,4
41415,90,10626,14871;15642,24455,0,0,2,0,2
41416,90,10627,15566;16182;19135;20046,24455,0,2,2,0,4
41417,90,10628,15681,24455,0,0,1,0,1
41418,90,10629,15700;16047,24455,0,0,2,0,2
41419,90,10630,15495;15703;18349;18443,24455,0,0,4,0,4
41420,90,10632,15272;15714;18559,24455,0,0,3,0,3
41421,90,10633,15721;15874;19147,24455,0,1,2,0,3
41422,90,10634,15729;15736;18596;18741,24455,0,0,4,0,4
41423,90,10635,15868;20674,24455,1,0,1,0,2
41424,90,10636,15644;16275;18473;18795;19438;19993,24455,0,2,4,0,6
41425,90,10637,16011;16330;19612;20168,24455,0,2,2,0,4
41426,90,10638,15346;15770;18467,24455,0,0,3,0,3
41427,90,10639,15772;18888;19674;20352,24455,0,2,2,0,4
41428,90,10640,15789;16273;18316;18857;19097;20482,24455,1,1,4,0,6
41429,90,10641,15798;15964;20502,24455,1,0,2,0,3
41430,90,10642,15521;15826,24455,0,0,2,0,2
41431,90,10643,15837;16049;19090;20281,24455,0,2,2,0,4
41432,90,10644,16173;18577;19061;19704,24455,0,2,2,0,4
41433,90,10645,15866;16243,24455,0,0,2,0,2
41434,90,10646,15711;15882;20298,24455,0,1,2,0,3
41435,90,10647,15691;19495,24455,0,1,1,0,2
41436,90,10648,10684,24820,0,0,0,1,1
41437,90,10649,11214,24820,0,0,0,1,1
41438,90,10654,11331,24820,0,0,0,1,1
41439,90,10655,11840,24820,0,0,0,1,1
41440,90,10658,11911,24820,0,0,0,1,1
41441,90,10664,12157,24820,0,0,0,1,1
41442,90,10666,11950;12343,24820,0,0,0,2,2
41443,90,10671,12945;13367,24820,0,0,2,0,2
41444,90,10673,13187;13645;18846,24820,0,0,3,0,3
41445,90,10676,13559;13941;19832,24820,0,1,2,0,3
41446,90,10677,13473,24820,0,0,1,0,1
41447,90,10683,14177;14444;19365,24820,0,1,2,0,3
41448,90,10684,13694;14358;19186,24820,0,1,2,0,3
41449,90,10689,14260;18764;18935,24820,0,0,3,0,3
41450,90,10690,14401;14812;19232;19895,24820,0,2,2,0,4
41451,90,10691,14381;14917;19001;19379,24820,0,1,3,0,4
41452,90,10695,14331;15006;19331,24820,0,1,2,0,3
41453,90,10696,15021;20089,24820,0,1,1,0,2
41454,90,10697,14160;14737;18905,24820,0,0,3,0,3
41455,90,10699,14701;14760;18512;19084;19633,24820,0,2,3,0,5
41456,90,10700,13987;14878;19355,24820,0,1,2,0,3
41457,90,10701,14923;16048,24820,0,0,2,0,2
41458,90,10702,14971;15511;19123;20260,24820,0,2,2,0,4
41459,90,10703,14977;15009,24820,0,0,2,0,2
41460,90,10704,15218;15423;19335,24820,0,1,2,0,3
41461,90,10705,15018;15298;19032;19155,24820,0,1,3,0,4
41462,90,10706,14989;15084,24820,0,0,2,0,2
41463,90,10707,14975;15580;18983;19093;19529;20084;20384,24820,0,4,3,0,7
41464,90,10708,15144;15368;19559;19980;20522,24820,1,2,2,0,5
41465,90,10709,15238;15484;19209,24820,0,1,2,0,3
41466,90,10710,15414;18578;18826;19130;19291,24820,0,2,3,0,5
41467,90,10711,15382;15676;19524;19730,24820,0,2,2,0,4
41468,90,10712,15289;15612;19553,24820,0,1,2,0,3
41469,90,10713,15293;16312;18968;20105,24820,0,1,3,0,4
41470,90,10714,15072;15314;19036;19094,24820,0,1,3,0,4
41471,90,10715,15486;16044,24820,0,0,2,0,2
41472,90,10716,15328;15645;19109;19424,24820,0,2,2,0,4
41473,90,10717,14827;15433;20106;20160,24820,0,2,2,0,4
41474,90,10718,15175;15336;19338;20196,24820,0,2,2,0,4
41475,90,10720,15377;15476;18972;19296;19871;20026,24820,0,3,3,0,6
41476,90,10721,15661;16025;18908;19087,24820,0,1,3,0,4
41477,90,10722,15102;15269;18987;19183,24820,0,1,3,0,4
41478,90,10723,15370;15422;19151;19364,24820,0,2,2,0,4
41479,90,10724,15435;19283,24820,0,1,1,0,2
41480,90,10725,15073;15533;19174;19527;19608,24820,0,3,2,0,5
41481,90,10726,15349;15810;19060,24820,0,1,2,0,3
41482,90,10727,15477;15527;19056;19820;20202,24820,0,2,3,0,5
41483,90,10729,15090,24820,0,0,1,0,1
41484,90,10730,15438;15450;18878;18959;19345,24820,0,1,4,0,5
41485,90,10732,14648;15033;19221,24820,0,1,2,0,3
41486,90,10733,14867;15587;18704,24820,0,0,3,0,3
41487,90,10734,15750;15920;18991;19395;20113,24820,0,2,3,0,5
41488,90,10735,14872;15637;19251;19889,24820,0,2,2,0,4
41489,90,10737,15658;16450;18653;19177;20095,24820,0,2,3,0,5
41490,90,10739,15670;16027,24820,0,0,2,0,2
41491,90,10740,15792;15896,24820,0,0,2,0,2
41492,90,10741,15418;15726;18730;19563,24820,0,1,3,0,4
41493,90,10742,15771;15794;20285,24820,0,1,2,0,3
41494,90,10743,16362;19121;20077,24820,0,2,1,0,3
41495,90,10744,16101;16186;19638;19839,24820,0,2,2,0,4
41496,90,10745,15488;16347;20323;20746,24820,1,1,2,0,4
41497,90,10746,15908;16668;20307;20491,24820,1,1,2,0,4
41498,90,10747,15567;15917;18557;19436,24820,0,1,3,0,4
41499,90,10748,15356;15922;19878;20173,24820,0,2,2,0,4
41500,90,10749,15828;16217;18567;19068;19959;20162,24820,0,3,3,0,6
41501,90,10750,15952;16300;19011;20265;20361,24820,0,2,3,0,5
41502,90,10751,15968;16299;19227;19370;20464,24820,1,2,2,0,5
41503,90,10752,15942;15982;19635;20321,24820,0,2,2,0,4
41504,90,10753,15787;15989;19240;20290,24820,0,2,2,0,4
41505,90,10754,16018;16189;18662;18994,24820,0,0,4,0,4
41506,90,10755,10720,25185,0,0,0,1,1
41507,90,10760,11027,25185,0,0,0,1,1
41508,90,10761,10941,25185,0,0,0,1,1
41509,90,10763,11501,25185,0,0,0,1,1
41510,90,10765,11907,25185,0,0,0,1,1
41511,90,10770,12664;13132,25185,0,0,1,1,2
41512,90,10771,12429,25185,0,0,0,1,1
41513,90,10783,13312;13586;18563,25185,0,0,3,0,3
41514,90,10784,13968;18960,25185,0,0,2,0,2
41515,90,10785,13389;13976;18881;19102,25185,0,1,3,0,4
41516,90,10788,13443,25185,0,0,1,0,1
41517,90,10793,13557;13848;18808;19077,25185,0,1,3,0,4
41518,90,10794,14015,25185,0,0,1,0,1
41519,90,10795,14420;14885;19437,25185,0,1,2,0,3
41520,90,10796,14127;14410;19234,25185,0,1,2,0,3
41521,90,10800,14385;15412,25185,0,0,2,0,2
41522,90,10801,13815;14019,25185,0,0,2,0,2
41523,90,10802,15319;18891;18953,25185,0,0,3,0,3
41524,90,10804,14696;14710;18752;19117,25185,0,1,3,0,4
41525,90,10806,14941;15281;19472,25185,0,1,2,0,3
41526,90,10807,14974;15118,25185,0,0,2,0,2
41527,90,10808,15026;16169,25185,0,0,2,0,2
41528,90,10809,15035;15534,25185,0,0,2,0,2
41529,90,10810,15110;19542;19625,25185,0,2,1,0,3
41530,90,10811,15124,25185,0,0,1,0,1
41531,90,10812,15208;15226;19892,25185,0,1,2,0,3
41532,90,10813,15236;15722;19928,25185,0,1,2,0,3
41533,90,10814,15767;19805,25185,0,1,1,0,2
41534,90,10815,15285;15638;18833;20075;20380,25185,0,2,3,0,5
41535,90,10816,15053;15278;19723,25185,0,1,2,0,3
41536,90,10817,15378;15824;18825;19069;20496,25185,1,1,3,0,5
41537,90,10818,15219;19543;19947,25185,0,2,1,0,3
41538,90,10819,15411;16130;18856;19161;19565;19616,25185,0,3,3,0,6
41539,90,10820,15558;15617;20198,25185,0,1,2,0,3
41540,90,10821,14533;15143,25185,0,0,2,0,2
41541,90,10822,15747;16160;19714;20256,25185,0,2,2,0,4
41542,90,10823,15461;15552,25185,0,0,2,0,2
41543,90,10824,15575;16176;19396;19466,25185,0,2,2,0,4
41544,90,10825,15626;15863;19778,25185,0,1,2,0,3
41545,90,10826,15916;18943;19597,25185,0,1,2,0,3
41546,90,10827,15428;15610;18683;19180,25185,0,1,3,0,4
41547,90,10830,15623;15838;19327,25185,0,1,2,0,3
41548,90,10831,15459;15634;19551;19584,25185,0,2,2,0,4
41549,90,10832,15641;15682;19580,25185,0,1,2,0,3
41550,90,10833,15662;16252;18727;19760;20074,25185,0,2,3,0,5
41551,90,10834,15665;15834;20012;20182,25185,0,2,2,0,4
41552,90,10835,15687;16119;19692;19937;20034;20128,25185,0,4,2,0,6
41553,90,10836,15706;16304;19490;19687;20545,25185,1,2,2,0,5
41554,90,10837,15666;15718,25185,0,0,2,0,2
41555,90,10838,15816;16341;20407;20663,25185,1,1,2,0,4
41556,90,10839,16043;16327;20197;20445,25185,1,1,2,0,4
41557,90,10840,15557;15579;18668;18961,25185,0,0,4,0,4
41558,90,10841,16329;19222;20222,25185,0,2,1,0,3
41559,90,10842,15886;16296,25185,0,0,2,0,2
41560,90,10843,15266;15888;18876;19891,25185,0,1,3,0,4
41561,90,10844,16188;16265;18538;19426,25185,0,1,3,0,4
41562,90,10845,15633;15915;20331,25185,0,1,2,0,3
41563,90,10846,15928;15981;20218;20734,25185,1,1,2,0,4
41564,90,10847,15640;15944,25185,0,0,2,0,2
41565,90,10848,15746;15947;19297;19640,25185,0,2,2,0,4
41566,90,10849,16360;16749;18733;18933,25185,0,0,4,0,4
41567,90,10851,15972;16128;19404;19855,25185,0,2,2,0,4
41568,90,10852,16010;16578;18895;19182;19711;19951;20680,25185,1,3,3,0,7
41569,90,10853,16051;16379;19751;20180,25185,0,2,2,0,4
41570,90,10854,16054;16058,25185,0,0,2,0,2
41571,90,10855,16057;16358;19141;19461,25185,0,2,2,0,4
41572,90,10856,16020;16059;19667;19901;20377,25185,0,3,2,0,5
41573,90,10857,16066;16315;19631;20388,25185,0,2,2,0,4
41574,90,10858,16095;16154;19449;19966;20053,25185,0,3,2,0,5
41575,90,10859,16116;16375;18768;19475,25185,0,1,3,0,4
41576,90,10860,15846;16117;19702;19829;20006,25185,0,3,2,0,5
41577,90,10861,16108;16122;19739;19976,25185,0,2,2,0,4
41578,90,10862,16124;16551;18923;20110,25185,0,1,3,0,4
41579,90,10863,16126;16233;18901;19452,25185,0,1,3,0,4
41580,90,10864,15639;16138;19341;20452;20574,25185,2,1,2,0,5
41581,90,10865,16151;16262,25185,0,0,2,0,2
41582,90,10866,15702;15761;18948;20009,25185,0,1,3,0,4
41583,90,10867,15884;16190,25185,0,0,2,0,2
41584,90,10875,11455,25550,0,0,0,1,1
41585,90,10876,11919,25550,0,0,0,1,1
41586,90,10882,11942,25550,0,0,0,1,1
41587,90,10884,12535,25550,0,0,0,1,1
41588,90,10888,12965;12997,25550,0,0,2,0,2
41589,90,10895,13535;13681,25550,0,0,2,0,2
41590,90,10900,13259;13626,25550,0,0,2,0,2
41591,90,10902,13475,25550,0,0,1,0,1
41592,90,10903,14856;14904;18773;19224,25550,0,1,3,0,4
41593,90,10906,13683;14501,25550,0,0,2,0,2
41594,90,10907,14785;19157;19613,25550,0,2,1,0,3
41595,90,10909,14527;14888,25550,0,0,2,0,2
41596,90,10911,14552;14902,25550,0,0,2,0,2
41597,90,10912,14619,25550,0,0,1,0,1
41598,90,10916,14700;14825;19120,25550,0,1,2,0,3
41599,90,10917,14697;14905;19458,25550,0,1,2,0,3
41600,90,10918,15156;15180;19856;20072,25550,0,2,2,0,4
41601,90,10921,14910;15063;19777,25550,0,1,2,0,3
41602,90,10922,15104;15160;19193;19522;20243,25550,0,3,2,0,5
41603,90,10923,15201;19380;19439,25550,0,2,1,0,3
41604,90,10924,15216;15303;19312;19511;19858,25550,0,3,2,0,5
41605,90,10925,15991;16284;19058,25550,0,1,2,0,3
41606,90,10927,15321;15728;19962,25550,0,1,2,0,3
41607,90,10928,15347;15731;19596,25550,0,1,2,0,3
41608,90,10929,14766;15354;19477;19645,25550,0,2,2,0,4
41609,90,10930,15410;15940;20269,25550,0,1,2,0,3
41610,90,10931,15335,25550,0,0,1,0,1
41611,90,10932,15481;15537;19601;19818,25550,0,2,2,0,4
41612,90,10933,15574;15807;19422;19586;19899,25550,0,3,2,0,5
41613,90,10934,15526;15853;19206;19661;20098,25550,0,3,2,0,5
41614,90,10935,15608;20547,25550,1,0,1,0,2
41615,90,10936,15287;15648;19027;19465,25550,0,1,3,0,4
41616,90,10937,15069;15651;19847;20104,25550,0,2,2,0,4
41617,90,10938,15674;15962;18805;18950,25550,0,0,4,0,4
41618,90,10939,15525;15897;19342,25550,0,1,2,0,3
41619,90,10940,15720;16147;19581;20925,25550,1,1,2,0,4
41620,90,10941,15748;15986;18810;18942;20020,25550,0,1,4,0,5
41621,90,10943,15365;15765;19772,25550,0,1,2,0,3
41622,90,10944,15775;19025;20154,25550,0,1,2,0,3
41623,90,10945,15532;15784;20042;20444,25550,1,1,2,0,4
41624,90,10946,15463;15801;18836;18992;19246,25550,0,1,4,0,5
41625,90,10947,15823;16185;19197;19544;19735;19921,25550,0,4,2,0,6
41626,90,10948,16105;16132;19170,25550,0,1,2,0,3
41627,90,10949,15889;16618;19054;19236,25550,0,1,3,0,4
41628,90,10950,15894;16125;19256;19803,25550,0,2,2,0,4
41629,90,10951,15153;15330;19819,25550,0,1,2,0,3
41630,90,10952,15929;15950;20189;20512,25550,1,1,2,0,4
41631,90,10953,15971;16628;20709,25550,1,0,2,0,3
41632,90,10954,15785;15975,25550,0,0,2,0,2
41633,90,10955,15821;16180;19643;20040,25550,0,2,2,0,4
41634,90,10956,15978;16000;19538;19881,25550,0,2,2,0,4
41635,90,10957,15646;16001;18746;19070;19800;20336,25550,0,3,3,0,6
41636,90,10958,16417;19864;19923;20068,25550,0,3,1,0,4
41637,90,10959,16033;16060;19552;20291,25550,0,2,2,0,4
41638,90,10961,16344;16395;19868;20392,25550,0,2,2,0,4
41639,90,10962,15571;16121;20179,25550,0,1,2,0,3
41640,90,10963,16131;16489;19003;19968,25550,0,1,3,0,4
41641,90,10964,16085;16170;19105;19825;19896;20873,25550,1,3,2,0,6
41642,90,10965,16201;16644;19776;20339,25550,0,2,2,0,4
41643,90,10966,16114;16602;19473;19956;20060,25550,0,3,2,0,5
41644,90,10967,16207;16402;20165;20369,25550,0,2,2,0,4
41645,90,10968,16065;16218;18937,25550,0,0,3,0,3
41646,90,10969,16222;16716;19626;20531,25550,1,1,2,0,4
41647,90,10970,15924;16246,25550,0,0,2,0,2
41648,90,10971,16144;16253,25550,0,0,2,0,2
41649,90,10972,16264;16403;18699;19710;19904,25550,0,2,3,0,5
41650,90,10973,16271;16645;19483;20116;20568,25550,1,2,2,0,5
41651,90,10974,16229;16279;19791;20401,25550,0,2,2,0,4
41652,90,10975,16015;16324;18742;19041;19481,25550,0,1,4,0,5
41653,90,10976,15698;16326,25550,0,0,2,0,2
41654,90,10979,11493,25915,0,0,0,1,1
41655,90,10980,11327;11544,25915,0,0,0,2,2
41656,90,10981,11678,25915,0,0,0,1,1
41657,90,10986,12100,25915,0,0,0,1,1
41658,90,10987,12211,25915,0,0,0,1,1
41659,90,10994,12334,25915,0,0,0,1,1
41660,90,10995,12662;13149,25915,0,0,1,1,2
41661,90,11002,13213;13608,25915,0,0,2,0,2
41662,90,11004,12782,25915,0,0,0,1,1
41663,90,11008,14025,25915,0,0,1,0,1
41664,90,11009,13365,25915,0,0,1,0,1
41665,90,11015,13503,25915,0,0,1,0,1
41666,90,11016,13993;14601,25915,0,0,2,0,2
41667,90,11018,14835;14945;19122,25915,0,1,2,0,3
41668,90,11020,13818;14386;19030,25915,0,0,3,0,3
41669,90,11024,14570,25915,0,0,1,0,1
41670,90,11029,15602,25915,0,0,1,0,1
41671,90,11030,14802;15121;19672;19748,25915,0,2,2,0,4
41672,90,11031,14831;14979;19219,25915,0,1,2,0,3
41673,90,11032,14846;18896,25915,0,0,2,0,2
41674,90,11033,14876;15693;19285;19663;19837,25915,0,3,2,0,5
41675,90,11036,14603;14642,25915,0,0,2,0,2
41676,90,11037,14776;14932;19014,25915,0,0,3,0,3
41677,90,11039,15182;15183,25915,0,0,2,0,2
41678,90,11041,15862;19850;20011;20171,25915,0,3,1,0,4
41679,90,11042,15548;15690;19675,25915,0,1,2,0,3
41680,90,11043,15465;15628,25915,0,0,2,0,2
41681,90,11044,15997;16225;19807,25915,0,1,2,0,3
41682,90,11045,15619;19019;19167;19844,25915,0,2,2,0,4
41683,90,11046,15498;15739,25915,0,0,2,0,2
41684,90,11047,15744;15885;18897;19128;19906,25915,0,2,3,0,5
41685,90,11048,15825;16468,25915,0,0,2,0,2
41686,90,11049,15833;19169;19303;19532,25915,0,3,1,0,4
41687,90,11050,15295;15865;18884;18949;19577,25915,0,1,4,0,5
41688,90,11051,15867;15883;18952;19400,25915,0,1,3,0,4
41689,90,11052,15324;15875,25915,0,0,2,0,2
41690,90,11053,15876;16163;20270,25915,0,1,2,0,3
41691,90,11054,15907;15925;19280;20186,25915,0,2,2,0,4
41692,90,11055,15910;16240;19408;20431,25915,0,2,2,0,4
41693,90,11056,15911;16209;19746;20292,25915,0,2,2,0,4
41694,90,11057,16261;16452;20686;20878,25915,2,0,2,0,4
41695,90,11058,16428;19512;19727,25915,0,2,1,0,3
41696,90,11059,16106;16318;19284;20843,25915,1,1,2,0,4
41697,90,11060,15376;16036;19278;19946;20455,25915,1,2,2,0,5
41698,90,11061,16037;16055;19433;19618;20723,25915,1,2,2,0,5
41699,90,11062,16089;16411,25915,0,0,2,0,2
41700,90,11063,15768;16091,25915,0,0,2,0,2
41701,90,11064,16092;16107;19418;19769;19890;20543,25915,1,3,2,0,6
41702,90,11065,15291;16098;19984;20220,25915,0,2,2,0,4
41703,90,11066,16418;19985;20227,25915,0,2,1,0,3
41704,90,11067,16023;16118;20258,25915,0,1,2,0,3
41705,90,11068,16137;16238;18872;20293,25915,0,1,3,0,4
41706,90,11069,16149;16599;19217;19478;19989;20199;20756,25915,1,4,2,0,7
41707,90,11070,16123;19181,25915,0,1,1,0,2
41708,90,11072,16197;16601;18838;19448;20720,25915,1,1,3,0,5
41709,90,11073,16208;20234,25915,0,1,1,0,2
41710,90,11074,16235;16412,25915,0,0,2,0,2
41711,90,11075,16112;16650;19199;20237;20334,25915,0,3,2,0,5
41712,90,11076,16861;20277,25915,0,1,1,0,2
41713,90,11077,15762;16282;20667,25915,1,0,2,0,3
41714,90,11078,16687;19053;19187,25915,0,1,2,0,3
41715,90,11079,16251;16291;19188;19609;20109,25915,0,3,2,0,5
41716,90,11080,16174;16333;19390;19828;20818,25915,1,2,2,0,5
41717,90,11081,16338;16610;20551,25915,1,0,2,0,3
41718,90,11082,16586;20637;20666,25915,2,0,1,0,3
41719,90,11083,16346;19860;19936,25915,0,2,1,0,3
41720,90,11084,16348;16787;20779,25915,1,0,2,0,3
41721,90,11085,16381;16544;19156;19238;20550,25915,1,2,2,0,5
41722,90,11086,16778;19366;19922;20063,25915,0,3,1,0,4
41723,90,11087,15621;16822;19005;19071;19484,25915,0,2,3,0,5
41724,90,11088,16353;16461;20080,25915,0,1,2,0,3
41725,90,11089,15590;16471;19909;20100,25915,0,2,2,0,4
41726,90,11090,16368;16472;19133;19517;19911;20044,25915,0,4,2,0,6
41727,90,11091,11766,26280,0,0,0,1,1
41728,90,11092,11473,26280,0,0,0,1,1
41729,90,11094,11519;11765,26280,0,0,0,2,2
41730,90,11095,11330,26280,0,0,0,1,1
41731,90,11097,11726,26280,0,0,0,1,1
41732,90,11098,11656,26280,0,0,0,1,1
41733,90,11103,11888,26280,0,0,0,1,1
41734,90,11113,12736,26280,0,0,0,1,1
41735,90,11114,12568,26280,0,0,0,1,1
41736,90,11120,12464,26280,0,0,0,1,1
41737,90,11125,13565;13802,26280,0,0,2,0,2
41738,90,11130,14116;14613,26280,0,0,2,0,2
41739,90,11137,14575,26280,0,0,1,0,1
41740,90,11138,13302,26280,0,0,1,0,1
41741,90,11139,14379;14663;18921;19423,26280,0,1,3,0,4
41742,90,11141,14557;14995,26280,0,0,2,0,2
41743,90,11142,15268;15473;18956;19198;19641,26280,0,2,3,0,5
41744,90,11143,14748;15244;19349;19617,26280,0,2,2,0,4
41745,90,11144,14580;15401,26280,0,0,2,0,2
41746,90,11145,15173,26280,0,0,1,0,1
41747,90,11150,14954;14985,26280,0,0,2,0,2
41748,90,11151,14513;14960,26280,0,0,2,0,2
41749,90,11152,15539;15832;19782,26280,0,1,2,0,3
41750,90,11153,15077;15340;19163;19411,26280,0,2,2,0,4
41751,90,11154,15078;15364;19716;19810,26280,0,2,2,0,4
41752,90,11157,14826;15165,26280,0,0,2,0,2
41753,90,11158,15185;19226;19913,26280,0,2,1,0,3
41754,90,11159,15194;19582;19831,26280,0,2,1,0,3
41755,90,11162,15315;15943;20841,26280,1,0,2,0,3
41756,90,11163,15353,26280,0,0,1,0,1
41757,90,11164,15383;15546,26280,0,0,2,0,2
41758,90,11165,15323;15381;20240,26280,0,1,2,0,3
41759,90,11166,15392;15890,26280,0,0,2,0,2
41760,90,11167,15397;15630;19265;19834,26280,0,2,2,0,4
41761,90,11168,15399;15471;19269;19455,26280,0,2,2,0,4
41762,90,11169,15479;15643;18981;19242,26280,0,1,3,0,4
41763,90,11170,15508;16039,26280,0,0,2,0,2
41764,90,11171,15499;15514;19942,26280,0,1,2,0,3
41765,90,11172,15573;16187,26280,0,0,2,0,2
41766,90,11173,15490;15588;19075;19491;19907;20294,26280,0,4,2,0,6
41767,90,11174,16753;17325,26280,0,0,2,0,2
41768,90,11176,15686;16337;19642;20064,26280,0,2,2,0,4
41769,90,11177,15358;15705;19131;19814,26280,0,2,2,0,4
41770,90,11178,16257;16439;19152;19519;20122;20400,26280,0,4,2,0,6
41771,90,11179,15719;16168;19520,26280,0,1,2,0,3
41772,90,11180,16030;16323,26280,0,0,2,0,2
41773,90,11181,15776;15781;19164;19352;20306,26280,0,3,2,0,5
41774,90,11182,15799;16589;19536;20230;20439,26280,1,2,2,0,5
41775,90,11183,15802;16288;19605;20541,26280,1,1,2,0,4
41776,90,11184,15847;15936;20246;20528,26280,1,1,2,0,4
41777,90,11186,15445;15880;18982;19604,26280,0,1,3,0,4
41778,90,11187,15901;16547;18989;19302;19934,26280,0,2,3,0,5
41779,90,11188,15985;16211;19050;19514;19822,26280,0,2,3,0,5
41780,90,11189,15673;15918;19304;19598,26280,0,2,2,0,4
41781,90,11190,15607;15930;19463;19972,26280,0,2,2,0,4
41782,90,11191,15921;15932;19500;19599;20394;20529,26280,1,3,2,0,6
41783,90,11192,15939;19150;20158,26280,0,2,1,0,3
41784,90,11193,15988;16192;20141,26280,0,1,2,0,3
41785,90,11194,15814;15992;20628,26280,1,0,2,0,3
41786,90,11195,15485;15994,26280,0,0,2,0,2
41787,90,11197,15993;16028;19247;19728,26280,0,2,2,0,4
41788,90,11199,16046;19691,26280,0,1,1,0,2
41789,90,11200,16069;16464;19953;20091,26280,0,2,2,0,4
41790,90,11201,16078;16407;19310;19505;20112;20811,26280,1,3,2,0,6
41791,90,11202,16383;16660;19441;19666,26280,0,2,2,0,4
41792,90,11203,16045;16135;19142;19606;19905,26280,0,3,2,0,5
41793,90,11204,16096;16512;20372;20559;20853,26280,2,1,2,0,5
41794,90,11205,16100;16389;19306;19322,26280,0,2,2,0,4
41795,90,11206,15605;16110;20010,26280,0,1,2,0,3
41796,90,11207,16094;16572;19603,26280,0,1,2,0,3
41797,90,11208,15851;16136;19194;19557;19885,26280,0,3,2,0,5
41798,90,11209,16087;16145;20562,26280,1,0,2,0,3
41799,90,11210,16490,26280,0,0,1,0,1
41800,90,11211,16425;19462;19720;20200,26280,0,3,1,0,4
41801,90,11212,15631;16193,26280,0,0,2,0,2
41802,90,11213,16177;16221,26280,0,0,2,0,2
41803,90,11215,16206;16493;19245;19356;19600,26280,0,3,2,0,5
41804,90,11216,15627;16276;19382;19689,26280,0,2,2,0,4
41805,90,11217,15898;16280,26280,0,0,2,0,2
41806,90,11218,15277;15663;20018,26280,0,1,2,0,3
41807,90,11219,16040;16575,26280,0,0,2,0,2
41808,90,11220,16731;16833;19460,26280,0,1,2,0,3
41809,90,11221,16303;16841;18920;19649;19754,26280,0,2,3,0,5
41810,90,11222,16331;16856,26280,0,0,2,0,2
41811,90,11223,16336;16671;19659;20314,26280,0,2,2,0,4
41812,90,11224,16385;20517,26280,1,0,1,0,2
41813,90,11225,16086;16361;19994;20033,26280,0,2,2,0,4
41814,90,11226,16542,26280,0,0,1,0,1
41815,90,11227,16373;16514;19965,26280,0,1,2,0,3
41816,90,11228,16335;16377,26280,0,0,2,0,2
41817,90,11229,16399;16426;20341,26280,0,1,2,0,3
41818,90,11230,16416;16670;19388;19549,26280,0,2,2,0,4
41819,90,11231,16693;17000;19654;20404,26280,0,2,2,0,4
41820,90,11232,16453;16469,26280,0,0,2,0,2
41821,90,11233,16802;16872,26280,0,0,2,0,2
41822,90,11234,16370;16478;19243;19434;19969;20251;20532;20647,26280,2,4,2,0,8
41823,90,11235,16504;16674;20611,26280,1,0,2,0,3
41824,90,11236,16021;16509;20067;20295;20393,26280,0,3,2,0,5
41825,90,11237,16527;16865;19749;20305;20511;20889,26280,2,2,2,0,6
41826,90,11238,16554;16744;20275,26280,0,1,2,0,3
41827,90,11239,10987,26645,0,0,0,1,1
41828,90,11240,11390,26645,0,0,0,1,1
41829,90,11241,11384,26645,0,0,0,1,1
41830,90,11244,11502,26645,0,0,0,1,1
41831,90,11245,11845,26645,0,0,0,1,1
41832,90,11246,11903,26645,0,0,0,1,1
41833,90,11254,12839,26645,0,0,0,1,1
41834,90,11258,12804,26645,0,0,0,1,1
41835,90,11260,12596;13206,26645,0,0,1,1,2
41836,90,11261,13237,26645,0,0,1,0,1
41837,90,11265,13374;13495,26645,0,0,2,0,2
41838,90,11266,12759;13234,26645,0,0,1,1,2
41839,90,11267,13999;19205,26645,0,1,1,0,2
41840,90,11271,13932;14006;19210,26645,0,1,2,0,3
41841,90,11272,13464;13945,26645,0,0,2,0,2
41842,90,11275,14267,26645,0,0,1,0,1
41843,90,11279,14460;14535;19752,26645,0,1,2,0,3
41844,90,11281,15154,26645,0,0,1,0,1
41845,90,11282,14788;14934,26645,0,0,2,0,2
41846,90,11283,14801;15372,26645,0,0,2,0,2
41847,90,11285,14765;14938,26645,0,0,2,0,2
41848,90,11286,15163;15211;20111,26645,0,1,2,0,3
41849,90,11288,15001;15271;19619,26645,0,1,2,0,3
41850,90,11290,15046;15893;19842;20217,26645,0,2,2,0,4
41851,90,11291,15815;15909,26645,0,0,2,0,2
41852,90,11293,15318;15967;19092;19719,26645,0,2,2,0,4
41853,90,11294,15384,26645,0,0,1,0,1
41854,90,11295,15373;15393;20236,26645,0,1,2,0,3
41855,90,11296,15409;19435;19918,26645,0,2,1,0,3
41856,90,11298,14949;15493;19340;19753,26645,0,2,2,0,4
41857,90,11299,15443;15529;19190,26645,0,1,2,0,3
41858,90,11300,15829;15966;19852;20148;20690,26645,1,2,2,0,5
41859,90,11301,15451;15538;19308;20405,26645,0,2,2,0,4
41860,90,11303,15591;15740;19821,26645,0,1,2,0,3
41861,90,11304,15753;20410,26645,0,1,1,0,2
41862,90,11306,15395,26645,0,0,1,0,1
41863,90,11307,15351;15900;19533;19992,26645,0,2,2,0,4
41864,90,11308,15389;15734;19254,26645,0,1,2,0,3
41865,90,11309,15756;15931,26645,0,0,2,0,2
41866,90,11310,15764;15845;20140,26645,0,1,2,0,3
41867,90,11311,15841;19211;19594;20014,26645,0,3,1,0,4
41868,90,11312,15861;16394,26645,0,0,2,0,2
41869,90,11313,15502;16052,26645,0,0,2,0,2
41870,90,11314,15919;16480;20267;20459,26645,1,1,2,0,4
41871,90,11315,15948,26645,0,0,1,0,1
41872,90,11316,15953;20595,26645,1,0,1,0,2
41873,90,11317,16479;16624;20223;20492,26645,1,1,2,0,4
41874,90,11318,15999;16237,26645,0,0,2,0,2
41875,90,11319,16006;16214;19289;20894,26645,1,1,2,0,4
41876,90,11320,16016;16198;19545;20554,26645,1,1,2,0,4
41877,90,11321,15949;16034,26645,0,0,2,0,2
41878,90,11322,16038;16088;19488;19964,26645,0,2,2,0,4
41879,90,11323,15977;16603;19660;20373,26645,0,2,2,0,4
41880,90,11324,16245;16958;20565;20821,26645,2,0,2,0,4
41881,90,11325,15795;16250;20117,26645,0,1,2,0,3
41882,90,11326,16167;16256;19731,26645,0,1,2,0,3
41883,90,11327,16532;19724;20406,26645,0,2,1,0,3
41884,90,11328,16067;16269;19925,26645,0,1,2,0,3
41885,90,11329,16111;16272,26645,0,0,2,0,2
41886,90,11330,16277;16855;19374,26645,0,1,2,0,3
41887,90,11331,16283;16633;19428;19678;20597,26645,1,2,2,0,5
41888,90,11332,15616;16164,26645,0,0,2,0,2
41889,90,11333,16013;16398;20316;20640,26645,1,1,2,0,4
41890,90,11334,15732;16420;20213;20553,26645,1,1,2,0,4
41891,90,11335,16157;16447;19677;20174,26645,0,2,2,0,4
41892,90,11336,16223;16458;19747,26645,0,1,2,0,3
41893,90,11337,16495;16732;20211,26645,0,1,2,0,3
41894,90,11338,16162;16506;20465;20923,26645,2,0,2,0,4
41895,90,11339,16519;16798;19875,26645,0,1,2,0,3
41896,90,11340,16378;16529;19846;20000,26645,0,2,2,0,4
41897,90,11341,16026;16560;19840;19944,26645,0,2,2,0,4
41898,90,11342,16153;16561;20662,26645,1,0,2,0,3
41899,90,11343,15945;16667;20902,26645,1,0,2,0,3
41900,90,11344,16287;16576;19874,26645,0,1,2,0,3
41901,90,11345,16008;16577;19272;19523;19786,26645,0,3,2,0,5
41902,90,11346,16580;16695,26645,0,0,2,0,2
41903,90,11347,16811;19323;19503;19725;20928,26645,1,3,1,0,5
41904,90,11348,16321;16593;19647;20031;20354,26645,0,3,2,0,5
41905,90,11349,16475;16606;19940;20436,26645,1,1,2,0,4
41906,90,11350,16607;17062;19086;19459;20266,26645,0,3,2,0,5
41907,90,11351,16620;16878;19119;19673,26645,0,2,2,0,4
41908,90,11352,16622;16966;19684;19932;20949,26645,1,2,2,0,5
41909,90,11353,16629;17046;19189;19506;20613,26645,1,2,2,0,5
41910,90,11354,16488;16635;20204,26645,0,1,2,0,3
41911,90,11355,16594;16648;19202;19623;20119,26645,0,3,2,0,5
41912,90,11356,15951;16244,26645,0,0,2,0,2
41913,90,11357,16654;16701;19343;19509,26645,0,2,2,0,4
41914,90,11358,16409;16703;20819,26645,1,0,2,0,3
41915,90,11359,16413;16728,26645,0,0,2,0,2
41916,90,11360,11581,27010,0,0,0,1,1
41917,90,11362,11545,27010,0,0,0,1,1
41918,90,11367,12104;12322,27010,0,0,0,2,2
41919,90,11369,11603,27010,0,0,0,1,1
41920,90,11370,12126,27010,0,0,0,1,1
41921,90,11372,12176,27010,0,0,0,1,1
41922,90,11374,12120;12225,27010,0,0,0,2,2
41923,90,11380,12793,27010,0,0,0,1,1
41924,90,11386,13424,27010,0,0,1,0,1
41925,90,11389,14510,27010,0,0,1,0,1
41926,90,11391,14594,27010,0,0,1,0,1
41927,90,11397,14340;15157,27010,0,0,2,0,2
41928,90,11402,14440;14725;19228,27010,0,1,2,0,3
41929,90,11404,14341;14509,27010,0,0,2,0,2
41930,90,11406,14906;15447,27010,0,0,2,0,2
41931,90,11409,15015;15259,27010,0,0,2,0,2
41932,90,11410,15017;15513;19610;19933;20187,27010,0,3,2,0,5
41933,90,11411,15472;15518;19229;19516,27010,0,2,2,0,4
41934,90,11413,14131;15071;19497;19792,27010,0,2,2,0,4
41935,90,11414,14798;14957,27010,0,0,2,0,2
41936,90,11415,15188;15618,27010,0,0,2,0,2
41937,90,11417,15234;19263;19445;19756,27010,0,3,1,0,4
41938,90,11419,15247;15357,27010,0,0,2,0,2
41939,90,11421,14853;15371,27010,0,0,2,0,2
41940,90,11423,15258;16012,27010,0,0,2,0,2
41941,90,11425,15614;16350;19999;20642,27010,1,1,2,0,4
41942,90,11426,15629;16308;19419,27010,0,1,2,0,3
41943,90,11427,15415;15692;19854,27010,0,1,2,0,3
41944,90,11428,15656;15715;19676;20090,27010,0,2,2,0,4
41945,90,11429,15725;15779;20093,27010,0,1,2,0,3
41946,90,11430,15743;16537,27010,0,0,2,0,2
41947,90,11433,15836;16263,27010,0,0,2,0,2
41948,90,11434,15685;15780;19761,27010,0,1,2,0,3
41949,90,11435,15877;16267;20747,27010,1,0,2,0,3
41950,90,11437,15934;19486;19849;19939,27010,0,3,1,0,4
41951,90,11438,15956;16501,27010,0,0,2,0,2
41952,90,11439,15974;15980,27010,0,0,2,0,2
41953,90,11440,15820;15995,27010,0,0,2,0,2
41954,90,11442,16042;16446;19783;20423,27010,0,2,2,0,4
41955,90,11443,15903;16084;19652;20181,27010,0,2,2,0,4
41956,90,11444,16115,27010,0,0,1,0,1
41957,90,11445,15923;16492;19908;20463,27010,1,1,2,0,4
41958,90,11446,16669;16708;19510;20081;20359;20585,27010,1,3,2,0,6
41959,90,11447,16090;16183;20530,27010,1,0,2,0,3
41960,90,11448,16623;17037,27010,0,0,2,0,2
41961,90,11449,16552;17065;19358;19900;20203;20301;20899,27010,1,4,2,0,7
41962,90,11450,16440,27010,0,0,1,0,1
41963,90,11451,16320,27010,0,0,1,0,1
41964,90,11452,16761;16979,27010,0,0,2,0,2
41965,90,11453,16759;20576,27010,1,0,1,0,2
41966,90,11455,16376;16588,27010,0,0,2,0,2
41967,90,11456,16404;16895;19201;20845,27010,1,1,2,0,4
41968,90,11458,16219;16422;19534;19696,27010,0,2,2,0,4
41969,90,11459,16533;16756;20785;20945,27010,2,0,2,0,4
41970,90,11460,16436;17204;19216;20398,27010,0,2,2,0,4
41971,90,11461,15708;16460,27010,0,0,2,0,2
41972,90,11463,16260;16779,27010,0,0,2,0,2
41973,90,11464,16498;16751;20771,27010,1,0,2,0,3
41974,90,11465,16445;16541;20083;20124;20582,27010,1,2,2,0,5
41975,90,11466,16386;16553;20870,27010,1,0,2,0,3
41976,90,11467,16159;16562;19360;19935;20143,27010,0,3,2,0,5
41977,90,11468,16270;16563;19528;20210;20433,27010,1,2,2,0,5
41978,90,11469,16568;16764;20313;20497;20617,27010,2,1,2,0,5
41979,90,11470,16113;16596;20049;20231;20506,27010,1,2,2,0,5
41980,90,11471,16608;16930;19220;19431;19952,27010,0,3,2,0,5
41981,90,11472,16815,27010,0,0,1,0,1
41982,90,11473,16685;16786,27010,0,0,2,0,2
41983,90,11474,16694;17106;19492;19764;20596,27010,1,2,2,0,5
41984,90,11475,16699;16875;19274;19410;19480,27010,0,3,2,0,5
41985,90,11476,16659;16947;19271;19680;19949,27010,0,3,2,0,5
41986,90,11477,16725;17068,27010,0,0,2,0,2
41987,90,11478,16980;19237;19981;20152,27010,0,3,1,0,4
41988,90,11479,16639;16738;19732;20412;20835,27010,1,2,2,0,5
41989,90,11480,16765;17028;20832,27010,1,0,2,0,3
41990,90,11481,16766;17119;19914;20607;20955,27010,2,1,2,0,5
41991,90,11482,16343;16783,27010,0,0,2,0,2
41992,90,11483,16803;17015;20094;20514,27010,1,1,2,0,4
41993,90,11484,16305;16357;19759;19817;20790,27010,1,2,2,0,5
41994,90,11485,16617;16857;20781,27010,1,0,2,0,3
41995,90,11486,16557;16850;19941;20002;20178,27010,0,3,2,0,5
41996,90,11487,11717,27375,0,0,0,1,1
41997,90,11489,11588,27375,0,0,0,1,1
41998,90,11492,11508,27375,0,0,0,1,1
41999,90,11493,11982,27375,0,0,0,1,1
42000,90,11496,12158,27375,0,0,0,1,1
42001,90,11498,12426,27375,0,0,0,1,1
42002,90,11500,12297,27375,0,0,0,1,1
42003,90,11502,12800,27375,0,0,0,1,1
42004,90,11506,12788,27375,0,0,0,1,1
42005,90,11507,13017;13211,27375,0,0,2,0,2
42006,90,11525,14408;15190;19615;20435,27375,1,1,2,0,4
42007,90,11528,14614;14926,27375,0,0,2,0,2
42008,90,11529,14653;15232;19391,27375,0,1,2,0,3
42009,90,11530,14387,27375,0,0,1,0,1
42010,90,11535,14793;15517;19809;20621,27375,1,1,2,0,4
42011,90,11536,14709;14950;19866,27375,0,1,2,0,3
42012,90,11538,14984;15403,27375,0,0,2,0,2
42013,90,11540,15343,27375,0,0,1,0,1
42014,90,11544,15561;15987,27375,0,0,2,0,2
42015,90,11546,15782;19954,27375,0,1,1,0,2
42016,90,11548,15796;15812,27375,0,0,2,0,2
42017,90,11549,15817,27375,0,0,1,0,1
42018,90,11550,15843;16249;20575,27375,1,0,2,0,3
42019,90,11551,15871;16548;19799;20297,27375,0,2,2,0,4
42020,90,11552,15609;15879,27375,0,0,2,0,2
42021,90,11553,15774;15946,27375,0,0,2,0,2
42022,90,11555,15717;16003;20337,27375,0,1,2,0,3
42023,90,11556,16022;16179,27375,0,0,2,0,2
42024,90,11557,16133;16278;19745;20729,27375,1,1,2,0,4
42025,90,11558,16079;16627;19978;20273,27375,0,2,2,0,4
42026,90,11561,15491;16224,27375,0,0,2,0,2
42027,90,11562,15519;16194;20777,27375,1,0,2,0,3
42028,90,11563,16081;16213,27375,0,0,2,0,2
42029,90,11564,16216;16339;20657,27375,1,0,2,0,3
42030,90,11565,15938;16195;19556;19865,27375,0,2,2,0,4
42031,90,11566,16228;16364;19387;19699;19950;20296,27375,0,4,2,0,6
42032,90,11567,16234;16771;20169;20434,27375,1,1,2,0,4
42033,90,11568,15963;16236;19806;20344,27375,0,2,2,0,4
42034,90,11570,16097;16286;19369;20057,27375,0,2,2,0,4
42035,90,11571,16005;19562;20022,27375,0,2,1,0,3
42036,90,11572,16226;16290,27375,0,0,2,0,2
42037,90,11573,16072;16310;19758;20103;20627,27375,1,2,2,0,5
42038,90,11574,16365,27375,0,0,1,0,1
42039,90,11575,16396;16821;20728,27375,1,0,2,0,3
42040,90,11576,16454;16613;19375;19734,27375,0,2,2,0,4
42041,90,11577,16293;16456;19996,27375,0,1,2,0,3
42042,90,11578,16009;16476;19376;20054,27375,0,2,2,0,4
42043,90,11579,16254;16661;20087;20419,27375,0,2,2,0,4
42044,90,11580,15790;16549;20413,27375,0,1,2,0,3
42045,90,11581,15576;16510;20577;20851,27375,2,0,2,0,4
42046,90,11582,16372;16424,27375,0,0,2,0,2
42047,90,11583,16565;20460,27375,1,0,1,0,2
42048,90,11584,16571;16609;19628;19804;20085;20363,27375,0,4,2,0,6
42049,90,11585,16631;17039,27375,0,0,2,0,2
42050,90,11586,16638;16812;19550;19665;19859,27375,0,3,2,0,5
42051,90,11587,16664;17188;19697;19997;20584,27375,1,2,2,0,5
42052,90,11588,16427,27375,0,0,1,0,1
42053,90,11589,16676;17137;19513;20150;20356;20806,27375,1,3,2,0,6
42054,90,11590,16686;17117;20791,27375,1,0,2,0,3
42055,90,11591,16706;16709;19743;19929,27375,0,2,2,0,4
42056,90,11592,16717,27375,0,0,1,0,1
42057,90,11593,16724;16934;19353,27375,0,1,2,0,3
42058,90,11594,16752;16755;20856,27375,1,0,2,0,3
42059,90,11595,16763;16927;19318;19700;19898,27375,0,3,2,0,5
42060,90,11596,16359;16768,27375,0,0,2,0,2
42061,90,11597,16845;17035;19394;19774,27375,0,2,2,0,4
42062,90,11598,16846;20685,27375,1,0,1,0,2
42063,90,11599,16281;17053;20114;20349,27375,0,2,2,0,4
42064,90,11600,17101;19467;19602;20327,27375,0,3,1,0,4
42065,90,11601,16883;17328;19334;19489,27375,0,2,2,0,4
42066,90,11602,16545;16891;20191;20604,27375,1,1,2,0,4
42067,90,11603,16294;16894;20120;20911,27375,1,1,2,0,4
42068,90,11604,16889;17087;19406;19540;20958,27375,1,2,2,0,5
42069,90,11605,16792;16899,27375,0,0,2,0,2
42070,90,11606,16924;16928;20428;20616,27375,1,1,2,0,4
42071,90,11607,16932;20570,27375,1,0,1,0,2
42072,90,11608,16526;16945;20205;20362;20918,27375,1,2,2,0,5
42073,90,11609,16697;16951;19767;20561,27375,1,1,2,0,4
42074,90,11610,16964;17055;20170;20357;20815,27375,1,2,2,0,5
42075,90,11611,11953,27740,0,0,0,1,1
42076,90,11612,11688,27740,0,0,0,1,1
42077,90,11613,11738;11873,27740,0,0,0,2,2
42078,90,11614,12131,27740,0,0,0,1,1
42079,90,11616,12214,27740,0,0,0,1,1
42080,90,11617,12009,27740,0,0,0,1,1
42081,90,11621,12105;12408,27740,0,0,0,2,2
42082,90,11622,12583,27740,0,0,0,1,1
42083,90,11624,12748,27740,0,0,0,1,1
42084,90,11625,12760;13052,27740,0,0,1,1,2
42085,90,11627,13142,27740,0,0,1,0,1
42086,90,11636,14109,27740,0,0,1,0,1
42087,90,11639,14183,27740,0,0,1,0,1
42088,90,11641,14303;14625,27740,0,0,2,0,2
42089,90,11643,14769;15189;19886;19931,27740,0,2,2,0,4
42090,90,11644,14952;15366;20130;20235,27740,0,2,2,0,4
42091,90,11645,14809;15599;19958;20271,27740,0,2,2,0,4
42092,90,11647,14899;15039,27740,0,0,2,0,2
42093,90,11648,14830;14980;19664,27740,0,1,2,0,3
42094,90,11649,15068;15407;19872;20078,27740,0,2,2,0,4
42095,90,11651,14495;15158,27740,0,0,2,0,2
42096,90,11653,15446;15745;19894,27740,0,1,2,0,3
42097,90,11654,15545;16191;19701;20774,27740,1,1,2,0,4
42098,90,11655,15337,27740,0,0,1,0,1
42099,90,11657,15237;15620;19757;20184,27740,0,2,2,0,4
42100,90,11658,15751;19823;20035,27740,0,2,1,0,3
42101,90,11659,15797;16570,27740,0,0,2,0,2
42102,90,11660,15805;15998,27740,0,0,2,0,2
42103,90,11662,16581;16750;20481;20839,27740,2,0,2,0,4
42104,90,11663,16297;16579,27740,0,0,2,0,2
42105,90,11664,16175;16801,27740,0,0,2,0,2
42106,90,11665,15672;16075;20151,27740,0,1,2,0,3
42107,90,11667,16523;19430,27740,0,1,1,0,2
42108,90,11668,16775,27740,0,0,1,0,1
42109,90,11670,16306;16859;20322;20965,27740,1,1,2,0,4
42110,90,11671,17100;19639;20825,27740,1,1,1,0,3
42111,90,11672,15859;16363,27740,0,0,2,0,2
42112,90,11673,16391;16448;20437;20847,27740,2,0,2,0,4
42113,90,11674,16393;16991;20052,27740,0,1,2,0,3
42114,90,11675,16437;16774;20038;20581;20719;20769;20901,27740,4,1,2,0,7
42115,90,11676,16441;17221,27740,0,0,2,0,2
42116,90,11677,16443;17072,27740,0,0,2,0,2
42117,90,11678,16449;19669;19903,27740,0,2,1,0,3
42118,90,11679,16451;16935;20892,27740,1,0,2,0,3
42119,90,11682,16507;17038,27740,0,0,2,0,2
42120,90,11683,16521;16968;19838;20683,27740,1,1,2,0,4
42121,90,11684,16640;16840;20725,27740,1,0,2,0,3
42122,90,11685,16274;16642;19779;19824;19897;20244,27740,0,4,2,0,6
42123,90,11686,16202;16675;20194;20284,27740,0,2,2,0,4
42124,90,11687,16678;16858;20610;20966,27740,2,0,2,0,4
42125,90,11688,16679;17408;19502;20036,27740,0,2,2,0,4
42126,90,11689,16688;16820;20136;20830,27740,1,1,2,0,4
42127,90,11690,16178;16692;19986;20379,27740,0,2,2,0,4
42128,90,11691,16698;16869;20177,27740,0,1,2,0,3
42129,90,11692,16712;16838,27740,0,0,2,0,2
42130,90,11693,16352;16656;20045;20208;20261;20612,27740,1,3,2,0,6
42131,90,11694,16741;19879;20402,27740,0,2,1,0,3
42132,90,11696,16584;16733;19741;20070;20156,27740,0,3,2,0,5
42133,90,11697,16918;17124;19578,27740,0,1,2,0,3
42134,90,11698,17047;17475;20221,27740,0,1,2,0,3
42135,90,11699,16799;16843,27740,0,0,2,0,2
42136,90,11700,17301;19632;20215,27740,0,2,1,0,3
42137,90,11701,16877;17397;19715;20935,27740,1,1,2,0,4
42138,90,11702,17357;19546,27740,0,1,1,0,2
42139,90,11703,16915;17157;19541;20391;20638,27740,1,2,2,0,5
42140,90,11704,16922;19679;20448,27740,1,1,1,0,3
42141,90,11705,16691;16923;19703;20319,27740,0,2,2,0,4
42142,90,11706,16795;20560,27740,1,0,1,0,2
42143,90,11707,16990;17322;20773,27740,1,0,2,0,3
42144,90,11708,17001,27740,0,0,1,0,1
42145,90,11709,16914;17005;19836;20320;20385,27740,0,3,2,0,5
42146,90,11710,17009;17084;20027;20798,27740,1,1,2,0,4
42147,90,11711,17018;17048;20375;20726,27740,1,1,2,0,4
42148,90,11712,16592;17040;20149,27740,0,1,2,0,3
42149,90,11713,17044;17337;19845;20908,27740,1,1,2,0,4
42150,90,11714,16590;16897;19515;20886,27740,1,1,2,0,4
42151,90,11715,17181;20555,27740,1,0,1,0,2
42152,90,11716,17079;20912,27740,1,0,1,0,2
42153,90,11717,17114;17308;19656;19930;20808,27740,1,2,2,0,5
42154,90,11718,11420,28105,0,0,0,1,1
42155,90,11719,11934,28105,0,0,0,1,1
42156,90,11720,11601,28105,0,0,0,1,1
42157,90,11721,12253,28105,0,0,0,1,1
42158,90,11727,12523,28105,0,0,0,1,1
42159,90,11728,12498,28105,0,0,0,1,1
42160,90,11730,12857;13306,28105,0,0,1,1,2
42161,90,11748,14909;14959,28105,0,0,2,0,2
42162,90,11750,14922;15327,28105,0,0,2,0,2
42163,90,11751,15130;15737,28105,0,0,2,0,2
42164,90,11754,14484,28105,0,0,1,0,1
42165,90,11755,14996;15312;19717,28105,0,1,2,0,3
42166,90,11756,15079;15344,28105,0,0,2,0,2
42167,90,11757,15554;20454,28105,1,0,1,0,2
42168,90,11760,15448;15970,28105,0,0,2,0,2
42169,90,11761,14914;15470,28105,0,0,2,0,2
42170,90,11762,15460;16070,28105,0,0,2,0,2
42171,90,11763,16482;19796;20510,28105,1,1,1,0,3
42172,90,11765,15806;19835,28105,0,1,1,0,2
42173,90,11767,15873,28105,0,0,1,0,1
42174,90,11770,15954;16546,28105,0,0,2,0,2
42175,90,11771,15878;16019,28105,0,0,2,0,2
42176,90,11772,16139;16414,28105,0,0,2,0,2
42177,90,11773,16241;19912,28105,0,1,1,0,2
42178,90,11774,16438;20772,28105,1,0,1,0,2
42179,90,11775,16311;16714;19693;20121;20644,28105,1,2,2,0,5
42180,90,11777,16366;16637;19688;20190;20353,28105,0,3,2,0,5
42181,90,11778,16713;16909;19870;20062;20118;20967,28105,1,3,2,0,6
42182,90,11779,16077;16457,28105,0,0,2,0,2
42183,90,11780,16474;16823;20019;20456,28105,1,1,2,0,4
42184,90,11781,16540;20780,28105,1,0,1,0,2
42185,90,11782,16573;16665;20552;20650,28105,2,0,2,0,4
42186,90,11783,16722;20328;20479,28105,1,1,1,0,3
42187,90,11784,15913;15961,28105,0,0,2,0,2
42188,90,11785,16647;17041;19740;20324;20563,28105,1,2,2,0,5
42189,90,11787,16734,28105,0,0,1,0,1
42190,90,11788,16736;17266;19671;20707,28105,1,1,2,0,4
42191,90,11789,16737;17140;20904,28105,1,0,2,0,3
42192,90,11790,16073;16313;19995,28105,0,1,2,0,3
42193,90,11791,16769;17098;19765,28105,0,1,2,0,3
42194,90,11792,16626;16777;19682,28105,0,1,2,0,3
42195,90,11793,16481;16788,28105,0,0,2,0,2
42196,90,11794,16790;20232;20466,28105,1,1,1,0,3
42197,90,11795,16791;17423;19585;20115,28105,0,2,2,0,4
42198,90,11796,16806,28105,0,0,1,0,1
42199,90,11797,16534;16809,28105,0,0,2,0,2
42200,90,11798,16826;17061,28105,0,0,2,0,2
42201,90,11799,16784;16831;20618;20897,28105,2,0,2,0,4
42202,90,11800,16921;20047;20135;20311,28105,0,3,1,0,4
42203,90,11801,16871;17298,28105,0,0,2,0,2
42204,90,11802,16851;17420;20390,28105,0,1,2,0,3
42205,90,11803,16863;17314;19979;20278;20453,28105,1,2,2,0,5
42206,90,11804,16866;17461;20318;20518,28105,1,1,2,0,4
42207,90,11805,16908;17240;19589;19706,28105,0,2,2,0,4
42208,90,11806,16465,28105,0,0,1,0,1
42209,90,11807,17070;17520;20796,28105,1,0,2,0,3
42210,90,11808,16455;16969;19863;20748,28105,1,1,2,0,4
42211,90,11809,16975;20250,28105,0,1,1,0,2
42212,90,11810,16953;17073;19973;20224,28105,0,2,2,0,4
42213,90,11811,17049,28105,0,0,1,0,1
42214,90,11812,16796;17054,28105,0,0,2,0,2
42215,90,11813,17063;17429;20021;20129;20500;20591,28105,2,2,2,0,6
42216,90,11814,17083;17536;19843;20347;20539;20836,28105,2,2,2,0,6
42217,90,11815,17095;17511;19636;20516,28105,1,1,2,0,4
42218,90,11816,17096;17162,28105,0,0,2,0,2
42219,90,11817,16985;17108;20742,28105,1,0,2,0,3
42220,90,11818,17110;17405;20030;20424;20727;20938,28105,2,2,2,0,6
42221,90,11819,17027;17152;20603,28105,1,0,2,0,3
42222,90,11820,17142;17269;19575,28105,0,1,2,0,3
42223,90,11821,17519;17727;19926;20138;20399;20468,28105,1,3,2,0,6
42224,90,11822,17193;20280,28105,0,1,1,0,2
42225,90,11823,17216;17556;20048,28105,0,1,2,0,3
42226,90,11824,17215;17222,28105,0,0,2,0,2
42227,90,11825,16805;17223;19574;20520;20783,28105,2,1,2,0,5
42228,90,11826,12037;12690,28470,0,0,0,2,2
42229,90,11827,11964,28470,0,0,0,1,1
42230,90,11828,12111;12115,28470,0,0,0,2,2
42231,90,11829,12017,28470,0,0,0,1,1
42232,90,11830,12254,28470,0,0,0,1,1
42233,90,11831,12189,28470,0,0,0,1,1
42234,90,11833,12109;12302,28470,0,0,0,2,2
42235,90,11834,12027,28470,0,0,0,1,1
42236,90,11835,11770,28470,0,0,0,1,1
42237,90,11837,11995,28470,0,0,0,1,1
42238,90,11841,12541;13028,28470,0,0,1,1,2
42239,90,11844,12412;13075,28470,0,0,1,1,2
42240,90,11846,12964,28470,0,0,1,0,1
42241,90,11859,13767,28470,0,0,1,0,1
42242,90,11860,13485,28470,0,0,1,0,1
42243,90,11863,13967,28470,0,0,1,0,1
42244,90,11864,14265,28470,0,0,1,0,1
42245,90,11865,14029;14751,28470,0,0,2,0,2
42246,90,11866,14592,28470,0,0,1,0,1
42247,90,11871,14271,28470,0,0,1,0,1
42248,90,11873,14506;14896,28470,0,0,2,0,2
42249,90,11877,14728;14969;20108,28470,0,1,2,0,3
42250,90,11878,14875;15317,28470,0,0,2,0,2
42251,90,11879,14620;14848,28470,0,0,2,0,2
42252,90,11880,14123,28470,0,0,1,0,1
42253,90,11883,14512,28470,0,0,1,0,1
42254,90,11884,15042;15242,28470,0,0,2,0,2
42255,90,11886,15852;20073,28470,0,1,1,0,2
42256,90,11889,15482;16083;20017;20288;20494,28470,1,2,2,0,5
42257,90,11890,15224;15503;19690;19785,28470,0,2,2,0,4
42258,90,11891,15563;16566;20226,28470,0,1,2,0,3
42259,90,11892,15570;16314,28470,0,0,2,0,2
42260,90,11893,15955;16082;19798,28470,0,1,2,0,3
42261,90,11894,15520;16158;20633;20744,28470,2,0,2,0,4
42262,90,11895,15773;15969;20478,28470,1,0,2,0,3
42263,90,11896,15842;16129;20055,28470,0,1,2,0,3
42264,90,11898,15887;16431,28470,0,0,2,0,2
42265,90,11900,15979;16351;19698;19811;20272;20408,28470,0,4,2,0,6
42266,90,11901,16056;16499;19797;19902;20157,28470,0,3,2,0,5
42267,90,11902,16242;16484;20147;20470,28470,1,1,2,0,4
42268,90,11903,16032,28470,0,0,1,0,1
42269,90,11904,16259;20515,28470,1,0,1,0,2
42270,90,11905,16285;16780,28470,0,0,2,0,2
42271,90,11906,16380;17272;20071;20201,28470,0,2,2,0,4
42272,90,11907,16382;16406;19815;20069,28470,0,2,2,0,4
42273,90,11908,16435;16710,28470,0,0,2,0,2
42274,90,11909,16459;17082,28470,0,0,2,0,2
42275,90,11910,16408;16502;19961;20195,28470,0,2,2,0,4
42276,90,11911,16515;16885;19773;20762,28470,1,1,2,0,4
42277,90,11912,16538;16876;20166;20573,28470,1,1,2,0,4
42278,90,11913,16673;16702;20572;20778,28470,2,0,2,0,4
42279,90,11914,15653;16682;20139;20665,28470,1,1,2,0,4
42280,90,11915,16730;20153;20383,28470,0,2,1,0,3
42281,90,11916,16556;16747;20239;20594,28470,1,1,2,0,4
42282,90,11917,16830;17375;20476,28470,1,0,2,0,3
42283,90,11918,16890;17512,28470,0,0,2,0,2
42284,90,11919,16905;17008;20652,28470,1,0,2,0,3
42285,90,11920,16880;16950;20702,28470,1,0,2,0,3
42286,90,11921,16962;17016;20365;20588,28470,1,1,2,0,4
42287,90,11923,16981;17440;19869,28470,0,1,2,0,3
42288,90,11924,16989;17424;20142;20484,28470,1,1,2,0,4
42289,90,11925,16911;17496;19833;20615,28470,1,1,2,0,4
42290,90,11926,17014;17499;20228;20473;20915,28470,2,1,2,0,5
42291,90,11927,17332;17402;20133;20376;20767,28470,1,2,2,0,5
42292,90,11928,16917;17036,28470,0,0,2,0,2
42293,90,11929,17094;17508;19943;20176,28470,0,2,2,0,4
42294,90,11930,16931;17097;20395;20905,28470,1,1,2,0,4
42295,90,11931,16616;17104;19708;20159;20309;20346,28470,0,4,2,0,6
42296,90,11932,17130;17575;19694;20792,28470,1,1,2,0,4
42297,90,11933,17103;17148;20425;20745,28470,1,1,2,0,4
42298,90,11934,17011;17156,28470,0,0,2,0,2
42299,90,11935,16817;17189;20614,28470,1,0,2,0,3
42300,90,11936,17592;17845;19780;20608,28470,1,1,2,0,4
42301,90,11937,17198;17201;20622,28470,1,0,2,0,3
42302,90,11938,17200;19763,28470,0,1,1,0,2
42303,90,11939,16913;17208;20403,28470,0,1,2,0,3
42304,90,11940,17147;17227;20065,28470,0,1,2,0,3
42305,90,11941,16745;17231;19960,28470,0,1,2,0,3
42306,90,11942,16666;17234;19883;20088,28470,0,2,2,0,4
42307,90,11943,17244;17246;20058;20368,28470,0,2,2,0,4
42308,90,11944,17256;17320;19683;20107,28470,0,2,2,0,4
42309,90,11945,17192;17267;20015;20743;20797,28470,2,1,2,0,5
42310,90,11946,17284;17673;20678;20869,28470,2,0,2,0,4
42311,90,11947,17509,28470,0,0,1,0,1
42312,90,11948,17312;17457,28470,0,0,2,0,2
42313,90,11949,17344;17492;19686;19967,28470,0,2,2,0,4
42314,90,11951,12164,28835,0,0,0,1,1
42315,90,11952,11931,28835,0,0,0,1,1
42316,90,11955,12313,28835,0,0,0,1,1
42317,90,11956,12722,28835,0,0,0,1,1
42318,90,11957,12763,28835,0,0,0,1,1
42319,90,11958,12823,28835,0,0,0,1,1
42320,90,11959,12056,28835,0,0,0,1,1
42321,90,11960,12880,28835,0,0,1,0,1
42322,90,11961,12927;12937,28835,0,0,2,0,2
42323,90,11964,13030,28835,0,0,1,0,1
42324,90,11965,12844;13089,28835,0,0,1,1,2
42325,90,11967,13337,28835,0,0,1,0,1
42326,90,11973,13756;14155,28835,0,0,2,0,2
42327,90,11976,13961,28835,0,0,1,0,1
42328,90,11977,14005,28835,0,0,1,0,1
42329,90,11980,14405,28835,0,0,1,0,1
42330,90,11981,13972,28835,0,0,1,0,1
42331,90,11982,14565;14598,28835,0,0,2,0,2
42332,90,11985,14688;15100,28835,0,0,2,0,2
42333,90,11988,15116,28835,0,0,1,0,1
42334,90,11990,15553;19788;19938,28835,0,2,1,0,3
42335,90,11991,15345;16150;20013,28835,0,1,2,0,3
42336,90,11992,15369;16080;19977;20303;20432,28835,0,3,2,0,5
42337,90,11995,15074;15235,28835,0,0,2,0,2
42338,90,11997,15699;16142;20317;20558,28835,1,1,2,0,4
42339,90,11998,15791;16210;20936,28835,1,0,2,0,3
42340,90,12000,15600;16076,28835,0,0,2,0,2
42341,90,12004,15752;16433,28835,0,0,2,0,2
42342,90,12006,14942;16301;20039,28835,0,1,2,0,3
42343,90,12007,16387;19948;20430,28835,0,2,1,0,3
42344,90,12008,16423;16949;20134,28835,0,1,2,0,3
42345,90,12009,16196;16558;20542;20768,28835,2,0,2,0,4
42346,90,12011,16483;16611;20268;20605,28835,1,1,2,0,4
42347,90,12012,16356;16636,28835,0,0,2,0,2
42348,90,12013,16983;20144;20310;20355,28835,0,3,1,0,4
42349,90,12016,16700;17174;20537,28835,1,0,2,0,3
42350,90,12017,17218;17374;19975,28835,0,1,2,0,3
42351,90,12019,16517;17059,28835,0,0,2,0,2
42352,90,12020,16757,28835,0,0,1,0,1
42353,90,12021,16808;16874;20775;20882,28835,2,0,2,0,4
42354,90,12022,16349;16810;20264,28835,0,1,2,0,3
42355,90,12023,16852;17213;19841;20738;20812,28835,2,1,2,0,5
42356,90,12025,16898;17326;20501;20736,28835,2,0,2,0,4
42357,90,12027,16770;16926;20907,28835,1,0,2,0,3
42358,90,12028,16942;17533;20247,28835,0,1,2,0,3
42359,90,12029,16963;17527,28835,0,0,2,0,2
42360,90,12030,16987,28835,0,0,1,0,1
42361,90,12031,16994,28835,0,0,1,0,1
42362,90,12032,17017;17632;20206;20461;20840,28835,2,1,2,0,5
42363,90,12033,17283;17551;20691,28835,1,0,2,0,3
42364,90,12034,17032;17605;20505,28835,1,0,2,0,3
42365,90,12035,17034;17531;20861,28835,1,0,2,0,3
42366,90,12036,17052;20848,28835,1,0,1,0,2
42367,90,12037,17274;17395;20241;20509;20599,28835,2,1,2,0,5
42368,90,12038,17066;17381;20137;20583,28835,1,1,2,0,4
42369,90,12039,17067;17406;20192,28835,0,1,2,0,3
42370,90,12040,17120;17687,28835,0,0,2,0,2
42371,90,12041,16881;17123;20513,28835,1,0,2,0,3
42372,90,12042,17091;17143;19991,28835,0,1,2,0,3
42373,90,12043,17144;17207;20655;20962,28835,2,0,2,0,4
42374,90,12044,17166;20386;20579;20862,28835,2,1,1,0,4
42375,90,12045,17177;17430;19888;20082;20429;20447,28835,1,3,2,0,6
42376,90,12046,17232;17493;20896,28835,1,0,2,0,3
42377,90,12047,17233;17557;19784;20631,28835,1,1,2,0,4
42378,90,12048,17237;17704;20229,28835,0,1,2,0,3
42379,90,12049,16954;17239;19957;20794,28835,1,1,2,0,4
42380,90,12050,16941,28835,0,0,1,0,1
42381,90,12051,16965;17248;19851;20001,28835,0,2,2,0,4
42382,90,12053,17288;17304;19801;20161;20525;20816;20879,28835,3,2,2,0,7
42383,90,12054,16477;17307;20028;20286;20880,28835,1,2,2,0,5
42384,90,12055,17323;17580;20387,28835,0,1,2,0,3
42385,90,12056,17331;17392;20593,28835,1,0,2,0,3
42386,90,12058,17356;17627;20951,28835,1,0,2,0,3
42387,90,12059,17206;17372;20051;20724,28835,1,1,2,0,4
42388,90,12060,17271;17393;19816;20086,28835,0,2,2,0,4
42389,90,12061,17438;17788;20056;20888,28835,1,1,2,0,4
42390,90,12062,17658;17671;19990;20079;20449,28835,1,2,2,0,5
42391,90,12063,17450;17588;19924,28835,0,1,2,0,3
42392,90,12064,17473;17619;19813,28835,0,1,2,0,3
42393,90,12065,12264,29200,0,0,0,1,1
42394,90,12066,11803,29200,0,0,0,1,1
42395,90,12067,12311;12445,29200,0,0,0,2,2
42396,90,12068,12510,29200,0,0,0,1,1
42397,90,12070,12768,29200,0,0,0,1,1
42398,90,12071,12875;13108,29200,0,0,2,0,2
42399,90,12073,13006,29200,0,0,1,0,1
42400,90,12076,13228,29200,0,0,1,0,1
42401,90,12078,13166;13310,29200,0,0,2,0,2
42402,90,12082,13417,29200,0,0,1,0,1
42403,90,12083,13429,29200,0,0,1,0,1
42404,90,12085,13946,29200,0,0,1,0,1
42405,90,12089,14102,29200,0,0,1,0,1
42406,90,12090,14199,29200,0,0,1,0,1
42407,90,12092,14335,29200,0,0,1,0,1
42408,90,12097,14617,29200,0,0,1,0,1
42409,90,12098,14994,29200,0,0,1,0,1
42410,90,12100,14380;14850,29200,0,0,2,0,2
42411,90,12101,15020;15167,29200,0,0,2,0,2
42412,90,12104,14266,29200,0,0,1,0,1
42413,90,12106,15408;15788;20188,29200,0,1,2,0,3
42414,90,12109,15522,29200,0,0,1,0,1
42415,90,12111,15657;16204;20023,29200,0,1,2,0,3
42416,90,12112,15723;15935,29200,0,0,2,0,2
42417,90,12114,16041,29200,0,0,1,0,1
42418,90,12115,15899;16711;20507;20703,29200,2,0,2,0,4
42419,90,12116,15914;16657,29200,0,0,2,0,2
42420,90,12117,15976;16342,29200,0,0,2,0,2
42421,90,12118,16004;16862;20145;20249;20549,29200,1,2,2,0,5
42422,90,12119,16102;16462;19920;20096,29200,0,2,2,0,4
42423,90,12120,16109;16165;19919;20193,29200,0,2,2,0,4
42424,90,12123,16295;16298,29200,0,0,2,0,2
42425,90,12124,16486;17107;19915;20755,29200,1,1,2,0,4
42426,90,12125,16505;16800,29200,0,0,2,0,2
42427,90,12126,16518,29200,0,0,1,0,1
42428,90,12127,16528;16977;20679;20799,29200,2,0,2,0,4
42429,90,12128,16497;17090;20917,29200,1,0,2,0,3
42430,90,12129,16591;17133;20696,29200,1,0,2,0,3
42431,90,12130,16604;16797,29200,0,0,2,0,2
42432,90,12131,16255;16621,29200,0,0,2,0,2
42433,90,12132,16813;17447;20276;20641,29200,1,1,2,0,4
42434,90,12133,16559;17236;20263,29200,0,1,2,0,3
42435,90,12134,16658;16719;20538;20590;20760,29200,3,0,2,0,5
42436,90,12135,16933;17010;20163;20333;20629,29200,1,2,2,0,5
42437,90,12136,16828;17296;20659,29200,1,0,2,0,3
42438,90,12137,16834;17195;20654,29200,1,0,2,0,3
42439,90,12138,15603;16014;20737,29200,1,0,2,0,3
42440,90,12140,17220;20397,29200,0,1,1,0,2
42441,90,12141,17012,29200,0,0,1,0,1
42442,90,12142,17019;17165;20483,29200,1,0,2,0,3
42443,90,12143,16997;17042,29200,0,0,2,0,2
42444,90,12144,17045;17706;20041;20326,29200,0,2,2,0,4
42445,90,12145,17075;17230;20471,29200,1,0,2,0,3
42446,90,12146,17129;17359;20681,29200,1,0,2,0,3
42447,90,12147,16794;17139,29200,0,0,2,0,2
42448,90,12148,17141,29200,0,0,1,0,1
42449,90,12149,17145;17327;20415,29200,0,1,2,0,3
42450,90,12150,17485,29200,0,0,1,0,1
42451,90,12151,17229;17672,29200,0,0,2,0,2
42452,90,12152,17169;17294;20697,29200,1,0,2,0,3
42453,90,12153,17254;20469,29200,1,0,1,0,2
42454,90,12154,17277;17747;19893;20475;20716,29200,2,1,2,0,5
42455,90,12155,17280;17875;20639,29200,1,0,2,0,3
42456,90,12156,17228;17300,29200,0,0,2,0,2
42457,90,12157,17316;20172,29200,0,1,1,0,2
42458,90,12158,17360;20350,29200,0,1,1,0,2
42459,90,12160,17396;17616;20340,29200,0,1,2,0,3
42460,90,12161,17403;17635;20283,29200,0,1,2,0,3
42461,90,12162,17710;17896;20900,29200,1,0,2,0,3
42462,90,12163,17500;17846;20330;20732,29200,1,1,2,0,4
42463,90,12164,17340;17505;20216;20692,29200,1,1,2,0,4
42464,90,12165,17828;17902;20005;20661,29200,1,1,2,0,4
42465,90,12166,17534;17733;20024,29200,0,1,2,0,3
42466,90,12167,17543;17761;20167,29200,0,1,2,0,3
42467,90,12168,17554;17600;20942,29200,1,0,2,0,3
42468,90,12169,17567;17878;20741,29200,1,0,2,0,3
42469,90,12170,12130,29565,0,0,0,1,1
42470,90,12171,12398;12741,29565,0,0,0,2,2
42471,90,12174,12511,29565,0,0,0,1,1
42472,90,12175,12614,29565,0,0,0,1,1
42473,90,12176,12248,29565,0,0,0,1,1
42474,90,12177,12275,29565,0,0,0,1,1
42475,90,12179,12743,29565,0,0,0,1,1
42476,90,12180,12956,29565,0,0,1,0,1
42477,90,12181,12816,29565,0,0,0,1,1
42478,90,12182,12694,29565,0,0,0,1,1
42479,90,12184,12716,29565,0,0,0,1,1
42480,90,12187,13135;13366,29565,0,0,2,0,2
42481,90,12195,13498;13780,29565,0,0,2,0,2
42482,90,12197,13862,29565,0,0,1,0,1
42483,90,12198,13872;13889,29565,0,0,2,0,2
42484,90,12200,14069,29565,0,0,1,0,1
42485,90,12201,14100,29565,0,0,1,0,1
42486,90,12203,14351,29565,0,0,1,0,1
42487,90,12205,14397,29565,0,0,1,0,1
42488,90,12206,14606;14880,29565,0,0,2,0,2
42489,90,12207,14396,29565,0,0,1,0,1
42490,90,12208,14745;15133,29565,0,0,2,0,2
42491,90,12209,14474;14928,29565,0,0,2,0,2
42492,90,12210,14870;15694,29565,0,0,2,0,2
42493,90,12211,15162;15187,29565,0,0,2,0,2
42494,90,12215,15659;16099;20238,29565,0,1,2,0,3
42495,90,12216,15697,29565,0,0,1,0,1
42496,90,12218,15707;15840,29565,0,0,2,0,2
42497,90,12219,15960;16400;20155;20669,29565,1,1,2,0,4
42498,90,12221,15983,29565,0,0,1,0,1
42499,90,12222,15957;16062,29565,0,0,2,0,2
42500,90,12223,15933;16071;20132;20382,29565,0,2,2,0,4
42501,90,12226,16155;16612;20414;20438,29565,1,1,2,0,4
42502,90,12227,15860;16134,29565,0,0,2,0,2
42503,90,12228,16232;16630;20673,29565,1,0,2,0,3
42504,90,12229,16309;20389,29565,0,1,1,0,2
42505,90,12231,16332;17050;20684,29565,1,0,2,0,3
42506,90,12232,16345,29565,0,0,1,0,1
42507,90,12233,16374;16957;20441;20717,29565,2,0,2,0,4
42508,90,12234,15572;16415;20758,29565,1,0,2,0,3
42509,90,12235,16434,29565,0,0,1,0,1
42510,90,12236,16432;16496;20495,29565,1,0,2,0,3
42511,90,12237,16564;16646;20787,29565,1,0,2,0,3
42512,90,12238,16587;16824;20421;20598;20941,29565,2,1,2,0,5
42513,90,12239,16835;16906;20259;20586,29565,1,1,2,0,4
42514,90,12240,16684;17247;20868,29565,1,0,2,0,3
42515,90,12241,16511;16683;20123;20606,29565,1,1,2,0,4
42516,90,12242,16715;17329,29565,0,0,2,0,2
42517,90,12243,16767;17469,29565,0,0,2,0,2
42518,90,12244,16781;17122;20587;20714,29565,2,0,2,0,4
42519,90,12246,16555;16690,29565,0,0,2,0,2
42520,90,12247,16884;17116;20338,29565,0,1,2,0,3
42521,90,12248,16643;16916;20564,29565,1,0,2,0,3
42522,90,12249,16956;17154;20721,29565,1,0,2,0,3
42523,90,12250,16993;17541;20043;20343,29565,0,2,2,0,4
42524,90,12251,17004;17522;20396;20602,29565,1,1,2,0,4
42525,90,12252,16444;16814,29565,0,0,2,0,2
42526,90,12253,17056;17146,29565,0,0,2,0,2
42527,90,12254,16839;17464,29565,0,0,2,0,2
42528,90,12255,17163;20207,29565,0,1,1,0,2
42529,90,12256,16696;17099;20776,29565,1,0,2,0,3
42530,90,12257,17134;17380;20315,29565,0,1,2,0,3
42531,90,12258,17176;20003,29565,0,1,1,0,2
42532,90,12259,17184;17663;20366,29565,0,1,2,0,3
42533,90,12260,17187;17404;20274,29565,0,1,2,0,3
42534,90,12261,16972;17212,29565,0,0,2,0,2
42535,90,12262,17209;17243;20884,29565,1,0,2,0,3
42536,90,12263,17109;17245;20329;20477,29565,1,1,2,0,4
42537,90,12264,17251;17262;20374,29565,0,1,2,0,3
42538,90,12265,17279;17662;20302;20784,29565,1,1,2,0,4
42539,90,12266,17285;20566;20846,29565,2,0,1,0,3
42540,90,12267,17364;17426;20895,29565,1,0,2,0,3
42541,90,12268,17128;17389;20548,29565,1,0,2,0,3
42542,90,12269,17400;17923;20183;20282;20971,29565,1,2,2,0,5
42543,90,12270,17414;18042,29565,0,0,2,0,2
42544,90,12271,17470;20802,29565,1,0,1,0,2
42545,90,12272,17431;17491;20416,29565,0,1,2,0,3
42546,90,12273,17444;17742;20004;20175;20664,29565,1,2,2,0,5
42547,90,12274,17459;17670;20489,29565,1,0,2,0,3
42548,90,12275,17453;17460;20578;20855;20927,29565,3,0,2,0,5
42549,90,12276,17462;17507,29565,0,0,2,0,2
42550,90,12277,17003;17463;20426,29565,0,1,2,0,3
42551,90,12278,17487;17807;20097;20325;20624,29565,1,2,2,0,5
42552,90,12279,17489,29565,0,0,1,0,1
42553,90,12280,17506;17768;20102;20852;20898,29565,2,1,2,0,5
42554,90,12281,17910;18034;20225;20378,29565,0,2,2,0,4
42555,90,12282,17182;17523;20066;20940,29565,1,1,2,0,4
42556,90,12283,17542;17955,29565,0,0,2,0,2
42557,90,12285,17591,29565,0,0,1,0,1
42558,90,12287,17604;17954;20358;20903,29565,1,1,2,0,4
42559,90,12288,17476;17617;20371,29565,0,1,2,0,3
42560,90,12289,17333;17621,29565,0,0,2,0,2
42561,90,12290,17572;17622;20715,29565,1,0,2,0,3
42562,90,12291,17982,29565,0,0,1,0,1
42563,90,12292,17330;17656,29565,0,0,2,0,2
42564,90,12293,17548;17684,29565,0,0,2,0,2
42565,90,12294,12502,29930,0,0,0,1,1
42566,90,12295,12507,29930,0,0,0,1,1
42567,90,12296,12534,29930,0,0,0,1,1
42568,90,12297,12576,29930,0,0,0,1,1
42569,90,12298,12645,29930,0,0,0,1,1
42570,90,12302,12863,29930,0,0,0,1,1
42571,90,12303,12874,29930,0,0,1,0,1
42572,90,12304,12907,29930,0,0,1,0,1
42573,90,12305,12979,29930,0,0,1,0,1
42574,90,12308,13247,29930,0,0,1,0,1
42575,90,12312,13148;13661,29930,0,0,2,0,2
42576,90,12315,13160,29930,0,0,1,0,1
42577,90,12316,13541;13902,29930,0,0,2,0,2
42578,90,12317,13202,29930,0,0,1,0,1
42579,90,12318,13145,29930,0,0,1,0,1
42580,90,12321,14218,29930,0,0,1,0,1
42581,90,12323,14357,29930,0,0,1,0,1
42582,90,12324,14389,29930,0,0,1,0,1
42583,90,12327,14403,29930,0,0,1,0,1
42584,90,12331,14469;14561,29930,0,0,2,0,2
42585,90,12333,14947;15777,29930,0,0,2,0,2
42586,90,12334,15243;15683,29930,0,0,2,0,2
42587,90,12335,15264;15724,29930,0,0,2,0,2
42588,90,12336,14815;14937,29930,0,0,2,0,2
42589,90,12339,15709,29930,0,0,1,0,1
42590,90,12340,16268,29930,0,0,1,0,1
42591,90,12342,15804;16068;20451,29930,1,0,2,0,3
42592,90,12345,16212;17136,29930,0,0,2,0,2
42593,90,12347,15958;16384;20676;20933,29930,2,0,2,0,4
42594,90,12348,16816,29930,0,0,1,0,1
42595,90,12349,16959;20859,29930,1,0,1,0,2
42596,90,12350,16743;20360;20569;20757,29930,2,1,1,0,4
42597,90,12351,16837,29930,0,0,1,0,1
42598,90,12352,16748;16827,29930,0,0,2,0,2
42599,90,12353,17167,29930,0,0,1,0,1
42600,90,12354,16772;16929,29930,0,0,2,0,2
42601,90,12355,16421;16785,29930,0,0,2,0,2
42602,90,12356,16574;16818;20668,29930,1,0,2,0,3
42603,90,12357,16848;17112;20345;20699,29930,1,1,2,0,4
42604,90,12358,16873;17024,29930,0,0,2,0,2
42605,90,12359,17006;17445;20335;20695,29930,1,1,2,0,4
42606,90,12360,16410;17051;20636,29930,1,0,2,0,3
42607,90,12361,17089;17126,29930,0,0,2,0,2
42608,90,12362,17135;17155;20126;20300;20504;20786,29930,2,2,2,0,6
42609,90,12363,17159;18088;20255;20427;20626,29930,1,2,2,0,5
42610,90,12364,17093,29930,0,0,1,0,1
42611,90,12365,17179,29930,0,0,1,0,1
42612,90,12366,17185;17690;20544,29930,1,0,2,0,3
42613,90,12367,17078,29930,0,0,1,0,1
42614,90,12368,17258;17278;20689,29930,1,0,2,0,3
42615,90,12369,17203;17583;20526,29930,1,0,2,0,3
42616,90,12370,17366,29930,0,0,1,0,1
42617,90,12371,17418;17972,29930,0,0,2,0,2
42618,90,12372,17007;17449;20857,29930,1,0,2,0,3
42619,90,12374,17675;17717;20711,29930,1,0,2,0,3
42620,90,12375,17488;17943,29930,0,0,2,0,2
42621,90,12376,17540;17840;20422;20450;20648,29930,2,1,2,0,5
42622,90,12377,17335;17586,29930,0,0,2,0,2
42623,90,12378,17451,29930,0,0,1,0,1
42624,90,12380,17637;17756;20833,29930,1,0,2,0,3
42625,90,12381,17661;18067;20146;20704,29930,1,1,2,0,4
42626,90,12382,17286;17669;20872,29930,1,0,2,0,3
42627,90,12383,17439;17677,29930,0,0,2,0,2
42628,90,12384,17692;17723;20409;20733;20837,29930,2,1,2,0,5
42629,90,12385,17456;17737;20834;20877,29930,2,0,2,0,4
42630,90,12386,17748;18120;20411;20632,29930,1,1,2,0,4
42631,90,12387,17775;17994;20214;20446;20937,29930,2,1,2,0,5
42632,90,12388,17796;17847,29930,0,0,2,0,2
42633,90,12389,17799;18009,29930,0,0,2,0,2
42634,90,12390,17382;17801,29930,0,0,2,0,2
42635,90,12391,12607,30295,0,0,0,1,1
42636,90,12393,12220,30295,0,0,0,1,1
42637,90,12395,12933,30295,0,0,1,0,1
42638,90,12396,12593,30295,0,0,0,1,1
42639,90,12397,12830,30295,0,0,0,1,1
42640,90,12398,12402,30295,0,0,0,1,1
42641,90,12400,13081,30295,0,0,1,0,1
42642,90,12401,12513;12976,30295,0,0,1,1,2
42643,90,12403,13418,30295,0,0,1,0,1
42644,90,12407,13804,30295,0,0,1,0,1
42645,90,12408,13900,30295,0,0,1,0,1
42646,90,12409,13969,30295,0,0,1,0,1
42647,90,12411,13274,30295,0,0,1,0,1
42648,90,12416,13970,30295,0,0,1,0,1
42649,90,12418,14665,30295,0,0,1,0,1
42650,90,12424,15054;15329,30295,0,0,2,0,2
42651,90,12425,15253;15455,30295,0,0,2,0,2
42652,90,12427,15279,30295,0,0,1,0,1
42653,90,12429,15126,30295,0,0,1,0,1
42654,90,12431,15541;15606,30295,0,0,2,0,2
42655,90,12432,15417,30295,0,0,1,0,1
42656,90,12433,15284,30295,0,0,1,0,1
42657,90,12434,15793;16397,30295,0,0,2,0,2
42658,90,12435,15688,30295,0,0,1,0,1
42659,90,12436,16334;16354;20687,30295,1,0,2,0,3
42660,90,12437,15515,30295,0,0,1,0,1
42661,90,12439,16215,30295,0,0,1,0,1
42662,90,12440,16184,30295,0,0,1,0,1
42663,90,12442,16316,30295,0,0,1,0,1
42664,90,12443,16325;16746,30295,0,0,2,0,2
42665,90,12444,16430;16494;20807;20934,30295,2,0,2,0,4
42666,90,12445,16867;20490,30295,1,0,1,0,2
42667,90,12446,16652;17023,30295,0,0,2,0,2
42668,90,12447,16513;16655,30295,0,0,2,0,2
42669,90,12448,16569,30295,0,0,1,0,1
42670,90,12449,16689;17175,30295,0,0,2,0,2
42671,90,12450,16619;16754,30295,0,0,2,0,2
42672,90,12453,16789;16832;20364,30295,0,1,2,0,3
42673,90,12455,16677;16955;20645,30295,1,0,2,0,3
42674,90,12457,17482;20312,30295,0,1,1,0,2
42675,90,12458,17219,30295,0,0,1,0,1
42676,90,12459,16649,30295,0,0,1,0,1
42677,90,12460,16998;17211;20809,30295,1,0,2,0,3
42678,90,12461,17058;17538;20609,30295,1,0,2,0,3
42679,90,12462,16910;17170;20493;20653,30295,2,0,2,0,4
42680,90,12463,17197;17394,30295,0,0,2,0,2
42681,90,12464,17196;17584,30295,0,0,2,0,2
42682,90,12465,17224;18203,30295,0,0,2,0,2
42683,90,12466,16704;16996;20682;20759,30295,2,0,2,0,4
42684,90,12467,17289;17547;20499,30295,1,0,2,0,3
42685,90,12468,17302,30295,0,0,1,0,1
42686,90,12469,17306;17341;20487;20906,30295,2,0,2,0,4
42687,90,12470,17321;17998,30295,0,0,2,0,2
42688,90,12471,17310;17346;20713,30295,1,0,2,0,3
42689,90,12473,17361;17765,30295,0,0,2,0,2
42690,90,12474,17290;17371;20367;20766,30295,1,1,2,0,4
42691,90,12475,17376;17378;20540,30295,1,0,2,0,3
42692,90,12476,17057;17411,30295,0,0,2,0,2
42693,90,12477,17480;17546;20849,30295,1,0,2,0,3
42694,90,12478,17502;17824,30295,0,0,2,0,2
42695,90,12479,17514;17544,30295,0,0,2,0,2
42696,90,12480,17530;17739;20619,30295,1,0,2,0,3
42697,90,12481,17537;17653,30295,0,0,2,0,2
42698,90,12482,17574;17623;20866,30295,1,0,2,0,3
42699,90,12483,17576;18021,30295,0,0,2,0,2
42700,90,12484,17585;17703,30295,0,0,2,0,2
42701,90,12485,17693;18103,30295,0,0,2,0,2
42702,90,12486,17606;18262;20672;20939,30295,2,0,2,0,4
42703,90,12487,17242;17608;20462;20764;20959,30295,3,0,2,0,5
42704,90,12488,17634,30295,0,0,1,0,1
42705,90,12489,17685;17819,30295,0,0,2,0,2
42706,90,12490,17697;18160,30295,0,0,2,0,2
42707,90,12491,17726;17867;20693;20921,30295,2,0,2,0,4
42708,90,12492,17743;18235;20523,30295,1,0,2,0,3
42709,90,12493,17750;17781;20233;20828,30295,1,1,2,0,4
42710,90,12494,17590;17811;20420,30295,0,1,2,0,3
42711,90,12495,17813;17872,30295,0,0,2,0,2
42712,90,12496,17827;17900,30295,0,0,2,0,2
42713,90,12497,17646;17834;20472;20651,30295,2,0,2,0,4
42714,90,12498,17642;17841,30295,0,0,2,0,2
42715,90,12499,17746;17849;20257;20498;20567,30295,2,1,2,0,5
42716,90,12500,17795;17851;20308;20854,30295,1,1,2,0,4
42717,90,12501,17526;17857;20739,30295,1,0,2,0,3
42718,90,12502,17866;17975;20457;20752,30295,2,0,2,0,4
42719,90,12503,17474;17645,30295,0,0,2,0,2
42720,90,12504,17593;17880;20731,30295,1,0,2,0,3
42721,90,12505,17883,30295,0,0,1,0,1
42722,90,12506,17202;17898,30295,0,0,2,0,2
42723,90,12507,17918;18197,30295,0,0,2,0,2
42724,90,12508,13472,30660,0,0,1,0,1
42725,90,12509,12749,30660,0,0,0,1,1
42726,90,12510,12600,30660,0,0,0,1,1
42727,90,12512,12461;12777,30660,0,0,0,2,2
42728,90,12514,12987,30660,0,0,1,0,1
42729,90,12515,12951,30660,0,0,1,0,1
42730,90,12517,13249,30660,0,0,1,0,1
42731,90,12519,13289;13779,30660,0,0,2,0,2
42732,90,12520,12689,30660,0,0,0,1,1
42733,90,12522,12865,30660,0,0,0,1,1
42734,90,12523,13025,30660,0,0,1,0,1
42735,90,12524,13664,30660,0,0,1,0,1
42736,90,12527,13838,30660,0,0,1,0,1
42737,90,12528,13583,30660,0,0,1,0,1
42738,90,12529,14037,30660,0,0,1,0,1
42739,90,12530,14054,30660,0,0,1,0,1
42740,90,12531,13544,30660,0,0,1,0,1
42741,90,12534,14231,30660,0,0,1,0,1
42742,90,12535,14087,30660,0,0,1,0,1
42743,90,12538,14805;15254,30660,0,0,2,0,2
42744,90,12539,14901;15125,30660,0,0,2,0,2
42745,90,12541,14730;15109,30660,0,0,2,0,2
42746,90,12544,15292,30660,0,0,1,0,1
42747,90,12545,15161;16120,30660,0,0,2,0,2
42748,90,12549,15647,30660,0,0,1,0,1
42749,90,12551,15803,30660,0,0,1,0,1
42750,90,12554,15864,30660,0,0,1,0,1
42751,90,12556,15652,30660,0,0,1,0,1
42752,90,12558,15559,30660,0,0,1,0,1
42753,90,12560,16074,30660,0,0,1,0,1
42754,90,12561,15984,30660,0,0,1,0,1
42755,90,12562,16485,30660,0,0,1,0,1
42756,90,12565,16567;16582;20533,30660,1,0,2,0,3
42757,90,12566,16405;16598;20826,30660,1,0,2,0,3
42758,90,12567,16140,30660,0,0,1,0,1
42759,90,12569,16634;20418;20458,30660,1,1,1,0,3
42760,90,12571,16729,30660,0,0,1,0,1
42761,90,12572,16522;17043,30660,0,0,2,0,2
42762,90,12573,17002,30660,0,0,1,0,1
42763,90,12574,16500,30660,0,0,1,0,1
42764,90,12575,16902;17720,30660,0,0,2,0,2
42765,90,12576,16978;17241;20519,30660,1,0,2,0,3
42766,90,12577,17088;17524,30660,0,0,2,0,2
42767,90,12578,17121;17132;20440,30660,1,0,2,0,3
42768,90,12579,17249,30660,0,0,1,0,1
42769,90,12580,17268;17387;20351;20754,30660,1,1,2,0,4
42770,90,12581,16782;17305;20701,30660,1,0,2,0,3
42771,90,12582,17317;20332,30660,0,1,1,0,2
42772,90,12583,17318;17352;20467;20820,30660,2,0,2,0,4
42773,90,12584,17343;17455;20480,30660,1,0,2,0,3
42774,90,12585,17377;17887,30660,0,0,2,0,2
42775,90,12586,17386;17630;20688,30660,1,0,2,0,3
42776,90,12587,17399;17903;20658;20865,30660,2,0,2,0,4
42777,90,12588,17432;17826;20381;20931,30660,1,1,2,0,4
42778,90,12589,17433;18072,30660,0,0,2,0,2
42779,90,12590,17442;18291,30660,0,0,2,0,2
42780,90,12591,17452,30660,0,0,1,0,1
42781,90,12592,17427;17510,30660,0,0,2,0,2
42782,90,12593,17161;17568,30660,0,0,2,0,2
42783,90,12594,17342;17562,30660,0,0,2,0,2
42784,90,12595,17766;20556;20961,30660,2,0,1,0,3
42785,90,12596,17571;17882;20914,30660,1,0,2,0,3
42786,90,12597,17908;20474,30660,1,0,1,0,2
42787,90,12598,17589;17822,30660,0,0,2,0,2
42788,90,12599,18122;20503;20623;20864,30660,3,0,1,0,4
42789,90,12600,17705;17959,30660,0,0,2,0,2
42790,90,12601,17495;17711,30660,0,0,2,0,2
42791,90,12602,17712,30660,0,0,1,0,1
42792,90,12603,17713;18164,30660,0,0,2,0,2
42793,90,12604,17734;17735,30660,0,0,2,0,2
42794,90,12605,17741;18354,30660,0,0,2,0,2
42795,90,12606,17759;18215;20417;20804,30660,1,1,2,0,4
42796,90,12607,17550;17783,30660,0,0,2,0,2
42797,90,12608,17609;17835;20485,30660,1,0,2,0,3
42798,90,12609,17838;18216,30660,0,0,2,0,2
42799,90,12610,17862;18126,30660,0,0,2,0,2
42800,90,12611,17782,30660,0,0,1,0,1
42801,90,12612,17901;17951,30660,0,0,2,0,2
42802,90,12613,17911;17921,30660,0,0,2,0,2
42803,90,12614,17915;18232;20546,30660,1,0,2,0,3
42804,90,12615,17563;17926,30660,0,0,2,0,2
42805,90,12616,18165,30660,0,0,1,0,1
42806,90,12617,17941,30660,0,0,1,0,1
42807,90,12618,17598;17957,30660,0,0,2,0,2
42808,90,12619,17979;18043,30660,0,0,2,0,2
42809,90,12620,17850;17990;20580;20970,30660,2,0,2,0,4
42810,90,12621,18002;18131,30660,0,0,2,0,2
42811,90,12622,18007,30660,0,0,1,0,1
42812,90,12623,18097,30660,0,0,1,0,1
42813,90,12624,17649;18024,30660,0,0,2,0,2
42814,90,12625,17515;17870,30660,0,0,2,0,2
42815,90,12626,18040;18340,30660,0,0,2,0,2
42816,90,12627,17398;18046,30660,0,0,2,0,2
42817,90,12628,12740,31025,0,0,0,1,1
42818,90,12629,12757,31025,0,0,0,1,1
42819,90,12630,12833,31025,0,0,0,1,1
42820,90,12631,12545,31025,0,0,0,1,1
42821,90,12633,13102,31025,0,0,1,0,1
42822,90,12634,13380,31025,0,0,1,0,1
42823,90,12636,13402;14017,31025,0,0,2,0,2
42824,90,12639,13519;13707,31025,0,0,2,0,2
42825,90,12642,13671,31025,0,0,1,0,1
42826,90,12645,14022,31025,0,0,1,0,1
42827,90,12646,14096,31025,0,0,1,0,1
42828,90,12647,14008,31025,0,0,1,0,1
42829,90,12652,14604,31025,0,0,1,0,1
42830,90,12653,15140,31025,0,0,1,0,1
42831,90,12654,14680,31025,0,0,1,0,1
42832,90,12657,14402,31025,0,0,1,0,1
42833,90,12658,15207,31025,0,0,1,0,1
42834,90,12659,15240,31025,0,0,1,0,1
42835,90,12660,15288,31025,0,0,1,0,1
42836,90,12661,15300,31025,0,0,1,0,1
42837,90,12663,15593,31025,0,0,1,0,1
42838,90,12664,15624,31025,0,0,1,0,1
42839,90,12665,15704,31025,0,0,1,0,1
42840,90,12666,15730,31025,0,0,1,0,1
42841,90,12667,15632;16466,31025,0,0,2,0,2
42842,90,12668,15299;16029,31025,0,0,2,0,2
42843,90,12671,16093,31025,0,0,1,0,1
42844,90,12672,15857,31025,0,0,1,0,1
42845,90,12673,16401;17102;20929,31025,1,0,2,0,3
42846,90,12674,15996;16002,31025,0,0,2,0,2
42847,90,12676,16632;17085;20694,31025,1,0,2,0,3
42848,90,12677,16104;16718;20600,31025,1,0,2,0,3
42849,90,12678,16525;16758,31025,0,0,2,0,2
42850,90,12679,16847,31025,0,0,1,0,1
42851,90,12680,16970;17259;20643,31025,1,0,2,0,3
42852,90,12682,16740;17025;20630,31025,1,0,2,0,3
42853,90,12684,16825;17064,31025,0,0,2,0,2
42854,90,12685,16995,31025,0,0,1,0,1
42855,90,12686,17077,31025,0,0,1,0,1
42856,90,12687,17153,31025,0,0,1,0,1
42857,90,12689,17282;17738;20926,31025,1,0,2,0,3
42858,90,12690,16860;17299;20946,31025,1,0,2,0,3
42859,90,12691,17601;17716,31025,0,0,2,0,2
42860,90,12692,17367;17660;20488,31025,1,0,2,0,3
42861,90,12693,17370;17477;20524;20601;20964,31025,3,0,2,0,5
42862,90,12694,17413;17490,31025,0,0,2,0,2
42863,90,12695,17150;17504;20708,31025,1,0,2,0,3
42864,90,12696,16939,31025,0,0,1,0,1
42865,90,12697,18200;20443;20831,31025,2,0,1,0,3
42866,90,12698,17521;17577;20953,31025,1,0,2,0,3
42867,90,12699,17596;18109,31025,0,0,2,0,2
42868,90,12700,17503;17674,31025,0,0,2,0,2
42869,90,12701,17688;17774,31025,0,0,2,0,2
42870,90,12702,17722;18010,31025,0,0,2,0,2
42871,90,12703,17731;20844,31025,1,0,1,0,2
42872,90,12704,17745;17803,31025,0,0,2,0,2
42873,90,12705,17942;20722;20788,31025,2,0,1,0,3
42874,90,12706,17769,31025,0,0,1,0,1
42875,90,12707,17858;17949;20620,31025,1,0,2,0,3
42876,90,12708,17873;17888;20712,31025,1,0,2,0,3
42877,90,12709,17558;17889,31025,0,0,2,0,2
42878,90,12710,18133;20751,31025,1,0,1,0,2
42879,90,12711,17932;18376;20822;20875,31025,2,0,2,0,4
42880,90,12712,17976;18249;20763,31025,1,0,2,0,3
42881,90,12713,17977;18199,31025,0,0,2,0,2
42882,90,12714,18274,31025,0,0,1,0,1
42883,90,12715,17899;18016,31025,0,0,2,0,2
42884,90,12716,17978;18022,31025,0,0,2,0,2
42885,90,12717,17869;18032,31025,0,0,2,0,2
42886,90,12718,18050;18281,31025,0,0,2,0,2
42887,90,12719,18053;18138,31025,0,0,2,0,2
42888,90,12720,18075;18258;20534;20801,31025,2,0,2,0,4
42889,90,12721,18089;18163,31025,0,0,2,0,2
42890,90,12722,18368,31025,0,0,1,0,1
42891,90,12723,18107;18279;20924,31025,1,0,2,0,3
42892,90,12724,18115;18225,31025,0,0,2,0,2
42893,90,12725,17935;18134;20670;20874,31025,2,0,2,0,4
42894,90,12726,18147,31025,0,0,1,0,1
42895,90,12727,12560,31390,0,0,0,1,1
42896,90,12729,13238,31390,0,0,1,0,1
42897,90,12730,13190,31390,0,0,1,0,1
42898,90,12731,12971,31390,0,0,1,0,1
42899,90,12732,13269,31390,0,0,1,0,1
42900,90,12733,13667;13863,31390,0,0,2,0,2
42901,90,12734,13749,31390,0,0,1,0,1
42902,90,12737,13248,31390,0,0,1,0,1
42903,90,12740,14058,31390,0,0,1,0,1
42904,90,12741,14144,31390,0,0,1,0,1
42905,90,12742,14270,31390,0,0,1,0,1
42906,90,12744,13910,31390,0,0,1,0,1
42907,90,12746,14423,31390,0,0,1,0,1
42908,90,12747,14543,31390,0,0,1,0,1
42909,90,12748,14741;14882,31390,0,0,2,0,2
42910,90,12749,14716,31390,0,0,1,0,1
42911,90,12752,14558,31390,0,0,1,0,1
42912,90,12754,15245;16017,31390,0,0,2,0,2
42913,90,12758,15434,31390,0,0,1,0,1
42914,90,12759,15596,31390,0,0,1,0,1
42915,90,12760,15668,31390,0,0,1,0,1
42916,90,12761,15701,31390,0,0,1,0,1
42917,90,12762,15306,31390,0,0,1,0,1
42918,90,12763,15850,31390,0,0,1,0,1
42919,90,12764,15856,31390,0,0,1,0,1
42920,90,12766,16141,31390,0,0,1,0,1
42921,90,12767,16061;16463,31390,0,0,2,0,2
42922,90,12772,16146,31390,0,0,1,0,1
42923,90,12773,15549,31390,0,0,1,0,1
42924,90,12774,16205;16944;20954,31390,1,0,2,0,3
42925,90,12776,15713,31390,0,0,1,0,1
42926,90,12777,16388;16727,31390,0,0,2,0,2
42927,90,12778,16161,31390,0,0,1,0,1
42928,90,12780,16653,31390,0,0,1,0,1
42929,90,12781,16721;17345,31390,0,0,2,0,2
42930,90,12782,16735,31390,0,0,1,0,1
42931,90,12783,16793,31390,0,0,1,0,1
42932,90,12784,16705;16864,31390,0,0,2,0,2
42933,90,12785,16868;17080;20829,31390,1,0,2,0,3
42934,90,12786,16888;17013,31390,0,0,2,0,2
42935,90,12787,17217;17255,31390,0,0,2,0,2
42936,90,12788,17081;17183;20740,31390,1,0,2,0,3
42937,90,12790,17113;17158;20710;20813,31390,2,0,2,0,4
42938,90,12791,16938;17115;20950,31390,1,0,2,0,3
42939,90,12792,17214,31390,0,0,1,0,1
42940,90,12793,17118,31390,0,0,1,0,1
42941,90,12795,17173;17570;20749,31390,1,0,2,0,3
42942,90,12796,17127;17434;20571;20932,31390,2,0,2,0,4
42943,90,12797,17171,31390,0,0,1,0,1
42944,90,12798,17210;17729,31390,0,0,2,0,2
42945,90,12799,16615;17238;20805;20867,31390,2,0,2,0,4
42946,90,12800,17263;17648;20795,31390,1,0,2,0,3
42947,90,12801,16952;17313,31390,0,0,2,0,2
42948,90,12802,17319;17772;20625,31390,1,0,2,0,3
42949,90,12803,17334,31390,0,0,1,0,1
42950,90,12804,17309;17351;20557,31390,1,0,2,0,3
42951,90,12805,17353,31390,0,0,1,0,1
42952,90,12806,17560;20910,31390,1,0,1,0,2
42953,90,12807,17373;17535,31390,0,0,2,0,2
42954,90,12808,17443;17865;20919,31390,1,0,2,0,3
42955,90,12809,17172;20646,31390,1,0,1,0,2
42956,90,12810,17194;17528,31390,0,0,2,0,2
42957,90,12811,17569;17615;20838,31390,1,0,2,0,3
42958,90,12812,17624;18277;20705;20909,31390,2,0,2,0,4
42959,90,12813,17664;18427;20592,31390,1,0,2,0,3
42960,90,12814,17486;17680,31390,0,0,2,0,2
42961,90,12815,17699;17714,31390,0,0,2,0,2
42962,90,12816,17715;17917,31390,0,0,2,0,2
42963,90,12817,17764;18114,31390,0,0,2,0,2
42964,90,12818,18259,31390,0,0,1,0,1
42965,90,12819,17513;17874,31390,0,0,2,0,2
42966,90,12820,18481;20718;20863,31390,2,0,1,0,3
42967,90,12821,17679;17854,31390,0,0,2,0,2
42968,90,12822,18405,31390,0,0,1,0,1
42969,90,12823,17628;17920,31390,0,0,2,0,2
42970,90,12824,17721;17937,31390,0,0,2,0,2
42971,90,12825,17871;17985,31390,0,0,2,0,2
42972,90,12826,17992;18233,31390,0,0,2,0,2
42973,90,12827,17618,31390,0,0,1,0,1
42974,90,12828,18017;18483,31390,0,0,2,0,2
42975,90,12829,18004;18066;20634;20677,31390,2,0,2,0,4
42976,90,12830,18081,31390,0,0,1,0,1
42977,90,12831,17794;18083,31390,0,0,2,0,2
42978,90,12832,18087;18179,31390,0,0,2,0,2
42979,90,12833,18090;18178,31390,0,0,2,0,2
42980,90,12834,18111;18401,31390,0,0,2,0,2
42981,90,12835,18162;18622,31390,0,0,2,0,2
42982,90,12836,18189;18925,31390,0,0,2,0,2
42983,90,12837,18725,31390,0,0,1,0,1
42984,90,12838,18219;18558;20589;20947,31390,2,0,2,0,4
42985,90,12839,17984;18238,31390,0,0,2,0,2
42986,90,12840,18177;18240,31390,0,0,2,0,2
42987,90,12841,12995,31755,0,0,1,0,1
42988,90,12842,13136,31755,0,0,1,0,1
42989,90,12844,13197;13326,31755,0,0,2,0,2
42990,90,12845,13083,31755,0,0,1,0,1
42991,90,12847,13831,31755,0,0,1,0,1
42992,90,12848,13950,31755,0,0,1,0,1
42993,90,12849,13966,31755,0,0,1,0,1
42994,90,12850,13978,31755,0,0,1,0,1
42995,90,12853,14310,31755,0,0,1,0,1
42996,90,12854,14366;14685,31755,0,0,2,0,2
42997,90,12856,14597,31755,0,0,1,0,1
42998,90,12857,14621,31755,0,0,1,0,1
42999,90,12858,14268,31755,0,0,1,0,1
43000,90,12859,14694,31755,0,0,1,0,1
43001,90,12860,14695,31755,0,0,1,0,1
43002,90,12862,14522,31755,0,0,1,0,1
43003,90,12863,15089;15813,31755,0,0,2,0,2
43004,90,12864,15213,31755,0,0,1,0,1
43005,90,12865,15179;15536,31755,0,0,2,0,2
43006,90,12867,15783,31755,0,0,1,0,1
43007,90,12869,15543,31755,0,0,1,0,1
43008,90,12870,15906,31755,0,0,1,0,1
43009,90,12871,15959,31755,0,0,1,0,1
43010,90,12873,16392,31755,0,0,1,0,1
43011,90,12874,16390,31755,0,0,1,0,1
43012,90,12875,16836,31755,0,0,1,0,1
43013,90,12876,16986,31755,0,0,1,0,1
43014,90,12877,16844;17160;20761,31755,1,0,2,0,3
43015,90,12878,16948,31755,0,0,1,0,1
43016,90,12879,17071;17419;20968,31755,1,0,2,0,3
43017,90,12880,16419;16595,31755,0,0,2,0,2
43018,90,12881,17021;17076,31755,0,0,2,0,2
43019,90,12882,17029;17149,31755,0,0,2,0,2
43020,90,12883,16614;16723,31755,0,0,2,0,2
43021,90,12884,17252,31755,0,0,1,0,1
43022,90,12885,16807,31755,0,0,1,0,1
43023,90,12886,17260;17779,31755,0,0,2,0,2
43024,90,12887,17264;17465;20883,31755,1,0,2,0,3
43025,90,12888,17250,31755,0,0,1,0,1
43026,90,12889,17354;17573;20750,31755,1,0,2,0,3
43027,90,12890,17365,31755,0,0,1,0,1
43028,90,12891,17379;20858,31755,1,0,1,0,2
43029,90,12892,17391;17468;20671,31755,1,0,2,0,3
43030,90,12893,17466;17654,31755,0,0,2,0,2
43031,90,12894,17472;18328;20770,31755,1,0,2,0,3
43032,90,12895,17273;17607;20881,31755,1,0,2,0,3
43033,90,12896,17350;17611,31755,0,0,2,0,2
43034,90,12897,17620;18166,31755,0,0,2,0,2
43035,90,12898,17641;20827,31755,1,0,1,0,2
43036,90,12899,17517;17694,31755,0,0,2,0,2
43037,90,12900,17695;18336;20730;20948,31755,2,0,2,0,4
43038,90,12901,17652;17778;20930,31755,1,0,2,0,3
43039,90,12902,17597;17780,31755,0,0,2,0,2
43040,90,12903,17790;17821;20920,31755,1,0,2,0,3
43041,90,12904,17798;17825;20876,31755,1,0,2,0,3
43042,90,12905,17855;18091,31755,0,0,2,0,2
43043,90,12906,17362;17892,31755,0,0,2,0,2
43044,90,12907,17893;18214;20810,31755,1,0,2,0,3
43045,90,12908,17939;18161,31755,0,0,2,0,2
43046,90,12909,17952;18158;20675;20943,31755,2,0,2,0,4
43047,90,12910,17968;18690;20803,31755,1,0,2,0,3
43048,90,12911,17986;18626,31755,0,0,2,0,2
43049,90,12912,17804;17995,31755,0,0,2,0,2
43050,90,12913,17579;18001,31755,0,0,2,0,2
43051,90,12914,18014;18241,31755,0,0,2,0,2
43052,90,12915,18044;18187;20969,31755,1,0,2,0,3
43053,90,12916,18052;18507;20891,31755,1,0,2,0,3
43054,90,12917,18171,31755,0,0,1,0,1
43055,90,12918,18085;18377,31755,0,0,2,0,2
43056,90,12919,18092;18911;20960,31755,1,0,2,0,3
43057,90,12920,18094;18289,31755,0,0,2,0,2
43058,90,12921,18099;18389;20800,31755,1,0,2,0,3
43059,90,12922,18113;18639;20706,31755,1,0,2,0,3
43060,90,12923,17643,31755,0,0,1,0,1
43061,90,12924,18129;18609;20842,31755,1,0,2,0,3
43062,90,12925,18130;18495;20660;20823,31755,2,0,2,0,4
43063,90,12926,17891,31755,0,0,1,0,1
43064,90,12927,18151;18457;20860,31755,1,0,2,0,3
43065,90,12928,17868;18154;20735,31755,1,0,2,0,3
43066,90,12929,17636;18157,31755,0,0,2,0,2
43067,90,12930,18311;20700;20793,31755,2,0,1,0,3
43068,90,12931,18213;18247,31755,0,0,2,0,2
43069,90,12932,18253;18343;20698,31755,1,0,2,0,3
43070,90,12933,17996;18041,31755,0,0,2,0,2
43071,90,12934,18298;18770,31755,0,0,2,0,2
43072,90,12935,18307;18784,31755,0,0,2,0,2
43073,90,12936,18198;18320,31755,0,0,2,0,2
43074,90,12937,18108;18346,31755,0,0,2,0,2
43075,90,12938,18347;18381,31755,0,0,2,0,2
43076,90,12939,18124;18385,31755,0,0,2,0,2
43077,90,12940,18306;18394,31755,0,0,2,0,2
43078,90,12941,13007;13523,32120,0,0,2,0,2
43079,90,12942,13370,32120,0,0,1,0,1
43080,90,12943,13486,32120,0,0,1,0,1
43081,90,12944,13271,32120,0,0,1,0,1
43082,90,12945,13628,32120,0,0,1,0,1
43083,90,12947,13757,32120,0,0,1,0,1
43084,90,12948,13985,32120,0,0,1,0,1
43085,90,12949,13891,32120,0,0,1,0,1
43086,90,12950,14284,32120,0,0,1,0,1
43087,90,12952,13973,32120,0,0,1,0,1
43088,90,12954,14859,32120,0,0,1,0,1
43089,90,12955,14240,32120,0,0,1,0,1
43090,90,12957,14140,32120,0,0,1,0,1
43091,90,12958,14612,32120,0,0,1,0,1
43092,90,12959,14672,32120,0,0,1,0,1
43093,90,12960,14755,32120,0,0,1,0,1
43094,90,12961,14790;14915,32120,0,0,2,0,2
43095,90,12962,14246,32120,0,0,1,0,1
43096,90,12963,14834,32120,0,0,1,0,1
43097,90,12964,14865,32120,0,0,1,0,1
43098,90,12966,14782,32120,0,0,1,0,1
43099,90,12967,15119,32120,0,0,1,0,1
43100,90,12970,14792,32120,0,0,1,0,1
43101,90,12972,15379,32120,0,0,1,0,1
43102,90,12973,15186,32120,0,0,1,0,1
43103,90,12974,15325,32120,0,0,1,0,1
43104,90,12976,15585,32120,0,0,1,0,1
43105,90,12978,15679,32120,0,0,1,0,1
43106,90,12979,15404,32120,0,0,1,0,1
43107,90,12980,15755,32120,0,0,1,0,1
43108,90,12981,16230;16473,32120,0,0,2,0,2
43109,90,12982,16289;16530,32120,0,0,2,0,2
43110,90,12983,16302,32120,0,0,1,0,1
43111,90,12985,16156,32120,0,0,1,0,1
43112,90,12986,16516,32120,0,0,1,0,1
43113,90,12987,16625;16842,32120,0,0,2,0,2
43114,90,12988,16900,32120,0,0,1,0,1
43115,90,12989,16887;17458,32120,0,0,2,0,2
43116,90,12990,16903;17388;20814,32120,1,0,2,0,3
43117,90,12991,16982,32120,0,0,1,0,1
43118,90,12992,16936,32120,0,0,1,0,1
43119,90,12993,16960;17339,32120,0,0,2,0,2
43120,90,12994,17287;17518,32120,0,0,2,0,2
43121,90,12995,17355,32120,0,0,1,0,1
43122,90,12997,17401,32120,0,0,1,0,1
43123,90,12998,17436;17689;20871,32120,1,0,2,0,3
43124,90,12999,17454;17678;20753,32120,1,0,2,0,3
43125,90,13000,17415,32120,0,0,1,0,1
43126,90,13001,17532;17539;20789,32120,1,0,2,0,3
43127,90,13002,17581;17967;20850,32120,1,0,2,0,3
43128,90,13003,17749,32120,0,0,1,0,1
43129,90,13004,17709;17758,32120,0,0,2,0,2
43130,90,13005,17797;18063,32120,0,0,2,0,2
43131,90,13006,17773,32120,0,0,1,0,1
43132,90,13007,18288,32120,0,0,1,0,1
43133,90,13008,17836,32120,0,0,1,0,1
43134,90,13009,17919;18146,32120,0,0,2,0,2
43135,90,13010,17930,32120,0,0,1,0,1
43136,90,13011,17956;18397,32120,0,0,2,0,2
43137,90,13012,17965;18486,32120,0,0,2,0,2
43138,90,13013,17686;17983,32120,0,0,2,0,2
43139,90,13014,17631;18070,32120,0,0,2,0,2
43140,90,13015,18104;18561;20765,32120,1,0,2,0,3
43141,90,13016,18110;18142,32120,0,0,2,0,2
43142,90,13017,18118;18248,32120,0,0,2,0,2
43143,90,13018,18137;18670,32120,0,0,2,0,2
43144,90,13019,18168,32120,0,0,1,0,1
43145,90,13020,17843;18174,32120,0,0,2,0,2
43146,90,13021,18204;18604,32120,0,0,2,0,2
43147,90,13022,18212;18499,32120,0,0,2,0,2
43148,90,13023,18223;18735,32120,0,0,2,0,2
43149,90,13024,18224;18587;20817;20890,32120,2,0,2,0,4
43150,90,13025,18282;18444;20916,32120,1,0,2,0,3
43151,90,13026,18286;18321,32120,0,0,2,0,2
43152,90,13027,18348,32120,0,0,1,0,1
43153,90,13028,18086;18378,32120,0,0,2,0,2
43154,90,13029,18205;18408,32120,0,0,2,0,2
43155,90,13030,18419;18729,32120,0,0,2,0,2
43156,90,13031,18434;18613,32120,0,0,2,0,2
43157,90,13032,18435,32120,0,0,1,0,1
43158,90,13033,18452;18615,32120,0,0,2,0,2
43159,90,13034,18453;18494,32120,0,0,2,0,2
43160,90,13035,18461;18824,32120,0,0,2,0,2
43161,90,13036,18342;18462,32120,0,0,2,0,2
43162,90,13037,18472;18555;20952,32120,1,0,2,0,3
43163,90,13038,18475;18530,32120,0,0,2,0,2
43164,90,13039,17823;17852,32120,0,0,2,0,2
43165,90,13040,18237;18505,32120,0,0,2,0,2
43166,90,13041,18246;18515,32120,0,0,2,0,2
43167,90,13042,18517;18663,32120,0,0,2,0,2
43168,90,13043,13002,32485,0,0,1,0,1
43169,90,13045,13584,32485,0,0,1,0,1
43170,90,13046,13347,32485,0,0,1,0,1
43171,90,13047,13309;13646,32485,0,0,2,0,2
43172,90,13048,13668,32485,0,0,1,0,1
43173,90,13050,14073,32485,0,0,1,0,1
43174,90,13051,14143,32485,0,0,1,0,1
43175,90,13052,14098,32485,0,0,1,0,1
43176,90,13053,14356,32485,0,0,1,0,1
43177,90,13054,14145,32485,0,0,1,0,1
43178,90,13056,14224,32485,0,0,1,0,1
43179,90,13057,14666,32485,0,0,1,0,1
43180,90,13059,14817,32485,0,0,1,0,1
43181,90,13060,14976;15333,32485,0,0,2,0,2
43182,90,13061,15057,32485,0,0,1,0,1
43183,90,13062,15060,32485,0,0,1,0,1
43184,90,13063,15076,32485,0,0,1,0,1
43185,90,13064,15082,32485,0,0,1,0,1
43186,90,13066,15274,32485,0,0,1,0,1
43187,90,13067,15316,32485,0,0,1,0,1
43188,90,13068,15431,32485,0,0,1,0,1
43189,90,13070,15214;15528,32485,0,0,2,0,2
43190,90,13071,15385,32485,0,0,1,0,1
43191,90,13072,15577,32485,0,0,1,0,1
43192,90,13073,16053,32485,0,0,1,0,1
43193,90,13074,16172,32485,0,0,1,0,1
43194,90,13075,16248,32485,0,0,1,0,1
43195,90,13076,16371,32485,0,0,1,0,1
43196,90,13077,16171,32485,0,0,1,0,1
43197,90,13078,16849,32485,0,0,1,0,1
43198,90,13079,16227,32485,0,0,1,0,1
43199,90,13080,15870,32485,0,0,1,0,1
43200,90,13081,16663,32485,0,0,1,0,1
43201,90,13082,16319,32485,0,0,1,0,1
43202,90,13083,16776,32485,0,0,1,0,1
43203,90,13084,16946,32485,0,0,1,0,1
43204,90,13085,16988;16992;20893,32485,1,0,2,0,3
43205,90,13086,17022;17501,32485,0,0,2,0,2
43206,90,13087,16882,32485,0,0,1,0,1
43207,90,13088,17111;17425;20887,32485,1,0,2,0,3
43208,90,13089,16762,32485,0,0,1,0,1
43209,90,13090,17275;17657,32485,0,0,2,0,2
43210,90,13091,17276;17681,32485,0,0,2,0,2
43211,90,13092,17421,32485,0,0,1,0,1
43212,90,13093,17416;17471,32485,0,0,2,0,2
43213,90,13094,17481;18149,32485,0,0,2,0,2
43214,90,13096,17553;17809,32485,0,0,2,0,2
43215,90,13097,17358,32485,0,0,1,0,1
43216,90,13098,17437;17613,32485,0,0,2,0,2
43217,90,13099,17265;17614,32485,0,0,2,0,2
43218,90,13100,17639;17934,32485,0,0,2,0,2
43219,90,13101,17651;18506,32485,0,0,2,0,2
43220,90,13102,17682;18254,32485,0,0,2,0,2
43221,90,13103,17718,32485,0,0,1,0,1
43222,90,13104,17751;18060,32485,0,0,2,0,2
43223,90,13105,17805,32485,0,0,1,0,1
43224,90,13106,17752;17839,32485,0,0,2,0,2
43225,90,13107,17946,32485,0,0,1,0,1
43226,90,13108,17938;18209,32485,0,0,2,0,2
43227,90,13109,17958;18025,32485,0,0,2,0,2
43228,90,13110,17816;18019,32485,0,0,2,0,2
43229,90,13111,17792;18023,32485,0,0,2,0,2
43230,90,13112,18028;18431,32485,0,0,2,0,2
43231,90,13113,18033,32485,0,0,1,0,1
43232,90,13114,18049;18677,32485,0,0,2,0,2
43233,90,13115,18054,32485,0,0,1,0,1
43234,90,13116,18078;18155;20885,32485,1,0,2,0,3
43235,90,13117,18153;18651,32485,0,0,2,0,2
43236,90,13118,18156;18196,32485,0,0,2,0,2
43237,90,13119,18180,32485,0,0,1,0,1
43238,90,13120,18208,32485,0,0,1,0,1
43239,90,13121,18222;18236,32485,0,0,2,0,2
43240,90,13122,18251;18375,32485,0,0,2,0,2
43241,90,13123,18290;18749;20944,32485,1,0,2,0,3
43242,90,13124,18300;18731,32485,0,0,2,0,2
43243,90,13125,18309;18637,32485,0,0,2,0,2
43244,90,13126,18207,32485,0,0,1,0,1
43245,90,13127,18319,32485,0,0,1,0,1
43246,90,13128,18331;18548,32485,0,0,2,0,2
43247,90,13129,17877,32485,0,0,1,0,1
43248,90,13130,18006;18426,32485,0,0,2,0,2
43249,90,13131,18330;18429,32485,0,0,2,0,2
43250,90,13132,18455;19016,32485,0,0,2,0,2
43251,90,13133,17950;18479,32485,0,0,2,0,2
43252,90,13134,18374;18496,32485,0,0,2,0,2
43253,90,13135,18502,32485,0,0,1,0,1
43254,90,13136,18283;18514,32485,0,0,2,0,2
43255,90,13137,18516,32485,0,0,1,0,1
43256,90,13138,18532;18852,32485,0,0,2,0,2
43257,90,13139,18543,32485,0,0,1,0,1
43258,90,13140,18048;18575,32485,0,0,2,0,2
43259,90,13141,18783;20913,32485,1,0,1,0,2
43260,90,13142,18598,32485,0,0,1,0,1
43261,90,13143,18612;18698,32485,0,0,2,0,2
43262,90,13144,18623;18867;20956,32485,1,0,2,0,3
43263,90,13145,13513,32850,0,0,1,0,1
43264,90,13146,13349,32850,0,0,1,0,1
43265,90,13147,13610,32850,0,0,1,0,1
43266,90,13148,13850,32850,0,0,1,0,1
43267,90,13149,13867,32850,0,0,1,0,1
43268,90,13150,14332,32850,0,0,1,0,1
43269,90,13151,13690,32850,0,0,1,0,1
43270,90,13152,13905,32850,0,0,1,0,1
43271,90,13153,13741,32850,0,0,1,0,1
43272,90,13154,13387,32850,0,0,1,0,1
43273,90,13155,14133,32850,0,0,1,0,1
43274,90,13156,14134,32850,0,0,1,0,1
43275,90,13157,13618,32850,0,0,1,0,1
43276,90,13158,14071,32850,0,0,1,0,1
43277,90,13159,13953,32850,0,0,1,0,1
43278,90,13160,14554,32850,0,0,1,0,1
43279,90,13161,14216,32850,0,0,1,0,1
43280,90,13162,14049,32850,0,0,1,0,1
43281,90,13163,14360,32850,0,0,1,0,1
43282,90,13164,14643,32850,0,0,1,0,1
43283,90,13165,14702,32850,0,0,1,0,1
43284,90,13166,14656;15117,32850,0,0,2,0,2
43285,90,13168,15129,32850,0,0,1,0,1
43286,90,13169,14481,32850,0,0,1,0,1
43287,90,13170,15088,32850,0,0,1,0,1
43288,90,13171,15106,32850,0,0,1,0,1
43289,90,13172,14775,32850,0,0,1,0,1
43290,90,13173,15145,32850,0,0,1,0,1
43291,90,13174,15155,32850,0,0,1,0,1
43292,90,13175,15387,32850,0,0,1,0,1
43293,90,13176,15405,32850,0,0,1,0,1
43294,90,13177,14799,32850,0,0,1,0,1
43295,90,13179,15800,32850,0,0,1,0,1
43296,90,13180,15738,32850,0,0,1,0,1
43297,90,13181,15510,32850,0,0,1,0,1
43298,90,13182,16127,32850,0,0,1,0,1
43299,90,13183,16317,32850,0,0,1,0,1
43300,90,13184,16328,32850,0,0,1,0,1
43301,90,13185,16369,32850,0,0,1,0,1
43302,90,13186,16503,32850,0,0,1,0,1
43303,90,13187,16266,32850,0,0,1,0,1
43304,90,13188,16148,32850,0,0,1,0,1
43305,90,13189,16247,32850,0,0,1,0,1
43306,90,13190,16943,32850,0,0,1,0,1
43307,90,13191,16487,32850,0,0,1,0,1
43308,90,13192,16467,32850,0,0,1,0,1
43309,90,13194,16974,32850,0,0,1,0,1
43310,90,13195,17235;17407,32850,0,0,2,0,2
43311,90,13196,17297,32850,0,0,1,0,1
43312,90,13197,17390;17525,32850,0,0,2,0,2
43313,90,13198,17422,32850,0,0,1,0,1
43314,90,13199,17484,32850,0,0,1,0,1
43315,90,13200,17497;17659,32850,0,0,2,0,2
43316,90,13201,17545,32850,0,0,1,0,1
43317,90,13202,17561;17755,32850,0,0,2,0,2
43318,90,13203,17629,32850,0,0,1,0,1
43319,90,13204,17696;17925,32850,0,0,2,0,2
43320,90,13205,17730;17802,32850,0,0,2,0,2
43321,90,13206,17565,32850,0,0,1,0,1
43322,90,13207,17810,32850,0,0,1,0,1
43323,90,13208,17812,32850,0,0,1,0,1
43324,90,13209,17667,32850,0,0,1,0,1
43325,90,13210,17886;18562,32850,0,0,2,0,2
43326,90,13211,17587,32850,0,0,1,0,1
43327,90,13212,17909;18565,32850,0,0,2,0,2
43328,90,13213,17753;17927,32850,0,0,2,0,2
43329,90,13214,17929,32850,0,0,1,0,1
43330,90,13215,17757,32850,0,0,1,0,1
43331,90,13216,18095;18820,32850,0,0,2,0,2
43332,90,13217,18102,32850,0,0,1,0,1
43333,90,13218,18106;18655,32850,0,0,2,0,2
43334,90,13219,17762;18116,32850,0,0,2,0,2
43335,90,13220,18123;18620,32850,0,0,2,0,2
43336,90,13221,18167;18244,32850,0,0,2,0,2
43337,90,13222,18186;18323,32850,0,0,2,0,2
43338,90,13223,17708;18206,32850,0,0,2,0,2
43339,90,13224,18265;18420,32850,0,0,2,0,2
43340,90,13225,18077;18278,32850,0,0,2,0,2
43341,90,13226,18293;18402,32850,0,0,2,0,2
43342,90,13227,18317;18883,32850,0,0,2,0,2
43343,90,13228,18334;18642,32850,0,0,2,0,2
43344,90,13229,18012;18357,32850,0,0,2,0,2
43345,90,13230,18367,32850,0,0,1,0,1
43346,90,13231,18396;18627,32850,0,0,2,0,2
43347,90,13232,18031;18417,32850,0,0,2,0,2
43348,90,13233,18447;18694,32850,0,0,2,0,2
43349,90,13234,17940;18450,32850,0,0,2,0,2
43350,90,13235,17890;18454,32850,0,0,2,0,2
43351,90,13236,18469;18864,32850,0,0,2,0,2
43352,90,13237,18474;18866,32850,0,0,2,0,2
43353,90,13238,18449;18569,32850,0,0,2,0,2
43354,90,13239,18576;18958,32850,0,0,2,0,2
43355,90,13240,18579,32850,0,0,1,0,1
43356,90,13241,18618;18786,32850,0,0,2,0,2
43357,90,13242,18628;18915,32850,0,0,2,0,2
43358,90,13243,18664;18778,32850,0,0,2,0,2
43359,90,13244,18666;19065,32850,0,1,1,0,2
43360,90,13245,18667;18971,32850,0,0,2,0,2
43361,90,13246,18761,32850,0,0,1,0,1
43362,90,13247,18687;19091,32850,0,1,1,0,2
43363,90,13248,18714;19158,32850,0,1,1,0,2
43364,90,13249,18716;18861,32850,0,0,2,0,2
43365,90,13250,18545;18722,32850,0,0,2,0,2
43366,90,13251,18734;19033,32850,0,0,2,0,2
43367,90,13252,18743;19059,32850,0,1,1,0,2
43368,90,13253,18674,32850,0,0,1,0,1
43369,90,13254,18465;18763,32850,0,0,2,0,2
43370,90,13255,18490;18765,32850,0,0,2,0,2
43371,100,797,10331,0,0,0,0,1,1
43372,100,4289,11984;12134,1095,0,0,0,2,2
43373,100,4536,11715;12177,1825,0,0,0,2,2
43374,100,4793,12083,2920,0,0,0,1,1
43375,100,4817,12168;12456;13314;14003,2920,0,0,0,4,4
43376,100,5118,12335,3650,0,0,0,1,1
43377,100,5177,12810,4015,0,0,0,1,1
43378,100,5584,12409,5475,0,0,0,1,1
43379,100,5639,12557,5475,0,0,0,1,1
43380,100,5663,13760;13895,5840,0,0,0,2,2
43381,100,5867,10246,6570,0,0,0,1,1
43382,100,6056,10308,6935,0,0,0,1,1
43383,100,6107,10480,7300,0,0,0,1,1
43384,100,6172,10400,7300,0,0,0,1,1
43385,100,6213,13700;14272,7665,0,0,1,1,2
43386,100,6260,10565,7665,0,0,0,1,1
43387,100,6327,10861,8030,0,0,0,1,1
43388,100,6336,10463,8030,0,0,0,1,1
43389,100,6384,10241,8395,0,0,0,1,1
43390,100,6418,13803,8395,0,0,0,1,1
43391,100,6431,10380,8395,0,0,0,1,1
43392,100,6436,12072;12660,8395,0,0,0,2,2
43393,100,6438,10578,8395,0,0,0,1,1
43394,100,6523,10850,8760,0,0,0,1,1
43395,100,6528,10547,8760,0,0,0,1,1
43396,100,6571,10177,9125,0,0,0,1,1
43397,100,6604,10540,9125,0,0,0,1,1
43398,100,6608,10739,9125,0,0,0,1,1
43399,100,6611,11009,9125,0,0,0,1,1
43400,100,6612,10627,9125,0,0,0,1,1
43401,100,6620,14556,9125,0,0,1,0,1
43402,100,6622,10677,9125,0,0,0,1,1
43403,100,6624,10873,9125,0,0,0,1,1
43404,100,6684,10457,9490,0,0,0,1,1
43405,100,6703,10546,9490,0,0,0,1,1
43406,100,6706,10799,9490,0,0,0,1,1
43407,100,6708,10585,9490,0,0,0,1,1
43408,100,6710,10604,9490,0,0,0,1,1
43409,100,6713,10616,9490,0,0,0,1,1
43410,100,6714,10687,9490,0,0,0,1,1
43411,100,6717,10670,9490,0,0,0,1,1
43412,100,6722,11053,9490,0,0,0,1,1
43413,100,6757,14681;15177,9855,0,0,2,0,2
43414,100,6774,10430,9855,0,0,0,1,1
43415,100,6778,10294,9855,0,0,0,1,1
43416,100,6780,10532,9855,0,0,0,1,1
43417,100,6782,10365,9855,0,0,0,1,1
43418,100,6786,10464,9855,0,0,0,1,1
43419,100,6787,10506,9855,0,0,0,1,1
43420,100,6789,10853,9855,0,0,0,1,1
43421,100,6791,10545,9855,0,0,0,1,1
43422,100,6797,10701,9855,0,0,0,1,1
43423,100,6800,10758,9855,0,0,0,1,1
43424,100,6801,10669,9855,0,0,0,1,1
43425,100,6802,10703,9855,0,0,0,1,1
43426,100,6803,10705,9855,0,0,0,1,1
43427,100,6805,11052,9855,0,0,0,1,1
43428,100,6806,14284;14404;18843,9855,0,0,3,0,3
43429,100,6811,11025,9855,0,0,0,1,1
43430,100,6813,10889,9855,0,0,0,1,1
43431,100,6815,10903,9855,0,0,0,1,1
43432,100,6860,10128,10220,0,0,0,1,1
43433,100,6874,10728,10220,0,0,0,1,1
43434,100,6880,10888,10220,0,0,0,1,1
43435,100,6883,10948,10220,0,0,0,1,1
43436,100,6885,11195,10220,0,0,0,1,1
43437,100,6927,10782,10585,0,0,0,1,1
43438,100,6931,10462,10585,0,0,0,1,1
43439,100,6937,10822,10585,0,0,0,1,1
43440,100,6940,10841,10585,0,0,0,1,1
43441,100,6947,11280,10585,0,0,0,1,1
43442,100,6949,10770,10585,0,0,0,1,1
43443,100,6951,10996,10585,0,0,0,1,1
43444,100,6952,10714;11045,10585,0,0,0,2,2
43445,100,6953,11274,10585,0,0,0,1,1
43446,100,6956,11080,10585,0,0,0,1,1
43447,100,6957,11343,10585,0,0,0,1,1
43448,100,6999,10231,10950,0,0,0,1,1
43449,100,7003,10378,10950,0,0,0,1,1
43450,100,7007,10420,10950,0,0,0,1,1
43451,100,7010,11194,10950,0,0,0,1,1
43452,100,7014,10793,10950,0,0,0,1,1
43453,100,7019,11168,10950,0,0,0,1,1
43454,100,7022,11296,10950,0,0,0,1,1
43455,100,7023,10912,10950,0,0,0,1,1
43456,100,7029,11005;11460,10950,0,0,0,2,2
43457,100,7030,11006,10950,0,0,0,1,1
43458,100,7032,11248,10950,0,0,0,1,1
43459,100,7033,11036,10950,0,0,0,1,1
43460,100,7035,11462,10950,0,0,0,1,1
43461,100,7036,11415,10950,0,0,0,1,1
43462,100,7037,11326,10950,0,0,0,1,1
43463,100,7039,11099,10950,0,0,0,1,1
43464,100,7040,11102,10950,0,0,0,1,1
43465,100,7041,11103,10950,0,0,0,1,1
43466,100,7043,11126,10950,0,0,0,1,1
43467,100,7045,11029,10950,0,0,0,1,1
43468,100,7048,11299,10950,0,0,0,1,1
43469,100,7049,11251,10950,0,0,0,1,1
43470,100,7051,11339,10950,0,0,0,1,1
43471,100,7052,14514,10950,0,0,1,0,1
43472,100,7095,10279,11315,0,0,0,1,1
43473,100,7100,10441,11315,0,0,0,1,1
43474,100,7104,10598,11315,0,0,0,1,1
43475,100,7105,11023,11315,0,0,0,1,1
43476,100,7107,10617,11315,0,0,0,1,1
43477,100,7110,10743,11315,0,0,0,1,1
43478,100,7111,10778,11315,0,0,0,1,1
43479,100,7115,11087,11315,0,0,0,1,1
43480,100,7117,10931,11315,0,0,0,1,1
43481,100,7118,10936,11315,0,0,0,1,1
43482,100,7120,10974,11315,0,0,0,1,1
43483,100,7121,10976,11315,0,0,0,1,1
43484,100,7123,10990,11315,0,0,0,1,1
43485,100,7125,11244,11315,0,0,0,1,1
43486,100,7128,11105,11315,0,0,0,1,1
43487,100,7130,10969,11315,0,0,0,1,1
43488,100,7133,11186;11189,11315,0,0,0,2,2
43489,100,7135,10949;11249,11315,0,0,0,2,2
43490,100,7137,11278,11315,0,0,0,1,1
43491,100,7178,10973,11680,0,0,0,1,1
43492,100,7181,11015,11680,0,0,0,1,1
43493,100,7186,10659,11680,0,0,0,1,1
43494,100,7188,11063,11680,0,0,0,1,1
43495,100,7189,10938,11680,0,0,0,1,1
43496,100,7192,10994;11149,11680,0,0,0,2,2
43497,100,7193,10982,11680,0,0,0,1,1
43498,100,7194,11694,11680,0,0,0,1,1
43499,100,7195,11496;12099,11680,0,0,0,2,2
43500,100,7199,11352,11680,0,0,0,1,1
43501,100,7201,11121,11680,0,0,0,1,1
43502,100,7203,11692,11680,0,0,0,1,1
43503,100,7206,11256;11562,11680,0,0,0,2,2
43504,100,7208,11550,11680,0,0,0,1,1
43505,100,7211,13670,11680,0,0,0,1,1
43506,100,7213,15004;20025,11680,0,0,2,0,2
43507,100,7214,11353;11630,11680,0,0,0,2,2
43508,100,7215,11366,11680,0,0,0,1,1
43509,100,7218,11387,11680,0,0,0,1,1
43510,100,7260,11002,12045,0,0,0,1,1
43511,100,7268,10622;10902,12045,0,0,0,2,2
43512,100,7279,10809,12045,0,0,0,1,1
43513,100,7280,11273,12045,0,0,0,1,1
43514,100,7286,11206;11308,12045,0,0,0,2,2
43515,100,7287,11135,12045,0,0,0,1,1
43516,100,7290,11292,12045,0,0,0,1,1
43517,100,7292,11442,12045,0,0,0,1,1
43518,100,7293,10658,12045,0,0,0,1,1
43519,100,7296,11556,12045,0,0,0,1,1
43520,100,7299,11597,12045,0,0,0,1,1
43521,100,7300,11090,12045,0,0,0,1,1
43522,100,7305,11294,12045,0,0,0,1,1
43523,100,7306,11495,12045,0,0,0,1,1
43524,100,7308,11720;11773,12045,0,0,0,2,2
43525,100,7311,11270;11379,12045,0,0,0,2,2
43526,100,7314,11405;11457,12045,0,0,0,2,2
43527,100,7316,11637;11681,12045,0,0,0,2,2
43528,100,7317,11469,12045,0,0,0,1,1
43529,100,7318,11447;11478,12045,0,0,0,2,2
43530,100,7319,11458,12045,0,0,0,1,1
43531,100,7321,11481,12045,0,0,0,1,1
43532,100,7322,11482,12045,0,0,0,1,1
43533,100,7367,11337,12410,0,0,0,1,1
43534,100,7376,11375,12410,0,0,0,1,1
43535,100,7379,11217,12410,0,0,0,1,1
43536,100,7380,11030,12410,0,0,0,1,1
43537,100,7382,10929,12410,0,0,0,1,1
43538,100,7383,11312,12410,0,0,0,1,1
43539,100,7385,11422,12410,0,0,0,1,1
43540,100,7387,11376,12410,0,0,0,1,1
43541,100,7388,11613,12410,0,0,0,1,1
43542,100,7389,11549,12410,0,0,0,1,1
43543,100,7391,11615,12410,0,0,0,1,1
43544,100,7393,11686;11825,12410,0,0,0,2,2
43545,100,7394,11313,12410,0,0,0,1,1
43546,100,7397,11438,12410,0,0,0,1,1
43547,100,7400,11452,12410,0,0,0,1,1
43548,100,7401,11382,12410,0,0,0,1,1
43549,100,7402,11497,12410,0,0,0,1,1
43550,100,7403,11503,12410,0,0,0,1,1
43551,100,7404,11611;11809,12410,0,0,0,2,2
43552,100,7408,11535,12410,0,0,0,1,1
43553,100,7409,11593,12410,0,0,0,1,1
43554,100,7452,11428;11570,12775,0,0,0,2,2
43555,100,7455,11283,12775,0,0,0,1,1
43556,100,7459,11138,12775,0,0,0,1,1
43557,100,7461,11902,12775,0,0,0,1,1
43558,100,7464,11272,12775,0,0,0,1,1
43559,100,7466,11461,12775,0,0,0,1,1
43560,100,7467,11901,12775,0,0,0,1,1
43561,100,7468,11345;11639,12775,0,0,0,2,2
43562,100,7470,11619,12775,0,0,0,1,1
43563,100,7471,11920,12775,0,0,0,1,1
43564,100,7472,11397,12775,0,0,0,1,1
43565,100,7473,11651,12775,0,0,0,1,1
43566,100,7475,11969,12775,0,0,0,1,1
43567,100,7477,11252;11431,12775,0,0,0,2,2
43568,100,7478,11928,12775,0,0,0,1,1
43569,100,7480,11488;11500,12775,0,0,0,2,2
43570,100,7482,11505,12775,0,0,0,1,1
43571,100,7484,11511;11707,12775,0,0,0,2,2
43572,100,7485,12025,12775,0,0,0,1,1
43573,100,7487,11724,12775,0,0,0,1,1
43574,100,7489,11360;11640,12775,0,0,0,2,2
43575,100,7491,11683,12775,0,0,0,1,1
43576,100,7519,11044,13140,0,0,0,1,1
43577,100,7522,11071,13140,0,0,0,1,1
43578,100,7523,11182,13140,0,0,0,1,1
43579,100,7525,10340,13140,0,0,0,1,1
43580,100,7527,10837,13140,0,0,0,1,1
43581,100,7530,11014;11190,13140,0,0,0,2,2
43582,100,7535,11425,13140,0,0,0,1,1
43583,100,7536,11167;11407,13140,0,0,0,2,2
43584,100,7537,11173;11684,13140,0,0,0,2,2
43585,100,7541,11752,13140,0,0,0,1,1
43586,100,7542,11237,13140,0,0,0,1,1
43587,100,7543,11498,13140,0,0,0,1,1
43588,100,7544,11311,13140,0,0,0,1,1
43589,100,7551,11480,13140,0,0,0,1,1
43590,100,7553,11504,13140,0,0,0,1,1
43591,100,7554,11507,13140,0,0,0,1,1
43592,100,7555,11512,13140,0,0,0,1,1
43593,100,7558,11559,13140,0,0,0,1,1
43594,100,7560,11414;11579,13140,0,0,0,2,2
43595,100,7562,11616,13140,0,0,0,1,1
43596,100,7563,12068,13140,0,0,0,1,1
43597,100,7564,11398,13140,0,0,0,1,1
43598,100,7565,11657,13140,0,0,0,1,1
43599,100,7567,11691;11700,13140,0,0,0,2,2
43600,100,7568,12086,13140,0,0,0,1,1
43601,100,7569,11712,13140,0,0,0,1,1
43602,100,7571,11763,13140,0,0,0,1,1
43603,100,7572,11325;11783,13140,0,0,0,2,2
43604,100,7573,11665,13140,0,0,0,1,1
43605,100,7619,11364,13505,0,0,0,1,1
43606,100,7625,11239,13505,0,0,0,1,1
43607,100,7626,11760,13505,0,0,0,1,1
43608,100,7628,11863,13505,0,0,0,1,1
43609,100,7629,11421,13505,0,0,0,1,1
43610,100,7630,11788,13505,0,0,0,1,1
43611,100,7633,11576;11666,13505,0,0,0,2,2
43612,100,7634,11848,13505,0,0,0,1,1
43613,100,7636,12053,13505,0,0,0,1,1
43614,100,7637,11474,13505,0,0,0,1,1
43615,100,7638,11638,13505,0,0,0,1,1
43616,100,7640,11523;11842,13505,0,0,0,2,2
43617,100,7641,11357,13505,0,0,0,1,1
43618,100,7643,11828;11876,13505,0,0,0,2,2
43619,100,7645,11817,13505,0,0,0,1,1
43620,100,7646,11489,13505,0,0,0,1,1
43621,100,7647,11774,13505,0,0,0,1,1
43622,100,7648,11698;12091,13505,0,0,0,2,2
43623,100,7649,12069,13505,0,0,0,1,1
43624,100,7650,12087,13505,0,0,0,1,1
43625,100,7652,11470;11734,13505,0,0,0,2,2
43626,100,7654,11762;11778,13505,0,0,0,2,2
43627,100,7655,11769,13505,0,0,0,1,1
43628,100,7656,11771,13505,0,0,0,1,1
43629,100,7657,12135,13505,0,0,0,1,1
43630,100,7659,11815,13505,0,0,0,1,1
43631,100,7660,11999,13505,0,0,0,1,1
43632,100,7661,11834,13505,0,0,0,1,1
43633,100,7665,12029,13505,0,0,0,1,1
43634,100,7666,11757;12067,13505,0,0,0,2,2
43635,100,7672,14838,13870,0,0,1,0,1
43636,100,7712,11101;11557,13870,0,0,0,2,2
43637,100,7717,11632,13870,0,0,0,1,1
43638,100,7719,11963,13870,0,0,0,1,1
43639,100,7721,11127;11245,13870,0,0,0,2,2
43640,100,7725,11618,13870,0,0,0,1,1
43641,100,7726,11314,13870,0,0,0,1,1
43642,100,7728,11385,13870,0,0,0,1,1
43643,100,7729,11609,13870,0,0,0,1,1
43644,100,7730,11729;11905,13870,0,0,0,2,2
43645,100,7732,11996,13870,0,0,0,1,1
43646,100,7733,11524,13870,0,0,0,1,1
43647,100,7736,11728,13870,0,0,0,1,1
43648,100,7737,16203;16239,13870,0,0,2,0,2
43649,100,7738,11641;11821,13870,0,0,0,2,2
43650,100,7739,11645;11731,13870,0,0,0,2,2
43651,100,7740,11232;11658,13870,0,0,0,2,2
43652,100,7742,11690,13870,0,0,0,1,1
43653,100,7744,11792,13870,0,0,0,1,1
43654,100,7745,11732,13870,0,0,0,1,1
43655,100,7749,12114,13870,0,0,0,1,1
43656,100,7750,11743,13870,0,0,0,1,1
43657,100,7752,12019,13870,0,0,0,1,1
43658,100,7753,11069,13870,0,0,0,1,1
43659,100,7754,11856;12204,13870,0,0,0,2,2
43660,100,7755,11709,13870,0,0,0,1,1
43661,100,7756,11881,13870,0,0,0,1,1
43662,100,7757,11406;11704,13870,0,0,0,2,2
43663,100,7758,11661,13870,0,0,0,1,1
43664,100,7759,11908;12203,13870,0,0,0,2,2
43665,100,7761,12043,13870,0,0,0,1,1
43666,100,7763,11922;11945,13870,0,0,0,2,2
43667,100,7764,12308,13870,0,0,0,1,1
43668,100,7765,11699,13870,0,0,0,1,1
43669,100,7766,12098,13870,0,0,0,1,1
43670,100,7809,10522,14235,0,0,0,1,1
43671,100,7813,10923,14235,0,0,0,1,1
43672,100,7814,10774,14235,0,0,0,1,1
43673,100,7817,11463;11577,14235,0,0,0,2,2
43674,100,7824,11591,14235,0,0,0,1,1
43675,100,7826,11371,14235,0,0,0,1,1
43676,100,7828,11565,14235,0,0,0,1,1
43677,100,7831,11711;11910,14235,0,0,0,2,2
43678,100,7832,12137,14235,0,0,0,1,1
43679,100,7835,11716,14235,0,0,0,1,1
43680,100,7836,11719,14235,0,0,0,1,1
43681,100,7838,12352,14235,0,0,0,1,1
43682,100,7839,11755;12144,14235,0,0,0,2,2
43683,100,7841,11900,14235,0,0,0,1,1
43684,100,7842,12008,14235,0,0,0,1,1
43685,100,7843,11799,14235,0,0,0,1,1
43686,100,7845,11836,14235,0,0,0,1,1
43687,100,7846,12357,14235,0,0,0,1,1
43688,100,7848,11971,14235,0,0,0,1,1
43689,100,7849,11894,14235,0,0,0,1,1
43690,100,7852,12223,14235,0,0,0,1,1
43691,100,7853,12272,14235,0,0,0,1,1
43692,100,7854,11853;12151,14235,0,0,0,2,2
43693,100,7855,12149,14235,0,0,0,1,1
43694,100,7857,12073;12305,14235,0,0,0,2,2
43695,100,7858,11673;12075,14235,0,0,0,2,2
43696,100,7859,12208;12249,14235,0,0,0,2,2
43697,100,7860,11560;12117,14235,0,0,0,2,2
43698,100,7895,10877,14600,0,0,0,1,1
43699,100,7901,11233,14600,0,0,0,1,1
43700,100,7904,11668,14600,0,0,0,1,1
43701,100,7905,11365,14600,0,0,0,1,1
43702,100,7909,11275,14600,0,0,0,1,1
43703,100,7910,11487,14600,0,0,0,1,1
43704,100,7912,11664,14600,0,0,0,1,1
43705,100,7914,11708,14600,0,0,0,1,1
43706,100,7915,11675,14600,0,0,0,1,1
43707,100,7919,11912,14600,0,0,0,1,1
43708,100,7920,12378,14600,0,0,0,1,1
43709,100,7922,11416;11849,14600,0,0,0,2,2
43710,100,7923,12022,14600,0,0,0,1,1
43711,100,7925,11992;12167,14600,0,0,0,2,2
43712,100,7926,12040,14600,0,0,0,1,1
43713,100,7928,11967;12314,14600,0,0,0,2,2
43714,100,7929,12406;12489,14600,0,0,0,2,2
43715,100,7930,11730;12001,14600,0,0,0,2,2
43716,100,7931,12161;12377,14600,0,0,0,2,2
43717,100,7933,12063;12202,14600,0,0,0,2,2
43718,100,7934,12089,14600,0,0,0,1,1
43719,100,7936,12092,14600,0,0,0,1,1
43720,100,7937,16429;16442;20635;20824;21033,14600,0,3,2,0,5
43721,100,7941,12128,14600,0,0,0,1,1
43722,100,7942,12140,14600,0,0,0,1,1
43723,100,7943,12183,14600,0,0,0,1,1
43724,100,7944,11933;12155,14600,0,0,0,2,2
43725,100,7945,12449,14600,0,0,0,1,1
43726,100,7946,11798;12141,14600,0,0,0,2,2
43727,100,7947,12230,14600,0,0,0,1,1
43728,100,7948,12233,14600,0,0,0,1,1
43729,100,7950,12554;12658,14600,0,0,0,2,2
43730,100,7986,10874,14965,0,0,0,1,1
43731,100,7990,11162,14965,0,0,0,1,1
43732,100,7992,11710;11796,14965,0,0,0,2,2
43733,100,7994,11604,14965,0,0,0,1,1
43734,100,7995,10911,14965,0,0,0,1,1
43735,100,7996,12239;12258,14965,0,0,0,2,2
43736,100,7997,11864,14965,0,0,0,1,1
43737,100,7998,11617;11943,14965,0,0,0,2,2
43738,100,7999,11319,14965,0,0,0,1,1
43739,100,8000,11780;12317,14965,0,0,0,2,2
43740,100,8001,11801,14965,0,0,0,1,1
43741,100,8002,12493,14965,0,0,0,1,1
43742,100,8003,12730,14965,0,0,0,1,1
43743,100,8005,11818,14965,0,0,0,1,1
43744,100,8006,11961,14965,0,0,0,1,1
43745,100,8007,11973,14965,0,0,0,1,1
43746,100,8008,11983,14965,0,0,0,1,1
43747,100,8009,12162,14965,0,0,0,1,1
43748,100,8010,12107,14965,0,0,0,1,1
43749,100,8012,12207;12459,14965,0,0,0,2,2
43750,100,8013,12599,14965,0,0,0,1,1
43751,100,8014,12221,14965,0,0,0,1,1
43752,100,8015,12226,14965,0,0,0,1,1
43753,100,8017,12344;18295,14965,0,0,1,1,2
43754,100,8018,12543;12629,14965,0,0,0,2,2
43755,100,8019,12603,14965,0,0,0,1,1
43756,100,8020,12490;12665,14965,0,0,0,2,2
43757,100,8022,12218,14965,0,0,0,1,1
43758,100,8023,12118;12330,14965,0,0,0,2,2
43759,100,8024,12648,14965,0,0,0,1,1
43760,100,8026,12251;12370,14965,0,0,0,2,2
43761,100,8027,12355,14965,0,0,0,1,1
43762,100,8031,10414,15330,0,0,0,1,1
43763,100,8067,10767,15330,0,0,0,1,1
43764,100,8072,10860,15330,0,0,0,1,1
43765,100,8073,11569;11653,15330,0,0,0,2,2
43766,100,8076,11367;12146,15330,0,0,0,2,2
43767,100,8077,11521,15330,0,0,0,1,1
43768,100,8081,11445,15330,0,0,0,1,1
43769,100,8082,11594;12044,15330,0,0,0,2,2
43770,100,8084,12219,15330,0,0,0,1,1
43771,100,8085,11659,15330,0,0,0,1,1
43772,100,8086,11915,15330,0,0,0,1,1
43773,100,8090,11844;11968,15330,0,0,0,2,2
43774,100,8091,12048,15330,0,0,0,1,1
43775,100,8092,11359,15330,0,0,0,1,1
43776,100,8096,11789;11937,15330,0,0,0,2,2
43777,100,8097,11948,15330,0,0,0,1,1
43778,100,8098,11747;11952,15330,0,0,0,2,2
43779,100,8099,11958,15330,0,0,0,1,1
43780,100,8100,12174,15330,0,0,0,1,1
43781,100,8101,12028,15330,0,0,0,1,1
43782,100,8102,11932,15330,0,0,0,1,1
43783,100,8103,11959;12050,15330,0,0,0,2,2
43784,100,8104,12060,15330,0,0,0,1,1
43785,100,8106,12171;12488,15330,0,0,0,2,2
43786,100,8107,12266;12284,15330,0,0,0,2,2
43787,100,8108,11929;12182,15330,0,0,0,2,2
43788,100,8109,12714,15330,0,0,0,1,1
43789,100,8110,12241,15330,0,0,0,1,1
43790,100,8111,12032,15330,0,0,0,1,1
43791,100,8112,12088;12235,15330,0,0,0,2,2
43792,100,8113,12139,15330,0,0,0,1,1
43793,100,8115,12630;12801,15330,0,0,0,2,2
43794,100,8116,11837,15330,0,0,0,1,1
43795,100,8117,11839;12397,15330,0,0,0,2,2
43796,100,8119,11974,15330,0,0,0,1,1
43797,100,8120,12479;16367,15330,0,0,1,1,2
43798,100,8148,11118,15695,0,0,0,1,1
43799,100,8151,11429,15695,0,0,0,1,1
43800,100,8154,10971,15695,0,0,0,1,1
43801,100,8155,11072,15695,0,0,0,1,1
43802,100,8161,11787,15695,0,0,0,1,1
43803,100,8163,11596,15695,0,0,0,1,1
43804,100,8164,12188,15695,0,0,0,1,1
43805,100,8165,11600,15695,0,0,0,1,1
43806,100,8167,12321,15695,0,0,0,1,1
43807,100,8168,11994,15695,0,0,0,1,1
43808,100,8170,11635;12061,15695,0,0,0,2,2
43809,100,8171,12045,15695,0,0,0,1,1
43810,100,8172,11991,15695,0,0,0,1,1
43811,100,8174,12071,15695,0,0,0,1,1
43812,100,8175,12341,15695,0,0,0,1,1
43813,100,8176,12318,15695,0,0,0,1,1
43814,100,8177,12101;12566,15695,0,0,0,2,2
43815,100,8178,12110;12546,15695,0,0,0,2,2
43816,100,8179,12121,15695,0,0,0,1,1
43817,100,8180,11824,15695,0,0,0,1,1
43818,100,8182,16651;16940;17167;17336;20957;21021;21441,15695,0,3,4,0,7
43819,100,8183,12350,15695,0,0,0,1,1
43820,100,8184,12935,15695,0,0,0,1,1
43821,100,8185,12236,15695,0,0,0,1,1
43822,100,8186,12688,15695,0,0,0,1,1
43823,100,8187,12090;12608,15695,0,0,0,2,2
43824,100,8188,12319;12644;17736,15695,0,0,1,2,3
43825,100,8189,12812;12836;15509,15695,0,0,1,2,3
43826,100,8190,16283;16550;20963,15695,0,1,2,0,3
43827,100,8191,12755,15695,0,0,0,1,1
43828,100,8193,12392,15695,0,0,0,1,1
43829,100,8194,12684,15695,0,0,0,1,1
43830,100,8196,13241,15695,0,0,0,1,1
43831,100,8197,12529;12901,15695,0,0,0,2,2
43832,100,8198,12365;12386,15695,0,0,0,2,2
43833,100,8199,12496,15695,0,0,0,1,1
43834,100,8200,12414,15695,0,0,0,1,1
43835,100,8201,12795;12815,15695,0,0,0,2,2
43836,100,8202,12486;12540;18011,15695,0,0,1,2,3
43837,100,8203,12559,15695,0,0,0,1,1
43838,100,8204,12432,15695,0,0,0,1,1
43839,100,8206,12871,15695,0,0,0,1,1
43840,100,8208,12519,15695,0,0,0,1,1
43841,100,8209,12617,15695,0,0,0,1,1
43842,100,8237,10443,16060,0,0,0,1,1
43843,100,8244,11293;11777,16060,0,0,0,2,2
43844,100,8246,11791,16060,0,0,0,1,1
43845,100,8247,12210;12866,16060,0,0,0,2,2
43846,100,8249,11649;12035,16060,0,0,0,2,2
43847,100,8251,12078,16060,0,0,0,1,1
43848,100,8252,11098,16060,0,0,0,1,1
43849,100,8256,11936,16060,0,0,0,1,1
43850,100,8257,11814;12021,16060,0,0,0,2,2
43851,100,8258,11867;12124,16060,0,0,0,2,2
43852,100,8259,11794,16060,0,0,0,1,1
43853,100,8262,12430;12625,16060,0,0,0,2,2
43854,100,8263,12720;12807,16060,0,0,0,2,2
43855,100,8264,11917,16060,0,0,0,1,1
43856,100,8266,12873,16060,0,0,0,1,1
43857,100,8267,11875,16060,0,0,0,1,1
43858,100,8268,12294,16060,0,0,0,1,1
43859,100,8269,12495;12705,16060,0,0,0,2,2
43860,100,8270,11872;11949,16060,0,0,0,2,2
43861,100,8271,12010,16060,0,0,0,1,1
43862,100,8272,12184,16060,0,0,0,1,1
43863,100,8273,12005;12195,16060,0,0,0,2,2
43864,100,8275,11860,16060,0,0,0,1,1
43865,100,8276,12260,16060,0,0,0,1,1
43866,100,8277,12434,16060,0,0,0,1,1
43867,100,8278,12332;12745,16060,0,0,0,2,2
43868,100,8279,12367,16060,0,0,0,1,1
43869,100,8280,12407,16060,0,0,0,1,1
43870,100,8281,12384,16060,0,0,0,1,1
43871,100,8282,12889;12963,16060,0,0,0,2,2
43872,100,8283,12735,16060,0,0,0,1,1
43873,100,8284,12517,16060,0,0,0,1,1
43874,100,8285,12427,16060,0,0,0,1,1
43875,100,8286,12460,16060,0,0,0,1,1
43876,100,8287,12719;12753,16060,0,0,0,2,2
43877,100,8288,12368;12579,16060,0,0,0,2,2
43878,100,8289,12227,16060,0,0,0,1,1
43879,100,8290,12620;12791,16060,0,0,0,2,2
43880,100,8291,12615,16060,0,0,0,1,1
43881,100,8292,12623;12776,16060,0,0,0,2,2
43882,100,8293,12825,16060,0,0,0,1,1
43883,100,8294,12206;12416,16060,0,0,0,2,2
43884,100,8295,12685,16060,0,0,0,1,1
43885,100,8297,12652;12698,16060,0,0,0,2,2
43886,100,8298,13084,16060,0,0,0,1,1
43887,100,8301,12257,16060,0,0,0,1,1
43888,100,8302,12737,16060,0,0,0,1,1
43889,100,8333,10875,16425,0,0,0,1,1
43890,100,8338,11483;12059,16425,0,0,0,2,2
43891,100,8339,11537;11642,16425,0,0,0,2,2
43892,100,8340,11542,16425,0,0,0,1,1
43893,100,8341,11403;11671,16425,0,0,0,2,2
43894,100,8342,11515;12057,16425,0,0,0,2,2
43895,100,8345,12281,16425,0,0,0,1,1
43896,100,8347,12047,16425,0,0,0,1,1
43897,100,8348,12269,16425,0,0,0,1,1
43898,100,8349,12851,16425,0,0,0,1,1
43899,100,8350,12228,16425,0,0,0,1,1
43900,100,8352,12640;12646,16425,0,0,0,2,2
43901,100,8353,12255;12497,16425,0,0,0,2,2
43902,100,8355,12846,16425,0,0,0,1,1
43903,100,8356,13008;13196,16425,0,0,0,2,2
43904,100,8357,12360;12446,16425,0,0,0,2,2
43905,100,8358,12362,16425,0,0,0,1,1
43906,100,8359,12395,16425,0,0,0,1,1
43907,100,8360,12792,16425,0,0,0,1,1
43908,100,8361,12834,16425,0,0,0,1,1
43909,100,8364,12674,16425,0,0,0,1,1
43910,100,8365,12859,16425,0,0,0,1,1
43911,100,8366,12550;12946,16425,0,0,0,2,2
43912,100,8367,12570,16425,0,0,0,1,1
43913,100,8368,12575,16425,0,0,0,1,1
43914,100,8369,12453,16425,0,0,0,1,1
43915,100,8370,12602;12639,16425,0,0,0,2,2
43916,100,8371,12723;12854,16425,0,0,0,2,2
43917,100,8372,12276,16425,0,0,0,1,1
43918,100,8373,12822,16425,0,0,0,1,1
43919,100,8374,12973,16425,0,0,0,1,1
43920,100,8375,12423;12974,16425,0,0,0,2,2
43921,100,8376,13379,16425,0,0,0,1,1
43922,100,8377,13198;13404,16425,0,0,0,2,2
43923,100,8378,12920,16425,0,0,0,1,1
43924,100,8379,12746;13048,16425,0,0,0,2,2
43925,100,8380,12417;12572,16425,0,0,0,2,2
43926,100,8381,12229;12761,16425,0,0,0,2,2
43927,100,8382,12616;12780,16425,0,0,0,2,2
43928,100,8383,12954;13085,16425,0,0,0,2,2
43929,100,8384,12396;12785,16425,0,0,0,2,2
43930,100,8385,12786,16425,0,0,0,1,1
43931,100,8386,13004;13054,16425,0,0,0,2,2
43932,100,8387,12790,16425,0,0,0,1,1
43933,100,8388,12802,16425,0,0,0,1,1
43934,100,8389,13264,16425,0,0,0,1,1
43935,100,8390,12113;12864,16425,0,0,0,2,2
43936,100,8425,11426;11624,16790,0,0,0,2,2
43937,100,8426,11702;12293,16790,0,0,0,2,2
43938,100,8428,11722,16790,0,0,0,1,1
43939,100,8431,12082,16790,0,0,0,1,1
43940,100,8433,12062,16790,0,0,0,1,1
43941,100,8434,11852;12143,16790,0,0,0,2,2
43942,100,8437,12133,16790,0,0,0,1,1
43943,100,8438,11802;12116,16790,0,0,0,2,2
43944,100,8439,11987,16790,0,0,0,1,1
43945,100,8441,12150;12444,16790,0,0,0,2,2
43946,100,8442,12418;12713,16790,0,0,0,2,2
43947,100,8443,12605,16790,0,0,0,1,1
43948,100,8444,12193,16790,0,0,0,1,1
43949,100,8445,12277;12328,16790,0,0,0,2,2
43950,100,8446,12244,16790,0,0,0,1,1
43951,100,8447,12642,16790,0,0,0,1,1
43952,100,8448,12185;12265,16790,0,0,0,2,2
43953,100,8449,12298;12351,16790,0,0,0,2,2
43954,100,8450,12315;12667,16790,0,0,0,2,2
43955,100,8452,12376;13257,16790,0,0,0,2,2
43956,100,8453,12380,16790,0,0,0,1,1
43957,100,8455,12611,16790,0,0,0,1,1
43958,100,8456,11883;12419,16790,0,0,0,2,2
43959,100,8457,12439,16790,0,0,0,1,1
43960,100,8458,12279;12455,16790,0,0,0,2,2
43961,100,8459,12454;12697,16790,0,0,0,2,2
43962,100,8460,12501;12892,16790,0,0,0,2,2
43963,100,8461,12514;12573,16790,0,0,0,2,2
43964,100,8463,12981,16790,0,0,0,1,1
43965,100,8464,13158,16790,0,0,0,1,1
43966,100,8465,12565,16790,0,0,0,1,1
43967,100,8466,13029;13300,16790,0,0,0,2,2
43968,100,8468,12681,16790,0,0,0,1,1
43969,100,8469,12561;12686,16790,0,0,0,2,2
43970,100,8470,13186,16790,0,0,0,1,1
43971,100,8471,12382;12742,16790,0,0,0,2,2
43972,100,8472,12654;12775,16790,0,0,0,2,2
43973,100,8473,12803,16790,0,0,0,1,1
43974,100,8474,12628;17913,16790,0,0,1,1,2
43975,100,8475,12160;12818,16790,0,0,0,2,2
43976,100,8476,12955,16790,0,0,0,1,1
43977,100,8477,12837,16790,0,0,0,1,1
43978,100,8478,12701;13057,16790,0,0,0,2,2
43979,100,8479,12700;12894,16790,0,0,0,2,2
43980,100,8480,12858;18608;21987,16790,1,0,1,1,3
43981,100,8481,12861,16790,0,0,0,1,1
43982,100,8482,13293;13308,16790,0,0,0,2,2
43983,100,8484,12879;13439,16790,0,0,0,2,2
43984,100,8485,12886;13340,16790,0,0,0,2,2
43985,100,8486,12919;13371,16790,0,0,0,2,2
43986,100,8487,12527;12924,16790,0,0,0,2,2
43987,100,8488,12672;13318,16790,0,0,0,2,2
43988,100,8489,12928;13363,16790,0,0,0,2,2
43989,100,8490,12942,16790,0,0,0,1,1
43990,100,8491,16641;16853;20185;21300,16790,0,1,3,0,4
43991,100,8492,12772,16790,0,0,0,1,1
43992,100,8514,10826,17155,0,0,0,1,1
43993,100,8516,11756,17155,0,0,0,1,1
43994,100,8521,12070;17253,17155,0,0,1,1,2
43995,100,8524,12020,17155,0,0,0,1,1
43996,100,8525,11572,17155,0,0,0,1,1
43997,100,8526,12119,17155,0,0,0,1,1
43998,100,8530,12156,17155,0,0,0,1,1
43999,100,8531,12192;12855,17155,0,0,0,2,2
44000,100,8532,12509,17155,0,0,0,1,1
44001,100,8533,12205;12470,17155,0,0,0,2,2
44002,100,8534,12270,17155,0,0,0,1,1
44003,100,8535,12715,17155,0,0,0,1,1
44004,100,8536,12280;12428,17155,0,0,0,2,2
44005,100,8537,12079,17155,0,0,0,1,1
44006,100,8538,12348;12643,17155,0,0,0,2,2
44007,100,8539,12399,17155,0,0,0,1,1
44008,100,8541,12292,17155,0,0,0,1,1
44009,100,8542,12712;16739,17155,0,0,1,1,2
44010,100,8543,12770,17155,0,0,0,1,1
44011,100,8546,12671;12778,17155,0,0,0,2,2
44012,100,8547,13377,17155,0,0,0,1,1
44013,100,8548,12339,17155,0,0,0,1,1
44014,100,8549,12539;12733,17155,0,0,0,2,2
44015,100,8550,12961;13230,17155,0,0,0,2,2
44016,100,8551,12245;12333,17155,0,0,0,2,2
44017,100,8553,12562;12906,17155,0,0,0,2,2
44018,100,8554,12622;13214,17155,0,0,0,2,2
44019,100,8555,12180,17155,0,0,0,1,1
44020,100,8556,12977;13050,17155,0,0,0,2,2
44021,100,8557,12463;12678,17155,0,0,0,2,2
44022,100,8559,13272;13391;15452,17155,0,0,1,2,3
44023,100,8560,12728,17155,0,0,0,1,1
44024,100,8561,12734;13290,17155,0,0,0,2,2
44025,100,8562,12744,17155,0,0,0,1,1
44026,100,8563,13204,17155,0,0,0,1,1
44027,100,8564,13034;13265,17155,0,0,0,2,2
44028,100,8565,12806;12883,17155,0,0,0,2,2
44029,100,8566,13355;18061,17155,0,0,1,1,2
44030,100,8567,13398;13579,17155,0,0,0,2,2
44031,100,8568,12915;13263,17155,0,0,0,2,2
44032,100,8569,12476;12896,17155,0,0,0,2,2
44033,100,8570,12878;13159,17155,0,0,0,2,2
44034,100,8571,12931;13170;17417,17155,0,0,1,2,3
44035,100,8572,12932;13192,17155,0,0,0,2,2
44036,100,8573,12751;12934,17155,0,0,0,2,2
44037,100,8574,12938;12990,17155,0,0,0,2,2
44038,100,8575,12968,17155,0,0,0,1,1
44039,100,8576,12960,17155,0,0,0,1,1
44040,100,8577,12592;12641,17155,0,0,0,2,2
44041,100,8578,13051;13409,17155,0,0,0,2,2
44042,100,8581,12925;13020,17155,0,0,0,2,2
44043,100,8583,13039,17155,0,0,0,1,1
44044,100,8584,13059,17155,0,0,0,1,1
44045,100,8585,12213;13063;16742,17155,0,0,1,2,3
44046,100,8586,13071,17155,0,0,0,1,1
44047,100,8588,12811;13133,17155,0,0,0,2,2
44048,100,8589,13107;13307,17155,0,0,0,2,2
44049,100,8621,11634;11822,17520,0,0,0,2,2
44050,100,8623,11782,17520,0,0,0,1,1
44051,100,8628,12393,17520,0,0,0,1,1
44052,100,8630,11647;12041,17520,0,0,0,2,2
44053,100,8631,12421,17520,0,0,0,1,1
44054,100,8632,12764,17520,0,0,0,1,1
44055,100,8633,11744;12327,17520,0,0,0,2,2
44056,100,8634,11764;12201,17520,0,0,0,2,2
44057,100,8635,11923;12034,17520,0,0,0,2,2
44058,100,8636,12181;12263,17520,0,0,0,2,2
44059,100,8637,12363,17520,0,0,0,1,1
44060,100,8639,12725,17520,0,0,0,1,1
44061,100,8640,12814,17520,0,0,0,1,1
44062,100,8641,13040,17520,0,0,0,1,1
44063,100,8643,12491;12838;16355,17520,0,0,1,2,3
44064,100,8644,12282;12522,17520,0,0,0,2,2
44065,100,8645,12821,17520,0,0,0,1,1
44066,100,8647,12549,17520,0,0,0,1,1
44067,100,8648,13140;13341,17520,0,0,0,2,2
44068,100,8649,12638,17520,0,0,0,1,1
44069,100,8650,12627;13252;17151,17520,0,0,1,2,3
44070,100,8651,12283;12457,17520,0,0,0,2,2
44071,100,8652,12655,17520,0,0,0,1,1
44072,100,8654,12771;12882,17520,0,0,0,2,2
44073,100,8655,12890;13146,17520,0,0,0,2,2
44074,100,8656,12515,17520,0,0,0,1,1
44075,100,8657,13116;13181,17520,0,0,0,2,2
44076,100,8658,12304;12848,17520,0,0,0,2,2
44077,100,8659,13533,17520,0,0,0,1,1
44078,100,8660,13091,17520,0,0,0,1,1
44079,100,8661,13313;13364,17520,0,0,0,2,2
44080,100,8662,12914;13270,17520,0,0,0,2,2
44081,100,8663,12936,17520,0,0,0,1,1
44082,100,8664,13005;13609,17520,0,0,0,2,2
44083,100,8665,13014;13176,17520,0,0,0,2,2
44084,100,8666,12921,17520,0,0,0,1,1
44085,100,8667,13482;13612,17520,0,0,0,2,2
44086,100,8668,12996,17520,0,0,0,1,1
44087,100,8669,13045;13550,17520,0,0,0,2,2
44088,100,8670,13622;13632,17520,0,0,0,2,2
44089,100,8671,12808;12881,17520,0,0,0,2,2
44090,100,8672,13076;13537,17520,0,0,0,2,2
44091,100,8673,13087;13178,17520,0,0,0,2,2
44092,100,8674,13517,17520,0,0,0,1,1
44093,100,8675,13141;13394,17520,0,0,0,2,2
44094,100,8676,13268,17520,0,0,0,1,1
44095,100,8677,12994;13189,17520,0,0,0,2,2
44096,100,8679,13255,17520,0,0,0,1,1
44097,100,8680,13489,17520,0,0,0,1,1
44098,100,8708,11885,17885,0,0,0,1,1
44099,100,8710,11682,17885,0,0,0,1,1
44100,100,8712,11372;11811,17885,0,0,0,2,2
44101,100,8713,16470;16707;20656;21691,17885,1,1,2,0,4
44102,100,8714,11520;12122,17885,0,0,0,2,2
44103,100,8720,12007,17885,0,0,0,1,1
44104,100,8721,11827,17885,0,0,0,1,1
44105,100,8722,11295;16143,17885,0,0,1,1,2
44106,100,8723,11543;11986,17885,0,0,0,2,2
44107,100,8727,12530,17885,0,0,0,1,1
44108,100,8728,12237;12571,17885,0,0,0,2,2
44109,100,8729,12577,17885,0,0,0,1,1
44110,100,8733,12631;13012,17885,0,0,0,2,2
44111,100,8734,12475,17885,0,0,0,1,1
44112,100,8735,12055;12482,17885,0,0,0,2,2
44113,100,8736,12717;13415,17885,0,0,0,2,2
44114,100,8737,12947;17138,17885,0,0,1,1,2
44115,100,8739,12632,17885,0,0,0,1,1
44116,100,8740,12862;13115,17885,0,0,0,2,2
44117,100,8742,12404,17885,0,0,0,1,1
44118,100,8743,17384;17603;21684,17885,1,0,2,0,3
44119,100,8744,13383,17885,0,0,0,1,1
44120,100,8745,13123,17885,0,0,0,1,1
44121,100,8746,13068,17885,0,0,0,1,1
44122,100,8747,12877;12980,17885,0,0,0,2,2
44123,100,8749,12773;13184,17885,0,0,0,2,2
44124,100,8750,13062;13630,17885,0,0,0,2,2
44125,100,8751,12524;13643;17638,17885,0,0,1,2,3
44126,100,8754,12975,17885,0,0,0,1,1
44127,100,8755,12478,17885,0,0,0,1,1
44128,100,8756,12991;13043,17885,0,0,0,2,2
44129,100,8757,12992;13010,17885,0,0,0,2,2
44130,100,8758,13079;13432,17885,0,0,0,2,2
44131,100,8759,13462;13659,17885,0,0,0,2,2
44132,100,8760,12944;13094,17885,0,0,0,2,2
44133,100,8761,12718;13118,17885,0,0,0,2,2
44134,100,8762,13220,17885,0,0,0,1,1
44135,100,8763,13121;13755,17885,0,0,0,2,2
44136,100,8764,12767;13131,17885,0,0,0,2,2
44137,100,8765,13227;13602,17885,0,0,0,2,2
44138,100,8766,13403,17885,0,0,0,1,1
44139,100,8767,13155,17885,0,0,0,1,1
44140,100,8768,13174;13185,17885,0,0,0,2,2
44141,100,8769,13096;13183,17885,0,0,0,2,2
44142,100,8770,13195,17885,0,0,0,1,1
44143,100,8771,13024;13647,17885,0,0,0,2,2
44144,100,8773,13242,17885,0,0,0,1,1
44145,100,8774,13250,17885,0,0,0,1,1
44146,100,8775,13180;13253;17960,17885,0,0,1,2,3
44147,100,8777,13003;13291;17479,17885,0,0,1,2,3
44148,100,8778,13295;13395,17885,0,0,0,2,2
44149,100,8779,13299;13613,17885,0,0,0,2,2
44150,100,8780,13303,17885,0,0,0,1,1
44151,100,8781,13122;13656,17885,0,0,0,2,2
44152,100,8782,13144,17885,0,0,0,1,1
44153,100,8783,12666;13518,17885,0,0,0,2,2
44154,100,8784,12888;13468,17885,0,0,0,2,2
44155,100,8785,13321;13703;17599,17885,0,0,1,2,3
44156,100,8786,13369;13669,17885,0,0,0,2,2
44157,100,8787,12706;13382,17885,0,0,0,2,2
44158,100,8788,13320;13396,17885,0,0,0,2,2
44159,100,8825,12012;12084,18250,0,0,0,2,2
44160,100,8826,11347;11820,18250,0,0,0,2,2
44161,100,8829,11605;12004,18250,0,0,0,2,2
44162,100,8830,12187,18250,0,0,0,1,1
44163,100,8832,12252;12336,18250,0,0,0,2,2
44164,100,8833,12338;12556,18250,0,0,0,2,2
44165,100,8834,12247;12347,18250,0,0,0,2,2
44166,100,8835,12452,18250,0,0,0,1,1
44167,100,8836,12186;12443,18250,0,0,0,2,2
44168,100,8837,12447;13324,18250,0,0,0,2,2
44169,100,8838,12016;12471,18250,0,0,0,2,2
44170,100,8839,12487,18250,0,0,0,1,1
44171,100,8840,12538;12597,18250,0,0,0,2,2
44172,100,8841,12754;13569;18918,18250,0,0,1,2,3
44173,100,8843,12850;13126,18250,0,0,0,2,2
44174,100,8844,13035,18250,0,0,0,1,1
44175,100,8845,13038;13093,18250,0,0,0,2,2
44176,100,8846,12699,18250,0,0,0,1,1
44177,100,8848,12710;13420,18250,0,0,0,2,2
44178,100,8851,12789,18250,0,0,0,1,1
44179,100,8852,12809,18250,0,0,0,1,1
44180,100,8853,12584;13053,18250,0,0,0,2,2
44181,100,8854,13470,18250,0,0,0,1,1
44182,100,8856,12958,18250,0,0,0,1,1
44183,100,8857,12465,18250,0,0,0,1,1
44184,100,8858,12941;13436,18250,0,0,0,2,2
44185,100,8859,12872;13449,18250,0,0,0,2,2
44186,100,8860,13022,18250,0,0,0,1,1
44187,100,8861,12962;13026,18250,0,0,0,2,2
44188,100,8862,13032,18250,0,0,0,1,1
44189,100,8863,12950;13036,18250,0,0,0,2,2
44190,100,8864,12867;13388,18250,0,0,0,2,2
44191,100,8865,13090,18250,0,0,0,1,1
44192,100,8866,13088;13092,18250,0,0,0,2,2
44193,100,8867,13021;13638,18250,0,0,0,2,2
44194,100,8868,12998;13129,18250,0,0,0,2,2
44195,100,8869,13137;13375,18250,0,0,0,2,2
44196,100,8870,13217;13297,18250,0,0,0,2,2
44197,100,8871,13688,18250,0,0,0,1,1
44198,100,8873,13112;13216;17640,18250,0,0,1,2,3
44199,100,8874,13360;13428,18250,0,0,0,2,2
44200,100,8875,13330,18250,0,0,0,1,1
44201,100,8876,13294;13496;17650,18250,0,0,1,2,3
44202,100,8877,12784;13361,18250,0,0,0,2,2
44203,100,8878,13304,18250,0,0,0,1,1
44204,100,8879,12959;13339,18250,0,0,0,2,2
44205,100,8880,13899,18250,0,0,0,1,1
44206,100,8881,13392;13660,18250,0,0,0,2,2
44207,100,8882,13587,18250,0,0,0,1,1
44208,100,8883,13359;13943,18250,0,0,0,2,2
44209,100,8884,13539,18250,0,0,0,1,1
44210,100,8885,13471,18250,0,0,0,1,1
44211,100,8887,13222;13851,18250,0,0,0,2,2
44212,100,8888,13774,18250,0,0,0,1,1
44213,100,8889,13493;14002,18250,0,0,0,2,2
44214,100,8892,13329;13532,18250,0,0,0,2,2
44215,100,8906,11175,18615,0,0,0,1,1
44216,100,8908,11019;11178,18615,0,0,0,2,2
44217,100,8912,11897,18615,0,0,0,1,1
44218,100,8915,11749,18615,0,0,0,1,1
44219,100,8918,12574,18615,0,0,0,1,1
44220,100,8919,12727,18615,0,0,0,1,1
44221,100,8920,12006,18615,0,0,0,1,1
44222,100,8923,12046,18615,0,0,0,1,1
44223,100,8926,12337,18615,0,0,0,1,1
44224,100,8927,12191;12563,18615,0,0,0,2,2
44225,100,8928,12366,18615,0,0,0,1,1
44226,100,8931,12798;12856,18615,0,0,0,2,2
44227,100,8932,12726,18615,0,0,0,1,1
44228,100,8934,12911;13103,18615,0,0,0,2,2
44229,100,8935,12178;12659,18615,0,0,0,2,2
44230,100,8936,12553;12679,18615,0,0,0,2,2
44231,100,8937,13474,18615,0,0,0,1,1
44232,100,8940,12957,18615,0,0,0,1,1
44233,100,8941,12499;12805,18615,0,0,0,2,2
44234,100,8942,13019;13266,18615,0,0,0,2,2
44235,100,8943,12827;13246,18615,0,0,0,2,2
44236,100,8944,12732;12842,18615,0,0,0,2,2
44237,100,8945,12843,18615,0,0,0,1,1
44238,100,8946,12847,18615,0,0,0,1,1
44239,100,8947,13070,18615,0,0,0,1,1
44240,100,8948,12908;17969,18615,0,0,1,1,2
44241,100,8949,12503,18615,0,0,0,1,1
44242,100,8950,12885;13666,18615,0,0,0,2,2
44243,100,8953,13455,18615,0,0,0,1,1
44244,100,8954,12651;13169,18615,0,0,0,2,2
44245,100,8956,13047;13506,18615,0,0,0,2,2
44246,100,8958,13109;13842,18615,0,0,0,2,2
44247,100,8959,13134;13508,18615,0,0,0,2,2
44248,100,8960,13163;13172,18615,0,0,0,2,2
44249,100,8962,13175;13736,18615,0,0,0,2,2
44250,100,8963,13191;13484,18615,0,0,0,2,2
44251,100,8964,13066;14014,18615,0,0,0,2,2
44252,100,8965,13918,18615,0,0,0,1,1
44253,100,8967,13254;13963,18615,0,0,0,2,2
44254,100,8968,13332,18615,0,0,0,1,1
44255,100,8970,13127,18615,0,0,0,1,1
44256,100,8971,13350;13354,18615,0,0,0,2,2
44257,100,8972,13067;13384,18615,0,0,0,2,2
44258,100,8973,12477;13386,18615,0,0,0,2,2
44259,100,8974,13407,18615,0,0,0,1,1
44260,100,8976,13599,18615,0,0,0,1,1
44261,100,8977,13752;13856,18615,0,0,0,2,2
44262,100,8978,14044,18615,0,0,0,1,1
44263,100,8979,13453;13606,18615,0,0,0,2,2
44264,100,8980,13046;13511,18615,0,0,0,2,2
44265,100,8981,13778,18615,0,0,0,1,1
44266,100,8982,13545,18615,0,0,0,1,1
44267,100,8983,13218,18615,0,0,0,1,1
44268,100,8984,13562,18615,0,0,0,1,1
44269,100,8985,13564;13704,18615,0,0,0,2,2
44270,100,8986,13573,18615,0,0,0,1,1
44271,100,8987,12989;13585,18615,0,0,0,2,2
44272,100,8988,13616,18615,0,0,0,1,1
44273,100,8989,13548;13883;18726,18615,0,0,1,2,3
44274,100,8991,13629;13650,18615,0,0,0,2,2
44275,100,8992,13637,18615,0,0,0,1,1
44276,100,8993,13528;13644,18615,0,0,0,2,2
44277,100,8994,13937,18615,0,0,0,1,1
44278,100,8995,13658,18615,0,0,0,1,1
44279,100,9012,11243,18980,0,0,0,1,1
44280,100,9017,11050,18980,0,0,0,1,1
44281,100,9023,11877,18980,0,0,0,1,1
44282,100,9024,11733;12163,18980,0,0,0,2,2
44283,100,9027,12108;12852,18980,0,0,0,2,2
44284,100,9028,11805;12209,18980,0,0,0,2,2
44285,100,9029,11946;12173,18980,0,0,0,2,2
44286,100,9033,12299,18980,0,0,0,1,1
44287,100,9036,12391;12917;18771,18980,0,0,1,2,3
44288,100,9037,12400,18980,0,0,0,1,1
44289,100,9039,12508,18980,0,0,0,1,1
44290,100,9040,12548;13244,18980,0,0,0,2,2
44291,100,9041,13258,18980,0,0,0,1,1
44292,100,9042,12595;12824,18980,0,0,0,2,2
44293,100,9045,12796;13497,18980,0,0,0,2,2
44294,100,9046,13001,18980,0,0,0,1,1
44295,100,9048,13353;13501,18980,0,0,0,2,2
44296,100,9049,12528;12969;17971,18980,0,0,1,2,3
44297,100,9050,12525;13041,18980,0,0,0,2,2
44298,100,9052,13077;13596,18980,0,0,0,2,2
44299,100,9053,13056;13101,18980,0,0,0,2,2
44300,100,9054,13031;13139,18980,0,0,0,2,2
44301,100,9055,13086;13687,18980,0,0,0,2,2
44302,100,9056,13182,18980,0,0,0,1,1
44303,100,9058,13221;13913;17478,18980,0,0,1,2,3
44304,100,9059,13223;13315,18980,0,0,0,2,2
44305,100,9060,13098;13483,18980,0,0,0,2,2
44306,100,9061,13226,18980,0,0,0,1,1
44307,100,9062,13256,18980,0,0,0,1,1
44308,100,9063,13267;13578,18980,0,0,0,2,2
44309,100,9066,13301;13766,18980,0,0,0,2,2
44310,100,9067,13422;13826,18980,0,0,0,2,2
44311,100,9068,13372;13457,18980,0,0,0,2,2
44312,100,9069,13027;13715,18980,0,0,0,2,2
44313,100,9070,13055;13430,18980,0,0,0,2,2
44314,100,9071,13514,18980,0,0,0,1,1
44315,100,9072,13344;13636,18980,0,0,0,2,2
44316,100,9073,13458;13580,18980,0,0,0,2,2
44317,100,9074,13461;13591;19429,18980,0,0,1,2,3
44318,100,9075,13100;13448,18980,0,0,0,2,2
44319,100,9076,13362;13491,18980,0,0,0,2,2
44320,100,9077,13534,18980,0,0,0,1,1
44321,100,9078,13444;13576,18980,0,0,0,2,2
44322,100,9079,13617;13996,18980,0,0,0,2,2
44323,100,9080,13705,18980,0,0,0,1,1
44324,100,9082,13179;13641,18980,0,0,0,2,2
44325,100,9083,13640;13642,18980,0,0,0,2,2
44326,100,9084,13693;13841,18980,0,0,0,2,2
44327,100,9086,13716;13893,18980,0,0,0,2,2
44328,100,9087,13233,18980,0,0,0,1,1
44329,100,9088,13761;13930,18980,0,0,0,2,2
44330,100,9090,13445;14057,18980,0,0,0,2,2
44331,100,9091,13904;13938,18980,0,0,0,2,2
44332,100,9108,11145,19345,0,0,0,1,1
44333,100,9118,11893,19345,0,0,0,1,1
44334,100,9121,12097,19345,0,0,0,1,1
44335,100,9122,12375;12949,19345,0,0,0,2,2
44336,100,9123,12356;12433,19345,0,0,0,2,2
44337,100,9124,12440;12520,19345,0,0,0,2,2
44338,100,9125,12480;12676,19345,0,0,0,2,2
44339,100,9127,12606;13099,19345,0,0,0,2,2
44340,100,9129,12222;12634,19345,0,0,0,2,2
44341,100,9131,12413;12598,19345,0,0,0,2,2
44342,100,9132,12199;13015,19345,0,0,0,2,2
44343,100,9133,13143;17191,19345,0,0,1,1,2
44344,100,9134,17020;17226;20101;20782,19345,0,1,3,0,4
44345,100,9135,13232;13316,19345,0,0,0,2,2
44346,100,9136,13800;14204,19345,0,0,0,2,2
44347,100,9137,13037;13106,19345,0,0,0,2,2
44348,100,9138,13611,19345,0,0,0,1,1
44349,100,9141,13672;13958,19345,0,0,0,2,2
44350,100,9142,13334,19345,0,0,0,1,1
44351,100,9143,13335;13336,19345,0,0,0,2,2
44352,100,9145,14046,19345,0,0,0,1,1
44353,100,9146,13940,19345,0,0,0,1,1
44354,100,9147,13138;13390,19345,0,0,0,2,2
44355,100,9148,13446;13717,19345,0,0,0,2,2
44356,100,9149,14152,19345,0,0,0,1,1
44357,100,9150,13401;13936,19345,0,0,0,2,2
44358,100,9152,14090;14339,19345,0,0,1,1,2
44359,100,9153,12952;13487,19345,0,0,0,2,2
44360,100,9154,13980;14115,19345,0,0,0,2,2
44361,100,9155,13978;14070,19345,0,0,0,2,2
44362,100,9156,13588;14041,19345,0,0,0,2,2
44363,100,9157,14063;14188;18276;21965,19345,1,0,1,2,4
44364,100,9158,13699,19345,0,0,0,1,1
44365,100,9159,13649,19345,0,0,0,1,1
44366,100,9160,13561;13673,19345,0,0,0,2,2
44367,100,9161,13219;13677,19345,0,0,0,2,2
44368,100,9162,13695,19345,0,0,0,1,1
44369,100,9164,13714;17168,19345,0,0,1,1,2
44370,100,9165,13723;13878,19345,0,0,0,2,2
44371,100,9166,13373;13732,19345,0,0,0,2,2
44372,100,9168,13323;13801,19345,0,0,0,2,2
44373,100,9170,13431;13771,19345,0,0,0,2,2
44374,100,9171,13600;13772,19345,0,0,0,2,2
44375,100,9172,13654;13858,19345,0,0,0,2,2
44376,100,9173,13790;13892,19345,0,0,0,2,2
44377,100,9174,13792,19345,0,0,0,1,1
44378,100,9175,13793;13849;18387,19345,0,0,1,2,3
44379,100,9177,13527;13845,19345,0,0,0,2,2
44380,100,9178,13979;14120,19345,0,0,0,2,2
44381,100,9180,13894,19345,0,0,0,1,1
44382,100,9181,13901;13919,19345,0,0,0,2,2
44383,100,9200,10838,19710,0,0,0,1,1
44384,100,9211,11997,19710,0,0,0,1,1
44385,100,9213,12288;12675,19710,0,0,0,2,2
44386,100,9216,12703,19710,0,0,0,1,1
44387,100,9217,12835;12922,19710,0,0,0,2,2
44388,100,9219,13676,19710,0,0,0,1,1
44389,100,9220,12656;13011,19710,0,0,0,2,2
44390,100,9221,12387;13124,19710,0,0,0,2,2
44391,100,9222,13120,19710,0,0,0,1,1
44392,100,9223,12621;13162;16892,19710,0,0,1,2,3
44393,100,9226,13665;13678,19710,0,0,0,2,2
44394,100,9227,13466;13515,19710,0,0,0,2,2
44395,100,9228,13165;13553,19710,0,0,0,2,2
44396,100,9232,13582,19710,0,0,0,1,1
44397,100,9233,13426;13477,19710,0,0,0,2,2
44398,100,9234,13542;13924,19710,0,0,0,2,2
44399,100,9235,13421;13551,19710,0,0,0,2,2
44400,100,9236,14110;14207;17702,19710,0,0,1,2,3
44401,100,9237,13435;13598,19710,0,0,0,2,2
44402,100,9238,13277;13440;18551,19710,0,0,1,2,3
44403,100,9239,13624;14138,19710,0,0,0,2,2
44404,100,9242,14327;14337,19710,0,0,2,0,2
44405,100,9243,14054;14314,19710,0,0,1,1,2
44406,100,9244,13460;13791,19710,0,0,0,2,2
44407,100,9245,13702,19710,0,0,0,1,1
44408,100,9246,13413;13708;18584,19710,0,0,1,2,3
44409,100,9247,13712;14206;18045,19710,0,0,1,2,3
44410,100,9249,14042,19710,0,0,0,1,1
44411,100,9250,13674;14362,19710,0,0,1,1,2
44412,100,9251,13231;13530,19710,0,0,0,2,2
44413,100,9252,14462;14466,19710,0,0,2,0,2
44414,100,9253,13832;14365;18681,19710,0,0,2,1,3
44415,100,9254,14089;14266,19710,0,0,1,1,2
44416,100,9255,13830;14158,19710,0,0,0,2,2
44417,100,9256,13907;14013;18221,19710,0,0,1,2,3
44418,100,9257,13236;13914,19710,0,0,0,2,2
44419,100,9258,13205;13926,19710,0,0,0,2,2
44420,100,9259,13947,19710,0,0,0,1,1
44421,100,9260,13906;13948,19710,0,0,0,2,2
44422,100,9262,13824;13990,19710,0,0,0,2,2
44423,100,9263,14097;14264,19710,0,0,1,1,2
44424,100,9264,14035,19710,0,0,0,1,1
44425,100,9265,13813;13944,19710,0,0,0,2,2
44426,100,9266,13871;14078,19710,0,0,0,2,2
44427,100,9267,14080;14451,19710,0,0,1,1,2
44428,100,9282,10381,20075,0,0,0,1,1
44429,100,9305,11944;12106,20075,0,0,0,2,2
44430,100,9309,12169;12653,20075,0,0,0,2,2
44431,100,9313,12724;13078,20075,0,0,0,2,2
44432,100,9314,12588,20075,0,0,0,1,1
44433,100,9315,12853,20075,0,0,0,1,1
44434,100,9316,12993;13411,20075,0,0,0,2,2
44435,100,9317,13033;13556,20075,0,0,0,2,2
44436,100,9318,12626,20075,0,0,0,1,1
44437,100,9319,13229,20075,0,0,0,1,1
44438,100,9321,13634,20075,0,0,0,1,1
44439,100,9323,13769;14171,20075,0,0,0,2,2
44440,100,9325,13325;13575,20075,0,0,0,2,2
44441,100,9327,14325;14359,20075,0,0,2,0,2
44442,100,9329,13706;14191;18372,20075,0,0,1,2,3
44443,100,9330,13710,20075,0,0,0,1,1
44444,100,9331,13516,20075,0,0,0,1,1
44445,100,9332,13730;14030,20075,0,0,0,2,2
44446,100,9333,13942;14443,20075,0,0,1,1,2
44447,100,9334,13789,20075,0,0,0,1,1
44448,100,9335,13797;14186,20075,0,0,0,2,2
44449,100,9336,13799;14137,20075,0,0,0,2,2
44450,100,9337,13839;13853,20075,0,0,0,2,2
44451,100,9338,13854,20075,0,0,0,1,1
44452,100,9339,13783;13877,20075,0,0,0,2,2
44453,100,9340,13888;14130,20075,0,0,0,2,2
44454,100,9341,13908,20075,0,0,0,1,1
44455,100,9342,14312,20075,0,0,1,0,1
44456,100,9343,13912;14053,20075,0,0,0,2,2
44457,100,9344,13406;13812,20075,0,0,0,2,2
44458,100,9345,13927,20075,0,0,0,1,1
44459,100,9346,13152;13933,20075,0,0,0,2,2
44460,100,9348,13951;14282,20075,0,0,1,1,2
44461,100,9349,13735;13954,20075,0,0,0,2,2
44462,100,9350,14009,20075,0,0,0,1,1
44463,100,9351,13876;14225;18184,20075,0,0,2,1,3
44464,100,9352,13692,20075,0,0,0,1,1
44465,100,9353,14022;14099,20075,0,0,0,2,2
44466,100,9354,14473;14546,20075,0,0,2,0,2
44467,100,9355,14107;14530,20075,0,0,1,1,2
44468,100,9356,13679;13809,20075,0,0,0,2,2
44469,100,9357,13816;14125,20075,0,0,0,2,2
44470,100,9358,14584,20075,0,0,1,0,1
44471,100,9359,14114,20075,0,0,0,1,1
44472,100,9360,13481;14154,20075,0,0,0,2,2
44473,100,9361,14178;14369,20075,0,0,1,1,2
44474,100,9362,14128;14181,20075,0,0,0,2,2
44475,100,9363,13796;14198;19525,20075,0,0,1,2,3
44476,100,9384,10965,20440,0,0,0,1,1
44477,100,9387,11748,20440,0,0,0,1,1
44478,100,9400,12492,20440,0,0,0,1,1
44479,100,9402,12345;12394,20440,0,0,0,2,2
44480,100,9403,12505,20440,0,0,0,1,1
44481,100,9404,12425,20440,0,0,0,1,1
44482,100,9405,13016;13215,20440,0,0,0,2,2
44483,100,9406,12466;12582,20440,0,0,0,2,2
44484,100,9407,12779;12902,20440,0,0,0,2,2
44485,100,9408,12601,20440,0,0,0,1,1
44486,100,9409,13044;13572,20440,0,0,0,2,2
44487,100,9410,12484;12750,20440,0,0,0,2,2
44488,100,9412,12765,20440,0,0,0,1,1
44489,100,9415,12939;13104;17441,20440,0,0,1,2,3
44490,100,9417,12870;13013,20440,0,0,0,2,2
44491,100,9419,13042;13193,20440,0,0,0,2,2
44492,100,9422,13151;13298,20440,0,0,0,2,2
44493,100,9423,13273,20440,0,0,0,1,1
44494,100,9424,13212,20440,0,0,0,1,1
44495,100,9425,13709,20440,0,0,0,1,1
44496,100,9426,13331,20440,0,0,0,1,1
44497,100,9428,12900;13438,20440,0,0,0,2,2
44498,100,9429,13463;13964,20440,0,0,0,2,2
44499,100,9430,13897;14169,20440,0,0,0,2,2
44500,100,9431,13525;13620,20440,0,0,0,2,2
44501,100,9433,13327;13698,20440,0,0,0,2,2
44502,100,9434,13720;14074,20440,0,0,0,2,2
44503,100,9435,13722;14184,20440,0,0,0,2,2
44504,100,9436,13731;14068,20440,0,0,0,2,2
44505,100,9437,13806;13855,20440,0,0,0,2,2
44506,100,9438,13961;14168,20440,0,0,0,2,2
44507,100,9439,13821,20440,0,0,0,1,1
44508,100,9440,14167,20440,0,0,0,1,1
44509,100,9441,13950;14318,20440,0,0,1,1,2
44510,100,9442,13601;13844,20440,0,0,0,2,2
44511,100,9443,14350;14390;18756,20440,0,0,3,0,3
44512,100,9444,14235;14237,20440,0,0,2,0,2
44513,100,9445,13934,20440,0,0,0,1,1
44514,100,9446,13276;14124,20440,0,0,0,2,2
44515,100,9447,14330,20440,0,0,1,0,1
44516,100,9449,13920,20440,0,0,0,1,1
44517,100,9451,13931;14363;19287,20440,0,0,2,1,3
44518,100,9452,14234;14343,20440,0,0,2,0,2
44519,100,9454,14412,20440,0,0,1,0,1
44520,100,9455,14652,20440,0,0,1,0,1
44521,100,9456,14320;17988,20440,0,0,2,0,2
44522,100,9457,14153;14677,20440,0,0,1,1,2
44523,100,9458,14086,20440,0,0,0,1,1
44524,100,9459,14231;14503,20440,0,0,2,0,2
44525,100,9460,14050;14182;18724,20440,0,0,1,2,3
44526,100,9462,13570;14465;19231,20440,0,0,2,1,3
44527,100,9463,13777;14076,20440,0,0,0,2,2
44528,100,9464,14088;14119;18906,20440,0,0,1,2,3
44529,100,9465,14157;14537,20440,0,0,1,1,2
44530,100,9466,14113;14626;19159,20440,0,0,2,1,3
44531,100,9468,14379;14468;18059,20440,0,0,3,0,3
44532,100,9470,13784;14161,20440,0,0,0,2,2
44533,100,9471,14436;14747,20440,0,0,2,0,2
44534,100,9472,13837,20440,0,0,0,1,1
44535,100,9473,14215;14458,20440,0,0,1,1,2
44536,100,9474,14134;14376;19771,20440,0,0,2,1,3
44537,100,9475,14147;14242,20440,0,0,1,1,2
44538,100,9476,13987;14243,20440,0,0,1,1,2
44539,100,9477,14256;14611,20440,0,0,2,0,2
44540,100,9478,13738;14269,20440,0,0,1,1,2
44541,100,9479,14292;18633,20440,0,0,2,0,2
44542,100,9480,14317;14354,20440,0,0,2,0,2
44543,100,9481,14319;14435,20440,0,0,2,0,2
44544,100,9482,14344;14638,20440,0,0,2,0,2
44545,100,9484,10102,20805,0,0,0,1,1
44546,100,9501,11400,20805,0,0,0,1,1
44547,100,9509,11925;12172,20805,0,0,0,2,2
44548,100,9513,12320,20805,0,0,0,1,1
44549,100,9515,12058,20805,0,0,0,1,1
44550,100,9518,12591;12657,20805,0,0,0,2,2
44551,100,9520,12983;13378,20805,0,0,0,2,2
44552,100,9522,12849,20805,0,0,0,1,1
44553,100,9523,12819,20805,0,0,0,1,1
44554,100,9525,12636;12841,20805,0,0,0,2,2
44555,100,9528,13459,20805,0,0,0,1,1
44556,100,9529,13157;13785,20805,0,0,0,2,2
44557,100,9530,12999;13819;17744,20805,0,0,1,2,3
44558,100,9532,13188,20805,0,0,0,1,1
44559,100,9533,14334;17770,20805,0,0,2,0,2
44560,100,9534,13346;13859,20805,0,0,0,2,2
44561,100,9535,13356;13510,20805,0,0,0,2,2
44562,100,9537,13405;14205,20805,0,0,0,2,2
44563,100,9538,13082;13368,20805,0,0,0,2,2
44564,100,9539,13451;13962,20805,0,0,0,2,2
44565,100,9540,14011;14308,20805,0,0,1,1,2
44566,100,9541,13492;13739,20805,0,0,0,2,2
44567,100,9542,13546;14126,20805,0,0,0,2,2
44568,100,9543,13581,20805,0,0,0,1,1
44569,100,9544,14252;17594,20805,0,0,2,0,2
44570,100,9545,13173,20805,0,0,0,1,1
44571,100,9546,13662;13807,20805,0,0,0,2,2
44572,100,9547,13441;13684;18634,20805,0,0,1,2,3
44573,100,9548,13776;14038,20805,0,0,0,2,2
44574,100,9549,13840;14446,20805,0,0,1,1,2
44575,100,9550,13836;13972,20805,0,0,0,2,2
44576,100,9552,13881;14139,20805,0,0,0,2,2
44577,100,9553,13862;14162,20805,0,0,0,2,2
44578,100,9554,14109;14276,20805,0,0,1,1,2
44579,100,9555,13168;13882,20805,0,0,0,2,2
44580,100,9557,14449;14621,20805,0,0,2,0,2
44581,100,9558,14043;14072,20805,0,0,0,2,2
44582,100,9559,13952;14048,20805,0,0,0,2,2
44583,100,9560,14051;14108;18359,20805,0,0,1,2,3
44584,100,9561,14595,20805,0,0,1,0,1
44585,100,9562,14118;18806,20805,0,0,1,1,2
44586,100,9563,14132,20805,0,0,0,1,1
44587,100,9564,13733;14146,20805,0,0,0,2,2
44588,100,9565,14845,20805,0,0,1,0,1
44589,100,9566,14151;18689,20805,0,0,1,1,2
44590,100,9567,14093;14478;18073;18428;19970,20805,0,0,4,1,5
44591,100,9568,13742;14194,20805,0,0,0,2,2
44592,100,9569,15122,20805,0,0,1,0,1
44593,100,9570,14202;14214,20805,0,0,0,2,2
44594,100,9571,13916;14230,20805,0,0,1,1,2
44595,100,9572,14232;14661,20805,0,0,2,0,2
44596,100,9573,13865;14500,20805,0,0,1,1,2
44597,100,9574,14532;19464;19830,20805,0,0,3,0,3
44598,100,9575,13829;14253,20805,0,0,1,1,2
44599,100,9576,14289;19314,20805,0,0,2,0,2
44600,100,9577,14602;14637;17999;19301;21945,20805,1,0,4,0,5
44601,100,9578,14395;14822,20805,0,0,2,0,2
44602,100,9579,14061;14418,20805,0,0,1,1,2
44603,100,9580,14558;14678,20805,0,0,2,0,2
44604,100,9582,14212;14459,20805,0,0,1,1,2
44605,100,9583,14563,20805,0,0,1,0,1
44606,100,9584,14778;14800,20805,0,0,2,0,2
44607,100,9599,11453,21170,0,0,0,1,1
44608,100,9605,11972,21170,0,0,0,1,1
44609,100,9606,11812;12381,21170,0,0,0,2,2
44610,100,9608,12912,21170,0,0,0,1,1
44611,100,9613,12262;12361,21170,0,0,0,2,2
44612,100,9614,12512,21170,0,0,0,1,1
44613,100,9615,12984;13526,21170,0,0,0,2,2
44614,100,9616,12448;12506,21170,0,0,0,2,2
44615,100,9620,12271,21170,0,0,0,1,1
44616,100,9621,12649;12923,21170,0,0,0,2,2
44617,100,9623,12752;12899,21170,0,0,0,2,2
44618,100,9627,12913;12940,21170,0,0,0,2,2
44619,100,9628,13603,21170,0,0,0,1,1
44620,100,9629,12982;13333,21170,0,0,0,2,2
44621,100,9631,13281,21170,0,0,0,1,1
44622,100,9632,12918;13635,21170,0,0,0,2,2
44623,100,9633,13199;13490,21170,0,0,0,2,2
44624,100,9638,13284;13427,21170,0,0,0,2,2
44625,100,9641,13502,21170,0,0,0,1,1
44626,100,9642,13782;13929,21170,0,0,0,2,2
44627,100,9644,14262;17856;20262,21170,0,1,2,0,3
44628,100,9645,13589;13762,21170,0,0,0,2,2
44629,100,9646,14223;19548,21170,0,0,2,0,2
44630,100,9647,13828,21170,0,0,0,1,1
44631,100,9649,13631;13866,21170,0,0,0,2,2
44632,100,9652,13751;13896,21170,0,0,0,2,2
44633,100,9653,13479;13675,21170,0,0,0,2,2
44634,100,9654,13478;13552,21170,0,0,0,2,2
44635,100,9655,14368,21170,0,0,1,0,1
44636,100,9656,13989;18173;19614,21170,0,0,2,1,3
44637,100,9657,14026,21170,0,0,0,1,1
44638,100,9658,13981;14448,21170,0,0,1,1,2
44639,100,9659,14056,21170,0,0,0,1,1
44640,100,9660,13969;14067,21170,0,0,0,2,2
44641,100,9661,14828;19416,21170,0,0,2,0,2
44642,100,9663,17311;18338;18614;18938;21621,21170,1,0,4,0,5
44643,100,9664,14010;14164,21170,0,0,0,2,2
44644,100,9665,14166;14707;18446,21170,0,0,2,1,3
44645,100,9666,13928;14203,21170,0,0,0,2,2
44646,100,9667,14018;14229,21170,0,0,1,1,2
44647,100,9668,14015;14585,21170,0,0,1,1,2
44648,100,9670,14322;14733,21170,0,0,2,0,2
44649,100,9671,13748;14353;18964,21170,0,0,2,1,3
44650,100,9672,14572;14694;17964;18438;19275,21170,0,0,5,0,5
44651,100,9673,13538;13861,21170,0,0,0,2,2
44652,100,9674,14943,21170,0,0,1,0,1
44653,100,9675,14193;14399,21170,0,0,1,1,2
44654,100,9676,14414;14415;18243;18593,21170,0,0,4,0,4
44655,100,9677,14429;14719,21170,0,0,2,0,2
44656,100,9678,14021;14434;18966,21170,0,0,2,1,3
44657,100,9679,13838;14479,21170,0,0,1,1,2
44658,100,9680,14797;14908,21170,0,0,2,0,2
44659,100,9681,14736;14768,21170,0,0,2,0,2
44660,100,9682,14062;14485,21170,0,0,1,1,2
44661,100,9683,13850;14263,21170,0,0,1,1,2
44662,100,9684,14175;14525,21170,0,0,1,1,2
44663,100,9685,14484;14761;20212,21170,0,0,3,0,3
44664,100,9686,14483;14547;19593,21170,0,0,3,0,3
44665,100,9687,14823;18390;20008,21170,0,0,3,0,3
44666,100,9688,14227;14555,21170,0,0,2,0,2
44667,100,9689,14708;15013;17349,21170,0,0,3,0,3
44668,100,9690,14045;19450,21170,0,0,1,1,2
44669,100,9691,14475;14608,21170,0,0,2,0,2
44670,100,9692,14616;14930,21170,0,0,2,0,2
44671,100,9694,10079,21535,0,0,0,1,1
44672,100,9696,10357,21535,0,0,0,1,1
44673,100,9697,10536,21535,0,0,0,1,1
44674,100,9708,12389,21535,0,0,0,1,1
44675,100,9710,12033,21535,0,0,0,1,1
44676,100,9712,12200,21535,0,0,0,1,1
44677,100,9715,12094,21535,0,0,0,1,1
44678,100,9717,12860;13128,21535,0,0,0,2,2
44679,100,9718,12390,21535,0,0,0,1,1
44680,100,9720,13243,21535,0,0,0,1,1
44681,100,9722,12677;12787;17776,21535,0,0,1,2,3
44682,100,9726,12619;12988,21535,0,0,0,2,2
44683,100,9727,13512,21535,0,0,0,1,1
44684,100,9729,12762;13414,21535,0,0,0,2,2
44685,100,9731,13245,21535,0,0,0,1,1
44686,100,9732,13251,21535,0,0,0,1,1
44687,100,9733,13408;13725,21535,0,0,0,2,2
44688,100,9734,13758,21535,0,0,0,1,1
44689,100,9736,12887;13540,21535,0,0,0,2,2
44690,100,9738,13358;13960,21535,0,0,0,2,2
44691,100,9739,13381;13412,21535,0,0,0,2,2
44692,100,9740,13627;13770,21535,0,0,0,2,2
44693,100,9741,13073;13701,21535,0,0,0,2,2
44694,100,9742,13880;14077,21535,0,0,0,2,2
44695,100,9743,14033,21535,0,0,0,1,1
44696,100,9744,14278,21535,0,0,1,0,1
44697,100,9745,13605;14065,21535,0,0,0,2,2
44698,100,9746,14698;14704;19262,21535,0,0,3,0,3
44699,100,9747,13795,21535,0,0,0,1,1
44700,100,9749,13614;13843;18255,21535,0,0,1,2,3
44701,100,9750,14425,21535,0,0,1,0,1
44702,100,9751,13737;13995,21535,0,0,0,2,2
44703,100,9752,13949;14517,21535,0,0,1,1,2
44704,100,9753,13494;13965,21535,0,0,0,2,2
44705,100,9754,19108;19288;19671,21535,0,0,3,0,3
44706,100,9756,14441,21535,0,0,1,0,1
44707,100,9757,14004,21535,0,0,0,1,1
44708,100,9758,18488;19030,21535,0,0,2,0,2
44709,100,9760,13286;14081,21535,0,0,0,2,2
44710,100,9761,14083;14965;18140;18260;19560;20059;21952,21535,1,0,5,1,7
44711,100,9762,14767,21535,0,0,1,0,1
44712,100,9763,13507;14142;18304,21535,0,0,1,2,3
44713,100,9764,14165;14409;19021,21535,0,0,2,1,3
44714,100,9765,14112;14548,21535,0,0,1,1,2
44715,100,9766,14066;14571;18649,21535,0,0,2,1,3
44716,100,9767,14336,21535,0,0,1,0,1
44717,100,9768,14211;14726;19002,21535,0,0,2,1,3
44718,100,9769,13921;14220,21535,0,0,0,2,2
44719,100,9770,14179;14241,21535,0,0,1,1,2
44720,100,9771,14578,21535,0,0,1,0,1
44721,100,9772,14012,21535,0,0,0,1,1
44722,100,9773,14789;14976,21535,0,0,2,0,2
44723,100,9774,14849;18976,21535,0,0,2,0,2
44724,100,9775,13686;14378,21535,0,0,1,1,2
44725,100,9776,14763,21535,0,0,1,0,1
44726,100,9777,14239;14630,21535,0,0,2,0,2
44727,100,9778,14372;14857;18013;18384,21535,0,0,4,0,4
44728,100,9779,14406;19583,21535,0,0,2,0,2
44729,100,9780,14521;14540,21535,0,0,2,0,2
44730,100,9781,14069;14413,21535,0,0,1,1,2
44731,100,9782,14316;14417,21535,0,0,2,0,2
44732,100,9783,14270;14453,21535,0,0,2,0,2
44733,100,9784,14103;14470,21535,0,0,1,1,2
44734,100,9785,15139,21535,0,0,1,0,1
44735,100,9786,15058;19742,21535,0,0,2,0,2
44736,100,9787,14247;14496;19634,21535,0,0,3,0,3
44737,100,9788,14456;14618;18774;22007,21535,1,0,3,0,4
44738,100,9789,14523,21535,0,0,1,0,1
44739,100,9790,14544,21535,0,0,1,0,1
44740,100,9791,14573;14586,21535,0,0,2,0,2
44741,100,9792,14581,21535,0,0,1,0,1
44742,100,9793,14091;14615,21535,0,0,1,1,2
44743,100,9794,14779;19028,21535,0,0,2,0,2
44744,100,9795,14860;15099,21535,0,0,2,0,2
44745,100,9796,14454;18932,21535,0,0,2,0,2
44746,100,9797,14326;18602;18913,21535,0,0,3,0,3
44747,100,9798,14660;14723;18745,21535,0,0,3,0,3
44748,100,9799,14433;14731,21535,0,0,2,0,2
44749,100,9800,14735;14816,21535,0,0,2,0,2
44750,100,9801,14743;14842;19359,21535,0,0,3,0,3
44751,100,9815,11148,21900,0,0,0,1,1
44752,100,9819,11459,21900,0,0,0,1,1
44753,100,9820,11547,21900,0,0,0,1,1
44754,100,9824,12647,21900,0,0,0,1,1
44755,100,9825,12354;17760,21900,0,0,1,1,2
44756,100,9826,12708,21900,0,0,0,1,1
44757,100,9831,13111,21900,0,0,0,1,1
44758,100,9832,13000,21900,0,0,0,1,1
44759,100,9837,13113;13711,21900,0,0,0,2,2
44760,100,9839,13279;13652,21900,0,0,0,2,2
44761,100,9840,13207;13224,21900,0,0,0,2,2
44762,100,9841,13397,21900,0,0,0,1,1
44763,100,9842,13261,21900,0,0,0,1,1
44764,100,9843,13164;13504,21900,0,0,0,2,2
44765,100,9844,13555;13781,21900,0,0,0,2,2
44766,100,9845,13476;13536,21900,0,0,0,2,2
44767,100,9847,13156;13625,21900,0,0,0,2,2
44768,100,9849,14432;19313,21900,0,0,2,0,2
44769,100,9850,13718,21900,0,0,0,1,1
44770,100,9851,13786;14274,21900,0,0,1,1,2
44771,100,9852,14305,21900,0,0,1,0,1
44772,100,9853,13827;14079,21900,0,0,0,2,2
44773,100,9854,13956,21900,0,0,0,1,1
44774,100,9856,13997,21900,0,0,0,1,1
44775,100,9857,14001;14200,21900,0,0,0,2,2
44776,100,9858,13074;13874,21900,0,0,0,2,2
44777,100,9859,13664;14222;17885,21900,0,0,2,1,3
44778,100,9861,14084;14727,21900,0,0,1,1,2
44779,100,9862,14516;14762;19207,21900,0,0,3,0,3
44780,100,9863,14758;15325,21900,0,0,2,0,2
44781,100,9864,13939;14095,21900,0,0,0,2,2
44782,100,9865,14007;14195,21900,0,0,0,2,2
44783,100,9866,14773;19138;19655,21900,0,0,3,0,3
44784,100,9868,14297;14394,21900,0,0,2,0,2
44785,100,9869,14302;14893;20299,21900,0,1,2,0,3
44786,100,9870,14593;14832;18702;19149;22030,21900,1,0,4,0,5
44787,100,9871,15003;19378,21900,0,0,2,0,2
44788,100,9872,14290;14345,21900,0,0,2,0,2
44789,100,9873,14333;14355,21900,0,0,2,0,2
44790,100,9874,14296;14364,21900,0,0,2,0,2
44791,100,9875,13788,21900,0,0,0,1,1
44792,100,9876,14463;14594;18580,21900,0,0,3,0,3
44793,100,9877,14197;14864;20032,21900,0,0,2,1,3
44794,100,9878,13869;14753;19225,21900,0,0,2,1,3
44795,100,9879,13846;14430;19326,21900,0,0,2,1,3
44796,100,9881,14813,21900,0,0,1,0,1
44797,100,9882,14843;15051;19561,21900,0,0,3,0,3
44798,100,9883,14492;14524;18712,21900,0,0,3,0,3
44799,100,9884,14385;14819,21900,0,0,2,0,2
44800,100,9885,15331;19214,21900,0,0,2,0,2
44801,100,9886,14371;14641;19367,21900,0,0,3,0,3
44802,100,9887,14560;14689,21900,0,0,2,0,2
44803,100,9888,14472;14567,21900,0,0,2,0,2
44804,100,9890,14599;14622,21900,0,0,2,0,2
44805,100,9891,14624;15313,21900,0,0,2,0,2
44806,100,9892,14096;14628;19877,21900,0,0,2,1,3
44807,100,9893,14445;14635,21900,0,0,2,0,2
44808,100,9894,14668,21900,0,0,1,0,1
44809,100,9895,14669;15005,21900,0,0,2,0,2
44810,100,9896,15229;15593,21900,0,0,2,0,2
44811,100,9897,14683,21900,0,0,1,0,1
44812,100,9899,14428;15056;18962;19276,21900,0,0,4,0,4
44813,100,9900,14717;14749,21900,0,0,2,0,2
44814,100,9901,14927;15265;18432;19012;19537,21900,0,0,5,0,5
44815,100,9902,15283,21900,0,0,1,0,1
44816,100,9903,15035;15305;19695,21900,0,0,3,0,3
44817,100,9904,14391;14649,21900,0,0,2,0,2
44818,100,9905,10881,22265,0,0,0,1,1
44819,100,9910,10444,22265,0,0,0,1,1
44820,100,9925,12325;12544,22265,0,0,0,2,2
44821,100,9932,13119,22265,0,0,0,1,1
44822,100,9934,13500,22265,0,0,0,1,1
44823,100,9938,13456;14082,22265,0,0,0,2,2
44824,100,9939,13521;13697,22265,0,0,0,2,2
44825,100,9940,14183;14250;18629,22265,0,0,2,1,3
44826,100,9941,13604,22265,0,0,0,1,1
44827,100,9942,13728,22265,0,0,0,1,1
44828,100,9943,13775,22265,0,0,0,1,1
44829,100,9944,14311,22265,0,0,1,0,1
44830,100,9946,13810;13847,22265,0,0,0,2,2
44831,100,9947,13864;13915,22265,0,0,0,2,2
44832,100,9948,14106;14338,22265,0,0,1,1,2
44833,100,9951,13994,22265,0,0,0,1,1
44834,100,9952,13922,22265,0,0,0,1,1
44835,100,9953,13505;14159;19595;22047,22265,1,0,1,2,4
44836,100,9954,14268;14541,22265,0,0,2,0,2
44837,100,9955,14258;14713;19095,22265,0,0,3,0,3
44838,100,9956,13759;14170,22265,0,0,0,2,2
44839,100,9957,14122;14254,22265,0,0,1,1,2
44840,100,9958,14724;20127,22265,0,0,2,0,2
44841,100,9959,14180,22265,0,0,0,1,1
44842,100,9960,14920;19611,22265,0,0,2,0,2
44843,100,9961,14301;15320;19566,22265,0,0,3,0,3
44844,100,9962,14309;14889,22265,0,0,2,0,2
44845,100,9964,14172,22265,0,0,0,1,1
44846,100,9965,14377;14900,22265,0,0,2,0,2
44847,100,9966,14383;14703,22265,0,0,2,0,2
44848,100,9967,14156;14388,22265,0,0,1,1,2
44849,100,9968,18202,22265,0,0,1,0,1
44850,100,9969,14464;17786,22265,0,0,2,0,2
44851,100,9970,14476;14631,22265,0,0,2,0,2
44852,100,9971,14493;15031,22265,0,0,2,0,2
44853,100,9973,14104;14553;19709,22265,0,0,2,1,3
44854,100,9974,14569;14796,22265,0,0,2,0,2
44855,100,9975,14771;18721;19399,22265,0,0,3,0,3
44856,100,9979,15263;18997;19770,22265,0,0,3,0,3
44857,100,9980,14640;15178,22265,0,0,2,0,2
44858,100,9981,14307;14670,22265,0,0,2,0,2
44859,100,9982,14411;14671;17740,22265,0,0,3,0,3
44860,100,9983,15220;15231;19402,22265,0,0,3,0,3
44861,100,9984,14422;14721,22265,0,0,2,0,2
44862,100,9985,14421;14742;17069,22265,0,0,3,0,3
44863,100,9987,14528;14869,22265,0,0,2,0,2
44864,100,9988,14583;14803;19414;19705,22265,0,0,4,0,4
44865,100,9990,15142;15304;19270;19766,22265,0,0,4,0,4
44866,100,9991,14488;14877,22265,0,0,2,0,2
44867,100,9992,14562;14879;19570,22265,0,0,3,0,3
44868,100,9993,14542;14757;18250,22265,0,0,3,0,3
44869,100,9995,14729;15462;19026,22265,0,0,3,0,3
44870,100,9997,14315;15083;18644;21992,22265,1,0,3,0,4
44871,100,9998,14718;14953,22265,0,0,2,0,2
44872,100,9999,14907;14964;18711;19371,22265,0,0,4,0,4
44873,100,10000,14918;14973,22265,0,0,2,0,2
44874,100,10001,14648;14981;17595;19487,22265,0,0,4,0,4
44875,100,10002,15016;15120,22265,0,0,2,0,2
44876,100,10014,11021,22630,0,0,0,1,1
44877,100,10015,11306,22630,0,0,0,1,1
44878,100,10019,11229,22630,0,0,0,1,1
44879,100,10031,12441;12774,22630,0,0,0,2,2
44880,100,10037,12898;13285,22630,0,0,0,2,2
44881,100,10038,12783,22630,0,0,0,1,1
44882,100,10039,13069,22630,0,0,0,1,1
44883,100,10043,13239,22630,0,0,0,1,1
44884,100,10044,13385;13524,22630,0,0,0,2,2
44885,100,10046,13595;13639,22630,0,0,0,2,2
44886,100,10047,13105;13623,22630,0,0,0,2,2
44887,100,10048,13357;13480,22630,0,0,0,2,2
44888,100,10049,13794;14174,22630,0,0,0,2,2
44889,100,10050,13568,22630,0,0,0,1,1
44890,100,10051,13651;14060,22630,0,0,0,2,2
44891,100,10052,13393;13574,22630,0,0,0,2,2
44892,100,10053,14102;14348,22630,0,0,1,1,2
44893,100,10054,13615;13857,22630,0,0,0,2,2
44894,100,10055,13834;14589,22630,0,0,1,1,2
44895,100,10056,13628;13898,22630,0,0,0,2,2
44896,100,10061,14559,22630,0,0,1,0,1
44897,100,10063,14712;14839,22630,0,0,2,0,2
44898,100,10064,14209;14590,22630,0,0,1,1,2
44899,100,10065,14360;14367,22630,0,0,2,0,2
44900,100,10066,14249;14306,22630,0,0,2,0,2
44901,100,10068,14255;14491;18907;22017,22630,1,0,3,0,4
44902,100,10069,14293;14577,22630,0,0,2,0,2
44903,100,10071,13923;14342,22630,0,0,1,1,2
44904,100,10072,14374,22630,0,0,1,0,1
44905,100,10073,13879;14393,22630,0,0,1,1,2
44906,100,10074,14780,22630,0,0,1,0,1
44907,100,10076,14452;15055,22630,0,0,2,0,2
44908,100,10077,13885;14455,22630,0,0,1,1,2
44909,100,10078,14502,22630,0,0,1,0,1
44910,100,10079,14148;14437,22630,0,0,1,1,2
44911,100,10081,14489;14610,22630,0,0,2,0,2
44912,100,10082,14280;14419,22630,0,0,2,0,2
44913,100,10083,15112;15458,22630,0,0,2,0,2
44914,100,10084,14884;15019,22630,0,0,2,0,2
44915,100,10085,14299;14623,22630,0,0,2,0,2
44916,100,10086,14837,22630,0,0,1,0,1
44917,100,10087,14684;15123;20099,22630,0,0,3,0,3
44918,100,10088,14791;15136;19116,22630,0,0,3,0,3
44919,100,10089,15105;15475;19496;19685;20535,22630,0,1,4,0,5
44920,100,10090,15261;15601;19134;20007,22630,0,0,4,0,4
44921,100,10091,14295;15225;17860,22630,0,0,3,0,3
44922,100,10092,14566;14854;19808,22630,0,0,3,0,3
44923,100,10093,15449;19241;19624,22630,0,0,3,0,3
44924,100,10094,14921,22630,0,0,1,0,1
44925,100,10095,14919;14958,22630,0,0,2,0,2
44926,100,10096,14990,22630,0,0,1,0,1
44927,100,10097,14992;19955,22630,0,0,2,0,2
44928,100,10098,15297;15300,22630,0,0,2,0,2
44929,100,10099,14770;15413;20050;20245,22630,0,1,3,0,4
44930,100,10100,14647;15007;18829,22630,0,0,3,0,3
44931,100,10101,14426;15023,22630,0,0,2,0,2
44932,100,10103,14759;15166,22630,0,0,2,0,2
44933,100,10104,15034,22630,0,0,1,0,1
44934,100,10105,15064;15469,22630,0,0,2,0,2
44935,100,10106,15075;15119;19592,22630,0,0,3,0,3
44936,100,10107,15081;15147,22630,0,0,2,0,2
44937,100,10108,14983;15085;17931;18425,22630,0,0,4,0,4
44938,100,10109,15093;19910,22630,0,0,2,0,2
44939,100,10110,15111;15114,22630,0,0,2,0,2
44940,100,10111,14352;14935,22630,0,0,2,0,2
44941,100,10112,15198;15388,22630,0,0,2,0,2
44942,100,10113,15273;19038,22630,0,0,2,0,2
44943,100,10114,15170;15230,22630,0,0,2,0,2
44944,100,10119,10544,22995,0,0,0,1,1
44945,100,10125,10549,22995,0,0,0,1,1
44946,100,10126,11056,22995,0,0,0,1,1
44947,100,10131,10704,22995,0,0,0,1,1
44948,100,10133,11268,22995,0,0,0,1,1
44949,100,10134,11258,22995,0,0,0,1,1
44950,100,10135,11289,22995,0,0,0,1,1
44951,100,10145,12613;12707,22995,0,0,0,2,2
44952,100,10150,12817,22995,0,0,0,1,1
44953,100,10158,13338,22995,0,0,0,1,1
44954,100,10160,13416;13820,22995,0,0,0,2,2
44955,100,10162,13592;14136;19010,22995,0,0,1,2,3
44956,100,10163,13061;13345,22995,0,0,0,2,2
44957,100,10164,13689;13988,22995,0,0,0,2,2
44958,100,10165,13558,22995,0,0,0,1,1
44959,100,10167,14024,22995,0,0,0,1,1
44960,100,10168,14031;18456,22995,0,0,1,1,2
44961,100,10169,13433;14040,22995,0,0,0,2,2
44962,100,10170,13597;14370;19184;22033,22995,1,0,2,1,4
44963,100,10172,14163;14221;18119;18211,22995,0,0,3,1,4
44964,100,10173,14173;14176;18511,22995,0,0,1,2,3
44965,100,10176,14248;18600,22995,0,0,2,0,2
44966,100,10177,15400;15856;19372;19474,22995,0,0,4,0,4
44967,100,10178,14416;14674;18944,22995,0,0,3,0,3
44968,100,10179,14300;14538,22995,0,0,2,0,2
44969,100,10181,13925;14744,22995,0,0,1,1,2
44970,100,10182,14887;15252;19588,22995,0,0,3,0,3
44971,100,10183,14133;14467;19000,22995,0,0,2,1,3
44972,100,10184,13984;19630;19882,22995,0,0,2,1,3
44973,100,10185,14480;15061,22995,0,0,2,0,2
44974,100,10186,14498;15578;19363;20037;20521,22995,0,1,4,0,5
44975,100,10187,14281;14505,22995,0,0,2,0,2
44976,100,10188,14520;14991;19099;19444,22995,0,0,4,0,4
44977,100,10189,15029,22995,0,0,1,0,1
44978,100,10191,14482;14591;18740,22995,0,0,3,0,3
44979,100,10192,15041,22995,0,0,1,0,1
44980,100,10193,14101;14667;19195,22995,0,0,2,1,3
44981,100,10194,14693;14722,22995,0,0,2,0,2
44982,100,10195,14706,22995,0,0,1,0,1
44983,100,10196,14808;19526,22995,0,0,2,0,2
44984,100,10197,14863,22995,0,0,1,0,1
44985,100,10198,14873;15199,22995,0,0,2,0,2
44986,100,10199,15060;15551;19591,22995,0,0,3,0,3
44987,100,10200,14881;15128,22995,0,0,2,0,2
44988,100,10201,14894;18816;22013,22995,1,0,2,0,3
44989,100,10202,15221;15532;18264;21964,22995,1,0,3,0,4
44990,100,10203,14925;15151;18834;19468,22995,0,0,4,0,4
44991,100,10204,14929;15290;18675,22995,0,0,3,0,3
44992,100,10205,15269;15430;19324,22995,0,0,3,0,3
44993,100,10206,14692;15002;18717,22995,0,0,3,0,3
44994,100,10207,14774;15011;17991,22995,0,0,3,0,3
44995,100,10208,15040;15595,22995,0,0,2,0,2
44996,100,10209,15050;19499,22995,0,0,2,0,2
44997,100,10210,15196;19670,22995,0,0,2,0,2
44998,100,10211,14966;15492,22995,0,0,2,0,2
44999,100,10212,15024;15560;18039;19330;22036,22995,1,0,4,0,5
45000,100,10215,15195;16192,22995,0,0,2,0,2
45001,100,10216,15292;15524;18588,22995,0,0,3,0,3
45002,100,10217,14764;15209;18882;19927,22995,0,0,4,0,4
45003,100,10218,15241;15625,22995,0,0,2,0,2
45004,100,10219,15636;18358,22995,0,0,2,0,2
45005,100,10226,10852,23360,0,0,0,1,1
45006,100,10232,11648,23360,0,0,0,1,1
45007,100,10239,12948,23360,0,0,0,1,1
45008,100,10245,13437;13648;18412,23360,0,0,1,2,3
45009,100,10247,13935;14208,23360,0,0,0,2,2
45010,100,10248,13425;13903;18382,23360,0,0,1,2,3
45011,100,10249,13860;14219;18414,23360,0,0,1,2,3
45012,100,10250,13805;18035,23360,0,0,1,1,2
45013,100,10251,13917;17966,23360,0,0,1,1,2
45014,100,10252,13875,23360,0,0,0,1,1
45015,100,10253,14777;14892,23360,0,0,2,0,2
45016,100,10254,14210;14275,23360,0,0,1,1,2
45017,100,10255,13817;13991,23360,0,0,0,2,2
45018,100,10256,14279;15212;19165,23360,0,0,3,0,3
45019,100,10257,14283;15059;19917;20125,23360,0,0,4,0,4
45020,100,10258,14135;14189,23360,0,0,0,2,2
45021,100,10259,14645;14714;19361,23360,0,0,3,0,3
45022,100,10260,14323;14579,23360,0,0,2,0,2
45023,100,10262,14504,23360,0,0,1,0,1
45024,100,10263,14518,23360,0,0,1,0,1
45025,100,10264,14939,23360,0,0,1,0,1
45026,100,10265,14787;15204;18999,23360,0,0,3,0,3
45027,100,10266,14680;14781,23360,0,0,2,0,2
45028,100,10267,14795;15380;18924,23360,0,0,3,0,3
45029,100,10268,14487;15223;18482,23360,0,0,3,0,3
45030,100,10269,15394;15480;18671,23360,0,0,3,0,3
45031,100,10270,14820;15217;19223,23360,0,0,3,0,3
45032,100,10271,14874;15067;18804;19988,23360,0,0,4,0,4
45033,100,10273,14895;14933;19568;22046,23360,1,0,3,0,4
45034,100,10274,14801;15206;19493,23360,0,0,3,0,3
45035,100,10275,14951,23360,0,0,1,0,1
45036,100,10276,14972;15439;19982,23360,0,0,3,0,3
45037,100,10277,14859;15045,23360,0,0,2,0,2
45038,100,10278,15193;19248,23360,0,0,2,0,2
45039,100,10279,15062;15819,23360,0,0,2,0,2
45040,100,10281,14912;15094,23360,0,0,2,0,2
45041,100,10283,14824;15113,23360,0,0,2,0,2
45042,100,10284,15150;15197,23360,0,0,2,0,2
45043,100,10285,14978;15589;19998,23360,0,0,3,0,3
45044,100,10286,14836;15191;18463,23360,0,0,3,0,3
45045,100,10287,15535;15827,23360,0,0,2,0,2
45046,100,10288,15849;20486,23360,0,1,1,0,2
45047,100,10289,14682;15047,23360,0,0,2,0,2
45048,100,10290,14659;15227;18713,23360,0,0,3,0,3
45049,100,10291,14886;15260,23360,0,0,2,0,2
45050,100,10292,15310;15419;20061,23360,0,0,3,0,3
45051,100,10293,15288;15809;19621;19867,23360,0,0,4,0,4
45052,100,10294,14702;15334,23360,0,0,2,0,2
45053,100,10295,15240;15348;18192;20304;21957,23360,1,1,3,0,5
45054,100,10296,15322;15474,23360,0,0,2,0,2
45055,100,10297,15363,23360,0,0,1,0,1
45056,100,10298,15091;15592,23360,0,0,2,0,2
45057,100,10299,15710;15855;20131,23360,0,0,3,0,3
45058,100,10300,15203;15667,23360,0,0,2,0,2
45059,100,10302,15440;15712;20989,23360,0,1,2,0,3
45060,100,10303,15441;19726;19781,23360,0,0,3,0,3
45061,100,10305,15818,23360,0,0,1,0,1
45062,100,10306,14679;15467;19373,23360,0,0,3,0,3
45063,100,10309,11134,23725,0,0,0,1,1
45064,100,10314,11351,23725,0,0,0,1,1
45065,100,10318,11921,23725,0,0,0,1,1
45066,100,10319,11566;12102,23725,0,0,0,2,2
45067,100,10325,12869,23725,0,0,0,1,1
45068,100,10327,12868;13167,23725,0,0,0,2,2
45069,100,10331,12826;13282,23725,0,0,0,2,2
45070,100,10333,13376;13765,23725,0,0,0,2,2
45071,100,10336,13288;13567,23725,0,0,0,2,2
45072,100,10340,13992,23725,0,0,0,1,1
45073,100,10344,13911;13977,23725,0,0,0,2,2
45074,100,10346,14407;14686;18673,23725,0,0,3,0,3
45075,100,10352,14754,23725,0,0,1,0,1
45076,100,10354,14499;14833,23725,0,0,2,0,2
45077,100,10355,14511,23725,0,0,1,0,1
45078,100,10356,14357;14519,23725,0,0,2,0,2
45079,100,10357,14075;14550;18554,23725,0,0,2,1,3
45080,100,10358,14324;14574;19620,23725,0,0,3,0,3
45081,100,10359,14650;14739;18136;18990,23725,0,0,4,0,4
45082,100,10360,14129;14691;18650;19736,23725,0,0,3,1,4
45083,100,10361,14461;14738,23725,0,0,2,0,2
45084,100,10362,14439;14756,23725,0,0,2,0,2
45085,100,10363,14810;18084,23725,0,0,2,0,2
45086,100,10364,15022;15830,23725,0,0,2,0,2
45087,100,10365,15301;15424,23725,0,0,2,0,2
45088,100,10366,14858,23725,0,0,1,0,1
45089,100,10367,14447;14868,23725,0,0,2,0,2
45090,100,10368,15487;16322;19456;19971,23725,0,0,4,0,4
45091,100,10369,15097,23725,0,0,1,0,1
45092,100,10370,14271;14913,23725,0,0,2,0,2
45093,100,10371,14695;14924,23725,0,0,2,0,2
45094,100,10372,15200;15270;19113,23725,0,0,3,0,3
45095,100,10373,14568;14948;20252,23725,0,1,2,0,3
45096,100,10375,14582;14750,23725,0,0,2,0,2
45097,100,10376,15010;15205,23725,0,0,2,0,2
45098,100,10378,15036,23725,0,0,1,0,1
45099,100,10379,15044;15048;19504;20219,23725,0,0,4,0,4
45100,100,10380,14968,23725,0,0,1,0,1
45101,100,10381,15049;15233,23725,0,0,2,0,2
45102,100,10382,14826;15464;18755,23725,0,0,3,0,3
45103,100,10383,14902;15038;20289,23725,0,1,2,0,3
45104,100,10384,15098;15202;18280,23725,0,0,3,0,3
45105,100,10385,15429,23725,0,0,1,0,1
45106,100,10386,14087;15137,23725,0,0,1,1,2
45107,100,10387,15107,23725,0,0,1,0,1
45108,100,10389,14587,23725,0,0,1,0,1
45109,100,10390,14998;15489,23725,0,0,2,0,2
45110,100,10391,15398,23725,0,0,1,0,1
45111,100,10392,15311;19508,23725,0,0,2,0,2
45112,100,10393,15181;15332,23725,0,0,2,0,2
45113,100,10394,15153;15342;19200;19794,23725,0,0,4,0,4
45114,100,10395,15108;15308;19627,23725,0,0,3,0,3
45115,100,10397,14944;15881;18977,23725,0,0,3,0,3
45116,100,10398,15695;18284,23725,0,0,2,0,2
45117,100,10399,15763,23725,0,0,1,0,1
45118,100,10400,15391,23725,0,0,1,0,1
45119,100,10402,15973;16007;19622;19722,23725,0,0,4,0,4
45120,100,10403,15101;15425,23725,0,0,2,0,2
45121,100,10404,15432;15858,23725,0,0,2,0,2
45122,100,10405,15192;15453;19114,23725,0,0,3,0,3
45123,100,10406,15184;15466,23725,0,0,2,0,2
45124,100,10407,15456;15848,23725,0,0,2,0,2
45125,100,10408,15164;15478;19789,23725,0,0,3,0,3
45126,100,10409,15483;15749,23725,0,0,2,0,2
45127,100,10410,14931;15500;18302;20076;20253,23725,0,1,4,0,5
45128,100,10411,15501;15941,23725,0,0,2,0,2
45129,100,10412,15504;15675;19607;20242,23725,0,1,3,0,4
45130,100,10413,15507;15664,23725,0,0,2,0,2
45131,100,10414,15396;15582;19501,23725,0,0,3,0,3
45132,100,10415,15614;16031;20442,23725,0,1,2,0,3
45133,100,10416,15654;15904,23725,0,0,2,0,2
45134,100,10417,15547;15990;20287,23725,0,1,2,0,3
45135,100,10418,15359;15550,23725,0,0,2,0,2
45136,100,10419,15556,23725,0,0,1,0,1
45137,100,10420,14769;15564;19479,23725,0,0,3,0,3
45138,100,10421,15286;15597;18313,23725,0,0,3,0,3
45139,100,10433,11433,24090,0,0,0,1,1
45140,100,10442,12342,24090,0,0,0,1,1
45141,100,10446,12306,24090,0,0,0,1,1
45142,100,10448,12840,24090,0,0,0,1,1
45143,100,10449,13058;13452,24090,0,0,0,2,2
45144,100,10452,13583;13764,24090,0,0,0,2,2
45145,100,10453,13352;13886,24090,0,0,0,2,2
45146,100,10458,13399;13727,24090,0,0,0,2,2
45147,100,10462,14039;14494,24090,0,0,1,1,2
45148,100,10463,14313;14450,24090,0,0,2,0,2
45149,100,10468,14829;14840,24090,0,0,2,0,2
45150,100,10469,14286;14746;19646,24090,0,0,3,0,3
45151,100,10470,14794,24090,0,0,1,0,1
45152,100,10471,14664,24090,0,0,1,0,1
45153,100,10478,15420;19887;22053,24090,1,0,2,0,3
45154,100,10479,14916;15132,24090,0,0,2,0,2
45155,100,10481,14851;18946;19425,24090,0,0,3,0,3
45156,100,10483,14903;15087,24090,0,0,2,0,2
45157,100,10484,14956;14967;18839;19729,24090,0,0,4,0,4
45158,100,10485,14970;14986,24090,0,0,2,0,2
45159,100,10486,14675;14997,24090,0,0,2,0,2
45160,100,10488,15406,24090,0,0,1,0,1
45161,100,10489,14818,24090,0,0,1,0,1
45162,100,10490,15070;15542,24090,0,0,2,0,2
45163,100,10491,14811;15043;19208,24090,0,0,3,0,3
45164,100,10492,15892;20370,24090,0,1,1,0,2
45165,100,10493,15246,24090,0,0,1,0,1
45166,100,10494,14891;15555;19337;20342,24090,0,1,3,0,4
45167,100,10495,15131;15375,24090,0,0,2,0,2
45168,100,10496,14993;15134;18685,24090,0,0,3,0,3
45169,100,10497,15141;15786;19848,24090,0,0,3,0,3
45170,100,10498,14982;15172,24090,0,0,2,0,2
45171,100,10500,14672;15294;19127,24090,0,0,3,0,3
45172,100,10501,15222;15367;19795,24090,0,0,3,0,3
45173,100,10502,15126;16050;19332;20649,24090,0,1,3,0,4
45174,100,10503,15250,24090,0,0,1,0,1
45175,100,10504,15275;15872,24090,0,0,2,0,2
45176,100,10505,15586;15754;19862,24090,0,0,3,0,3
45177,100,10506,15696;15760;19118,24090,0,0,3,0,3
45178,100,10507,15730;15811,24090,0,0,2,0,2
45179,100,10508,15207;15326;20209,24090,0,0,3,0,3
45180,100,10509,15249;15338,24090,0,0,2,0,2
45181,100,10510,14940;15339;18813;22012,24090,1,0,3,0,4
45182,100,10511,15361;18928;20536,24090,0,1,2,0,3
45183,100,10512,15402;15902,24090,0,0,2,0,2
45184,100,10513,15421;15869,24090,0,0,2,0,2
45185,100,10514,15426,24090,0,0,1,0,1
45186,100,10515,15427;15650,24090,0,0,2,0,2
45187,100,10516,15008,24090,0,0,1,0,1
45188,100,10517,16103;20254,24090,0,1,1,0,2
45189,100,10518,15350;15444,24090,0,0,2,0,2
45190,100,10519,15496;15622,24090,0,0,2,0,2
45191,100,10520,15506;15831,24090,0,0,2,0,2
45192,100,10521,15316;15530;20029,24090,0,0,3,0,3
45193,100,10522,15284;15581;19218;19812,24090,0,0,4,0,4
45194,100,10523,15012;15583;19264,24090,0,0,3,0,3
45195,100,10524,15307,24090,0,0,1,0,1
45196,100,10525,15262;15613,24090,0,0,2,0,2
45197,100,10526,15615;16024,24090,0,0,2,0,2
45198,100,10527,15671;15799;19873,24090,0,0,3,0,3
45199,100,10528,15635;15655,24090,0,0,2,0,2
45200,100,10530,15649;15891;20164,24090,0,0,3,0,3
45201,100,10531,15660;15835,24090,0,0,2,0,2
45202,100,10532,15562;15926,24090,0,0,2,0,2
45203,100,10533,15680;15741,24090,0,0,2,0,2
45204,100,10534,15540;15689;19498,24090,0,0,3,0,3
45205,100,10536,10950,24455,0,0,0,1,1
45206,100,10541,11230,24455,0,0,0,1,1
45207,100,10544,11670;11767,24455,0,0,0,2,2
45208,100,10559,13342;13750;18535,24455,0,0,1,2,3
45209,100,10562,13529,24455,0,0,0,1,1
45210,100,10565,13798,24455,0,0,0,1,1
45211,100,10570,14481;14654,24455,0,0,2,0,2
45212,100,10572,13998;14185,24455,0,0,0,2,2
45213,100,10573,15282;15678,24455,0,0,2,0,2
45214,100,10579,14490,24455,0,0,1,0,1
45215,100,10580,14273;14644,24455,0,0,2,0,2
45216,100,10581,14396,24455,0,0,1,0,1
45217,100,10582,14865;14890,24455,0,0,2,0,2
45218,100,10583,14277;14711,24455,0,0,2,0,2
45219,100,10584,14841;14844;19507,24455,0,0,3,0,3
45220,100,10585,14662,24455,0,0,1,0,1
45221,100,10586,15215;15727;18751;19653,24455,0,0,4,0,4
45222,100,10590,14457;14752,24455,0,0,2,0,2
45223,100,10591,15092;15355;19292,24455,0,0,3,0,3
45224,100,10592,14294;14605,24455,0,0,2,0,2
45225,100,10595,15030;19469,24455,0,0,2,0,2
45226,100,10596,14946;15096,24455,0,0,2,0,2
45227,100,10597,15037;15569;19916,24455,0,0,3,0,3
45228,100,10600,15149;20279,24455,0,1,1,0,2
45229,100,10601,15169;15251;19235,24455,0,0,3,0,3
45230,100,10602,15146,24455,0,0,1,0,1
45231,100,10603,14513;15168;19535,24455,0,0,3,0,3
45232,100,10604,15360,24455,0,0,1,0,1
45233,100,10605,14898;15174;19007,24455,0,0,3,0,3
45234,100,10606,15677;16140;20527,24455,0,1,2,0,3
45235,100,10607,15405;15742;19081;20922,24455,0,1,3,0,4
45236,100,10608,15296;16035;19571,24455,0,0,3,0,3
45237,100,10609,15302;15854,24455,0,0,2,0,2
45238,100,10610,15086;15523,24455,0,0,2,0,2
45239,100,10612,15621;15937;20016,24455,0,0,3,0,3
45240,100,10613,15106;15386;20248,24455,0,1,2,0,3
45241,100,10614,15442;19853,24455,0,0,2,0,2
45242,100,10615,14772;15454;19348,24455,0,0,3,0,3
45243,100,10617,15497;15505,24455,0,0,2,0,2
45244,100,10618,16063;16152;19554,24455,0,0,3,0,3
45245,100,10620,15544;15594,24455,0,0,2,0,2
45246,100,10622,15565;15669,24455,0,0,2,0,2
45247,100,10623,15584;15808;19290,24455,0,0,3,0,3
45248,100,10624,15895,24455,0,0,1,0,1
45249,100,10625,15362;15927;19485;19793,24455,0,0,4,0,4
45250,100,10626,14871;15642,24455,0,0,2,0,2
45251,100,10627,16182;20046,24455,0,0,2,0,2
45252,100,10629,15568;15700,24455,0,0,2,0,2
45253,100,10630,15684;15703,24455,0,0,2,0,2
45254,100,10632,15335;15714,24455,0,0,2,0,2
45255,100,10633,15721;15874,24455,0,0,2,0,2
45256,100,10634,15729;15736,24455,0,0,2,0,2
45257,100,10635,15549;15868;20674,24455,0,1,2,0,3
45258,100,10636,15644;16275,24455,0,0,2,0,2
45259,100,10637,16011;16330;20168,24455,0,0,3,0,3
45260,100,10638,15346;15770,24455,0,0,2,0,2
45261,100,10639,15494;15772;19674;20352,24455,0,1,3,0,4
45262,100,10640,16273;18316;20482,24455,0,1,2,0,3
45263,100,10641,15798;15964;20502,24455,0,1,2,0,3
45264,100,10642,15826,24455,0,0,1,0,1
45265,100,10643,15541;16049;20281,24455,0,1,2,0,3
45266,100,10644,15857;16173;19061;19704;22026,24455,1,0,4,0,5
45267,100,10645,15866;16243,24455,0,0,2,0,2
45268,100,10646,15711;15882;20298,24455,0,1,2,0,3
45269,100,10647,15274;15691,24455,0,0,2,0,2
45270,100,10649,11214,24820,0,0,0,1,1
45271,100,10654,11331,24820,0,0,0,1,1
45272,100,10655,11840,24820,0,0,0,1,1
45273,100,10658,11911,24820,0,0,0,1,1
45274,100,10664,12157,24820,0,0,0,1,1
45275,100,10666,11950;12343,24820,0,0,0,2,2
45276,100,10671,12945,24820,0,0,0,1,1
45277,100,10673,13187;13645,24820,0,0,0,2,2
45278,100,10676,13559;13941,24820,0,0,0,2,2
45279,100,10677,13473,24820,0,0,0,1,1
45280,100,10683,14177;14444,24820,0,0,1,1,2
45281,100,10684,13694;14358,24820,0,0,1,1,2
45282,100,10689,14260,24820,0,0,1,0,1
45283,100,10690,14401;14812;19895,24820,0,0,3,0,3
45284,100,10691,14381;14917;19379,24820,0,0,3,0,3
45285,100,10695,14331;15006;19331,24820,0,0,3,0,3
45286,100,10696,15021;20089,24820,0,0,2,0,2
45287,100,10697,14160;14737;18905,24820,0,0,2,1,3
45288,100,10699,14701;14760,24820,0,0,2,0,2
45289,100,10700,14424;14878,24820,0,0,2,0,2
45290,100,10701,14923;16048,24820,0,0,2,0,2
45291,100,10702,14971;15511,24820,0,0,2,0,2
45292,100,10703,14977;15009,24820,0,0,2,0,2
45293,100,10704,15218;15423,24820,0,0,2,0,2
45294,100,10705,15018;15298,24820,0,0,2,0,2
45295,100,10706,14989;15084,24820,0,0,2,0,2
45296,100,10707,14975;15580;20084;20384,24820,0,1,3,0,4
45297,100,10708,15144;15368;20522,24820,0,1,2,0,3
45298,100,10709,14755;15484,24820,0,0,2,0,2
45299,100,10710,15414,24820,0,0,1,0,1
45300,100,10711,15676;19524;19730,24820,0,0,3,0,3
45301,100,10712,15289;15612,24820,0,0,2,0,2
45302,100,10713,15293;16312;20105,24820,0,0,3,0,3
45303,100,10714,15072;15314,24820,0,0,2,0,2
45304,100,10715,15486;16044,24820,0,0,2,0,2
45305,100,10716,15328;15645;19424,24820,0,0,3,0,3
45306,100,10717,15433;20106;20160,24820,0,0,3,0,3
45307,100,10718,15336;20196,24820,0,0,2,0,2
45308,100,10720,15476;18972;19871;20026,24820,0,0,4,0,4
45309,100,10721,15661;16025,24820,0,0,2,0,2
45310,100,10722,14856;15102,24820,0,0,2,0,2
45311,100,10723,15370;15422,24820,0,0,2,0,2
45312,100,10724,15435,24820,0,0,1,0,1
45313,100,10725,15073;15533;19608,24820,0,0,3,0,3
45314,100,10726,15349;15810,24820,0,0,2,0,2
45315,100,10727,15373;15527;19056;19820;20202,24820,0,0,5,0,5
45316,100,10729,15090,24820,0,0,1,0,1
45317,100,10730,15450;19345,24820,0,0,2,0,2
45318,100,10732,15033,24820,0,0,1,0,1
45319,100,10733,14867;15587,24820,0,0,2,0,2
45320,100,10734,15920;18991;19395;20113;21003,24820,0,1,4,0,5
45321,100,10735,14872;15637;19251;21539,24820,1,0,3,0,4
45322,100,10737,16450;20095,24820,0,0,2,0,2
45323,100,10739,15670;16027,24820,0,0,2,0,2
45324,100,10741,15418;15726;18730;19563,24820,0,0,4,0,4
45325,100,10742,15771;15794;20285,24820,0,1,2,0,3
45326,100,10743,16362;20077,24820,0,0,2,0,2
45327,100,10744,16101;16186;19638;19839,24820,0,0,4,0,4
45328,100,10745,16347;20323;20746,24820,0,2,1,0,3
45329,100,10746,15908;16668;20307;20491,24820,0,2,2,0,4
45330,100,10747,15567;15917;19436,24820,0,0,3,0,3
45331,100,10748,15922;20173,24820,0,0,2,0,2
45332,100,10749,15828;16217;19959;20162,24820,0,0,4,0,4
45333,100,10750,15952;16300;20265;20361,24820,0,2,2,0,4
45334,100,10751,15968;16299;19227;20464,24820,0,1,3,0,4
45335,100,10752,15942;15982;20321,24820,0,1,2,0,3
45336,100,10753,15787;15989;20290,24820,0,1,2,0,3
45337,100,10754,16018;16189;18994,24820,0,0,3,0,3
45338,100,10760,11027,25185,0,0,0,1,1
45339,100,10763,11501,25185,0,0,0,1,1
45340,100,10765,11907,25185,0,0,0,1,1
45341,100,10770,12664;13132,25185,0,0,0,2,2
45342,100,10771,12429,25185,0,0,0,1,1
45343,100,10783,13312;13586,25185,0,0,0,2,2
45344,100,10784,13968;13985,25185,0,0,0,2,2
45345,100,10785,13389;13976;19102,25185,0,0,1,2,3
45346,100,10788,13443,25185,0,0,0,1,1
45347,100,10793,13557;13848,25185,0,0,0,2,2
45348,100,10795,14420;14885,25185,0,0,2,0,2
45349,100,10796,14127;14410,25185,0,0,1,1,2
45350,100,10800,15412,25185,0,0,1,0,1
45351,100,10801,13815;14019,25185,0,0,0,2,2
45352,100,10802,15319;15894,25185,0,0,2,0,2
45353,100,10804,14696;14710;18752,25185,0,0,3,0,3
45354,100,10806,14941;15281;19472,25185,0,0,3,0,3
45355,100,10807,14974;15118,25185,0,0,2,0,2
45356,100,10808,15026;16169,25185,0,0,2,0,2
45357,100,10809,15129;15534,25185,0,0,2,0,2
45358,100,10810,15110;19625,25185,0,0,2,0,2
45359,100,10811,15124,25185,0,0,1,0,1
45360,100,10812,15208;15226,25185,0,0,2,0,2
45361,100,10813,15722;19928,25185,0,0,2,0,2
45362,100,10814,15088;15767,25185,0,0,2,0,2
45363,100,10815,15285;15638;20075;20380,25185,0,1,3,0,4
45364,100,10816,15053;15278;19723,25185,0,0,3,0,3
45365,100,10817,15378;15824;20496,25185,0,1,2,0,3
45366,100,10818,15219,25185,0,0,1,0,1
45367,100,10819,15411;16130;19161;19565,25185,0,0,4,0,4
45368,100,10820,15558;15617;20198,25185,0,0,3,0,3
45369,100,10821,15143,25185,0,0,1,0,1
45370,100,10822,15747;16160;19714;20256,25185,0,1,3,0,4
45371,100,10823,15461,25185,0,0,1,0,1
45372,100,10824,15759;16176;19466,25185,0,0,3,0,3
45373,100,10825,15863;19778,25185,0,0,2,0,2
45374,100,10826,15352;15916;19597,25185,0,0,3,0,3
45375,100,10827,15428;15610,25185,0,0,2,0,2
45376,100,10830,15448;15623;19327,25185,0,0,3,0,3
45377,100,10831,15459;15634;19584,25185,0,0,3,0,3
45378,100,10832,15641;15682;19580,25185,0,0,3,0,3
45379,100,10833,16252;20074,25185,0,0,2,0,2
45380,100,10834,15665;15834;20012;20182,25185,0,0,4,0,4
45381,100,10835,15687;16119;19692;19937;20034;20128,25185,0,0,6,0,6
45382,100,10836,16021;16304;19490;20545,25185,0,1,3,0,4
45383,100,10837,15666,25185,0,0,1,0,1
45384,100,10838,16341;20407;20663,25185,0,2,1,0,3
45385,100,10839,16043;16327;20197;20445,25185,0,1,3,0,4
45386,100,10840,15557;15579;18668,25185,0,0,3,0,3
45387,100,10841,15381;16329;20222,25185,0,0,3,0,3
45388,100,10842,16296,25185,0,0,1,0,1
45389,100,10843,15266;15888,25185,0,0,2,0,2
45390,100,10844,16188;16265;19426;22043,25185,1,0,3,0,4
45391,100,10845,15915;16040;20331,25185,0,1,2,0,3
45392,100,10846,15928;15981;20218;20734,25185,0,1,3,0,4
45393,100,10847,15640;15944,25185,0,0,2,0,2
45394,100,10848,15746;15947;19297;19640,25185,0,0,4,0,4
45395,100,10849,16360;16749;18933;22020,25185,1,0,3,0,4
45396,100,10851,15389;15972;19404,25185,0,0,3,0,3
45397,100,10852,16578;19951;20680,25185,0,1,2,0,3
45398,100,10853,16379;20180,25185,0,0,2,0,2
45399,100,10854,16054;16058,25185,0,0,2,0,2
45400,100,10855,16358,25185,0,0,1,0,1
45401,100,10856,16020;16059;19667;19901;20377,25185,0,1,4,0,5
45402,100,10857,16066;16315;20388,25185,0,1,2,0,3
45403,100,10858,16095;16154;19966;20053,25185,0,0,4,0,4
45404,100,10859,16116;16375,25185,0,0,2,0,2
45405,100,10860,15846;16117;19702;20006,25185,0,0,4,0,4
45406,100,10861,15515;16122;19739;19976,25185,0,0,4,0,4
45407,100,10862,16124;16551;20110,25185,0,0,3,0,3
45408,100,10863,16126;16233;19452,25185,0,0,3,0,3
45409,100,10864,15639;16138;19341;20452;20574;22037,25185,1,2,3,0,6
45410,100,10865,16262,25185,0,0,1,0,1
45411,100,10866,15702;15761;20009,25185,0,0,3,0,3
45412,100,10867,15884;16190,25185,0,0,2,0,2
45413,100,10875,11455,25550,0,0,0,1,1
45414,100,10876,11919,25550,0,0,0,1,1
45415,100,10882,11942,25550,0,0,0,1,1
45416,100,10884,12535,25550,0,0,0,1,1
45417,100,10888,12965;12997,25550,0,0,0,2,2
45418,100,10895,13681,25550,0,0,0,1,1
45419,100,10900,13259;13626,25550,0,0,0,2,2
45420,100,10902,13475,25550,0,0,0,1,1
45421,100,10903,14405;14904,25550,0,0,2,0,2
45422,100,10906,13683;14501,25550,0,0,1,1,2
45423,100,10907,14600;14785;19613,25550,0,0,3,0,3
45424,100,10909,14527;14888,25550,0,0,2,0,2
45425,100,10911,14552,25550,0,0,1,0,1
45426,100,10916,14700,25550,0,0,1,0,1
45427,100,10917,14697;14905,25550,0,0,2,0,2
45428,100,10918,15180;19856;20072,25550,0,0,3,0,3
45429,100,10921,14910;15063;19777,25550,0,0,3,0,3
45430,100,10922,15104;15160;19193;19522;20243,25550,0,1,4,0,5
45431,100,10923,15201;15495;19380;19439,25550,0,0,4,0,4
45432,100,10924,15216;15303,25550,0,0,2,0,2
45433,100,10925,15991;16284;21297,25550,0,1,2,0,3
45434,100,10927,15321;15728;19962,25550,0,0,3,0,3
45435,100,10928,15347;15731,25550,0,0,2,0,2
45436,100,10929,15354;19477,25550,0,0,2,0,2
45437,100,10930,15520;15940;20269,25550,0,1,2,0,3
45438,100,10932,15516;15537;19818,25550,0,0,3,0,3
45439,100,10933,15807;16010;19422;19899,25550,0,0,4,0,4
45440,100,10934,15526;15853;20098,25550,0,0,3,0,3
45441,100,10935,15608;15611;20547,25550,0,1,2,0,3
45442,100,10936,15287;15648;19465,25550,0,0,3,0,3
45443,100,10937,15069;19847;20104,25550,0,0,3,0,3
45444,100,10938,15674;15962;18950,25550,0,0,3,0,3
45445,100,10939,15525;15897,25550,0,0,2,0,2
45446,100,10940,15720;16147;19581;20925,25550,0,1,3,0,4
45447,100,10941,15748;15986;20020,25550,0,0,3,0,3
45448,100,10943,15365;15765;19772,25550,0,0,3,0,3
45449,100,10944,15186;15775;20154,25550,0,0,3,0,3
45450,100,10945,15783;15784;20042;20444,25550,0,1,3,0,4
45451,100,10946,15463;15801,25550,0,0,2,0,2
45452,100,10947,15823;16185;19544;19735;19921,25550,0,0,5,0,5
45453,100,10948,15658;16132;19170,25550,0,0,3,0,3
45454,100,10949,15889;16618,25550,0,0,2,0,2
45455,100,10950,16125;16302;19256,25550,0,0,3,0,3
45456,100,10951,15330,25550,0,0,1,0,1
45457,100,10952,15929;15950;20189;20512,25550,0,1,3,0,4
45458,100,10953,15971;16628;20709,25550,0,1,2,0,3
45459,100,10954,15785;15975,25550,0,0,2,0,2
45460,100,10955,15821;16180;20040,25550,0,0,3,0,3
45461,100,10956,15978;16000;19538;19881,25550,0,0,4,0,4
45462,100,10957,15646;16001;20336,25550,0,1,2,0,3
45463,100,10958,15948;16417;19923;20068,25550,0,0,4,0,4
45464,100,10959,16033;16060;20291,25550,0,1,2,0,3
45465,100,10961,16344;16395;19868;20392,25550,0,1,3,0,4
45466,100,10962,15571;16121,25550,0,0,2,0,2
45467,100,10963,16131;16489;19968,25550,0,0,3,0,3
45468,100,10964,16085;16170;19825;19896;20873,25550,0,1,4,0,5
45469,100,10965,16201;16644;20339,25550,0,1,2,0,3
45470,100,10966,16114;16602;19956;20060,25550,0,0,4,0,4
45471,100,10967,16402;20165;20369,25550,0,1,2,0,3
45472,100,10968,16065;16218,25550,0,0,2,0,2
45473,100,10969,16222;16716;19626;20531;21306,25550,0,2,3,0,5
45474,100,10970,15924;16246,25550,0,0,2,0,2
45475,100,10971,16253,25550,0,0,1,0,1
45476,100,10972,16264;16403;19710;19904,25550,0,0,4,0,4
45477,100,10973,15709;16645;20116;20568;21075,25550,0,2,3,0,5
45478,100,10974,16229;16279;20401,25550,0,1,2,0,3
45479,100,10975,15679;16324;19481,25550,0,0,3,0,3
45480,100,10979,11493,25915,0,0,0,1,1
45481,100,10980,11327,25915,0,0,0,1,1
45482,100,10981,11678,25915,0,0,0,1,1
45483,100,10986,12100,25915,0,0,0,1,1
45484,100,10987,12211,25915,0,0,0,1,1
45485,100,10994,12334,25915,0,0,0,1,1
45486,100,10995,13149,25915,0,0,0,1,1
45487,100,11002,13213;13608,25915,0,0,0,2,2
45488,100,11004,12782,25915,0,0,0,1,1
45489,100,11008,14025,25915,0,0,0,1,1
45490,100,11009,13365,25915,0,0,0,1,1
45491,100,11015,13503,25915,0,0,0,1,1
45492,100,11016,13993;14601,25915,0,0,1,1,2
45493,100,11018,14835;14945;19122,25915,0,0,3,0,3
45494,100,11020,13818;14386,25915,0,0,1,1,2
45495,100,11024,14387;14570,25915,0,0,2,0,2
45496,100,11029,15415;15602,25915,0,0,2,0,2
45497,100,11030,14802;15121,25915,0,0,2,0,2
45498,100,11031,14831;14979,25915,0,0,2,0,2
45499,100,11033,15693,25915,0,0,1,0,1
45500,100,11036,14642;14705,25915,0,0,2,0,2
45501,100,11037,14776;14932,25915,0,0,2,0,2
45502,100,11039,15182;15183,25915,0,0,2,0,2
45503,100,11041,15570;15862;19850;20011;20171,25915,0,0,5,0,5
45504,100,11042,15548;15690,25915,0,0,2,0,2
45505,100,11043,15465,25915,0,0,1,0,1
45506,100,11044,15988;16225,25915,0,0,2,0,2
45507,100,11045,15138;15619;19167,25915,0,0,3,0,3
45508,100,11046,15498;15739,25915,0,0,2,0,2
45509,100,11047,15744;15885;19906,25915,0,0,3,0,3
45510,100,11048,16468,25915,0,0,1,0,1
45511,100,11049,15628;15833,25915,0,0,2,0,2
45512,100,11050,15850;15865;19577,25915,0,0,3,0,3
45513,100,11051,15867;15883,25915,0,0,2,0,2
45514,100,11052,15324;15875,25915,0,0,2,0,2
45515,100,11053,15103;15876;20270,25915,0,1,2,0,3
45516,100,11054,15907;15925;20186,25915,0,0,3,0,3
45517,100,11055,15910;16240;20431,25915,0,1,2,0,3
45518,100,11056,15911;16209;20292,25915,0,1,2,0,3
45519,100,11057,16261;16452;20686;20878,25915,0,2,2,0,4
45520,100,11058,15477;16428;19727,25915,0,0,3,0,3
45521,100,11059,16318;20843,25915,0,1,1,0,2
45522,100,11060,15376;16036;19946;20455,25915,0,1,3,0,4
45523,100,11061,16037;16055;19433;20723,25915,0,1,3,0,4
45524,100,11062,16411,25915,0,0,1,0,1
45525,100,11063,15768;16091,25915,0,0,2,0,2
45526,100,11064,16092;16107;19890;20543,25915,0,1,3,0,4
45527,100,11065,15706;16098;19984;20220,25915,0,0,4,0,4
45528,100,11066,16418;19985;20227,25915,0,1,2,0,3
45529,100,11067,16023;16118;20258,25915,0,1,2,0,3
45530,100,11068,16137;16238;20293,25915,0,1,2,0,3
45531,100,11069,16149;16599;19989;20199;20756,25915,0,1,4,0,5
45532,100,11070,15395;16123,25915,0,0,2,0,2
45533,100,11072,16197;16601;19448;20720,25915,0,1,3,0,4
45534,100,11073,15906;16208;20234,25915,0,1,2,0,3
45535,100,11074,16412,25915,0,0,1,0,1
45536,100,11075,16112;16650;20237;20334,25915,0,2,2,0,4
45537,100,11076,16861;16961;20277,25915,0,1,2,0,3
45538,100,11077,15762;16282;20667,25915,0,1,2,0,3
45539,100,11078,16177;16687;19187,25915,0,0,3,0,3
45540,100,11079,16251;16291;19188;21106,25915,0,1,3,0,4
45541,100,11080,16174;20818;21182,25915,0,2,1,0,3
45542,100,11081,16338;16610;20551;21362,25915,0,2,2,0,4
45543,100,11082,16586;20637;20666,25915,0,2,1,0,3
45544,100,11083,16346;19860;19936,25915,0,0,3,0,3
45545,100,11084,16348;16787;20779,25915,0,1,2,0,3
45546,100,11085,16381;16544;20550,25915,0,1,2,0,3
45547,100,11086,16717;16778;19922;20063,25915,0,0,4,0,4
45548,100,11087,16491;16822;19005,25915,0,0,3,0,3
45549,100,11088,16353;16461;20080,25915,0,0,3,0,3
45550,100,11089,16213;16471;20100;20982,25915,0,1,3,0,4
45551,100,11090,16368;16472;19911;20044;21081,25915,0,1,4,0,5
45552,100,11092,11473,26280,0,0,0,1,1
45553,100,11094,11519;11765,26280,0,0,0,2,2
45554,100,11095,11330,26280,0,0,0,1,1
45555,100,11098,11656,26280,0,0,0,1,1
45556,100,11103,11888,26280,0,0,0,1,1
45557,100,11114,12568,26280,0,0,0,1,1
45558,100,11120,12464,26280,0,0,0,1,1
45559,100,11125,13565;13802,26280,0,0,0,2,2
45560,100,11130,14116;14613,26280,0,0,1,1,2
45561,100,11137,14575;14632,26280,0,0,2,0,2
45562,100,11138,13302,26280,0,0,0,1,1
45563,100,11139,14663;19423,26280,0,0,2,0,2
45564,100,11141,14557;14995,26280,0,0,2,0,2
45565,100,11142,15268;18956,26280,0,0,2,0,2
45566,100,11143,14748;15244,26280,0,0,2,0,2
45567,100,11144,14580;15401,26280,0,0,2,0,2
45568,100,11150,14954;14985,26280,0,0,2,0,2
45569,100,11151,14960,26280,0,0,1,0,1
45570,100,11152,15539;15832,26280,0,0,2,0,2
45571,100,11153,15077;19163,26280,0,0,2,0,2
45572,100,11154,15078;15364,26280,0,0,2,0,2
45573,100,11158,15185;19913,26280,0,0,2,0,2
45574,100,11159,14740;15194;19582;19831,26280,0,0,4,0,4
45575,100,11162,15315;15943;20841,26280,0,1,2,0,3
45576,100,11163,15353,26280,0,0,1,0,1
45577,100,11164,15383;15546,26280,0,0,2,0,2
45578,100,11165,14533;15323;20240,26280,0,1,2,0,3
45579,100,11166,15392;15890,26280,0,0,2,0,2
45580,100,11167,15397;15630;19265,26280,0,0,3,0,3
45581,100,11168,15399;15471;19269;19455,26280,0,0,4,0,4
45582,100,11169,15479;15643;18981,26280,0,0,3,0,3
45583,100,11170,15508;16039,26280,0,0,2,0,2
45584,100,11171,15499;15514;19942,26280,0,0,3,0,3
45585,100,11172,15573;16187,26280,0,0,2,0,2
45586,100,11173,14815;15588;19907;20294,26280,0,1,3,0,4
45587,100,11174,16753;17325;21299,26280,0,1,2,0,3
45588,100,11176,15686;16337,26280,0,0,2,0,2
45589,100,11177,15358;15705;19131;19814,26280,0,0,4,0,4
45590,100,11178,16257;16439;19152;19519;20122;20400,26280,0,1,5,0,6
45591,100,11179,15519;16168;19520,26280,0,0,3,0,3
45592,100,11180,16030;16323,26280,0,0,2,0,2
45593,100,11181,15776;15781;19164;19352;20306,26280,0,1,4,0,5
45594,100,11182,16589;19536;20230;20439,26280,0,2,2,0,4
45595,100,11183,15802;16288;20541,26280,0,1,2,0,3
45596,100,11184,15552;15936;20246;20528,26280,0,2,2,0,4
45597,100,11186,15445;15880;19604,26280,0,0,3,0,3
45598,100,11187,15901;16547,26280,0,0,2,0,2
45599,100,11188,15985;16211;19050;19822,26280,0,0,4,0,4
45600,100,11189,15673;15918;19598,26280,0,0,3,0,3
45601,100,11190,15607;15930;19463;19972,26280,0,0,4,0,4
45602,100,11191,15436;15932;19500;20394;20529,26280,0,2,3,0,5
45603,100,11192,15905;15939;20158,26280,0,0,3,0,3
45604,100,11194,15814;15992;20628,26280,0,1,2,0,3
45605,100,11195,15485;15994,26280,0,0,2,0,2
45606,100,11197,15993;16028,26280,0,0,2,0,2
45607,100,11199,16046;16500;19691,26280,0,0,3,0,3
45608,100,11200,16069;16464;19953;20091,26280,0,0,4,0,4
45609,100,11201,16078;16407;19505;20112;20811;22045,26280,1,1,4,0,6
45610,100,11202,16383;16660;19441;19666,26280,0,0,4,0,4
45611,100,11203,16006;16135;19142;19606;19905,26280,0,0,5,0,5
45612,100,11204,16096;16512;20372;20559;20853,26280,0,3,2,0,5
45613,100,11205,16389,26280,0,0,1,0,1
45614,100,11206,15605;16110,26280,0,0,2,0,2
45615,100,11207,16094;16572;21224,26280,0,1,2,0,3
45616,100,11208,15851;16136;19194;19885,26280,0,0,4,0,4
45617,100,11209,16087;16145;20562,26280,0,1,2,0,3
45618,100,11210,16490;21032,26280,0,1,1,0,2
45619,100,11211,16320;16425;19720;20200,26280,0,0,4,0,4
45620,100,11212,15631;16193,26280,0,0,2,0,2
45621,100,11215,16206;16493;19245;19600,26280,0,0,4,0,4
45622,100,11216,15627;16276;19382;19689,26280,0,0,4,0,4
45623,100,11217,15898;16280,26280,0,0,2,0,2
45624,100,11218,15663;20018,26280,0,0,2,0,2
45625,100,11219,16575,26280,0,0,1,0,1
45626,100,11220,16731;16833;19460,26280,0,0,3,0,3
45627,100,11221,16841;18920;19649;19754,26280,0,0,4,0,4
45628,100,11222,16331;16856;21379,26280,0,1,2,0,3
45629,100,11223,16336;16671;20314,26280,0,1,2,0,3
45630,100,11224,16385;20517,26280,0,1,1,0,2
45631,100,11225,16086;16361;19994;20033,26280,0,0,4,0,4
45632,100,11226,16542,26280,0,0,1,0,1
45633,100,11227,16373;16514,26280,0,0,2,0,2
45634,100,11228,16335;16377,26280,0,0,2,0,2
45635,100,11229,16399;16426;20341,26280,0,1,2,0,3
45636,100,11230,16416;16670,26280,0,0,2,0,2
45637,100,11231,16693;17000;19654;20404;21147,26280,0,2,3,0,5
45638,100,11232,16453;16469,26280,0,0,2,0,2
45639,100,11233,16802;16872;21098,26280,0,1,2,0,3
45640,100,11234,16478;16681;19434;19969;20251;20532;20647,26280,0,3,4,0,7
45641,100,11235,16504;16674;20611,26280,0,1,2,0,3
45642,100,11236,16509;16629;20067;20295;20393,26280,0,2,3,0,5
45643,100,11237,16527;16865;19749;20305;20511;20889,26280,0,3,3,0,6
45644,100,11238,16554;16744;20275,26280,0,1,2,0,3
45645,100,11239,10987,26645,0,0,0,1,1
45646,100,11241,11384,26645,0,0,0,1,1
45647,100,11245,11845,26645,0,0,0,1,1
45648,100,11254,12839,26645,0,0,0,1,1
45649,100,11258,12804,26645,0,0,0,1,1
45650,100,11260,12596,26645,0,0,0,1,1
45651,100,11261,13237,26645,0,0,0,1,1
45652,100,11265,13374,26645,0,0,0,1,1
45653,100,11266,12759;13234,26645,0,0,0,2,2
45654,100,11267,13999;19205,26645,0,0,1,1,2
45655,100,11271,13932;14006,26645,0,0,0,2,2
45656,100,11272,13945,26645,0,0,0,1,1
45657,100,11279,14460;14535;19752,26645,0,0,3,0,3
45658,100,11281,15154;15309,26645,0,0,2,0,2
45659,100,11282,14788;14934,26645,0,0,2,0,2
45660,100,11286,14665;15211;20111,26645,0,0,3,0,3
45661,100,11288,14534;15271;19619,26645,0,0,3,0,3
45662,100,11290,15046;15893;20217,26645,0,0,3,0,3
45663,100,11291,15815;15909,26645,0,0,2,0,2
45664,100,11293,15318;15967;19092,26645,0,0,3,0,3
45665,100,11294,15384,26645,0,0,1,0,1
45666,100,11295,15393;20236,26645,0,1,1,0,2
45667,100,11296,15409;19435;19918,26645,0,0,3,0,3
45668,100,11298,14949;15493;19340,26645,0,0,3,0,3
45669,100,11299,15529;19190,26645,0,0,2,0,2
45670,100,11300,15829;15966;20148;20690,26645,0,1,3,0,4
45671,100,11301,15451;15538;19308;20405,26645,0,1,3,0,4
45672,100,11303,15740;19821,26645,0,0,2,0,2
45673,100,11304,14782;15753;20410,26645,0,1,2,0,3
45674,100,11307,15351;15900;19992,26645,0,0,3,0,3
45675,100,11308,15734,26645,0,0,1,0,1
45676,100,11309,15756;15931,26645,0,0,2,0,2
45677,100,11310,15764;15845;20140,26645,0,0,3,0,3
45678,100,11311,15522;15841;19594;20014,26645,0,0,4,0,4
45679,100,11312,15861;16394,26645,0,0,2,0,2
45680,100,11313,15502;16052,26645,0,0,2,0,2
45681,100,11314,15919;16480;20267;20459,26645,0,2,2,0,4
45682,100,11316,15755;15953;20595,26645,0,1,2,0,3
45683,100,11317,16479;20223;20492,26645,0,2,1,0,3
45684,100,11318,15999;16237,26645,0,0,2,0,2
45685,100,11319,16015;16214;20894,26645,0,1,2,0,3
45686,100,11320,16016;16198;20554,26645,0,1,2,0,3
45687,100,11321,15238;16034,26645,0,0,2,0,2
45688,100,11322,16038;16088;19488,26645,0,0,3,0,3
45689,100,11323,15977;16603;19660;20373,26645,0,1,3,0,4
45690,100,11324,16958;20565;20821,26645,0,2,1,0,3
45691,100,11325,15795;16250;20117,26645,0,0,3,0,3
45692,100,11326,16167;16256;19731,26645,0,0,3,0,3
45693,100,11327,16522;16532;20406,26645,0,1,2,0,3
45694,100,11328,16269;19925,26645,0,0,2,0,2
45695,100,11329,16111;16272;21023,26645,0,1,2,0,3
45696,100,11330,16277;16855;21203,26645,0,1,2,0,3
45697,100,11331,16633;19428;19678;20597,26645,0,1,3,0,4
45698,100,11332,15616;16164,26645,0,0,2,0,2
45699,100,11333,16013;16398;20316;20640,26645,0,2,2,0,4
45700,100,11334,15732;16420;20213;20553,26645,0,1,3,0,4
45701,100,11335,16447;19677;20174,26645,0,0,3,0,3
45702,100,11336,16223;16458,26645,0,0,2,0,2
45703,100,11337,16495;16732;20211;21158,26645,0,1,3,0,4
45704,100,11338,16162;16506;20465;20923,26645,0,2,2,0,4
45705,100,11339,16519;16798;20976;21235,26645,0,2,2,0,4
45706,100,11340,16378;16529;19846,26645,0,0,3,0,3
45707,100,11341,16560;16590;19840;19944,26645,0,0,4,0,4
45708,100,11342,16153;16561;20662,26645,0,1,2,0,3
45709,100,11343,15945;16667;20902;21120,26645,0,2,2,0,4
45710,100,11344,16287;16576;21680,26645,1,0,2,0,3
45711,100,11345,16008;16577;19523,26645,0,0,3,0,3
45712,100,11346,16580,26645,0,0,1,0,1
45713,100,11347,16556;16811;19725;20928,26645,0,1,3,0,4
45714,100,11348,16321;16593;20031;20354,26645,0,1,3,0,4
45715,100,11349,16475;16606;19940;20436,26645,0,1,3,0,4
45716,100,11350,16607;17062;19459;20266,26645,0,1,3,0,4
45717,100,11351,16620;16878,26645,0,0,2,0,2
45718,100,11352,16622;16966;19684;19932;20949,26645,0,1,4,0,5
45719,100,11353,16987;17046;19506;20613,26645,0,1,3,0,4
45720,100,11354,16488;16635;20204,26645,0,0,3,0,3
45721,100,11355,16594;16648;19202;20119,26645,0,0,4,0,4
45722,100,11356,15951;16093,26645,0,0,2,0,2
45723,100,11357,16654;16701,26645,0,0,2,0,2
45724,100,11358,16409;16703;20819,26645,0,1,2,0,3
45725,100,11359,16413;16728,26645,0,0,2,0,2
45726,100,11360,11581,27010,0,0,0,1,1
45727,100,11367,12104;12322,27010,0,0,0,2,2
45728,100,11369,11603,27010,0,0,0,1,1
45729,100,11370,12126,27010,0,0,0,1,1
45730,100,11372,12176,27010,0,0,0,1,1
45731,100,11374,12120;12225,27010,0,0,0,2,2
45732,100,11380,12793,27010,0,0,0,1,1
45733,100,11389,14510,27010,0,0,1,0,1
45734,100,11397,14340;15157,27010,0,0,2,0,2
45735,100,11402,14440;14725,27010,0,0,2,0,2
45736,100,11404,14341,27010,0,0,1,0,1
45737,100,11406,15447,27010,0,0,1,0,1
45738,100,11409,15015;15259,27010,0,0,2,0,2
45739,100,11410,15017;15513;19933;20187,27010,0,0,4,0,4
45740,100,11411,15472;15518,27010,0,0,2,0,2
45741,100,11413,14131;15071;19497;19792,27010,0,0,3,1,4
45742,100,11414,14798;14957,27010,0,0,2,0,2
45743,100,11415,15188;15618,27010,0,0,2,0,2
45744,100,11417,14799;15234;19756,27010,0,0,3,0,3
45745,100,11419,15357,27010,0,0,1,0,1
45746,100,11421,14853;15371,27010,0,0,2,0,2
45747,100,11423,15258;16012,27010,0,0,2,0,2
45748,100,11425,16350;19999;20642,27010,0,1,2,0,3
45749,100,11426,15629;16308;19419,27010,0,0,3,0,3
45750,100,11427,15028;15692,27010,0,0,2,0,2
45751,100,11428,15656;15715;19676;20090,27010,0,0,4,0,4
45752,100,11429,15725;15779;20093,27010,0,0,3,0,3
45753,100,11430,15743;16537,27010,0,0,2,0,2
45754,100,11433,15836;16263;21571,27010,1,0,2,0,3
45755,100,11434,15685;15780;19761,27010,0,0,3,0,3
45756,100,11435,15877;16267;20747,27010,0,1,2,0,3
45757,100,11437,15934;15984;19849;19939,27010,0,0,4,0,4
45758,100,11438,15956;16501,27010,0,0,2,0,2
45759,100,11439,15974,27010,0,0,1,0,1
45760,100,11440,15820;15995,27010,0,0,2,0,2
45761,100,11442,16042;16446;20423,27010,0,1,2,0,3
45762,100,11443,15903;16084;19652;20181,27010,0,0,4,0,4
45763,100,11444,16115,27010,0,0,1,0,1
45764,100,11445,15923;16492;19908;20463,27010,0,1,3,0,4
45765,100,11446,16669;16708;20081;20359;20585,27010,0,2,3,0,5
45766,100,11447,16090;16183;20530,27010,0,1,2,0,3
45767,100,11448,16623;17037,27010,0,0,2,0,2
45768,100,11449,16552;17065;19900;20203;20301;20899;21756,27010,1,2,4,0,7
45769,100,11450,15800;16440,27010,0,0,2,0,2
45770,100,11452,16761,27010,0,0,1,0,1
45771,100,11453,16371;16759;20576;21052,27010,0,2,2,0,4
45772,100,11455,16376;16588,27010,0,0,2,0,2
45773,100,11456,16404;16895;20845,27010,0,1,2,0,3
45774,100,11458,16422;19534,27010,0,0,2,0,2
45775,100,11459,16533;16756;20785;20945;21565,27010,1,2,2,0,5
45776,100,11460,16436;17204;19216;20398;21385,27010,0,2,3,0,5
45777,100,11463,16260;16779;21105,27010,0,1,2,0,3
45778,100,11464,16751;20771,27010,0,1,1,0,2
45779,100,11465,16445;16541;20083;20124;20582,27010,0,1,4,0,5
45780,100,11466,16553;16994;20870;21046,27010,0,2,2,0,4
45781,100,11467,16159;16562;19935;20143,27010,0,0,4,0,4
45782,100,11468,16270;16563;20210;20433,27010,0,1,3,0,4
45783,100,11469,16568;16764;20313;20497;20617,27010,0,3,2,0,5
45784,100,11470,16245;16596;20049;20231;20506,27010,0,2,3,0,5
45785,100,11471,16608;16930;19220;19952,27010,0,0,4,0,4
45786,100,11472,16432;16815;21486,27010,0,1,2,0,3
45787,100,11473,16685;16786,27010,0,0,2,0,2
45788,100,11474,16694;17106;19764;20596,27010,0,1,3,0,4
45789,100,11475,16699;16875;19274;19480;21556,27010,1,0,4,0,5
45790,100,11476,16659;16947;19949,27010,0,0,3,0,3
45791,100,11477,16725;17068;21214,27010,0,1,2,0,3
45792,100,11478,16980;17074;19981;20152,27010,0,0,4,0,4
45793,100,11479,16738;20412;20835,27010,0,2,1,0,3
45794,100,11480,16976;17028;20832,27010,0,1,2,0,3
45795,100,11481,16766;17119;19914;20607;20955,27010,0,2,3,0,5
45796,100,11482,16343;16783;21250,27010,0,1,2,0,3
45797,100,11483,16803;17015;20094;20514,27010,0,1,3,0,4
45798,100,11484,16305;16357;19817;20790,27010,0,1,3,0,4
45799,100,11485,16617;20781,27010,0,1,1,0,2
45800,100,11486,16850;19941;20002;20178,27010,0,0,4,0,4
45801,100,11492,11508,27375,0,0,0,1,1
45802,100,11493,11982,27375,0,0,0,1,1
45803,100,11498,12426,27375,0,0,0,1,1
45804,100,11500,12297,27375,0,0,0,1,1
45805,100,11502,12800,27375,0,0,0,1,1
45806,100,11506,12788,27375,0,0,0,1,1
45807,100,11507,13017;13211,27375,0,0,0,2,2
45808,100,11525,14408;15190;19615;20435,27375,0,1,3,0,4
45809,100,11528,14614;14926,27375,0,0,2,0,2
45810,100,11529,14653;15232,27375,0,0,2,0,2
45811,100,11535,14793;15517;19809;20621,27375,0,1,3,0,4
45812,100,11536,14709;14950;19866,27375,0,0,3,0,3
45813,100,11538,14984;15403,27375,0,0,2,0,2
45814,100,11540,15127;15343,27375,0,0,2,0,2
45815,100,11544,15561;15987,27375,0,0,2,0,2
45816,100,11546,15782;15955;19954,27375,0,0,3,0,3
45817,100,11548,15796;15812,27375,0,0,2,0,2
45818,100,11549,15434;15817,27375,0,0,2,0,2
45819,100,11550,15843;16249;20575,27375,0,1,2,0,3
45820,100,11551,16434;16548;19799;20297,27375,0,1,3,0,4
45821,100,11552,15609;15879;21251,27375,0,1,2,0,3
45822,100,11553,15774;15946,27375,0,0,2,0,2
45823,100,11555,15717;16003;20337,27375,0,1,2,0,3
45824,100,11556,16022;16179,27375,0,0,2,0,2
45825,100,11557,16278;19745;20729,27375,0,1,2,0,3
45826,100,11558,15735;16627;19978;20273;22054,27375,1,1,3,0,5
45827,100,11561,15491;16224,27375,0,0,2,0,2
45828,100,11562,15279;16194;20777,27375,0,1,2,0,3
45829,100,11563,15704;16081,27375,0,0,2,0,2
45830,100,11564,16271;16339;20657,27375,0,1,2,0,3
45831,100,11565,15938;16195;19865,27375,0,0,3,0,3
45832,100,11566,16228;16364;19387;19699;20296,27375,0,1,4,0,5
45833,100,11567,16234;16771;20169;20434;21016,27375,0,2,3,0,5
45834,100,11568,16236;16390;19806;20344,27375,0,1,3,0,4
45835,100,11570,16097;16286;20057,27375,0,0,3,0,3
45836,100,11571,15596;16005;20022,27375,0,0,3,0,3
45837,100,11572,16226;16290,27375,0,0,2,0,2
45838,100,11573,16072;16310;19758;20103;20627,27375,0,1,4,0,5
45839,100,11574,16365,27375,0,0,1,0,1
45840,100,11575,16396;16821;20728,27375,0,1,2,0,3
45841,100,11576,16454;16613,27375,0,0,2,0,2
45842,100,11577,16293;16456;19996,27375,0,0,3,0,3
45843,100,11578,16009;16476;19376;20054,27375,0,0,4,0,4
45844,100,11579,16254;16661;20087;20419,27375,0,1,3,0,4
45845,100,11580,15713;16549;20413,27375,0,1,2,0,3
45846,100,11581,16510;16925;20577;20851,27375,0,2,2,0,4
45847,100,11582,16372;16424,27375,0,0,2,0,2
45848,100,11583,16565;20460,27375,0,1,1,0,2
45849,100,11584,16571;16609;19628;19804;20085;20363,27375,0,1,5,0,6
45850,100,11585,16631;17039,27375,0,0,2,0,2
45851,100,11586,16812;19550,27375,0,0,2,0,2
45852,100,11587,16664;17188;19997;20584;21736,27375,1,1,3,0,5
45853,100,11588,16427,27375,0,0,1,0,1
45854,100,11589,16676;17137;19513;20150;20356;20806;20981;21511,27375,1,3,4,0,8
45855,100,11590,16686;17117;20791;21088;21506,27375,1,2,2,0,5
45856,100,11591,16706;16709,27375,0,0,2,0,2
45857,100,11593,16934,27375,0,0,1,0,1
45858,100,11594,16752;20856,27375,0,1,1,0,2
45859,100,11595,16763;16927;19318;19700,27375,0,0,4,0,4
45860,100,11596,16359;16768,27375,0,0,2,0,2
45861,100,11597,16845;17035;19394;22042,27375,1,0,3,0,4
45862,100,11598,16455;16846;20685,27375,0,1,2,0,3
45863,100,11599,16281;17053;20114;20349,27375,0,1,3,0,4
45864,100,11600,16948;17101;20327,27375,0,1,2,0,3
45865,100,11601,16883;17328;19334;19489,27375,0,0,4,0,4
45866,100,11602,16545;16891;20191;20604,27375,0,1,3,0,4
45867,100,11603,16294;16894;20120;20911,27375,0,1,3,0,4
45868,100,11604,16889;17087;19406;19540;20958,27375,0,1,4,0,5
45869,100,11605,16792;16899;21213;21430,27375,0,2,2,0,4
45870,100,11606,16924;16928;20428;20616,27375,0,2,2,0,4
45871,100,11607,16521;16932;20570,27375,0,1,2,0,3
45872,100,11608,16526;16945;20205;20362;20918,27375,0,2,3,0,5
45873,100,11609,16697;16951;19767;20561,27375,0,1,3,0,4
45874,100,11610,16964;17055;20170;20357;20815,27375,0,2,3,0,5
45875,100,11611,11953,27740,0,0,0,1,1
45876,100,11613,11738,27740,0,0,0,1,1
45877,100,11614,12131,27740,0,0,0,1,1
45878,100,11616,12214,27740,0,0,0,1,1
45879,100,11617,12009,27740,0,0,0,1,1
45880,100,11621,12105,27740,0,0,0,1,1
45881,100,11624,12748,27740,0,0,0,1,1
45882,100,11625,12760;13052,27740,0,0,0,2,2
45883,100,11627,13142,27740,0,0,0,1,1
45884,100,11641,14303;14625,27740,0,0,2,0,2
45885,100,11643,15189;19931,27740,0,0,2,0,2
45886,100,11644,15366;20130;20235,27740,0,1,2,0,3
45887,100,11645,14809;15599;20271,27740,0,1,2,0,3
45888,100,11647,14899;15039,27740,0,0,2,0,2
45889,100,11648,14830;14980;19664,27740,0,0,3,0,3
45890,100,11649,15068;15407;20078,27740,0,0,3,0,3
45891,100,11651,14495;15158,27740,0,0,2,0,2
45892,100,11653,15745,27740,0,0,1,0,1
45893,100,11654,15512;16191;19701;20774,27740,0,1,3,0,4
45894,100,11657,15237;15620;19757;20184;20992,27740,0,1,4,0,5
45895,100,11658,14834;15751;19823;20035,27740,0,0,4,0,4
45896,100,11659,15797;16570,27740,0,0,2,0,2
45897,100,11660,15805;15998,27740,0,0,2,0,2
45898,100,11662,16750;20481;20839,27740,0,2,1,0,3
45899,100,11663,16297;16579,27740,0,0,2,0,2
45900,100,11664,16175;16801,27740,0,0,2,0,2
45901,100,11665,15672;16075;20151,27740,0,0,3,0,3
45902,100,11667,15870;16523,27740,0,0,2,0,2
45903,100,11670,16859;20322;20965;21256,27740,0,3,1,0,4
45904,100,11671,16720;17100;19639;20825;20972;21405,27740,0,3,3,0,6
45905,100,11672,15859;16363,27740,0,0,2,0,2
45906,100,11673,16391;16448;20437;20847,27740,0,2,2,0,4
45907,100,11674,16393;16991;20052;21162,27740,0,1,3,0,4
45908,100,11675,16437;16774;20038;20581;20719;20769;20901,27740,0,4,3,0,7
45909,100,11676,16441;17221;21072,27740,0,1,2,0,3
45910,100,11677,16443;17072,27740,0,0,2,0,2
45911,100,11678,16449;16585;19903,27740,0,0,3,0,3
45912,100,11679,16451;16935;20892,27740,0,1,2,0,3
45913,100,11682,16507;17038;21019,27740,0,1,2,0,3
45914,100,11683,16316;16968;19838;20683;21248,27740,0,2,3,0,5
45915,100,11684,16640;16840;20725,27740,0,1,2,0,3
45916,100,11685,16274;16642;19779;19897;20244,27740,0,1,4,0,5
45917,100,11686,16202;16675;20194;20284,27740,0,1,3,0,4
45918,100,11687,16678;16858;20610;20966,27740,0,2,2,0,4
45919,100,11688,16679;17408;19502;21665,27740,1,0,3,0,4
45920,100,11689,16688;16820;20136;20830;21323,27740,0,2,3,0,5
45921,100,11690,16178;16692;19986;20379;21164,27740,0,2,3,0,5
45922,100,11691,16698;16869,27740,0,0,2,0,2
45923,100,11692,16712;16838,27740,0,0,2,0,2
45924,100,11693,16352;16656;20045;20208;20261;20612,27740,0,2,4,0,6
45925,100,11694,16605;16741;19879;20402;21013,27740,0,2,3,0,5
45926,100,11696,16584;16733;20070;20156,27740,0,0,4,0,4
45927,100,11697,16918;17124,27740,0,0,2,0,2
45928,100,11698,17047;17475;20221;21223;21643,27740,1,1,3,0,5
45929,100,11699,16799;16843,27740,0,0,2,0,2
45930,100,11700,17001;17301;20215,27740,0,0,3,0,3
45931,100,11701,16877;17397;19715;20935;21345,27740,0,2,3,0,5
45932,100,11702,16871;17357;21113,27740,0,1,2,0,3
45933,100,11703,16915;17157;20391;20638,27740,0,2,2,0,4
45934,100,11704,16922;19679;20448;21707,27740,1,1,2,0,4
45935,100,11705,16691;16923;20319,27740,0,1,2,0,3
45936,100,11706,16795;17125;20560;21006;21077,27740,0,3,2,0,5
45937,100,11707,16990;17322;20773;21097,27740,0,2,2,0,4
45938,100,11709,16914;17005;19836;20320;20385;21185,27740,0,3,3,0,6
45939,100,11710,17009;17084;20798;21479,27740,0,2,2,0,4
45940,100,11711,17018;17048;20375;20726,27740,0,2,2,0,4
45941,100,11712,16592;17040;20149;21490,27740,0,1,3,0,4
45942,100,11713,17044;17337;19845;20908,27740,0,1,3,0,4
45943,100,11714,16897;19515;20886,27740,0,1,2,0,3
45944,100,11715,16597;17181;20555,27740,0,1,2,0,3
45945,100,11716,16672;17079;20912,27740,0,1,2,0,3
45946,100,11717,17114;17308;19656;19930;20808;21881,27740,1,1,4,0,6
45947,100,11720,11601,28105,0,0,0,1,1
45948,100,11721,12253,28105,0,0,0,1,1
45949,100,11727,12523,28105,0,0,0,1,1
45950,100,11728,12498,28105,0,0,0,1,1
45951,100,11730,12857;13306,28105,0,0,0,2,2
45952,100,11748,14909;14959,28105,0,0,2,0,2
45953,100,11750,15327,28105,0,0,1,0,1
45954,100,11751,15130;15737,28105,0,0,2,0,2
45955,100,11755,14996;15312;19717,28105,0,0,3,0,3
45956,100,11756,15344,28105,0,0,1,0,1
45957,100,11757,15155;15554;20454,28105,0,1,2,0,3
45958,100,11761,14914;15470,28105,0,0,2,0,2
45959,100,11762,15460;16070,28105,0,0,2,0,2
45960,100,11763,16482;19796;20510,28105,0,1,2,0,3
45961,100,11765,15688;15806;19835,28105,0,0,3,0,3
45962,100,11767,15490;15873,28105,0,0,2,0,2
45963,100,11770,16546,28105,0,0,1,0,1
45964,100,11771,15878;16019,28105,0,0,2,0,2
45965,100,11772,16139;16414,28105,0,0,2,0,2
45966,100,11773,16241;16524;19912,28105,0,0,3,0,3
45967,100,11774,16345;16438;20772,28105,0,1,2,0,3
45968,100,11775,16311;16714;20121;20644,28105,0,1,3,0,4
45969,100,11777,16366;16637;19688;20190;20353,28105,0,1,4,0,5
45970,100,11778,16713;16909;19870;20062;20967;21304;21645,28105,1,2,4,0,7
45971,100,11779,16077;16457,28105,0,0,2,0,2
45972,100,11780,16474;16823;20019;20456,28105,0,1,3,0,4
45973,100,11781,16540;20780;20979,28105,0,2,1,0,3
45974,100,11782,16665;20552;20650;21282,28105,0,3,1,0,4
45975,100,11783,16248;16722;20328;20479,28105,0,2,2,0,4
45976,100,11784,15913;15961,28105,0,0,2,0,2
45977,100,11785,16647;17041;20324;20563,28105,0,2,2,0,4
45978,100,11787,16734,28105,0,0,1,0,1
45979,100,11788,16736;17266;20707,28105,0,1,2,0,3
45980,100,11789,17105;17140;20904;21157,28105,0,2,2,0,4
45981,100,11790,16073;16313;19995,28105,0,0,3,0,3
45982,100,11791,16639;17098;19765;22051,28105,1,0,3,0,4
45983,100,11792,16626;16777,28105,0,0,2,0,2
45984,100,11793,16481;16788,28105,0,0,2,0,2
45985,100,11794,16508;16790;20232;20466;21429,28105,0,3,2,0,5
45986,100,11795,16791;17423;20115;21037,28105,0,1,3,0,4
45987,100,11797,16534;16809,28105,0,0,2,0,2
45988,100,11798,16826;17061;21142;21478,28105,0,2,2,0,4
45989,100,11799,16784;16831;20618;20897;21281,28105,0,3,2,0,5
45990,100,11800,16921;16995;20135;20311,28105,0,1,3,0,4
45991,100,11801,17214;17298;21365,28105,0,1,2,0,3
45992,100,11802,16851;17420;20390;20973;21071,28105,0,3,2,0,5
45993,100,11803,16863;17314;20278;20453;21558,28105,1,2,2,0,5
45994,100,11804,16866;17461;20318;20518;21150;21318,28105,0,4,2,0,6
45995,100,11805,16908;17240;19706,28105,0,0,3,0,3
45996,100,11806,16465,28105,0,0,1,0,1
45997,100,11807,17369;17520;20796;21674,28105,1,1,2,0,4
45998,100,11808,16836;16969;19863;20748,28105,0,1,3,0,4
45999,100,11809,16369;16975;20250,28105,0,1,2,0,3
46000,100,11810,16953;17073;19973;20224,28105,0,1,3,0,4
46001,100,11811,17049,28105,0,0,1,0,1
46002,100,11812,16796;17054;21048,28105,0,1,2,0,3
46003,100,11813,17063;17429;20021;20500;20591,28105,0,2,3,0,5
46004,100,11814,17083;17536;20347;20539;20836,28105,0,3,2,0,5
46005,100,11815,17095;17511;19636;20516;21180;21488,28105,0,3,3,0,6
46006,100,11816,16986;17162;21069,28105,0,1,2,0,3
46007,100,11817,16985;17108;20742,28105,0,1,2,0,3
46008,100,11818,17110;17405;20030;20424;20727;20938;21080,28105,0,4,3,0,7
46009,100,11819,17027;17152;20603,28105,0,1,2,0,3
46010,100,11820,17142;17269;19575,28105,0,0,3,0,3
46011,100,11821,17519;17727;19926;20138;20399;20468;21494,28105,0,3,4,0,7
46012,100,11822,16535;17193;20280,28105,0,1,2,0,3
46013,100,11823,17216;17556;20048,28105,0,0,3,0,3
46014,100,11824,17215;17222;21909,28105,1,0,2,0,3
46015,100,11825,16805;17223;19574;20520;20783;20998;21226;21850,28105,1,4,3,0,8
46016,100,11826,12037;12690,28470,0,0,0,2,2
46017,100,11828,12111,28470,0,0,0,1,1
46018,100,11829,12017,28470,0,0,0,1,1
46019,100,11831,12189,28470,0,0,0,1,1
46020,100,11834,12027,28470,0,0,0,1,1
46021,100,11835,11770,28470,0,0,0,1,1
46022,100,11837,11995,28470,0,0,0,1,1
46023,100,11841,13028,28470,0,0,0,1,1
46024,100,11844,12412;13075,28470,0,0,0,2,2
46025,100,11846,12964,28470,0,0,0,1,1
46026,100,11859,13767,28470,0,0,0,1,1
46027,100,11860,13485,28470,0,0,0,1,1
46028,100,11863,13967,28470,0,0,0,1,1
46029,100,11864,14265,28470,0,0,1,0,1
46030,100,11865,14029;14751,28470,0,0,1,1,2
46031,100,11866,14592,28470,0,0,1,0,1
46032,100,11873,14896,28470,0,0,1,0,1
46033,100,11877,14969;20108,28470,0,0,2,0,2
46034,100,11878,14875;15317,28470,0,0,2,0,2
46035,100,11879,14620;14848,28470,0,0,2,0,2
46036,100,11880,14123,28470,0,0,0,1,1
46037,100,11884,15242,28470,0,0,1,0,1
46038,100,11886,15585;15852;20073,28470,0,0,3,0,3
46039,100,11889,15803;16083;20017;20288;20494,28470,0,2,3,0,5
46040,100,11890,15503;15652;19690;19785,28470,0,0,4,0,4
46041,100,11891,15563;16566;20226,28470,0,1,2,0,3
46042,100,11892,16314;16319,28470,0,0,2,0,2
46043,100,11893,15701;16082,28470,0,0,2,0,2
46044,100,11894,15980;16158;20633;20744,28470,0,2,2,0,4
46045,100,11895,15969;20478,28470,0,1,1,0,2
46046,100,11896,15842;16129;20055,28470,0,0,3,0,3
46047,100,11898,15887;16431,28470,0,0,2,0,2
46048,100,11900,15979;16351;19698;19811;20272;20408,28470,0,2,4,0,6
46049,100,11901,16056;16499;19797;19902;20157;22052,28470,1,0,5,0,6
46050,100,11902,16242;16484;20147;20470,28470,0,1,3,0,4
46051,100,11904,16259;16485;20515,28470,0,1,2,0,3
46052,100,11905,16285;16780,28470,0,0,2,0,2
46053,100,11906,16380;17272;20071;20201,28470,0,0,4,0,4
46054,100,11907,16207;16406;19815;20069,28470,0,0,4,0,4
46055,100,11908,16435;16710,28470,0,0,2,0,2
46056,100,11909,16459;17082;21440,28470,0,1,2,0,3
46057,100,11910,16408;16502;19961,28470,0,0,3,0,3
46058,100,11911,16515;16885;19773;20762,28470,0,1,3,0,4
46059,100,11912,16876;20166;20573,28470,0,1,2,0,3
46060,100,11913,16673;16702;20572;20778,28470,0,2,2,0,4
46061,100,11914,15653;16682;20139;20665,28470,0,1,3,0,4
46062,100,11915,16392;16730;20153;20383,28470,0,1,3,0,4
46063,100,11916,16587;16747;20239;20594,28470,0,2,2,0,4
46064,100,11917,16830;17375;20476;21151,28470,0,2,2,0,4
46065,100,11918,16890;17512;21141;21567,28470,1,1,2,0,4
46066,100,11919,16905;17008;20652,28470,0,1,2,0,3
46067,100,11920,16950;20702,28470,0,1,1,0,2
46068,100,11921,16962;17016;20365;20588,28470,0,2,2,0,4
46069,100,11923,16981;17440;19869;21492,28470,0,1,3,0,4
46070,100,11924,16989;17424;20484,28470,0,1,2,0,3
46071,100,11925,16911;17496;19833;20615;21011;21176,28470,0,3,3,0,6
46072,100,11926,17499;20228;20473;20915;21710,28470,1,3,1,0,5
46073,100,11927,17332;17402;20133;20376;20767;21923,28470,1,2,3,0,6
46074,100,11928,16917;17036;21107,28470,0,1,2,0,3
46075,100,11929,17508;19943;20176;21234,28470,0,1,3,0,4
46076,100,11930,16931;17097;20395;20905,28470,0,2,2,0,4
46077,100,11931,16886;17104;19708;20159;20309;20346;21817,28470,1,2,4,0,7
46078,100,11932,17130;17575;19694;20792;21007;21731,28470,1,2,3,0,6
46079,100,11933,17148;20425;20745;21099;21276,28470,0,4,1,0,5
46080,100,11934,17011;17156,28470,0,0,2,0,2
46081,100,11935,16817;17189;20614,28470,0,1,2,0,3
46082,100,11936,17592;17845;20608;21432,28470,0,2,2,0,4
46083,100,11937,17014;17201;20622,28470,0,1,2,0,3
46084,100,11938,17200;19763;21313,28470,0,1,2,0,3
46085,100,11939,16649;17208;20403;20995,28470,0,2,2,0,4
46086,100,11940,17147;17227;20065;21012;21853,28470,1,1,3,0,5
46087,100,11941,17113;17231,28470,0,0,2,0,2
46088,100,11942,16666;17234;19883;20088,28470,0,0,4,0,4
46089,100,11943,17244;17246;20058;20368,28470,0,1,3,0,4
46090,100,11944,17256;17320;19683;20107;22048,28470,1,0,4,0,5
46091,100,11945,17192;17267;20015;20743;20797,28470,0,2,3,0,5
46092,100,11946,17284;17673;20678;20869;21600,28470,1,2,2,0,5
46093,100,11947,17509;21188;21418;21824,28470,1,2,1,0,4
46094,100,11948,17312;17457,28470,0,0,2,0,2
46095,100,11949,17344;17492;19967;21712,28470,1,0,3,0,4
46096,100,11951,12164,28835,0,0,0,1,1
46097,100,11952,11931,28835,0,0,0,1,1
46098,100,11955,12313,28835,0,0,0,1,1
46099,100,11956,12722,28835,0,0,0,1,1
46100,100,11957,12763,28835,0,0,0,1,1
46101,100,11958,12823,28835,0,0,0,1,1
46102,100,11960,12880,28835,0,0,0,1,1
46103,100,11964,13030,28835,0,0,0,1,1
46104,100,11965,12844;13089,28835,0,0,0,2,2
46105,100,11967,13337,28835,0,0,0,1,1
46106,100,11973,13756;14155,28835,0,0,0,2,2
46107,100,11977,14005,28835,0,0,0,1,1
46108,100,11982,14565;14598,28835,0,0,2,0,2
46109,100,11985,14688;15100,28835,0,0,2,0,2
46110,100,11990,15213;15553;19788;19938,28835,0,0,4,0,4
46111,100,11991,15345;16150;20013,28835,0,0,3,0,3
46112,100,11992,15369;16080;19977;20303;20432,28835,0,2,3,0,5
46113,100,11995,15074;15235,28835,0,0,2,0,2
46114,100,11997,16053;16142;20317;20558,28835,0,2,2,0,4
46115,100,11998,15791;16210;20936,28835,0,1,2,0,3
46116,100,12000,15697;16076,28835,0,0,2,0,2
46117,100,12004,16433,28835,0,0,1,0,1
46118,100,12006,16301;20039,28835,0,0,2,0,2
46119,100,12007,16387;19948;20430,28835,0,1,2,0,3
46120,100,12008,16423;16949;20134,28835,0,0,3,0,3
46121,100,12009,16196;16558;20542;20768,28835,0,2,2,0,4
46122,100,12011,16104;16611;20268;20605,28835,0,2,2,0,4
46123,100,12012,16356;16636,28835,0,0,2,0,2
46124,100,12013,16735;16983;20144;20310;20355,28835,0,2,3,0,5
46125,100,12016,16700;17174;20537,28835,0,1,2,0,3
46126,100,12017,17218;17374,28835,0,0,2,0,2
46127,100,12019,16517;17059;21195,28835,0,1,2,0,3
46128,100,12020,16757,28835,0,0,1,0,1
46129,100,12021,16874;20775;20882,28835,0,2,1,0,3
46130,100,12022,16349;16810;20264,28835,0,1,2,0,3
46131,100,12023,16852;17213;19841;20738;20812,28835,0,2,3,0,5
46132,100,12025,16898;17326;20501;20736,28835,0,2,2,0,4
46133,100,12027,16770;16926;20907;21481,28835,0,2,2,0,4
46134,100,12028,16942;17533;20247;21626;21911,28835,2,1,2,0,5
46135,100,12029,16963;17527,28835,0,0,2,0,2
46136,100,12032,17017;17632;20206;20461;20840,28835,0,2,3,0,5
46137,100,12033,17283;17551;20691;21262;21593,28835,1,2,2,0,5
46138,100,12034,17032;17605;20505;21068;21270,28835,0,3,2,0,5
46139,100,12035,17034;17531;20861;21200,28835,0,2,2,0,4
46140,100,12036,17052;17131;20848;21334,28835,0,2,2,0,4
46141,100,12037,17274;17395;20241;20509;20599;21742,28835,1,3,2,0,6
46142,100,12038,17066;17381;20137;20583;21444;21922,28835,1,2,3,0,6
46143,100,12039,17067;17406;20192;21384;21602,28835,1,1,3,0,5
46144,100,12040,17120;17687,28835,0,0,2,0,2
46145,100,12041,16882;17123;20513,28835,0,1,2,0,3
46146,100,12042,17091;17143;19991;21028;21570,28835,1,1,3,0,5
46147,100,12043,17144;17207;20655;20962;21178,28835,0,3,2,0,5
46148,100,12044,16888;17166;20386;20579;20862,28835,0,3,2,0,5
46149,100,12045,17177;17430;19888;20082;20429;20447,28835,0,2,4,0,6
46150,100,12046,17232;17493;20896;21356;21803,28835,1,2,2,0,5
46151,100,12047,17435;17557;20631,28835,0,1,2,0,3
46152,100,12048,17237;17704;20229;21687,28835,1,1,2,0,4
46153,100,12049,17060;17239;19957;20794,28835,0,1,3,0,4
46154,100,12050,16941,28835,0,0,1,0,1
46155,100,12051,16965;17248;19851;20001,28835,0,0,4,0,4
46156,100,12053,17288;17304;19801;20161;20525;20816;20879,28835,0,3,4,0,7
46157,100,12054,16477;17307;20028;20286;20880,28835,0,2,3,0,5
46158,100,12055,17323;17580;20387,28835,0,1,2,0,3
46159,100,12056,17331;17392;20593,28835,0,1,2,0,3
46160,100,12058,17356;17627;20951,28835,0,1,2,0,3
46161,100,12059,17206;17372;20051;20724,28835,0,1,3,0,4
46162,100,12060,17271;17393;20086;21065,28835,0,1,3,0,4
46163,100,12061,17530;17788;20056;20888,28835,0,1,3,0,4
46164,100,12062,17467;17671;19990;20079;20449;21928,28835,1,1,4,0,6
46165,100,12063,17588;19924;21677,28835,1,0,2,0,3
46166,100,12064,17473;17619,28835,0,0,2,0,2
46167,100,12065,12264,29200,0,0,0,1,1
46168,100,12067,12311;12445,29200,0,0,0,2,2
46169,100,12068,12510,29200,0,0,0,1,1
46170,100,12070,12768,29200,0,0,0,1,1
46171,100,12071,12875;13108,29200,0,0,0,2,2
46172,100,12073,13006,29200,0,0,0,1,1
46173,100,12076,13228,29200,0,0,0,1,1
46174,100,12078,13166;13310,29200,0,0,0,2,2
46175,100,12082,13417;14092,29200,0,0,0,2,2
46176,100,12083,13429;13713,29200,0,0,0,2,2
46177,100,12090,14199,29200,0,0,0,1,1
46178,100,12092,14335,29200,0,0,1,0,1
46179,100,12097,14617,29200,0,0,1,0,1
46180,100,12098,14554;14994,29200,0,0,2,0,2
46181,100,12100,14380;14850,29200,0,0,2,0,2
46182,100,12101,15020;15167,29200,0,0,2,0,2
46183,100,12106,15408;15788;20188,29200,0,0,3,0,3
46184,100,12111,15657;16204;20023,29200,0,0,3,0,3
46185,100,12112,15723;15935,29200,0,0,2,0,2
46186,100,12115,15899;16711;20507;20703,29200,0,2,2,0,4
46187,100,12116,15914;16657,29200,0,0,2,0,2
46188,100,12117,15976;16342;21639,29200,1,0,2,0,3
46189,100,12118,16004;16862;20145;20549,29200,0,1,3,0,4
46190,100,12119,16102;16462;19920;20096,29200,0,0,4,0,4
46191,100,12120,16109;16165;19919;20193,29200,0,0,4,0,4
46192,100,12123,16298,29200,0,0,1,0,1
46193,100,12124,16486;17107;19915;20755,29200,0,1,3,0,4
46194,100,12125,16505;16800,29200,0,0,2,0,2
46195,100,12126,16518;16904,29200,0,0,2,0,2
46196,100,12127,16528;16977;20679;20799,29200,0,2,2,0,4
46197,100,12128,16200;17090;20917;21108;21298,29200,0,3,2,0,5
46198,100,12129,16591;17133;20696;21288;21347,29200,0,3,2,0,5
46199,100,12130,16604;16797,29200,0,0,2,0,2
46200,100,12131,16621;21236,29200,0,1,1,0,2
46201,100,12132,16813;17447;20276;20641;21502,29200,1,2,2,0,5
46202,100,12133,16559;17236;20263,29200,0,1,2,0,3
46203,100,12134,16658;16719;20538;20590;20760,29200,0,3,2,0,5
46204,100,12135,16933;17010;20163;20333;20629,29200,0,2,3,0,5
46205,100,12136,16828;17296;20659;21135,29200,0,2,2,0,4
46206,100,12137,16834;17195;20654;21259,29200,0,2,2,0,4
46207,100,12138,16014;16306;20737,29200,0,1,2,0,3
46208,100,12140,16543;17220;20397,29200,0,1,2,0,3
46209,100,12141,17348,29200,0,0,1,0,1
46210,100,12142,17019;17165;20483,29200,0,1,2,0,3
46211,100,12143,16997;17042;21421,29200,0,1,2,0,3
46212,100,12144,17045;17706;20041;20326,29200,0,1,3,0,4
46213,100,12145,17075;17230;20471;21057,29200,0,2,2,0,4
46214,100,12146,17129;17359;20681;21620,29200,1,1,2,0,4
46215,100,12147,17139;21129,29200,0,1,1,0,2
46216,100,12148,17141,29200,0,0,1,0,1
46217,100,12149,17145;17327;20415,29200,0,1,2,0,3
46218,100,12150,17448;17485;20983;21283,29200,0,2,2,0,4
46219,100,12151,17229;17672;21348,29200,0,1,2,0,3
46220,100,12152,17093;17294;20697,29200,0,1,2,0,3
46221,100,12153,17254;20469;21193,29200,0,2,1,0,3
46222,100,12154,17277;17747;19893;20475;20716,29200,0,2,3,0,5
46223,100,12155,17280;17875;20639;21177,29200,0,2,2,0,4
46224,100,12156,17228;17300;21127,29200,0,1,2,0,3
46225,100,12157,16939;17316;20172;21149,29200,0,1,3,0,4
46226,100,12158,16943;17360;20350;20986,29200,0,2,2,0,4
46227,100,12160,17602;17616;20340;21926,29200,1,1,2,0,4
46228,100,12161,17403;17635;21424,29200,0,1,2,0,3
46229,100,12162,17710;17896;20900;21257,29200,0,2,2,0,4
46230,100,12163,17500;17846;20330;20732,29200,0,2,2,0,4
46231,100,12164,17340;17505;20216;20692;21613,29200,1,1,3,0,5
46232,100,12165,17767;17828;20005;20661;21935,29200,1,1,3,0,5
46233,100,12166,17534;17733;20024;20974,29200,0,1,3,0,4
46234,100,12167,17761;20167;21875,29200,1,0,2,0,3
46235,100,12168,17554;17600;20942,29200,0,1,2,0,3
46236,100,12169,17567;17878;20741;21536,29200,1,1,2,0,4
46237,100,12170,12130,29565,0,0,0,1,1
46238,100,12171,12398;12741,29565,0,0,0,2,2
46239,100,12174,12511,29565,0,0,0,1,1
46240,100,12175,12614,29565,0,0,0,1,1
46241,100,12176,12248,29565,0,0,0,1,1
46242,100,12179,12743,29565,0,0,0,1,1
46243,100,12180,12956,29565,0,0,0,1,1
46244,100,12184,12716,29565,0,0,0,1,1
46245,100,12187,13135;13366,29565,0,0,0,2,2
46246,100,12195,13498;13780,29565,0,0,0,2,2
46247,100,12198,13872;13889,29565,0,0,0,2,2
46248,100,12201,14100,29565,0,0,0,1,1
46249,100,12203,14351;14847,29565,0,0,2,0,2
46250,100,12205,14397;14619,29565,0,0,2,0,2
46251,100,12206,14606;14880,29565,0,0,2,0,2
46252,100,12208,14745;15133,29565,0,0,2,0,2
46253,100,12209,14474;14928,29565,0,0,2,0,2
46254,100,12210,15694,29565,0,0,1,0,1
46255,100,12211,15187,29565,0,0,1,0,1
46256,100,12215,15659;16099;20238,29565,0,1,2,0,3
46257,100,12218,15840,29565,0,0,1,0,1
46258,100,12219,15960;16400;20155;20669,29565,0,1,3,0,4
46259,100,12221,15404;15983,29565,0,0,2,0,2
46260,100,12222,15957;16062,29565,0,0,2,0,2
46261,100,12223,15933;16071;20132;20382,29565,0,1,3,0,4
46262,100,12226,16612;16806;20414;20438;21014,29565,0,3,2,0,5
46263,100,12227,15860;16134,29565,0,0,2,0,2
46264,100,12228,16232;16630;20673;21437,29565,0,2,2,0,4
46265,100,12229,15482;16309;20389,29565,0,1,2,0,3
46266,100,12231,16332;17050;20684;21173,29565,0,2,2,0,4
46267,100,12233,16957;20441;20717,29565,0,2,1,0,3
46268,100,12234,15572;16415;20758;21123,29565,0,2,2,0,4
46269,100,12236,16156;16496;20495,29565,0,1,2,0,3
46270,100,12237,16564;16646;20787;21218,29565,0,2,2,0,4
46271,100,12238,16128;16824;20421;20598;20941,29565,0,3,2,0,5
46272,100,12239,16835;16906;20259;20586,29565,0,2,2,0,4
46273,100,12240,17247;20868;21368,29565,0,2,1,0,3
46274,100,12241,16511;16683;20123;20606,29565,0,1,3,0,4
46275,100,12242,16715;17329;21186;21601,29565,1,1,2,0,4
46276,100,12243,16767;17469;21663,29565,1,0,2,0,3
46277,100,12244,16781;17122;20587;20714,29565,0,2,2,0,4
46278,100,12246,16555;16690,29565,0,0,2,0,2
46279,100,12247,16884;17116;20338,29565,0,1,2,0,3
46280,100,12248,16643;16916;20564;20996;21483,29565,0,3,2,0,5
46281,100,12249,16956;17154;20721,29565,0,1,2,0,3
46282,100,12250,16993;17541;20043;20343;21560,29565,1,1,3,0,5
46283,100,12251,17004;17522;20396;20602;21528,29565,1,2,2,0,5
46284,100,12252,16444;16814,29565,0,0,2,0,2
46285,100,12253,17056;17146;21372,29565,0,1,2,0,3
46286,100,12254,17464;21330,29565,0,1,1,0,2
46287,100,12255,17163;20207;21535,29565,1,0,2,0,3
46288,100,12256,16696;17099;20776;21280;21678,29565,1,2,2,0,5
46289,100,12257,17380;20315,29565,0,1,1,0,2
46290,100,12258,16680;17176;20003,29565,0,0,3,0,3
46291,100,12259,17184;17663;20366;21391,29565,0,2,2,0,4
46292,100,12260,17187;17404;20274;21194,29565,0,2,2,0,4
46293,100,12262,17243;20884,29565,0,1,1,0,2
46294,100,12263,17109;17245;20329;20477,29565,0,2,2,0,4
46295,100,12264,17251;17262;20374,29565,0,1,2,0,3
46296,100,12265,17279;17662;20302;20784;20999,29565,0,3,2,0,5
46297,100,12266,16901;17285;20566;20846,29565,0,2,2,0,4
46298,100,12267,17364;17426;20895,29565,0,1,2,0,3
46299,100,12268,17128;17389;20548;21202,29565,0,2,2,0,4
46300,100,12269,17400;17923;20183;20282;20971,29565,0,2,3,0,5
46301,100,12270,18042;21404;21715,29565,1,1,1,0,3
46302,100,12271,17309;17470;20802;21772,29565,1,1,2,0,4
46303,100,12272,17431;17491;20416;21505,29565,1,1,2,0,4
46304,100,12273,17566;17742;20004;20175;20664,29565,0,1,4,0,5
46305,100,12274,17459;17670;20489,29565,0,1,2,0,3
46306,100,12275,17453;17460;20578;20855;20927;21137,29565,0,4,2,0,6
46307,100,12276,17462;17507;21878;21924,29565,2,0,2,0,4
46308,100,12277,17003;17463;20426,29565,0,1,2,0,3
46309,100,12278,17487;17807;20097;20325;20624,29565,0,2,3,0,5
46310,100,12279,17118;17489;21082;21518;21811,29565,2,1,2,0,5
46311,100,12280,17506;17768;20852;20898,29565,0,2,2,0,4
46312,100,12281,18034;20225;20378;21233,29565,0,3,1,0,4
46313,100,12282,17182;17523;20066;20940;21092,29565,0,2,3,0,5
46314,100,12283,17542;17955;21374;21653,29565,1,1,2,0,4
46315,100,12285,17591;17805;21501,29565,1,0,2,0,3
46316,100,12287,17433;17604;20358;20903;21055;21130;21815,29565,1,4,2,0,7
46317,100,12288,17476;17617;20371,29565,0,1,2,0,3
46318,100,12289,17333;17621;21060;21264;21927,29565,1,2,2,0,5
46319,100,12290,17572;17622;20715;21165,29565,0,2,2,0,4
46320,100,12291,17610;17982,29565,0,0,2,0,2
46321,100,12292,17330;17656;21084;21445,29565,0,2,2,0,4
46322,100,12293,17548;17684;21043;21249;21449,29565,0,3,2,0,5
46323,100,12294,12502,29930,0,0,0,1,1
46324,100,12295,12507,29930,0,0,0,1,1
46325,100,12296,12534,29930,0,0,0,1,1
46326,100,12297,12576,29930,0,0,0,1,1
46327,100,12298,12645,29930,0,0,0,1,1
46328,100,12302,12863,29930,0,0,0,1,1
46329,100,12304,12907,29930,0,0,0,1,1
46330,100,12305,12979,29930,0,0,0,1,1
46331,100,12308,13247,29930,0,0,0,1,1
46332,100,12312,13148;13661,29930,0,0,0,2,2
46333,100,12315,13160,29930,0,0,0,1,1
46334,100,12316,13541;13902,29930,0,0,0,2,2
46335,100,12317,13202,29930,0,0,0,1,1
46336,100,12318,13145,29930,0,0,0,1,1
46337,100,12321,14218,29930,0,0,0,1,1
46338,100,12324,14328;14389,29930,0,0,2,0,2
46339,100,12327,14403,29930,0,0,1,0,1
46340,100,12331,14469;14561,29930,0,0,2,0,2
46341,100,12333,14947;15777,29930,0,0,2,0,2
46342,100,12334,15243;15683,29930,0,0,2,0,2
46343,100,12335,15698;15724,29930,0,0,2,0,2
46344,100,12336,14937,29930,0,0,1,0,1
46345,100,12340,15681;16268,29930,0,0,2,0,2
46346,100,12342,15804;16068;20451,29930,0,1,2,0,3
46347,100,12345,16212;17136,29930,0,0,2,0,2
46348,100,12347,16384;20676;20933,29930,0,2,1,0,3
46349,100,12348,16816;21102,29930,0,1,1,0,2
46350,100,12349,16638;16959;20859;21355;21655,29930,1,2,2,0,5
46351,100,12350,16743;16879;20360;20569;20757,29930,0,3,2,0,5
46352,100,12351,16837,29930,0,0,1,0,1
46353,100,12352,16827;21608,29930,1,0,1,0,2
46354,100,12354,16772;16929,29930,0,0,2,0,2
46355,100,12355,16421;16785,29930,0,0,2,0,2
46356,100,12356,16574;16818;20668;21439,29930,0,2,2,0,4
46357,100,12357,16848;17112;20345;20699;21063,29930,0,3,2,0,5
46358,100,12358,16873;17024,29930,0,0,2,0,2
46359,100,12359,17445;20335;20695;21036,29930,0,3,1,0,4
46360,100,12360,16410;17051;20636,29930,0,1,2,0,3
46361,100,12361,16880;17126;21344,29930,0,1,2,0,3
46362,100,12362,17135;20126;20300;20504;20786,29930,0,3,2,0,5
46363,100,12363,17159;18088;20255;20427;20626;21543,29930,1,3,2,0,6
46364,100,12365,16776;17179;21291;21787,29930,1,1,2,0,4
46365,100,12366,17185;17690;20544;21320,29930,0,2,2,0,4
46366,100,12367,17078;17315;21642,29930,1,0,2,0,3
46367,100,12368,17258;17278;20689,29930,0,1,2,0,3
46368,100,12369,17385;17583;20526;21190;21534,29930,1,2,2,0,5
46369,100,12370,16624;17164;21244,29930,0,1,2,0,3
46370,100,12371,17418;17972;21111;21694;21944,29930,2,1,2,0,5
46371,100,12372,17007;17449;20857;21632,29930,1,1,2,0,4
46372,100,12374,17675;17717;20711;21295;21685,29930,1,2,2,0,5
46373,100,12375,17488;17943;21324,29930,0,1,2,0,3
46374,100,12376,17540;17840;20422;20450;20648;21279;21403,29930,0,5,2,0,7
46375,100,12377,17335;17586;21554,29930,1,0,2,0,3
46376,100,12378,17451;17719,29930,0,0,2,0,2
46377,100,12380,17637;17756;20833;21117;21776;21918,29930,2,2,2,0,6
46378,100,12381,17661;18067;20146;20704;21017,29930,0,2,3,0,5
46379,100,12382,17286;17669;20872,29930,0,1,2,0,3
46380,100,12383,17263;17677;21417;21761,29930,1,1,2,0,4
46381,100,12384,17692;17723;20409;20733;20837;21118;21729;21929,29930,2,4,2,0,8
46382,100,12385,17456;17737;20834;20877;21773,29930,1,2,2,0,5
46383,100,12386,17748;18120;20411;20632;21042,29930,0,3,2,0,5
46384,100,12387,17775;17994;20214;20446;20937;21263;21852,29930,1,3,3,0,7
46385,100,12388,17796;17847;21163;21838,29930,1,1,2,0,4
46386,100,12389,17799;18009,29930,0,0,2,0,2
46387,100,12390,17382;17801;21010;21357;21628,29930,1,2,2,0,5
46388,100,12391,12607,30295,0,0,0,1,1
46389,100,12393,12220,30295,0,0,0,1,1
46390,100,12395,12933,30295,0,0,0,1,1
46391,100,12396,12593,30295,0,0,0,1,1
46392,100,12398,12402,30295,0,0,0,1,1
46393,100,12400,13081,30295,0,0,0,1,1
46394,100,12401,12513;12976,30295,0,0,0,2,2
46395,100,12403,13418,30295,0,0,0,1,1
46396,100,12407,13804,30295,0,0,0,1,1
46397,100,12408,13900,30295,0,0,0,1,1
46398,100,12424,15054;15329,30295,0,0,2,0,2
46399,100,12425,15253;15455,30295,0,0,2,0,2
46400,100,12432,15417,30295,0,0,1,0,1
46401,100,12433,15468,30295,0,0,1,0,1
46402,100,12434,15793;16397,30295,0,0,2,0,2
46403,100,12436,16334;16354;20687,30295,0,1,2,0,3
46404,100,12439,16215,30295,0,0,1,0,1
46405,100,12440,16184;16973;21397,30295,0,1,2,0,3
46406,100,12443,16325;16746,30295,0,0,2,0,2
46407,100,12444,16430;16494;20807;20934,30295,0,2,2,0,4
46408,100,12445,16867;20490,30295,0,1,1,0,2
46409,100,12446,16652;17023,30295,0,0,2,0,2
46410,100,12447,16513;16655,30295,0,0,2,0,2
46411,100,12448,16536;16569,30295,0,0,2,0,2
46412,100,12449,17175;21066,30295,0,1,1,0,2
46413,100,12450,16619;16754;21351,30295,0,1,2,0,3
46414,100,12453,16789;16832;20364,30295,0,1,2,0,3
46415,100,12455,16677;16955;20645,30295,0,1,2,0,3
46416,100,12457,16936;17482;20312;21269,30295,0,2,2,0,4
46417,100,12458,16807;17219;21480,30295,0,1,2,0,3
46418,100,12460,16998;17211;20809,30295,0,1,2,0,3
46419,100,12461,17058;17538;20609;21070,30295,0,2,2,0,4
46420,100,12462,16910;17170;20493;20653,30295,0,2,2,0,4
46421,100,12463,17197;17394;21125,30295,0,1,2,0,3
46422,100,12464,17196;17584;21020;21457,30295,0,2,2,0,4
46423,100,12465,18203;21078;21170;21316;21453,30295,0,4,1,0,5
46424,100,12466,16704;16996;20682;20759,30295,0,2,2,0,4
46425,100,12467,17289;17547;20499;21026;21925,30295,1,2,2,0,5
46426,100,12468,16954;17302;21030,30295,0,1,2,0,3
46427,100,12469,17306;17341;20487;20906,30295,0,2,2,0,4
46428,100,12470,17321;17998,30295,0,0,2,0,2
46429,100,12471,17310;17346;20713,30295,0,1,2,0,3
46430,100,12473,17765;21346;21455,30295,0,2,1,0,3
46431,100,12474,17371;20367;20766;21086,30295,0,3,1,0,4
46432,100,12475,17376;17378;20540;21581,30295,1,1,2,0,4
46433,100,12476,17057;17411;21629,30295,1,0,2,0,3
46434,100,12477,17480;17546;20849;21201;21784,30295,1,2,2,0,5
46435,100,12478,17502;17824;21422;21675,30295,1,1,2,0,4
46436,100,12479,17514;17544;21000,30295,0,1,2,0,3
46437,100,12480,17739;20619;21274;21834,30295,1,2,1,0,4
46438,100,12481,17537;17653;21822,30295,1,0,2,0,3
46439,100,12482,17574;17623;20866,30295,0,1,2,0,3
46440,100,12483,17576;18021;20977;21059,30295,0,2,2,0,4
46441,100,12484,17585;17703;21199;21312,30295,0,2,2,0,4
46442,100,12485,18103,30295,0,0,1,0,1
46443,100,12486,17606;18262;20672;20939,30295,0,2,2,0,4
46444,100,12487,17242;17608;20462;20764;20959;21126;21447,30295,0,5,2,0,7
46445,100,12489,17685;17819,30295,0,0,2,0,2
46446,100,12490,18160;21955,30295,1,0,1,0,2
46447,100,12491,17726;17867;20693;20921;21930,30295,1,2,2,0,5
46448,100,12492,17743;18235;20523;21243,30295,0,2,2,0,4
46449,100,12493,17750;17781;20233;20828;21900,30295,1,2,2,0,5
46450,100,12494,17396;17811;20420;21053,30295,0,2,2,0,4
46451,100,12495,17813;17872;20987;21155,30295,0,2,2,0,4
46452,100,12496,17900;21079;21326,30295,0,2,1,0,3
46453,100,12497,17646;17834;20472;20651,30295,0,2,2,0,4
46454,100,12498,17642;17841,30295,0,0,2,0,2
46455,100,12499,17746;17849;20257;20498;20567;21252,30295,0,4,2,0,6
46456,100,12500,17795;20308;20854;21054;21826,30295,1,3,1,0,5
46457,100,12501,17526;17857;20739;21056;21067,30295,0,3,2,0,5
46458,100,12502,17866;17975;20457;20752;21044;21879,30295,1,3,2,0,6
46459,100,12503,17474;17645;21167;21725,30295,1,1,2,0,4
46460,100,12504,17593;17880;20731;21143,30295,0,2,2,0,4
46461,100,12505,17883;18135;21527;21898,30295,2,0,2,0,4
46462,100,12506,17399;17898;21008;21245;21812,30295,1,2,2,0,5
46463,100,12507,17918;18197;21509;21767;21958,30295,3,0,2,0,5
46464,100,12508,13472,30660,0,0,0,1,1
46465,100,12509,12749,30660,0,0,0,1,1
46466,100,12510,12600,30660,0,0,0,1,1
46467,100,12512,12461;12777,30660,0,0,0,2,2
46468,100,12514,12987,30660,0,0,0,1,1
46469,100,12517,13249,30660,0,0,0,1,1
46470,100,12519,13289;13779,30660,0,0,0,2,2
46471,100,12520,12689,30660,0,0,0,1,1
46472,100,12522,12865,30660,0,0,0,1,1
46473,100,12523,13025,30660,0,0,0,1,1
46474,100,12529,14037,30660,0,0,0,1,1
46475,100,12531,13544;13768,30660,0,0,0,2,2
46476,100,12538,14805;15254,30660,0,0,2,0,2
46477,100,12539,15125,30660,0,0,1,0,1
46478,100,12541,14730;15109,30660,0,0,2,0,2
46479,100,12545,15161;16120,30660,0,0,2,0,2
46480,100,12549,15647,30660,0,0,1,0,1
46481,100,12554,15864;16166,30660,0,0,2,0,2
46482,100,12560,16074,30660,0,0,1,0,1
46483,100,12565,16108;16582;20533,30660,0,1,2,0,3
46484,100,12566,16405;16598;20826,30660,0,1,2,0,3
46485,100,12569,16634;20418;20458,30660,0,2,1,0,3
46486,100,12572,16726;17043,30660,0,0,2,0,2
46487,100,12573,17002,30660,0,0,1,0,1
46488,100,12575,16902;17720;21630;21919,30660,2,0,2,0,4
46489,100,12576,16978;17241;20519;21340,30660,0,2,2,0,4
46490,100,12577,17088;17524;21610,30660,1,0,2,0,3
46491,100,12578,17121;17132;20440,30660,0,1,2,0,3
46492,100,12579,17186;17249,30660,0,0,2,0,2
46493,100,12580,17268;17387;20351;20754,30660,0,2,2,0,4
46494,100,12581,16782;17305;20701;21611,30660,1,1,2,0,4
46495,100,12582,16762;17317;20332;21160,30660,0,2,2,0,4
46496,100,12583,17318;17352;20467;20820,30660,0,2,2,0,4
46497,100,12584,17343;17455;20480,30660,0,1,2,0,3
46498,100,12585,17887;21420;21646,30660,1,1,1,0,3
46499,100,12586,17386;17630;20688;21273,30660,0,2,2,0,4
46500,100,12587,17903;18047;20658;20865;21538;21938,30660,2,2,2,0,6
46501,100,12588,17432;17826;20381;20931;21321,30660,0,3,2,0,5
46502,100,12589,18072;21575,30660,1,0,1,0,2
46503,100,12590,17442;18291,30660,0,0,2,0,2
46504,100,12591,17452,30660,0,0,1,0,1
46505,100,12592,17427;17510;21314,30660,0,1,2,0,3
46506,100,12593,16984;17568;21452;21820,30660,1,1,2,0,4
46507,100,12594,17342;17562;21425,30660,0,1,2,0,3
46508,100,12595,17250;17766;20556;20961;21461,30660,0,3,2,0,5
46509,100,12596,17571;17882;20914;21168,30660,0,2,2,0,4
46510,100,12597,17861;17908;20474;21220,30660,0,2,2,0,4
46511,100,12598,17589;17822,30660,0,0,2,0,2
46512,100,12599,18095;18122;20503;20623;20864,30660,0,3,2,0,5
46513,100,12600,17705;17959,30660,0,0,2,0,2
46514,100,12601,17495;17711;21689;21847,30660,2,0,2,0,4
46515,100,12603,17713;18164;21568,30660,1,0,2,0,3
46516,100,12604,17735;21025;21361,30660,0,2,1,0,3
46517,100,12605,17741;18354,30660,0,0,2,0,2
46518,100,12606,17759;18215;20417;20804,30660,0,2,2,0,4
46519,100,12607,17550;17783;21796,30660,1,0,2,0,3
46520,100,12608,17609;17835;20485;21892,30660,1,1,2,0,4
46521,100,12609,17838;18216;21018;21634,30660,1,1,2,0,4
46522,100,12610,17862;18126,30660,0,0,2,0,2
46523,100,12611,17494;17782;21516;21836,30660,2,0,2,0,4
46524,100,12612,17901;17951;21034;21319,30660,0,2,2,0,4
46525,100,12613,17911;17921,30660,0,0,2,0,2
46526,100,12614,17915;18232;20546;21332,30660,0,2,2,0,4
46527,100,12615,17563;17926;21941,30660,1,0,2,0,3
46528,100,12617,17941,30660,0,0,1,0,1
46529,100,12618,17598;17957;21750,30660,1,0,2,0,3
46530,100,12619,17979;21764,30660,1,0,1,0,2
46531,100,12620,17383;17850;20580;20970,30660,0,2,2,0,4
46532,100,12621,18002;18131;21134;21296;21564,30660,1,2,2,0,5
46533,100,12622,17837;18007;21205,30660,0,1,2,0,3
46534,100,12623,18097;18230;21961,30660,1,0,2,0,3
46535,100,12624,18024;21217,30660,0,1,1,0,2
46536,100,12625,17515;17870,30660,0,0,2,0,2
46537,100,12626,18121;18340,30660,0,0,2,0,2
46538,100,12627,17398;18046,30660,0,0,2,0,2
46539,100,12629,12757,31025,0,0,0,1,1
46540,100,12630,12833,31025,0,0,0,1,1
46541,100,12631,12545,31025,0,0,0,1,1
46542,100,12633,13102,31025,0,0,0,1,1
46543,100,12634,13380,31025,0,0,0,1,1
46544,100,12636,13402;14017,31025,0,0,0,2,2
46545,100,12639,13519;13707,31025,0,0,0,2,2
46546,100,12642,13671,31025,0,0,0,1,1
46547,100,12647,14008,31025,0,0,0,1,1
46548,100,12652,14512;14604,31025,0,0,2,0,2
46549,100,12653,14267;15140,31025,0,0,2,0,2
46550,100,12664,15624,31025,0,0,1,0,1
46551,100,12667,15632;16466,31025,0,0,2,0,2
46552,100,12668,15299;16029,31025,0,0,2,0,2
46553,100,12673,16755;17102;20929,31025,0,1,2,0,3
46554,100,12674,15996;16002,31025,0,0,2,0,2
46555,100,12676,16632;17085;20694;21050,31025,0,2,2,0,4
46556,100,12677,16718;20600;21219,31025,0,2,1,0,3
46557,100,12678,16525;16758,31025,0,0,2,0,2
46558,100,12679,16847,31025,0,0,1,0,1
46559,100,12680,17259;20643,31025,0,1,1,0,2
46560,100,12682,16740;17025;20630;21041,31025,0,2,2,0,4
46561,100,12684,16825;17064,31025,0,0,2,0,2
46562,100,12689,17282;17738;20926;21526,31025,1,1,2,0,4
46563,100,12690,16860;17299;20946;21091,31025,0,2,2,0,4
46564,100,12691,17601;17716,31025,0,0,2,0,2
46565,100,12692,17006;17660;20488;21588,31025,1,1,2,0,4
46566,100,12693,17096;17370;20524;20601;20964,31025,0,3,2,0,5
46567,100,12694,17413;17490;21624,31025,1,0,2,0,3
46568,100,12695,17150;17504;20708,31025,0,1,2,0,3
46569,100,12697,18190;18200;20443;20831,31025,0,2,2,0,4
46570,100,12698,17521;17577;20953,31025,0,1,2,0,3
46571,100,12699,17815;18109;21722,31025,1,0,2,0,3
46572,100,12700,17503;17674;21414;21617,31025,1,1,2,0,4
46573,100,12701,17688;17774,31025,0,0,2,0,2
46574,100,12702,17722;18010,31025,0,0,2,0,2
46575,100,12703,17543;17731;20844;21352,31025,0,2,2,0,4
46576,100,12704,17745;17803;21469,31025,0,1,2,0,3
46577,100,12705,17942;20722;20788;21228;21943,31025,1,3,1,0,5
46578,100,12706,17769;21004;21695;21933,31025,2,1,1,0,4
46579,100,12707,17858;17949;20620;21116;21426;21936,31025,1,3,2,0,6
46580,100,12708,17873;17888;20712;20988;21076,31025,0,3,2,0,5
46581,100,12709,17558;17889,31025,0,0,2,0,2
46582,100,12710,17612;18133;20751;21089;21377;21737,31025,1,3,2,0,6
46583,100,12711,17932;18376;20822;20875;21206,31025,0,3,2,0,5
46584,100,12712,17976;18249;20763;21039,31025,0,2,2,0,4
46585,100,12713,17977;18199;20991;21496,31025,0,2,2,0,4
46586,100,12714,18130;18274,31025,0,0,2,0,2
46587,100,12715,18016;21353;21598,31025,1,1,1,0,3
46588,100,12716,17978;18022;21443;21788,31025,1,1,2,0,4
46589,100,12717,17869;18032,31025,0,0,2,0,2
46590,100,12718,18050;18281;21664,31025,1,0,2,0,3
46591,100,12719,18053,31025,0,0,1,0,1
46592,100,12720,18075;18258;20534;20801;21596;21963,31025,2,2,2,0,6
46593,100,12721,18089;18163,31025,0,0,2,0,2
46594,100,12723,18185;18279;20924,31025,0,1,2,0,3
46595,100,12724,18225;21859,31025,1,0,1,0,2
46596,100,12725,17935;18134;20670;20874;21230;21754,31025,1,3,2,0,6
46597,100,12726,18096;18147,31025,0,0,2,0,2
46598,100,12727,12560,31390,0,0,0,1,1
46599,100,12729,13238,31390,0,0,0,1,1
46600,100,12730,13190,31390,0,0,0,1,1
46601,100,12731,12971,31390,0,0,0,1,1
46602,100,12732,13269,31390,0,0,0,1,1
46603,100,12733,13667,31390,0,0,0,1,1
46604,100,12737,13248,31390,0,0,0,1,1
46605,100,12740,14058,31390,0,0,0,1,1
46606,100,12741,14144,31390,0,0,0,1,1
46607,100,12746,14423;14629,31390,0,0,2,0,2
46608,100,12747,14543;14687,31390,0,0,2,0,2
46609,100,12748,14741;14882,31390,0,0,2,0,2
46610,100,12762,15306,31390,0,0,1,0,1
46611,100,12766,16017;16141,31390,0,0,2,0,2
46612,100,12767,16061;16463;21159,31390,0,1,2,0,3
46613,100,12772,16041;16146,31390,0,0,2,0,2
46614,100,12774,16205;16944;20954,31390,0,1,2,0,3
46615,100,12777,16388;16727;21466,31390,0,1,2,0,3
46616,100,12778,16161,31390,0,0,1,0,1
46617,100,12780,16653;17190,31390,0,0,2,0,2
46618,100,12781,16721;17345;21002,31390,0,1,2,0,3
46619,100,12783,16793,31390,0,0,1,0,1
46620,100,12784,16705;16864,31390,0,0,2,0,2
46621,100,12785,16868;17080;20829,31390,0,1,2,0,3
46622,100,12786,16614;17013,31390,0,0,2,0,2
46623,100,12787,17217;17255;21246,31390,0,1,2,0,3
46624,100,12788,17081;17183;20740;21436,31390,0,2,2,0,4
46625,100,12790,17158;20710;20813;21024,31390,0,3,1,0,4
46626,100,12791,16938;17115;20950;21031,31390,0,2,2,0,4
46627,100,12795,17555;17570;20749;21497;21899,31390,2,1,2,0,5
46628,100,12796,17127;17434;20571;20932,31390,0,2,2,0,4
46629,100,12797,17171,31390,0,0,1,0,1
46630,100,12798,17422;17729;21454,31390,0,1,2,0,3
46631,100,12799,16615;17238;20805;20867,31390,0,2,2,0,4
46632,100,12800,16804;17648;20795;21064;21192;21844,31390,1,3,2,0,6
46633,100,12801,16952;17313;21317,31390,0,1,2,0,3
46634,100,12802,17319;17772;20625;21161,31390,0,2,2,0,4
46635,100,12803,17334;17338,31390,0,0,2,0,2
46636,100,12804,17351;20557,31390,0,1,1,0,2
46637,100,12805,17353,31390,0,0,1,0,1
46638,100,12806,17559;17560;20910;21179,31390,0,2,2,0,4
46639,100,12807,17373;17535;21145,31390,0,1,2,0,3
46640,100,12808,17443;17865;20919;21460,31390,0,2,2,0,4
46641,100,12809,17172;20646,31390,0,1,1,0,2
46642,100,12810,17194;17528;21183,31390,0,1,2,0,3
46643,100,12811,17569;17615;20838,31390,0,1,2,0,3
46644,100,12812,17624;18277;20705;20909;21335,31390,0,3,2,0,5
46645,100,12813,17664;18427;20592;21513,31390,1,1,2,0,4
46646,100,12814,17486;17680;21112,31390,0,1,2,0,3
46647,100,12815,17699;17714;21231;21485,31390,0,2,2,0,4
46648,100,12816,17715;17917;21939,31390,1,0,2,0,3
46649,100,12817,17764;18114;21015;21172;21350;21950,31390,1,3,2,0,6
46650,100,12818,17787;18259;21730;21876,31390,2,0,2,0,4
46651,100,12819,17874;18006;21121;21367;21781,31390,1,2,2,0,5
46652,100,12820,18481;18683;20718;20863,31390,0,2,2,0,4
46653,100,12821,17679;17854;21498;21873,31390,2,0,2,0,4
46654,100,12822,18287;18405;21973,31390,1,0,2,0,3
46655,100,12823,17628;17920,31390,0,0,2,0,2
46656,100,12824,17721;17937;21001;21222;21942,31390,1,2,2,0,5
46657,100,12825,17871;17985,31390,0,0,2,0,2
46658,100,12826,18233,31390,0,0,1,0,1
46659,100,12827,17618;18267;21388;21801,31390,1,1,2,0,4
46660,100,12828,18017;18483;21210;21532,31390,1,1,2,0,4
46661,100,12829,17965;18004;20634;20677,31390,0,2,2,0,4
46662,100,12831,18083;21309;21589,31390,1,1,1,0,3
46663,100,12832,18179;21733,31390,1,0,1,0,2
46664,100,12833,18090;18178;21482,31390,0,1,2,0,3
46665,100,12834,18401;21555;21972,31390,2,0,1,0,3
46666,100,12835,18162;21428,31390,0,1,1,0,2
46667,100,12836,18189;18925;21058;21266,31390,0,2,2,0,4
46668,100,12837,18725;18785;21487,31390,0,1,2,0,3
46669,100,12838,18219;18558;20589;20947;21133,31390,0,3,2,0,5
46670,100,12839,17984;18238;21400;21484,31390,0,2,2,0,4
46671,100,12840,18177;18240;21305;21464;21525,31390,1,2,2,0,5
46672,100,12842,13136,31755,0,0,0,1,1
46673,100,12844,13197;13326,31755,0,0,0,2,2
46674,100,12845,13083,31755,0,0,0,1,1
46675,100,12847,13831,31755,0,0,0,1,1
46676,100,12849,13966,31755,0,0,0,1,1
46677,100,12853,14310,31755,0,0,1,0,1
46678,100,12854,14366;14685,31755,0,0,2,0,2
46679,100,12856,14597,31755,0,0,1,0,1
46680,100,12863,15089;15813,31755,0,0,2,0,2
46681,100,12865,15179;15536,31755,0,0,2,0,2
46682,100,12869,15543,31755,0,0,1,0,1
46683,100,12871,15959,31755,0,0,1,0,1
46684,100,12877,16819;17160;20761,31755,0,1,2,0,3
46685,100,12879,17071;17419;20968;21093,31755,0,2,2,0,4
46686,100,12880,16419;16595,31755,0,0,2,0,2
46687,100,12881,17021;17076;21103;21720,31755,1,1,2,0,4
46688,100,12882,17029;17149;21491,31755,0,1,2,0,3
46689,100,12883,16723;21061;21721,31755,1,1,1,0,3
46690,100,12884,17665;21229,31755,0,1,1,0,2
46691,100,12886,17260;17779;20975;21495;21877,31755,1,2,2,0,5
46692,100,12887,17264;17465;20883;21459,31755,0,2,2,0,4
46693,100,12889,17354;17573;20750;21166;21359,31755,0,3,2,0,5
46694,100,12890,17205;17365;21778,31755,1,0,2,0,3
46695,100,12891,16982;17379;20858,31755,0,1,2,0,3
46696,100,12892,17391;17468;20671;21662,31755,1,1,2,0,4
46697,100,12893,17466;17654;21390,31755,0,1,2,0,3
46698,100,12894,17472;18328;20770;21022;21475,31755,0,3,2,0,5
46699,100,12895,17273;17607;20881,31755,0,1,2,0,3
46700,100,12896,17350;17611;21101,31755,0,1,2,0,3
46701,100,12897,17620;18166,31755,0,0,2,0,2
46702,100,12898,17203;17641;20827,31755,0,1,2,0,3
46703,100,12899,17517;17694;21156;21333,31755,0,2,2,0,4
46704,100,12900,17695;18336;20730;20948;21671,31755,1,2,2,0,5
46705,100,12901,17652;17778;20930,31755,0,1,2,0,3
46706,100,12902,17597;17780,31755,0,0,2,0,2
46707,100,12903,17790;17821;20920;21104,31755,0,2,2,0,4
46708,100,12904,17798;17825;20876;21284,31755,0,2,2,0,4
46709,100,12905,17855;18091;21580,31755,1,0,2,0,3
46710,100,12906,17362;17892;21285;21894,31755,1,1,2,0,4
46711,100,12907,17893;18214;20810;21239;21392;21683,31755,1,3,2,0,6
46712,100,12908,18161;18239;21956,31755,1,0,2,0,3
46713,100,12909,17952;18081;20675;20943;21148;21380;21576;21765,31755,2,4,2,0,8
46714,100,12910,18690;20803;21035;21132;21394;21999,31755,1,4,1,0,6
46715,100,12911,18404;18626;21095,31755,0,1,2,0,3
46716,100,12912,17804;17995;21863,31755,1,0,2,0,3
46717,100,12913,17579;18001;21187,31755,0,1,2,0,3
46718,100,12914,18014;18241,31755,0,0,2,0,2
46719,100,12915,18044;18187;20969;21557,31755,1,1,2,0,4
46720,100,12916,18052;18507;20891;21579,31755,1,1,2,0,4
46721,100,12917,18171;18705;22002,31755,1,0,2,0,3
46722,100,12918,18085;18377;21366,31755,0,1,2,0,3
46723,100,12919,18092;18911;20960;21128;21472,31755,0,3,2,0,5
46724,100,12920,18094;18289;21595,31755,1,0,2,0,3
46725,100,12921,18099;18389;20800;21138;21606;21842,31755,2,2,2,0,6
46726,100,12922,18113;18639;20706;21797,31755,1,1,2,0,4
46727,100,12923,17643;18079;21744,31755,1,0,2,0,3
46728,100,12924,18129;18609;20842;21726;21988,31755,2,1,2,0,5
46729,100,12925,18398;18495;20660;20823,31755,0,2,2,0,4
46730,100,12927,18457;20860;21386;21468,31755,0,3,1,0,4
46731,100,12928,17868;18154;20735;20990,31755,0,2,2,0,4
46732,100,12929,18157;21237;21327,31755,0,2,1,0,3
46733,100,12930,18311;18393;20700;20793;21402,31755,0,3,2,0,5
46734,100,12931,18025;18247;21171;21301;21616,31755,1,2,2,0,5
46735,100,12932,18343;20698;21828;21970,31755,2,1,1,0,4
46736,100,12933,17996;18041;21884,31755,1,0,2,0,3
46737,100,12934,18312;18770;21267;22006,31755,1,1,2,0,4
46738,100,12935,18345;18784;21910,31755,1,0,2,0,3
46739,100,12936,18320,31755,0,0,1,0,1
46740,100,12937,18108;18346,31755,0,0,2,0,2
46741,100,12938,18347;18381,31755,0,0,2,0,2
46742,100,12939,18124;18385,31755,0,0,2,0,2
46743,100,12940,17667;18306;21696,31755,1,0,2,0,3
46744,100,12941,13007;13523,32120,0,0,0,2,2
46745,100,12942,13370,32120,0,0,0,1,1
46746,100,12943,13486,32120,0,0,0,1,1
46747,100,12947,13757,32120,0,0,0,1,1
46748,100,12952,13973,32120,0,0,0,1,1
46749,100,12955,14240,32120,0,0,1,0,1
46750,100,12957,14140,32120,0,0,0,1,1
46751,100,12958,14539;14612,32120,0,0,2,0,2
46752,100,12961,14790;14915,32120,0,0,2,0,2
46753,100,12962,14246,32120,0,0,1,0,1
46754,100,12970,14792,32120,0,0,1,0,1
46755,100,12981,16230;16473,32120,0,0,2,0,2
46756,100,12982,16289;16530,32120,0,0,2,0,2
46757,100,12987,16625;16842,32120,0,0,2,0,2
46758,100,12988,16900,32120,0,0,1,0,1
46759,100,12989,16887;17458;21542;21709,32120,2,0,2,0,4
46760,100,12990,16903;17388;20814,32120,0,1,2,0,3
46761,100,12993,16960;17339;21196;21308,32120,0,2,2,0,4
46762,100,12994,17287;17518;21738,32120,1,0,2,0,3
46763,100,12995,17355,32120,0,0,1,0,1
46764,100,12997,17199;17401,32120,0,0,2,0,2
46765,100,12998,17436;17689;20871,32120,0,1,2,0,3
46766,100,12999,17454;17678;20753;21322,32120,0,2,2,0,4
46767,100,13000,17415;17666;21551,32120,1,0,2,0,3
46768,100,13001,17532;17539;20789,32120,0,1,2,0,3
46769,100,13002,17967;20850;21045,32120,0,2,1,0,3
46770,100,13003,17581;17749;20980;21463;21931,32120,1,2,2,0,5
46771,100,13004,17709;17758,32120,0,0,2,0,2
46772,100,13005,17797;18063;21174;21591,32120,1,1,2,0,4
46773,100,13006,17773;17800;21743;21885,32120,2,0,2,0,4
46774,100,13007,18141;18288;21204;21423;21966,32120,1,2,2,0,5
46775,100,13008,17836;17894;21902;21937,32120,2,0,2,0,4
46776,100,13009,17919;18146;21431;21625,32120,1,1,2,0,4
46777,100,13010,17590;17930;21848,32120,1,0,2,0,3
46778,100,13011,17956;18397;21238;21524;21802;21886,32120,3,1,2,0,6
46779,100,13012,18486;21698;21904,32120,2,0,1,0,3
46780,100,13013,17712;17983;21673;21864,32120,2,0,2,0,4
46781,100,13014,17631;18070;21258;21735;21949,32120,2,1,2,0,5
46782,100,13015,18104;18561;20765,32120,0,1,2,0,3
46783,100,13016,18110;18142;21198;21415,32120,0,2,2,0,4
46784,100,13017,18118;18248;20985;21197,32120,0,2,2,0,4
46785,100,13018,18137;18670;20997;21207;21520,32120,1,2,2,0,5
46786,100,13019,18168;21728,32120,1,0,1,0,2
46787,100,13021,18093;18604;21272;21450,32120,0,2,2,0,4
46788,100,13022,18212;18499;21181;21888;21982,32120,2,1,2,0,5
46789,100,13023,18223;18735;21458;21823,32120,1,1,2,0,4
46790,100,13024,18587;20817;20890;21073;21515,32120,1,3,1,0,5
46791,100,13025,17891;18282;20916;21559;21775,32120,2,1,2,0,5
46792,100,13026,18286;18321;21087;21819,32120,1,1,2,0,4
46793,100,13027,18348;18645;21184;21658,32120,1,1,2,0,4
46794,100,13028,17686;18378;21727;21769,32120,2,0,2,0,4
46795,100,13029,18205;18408,32120,0,0,2,0,2
46796,100,13030,18419;18729,32120,0,0,2,0,2
46797,100,13031,18434;18613;21550;21779,32120,2,0,2,0,4
46798,100,13033,18452;18615;21759,32120,1,0,2,0,3
46799,100,13034,18453;18494;21477;21714,32120,1,1,2,0,4
46800,100,13035,18461;18824;20994;21062,32120,0,2,2,0,4
46801,100,13036,18342;18462;21271;21762,32120,1,1,2,0,4
46802,100,13037,18472;20952;20984,32120,0,2,1,0,3
46803,100,13038,18475;18530;21607,32120,1,0,2,0,3
46804,100,13039,17823;17852;21009;21225,32120,0,2,2,0,4
46805,100,13040,18237;18505;21328;21519,32120,1,1,2,0,4
46806,100,13041,18246;18515;21278;21393;21690,32120,1,2,2,0,5
46807,100,13042,18517;18663;21341;21648,32120,1,1,2,0,4
46808,100,13043,13002,32485,0,0,0,1,1
46809,100,13045,13584,32485,0,0,0,1,1
46810,100,13046,13347,32485,0,0,0,1,1
46811,100,13047,13309;13646,32485,0,0,0,2,2
46812,100,13048,13668,32485,0,0,0,1,1
46813,100,13050,14073,32485,0,0,0,1,1
46814,100,13052,14098,32485,0,0,0,1,1
46815,100,13053,14356,32485,0,0,1,0,1
46816,100,13054,14145,32485,0,0,0,1,1
46817,100,13056,14224,32485,0,0,1,0,1
46818,100,13057,14666,32485,0,0,1,0,1
46819,100,13059,14817,32485,0,0,1,0,1
46820,100,13060,15333,32485,0,0,1,0,1
46821,100,13061,15057,32485,0,0,1,0,1
46822,100,13064,15080;15082,32485,0,0,2,0,2
46823,100,13068,15431,32485,0,0,1,0,1
46824,100,13070,15214;15528,32485,0,0,2,0,2
46825,100,13071,15385,32485,0,0,1,0,1
46826,100,13072,15577,32485,0,0,1,0,1
46827,100,13077,16171,32485,0,0,1,0,1
46828,100,13079,16227,32485,0,0,1,0,1
46829,100,13081,16663;17212;21476,32485,0,1,2,0,3
46830,100,13084,16946,32485,0,0,1,0,1
46831,100,13085,16988;16992;20893,32485,0,1,2,0,3
46832,100,13086,17022;17501;21471,32485,0,1,2,0,3
46833,100,13088,17111;17425;20887;21085;21667,32485,1,2,2,0,5
46834,100,13090,17275;17657;21275;21794,32485,1,1,2,0,4
46835,100,13091,17276;17681;21342;21615,32485,1,1,2,0,4
46836,100,13092,17421;17655;20508;21416;21840,32485,1,2,2,0,5
46837,100,13093,17416;17471;21051;21587,32485,1,1,2,0,4
46838,100,13094,17481;18149;21047;21268,32485,0,2,2,0,4
46839,100,13096,17809,32485,0,0,1,0,1
46840,100,13097,17358,32485,0,0,1,0,1
46841,100,13098,17437;17613;21265,32485,0,1,2,0,3
46842,100,13099,17265;17614;21401;21442,32485,0,2,2,0,4
46843,100,13100,17639;17934,32485,0,0,2,0,2
46844,100,13101,17651;18506;21983,32485,1,0,2,0,3
46845,100,13102,17682;18254;21349,32485,0,1,2,0,3
46846,100,13104,17751;18060;21287;21533;21948,32485,2,1,2,0,5
46847,100,13106,17752;17839;21932,32485,1,0,2,0,3
46848,100,13108,17938;18209;21960,32485,1,0,2,0,3
46849,100,13109,17587;17958;21136;21293;21585;21688,32485,2,2,2,0,6
46850,100,13110,17816;18019;21110;21337,32485,0,2,2,0,4
46851,100,13111,17792;18023,32485,0,0,2,0,2
46852,100,13112,18028;18431;21896,32485,1,0,2,0,3
46853,100,13113,18033;21770,32485,1,0,1,0,2
46854,100,13114,18049;18677;21998,32485,1,0,2,0,3
46855,100,13115,17946;18054;21325;21749,32485,1,1,2,0,4
46856,100,13116,18078;18155;20885;21074;21310;21954,32485,1,3,2,0,6
46857,100,13117,18153;18651;21724;21872,32485,2,0,2,0,4
46858,100,13118,18156;18196;21049;21209;21302,32485,0,3,2,0,5
46859,100,13119,18180;21540,32485,1,0,1,0,2
46860,100,13120,18208,32485,0,0,1,0,1
46861,100,13121,18222;21253;21507,32485,1,1,1,0,3
46862,100,13122,18251;18375;21569;21862;21962,32485,3,0,2,0,5
46863,100,13123,18290;18749;20944;21029;21240,32485,0,3,2,0,5
46864,100,13124,18731;21895,32485,1,0,1,0,2
46865,100,13125,18637;20978;21114;21614,32485,1,2,1,0,4
46866,100,13127,17916;18319;21637;21915,32485,2,0,2,0,4
46867,100,13128,18331;18548;21232,32485,0,1,2,0,3
46868,100,13129,17785;17877;21934,32485,1,0,2,0,3
46869,100,13130,18426;21633,32485,1,0,1,0,2
46870,100,13131,18330;18429,32485,0,0,2,0,2
46871,100,13132,18455;19016;20993;21290,32485,0,2,2,0,4
46872,100,13133,17950;18479;21545,32485,1,0,2,0,3
46873,100,13134,18374;18496,32485,0,0,2,0,2
46874,100,13135,18501;18502;21005;21427,32485,0,2,2,0,4
46875,100,13136,18514;21547;21841,32485,2,0,1,0,3
46876,100,13137,18516;21537;21718,32485,2,0,1,0,3
46877,100,13138,18532;18852,32485,0,0,2,0,2
46878,100,13140,18048;18575;21255,32485,0,1,2,0,3
46879,100,13141,18170;18783;20913;21154;21631,32485,1,2,2,0,5
46880,100,13142,18256;18598;21027;21986,32485,1,1,2,0,4
46881,100,13143,18612;18698;21406,32485,0,1,2,0,3
46882,100,13144,18623;18867;20956;21241;21609,32485,1,2,2,0,5
46883,100,13145,13513,32850,0,0,0,1,1
46884,100,13146,13349,32850,0,0,0,1,1
46885,100,13147,13610;13808,32850,0,0,0,2,2
46886,100,13149,13867;14032,32850,0,0,0,2,2
46887,100,13151,13690,32850,0,0,0,1,1
46888,100,13152,13905,32850,0,0,0,1,1
46889,100,13153,13741,32850,0,0,0,1,1
46890,100,13154,13387,32850,0,0,0,1,1
46891,100,13157,13618,32850,0,0,0,1,1
46892,100,13158,14071,32850,0,0,0,1,1
46893,100,13159,13953,32850,0,0,0,1,1
46894,100,13161,14216,32850,0,0,0,1,1
46895,100,13162,14049,32850,0,0,0,1,1
46896,100,13164,14643;14988,32850,0,0,2,0,2
46897,100,13166,15117,32850,0,0,1,0,1
46898,100,13173,15145,32850,0,0,1,0,1
46899,100,13175,15387,32850,0,0,1,0,1
46900,100,13180,15738,32850,0,0,1,0,1
46901,100,13181,15510,32850,0,0,1,0,1
46902,100,13182,16127,32850,0,0,1,0,1
46903,100,13183,16317;16326,32850,0,0,2,0,2
46904,100,13184,16328;16460,32850,0,0,2,0,2
46905,100,13186,16503,32850,0,0,1,0,1
46906,100,13187,16266,32850,0,0,1,0,1
46907,100,13189,16247,32850,0,0,1,0,1
46908,100,13191,16487,32850,0,0,1,0,1
46909,100,13192,16467,32850,0,0,1,0,1
46910,100,13194,16974,32850,0,0,1,0,1
46911,100,13195,17198;17407;21382;21916,32850,1,1,2,0,4
46912,100,13196,17297,32850,0,0,1,0,1
46913,100,13197,17390;17525;21798,32850,1,0,2,0,3
46914,100,13200,17497;17659;21315,32850,0,1,2,0,3
46915,100,13201,17545;18098;21586,32850,1,0,2,0,3
46916,100,13202,17561;17755;21124;21395,32850,0,2,2,0,4
46917,100,13203,17629,32850,0,0,1,0,1
46918,100,13204,17925;21940,32850,1,0,1,0,2
46919,100,13205,17802;21785,32850,1,0,1,0,2
46920,100,13206,17565;17912;21597,32850,1,0,2,0,3
46921,100,13207,17498;17810;21381;21473,32850,0,2,2,0,4
46922,100,13208,17812,32850,0,0,1,0,1
46923,100,13209,17691;17884;21413;21544,32850,1,1,2,0,4
46924,100,13210,17886;18562;21360;21985,32850,1,1,2,0,4
46925,100,13212,17909;18565,32850,0,0,2,0,2
46926,100,13213,17753;17927,32850,0,0,2,0,2
46927,100,13214,17683;17929;21100;21311,32850,0,2,2,0,4
46928,100,13215,17757,32850,0,0,1,0,1
46929,100,13216,18820,32850,0,0,1,0,1
46930,100,13217,18102;18353;21971,32850,1,0,2,0,3
46931,100,13218,18106;18655,32850,0,0,2,0,2
46932,100,13219,17904;18116;21867,32850,1,0,2,0,3
46933,100,13220,18123;18620,32850,0,0,2,0,2
46934,100,13221,18167;21603,32850,1,0,1,0,2
46935,100,13222,18186;18323;21260;21363;21669,32850,1,2,2,0,5
46936,100,13223,17708;18206;21522;21640,32850,2,0,2,0,4
46937,100,13224,18265;21434;21594;21830,32850,2,1,1,0,4
46938,100,13225,18077;18278;21303;21703,32850,1,1,2,0,4
46939,100,13226,18293;18402,32850,0,0,2,0,2
46940,100,13227,18317;18883;21040;21215;21462,32850,0,3,2,0,5
46941,100,13228,18334;18642;21470;21766,32850,1,1,2,0,4
46942,100,13229,18357;21371;21619,32850,1,1,1,0,3
46943,100,13230,18361;18367,32850,0,0,2,0,2
46944,100,13231,18396;18627;21294,32850,0,1,2,0,3
46945,100,13232,18031;18417;21855,32850,1,0,2,0,3
46946,100,13233,18447;18694,32850,0,0,2,0,2
46947,100,13234,17940;18450;21854,32850,1,0,2,0,3
46948,100,13235,17890;18454;21399;21638;21777,32850,2,1,2,0,5
46949,100,13236,18469;18864;21038;21446,32850,0,2,2,0,4
46950,100,13237,18866,32850,0,0,1,0,1
46951,100,13238,18569;18597;21623,32850,1,0,2,0,3
46952,100,13239,18958;21289;21711,32850,1,1,1,0,3
46953,100,13240,18579;18948;21307;21670,32850,1,1,2,0,4
46954,100,13241,18301;18786;21169;21652,32850,1,1,2,0,4
46955,100,13242,18915,32850,0,0,1,0,1
46956,100,13243,18778;21115,32850,0,1,1,0,2
46957,100,13244,19065;21146,32850,0,1,1,0,2
46958,100,13245,18667;18971,32850,0,0,2,0,2
46959,100,13246,18560;18761;21768,32850,1,0,2,0,3
46960,100,13247,18687;19091;21083;21383,32850,0,2,2,0,4
46961,100,13248,18714;19158;21109;21408,32850,0,2,2,0,4
46962,100,13249,18716;18861,32850,0,0,2,0,2
46963,100,13250,18722;21553,32850,1,0,1,0,2
46964,100,13251,19033,32850,0,0,1,0,1
46965,100,13252,18743;19059;21376,32850,0,1,2,0,3
46966,100,13253,18674;18890;21912,32850,1,0,2,0,3
46967,100,13254,18465;18763,32850,0,0,2,0,2
46968,100,13255,18490;18765;21208;21582,32850,1,1,2,0,4
46969,100,13256,13863,33215,0,0,0,1,1
46970,100,13257,13685,33215,0,0,0,1,1
46971,100,13258,13691,33215,0,0,0,1,1
46972,100,13259,13852,33215,0,0,0,1,1
46973,100,13260,13983,33215,0,0,0,1,1
46974,100,13261,14064,33215,0,0,0,1,1
46975,100,13263,14150,33215,0,0,0,1,1
46976,100,13266,15165,33215,0,0,1,0,1
46977,100,13267,14576;14936,33215,0,0,2,0,2
46978,100,13268,13955,33215,0,0,0,1,1
46979,100,13270,14732;15025,33215,0,0,2,0,2
46980,100,13272,14765,33215,0,0,1,0,1
46981,100,13277,14607,33215,0,0,1,0,1
46982,100,13280,15175;15176,33215,0,0,2,0,2
46983,100,13282,15291,33215,0,0,1,0,1
46984,100,13286,15574,33215,0,0,1,0,1
46985,100,13288,15374,33215,0,0,1,0,1
46986,100,13290,15699,33215,0,0,1,0,1
46987,100,13294,16773,33215,0,0,1,0,1
46988,100,13296,16907;16920;21144,33215,0,1,2,0,3
46989,100,13301,16737,33215,0,0,1,0,1
46990,100,13302,16844,33215,0,0,1,0,1
46991,100,13303,17257;17818,33215,0,0,2,0,2
46992,100,13304,17270;17582;21573,33215,1,0,2,0,3
46993,100,13305,17173,33215,0,0,1,0,1
46994,100,13306,17732;17763;21387;21456,33215,0,2,2,0,4
46995,100,13307,17820;18148,33215,0,0,2,0,2
46996,100,13308,17895;18392;21221;21552,33215,1,1,2,0,4
46997,100,13309,18128,33215,0,0,1,0,1
46998,100,13310,17906;17962;21375,33215,0,1,2,0,3
46999,100,13311,17936,33215,0,0,1,0,1
47000,100,13312,17939,33215,0,0,1,0,1
47001,100,13313,17552;17948,33215,0,0,2,0,2
47002,100,13314,17848;17980,33215,0,0,2,0,2
47003,100,13315,18005;18297;21905,33215,1,0,2,0,3
47004,100,13317,18015,33215,0,0,1,0,1
47005,100,13318,17974;18020,33215,0,0,2,0,2
47006,100,13319,18037;18062,33215,0,0,2,0,2
47007,100,13320,18038;18573;21510,33215,1,0,2,0,3
47008,100,13321,17970;18058;21227;21364,33215,0,2,2,0,4
47009,100,13322,18064;18510,33215,0,0,2,0,2
47010,100,13324,18242;21433;21546,33215,1,1,1,0,3
47011,100,13325,17859;18143;21920;21953,33215,2,0,2,0,4
47012,100,13326,18622,33215,0,0,1,0,1
47013,100,13327,18181,33215,0,0,1,0,1
47014,100,13328,18000;18210;21211;21549,33215,1,1,2,0,4
47015,100,13329,18226;21814,33215,1,0,1,0,2
47016,100,13330,18183;18231,33215,0,0,2,0,2
47017,100,13331,17644;18252;21813,33215,1,0,2,0,3
47018,100,13332,18630;21622,33215,1,0,1,0,2
47019,100,13333,18269;18700;21140;21329,33215,0,2,2,0,4
47020,100,13334,17832;18539;21119;21389,33215,0,2,2,0,4
47021,100,13335,17944;18296;21563,33215,1,0,2,0,3
47022,100,13336,18300;18858;21523;21882;22015,33215,3,0,2,0,5
47023,100,13337,18308;18901,33215,0,0,2,0,2
47024,100,13338,18322;18366;21747,33215,1,0,2,0,3
47025,100,13339,18352;18607;21719,33215,1,0,2,0,3
47026,100,13340,18174;18356,33215,0,0,2,0,2
47027,100,13341,18195;18383,33215,0,0,2,0,2
47028,100,13342,18403;18619;21096;21989,33215,1,1,2,0,4
47029,100,13343,18410;18897,33215,0,0,2,0,2
47030,100,13344,18074;18413;21517;21649,33215,2,0,2,0,4
47031,100,13345,18430;21131;21757;21975,33215,2,1,1,0,4
47032,100,13346,18228;18433;21921,33215,1,0,2,0,3
47033,100,13347,18445;19027;21906,33215,1,0,2,0,3
47034,100,13348,18489;18590;21883;21981,33215,2,0,2,0,4
47035,100,13349,18513;21212,33215,0,1,1,0,2
47036,100,13350,19051;21139,33215,0,1,1,0,2
47037,100,13351,18601;19083;21152,33215,0,1,2,0,3
47038,100,13352,18549;18638;21354,33215,0,1,2,0,3
47039,100,13353,18339;18669;21090;21261;21650,33215,1,2,2,0,5
47040,100,13354,18659;18678,33215,0,0,2,0,2
47041,100,13355,18684;19147;21094,33215,0,1,2,0,3
47042,100,13356,18697;19040;21679,33215,1,0,2,0,3
47043,100,13357,18688;18704,33215,0,0,2,0,2
47044,100,13358,18503;18741,33215,0,0,2,0,2
47045,100,13359,18591;18747,33215,0,0,2,0,2
47046,100,13360,18750;19237;21153;21435;21837,33215,1,2,2,0,5
47047,100,13361,18758;19101,33215,0,0,2,0,2
47048,100,13362,18636;18779;21874,33215,1,0,2,0,3
47049,100,13363,18307,33215,0,0,1,0,1
47050,100,13364,18728;18787;21370;21618;22008,33215,2,1,2,0,5
47051,100,13365,18805;19121;21247,33215,0,1,2,0,3
47052,100,13366,18795;18807;21791;21870;22009,33215,3,0,2,0,5
47053,100,13367,18797;18831,33215,0,0,2,0,2
47054,100,13368,18842;18984,33215,0,0,2,0,2
47055,100,13369,18845;18865;21122;21451,33215,0,2,2,0,4
47056,100,13370,18723;18880,33215,0,0,2,0,2
47057,100,13371,18832;18892,33215,0,0,2,0,2
47058,100,13372,18902;19044,33215,0,0,2,0,2
47059,100,13373,18910;19271,33215,0,0,2,0,2
47060,100,13374,13171,33580,0,0,0,1,1
47061,100,13375,13278,33580,0,0,0,1,1
47062,100,13376,13726,33580,0,0,0,1,1
47063,100,13377,13835,33580,0,0,0,1,1
47064,100,13378,13423,33580,0,0,0,1,1
47065,100,13379,14036,33580,0,0,0,1,1
47066,100,13381,13909,33580,0,0,0,1,1
47067,100,13385,14261,33580,0,0,1,0,1
47068,100,13389,14827,33580,0,0,1,0,1
47069,100,13391,14545,33580,0,0,1,0,1
47070,100,13392,15239,33580,0,0,1,0,1
47071,100,13394,15337,33580,0,0,1,0,1
47072,100,13395,14846;15171,33580,0,0,2,0,2
47073,100,13398,14852;15228,33580,0,0,2,0,2
47074,100,13405,15789;15896,33580,0,0,2,0,2
47075,100,13406,16157,33580,0,0,1,0,1
47076,100,13410,16854;17303;21336,33580,0,1,2,0,3
47077,100,13411,16979;17324;21692,33580,1,0,2,0,3
47078,100,13412,17235;17293;21216,33580,0,1,2,0,3
47079,100,13414,16970,33580,0,0,1,0,1
47080,100,13415,17030;17292,33580,0,0,2,0,2
47081,100,13418,17513;18026,33580,0,0,2,0,2
47082,100,13419,17529;17549;21242;21529,33580,1,1,2,0,4
47083,100,13420,17233,33580,0,0,1,0,1
47084,100,13422,17596;18150;21752,33580,1,0,2,0,3
47085,100,13423,17649,33580,0,0,1,0,1
47086,100,13424,17438,33580,0,0,1,0,1
47087,100,13425,17789;18139,33580,0,0,2,0,2
47088,100,13426,17484;17817;21358,33580,0,1,2,0,3
47089,100,13427,17668;17853;21465;21666,33580,1,1,2,0,4
47090,100,13428,17914;18351;21343;21448,33580,0,2,2,0,4
47091,100,13429,17953;18008;21286;21493,33580,0,2,2,0,4
47092,100,13430,17899;18101;21474,33580,0,1,2,0,3
47093,100,13431,18036,33580,0,0,1,0,1
47094,100,13432,18043;18368,33580,0,0,2,0,2
47095,100,13434,17697;17993;21734,33580,1,0,2,0,3
47096,100,13435,18159;18176;21793,33580,1,0,2,0,3
47097,100,13437,18204;18742,33580,0,0,2,0,2
47098,100,13438,18227;18896;21901,33580,1,0,2,0,3
47099,100,13439,18271;18857;21369,33580,0,1,2,0,3
47100,100,13440,18298;18543;21175;21708,33580,1,1,2,0,4
47101,100,13441,18309;18470;21978,33580,1,0,2,0,3
47102,100,13442,18415;18520;21647,33580,1,0,2,0,3
47103,100,13443,18012;18327;21331;21969,33580,1,1,2,0,4
47104,100,13444,18344;18556,33580,0,0,2,0,2
47105,100,13445,18364;18919;21627;22018,33580,2,0,2,0,4
47106,100,13446,18191;18407;21191;21566;21739,33580,2,1,2,0,5
47107,100,13447,18360;18524,33580,0,0,2,0,2
47108,100,13448,18893,33580,0,0,1,0,1
47109,100,13449,19073,33580,0,0,1,0,1
47110,100,13451,18540;18547;21661;21771,33580,2,0,2,0,4
47111,100,13452,19072;21410,33580,0,1,1,0,2
47112,100,13453,18557;18559;21890,33580,1,0,2,0,3
47113,100,13454,18566;18879;21740,33580,1,0,2,0,3
47114,100,13455,18581,33580,0,0,1,0,1
47115,100,13456,18982;22021,33580,1,0,1,0,2
47116,100,13457,18194;18586,33580,0,0,2,0,2
47117,100,13458,18617;18877,33580,0,0,2,0,2
47118,100,13459,18245;18631;21991,33580,1,0,2,0,3
47119,100,13460,18648;18874,33580,0,0,2,0,2
47120,100,13461,19141,33580,0,0,1,0,1
47121,100,13462,18577;18658;21396;21577;21995,33580,2,1,2,0,5
47122,100,13463,18624;18699;21723;22001,33580,2,0,2,0,4
47123,100,13464,18708;19064;21292;21704,33580,1,1,2,0,4
47124,100,13465,18217;18727;22004,33580,1,0,2,0,3
47125,100,13466,19060;21254,33580,0,1,1,0,2
47126,100,13467,18757;18894;21829,33580,1,0,2,0,3
47127,100,13468,18294;18793;21438;21808,33580,1,1,2,0,4
47128,100,13469,18801;18904;22011,33580,1,0,2,0,3
47129,100,13470,18632;18815;21635;21810,33580,2,0,2,0,4
47130,100,13471,18821;19321;21277,33580,0,1,2,0,3
47131,100,13472,18544;18830;22014,33580,1,0,2,0,3
47132,100,13473,18835;19210;21467,33580,0,1,2,0,3
47133,100,13474,18836;18969;21189;21716;21755,33580,2,1,2,0,5
47134,100,13475,18838;18945;21419,33580,0,1,2,0,3
47135,100,13476,18422;18848;21753,33580,1,0,2,0,3
47136,100,13477,18900;18967;21590,33580,1,0,2,0,3
47137,100,13478,18912;19004,33580,0,0,2,0,2
47138,100,13479,18970;19296,33580,0,0,2,0,2
47139,100,13480,18989;19261,33580,0,0,2,0,2
47140,100,13481,19042;19239,33580,0,0,2,0,2
47141,100,13485,14217,33945,0,0,0,1,1
47142,100,13486,14226,33945,0,0,1,0,1
47143,100,13487,13891,33945,0,0,0,1,1
47144,100,13488,13724,33945,0,0,0,1,1
47145,100,13489,13787;14000,33945,0,0,0,2,2
47146,100,13490,14149,33945,0,0,0,1,1
47147,100,13491,14347,33945,0,0,1,0,1
47148,100,13495,14244,33945,0,0,1,0,1
47149,100,13497,14321,33945,0,0,1,0,1
47150,100,13498,14564;14728,33945,0,0,2,0,2
47151,100,13504,15076,33945,0,0,1,0,1
47152,100,13507,15576,33945,0,0,1,0,1
47153,100,13508,14814;15280,33945,0,0,2,0,2
47154,100,13510,15837,33945,0,0,1,0,1
47155,100,13511,15600,33945,0,0,1,0,1
47156,100,13514,16295,33945,0,0,1,0,1
47157,100,13517,15752,33945,0,0,1,0,1
47158,100,13518,16497,33945,0,0,1,0,1
47159,100,13522,16760,33945,0,0,1,0,1
47160,100,13523,16857,33945,0,0,1,0,1
47161,100,13524,16829;16870;21411,33945,0,1,2,0,3
47162,100,13525,16172;16919;21407,33945,0,1,2,0,3
47163,100,13526,17086;17089,33945,0,0,2,0,2
47164,100,13527,16616,33945,0,0,1,0,1
47165,100,13528,16794,33945,0,0,1,0,1
47166,100,13529,17178;17428,33945,0,0,2,0,2
47167,100,13530,17210,33945,0,0,1,0,1
47168,100,13532,17290;18201;21959,33945,1,0,2,0,3
47169,100,13533,18068,33945,0,0,1,0,1
47170,100,13536,17633;17833;21338,33945,0,1,2,0,3
47171,100,13538,17446;17793;21574;21763,33945,2,0,2,0,4
47172,100,13539,17990;18261,33945,0,0,2,0,2
47173,100,13540,17881;18529,33945,0,0,2,0,2
47174,100,13541,17897;18188,33945,0,0,2,0,2
47175,100,13542,17830;17981,33945,0,0,2,0,2
47176,100,13544,17414,33945,0,0,1,0,1
47177,100,13545,18057;18145;21339;21701,33945,1,1,2,0,4
47178,100,13546,18069;18182,33945,0,0,2,0,2
47179,100,13547,18080;18399;21656,33945,1,0,2,0,3
47180,100,13548,18107;18380,33945,0,0,2,0,2
47181,100,13549,18218;18466;21604;21659,33945,2,0,2,0,4
47182,100,13550,18325;18332,33945,0,0,2,0,2
47183,100,13551,18386;18672;21846;21997,33945,2,0,2,0,4
47184,100,13552,18817;18875;21508;21758,33945,2,0,2,0,4
47185,100,13553,18484,33945,0,0,1,0,1
47186,100,13554,18746;21807,33945,1,0,1,0,2
47187,100,13555,18497;19129,33945,0,0,2,0,2
47188,100,13556,18563;18782;21821,33945,1,0,2,0,3
47189,100,13557,18589;18652;21993,33945,1,0,2,0,3
47190,100,13559,18635;18753;21514,33945,1,0,2,0,3
47191,100,13560,18676;19132,33945,0,0,2,0,2
47192,100,13561,18679;19096;21741,33945,1,0,2,0,3
47193,100,13562,18718;18812;21398;21644,33945,1,1,2,0,4
47194,100,13563,18732;19280;21774,33945,1,0,2,0,3
47195,100,13564,18709;18738;21717,33945,1,0,2,0,3
47196,100,13565,18570;18739;21592,33945,1,0,2,0,3
47197,100,13566,18759;19521,33945,0,0,2,0,2
47198,100,13567,18193;18762;21806,33945,1,0,2,0,3
47199,100,13568,18764;19017;21572,33945,1,0,2,0,3
47200,100,13569,18773;19541,33945,0,0,2,0,2
47201,100,13570,18777;18922,33945,0,0,2,0,2
47202,100,13571,18536;18899;21845,33945,1,0,2,0,3
47203,100,13572,18628;18885,33945,0,0,2,0,2
47204,100,13573,18733;18926;22019,33945,1,0,2,0,3
47205,100,13574,18519;18949,33945,0,0,2,0,2
47206,100,13575,18936;18955;21693,33945,1,0,2,0,3
47207,100,13576,18715;18959,33945,0,0,2,0,2
47208,100,13577,18846;18961,33945,0,0,2,0,2
47209,100,13578,18965;19093,33945,0,0,2,0,2
47210,100,13579,18572;18988,33945,0,0,2,0,2
47211,100,13580,19022;19229,33945,0,0,2,0,2
47212,100,13581,18837;19046,33945,0,0,2,0,2
47213,100,13582,18459;19047,33945,0,0,2,0,2
47214,100,13583,18737;19049;21636,33945,1,0,2,0,3
47215,100,13584,18914;19053;21489;21858,33945,1,1,2,0,4
47216,100,13585,18923;19068,33945,0,0,2,0,2
47217,100,13586,19069;19145;21681,33945,1,0,2,0,3
47218,100,13587,19076;19494;21378;21706;22044,33945,2,1,2,0,5
47219,100,13588,19082;19311;21583,33945,1,0,2,0,3
47220,100,13589,18841;19094;21504,33945,1,0,2,0,3
47221,100,13590,19097;19458,33945,0,0,2,0,2
47222,100,13591,19109;19364;21373;21657,33945,1,1,2,0,4
47223,100,13592,18800;19119,33945,0,0,2,0,2
47224,100,13593,19123;19312;21503;21697,33945,2,0,2,0,4
47225,100,13594,18696;19136;22028,33945,1,0,2,0,3
47226,100,13595,18822;19137,33945,0,0,2,0,2
47227,100,13596,19143;19160,33945,0,0,2,0,2
47228,100,13597,19173;19196;21869;22032,33945,2,0,2,0,4
47229,100,13598,19186;19492;21512,33945,1,0,2,0,3
47230,100,13599,13986,34310,0,0,0,1,1
47231,100,13600,13753,34310,0,0,0,1,1
47232,100,13601,14028,34310,0,0,0,1,1
47233,100,13602,14047,34310,0,0,0,1,1
47234,100,13604,14304,34310,0,0,1,0,1
47235,100,13605,14027,34310,0,0,0,1,1
47236,100,13608,14507,34310,0,0,1,0,1
47237,100,13609,14609,34310,0,0,1,0,1
47238,100,13610,14734,34310,0,0,1,0,1
47239,100,13613,15295,34310,0,0,1,0,1
47240,100,13614,14922,34310,0,0,1,0,1
47241,100,13615,14952;15135,34310,0,0,2,0,2
47242,100,13618,15488,34310,0,0,1,0,1
47243,100,13622,15839;15949,34310,0,0,2,0,2
47244,100,13623,16045,34310,0,0,1,0,1
47245,100,13624,15766;16067,34310,0,0,2,0,2
47246,100,13625,16105,34310,0,0,1,0,1
47247,100,13628,16386,34310,0,0,1,0,1
47248,100,13629,16401,34310,0,0,1,0,1
47249,100,13631,16370,34310,0,0,1,0,1
47250,100,13633,15871,34310,0,0,1,0,1
47251,100,13635,16765,34310,0,0,1,0,1
47252,100,13638,16999;17103,34310,0,0,2,0,2
47253,100,13640,17291;17347;21541,34310,1,0,2,0,3
47254,100,13641,17368;17701,34310,0,0,2,0,2
47255,100,13643,17707;18263,34310,0,0,2,0,2
47256,100,13645,17842;17879;21548;21818,34310,2,0,2,0,4
47257,100,13646,17696;17905;21668;21891,34310,2,0,2,0,4
47258,100,13647,18003;18318,34310,0,0,2,0,2
47259,100,13648,17910;18125;21951,34310,1,0,2,0,3
47260,100,13649,17814;18127,34310,0,0,2,0,2
47261,100,13650,17961,34310,0,0,1,0,1
47262,100,13651,17636,34310,0,0,1,0,1
47263,100,13652,17224,34310,0,0,1,0,1
47264,100,13653,18768;21605,34310,1,0,1,0,2
47265,100,13654,18305;18930;21584;21654,34310,2,0,2,0,4
47266,100,13655,18207;18337,34310,0,0,2,0,2
47267,100,13656,18273;18350,34310,0,0,2,0,2
47268,100,13657,18355;18508;21612,34310,1,0,2,0,3
47269,100,13658,18365;18522;21825,34310,1,0,2,0,3
47270,100,13659,18371;18538,34310,0,0,2,0,2
47271,100,13660,18395;18567,34310,0,0,2,0,2
47272,100,13661,18329;18476;21531;21979,34310,2,0,2,0,4
47273,100,13662,18458;19015;22024,34310,1,0,2,0,3
47274,100,13663,18460;18781,34310,0,0,2,0,2
47275,100,13664,18474,34310,0,0,1,0,1
47276,100,13665,18409;18477;21499;21809;21980,34310,3,0,2,0,5
47277,100,13667,18571;18744;21412,34310,0,1,2,0,3
47278,100,13668,18504;18574,34310,0,0,2,0,2
47279,100,13669,18578;18878,34310,0,0,2,0,2
47280,100,13670,18665;19052,34310,0,0,2,0,2
47281,100,13671,18664,34310,0,0,1,0,1
47282,100,13672,18680;19356;21889,34310,1,0,2,0,3
47283,100,13673,19128,34310,0,0,1,0,1
47284,100,13674,18754;19319,34310,0,0,2,0,2
47285,100,13675,18444;18585,34310,0,0,2,0,2
47286,100,13676,18772;19008,34310,0,0,2,0,2
47287,100,13677,18978,34310,0,0,1,0,1
47288,100,13678,18435;18802,34310,0,0,2,0,2
47289,100,13680,19510,34310,0,0,1,0,1
47290,100,13681,18825;18862;21686;21860,34310,2,0,2,0,4
47291,100,13682,18819;18863;22016,34310,1,0,2,0,3
47292,100,13683,18881;19135,34310,0,0,2,0,2
47293,100,13684,18809;18898,34310,0,0,2,0,2
47294,100,13685,18916;18992,34310,0,0,2,0,2
47295,100,13686,18921;19150,34310,0,0,2,0,2
47296,100,13687,18871;18927,34310,0,0,2,0,2
47297,100,13688,18891;18942;21562,34310,1,0,2,0,3
47298,100,13689,18576;18850,34310,0,0,2,0,2
47299,100,13690,18968;19546;21672,34310,1,0,2,0,3
47300,100,13691,18980;19411;21409;21676,34310,1,1,2,0,4
47301,100,13692,18993;19478;22023,34310,1,0,2,0,3
47302,100,13693,18996;19551,34310,0,0,2,0,2
47303,100,13694,19555,34310,0,0,1,0,1
47304,100,13695,19014,34310,0,0,1,0,1
47305,100,13696,18908;19023,34310,0,0,2,0,2
47306,100,13697,19032;19431,34310,0,0,2,0,2
47307,100,13698,18803;19036,34310,0,0,2,0,2
47308,100,13699,18603;19043,34310,0,0,2,0,2
47309,100,13700,19063;19596;21827,34310,1,0,2,0,3
47310,100,13701,19090;19260;21651,34310,1,0,2,0,3
47311,100,13702,19125;19393;21816,34310,1,0,2,0,3
47312,100,13703,19172;21521;22031,34310,2,0,1,0,3
47313,100,13704,19157;19191,34310,0,0,2,0,2
47314,100,13705,19011;19192;21641;21907,34310,2,0,2,0,4
47315,100,13706,19199;19368,34310,0,0,2,0,2
47316,100,13707,19217;19471,34310,0,0,2,0,2
47317,100,13708,19230;19449;21843,34310,1,0,2,0,3
47318,100,13709,19234;19322;21700,34310,1,0,2,0,3
47319,100,13710,19215;19242,34310,0,0,2,0,2
47320,100,13711,19278;19516,34310,0,0,2,0,2
47321,100,13712,18849;19281,34310,0,0,2,0,2
47322,100,13713,19282,34310,0,0,1,0,1
47323,100,13714,19293,34310,0,0,1,0,1
47324,100,13715,19303;19304;21903,34310,1,0,2,0,3
47325,100,13716,14141;14384,34675,0,0,1,1,2
47326,100,13717,13400,34675,0,0,0,1,1
47327,100,13719,14288,34675,0,0,1,0,1
47328,100,13720,14094,34675,0,0,0,1,1
47329,100,13721,14020,34675,0,0,0,1,1
47330,100,13723,14766,34675,0,0,1,0,1
47331,100,13724,14870,34675,0,0,1,0,1
47332,100,13731,15236,34675,0,0,1,0,1
47333,100,13735,15590,34675,0,0,1,0,1
47334,100,13736,15210,34675,0,0,1,0,1
47335,100,13737,15633,34675,0,0,1,0,1
47336,100,13739,15997,34675,0,0,1,0,1
47337,100,13740,15245,34675,0,0,1,0,1
47338,100,13741,15912;16026,34675,0,0,2,0,2
47339,100,13742,16079,34675,0,0,1,0,1
47340,100,13744,16340,34675,0,0,1,0,1
47341,100,13747,16769,34675,0,0,1,0,1
47342,100,13748,16893,34675,0,0,1,0,1
47343,100,13750,16971;17033,34675,0,0,2,0,2
47344,100,13753,16684,34675,0,0,1,0,1
47345,100,13755,17169,34675,0,0,1,0,1
47346,100,13757,16539;17409,34675,0,0,2,0,2
47347,100,13759,17361;17412;21917,34675,1,0,2,0,3
47348,100,13760,17791,34675,0,0,1,0,1
47349,100,13761,17730;17928,34675,0,0,2,0,2
47350,100,13763,18076,34675,0,0,1,0,1
47351,100,13764,18082;18175,34675,0,0,2,0,2
47352,100,13765,18086;18362,34675,0,0,2,0,2
47353,100,13766,17843;18055;21947,34675,1,0,2,0,3
47354,100,13767,18236,34675,0,0,1,0,1
47355,100,13768,18314;21967,34675,1,0,1,0,2
47356,100,13769,18257;18370;21908,34675,1,0,2,0,3
47357,100,13770,18100;18440,34675,0,0,2,0,2
47358,100,13771,18449,34675,0,0,1,0,1
47359,100,13772,18498;21835,34675,1,0,1,0,2
47360,100,13773,18553;18840,34675,0,0,2,0,2
47361,100,13774,18310;18595;21789,34675,1,0,2,0,3
47362,100,13775,18056;18616,34675,0,0,2,0,2
47363,100,13776,18253,34675,0,0,1,0,1
47364,100,13777,18647;18788,34675,0,0,2,0,2
47365,100,13778,18545;18695;21804;22000,34675,2,0,2,0,4
47366,100,13779,18767;19104,34675,0,0,2,0,2
47367,100,13780,18776;18791,34675,0,0,2,0,2
47368,100,13781,18794;19198,34675,0,0,2,0,2
47369,100,13782,18796,34675,0,0,1,0,1
47370,100,13783,18847,34675,0,0,1,0,1
47371,100,13784,18692;18855;21748,34675,1,0,2,0,3
47372,100,13785,18789;18860,34675,0,0,2,0,2
47373,100,13787,18895;19078;21660;21839,34675,2,0,2,0,4
47374,100,13788,18937;19130,34675,0,0,2,0,2
47375,100,13789,18947;19259,34675,0,0,2,0,2
47376,100,13790,18856;19029,34675,0,0,2,0,2
47377,100,13791,19048;19079,34675,0,0,2,0,2
47378,100,13792,19054;19166,34675,0,0,2,0,2
47379,100,13793,19071;19289;21530;21780,34675,2,0,2,0,4
47380,100,13794,18903;19074,34675,0,0,2,0,2
47381,100,13795,19110;19374,34675,0,0,2,0,2
47382,100,13796,19120;19349,34675,0,0,2,0,2
47383,100,13797,19115;19126,34675,0,0,2,0,2
47384,100,13798,19151;19153;21682,34675,1,0,2,0,3
47385,100,13799,19019;19177;21578,34675,1,0,2,0,3
47386,100,13800,19211;19391;22041,34675,1,0,2,0,3
47387,100,13801,19221;19633,34675,0,0,2,0,2
47388,100,13802,18811;19224;21732,34675,1,0,2,0,3
47389,100,13803,19181;19228,34675,0,0,2,0,2
47390,100,13804,19031;19283,34675,0,0,2,0,2
47391,100,13805,19298,34675,0,0,1,0,1
47392,100,13806,19299,34675,0,0,1,0,1
47393,100,13807,19307;19578,34675,0,0,2,0,2
47394,100,13808,19309;19412,34675,0,0,2,0,2
47395,100,13809,19310;19437,34675,0,0,2,0,2
47396,100,13810,19320,34675,0,0,1,0,1
47397,100,13811,19350;19397;21833;22039,34675,2,0,2,0,4
47398,100,13812,18886;19353;21561,34675,1,0,2,0,3
47399,100,13813,19385;19438,34675,0,0,2,0,2
47400,100,13814,19398;19440;21880,34675,1,0,2,0,3
47401,100,13815,19415;19495;21599,34675,1,0,2,0,3
47402,100,13816,19418;19733;21500,34675,1,0,2,0,3
47403,100,13817,13773,35040,0,0,0,1,1
47404,100,13818,13745,35040,0,0,0,1,1
47405,100,13821,14656;14897,35040,0,0,2,0,2
47406,100,13822,14783,35040,0,0,1,0,1
47407,100,13825,14962,35040,0,0,1,0,1
47408,100,13826,15001,35040,0,0,1,0,1
47409,100,13828,14855,35040,0,0,1,0,1
47410,100,13829,15159,35040,0,0,1,0,1
47411,100,13830,15276,35040,0,0,1,0,1
47412,100,13831,15438,35040,0,0,1,0,1
47413,100,13833,15575,35040,0,0,1,0,1
47414,100,13835,15662,35040,0,0,1,0,1
47415,100,13836,15707,35040,0,0,1,0,1
47416,100,13837,15847,35040,0,0,1,0,1
47417,100,13839,16163,35040,0,0,1,0,1
47418,100,13840,15545,35040,0,0,1,0,1
47419,100,13842,16219;16221,35040,0,0,2,0,2
47420,100,13844,16567;16775,35040,0,0,2,0,2
47421,100,13847,16538,35040,0,0,1,0,1
47422,100,13848,16881,35040,0,0,1,0,1
47423,100,13849,17092,35040,0,0,1,0,1
47424,100,13850,17077,35040,0,0,1,0,1
47425,100,13851,17261;17295,35040,0,0,2,0,2
47426,100,13854,17439,35040,0,0,1,0,1
47427,100,13856,17676;17922,35040,0,0,2,0,2
47428,100,13858,17728,35040,0,0,1,0,1
47429,100,13859,17202,35040,0,0,1,0,1
47430,100,13860,17700;18027,35040,0,0,2,0,2
47431,100,13861,18040,35040,0,0,1,0,1
47432,100,13862,18115;18473,35040,0,0,2,0,2
47433,100,13863,18138,35040,0,0,1,0,1
47434,100,13864,18172;18509,35040,0,0,2,0,2
47435,100,13865,18315;18526;21984,35040,1,0,2,0,3
47436,100,13866,18656;21994,35040,1,0,1,0,2
47437,100,13868,18388;19252,35040,0,0,2,0,2
47438,100,13870,18406;19266;21865,35040,1,0,2,0,3
47439,100,13871,18421;18808,35040,0,0,2,0,2
47440,100,13872,18268;18439;21705;21976,35040,2,0,2,0,4
47441,100,13873,18441;18661,35040,0,0,2,0,2
47442,100,13874,18448;18480,35040,0,0,2,0,2
47443,100,13875,18335;18451,35040,0,0,2,0,2
47444,100,13876,18151,35040,0,0,1,0,1
47445,100,13877,18471;18492,35040,0,0,2,0,2
47446,100,13878,18391;18500,35040,0,0,2,0,2
47447,100,13879,18326,35040,0,0,1,0,1
47448,100,13880,18527;19067;22027,35040,1,0,2,0,3
47449,100,13881,18537;18859,35040,0,0,2,0,2
47450,100,13882,18552;18564;21857,35040,1,0,2,0,3
47451,100,13883,18568,35040,0,0,1,0,1
47452,100,13884,18487;18606;21805,35040,1,0,2,0,3
47453,100,13885,18660;18872,35040,0,0,2,0,2
47454,100,13886,18518;18693;21868,35040,1,0,2,0,3
47455,100,13887,18132;18611,35040,0,0,2,0,2
47456,100,13888,18424;18707,35040,0,0,2,0,2
47457,100,13889,18710;22003,35040,1,0,1,0,2
47458,100,13890,18775;18986,35040,0,0,2,0,2
47459,100,13891,18799;22010,35040,1,0,1,0,2
47460,100,13892,18934;19483;21760,35040,1,0,2,0,3
47461,100,13893,18868;18951,35040,0,0,2,0,2
47462,100,13894,18833;18952,35040,0,0,2,0,2
47463,100,13895,18436;18974,35040,0,0,2,0,2
47464,100,13896,19003;19486,35040,0,0,2,0,2
47465,100,13897,19006;19342;21713,35040,1,0,2,0,3
47466,100,13898,19009;19236,35040,0,0,2,0,2
47467,100,13899,19018;19041;22025,35040,1,0,2,0,3
47468,100,13900,19025;19333,35040,0,0,2,0,2
47469,100,13901,19246;19661,35040,0,0,2,0,2
47470,100,13902,18818;19075;21871,35040,1,0,2,0,3
47471,100,13903,19088;19476,35040,0,0,2,0,2
47472,100,13904,19103,35040,0,0,1,0,1
47473,100,13905,19117;19610;21702,35040,1,0,2,0,3
47474,100,13906,18888;19139,35040,0,0,2,0,2
47475,100,13907,18983;19140;21799;22029,35040,2,0,2,0,4
47476,100,13908,19171;19323,35040,0,0,2,0,2
47477,100,13909,19206;19579;21790,35040,1,0,2,0,3
47478,100,13910,18935;19209,35040,0,0,2,0,2
47479,100,13911,19213;19316,35040,0,0,2,0,2
47480,100,13912,19219;19405,35040,0,0,2,0,2
47481,100,13913,19233;19531,35040,0,0,2,0,2
47482,100,13914,18889;19240,35040,0,0,2,0,2
47483,100,13915,19169;19253,35040,0,0,2,0,2
47484,100,13916,19549,35040,0,0,1,0,1
47485,100,13917,19268;21831,35040,1,0,1,0,2
47486,100,13918,19286;19748,35040,0,0,2,0,2
47487,100,13919,19294;19362;21699,35040,1,0,2,0,3
47488,100,13920,19315;19590,35040,0,0,2,0,2
47489,100,13921,19317;19386,35040,0,0,2,0,2
47490,100,13922,19375;19644,35040,0,0,2,0,2
47491,100,13923,18887;19377,35040,0,0,2,0,2
47492,100,13924,18979;19383,35040,0,0,2,0,2
47493,100,13925,19338;19400,35040,0,0,2,0,2
47494,100,13926,19446;19559,35040,0,0,2,0,2
47495,100,13927,19530;19629,35040,0,0,2,0,2
47496,100,13928,19057;19532,35040,0,0,2,0,2
47497,100,13929,19111;19542,35040,0,0,2,0,2
47498,100,13930,19279;19552,35040,0,0,2,0,2
47499,100,13931,19668,35040,0,0,1,0,1
47500,100,13932,19567;19872,35040,0,0,2,0,2
47501,100,13933,14298,35405,0,0,1,0,1
47502,100,13934,14549,35405,0,0,1,0,1
47503,100,13935,14506,35405,0,0,1,0,1
47504,100,13936,14633,35405,0,0,1,0,1
47505,100,13937,14551,35405,0,0,1,0,1
47506,100,13938,14901,35405,0,0,1,0,1
47507,100,13939,14961,35405,0,0,1,0,1
47508,100,13940,15156,35405,0,0,1,0,1
47509,100,13942,15356,35405,0,0,1,0,1
47510,100,13943,15382,35405,0,0,1,0,1
47511,100,13945,14861;15173,35405,0,0,2,0,2
47512,100,13946,15603,35405,0,0,1,0,1
47513,100,13949,15838,35405,0,0,1,0,1
47514,100,13950,15921,35405,0,0,1,0,1
47515,100,13952,16155;16231,35405,0,0,2,0,2
47516,100,13954,16244,35405,0,0,1,0,1
47517,100,13955,16144,35405,0,0,1,0,1
47518,100,13956,16516,35405,0,0,1,0,1
47519,100,13957,16557,35405,0,0,1,0,1
47520,100,13958,16573,35405,0,0,1,0,1
47521,100,13960,16498;17180,35405,0,0,2,0,2
47522,100,13966,17153,35405,0,0,1,0,1
47523,100,13968,17477,35405,0,0,1,0,1
47524,100,13970,17252,35405,0,0,1,0,1
47525,100,13971,17777;17831;21786,35405,1,0,2,0,3
47526,100,13973,17924,35405,0,0,1,0,1
47527,100,13974,17963;18531,35405,0,0,2,0,2
47528,100,13975,17989;18266,35405,0,0,2,0,2
47529,100,13976,17808;18066;21913,35405,1,0,2,0,3
47530,100,13977,17844;18030;21782;21946,35405,2,0,2,0,4
47531,100,13978,17725;17754,35405,0,0,2,0,2
47532,100,13979,17578;18051,35405,0,0,2,0,2
47533,100,13980,17864;18065;21783,35405,1,0,2,0,3
47534,100,13981,18087,35405,0,0,1,0,1
47535,100,13982,18270;18442;21977,35405,1,0,2,0,3
47536,100,13983,18272;19247,35405,0,0,2,0,2
47537,100,13984,18285;18324;21968,35405,1,0,2,0,3
47538,100,13985,18117;18333,35405,0,0,2,0,2
47539,100,13986,18349,35405,0,0,1,0,1
47540,100,13987,18152;18369,35405,0,0,2,0,2
47541,100,13988,18373,35405,0,0,1,0,1
47542,100,13989,18220;18379;21800;21914,35405,2,0,2,0,4
47543,100,13990,18416;18953,35405,0,0,2,0,2
47544,100,13991,18443;18703,35405,0,0,2,0,2
47545,100,13992,18464;18662;21745;21996,35405,2,0,2,0,4
47546,100,13993,18485;18521,35405,0,0,2,0,2
47547,100,13994,18523,35405,0,0,1,0,1
47548,100,13995,18534;18769;22005,35405,1,0,2,0,3
47549,100,13996,18594;19089;21792,35405,1,0,2,0,3
47550,100,13997,18411;18621;21990,35405,1,0,2,0,3
47551,100,13998,17986;18592,35405,0,0,2,0,2
47552,100,13999,18512;18682,35405,0,0,2,0,2
47553,100,14000,18720;19454,35405,0,0,2,0,2
47554,100,14002,18478;18748,35405,0,0,2,0,2
47555,100,14003,18760;19001,35405,0,0,2,0,2
47556,100,14004,18870;19107,35405,0,0,2,0,2
47557,100,14005,18917;18939,35405,0,0,2,0,2
47558,100,14006,18884;18975,35405,0,0,2,0,2
47559,100,14007,18780;18985;22022,35405,1,0,2,0,3
47560,100,14008,19084;19696,35405,0,0,2,0,2
47561,100,14009,19086;19768,35405,0,0,2,0,2
47562,100,14010,19098;19741,35405,0,0,2,0,2
47563,100,14011,19100;19178,35405,0,0,2,0,2
47564,100,14012,18691;19133,35405,0,0,2,0,2
47565,100,14013,19144;19697,35405,0,0,2,0,2
47566,100,14014,19080;19148,35405,0,0,2,0,2
47567,100,14015,18854;19174,35405,0,0,2,0,2
47568,100,14016,19176;19358,35405,0,0,2,0,2
47569,100,14017,18869;19180,35405,0,0,2,0,2
47570,100,14018,19201;19475,35405,0,0,2,0,2
47571,100,14019,19774,35405,0,0,1,0,1
47572,100,14020,19254,35405,0,0,1,0,1
47573,100,14021,19255;19285;21746,35405,1,0,2,0,3
47574,100,14022,19329;19878,35405,0,0,2,0,2
47575,100,14023,19336;19576,35405,0,0,2,0,2
47576,100,14024,18876;19339,35405,0,0,2,0,2
47577,100,14025,18827;19389,35405,0,0,2,0,2
47578,100,14026,19390;19824;21849,35405,1,0,2,0,3
47579,100,14027,18605;19401,35405,0,0,2,0,2
47580,100,14028,19366;19408,35405,0,0,2,0,2
47581,100,14029,19417,35405,0,0,1,0,1
47582,100,14030,19396;19453,35405,0,0,2,0,2
47583,100,14031,19473,35405,0,0,1,0,1
47584,100,14032,19482;19974,35405,0,0,2,0,2
47585,100,14033,19034;19491,35405,0,0,2,0,2
47586,100,14034,19503;21866,35405,1,0,1,0,2
47587,100,14035,19528;19669,35405,0,0,2,0,2
47588,100,14036,19533,35405,0,0,1,0,1
47589,100,14037,18792;19420,35405,0,0,2,0,2
47590,100,14038,19443,35405,0,0,1,0,1
47591,100,14039,19263,35405,0,0,1,0,1
47592,100,14040,19512;19553;21897,35405,1,0,2,0,3
47593,100,14041,18998;19875;21861,35405,1,0,2,0,3
47594,100,14042,19461;19556,35405,0,0,2,0,2
47595,100,14043,19300;19564;21795,35405,1,0,2,0,3
47596,100,14044,19572;19612,35405,0,0,2,0,2
47597,100,14045,19589;19716,35405,0,0,2,0,2
47598,100,14046,19605;19712,35405,0,0,2,0,2
47599,100,14047,19623,35405,0,0,1,0,1
47600,100,14048,19637;19751;21751;21851;22050,35405,3,0,2,0,5
47601,100,14049,19648;19934,35405,0,0,2,0,2
47602,100,14050,19609;19659,35405,0,0,2,0,2
47603,100,14051,19557,35405,0,0,1,0,1
47604,100,14052,14085,35770,0,0,0,1,1
47605,100,14053,14715,35770,0,0,1,0,1
47606,100,14054,14257,35770,0,0,1,0,1
47607,100,14055,14236,35770,0,0,1,0,1
47608,100,14057,14111,35770,0,0,0,1,1
47609,100,14058,14942,35770,0,0,1,0,1
47610,100,14059,15000;15372,35770,0,0,2,0,2
47611,100,14060,15079,35770,0,0,1,0,1
47612,100,14063,14438,35770,0,0,1,0,1
47613,100,14064,15267,35770,0,0,1,0,1
47614,100,14065,15257,35770,0,0,1,0,1
47615,100,14066,14531,35770,0,0,1,0,1
47616,100,14067,15410,35770,0,0,1,0,1
47617,100,14069,14720,35770,0,0,1,0,1
47618,100,14070,15604,35770,0,0,1,0,1
47619,100,14071,15718,35770,0,0,1,0,1
47620,100,14072,15750;15970,35770,0,0,2,0,2
47621,100,14073,15954,35770,0,0,1,0,1
47622,100,14074,16089,35770,0,0,1,0,1
47623,100,14075,15963,35770,0,0,1,0,1
47624,100,14078,16483,35770,0,0,1,0,1
47625,100,14081,17161,35770,0,0,1,0,1
47626,100,14082,17225;17724,35770,0,0,2,0,2
47627,100,14083,16972,35770,0,0,1,0,1
47628,100,14084,17366,35770,0,0,1,0,1
47629,100,14085,17450,35770,0,0,1,0,1
47630,100,14086,17625;17933,35770,0,0,2,0,2
47631,100,14087,17634,35770,0,0,1,0,1
47632,100,14088,17851,35770,0,0,1,0,1
47633,100,14089,17806;17947,35770,0,0,2,0,2
47634,100,14090,17829;17997,35770,0,0,2,0,2
47635,100,14091,17693,35770,0,0,1,0,1
47636,100,14092,18229,35770,0,0,1,0,1
47637,100,14093,18112,35770,0,0,1,0,1
47638,100,14094,18292;18826,35770,0,0,2,0,2
47639,100,14095,17564;18303,35770,0,0,2,0,2
47640,100,14096,18363;18701,35770,0,0,2,0,2
47641,100,14097,17863;18418;21974,35770,1,0,2,0,3
47642,100,14098,18423;19384,35770,0,0,2,0,2
47643,100,14099,18525;18798,35770,0,0,2,0,2
47644,100,14100,18582;19039,35770,0,0,2,0,2
47645,100,14101,18618;18640,35770,0,0,2,0,2
47646,100,14102,18625,35770,0,0,1,0,1
47647,100,14103,18719,35770,0,0,1,0,1
47648,100,14104,18766,35770,0,0,1,0,1
47649,100,14105,18790;18963,35770,0,0,2,0,2
47650,100,14106,18810;18960,35770,0,0,2,0,2
47651,100,14107,18467;18844,35770,0,0,2,0,2
47652,100,14109,18542;18943,35770,0,0,2,0,2
47653,100,14110,18973;19305,35770,0,0,2,0,2
47654,100,14111,18734,35770,0,0,1,0,1
47655,100,14112,19055;19529,35770,0,0,2,0,2
47656,100,14113,18823;19146,35770,0,0,2,0,2
47657,100,14114,19232,35770,0,0,1,0,1
47658,100,14115,19179;19243,35770,0,0,2,0,2
47659,100,14116,19244;19753,35770,0,0,2,0,2
47660,100,14117,19250;19798,35770,0,0,2,0,2
47661,100,14118,19203,35770,0,0,1,0,1
47662,100,14119,19162;19277;22035,35770,1,0,2,0,3
47663,100,14120,19295;19681,35770,0,0,2,0,2
47664,100,14121,19325;19585,35770,0,0,2,0,2
47665,100,14122,19343;19993,35770,0,0,2,0,2
47666,100,14123,19087;19360,35770,0,0,2,0,2
47667,100,14124,19302,35770,0,0,1,0,1
47668,100,14125,19370;19388,35770,0,0,2,0,2
47669,100,14126,19409;19734,35770,0,0,2,0,2
47670,100,14127,19410;19430,35770,0,0,2,0,2
47671,100,14128,19413;19891,35770,0,0,2,0,2
47672,100,14129,18940;19421,35770,0,0,2,0,2
47673,100,14130,19156;19432,35770,0,0,2,0,2
47674,100,14131,19462;19657,35770,0,0,2,0,2
47675,100,14132,19249;19470,35770,0,0,2,0,2
47676,100,14133,19651,35770,0,0,1,0,1
47677,100,14134,19484;19543,35770,0,0,2,0,2
47678,100,14135,19447;19511,35770,0,0,2,0,2
47679,100,14136,19514;19776,35770,0,0,2,0,2
47680,100,14137,19517;19759,35770,0,0,2,0,2
47681,100,14138,19539;19791,35770,0,0,2,0,2
47682,100,14139,19558,35770,0,0,1,0,1
47683,100,14140,19258;19573,35770,0,0,2,0,2
47684,100,14141,19602;19635;21893,35770,1,0,2,0,3
47685,100,14142,19658;19790;21856,35770,1,0,2,0,3
47686,100,14143,19066,35770,0,0,1,0,1
47687,100,14144,19586;19680,35770,0,0,2,0,2
47688,100,14145,19682,35770,0,0,1,0,1
47689,100,14146,19844,35770,0,0,1,0,1
47690,100,14147,19703;19713,35770,0,0,2,0,2
47691,100,14148,19357;19718,35770,0,0,2,0,2
47692,100,14149,19837;19884;21887,35770,1,0,2,0,3
47693,100,14150,19738,35770,0,0,1,0,1
47694,100,14151,19760;19980,35770,0,0,2,0,2
47695,100,14152,19769;19800,35770,0,0,2,0,2
47696,100,14153,19775;20027;21832,35770,1,0,2,0,3
47697,100,14154,14486,36135,0,0,1,0,1
47698,100,14156,14105,36135,0,0,0,1,1
47699,100,14157,14775,36135,0,0,1,0,1
47700,100,14159,15042,36135,0,0,1,0,1
47701,100,14160,15066,36135,0,0,1,0,1
47702,100,14161,15162,36135,0,0,1,0,1
47703,100,14162,15248;15822,36135,0,0,2,0,2
47704,100,14164,15247,36135,0,0,1,0,1
47705,100,14166,15377,36135,0,0,1,0,1
47706,100,14167,15341,36135,0,0,1,0,1
47707,100,14168,15559,36135,0,0,1,0,1
47708,100,14169,15272,36135,0,0,1,0,1
47709,100,14170,15591,36135,0,0,1,0,1
47710,100,14171,15844,36135,0,0,1,0,1
47711,100,14173,15825;16032,36135,0,0,2,0,2
47712,100,14174,15521,36135,0,0,1,0,1
47713,100,14176,16148,36135,0,0,1,0,1
47714,100,14177,16151,36135,0,0,1,0,1
47715,100,14178,16106,36135,0,0,1,0,1
47716,100,14179,15816,36135,0,0,1,0,1
47717,100,14180,16581,36135,0,0,1,0,1
47718,100,14181,16303,36135,0,0,1,0,1
47719,100,14182,16913,36135,0,0,1,0,1
47720,100,14185,17134,36135,0,0,1,0,1
47721,100,14187,17367,36135,0,0,1,0,1
47722,100,14188,17444,36135,0,0,1,0,1
47723,100,14190,16839,36135,0,0,1,0,1
47724,100,14191,17516,36135,0,0,1,0,1
47725,100,14192,17553,36135,0,0,1,0,1
47726,100,14193,17658,36135,0,0,1,0,1
47727,100,14194,17734,36135,0,0,1,0,1
47728,100,14195,17771;18169,36135,0,0,2,0,2
47729,100,14197,17968,36135,0,0,1,0,1
47730,100,14198,17973;17987,36135,0,0,2,0,2
47731,100,14199,17762,36135,0,0,1,0,1
47732,100,14200,17992,36135,0,0,1,0,1
47733,100,14201,18420,36135,0,0,1,0,1
47734,100,14202,18283,36135,0,0,1,0,1
47735,100,14203,18341,36135,0,0,1,0,1
47736,100,14204,18437,36135,0,0,1,0,1
47737,100,14205,18071;18468,36135,0,0,2,0,2
47738,100,14206,18546;19267,36135,0,0,2,0,2
47739,100,14207,18686;18853,36135,0,0,2,0,2
47740,100,14208,18550;18643,36135,0,0,2,0,2
47741,100,14209,18657,36135,0,0,1,0,1
47742,100,14211,18929;19599,36135,0,0,2,0,2
47743,100,14212,18954;19189;22034,36135,1,0,2,0,3
47744,100,14213,18995;19732,36135,0,0,2,0,2
47745,100,14214,19024;19105,36135,0,0,2,0,2
47746,100,14215,18653;19045,36135,0,0,2,0,2
47747,100,14216,18533,36135,0,0,1,0,1
47748,100,14217,19238,36135,0,0,1,0,1
47749,100,14218,19062;19783,36135,0,0,2,0,2
47750,100,14219,18528;19154,36135,0,0,2,0,2
47751,100,14220,19155;19601,36135,0,0,2,0,2
47752,100,14221,19085;19212,36135,0,0,2,0,2
47753,100,14222,19106;19284,36135,0,0,2,0,2
47754,100,14223,19346,36135,0,0,1,0,1
47755,100,14224,18941,36135,0,0,1,0,1
47756,100,14225,19112;19306,36135,0,0,2,0,2
47757,100,14226,19197;19328,36135,0,0,2,0,2
47758,100,14227,19335,36135,0,0,1,0,1
47759,100,14228,19185;19351,36135,0,0,2,0,2
47760,100,14229,19058;19355;22040,36135,1,0,2,0,3
47761,100,14230,19369,36135,0,0,1,0,1
47762,100,14231,19427;19641,36135,0,0,2,0,2
47763,100,14232,19545,36135,0,0,1,0,1
47764,100,14233,19587;20047,36135,0,0,2,0,2
47765,100,14234,19617;19963,36135,0,0,2,0,2
47766,100,14235,19618;19665,36135,0,0,2,0,2
47767,100,14236,19663;19803,36135,0,0,2,0,2
47768,100,14237,19707;19909,36135,0,0,2,0,2
47769,100,14238,19721,36135,0,0,1,0,1
47770,100,14239,19724,36135,0,0,1,0,1
47771,100,14240,19737;19743,36135,0,0,2,0,2
47772,100,14241,19347;19744,36135,0,0,2,0,2
47773,100,14242,19750,36135,0,0,1,0,1
47774,100,14243,19686;19762,36135,0,0,2,0,2
47775,100,14244,19802;19965,36135,0,0,2,0,2
47776,100,14245,19810;19950,36135,0,0,2,0,2
47777,100,14246,19813;20064,36135,0,0,2,0,2
47778,100,14247,19826;20036,36135,0,0,2,0,2
47779,100,14248,19829,36135,0,0,1,0,1
47780,100,14249,19832;19987,36135,0,0,2,0,2
47781,100,14250,19843;20141,36135,0,0,2,0,2
47782,100,14251,19852;20118,36135,0,0,2,0,2
47783,100,14252,19204;19854,36135,0,0,2,0,2
47784,100,14253,19859;20102,36135,0,0,2,0,2
47785,100,14254,19662;19861,36135,0,0,2,0,2
47786,100,14255,19864;20195,36135,0,0,2,0,2
47787,100,14256,19719;19880,36135,0,0,2,0,2
47788,100,14257,19569;19886,36135,0,0,2,0,2
47789,100,14258,14806,36500,0,0,1,0,1
47790,100,14259,14825,36500,0,0,1,0,1
47791,100,14260,14876,36500,0,0,1,0,1
47792,100,14261,14634,36500,0,0,1,0,1
47793,100,14262,14529,36500,0,0,1,0,1
47794,100,14263,15264,36500,0,0,1,0,1
47795,100,14264,15443,36500,0,0,1,0,1
47796,100,14265,15457,36500,0,0,1,0,1
47797,100,14266,15668,36500,0,0,1,0,1
47798,100,14267,15708,36500,0,0,1,0,1
47799,100,14268,15757,36500,0,0,1,0,1
47800,100,14269,15566,36500,0,0,1,0,1
47801,100,14270,16133,36500,0,0,1,0,1
47802,100,14271,16307,36500,0,0,1,0,1
47803,100,14272,16374,36500,0,0,1,0,1
47804,100,14273,16235,36500,0,0,1,0,1
47805,100,14274,16520,36500,0,0,1,0,1
47806,100,14275,16255,36500,0,0,1,0,1
47807,100,14276,16689,36500,0,0,1,0,1
47808,100,14277,17155,36500,0,0,1,0,1
47809,100,14278,17209,36500,0,0,1,0,1
47810,100,14279,17012,36500,0,0,1,0,1
47811,100,14280,17483;17784,36500,0,0,2,0,2
47812,100,14281,17094,36500,0,0,1,0,1
47813,100,14282,17827,36500,0,0,1,0,1
47814,100,14283,17377,36500,0,0,1,0,1
47815,100,14284,18144,36500,0,0,1,0,1
47816,100,14285,18111,36500,0,0,1,0,1
47817,100,14286,17902,36500,0,0,1,0,1
47818,100,14287,18234,36500,0,0,1,0,1
47819,100,14288,18244,36500,0,0,1,0,1
47820,100,14289,18198,36500,0,0,1,0,1
47821,100,14290,17954,36500,0,0,1,0,1
47822,100,14291,17945,36500,0,0,1,0,1
47823,100,14292,18275;18491,36500,0,0,2,0,2
47824,100,14293,18541,36500,0,0,1,0,1
47825,100,14294,18596;18599,36500,0,0,2,0,2
47826,100,14295,18641,36500,0,0,1,0,1
47827,100,14296,18654;18931,36500,0,0,2,0,2
47828,100,14297,18666,36500,0,0,1,0,1
47829,100,14298,19616,36500,0,0,1,0,1
47830,100,14299,18493,36500,0,0,1,0,1
47831,100,14300,18814,36500,0,0,1,0,1
47832,100,14301,18610;18909,36500,0,0,2,0,2
47833,100,14302,18828;18957,36500,0,0,2,0,2
47834,100,14303,18583,36500,0,0,1,0,1
47835,100,14304,18987;19381,36500,0,0,2,0,2
47836,100,14305,19013;19645,36500,0,0,2,0,2
47837,100,14306,19020,36500,0,0,1,0,1
47838,100,14307,19070;19226,36500,0,0,2,0,2
47839,100,14308,19077;19632,36500,0,0,2,0,2
47840,100,14309,18736,36500,0,0,1,0,1
47841,100,14310,19175,36500,0,0,1,0,1
47842,100,14311,19222;20010,36500,0,0,2,0,2
47843,100,14312,19272,36500,0,0,1,0,1
47844,100,14313,19291,36500,0,0,1,0,1
47845,100,14314,19183,36500,0,0,1,0,1
47846,100,14315,18851;19344;22038,36500,1,0,2,0,3
47847,100,14316,19365,36500,0,0,1,0,1
47848,100,14317,19168;19392,36500,0,0,2,0,2
47849,100,14318,19403,36500,0,0,1,0,1
47850,100,14319,19037;19407,36500,0,0,2,0,2
47851,100,14320,19442;20179,36500,0,0,2,0,2
47852,100,14321,19257;19445,36500,0,0,2,0,2
47853,100,14322,19451;19889,36500,0,0,2,0,2
47854,100,14323,19457;19527,36500,0,0,2,0,2
47855,100,14324,19467;19562,36500,0,0,2,0,2
47856,100,14325,19509;19786,36500,0,0,2,0,2
47857,100,14326,19518;19693;22049,36500,1,0,2,0,3
47858,100,14327,19603;19642,36500,0,0,2,0,2
47859,100,14328,19354;19631,36500,0,0,2,0,2
47860,100,14329,19643;19673,36500,0,0,2,0,2
47861,100,14330,19124;19647,36500,0,0,2,0,2
47862,100,14331,19650;20129,36500,0,0,2,0,2
47863,100,14332,19672;19807,36500,0,0,2,0,2
47864,100,14333,19687;19874,36500,0,0,2,0,2
47865,100,14334,19728;20092,36500,0,0,2,0,2
47866,100,14335,19740;19755,36500,0,0,2,0,2
47867,100,14336,19747;19827,36500,0,0,2,0,2
47868,100,14337,19780;19858,36500,0,0,2,0,2
47869,100,14338,19782;20142,36500,0,0,2,0,2
47870,100,14339,19784;20260,36500,0,1,1,0,2
47871,100,14340,19828;20177,36500,0,0,2,0,2
47872,100,14341,19834,36500,0,0,1,0,1
47873,100,14342,19805;19842,36500,0,0,2,0,2
47874,100,14343,19711,36500,0,0,1,0,1
47875,100,14344,19182;19855,36500,0,0,2,0,2
47876,100,14345,19857;19979,36500,0,0,2,0,2
47877,100,14346,19876;19894,36500,0,0,2,0,2
47878,100,14347,19675;19892,36500,0,0,2,0,2
47879,100,14348,19819;19898,36500,0,0,2,0,2
47880,100,14349,19746;19929,36500,0,0,2,0,2
47881,100,14350,19273;19945,36500,0,0,2,0,2
47882,100,14351,19947;20283,36500,0,1,1,0,2
47883,100,14352,19958,36500,0,0,1,0,1
47884,100,14353,19960;20000,36500,0,0,2,0,2
47885,100,14354,19816;19964,36500,0,0,2,0,2
47886,100,14355,19975;20249,36500,0,1,1,0,2
47887,100,14356,19983;20109,36500,0,0,2,0,2
47888,110,4793,12083,2920,0,0,0,1,1
47889,110,4817,14003,2920,0,0,0,1,1
47890,110,5177,12810,4015,0,0,0,1,1
47891,110,5663,13760;13895,5840,0,0,0,2,2
47892,110,6213,13700;14272,7665,0,0,0,2,2
47893,110,6418,13803,8395,0,0,0,1,1
47894,110,6620,14556,9125,0,0,0,1,1
47895,110,6757,14681;15177,9855,0,0,0,2,2
47896,110,6806,14284;14404,9855,0,0,0,2,2
47897,110,6952,11045,10585,0,0,0,1,1
47898,110,6957,11343,10585,0,0,0,1,1
47899,110,7029,11460,10950,0,0,0,1,1
47900,110,7032,11248,10950,0,0,0,1,1
47901,110,7040,11102,10950,0,0,0,1,1
47902,110,7043,11126,10950,0,0,0,1,1
47903,110,7052,14514,10950,0,0,0,1,1
47904,110,7201,11121,11680,0,0,0,1,1
47905,110,7211,13670,11680,0,0,0,1,1
47906,110,7213,15004,11680,0,0,0,1,1
47907,110,7215,11366,11680,0,0,0,1,1
47908,110,7299,11597,12045,0,0,0,1,1
47909,110,7311,11379,12045,0,0,0,1,1
47910,110,7314,11405;11457,12045,0,0,0,2,2
47911,110,7316,11637,12045,0,0,0,1,1
47912,110,7393,11825,12410,0,0,0,1,1
47913,110,7408,11535,12410,0,0,0,1,1
47914,110,7466,11461,12775,0,0,0,1,1
47915,110,7470,11619,12775,0,0,0,1,1
47916,110,7475,11969,12775,0,0,0,1,1
47917,110,7478,11928,12775,0,0,0,1,1
47918,110,7484,11511,12775,0,0,0,1,1
47919,110,7485,12025,12775,0,0,0,1,1
47920,110,7487,11724,12775,0,0,0,1,1
47921,110,7544,11311,13140,0,0,0,1,1
47922,110,7565,11657,13140,0,0,0,1,1
47923,110,7628,11863,13505,0,0,0,1,1
47924,110,7634,11848,13505,0,0,0,1,1
47925,110,7636,12053,13505,0,0,0,1,1
47926,110,7640,11842,13505,0,0,0,1,1
47927,110,7641,11357,13505,0,0,0,1,1
47928,110,7643,11876,13505,0,0,0,1,1
47929,110,7645,11817,13505,0,0,0,1,1
47930,110,7647,11774,13505,0,0,0,1,1
47931,110,7652,11734,13505,0,0,0,1,1
47932,110,7672,14838,13870,0,0,0,1,1
47933,110,7712,11557,13870,0,0,0,1,1
47934,110,7719,11963,13870,0,0,0,1,1
47935,110,7729,11609,13870,0,0,0,1,1
47936,110,7730,11729,13870,0,0,0,1,1
47937,110,7732,11996,13870,0,0,0,1,1
47938,110,7737,16203;16239,13870,0,0,2,0,2
47939,110,7739,11731,13870,0,0,0,1,1
47940,110,7754,11856,13870,0,0,0,1,1
47941,110,7759,12203,13870,0,0,0,1,1
47942,110,7764,12308,13870,0,0,0,1,1
47943,110,7765,11699,13870,0,0,0,1,1
47944,110,7817,11577,14235,0,0,0,1,1
47945,110,7824,11591,14235,0,0,0,1,1
47946,110,7828,11565,14235,0,0,0,1,1
47947,110,7838,12352,14235,0,0,0,1,1
47948,110,7841,11900,14235,0,0,0,1,1
47949,110,7842,12008,14235,0,0,0,1,1
47950,110,7845,11836,14235,0,0,0,1,1
47951,110,7854,12151,14235,0,0,0,1,1
47952,110,7855,12149,14235,0,0,0,1,1
47953,110,7857,12073,14235,0,0,0,1,1
47954,110,7858,11673,14235,0,0,0,1,1
47955,110,7859,12249,14235,0,0,0,1,1
47956,110,7909,11275,14600,0,0,0,1,1
47957,110,7912,11664,14600,0,0,0,1,1
47958,110,7920,12378,14600,0,0,0,1,1
47959,110,7923,12022,14600,0,0,0,1,1
47960,110,7925,11992,14600,0,0,0,1,1
47961,110,7929,12406;12489,14600,0,0,0,2,2
47962,110,7930,12001,14600,0,0,0,1,1
47963,110,7931,12161,14600,0,0,0,1,1
47964,110,7933,12202,14600,0,0,0,1,1
47965,110,7934,12089,14600,0,0,0,1,1
47966,110,7937,16429;16442;20824;21033,14600,0,0,4,0,4
47967,110,7942,12140,14600,0,0,0,1,1
47968,110,7943,12183,14600,0,0,0,1,1
47969,110,7944,12155,14600,0,0,0,1,1
47970,110,7945,12449,14600,0,0,0,1,1
47971,110,7946,12141,14600,0,0,0,1,1
47972,110,7948,12233,14600,0,0,0,1,1
47973,110,7950,12554,14600,0,0,0,1,1
47974,110,7992,11710;11796,14965,0,0,0,2,2
47975,110,7994,11604,14965,0,0,0,1,1
47976,110,8000,11780;12317,14965,0,0,0,2,2
47977,110,8003,12730,14965,0,0,0,1,1
47978,110,8010,12107,14965,0,0,0,1,1
47979,110,8014,12221,14965,0,0,0,1,1
47980,110,8017,18295,14965,0,0,1,0,1
47981,110,8018,12543;12629,14965,0,0,0,2,2
47982,110,8019,12603,14965,0,0,0,1,1
47983,110,8020,12665,14965,0,0,0,1,1
47984,110,8023,12330,14965,0,0,0,1,1
47985,110,8024,12648,14965,0,0,0,1,1
47986,110,8026,12251;12370,14965,0,0,0,2,2
47987,110,8027,12355,14965,0,0,0,1,1
47988,110,8073,11653,15330,0,0,0,1,1
47989,110,8076,12146,15330,0,0,0,1,1
47990,110,8081,11445,15330,0,0,0,1,1
47991,110,8084,12219,15330,0,0,0,1,1
47992,110,8085,11659,15330,0,0,0,1,1
47993,110,8090,11844;11968,15330,0,0,0,2,2
47994,110,8104,12060,15330,0,0,0,1,1
47995,110,8107,12266;12284,15330,0,0,0,2,2
47996,110,8112,12088;12235,15330,0,0,0,2,2
47997,110,8117,12397,15330,0,0,0,1,1
47998,110,8120,12479,15330,0,0,0,1,1
47999,110,8148,11118,15695,0,0,0,1,1
48000,110,8164,12188,15695,0,0,0,1,1
48001,110,8165,11600,15695,0,0,0,1,1
48002,110,8170,12061,15695,0,0,0,1,1
48003,110,8171,12045,15695,0,0,0,1,1
48004,110,8172,11991,15695,0,0,0,1,1
48005,110,8176,12318,15695,0,0,0,1,1
48006,110,8177,12101;12566,15695,0,0,0,2,2
48007,110,8179,12121,15695,0,0,0,1,1
48008,110,8182,16651;16940;17167;17336;20957;21021;21441,15695,0,1,6,0,7
48009,110,8184,12935,15695,0,0,0,1,1
48010,110,8189,12812,15695,0,0,0,1,1
48011,110,8190,16283;16550,15695,0,0,2,0,2
48012,110,8191,12755,15695,0,0,0,1,1
48013,110,8193,12392,15695,0,0,0,1,1
48014,110,8194,12684,15695,0,0,0,1,1
48015,110,8196,13241,15695,0,0,0,1,1
48016,110,8197,12529;12901,15695,0,0,0,2,2
48017,110,8198,12365,15695,0,0,0,1,1
48018,110,8199,12496,15695,0,0,0,1,1
48019,110,8200,12414,15695,0,0,0,1,1
48020,110,8201,12795;12815,15695,0,0,0,2,2
48021,110,8202,12486;12540,15695,0,0,0,2,2
48022,110,8206,12871,15695,0,0,0,1,1
48023,110,8247,12866,16060,0,0,0,1,1
48024,110,8258,11867,16060,0,0,0,1,1
48025,110,8262,12430,16060,0,0,0,1,1
48026,110,8263,12807,16060,0,0,0,1,1
48027,110,8264,11917,16060,0,0,0,1,1
48028,110,8268,12294,16060,0,0,0,1,1
48029,110,8269,12495;12705,16060,0,0,0,2,2
48030,110,8270,11872;11949,16060,0,0,0,2,2
48031,110,8273,12195,16060,0,0,0,1,1
48032,110,8278,12332;12745,16060,0,0,0,2,2
48033,110,8279,12367,16060,0,0,0,1,1
48034,110,8280,12407,16060,0,0,0,1,1
48035,110,8282,12889;12963,16060,0,0,0,2,2
48036,110,8283,12735,16060,0,0,0,1,1
48037,110,8285,12427,16060,0,0,0,1,1
48038,110,8287,12719;12753,16060,0,0,0,2,2
48039,110,8289,12227,16060,0,0,0,1,1
48040,110,8290,12620,16060,0,0,0,1,1
48041,110,8291,12615,16060,0,0,0,1,1
48042,110,8292,12623;12776,16060,0,0,0,2,2
48043,110,8295,12685,16060,0,0,0,1,1
48044,110,8297,12652,16060,0,0,0,1,1
48045,110,8298,13084,16060,0,0,0,1,1
48046,110,8302,12737,16060,0,0,0,1,1
48047,110,8338,12059,16425,0,0,0,1,1
48048,110,8340,11542,16425,0,0,0,1,1
48049,110,8342,12057,16425,0,0,0,1,1
48050,110,8348,12269,16425,0,0,0,1,1
48051,110,8349,12851,16425,0,0,0,1,1
48052,110,8352,12640,16425,0,0,0,1,1
48053,110,8355,12846,16425,0,0,0,1,1
48054,110,8356,13196,16425,0,0,0,1,1
48055,110,8359,12395,16425,0,0,0,1,1
48056,110,8360,12792,16425,0,0,0,1,1
48057,110,8361,12834,16425,0,0,0,1,1
48058,110,8364,12674,16425,0,0,0,1,1
48059,110,8365,12859,16425,0,0,0,1,1
48060,110,8366,12550;12946,16425,0,0,0,2,2
48061,110,8368,12575,16425,0,0,0,1,1
48062,110,8369,12453,16425,0,0,0,1,1
48063,110,8371,12723;12854,16425,0,0,0,2,2
48064,110,8372,12276,16425,0,0,0,1,1
48065,110,8373,12822,16425,0,0,0,1,1
48066,110,8374,12973,16425,0,0,0,1,1
48067,110,8375,12974,16425,0,0,0,1,1
48068,110,8376,13379,16425,0,0,0,1,1
48069,110,8377,13198;13404,16425,0,0,0,2,2
48070,110,8378,12920,16425,0,0,0,1,1
48071,110,8379,13048,16425,0,0,0,1,1
48072,110,8380,12572,16425,0,0,0,1,1
48073,110,8382,12616,16425,0,0,0,1,1
48074,110,8383,12954;13085,16425,0,0,0,2,2
48075,110,8384,12785,16425,0,0,0,1,1
48076,110,8386,13004;13054,16425,0,0,0,2,2
48077,110,8390,12864,16425,0,0,0,1,1
48078,110,8426,12293,16790,0,0,0,1,1
48079,110,8431,12082,16790,0,0,0,1,1
48080,110,8442,12418,16790,0,0,0,1,1
48081,110,8444,12193,16790,0,0,0,1,1
48082,110,8445,12277;12328,16790,0,0,0,2,2
48083,110,8446,12244,16790,0,0,0,1,1
48084,110,8447,12642,16790,0,0,0,1,1
48085,110,8448,12185,16790,0,0,0,1,1
48086,110,8450,12315,16790,0,0,0,1,1
48087,110,8452,12376,16790,0,0,0,1,1
48088,110,8456,12419,16790,0,0,0,1,1
48089,110,8457,12439,16790,0,0,0,1,1
48090,110,8458,12279;12455,16790,0,0,0,2,2
48091,110,8459,12697,16790,0,0,0,1,1
48092,110,8460,12892,16790,0,0,0,1,1
48093,110,8461,12514,16790,0,0,0,1,1
48094,110,8464,13158,16790,0,0,0,1,1
48095,110,8466,13029;13300,16790,0,0,0,2,2
48096,110,8468,12681,16790,0,0,0,1,1
48097,110,8469,12686,16790,0,0,0,1,1
48098,110,8470,13186,16790,0,0,0,1,1
48099,110,8471,12382,16790,0,0,0,1,1
48100,110,8472,12775,16790,0,0,0,1,1
48101,110,8473,12803,16790,0,0,0,1,1
48102,110,8474,12628,16790,0,0,0,1,1
48103,110,8475,12818,16790,0,0,0,1,1
48104,110,8476,12955,16790,0,0,0,1,1
48105,110,8477,12837,16790,0,0,0,1,1
48106,110,8478,12701;13057,16790,0,0,0,2,2
48107,110,8479,12894,16790,0,0,0,1,1
48108,110,8480,12858,16790,0,0,0,1,1
48109,110,8481,12861,16790,0,0,0,1,1
48110,110,8482,13308,16790,0,0,0,1,1
48111,110,8484,12879;13439,16790,0,0,0,2,2
48112,110,8485,12886,16790,0,0,0,1,1
48113,110,8486,12919;13371,16790,0,0,0,2,2
48114,110,8487,12924,16790,0,0,0,1,1
48115,110,8488,12672;13318,16790,0,0,0,2,2
48116,110,8490,12942,16790,0,0,0,1,1
48117,110,8491,16641;16853;21300,16790,0,1,2,0,3
48118,110,8492,12772,16790,0,0,0,1,1
48119,110,8516,11756,17155,0,0,0,1,1
48120,110,8521,12070;17253,17155,0,0,1,1,2
48121,110,8530,12156,17155,0,0,0,1,1
48122,110,8534,12270,17155,0,0,0,1,1
48123,110,8536,12280,17155,0,0,0,1,1
48124,110,8537,12079,17155,0,0,0,1,1
48125,110,8541,12292,17155,0,0,0,1,1
48126,110,8542,12712,17155,0,0,0,1,1
48127,110,8543,12770,17155,0,0,0,1,1
48128,110,8546,12778,17155,0,0,0,1,1
48129,110,8547,13377,17155,0,0,0,1,1
48130,110,8548,12339,17155,0,0,0,1,1
48131,110,8549,12539;12733,17155,0,0,0,2,2
48132,110,8550,12961,17155,0,0,0,1,1
48133,110,8551,12245;12333,17155,0,0,0,2,2
48134,110,8553,12906,17155,0,0,0,1,1
48135,110,8554,12622;13214,17155,0,0,0,2,2
48136,110,8555,12180,17155,0,0,0,1,1
48137,110,8556,13050,17155,0,0,0,1,1
48138,110,8559,13272;13391;15452,17155,0,0,0,3,3
48139,110,8561,12734;13290,17155,0,0,0,2,2
48140,110,8562,12744,17155,0,0,0,1,1
48141,110,8563,13204,17155,0,0,0,1,1
48142,110,8564,13034;13265,17155,0,0,0,2,2
48143,110,8565,12806;12883,17155,0,0,0,2,2
48144,110,8567,13398;13579,17155,0,0,0,2,2
48145,110,8569,12896,17155,0,0,0,1,1
48146,110,8570,12878;13159,17155,0,0,0,2,2
48147,110,8571,12931;13170,17155,0,0,0,2,2
48148,110,8572,12932,17155,0,0,0,1,1
48149,110,8573,12751;12934,17155,0,0,0,2,2
48150,110,8574,12938;12990,17155,0,0,0,2,2
48151,110,8576,12960,17155,0,0,0,1,1
48152,110,8577,12592;12641,17155,0,0,0,2,2
48153,110,8578,13051;13409,17155,0,0,0,2,2
48154,110,8581,12925;13020,17155,0,0,0,2,2
48155,110,8585,12213;13063;16742,17155,0,0,1,2,3
48156,110,8586,13071,17155,0,0,0,1,1
48157,110,8588,12811;13133,17155,0,0,0,2,2
48158,110,8589,13307,17155,0,0,0,1,1
48159,110,8621,11634,17520,0,0,0,1,1
48160,110,8623,11782,17520,0,0,0,1,1
48161,110,8628,12393,17520,0,0,0,1,1
48162,110,8631,12421,17520,0,0,0,1,1
48163,110,8632,12764,17520,0,0,0,1,1
48164,110,8633,11744;12327,17520,0,0,0,2,2
48165,110,8636,12263,17520,0,0,0,1,1
48166,110,8637,12363,17520,0,0,0,1,1
48167,110,8639,12725,17520,0,0,0,1,1
48168,110,8640,12814,17520,0,0,0,1,1
48169,110,8641,13040,17520,0,0,0,1,1
48170,110,8643,12491;12838,17520,0,0,0,2,2
48171,110,8645,12821,17520,0,0,0,1,1
48172,110,8648,13140;13341,17520,0,0,0,2,2
48173,110,8649,12638,17520,0,0,0,1,1
48174,110,8650,12627;13252;17151,17520,0,0,1,2,3
48175,110,8651,12457,17520,0,0,0,1,1
48176,110,8652,12655,17520,0,0,0,1,1
48177,110,8654,12771,17520,0,0,0,1,1
48178,110,8655,12890;13146,17520,0,0,0,2,2
48179,110,8657,13116;13181,17520,0,0,0,2,2
48180,110,8658,12304;12848,17520,0,0,0,2,2
48181,110,8659,13533,17520,0,0,0,1,1
48182,110,8660,13091,17520,0,0,0,1,1
48183,110,8661,13313;13364,17520,0,0,0,2,2
48184,110,8662,13270,17520,0,0,0,1,1
48185,110,8663,12936,17520,0,0,0,1,1
48186,110,8664,13609,17520,0,0,0,1,1
48187,110,8665,13014;13176,17520,0,0,0,2,2
48188,110,8666,12921,17520,0,0,0,1,1
48189,110,8667,13482;13612,17520,0,0,0,2,2
48190,110,8669,13045;13550,17520,0,0,0,2,2
48191,110,8670,13622;13632,17520,0,0,0,2,2
48192,110,8672,13076;13537,17520,0,0,0,2,2
48193,110,8673,13087;13178,17520,0,0,0,2,2
48194,110,8675,13141,17520,0,0,0,1,1
48195,110,8676,13268,17520,0,0,0,1,1
48196,110,8677,12994;13189,17520,0,0,0,2,2
48197,110,8679,13255,17520,0,0,0,1,1
48198,110,8680,13489,17520,0,0,0,1,1
48199,110,8710,11682,17885,0,0,0,1,1
48200,110,8712,11811,17885,0,0,0,1,1
48201,110,8713,16470;16707;20656;21691,17885,0,1,3,0,4
48202,110,8714,12122,17885,0,0,0,1,1
48203,110,8720,12007,17885,0,0,0,1,1
48204,110,8722,11295,17885,0,0,0,1,1
48205,110,8729,12577,17885,0,0,0,1,1
48206,110,8734,12475,17885,0,0,0,1,1
48207,110,8735,12055;12482,17885,0,0,0,2,2
48208,110,8736,12717;13415,17885,0,0,0,2,2
48209,110,8737,17138,17885,0,0,1,0,1
48210,110,8740,13115,17885,0,0,0,1,1
48211,110,8742,12404,17885,0,0,0,1,1
48212,110,8743,17384;17603;21684,17885,0,1,2,0,3
48213,110,8744,13383,17885,0,0,0,1,1
48214,110,8745,13123,17885,0,0,0,1,1
48215,110,8746,13068,17885,0,0,0,1,1
48216,110,8747,12980,17885,0,0,0,1,1
48217,110,8749,12773;13184,17885,0,0,0,2,2
48218,110,8750,13630,17885,0,0,0,1,1
48219,110,8751,12524;13643,17885,0,0,0,2,2
48220,110,8755,12478,17885,0,0,0,1,1
48221,110,8756,12991;13043,17885,0,0,0,2,2
48222,110,8757,13010,17885,0,0,0,1,1
48223,110,8758,13432,17885,0,0,0,1,1
48224,110,8759,13462,17885,0,0,0,1,1
48225,110,8760,12944;13094,17885,0,0,0,2,2
48226,110,8761,12718;13118,17885,0,0,0,2,2
48227,110,8762,13220,17885,0,0,0,1,1
48228,110,8763,13121;13755,17885,0,0,0,2,2
48229,110,8764,12767;13131,17885,0,0,0,2,2
48230,110,8766,13403,17885,0,0,0,1,1
48231,110,8767,13155,17885,0,0,0,1,1
48232,110,8768,13174,17885,0,0,0,1,1
48233,110,8769,13096;13183,17885,0,0,0,2,2
48234,110,8770,13195,17885,0,0,0,1,1
48235,110,8771,13024,17885,0,0,0,1,1
48236,110,8773,13242,17885,0,0,0,1,1
48237,110,8774,13250,17885,0,0,0,1,1
48238,110,8775,13180;13253;17960,17885,0,0,1,2,3
48239,110,8777,13291;17479,17885,0,0,1,1,2
48240,110,8778,13295,17885,0,0,0,1,1
48241,110,8780,13303,17885,0,0,0,1,1
48242,110,8781,13122;13656,17885,0,0,0,2,2
48243,110,8782,13144,17885,0,0,0,1,1
48244,110,8783,12666;13518,17885,0,0,0,2,2
48245,110,8784,13468,17885,0,0,0,1,1
48246,110,8785,13703,17885,0,0,0,1,1
48247,110,8786,13369;13669,17885,0,0,0,2,2
48248,110,8787,13382,17885,0,0,0,1,1
48249,110,8788,13396,17885,0,0,0,1,1
48250,110,8826,11820,18250,0,0,0,1,1
48251,110,8829,12004,18250,0,0,0,1,1
48252,110,8833,12556,18250,0,0,0,1,1
48253,110,8835,12452,18250,0,0,0,1,1
48254,110,8836,12186,18250,0,0,0,1,1
48255,110,8837,13324,18250,0,0,0,1,1
48256,110,8840,12597,18250,0,0,0,1,1
48257,110,8841,12754,18250,0,0,0,1,1
48258,110,8843,12850;13126,18250,0,0,0,2,2
48259,110,8845,13038;13093,18250,0,0,0,2,2
48260,110,8846,12699,18250,0,0,0,1,1
48261,110,8848,12710,18250,0,0,0,1,1
48262,110,8851,12789,18250,0,0,0,1,1
48263,110,8853,12584;13053,18250,0,0,0,2,2
48264,110,8854,13470,18250,0,0,0,1,1
48265,110,8856,12958,18250,0,0,0,1,1
48266,110,8857,12465,18250,0,0,0,1,1
48267,110,8858,12941;13436,18250,0,0,0,2,2
48268,110,8859,12872,18250,0,0,0,1,1
48269,110,8860,13022,18250,0,0,0,1,1
48270,110,8861,12962;13026,18250,0,0,0,2,2
48271,110,8863,12950,18250,0,0,0,1,1
48272,110,8864,12867;13388,18250,0,0,0,2,2
48273,110,8865,13090,18250,0,0,0,1,1
48274,110,8866,13088,18250,0,0,0,1,1
48275,110,8867,13638,18250,0,0,0,1,1
48276,110,8868,12998;13129,18250,0,0,0,2,2
48277,110,8869,13137,18250,0,0,0,1,1
48278,110,8871,13688,18250,0,0,0,1,1
48279,110,8873,13216,18250,0,0,0,1,1
48280,110,8874,13360;13428,18250,0,0,0,2,2
48281,110,8875,13330,18250,0,0,0,1,1
48282,110,8876,13294;13496,18250,0,0,0,2,2
48283,110,8877,12784;13361,18250,0,0,0,2,2
48284,110,8878,13304,18250,0,0,0,1,1
48285,110,8879,12959;13339,18250,0,0,0,2,2
48286,110,8880,13899,18250,0,0,0,1,1
48287,110,8881,13392;13660,18250,0,0,0,2,2
48288,110,8883,13359;13943,18250,0,0,0,2,2
48289,110,8884,13539,18250,0,0,0,1,1
48290,110,8885,13471,18250,0,0,0,1,1
48291,110,8887,13222;13851,18250,0,0,0,2,2
48292,110,8888,13774,18250,0,0,0,1,1
48293,110,8889,14002,18250,0,0,0,1,1
48294,110,8892,13329;13532,18250,0,0,0,2,2
48295,110,8906,11175,18615,0,0,0,1,1
48296,110,8908,11178,18615,0,0,0,1,1
48297,110,8919,12727,18615,0,0,0,1,1
48298,110,8920,12006,18615,0,0,0,1,1
48299,110,8927,12563,18615,0,0,0,1,1
48300,110,8928,12366,18615,0,0,0,1,1
48301,110,8931,12798;12856,18615,0,0,0,2,2
48302,110,8932,12726,18615,0,0,0,1,1
48303,110,8934,12911;13103,18615,0,0,0,2,2
48304,110,8937,13474,18615,0,0,0,1,1
48305,110,8940,12957,18615,0,0,0,1,1
48306,110,8943,12827;13246,18615,0,0,0,2,2
48307,110,8944,12732,18615,0,0,0,1,1
48308,110,8945,12843,18615,0,0,0,1,1
48309,110,8946,12847,18615,0,0,0,1,1
48310,110,8947,13070,18615,0,0,0,1,1
48311,110,8948,12908,18615,0,0,0,1,1
48312,110,8950,12885,18615,0,0,0,1,1
48313,110,8953,13455,18615,0,0,0,1,1
48314,110,8956,13506,18615,0,0,0,1,1
48315,110,8958,13109;13842,18615,0,0,0,2,2
48316,110,8959,13134;13508,18615,0,0,0,2,2
48317,110,8960,13163;13172,18615,0,0,0,2,2
48318,110,8962,13175;13736,18615,0,0,0,2,2
48319,110,8963,13191;13484,18615,0,0,0,2,2
48320,110,8964,13066;14014,18615,0,0,0,2,2
48321,110,8965,13918,18615,0,0,0,1,1
48322,110,8967,13254;13963,18615,0,0,0,2,2
48323,110,8968,13332,18615,0,0,0,1,1
48324,110,8971,13350;13354,18615,0,0,0,2,2
48325,110,8972,13067;13384,18615,0,0,0,2,2
48326,110,8973,12477;13386,18615,0,0,0,2,2
48327,110,8974,13407,18615,0,0,0,1,1
48328,110,8976,13599,18615,0,0,0,1,1
48329,110,8977,13752;13856,18615,0,0,0,2,2
48330,110,8978,14044,18615,0,0,0,1,1
48331,110,8979,13453;13606,18615,0,0,0,2,2
48332,110,8980,13046,18615,0,0,0,1,1
48333,110,8981,13778,18615,0,0,0,1,1
48334,110,8982,13545,18615,0,0,0,1,1
48335,110,8983,13218,18615,0,0,0,1,1
48336,110,8984,13562,18615,0,0,0,1,1
48337,110,8985,13704,18615,0,0,0,1,1
48338,110,8986,13573,18615,0,0,0,1,1
48339,110,8987,12989;13585,18615,0,0,0,2,2
48340,110,8989,13548;13883,18615,0,0,0,2,2
48341,110,8991,13650,18615,0,0,0,1,1
48342,110,8992,13637,18615,0,0,0,1,1
48343,110,8993,13528;13644,18615,0,0,0,2,2
48344,110,9012,11243,18980,0,0,0,1,1
48345,110,9027,12852,18980,0,0,0,1,1
48346,110,9029,12173,18980,0,0,0,1,1
48347,110,9036,12917;18771;22115;22411;22542,18980,0,3,1,1,5
48348,110,9039,12508,18980,0,0,0,1,1
48349,110,9040,12548,18980,0,0,0,1,1
48350,110,9041,13258,18980,0,0,0,1,1
48351,110,9042,12595,18980,0,0,0,1,1
48352,110,9045,12796;13497,18980,0,0,0,2,2
48353,110,9046,13001,18980,0,0,0,1,1
48354,110,9048,13353,18980,0,0,0,1,1
48355,110,9049,12969;17971,18980,0,0,1,1,2
48356,110,9050,13041,18980,0,0,0,1,1
48357,110,9052,13077;13596,18980,0,0,0,2,2
48358,110,9053,13101,18980,0,0,0,1,1
48359,110,9054,13031;13139,18980,0,0,0,2,2
48360,110,9055,13086;13687,18980,0,0,0,2,2
48361,110,9056,13182,18980,0,0,0,1,1
48362,110,9058,13221;13913;17478,18980,0,0,1,2,3
48363,110,9059,13315,18980,0,0,0,1,1
48364,110,9060,13483,18980,0,0,0,1,1
48365,110,9062,13256,18980,0,0,0,1,1
48366,110,9063,13578,18980,0,0,0,1,1
48367,110,9066,13301;13766,18980,0,0,0,2,2
48368,110,9067,13422;13826,18980,0,0,0,2,2
48369,110,9068,13372;13457,18980,0,0,0,2,2
48370,110,9069,13027;13715,18980,0,0,0,2,2
48371,110,9070,13055;13430,18980,0,0,0,2,2
48372,110,9073,13458;13580,18980,0,0,0,2,2
48373,110,9074,13461;13591,18980,0,0,0,2,2
48374,110,9075,13100;13448,18980,0,0,0,2,2
48375,110,9076,13362,18980,0,0,0,1,1
48376,110,9077,13534,18980,0,0,0,1,1
48377,110,9078,13444,18980,0,0,0,1,1
48378,110,9079,13617;13996,18980,0,0,0,2,2
48379,110,9080,13705,18980,0,0,0,1,1
48380,110,9082,13179;13641,18980,0,0,0,2,2
48381,110,9083,13642,18980,0,0,0,1,1
48382,110,9084,13693;13841,18980,0,0,0,2,2
48383,110,9086,13716;13893,18980,0,0,0,2,2
48384,110,9088,13761;13930,18980,0,0,0,2,2
48385,110,9090,14057,18980,0,0,0,1,1
48386,110,9091,13904;13938,18980,0,0,0,2,2
48387,110,9122,12949,19345,0,0,0,1,1
48388,110,9124,12520,19345,0,0,0,1,1
48389,110,9125,12480;12676,19345,0,0,0,2,2
48390,110,9127,12606,19345,0,0,0,1,1
48391,110,9131,12413;12598,19345,0,0,0,2,2
48392,110,9132,13015,19345,0,0,0,1,1
48393,110,9134,17020;17226,19345,0,0,2,0,2
48394,110,9135,13232,19345,0,0,0,1,1
48395,110,9136,13800;14204,19345,0,0,0,2,2
48396,110,9137,13037;13106,19345,0,0,0,2,2
48397,110,9138,13611,19345,0,0,0,1,1
48398,110,9141,13672;13958,19345,0,0,0,2,2
48399,110,9142,13334,19345,0,0,0,1,1
48400,110,9143,13335,19345,0,0,0,1,1
48401,110,9146,13940,19345,0,0,0,1,1
48402,110,9147,13138;13390,19345,0,0,0,2,2
48403,110,9148,13446;13717,19345,0,0,0,2,2
48404,110,9149,14152,19345,0,0,0,1,1
48405,110,9150,13401;13936,19345,0,0,0,2,2
48406,110,9152,14090;14339,19345,0,0,0,2,2
48407,110,9153,12952,19345,0,0,0,1,1
48408,110,9154,13980;14115,19345,0,0,0,2,2
48409,110,9155,13978;14070,19345,0,0,0,2,2
48410,110,9156,14041,19345,0,0,0,1,1
48411,110,9157,14063,19345,0,0,0,1,1
48412,110,9158,13699,19345,0,0,0,1,1
48413,110,9160,13561;13673,19345,0,0,0,2,2
48414,110,9161,13219;13677,19345,0,0,0,2,2
48415,110,9162,13695,19345,0,0,0,1,1
48416,110,9164,13714,19345,0,0,0,1,1
48417,110,9165,13723;13878,19345,0,0,0,2,2
48418,110,9166,13373;13732,19345,0,0,0,2,2
48419,110,9168,13323,19345,0,0,0,1,1
48420,110,9170,13431;13771,19345,0,0,0,2,2
48421,110,9171,13600;13772,19345,0,0,0,2,2
48422,110,9172,13654;13858,19345,0,0,0,2,2
48423,110,9173,13790;13892,19345,0,0,0,2,2
48424,110,9174,13792,19345,0,0,0,1,1
48425,110,9175,13793;13849,19345,0,0,0,2,2
48426,110,9177,13527;13845,19345,0,0,0,2,2
48427,110,9178,14120,19345,0,0,0,1,1
48428,110,9180,13894,19345,0,0,0,1,1
48429,110,9181,13901;13919,19345,0,0,0,2,2
48430,110,9213,12288;12675,19710,0,0,0,2,2
48431,110,9217,12835,19710,0,0,0,1,1
48432,110,9219,13676,19710,0,0,0,1,1
48433,110,9221,13124,19710,0,0,0,1,1
48434,110,9222,13120,19710,0,0,0,1,1
48435,110,9223,12621;13162,19710,0,0,0,2,2
48436,110,9226,13678,19710,0,0,0,1,1
48437,110,9227,13515,19710,0,0,0,1,1
48438,110,9228,13165,19710,0,0,0,1,1
48439,110,9232,13582,19710,0,0,0,1,1
48440,110,9233,13477,19710,0,0,0,1,1
48441,110,9234,13924,19710,0,0,0,1,1
48442,110,9235,13421;13551,19710,0,0,0,2,2
48443,110,9236,14110;14207,19710,0,0,0,2,2
48444,110,9237,13435;13598,19710,0,0,0,2,2
48445,110,9238,13440,19710,0,0,0,1,1
48446,110,9239,14138,19710,0,0,0,1,1
48447,110,9242,14327;14337,19710,0,0,0,2,2
48448,110,9243,14054;14314,19710,0,0,0,2,2
48449,110,9244,13791,19710,0,0,0,1,1
48450,110,9245,13702,19710,0,0,0,1,1
48451,110,9246,13413;13708,19710,0,0,0,2,2
48452,110,9247,13712;14206,19710,0,0,0,2,2
48453,110,9249,14042,19710,0,0,0,1,1
48454,110,9250,13674;14362,19710,0,0,0,2,2
48455,110,9251,13231;13530,19710,0,0,0,2,2
48456,110,9252,14462;14466,19710,0,0,0,2,2
48457,110,9253,13832;14365,19710,0,0,0,2,2
48458,110,9254,14266,19710,0,0,0,1,1
48459,110,9255,13830;14158,19710,0,0,0,2,2
48460,110,9256,13907,19710,0,0,0,1,1
48461,110,9257,13236;13914,19710,0,0,0,2,2
48462,110,9258,13205;13926,19710,0,0,0,2,2
48463,110,9259,13947,19710,0,0,0,1,1
48464,110,9260,13948,19710,0,0,0,1,1
48465,110,9262,13824;13990,19710,0,0,0,2,2
48466,110,9263,14097;14264,19710,0,0,0,2,2
48467,110,9264,14035,19710,0,0,0,1,1
48468,110,9265,13813,19710,0,0,0,1,1
48469,110,9266,13871;14078,19710,0,0,0,2,2
48470,110,9267,14080;14451,19710,0,0,0,2,2
48471,110,9305,12106,20075,0,0,0,1,1
48472,110,9309,12169,20075,0,0,0,1,1
48473,110,9313,13078,20075,0,0,0,1,1
48474,110,9314,12588,20075,0,0,0,1,1
48475,110,9315,12853,20075,0,0,0,1,1
48476,110,9316,12993;13411,20075,0,0,0,2,2
48477,110,9318,12626,20075,0,0,0,1,1
48478,110,9319,13229,20075,0,0,0,1,1
48479,110,9321,13634,20075,0,0,0,1,1
48480,110,9323,13769;14171,20075,0,0,0,2,2
48481,110,9325,13325;13575,20075,0,0,0,2,2
48482,110,9327,14325;14359,20075,0,0,0,2,2
48483,110,9329,13706;14191,20075,0,0,0,2,2
48484,110,9330,13710,20075,0,0,0,1,1
48485,110,9331,13516,20075,0,0,0,1,1
48486,110,9332,14030,20075,0,0,0,1,1
48487,110,9333,13942;14443,20075,0,0,0,2,2
48488,110,9334,13789,20075,0,0,0,1,1
48489,110,9335,14186,20075,0,0,0,1,1
48490,110,9336,13799;14137,20075,0,0,0,2,2
48491,110,9337,13839;13853,20075,0,0,0,2,2
48492,110,9338,13854,20075,0,0,0,1,1
48493,110,9339,13783;13877,20075,0,0,0,2,2
48494,110,9340,13888;14130,20075,0,0,0,2,2
48495,110,9341,13908,20075,0,0,0,1,1
48496,110,9342,14312,20075,0,0,0,1,1
48497,110,9343,13912,20075,0,0,0,1,1
48498,110,9344,13406;13812,20075,0,0,0,2,2
48499,110,9345,13927,20075,0,0,0,1,1
48500,110,9346,13152,20075,0,0,0,1,1
48501,110,9348,13951;14282,20075,0,0,0,2,2
48502,110,9349,13735;13954,20075,0,0,0,2,2
48503,110,9350,14009,20075,0,0,0,1,1
48504,110,9351,14225,20075,0,0,0,1,1
48505,110,9352,13692,20075,0,0,0,1,1
48506,110,9353,14022,20075,0,0,0,1,1
48507,110,9354,14473;14546,20075,0,0,0,2,2
48508,110,9355,14107;14530,20075,0,0,0,2,2
48509,110,9356,13679;13809,20075,0,0,0,2,2
48510,110,9357,13816;14125,20075,0,0,0,2,2
48511,110,9359,14114,20075,0,0,0,1,1
48512,110,9360,13481;14154,20075,0,0,0,2,2
48513,110,9361,14178;14369,20075,0,0,0,2,2
48514,110,9362,14128;14181,20075,0,0,0,2,2
48515,110,9363,13796;14198,20075,0,0,0,2,2
48516,110,9402,12345,20440,0,0,0,1,1
48517,110,9404,12425,20440,0,0,0,1,1
48518,110,9405,13016;13215,20440,0,0,0,2,2
48519,110,9406,12466;12582,20440,0,0,0,2,2
48520,110,9407,12779;12902,20440,0,0,0,2,2
48521,110,9409,13044;13572,20440,0,0,0,2,2
48522,110,9410,12750,20440,0,0,0,1,1
48523,110,9415,12939;13104,20440,0,0,0,2,2
48524,110,9417,13013,20440,0,0,0,1,1
48525,110,9419,13193,20440,0,0,0,1,1
48526,110,9422,13151;13298,20440,0,0,0,2,2
48527,110,9423,13273,20440,0,0,0,1,1
48528,110,9424,13212,20440,0,0,0,1,1
48529,110,9425,13709,20440,0,0,0,1,1
48530,110,9426,13331,20440,0,0,0,1,1
48531,110,9428,13438,20440,0,0,0,1,1
48532,110,9429,13463;13964,20440,0,0,0,2,2
48533,110,9430,13897;14169,20440,0,0,0,2,2
48534,110,9431,13525,20440,0,0,0,1,1
48535,110,9433,13698,20440,0,0,0,1,1
48536,110,9434,14074,20440,0,0,0,1,1
48537,110,9435,13722;14184,20440,0,0,0,2,2
48538,110,9436,13731,20440,0,0,0,1,1
48539,110,9437,13806;13855,20440,0,0,0,2,2
48540,110,9438,13961;14168,20440,0,0,0,2,2
48541,110,9439,13821,20440,0,0,0,1,1
48542,110,9440,14167,20440,0,0,0,1,1
48543,110,9441,13950;14318,20440,0,0,0,2,2
48544,110,9442,13601;13844,20440,0,0,0,2,2
48545,110,9443,14350;18756,20440,0,0,1,1,2
48546,110,9444,14237,20440,0,0,0,1,1
48547,110,9445,13934,20440,0,0,0,1,1
48548,110,9446,13276;14124,20440,0,0,0,2,2
48549,110,9447,14330,20440,0,0,0,1,1
48550,110,9449,13920,20440,0,0,0,1,1
48551,110,9451,14363;19287,20440,0,0,1,1,2
48552,110,9452,14234;14343,20440,0,0,0,2,2
48553,110,9454,14412,20440,0,0,0,1,1
48554,110,9455,14652,20440,0,0,0,1,1
48555,110,9456,14320,20440,0,0,0,1,1
48556,110,9457,14153;14677,20440,0,0,0,2,2
48557,110,9459,14231;14503,20440,0,0,0,2,2
48558,110,9460,14182,20440,0,0,0,1,1
48559,110,9462,14465;19231;22239;22576;23120,20440,1,2,1,1,5
48560,110,9463,14076,20440,0,0,0,1,1
48561,110,9464,14088;14119,20440,0,0,0,2,2
48562,110,9465,14157;14537,20440,0,0,0,2,2
48563,110,9466,14113;14626,20440,0,0,0,2,2
48564,110,9468,14379;14468,20440,0,0,0,2,2
48565,110,9470,13784;14161,20440,0,0,0,2,2
48566,110,9471,14747,20440,0,0,0,1,1
48567,110,9472,13837,20440,0,0,0,1,1
48568,110,9473,14215;14458,20440,0,0,0,2,2
48569,110,9474,14376,20440,0,0,0,1,1
48570,110,9475,14242,20440,0,0,0,1,1
48571,110,9476,13987;14243,20440,0,0,0,2,2
48572,110,9477,14256;14611,20440,0,0,0,2,2
48573,110,9478,13738;14269,20440,0,0,0,2,2
48574,110,9479,14292;18633,20440,0,0,1,1,2
48575,110,9480,14317;14354,20440,0,0,0,2,2
48576,110,9481,14319;14435,20440,0,0,0,2,2
48577,110,9482,14344;14638,20440,0,0,0,2,2
48578,110,9513,12320,20805,0,0,0,1,1
48579,110,9518,12591,20805,0,0,0,1,1
48580,110,9520,13378,20805,0,0,0,1,1
48581,110,9522,12849,20805,0,0,0,1,1
48582,110,9523,12819,20805,0,0,0,1,1
48583,110,9525,12841,20805,0,0,0,1,1
48584,110,9529,13157;13785,20805,0,0,0,2,2
48585,110,9532,13188,20805,0,0,0,1,1
48586,110,9533,14334,20805,0,0,0,1,1
48587,110,9534,13346;13859,20805,0,0,0,2,2
48588,110,9535,13356;13510,20805,0,0,0,2,2
48589,110,9537,13405;14205,20805,0,0,0,2,2
48590,110,9538,13082;13368,20805,0,0,0,2,2
48591,110,9539,13451;13962,20805,0,0,0,2,2
48592,110,9540,14011;14308,20805,0,0,0,2,2
48593,110,9541,13492,20805,0,0,0,1,1
48594,110,9542,14126,20805,0,0,0,1,1
48595,110,9543,13581,20805,0,0,0,1,1
48596,110,9544,14252,20805,0,0,0,1,1
48597,110,9545,13173,20805,0,0,0,1,1
48598,110,9546,13662;13807,20805,0,0,0,2,2
48599,110,9547,13441;13684,20805,0,0,0,2,2
48600,110,9548,13776;14038,20805,0,0,0,2,2
48601,110,9549,13840;14446,20805,0,0,0,2,2
48602,110,9550,13836,20805,0,0,0,1,1
48603,110,9552,13881,20805,0,0,0,1,1
48604,110,9553,14162,20805,0,0,0,1,1
48605,110,9554,14109;14276,20805,0,0,0,2,2
48606,110,9555,13882,20805,0,0,0,1,1
48607,110,9557,14449;14621,20805,0,0,0,2,2
48608,110,9558,14043;14072,20805,0,0,0,2,2
48609,110,9559,13952;14048,20805,0,0,0,2,2
48610,110,9560,14051;14108,20805,0,0,0,2,2
48611,110,9561,14595,20805,0,0,0,1,1
48612,110,9562,14118,20805,0,0,0,1,1
48613,110,9563,14132,20805,0,0,0,1,1
48614,110,9564,13733;14146,20805,0,0,0,2,2
48615,110,9565,14845,20805,0,0,0,1,1
48616,110,9566,14151,20805,0,0,0,1,1
48617,110,9567,14093;14478,20805,0,0,0,2,2
48618,110,9568,14194,20805,0,0,0,1,1
48619,110,9569,15122,20805,0,0,0,1,1
48620,110,9570,14202;14214,20805,0,0,0,2,2
48621,110,9572,14232;14661,20805,0,0,0,2,2
48622,110,9573,13865;14500,20805,0,0,0,2,2
48623,110,9574,14532,20805,0,0,0,1,1
48624,110,9575,13829;14253,20805,0,0,0,2,2
48625,110,9576,18913;19314;22710;23124,20805,2,0,2,0,4
48626,110,9577,14602;14637;17999;19301;21945;22708;22934,20805,2,1,2,2,7
48627,110,9578,14395;14822,20805,0,0,0,2,2
48628,110,9579,14061;14418,20805,0,0,0,2,2
48629,110,9580,14558;14678,20805,0,0,0,2,2
48630,110,9582,14212;14459,20805,0,0,0,2,2
48631,110,9583,14563,20805,0,0,0,1,1
48632,110,9584,14778;14800,20805,0,0,0,2,2
48633,110,9608,12912,21170,0,0,0,1,1
48634,110,9613,12361,21170,0,0,0,1,1
48635,110,9614,12512,21170,0,0,0,1,1
48636,110,9616,12506,21170,0,0,0,1,1
48637,110,9623,12899,21170,0,0,0,1,1
48638,110,9627,12913;12940,21170,0,0,0,2,2
48639,110,9628,13603,21170,0,0,0,1,1
48640,110,9629,12982;13333,21170,0,0,0,2,2
48641,110,9631,13281,21170,0,0,0,1,1
48642,110,9632,12918;13635,21170,0,0,0,2,2
48643,110,9633,13199;13490,21170,0,0,0,2,2
48644,110,9638,13284;13427,21170,0,0,0,2,2
48645,110,9641,13502,21170,0,0,0,1,1
48646,110,9642,13782;13929,21170,0,0,0,2,2
48647,110,9644,14262;20262,21170,0,0,1,1,2
48648,110,9645,13589;13762,21170,0,0,0,2,2
48649,110,9646,14223,21170,0,0,0,1,1
48650,110,9647,13828,21170,0,0,0,1,1
48651,110,9649,13631;13866,21170,0,0,0,2,2
48652,110,9652,13751;13896,21170,0,0,0,2,2
48653,110,9653,13479;13675,21170,0,0,0,2,2
48654,110,9654,13478,21170,0,0,0,1,1
48655,110,9655,14368,21170,0,0,0,1,1
48656,110,9656,13989,21170,0,0,0,1,1
48657,110,9657,14026,21170,0,0,0,1,1
48658,110,9658,13981;14448,21170,0,0,0,2,2
48659,110,9659,14056,21170,0,0,0,1,1
48660,110,9660,13969;14067,21170,0,0,0,2,2
48661,110,9661,14828;19416,21170,0,0,1,1,2
48662,110,9663,17049;17311;18338;18415;18614;18938;21621;22426,21170,0,2,6,0,8
48663,110,9664,14010;14164,21170,0,0,0,2,2
48664,110,9665,14166;14707,21170,0,0,0,2,2
48665,110,9666,14203,21170,0,0,0,1,1
48666,110,9667,14018;14229,21170,0,0,0,2,2
48667,110,9668,14015;14585,21170,0,0,0,2,2
48668,110,9670,14322;14733,21170,0,0,0,2,2
48669,110,9671,13748;14353,21170,0,0,0,2,2
48670,110,9672,14572;14694,21170,0,0,0,2,2
48671,110,9673,13538;13861,21170,0,0,0,2,2
48672,110,9675,14193;14399,21170,0,0,0,2,2
48673,110,9676,14414;14415,21170,0,0,0,2,2
48674,110,9677,14429;14719,21170,0,0,0,2,2
48675,110,9678,14021;14434,21170,0,0,0,2,2
48676,110,9679,14479,21170,0,0,0,1,1
48677,110,9680,14797;14908,21170,0,0,0,2,2
48678,110,9681,14736;14768,21170,0,0,0,2,2
48679,110,9682,14062;14485,21170,0,0,0,2,2
48680,110,9683,13850;14263,21170,0,0,0,2,2
48681,110,9684,14525,21170,0,0,0,1,1
48682,110,9685,14484;14761,21170,0,0,0,2,2
48683,110,9686,14483;14547,21170,0,0,0,2,2
48684,110,9687,14823,21170,0,0,0,1,1
48685,110,9688,14227;14555,21170,0,0,0,2,2
48686,110,9689,15013,21170,0,0,0,1,1
48687,110,9690,14045;19450,21170,0,0,1,1,2
48688,110,9691,14608,21170,0,0,0,1,1
48689,110,9692,14616;14930,21170,0,0,0,2,2
48690,110,9710,12033,21535,0,0,0,1,1
48691,110,9712,12200,21535,0,0,0,1,1
48692,110,9726,12619;12988,21535,0,0,0,2,2
48693,110,9727,13512,21535,0,0,0,1,1
48694,110,9729,12762;13414,21535,0,0,0,2,2
48695,110,9731,13245,21535,0,0,0,1,1
48696,110,9733,13408;13725,21535,0,0,0,2,2
48697,110,9734,13758,21535,0,0,0,1,1
48698,110,9736,12887,21535,0,0,0,1,1
48699,110,9738,13358;13960,21535,0,0,0,2,2
48700,110,9739,13381;13412,21535,0,0,0,2,2
48701,110,9740,13627;13770,21535,0,0,0,2,2
48702,110,9741,13073;13701,21535,0,0,0,2,2
48703,110,9742,14077,21535,0,0,0,1,1
48704,110,9743,14033,21535,0,0,0,1,1
48705,110,9744,14278,21535,0,0,0,1,1
48706,110,9745,13605;14065,21535,0,0,0,2,2
48707,110,9746,14698;14704,21535,0,0,0,2,2
48708,110,9747,13795,21535,0,0,0,1,1
48709,110,9749,13614;13843,21535,0,0,0,2,2
48710,110,9750,14425,21535,0,0,0,1,1
48711,110,9751,13995,21535,0,0,0,1,1
48712,110,9752,14517,21535,0,0,0,1,1
48713,110,9753,13494,21535,0,0,0,1,1
48714,110,9754,19108;19288;19671;19919;22359;23144,21535,1,1,4,0,6
48715,110,9756,14441,21535,0,0,0,1,1
48716,110,9757,14004,21535,0,0,0,1,1
48717,110,9758,19030;22697,21535,1,0,1,0,2
48718,110,9761,14083;14965,21535,0,0,0,2,2
48719,110,9762,14767,21535,0,0,0,1,1
48720,110,9763,13507;14142,21535,0,0,0,2,2
48721,110,9764,14165;14409,21535,0,0,0,2,2
48722,110,9765,14112;14548,21535,0,0,0,2,2
48723,110,9766,14571,21535,0,0,0,1,1
48724,110,9767,14336,21535,0,0,0,1,1
48725,110,9768,14211;14726,21535,0,0,0,2,2
48726,110,9769,13921;14220,21535,0,0,0,2,2
48727,110,9770,14179;14241,21535,0,0,0,2,2
48728,110,9771,14578,21535,0,0,0,1,1
48729,110,9772,14012,21535,0,0,0,1,1
48730,110,9773,14789;14976,21535,0,0,0,2,2
48731,110,9774,14849,21535,0,0,0,1,1
48732,110,9775,13686;14378,21535,0,0,0,2,2
48733,110,9776,14763,21535,0,0,0,1,1
48734,110,9777,14239,21535,0,0,0,1,1
48735,110,9778,14857;18013,21535,0,0,1,1,2
48736,110,9779,14406,21535,0,0,0,1,1
48737,110,9780,14521;14540,21535,0,0,0,2,2
48738,110,9781,14069;14413,21535,0,0,0,2,2
48739,110,9782,14417,21535,0,0,0,1,1
48740,110,9783,14270;14453,21535,0,0,0,2,2
48741,110,9784,14103;14470,21535,0,0,0,2,2
48742,110,9785,15139,21535,0,0,0,1,1
48743,110,9786,15058,21535,0,0,0,1,1
48744,110,9787,14247;14496,21535,0,0,0,2,2
48745,110,9788,14456;18774;22007;22116,21535,0,2,1,1,4
48746,110,9789,14523,21535,0,0,0,1,1
48747,110,9790,14544,21535,0,0,0,1,1
48748,110,9791,14573;14586,21535,0,0,0,2,2
48749,110,9792,14581,21535,0,0,0,1,1
48750,110,9793,14091;14615,21535,0,0,0,2,2
48751,110,9794,14779,21535,0,0,0,1,1
48752,110,9795,14860;15099,21535,0,0,0,2,2
48753,110,9796,14454,21535,0,0,0,1,1
48754,110,9797,14326,21535,0,0,0,1,1
48755,110,9798,14660;14723,21535,0,0,0,2,2
48756,110,9799,14433;14731,21535,0,0,0,2,2
48757,110,9800,14816,21535,0,0,0,1,1
48758,110,9801,14743;14842,21535,0,0,0,2,2
48759,110,9819,11459,21900,0,0,0,1,1
48760,110,9820,11547,21900,0,0,0,1,1
48761,110,9824,12647,21900,0,0,0,1,1
48762,110,9825,12354,21900,0,0,0,1,1
48763,110,9826,12708,21900,0,0,0,1,1
48764,110,9831,13111,21900,0,0,0,1,1
48765,110,9832,13000,21900,0,0,0,1,1
48766,110,9837,13711,21900,0,0,0,1,1
48767,110,9839,13279;13652,21900,0,0,0,2,2
48768,110,9840,13207,21900,0,0,0,1,1
48769,110,9841,13397,21900,0,0,0,1,1
48770,110,9842,13261,21900,0,0,0,1,1
48771,110,9843,13164,21900,0,0,0,1,1
48772,110,9844,13555;13781,21900,0,0,0,2,2
48773,110,9845,13476;13536,21900,0,0,0,2,2
48774,110,9847,13156;13625,21900,0,0,0,2,2
48775,110,9849,14432,21900,0,0,0,1,1
48776,110,9850,13718,21900,0,0,0,1,1
48777,110,9851,13786;14274,21900,0,0,0,2,2
48778,110,9852,14305,21900,0,0,0,1,1
48779,110,9853,14079,21900,0,0,0,1,1
48780,110,9854,13956,21900,0,0,0,1,1
48781,110,9856,13997,21900,0,0,0,1,1
48782,110,9857,14001;14200,21900,0,0,0,2,2
48783,110,9858,13874,21900,0,0,0,1,1
48784,110,9859,13664;14222,21900,0,0,0,2,2
48785,110,9861,14727,21900,0,0,0,1,1
48786,110,9862,14516;14762,21900,0,0,0,2,2
48787,110,9863,14758;15325,21900,0,0,0,2,2
48788,110,9864,13939,21900,0,0,0,1,1
48789,110,9865,14195,21900,0,0,0,1,1
48790,110,9868,14297;14394,21900,0,0,0,2,2
48791,110,9869,14302;14893,21900,0,0,0,2,2
48792,110,9870,14593;14832;19149;22030;22234;22445;22808,21900,1,3,1,2,7
48793,110,9871,15003,21900,0,0,0,1,1
48794,110,9872,14290;14345,21900,0,0,0,2,2
48795,110,9873,14333;14355,21900,0,0,0,2,2
48796,110,9874,14296,21900,0,0,0,1,1
48797,110,9875,13788,21900,0,0,0,1,1
48798,110,9876,14463;14594;18580,21900,0,0,1,2,3
48799,110,9877,14197;20032,21900,0,0,1,1,2
48800,110,9878,13869;14753,21900,0,0,0,2,2
48801,110,9879,13846;14430,21900,0,0,0,2,2
48802,110,9881,14813,21900,0,0,0,1,1
48803,110,9882,14843;15051,21900,0,0,0,2,2
48804,110,9883,14492;14524,21900,0,0,0,2,2
48805,110,9884,14385;14819,21900,0,0,0,2,2
48806,110,9885,15008;15331,21900,0,0,0,2,2
48807,110,9886,14371;14641;19367,21900,0,0,1,2,3
48808,110,9887,14560;14689,21900,0,0,0,2,2
48809,110,9888,14567,21900,0,0,0,1,1
48810,110,9890,14599,21900,0,0,0,1,1
48811,110,9891,15313,21900,0,0,0,1,1
48812,110,9892,14096;14628,21900,0,0,0,2,2
48813,110,9893,14445;14635,21900,0,0,0,2,2
48814,110,9894,14668,21900,0,0,0,1,1
48815,110,9895,14669;15005,21900,0,0,0,2,2
48816,110,9896,15229;15593,21900,0,0,0,2,2
48817,110,9897,14683,21900,0,0,0,1,1
48818,110,9899,14428;15056;18962,21900,0,0,1,2,3
48819,110,9900,14717;14749,21900,0,0,0,2,2
48820,110,9901,14927;15265,21900,0,0,0,2,2
48821,110,9902,15283,21900,0,0,0,1,1
48822,110,9903,15035;15305,21900,0,0,0,2,2
48823,110,9904,14391;14649,21900,0,0,0,2,2
48824,110,9925,12544,22265,0,0,0,1,1
48825,110,9934,13500,22265,0,0,0,1,1
48826,110,9938,13456;14082,22265,0,0,0,2,2
48827,110,9939,13521;13697,22265,0,0,0,2,2
48828,110,9940,14183;14250,22265,0,0,0,2,2
48829,110,9943,13775,22265,0,0,0,1,1
48830,110,9944,14311,22265,0,0,0,1,1
48831,110,9946,13810;13847,22265,0,0,0,2,2
48832,110,9947,13864;13915,22265,0,0,0,2,2
48833,110,9948,14106;14338,22265,0,0,0,2,2
48834,110,9951,13994,22265,0,0,0,1,1
48835,110,9953,13505;14159,22265,0,0,0,2,2
48836,110,9954,14268;14541,22265,0,0,0,2,2
48837,110,9955,14258;14713,22265,0,0,0,2,2
48838,110,9956,13759;14170,22265,0,0,0,2,2
48839,110,9957,14122;14254,22265,0,0,0,2,2
48840,110,9958,14724,22265,0,0,0,1,1
48841,110,9959,14180,22265,0,0,0,1,1
48842,110,9960,14920,22265,0,0,0,1,1
48843,110,9961,14301;15320,22265,0,0,0,2,2
48844,110,9962,14309;14889,22265,0,0,0,2,2
48845,110,9964,14172,22265,0,0,0,1,1
48846,110,9965,14377;14900,22265,0,0,0,2,2
48847,110,9966,14383;14703,22265,0,0,0,2,2
48848,110,9967,14156;14388,22265,0,0,0,2,2
48849,110,9968,17700;18202,22265,0,0,2,0,2
48850,110,9969,14464,22265,0,0,0,1,1
48851,110,9970,14476;14631,22265,0,0,0,2,2
48852,110,9971,14493;15031,22265,0,0,0,2,2
48853,110,9973,14104;14553,22265,0,0,0,2,2
48854,110,9974,14569;14796,22265,0,0,0,2,2
48855,110,9975,14771,22265,0,0,0,1,1
48856,110,9980,14640;15178,22265,0,0,0,2,2
48857,110,9981,14307;14670,22265,0,0,0,2,2
48858,110,9982,14411;14671,22265,0,0,0,2,2
48859,110,9983,15220;15231,22265,0,0,0,2,2
48860,110,9984,14422;14721,22265,0,0,0,2,2
48861,110,9985,14421;14742,22265,0,0,0,2,2
48862,110,9987,14528;14869,22265,0,0,0,2,2
48863,110,9988,14583;14803;19414,22265,0,0,1,2,3
48864,110,9990,15142;15304,22265,0,0,0,2,2
48865,110,9991,14877,22265,0,0,0,1,1
48866,110,9992,14879,22265,0,0,0,1,1
48867,110,9993,14542;14757,22265,0,0,0,2,2
48868,110,9995,14729;15462,22265,0,0,0,2,2
48869,110,9997,14315;15083;18644;21992,22265,0,1,1,2,4
48870,110,9998,14953,22265,0,0,0,1,1
48871,110,9999,14907;14964,22265,0,0,0,2,2
48872,110,10000,14918;14973,22265,0,0,0,2,2
48873,110,10001,14648;14981,22265,0,0,0,2,2
48874,110,10002,15016;15120,22265,0,0,0,2,2
48875,110,10031,12441;12774,22630,0,0,0,2,2
48876,110,10037,12898;13285,22630,0,0,0,2,2
48877,110,10038,12783,22630,0,0,0,1,1
48878,110,10039,13069,22630,0,0,0,1,1
48879,110,10044,13524,22630,0,0,0,1,1
48880,110,10046,13595,22630,0,0,0,1,1
48881,110,10047,13623,22630,0,0,0,1,1
48882,110,10048,13480,22630,0,0,0,1,1
48883,110,10049,13794;14174,22630,0,0,0,2,2
48884,110,10050,13568,22630,0,0,0,1,1
48885,110,10052,13393;13574,22630,0,0,0,2,2
48886,110,10054,13857,22630,0,0,0,1,1
48887,110,10055,14589,22630,0,0,0,1,1
48888,110,10056,13628;13898,22630,0,0,0,2,2
48889,110,10061,14559,22630,0,0,0,1,1
48890,110,10063,14712;14839,22630,0,0,0,2,2
48891,110,10064,14209;14590,22630,0,0,0,2,2
48892,110,10065,14360;14367,22630,0,0,0,2,2
48893,110,10066,14249;14306,22630,0,0,0,2,2
48894,110,10068,14255;14491,22630,0,0,0,2,2
48895,110,10069,14293;14577,22630,0,0,0,2,2
48896,110,10071,13923;14342,22630,0,0,0,2,2
48897,110,10072,14374,22630,0,0,0,1,1
48898,110,10073,13879;14393,22630,0,0,0,2,2
48899,110,10074,14780,22630,0,0,0,1,1
48900,110,10076,15055,22630,0,0,0,1,1
48901,110,10077,13885;14455,22630,0,0,0,2,2
48902,110,10078,14502,22630,0,0,0,1,1
48903,110,10079,14437,22630,0,0,0,1,1
48904,110,10081,14489;14610,22630,0,0,0,2,2
48905,110,10082,14280;14419,22630,0,0,0,2,2
48906,110,10083,15112;15458,22630,0,0,0,2,2
48907,110,10084,14884;15019,22630,0,0,0,2,2
48908,110,10085,14299;14623,22630,0,0,0,2,2
48909,110,10086,14837,22630,0,0,0,1,1
48910,110,10087,14684;15123,22630,0,0,0,2,2
48911,110,10088,14791;15136;19116;22570;22703,22630,1,1,1,2,5
48912,110,10089,15105;15475,22630,0,0,0,2,2
48913,110,10090,15261;20007,22630,0,0,1,1,2
48914,110,10091,15225,22630,0,0,0,1,1
48915,110,10092,14566;14854,22630,0,0,0,2,2
48916,110,10093,15449,22630,0,0,0,1,1
48917,110,10094,14921,22630,0,0,0,1,1
48918,110,10095,14919;14958,22630,0,0,0,2,2
48919,110,10096,14990,22630,0,0,0,1,1
48920,110,10097,14992,22630,0,0,0,1,1
48921,110,10098,15297;15300,22630,0,0,0,2,2
48922,110,10099,14770;15413,22630,0,0,0,2,2
48923,110,10100,14647;15007,22630,0,0,0,2,2
48924,110,10101,14426;15023,22630,0,0,0,2,2
48925,110,10103,14759;15166,22630,0,0,0,2,2
48926,110,10104,15034;15153,22630,0,0,0,2,2
48927,110,10105,15064;15469,22630,0,0,0,2,2
48928,110,10106,15075;15119,22630,0,0,0,2,2
48929,110,10107,15081;15147,22630,0,0,0,2,2
48930,110,10108,14983;18425,22630,0,0,1,1,2
48931,110,10109,15093;19910,22630,0,0,1,1,2
48932,110,10111,14352;14935,22630,0,0,0,2,2
48933,110,10112,15198;15388,22630,0,0,0,2,2
48934,110,10113,14597;15273,22630,0,0,0,2,2
48935,110,10114,15170;15230,22630,0,0,0,2,2
48936,110,10150,12817,22995,0,0,0,1,1
48937,110,10158,13338,22995,0,0,0,1,1
48938,110,10160,13416;13820,22995,0,0,0,2,2
48939,110,10162,13592;14136,22995,0,0,0,2,2
48940,110,10163,13061,22995,0,0,0,1,1
48941,110,10164,13689;13988,22995,0,0,0,2,2
48942,110,10165,13558,22995,0,0,0,1,1
48943,110,10167,14024,22995,0,0,0,1,1
48944,110,10168,14031,22995,0,0,0,1,1
48945,110,10169,14040,22995,0,0,0,1,1
48946,110,10170,14370,22995,0,0,0,1,1
48947,110,10172,14163;14221;18211,22995,0,0,1,2,3
48948,110,10173,14173;14176;18511,22995,0,0,1,2,3
48949,110,10176,14248,22995,0,0,0,1,1
48950,110,10177,15400,22995,0,0,0,1,1
48951,110,10178,14416;14674,22995,0,0,0,2,2
48952,110,10179,14300;14538,22995,0,0,0,2,2
48953,110,10181,13925;14744,22995,0,0,0,2,2
48954,110,10182,14887;15252,22995,0,0,0,2,2
48955,110,10183,14467,22995,0,0,0,1,1
48956,110,10184,13984,22995,0,0,0,1,1
48957,110,10185,14480;15061,22995,0,0,0,2,2
48958,110,10186,14498;15578;19363;20037;20521,22995,0,0,3,2,5
48959,110,10187,14281;14505,22995,0,0,0,2,2
48960,110,10188,14520;19444,22995,0,0,1,1,2
48961,110,10189,15029,22995,0,0,0,1,1
48962,110,10191,14482;14591,22995,0,0,0,2,2
48963,110,10192,15041,22995,0,0,0,1,1
48964,110,10193,14101;14667,22995,0,0,0,2,2
48965,110,10194,14693,22995,0,0,0,1,1
48966,110,10195,14706,22995,0,0,0,1,1
48967,110,10196,14808,22995,0,0,0,1,1
48968,110,10197,14863,22995,0,0,0,1,1
48969,110,10198,14873;15199,22995,0,0,0,2,2
48970,110,10199,15060;15551,22995,0,0,0,2,2
48971,110,10200,14881,22995,0,0,0,1,1
48972,110,10201,14894;18816;22013,22995,0,1,1,1,3
48973,110,10202,15221;15532,22995,0,0,0,2,2
48974,110,10203,14925;15151,22995,0,0,0,2,2
48975,110,10204,14929;15290,22995,0,0,0,2,2
48976,110,10205,15269;15430,22995,0,0,0,2,2
48977,110,10206,14692;15002,22995,0,0,0,2,2
48978,110,10207,15011;17991,22995,0,0,1,1,2
48979,110,10208,15040;15595,22995,0,0,0,2,2
48980,110,10209,15050;19499,22995,0,0,1,1,2
48981,110,10210,15196,22995,0,0,0,1,1
48982,110,10211,14966;15492,22995,0,0,0,2,2
48983,110,10212,15024;15560;19330;22036;22819,22995,1,1,1,2,5
48984,110,10215,16192,22995,0,0,1,0,1
48985,110,10216,15524;18588;23007,22995,1,0,1,1,3
48986,110,10217,14764;15209,22995,0,0,0,2,2
48987,110,10218,15241;15625,22995,0,0,1,1,2
48988,110,10219,15636,22995,0,0,1,0,1
48989,110,10239,12948,23360,0,0,0,1,1
48990,110,10245,13648,23360,0,0,0,1,1
48991,110,10247,13935;14208,23360,0,0,0,2,2
48992,110,10248,13425;13903,23360,0,0,0,2,2
48993,110,10249,13860;14219,23360,0,0,0,2,2
48994,110,10250,13805,23360,0,0,0,1,1
48995,110,10251,13917;17966,23360,0,0,1,1,2
48996,110,10252,13875,23360,0,0,0,1,1
48997,110,10253,14777;14892,23360,0,0,0,2,2
48998,110,10254,14210;14275,23360,0,0,0,2,2
48999,110,10255,13817;13991,23360,0,0,0,2,2
49000,110,10256,14279;15212,23360,0,0,0,2,2
49001,110,10257,14283;15059,23360,0,0,0,2,2
49002,110,10259,14645;14714;19361,23360,0,0,1,2,3
49003,110,10260,14323;14579,23360,0,0,0,2,2
49004,110,10262,14504,23360,0,0,0,1,1
49005,110,10264,14939,23360,0,0,0,1,1
49006,110,10265,14787;15204,23360,0,0,0,2,2
49007,110,10266,14781,23360,0,0,0,1,1
49008,110,10267,15380,23360,0,0,0,1,1
49009,110,10268,14487;15223,23360,0,0,0,2,2
49010,110,10269,15394;15480,23360,0,0,0,2,2
49011,110,10270,14820,23360,0,0,0,1,1
49012,110,10271,14874;15067;19988,23360,0,0,1,2,3
49013,110,10273,14895;14933,23360,0,0,0,2,2
49014,110,10274,14801;15206,23360,0,0,0,2,2
49015,110,10275,14951,23360,0,0,0,1,1
49016,110,10276,14972;15439,23360,0,0,0,2,2
49017,110,10277,14859;15045,23360,0,0,0,2,2
49018,110,10278,15193,23360,0,0,0,1,1
49019,110,10279,15062;15819,23360,0,0,1,1,2
49020,110,10281,14912;15094,23360,0,0,0,2,2
49021,110,10283,14824;15113,23360,0,0,0,2,2
49022,110,10284,15197,23360,0,0,0,1,1
49023,110,10285,15589,23360,0,0,0,1,1
49024,110,10286,14836;15191,23360,0,0,0,2,2
49025,110,10287,15535;15827,23360,0,0,1,1,2
49026,110,10288,15849,23360,0,0,1,0,1
49027,110,10289,14682;15047,23360,0,0,0,2,2
49028,110,10290,14659;15227,23360,0,0,0,2,2
49029,110,10291,14886;15260,23360,0,0,0,2,2
49030,110,10292,15419,23360,0,0,0,1,1
49031,110,10293,15288;15809,23360,0,0,1,1,2
49032,110,10294,15334,23360,0,0,0,1,1
49033,110,10295,15240;15348,23360,0,0,0,2,2
49034,110,10296,15474,23360,0,0,0,1,1
49035,110,10297,15363,23360,0,0,0,1,1
49036,110,10298,15091;15592,23360,0,0,0,2,2
49037,110,10299,15710;15855,23360,0,0,2,0,2
49038,110,10302,15440;15712;20989,23360,0,0,2,1,3
49039,110,10303,15441;19781,23360,0,0,1,1,2
49040,110,10305,15818,23360,0,0,1,0,1
49041,110,10306,14679;15467,23360,0,0,0,2,2
49042,110,10318,11921,23725,0,0,0,1,1
49043,110,10325,12869,23725,0,0,0,1,1
49044,110,10331,12826;13282,23725,0,0,0,2,2
49045,110,10333,13376;13765,23725,0,0,0,2,2
49046,110,10336,13288;13567,23725,0,0,0,2,2
49047,110,10340,13992,23725,0,0,0,1,1
49048,110,10344,13911,23725,0,0,0,1,1
49049,110,10346,14407;14686,23725,0,0,0,2,2
49050,110,10352,14754,23725,0,0,0,1,1
49051,110,10354,14499;14833,23725,0,0,0,2,2
49052,110,10355,14511,23725,0,0,0,1,1
49053,110,10356,14357;14519,23725,0,0,0,2,2
49054,110,10357,14075;14550;18554,23725,0,0,1,2,3
49055,110,10358,14324;14574,23725,0,0,0,2,2
49056,110,10359,14650;14739,23725,0,0,0,2,2
49057,110,10360,14129;14691,23725,0,0,0,2,2
49058,110,10361,14461;14738,23725,0,0,0,2,2
49059,110,10362,14439;14756,23725,0,0,0,2,2
49060,110,10363,14810,23725,0,0,0,1,1
49061,110,10364,15022;15830,23725,0,0,1,1,2
49062,110,10365,15301,23725,0,0,0,1,1
49063,110,10366,14858,23725,0,0,0,1,1
49064,110,10367,14447;14868,23725,0,0,0,2,2
49065,110,10368,15487,23725,0,0,0,1,1
49066,110,10369,15097,23725,0,0,0,1,1
49067,110,10370,14271;14913,23725,0,0,0,2,2
49068,110,10371,14695;14924,23725,0,0,0,2,2
49069,110,10372,15270;19113;22441,23725,0,1,1,1,3
49070,110,10373,14568;14948,23725,0,0,0,2,2
49071,110,10375,14582;14750,23725,0,0,0,2,2
49072,110,10376,15010;15205,23725,0,0,0,2,2
49073,110,10379,15044;15048;20219,23725,0,0,1,2,3
49074,110,10380,14968,23725,0,0,0,1,1
49075,110,10381,15049;15233,23725,0,0,0,2,2
49076,110,10382,14826;15464,23725,0,0,0,2,2
49077,110,10383,14902;15038,23725,0,0,0,2,2
49078,110,10384,15098;15202,23725,0,0,0,2,2
49079,110,10386,15137,23725,0,0,0,1,1
49080,110,10387,15107,23725,0,0,0,1,1
49081,110,10389,14587,23725,0,0,0,1,1
49082,110,10390,14998;15489,23725,0,0,0,2,2
49083,110,10391,15398,23725,0,0,0,1,1
49084,110,10393,15181;15332,23725,0,0,0,2,2
49085,110,10394,15342,23725,0,0,0,1,1
49086,110,10395,15108;19627,23725,0,0,1,1,2
49087,110,10397,14944;15881,23725,0,0,1,1,2
49088,110,10398,15695,23725,0,0,1,0,1
49089,110,10399,15763;16322,23725,0,0,2,0,2
49090,110,10400,15391,23725,0,0,0,1,1
49091,110,10402,15973;16007;19622,23725,0,0,3,0,3
49092,110,10403,15101;15425,23725,0,0,0,2,2
49093,110,10404,15432;15858,23725,0,0,1,1,2
49094,110,10405,15192;15453,23725,0,0,0,2,2
49095,110,10406,15184,23725,0,0,0,1,1
49096,110,10407,15456;15848,23725,0,0,1,1,2
49097,110,10408,15164,23725,0,0,0,1,1
49098,110,10409,15483;15749,23725,0,0,1,1,2
49099,110,10410,14931;15500;20076;20253,23725,0,0,2,2,4
49100,110,10411,15501;15941,23725,0,0,1,1,2
49101,110,10412,15504;15675,23725,0,0,1,1,2
49102,110,10413,15507;15664,23725,0,0,1,1,2
49103,110,10414,15396;15582;19501,23725,0,0,1,2,3
49104,110,10415,15614;16031,23725,0,0,2,0,2
49105,110,10417,15547;15990,23725,0,0,1,1,2
49106,110,10418,15359;15550,23725,0,0,0,2,2
49107,110,10419,15076;15556,23725,0,0,0,2,2
49108,110,10420,14769;15564;19479;23044,23725,1,0,1,2,4
49109,110,10421,15597,23725,0,0,0,1,1
49110,110,10442,12342,24090,0,0,0,1,1
49111,110,10446,12306,24090,0,0,0,1,1
49112,110,10449,13058;13452,24090,0,0,0,2,2
49113,110,10452,13764,24090,0,0,0,1,1
49114,110,10453,13352;13886,24090,0,0,0,2,2
49115,110,10458,13399;13727,24090,0,0,0,2,2
49116,110,10462,14039;14494,24090,0,0,0,2,2
49117,110,10463,14313;14450,24090,0,0,0,2,2
49118,110,10468,14829;14840,24090,0,0,0,2,2
49119,110,10469,14286,24090,0,0,0,1,1
49120,110,10470,14794,24090,0,0,0,1,1
49121,110,10471,14664,24090,0,0,0,1,1
49122,110,10478,15420,24090,0,0,0,1,1
49123,110,10479,14916;15132,24090,0,0,0,2,2
49124,110,10481,14851,24090,0,0,0,1,1
49125,110,10483,15087,24090,0,0,0,1,1
49126,110,10484,14956;14967,24090,0,0,0,2,2
49127,110,10485,14986,24090,0,0,0,1,1
49128,110,10486,14997,24090,0,0,0,1,1
49129,110,10488,15406,24090,0,0,0,1,1
49130,110,10489,14818,24090,0,0,0,1,1
49131,110,10490,15070;15542,24090,0,0,0,2,2
49132,110,10491,14811;15043,24090,0,0,0,2,2
49133,110,10492,15057;15892;20370,24090,0,0,2,1,3
49134,110,10493,15246;15509,24090,0,0,0,2,2
49135,110,10494,14891;20342,24090,0,0,1,1,2
49136,110,10495,15131;15375,24090,0,0,0,2,2
49137,110,10496,14993;15134,24090,0,0,0,2,2
49138,110,10497,15786;19848,24090,0,0,2,0,2
49139,110,10498,14982;15172,24090,0,0,0,2,2
49140,110,10500,14672;15294,24090,0,0,0,2,2
49141,110,10501,15222;15367,24090,0,0,0,2,2
49142,110,10502,15126;16050;20649,24090,0,0,2,1,3
49143,110,10504,15275;15872,24090,0,0,1,1,2
49144,110,10505,15586;15754;19862,24090,0,0,2,1,3
49145,110,10506,15696;15760,24090,0,0,2,0,2
49146,110,10507,15730;15811,24090,0,0,2,0,2
49147,110,10508,15207;15326,24090,0,0,0,2,2
49148,110,10509,15249;15338,24090,0,0,0,2,2
49149,110,10510,14940;15339,24090,0,0,0,2,2
49150,110,10511,15361,24090,0,0,0,1,1
49151,110,10512,15402;15902,24090,0,0,1,1,2
49152,110,10513,15421;15869,24090,0,0,1,1,2
49153,110,10514,15426;15707,24090,0,0,1,1,2
49154,110,10515,15427;15650,24090,0,0,1,1,2
49155,110,10517,15604;16103;20254,24090,0,0,3,0,3
49156,110,10518,15350;15444,24090,0,0,0,2,2
49157,110,10519,15496;15622,24090,0,0,1,1,2
49158,110,10520,15506;15831,24090,0,0,1,1,2
49159,110,10521,15316;15530,24090,0,0,0,2,2
49160,110,10522,15284;15581;19812;22742,24090,1,0,1,2,4
49161,110,10523,15012;15583,24090,0,0,0,2,2
49162,110,10524,15307,24090,0,0,0,1,1
49163,110,10525,15262;15613,24090,0,0,1,1,2
49164,110,10526,15615;16024,24090,0,0,2,0,2
49165,110,10527,15671;15799,24090,0,0,2,0,2
49166,110,10528,15635;15655,24090,0,0,2,0,2
49167,110,10530,15649;15891;20164,24090,0,0,3,0,3
49168,110,10531,15660;15835,24090,0,0,2,0,2
49169,110,10532,15562,24090,0,0,0,1,1
49170,110,10533,15680;15741,24090,0,0,2,0,2
49171,110,10534,15540;15689,24090,0,0,1,1,2
49172,110,10559,13342;13750,24455,0,0,0,2,2
49173,110,10562,13529,24455,0,0,0,1,1
49174,110,10565,13798,24455,0,0,0,1,1
49175,110,10570,14481;14654,24455,0,0,0,2,2
49176,110,10572,13998;14185,24455,0,0,0,2,2
49177,110,10573,15282;15678,24455,0,0,1,1,2
49178,110,10579,14490,24455,0,0,0,1,1
49179,110,10580,14273,24455,0,0,0,1,1
49180,110,10581,14396,24455,0,0,0,1,1
49181,110,10582,14865;14890,24455,0,0,0,2,2
49182,110,10583,14277;14711,24455,0,0,0,2,2
49183,110,10584,14841,24455,0,0,0,1,1
49184,110,10585,14662,24455,0,0,0,1,1
49185,110,10586,15215,24455,0,0,0,1,1
49186,110,10590,14752,24455,0,0,0,1,1
49187,110,10591,15092;15355,24455,0,0,0,2,2
49188,110,10592,14294;14605,24455,0,0,0,2,2
49189,110,10595,15030;15387,24455,0,0,0,2,2
49190,110,10596,14946;15096,24455,0,0,0,2,2
49191,110,10597,15037;15569,24455,0,0,0,2,2
49192,110,10600,15149,24455,0,0,0,1,1
49193,110,10601,15169;15251,24455,0,0,0,2,2
49194,110,10602,15146,24455,0,0,0,1,1
49195,110,10603,14513;15168,24455,0,0,0,2,2
49196,110,10604,15360,24455,0,0,0,1,1
49197,110,10605,14898;15174,24455,0,0,0,2,2
49198,110,10606,15677,24455,0,0,1,0,1
49199,110,10607,15405;15742;20922,24455,0,0,2,1,3
49200,110,10608,15296;16035,24455,0,0,1,1,2
49201,110,10609,15494;15854,24455,0,0,1,1,2
49202,110,10610,15086;15523,24455,0,0,0,2,2
49203,110,10612,15621;15937,24455,0,0,2,0,2
49204,110,10613,15106;15386;20248,24455,0,0,1,2,3
49205,110,10615,15454;19348;22590;22941,24455,1,1,1,1,4
49206,110,10617,15497;15505,24455,0,0,0,2,2
49207,110,10618,16063;16152,24455,0,0,2,0,2
49208,110,10620,15544;15594,24455,0,0,0,2,2
49209,110,10622,15669,24455,0,0,1,0,1
49210,110,10623,15584;15808,24455,0,0,1,1,2
49211,110,10625,15362;15927,24455,0,0,1,1,2
49212,110,10626,14871;15642,24455,0,0,1,1,2
49213,110,10627,16182,24455,0,0,1,0,1
49214,110,10629,15700,24455,0,0,1,0,1
49215,110,10630,15684;15703,24455,0,0,2,0,2
49216,110,10632,15714,24455,0,0,1,0,1
49217,110,10633,15721;15874,24455,0,0,2,0,2
49218,110,10634,15729;15736,24455,0,0,2,0,2
49219,110,10635,15549;15868,24455,0,0,1,1,2
49220,110,10636,15956;16275,24455,0,0,2,0,2
49221,110,10637,16011;16330,24455,0,0,2,0,2
49222,110,10638,15346;15770,24455,0,0,1,1,2
49223,110,10639,15772,24455,0,0,1,0,1
49224,110,10640,16273,24455,0,0,1,0,1
49225,110,10641,15798;15964,24455,0,0,2,0,2
49226,110,10642,15826;15846,24455,0,0,2,0,2
49227,110,10643,16049,24455,0,0,1,0,1
49228,110,10644,15857;16173,24455,0,0,2,0,2
49229,110,10645,15866;16243,24455,0,0,2,0,2
49230,110,10646,15711;15882,24455,0,0,2,0,2
49231,110,10647,15274;15691,24455,0,0,1,1,2
49232,110,10666,12343,24820,0,0,0,1,1
49233,110,10671,12945,24820,0,0,0,1,1
49234,110,10673,13645,24820,0,0,0,1,1
49235,110,10676,13559;13941,24820,0,0,0,2,2
49236,110,10677,13473,24820,0,0,0,1,1
49237,110,10683,14177;14444,24820,0,0,0,2,2
49238,110,10684,13694;14358,24820,0,0,0,2,2
49239,110,10689,14260,24820,0,0,0,1,1
49240,110,10690,14812,24820,0,0,0,1,1
49241,110,10691,14381;14917,24820,0,0,0,2,2
49242,110,10695,14331;15006;19331,24820,0,0,1,2,3
49243,110,10696,15021;20089,24820,0,0,1,1,2
49244,110,10699,14701;14760,24820,0,0,0,2,2
49245,110,10700,14424;14878,24820,0,0,0,2,2
49246,110,10701,14923;16048,24820,0,0,1,1,2
49247,110,10702,14971;15511,24820,0,0,0,2,2
49248,110,10703,14977;15009,24820,0,0,0,2,2
49249,110,10704,15218;15423,24820,0,0,0,2,2
49250,110,10705,15298,24820,0,0,0,1,1
49251,110,10706,14989;15084,24820,0,0,0,2,2
49252,110,10707,14975;15580,24820,0,0,0,2,2
49253,110,10708,15144;15368;20522;23092,24820,1,0,1,2,4
49254,110,10709,15484,24820,0,0,0,1,1
49255,110,10711,15676;19524,24820,0,0,2,0,2
49256,110,10712,15289;15612,24820,0,0,1,1,2
49257,110,10713,15293;16312;20105,24820,0,0,2,1,3
49258,110,10714,15072;15314,24820,0,0,0,2,2
49259,110,10716,15328;15645,24820,0,0,1,1,2
49260,110,10717,15433;20106,24820,0,0,1,1,2
49261,110,10718,15336,24820,0,0,0,1,1
49262,110,10720,15476;20026,24820,0,0,1,1,2
49263,110,10721,15661;16025,24820,0,0,2,0,2
49264,110,10722,14856;15102,24820,0,0,0,2,2
49265,110,10723,15370;15422,24820,0,0,0,2,2
49266,110,10724,15435,24820,0,0,0,1,1
49267,110,10725,15073;15533,24820,0,0,0,2,2
49268,110,10726,15349;15810,24820,0,0,1,1,2
49269,110,10727,15373;15527;20202,24820,0,0,1,2,3
49270,110,10729,15090,24820,0,0,0,1,1
49271,110,10732,15033,24820,0,0,0,1,1
49272,110,10734,15295;15920;20113;21003,24820,0,0,3,1,4
49273,110,10735,14872;15637;21539,24820,0,1,1,1,3
49274,110,10737,16222;16450;20095,24820,0,0,3,0,3
49275,110,10739,15670;16027,24820,0,0,2,0,2
49276,110,10741,15418;15726;19563;22252,24820,0,1,2,1,4
49277,110,10742,15771;15794;20285,24820,0,0,3,0,3
49278,110,10743,16362,24820,0,0,1,0,1
49279,110,10744,16186;16497;19839,24820,0,0,3,0,3
49280,110,10745,16347;16372,24820,0,0,2,0,2
49281,110,10746,16227;16668,24820,0,0,2,0,2
49282,110,10747,15567;15917,24820,0,0,1,1,2
49283,110,10749,15828;16217,24820,0,0,2,0,2
49284,110,10750,15952;16300,24820,0,0,2,0,2
49285,110,10751,15968;16299;20464,24820,0,0,3,0,3
49286,110,10752,15942;15982,24820,0,0,2,0,2
49287,110,10753,15787;15989,24820,0,0,2,0,2
49288,110,10754,15624;16189,24820,0,0,2,0,2
49289,110,10771,12429,25185,0,0,0,1,1
49290,110,10783,13312;13586,25185,0,0,0,2,2
49291,110,10784,13968,25185,0,0,0,1,1
49292,110,10785,13389;13976,25185,0,0,0,2,2
49293,110,10788,13443,25185,0,0,0,1,1
49294,110,10793,13557;13848,25185,0,0,0,2,2
49295,110,10795,14420;14885,25185,0,0,0,2,2
49296,110,10796,14127;14410,25185,0,0,0,2,2
49297,110,10801,13815;14019,25185,0,0,0,2,2
49298,110,10802,15319;15894,25185,0,0,1,1,2
49299,110,10804,14696;14710,25185,0,0,0,2,2
49300,110,10806,14941,25185,0,0,0,1,1
49301,110,10807,14974;15118,25185,0,0,0,2,2
49302,110,10808,15026;16169,25185,0,0,1,1,2
49303,110,10809,15129;15534,25185,0,0,0,2,2
49304,110,10810,15110,25185,0,0,0,1,1
49305,110,10812,15208;15226,25185,0,0,0,2,2
49306,110,10813,15438;15722,25185,0,0,1,1,2
49307,110,10814,15767,25185,0,0,1,0,1
49308,110,10815,15285;15638,25185,0,0,1,1,2
49309,110,10816,15053,25185,0,0,0,1,1
49310,110,10817,15738;15824;20496,25185,0,0,3,0,3
49311,110,10818,15219,25185,0,0,0,1,1
49312,110,10819,15747;16130,25185,0,0,2,0,2
49313,110,10820,15617,25185,0,0,1,0,1
49314,110,10821,15143,25185,0,0,0,1,1
49315,110,10822,15851;16160;19714;20256;23058,25185,1,0,4,0,5
49316,110,10824,15759;16176,25185,0,0,2,0,2
49317,110,10825,15863;15871;19778;22848,25185,1,0,3,0,4
49318,110,10826,15352;15916,25185,0,0,1,1,2
49319,110,10827,15428;15610,25185,0,0,1,1,2
49320,110,10830,15448;15623;19327,25185,0,0,2,1,3
49321,110,10831,15459;15634;19584,25185,0,0,2,1,3
49322,110,10832,15641;15682,25185,0,0,2,0,2
49323,110,10834,15665;15834,25185,0,0,2,0,2
49324,110,10835,16119,25185,0,0,1,0,1
49325,110,10836,16021;16304;20545,25185,0,0,3,0,3
49326,110,10838,16341;20663,25185,0,0,2,0,2
49327,110,10839,16043;16327;20445,25185,0,0,3,0,3
49328,110,10840,15557;18668,25185,0,0,1,1,2
49329,110,10841,15381;16329,25185,0,0,1,1,2
49330,110,10843,15266;15888,25185,0,0,1,1,2
49331,110,10844,16188;16265,25185,0,0,2,0,2
49332,110,10845,15915;20331,25185,0,0,2,0,2
49333,110,10846,15928;15981;20734,25185,0,0,3,0,3
49334,110,10847,15640;15944,25185,0,0,2,0,2
49335,110,10848,15746;15947;19297,25185,0,0,3,0,3
49336,110,10849,16360;16749,25185,0,0,2,0,2
49337,110,10851,15389;15972,25185,0,0,1,1,2
49338,110,10852,16578,25185,0,0,1,0,1
49339,110,10854,16054;16058,25185,0,0,2,0,2
49340,110,10856,16059;19901;22745;22852;23157,25185,3,0,2,0,5
49341,110,10857,16066;16315;20388;22638;22762,25185,1,1,3,0,5
49342,110,10858,16095;16154;19966;22859,25185,1,0,3,0,4
49343,110,10859,16116;16375,25185,0,0,2,0,2
49344,110,10860,15850;16117,25185,0,0,2,0,2
49345,110,10861,15515,25185,0,0,0,1,1
49346,110,10862,16124;16551,25185,0,0,2,0,2
49347,110,10863,16126;16233,25185,0,0,2,0,2
49348,110,10864,15639;16138;19341;20452;22037;22940,25185,1,1,4,0,6
49349,110,10865,16262,25185,0,0,1,0,1
49350,110,10866,15761,25185,0,0,1,0,1
49351,110,10867,15884;16190,25185,0,0,2,0,2
49352,110,10876,11919,25550,0,0,0,1,1
49353,110,10884,12535,25550,0,0,0,1,1
49354,110,10888,12965;12997,25550,0,0,0,2,2
49355,110,10895,13681,25550,0,0,0,1,1
49356,110,10900,13259;13626,25550,0,0,0,2,2
49357,110,10902,13475,25550,0,0,0,1,1
49358,110,10906,14501,25550,0,0,0,1,1
49359,110,10907,14600;14785,25550,0,0,0,2,2
49360,110,10909,14527;14888,25550,0,0,0,2,2
49361,110,10911,14552,25550,0,0,0,1,1
49362,110,10917,14697;14905,25550,0,0,0,2,2
49363,110,10918,15180,25550,0,0,0,1,1
49364,110,10921,14910;15063,25550,0,0,0,2,2
49365,110,10922,15104;15160;19193;19522,25550,0,0,2,2,4
49366,110,10923,15201;15495;19380,25550,0,0,1,2,3
49367,110,10924,15216;15303,25550,0,0,0,2,2
49368,110,10925,15991;16284;21297,25550,0,1,2,0,3
49369,110,10927,15728,25550,0,0,1,0,1
49370,110,10928,15347;15731,25550,0,0,1,1,2
49371,110,10929,15354,25550,0,0,0,1,1
49372,110,10930,15520;15940,25550,0,0,1,1,2
49373,110,10932,15516;15537,25550,0,0,0,2,2
49374,110,10933,15807;16010,25550,0,0,2,0,2
49375,110,10934,15526;15853,25550,0,0,1,1,2
49376,110,10935,15608;15611,25550,0,0,2,0,2
49377,110,10936,15287;15648,25550,0,0,1,1,2
49378,110,10937,15069;15311,25550,0,0,0,2,2
49379,110,10938,15962;18950;22694;22912,25550,2,0,2,0,4
49380,110,10939,15897,25550,0,0,1,0,1
49381,110,10940,15720;16147;20925,25550,0,0,3,0,3
49382,110,10941,15748;15986,25550,0,0,2,0,2
49383,110,10943,15365;15765,25550,0,0,1,1,2
49384,110,10944,15775,25550,0,0,1,0,1
49385,110,10945,15783;15784;20444,25550,0,0,3,0,3
49386,110,10946,15463;15801,25550,0,0,1,1,2
49387,110,10947,15823;16185;19735,25550,0,0,3,0,3
49388,110,10948,15658;16132;19170,25550,0,0,3,0,3
49389,110,10950,16125;16302,25550,0,0,2,0,2
49390,110,10951,15330,25550,0,0,0,1,1
49391,110,10952,15929;15950,25550,0,0,2,0,2
49392,110,10953,15971;16628;20709,25550,0,0,3,0,3
49393,110,10954,15785,25550,0,0,1,0,1
49394,110,10955,15821;16180,25550,0,0,2,0,2
49395,110,10956,15978;16000,25550,0,0,2,0,2
49396,110,10957,15646;16001;20336,25550,0,0,3,0,3
49397,110,10958,15948;16417,25550,0,0,2,0,2
49398,110,10959,16033;16060,25550,0,0,2,0,2
49399,110,10961,16344;16395,25550,0,0,2,0,2
49400,110,10962,15571;16121,25550,0,0,1,1,2
49401,110,10963,16131;16489,25550,0,0,2,0,2
49402,110,10965,16201;16644,25550,0,0,2,0,2
49403,110,10966,16114;16602;20060,25550,0,0,3,0,3
49404,110,10967,16255;16402,25550,0,0,2,0,2
49405,110,10968,16065;16218,25550,0,0,2,0,2
49406,110,10969,16716;19626;20531;21306,25550,0,1,3,0,4
49407,110,10970,15924;16246,25550,0,0,2,0,2
49408,110,10971,16151;16253,25550,0,0,2,0,2
49409,110,10972,16264;16403,25550,0,0,2,0,2
49410,110,10973,16645;20116;21075,25550,0,0,3,0,3
49411,110,10974,16229;16279;20401,25550,0,0,3,0,3
49412,110,10975,15679;16324,25550,0,0,2,0,2
49413,110,10986,12100,25915,0,0,0,1,1
49414,110,10987,12211,25915,0,0,0,1,1
49415,110,10995,13149,25915,0,0,0,1,1
49416,110,11002,13608,25915,0,0,0,1,1
49417,110,11008,14025,25915,0,0,0,1,1
49418,110,11015,13503,25915,0,0,0,1,1
49419,110,11016,14601,25915,0,0,0,1,1
49420,110,11018,14835;14945,25915,0,0,0,2,2
49421,110,11020,13818,25915,0,0,0,1,1
49422,110,11024,14570,25915,0,0,0,1,1
49423,110,11029,15415;15602,25915,0,0,1,1,2
49424,110,11030,14802;15121,25915,0,0,0,2,2
49425,110,11031,14831;14979,25915,0,0,0,2,2
49426,110,11036,14642;14705,25915,0,0,0,2,2
49427,110,11037,14776;14932,25915,0,0,0,2,2
49428,110,11039,15182;15183,25915,0,0,0,2,2
49429,110,11041,15570;15862;19850,25915,0,0,2,1,3
49430,110,11042,15548;15690,25915,0,0,1,1,2
49431,110,11043,15465,25915,0,0,0,1,1
49432,110,11044,15988;16225,25915,0,0,2,0,2
49433,110,11045,15138;15619;19167,25915,0,0,2,1,3
49434,110,11046,15498;15739,25915,0,0,1,1,2
49435,110,11047,15744;15885;19906,25915,0,0,3,0,3
49436,110,11048,15559;16468,25915,0,0,1,1,2
49437,110,11049,15628;15833,25915,0,0,2,0,2
49438,110,11050,15865,25915,0,0,1,0,1
49439,110,11051,15867;15883,25915,0,0,2,0,2
49440,110,11052,15324,25915,0,0,0,1,1
49441,110,11053,15103;15876;20270,25915,0,0,2,1,3
49442,110,11054,15907;15925,25915,0,0,2,0,2
49443,110,11055,15910,25915,0,0,1,0,1
49444,110,11056,15911;16209,25915,0,0,2,0,2
49445,110,11057,16261;16452;20686;20878,25915,0,0,4,0,4
49446,110,11058,15477;16428,25915,0,0,1,1,2
49447,110,11059,16318,25915,0,0,1,0,1
49448,110,11060,15376;16036,25915,0,0,1,1,2
49449,110,11061,16037;16055,25915,0,0,2,0,2
49450,110,11062,15699;16411,25915,0,0,2,0,2
49451,110,11063,15768;16091,25915,0,0,2,0,2
49452,110,11064,16092;16107;20543;22500;22989,25915,1,1,3,0,5
49453,110,11065,15706;16098,25915,0,0,2,0,2
49454,110,11066,16247;16418;19985,25915,0,0,3,0,3
49455,110,11067,16040;16118;20258,25915,0,0,3,0,3
49456,110,11068,16137;16238;20293,25915,0,0,3,0,3
49457,110,11069,16599;19989;22975,25915,1,0,2,0,3
49458,110,11070,15395;16123,25915,0,0,1,1,2
49459,110,11072,16197;16601;19448;22596;22724,25915,1,1,3,0,5
49460,110,11073,15906,25915,0,0,1,0,1
49461,110,11075,16112;16650,25915,0,0,2,0,2
49462,110,11076,16483;16861;20277;22265,25915,0,1,3,0,4
49463,110,11077,16282,25915,0,0,1,0,1
49464,110,11078,16177;16687,25915,0,0,2,0,2
49465,110,11079,16251;16291;21106,25915,0,0,3,0,3
49466,110,11080,16174;20818;21182,25915,0,0,3,0,3
49467,110,11081,16338;16610;20551;21362,25915,0,1,3,0,4
49468,110,11082,15723;16586;20637;20666,25915,0,0,4,0,4
49469,110,11083,16157;16346,25915,0,0,2,0,2
49470,110,11084,16272;16787;20779;21023,25915,0,0,4,0,4
49471,110,11085,16381;16544,25915,0,0,2,0,2
49472,110,11086,16717;16778,25915,0,0,2,0,2
49473,110,11087,16822,25915,0,0,1,0,1
49474,110,11088,16353;16461,25915,0,0,2,0,2
49475,110,11089,16213;16471;20982,25915,0,0,3,0,3
49476,110,11090,16368;16472;21081,25915,0,0,3,0,3
49477,110,11098,11656,26280,0,0,0,1,1
49478,110,11125,13565,26280,0,0,0,1,1
49479,110,11130,14116;14613,26280,0,0,0,2,2
49480,110,11137,14575;14632,26280,0,0,0,2,2
49481,110,11138,13302,26280,0,0,0,1,1
49482,110,11139,14663,26280,0,0,0,1,1
49483,110,11141,14557;14995,26280,0,0,0,2,2
49484,110,11142,14766;15268,26280,0,0,0,2,2
49485,110,11143,14748;15244,26280,0,0,0,2,2
49486,110,11144,14580;15401,26280,0,0,0,2,2
49487,110,11150,14954;14985,26280,0,0,0,2,2
49488,110,11151,14960,26280,0,0,0,1,1
49489,110,11153,15077,26280,0,0,0,1,1
49490,110,11154,15078;15364,26280,0,0,0,2,2
49491,110,11158,15185;19913;23158,26280,1,0,1,1,3
49492,110,11159,14740;15194,26280,0,0,0,2,2
49493,110,11162,15315;15943;20841,26280,0,0,2,1,3
49494,110,11163,15353,26280,0,0,0,1,1
49495,110,11164,15383;15546,26280,0,0,0,2,2
49496,110,11165,14533;15323,26280,0,0,0,2,2
49497,110,11166,15392;15890,26280,0,0,1,1,2
49498,110,11167,15397;15630;19265;22815,26280,1,0,2,1,4
49499,110,11168,15399;15471;19269,26280,0,0,1,2,3
49500,110,11169,15479;15643,26280,0,0,1,1,2
49501,110,11170,15508;16039,26280,0,0,1,1,2
49502,110,11171,15499;15514,26280,0,0,0,2,2
49503,110,11172,15573;16187,26280,0,0,1,1,2
49504,110,11173,14815;15588;19907,26280,0,0,1,2,3
49505,110,11174,16753;21299,26280,0,1,1,0,2
49506,110,11176,15686;16337,26280,0,0,2,0,2
49507,110,11177,15358;15705,26280,0,0,1,1,2
49508,110,11178,16439,26280,0,0,1,0,1
49509,110,11179,15519,26280,0,0,0,1,1
49510,110,11180,16030;16323,26280,0,0,2,0,2
49511,110,11181,15776;15781;19164;22810,26280,1,0,3,0,4
49512,110,11182,16589,26280,0,0,1,0,1
49513,110,11183,15802;16288;20541,26280,0,0,3,0,3
49514,110,11184,15552;15936,26280,0,0,1,1,2
49515,110,11186,15880,26280,0,0,1,0,1
49516,110,11187,15901;16547,26280,0,0,2,0,2
49517,110,11188,15985;16211;19050;22132,26280,0,1,3,0,4
49518,110,11189,15673;15918,26280,0,0,2,0,2
49519,110,11190,15607;15930,26280,0,0,2,0,2
49520,110,11191,15436;15932;19500;20529,26280,0,0,3,1,4
49521,110,11192,15939;20158,26280,0,0,2,0,2
49522,110,11194,15814;15992,26280,0,0,2,0,2
49523,110,11195,15994,26280,0,0,1,0,1
49524,110,11197,16028,26280,0,0,1,0,1
49525,110,11199,16500,26280,0,0,1,0,1
49526,110,11200,16069;16464,26280,0,0,2,0,2
49527,110,11201,16078;16407;19505;22045;22476,26280,0,2,3,0,5
49528,110,11202,16383;16660;19666;22966;23056,26280,2,0,3,0,5
49529,110,11203,16135,26280,0,0,1,0,1
49530,110,11204,16512;20372,26280,0,0,2,0,2
49531,110,11205,16389,26280,0,0,1,0,1
49532,110,11206,15605;16110,26280,0,0,2,0,2
49533,110,11207,16094;16572;21224,26280,0,0,3,0,3
49534,110,11209,16087;16145;20562,26280,0,0,3,0,3
49535,110,11210,16490;21032,26280,0,0,2,0,2
49536,110,11211,16320;16425,26280,0,0,2,0,2
49537,110,11212,15631;16193,26280,0,0,2,0,2
49538,110,11215,16493;19245,26280,0,0,2,0,2
49539,110,11216,16269;16276,26280,0,0,2,0,2
49540,110,11217,15898;16280,26280,0,0,2,0,2
49541,110,11218,15145;15663,26280,0,0,1,1,2
49542,110,11219,16575,26280,0,0,1,0,1
49543,110,11220,16731;16833,26280,0,0,2,0,2
49544,110,11221,16212;16841,26280,0,0,2,0,2
49545,110,11222,16331;16856;21379,26280,0,1,2,0,3
49546,110,11223,16336;16671,26280,0,0,2,0,2
49547,110,11225,16086;16361,26280,0,0,2,0,2
49548,110,11226,16542,26280,0,0,1,0,1
49549,110,11227,16373;16514,26280,0,0,2,0,2
49550,110,11228,16335;16377,26280,0,0,2,0,2
49551,110,11229,16399;16426,26280,0,0,2,0,2
49552,110,11230,16416;16670,26280,0,0,2,0,2
49553,110,11231,16693;17000;21147,26280,0,0,3,0,3
49554,110,11232,16453;16469,26280,0,0,2,0,2
49555,110,11233,16802;21098,26280,0,0,2,0,2
49556,110,11234,16478;20532;20647,26280,0,0,3,0,3
49557,110,11235,16504;16674;20611;22267,26280,0,1,3,0,4
49558,110,11236,16509;16629,26280,0,0,2,0,2
49559,110,11237,16527;16865;19749;20889,26280,0,0,4,0,4
49560,110,11238,16554;16744,26280,0,0,2,0,2
49561,110,11258,12804,26645,0,0,0,1,1
49562,110,11265,13374,26645,0,0,0,1,1
49563,110,11266,12759;13234,26645,0,0,0,2,2
49564,110,11267,13999,26645,0,0,0,1,1
49565,110,11271,13932;14006,26645,0,0,0,2,2
49566,110,11272,13945,26645,0,0,0,1,1
49567,110,11279,14460;14535,26645,0,0,0,2,2
49568,110,11281,15154;15309,26645,0,0,0,2,2
49569,110,11282,14788,26645,0,0,0,1,1
49570,110,11286,15211,26645,0,0,0,1,1
49571,110,11288,14534;15271,26645,0,0,0,2,2
49572,110,11290,15046;15893,26645,0,0,1,1,2
49573,110,11291,15815;15909,26645,0,0,2,0,2
49574,110,11293,15318;15967,26645,0,0,1,1,2
49575,110,11294,15384,26645,0,0,0,1,1
49576,110,11295,15393;20236;22870,26645,1,0,1,1,3
49577,110,11296,15409;19435,26645,0,0,1,1,2
49578,110,11298,14949;15493;19340;23126,26645,1,0,1,2,4
49579,110,11299,15529;19190;22236;22573,26645,0,2,1,1,4
49580,110,11300,15829;15966,26645,0,0,2,0,2
49581,110,11301,15451;15538,26645,0,0,0,2,2
49582,110,11304,15753;20410,26645,0,0,2,0,2
49583,110,11307,15351;15900,26645,0,0,1,1,2
49584,110,11309,15931,26645,0,0,1,0,1
49585,110,11310,15764;15845,26645,0,0,2,0,2
49586,110,11311,15522;15841,26645,0,0,1,1,2
49587,110,11312,16394,26645,0,0,1,0,1
49588,110,11313,16052,26645,0,0,1,0,1
49589,110,11314,15919;16480,26645,0,0,2,0,2
49590,110,11316,15755;15953,26645,0,0,2,0,2
49591,110,11317,16443;16479;20223,26645,0,0,3,0,3
49592,110,11318,15999,26645,0,0,1,0,1
49593,110,11319,16214;20894,26645,0,0,2,0,2
49594,110,11320,16016;16198,26645,0,0,2,0,2
49595,110,11321,15238;16034,26645,0,0,1,1,2
49596,110,11322,16038;16088,26645,0,0,2,0,2
49597,110,11323,15977;16603,26645,0,0,2,0,2
49598,110,11324,16573;16958;20821,26645,0,0,3,0,3
49599,110,11325,16250;20117,26645,0,0,2,0,2
49600,110,11327,16522;16532,26645,0,0,2,0,2
49601,110,11330,16277;16855;21203,26645,0,0,3,0,3
49602,110,11331,16274;16633;20597,26645,0,0,3,0,3
49603,110,11332,15616;16164,26645,0,0,2,0,2
49604,110,11333,16398;20640,26645,0,0,2,0,2
49605,110,11334,15732;16420,26645,0,0,2,0,2
49606,110,11335,15757;16447,26645,0,0,2,0,2
49607,110,11336,16223;16458,26645,0,0,2,0,2
49608,110,11337,16495;16732;21158,26645,0,0,3,0,3
49609,110,11338,16256;16506;20465;22765,26645,1,0,3,0,4
49610,110,11339,16798;21235,26645,0,0,2,0,2
49611,110,11340,16378;16529,26645,0,0,2,0,2
49612,110,11341,16560,26645,0,0,1,0,1
49613,110,11342,16543;16561,26645,0,0,2,0,2
49614,110,11343,15945;16667;20902;21120,26645,0,0,4,0,4
49615,110,11344,16287;16576;21680,26645,0,1,2,0,3
49616,110,11345,16008;16577,26645,0,0,2,0,2
49617,110,11347,16556;16811;20928,26645,0,0,3,0,3
49618,110,11348,16321;16593;20031,26645,0,0,3,0,3
49619,110,11349,16557;16606;20436,26645,0,0,3,0,3
49620,110,11350,16607;17062;19459,26645,0,0,3,0,3
49621,110,11351,16620,26645,0,0,1,0,1
49622,110,11352,16622;16966,26645,0,0,2,0,2
49623,110,11353,16987;17046,26645,0,0,2,0,2
49624,110,11354,16635,26645,0,0,1,0,1
49625,110,11355,16648,26645,0,0,1,0,1
49626,110,11356,15951;16093,26645,0,0,2,0,2
49627,110,11357,16654,26645,0,0,1,0,1
49628,110,11358,16409;16703;20819,26645,0,0,3,0,3
49629,110,11359,16413;16728,26645,0,0,2,0,2
49630,110,11389,14510,27010,0,0,0,1,1
49631,110,11397,14340;15157,27010,0,0,0,2,2
49632,110,11402,14440;14725,27010,0,0,0,2,2
49633,110,11404,14341,27010,0,0,0,1,1
49634,110,11406,15447,27010,0,0,0,1,1
49635,110,11409,15015;15259,27010,0,0,0,2,2
49636,110,11410,15017;15513;20187,27010,0,0,1,2,3
49637,110,11411,15472;15518,27010,0,0,0,2,2
49638,110,11413,14131;15071,27010,0,0,0,2,2
49639,110,11414,14798,27010,0,0,0,1,1
49640,110,11415,15188;15618,27010,0,0,1,1,2
49641,110,11417,14799;15234,27010,0,0,0,2,2
49642,110,11421,15371,27010,0,0,0,1,1
49643,110,11423,15258;16012,27010,0,0,1,1,2
49644,110,11425,16350;16358,27010,0,0,2,0,2
49645,110,11426,15697;16308;19419,27010,0,0,3,0,3
49646,110,11427,15028;15692,27010,0,0,1,1,2
49647,110,11428,15656;15715,27010,0,0,2,0,2
49648,110,11429,15725;15779,27010,0,0,2,0,2
49649,110,11430,16537,27010,0,0,1,0,1
49650,110,11433,15836;16263;21571,27010,0,1,2,0,3
49651,110,11434,15685;15780,27010,0,0,2,0,2
49652,110,11435,15877;16267;20747,27010,0,0,3,0,3
49653,110,11437,15934;15984,27010,0,0,2,0,2
49654,110,11439,15974,27010,0,0,1,0,1
49655,110,11440,15820;15995,27010,0,0,2,0,2
49656,110,11442,16042;16446,27010,0,0,2,0,2
49657,110,11443,15903;16084,27010,0,0,2,0,2
49658,110,11444,16115,27010,0,0,1,0,1
49659,110,11445,16492,27010,0,0,1,0,1
49660,110,11446,16708,27010,0,0,1,0,1
49661,110,11447,16090;16183,27010,0,0,2,0,2
49662,110,11448,16623;17037,27010,0,0,2,0,2
49663,110,11449,16552;17065;21756,27010,0,1,2,0,3
49664,110,11450,15800;16440,27010,0,0,2,0,2
49665,110,11452,16307;16761,27010,0,0,2,0,2
49666,110,11453,16371;16759,27010,0,0,2,0,2
49667,110,11455,16376;16588,27010,0,0,2,0,2
49668,110,11456,16404;16895;20845,27010,0,0,3,0,3
49669,110,11458,16422,27010,0,0,1,0,1
49670,110,11459,16756;21565,27010,0,1,1,0,2
49671,110,11460,16972;17204;20398;21385,27010,0,1,3,0,4
49672,110,11463,16260;16779;21105,27010,0,0,3,0,3
49673,110,11464,16751;16857;20771,27010,0,0,3,0,3
49674,110,11465,16148;20124;20582;22863,27010,1,0,3,0,4
49675,110,11466,16553;20870;21046,27010,0,0,3,0,3
49676,110,11467,16159;16562;20143,27010,0,0,3,0,3
49677,110,11468,16270;16563;20433,27010,0,0,3,0,3
49678,110,11469,16235;16764;20313;20617,27010,0,0,4,0,4
49679,110,11470,16245;16596;20231,27010,0,0,3,0,3
49680,110,11471,16608;16930,27010,0,0,2,0,2
49681,110,11472,16432;16815;21486,27010,0,1,2,0,3
49682,110,11473,16685;16786,27010,0,0,2,0,2
49683,110,11474,16694;17106;20596,27010,0,0,3,0,3
49684,110,11475,16699;16875;21556,27010,0,1,2,0,3
49685,110,11476,16659;16947;19949;22621,27010,0,1,3,0,4
49686,110,11477,16725;17068;21214,27010,0,0,3,0,3
49687,110,11478,16980;17074,27010,0,0,2,0,2
49688,110,11479,16386;16738;20835,27010,0,0,3,0,3
49689,110,11480,17028;20832,27010,0,0,2,0,2
49690,110,11481,16766;17119;20607;20955;23095,27010,1,0,4,0,5
49691,110,11482,16343;16783;21250,27010,0,0,3,0,3
49692,110,11483,16799;17015;20514,27010,0,0,3,0,3
49693,110,11484,16305;16357;20790,27010,0,0,3,0,3
49694,110,11485,16520;16617,27010,0,0,2,0,2
49695,110,11486,16850,27010,0,0,1,0,1
49696,110,11498,12426,27375,0,0,0,1,1
49697,110,11500,12297,27375,0,0,0,1,1
49698,110,11502,12800,27375,0,0,0,1,1
49699,110,11507,13211,27375,0,0,0,1,1
49700,110,11525,14408;15190,27375,0,0,0,2,2
49701,110,11528,14614;14926,27375,0,0,0,2,2
49702,110,11529,14653;15232,27375,0,0,0,2,2
49703,110,11535,14793;15517,27375,0,0,0,2,2
49704,110,11536,14709;14950,27375,0,0,0,2,2
49705,110,11538,14984;15403,27375,0,0,0,2,2
49706,110,11540,15343,27375,0,0,0,1,1
49707,110,11544,15561;15987,27375,0,0,1,1,2
49708,110,11546,15782;15955,27375,0,0,2,0,2
49709,110,11548,15796;15812,27375,0,0,2,0,2
49710,110,11549,15434;15817,27375,0,0,1,1,2
49711,110,11550,15843;16249;20575,27375,0,0,3,0,3
49712,110,11551,16548,27375,0,0,1,0,1
49713,110,11552,15609;15879;21251,27375,0,0,3,0,3
49714,110,11555,15717,27375,0,0,1,0,1
49715,110,11556,16179,27375,0,0,1,0,1
49716,110,11557,16278;19745;20729,27375,0,0,3,0,3
49717,110,11558,16044;20273;22871;23168,27375,2,0,2,0,4
49718,110,11561,15491;16224,27375,0,0,1,1,2
49719,110,11562,15279;16194,27375,0,0,1,1,2
49720,110,11563,15704;16081,27375,0,0,2,0,2
49721,110,11564,16271;16339;20657,27375,0,0,3,0,3
49722,110,11565,15938;16195,27375,0,0,2,0,2
49723,110,11566,16364;19387;22465;22822,27375,1,1,2,0,4
49724,110,11567,16234;16771;21016,27375,0,0,3,0,3
49725,110,11568,16236;16390;19806,27375,0,0,3,0,3
49726,110,11570,16097;16286,27375,0,0,2,0,2
49727,110,11571,15596;16005,27375,0,0,1,1,2
49728,110,11572,16226;16290,27375,0,0,2,0,2
49729,110,11573,16072;16310,27375,0,0,2,0,2
49730,110,11574,16365;16580,27375,0,0,2,0,2
49731,110,11575,16396;16821;20728,27375,0,0,3,0,3
49732,110,11576,16454;16613,27375,0,0,2,0,2
49733,110,11577,16293;16456;19996;22167;22862,27375,1,1,3,0,5
49734,110,11578,16257;16476;20054,27375,0,0,3,0,3
49735,110,11579,16254;16661;20087,27375,0,0,3,0,3
49736,110,11580,15713;16549,27375,0,0,2,0,2
49737,110,11581,16510;20577;20851,27375,0,0,3,0,3
49738,110,11582,16424,27375,0,0,1,0,1
49739,110,11583,16297;16565;20460,27375,0,0,3,0,3
49740,110,11584,16609,27375,0,0,1,0,1
49741,110,11585,16631;17039,27375,0,0,2,0,2
49742,110,11586,16734;16812;19550;22958,27375,1,0,3,0,4
49743,110,11587,17188;19997;20584;21736;22884,27375,1,1,3,0,5
49744,110,11588,16319;16427,27375,0,0,2,0,2
49745,110,11589,16676;17137;20356;20981;21511,27375,0,1,4,0,5
49746,110,11590,16686;17117;20791;21088;21506,27375,0,1,4,0,5
49747,110,11591,16709,27375,0,0,1,0,1
49748,110,11594,16752,27375,0,0,1,0,1
49749,110,11595,16763;16927,27375,0,0,2,0,2
49750,110,11596,16768,27375,0,0,1,0,1
49751,110,11597,16845;17035,27375,0,0,2,0,2
49752,110,11598,16455;16846,27375,0,0,2,0,2
49753,110,11599,16281;17053,27375,0,0,2,0,2
49754,110,11600,16948;17101,27375,0,0,2,0,2
49755,110,11601,16883;17328,27375,0,0,2,0,2
49756,110,11602,16545;16891;20604,27375,0,0,3,0,3
49757,110,11603,16294;16894;20911,27375,0,0,3,0,3
49758,110,11604,17087;19406;20958,27375,0,0,3,0,3
49759,110,11605,16792;16899;21213;21430,27375,0,1,3,0,4
49760,110,11606,16924;16928;20616,27375,0,0,3,0,3
49761,110,11607,16521;16932,27375,0,0,2,0,2
49762,110,11608,16526;16945;20205,27375,0,0,3,0,3
49763,110,11609,16697;16951;20561,27375,0,0,3,0,3
49764,110,11610,16964;17055;20815,27375,0,0,3,0,3
49765,110,11611,11953,27740,0,0,0,1,1
49766,110,11613,11738,27740,0,0,0,1,1
49767,110,11614,12131,27740,0,0,0,1,1
49768,110,11617,12009,27740,0,0,0,1,1
49769,110,11621,12105,27740,0,0,0,1,1
49770,110,11624,12748,27740,0,0,0,1,1
49771,110,11625,13052,27740,0,0,0,1,1
49772,110,11641,14303;14625,27740,0,0,0,2,2
49773,110,11643,15189,27740,0,0,0,1,1
49774,110,11644,15366,27740,0,0,0,1,1
49775,110,11645,14809;15599;20271,27740,0,0,1,2,3
49776,110,11647,14899;15039,27740,0,0,0,2,2
49777,110,11648,14830;14980,27740,0,0,0,2,2
49778,110,11649,15068;15407;20078,27740,0,0,1,2,3
49779,110,11651,14495;15158,27740,0,0,0,2,2
49780,110,11653,15633,27740,0,0,1,0,1
49781,110,11654,15512,27740,0,0,0,1,1
49782,110,11657,15237;15620;19757;20992,27740,0,0,3,1,4
49783,110,11658,14834;15751,27740,0,0,1,1,2
49784,110,11659,15797;16570,27740,0,0,2,0,2
49785,110,11660,15805;16252,27740,0,0,2,0,2
49786,110,11662,16750;20481;20839,27740,0,0,3,0,3
49787,110,11663,16579,27740,0,0,1,0,1
49788,110,11664,16175;16801,27740,0,0,2,0,2
49789,110,11665,15672;16075;20151,27740,0,0,3,0,3
49790,110,11667,15870;16523,27740,0,0,2,0,2
49791,110,11670,16295;16859;20322;20965;21256,27740,0,0,5,0,5
49792,110,11671,16720;17100;20825;20972;21405,27740,0,1,4,0,5
49793,110,11673,16391;20437,27740,0,0,2,0,2
49794,110,11674,16393;16991;20052;21162;22753,27740,1,0,4,0,5
49795,110,11675,16616;16774;20581;20719;20901,27740,0,0,5,0,5
49796,110,11676,16441;17221,27740,0,0,2,0,2
49797,110,11677,16244;17072,27740,0,0,2,0,2
49798,110,11678,16449;16585,27740,0,0,2,0,2
49799,110,11679,16451;16935,27740,0,0,2,0,2
49800,110,11682,16825;17038;21019,27740,0,0,3,0,3
49801,110,11683,16316;16968;20683;21248,27740,0,0,4,0,4
49802,110,11684,16640;16840;20725,27740,0,0,3,0,3
49803,110,11685,16642;20244,27740,0,0,2,0,2
49804,110,11686,16202;16675;20284,27740,0,0,3,0,3
49805,110,11687,16678;16858;20610,27740,0,0,3,0,3
49806,110,11688,16679;17408;21665,27740,0,1,2,0,3
49807,110,11689,16688;16820;20830;21323,27740,0,1,3,0,4
49808,110,11690,16178;16692;21164,27740,0,0,3,0,3
49809,110,11691,16698;16869,27740,0,0,2,0,2
49810,110,11692,16838,27740,0,0,1,0,1
49811,110,11693,16352;16656;20045;20208;20612;22262;22625,27740,0,2,5,0,7
49812,110,11694,16605;16741;21013,27740,0,0,3,0,3
49813,110,11696,16584;16733;20070;22168,27740,0,1,3,0,4
49814,110,11697,16918;17124,27740,0,0,2,0,2
49815,110,11698,17047;17475;21223;21643,27740,0,1,3,0,4
49816,110,11699,16843,27740,0,0,1,0,1
49817,110,11700,17001;17301,27740,0,0,2,0,2
49818,110,11701,16877;17397;20935;21345,27740,0,1,3,0,4
49819,110,11702,17357;21113,27740,0,0,2,0,2
49820,110,11703,16915;17157;20391,27740,0,0,3,0,3
49821,110,11704,16922;21707,27740,0,1,1,0,2
49822,110,11705,16923,27740,0,0,1,0,1
49823,110,11706,16795;17125;20560;21006;21077,27740,0,0,5,0,5
49824,110,11707,16990;17322;21097,27740,0,0,3,0,3
49825,110,11709,17005;21185,27740,0,0,2,0,2
49826,110,11710,17084;20798;21479,27740,0,1,2,0,3
49827,110,11711,17018;17048;20726,27740,0,0,3,0,3
49828,110,11712,16592;17040;21490,27740,0,1,2,0,3
49829,110,11713,17044;17337;20908,27740,0,0,3,0,3
49830,110,11714,16897;19515;20886,27740,0,0,3,0,3
49831,110,11715,16597;17181,27740,0,0,2,0,2
49832,110,11716,16672;17079;20912,27740,0,0,3,0,3
49833,110,11717,17308;17473;19930;21881,27740,0,1,3,0,4
49834,110,11721,12253,28105,0,0,0,1,1
49835,110,11730,12857;13306,28105,0,0,0,2,2
49836,110,11748,14909;14959,28105,0,0,0,2,2
49837,110,11750,15327,28105,0,0,0,1,1
49838,110,11751,15443;15737,28105,0,0,1,1,2
49839,110,11755,14996;15312,28105,0,0,0,2,2
49840,110,11756,15247;15344,28105,0,0,0,2,2
49841,110,11757,15155;15554;20454,28105,0,0,1,2,3
49842,110,11761,14914;15470,28105,0,0,0,2,2
49843,110,11762,15460;16070,28105,0,0,1,1,2
49844,110,11763,16482;19796;22741,28105,1,0,2,0,3
49845,110,11765,15688;15806;19835,28105,0,0,3,0,3
49846,110,11767,15490;15873,28105,0,0,1,1,2
49847,110,11770,16546,28105,0,0,1,0,1
49848,110,11772,16414,28105,0,0,1,0,1
49849,110,11773,16171;16241;19912;22358;22853,28105,1,1,3,0,5
49850,110,11774,16345;16438;20772;22771,28105,1,0,3,0,4
49851,110,11775,16311;16714,28105,0,0,2,0,2
49852,110,11777,16366;16637,28105,0,0,2,0,2
49853,110,11778,16909;20967;21304;21645,28105,0,2,2,0,4
49854,110,11779,16077;16457,28105,0,0,2,0,2
49855,110,11780,16474;16823;20019;22260,28105,0,1,3,0,4
49856,110,11781,16215;16540;20780;20979,28105,0,0,4,0,4
49857,110,11782,16437;16665;21282,28105,0,0,3,0,3
49858,110,11783,16722;20328,28105,0,0,2,0,2
49859,110,11784,15913;15961,28105,0,0,2,0,2
49860,110,11785,16647;17041,28105,0,0,2,0,2
49861,110,11788,16736;17266;20707,28105,0,0,3,0,3
49862,110,11789,16773;17140;20904;21157,28105,0,0,4,0,4
49863,110,11790,16073;16313,28105,0,0,2,0,2
49864,110,11791,16639;17098,28105,0,0,2,0,2
49865,110,11793,16481;16788,28105,0,0,2,0,2
49866,110,11794,16508;16790;21429,28105,0,1,2,0,3
49867,110,11795,16791;17423;21037,28105,0,0,3,0,3
49868,110,11797,16534;16809,28105,0,0,2,0,2
49869,110,11798,16826;17061;21142;21478,28105,0,1,3,0,4
49870,110,11799,16784;16831;20618;20897,28105,0,0,4,0,4
49871,110,11800,16921;16995;20311,28105,0,0,3,0,3
49872,110,11801,17214;17298;21365,28105,0,1,2,0,3
49873,110,11802,16851;17420;20973;21071,28105,0,0,4,0,4
49874,110,11803,16863;17314;20278;20453;21558,28105,0,1,4,0,5
49875,110,11804,16866;17461;20318;21150;21318;22634,28105,0,2,4,0,6
49876,110,11805,17240,28105,0,0,1,0,1
49877,110,11806,16465,28105,0,0,1,0,1
49878,110,11807,17369;17520;20796;21674,28105,0,1,3,0,4
49879,110,11808,16836;16969,28105,0,0,2,0,2
49880,110,11809,16369;16975,28105,0,0,2,0,2
49881,110,11810,16953;17073;19973;22364;22748,28105,1,1,3,0,5
49882,110,11812,16796;17054,28105,0,0,2,0,2
49883,110,11813,17429;20500,28105,0,0,2,0,2
49884,110,11814,17105;17536;22503,28105,0,1,2,0,3
49885,110,11815,17511;21180;21488,28105,0,1,2,0,3
49886,110,11816,16986;17162;21069,28105,0,0,3,0,3
49887,110,11817,16985;17108;20742,28105,0,0,3,0,3
49888,110,11818,17405;17590;20727;20938;21080;22770,28105,1,0,5,0,6
49889,110,11819,17027;17152;20603,28105,0,0,3,0,3
49890,110,11820,17142;17269;19575,28105,0,0,3,0,3
49891,110,11821,17519;17727;19926;20468;21494,28105,0,1,4,0,5
49892,110,11822,17193,28105,0,0,1,0,1
49893,110,11824,17215;17222;21909,28105,0,1,2,0,3
49894,110,11825,16805;17223;21226;21850,28105,0,1,3,0,4
49895,110,11826,12690,28470,0,0,0,1,1
49896,110,11831,12189,28470,0,0,0,1,1
49897,110,11837,11995,28470,0,0,0,1,1
49898,110,11844,13075,28470,0,0,0,1,1
49899,110,11846,12964,28470,0,0,0,1,1
49900,110,11859,13767,28470,0,0,0,1,1
49901,110,11860,13485,28470,0,0,0,1,1
49902,110,11863,13967,28470,0,0,0,1,1
49903,110,11864,14265,28470,0,0,0,1,1
49904,110,11865,14029;14751,28470,0,0,0,2,2
49905,110,11866,14592,28470,0,0,0,1,1
49906,110,11873,14896,28470,0,0,0,1,1
49907,110,11877,14969;20108,28470,0,0,1,1,2
49908,110,11878,14875,28470,0,0,0,1,1
49909,110,11879,14620;14848,28470,0,0,0,2,2
49910,110,11880,14123,28470,0,0,0,1,1
49911,110,11884,15242,28470,0,0,0,1,1
49912,110,11886,15585;15852,28470,0,0,1,1,2
49913,110,11889,16083;20494;22988;23175,28470,2,0,2,0,4
49914,110,11890,15503,28470,0,0,0,1,1
49915,110,11891,16566,28470,0,0,1,0,1
49916,110,11894,15980;16158;20633;20744;23097,28470,1,0,4,0,5
49917,110,11895,15969,28470,0,0,1,0,1
49918,110,11896,15963;16129,28470,0,0,2,0,2
49919,110,11898,15887;16431,28470,0,0,2,0,2
49920,110,11900,16351;19811,28470,0,0,2,0,2
49921,110,11901,16056;16499,28470,0,0,2,0,2
49922,110,11902,16242;16484;20470,28470,0,0,3,0,3
49923,110,11904,16259;16485,28470,0,0,2,0,2
49924,110,11905,16285;16780,28470,0,0,2,0,2
49925,110,11906,16380;17272;20071,28470,0,0,3,0,3
49926,110,11907,16207;16406,28470,0,0,2,0,2
49927,110,11908,16710;16949,28470,0,0,2,0,2
49928,110,11909,16459;17082;21440,28470,0,1,2,0,3
49929,110,11910,16408,28470,0,0,1,0,1
49930,110,11911,16515;16885,28470,0,0,2,0,2
49931,110,11912,16876;20573,28470,0,0,2,0,2
49932,110,11913,16673;16702;20572,28470,0,0,3,0,3
49933,110,11914,16682;16900;20665,28470,0,0,3,0,3
49934,110,11915,16392;16730,28470,0,0,2,0,2
49935,110,11916,16587;16747,28470,0,0,2,0,2
49936,110,11917,17375;17542;21151,28470,0,0,3,0,3
49937,110,11918,16890;17512;21141;21567,28470,0,1,3,0,4
49938,110,11919,16905;17008,28470,0,0,2,0,2
49939,110,11920,16950;17173,28470,0,0,2,0,2
49940,110,11921,16962;17016;20588,28470,0,0,3,0,3
49941,110,11923,17440;17441;21492,28470,0,1,2,0,3
49942,110,11924,16989;17424,28470,0,0,2,0,2
49943,110,11925,16911;17496;21176,28470,0,0,3,0,3
49944,110,11926,17499;20228;20915;21710;22170;23167,28470,1,2,3,0,6
49945,110,11927,17191;17402;20767;21923,28470,0,1,3,0,4
49946,110,11928,16917;17036;21107,28470,0,0,3,0,3
49947,110,11929,17508;21234,28470,0,0,2,0,2
49948,110,11930,16931;17097;20395;20905,28470,0,0,4,0,4
49949,110,11931,16886;17104;20309;21817,28470,0,1,3,0,4
49950,110,11932,17575;21007;21731,28470,0,1,2,0,3
49951,110,11933,16839;17148;21099;21276,28470,0,0,4,0,4
49952,110,11934,17011;17156,28470,0,0,2,0,2
49953,110,11935,17189;20614,28470,0,0,2,0,2
49954,110,11936,17592;17845;20608;21432;23096,28470,1,1,3,0,5
49955,110,11937,17014;17201,28470,0,0,2,0,2
49956,110,11938,17089;17200;21313,28470,0,1,2,0,3
49957,110,11939,17208;20995,28470,0,0,2,0,2
49958,110,11940,17147;17227;21853,28470,0,1,2,0,3
49959,110,11941,16892;17231,28470,0,0,2,0,2
49960,110,11942,16666;17234,28470,0,0,2,0,2
49961,110,11943,17244;17246;20058,28470,0,0,3,0,3
49962,110,11944,17256;17320;20107,28470,0,0,3,0,3
49963,110,11945,17192;17267,28470,0,0,2,0,2
49964,110,11946,17284;17673;20678;21600,28470,0,1,3,0,4
49965,110,11947,17509;21188;21418;21824,28470,0,2,2,0,4
49966,110,11948,17312;17457,28470,0,0,2,0,2
49967,110,11949,17344;17492;21712,28470,0,1,2,0,3
49968,110,11965,12844,28835,0,0,0,1,1
49969,110,11967,13337,28835,0,0,0,1,1
49970,110,11973,13756;14155,28835,0,0,0,2,2
49971,110,11977,14005,28835,0,0,0,1,1
49972,110,11982,14565;14598,28835,0,0,0,2,2
49973,110,11985,14688;15100,28835,0,0,0,2,2
49974,110,11990,15213;15553,28835,0,0,0,2,2
49975,110,11991,15345;16150,28835,0,0,1,1,2
49976,110,11992,15369;16170;20303;20873,28835,0,0,3,1,4
49977,110,11995,15074;15235,28835,0,0,0,2,2
49978,110,11997,16053;16142;20317;20558,28835,0,0,4,0,4
49979,110,11998,15791;16210;20936,28835,0,0,3,0,3
49980,110,12000,16076,28835,0,0,1,0,1
49981,110,12006,16301,28835,0,0,1,0,1
49982,110,12007,16387;19948;22165;22491,28835,0,2,2,0,4
49983,110,12009,16196;16558;20542;20768,28835,0,0,4,0,4
49984,110,12011,16104;16611,28835,0,0,2,0,2
49985,110,12012,16356,28835,0,0,1,0,1
49986,110,12013,16735;16983;20310;20355,28835,0,0,4,0,4
49987,110,12016,16700;17174,28835,0,0,2,0,2
49988,110,12017,17218;17374,28835,0,0,2,0,2
49989,110,12019,16517;17059;21195,28835,0,0,3,0,3
49990,110,12020,16757;17595,28835,0,0,2,0,2
49991,110,12021,16874;20775,28835,0,0,2,0,2
49992,110,12022,16349;16810,28835,0,0,2,0,2
49993,110,12023,16852;17213;20738;20812,28835,0,0,4,0,4
49994,110,12025,16898;17326;20736;22644;23099,28835,1,1,3,0,5
49995,110,12027,16770;16926;20907;21481,28835,0,1,3,0,4
49996,110,12028,16942;17533;21626;21911,28835,0,2,2,0,4
49997,110,12029,17210;17527,28835,0,0,2,0,2
49998,110,12032,17017;17632;20840,28835,0,0,3,0,3
49999,110,12033,17161;17551;21262;21593,28835,0,1,3,0,4
50000,110,12034,17605;17736;21068;21270,28835,0,0,4,0,4
50001,110,12035,17034;17531;21200,28835,0,0,3,0,3
50002,110,12036,17052;17131;20848;21334,28835,0,1,3,0,4
50003,110,12037,17274;17395;20509;20599;21742,28835,0,1,4,0,5
50004,110,12038,17066;17381;20137;21444;21922,28835,0,2,3,0,5
50005,110,12039,17406;21384;21602,28835,0,2,1,0,3
50006,110,12040,17120;17687,28835,0,0,2,0,2
50007,110,12041,16830;17123,28835,0,0,2,0,2
50008,110,12042,17091;17143;21028;21570,28835,0,1,3,0,4
50009,110,12043,17144;17207;20655;21178,28835,0,0,4,0,4
50010,110,12044,16888;17166;20862,28835,0,0,3,0,3
50011,110,12045,17233;17430;20082,28835,0,0,3,0,3
50012,110,12046,17232;17493;20896;21356;21803,28835,0,2,3,0,5
50013,110,12047,17435;17557;20631,28835,0,0,3,0,3
50014,110,12048,17704;21687,28835,0,1,1,0,2
50015,110,12049,17060;17239;20794,28835,0,0,3,0,3
50016,110,12050,16941,28835,0,0,1,0,1
50017,110,12051,16965;17248,28835,0,0,2,0,2
50018,110,12053,17288,28835,0,0,1,0,1
50019,110,12054,16477;17307;20286;20880,28835,0,0,4,0,4
50020,110,12055,17323;17580;20387,28835,0,0,3,0,3
50021,110,12056,17331;17392;20593;23094,28835,1,0,3,0,4
50022,110,12059,17206;17372;22502,28835,0,1,2,0,3
50023,110,12060,17393;17516;21065,28835,0,0,3,0,3
50024,110,12061,17530;17788;20056;20888,28835,0,0,4,0,4
50025,110,12062,17467;17671;20079;21928,28835,0,1,3,0,4
50026,110,12063,17270;17588;21677,28835,0,1,2,0,3
50027,110,12064,17619,28835,0,0,1,0,1
50028,110,12065,12264,29200,0,0,0,1,1
50029,110,12068,12510,29200,0,0,0,1,1
50030,110,12070,12768,29200,0,0,0,1,1
50031,110,12071,12875;13108,29200,0,0,0,2,2
50032,110,12076,13228,29200,0,0,0,1,1
50033,110,12078,13310,29200,0,0,0,1,1
50034,110,12082,13417;14092,29200,0,0,0,2,2
50035,110,12083,13713,29200,0,0,0,1,1
50036,110,12092,14335,29200,0,0,0,1,1
50037,110,12097,14617,29200,0,0,0,1,1
50038,110,12098,14554;14994,29200,0,0,0,2,2
50039,110,12100,14380;14850,29200,0,0,0,2,2
50040,110,12101,15167,29200,0,0,0,1,1
50041,110,12106,15408;15788,29200,0,0,1,1,2
50042,110,12111,15657;16204,29200,0,0,2,0,2
50043,110,12112,15935,29200,0,0,1,0,1
50044,110,12115,16206;16711;20703,29200,0,0,3,0,3
50045,110,12117,15976;16342;21639,29200,0,1,2,0,3
50046,110,12118,16004;16862,29200,0,0,2,0,2
50047,110,12119,16102;16462;19920;22746;22854;23070,29200,3,0,3,0,6
50048,110,12120,16109;16165,29200,0,0,2,0,2
50049,110,12123,15946;16298,29200,0,0,2,0,2
50050,110,12124,16486;17107;20755,29200,0,0,3,0,3
50051,110,12125,16505;16800,29200,0,0,2,0,2
50052,110,12126,16518;16904,29200,0,0,2,0,2
50053,110,12127,16528;16977;20679;20799,29200,0,0,4,0,4
50054,110,12128,16200;17090;20917;21108;21298,29200,0,1,4,0,5
50055,110,12129,16591;17133;21288;21347,29200,0,1,3,0,4
50056,110,12130,16797,29200,0,0,1,0,1
50057,110,12131,15861;16621;21236,29200,0,0,3,0,3
50058,110,12132,16813;17447;20276;21502,29200,0,1,3,0,4
50059,110,12133,16535;17236,29200,0,0,2,0,2
50060,110,12134,16658;16719;20760,29200,0,0,3,0,3
50061,110,12135,16933;17010;20629,29200,0,0,3,0,3
50062,110,12136,16828;17296;21135,29200,0,0,3,0,3
50063,110,12137,16834;17195;20654;21259,29200,0,0,4,0,4
50064,110,12138,16014;16306,29200,0,0,2,0,2
50065,110,12140,17220,29200,0,0,1,0,1
50066,110,12141,17348,29200,0,0,1,0,1
50067,110,12142,17019;17165,29200,0,0,2,0,2
50068,110,12143,16997;17042;21421,29200,0,1,2,0,3
50069,110,12144,17045;17706;20041;20326;22647,29200,1,0,4,0,5
50070,110,12145,17075;17230;21057,29200,0,0,3,0,3
50071,110,12146,17129;17359;21620,29200,0,1,2,0,3
50072,110,12147,17139;17141;21129,29200,0,0,3,0,3
50073,110,12149,17145;17327,29200,0,0,2,0,2
50074,110,12150,17485;20983;21283,29200,0,0,3,0,3
50075,110,12151,17229;17672;21348,29200,0,1,2,0,3
50076,110,12152,17093;17294;20697,29200,0,0,3,0,3
50077,110,12153,17254;21193,29200,0,0,2,0,2
50078,110,12154,17747;20475;20716;22680,29200,1,0,3,0,4
50079,110,12155,17280;17875;21177,29200,0,0,3,0,3
50080,110,12156,17228;17300;21127,29200,0,0,3,0,3
50081,110,12157,16939;17316;21149,29200,0,0,3,0,3
50082,110,12158,17171;17360;20986,29200,0,0,3,0,3
50083,110,12160,17602;17616;21926,29200,0,1,2,0,3
50084,110,12161,17403;17635;21424,29200,0,1,2,0,3
50085,110,12162,17710;17896;20900;21257;23183,29200,1,0,4,0,5
50086,110,12163,17500;17846;20732;22505,29200,0,1,3,0,4
50087,110,12164,17340;17505;21613,29200,0,1,2,0,3
50088,110,12165,17828;21935,29200,0,1,1,0,2
50089,110,12166,17733;20974,29200,0,0,2,0,2
50090,110,12167,17413;17761;21875,29200,0,1,2,0,3
50091,110,12168,17271;17554;20942,29200,0,0,3,0,3
50092,110,12169,17878;20741;21536;22066,29200,0,2,2,0,4
50093,110,12171,12398;12741,29565,0,0,0,2,2
50094,110,12175,12614,29565,0,0,0,1,1
50095,110,12176,12248,29565,0,0,0,1,1
50096,110,12179,12743,29565,0,0,0,1,1
50097,110,12180,12956,29565,0,0,0,1,1
50098,110,12184,12716,29565,0,0,0,1,1
50099,110,12187,13135;13366,29565,0,0,0,2,2
50100,110,12195,13498;13780,29565,0,0,0,2,2
50101,110,12198,13872;13889,29565,0,0,0,2,2
50102,110,12201,14100,29565,0,0,0,1,1
50103,110,12203,14351;14847,29565,0,0,0,2,2
50104,110,12205,14619,29565,0,0,0,1,1
50105,110,12206,14606;14880,29565,0,0,0,2,2
50106,110,12208,14745;15133,29565,0,0,0,2,2
50107,110,12209,14474;14928,29565,0,0,0,2,2
50108,110,12211,15187,29565,0,0,0,1,1
50109,110,12215,15659;20238,29565,0,0,2,0,2
50110,110,12218,15840,29565,0,0,1,0,1
50111,110,12219,15960;16400;20669,29565,0,0,3,0,3
50112,110,12221,15404;15983,29565,0,0,1,1,2
50113,110,12222,15957;16062,29565,0,0,2,0,2
50114,110,12223,15933;16071,29565,0,0,2,0,2
50115,110,12226,16612;21014,29565,0,0,2,0,2
50116,110,12227,15668;16134,29565,0,0,2,0,2
50117,110,12228,20501;20673,29565,0,0,2,0,2
50118,110,12229,15482;16309;20389;22371,29565,0,1,2,1,4
50119,110,12231,16332;17050;20684;21173,29565,0,0,4,0,4
50120,110,12234,15572;16415;20758;21123,29565,0,0,3,1,4
50121,110,12236,16156;16496,29565,0,0,2,0,2
50122,110,12237,16564;16646;20787;21218,29565,0,0,4,0,4
50123,110,12238,16128;16824;20941,29565,0,0,3,0,3
50124,110,12239,16906;20586,29565,0,0,2,0,2
50125,110,12240,17247;21368,29565,0,1,1,0,2
50126,110,12241,16511;16683,29565,0,0,2,0,2
50127,110,12242,16715;17329;21186;21601,29565,0,1,3,0,4
50128,110,12243,16767;17469;21663,29565,0,1,2,0,3
50129,110,12244,16781;17122,29565,0,0,2,0,2
50130,110,12246,16555;16690,29565,0,0,2,0,2
50131,110,12247,16884;17116,29565,0,0,2,0,2
50132,110,12248,16643;16916;20996;21483,29565,0,1,3,0,4
50133,110,12249,16956;17154;20721,29565,0,0,3,0,3
50134,110,12250,17217;17541;21560,29565,0,1,2,0,3
50135,110,12251,17004;17522;20396;20602;21528,29565,0,1,4,0,5
50136,110,12252,16444;16814,29565,0,0,2,0,2
50137,110,12253,17056;17146;21372,29565,0,1,2,0,3
50138,110,12254,17464;21330,29565,0,1,1,0,2
50139,110,12255,17088;17163;21535,29565,0,1,2,0,3
50140,110,12256,16946;17099;20776;21280;21678,29565,0,1,4,0,5
50141,110,12257,17358;17380;20315;22872;23086,29565,2,0,3,0,5
50142,110,12258,16680;17176,29565,0,0,2,0,2
50143,110,12259,17184;17663;20366;21391,29565,0,1,3,0,4
50144,110,12260,17404;17535;20274;21194,29565,0,0,4,0,4
50145,110,12262,16878;17243;20884,29565,0,0,3,0,3
50146,110,12263,17109;17245;20477;22766,29565,1,0,3,0,4
50147,110,12264,17077;17262,29565,0,0,2,0,2
50148,110,12265,17279;17662;20784;20999,29565,0,0,4,0,4
50149,110,12266,16901;17285;20846,29565,0,0,3,0,3
50150,110,12267,17364;22172,29565,0,1,1,0,2
50151,110,12268,17198;17389;21202,29565,0,0,3,0,3
50152,110,12269,17400;17923;20183;22067,29565,0,1,3,0,4
50153,110,12270,18042;21404;21715;22280,29565,0,3,1,0,4
50154,110,12271,17187;17470;21772,29565,0,1,2,0,3
50155,110,12272,17431;17491;21505,29565,0,1,2,0,3
50156,110,12273,17566;17742;20004;20175;23081,29565,1,0,4,0,5
50157,110,12274,17459;17670,29565,0,0,2,0,2
50158,110,12275,17453;17460;20578;20855;20927;21137;23178,29565,1,0,6,0,7
50159,110,12276,17462;17507;21878;21924,29565,0,2,2,0,4
50160,110,12277,17003;17463,29565,0,0,2,0,2
50161,110,12278,17487;17807;20325;23171,29565,1,0,3,0,4
50162,110,12279,17118;17489;21082;21518;21811,29565,0,2,3,0,5
50163,110,12280,17506;17768;20852;20898,29565,0,0,4,0,4
50164,110,12281,17658;18034;21233;22179,29565,0,1,3,0,4
50165,110,12282,17182;17523;20066;21092,29565,0,0,4,0,4
50166,110,12283,17915;17955;21374;21653;22376,29565,0,3,2,0,5
50167,110,12285,17591;17805;21501,29565,0,1,2,0,3
50168,110,12287,17433;17604;20903;21130;21815,29565,0,1,4,0,5
50169,110,12288,17069;17617;20371;22874,29565,1,0,3,0,4
50170,110,12289,17333;17621;21060;21264;21927;22173,29565,0,2,4,0,6
50171,110,12290,17572;17622;21165,29565,0,0,3,0,3
50172,110,12291,17982,29565,0,0,1,0,1
50173,110,12292,17330;17656;21084;21445,29565,0,1,3,0,4
50174,110,12293,17548;17684;21043;21249;21449,29565,0,1,4,0,5
50175,110,12295,12507,29930,0,0,0,1,1
50176,110,12296,12534,29930,0,0,0,1,1
50177,110,12297,12576,29930,0,0,0,1,1
50178,110,12298,12645,29930,0,0,0,1,1
50179,110,12302,12863,29930,0,0,0,1,1
50180,110,12304,12907,29930,0,0,0,1,1
50181,110,12305,12979,29930,0,0,0,1,1
50182,110,12312,13148;13661,29930,0,0,0,2,2
50183,110,12315,13160,29930,0,0,0,1,1
50184,110,12316,13541;13902,29930,0,0,0,2,2
50185,110,12317,13202,29930,0,0,0,1,1
50186,110,12318,13145,29930,0,0,0,1,1
50187,110,12321,14218,29930,0,0,0,1,1
50188,110,12324,14328,29930,0,0,0,1,1
50189,110,12327,14403;15124,29930,0,0,0,2,2
50190,110,12331,14469;14561,29930,0,0,0,2,2
50191,110,12333,14947;15777,29930,0,0,1,1,2
50192,110,12334,15243,29930,0,0,0,1,1
50193,110,12335,15590;15724,29930,0,0,1,1,2
50194,110,12340,15681;16268,29930,0,0,2,0,2
50195,110,12342,15804;16068,29930,0,0,2,0,2
50196,110,12345,17136,29930,0,0,1,0,1
50197,110,12347,16384;20676;20933,29930,0,0,3,0,3
50198,110,12348,16816;21102,29930,0,0,2,0,2
50199,110,12349,16959;21355;21655,29930,0,2,1,0,3
50200,110,12350,16743;16879;20360;20757,29930,0,0,4,0,4
50201,110,12351,16837,29930,0,0,1,0,1
50202,110,12352,16827;21608,29930,0,1,1,0,2
50203,110,12356,16574;16818;21439,29930,0,1,2,0,3
50204,110,12357,16848;17112;20699;21063,29930,0,0,4,0,4
50205,110,12358,16873;17024,29930,0,0,2,0,2
50206,110,12359,17439;17445;20695,29930,0,0,3,0,3
50207,110,12360,16410;17051,29930,0,0,2,0,2
50208,110,12361,17002;17126;21344,29930,0,1,2,0,3
50209,110,12362,16445;17135;20786,29930,0,0,3,0,3
50210,110,12363,17325;18088;21543;22181,29930,0,2,2,0,4
50211,110,12365,16776;17179;21291;21787,29930,0,2,2,0,4
50212,110,12366,17185;17690;20544;21320;23176,29930,1,1,3,0,5
50213,110,12367,17315;21642,29930,0,1,1,0,2
50214,110,12368,17278;20689,29930,0,0,2,0,2
50215,110,12369,17583;20526;21190;21534;22767,29930,1,1,3,0,5
50216,110,12370,16624;17164;21244,29930,0,0,3,0,3
50217,110,12371,17418;17972;21111;21694;21944,29930,0,2,3,0,5
50218,110,12372,17007;17449;20857;21632,29930,0,1,3,0,4
50219,110,12374,17675;17717;20711;21295;21685;22372,29930,0,3,3,0,6
50220,110,12375,17488;17943;21324,29930,0,1,2,0,3
50221,110,12376,17540;17840;20450;20648;21279;21403;22273,29930,0,2,5,0,7
50222,110,12377,17335;17586;21554,29930,0,1,2,0,3
50223,110,12378,17451;17719,29930,0,0,2,0,2
50224,110,12380,17637;17756;21117;21776;21918;22269,29930,0,3,3,0,6
50225,110,12381,17661;18067;20704;21017,29930,0,0,4,0,4
50226,110,12382,16881;17669;20872,29930,0,0,3,0,3
50227,110,12383,17263;17677;21417;21761,29930,0,2,2,0,4
50228,110,12384,17723;20409;20733;21118;21729;21929,29930,0,2,4,0,6
50229,110,12385,17456;17737;20834;20877;21773,29930,0,1,4,0,5
50230,110,12386,17748;18120;21042;22284,29930,0,1,3,0,4
50231,110,12387,17994;20446;20937;21263;21852;22177,29930,0,2,4,0,6
50232,110,12388,17483;17796;21838,29930,0,1,2,0,3
50233,110,12389,17799;18009,29930,0,0,2,0,2
50234,110,12390,17382;17801;21010;21357;21628,29930,0,2,3,0,5
50235,110,12391,12607,30295,0,0,0,1,1
50236,110,12395,12933,30295,0,0,0,1,1
50237,110,12398,12402,30295,0,0,0,1,1
50238,110,12400,13081,30295,0,0,0,1,1
50239,110,12401,12513;12976,30295,0,0,0,2,2
50240,110,12403,13418,30295,0,0,0,1,1
50241,110,12407,13804,30295,0,0,0,1,1
50242,110,12408,13900,30295,0,0,0,1,1
50243,110,12424,15054;15329,30295,0,0,0,2,2
50244,110,12425,15253;15455,30295,0,0,0,2,2
50245,110,12432,15357;15417,30295,0,0,0,2,2
50246,110,12433,15468,30295,0,0,0,1,1
50247,110,12434,15793;16397,30295,0,0,2,0,2
50248,110,12436,16334;16354,30295,0,0,2,0,2
50249,110,12440,16184;16973;21397,30295,0,1,2,0,3
50250,110,12443,16325;16746,30295,0,0,2,0,2
50251,110,12444,16430;16494;20807;20934,30295,0,0,4,0,4
50252,110,12445,16516;16867,30295,0,0,2,0,2
50253,110,12446,16652;17023,30295,0,0,2,0,2
50254,110,12447,16513;16655,30295,0,0,2,0,2
50255,110,12448,16161;16536,30295,0,0,2,0,2
50256,110,12449,16961;17175;21066,30295,0,0,3,0,3
50257,110,12450,16619;16754;21351,30295,0,1,2,0,3
50258,110,12453,16789;16832,30295,0,0,2,0,2
50259,110,12455,16677;16955,30295,0,0,2,0,2
50260,110,12457,16936;17482;20312;21269,30295,0,0,4,0,4
50261,110,12458,16807;17219;21480,30295,0,1,2,0,3
50262,110,12460,16998;17211,30295,0,0,2,0,2
50263,110,12461,17538;20609;21070,30295,0,0,3,0,3
50264,110,12462,16910;17170,30295,0,0,2,0,2
50265,110,12463,17197;17394;21125;22171,30295,0,1,3,0,4
50266,110,12464,17196;17584;21457,30295,0,1,2,0,3
50267,110,12465,18203;21078;21170;21316;21453;22081,30295,0,3,3,0,6
50268,110,12466,16913;16996;20682;20759,30295,0,0,4,0,4
50269,110,12467,17289;17547;21026;21925,30295,0,1,3,0,4
50270,110,12468,16954;17302;21030,30295,0,0,3,0,3
50271,110,12469,17306;17341;20487;20906;23090,30295,1,0,4,0,5
50272,110,12470,17998,30295,0,0,1,0,1
50273,110,12471,17310;17346,30295,0,0,2,0,2
50274,110,12473,17765;21346;21455,30295,0,2,1,0,3
50275,110,12474,17371;20367;21086;22761,30295,1,0,3,0,4
50276,110,12475,17376;17378;21581,30295,0,1,2,0,3
50277,110,12476,17057;17411;21629,30295,0,1,2,0,3
50278,110,12477,17480;17546;20849;21201;21784,30295,0,1,4,0,5
50279,110,12478,17502;17824;21422;21675,30295,0,2,2,0,4
50280,110,12479,17349;17514;21000,30295,0,0,3,0,3
50281,110,12480,17377;17739;21274;21834;22373,30295,0,2,3,0,5
50282,110,12481,17537;17653;21822,30295,0,1,2,0,3
50283,110,12482,17574;17623,30295,0,0,2,0,2
50284,110,12483,17888;18021;21059;22508,30295,0,1,3,0,4
50285,110,12484,17585;17703;21199;21312,30295,0,1,3,0,4
50286,110,12485,18103;18221,30295,0,0,2,0,2
50287,110,12486,17606;18262,30295,0,0,2,0,2
50288,110,12487,17242;17608;20764;20959;21126;21447;22991;23180,30295,2,1,5,0,8
50289,110,12489,17685;17819,30295,0,0,2,0,2
50290,110,12490,18073;18160;21955,30295,0,1,2,0,3
50291,110,12491,17726;17867;20693;20921;21930,30295,0,1,4,0,5
50292,110,12492,17743;18235;20523;21243;22880,30295,1,0,4,0,5
50293,110,12493,17750;17781;20233;21900;22630,30295,0,2,3,0,5
50294,110,12494,17396;17811;21053,30295,0,0,3,0,3
50295,110,12495,17813;17872;21155,30295,0,0,3,0,3
50296,110,12496,16872;17900;21079;21326,30295,0,1,3,0,4
50297,110,12497,17646;17834,30295,0,0,2,0,2
50298,110,12498,17841,30295,0,0,1,0,1
50299,110,12499,17746;17849;20257;21252;22982;23084,30295,2,0,4,0,6
50300,110,12500,17795;17902;21054;21826,30295,0,1,3,0,4
50301,110,12501,17526;17857;21056;21067,30295,0,0,4,0,4
50302,110,12502,17866;17975;20457;20752;21879;22176;22641,30295,0,3,4,0,7
50303,110,12503,17474;17645;21167;21725,30295,0,1,3,0,4
50304,110,12504,17205;17880,30295,0,0,2,0,2
50305,110,12505,17883;18135;21527;21898,30295,0,2,2,0,4
50306,110,12506,17898;21008;21245;21812;22276,30295,0,2,3,0,5
50307,110,12507,17918;18197;21509;21767;21958;22285,30295,0,4,2,0,6
50308,110,12508,13472,30660,0,0,0,1,1
50309,110,12509,12749,30660,0,0,0,1,1
50310,110,12510,12600,30660,0,0,0,1,1
50311,110,12512,12461;12777,30660,0,0,0,2,2
50312,110,12514,12987,30660,0,0,0,1,1
50313,110,12519,13289,30660,0,0,0,1,1
50314,110,12520,12689,30660,0,0,0,1,1
50315,110,12531,13544;13768,30660,0,0,0,2,2
50316,110,12538,14805,30660,0,0,0,1,1
50317,110,12541,14730;15109,30660,0,0,0,2,2
50318,110,12545,15161;16120,30660,0,0,1,1,2
50319,110,12549,15647,30660,0,0,1,0,1
50320,110,12554,16166,30660,0,0,1,0,1
50321,110,12560,16074,30660,0,0,1,0,1
50322,110,12565,16108;16582;20533;23093,30660,1,0,3,0,4
50323,110,12566,16405;16598;20826,30660,0,0,3,0,3
50324,110,12569,16487;16634,30660,0,0,2,0,2
50325,110,12575,17720;21630;21919,30660,0,2,1,0,3
50326,110,12576,16978;17241;21340,30660,0,1,2,0,3
50327,110,12577,17110;17524;21610,30660,0,1,2,0,3
50328,110,12578,17121;17132,30660,0,0,2,0,2
50329,110,12579,17186,30660,0,0,1,0,1
50330,110,12580,17268;17387;20351,30660,0,0,3,0,3
50331,110,12581,17305;20701;21611,30660,0,1,2,0,3
50332,110,12582,16762;17317;20332;21160,30660,0,0,4,0,4
50333,110,12583,17318;17352;20467,30660,0,0,3,0,3
50334,110,12584,17343;17455;20480;22268,30660,0,1,3,0,4
50335,110,12585,17887;21420;21646;22649,30660,1,2,1,0,4
50336,110,12586,17177;17630;21273,30660,0,0,3,0,3
50337,110,12587,17903;20865;21538;21938,30660,0,2,2,0,4
50338,110,12588,17432;17826;20381;21321;22064,30660,0,2,3,0,5
50339,110,12589,17638;18072;21575,30660,0,1,2,0,3
50340,110,12590,17442;18291,30660,0,0,2,0,2
50341,110,12591,17452,30660,0,0,1,0,1
50342,110,12592,17427;17510;21314,30660,0,1,2,0,3
50343,110,12593,17568;21452;21820,30660,0,2,1,0,3
50344,110,12594,17113;17562;21425,30660,0,1,2,0,3
50345,110,12595,17250;17766;21461;22374,30660,0,2,2,0,4
50346,110,12596,17882;20914;21168,30660,0,0,3,0,3
50347,110,12597,17861;17908;21220,30660,0,0,3,0,3
50348,110,12598,17822,30660,0,0,1,0,1
50349,110,12599,18095;18122;20864,30660,0,0,3,0,3
50350,110,12600,17833;17959,30660,0,0,2,0,2
50351,110,12601,17495;17711;21689;21847,30660,0,2,2,0,4
50352,110,12603,17713;18164;21568,30660,0,1,2,0,3
50353,110,12604,17696;17735;21025;21361,30660,0,1,3,0,4
50354,110,12605,17741;18354,30660,0,0,2,0,2
50355,110,12606,17759;18215;20417;20804,30660,0,0,4,0,4
50356,110,12607,17550;17783;21796;22062,30660,0,2,2,0,4
50357,110,12608,17609;17835;21892,30660,0,1,2,0,3
50358,110,12609,17838;18216;21018;21634,30660,0,1,3,0,4
50359,110,12610,17862;18126;22379,30660,0,1,2,0,3
50360,110,12611,17494;17782;21516;21836,30660,0,2,2,0,4
50361,110,12612,17899;17951;21034;21319,30660,0,1,3,0,4
50362,110,12614,18232;20546;21332,30660,0,1,2,0,3
50363,110,12615,17563;17926;21941,30660,0,1,2,0,3
50364,110,12618,17598;17957;21750,30660,0,1,2,0,3
50365,110,12619,17789;17979;21764;22278,30660,0,2,2,0,4
50366,110,12620,17383;17850;20970;22274,30660,0,1,3,0,4
50367,110,12621,18002;18131;21134;21296;21564,30660,0,2,3,0,5
50368,110,12622,17837;18007;21205;22071,30660,0,1,3,0,4
50369,110,12623,18097;18230;21961,30660,0,1,2,0,3
50370,110,12624,17610;18024;21217,30660,0,0,3,0,3
50371,110,12625,17515;17870,30660,0,0,2,0,2
50372,110,12626,18121;18340,30660,0,0,2,0,2
50373,110,12627,17398;18046;22075;22180,30660,0,2,2,0,4
50374,110,12629,12757,31025,0,0,0,1,1
50375,110,12630,12833,31025,0,0,0,1,1
50376,110,12631,12545,31025,0,0,0,1,1
50377,110,12633,13102,31025,0,0,0,1,1
50378,110,12634,13380,31025,0,0,0,1,1
50379,110,12636,13402;14017,31025,0,0,0,2,2
50380,110,12639,13519;13707,31025,0,0,0,2,2
50381,110,12642,13671,31025,0,0,0,1,1
50382,110,12647,14008,31025,0,0,0,1,1
50383,110,12652,14512;14604,31025,0,0,0,2,2
50384,110,12653,14267;15140,31025,0,0,0,2,2
50385,110,12667,15632;16466,31025,0,0,2,0,2
50386,110,12668,15299;16029,31025,0,0,1,1,2
50387,110,12673,16684;17102,31025,0,0,2,0,2
50388,110,12674,15996,31025,0,0,1,0,1
50389,110,12676,17085;21050,31025,0,0,2,0,2
50390,110,12677,16079;16718;21219,31025,0,0,3,0,3
50391,110,12678,16525;16758,31025,0,0,2,0,2
50392,110,12679,16847,31025,0,0,1,0,1
50393,110,12680,17202;17259,31025,0,0,2,0,2
50394,110,12682,16740;17255;21041;21246,31025,0,0,4,0,4
50395,110,12684,15908;17064,31025,0,0,2,0,2
50396,110,12689,17282;17738;21526,31025,0,1,2,0,3
50397,110,12690,17299;20946;21091,31025,0,0,3,0,3
50398,110,12692,17006;17660;21588,31025,0,1,2,0,3
50399,110,12693,17096;17370,31025,0,0,2,0,2
50400,110,12694,17033;17490;21624,31025,0,1,2,0,3
50401,110,12695,17012;17150;20708,31025,0,0,3,0,3
50402,110,12697,18190;18200;20831;22888,31025,1,0,3,0,4
50403,110,12698,17521;17577;20953,31025,0,0,3,0,3
50404,110,12699,18109;21722,31025,0,1,1,0,2
50405,110,12700,17503;17674;21414;21617,31025,0,2,2,0,4
50406,110,12701,17688;17774,31025,0,0,2,0,2
50407,110,12702,17722;18010,31025,0,0,2,0,2
50408,110,12703,17534;17731;21352;22061,31025,0,2,2,0,4
50409,110,12704,17803;21469,31025,0,1,1,0,2
50410,110,12705,17942;20722;20788;21228;21943,31025,0,1,4,0,5
50411,110,12706,17769;21004;21695;21933,31025,0,2,2,0,4
50412,110,12707,17644;17858;20620;21116;21426;21936,31025,0,2,4,0,6
50413,110,12708,17873;17986;20712;20988;21076,31025,0,0,5,0,5
50414,110,12709,17558;17889,31025,0,0,2,0,2
50415,110,12710,17901;18133;21089;21377;21737,31025,0,2,3,0,5
50416,110,12711,17932;18376;21206;22779,31025,1,0,3,0,4
50417,110,12712,17976;18249;21039;22516,31025,0,1,3,0,4
50418,110,12713,18199;20991;21496;22514,31025,0,2,2,0,4
50419,110,12714,18130;18274;22774,31025,1,0,2,0,3
50420,110,12715,18016;21353;21598;22072;22507,31025,0,4,1,0,5
50421,110,12716,17978;18022;21443;21788,31025,0,2,2,0,4
50422,110,12717,17869;18032;22178,31025,0,1,2,0,3
50423,110,12718,18050;18281;21664,31025,0,1,2,0,3
50424,110,12719,17599;18053,31025,0,0,2,0,2
50425,110,12720,18075;18258;20534;20801;21596;21963;22083;22768;23182,31025,2,3,4,0,9
50426,110,12721,18089;18163,31025,0,0,2,0,2
50427,110,12723,18185;18279;22288,31025,0,1,2,0,3
50428,110,12724,18225;21859;22654,31025,1,1,1,0,3
50429,110,12725,17935;18134;20670;20874;21230;21754;22079,31025,0,2,5,0,7
50430,110,12726,18096;18147;22512,31025,0,1,2,0,3
50431,110,12727,12560,31390,0,0,0,1,1
50432,110,12729,13238,31390,0,0,0,1,1
50433,110,12732,13269,31390,0,0,0,1,1
50434,110,12733,13667,31390,0,0,0,1,1
50435,110,12737,13248,31390,0,0,0,1,1
50436,110,12740,14058,31390,0,0,0,1,1
50437,110,12741,14144,31390,0,0,0,1,1
50438,110,12746,14629,31390,0,0,0,1,1
50439,110,12747,14543;14687,31390,0,0,0,2,2
50440,110,12748,14741;14882,31390,0,0,0,2,2
50441,110,12762,15306;15904,31390,0,0,1,1,2
50442,110,12766,16017;16141,31390,0,0,2,0,2
50443,110,12767,16061;16463;21159,31390,0,0,3,0,3
50444,110,12772,16041,31390,0,0,1,0,1
50445,110,12774,16944;20954,31390,0,0,2,0,2
50446,110,12777,16388;16727;21466,31390,0,1,2,0,3
50447,110,12780,16653;17190,31390,0,0,2,0,2
50448,110,12781,16721;17345;21002,31390,0,0,3,0,3
50449,110,12783,16793,31390,0,0,1,0,1
50450,110,12784,16705;16864,31390,0,0,2,0,2
50451,110,12785,16868;17080;20829,31390,0,0,3,0,3
50452,110,12786,16614;17013,31390,0,0,2,0,2
50453,110,12788,17081;17183;20740;21436,31390,0,1,3,0,4
50454,110,12790,17158;20710;20813;21024,31390,0,0,4,0,4
50455,110,12791,16938;17115;20950;21031;22995,31390,1,0,4,0,5
50456,110,12795,17555;17570;20749;21497;21899,31390,0,2,3,0,5
50457,110,12796,17127;17434;20571,31390,0,0,3,0,3
50458,110,12798,17728;17729;21454;22060,31390,0,2,2,0,4
50459,110,12799,16615;17238;20805;20867,31390,0,0,4,0,4
50460,110,12800,17648;20795;21064;21192;21844;22646;22992,31390,1,2,4,0,7
50461,110,12801,16952;17313;21317,31390,0,1,2,0,3
50462,110,12802,17319;21161,31390,0,0,2,0,2
50463,110,12803,17334;17338,31390,0,0,2,0,2
50464,110,12804,17351;17353,31390,0,0,2,0,2
50465,110,12806,17559;17560;20910;21179,31390,0,0,4,0,4
50466,110,12807,17373;21145,31390,0,0,2,0,2
50467,110,12808,17865;20919;21460,31390,0,1,2,0,3
50468,110,12809,17155;17172;20646,31390,0,0,3,0,3
50469,110,12810,17194;17528;21183,31390,0,0,3,0,3
50470,110,12811,17569;17615;20838,31390,0,0,3,0,3
50471,110,12812,17624;18277;20705;20909;21335,31390,0,1,4,0,5
50472,110,12813,17664;18427;20592;21513;22194;22643,31390,0,3,3,0,6
50473,110,12814,17680;21112,31390,0,0,2,0,2
50474,110,12815,17714;21231;21485,31390,0,1,2,0,3
50475,110,12816,17715;17917;21939,31390,0,1,2,0,3
50476,110,12817,17764;18114;21015;21172;21350;21950;22994,31390,1,2,4,0,7
50477,110,12818,17787;18259;21730;21876,31390,0,2,2,0,4
50478,110,12819,17874;18006;21121;21367;21781,31390,0,2,3,0,5
50479,110,12820,18683;22296,31390,0,1,1,0,2
50480,110,12821,17679;17854;21498;21873,31390,0,2,2,0,4
50481,110,12822,18405;21973,31390,0,1,1,0,2
50482,110,12823,17628;17920,31390,0,0,2,0,2
50483,110,12824,17721;17937;21001;21222;21942,31390,0,1,4,0,5
50484,110,12825,17871;17985;22069,31390,0,1,2,0,3
50485,110,12826,18233;22515,31390,0,1,1,0,2
50486,110,12827,17618;18267;21388;21801,31390,0,2,2,0,4
50487,110,12828,18017;18483;21210;21532;23001,31390,1,1,3,0,5
50488,110,12829,17830;18004,31390,0,0,2,0,2
50489,110,12831,17650;18083;21309;21589,31390,0,2,2,0,4
50490,110,12832,18179;18260;21733,31390,0,1,2,0,3
50491,110,12833,18090;18178;21482;22076,31390,0,2,2,0,4
50492,110,12834,17949;18401;21555;21972,31390,0,2,2,0,4
50493,110,12835,17745;18162;21428,31390,0,1,2,0,3
50494,110,12836,18925;21266;22321,31390,0,1,2,0,3
50495,110,12837,18725;18785;21487;22901,31390,1,1,2,0,4
50496,110,12838,18219;18558;20589;20947;21133,31390,0,0,5,0,5
50497,110,12839,17984;18238;21400;21484;22655,31390,1,2,2,0,5
50498,110,12840,18177;18240;21305;21464;21525,31390,0,3,2,0,5
50499,110,12844,13197;13326,31755,0,0,0,2,2
50500,110,12845,13083,31755,0,0,0,1,1
50501,110,12847,13831,31755,0,0,0,1,1
50502,110,12849,13966,31755,0,0,0,1,1
50503,110,12853,14310,31755,0,0,0,1,1
50504,110,12854,14366;14685,31755,0,0,0,2,2
50505,110,12863,15089;15813,31755,0,0,1,1,2
50506,110,12865,15179,31755,0,0,0,1,1
50507,110,12869,15543,31755,0,0,0,1,1
50508,110,12871,15740;15959,31755,0,0,2,0,2
50509,110,12877,16819;17160;20761,31755,0,0,3,0,3
50510,110,12879,17071;17419;20968;21093,31755,0,0,4,0,4
50511,110,12880,16419;16595,31755,0,0,2,0,2
50512,110,12881,16706;17076;21720,31755,0,1,2,0,3
50513,110,12882,17029;17149;21491,31755,0,1,2,0,3
50514,110,12883,16105;16723;21061;21721,31755,0,1,3,0,4
50515,110,12884,17481;17665;21229,31755,0,0,3,0,3
50516,110,12886,17249;17779;20975;21495;21877,31755,0,2,3,0,5
50517,110,12887,17465;21459,31755,0,1,1,0,2
50518,110,12889,17354;17573;20750;21166;21359,31755,0,1,4,0,5
50519,110,12890,16963;17365;21778,31755,0,1,2,0,3
50520,110,12891,17379;20858;22055,31755,0,1,2,0,3
50521,110,12892,17391;17444;20671;21662;23098,31755,1,1,3,0,5
50522,110,12893,17466;17654;21390,31755,0,1,2,0,3
50523,110,12894,17472;18328;21475;22384,31755,0,2,2,0,4
50524,110,12895,17273;17607;20881,31755,0,0,3,0,3
50525,110,12896,17350;17611;21101,31755,0,0,3,0,3
50526,110,12897,17620;18166,31755,0,0,2,0,2
50527,110,12898,17203;17641,31755,0,0,2,0,2
50528,110,12899,17517;21156;21333,31755,0,1,2,0,3
50529,110,12900,17695;18336;21671;22087,31755,0,2,2,0,4
50530,110,12901,17652;17778,31755,0,0,2,0,2
50531,110,12902,17780,31755,0,0,1,0,1
50532,110,12903,17790;17821;20920;21104,31755,0,0,4,0,4
50533,110,12904,17798;17825;20876,31755,0,0,3,0,3
50534,110,12905,17855;18091;21580;22511,31755,0,2,2,0,4
50535,110,12906,17362;17892;21285;21894,31755,0,1,3,0,4
50536,110,12907,18214;18437;21239;21392;21683;22286;22653,31755,1,3,3,0,7
50537,110,12908,18161;18239;21956,31755,0,1,2,0,3
50538,110,12909,17952;18081;20675;21148;21380;21576;21765,31755,0,3,4,0,7
50539,110,12910,18690;18721;20803;21035;21132;21394;21999;22676;23011,31755,2,2,5,0,9
50540,110,12911,18626;21095;22533,31755,0,1,2,0,3
50541,110,12912,17995;21863,31755,0,1,1,0,2
50542,110,12913,17579;18001;21187,31755,0,0,3,0,3
50543,110,12914,18014;18241;22287,31755,0,1,2,0,3
50544,110,12915,18044;18187;20969;21557,31755,0,1,3,0,4
50545,110,12916,17954;18507;20891;21579;22099,31755,0,2,3,0,5
50546,110,12917,18171;18705;22002;22110,31755,0,2,2,0,4
50547,110,12918,18085;18377;21366;22773,31755,1,1,2,0,4
50548,110,12919,18697;18911;21128;21472,31755,0,1,3,0,4
50549,110,12920,18094;18289;21595;22086;22519,31755,0,3,2,0,5
50550,110,12921,18099;18389;20800;21138;21606;21842;22091;22292;22891,31755,1,4,4,0,9
50551,110,12922,18423;18639;21797,31755,0,1,2,0,3
50552,110,12923,18079;18390;21744,31755,0,1,2,0,3
50553,110,12924,18609;20842;21726;21988;22201;22399,31755,0,4,2,0,6
50554,110,12925,18495;20823;22394;22664,31755,1,1,2,0,4
50555,110,12927,18457;18584;20860;21386;21468;22096,31755,0,3,3,0,6
50556,110,12928,17868;20990,31755,0,0,2,0,2
50557,110,12929,17757;18157;21237;21327,31755,0,1,3,0,4
50558,110,12930,18311;18393;20700;21402;22290;22776,31755,1,2,3,0,6
50559,110,12931,18025;18247;21301;21616,31755,0,2,2,0,4
50560,110,12932,18284;18343;21828;21970;22385,31755,0,3,2,0,5
50561,110,12933,17996;18041;21884;22074,31755,0,2,2,0,4
50562,110,12934,18770;21267;22006;22114;22682,31755,1,2,2,0,5
50563,110,12935,18734;18784;21910,31755,0,1,2,0,3
50564,110,12936,18320,31755,0,0,1,0,1
50565,110,12937,18346;22190,31755,0,1,1,0,2
50566,110,12938,18347;18381,31755,0,0,2,0,2
50567,110,12939,18385,31755,0,0,1,0,1
50568,110,12940,17667;18306;21696;22289,31755,0,2,2,0,4
50569,110,12941,13007;13523,32120,0,0,0,2,2
50570,110,12942,13370,32120,0,0,0,1,1
50571,110,12943,13486,32120,0,0,0,1,1
50572,110,12947,13757,32120,0,0,0,1,1
50573,110,12952,13973,32120,0,0,0,1,1
50574,110,12955,14240,32120,0,0,0,1,1
50575,110,12957,14140,32120,0,0,0,1,1
50576,110,12958,14539;14612,32120,0,0,0,2,2
50577,110,12961,14790;14915,32120,0,0,0,2,2
50578,110,12962,14246,32120,0,0,0,1,1
50579,110,12970,14792,32120,0,0,0,1,1
50580,110,12981,16230;16473,32120,0,0,2,0,2
50581,110,12982,16303;16530,32120,0,0,2,0,2
50582,110,12987,16842,32120,0,0,1,0,1
50583,110,12989,17386;17458;21542;21709,32120,0,2,2,0,4
50584,110,12990,16903;17388;20814,32120,0,0,3,0,3
50585,110,12993,16960;17339;21308,32120,0,1,2,0,3
50586,110,12994,17287;17518;21738,32120,0,1,2,0,3
50587,110,12995,17355;17936,32120,0,0,2,0,2
50588,110,12997,17199,32120,0,0,1,0,1
50589,110,12998,17689;22059,32120,0,1,1,0,2
50590,110,12999,17678;20753;21322;22057,32120,0,2,2,0,4
50591,110,13000,17415;17666;21551,32120,0,1,2,0,3
50592,110,13001,17532;17539;20789,32120,0,0,3,0,3
50593,110,13002,17967;20850;21045,32120,0,0,3,0,3
50594,110,13003,17749;20980;21463;21931,32120,0,2,2,0,4
50595,110,13004,17709;17758;22270,32120,0,1,2,0,3
50596,110,13005,17797;18063;21174;21591,32120,0,1,3,0,4
50597,110,13006,17773;17800;21743;21885,32120,0,2,2,0,4
50598,110,13007,17856;18288;21423;21966,32120,0,2,2,0,4
50599,110,13008,17836;17894;21902;21937;22506,32120,0,3,2,0,5
50600,110,13009,17919;18146;21431;21625;22182,32120,0,3,2,0,5
50601,110,13010,17601;17930;21848,32120,0,1,2,0,3
50602,110,13011,18039;18397;21524;21802;21886,32120,0,3,2,0,5
50603,110,13012,18486;21698;21904;22391,32120,0,3,1,0,4
50604,110,13013,17712;17983;21673;21864,32120,0,2,2,0,4
50605,110,13014,18048;18070;21258;21735;21949,32120,0,2,3,0,5
50606,110,13015,18104;18561;20765;22103;22398;22530;22667,32120,1,3,3,0,7
50607,110,13016,18110;18142;21415,32120,0,1,2,0,3
50608,110,13017,18248;21197;22082,32120,0,1,2,0,3
50609,110,13018,18137;18670;20997;21207;21520,32120,0,1,4,0,5
50610,110,13019,18168;21728;22652,32120,1,1,1,0,3
50611,110,13021,18093;18604;21272;21450;22305,32120,0,2,3,0,5
50612,110,13022,18212;18499;21888;21982,32120,0,2,2,0,4
50613,110,13023,18223;18735;21458;21823;23014,32120,1,2,2,0,5
50614,110,13024,18587;18766;20817;21073;21515;22669,32120,1,1,4,0,6
50615,110,13025,17891;18282;20916;21559;21775;22085;22657,32120,1,3,3,0,7
50616,110,13026,18286;18321;21087;21819;22775,32120,1,1,3,0,5
50617,110,13027,18645;21184;21658;22674;22787,32120,2,1,2,0,5
50618,110,13028,18378;21727;21769,32120,0,2,1,0,3
50619,110,13029,18205;18408,32120,0,0,2,0,2
50620,110,13030,18419;18729,32120,0,0,2,0,2
50621,110,13031,18434;18613;21550;21779,32120,0,2,2,0,4
50622,110,13033,18452;18615;21759;22389;23000,32120,1,2,2,0,5
50623,110,13034,18453;18494;21477;21714;22198;22782,32120,1,3,2,0,6
50624,110,13035,18461;20994;21062;22523;22663,32120,1,1,3,0,5
50625,110,13036,17760;18342;21271;21762,32120,0,1,3,0,4
50626,110,13037,18227;18426;20952;21633,32120,0,1,3,0,4
50627,110,13038,18475;18530;21607,32120,0,1,2,0,3
50628,110,13039,17823;17852;21009;21225;22271,32120,0,1,4,0,5
50629,110,13040,18237;18505;21328;21519,32120,0,2,2,0,4
50630,110,13041,18246;18515;21278;21393;21690;22100;22298,32120,0,4,3,0,7
50631,110,13042,18517;18663;21341;21648,32120,0,2,2,0,4
50632,110,13043,13002,32485,0,0,0,1,1
50633,110,13045,13584,32485,0,0,0,1,1
50634,110,13046,13347,32485,0,0,0,1,1
50635,110,13047,13309;13646,32485,0,0,0,2,2
50636,110,13048,13668,32485,0,0,0,1,1
50637,110,13050,14073,32485,0,0,0,1,1
50638,110,13052,14098,32485,0,0,0,1,1
50639,110,13053,14356,32485,0,0,0,1,1
50640,110,13054,14145,32485,0,0,0,1,1
50641,110,13056,14224,32485,0,0,0,1,1
50642,110,13057,14666,32485,0,0,0,1,1
50643,110,13059,14817,32485,0,0,0,1,1
50644,110,13060,15333,32485,0,0,0,1,1
50645,110,13064,15080,32485,0,0,0,1,1
50646,110,13068,15431,32485,0,0,0,1,1
50647,110,13070,15214;15528,32485,0,0,0,2,2
50648,110,13071,15385;15734,32485,0,0,1,1,2
50649,110,13072,15577,32485,0,0,0,1,1
50650,110,13081,16663;17212;21476,32485,0,1,2,0,3
50651,110,13085,16988;16992,32485,0,0,2,0,2
50652,110,13086,17022;17501;21471,32485,0,1,2,0,3
50653,110,13088,17111;17425;20887;21085;21667,32485,0,1,4,0,5
50654,110,13090,17657;21275;21794,32485,0,1,2,0,3
50655,110,13091,17681;21342;21615;22058,32485,0,3,1,0,4
50656,110,13092,17421;17655;21416;21840,32485,0,2,2,0,4
50657,110,13093,17416;17471;21051;21587,32485,0,1,3,0,4
50658,110,13094,17309;18149;21047;21268,32485,0,0,4,0,4
50659,110,13098,17613;21265;23186,32485,1,0,2,0,3
50660,110,13099,17265;17614;21401;21442,32485,0,2,2,0,4
50661,110,13100,17639;17934,32485,0,0,2,0,2
50662,110,13101,17651;18506;21983;22098,32485,0,2,2,0,4
50663,110,13102,17682;18254;21349,32485,0,1,2,0,3
50664,110,13104,17751;18060;21287;21533;21948;22510,32485,0,3,3,0,6
50665,110,13106,17839;21932,32485,0,1,1,0,2
50666,110,13108,17938;18209;21960;22186,32485,0,2,2,0,4
50667,110,13109,17587;17958;21136;21293;21585;21688;22175,32485,0,4,3,0,7
50668,110,13110,17816;21110;21337,32485,0,1,2,0,3
50669,110,13111,17792;18023,32485,0,0,2,0,2
50670,110,13112,18028;18431;21896;22195,32485,0,2,2,0,4
50671,110,13113,18033;21770,32485,0,1,1,0,2
50672,110,13114,18049;18677;21998;22309,32485,0,2,2,0,4
50673,110,13115,17946;18054;21325;21749;22281,32485,0,3,2,0,5
50674,110,13116,18078;18155;20885;21074;21310;21954;22993,32485,1,2,4,0,7
50675,110,13117,18153;18651;21724;21872;22537,32485,0,3,2,0,5
50676,110,13118,18156;18196;21049;21209;21302;22183,32485,0,2,4,0,6
50677,110,13119,18180;21540,32485,0,1,1,0,2
50678,110,13120,17941;18208,32485,0,0,2,0,2
50679,110,13121,17992;18222;21253;21507,32485,0,1,3,0,4
50680,110,13122,17827;18251;21569;21862;21962;22187,32485,0,4,2,0,6
50681,110,13123,18749;20944;21029;21240;22211;22409;22681,32485,1,2,4,0,7
50682,110,13124,18731;19000;21895;22209;22407,32485,0,3,2,0,5
50683,110,13125,18637;20978;21114;21614;22401,32485,0,2,3,0,5
50684,110,13127,17916;18319;21637;21915,32485,0,2,2,0,4
50685,110,13128,18331;18548;21232;22199,32485,0,1,3,0,4
50686,110,13129,17785;17877;21934,32485,0,1,2,0,3
50687,110,13131,18330;18429;22658,32485,1,0,2,0,3
50688,110,13132,18472;19016;20993;21290,32485,0,0,4,0,4
50689,110,13133,17950;18479;21545,32485,0,1,2,0,3
50690,110,13134,18374;18496,32485,0,0,2,0,2
50691,110,13135,18501;18502;21005;21427;23105,32485,1,1,3,0,5
50692,110,13136,18514;21547;21841;22665,32485,1,2,1,0,4
50693,110,13137,17968;18516;21537;21718;22101;22527,32485,0,4,2,0,6
50694,110,13138,18532;18852;22395,32485,0,1,2,0,3
50695,110,13140,18280;18575;21255;22302,32485,0,1,3,0,4
50696,110,13141,18170;18783;21631,32485,0,1,2,0,3
50697,110,13142,18256;18598;21027;21986;22200,32485,0,2,3,0,5
50698,110,13143,18612;18698;21406,32485,0,1,2,0,3
50699,110,13144,18867;21241;21609;22547,32485,0,2,2,0,4
50700,110,13145,13513,32850,0,0,0,1,1
50701,110,13146,13349,32850,0,0,0,1,1
50702,110,13147,13808,32850,0,0,0,1,1
50703,110,13149,13867;14032,32850,0,0,0,2,2
50704,110,13152,13905,32850,0,0,0,1,1
50705,110,13153,13741,32850,0,0,0,1,1
50706,110,13154,13387,32850,0,0,0,1,1
50707,110,13159,13953,32850,0,0,0,1,1
50708,110,13161,14216,32850,0,0,0,1,1
50709,110,13162,14049,32850,0,0,0,1,1
50710,110,13164,14643;14988,32850,0,0,0,2,2
50711,110,13166,15117,32850,0,0,0,1,1
50712,110,13181,15510,32850,0,0,0,1,1
50713,110,13182,16127,32850,0,0,1,0,1
50714,110,13183,16317;16326,32850,0,0,2,0,2
50715,110,13184,16328;16460,32850,0,0,2,0,2
50716,110,13186,16503,32850,0,0,1,0,1
50717,110,13192,16467,32850,0,0,1,0,1
50718,110,13194,16974,32850,0,0,1,0,1
50719,110,13195,17260;17407;21382;21916,32850,0,2,2,0,4
50720,110,13197,17525;21798,32850,0,1,1,0,2
50721,110,13200,17347;17659;21315;22056,32850,0,2,2,0,4
50722,110,13201,17988;18098;21586,32850,0,1,2,0,3
50723,110,13202,17417;17755;21395,32850,0,1,2,0,3
50724,110,13203,18192;21957,32850,0,1,1,0,2
50725,110,13204,17925;21940,32850,0,1,1,0,2
50726,110,13205,17802;21785,32850,0,1,1,0,2
50727,110,13206,17565;17912;21597,32850,0,1,2,0,3
50728,110,13207,17498;17810;21381;21473,32850,0,2,2,0,4
50729,110,13208,17812,32850,0,0,1,0,1
50730,110,13209,17691;17884;21413;21544,32850,0,2,2,0,4
50731,110,13210,17886;18562;21360;21985;22104,32850,0,3,2,0,5
50732,110,13212,17909;18565,32850,0,0,2,0,2
50733,110,13213,17753;17927,32850,0,0,2,0,2
50734,110,13214,17683;17929;21311,32850,0,1,2,0,3
50735,110,13216,18313;18820,32850,0,0,2,0,2
50736,110,13217,18102;18353;21971;22777,32850,1,1,2,0,4
50737,110,13218,18106;18655;22307;23010,32850,1,1,2,0,4
50738,110,13219,17904;18116;21867;22077;22513;22651,32850,1,3,2,0,6
50739,110,13220,18123;18620;22672,32850,1,0,2,0,3
50740,110,13221,18040;18167;21603,32850,0,1,2,0,3
50741,110,13222,18186;18323;21260;21363;21669;23103,32850,1,2,3,0,6
50742,110,13223,17708;18206;21522;21640,32850,0,2,2,0,4
50743,110,13224,18265;21434;21594;21830,32850,0,3,1,0,4
50744,110,13225,18077;18278;21303;21703;22518,32850,0,3,2,0,5
50745,110,13226,18293;18402;22188,32850,0,1,2,0,3
50746,110,13227,18317;18883;21040;21215;21462;22548;23109,32850,1,2,4,0,7
50747,110,13228,18334;18642;21470;21766;22202,32850,0,3,2,0,5
50748,110,13229,18189;18357;21371;21619;23104,32850,1,2,2,0,5
50749,110,13230,18361;22191,32850,0,1,1,0,2
50750,110,13231,18600;18627;21294;22786,32850,1,1,2,0,4
50751,110,13232,18244;18417;21855,32850,0,1,2,0,3
50752,110,13233,18447;18694;22294,32850,0,1,2,0,3
50753,110,13234,17940;18450;21854,32850,0,1,2,0,3
50754,110,13235,18454;21399;21638;21777;22095;22390;22893,32850,1,5,1,0,7
50755,110,13236,18469;18864;21446;22216,32850,0,2,2,0,4
50756,110,13237,18866;22687,32850,1,0,1,0,2
50757,110,13238,18569;18597;21623;23004,32850,1,1,2,0,4
50758,110,13239,18958;21289;21711;22431;22555;22695,32850,1,3,2,0,6
50759,110,13240,18948;21307;21670;22911,32850,1,2,1,0,4
50760,110,13241,18301;18786;21169;21652;23016;23108,32850,2,1,3,0,6
50761,110,13243,18283;18778;21115;22214;22543,32850,0,2,3,0,5
50762,110,13244,19065;19186;21146;22565,32850,0,1,3,0,4
50763,110,13245,18667;18971;22432,32850,0,1,2,0,3
50764,110,13246,18560;18761;21768,32850,0,1,2,0,3
50765,110,13247,18687;19091;21083;21383;22136;22231,32850,0,3,3,0,6
50766,110,13248,18714;19158;21109;21408;23119,32850,1,1,3,0,5
50767,110,13249,18716;18861;22207;22312;22678,32850,1,2,2,0,5
50768,110,13250,18722;18920;21553;22900,32850,1,1,2,0,4
50769,110,13252,18743;19059;21376;23027,32850,1,1,2,0,4
50770,110,13253,18674;18890;21912;22422,32850,0,2,2,0,4
50771,110,13254,18465;18763;22212;22313;22410,32850,0,3,2,0,5
50772,110,13255,18490;18765;21208;21582;22213,32850,0,2,3,0,5
50773,110,13256,13863,33215,0,0,0,1,1
50774,110,13257,13685,33215,0,0,0,1,1
50775,110,13258,13691,33215,0,0,0,1,1
50776,110,13259,13852,33215,0,0,0,1,1
50777,110,13261,14064,33215,0,0,0,1,1
50778,110,13263,14150,33215,0,0,0,1,1
50779,110,13266,15165,33215,0,0,0,1,1
50780,110,13267,14936,33215,0,0,0,1,1
50781,110,13268,13955,33215,0,0,0,1,1
50782,110,13270,15025,33215,0,0,0,1,1
50783,110,13272,14765;15450,33215,0,0,0,2,2
50784,110,13280,15175;15176,33215,0,0,0,2,2
50785,110,13282,15291,33215,0,0,0,1,1
50786,110,13288,15374,33215,0,0,0,1,1
50787,110,13296,16920;17058;21144,33215,0,0,3,0,3
50788,110,13303,17818,33215,0,0,1,0,1
50789,110,13304,17582;21573,33215,0,1,1,0,2
50790,110,13306,17732;17763;21387;21456,33215,0,2,2,0,4
50791,110,13307,17820;18148,33215,0,0,2,0,2
50792,110,13308,18141;18392;21221;21552;22092,33215,0,2,3,0,5
50793,110,13309,17367;18128;22078;22887,33215,1,1,2,0,4
50794,110,13310,17962;18019;21375;22068,33215,0,2,2,0,4
50795,110,13312,17939,33215,0,0,1,0,1
50796,110,13313,17552;17948;22174,33215,0,1,2,0,3
50797,110,13314,17848;17980,33215,0,0,2,0,2
50798,110,13315,18005;18297;21905,33215,0,1,2,0,3
50799,110,13318,17597;18020,33215,0,0,2,0,2
50800,110,13319,18062,33215,0,0,1,0,1
50801,110,13320,18038;18573;21510;22301,33215,0,2,2,0,4
50802,110,13321,18058;21227;21364;22378;22509,33215,0,3,2,0,5
50803,110,13322,18064;18510,33215,0,0,2,0,2
50804,110,13324,18242;21433;21546,33215,0,2,1,0,3
50805,110,13325,17859;18143;21920;21953;22080,33215,0,3,2,0,5
50806,110,13326,18622;18649;22402,33215,0,1,2,0,3
50807,110,13328,18000;18210;21211;21549,33215,0,1,3,0,4
50808,110,13329,17945;18226;21814,33215,0,1,2,0,3
50809,110,13330,18183;18231,33215,0,0,2,0,2
50810,110,13331,17634;18252;21813,33215,0,1,2,0,3
50811,110,13333,18269;18700;21140;21329;22311;22792,33215,1,2,3,0,6
50812,110,13334,17832;18539;21119;21389,33215,0,1,3,0,4
50813,110,13335,17944;18296;21563;22189;22382,33215,0,3,2,0,5
50814,110,13336,18300;18858;21523;21882;22015;22546,33215,0,4,2,0,6
50815,110,13337,18308;18901;22217;22319,33215,0,2,2,0,4
50816,110,13338,18366;21747,33215,0,1,1,0,2
50817,110,13339,18352;18607;21719,33215,0,1,2,0,3
50818,110,13340,18174;18356,33215,0,0,2,0,2
50819,110,13341,18195;18383;22890,33215,1,0,2,0,3
50820,110,13342,18403;18619;21989;22671,33215,1,1,2,0,4
50821,110,13343,18410;18897,33215,0,0,2,0,2
50822,110,13344,18074;18413;21517;21649,33215,0,2,2,0,4
50823,110,13345,18430;21131;21757;21975;22094;22387,33215,0,4,2,0,6
50824,110,13346,18433;21921;22388;22662,33215,1,2,1,0,4
50825,110,13347,18445;19027;21906;22128;23024,33215,1,2,2,0,5
50826,110,13348,18489;18590;21883;21981;22525,33215,0,3,2,0,5
50827,110,13349,18387;18513;21212;23002,33215,1,0,3,0,4
50828,110,13350,19051;21139;22918,33215,1,0,2,0,3
50829,110,13351,19083;21152;22567;22920,33215,1,1,2,0,4
50830,110,13352,18549;18638;21354;22535,33215,0,2,2,0,4
50831,110,13353,18339;18669;21090;21261;21650;22108;22204;22538,33215,0,4,4,0,8
50832,110,13354,18659;18678;22310;22790,33215,1,1,2,0,4
50833,110,13355,19147;19530;21094;22233;22329,33215,0,2,3,0,5
50834,110,13356,19040;21679;22130;22226,33215,0,3,1,0,4
50835,110,13357,18688;18704;22109;22540;22793,33215,1,2,2,0,5
50836,110,13358,18503;18741;22408,33215,0,1,2,0,3
50837,110,13359,18591;18747,33215,0,0,2,0,2
50838,110,13360,19038;19237;21153;21435;21837;22141;22813,33215,1,3,3,0,7
50839,110,13361,19101;22325;22701,33215,1,1,1,0,3
50840,110,13362,18779;21874,33215,0,1,1,0,2
50841,110,13363,18307;18602;22531;22784,33215,1,1,2,0,4
50842,110,13364,18728;18787;21370;21618;22008;22413,33215,0,4,2,0,6
50843,110,13365,18805;19121;21247;22442,33215,0,1,3,0,4
50844,110,13366,18795;18807;21791;21870;22009;22684,33215,1,3,2,0,6
50845,110,13367,18686;18797,33215,0,0,2,0,2
50846,110,13368,18842;18984,33215,0,0,2,0,2
50847,110,13369,18845;18865;21122;21451;22120;22544,33215,0,3,3,0,6
50848,110,13370,18723;18880,33215,0,0,2,0,2
50849,110,13371,18832;18892,33215,0,0,2,0,2
50850,110,13372,18902;19044,33215,0,0,2,0,2
50851,110,13373,18910;19271;22550,33215,0,1,2,0,3
50852,110,13375,13278,33580,0,0,0,1,1
50853,110,13376,13726,33580,0,0,0,1,1
50854,110,13377,13835,33580,0,0,0,1,1
50855,110,13379,14036,33580,0,0,0,1,1
50856,110,13381,13909,33580,0,0,0,1,1
50857,110,13385,14261,33580,0,0,0,1,1
50858,110,13389,14827,33580,0,0,0,1,1
50859,110,13391,14545,33580,0,0,0,1,1
50860,110,13394,15337,33580,0,0,0,1,1
50861,110,13395,14846;15171,33580,0,0,0,2,2
50862,110,13398,14852;15228,33580,0,0,0,2,2
50863,110,13405,15789;15896,33580,0,0,2,0,2
50864,110,13410,16854;17303;21336,33580,0,1,2,0,3
50865,110,13411,16979;17324;21692,33580,0,1,2,0,3
50866,110,13412,17235;17293;21216,33580,0,0,3,0,3
50867,110,13415,17030;17292,33580,0,0,2,0,2
50868,110,13418,17513;18026,33580,0,0,2,0,2
50869,110,13419,17275;17529;21242;21529,33580,0,1,3,0,4
50870,110,13422,17596;18150;21752,33580,0,1,2,0,3
50871,110,13423,17649;17885,33580,0,0,2,0,2
50872,110,13424,17438,33580,0,0,1,0,1
50873,110,13425,17631;18139,33580,0,0,2,0,2
50874,110,13426,17484;17817;21358;22063;22504,33580,0,3,2,0,5
50875,110,13427,17668;17853;21465;21666;22065,33580,0,3,2,0,5
50876,110,13428,17914;18351;21343;21448;22088,33580,0,3,2,0,5
50877,110,13429,17953;18008;21286;21493;22996,33580,1,1,3,0,5
50878,110,13430,18101;18236;21474,33580,0,1,2,0,3
50879,110,13432,18043;18368,33580,0,0,2,0,2
50880,110,13434,17993;21734;22070,33580,0,2,1,0,3
50881,110,13435,18159;18176;21793,33580,0,1,2,0,3
50882,110,13437,18204;18742,33580,0,0,2,0,2
50883,110,13438,18896;21901;22690;22909,33580,2,1,1,0,4
50884,110,13439,18271;18857;21369,33580,0,1,2,0,3
50885,110,13440,18298;18543;21175;21708;22299;22529,33580,0,3,3,0,6
50886,110,13441,18309;18470;21978,33580,0,1,2,0,3
50887,110,13442,18520;18583;21647,33580,0,1,2,0,3
50888,110,13443,18012;18327;21331;21969,33580,0,2,2,0,4
50889,110,13444,18344;18556;22300,33580,0,1,2,0,3
50890,110,13445,18364;18919;21627;22018;22218,33580,0,3,2,0,5
50891,110,13446,18191;18407;21191;21566;21739;22521;22660,33580,1,3,3,0,7
50892,110,13447,18360;18524;23003,33580,1,0,2,0,3
50893,110,13449,19073,33580,0,0,1,0,1
50894,110,13451,18540;18547;21661;21771,33580,0,2,2,0,4
50895,110,13452,19072;21410;22134,33580,0,2,1,0,3
50896,110,13453,18557;18559;21890;22896,33580,1,1,2,0,4
50897,110,13454,18566;18879;21740;22420,33580,0,2,2,0,4
50898,110,13456,18982;22021;22802;23023;23112,33580,3,1,1,0,5
50899,110,13457,18586,33580,0,0,1,0,1
50900,110,13458,18877,33580,0,0,1,0,1
50901,110,13459,18245;18631;21991,33580,0,1,2,0,3
50902,110,13460,18648;18874;22688;22907,33580,2,0,2,0,4
50903,110,13461,19141;23029,33580,1,0,1,0,2
50904,110,13462,18577;18630;21396;21577;21622;21995;22203;22534,33580,0,6,2,0,8
50905,110,13463,18624;18699;21723;22001,33580,0,2,2,0,4
50906,110,13464,18708;19064;21292;21704,33580,0,2,2,0,4
50907,110,13465,18217;18727;22004;22679;22794,33580,2,1,2,0,5
50908,110,13466,18895;19060;21254;22564,33580,0,1,3,0,4
50909,110,13467,18757;18894;21829;22795;23015,33580,2,1,2,0,5
50910,110,13468,18294;18793;21438;21808;22683,33580,1,2,2,0,5
50911,110,13469,18801;18904;22011;22414,33580,0,2,2,0,4
50912,110,13470,18815;21635;21810,33580,0,2,1,0,3
50913,110,13471,18821;19321;21277;22459;23125,33580,1,1,3,0,5
50914,110,13472,18830;22014,33580,0,1,1,0,2
50915,110,13473,19210;21467;22450;22574,33580,0,3,1,0,4
50916,110,13474,18836;18969;21189;21716;21755,33580,0,2,3,0,5
50917,110,13475,18945;21419;22221;22427;22692;22800,33580,2,3,1,0,6
50918,110,13476,18422;18848;21753;23017,33580,1,1,2,0,4
50919,110,13477,18967;19187;21590;23022,33580,1,1,2,0,4
50920,110,13478,18912;19004,33580,0,0,2,0,2
50921,110,13479,18970;19296;22125;22556,33580,0,2,2,0,4
50922,110,13480,18989;19261;22454;23032,33580,1,1,2,0,4
50923,110,13487,13891,33945,0,0,0,1,1
50924,110,13488,13724,33945,0,0,0,1,1
50925,110,13489,13787;14000,33945,0,0,0,2,2
50926,110,13490,14149,33945,0,0,0,1,1
50927,110,13491,14347,33945,0,0,0,1,1
50928,110,13497,14321,33945,0,0,0,1,1
50929,110,13498,14564;14728,33945,0,0,0,2,2
50930,110,13507,15576,33945,0,0,0,1,1
50931,110,13508,14814;15280,33945,0,0,0,2,2
50932,110,13510,15832;15837,33945,0,0,2,0,2
50933,110,13524,16829;16870;21411,33945,0,1,2,0,3
50934,110,13525,16172;16919;21407,33945,0,1,2,0,3
50935,110,13528,16794,33945,0,0,1,0,1
50936,110,13529,17178;17428,33945,0,0,2,0,2
50937,110,13532,17290;18201;21959;22185,33945,0,2,2,0,4
50938,110,13536,17633,33945,0,0,1,0,1
50939,110,13538,17446;17793;21574;21763;22375,33945,0,3,2,0,5
50940,110,13539,18261,33945,0,0,1,0,1
50941,110,13540,17881;18529,33945,0,0,2,0,2
50942,110,13541,17897;18188,33945,0,0,2,0,2
50943,110,13542,17981,33945,0,0,1,0,1
50944,110,13544,17702,33945,0,0,1,0,1
50945,110,13545,18057;18145;21339;21701,33945,0,2,2,0,4
50946,110,13546,18069;18182,33945,0,0,2,0,2
50947,110,13547,18080;18399;21656,33945,0,1,2,0,3
50948,110,13548,18124;18380;22193;22781,33945,1,1,2,0,4
50949,110,13549,18218;18466;21604;21659,33945,0,2,2,0,4
50950,110,13550,18325;18332,33945,0,0,2,0,2
50951,110,13551,18386;18672;21846;21997,33945,0,2,2,0,4
50952,110,13552,18817;18875;21508;21758;22908,33945,1,2,2,0,5
50953,110,13553,18484;18944;22124;23021,33945,1,1,2,0,4
50954,110,13555,18497;19129;22571;22807,33945,1,1,2,0,4
50955,110,13556,18563;18782;21821,33945,0,1,2,0,3
50956,110,13557,18589;18652;21993;22562;22788;22899,33945,2,2,2,0,6
50957,110,13559,18635;18753;21514,33945,0,1,2,0,3
50958,110,13560,18676;19132;22921,33945,1,0,2,0,3
50959,110,13561,18679;19096;21741,33945,0,1,2,0,3
50960,110,13562,18653;18718;21398;21644,33945,0,2,2,0,4
50961,110,13563,19280;21774;22243;22336,33945,0,3,1,0,4
50962,110,13564,18709;21717;22206,33945,0,2,1,0,3
50963,110,13565,18570;18739;21592;22897,33945,1,1,2,0,4
50964,110,13566,19521;22830;22955,33945,2,0,1,0,3
50965,110,13567,18193;18762;21806,33945,0,1,2,0,3
50966,110,13568,18764;19017;21572;22225,33945,0,2,2,0,4
50967,110,13569,18773;19541;22250;22601;22833,33945,1,2,2,0,5
50968,110,13570,18922;22320,33945,0,1,1,0,2
50969,110,13571,18455;18899;21845;22691,33945,1,1,2,0,4
50970,110,13572,18628;18885;22421;22689,33945,1,1,2,0,4
50971,110,13573,18733;18926;22019;22219,33945,0,2,2,0,4
50972,110,13574,18519;18949;22693,33945,1,0,2,0,3
50973,110,13575,18936;18955;21693;22430;22554,33945,0,3,2,0,5
50974,110,13576,18715;18959;22112;23012,33945,1,1,2,0,4
50975,110,13577,18961;23111,33945,1,0,1,0,2
50976,110,13578,18965;19093,33945,0,0,2,0,2
50977,110,13579,18572;18988,33945,0,0,2,0,2
50978,110,13580,19022;19229;22928,33945,1,0,2,0,3
50979,110,13581,18837;19046;22698;22917,33945,2,0,2,0,4
50980,110,13582,19047;22437;23115,33945,1,1,1,0,3
50981,110,13583,18737;19049;21636,33945,0,1,2,0,3
50982,110,13584,18914;19053;21489;21858;22122;22424;22798;23019,33945,2,4,2,0,8
50983,110,13585,19068;22133;22324;23116,33945,1,2,1,0,4
50984,110,13586,19069;19145;21681;23030,33945,1,1,2,0,4
50985,110,13587,19218;19494;21378;21706;22044;22475;23046,33945,1,4,2,0,7
50986,110,13588,19082;19311;21583;22457;23123,33945,1,2,2,0,5
50987,110,13589,18841;19094;21504,33945,0,1,2,0,3
50988,110,13590,19097;19458,33945,0,0,2,0,2
50989,110,13591,19109;19364;21373;21657,33945,0,2,2,0,4
50990,110,13592,18800;19119,33945,0,0,2,0,2
50991,110,13593,19123;19312;21503;21697;22458,33945,0,3,2,0,5
50992,110,13594,18696;19136;22028;22137,33945,0,2,2,0,4
50993,110,13595,18822;19137;22138;22444;22922,33945,1,2,2,0,5
50994,110,13596,19143;19160;22139;22809,33945,1,1,2,0,4
50995,110,13597,19173;19196;21869;22032,33945,0,2,2,0,4
50996,110,13598,19492;21512;22474;22727,33945,1,2,1,0,4
50997,110,13599,13986,34310,0,0,0,1,1
50998,110,13600,13753,34310,0,0,0,1,1
50999,110,13601,14028,34310,0,0,0,1,1
51000,110,13602,14047,34310,0,0,0,1,1
51001,110,13604,14304,34310,0,0,0,1,1
51002,110,13605,14027,34310,0,0,0,1,1
51003,110,13609,14609,34310,0,0,0,1,1
51004,110,13610,14734;14937,34310,0,0,0,2,2
51005,110,13614,14922,34310,0,0,0,1,1
51006,110,13615,14952;15135,34310,0,0,0,2,2
51007,110,13618,15488,34310,0,0,0,1,1
51008,110,13622,15839;15949,34310,0,0,2,0,2
51009,110,13623,16045,34310,0,0,1,0,1
51010,110,13624,15766;16067,34310,0,0,2,0,2
51011,110,13631,16433,34310,0,0,1,0,1
51012,110,13635,16765,34310,0,0,1,0,1
51013,110,13638,16999;17103,34310,0,0,2,0,2
51014,110,13640,16907;17291;21541,34310,0,1,2,0,3
51015,110,13641,17701,34310,0,0,1,0,1
51016,110,13643,17924;18263;22084,34310,0,1,2,0,3
51017,110,13645,17251;17842;21548;21818,34310,0,2,2,0,4
51018,110,13646,17905;21668;21891,34310,0,2,1,0,3
51019,110,13647,18113;18318;22291,34310,0,1,2,0,3
51020,110,13648,17910;18125;21951,34310,0,1,2,0,3
51021,110,13649,17814;18127,34310,0,0,2,0,2
51022,110,13650,17961,34310,0,0,1,0,1
51023,110,13651,17636;18036,34310,0,0,2,0,2
51024,110,13653,18194;18768;21605,34310,0,1,2,0,3
51025,110,13654,18732;18930;21584;21654,34310,0,2,2,0,4
51026,110,13655,18207;18337,34310,0,0,2,0,2
51027,110,13656,18273;18350,34310,0,0,2,0,2
51028,110,13657,18355;18508;21612;22895,34310,1,1,2,0,4
51029,110,13658,18365;18522;21825,34310,0,1,2,0,3
51030,110,13659,18129;18538;22528,34310,0,1,2,0,3
51031,110,13660,18395;18567,34310,0,0,2,0,2
51032,110,13661,18329;18476;21531;21979;22295;22524,34310,0,4,2,0,6
51033,110,13662,18458;19015;22024,34310,0,1,2,0,3
51034,110,13663,18460;18781,34310,0,0,2,0,2
51035,110,13664,18474,34310,0,0,1,0,1
51036,110,13665,18409;18477;21499;21809;21980,34310,0,3,2,0,5
51037,110,13667,18571;18744;21412;22210,34310,0,2,2,0,4
51038,110,13668,18504;18574;22526;22894,34310,1,1,2,0,4
51039,110,13669,18568;18878,34310,0,0,2,0,2
51040,110,13670,18665;19052;22227;22438,34310,0,2,2,0,4
51041,110,13671,18276;18664;21965,34310,0,1,2,0,3
51042,110,13672,18680;19356;21889;22592,34310,0,2,2,0,4
51043,110,13673,19128;19256,34310,0,0,2,0,2
51044,110,13674,19319;22585;22713,34310,1,1,1,0,3
51045,110,13675,18444;18585;22303;23006,34310,1,1,2,0,4
51046,110,13676,18772;19008;22435,34310,0,1,2,0,3
51047,110,13678,18802;19007,34310,0,0,2,0,2
51048,110,13681,18367;18825;21686;21860;22118;22415,34310,0,4,2,0,6
51049,110,13682,18849;18863;22016;22215;22318,34310,0,3,2,0,5
51050,110,13683,18881;19135;22327,34310,0,1,2,0,3
51051,110,13684,18809;18898;22797,34310,1,0,2,0,3
51052,110,13685,18916;18992;22558;22803,34310,1,1,2,0,4
51053,110,13686,18921;19150;22235,34310,0,1,2,0,3
51054,110,13687,18871;18927;22123,34310,0,1,2,0,3
51055,110,13688,18891;18942;21562;22552,34310,0,2,2,0,4
51056,110,13689,18576;18850;22904,34310,1,0,2,0,3
51057,110,13690,18968;19546;21672;22479,34310,0,2,2,0,4
51058,110,13691,18980;19411;21409;21676;22467,34310,0,3,2,0,5
51059,110,13692,18993;19478;22023;22224;23113,34310,1,2,2,0,5
51060,110,13693,18996;19551;23049,34310,1,0,2,0,3
51061,110,13694,19555,34310,0,0,1,0,1
51062,110,13695,19014;19389,34310,0,0,2,0,2
51063,110,13696,18908;19023;22127;22804,34310,1,1,2,0,4
51064,110,13697,19032;19431;22719;22827,34310,2,0,2,0,4
51065,110,13698,18803;19036,34310,0,0,2,0,2
51066,110,13699,18603;19043;22916;23026;23114,34310,3,0,2,0,5
51067,110,13700,19504;19596;21827,34310,0,1,2,0,3
51068,110,13701,19260;21651;22143;22453,34310,0,3,1,0,4
51069,110,13702,19134;19393;21816;22466,34310,0,2,2,0,4
51070,110,13703,18966;19172;21521;22031;22448;22812,34310,1,3,2,0,6
51071,110,13704,19157;19191;22704;22924,34310,2,0,2,0,4
51072,110,13705,19011;19192;21641;21907,34310,0,2,2,0,4
51073,110,13707,19471;22828,34310,1,0,1,0,2
51074,110,13708,19230;19449;21843;22469,34310,0,2,2,0,4
51075,110,13709,19234;19322;21700;22587;22938,34310,1,2,2,0,5
51076,110,13710,18824;19215;22451;22926,34310,1,1,2,0,4
51077,110,13711,19278;19516,34310,0,0,2,0,2
51078,110,13712,18759;19281;22816,34310,1,0,2,0,3
51079,110,13713,19276;19282;22242;22933,34310,1,1,2,0,4
51080,110,13714,19293;22455,34310,0,1,1,0,2
51081,110,13715,19303;19304;21903;22818;23122,34310,2,1,2,0,5
51082,110,13716,14141;14384,34675,0,0,0,2,2
51083,110,13717,13400,34675,0,0,0,1,1
51084,110,13719,14288,34675,0,0,0,1,1
51085,110,13720,14094,34675,0,0,0,1,1
51086,110,13721,14020,34675,0,0,0,1,1
51087,110,13724,14870,34675,0,0,0,1,1
51088,110,13731,14943;15236,34675,0,0,0,2,2
51089,110,13736,15036;15210,34675,0,0,0,2,2
51090,110,13737,15666,34675,0,0,1,0,1
51091,110,13739,15997,34675,0,0,1,0,1
51092,110,13741,15912;16026,34675,0,0,2,0,2
51093,110,13744,16340,34675,0,0,1,0,1
51094,110,13747,16769,34675,0,0,1,0,1
51095,110,13748,16893,34675,0,0,1,0,1
51096,110,13750,16971,34675,0,0,1,0,1
51097,110,13755,17169,34675,0,0,1,0,1
51098,110,13757,16539;17409,34675,0,0,2,0,2
51099,110,13759,17361;17412;21917,34675,0,1,2,0,3
51100,110,13761,17730;17928,34675,0,0,2,0,2
51101,110,13764,18082;18119;22282,34675,0,1,2,0,3
51102,110,13765,18086;18362;22192,34675,0,1,2,0,3
51103,110,13766,17843;18055;21947,34675,0,1,2,0,3
51104,110,13768,18314;21967,34675,0,1,1,0,2
51105,110,13769,18257;18370;21908,34675,0,1,2,0,3
51106,110,13770,18100;18440,34675,0,0,2,0,2
51107,110,13771,18449,34675,0,0,1,0,1
51108,110,13772,18071;18498;21835;22297,34675,0,2,2,0,4
51109,110,13773,18553;18840;22119;22417,34675,0,2,2,0,4
51110,110,13774,18595;21789;22105;22304;22670;22898,34675,2,3,1,0,6
51111,110,13775,18056;18616;22785,34675,1,0,2,0,3
51112,110,13776,18253,34675,0,0,1,0,1
51113,110,13777,18647;18788,34675,0,0,2,0,2
51114,110,13778,18545;18695;21804;22000;22791,34675,1,2,2,0,5
51115,110,13779,18767;19104;22702,34675,1,0,2,0,3
51116,110,13780,18776;18791,34675,0,0,2,0,2
51117,110,13781,18794;19198;22330,34675,0,1,2,0,3
51118,110,13782,18796,34675,0,0,1,0,1
51119,110,13784,18692;18855;21748;22545;22906,34675,1,2,2,0,5
51120,110,13785,18789;18860;22121;22418;23018,34675,1,2,2,0,5
51121,110,13787,18724;19078;21660;21839;22135,34675,0,3,2,0,5
51122,110,13788,18937;19130;22910,34675,1,0,2,0,3
51123,110,13789,19259;22241;22931,34675,1,1,1,0,3
51124,110,13790,18856;19029;22129;22561;23025,34675,1,2,2,0,5
51125,110,13791,18579;19048;22131,34675,0,1,2,0,3
51126,110,13792,19166;22140;22811,34675,1,1,1,0,3
51127,110,13793,19071;19289;21530;21780,34675,0,2,2,0,4
51128,110,13794,18903;19074;22423,34675,0,1,2,0,3
51129,110,13795,19374,34675,0,0,1,0,1
51130,110,13796,19120;19349,34675,0,0,2,0,2
51131,110,13797,19115;19126;23117,34675,1,0,2,0,3
51132,110,13798,19153;21682;22446,34675,0,2,1,0,3
51133,110,13799,19019;19177;21578;22572,34675,0,2,2,0,4
51134,110,13800,19211;19391;22041;22945,34675,1,1,2,0,4
51135,110,13801,19221;19633,34675,0,0,2,0,2
51136,110,13802,18811;19224;21732;22332,34675,0,2,2,0,4
51137,110,13803,19181;19228;22333,34675,0,1,2,0,3
51138,110,13804,19031;19283;22582;23034;23121,34675,2,1,2,0,5
51139,110,13805,19298;22583,34675,0,1,1,0,2
51140,110,13807,19307;19578,34675,0,0,2,0,2
51141,110,13808,19412,34675,0,0,1,0,1
51142,110,13809,19310;19437;22152;22721;23042,34675,2,1,2,0,5
51143,110,13810,18523;19320;21807;22586;22937,34675,1,2,2,0,5
51144,110,13811,19350;21833;22039;22591;23036;23127,34675,2,3,1,0,6
51145,110,13812,18886;19353;21561,34675,0,1,2,0,3
51146,110,13813,19385;22716;23131,34675,2,0,1,0,3
51147,110,13814,19275;19440;21880;22595,34675,0,2,2,0,4
51148,110,13815,19495;19509;21599;23136,34675,1,1,2,0,4
51149,110,13816,19382;19733;21500;23063,34675,1,1,2,0,4
51150,110,13817,13773,35040,0,0,0,1,1
51151,110,13818,13745,35040,0,0,0,1,1
51152,110,13821,14656;14897,35040,0,0,0,2,2
51153,110,13822,14783,35040,0,0,0,1,1
51154,110,13825,14962,35040,0,0,0,1,1
51155,110,13826,15001;15250,35040,0,0,0,2,2
51156,110,13828,14855,35040,0,0,0,1,1
51157,110,13829,15159,35040,0,0,0,1,1
51158,110,13830,15276,35040,0,0,0,1,1
51159,110,13835,15412;15662,35040,0,0,1,1,2
51160,110,13837,15847,35040,0,0,1,0,1
51161,110,13839,16163,35040,0,0,1,0,1
51162,110,13840,15545,35040,0,0,0,1,1
51163,110,13842,16221,35040,0,0,1,0,1
51164,110,13844,16567;16775,35040,0,0,2,0,2
51165,110,13849,17043;17092,35040,0,0,2,0,2
51166,110,13851,17261;17295,35040,0,0,2,0,2
51167,110,13856,17676;17922,35040,0,0,2,0,2
51168,110,13860,18027;22073,35040,0,1,1,0,2
51169,110,13862,18473;18632;22197,35040,0,1,2,0,3
51170,110,13864,18172;18509;22184,35040,0,1,2,0,3
51171,110,13865,18315;18526;21984,35040,0,1,2,0,3
51172,110,13866,18656;21994;22403;22675,35040,1,2,1,0,4
51173,110,13868,18388;19252;22578,35040,0,1,2,0,3
51174,110,13870,18406;19266;21865;22144,35040,0,2,2,0,4
51175,110,13871,18421;18808,35040,0,0,2,0,2
51176,110,13872,18268;18439;21705;21976,35040,0,2,2,0,4
51177,110,13873,18441;18661;22107;22308;22404,35040,0,3,2,0,5
51178,110,13874,18448;18480,35040,0,0,2,0,2
51179,110,13875,18451,35040,0,0,1,0,1
51180,110,13876,18234;18463,35040,0,0,2,0,2
51181,110,13877,18492;22097,35040,0,1,1,0,2
51182,110,13878,18391;18500,35040,0,0,2,0,2
51183,110,13879,18326,35040,0,0,1,0,1
51184,110,13880,18363;19067;22027;22566,35040,0,2,2,0,4
51185,110,13881,18859;22686;22796,35040,2,0,1,0,3
51186,110,13882,18552;21857;22397,35040,0,2,1,0,3
51187,110,13884,18487;18606;21805;22392,35040,0,2,2,0,4
51188,110,13885,18660;18872;22419,35040,0,1,2,0,3
51189,110,13886,18693;21868;22205,35040,0,2,1,0,3
51190,110,13887,18132;18611,35040,0,0,2,0,2
51191,110,13888,18424;18707;22111;22677,35040,1,1,2,0,4
51192,110,13889,18710;22003,35040,0,1,1,0,2
51193,110,13890,18775;18986;22117;22412,35040,0,2,2,0,4
51194,110,13891,18228;18799;22010,35040,0,1,2,0,3
51195,110,13892,18934;19483;21760;22344,35040,0,2,2,0,4
51196,110,13893,18951;22222,35040,0,1,1,0,2
51197,110,13894,18952;22428;22553,35040,0,2,1,0,3
51198,110,13895,18436;18974,35040,0,0,2,0,2
51199,110,13896,19003;19486;22726,35040,1,0,2,0,3
51200,110,13897,19342;21713,35040,0,1,1,0,2
51201,110,13898,19009;19236,35040,0,0,2,0,2
51202,110,13899,19018;19041;22025,35040,0,1,2,0,3
51203,110,13900,19025;19333;22589;22939,35040,1,1,2,0,4
51204,110,13901,19246;19661;22605,35040,0,1,2,0,3
51205,110,13902,18818;19075;21871,35040,0,1,2,0,3
51206,110,13903,19088;19476;22343,35040,0,1,2,0,3
51207,110,13904,18713;19056;22563,35040,0,1,2,0,3
51208,110,13905,19117;19610;21702,35040,0,1,2,0,3
51209,110,13906,18888;19139;22328,35040,0,1,2,0,3
51210,110,13907,18983;19140;21799;22029,35040,0,2,2,0,4
51211,110,13908,19171;19323;22460;22714,35040,1,1,2,0,4
51212,110,13909,19206;19579;21790;22960,35040,1,1,2,0,4
51213,110,13910,18935;19209;22449;22705,35040,1,1,2,0,4
51214,110,13911,19213;19316;22147;22244;22711;22936,35040,2,2,2,0,6
51215,110,13912,19219;19405;22824,35040,1,0,2,0,3
51216,110,13913,19233;19531,35040,0,0,2,0,2
51217,110,13914,18889;19240;22240;22814;22929,35040,2,1,2,0,5
51218,110,13917,19268;21831;22145;22581,35040,0,3,1,0,4
51219,110,13918,19286;19748,35040,0,0,2,0,2
51220,110,13919,19294;21699;22146;22456,35040,0,3,1,0,4
51221,110,13920,19590,35040,0,0,1,0,1
51222,110,13921,19317;19386;22712,35040,1,0,2,0,3
51223,110,13922,19375;19644;23054,35040,1,0,2,0,3
51224,110,13923,19377;22151;22464;23039,35040,1,2,1,0,4
51225,110,13924,19203;19383;22943,35040,1,0,2,0,3
51226,110,13925,19338;19400,35040,0,0,2,0,2
51227,110,13927,19629;19649,35040,0,0,2,0,2
51228,110,13928,19057;19532;22831,35040,1,0,2,0,3
51229,110,13929,19542;22478;23140,35040,1,1,1,0,3
51230,110,13930,19279;19552;22834,35040,1,0,2,0,3
51231,110,13931,19183;19668;23057,35040,1,0,2,0,3
51232,110,13932,19567;19872,35040,0,0,2,0,2
51233,110,13933,14298,35405,0,0,0,1,1
51234,110,13934,14549,35405,0,0,0,1,1
51235,110,13935,14506,35405,0,0,0,1,1
51236,110,13936,14633,35405,0,0,0,1,1
51237,110,13937,14551,35405,0,0,0,1,1
51238,110,13938,14901,35405,0,0,0,1,1
51239,110,13940,15156,35405,0,0,0,1,1
51240,110,13942,15356;15693,35405,0,0,1,1,2
51241,110,13943,15382,35405,0,0,0,1,1
51242,110,13945,14861;15173,35405,0,0,0,2,2
51243,110,13949,15838;15922,35405,0,0,2,0,2
51244,110,13952,16231,35405,0,0,1,0,1
51245,110,13955,16144;16363,35405,0,0,2,0,2
51246,110,13960,17180,35405,0,0,1,0,1
51247,110,13966,17153,35405,0,0,1,0,1
51248,110,13968,17477,35405,0,0,1,0,1
51249,110,13970,17252,35405,0,0,1,0,1
51250,110,13971,17831;21786;22272,35405,0,2,1,0,3
51251,110,13974,18531;22102,35405,0,1,1,0,2
51252,110,13975,18266;22517;22656,35405,1,1,1,0,3
51253,110,13976,17775;17808;21913,35405,0,1,2,0,3
51254,110,13977,18030;21782;21946,35405,0,2,1,0,3
51255,110,13978,17725;17754;22648,35405,1,0,2,0,3
51256,110,13979,18051;18250,35405,0,0,2,0,2
51257,110,13980,17864;18065;21783;22650;22772,35405,2,1,2,0,5
51258,110,13981,18087;18581;22668;23005,35405,2,0,2,0,4
51259,110,13982,18270;18442;21977;22999,35405,1,1,2,0,4
51260,110,13983,18272;19247,35405,0,0,2,0,2
51261,110,13984,18285;18324;21968;22383;22889,35405,1,2,2,0,5
51262,110,13985,18117;18333,35405,0,0,2,0,2
51263,110,13986,18349,35405,0,0,1,0,1
51264,110,13987,18152;18369;22778,35405,1,0,2,0,3
51265,110,13989,18220;18379;21800;21914;22659;22780,35405,2,2,2,0,6
51266,110,13990,18416;18953;22429;22801,35405,1,1,2,0,4
51267,110,13991,18443;18703;22406,35405,0,1,2,0,3
51268,110,13992,18464;18662;21745;21996;22405,35405,0,3,2,0,5
51269,110,13993,18485;18521;22783,35405,1,0,2,0,3
51270,110,13995,18534;18769;22005;22113,35405,0,2,2,0,4
51271,110,13996,18594;19089;21792;22230;22439,35405,0,3,2,0,5
51272,110,13997,18411;18621;21990,35405,0,1,2,0,3
51273,110,13999,18682,35405,0,0,1,0,1
51274,110,14000,19454;19455;22470;22725;22950;23134,35405,3,1,2,0,6
51275,110,14002,18593;18748;22541,35405,0,1,2,0,3
51276,110,14003,18760;19001;22560,35405,0,1,2,0,3
51277,110,14004,18870;19107,35405,0,0,2,0,2
51278,110,14005,18917;18939,35405,0,0,2,0,2
51279,110,14006,18975;22433,35405,0,1,1,0,2
51280,110,14007,18780;18985;22022,35405,0,1,2,0,3
51281,110,14008,19084;19696;22162;22968,35405,1,1,2,0,4
51282,110,14009,19086;19768;22970,35405,1,0,2,0,3
51283,110,14010,19098;19741;22355,35405,0,1,2,0,3
51284,110,14011,19100;19178;22440,35405,0,1,2,0,3
51285,110,14012,18792;19133;22443,35405,0,1,2,0,3
51286,110,14013,19604;19697,35405,0,0,2,0,2
51287,110,14014,19080;19148,35405,0,0,2,0,2
51288,110,14015,18854;22905,35405,1,0,1,0,2
51289,110,14016,19176;19358;22246,35405,0,1,2,0,3
51290,110,14017,18869;19180,35405,0,0,2,0,2
51291,110,14018,19201;19475;22342,35405,0,1,2,0,3
51292,110,14019,19654;19774;22738,35405,1,0,2,0,3
51293,110,14021,19255;19285;21746;23035,35405,1,1,2,0,4
51294,110,14022,19329;19878,35405,0,0,2,0,2
51295,110,14023,19336;19576;22959,35405,1,0,2,0,3
51296,110,14024,18876;19339;22245;22339,35405,0,2,2,0,4
51297,110,14026,19390;19824;21849;23066,35405,1,1,2,0,4
51298,110,14027,18605;19401;22718;22946,35405,2,0,2,0,4
51299,110,14028,19408,35405,0,0,1,0,1
51300,110,14029,18671;19417;23041,35405,1,0,2,0,3
51301,110,14030,19396;19453;22154;22341;22949;23043,35405,2,2,2,0,6
51302,110,14031,19473;19498,35405,0,0,2,0,2
51303,110,14032,19482;19974,35405,0,0,2,0,2
51304,110,14033,19491;22473,35405,0,1,1,0,2
51305,110,14034,19503;21866;22345;22728;23138,35405,2,2,1,0,5
51306,110,14035,19616;19669,35405,0,0,2,0,2
51307,110,14037,19334;19420;22825,35405,1,0,2,0,3
51308,110,14038,19443;19493;22153;22468;22722,35405,1,2,2,0,5
51309,110,14039,19263;19771;22847,35405,1,0,2,0,3
51310,110,14040,19512;19553;21897;22251;23141,35405,1,2,2,0,5
51311,110,14041,18998;19875;21861,35405,0,1,2,0,3
51312,110,14042,19461;19556,35405,0,0,2,0,2
51313,110,14043,19300;19564;21795,35405,0,1,2,0,3
51314,110,14044,19572;19612;22837;22962,35405,2,0,2,0,4
51315,110,14045,19589;19716;22609;23148,35405,1,1,2,0,4
51316,110,14046,19605;19712;22735,35405,1,0,2,0,3
51317,110,14048,19460;19751;21751;21851;22050;22969,35405,1,3,2,0,6
51318,110,14049,19934,35405,0,0,1,0,1
51319,110,14050,19092;19609,35405,0,0,2,0,2
51320,110,14051,19557;19595;22047;22835,35405,1,1,2,0,4
51321,110,14052,14085,35770,0,0,0,1,1
51322,110,14053,14715,35770,0,0,0,1,1
51323,110,14054,14257,35770,0,0,0,1,1
51324,110,14055,14236,35770,0,0,0,1,1
51325,110,14057,14111,35770,0,0,0,1,1
51326,110,14058,14942,35770,0,0,0,1,1
51327,110,14059,15000;15372,35770,0,0,0,2,2
51328,110,14060,15079;15667,35770,0,0,1,1,2
51329,110,14065,15257,35770,0,0,0,1,1
51330,110,14066,14531,35770,0,0,0,1,1
51331,110,14067,15410,35770,0,0,0,1,1
51332,110,14069,14720,35770,0,0,0,1,1
51333,110,14071,15718;16019,35770,0,0,2,0,2
51334,110,14072,15750;15970,35770,0,0,2,0,2
51335,110,14074,16089,35770,0,0,1,0,1
51336,110,14082,17225;17724,35770,0,0,2,0,2
51337,110,14084,17366,35770,0,0,1,0,1
51338,110,14085,17450,35770,0,0,1,0,1
51339,110,14086,17933,35770,0,0,1,0,1
51340,110,14088,18382;22090,35770,0,1,1,0,2
51341,110,14089,17806,35770,0,0,1,0,1
51342,110,14090,17829;17997,35770,0,0,2,0,2
51343,110,14091,17693;17809,35770,0,0,2,0,2
51344,110,14092,18681;18685;23107,35770,1,0,2,0,3
51345,110,14093,18112;18446,35770,0,0,2,0,2
51346,110,14094,18292;18826;22315;22416,35770,0,2,2,0,4
51347,110,14095,17564;18303;22998,35770,1,0,2,0,3
51348,110,14096,18701,35770,0,0,1,0,1
51349,110,14097,17863;18418;21974;22386;22661,35770,1,2,2,0,5
51350,110,14098,19384;22944,35770,1,0,1,0,2
51351,110,14099,18525;18798,35770,0,0,2,0,2
51352,110,14100,18582;19039;22323,35770,0,1,2,0,3
51353,110,14101,18640;22536;23106,35770,1,1,1,0,3
51354,110,14102,18625;22400;23008,35770,1,1,1,0,3
51355,110,14103,18719,35770,0,0,1,0,1
51356,110,14105,18790;18963;22223;22696,35770,1,1,2,0,4
51357,110,14106,18810;18960,35770,0,0,2,0,2
51358,110,14107,18467;18844;22317,35770,0,1,2,0,3
51359,110,14109,18542;18943;22799,35770,1,0,2,0,3
51360,110,14110,18973;19305;22709,35770,1,0,2,0,3
51361,110,14112,19055;19529,35770,0,0,2,0,2
51362,110,14113,18823;19146,35770,0,0,2,0,2
51363,110,14114,19220;19232,35770,0,0,2,0,2
51364,110,14115,19179;19243;22142;22577;23031,35770,1,2,2,0,5
51365,110,14116,19244;19753,35770,0,0,2,0,2
51366,110,14117,19798;19969,35770,0,0,2,0,2
51367,110,14119,18814;19277;22035;23033,35770,1,1,2,0,4
51368,110,14120,19295;19681,35770,0,0,2,0,2
51369,110,14121,19325;19585;22461;22588,35770,0,2,2,0,4
51370,110,14122,19343;19993;23074,35770,1,0,2,0,3
51371,110,14123,18923;19360;22149;22593,35770,0,2,2,0,4
51372,110,14124,19302;22817;22935,35770,2,0,1,0,3
51373,110,14125,19370;19388;22820;23038;23130,35770,3,0,2,0,5
51374,110,14126,19409;19734;22612,35770,0,1,2,0,3
51375,110,14127,19430;19533,35770,0,0,2,0,2
51376,110,14128,19891;23069,35770,1,0,1,0,2
51377,110,14129,18940;19421;22826,35770,1,0,2,0,3
51378,110,14130,19432,35770,0,0,1,0,1
51379,110,14131,19462;19657;22965,35770,1,0,2,0,3
51380,110,14132,19249;19470;22155,35770,0,1,2,0,3
51381,110,14133,19554;19699;22352,35770,0,1,2,0,3
51382,110,14134,19484;19543;22158,35770,0,1,2,0,3
51383,110,14135,19161;19511;22729,35770,1,0,2,0,3
51384,110,14136,19514;19776;22971,35770,1,0,2,0,3
51385,110,14137,19195;19759,35770,0,0,2,0,2
51386,110,14138,19539;19791;22600;22832,35770,1,1,2,0,4
51387,110,14139,19558;19809,35770,0,0,2,0,2
51388,110,14140,19258;19573;22602,35770,0,1,2,0,3
51389,110,14141,19602;19635;21893;23053,35770,1,1,2,0,4
51390,110,14142,19466;19790;21856;23065,35770,1,1,2,0,4
51391,110,14143,19066;19099;22568;22700;22805,35770,2,1,2,0,5
51392,110,14144,19680;22842,35770,1,0,1,0,2
51393,110,14145,19664;19682;22484;23145,35770,1,1,2,0,4
51394,110,14146,19362;19844;22488;22616,35770,0,2,2,0,4
51395,110,14147,19125;19703,35770,0,0,2,0,2
51396,110,14148,19357;19718;23059,35770,1,0,2,0,3
51397,110,14149,19837;19884;21887;22615;22849;23067,35770,2,2,2,0,6
51398,110,14150,19738;19914,35770,0,0,2,0,2
51399,110,14151,19980;22860,35770,1,0,1,0,2
51400,110,14152,19769;19800;23151,35770,1,0,2,0,3
51401,110,14153,19775;20027;21832;22752,35770,1,1,2,0,4
51402,110,14154,14486,36135,0,0,0,1,1
51403,110,14156,14105,36135,0,0,0,1,1
51404,110,14157,14775,36135,0,0,0,1,1
51405,110,14159,15042,36135,0,0,0,1,1
51406,110,14160,15066,36135,0,0,0,1,1
51407,110,14161,15162,36135,0,0,0,1,1
51408,110,14162,15248;15822,36135,0,0,1,1,2
51409,110,14166,15377,36135,0,0,0,1,1
51410,110,14168,15694;15708,36135,0,0,2,0,2
51411,110,14169,15272,36135,0,0,0,1,1
51412,110,14170,15591;15895,36135,0,0,1,1,2
51413,110,14171,15844;16421,36135,0,0,2,0,2
51414,110,14173,15825;16032,36135,0,0,2,0,2
51415,110,14178,16106,36135,0,0,1,0,1
51416,110,14179,15587;15816,36135,0,0,1,1,2
51417,110,14180,16581;16760,36135,0,0,2,0,2
51418,110,14185,17134,36135,0,0,1,0,1
51419,110,14192,17553,36135,0,0,1,0,1
51420,110,14194,17734,36135,0,0,1,0,1
51421,110,14195,17771;18169,36135,0,0,2,0,2
51422,110,14198,17987,36135,0,0,1,0,1
51423,110,14201,18420;19254;22579;22930,36135,1,1,2,0,4
51424,110,14203,18341;18933;22020;22551;23020,36135,1,2,2,0,5
51425,110,14205,18414;18468;22196,36135,0,1,2,0,3
51426,110,14206,18546;19267;22334;22932,36135,1,1,2,0,4
51427,110,14207,18853;18956,36135,0,0,2,0,2
51428,110,14211,18929;19599;22347;22480;23052,36135,1,2,2,0,5
51429,110,14212,18954;19189;22034;22925,36135,1,1,2,0,4
51430,110,14213,18995;19732;22845,36135,1,0,2,0,3
51431,110,14214,19024;19105,36135,0,0,2,0,2
51432,110,14215,18990;19045,36135,0,0,2,0,2
51433,110,14216,19005;19422,36135,0,0,2,0,2
51434,110,14218,19062;19783;22739,36135,1,0,2,0,3
51435,110,14219,18528;19154,36135,0,0,2,0,2
51436,110,14220,19155;19601,36135,0,0,2,0,2
51437,110,14221,19212;22238;22575,36135,0,2,1,0,3
51438,110,14222,19106;19284;22232;22569,36135,0,2,2,0,4
51439,110,14223,19163;19346;22715,36135,1,0,2,0,3
51440,110,14225,19306,36135,0,0,1,0,1
51441,110,14226,19197;19328,36135,0,0,2,0,2
51442,110,14227,19335,36135,0,0,1,0,1
51443,110,14228,19185;19351;23037;23128,36135,2,0,2,0,4
51444,110,14229,19058;19355;22040,36135,0,1,2,0,3
51445,110,14230,19238;19369;22150;22463,36135,0,2,2,0,4
51446,110,14231,19427;19641;22839,36135,1,0,2,0,3
51447,110,14232,19545;19860,36135,0,0,2,0,2
51448,110,14233,19587;20047;23077,36135,1,0,2,0,3
51449,110,14234,19617;19963,36135,0,0,2,0,2
51450,110,14236,19663;19803;22973,36135,1,0,2,0,3
51451,110,14237,19707;19909,36135,0,0,2,0,2
51452,110,14238,19721;19793,36135,0,0,2,0,2
51453,110,14239,19076;19724;23062,36135,1,0,2,0,3
51454,110,14240,19737;19743;23064,36135,1,0,2,0,3
51455,110,14241,19347;19744,36135,0,0,2,0,2
51456,110,14242,19750;20133;22864,36135,1,0,2,0,3
51457,110,14243,19686;19762;22734,36135,1,0,2,0,3
51458,110,14244,19802;19965,36135,0,0,2,0,2
51459,110,14245,19810;19950,36135,0,0,2,0,2
51460,110,14246,19813;20064,36135,0,0,2,0,2
51461,110,14247,19826;20036,36135,0,0,2,0,2
51462,110,14248,19829;20364,36135,0,0,2,0,2
51463,110,14249,19832;19987;22166;22623,36135,0,2,2,0,4
51464,110,14250,20141;22980,36135,1,0,1,0,2
51465,110,14251,19852;20118,36135,0,0,2,0,2
51466,110,14252,19204;19854,36135,0,0,2,0,2
51467,110,14253,19859;20102,36135,0,0,2,0,2
51468,110,14254,19662;19861;22743,36135,1,0,2,0,3
51469,110,14255,19864;20195,36135,0,0,2,0,2
51470,110,14256,19719;19880;22353;22736;22843,36135,2,1,2,0,5
51471,110,14257,19569;19886,36135,0,0,2,0,2
51472,110,14259,14825,36500,0,0,0,1,1
51473,110,14260,14876;15429,36500,0,0,0,2,2
51474,110,14262,14529,36500,0,0,0,1,1
51475,110,14263,15264,36500,0,0,0,1,1
51476,110,14269,15566,36500,0,0,0,1,1
51477,110,14270,16133,36500,0,0,1,0,1
51478,110,14278,17209;17913,36500,0,0,2,0,2
51479,110,14280,17640;17784,36500,0,0,2,0,2
51480,110,14284,18144;18629;22673,36500,1,0,2,0,3
51481,110,14285,18111;18184,36500,0,0,2,0,2
51482,110,14289,18198;18946,36500,0,0,2,0,2
51483,110,14292,18275;18491;22393,36500,0,1,2,0,3
51484,110,14293,18428;18512;22093;22892,36500,1,1,2,0,4
51485,110,14294,18596;18599,36500,0,0,2,0,2
51486,110,14296,18654;18931;22425,36500,0,1,2,0,3
51487,110,14297,18666;18977;22434,36500,0,1,2,0,3
51488,110,14299,18493,36500,0,0,1,0,1
51489,110,14300,19426;22043,36500,0,1,1,0,2
51490,110,14301,18610;18909;22549,36500,0,1,2,0,3
51491,110,14302,18828;18957;22903,36500,1,0,2,0,3
51492,110,14304,18987;19381,36500,0,0,2,0,2
51493,110,14305,19013;19645;22603;23055,36500,1,1,2,0,4
51494,110,14306,19020;19488;22248;22472;22598;23045,36500,1,3,2,0,6
51495,110,14307,19226;22927,36500,1,0,1,0,2
51496,110,14308,19077;19632;22160;22838,36500,1,1,2,0,4
51497,110,14309,18736;19142;23118,36500,1,0,2,0,3
51498,110,14310,19175,36500,0,0,1,0,1
51499,110,14311,19222;20010,36500,0,0,2,0,2
51500,110,14312,19216;19272;22331,36500,0,1,2,0,3
51501,110,14313,19291,36500,0,0,1,0,1
51502,110,14315,18851;19344;22038,36500,0,1,2,0,3
51503,110,14316,19365;19452;22948,36500,1,0,2,0,3
51504,110,14317,19168;19392;22717,36500,1,0,2,0,3
51505,110,14318,19403;22947,36500,1,0,1,0,2
51506,110,14319,19037;19407;22594,36500,0,1,2,0,3
51507,110,14320,19442;20179,36500,0,0,2,0,2
51508,110,14321,19257;19445;22723,36500,1,0,2,0,3
51509,110,14322,19451;19889;22974,36500,1,0,2,0,3
51510,110,14323,19457;23135,36500,1,0,1,0,2
51511,110,14324,19562;19577,36500,0,0,2,0,2
51512,110,14325,19786;22740,36500,1,0,1,0,2
51513,110,14326,19518;19693;22049,36500,0,1,2,0,3
51514,110,14327,19603;19642;22840;22963,36500,2,0,2,0,4
51515,110,14328,19354;19631,36500,0,0,2,0,2
51516,110,14329,19643;19673,36500,0,0,2,0,2
51517,110,14330,19124;19647,36500,0,0,2,0,2
51518,110,14331,19650;20129,36500,0,0,2,0,2
51519,110,14332,19784;19807,36500,0,0,2,0,2
51520,110,14333,19687;19874;22161,36500,0,1,2,0,3
51521,110,14334,20092;20306,36500,0,0,2,0,2
51522,110,14335,19740;19755;22354;22737;23149,36500,2,1,2,0,5
51523,110,14336,19747;19827,36500,0,0,2,0,2
51524,110,14337,19780,36500,0,0,1,0,1
51525,110,14338,19782;20142,36500,0,0,2,0,2
51526,110,14339,20260;22370;22632,36500,0,2,1,0,3
51527,110,14340,19828;20177,36500,0,0,2,0,2
51528,110,14341,19834;19853;23154,36500,1,0,2,0,3
51529,110,14342,19805;19842;23153,36500,1,0,2,0,3
51530,110,14343,19711;20174,36500,0,0,2,0,2
51531,110,14344,19624;19855,36500,0,0,2,0,2
51532,110,14345,19857;19979,36500,0,0,2,0,2
51533,110,14346,19876;19894,36500,0,0,2,0,2
51534,110,14347,19675;19892,36500,0,0,2,0,2
51535,110,14348,19819;19898,36500,0,0,2,0,2
51536,110,14349,19746;19929,36500,0,0,2,0,2
51537,110,14350,19566;19945;22620,36500,0,1,2,0,3
51538,110,14351,19947;20283,36500,0,0,2,0,2
51539,110,14352,19685;19958;21437;22492;22622,36500,0,3,2,0,5
51540,110,14353,19960;20000;22750,36500,1,0,2,0,3
51541,110,14354,19816;19964;22487,36500,0,1,2,0,3
51542,110,14355,20249;20416,36500,0,0,2,0,2
51543,110,14356,19983;20109,36500,0,0,2,0,2
51544,110,14357,14405,36865,0,0,0,1,1
51545,110,14358,14732,36865,0,0,0,1,1
51546,110,14359,15601;15774,36865,0,0,1,1,2
51547,110,14361,14772,36865,0,0,0,1,1
51548,110,14362,15541,36865,0,0,0,1,1
51549,110,14364,15335;15461,36865,0,0,0,2,2
51550,110,14367,15502;16296,36865,0,0,1,1,2
51551,110,14369,15860,36865,0,0,1,0,1
51552,110,14370,16018,36865,0,0,1,0,1
51553,110,14371,16232,36865,0,0,1,0,1
51554,110,14373,15629,36865,0,0,1,0,1
51555,110,14376,16569,36865,0,0,1,0,1
51556,110,14380,16929,36865,0,0,1,0,1
51557,110,14381,16880;17168,36865,0,0,2,0,2
51558,110,14382,17504;17770,36865,0,0,2,0,2
51559,110,14384,16871,36865,0,0,1,0,1
51560,110,14385,17422,36865,0,0,1,0,1
51561,110,14386,17264,36865,0,0,1,0,1
51562,110,14389,17594;17776,36865,0,0,2,0,2
51563,110,14390,17286,36865,0,0,1,0,1
51564,110,14391,18015,36865,0,0,1,0,1
51565,110,14393,17847;18359,36865,0,0,2,0,2
51566,110,14397,17974;18535,36865,0,0,2,0,2
51567,110,14398,18047,36865,0,0,1,0,1
51568,110,14402,18243;18482,36865,0,0,2,0,2
51569,110,14403,18136;18264;21964;22381;23102,36865,1,2,2,0,5
51570,110,14404,18290;18592,36865,0,0,2,0,2
51571,110,14405,18345;18551;22396;22666,36865,1,1,2,0,4
51572,110,14406,18358;22089,36865,0,1,1,0,2
51573,110,14407,18375;18882,36865,0,0,2,0,2
51574,110,14409,18456;18804,36865,0,0,2,0,2
51575,110,14410,18478;18751,36865,0,0,2,0,2
51576,110,14411,18978;22557,36865,0,1,1,0,2
51577,110,14412,18533;18608;21987;22306;22532,36865,0,3,2,0,5
51578,110,14414,18711;18717;23013,36865,1,0,2,0,3
51579,110,14415,18730;18997;22559,36865,0,1,2,0,3
51580,110,14416,18831;19138,36865,0,0,2,0,2
51581,110,14417,18843;19318;22338,36865,0,1,2,0,3
51582,110,14419,18537;19127;22326,36865,0,1,2,0,3
51583,110,14420,19010;19102;22806,36865,1,0,2,0,3
51584,110,14422,19395;22823;23040,36865,2,0,1,0,3
51585,110,14423,19182;19184;22033,36865,0,1,2,0,3
51586,110,14424,19202;19324,36865,0,0,2,0,2
51587,110,14425,18834;19308;22337;22584,36865,0,2,2,0,4
51588,110,14426,19337;19345;22148,36865,0,1,2,0,3
51589,110,14427,19397;19804;22614;23152,36865,1,1,2,0,4
51590,110,14428,18906;19376;22942,36865,1,0,2,0,3
51591,110,14429,19438;19911,36865,0,0,2,0,2
51592,110,14430,19429;19765;22051,36865,0,1,2,0,3
51593,110,14431,19156;19615;22159,36865,0,1,2,0,3
51594,110,14432,19436;20152,36865,0,0,2,0,2
51595,110,14433,19517,36865,0,0,1,0,1
51596,110,14434,19565;19888,36865,0,0,2,0,2
51597,110,14435,18972;19568;22046;22253;23050,36865,1,2,2,0,5
51598,110,14436,19598;19925,36865,0,0,2,0,2
51599,110,14437,19611;19634;22481,36865,0,1,2,0,3
51600,110,14438,19549;19665,36865,0,0,2,0,2
51601,110,14440,19606;19636;22348,36865,0,1,2,0,3
51602,110,14441,19535;19660;22604;23143,36865,1,1,2,0,4
51603,110,14442,19477;19672,36865,0,0,2,0,2
51604,110,14443,19506;19678,36865,0,0,2,0,2
51605,110,14444,19702;19799,36865,0,0,2,0,2
51606,110,14445,19708;20098,36865,0,0,2,0,2
51607,110,14446,19472;19709,36865,0,0,2,0,2
51608,110,14447,19777;19823,36865,0,0,2,0,2
51609,110,14448,19250,36865,0,0,1,0,1
51610,110,14449,19836;20103,36865,0,0,2,0,2
51611,110,14450,19841;20418,36865,0,0,2,0,2
51612,110,14451,19849;22164,36865,0,1,1,0,2
51613,110,14452,19879;19955;23072;23159,36865,2,0,2,0,4
51614,110,14453,20237,36865,0,0,1,0,1
51615,110,14454,19639;19899,36865,0,0,2,0,2
51616,110,14455,19933;20292,36865,0,0,2,0,2
51617,110,14456,19935;20380,36865,0,0,2,0,2
51618,110,14457,19962;20115;22755,36865,1,0,2,0,3
51619,110,14458,19971;20111;22169,36865,0,1,2,0,3
51620,110,14459,19763;19978;22054,36865,0,1,2,0,3
51621,110,14460,19986;23073,36865,1,0,1,0,2
51622,110,14461,19739;19994;22861;23160,36865,2,0,2,0,4
51623,110,14462,20006;23162,36865,1,0,1,0,2
51624,110,14463,20022,36865,0,0,1,0,1
51625,110,14464,20030;20383;22637;22985,36865,1,1,2,0,4
51626,110,14465,20046;20429,36865,0,0,2,0,2
51627,110,14466,20094,36865,0,0,1,0,1
51628,110,14469,14795,37230,0,0,0,1,1
51629,110,14470,15486,37230,0,0,0,1,1
51630,110,14472,15539,37230,0,0,0,1,1
51631,110,14473,14978,37230,0,0,0,1,1
51632,110,14474,15286;15442,37230,0,0,0,2,2
51633,110,14475,15203,37230,0,0,0,1,1
51634,110,14476,15698,37230,0,0,1,0,1
51635,110,14477,15905,37230,0,0,1,0,1
51636,110,14480,16289;16385,37230,0,0,2,0,2
51637,110,14481,15563,37230,0,0,0,1,1
51638,110,14482,16934,37230,0,0,1,0,1
51639,110,14485,16957;16981,37230,0,0,2,0,2
51640,110,14486,17032,37230,0,0,1,0,1
51641,110,14494,16902,37230,0,0,1,0,1
51642,110,14497,17956,37230,0,0,1,0,1
51643,110,14498,18011;18061,37230,0,0,2,0,2
51644,110,14499,17159,37230,0,0,1,0,1
51645,110,14500,17893,37230,0,0,1,0,1
51646,110,14502,18312;19194,37230,0,0,2,0,2
51647,110,14503,18702;19264;22580;22707,37230,1,1,2,0,4
51648,110,14504,18740;18839,37230,0,0,2,0,2
51649,110,14506,18819;18991;22913,37230,1,0,2,0,3
51650,110,14507,18887;19122,37230,0,0,2,0,2
51651,110,14508,18752;18928,37230,0,0,2,0,2
51652,110,14509,18712;19021;22436,37230,0,1,2,0,3
51653,110,14510,19103;19667;22349,37230,0,1,2,0,3
51654,110,14511,19114;19313,37230,0,0,2,0,2
51655,110,14512,19151;19251;22452,37230,0,1,2,0,3
51656,110,14514,19131;19270;22335,37230,0,1,2,0,3
51657,110,14515,19368;19415,37230,0,0,2,0,2
51658,110,14516,19290;19465;22952,37230,1,0,2,0,3
51659,110,14517,19480;19592;22471,37230,0,1,2,0,3
51660,110,14518,19485;19607;22597;22829,37230,1,1,2,0,4
51661,110,14519,19502;19764;22846,37230,1,0,2,0,3
51662,110,14520,19525;19887;22053,37230,0,1,2,0,3
51663,110,14521,19538;19608;22477;22957,37230,1,1,2,0,4
51664,110,14522,19583,37230,0,0,1,0,1
51665,110,14523,19593;19797;22052;22356,37230,0,2,2,0,4
51666,110,14524,19630;19795;22972,37230,1,0,2,0,3
51667,110,14525,19227;19655;22255;22733;22964,37230,2,1,2,0,5
51668,110,14526,19528;19591;23051,37230,1,0,2,0,3
51669,110,14527,19691;22607,37230,0,1,1,0,2
51670,110,14528,19705;20247,37230,0,0,2,0,2
51671,110,14529,19729;19730,37230,0,0,2,0,2
51672,110,14530,20059;22977,37230,1,0,1,0,2
51673,110,14531,19772;19970;22363,37230,0,1,2,0,3
51674,110,14532,19726;19779;23150,37230,1,0,2,0,3
51675,110,14533,20042;20189;22261;22624,37230,0,2,2,0,4
51676,110,14534,19838;20135;22865,37230,1,0,2,0,3
51677,110,14535,19481;19868;22489;22617,37230,0,2,2,0,4
51678,110,14536,19897;19904,37230,0,0,2,0,2
51679,110,14537,19922;20482,37230,0,0,2,0,2
51680,110,14538,19937;19995,37230,0,0,2,0,2
51681,110,14539,19941;20049,37230,0,0,2,0,2
51682,110,14540,19991;20126,37230,0,0,2,0,2
51683,110,14541,20009;20479,37230,0,0,2,0,2
51684,110,14542,20024;20213;23166,37230,1,0,2,0,3
51685,110,14543,19939;20028,37230,0,0,2,0,2
51686,110,14544,20039;20323,37230,0,0,2,0,2
51687,110,14545,20050;20365,37230,0,0,2,0,2
51688,110,14546,19954;20074;23164,37230,1,0,2,0,3
51689,110,14547,20075;20222,37230,0,0,2,0,2
51690,110,14548,20018;20091;22367,37230,0,1,2,0,3
51691,110,14549,20378,37230,0,0,1,0,1
51692,110,14550,19679;20097;22978,37230,1,0,2,0,3
51693,110,14551,19727;20112,37230,0,0,2,0,2
51694,110,14552,20139;20458;23089,37230,1,0,2,0,3
51695,110,14553,20140;20316,37230,0,0,2,0,2
51696,110,14554,20132;20147;22368,37230,0,1,2,0,3
51697,110,14555,19944;20154;22981,37230,1,0,2,0,3
51698,110,14556,20119;20217,37230,0,0,2,0,2
51699,110,14557,14665,37595,0,0,0,1,1
51700,110,14558,15322,37595,0,0,0,1,1
51701,110,14559,15292,37595,0,0,0,1,1
51702,110,14560,15652,37595,0,0,1,0,1
51703,110,14562,15114,37595,0,0,0,1,1
51704,110,14564,15701,37595,0,0,1,0,1
51705,110,14565,16096,37595,0,0,1,0,1
51706,110,14566,15687,37595,0,0,1,0,1
51707,110,14570,16412;16448,37595,0,0,2,0,2
51708,110,14573,16590,37595,0,0,1,0,1
51709,110,14574,15653,37595,0,0,1,0,1
51710,110,14575,16696;16772,37595,0,0,2,0,2
51711,110,14576,16355;16739,37595,0,0,2,0,2
51712,110,14578,16625,37595,0,0,1,0,1
51713,110,14580,17021,37595,0,0,1,0,1
51714,110,14582,16498,37595,0,0,1,0,1
51715,110,14590,17643,37595,0,0,1,0,1
51716,110,14592,17895;18255;22380,37595,0,1,2,0,3
51717,110,14596,18384,37595,0,0,1,0,1
51718,110,14597,18052;18412;22293;22522,37595,0,2,2,0,4
51719,110,14598,18371,37595,0,0,1,0,1
51720,110,14599,18673;19028;22789,37595,1,0,2,0,3
51721,110,14600,18636;19239,37595,0,0,2,0,2
51722,110,14601,18435,37595,0,0,1,0,1
51723,110,14602,18806;22314;22685,37595,1,1,1,0,3
51724,110,14604,18964;19640;22482;22732,37595,1,1,2,0,4
51725,110,14606,19095;19326,37595,0,0,2,0,2
51726,110,14607,18745;19111,37595,0,0,2,0,2
51727,110,14608,18684,37595,0,0,1,0,1
51728,110,14609,19090,37595,0,0,1,0,1
51729,110,14610,19332;19428;23133,37595,1,0,2,0,3
51730,110,14611,19706;19895,37595,0,0,2,0,2
51731,110,14612,19646;22483;22841,37595,1,1,1,0,3
51732,110,14613,19469,37595,0,0,1,0,1
51733,110,14614,19496;19574,37595,0,0,2,0,2
51734,110,14615,19519;19767;22613,37595,0,1,2,0,3
51735,110,14616,20002;23161,37595,1,0,1,0,2
51736,110,14617,19200;19600;22836,37595,1,0,2,0,3
51737,110,14618,19623;19684;22256;22351;22606;22967,37595,1,3,2,0,6
51738,110,14619,19695;20099;23079,37595,1,0,2,0,3
51739,110,14620,19698;19957,37595,0,0,2,0,2
51740,110,14621,19544;19700;22608,37595,0,1,2,0,3
51741,110,14622,19752;20173,37595,0,0,2,0,2
51742,110,14623,19766;20194,37595,0,0,2,0,2
51743,110,14624,19770;19905,37595,0,0,2,0,2
51744,110,14625,19999,37595,0,0,1,0,1
51745,110,14626,19789;20359;22636,37595,0,1,2,0,3
51746,110,14627,20539;22642,37595,0,1,1,0,2
51747,110,14628,19081;19118;22229;23028,37595,1,1,2,0,4
51748,110,14629,19871;20149;22496,37595,0,1,2,0,3
51749,110,14630,19873;19984;22749,37595,1,0,2,0,3
51750,110,14631,19893;20184,37595,0,0,2,0,2
51751,110,14632,19896;19982,37595,0,0,2,0,2
51752,110,14633,19908;20347;22635,37595,0,1,2,0,3
51753,110,14634,19758;19936;22362,37595,0,1,2,0,3
51754,110,14635,19881;19942;22619;22857,37595,1,1,2,0,4
51755,110,14636,19882;19951,37595,0,0,2,0,2
51756,110,14637,19851;19972,37595,0,0,2,0,2
51757,110,14638,19977;20167,37595,0,0,2,0,2
51758,110,14639,20038;20628;22494;22976,37595,1,1,2,0,4
51759,110,14640,20491;20557,37595,0,0,2,0,2
51760,110,14641,20084;20299,37595,0,0,2,0,2
51761,110,14642,20100;20229,37595,0,0,2,0,2
51762,110,14643,20127;20196,37595,0,0,2,0,2
51763,110,14645,20138;20288;22983,37595,1,0,2,0,3
51764,110,14646,19843;20255,37595,0,0,2,0,2
51765,110,14647,20146;20550,37595,0,0,2,0,2
51766,110,14648,20191,37595,0,0,1,0,1
51767,110,14649,19938;20176;22757,37595,1,0,2,0,3
51768,110,14650,20185;20227;22497,37595,0,1,2,0,3
51769,110,14651,20192;20352,37595,0,0,2,0,2
51770,110,14652,20168;20212,37595,0,0,2,0,2
51771,110,14653,20186;20239,37595,0,0,2,0,2
51772,110,14654,19923;20242,37595,0,0,2,0,2
51773,110,14655,19975;20017;22259;22493;23163,37595,1,2,2,0,5
51774,110,14656,20272;20362,37595,0,0,2,0,2
51775,110,14657,20279;20456,37595,0,0,2,0,2
51776,110,14658,20304;20428;22878,37595,1,0,2,0,3
51777,110,14659,14853,37960,0,0,0,1,1
51778,110,14660,15411,37960,0,0,0,1,1
51779,110,14662,15674;16136,37960,0,0,2,0,2
51780,110,14663,14782,37960,0,0,0,1,1
51781,110,14664,15756,37960,0,0,1,0,1
51782,110,14666,15186,37960,0,0,0,1,1
51783,110,14667,15795,37960,0,0,1,0,1
51784,110,14668,16002,37960,0,0,1,0,1
51785,110,14670,16101;16314,37960,0,0,2,0,2
51786,110,14671,16153,37960,0,0,1,0,1
51787,110,14672,16085,37960,0,0,1,0,1
51788,110,14673,16237;16657,37960,0,0,2,0,2
51789,110,14677,16604,37960,0,0,1,0,1
51790,110,14678,16726,37960,0,0,1,0,1
51791,110,14682,16984,37960,0,0,1,0,1
51792,110,14687,16436,37960,0,0,1,0,1
51793,110,14689,16559,37960,0,0,1,0,1
51794,110,14690,17283,37960,0,0,1,0,1
51795,110,14692,17342,37960,0,0,1,0,1
51796,110,14693,16943,37960,0,0,1,0,1
51797,110,14695,17436;17716,37960,0,0,2,0,2
51798,110,14696,17544,37960,0,0,1,0,1
51799,110,14697,17486,37960,0,0,1,0,1
51800,110,14698,17694;18068,37960,0,0,2,0,2
51801,110,14700,17543;17931,37960,0,0,2,0,2
51802,110,14701,17740,37960,0,0,1,0,1
51803,110,14703,17911;18045,37960,0,0,2,0,2
51804,110,14704,17545;18084;22283,37960,0,1,2,0,3
51805,110,14710,18154;18181,37960,0,0,2,0,2
51806,110,14711,18031;18302,37960,0,0,2,0,2
51807,110,14712,18432,37960,0,0,1,0,1
51808,110,14713,18907;22017,37960,0,1,1,0,2
51809,110,14714,18396,37960,0,0,1,0,1
51810,110,14715,18641;19359;22462;23129,37960,1,1,2,0,4
51811,110,14717,18862;18893,37960,0,0,2,0,2
51812,110,14718,18884;19497;22156;22249;23047;23137,37960,2,2,2,0,6
51813,110,14719,18372;18999;22322,37960,0,1,2,0,3
51814,110,14721,19070,37960,0,0,1,0,1
51815,110,14722,18755;19165;22447,37960,0,1,2,0,3
51816,110,14723,19207;19683;22048;22350,37960,0,2,2,0,4
51817,110,14724,19534,37960,0,0,1,0,1
51818,110,14725,18827;19423;22247;22340,37960,0,2,2,0,4
51819,110,14726,19169,37960,0,0,1,0,1
51820,110,14727,19366;19674,37960,0,0,2,0,2
51821,110,14729,19446,37960,0,0,1,0,1
51822,110,14730,19487;19863;23155,37960,1,0,2,0,3
51823,110,14731,19490;19594;22254;22731;22961,37960,2,1,2,0,5
51824,110,14732,18813;19034;22012;22902,37960,1,1,2,0,4
51825,110,14734,19467;19903,37960,0,0,2,0,2
51826,110,14736,19613;19943;23071,37960,1,0,2,0,3
51827,110,14737,19653;19694,37960,0,0,2,0,2
51828,110,14738,19676;19731;22611,37960,0,1,2,0,3
51829,110,14739,19586,37960,0,0,1,0,1
51830,110,14740,19144,37960,0,0,1,0,1
51831,110,14741,19513;19715;22485;23147,37960,1,1,2,0,4
51832,110,14742,19725;19902;22486;22610;22844,37960,1,2,2,0,5
51833,110,14743,19658,37960,0,0,1,0,1
51834,110,14744,19883;20081,37960,0,0,2,0,2
51835,110,14745,19570;19924;22360;22855,37960,1,1,2,0,4
51836,110,14746,19917;19928;22490;22618,37960,0,2,2,0,4
51837,110,14747,19885;19952;22747,37960,1,0,2,0,3
51838,110,14748,20003;20621,37960,0,0,2,0,2
51839,110,14749,20015;20349;22266,37960,0,1,2,0,3
51840,110,14750,20020,37960,0,0,1,0,1
51841,110,14751,20029;23075,37960,1,0,1,0,2
51842,110,14752,20085;20476,37960,0,0,2,0,2
51843,110,14753,20090;20404,37960,0,0,2,0,2
51844,110,14754,20169;20681,37960,0,0,2,0,2
51845,110,14755,20190;20510,37960,0,0,2,0,2
51846,110,14756,20057;20243,37960,0,0,2,0,2
51847,110,14757,20280;20423,37960,0,0,2,0,2
51848,110,14758,20282,37960,0,0,1,0,1
51849,110,14759,20218;20297;23169,37960,1,0,2,0,3
51850,110,14760,20308;20448,37960,0,0,2,0,2
51851,110,14761,19580;20314;22633,37960,0,1,2,0,3
51852,110,14762,20267;20320,37960,0,0,2,0,2
51853,110,14763,20341;20462,37960,0,0,2,0,2
51854,110,14764,20353;20431,37960,0,0,2,0,2
51855,110,14765,20368;20664,37960,0,0,2,0,2
51856,110,14766,20025;20386,37960,0,0,2,0,2
51857,110,14767,20662,37960,0,0,1,0,1
51858,110,14768,20294;20424,37960,0,0,2,0,2
51859,110,14769,15485,38325,0,0,0,1,1
51860,110,14770,15565,38325,0,0,0,1,1
51861,110,14773,16348,38325,0,0,1,0,1
51862,110,14774,16475,38325,0,0,1,0,1
51863,110,14775,15923,38325,0,0,1,0,1
51864,110,14776,16925,38325,0,0,1,0,1
51865,110,14777,16423;16501,38325,0,0,2,0,2
51866,110,14779,16704,38325,0,0,1,0,1
51867,110,14780,16817,38325,0,0,1,0,1
51868,110,14781,17216,38325,0,0,1,0,1
51869,110,14783,17114,38325,0,0,1,0,1
51870,110,14784,17772;18059,38325,0,0,2,0,2
51871,110,14785,17401,38325,0,0,1,0,1
51872,110,14787,17699,38325,0,0,1,0,1
51873,110,14789,17762,38325,0,0,1,0,1
51874,110,14793,17879;18373,38325,0,0,2,0,2
51875,110,14795,17906;18304;22520,38325,0,1,2,0,3
51876,110,14799,17977,38325,0,0,1,0,1
51877,110,14800,18335,38325,0,0,1,0,1
51878,110,14801,18398,38325,0,0,1,0,1
51879,110,14802,17890,38325,0,0,1,0,1
51880,110,14803,18438;18462,38325,0,0,2,0,2
51881,110,14804,17969;18115,38325,0,0,2,0,2
51882,110,14807,18657,38325,0,0,1,0,1
51883,110,14808,18173;18689;22539,38325,0,1,2,0,3
51884,110,14809,18738,38325,0,0,1,0,1
51885,110,14812,18924,38325,0,0,1,0,1
51886,110,14813,18900,38325,0,0,1,0,1
51887,110,14815,19110;19253,38325,0,0,2,0,2
51888,110,14816,19248;19710,38325,0,0,2,0,2
51889,110,14818,19371,38325,0,0,1,0,1
51890,110,14819,19620;23142,38325,1,0,1,0,2
51891,110,14820,19274;19373;22821,38325,1,0,2,0,3
51892,110,14823,19399;19690,38325,0,0,2,0,2
51893,110,14824,19410,38325,0,0,1,0,1
51894,110,14825,19433;19520;22720,38325,1,0,2,0,3
51895,110,14826,19159;19468,38325,0,0,2,0,2
51896,110,14827,19507;19815,38325,0,0,2,0,2
51897,110,14828,19540;19560;23139,38325,1,0,2,0,3
51898,110,14829,19619;19998,38325,0,0,2,0,2
51899,110,14830,19625;19900;22357;22851,38325,1,1,2,0,4
51900,110,14831,19677,38325,0,0,1,0,1
51901,110,14832,19688;19717,38325,0,0,2,0,2
51902,110,14833,19418,38325,0,0,1,0,1
51903,110,14834,19814;20203;23082,38325,1,0,2,0,3
51904,110,14835,19656;19818;22257,38325,0,1,2,0,3
51905,110,14836,19821;20502,38325,0,0,2,0,2
51906,110,14837,19916;20503,38325,0,0,2,0,2
51907,110,14838,19597;19932;22361;22856,38325,1,1,2,0,4
51908,110,14839,19273,38325,0,0,1,0,1
51909,110,14840,19785,38325,0,0,1,0,1
51910,110,14841,20483,38325,0,0,1,0,1
51911,110,14842,20048,38325,0,0,1,0,1
51912,110,14843,20068;20170,38325,0,0,2,0,2
51913,110,14844,19956;20069,38325,0,0,2,0,2
51914,110,14845,20086;20555;22883,38325,1,0,2,0,3
51915,110,14846,20096;20327;22627,38325,0,1,2,0,3
51916,110,14847,19638;20110,38325,0,0,2,0,2
51917,110,14848,20159;20161;22867,38325,1,0,2,0,3
51918,110,14849,20165,38325,0,0,1,0,1
51919,110,14850,20178;20390,38325,0,0,2,0,2
51920,110,14851,20198;20376;23172,38325,1,0,2,0,3
51921,110,14852,20210;20419;22763,38325,1,0,2,0,3
51922,110,14853,20221,38325,0,0,1,0,1
51923,110,14854,20197;20232,38325,0,0,2,0,2
51924,110,14855,20200;20289,38325,0,0,2,0,2
51925,110,14856,19820;20295,38325,0,0,2,0,2
51926,110,14857,19927;20307,38325,0,0,2,0,2
51927,110,14858,20330,38325,0,0,1,0,1
51928,110,14859,20338;20685;22501,38325,0,1,2,0,3
51929,110,14860,20343,38325,0,0,1,0,1
51930,110,14861,20350;20713,38325,0,0,2,0,2
51931,110,14862,20425,38325,0,0,1,0,1
51932,110,14863,20080;20384;22875,38325,1,0,2,0,3
51933,110,14864,20393;20579,38325,0,0,2,0,2
51934,110,14865,20063;20397,38325,0,0,2,0,2
51935,110,14866,20402;20793,38325,0,0,2,0,2
51936,110,14867,20407;20668,38325,0,0,2,0,2
51937,110,14868,20718,38325,0,0,1,0,1
51938,110,14869,20224;20484,38325,0,0,2,0,2
51939,110,14870,20493,38325,0,0,1,0,1
51940,110,14871,20430;20497,38325,0,0,2,0,2
51941,110,14872,20499;20820,38325,0,0,2,0,2
51942,110,14873,20650,38325,0,0,1,0,1
51943,110,14874,19831;20505,38325,0,0,2,0,2
51944,110,14875,20363,38325,0,0,1,0,1
51945,110,14876,20518;20792,38325,0,0,2,0,2
51946,110,14877,20564,38325,0,0,1,0,1
51947,110,14878,20469;20528,38325,0,0,2,0,2
51948,110,14880,15856,38690,0,0,1,0,1
51949,110,14882,15341,38690,0,0,0,1,1
51950,110,14883,15735,38690,0,0,1,0,1
51951,110,14884,16006,38690,0,0,1,0,1
51952,110,14885,16139;16777,38690,0,0,2,0,2
51953,110,14886,15600,38690,0,0,0,1,1
51954,110,14887,15993,38690,0,0,1,0,1
51955,110,14888,16785;17627,38690,0,0,2,0,2
51956,110,14889,16434,38690,0,0,1,0,1
51957,110,14890,16046,38690,0,0,1,0,1
51958,110,14891,15743,38690,0,0,1,0,1
51959,110,14894,16835,38690,0,0,1,0,1
51960,110,14896,16691,38690,0,0,1,0,1
51961,110,14901,16860,38690,0,0,1,0,1
51962,110,14902,17426;18035;22279;22377;22886;22997,38690,2,2,2,0,6
51963,110,14904,16982,38690,0,0,1,0,1
51964,110,14905,17083,38690,0,0,1,0,1
51965,110,14906,17578;17791,38690,0,0,2,0,2
51966,110,14907,17589;17964;22277,38690,0,1,2,0,3
51967,110,14911,17767,38690,0,0,1,0,1
51968,110,14913,17844;18140;21952,38690,0,1,2,0,3
51969,110,14914,17786;17860;22275,38690,0,1,2,0,3
51970,110,14915,17556;17705,38690,0,0,2,0,2
51971,110,14916,17990,38690,0,0,1,0,1
51972,110,14917,17257,38690,0,0,1,0,1
51973,110,14920,18527;19235;22706,38690,1,0,2,0,3
51974,110,14921,18564;18994;22126,38690,0,1,2,0,3
51975,110,14923,19404;19582;22346,38690,0,1,2,0,3
51976,110,14924,18720;19372,38690,0,0,2,0,2
51977,110,14925,18643;18754;23009,38690,1,0,2,0,3
51978,110,14926,18829;22316,38690,0,1,1,0,2
51979,110,14928,18675;18932;22220;23110,38690,1,1,2,0,4
51980,110,14929,18838,38690,0,0,1,0,1
51981,110,14930,18833,38690,0,0,1,0,1
51982,110,14931,18918;19012;22915,38690,1,0,2,0,3
51983,110,14932,19174;19223,38690,0,0,2,0,2
51984,110,14933,19241;19670,38690,0,0,2,0,2
51985,110,14935,19199;19742,38690,0,0,2,0,2
51986,110,14936,19379;19489,38690,0,0,2,0,2
51987,110,14937,19398,38690,0,0,1,0,1
51988,110,14938,19425;19953;22858,38690,1,0,2,0,3
51989,110,14939,19434;19722;23060,38690,1,0,2,0,3
51990,110,14940,19447,38690,0,0,1,0,1
51991,110,14941,19536;22157;23048,38690,1,1,1,0,3
51992,110,14942,19571;19921,38690,0,0,2,0,2
51993,110,14943,19621;20067,38690,0,0,2,0,2
51994,110,14944,19659,38690,0,0,1,0,1
51995,110,14945,19728;20199,38690,0,0,2,0,2
51996,110,14946,19628;19736,38690,0,0,2,0,2
51997,110,14947,19858;20055;22626;23078,38690,1,1,2,0,4
51998,110,14948,19788;19915;22163,38690,0,1,2,0,3
51999,110,14949,19794;19869;23156,38690,1,0,2,0,3
52000,110,14950,20214,38690,0,0,1,0,1
52001,110,14951,19847;20051,38690,0,0,2,0,2
52002,110,14952,19867,38690,0,0,1,0,1
52003,110,14953,19413,38690,0,0,1,0,1
52004,110,14954,19946;20245,38690,0,0,2,0,2
52005,110,14955,19961;19981,38690,0,0,2,0,2
52006,110,14956,19959;20034,38690,0,0,2,0,2
52007,110,14957,19756;20040,38690,0,0,2,0,2
52008,110,14958,19992;20121,38690,0,0,2,0,2
52009,110,14959,20128;20413;22877,38690,1,0,2,0,3
52010,110,14960,20130;20394;22639,38690,0,1,2,0,3
52011,110,14961,19439;20134;22628;23080,38690,1,1,2,0,4
52012,110,14962,19704;20145;23146,38690,1,0,2,0,3
52013,110,14963,20211;20474,38690,0,0,2,0,2
52014,110,14964,19840;20181,38690,0,0,2,0,2
52015,110,14965,20204;20720,38690,0,0,2,0,2
52016,110,14966,20235;20290;22631,38690,0,1,2,0,3
52017,110,14967,20246;20536;22769,38690,1,0,2,0,3
52018,110,14968,20373,38690,0,0,1,0,1
52019,110,14969,20014;20275;22498;23085,38690,1,1,2,0,4
52020,110,14970,19918;20300,38690,0,0,2,0,2
52021,110,14971,20305;20379,38690,0,0,2,0,2
52022,110,14972,20333;20399;22873;22984,38690,2,0,2,0,4
52023,110,14973,20346;20595;22885,38690,1,0,2,0,3
52024,110,14974,20411;20672,38690,0,0,2,0,2
52025,110,14976,20420;20651,38690,0,0,2,0,2
52026,110,14977,20412;22986,38690,1,0,1,0,2
52027,110,14978,20162;20442,38690,0,0,2,0,2
52028,110,14979,20449;20802,38690,0,0,2,0,2
52029,110,14980,20451;20940,38690,0,0,2,0,2
52030,110,14981,20403;20486;22876,38690,1,0,2,0,3
52031,110,14982,20488;20569,38690,0,0,2,0,2
52032,110,14983,20490;20605,38690,0,0,2,0,2
52033,110,14984,20053,38690,0,0,1,0,1
52034,110,14985,20415;20495,38690,0,0,2,0,2
52035,110,14986,20525;20527;22881,38690,1,0,2,0,3
52036,110,14987,20540;20570,38690,0,0,2,0,2
52037,110,14988,20553;20559,38690,0,0,2,0,2
52038,110,14989,20511;20576,38690,0,0,2,0,2
52039,110,14990,20587;20863,38690,0,0,2,0,2
52040,110,14991,20624;20627,38690,0,0,2,0,2
52041,110,14992,15752,39055,0,0,1,0,1
52042,110,14993,15702,39055,0,0,1,0,1
52043,110,14994,15878,39055,0,0,1,0,1
52044,110,14995,15899,39055,0,0,1,0,1
52045,110,14996,15603,39055,0,0,1,0,1
52046,110,14997,16023,39055,0,0,1,0,1
52047,110,14998,16143,39055,0,0,1,0,1
52048,110,14999,16367,39055,0,0,1,0,1
52049,110,15000,16009,39055,0,0,1,0,1
52050,110,15001,16806,39055,0,0,1,0,1
52051,110,15002,15889,39055,0,0,1,0,1
52052,110,15003,15709,39055,0,0,1,0,1
52053,110,15004,16594,39055,0,0,1,0,1
52054,110,15005,15914,39055,0,0,1,0,1
52055,110,15006,16755,39055,0,0,1,0,1
52056,110,15007,17277,39055,0,0,1,0,1
52057,110,15008,17321,39055,0,0,1,0,1
52058,110,15009,16993,39055,0,0,1,0,1
52059,110,15011,17744,39055,0,0,1,0,1
52060,110,15016,18229,39055,0,0,1,0,1
52061,110,15017,17707,39055,0,0,1,0,1
52062,110,15018,18316,39055,0,0,1,0,1
52063,110,15020,17921;18107,39055,0,0,2,0,2
52064,110,15021,17989,39055,0,0,1,0,1
52065,110,15022,18287,39055,0,0,1,0,1
52066,110,15024,17963,39055,0,0,1,0,1
52067,110,15026,18623;18915,39055,0,0,2,0,2
52068,110,15027,18550;19061;22026;22228;22699;22919,39055,2,2,2,0,6
52069,110,15029,18812,39055,0,0,1,0,1
52070,110,15030,18726;18976;22208,39055,0,1,2,0,3
52071,110,15031,18750,39055,0,0,1,0,1
52072,110,15033,18536;18650,39055,0,0,2,0,2
52073,110,15034,18979;19002;22914,39055,1,0,2,0,3
52074,110,15035,19463;22951,39055,1,0,1,0,2
52075,110,15037,19085,39055,0,0,1,0,1
52076,110,15038,19087,39055,0,0,1,0,1
52077,110,15039,19162,39055,0,0,1,0,1
52078,110,15041,18947;19618,39055,0,0,2,0,2
52079,110,15042,19352;19559,39055,0,0,2,0,2
52080,110,15043,19614,39055,0,0,1,0,1
52081,110,15044,19456;19561,39055,0,0,2,0,2
52082,110,15047,19689;19856,39055,0,0,2,0,2
52083,110,15048,19581;19720,39055,0,0,2,0,2
52084,110,15049,19214;19723;23061,39055,1,0,2,0,3
52085,110,15051,19808;20144;22756;22866,39055,2,0,2,0,4
52086,110,15052,19830;19846;22850;23068,39055,2,0,2,0,4
52087,110,15053,20268;22264,39055,0,1,1,0,2
52088,110,15056,19754;19931,39055,0,0,2,0,2
52089,110,15057,19510;19648;22954,39055,1,0,2,0,3
52090,110,15058,20498,39055,0,0,1,0,1
52091,110,15059,20008;22258,39055,0,1,1,0,2
52092,110,15060,20011;22365;22751,39055,1,1,1,0,3
52093,110,15061,20043;20687,39055,0,0,2,0,2
52094,110,15062,20073;20688,39055,0,0,2,0,2
52095,110,15063,20680,39055,0,0,1,0,1
52096,110,15064,20114;20344,39055,0,0,2,0,2
52097,110,15065,20120,39055,0,0,1,0,1
52098,110,15066,20157;20642,39055,0,0,2,0,2
52099,110,15067,20166;20766;22645,39055,0,1,2,0,3
52100,110,15068,20220;20535,39055,0,0,2,0,2
52101,110,15069,20259;20606,39055,0,0,2,0,2
52102,110,15070,20261;20730;22990,39055,1,0,2,0,3
52103,110,15071,20265;20585,39055,0,0,2,0,2
52104,110,15072,20281;20809,39055,0,0,2,0,2
52105,110,15073,20240;20291,39055,0,0,2,0,2
52106,110,15074,19822;20296,39055,0,0,2,0,2
52107,110,15075,20298,39055,0,0,1,0,1
52108,110,15076,20434;20548;23177,39055,1,0,2,0,3
52109,110,15077,20201;20435,39055,0,0,2,0,2
52110,110,15078,20156;20443,39055,0,0,2,0,2
52111,110,15079,20422;20455;22640;22764,39055,1,1,2,0,4
52112,110,15080,20461;20538,39055,0,0,2,0,2
52113,110,15081,20463;20890,39055,0,0,2,0,2
52114,110,15082,20150;20375,39055,0,0,2,0,2
52115,110,15083,20013;20172,39055,0,0,2,0,2
52116,110,15084,20932,39055,0,0,1,0,1
52117,110,15085,20869,39055,0,0,1,0,1
52118,110,15086,20517;20949,39055,0,0,2,0,2
52119,110,15087,20530,39055,0,0,1,0,1
52120,110,15088,19817,39055,0,0,1,0,1
52121,110,15089,20252;20547,39055,0,0,2,0,2
52122,110,15090,20489;20552,39055,0,0,2,0,2
52123,110,15091,20340;20574,39055,0,0,2,0,2
52124,110,15092,20580;21048,39055,0,0,2,0,2
52125,110,15093,20406;20598,39055,0,0,2,0,2
52126,110,15094,20568;20626,39055,0,0,2,0,2
52127,110,15095,20636,39055,0,0,1,0,1
52128,110,15096,20473;20653,39055,0,0,2,0,2
52129,110,15097,20661;20717,39055,0,0,2,0,2
52130,110,15098,20634;20692,39055,0,0,2,0,2
52131,110,15099,20924;23184,39055,1,0,1,0,2
52132,110,15100,20638;20746,39055,0,0,2,0,2
52133,110,15102,16013,39420,0,0,1,0,1
52134,110,15103,16022,39420,0,0,1,0,1
52135,110,15104,16155,39420,0,0,1,0,1
52136,110,15105,16519,39420,0,0,1,0,1
52137,110,15106,16488,39420,0,0,1,0,1
52138,110,15107,16712,39420,0,0,1,0,1
52139,110,15109,16782,39420,0,0,1,0,1
52140,110,15110,16889,39420,0,0,1,0,1
52141,110,15111,16205;16618,39420,0,0,2,0,2
52142,110,15112,17128,39420,0,0,1,0,1
52143,110,15115,17385,39420,0,0,1,0,1
52144,110,15116,17414,39420,0,0,1,0,1
52145,110,15117,17468,39420,0,0,1,0,1
52146,110,15118,17497,39420,0,0,1,0,1
52147,110,15119,17549,39420,0,0,1,0,1
52148,110,15120,17130,39420,0,0,1,0,1
52149,110,15122,17237,39420,0,0,1,0,1
52150,110,15123,17593,39420,0,0,1,0,1
52151,110,15124,17947,39420,0,0,1,0,1
52152,110,15126,18003,39420,0,0,1,0,1
52153,110,15127,17561,39420,0,0,1,0,1
52154,110,15128,18066,39420,0,0,1,0,1
52155,110,15129,18108,39420,0,0,1,0,1
52156,110,15132,17851,39420,0,0,1,0,1
52157,110,15133,18488,39420,0,0,1,0,1
52158,110,15135,18404,39420,0,0,1,0,1
52159,110,15136,18518,39420,0,0,1,0,1
52160,110,15137,18758;19474;22953,39420,1,0,2,0,3
52161,110,15139,18847,39420,0,0,1,0,1
52162,110,15140,18941,39420,0,0,1,0,1
52163,110,15141,19006;19188,39420,0,0,2,0,2
52164,110,15142,19026;19042,39420,0,0,2,0,2
52165,110,15143,19079,39420,0,0,1,0,1
52166,110,15144,19208;20193,39420,0,0,2,0,2
52167,110,15145,19242,39420,0,0,1,0,1
52168,110,15147,19205;19292;22237,39420,0,1,2,0,3
52169,110,15149,19464;19537;22599;22730;22956,39420,2,1,2,0,5
52170,110,15150,19651,39420,0,0,1,0,1
52171,110,15151,19713;20035;23076,39420,1,0,2,0,3
52172,110,15152,19637,39420,0,0,1,0,1
52173,110,15154,19801;20369,39420,0,0,2,0,2
52174,110,15155,19845;20101,39420,0,0,2,0,2
52175,110,15156,19877;19990,39420,0,0,2,0,2
52176,110,15157,19967;20033,39420,0,0,2,0,2
52177,110,15158,19968;20012,39420,0,0,2,0,2
52178,110,15159,20083;20643,39420,0,0,2,0,2
52179,110,15160,20123;20206;23165,39420,1,0,2,0,3
52180,110,15161,20125;20155,39420,0,0,2,0,2
52181,110,15162,20180;20556,39420,0,0,2,0,2
52182,110,15163,19833,39420,0,0,1,0,1
52183,110,15164,20287;20879,39420,0,0,2,0,2
52184,110,15165,20354,39420,0,0,1,0,1
52185,110,15168,20093,39420,0,0,1,0,1
52186,110,15169,20392;20635,39420,0,0,2,0,2
52187,110,15170,20405;20472,39420,0,0,2,0,2
52188,110,15171,20438;20777,39420,0,0,2,0,2
52189,110,15172,20441;20756,39420,0,0,2,0,2
52190,110,15173,20459,39420,0,0,1,0,1
52191,110,15174,20471;21044,39420,0,0,2,0,2
52192,110,15175,20513;21163,39420,0,0,2,0,2
52193,110,15176,20524,39420,0,0,1,0,1
52194,110,15177,20216;20537;22882,39420,1,0,2,0,3
52195,110,15178,20414;20549,39420,0,0,2,0,2
52196,110,15179,20565;20861,39420,0,0,2,0,2
52197,110,15180,20567;20781,39420,0,0,2,0,2
52198,110,15181,20583,39420,0,0,1,0,1
52199,110,15182,20622;21100;23185,39420,1,0,2,0,3
52200,110,15183,20632;20931,39420,0,0,2,0,2
52201,110,15184,20266;20641,39420,0,0,2,0,2
52202,110,15185,20652;21143,39420,0,0,2,0,2
52203,110,15186,20658;20859,39420,0,0,2,0,2
52204,110,15187,20601;20659,39420,0,0,2,0,2
52205,110,15188,20645;20660,39420,0,0,2,0,2
52206,110,15189,20182;20690,39420,0,0,2,0,2
52207,110,15190,20706;21020,39420,0,0,2,0,2
52208,110,15191,20743;20956,39420,0,0,2,0,2
52209,110,15192,20225;20751,39420,0,0,2,0,2
52210,110,15193,20516;20769;23181,39420,1,0,2,0,3
52211,110,15194,20785;20984,39420,0,0,2,0,2
52212,110,15195,20808;20971,39420,0,0,2,0,2
52213,110,15196,20702;20810,39420,0,0,2,0,2
52214,110,15197,20827;20948,39420,0,0,2,0,2
52215,110,15198,20833,39420,0,0,1,0,1
52216,110,15199,20843;20892,39420,0,0,2,0,2
52217,110,15200,15803,39785,0,0,1,0,1
52218,110,15201,16248,39785,0,0,1,0,1
52219,110,15202,16266;16379,39785,0,0,2,0,2
52220,110,15203,16359,39785,0,0,1,0,1
52221,110,15204,16370,39785,0,0,1,0,1
52222,110,15205,16374,39785,0,0,1,0,1
52223,110,15206,16491,39785,0,0,1,0,1
52224,110,15208,16524,39785,0,0,1,0,1
52225,110,15209,16638,39785,0,0,1,0,1
52226,110,15210,17224,39785,0,0,1,0,1
52227,110,15211,16994,39785,0,0,1,0,1
52228,110,15212,16976,39785,0,0,1,0,1
52229,110,15213,17078,39785,0,0,1,0,1
52230,110,15214,16632,39785,0,0,1,0,1
52231,110,15215,16882,39785,0,0,1,0,1
52232,110,15216,16664,39785,0,0,1,0,1
52233,110,15219,17276,39785,0,0,1,0,1
52234,110,15220,17304,39785,0,0,1,0,1
52235,110,15221,17297,39785,0,0,1,0,1
52236,110,15222,17368,39785,0,0,1,0,1
52237,110,15223,17063,39785,0,0,1,0,1
52238,110,15224,17625,39785,0,0,1,0,1
52239,110,15225,17356,39785,0,0,1,0,1
52240,110,15226,16804,39785,0,0,1,0,1
52241,110,15227,17686,39785,0,0,1,0,1
52242,110,15228,17692,39785,0,0,1,0,1
52243,110,15229,17581,39785,0,0,1,0,1
52244,110,15230,17567,39785,0,0,1,0,1
52245,110,15231,17571,39785,0,0,1,0,1
52246,110,15232,17973,39785,0,0,1,0,1
52247,110,15233,17804,39785,0,0,1,0,1
52248,110,15234,18076,39785,0,0,1,0,1
52249,110,15235,18305,39785,0,0,1,0,1
52250,110,15236,18322,39785,0,0,1,0,1
52251,110,15237,18151,39785,0,0,1,0,1
52252,110,15238,18310,39785,0,0,1,0,1
52253,110,15242,18981,39785,0,0,1,0,1
52254,110,15243,19394;22042;23132,39785,1,1,1,0,3
52255,110,15244,19309,39785,0,0,1,0,1
52256,110,15245,19402,39785,0,0,1,0,1
52257,110,15246,19508,39785,0,0,1,0,1
52258,110,15247,19523,39785,0,0,1,0,1
52259,110,15248,19692;20160,39785,0,0,2,0,2
52260,110,15249,19760,39785,0,0,1,0,1
52261,110,15250,19761;20062;22495,39785,0,1,2,0,3
52262,110,15251,19870;20209;22369;22868,39785,1,1,2,0,4
52263,110,15252,19940;20226;22629;22869,39785,1,1,2,0,4
52264,110,15253,19976,39785,0,0,1,0,1
52265,110,15255,20044;20361,39785,0,0,2,0,2
52266,110,15256,20065;20171,39785,0,0,2,0,2
52267,110,15257,20072;20188;22366,39785,0,1,2,0,3
52268,110,15258,20104;20321;23170,39785,1,0,2,0,3
52269,110,15259,20163;20426;23088,39785,1,0,2,0,3
52270,110,15260,20207;20745;23100,39785,1,0,2,0,3
52271,110,15261,20230;20301,39785,0,0,2,0,2
52272,110,15262,20234;20241;22263;23083,39785,1,1,2,0,4
52273,110,15263,20250;20591,39785,0,0,2,0,2
52274,110,15264,20264,39785,0,0,1,0,1
52275,110,15265,20302,39785,0,0,1,0,1
52276,110,15266,20324,39785,0,0,1,0,1
52277,110,15267,20329;20737,39785,0,0,2,0,2
52278,110,15268,20334;20358,39785,0,0,2,0,2
52279,110,15269,20345;20447,39785,0,0,2,0,2
52280,110,15270,20136;20357,39785,0,0,2,0,2
52281,110,15271,20400,39785,0,0,1,0,1
52282,110,15272,20377,39785,0,0,1,0,1
52283,110,15273,20153;20427;23173,39785,1,0,2,0,3
52284,110,15274,20506;20836;22879,39785,1,0,2,0,3
52285,110,15275,20515;20615,39785,0,0,2,0,2
52286,110,15276,20519;20822,39785,0,0,2,0,2
52287,110,15277,20269;20563,39785,0,0,2,0,2
52288,110,15278,20566;20899,39785,0,0,2,0,2
52289,110,15279,20590;20963,39785,0,0,2,0,2
52290,110,15280,20613;21204,39785,0,0,2,0,2
52291,110,15281,20619;21055,39785,0,0,2,0,2
52292,110,15282,20639;20739,39785,0,0,2,0,2
52293,110,15283,20644;20677,39785,0,0,2,0,2
52294,110,15284,20691;20778,39785,0,0,2,0,2
52295,110,15285,20694,39785,0,0,1,0,1
52296,110,15286,20466;20698,39785,0,0,2,0,2
52297,110,15287,20385;20714,39785,0,0,2,0,2
52298,110,15288,20715;21036,39785,0,0,2,0,2
52299,110,15289,20724;20976,39785,0,0,2,0,2
52300,110,15290,20731;20962,39785,0,0,2,0,2
52301,110,15291,20735,39785,0,0,1,0,1
52302,110,15292,20748;20964,39785,0,0,2,0,2
52303,110,15293,20623;20762;23179,39785,1,0,2,0,3
52304,110,15294,20763;23101,39785,1,0,1,0,2
52305,110,15295,20773;20945,39785,0,0,2,0,2
52306,110,15296,20783,39785,0,0,1,0,1
52307,110,15297,20844;21058,39785,0,0,2,0,2
52308,110,15298,20847;20939,39785,0,0,2,0,2
52309,110,15299,20853;21072,39785,0,0,2,0,2
52310,110,15300,20868;21171,39785,0,0,2,0,2
52311,110,15301,20770;20871,39785,0,0,2,0,2
52312,110,15302,20893;21124,39785,0,0,2,0,2
52313,110,15303,20918;21052,39785,0,0,2,0,2
52314,110,15304,20806;20923,39785,0,0,2,0,2
52315,110,15305,20507,39785,0,0,1,0,1
52316,110,15306,20951;21096,39785,0,0,2,0,2
52317,110,15307,20961;21038,39785,0,0,2,0,2
52318,110,15308,16015,40150,0,0,1,0,1
52319,110,15309,16228,40150,0,0,1,0,1
52320,110,15310,16502,40150,0,0,1,0,1
52321,110,15311,16689,40150,0,0,1,0,1
52322,110,15312,16538,40150,0,0,1,0,1
52323,110,15313,16149,40150,0,0,1,0,1
52324,110,15314,16649,40150,0,0,1,0,1
52325,110,15315,15954,40150,0,0,1,0,1
52326,110,15316,16713,40150,0,0,1,0,1
52327,110,15317,16844,40150,0,0,1,0,1
52328,110,15318,16908,40150,0,0,1,0,1
52329,110,15319,16571,40150,0,0,1,0,1
52330,110,15320,16914,40150,0,0,1,0,1
52331,110,15321,17094,40150,0,0,1,0,1
52332,110,15322,17067,40150,0,0,1,0,1
52333,110,15323,17437,40150,0,0,1,0,1
52334,110,15324,17095,40150,0,0,1,0,1
52335,110,15325,17390,40150,0,0,1,0,1
52336,110,15326,17612,40150,0,0,1,0,1
52337,110,15327,17777,40150,0,0,1,0,1
52338,110,15328,17443,40150,0,0,1,0,1
52339,110,15329,17970,40150,0,0,1,0,1
52340,110,15330,17815,40150,0,0,1,0,1
52341,110,15331,17629,40150,0,0,1,0,1
52342,110,15332,18138;18634;22106,40150,0,1,2,0,3
52343,110,15333,18348,40150,0,0,1,0,1
52344,110,15334,18459,40150,0,0,1,0,1
52345,110,15335,18471,40150,0,0,1,0,1
52346,110,15336,18618;19152;22923,40150,1,0,2,0,3
52347,110,15337,18691,40150,0,0,1,0,1
52348,110,15338,18544,40150,0,0,1,0,1
52349,110,15339,18835,40150,0,0,1,0,1
52350,110,15340,18617,40150,0,0,1,0,1
52351,110,15341,18846,40150,0,0,1,0,1
52352,110,15342,18601,40150,0,0,1,0,1
52353,110,15344,19054,40150,0,0,1,0,1
52354,110,15345,19217,40150,0,0,1,0,1
52355,110,15346,19315,40150,0,0,1,0,1
52356,110,15347,19378,40150,0,0,1,0,1
52357,110,15348,19262,40150,0,0,1,0,1
52358,110,15349,19424,40150,0,0,1,0,1
52359,110,15350,19526;19701,40150,0,0,2,0,2
52360,110,15351,19441,40150,0,0,1,0,1
52361,110,15352,19548,40150,0,0,1,0,1
52362,110,15353,19652,40150,0,0,1,0,1
52363,110,15354,19865;19890;22744,40150,1,0,2,0,3
52364,110,15355,19866,40150,0,0,1,0,1
52365,110,15356,20001;20600,40150,0,0,2,0,2
52366,110,15357,19588,40150,0,0,1,0,1
52367,110,15358,20016;20251;22758,40150,1,0,2,0,3
52368,110,15359,20021,40150,0,0,1,0,1
52369,110,15360,19792;20061;22754,40150,1,0,2,0,3
52370,110,15361,20077;20374;23087,40150,1,0,2,0,3
52371,110,15362,20088,40150,0,0,1,0,1
52372,110,15363,20131;20148;22979,40150,1,0,2,0,3
52373,110,15364,19825,40150,0,0,1,0,1
52374,110,15365,20263;20478;22759,40150,1,0,2,0,3
52375,110,15366,20319;20335;22760,40150,1,0,2,0,3
52376,110,15367,20337;20520,40150,0,0,2,0,2
52377,110,15368,20382,40150,0,0,1,0,1
52378,110,15369,20408,40150,0,0,1,0,1
52379,110,15370,20421;20696,40150,0,0,2,0,2
52380,110,15371,20432,40150,0,0,1,0,1
52381,110,15372,20439;20594,40150,0,0,2,0,2
52382,110,15373,20440;20485;22499;22987;23174,40150,2,1,2,0,5
52383,110,15374,20023;20492;23091,40150,1,0,2,0,3
52384,110,15375,20005,40150,0,0,1,0,1
52385,110,15376,20508;20811,40150,0,0,2,0,2
52386,110,15377,20630,40150,0,0,1,0,1
52387,110,15378,20504,40150,0,0,1,0,1
52388,110,15379,20667;20998,40150,0,0,2,0,2
52389,110,15380,20674;20875,40150,0,0,2,0,2
52390,110,15381,20723,40150,0,0,1,0,1
52391,110,15382,20754;20774,40150,0,0,2,0,2
52392,110,15383,20782;21281,40150,0,0,2,0,2
52393,110,15384,20797;21284,40150,0,0,2,0,2
52394,110,15385,20816;20882,40150,0,0,2,0,2
52395,110,15386,20828;21022,40150,0,0,2,0,2
52396,110,15387,20339;20837,40150,0,0,2,0,2
52397,110,15388,20854;20966,40150,0,0,2,0,2
52398,110,15389,20856;21154,40150,0,0,2,0,2
52399,110,15390,20866;21196,40150,0,0,2,0,2
52400,110,15391,20512,40150,0,0,1,0,1
52401,110,15392,20883;20985,40150,0,0,2,0,2
52402,110,15393,20895;21198,40150,0,0,2,0,2
52403,110,15394,20926;20943,40150,0,0,2,0,2
52404,110,15395,20929,40150,0,0,1,0,1
52405,110,15396,20930;21338,40150,0,1,1,0,2
52406,110,15397,20960;21103,40150,0,0,2,0,2
52407,110,15398,20977;21181,40150,0,0,2,0,2
52408,110,15399,20987;21238,40150,0,0,2,0,2
52409,110,15400,20913;21011,40150,0,0,2,0,2
52410,110,15401,21012,40150,0,0,1,0,1
52411,120,5663,13760,5840,0,0,0,1,1
52412,120,6213,13700,7665,0,0,0,1,1
52413,120,6620,14556,9125,0,0,0,1,1
52414,120,6757,14681;15177,9855,0,0,0,2,2
52415,120,6806,14284,9855,0,0,0,1,1
52416,120,7052,14514,10950,0,0,0,1,1
52417,120,7211,13670,11680,0,0,0,1,1
52418,120,7213,15004,11680,0,0,0,1,1
52419,120,7672,14838,13870,0,0,0,1,1
52420,120,7737,16239,13870,0,0,0,1,1
52421,120,7933,12202,14600,0,0,0,1,1
52422,120,7937,16429,14600,0,0,0,1,1
52423,120,7944,12155,14600,0,0,0,1,1
52424,120,7945,12449,14600,0,0,0,1,1
52425,120,7948,12233,14600,0,0,0,1,1
52426,120,8000,12317,14965,0,0,0,1,1
52427,120,8003,12730,14965,0,0,0,1,1
52428,120,8018,12629,14965,0,0,0,1,1
52429,120,8020,12665,14965,0,0,0,1,1
52430,120,8026,12370,14965,0,0,0,1,1
52431,120,8170,12061,15695,0,0,0,1,1
52432,120,8182,16651;16940;17167;17336;20957;23822,15695,1,0,3,2,6
52433,120,8190,16283;16550,15695,0,0,0,2,2
52434,120,8191,12755,15695,0,0,0,1,1
52435,120,8194,12684,15695,0,0,0,1,1
52436,120,8196,13241,15695,0,0,0,1,1
52437,120,8197,12901,15695,0,0,0,1,1
52438,120,8201,12795,15695,0,0,0,1,1
52439,120,8206,12871,15695,0,0,0,1,1
52440,120,8269,12495,16060,0,0,0,1,1
52441,120,8282,12963,16060,0,0,0,1,1
52442,120,8283,12735,16060,0,0,0,1,1
52443,120,8298,13084,16060,0,0,0,1,1
52444,120,8352,12640,16425,0,0,0,1,1
52445,120,8360,12792,16425,0,0,0,1,1
52446,120,8369,12453,16425,0,0,0,1,1
52447,120,8376,13379,16425,0,0,0,1,1
52448,120,8377,13198,16425,0,0,0,1,1
52449,120,8378,12920,16425,0,0,0,1,1
52450,120,8386,13004,16425,0,0,0,1,1
52451,120,8390,12864,16425,0,0,0,1,1
52452,120,8445,12277,16790,0,0,0,1,1
52453,120,8448,12185,16790,0,0,0,1,1
52454,120,8456,12419,16790,0,0,0,1,1
52455,120,8469,12686,16790,0,0,0,1,1
52456,120,8470,13186,16790,0,0,0,1,1
52457,120,8475,12818,16790,0,0,0,1,1
52458,120,8486,13371,16790,0,0,0,1,1
52459,120,8487,12924,16790,0,0,0,1,1
52460,120,8488,12672,16790,0,0,0,1,1
52461,120,8490,12942,16790,0,0,0,1,1
52462,120,8491,16641;16853;21300,16790,0,0,1,2,3
52463,120,8492,12772,16790,0,0,0,1,1
52464,120,8521,17253;17306,17155,0,0,2,0,2
52465,120,8549,12733,17155,0,0,0,1,1
52466,120,8559,13272;15452,17155,0,0,0,2,2
52467,120,8561,13290,17155,0,0,0,1,1
52468,120,8562,12744,17155,0,0,0,1,1
52469,120,8564,13034,17155,0,0,0,1,1
52470,120,8567,13398,17155,0,0,0,1,1
52471,120,8569,12896,17155,0,0,0,1,1
52472,120,8570,13159,17155,0,0,0,1,1
52473,120,8571,13170,17155,0,0,0,1,1
52474,120,8573,12934,17155,0,0,0,1,1
52475,120,8574,12938,17155,0,0,0,1,1
52476,120,8578,13409,17155,0,0,0,1,1
52477,120,8581,12925,17155,0,0,0,1,1
52478,120,8585,16742,17155,0,0,0,1,1
52479,120,8588,13133,17155,0,0,0,1,1
52480,120,8589,13307,17155,0,0,0,1,1
52481,120,8628,12393,17520,0,0,0,1,1
52482,120,8632,12764,17520,0,0,0,1,1
52483,120,8643,12491,17520,0,0,0,1,1
52484,120,8645,12821,17520,0,0,0,1,1
52485,120,8651,12457,17520,0,0,0,1,1
52486,120,8660,13091,17520,0,0,0,1,1
52487,120,8665,13176,17520,0,0,0,1,1
52488,120,8667,13482,17520,0,0,0,1,1
52489,120,8669,13550,17520,0,0,0,1,1
52490,120,8672,13537,17520,0,0,0,1,1
52491,120,8673,13087,17520,0,0,0,1,1
52492,120,8675,13141,17520,0,0,0,1,1
52493,120,8713,16470;16707,17885,0,0,0,2,2
52494,120,8729,12577,17885,0,0,0,1,1
52495,120,8736,13415,17885,0,0,0,1,1
52496,120,8742,12404,17885,0,0,0,1,1
52497,120,8743,17384;17603,17885,0,0,2,0,2
52498,120,8746,13068,17885,0,0,0,1,1
52499,120,8747,12980,17885,0,0,0,1,1
52500,120,8749,12773;13184,17885,0,0,0,2,2
52501,120,8750,13630,17885,0,0,0,1,1
52502,120,8756,13043,17885,0,0,0,1,1
52503,120,8758,13432,17885,0,0,0,1,1
52504,120,8761,12718,17885,0,0,0,1,1
52505,120,8764,13131,17885,0,0,0,1,1
52506,120,8767,13155,17885,0,0,0,1,1
52507,120,8769,13183,17885,0,0,0,1,1
52508,120,8774,13250,17885,0,0,0,1,1
52509,120,8775,13180,17885,0,0,0,1,1
52510,120,8783,12666;13518,17885,0,0,0,2,2
52511,120,8784,13468,17885,0,0,0,1,1
52512,120,8785,13703,17885,0,0,0,1,1
52513,120,8786,13369;13669,17885,0,0,0,2,2
52514,120,8853,13053,18250,0,0,0,1,1
52515,120,8854,13470,18250,0,0,0,1,1
52516,120,8856,12958,18250,0,0,0,1,1
52517,120,8858,13436,18250,0,0,0,1,1
52518,120,8860,13022,18250,0,0,0,1,1
52519,120,8861,13026,18250,0,0,0,1,1
52520,120,8864,12867,18250,0,0,0,1,1
52521,120,8868,12998,18250,0,0,0,1,1
52522,120,8869,13137,18250,0,0,0,1,1
52523,120,8873,13216,18250,0,0,0,1,1
52524,120,8874,13360,18250,0,0,0,1,1
52525,120,8877,12784,18250,0,0,0,1,1
52526,120,8878,13304,18250,0,0,0,1,1
52527,120,8883,13359;13943,18250,0,0,0,2,2
52528,120,8884,13539,18250,0,0,0,1,1
52529,120,8885,13471,18250,0,0,0,1,1
52530,120,8887,13851,18250,0,0,0,1,1
52531,120,8892,13532,18250,0,0,0,1,1
52532,120,8931,12856,18615,0,0,0,1,1
52533,120,8934,13103,18615,0,0,0,1,1
52534,120,8940,12957,18615,0,0,0,1,1
52535,120,8943,12827,18615,0,0,0,1,1
52536,120,8945,12843,18615,0,0,0,1,1
52537,120,8956,13506,18615,0,0,0,1,1
52538,120,8958,13842,18615,0,0,0,1,1
52539,120,8959,13508,18615,0,0,0,1,1
52540,120,8960,13163;13172,18615,0,0,0,2,2
52541,120,8963,13191,18615,0,0,0,1,1
52542,120,8964,14014,18615,0,0,0,1,1
52543,120,8967,13963,18615,0,0,0,1,1
52544,120,8973,12477;13386,18615,0,0,0,2,2
52545,120,8974,13407,18615,0,0,0,1,1
52546,120,8977,13752;13856,18615,0,0,0,2,2
52547,120,8978,14044,18615,0,0,0,1,1
52548,120,8986,13573,18615,0,0,0,1,1
52549,120,8987,13585,18615,0,0,0,1,1
52550,120,8989,13548;13883,18615,0,0,0,2,2
52551,120,8993,13528;13644,18615,0,0,0,2,2
52552,120,9036,12917;18771;22115;22542,18980,0,1,2,1,4
52553,120,9040,12548,18980,0,0,0,1,1
52554,120,9045,13497,18980,0,0,0,1,1
52555,120,9050,13041,18980,0,0,0,1,1
52556,120,9052,13077,18980,0,0,0,1,1
52557,120,9060,13483,18980,0,0,0,1,1
52558,120,9062,13256,18980,0,0,0,1,1
52559,120,9066,13766,18980,0,0,0,1,1
52560,120,9068,13372;13457,18980,0,0,0,2,2
52561,120,9069,13027,18980,0,0,0,1,1
52562,120,9070,13055,18980,0,0,0,1,1
52563,120,9073,13458,18980,0,0,0,1,1
52564,120,9074,13461,18980,0,0,0,1,1
52565,120,9075,13448,18980,0,0,0,1,1
52566,120,9077,13534,18980,0,0,0,1,1
52567,120,9079,13996,18980,0,0,0,1,1
52568,120,9080,13705,18980,0,0,0,1,1
52569,120,9082,13641,18980,0,0,0,1,1
52570,120,9086,13716,18980,0,0,0,1,1
52571,120,9088,13930,18980,0,0,0,1,1
52572,120,9090,14057,18980,0,0,0,1,1
52573,120,9091,13904;13938,18980,0,0,0,2,2
52574,120,9125,12480;12676,19345,0,0,0,2,2
52575,120,9134,17020;17226,19345,0,0,2,0,2
52576,120,9135,13232,19345,0,0,0,1,1
52577,120,9136,14204,19345,0,0,0,1,1
52578,120,9137,13037;13106,19345,0,0,0,2,2
52579,120,9138,13611,19345,0,0,0,1,1
52580,120,9141,13672;13958,19345,0,0,0,2,2
52581,120,9146,13940,19345,0,0,0,1,1
52582,120,9148,13717,19345,0,0,0,1,1
52583,120,9150,13936,19345,0,0,0,1,1
52584,120,9152,14090;14339,19345,0,0,0,2,2
52585,120,9153,12952,19345,0,0,0,1,1
52586,120,9154,14115,19345,0,0,0,1,1
52587,120,9155,13978,19345,0,0,0,1,1
52588,120,9156,14041,19345,0,0,0,1,1
52589,120,9157,14063,19345,0,0,0,1,1
52590,120,9160,13561,19345,0,0,0,1,1
52591,120,9161,13677,19345,0,0,0,1,1
52592,120,9166,13732,19345,0,0,0,1,1
52593,120,9168,13323,19345,0,0,0,1,1
52594,120,9170,13431;13771,19345,0,0,0,2,2
52595,120,9171,13600,19345,0,0,0,1,1
52596,120,9172,13654;13858,19345,0,0,0,2,2
52597,120,9175,13793;13849,19345,0,0,0,2,2
52598,120,9177,13845,19345,0,0,0,1,1
52599,120,9181,13901;13919,19345,0,0,0,2,2
52600,120,9213,12288,19710,0,0,0,1,1
52601,120,9219,13676,19710,0,0,0,1,1
52602,120,9223,13162,19710,0,0,0,1,1
52603,120,9226,13678,19710,0,0,0,1,1
52604,120,9227,13515,19710,0,0,0,1,1
52605,120,9232,13582,19710,0,0,0,1,1
52606,120,9233,13477,19710,0,0,0,1,1
52607,120,9234,13924,19710,0,0,0,1,1
52608,120,9236,14110,19710,0,0,0,1,1
52609,120,9237,13435,19710,0,0,0,1,1
52610,120,9242,14327;14337,19710,0,0,0,2,2
52611,120,9243,14054;14314,19710,0,0,0,2,2
52612,120,9244,13791,19710,0,0,0,1,1
52613,120,9245,13702,19710,0,0,0,1,1
52614,120,9246,13708,19710,0,0,0,1,1
52615,120,9247,13712;14206,19710,0,0,0,2,2
52616,120,9250,14362,19710,0,0,0,1,1
52617,120,9252,14462;14466,19710,0,0,0,2,2
52618,120,9255,14158,19710,0,0,0,1,1
52619,120,9256,13907,19710,0,0,0,1,1
52620,120,9257,13914,19710,0,0,0,1,1
52621,120,9258,13926,19710,0,0,0,1,1
52622,120,9260,13948,19710,0,0,0,1,1
52623,120,9262,13990,19710,0,0,0,1,1
52624,120,9263,14097;14264,19710,0,0,0,2,2
52625,120,9264,14035,19710,0,0,0,1,1
52626,120,9265,13813,19710,0,0,0,1,1
52627,120,9266,13871,19710,0,0,0,1,1
52628,120,9267,14080;14451,19710,0,0,0,2,2
52629,120,9315,12853,20075,0,0,0,1,1
52630,120,9316,13411,20075,0,0,0,1,1
52631,120,9318,12626,20075,0,0,0,1,1
52632,120,9321,13634,20075,0,0,0,1,1
52633,120,9323,14171,20075,0,0,0,1,1
52634,120,9325,13575,20075,0,0,0,1,1
52635,120,9327,14325;14359,20075,0,0,0,2,2
52636,120,9329,14191,20075,0,0,0,1,1
52637,120,9330,13710,20075,0,0,0,1,1
52638,120,9331,13516,20075,0,0,0,1,1
52639,120,9332,14030,20075,0,0,0,1,1
52640,120,9333,14443,20075,0,0,0,1,1
52641,120,9335,14186,20075,0,0,0,1,1
52642,120,9336,13799,20075,0,0,0,1,1
52643,120,9338,13854,20075,0,0,0,1,1
52644,120,9339,13877,20075,0,0,0,1,1
52645,120,9340,13888;14130,20075,0,0,0,2,2
52646,120,9341,13908,20075,0,0,0,1,1
52647,120,9342,14312,20075,0,0,0,1,1
52648,120,9343,13912,20075,0,0,0,1,1
52649,120,9344,13406,20075,0,0,0,1,1
52650,120,9346,13152,20075,0,0,0,1,1
52651,120,9348,13951;14282,20075,0,0,0,2,2
52652,120,9350,14009,20075,0,0,0,1,1
52653,120,9351,14225,20075,0,0,0,1,1
52654,120,9354,14546,20075,0,0,0,1,1
52655,120,9355,14530,20075,0,0,0,1,1
52656,120,9356,13679;13809,20075,0,0,0,2,2
52657,120,9357,13816;14125,20075,0,0,0,2,2
52658,120,9360,13481;14154,20075,0,0,0,2,2
52659,120,9361,14369,20075,0,0,0,1,1
52660,120,9362,14128;14181,20075,0,0,0,2,2
52661,120,9407,12902,20440,0,0,0,1,1
52662,120,9409,13044;13572,20440,0,0,0,2,2
52663,120,9415,12939;13104,20440,0,0,0,2,2
52664,120,9417,13013,20440,0,0,0,1,1
52665,120,9426,13331,20440,0,0,0,1,1
52666,120,9430,13897,20440,0,0,0,1,1
52667,120,9431,13525,20440,0,0,0,1,1
52668,120,9434,14074,20440,0,0,0,1,1
52669,120,9435,13722;14184,20440,0,0,0,2,2
52670,120,9436,13731,20440,0,0,0,1,1
52671,120,9437,13806;13855,20440,0,0,0,2,2
52672,120,9438,13961;14168,20440,0,0,0,2,2
52673,120,9440,14167,20440,0,0,0,1,1
52674,120,9441,14318,20440,0,0,0,1,1
52675,120,9442,13601;13844,20440,0,0,0,2,2
52676,120,9443,18756,20440,0,0,1,0,1
52677,120,9445,13934,20440,0,0,0,1,1
52678,120,9446,13276,20440,0,0,0,1,1
52679,120,9447,14330,20440,0,0,0,1,1
52680,120,9449,13920,20440,0,0,0,1,1
52681,120,9452,14234;14343,20440,0,0,0,2,2
52682,120,9454,14412,20440,0,0,0,1,1
52683,120,9455,14652,20440,0,0,0,1,1
52684,120,9456,14320,20440,0,0,0,1,1
52685,120,9457,14153;14677,20440,0,0,0,2,2
52686,120,9459,14231;14503,20440,0,0,0,2,2
52687,120,9463,14076,20440,0,0,0,1,1
52688,120,9464,14088;14119,20440,0,0,0,2,2
52689,120,9465,14537,20440,0,0,0,1,1
52690,120,9466,14113;14626,20440,0,0,0,2,2
52691,120,9468,14379;14468,20440,0,0,0,2,2
52692,120,9470,13784,20440,0,0,0,1,1
52693,120,9471,14747,20440,0,0,0,1,1
52694,120,9472,13837,20440,0,0,0,1,1
52695,120,9474,14376,20440,0,0,0,1,1
52696,120,9476,13987;14243,20440,0,0,0,2,2
52697,120,9477,14256;14611,20440,0,0,0,2,2
52698,120,9479,14292,20440,0,0,0,1,1
52699,120,9480,14354,20440,0,0,0,1,1
52700,120,9481,14319;14435,20440,0,0,0,2,2
52701,120,9525,12841,20805,0,0,0,1,1
52702,120,9529,13157;13785,20805,0,0,0,2,2
52703,120,9534,13346;13859,20805,0,0,0,2,2
52704,120,9537,14205,20805,0,0,0,1,1
52705,120,9538,13368,20805,0,0,0,1,1
52706,120,9539,13451;13962,20805,0,0,0,2,2
52707,120,9540,14011;14308,20805,0,0,0,2,2
52708,120,9543,13581,20805,0,0,0,1,1
52709,120,9546,13807,20805,0,0,0,1,1
52710,120,9547,13441;13684,20805,0,0,0,2,2
52711,120,9549,13840;14446,20805,0,0,0,2,2
52712,120,9552,13881,20805,0,0,0,1,1
52713,120,9553,14162,20805,0,0,0,1,1
52714,120,9554,14276,20805,0,0,0,1,1
52715,120,9557,14449;14621,20805,0,0,0,2,2
52716,120,9559,13952;14048,20805,0,0,0,2,2
52717,120,9560,14108,20805,0,0,0,1,1
52718,120,9561,14595,20805,0,0,0,1,1
52719,120,9562,14118,20805,0,0,0,1,1
52720,120,9563,14132,20805,0,0,0,1,1
52721,120,9564,14146,20805,0,0,0,1,1
52722,120,9565,14845,20805,0,0,0,1,1
52723,120,9566,14151,20805,0,0,0,1,1
52724,120,9567,14093;14478,20805,0,0,0,2,2
52725,120,9568,14194,20805,0,0,0,1,1
52726,120,9570,14202,20805,0,0,0,1,1
52727,120,9572,14232;14661,20805,0,0,0,2,2
52728,120,9573,13865;14500,20805,0,0,0,2,2
52729,120,9574,14532,20805,0,0,0,1,1
52730,120,9575,14253,20805,0,0,0,1,1
52731,120,9576,19314;22710;23124,20805,0,2,1,0,3
52732,120,9577,14602;14637;17999;21945,20805,0,0,2,2,4
52733,120,9578,14395;14822,20805,0,0,0,2,2
52734,120,9579,14061;14418,20805,0,0,0,2,2
52735,120,9580,14558;14678,20805,0,0,0,2,2
52736,120,9582,14459,20805,0,0,0,1,1
52737,120,9583,14563,20805,0,0,0,1,1
52738,120,9584,14778;14800,20805,0,0,0,2,2
52739,120,9627,12913,21170,0,0,0,1,1
52740,120,9628,13603,21170,0,0,0,1,1
52741,120,9632,12918;13635,21170,0,0,0,2,2
52742,120,9633,13490,21170,0,0,0,1,1
52743,120,9638,13284,21170,0,0,0,1,1
52744,120,9642,13782,21170,0,0,0,1,1
52745,120,9644,14262,21170,0,0,0,1,1
52746,120,9645,13589;13762,21170,0,0,0,2,2
52747,120,9646,14223,21170,0,0,0,1,1
52748,120,9647,13828,21170,0,0,0,1,1
52749,120,9649,13631;13866,21170,0,0,0,2,2
52750,120,9655,14368,21170,0,0,0,1,1
52751,120,9656,13989,21170,0,0,0,1,1
52752,120,9657,14026,21170,0,0,0,1,1
52753,120,9659,14056,21170,0,0,0,1,1
52754,120,9660,13969;14067,21170,0,0,0,2,2
52755,120,9661,14828;19416,21170,0,0,1,1,2
52756,120,9663,17049;17311;18338;18614;18734;18938;22426,21170,0,1,6,0,7
52757,120,9664,14010;14164,21170,0,0,0,2,2
52758,120,9665,14707,21170,0,0,0,1,1
52759,120,9666,14203,21170,0,0,0,1,1
52760,120,9667,14018;14229,21170,0,0,0,2,2
52761,120,9668,14585,21170,0,0,0,1,1
52762,120,9670,14322;14733,21170,0,0,0,2,2
52763,120,9671,13748;14353,21170,0,0,0,2,2
52764,120,9672,14572;14694,21170,0,0,0,2,2
52765,120,9673,13861,21170,0,0,0,1,1
52766,120,9676,14415,21170,0,0,0,1,1
52767,120,9677,14429,21170,0,0,0,1,1
52768,120,9678,14434,21170,0,0,0,1,1
52769,120,9680,14908,21170,0,0,0,1,1
52770,120,9681,14768,21170,0,0,0,1,1
52771,120,9683,14263,21170,0,0,0,1,1
52772,120,9684,14525,21170,0,0,0,1,1
52773,120,9686,14483;14547,21170,0,0,0,2,2
52774,120,9687,14823,21170,0,0,0,1,1
52775,120,9688,14555,21170,0,0,0,1,1
52776,120,9689,15013,21170,0,0,0,1,1
52777,120,9690,14045;19450,21170,0,0,1,1,2
52778,120,9691,14608,21170,0,0,0,1,1
52779,120,9692,14930,21170,0,0,0,1,1
52780,120,9710,12033,21535,0,0,0,1,1
52781,120,9733,13725,21535,0,0,0,1,1
52782,120,9738,13358;13960,21535,0,0,0,2,2
52783,120,9739,13381;13412,21535,0,0,0,2,2
52784,120,9740,13770,21535,0,0,0,1,1
52785,120,9742,14077,21535,0,0,0,1,1
52786,120,9743,14033,21535,0,0,0,1,1
52787,120,9744,14278,21535,0,0,0,1,1
52788,120,9745,14065,21535,0,0,0,1,1
52789,120,9746,14698;14704,21535,0,0,0,2,2
52790,120,9749,13843,21535,0,0,0,1,1
52791,120,9750,14425,21535,0,0,0,1,1
52792,120,9754,19108;19288;19671;19919;22359;23144;23319;23531,21535,0,3,5,0,8
52793,120,9756,14441,21535,0,0,0,1,1
52794,120,9758,18732;19030;22697,21535,0,1,2,0,3
52795,120,9761,14965,21535,0,0,0,1,1
52796,120,9763,14142,21535,0,0,0,1,1
52797,120,9764,14409,21535,0,0,0,1,1
52798,120,9765,14112;14548,21535,0,0,0,2,2
52799,120,9766,14571,21535,0,0,0,1,1
52800,120,9767,14336,21535,0,0,0,1,1
52801,120,9768,14211;14726,21535,0,0,0,2,2
52802,120,9769,14220,21535,0,0,0,1,1
52803,120,9770,14179,21535,0,0,0,1,1
52804,120,9771,14578,21535,0,0,0,1,1
52805,120,9772,14012,21535,0,0,0,1,1
52806,120,9773,14976,21535,0,0,0,1,1
52807,120,9774,14849,21535,0,0,0,1,1
52808,120,9775,13686,21535,0,0,0,1,1
52809,120,9776,14763,21535,0,0,0,1,1
52810,120,9777,14239,21535,0,0,0,1,1
52811,120,9778,14857,21535,0,0,0,1,1
52812,120,9779,14406,21535,0,0,0,1,1
52813,120,9780,14540,21535,0,0,0,1,1
52814,120,9781,14413,21535,0,0,0,1,1
52815,120,9782,14417,21535,0,0,0,1,1
52816,120,9783,14270;14453,21535,0,0,0,2,2
52817,120,9784,14103;14470,21535,0,0,0,2,2
52818,120,9785,15139,21535,0,0,0,1,1
52819,120,9786,15058,21535,0,0,0,1,1
52820,120,9787,14496,21535,0,0,0,1,1
52821,120,9788,14456;18774;22007;22116,21535,0,0,3,1,4
52822,120,9789,14523,21535,0,0,0,1,1
52823,120,9790,14544,21535,0,0,0,1,1
52824,120,9791,14573;14586,21535,0,0,0,2,2
52825,120,9792,14581,21535,0,0,0,1,1
52826,120,9793,14091,21535,0,0,0,1,1
52827,120,9794,14779,21535,0,0,0,1,1
52828,120,9795,14860;15099,21535,0,0,0,2,2
52829,120,9796,14454,21535,0,0,0,1,1
52830,120,9797,14326,21535,0,0,0,1,1
52831,120,9799,14433;14731,21535,0,0,0,2,2
52832,120,9800,14816,21535,0,0,0,1,1
52833,120,9837,13711,21900,0,0,0,1,1
52834,120,9841,13397,21900,0,0,0,1,1
52835,120,9844,13781,21900,0,0,0,1,1
52836,120,9847,13625,21900,0,0,0,1,1
52837,120,9849,14432,21900,0,0,0,1,1
52838,120,9850,13718,21900,0,0,0,1,1
52839,120,9851,13786,21900,0,0,0,1,1
52840,120,9852,14305,21900,0,0,0,1,1
52841,120,9853,14079,21900,0,0,0,1,1
52842,120,9856,13997,21900,0,0,0,1,1
52843,120,9857,14200,21900,0,0,0,1,1
52844,120,9859,14222,21900,0,0,0,1,1
52845,120,9862,14516;14762,21900,0,0,0,2,2
52846,120,9863,14758;15325,21900,0,0,0,2,2
52847,120,9865,14195,21900,0,0,0,1,1
52848,120,9868,14297;14394,21900,0,0,0,2,2
52849,120,9869,14302;14893,21900,0,0,0,2,2
52850,120,9870,14593;14832;19149;22030;22234;22445;22808,21900,0,2,3,2,7
52851,120,9871,15003,21900,0,0,0,1,1
52852,120,9872,14290;14345,21900,0,0,0,2,2
52853,120,9873,14355,21900,0,0,0,1,1
52854,120,9874,14296,21900,0,0,0,1,1
52855,120,9876,14594;18580,21900,0,0,1,1,2
52856,120,9878,14753,21900,0,0,0,1,1
52857,120,9879,14430,21900,0,0,0,1,1
52858,120,9881,14813,21900,0,0,0,1,1
52859,120,9882,14843;15051,21900,0,0,0,2,2
52860,120,9883,14492,21900,0,0,0,1,1
52861,120,9884,14385;14819,21900,0,0,0,2,2
52862,120,9886,14641,21900,0,0,0,1,1
52863,120,9887,14560;14689,21900,0,0,0,2,2
52864,120,9888,14567,21900,0,0,0,1,1
52865,120,9891,15313,21900,0,0,0,1,1
52866,120,9892,14628,21900,0,0,0,1,1
52867,120,9893,14635,21900,0,0,0,1,1
52868,120,9894,14668,21900,0,0,0,1,1
52869,120,9895,14669;15005,21900,0,0,0,2,2
52870,120,9896,15229;15593,21900,0,0,0,2,2
52871,120,9897,14683,21900,0,0,0,1,1
52872,120,9899,14428;15056;18962,21900,0,0,1,2,3
52873,120,9900,14717;14749,21900,0,0,0,2,2
52874,120,9901,15265,21900,0,0,0,1,1
52875,120,9902,15283,21900,0,0,0,1,1
52876,120,9903,15035,21900,0,0,0,1,1
52877,120,9904,14391;14649,21900,0,0,0,2,2
52878,120,9938,14082,22265,0,0,0,1,1
52879,120,9939,13521,22265,0,0,0,1,1
52880,120,9940,14250,22265,0,0,0,1,1
52881,120,9946,13810;13847,22265,0,0,0,2,2
52882,120,9947,13864;13915,22265,0,0,0,2,2
52883,120,9948,14106;14338,22265,0,0,0,2,2
52884,120,9951,13994,22265,0,0,0,1,1
52885,120,9953,14159,22265,0,0,0,1,1
52886,120,9954,14268;14541,22265,0,0,0,2,2
52887,120,9955,14713,22265,0,0,0,1,1
52888,120,9956,13759;14170,22265,0,0,0,2,2
52889,120,9957,14122,22265,0,0,0,1,1
52890,120,9959,14180,22265,0,0,0,1,1
52891,120,9960,14920,22265,0,0,0,1,1
52892,120,9961,15320,22265,0,0,0,1,1
52893,120,9962,14309;14889,22265,0,0,0,2,2
52894,120,9964,14172,22265,0,0,0,1,1
52895,120,9965,14377;14900,22265,0,0,0,2,2
52896,120,9966,14383;14703,22265,0,0,0,2,2
52897,120,9967,14388,22265,0,0,0,1,1
52898,120,9968,17700;18202,22265,0,0,2,0,2
52899,120,9969,14464,22265,0,0,0,1,1
52900,120,9970,14476;14631,22265,0,0,0,2,2
52901,120,9971,14493;15031,22265,0,0,0,2,2
52902,120,9973,14553,22265,0,0,0,1,1
52903,120,9974,14796,22265,0,0,0,1,1
52904,120,9975,14771,22265,0,0,0,1,1
52905,120,9980,14640;15178,22265,0,0,0,2,2
52906,120,9981,14670,22265,0,0,0,1,1
52907,120,9982,14671,22265,0,0,0,1,1
52908,120,9983,15231,22265,0,0,0,1,1
52909,120,9984,14422;14721,22265,0,0,0,2,2
52910,120,9985,14742,22265,0,0,0,1,1
52911,120,9987,14869,22265,0,0,0,1,1
52912,120,9988,14803,22265,0,0,0,1,1
52913,120,9990,15142,22265,0,0,0,1,1
52914,120,9991,14877,22265,0,0,0,1,1
52915,120,9992,14879,22265,0,0,0,1,1
52916,120,9993,14542;14757,22265,0,0,0,2,2
52917,120,9995,15462,22265,0,0,0,1,1
52918,120,9997,18644;21992,22265,0,0,2,0,2
52919,120,9999,14907;14964,22265,0,0,0,2,2
52920,120,10000,14918;14973,22265,0,0,0,2,2
52921,120,10001,14648;14981,22265,0,0,0,2,2
52922,120,10002,15016;15120,22265,0,0,0,2,2
52923,120,10047,13623,22630,0,0,0,1,1
52924,120,10048,13480,22630,0,0,0,1,1
52925,120,10049,13794;14174,22630,0,0,0,2,2
52926,120,10052,13393;13574,22630,0,0,0,2,2
52927,120,10055,14589,22630,0,0,0,1,1
52928,120,10056,13898,22630,0,0,0,1,1
52929,120,10061,14559,22630,0,0,0,1,1
52930,120,10063,14712;14839,22630,0,0,0,2,2
52931,120,10064,14590,22630,0,0,0,1,1
52932,120,10065,14367,22630,0,0,0,1,1
52933,120,10066,14249;14306,22630,0,0,0,2,2
52934,120,10068,14255;14491,22630,0,0,0,2,2
52935,120,10069,14293;14577,22630,0,0,0,2,2
52936,120,10071,14342,22630,0,0,0,1,1
52937,120,10073,13879;14393,22630,0,0,0,2,2
52938,120,10074,14780,22630,0,0,0,1,1
52939,120,10076,15055,22630,0,0,0,1,1
52940,120,10077,13885;14455,22630,0,0,0,2,2
52941,120,10078,14502,22630,0,0,0,1,1
52942,120,10081,14610,22630,0,0,0,1,1
52943,120,10082,14280;14419,22630,0,0,0,2,2
52944,120,10083,15458,22630,0,0,0,1,1
52945,120,10084,15019,22630,0,0,0,1,1
52946,120,10085,14299;14623,22630,0,0,0,2,2
52947,120,10087,14684,22630,0,0,0,1,1
52948,120,10088,14791;15136,22630,0,0,0,2,2
52949,120,10089,15105;15475,22630,0,0,0,2,2
52950,120,10090,15261,22630,0,0,0,1,1
52951,120,10091,15225,22630,0,0,0,1,1
52952,120,10092,14566;14854,22630,0,0,0,2,2
52953,120,10093,15449,22630,0,0,0,1,1
52954,120,10094,14921,22630,0,0,0,1,1
52955,120,10095,14919;14958,22630,0,0,0,2,2
52956,120,10097,14992,22630,0,0,0,1,1
52957,120,10098,15297;15300,22630,0,0,0,2,2
52958,120,10099,14770;15413,22630,0,0,0,2,2
52959,120,10100,15007,22630,0,0,0,1,1
52960,120,10101,14426;15023,22630,0,0,0,2,2
52961,120,10103,15166,22630,0,0,0,1,1
52962,120,10104,15034;15153,22630,0,0,0,2,2
52963,120,10105,15064;15469,22630,0,0,0,2,2
52964,120,10106,15075,22630,0,0,0,1,1
52965,120,10107,15081;15147,22630,0,0,0,2,2
52966,120,10108,14983,22630,0,0,0,1,1
52967,120,10109,19910;23448;24096,22630,1,1,1,0,3
52968,120,10111,14352;14935,22630,0,0,0,2,2
52969,120,10112,15198;15388,22630,0,0,0,2,2
52970,120,10113,14597;15273,22630,0,0,0,2,2
52971,120,10114,15170;15230,22630,0,0,0,2,2
52972,120,10160,13416;13820,22995,0,0,0,2,2
52973,120,10162,14136,22995,0,0,0,1,1
52974,120,10164,13689;13988,22995,0,0,0,2,2
52975,120,10165,13558,22995,0,0,0,1,1
52976,120,10168,14031,22995,0,0,0,1,1
52977,120,10170,14370,22995,0,0,0,1,1
52978,120,10172,14163;14221,22995,0,0,0,2,2
52979,120,10173,14173;14176;18511,22995,0,0,1,2,3
52980,120,10176,14248,22995,0,0,0,1,1
52981,120,10177,15400,22995,0,0,0,1,1
52982,120,10178,14416;14674,22995,0,0,0,2,2
52983,120,10179,14300,22995,0,0,0,1,1
52984,120,10181,13925;14744,22995,0,0,0,2,2
52985,120,10182,14887,22995,0,0,0,1,1
52986,120,10185,15061,22995,0,0,0,1,1
52987,120,10186,14498;20521;23271;24119,22995,1,1,1,1,4
52988,120,10187,14281;14505,22995,0,0,0,2,2
52989,120,10188,14520;19444,22995,0,0,1,1,2
52990,120,10189,15029,22995,0,0,0,1,1
52991,120,10191,14482;14591,22995,0,0,0,2,2
52992,120,10192,15041,22995,0,0,0,1,1
52993,120,10194,14693,22995,0,0,0,1,1
52994,120,10195,14706,22995,0,0,0,1,1
52995,120,10197,14863,22995,0,0,0,1,1
52996,120,10198,14873,22995,0,0,0,1,1
52997,120,10199,15060;15551,22995,0,0,0,2,2
52998,120,10201,14894,22995,0,0,0,1,1
52999,120,10202,15221;15532,22995,0,0,0,2,2
53000,120,10203,14925;15151,22995,0,0,0,2,2
53001,120,10204,14929;15290,22995,0,0,0,2,2
53002,120,10205,15269;15430,22995,0,0,0,2,2
53003,120,10206,14692;15002,22995,0,0,0,2,2
53004,120,10207,15011,22995,0,0,0,1,1
53005,120,10208,15040;15595,22995,0,0,0,2,2
53006,120,10210,15196,22995,0,0,0,1,1
53007,120,10211,14966;15492,22995,0,0,0,2,2
53008,120,10212,15560,22995,0,0,0,1,1
53009,120,10215,16192,22995,0,0,0,1,1
53010,120,10216,15524,22995,0,0,0,1,1
53011,120,10217,14764;15209,22995,0,0,0,2,2
53012,120,10218,15625,22995,0,0,0,1,1
53013,120,10219,15636,22995,0,0,0,1,1
53014,120,10239,12948,23360,0,0,0,1,1
53015,120,10245,13648,23360,0,0,0,1,1
53016,120,10247,14208,23360,0,0,0,1,1
53017,120,10248,13425,23360,0,0,0,1,1
53018,120,10249,13860;14219,23360,0,0,0,2,2
53019,120,10251,13917,23360,0,0,0,1,1
53020,120,10252,13875,23360,0,0,0,1,1
53021,120,10254,14210;14275,23360,0,0,0,2,2
53022,120,10255,13817,23360,0,0,0,1,1
53023,120,10256,15212,23360,0,0,0,1,1
53024,120,10257,15059,23360,0,0,0,1,1
53025,120,10259,14645;14714;19361,23360,0,0,1,2,3
53026,120,10260,14579,23360,0,0,0,1,1
53027,120,10262,14504,23360,0,0,0,1,1
53028,120,10265,14787;15204,23360,0,0,0,2,2
53029,120,10266,14781,23360,0,0,0,1,1
53030,120,10267,15380,23360,0,0,0,1,1
53031,120,10268,14487;15223,23360,0,0,0,2,2
53032,120,10269,15394;15480,23360,0,0,0,2,2
53033,120,10270,14820,23360,0,0,0,1,1
53034,120,10271,14874;15067,23360,0,0,0,2,2
53035,120,10273,14895;14933,23360,0,0,0,2,2
53036,120,10274,15206,23360,0,0,0,1,1
53037,120,10275,14951,23360,0,0,0,1,1
53038,120,10276,14972;15439,23360,0,0,0,2,2
53039,120,10278,15193,23360,0,0,0,1,1
53040,120,10279,15062;15819,23360,0,0,0,2,2
53041,120,10281,14912,23360,0,0,0,1,1
53042,120,10283,14824;15113,23360,0,0,0,2,2
53043,120,10285,15589,23360,0,0,0,1,1
53044,120,10286,14836,23360,0,0,0,1,1
53045,120,10287,15535;15827,23360,0,0,0,2,2
53046,120,10288,15849,23360,0,0,0,1,1
53047,120,10289,15047,23360,0,0,0,1,1
53048,120,10290,14659;15227,23360,0,0,0,2,2
53049,120,10291,14886;15260,23360,0,0,0,2,2
53050,120,10292,15419,23360,0,0,0,1,1
53051,120,10293,15809,23360,0,0,0,1,1
53052,120,10294,15334,23360,0,0,0,1,1
53053,120,10295,15240;15348,23360,0,0,0,2,2
53054,120,10296,15474,23360,0,0,0,1,1
53055,120,10297,15363,23360,0,0,0,1,1
53056,120,10298,15091;15592,23360,0,0,0,2,2
53057,120,10299,15710;15855,23360,0,0,0,2,2
53058,120,10302,15440;15712,23360,0,0,0,2,2
53059,120,10303,15441,23360,0,0,0,1,1
53060,120,10305,15818,23360,0,0,0,1,1
53061,120,10306,14679;15467,23360,0,0,0,2,2
53062,120,10331,12826,23725,0,0,0,1,1
53063,120,10333,13765,23725,0,0,0,1,1
53064,120,10336,13567,23725,0,0,0,1,1
53065,120,10346,14407;14686,23725,0,0,0,2,2
53066,120,10352,14754,23725,0,0,0,1,1
53067,120,10354,14499,23725,0,0,0,1,1
53068,120,10356,14357;14519,23725,0,0,0,2,2
53069,120,10357,14075;14550;18554,23725,0,0,1,2,3
53070,120,10359,14739,23725,0,0,0,1,1
53071,120,10360,14691,23725,0,0,0,1,1
53072,120,10361,14461;14738,23725,0,0,0,2,2
53073,120,10362,14756,23725,0,0,0,1,1
53074,120,10363,14810,23725,0,0,0,1,1
53075,120,10364,15022;15830,23725,0,0,0,2,2
53076,120,10365,15301,23725,0,0,0,1,1
53077,120,10366,14858,23725,0,0,0,1,1
53078,120,10367,14868,23725,0,0,0,1,1
53079,120,10368,15487,23725,0,0,0,1,1
53080,120,10369,15097,23725,0,0,0,1,1
53081,120,10370,14913,23725,0,0,0,1,1
53082,120,10371,14695;14924,23725,0,0,0,2,2
53083,120,10372,15270,23725,0,0,0,1,1
53084,120,10373,14568;14948,23725,0,0,0,2,2
53085,120,10375,14582,23725,0,0,0,1,1
53086,120,10376,15010;15205,23725,0,0,0,2,2
53087,120,10379,15044;15048,23725,0,0,0,2,2
53088,120,10380,14968,23725,0,0,0,1,1
53089,120,10381,15049;15233,23725,0,0,0,2,2
53090,120,10382,14826;15464,23725,0,0,0,2,2
53091,120,10383,14902;15038,23725,0,0,0,2,2
53092,120,10384,15098;15202,23725,0,0,0,2,2
53093,120,10386,15137,23725,0,0,0,1,1
53094,120,10387,15107,23725,0,0,0,1,1
53095,120,10389,14587,23725,0,0,0,1,1
53096,120,10390,14998;15489,23725,0,0,0,2,2
53097,120,10391,15398,23725,0,0,0,1,1
53098,120,10394,15342,23725,0,0,0,1,1
53099,120,10397,14944;15881,23725,0,0,0,2,2
53100,120,10398,15695,23725,0,0,0,1,1
53101,120,10399,15763,23725,0,0,0,1,1
53102,120,10402,15973;16007,23725,0,0,0,2,2
53103,120,10403,15101;15425,23725,0,0,0,2,2
53104,120,10404,15858,23725,0,0,0,1,1
53105,120,10405,15192;15453,23725,0,0,0,2,2
53106,120,10406,15184,23725,0,0,0,1,1
53107,120,10407,15456;15848,23725,0,0,0,2,2
53108,120,10408,15164,23725,0,0,0,1,1
53109,120,10409,15483,23725,0,0,0,1,1
53110,120,10410,14931;15500,23725,0,0,0,2,2
53111,120,10411,15501;15941,23725,0,0,0,2,2
53112,120,10412,15675,23725,0,0,0,1,1
53113,120,10413,15507;15664,23725,0,0,0,2,2
53114,120,10414,15396;15582,23725,0,0,0,2,2
53115,120,10415,15614;16031,23725,0,0,0,2,2
53116,120,10417,15547;15990,23725,0,0,0,2,2
53117,120,10418,15359;15550,23725,0,0,0,2,2
53118,120,10419,15076;15556,23725,0,0,0,2,2
53119,120,10420,14769;15564;19479;23044;23854,23725,1,1,1,2,5
53120,120,10421,15597,23725,0,0,0,1,1
53121,120,10449,13058,24090,0,0,0,1,1
53122,120,10453,13352,24090,0,0,0,1,1
53123,120,10458,13727,24090,0,0,0,1,1
53124,120,10462,14494,24090,0,0,0,1,1
53125,120,10463,14313;14450,24090,0,0,0,2,2
53126,120,10468,14829;14840,24090,0,0,0,2,2
53127,120,10469,14286,24090,0,0,0,1,1
53128,120,10470,14794,24090,0,0,0,1,1
53129,120,10478,15420,24090,0,0,0,1,1
53130,120,10481,14851,24090,0,0,0,1,1
53131,120,10483,15087,24090,0,0,0,1,1
53132,120,10484,14956;14967,24090,0,0,0,2,2
53133,120,10485,14986,24090,0,0,0,1,1
53134,120,10486,14997,24090,0,0,0,1,1
53135,120,10488,15406,24090,0,0,0,1,1
53136,120,10489,14818,24090,0,0,0,1,1
53137,120,10490,15070;15542,24090,0,0,0,2,2
53138,120,10491,14811;15043,24090,0,0,0,2,2
53139,120,10492,15057;15892,24090,0,0,0,2,2
53140,120,10493,15246;15509,24090,0,0,0,2,2
53141,120,10494,14891,24090,0,0,0,1,1
53142,120,10495,15375,24090,0,0,0,1,1
53143,120,10496,14993,24090,0,0,0,1,1
53144,120,10497,19848;19892;24202,24090,1,0,2,0,3
53145,120,10498,14982;15172,24090,0,0,0,2,2
53146,120,10500,15294,24090,0,0,0,1,1
53147,120,10501,15222;15367,24090,0,0,0,2,2
53148,120,10502,15126;16050,24090,0,0,0,2,2
53149,120,10504,15275;15872,24090,0,0,0,2,2
53150,120,10505,15586,24090,0,0,0,1,1
53151,120,10506,15696;15760,24090,0,0,0,2,2
53152,120,10507,15730,24090,0,0,0,1,1
53153,120,10508,15207,24090,0,0,0,1,1
53154,120,10509,15249;15338,24090,0,0,0,2,2
53155,120,10510,14940;15339,24090,0,0,0,2,2
53156,120,10511,15361,24090,0,0,0,1,1
53157,120,10512,15402;15902,24090,0,0,0,2,2
53158,120,10513,15421;15869,24090,0,0,0,2,2
53159,120,10514,15426,24090,0,0,0,1,1
53160,120,10515,15650,24090,0,0,0,1,1
53161,120,10517,15604;16103,24090,0,0,0,2,2
53162,120,10518,15350;15444,24090,0,0,0,2,2
53163,120,10519,15496;15622,24090,0,0,0,2,2
53164,120,10520,15506;15831,24090,0,0,0,2,2
53165,120,10521,15316;15530,24090,0,0,0,2,2
53166,120,10522,15284;15581,24090,0,0,0,2,2
53167,120,10523,15012;15583,24090,0,0,0,2,2
53168,120,10524,15307,24090,0,0,0,1,1
53169,120,10525,15262;15613,24090,0,0,0,2,2
53170,120,10526,15615;16024,24090,0,0,0,2,2
53171,120,10527,15671;15799,24090,0,0,0,2,2
53172,120,10528,15635;15655,24090,0,0,0,2,2
53173,120,10530,15649;15891,24090,0,0,0,2,2
53174,120,10531,15660;15835,24090,0,0,0,2,2
53175,120,10532,15562,24090,0,0,0,1,1
53176,120,10533,15680;15741,24090,0,0,0,2,2
53177,120,10534,15540;15689,24090,0,0,0,2,2
53178,120,10559,13750,24455,0,0,0,1,1
53179,120,10565,13798,24455,0,0,0,1,1
53180,120,10572,13998;14185,24455,0,0,0,2,2
53181,120,10573,15282;15678,24455,0,0,0,2,2
53182,120,10579,14490,24455,0,0,0,1,1
53183,120,10581,14396,24455,0,0,0,1,1
53184,120,10582,14865;14890,24455,0,0,0,2,2
53185,120,10584,14841,24455,0,0,0,1,1
53186,120,10585,14662,24455,0,0,0,1,1
53187,120,10586,15215,24455,0,0,0,1,1
53188,120,10590,14752,24455,0,0,0,1,1
53189,120,10591,15092;15355,24455,0,0,0,2,2
53190,120,10592,14605,24455,0,0,0,1,1
53191,120,10595,15030;15387,24455,0,0,0,2,2
53192,120,10596,14946;15096,24455,0,0,0,2,2
53193,120,10597,15037,24455,0,0,0,1,1
53194,120,10600,15149,24455,0,0,0,1,1
53195,120,10601,15169;15251,24455,0,0,0,2,2
53196,120,10602,15146,24455,0,0,0,1,1
53197,120,10603,14513;15168,24455,0,0,0,2,2
53198,120,10604,15360,24455,0,0,0,1,1
53199,120,10605,15174,24455,0,0,0,1,1
53200,120,10606,15677,24455,0,0,0,1,1
53201,120,10607,15405;15742;20922,24455,0,0,1,2,3
53202,120,10608,15296;16035,24455,0,0,0,2,2
53203,120,10609,15854,24455,0,0,0,1,1
53204,120,10610,15523,24455,0,0,0,1,1
53205,120,10612,15621;15937,24455,0,0,0,2,2
53206,120,10613,15386,24455,0,0,0,1,1
53207,120,10615,15454,24455,0,0,0,1,1
53208,120,10617,15497;15505,24455,0,0,0,2,2
53209,120,10618,16152,24455,0,0,0,1,1
53210,120,10620,15544;15594,24455,0,0,0,2,2
53211,120,10622,15669,24455,0,0,0,1,1
53212,120,10623,15584;15808,24455,0,0,0,2,2
53213,120,10625,15362;15927,24455,0,0,0,2,2
53214,120,10626,14871;15642,24455,0,0,0,2,2
53215,120,10627,16182,24455,0,0,0,1,1
53216,120,10630,15684,24455,0,0,0,1,1
53217,120,10632,15714,24455,0,0,0,1,1
53218,120,10633,15721;15874,24455,0,0,0,2,2
53219,120,10634,15736,24455,0,0,0,1,1
53220,120,10635,15549;15868,24455,0,0,0,2,2
53221,120,10636,16275,24455,0,0,0,1,1
53222,120,10637,16011;16330,24455,0,0,0,2,2
53223,120,10638,15346;15770,24455,0,0,0,2,2
53224,120,10641,15964,24455,0,0,0,1,1
53225,120,10642,15826;15846,24455,0,0,0,2,2
53226,120,10643,16049,24455,0,0,0,1,1
53227,120,10644,15857;16173,24455,0,0,0,2,2
53228,120,10645,15866;16243,24455,0,0,0,2,2
53229,120,10646,15711;15882,24455,0,0,0,2,2
53230,120,10647,15274;15691,24455,0,0,0,2,2
53231,120,10673,13645,24820,0,0,0,1,1
53232,120,10676,13941,24820,0,0,0,1,1
53233,120,10683,14177;14444,24820,0,0,0,2,2
53234,120,10684,13694;14358,24820,0,0,0,2,2
53235,120,10689,14260,24820,0,0,0,1,1
53236,120,10690,14812,24820,0,0,0,1,1
53237,120,10695,14331;15006,24820,0,0,0,2,2
53238,120,10696,15021;20089,24820,0,0,1,1,2
53239,120,10699,14701;14760,24820,0,0,0,2,2
53240,120,10700,14424;14878,24820,0,0,0,2,2
53241,120,10701,16048,24820,0,0,0,1,1
53242,120,10702,14971;15511,24820,0,0,0,2,2
53243,120,10703,14977,24820,0,0,0,1,1
53244,120,10704,15218;15423,24820,0,0,0,2,2
53245,120,10705,15298,24820,0,0,0,1,1
53246,120,10706,14989;15084,24820,0,0,0,2,2
53247,120,10707,14975;15580,24820,0,0,0,2,2
53248,120,10708,15144;15368,24820,0,0,0,2,2
53249,120,10709,15484,24820,0,0,0,1,1
53250,120,10711,15676,24820,0,0,0,1,1
53251,120,10712,15289,24820,0,0,0,1,1
53252,120,10713,15293;16312;20105,24820,0,0,1,2,3
53253,120,10714,15072;15314,24820,0,0,0,2,2
53254,120,10716,15328;15645,24820,0,0,0,2,2
53255,120,10717,15433,24820,0,0,0,1,1
53256,120,10718,15336,24820,0,0,0,1,1
53257,120,10720,15476;20026,24820,0,0,1,1,2
53258,120,10721,15661;16025,24820,0,0,0,2,2
53259,120,10722,14856;15102,24820,0,0,0,2,2
53260,120,10723,15370;15422,24820,0,0,0,2,2
53261,120,10725,15533,24820,0,0,0,1,1
53262,120,10726,15349;15810,24820,0,0,0,2,2
53263,120,10727,15373,24820,0,0,0,1,1
53264,120,10729,15090,24820,0,0,0,1,1
53265,120,10732,15033,24820,0,0,0,1,1
53266,120,10734,15295;15920,24820,0,0,0,2,2
53267,120,10735,14872;15637;21539,24820,0,0,1,2,3
53268,120,10737,16222;16450,24820,0,0,0,2,2
53269,120,10739,15670;16027,24820,0,0,0,2,2
53270,120,10741,15418;15726,24820,0,0,0,2,2
53271,120,10742,15771;15794,24820,0,0,0,2,2
53272,120,10743,16362,24820,0,0,0,1,1
53273,120,10744,16186;16497,24820,0,0,0,2,2
53274,120,10745,16347;16372,24820,0,0,0,2,2
53275,120,10746,16227;16668,24820,0,0,0,2,2
53276,120,10747,15567;15917,24820,0,0,0,2,2
53277,120,10749,16217,24820,0,0,0,1,1
53278,120,10750,15952;16300,24820,0,0,0,2,2
53279,120,10751,15968;16299,24820,0,0,0,2,2
53280,120,10752,15982,24820,0,0,0,1,1
53281,120,10753,15787;15989,24820,0,0,0,2,2
53282,120,10754,15624;16189,24820,0,0,0,2,2
53283,120,10783,13586,25185,0,0,0,1,1
53284,120,10793,13848,25185,0,0,0,1,1
53285,120,10795,14420;14885,25185,0,0,0,2,2
53286,120,10796,14127;14410,25185,0,0,0,2,2
53287,120,10801,14019,25185,0,0,0,1,1
53288,120,10802,15319,25185,0,0,0,1,1
53289,120,10804,14696;14710,25185,0,0,0,2,2
53290,120,10807,14974;15118,25185,0,0,0,2,2
53291,120,10808,15026,25185,0,0,0,1,1
53292,120,10809,15129;15534,25185,0,0,0,2,2
53293,120,10810,15110,25185,0,0,0,1,1
53294,120,10812,15226,25185,0,0,0,1,1
53295,120,10813,15438;15722,25185,0,0,0,2,2
53296,120,10814,15767,25185,0,0,0,1,1
53297,120,10815,15285;15638,25185,0,0,0,2,2
53298,120,10816,15053,25185,0,0,0,1,1
53299,120,10817,15738;15824;20496,25185,0,0,1,2,3
53300,120,10819,15747;16130,25185,0,0,0,2,2
53301,120,10820,15617,25185,0,0,0,1,1
53302,120,10821,15143,25185,0,0,0,1,1
53303,120,10822,16160,25185,0,0,0,1,1
53304,120,10824,15759;16176,25185,0,0,0,2,2
53305,120,10825,15863;15871,25185,0,0,0,2,2
53306,120,10826,15352;15916,25185,0,0,0,2,2
53307,120,10827,15610,25185,0,0,0,1,1
53308,120,10830,15448;15623;19327,25185,0,0,1,2,3
53309,120,10831,15459;15634,25185,0,0,0,2,2
53310,120,10832,15641;15682,25185,0,0,0,2,2
53311,120,10834,15665;15834,25185,0,0,0,2,2
53312,120,10835,16119,25185,0,0,0,1,1
53313,120,10836,16021;16304,25185,0,0,0,2,2
53314,120,10838,16341,25185,0,0,0,1,1
53315,120,10839,16043;16327,25185,0,0,0,2,2
53316,120,10840,15557,25185,0,0,0,1,1
53317,120,10843,15266,25185,0,0,0,1,1
53318,120,10844,16188;16265,25185,0,0,0,2,2
53319,120,10845,20331;20509;23473,25185,0,1,2,0,3
53320,120,10846,15928;15981;20734;23378,25185,0,1,1,2,4
53321,120,10847,15944,25185,0,0,0,1,1
53322,120,10848,15947,25185,0,0,0,1,1
53323,120,10849,16360;16749,25185,0,0,0,2,2
53324,120,10851,15389;15972,25185,0,0,0,2,2
53325,120,10854,16054;16058,25185,0,0,0,2,2
53326,120,10856,16059;19901;22745;22852;23157;23446;23545;23980,25185,1,5,1,1,8
53327,120,10857,16066;16315,25185,0,0,0,2,2
53328,120,10858,16095;16154,25185,0,0,0,2,2
53329,120,10859,16116;16375,25185,0,0,0,2,2
53330,120,10860,15850,25185,0,0,0,1,1
53331,120,10861,15515,25185,0,0,0,1,1
53332,120,10862,16124;16551,25185,0,0,0,2,2
53333,120,10863,16126,25185,0,0,0,1,1
53334,120,10864,15639;16138;19341;20452;22940,25185,0,1,2,2,5
53335,120,10865,16262,25185,0,0,0,1,1
53336,120,10866,15761,25185,0,0,0,1,1
53337,120,10867,15884;16190,25185,0,0,0,2,2
53338,120,10888,12965;12997,25550,0,0,0,2,2
53339,120,10900,13626,25550,0,0,0,1,1
53340,120,10906,14501,25550,0,0,0,1,1
53341,120,10907,14600;14785,25550,0,0,0,2,2
53342,120,10909,14888,25550,0,0,0,1,1
53343,120,10911,14552,25550,0,0,0,1,1
53344,120,10917,14697;14905,25550,0,0,0,2,2
53345,120,10918,15180,25550,0,0,0,1,1
53346,120,10921,15063,25550,0,0,0,1,1
53347,120,10922,15104;15160;19522;23313,25550,0,1,1,2,4
53348,120,10923,15201;15495,25550,0,0,0,2,2
53349,120,10924,15216;15303,25550,0,0,0,2,2
53350,120,10925,15991;16284,25550,0,0,0,2,2
53351,120,10927,15728,25550,0,0,0,1,1
53352,120,10928,15731,25550,0,0,0,1,1
53353,120,10929,15354,25550,0,0,0,1,1
53354,120,10930,15520;15940,25550,0,0,0,2,2
53355,120,10932,15516;15537,25550,0,0,0,2,2
53356,120,10934,15526;15853,25550,0,0,0,2,2
53357,120,10935,15611,25550,0,0,0,1,1
53358,120,10936,15287;15648,25550,0,0,0,2,2
53359,120,10937,15069;15311,25550,0,0,0,2,2
53360,120,10938,15962,25550,0,0,0,1,1
53361,120,10939,15897,25550,0,0,0,1,1
53362,120,10940,15720;16147,25550,0,0,0,2,2
53363,120,10941,15748;15986,25550,0,0,0,2,2
53364,120,10943,15365;15765,25550,0,0,0,2,2
53365,120,10944,15775,25550,0,0,0,1,1
53366,120,10945,15783;15784,25550,0,0,0,2,2
53367,120,10946,15463,25550,0,0,0,1,1
53368,120,10947,15823;16185;19735;23751,25550,1,0,1,2,4
53369,120,10948,15658;16132,25550,0,0,0,2,2
53370,120,10950,16125;16302,25550,0,0,0,2,2
53371,120,10951,15330,25550,0,0,0,1,1
53372,120,10952,15929;15950,25550,0,0,0,2,2
53373,120,10953,15971;16628;20709,25550,0,0,1,2,3
53374,120,10954,15785,25550,0,0,0,1,1
53375,120,10955,15821;16180,25550,0,0,0,2,2
53376,120,10956,15978;16000,25550,0,0,0,2,2
53377,120,10957,15646;16001;20336,25550,0,0,1,2,3
53378,120,10958,15948;16417,25550,0,0,0,2,2
53379,120,10959,16033;16060,25550,0,0,0,2,2
53380,120,10961,16344;16395,25550,0,0,0,2,2
53381,120,10962,16121,25550,0,0,0,1,1
53382,120,10963,16131;16489,25550,0,0,0,2,2
53383,120,10965,16201;16644,25550,0,0,0,2,2
53384,120,10966,16114;16602,25550,0,0,0,2,2
53385,120,10967,16255;16402,25550,0,0,0,2,2
53386,120,10968,16065;16218,25550,0,0,0,2,2
53387,120,10969,16625;16716,25550,0,0,0,2,2
53388,120,10970,15924;16246,25550,0,0,0,2,2
53389,120,10971,16253,25550,0,0,0,1,1
53390,120,10972,16264;16403,25550,0,0,0,2,2
53391,120,10973,16645,25550,0,0,0,1,1
53392,120,10974,16229;16279,25550,0,0,0,2,2
53393,120,10975,15679;16324,25550,0,0,0,2,2
53394,120,10987,12211,25915,0,0,0,1,1
53395,120,11008,14025,25915,0,0,0,1,1
53396,120,11016,14601,25915,0,0,0,1,1
53397,120,11018,14835;14945,25915,0,0,0,2,2
53398,120,11020,13818,25915,0,0,0,1,1
53399,120,11024,14570,25915,0,0,0,1,1
53400,120,11029,15602,25915,0,0,0,1,1
53401,120,11030,15121,25915,0,0,0,1,1
53402,120,11031,14979,25915,0,0,0,1,1
53403,120,11036,14705,25915,0,0,0,1,1
53404,120,11037,14776;14932,25915,0,0,0,2,2
53405,120,11039,15183,25915,0,0,0,1,1
53406,120,11041,15570;19850,25915,0,0,1,1,2
53407,120,11042,15548;15690,25915,0,0,0,2,2
53408,120,11044,15988;16225,25915,0,0,0,2,2
53409,120,11045,15138;15619;19167,25915,0,0,1,2,3
53410,120,11046,15498;15739,25915,0,0,0,2,2
53411,120,11047,15744;15885,25915,0,0,0,2,2
53412,120,11048,15559;16468,25915,0,0,0,2,2
53413,120,11049,15628,25915,0,0,0,1,1
53414,120,11050,15865,25915,0,0,0,1,1
53415,120,11051,15867,25915,0,0,0,1,1
53416,120,11052,15324,25915,0,0,0,1,1
53417,120,11053,15876;20270;23677;23780;24000,25915,2,1,1,1,5
53418,120,11054,15907;15925,25915,0,0,0,2,2
53419,120,11055,15910,25915,0,0,0,1,1
53420,120,11056,15911;16209,25915,0,0,0,2,2
53421,120,11057,16261;16452;20686;23698,25915,0,1,1,2,4
53422,120,11058,15477;16428,25915,0,0,0,2,2
53423,120,11059,16318,25915,0,0,0,1,1
53424,120,11060,15376;16036,25915,0,0,0,2,2
53425,120,11061,16037;16055,25915,0,0,0,2,2
53426,120,11062,15699;16411,25915,0,0,0,2,2
53427,120,11063,15768;16091,25915,0,0,0,2,2
53428,120,11064,16092;16107,25915,0,0,0,2,2
53429,120,11065,15706;16098,25915,0,0,0,2,2
53430,120,11066,16247;16418,25915,0,0,0,2,2
53431,120,11067,16040;16118,25915,0,0,0,2,2
53432,120,11068,20293;23264;23355;24108;24218,25915,2,2,1,0,5
53433,120,11069,16599,25915,0,0,0,1,1
53434,120,11070,15395;16123,25915,0,0,0,2,2
53435,120,11072,16197;16601,25915,0,0,0,2,2
53436,120,11073,15906,25915,0,0,0,1,1
53437,120,11075,16112;16650,25915,0,0,0,2,2
53438,120,11076,16483;16861;20277;22265;23885;24214,25915,2,0,2,2,6
53439,120,11077,16282,25915,0,0,0,1,1
53440,120,11078,16177,25915,0,0,0,1,1
53441,120,11079,16251;16291,25915,0,0,0,2,2
53442,120,11080,21182,25915,0,0,1,0,1
53443,120,11081,16338;16610,25915,0,0,0,2,2
53444,120,11082,16586;20637,25915,0,0,1,1,2
53445,120,11083,16157;16346,25915,0,0,0,2,2
53446,120,11084,16272;16787;21023,25915,0,0,1,2,3
53447,120,11085,16381;16544,25915,0,0,0,2,2
53448,120,11086,16717;16778,25915,0,0,0,2,2
53449,120,11088,16353;16461,25915,0,0,0,2,2
53450,120,11089,16213;16471,25915,0,0,0,2,2
53451,120,11090,16368;16472,25915,0,0,0,2,2
53452,120,11130,14116,26280,0,0,0,1,1
53453,120,11137,14575,26280,0,0,0,1,1
53454,120,11139,14663,26280,0,0,0,1,1
53455,120,11141,14557;14995,26280,0,0,0,2,2
53456,120,11142,14766;15268,26280,0,0,0,2,2
53457,120,11143,15244,26280,0,0,0,1,1
53458,120,11144,14580;15401,26280,0,0,0,2,2
53459,120,11150,14954;14985,26280,0,0,0,2,2
53460,120,11151,14960,26280,0,0,0,1,1
53461,120,11153,15077,26280,0,0,0,1,1
53462,120,11154,15078;15364,26280,0,0,0,2,2
53463,120,11158,19913;23158,26280,0,1,1,0,2
53464,120,11159,14740;15194,26280,0,0,0,2,2
53465,120,11162,15315;15943,26280,0,0,0,2,2
53466,120,11163,15353,26280,0,0,0,1,1
53467,120,11164,15383,26280,0,0,0,1,1
53468,120,11165,14533;15323,26280,0,0,0,2,2
53469,120,11166,15392;15890,26280,0,0,0,2,2
53470,120,11167,15397;15630;19265;22815,26280,0,1,1,2,4
53471,120,11168,15399,26280,0,0,0,1,1
53472,120,11169,15479;15643,26280,0,0,0,2,2
53473,120,11170,15508;16039,26280,0,0,0,2,2
53474,120,11171,15499;15514,26280,0,0,0,2,2
53475,120,11172,15573;16187,26280,0,0,0,2,2
53476,120,11173,14815;15588,26280,0,0,0,2,2
53477,120,11174,16753,26280,0,0,0,1,1
53478,120,11176,15686;16337,26280,0,0,0,2,2
53479,120,11177,15358;15705,26280,0,0,0,2,2
53480,120,11178,16439,26280,0,0,0,1,1
53481,120,11179,15519,26280,0,0,0,1,1
53482,120,11180,16030;16323,26280,0,0,0,2,2
53483,120,11181,15776;15781,26280,0,0,0,2,2
53484,120,11182,16589,26280,0,0,0,1,1
53485,120,11183,15802;16288,26280,0,0,0,2,2
53486,120,11184,15552;15936,26280,0,0,0,2,2
53487,120,11186,15880,26280,0,0,0,1,1
53488,120,11187,15901;16547,26280,0,0,0,2,2
53489,120,11188,16211,26280,0,0,0,1,1
53490,120,11189,15673;15918,26280,0,0,0,2,2
53491,120,11190,15607;15930,26280,0,0,0,2,2
53492,120,11191,15436;15932;20529,26280,0,0,1,2,3
53493,120,11192,15939,26280,0,0,0,1,1
53494,120,11194,15814;15992,26280,0,0,0,2,2
53495,120,11195,15994,26280,0,0,0,1,1
53496,120,11197,16028,26280,0,0,0,1,1
53497,120,11199,16500,26280,0,0,0,1,1
53498,120,11200,16069;16464,26280,0,0,0,2,2
53499,120,11201,16078;16407,26280,0,0,0,2,2
53500,120,11202,16383;16660,26280,0,0,0,2,2
53501,120,11203,16135,26280,0,0,0,1,1
53502,120,11204,16228;16512,26280,0,0,0,2,2
53503,120,11205,16389,26280,0,0,0,1,1
53504,120,11206,15605;16110,26280,0,0,0,2,2
53505,120,11207,16572,26280,0,0,0,1,1
53506,120,11209,16087;16145,26280,0,0,0,2,2
53507,120,11210,16490;21032,26280,0,0,1,1,2
53508,120,11211,16320;16425,26280,0,0,0,2,2
53509,120,11212,15631;16193,26280,0,0,0,2,2
53510,120,11215,16493,26280,0,0,0,1,1
53511,120,11216,16269;16276,26280,0,0,0,2,2
53512,120,11217,15898;16280,26280,0,0,0,2,2
53513,120,11218,15663,26280,0,0,0,1,1
53514,120,11219,16575,26280,0,0,0,1,1
53515,120,11220,16833;16835,26280,0,0,0,2,2
53516,120,11221,16212;16841,26280,0,0,0,2,2
53517,120,11222,16248;16856;21379;23838;24067,26280,2,0,1,2,5
53518,120,11223,16336;16671,26280,0,0,0,2,2
53519,120,11225,16086;16361,26280,0,0,0,2,2
53520,120,11227,16373;16514,26280,0,0,0,2,2
53521,120,11228,16335;16377,26280,0,0,0,2,2
53522,120,11229,16399;16426,26280,0,0,0,2,2
53523,120,11230,16416;16670,26280,0,0,0,2,2
53524,120,11231,16693;17000,26280,0,0,0,2,2
53525,120,11232,16453;16469,26280,0,0,0,2,2
53526,120,11233,16802,26280,0,0,0,1,1
53527,120,11234,20258;20532;20603;20647;23276;23914;24026;24124;24238,26280,4,1,4,0,9
53528,120,11235,16504;16674,26280,0,0,0,2,2
53529,120,11236,16509;16629,26280,0,0,0,2,2
53530,120,11237,16527;16865,26280,0,0,0,2,2
53531,120,11238,16744,26280,0,0,0,1,1
53532,120,11258,12804,26645,0,0,0,1,1
53533,120,11265,13374,26645,0,0,0,1,1
53534,120,11266,13234,26645,0,0,0,1,1
53535,120,11271,13932;14006,26645,0,0,0,2,2
53536,120,11279,14535,26645,0,0,0,1,1
53537,120,11286,15211,26645,0,0,0,1,1
53538,120,11288,14534;15271,26645,0,0,0,2,2
53539,120,11290,15046;15893,26645,0,0,0,2,2
53540,120,11291,15815;15909,26645,0,0,0,2,2
53541,120,11293,15967,26645,0,0,0,1,1
53542,120,11294,15384,26645,0,0,0,1,1
53543,120,11295,20236;22870;23350;23561;23996;24210,26645,2,3,1,0,6
53544,120,11296,15409,26645,0,0,0,1,1
53545,120,11298,14949;15493,26645,0,0,0,2,2
53546,120,11299,15529;19190;22236;22573,26645,0,1,2,1,4
53547,120,11300,15966,26645,0,0,0,1,1
53548,120,11301,15451;15538,26645,0,0,0,2,2
53549,120,11304,15753,26645,0,0,0,1,1
53550,120,11307,15900,26645,0,0,0,1,1
53551,120,11309,15931,26645,0,0,0,1,1
53552,120,11310,15764,26645,0,0,0,1,1
53553,120,11311,15522;15841,26645,0,0,0,2,2
53554,120,11312,16394,26645,0,0,0,1,1
53555,120,11313,16052,26645,0,0,0,1,1
53556,120,11314,15919;16480,26645,0,0,0,2,2
53557,120,11316,15755;15953,26645,0,0,0,2,2
53558,120,11317,16443;16479,26645,0,0,0,2,2
53559,120,11318,15999,26645,0,0,0,1,1
53560,120,11319,16214;20894,26645,0,0,1,1,2
53561,120,11320,16016;16198,26645,0,0,0,2,2
53562,120,11321,15238;16034,26645,0,0,0,2,2
53563,120,11322,16038;16088,26645,0,0,0,2,2
53564,120,11323,15977;16603,26645,0,0,0,2,2
53565,120,11324,16573;16958,26645,0,0,0,2,2
53566,120,11325,16250;20117,26645,0,0,1,1,2
53567,120,11327,16522;16532,26645,0,0,0,2,2
53568,120,11330,16277;16855,26645,0,0,0,2,2
53569,120,11331,16633,26645,0,0,0,1,1
53570,120,11332,15616;16164,26645,0,0,0,2,2
53571,120,11333,16398,26645,0,0,0,1,1
53572,120,11334,15732;16420,26645,0,0,0,2,2
53573,120,11335,15757;16447,26645,0,0,0,2,2
53574,120,11336,16223;16458,26645,0,0,0,2,2
53575,120,11337,16495;16732,26645,0,0,0,2,2
53576,120,11338,16256;16506,26645,0,0,0,2,2
53577,120,11339,16232;16798,26645,0,0,0,2,2
53578,120,11340,16378;16529,26645,0,0,0,2,2
53579,120,11341,16560,26645,0,0,0,1,1
53580,120,11342,16543;16561,26645,0,0,0,2,2
53581,120,11343,16667;20902;24144,26645,1,0,1,1,3
53582,120,11344,16287;16576,26645,0,0,0,2,2
53583,120,11345,16008;16577,26645,0,0,0,2,2
53584,120,11347,16556;16811,26645,0,0,0,2,2
53585,120,11348,16321;16593,26645,0,0,0,2,2
53586,120,11349,16557;16606,26645,0,0,0,2,2
53587,120,11350,16607;17062,26645,0,0,1,1,2
53588,120,11351,16620,26645,0,0,0,1,1
53589,120,11352,16622;16966,26645,0,0,0,2,2
53590,120,11353,17046,26645,0,0,1,0,1
53591,120,11354,16635,26645,0,0,0,1,1
53592,120,11355,16648,26645,0,0,0,1,1
53593,120,11356,15951;16093,26645,0,0,0,2,2
53594,120,11357,16654,26645,0,0,0,1,1
53595,120,11358,16409;16703,26645,0,0,0,2,2
53596,120,11359,16413;16728,26645,0,0,0,2,2
53597,120,11389,14510,27010,0,0,0,1,1
53598,120,11397,14340;15157,27010,0,0,0,2,2
53599,120,11402,14440,27010,0,0,0,1,1
53600,120,11409,15015;15259,27010,0,0,0,2,2
53601,120,11410,15017;15513,27010,0,0,0,2,2
53602,120,11411,15472;15518,27010,0,0,0,2,2
53603,120,11413,14131;15071,27010,0,0,0,2,2
53604,120,11415,15188;15618,27010,0,0,0,2,2
53605,120,11417,15234,27010,0,0,0,1,1
53606,120,11421,15371,27010,0,0,0,1,1
53607,120,11423,16012,27010,0,0,0,1,1
53608,120,11425,16350;16358,27010,0,0,0,2,2
53609,120,11426,15697;16308,27010,0,0,0,2,2
53610,120,11427,15028;15692,27010,0,0,0,2,2
53611,120,11428,15656;15715,27010,0,0,0,2,2
53612,120,11429,15725,27010,0,0,0,1,1
53613,120,11430,16537,27010,0,0,0,1,1
53614,120,11433,15836;16263,27010,0,0,0,2,2
53615,120,11434,15685;15780,27010,0,0,0,2,2
53616,120,11435,15877;16267,27010,0,0,0,2,2
53617,120,11437,15934;15984,27010,0,0,0,2,2
53618,120,11440,15820;15995,27010,0,0,0,2,2
53619,120,11442,16042;16446,27010,0,0,0,2,2
53620,120,11443,15903;16084,27010,0,0,0,2,2
53621,120,11445,16492;16664,27010,0,0,0,2,2
53622,120,11447,16183,27010,0,0,0,1,1
53623,120,11448,16623;17037,27010,0,0,1,1,2
53624,120,11449,16552;17065,27010,0,0,1,1,2
53625,120,11450,15800;16440,27010,0,0,0,2,2
53626,120,11452,16307;16761,27010,0,0,0,2,2
53627,120,11453,16371;16759,27010,0,0,0,2,2
53628,120,11455,16376;16588,27010,0,0,0,2,2
53629,120,11456,16404;16895,27010,0,0,0,2,2
53630,120,11458,16422,27010,0,0,0,1,1
53631,120,11459,16679;16756,27010,0,0,0,2,2
53632,120,11460,16972;17204;21385,27010,0,0,2,1,3
53633,120,11463,16260;16779;21105,27010,0,0,1,2,3
53634,120,11464,16751;16857,27010,0,0,0,2,2
53635,120,11465,16148;16546,27010,0,0,0,2,2
53636,120,11466,16553;21046,27010,0,0,1,1,2
53637,120,11467,16159;16562,27010,0,0,0,2,2
53638,120,11468,16270;16563;20433;24010;24115,27010,2,0,1,2,5
53639,120,11469,16764,27010,0,0,0,1,1
53640,120,11470,16245;16596,27010,0,0,0,2,2
53641,120,11471,16608;16930,27010,0,0,0,2,2
53642,120,11472,16432;16815,27010,0,0,0,2,2
53643,120,11473,16685;16786,27010,0,0,0,2,2
53644,120,11474,16694;17106,27010,0,0,1,1,2
53645,120,11475,16699;16875;21556,27010,0,0,1,2,3
53646,120,11476,16659;16947;19949;22621,27010,0,1,1,2,4
53647,120,11477,16725;17068,27010,0,0,1,1,2
53648,120,11478,16980;17074,27010,0,0,1,1,2
53649,120,11479,16386;16738,27010,0,0,0,2,2
53650,120,11480,16974,27010,0,0,0,1,1
53651,120,11481,16766;17119;20955,27010,0,0,2,1,3
53652,120,11482,16343;16783,27010,0,0,0,2,2
53653,120,11483,16799;17015,27010,0,0,1,1,2
53654,120,11484,16305;16357,27010,0,0,0,2,2
53655,120,11485,16520;16617,27010,0,0,0,2,2
53656,120,11486,16850,27010,0,0,0,1,1
53657,120,11498,12426,27375,0,0,0,1,1
53658,120,11525,14408;15190,27375,0,0,0,2,2
53659,120,11528,14926,27375,0,0,0,1,1
53660,120,11529,14653;15232,27375,0,0,0,2,2
53661,120,11535,14793,27375,0,0,0,1,1
53662,120,11536,14709;14950,27375,0,0,0,2,2
53663,120,11538,14984;15403,27375,0,0,0,2,2
53664,120,11540,15343,27375,0,0,0,1,1
53665,120,11544,15987,27375,0,0,0,1,1
53666,120,11546,15955,27375,0,0,0,1,1
53667,120,11548,15812,27375,0,0,0,1,1
53668,120,11549,15434;15817,27375,0,0,0,2,2
53669,120,11550,15843;16249,27375,0,0,0,2,2
53670,120,11552,15609;15879,27375,0,0,0,2,2
53671,120,11555,15717,27375,0,0,0,1,1
53672,120,11556,16179,27375,0,0,0,1,1
53673,120,11557,16278;19745,27375,0,0,1,1,2
53674,120,11558,20273;22871;23168;23353;23566,27375,0,4,1,0,5
53675,120,11561,15491,27375,0,0,0,1,1
53676,120,11562,16194,27375,0,0,0,1,1
53677,120,11563,15704;16081,27375,0,0,0,2,2
53678,120,11564,16339,27375,0,0,0,1,1
53679,120,11565,15938;16195,27375,0,0,0,2,2
53680,120,11566,16364;19387;22465;22822,27375,0,2,1,1,4
53681,120,11567,16234;16771;21016,27375,0,0,1,2,3
53682,120,11568,16236;16390,27375,0,0,0,2,2
53683,120,11570,16097;16286,27375,0,0,0,2,2
53684,120,11571,15596;16005,27375,0,0,0,2,2
53685,120,11572,16226;16290,27375,0,0,0,2,2
53686,120,11573,16072;16310,27375,0,0,0,2,2
53687,120,11574,16365;16580,27375,0,0,0,2,2
53688,120,11575,16396;16821,27375,0,0,0,2,2
53689,120,11576,16454;16613,27375,0,0,0,2,2
53690,120,11577,16293;16456,27375,0,0,0,2,2
53691,120,11578,16257;16476,27375,0,0,0,2,2
53692,120,11579,16254;16661,27375,0,0,0,2,2
53693,120,11580,15713;16549,27375,0,0,0,2,2
53694,120,11581,16510,27375,0,0,0,1,1
53695,120,11582,16424,27375,0,0,0,1,1
53696,120,11583,16297;16565;20460;24011,27375,1,0,1,2,4
53697,120,11584,16609,27375,0,0,0,1,1
53698,120,11585,16631,27375,0,0,0,1,1
53699,120,11586,16812,27375,0,0,0,1,1
53700,120,11587,17188;17592,27375,0,0,2,0,2
53701,120,11588,16319;16427,27375,0,0,0,2,2
53702,120,11589,16676;17137,27375,0,0,1,1,2
53703,120,11590,17117,27375,0,0,1,0,1
53704,120,11595,16763;16927,27375,0,0,0,2,2
53705,120,11596,16768,27375,0,0,0,1,1
53706,120,11597,16845;17035,27375,0,0,1,1,2
53707,120,11598,16455;16846,27375,0,0,0,2,2
53708,120,11599,17053,27375,0,0,1,0,1
53709,120,11600,17029;17101,27375,0,0,2,0,2
53710,120,11601,16883;17328,27375,0,0,1,1,2
53711,120,11602,16545;16891,27375,0,0,0,2,2
53712,120,11603,16294;16894,27375,0,0,0,2,2
53713,120,11604,16941;17087,27375,0,0,1,1,2
53714,120,11605,16792;16899,27375,0,0,0,2,2
53715,120,11606,16924;16928,27375,0,0,0,2,2
53716,120,11607,16932,27375,0,0,0,1,1
53717,120,11608,16526;16945;20205,27375,0,0,1,2,3
53718,120,11609,16697;16951,27375,0,0,0,2,2
53719,120,11610,16964;17055,27375,0,0,1,1,2
53720,120,11641,14625,27740,0,0,0,1,1
53721,120,11643,15189,27740,0,0,0,1,1
53722,120,11644,15366,27740,0,0,0,1,1
53723,120,11645,15599,27740,0,0,0,1,1
53724,120,11648,14830;14980,27740,0,0,0,2,2
53725,120,11649,15068;15407,27740,0,0,0,2,2
53726,120,11653,15633,27740,0,0,0,1,1
53727,120,11654,15512,27740,0,0,0,1,1
53728,120,11657,15237;15620,27740,0,0,0,2,2
53729,120,11658,15751,27740,0,0,0,1,1
53730,120,11659,15797;16570,27740,0,0,0,2,2
53731,120,11660,15805;16252,27740,0,0,0,2,2
53732,120,11662,16750;16837,27740,0,0,0,2,2
53733,120,11663,16579,27740,0,0,0,1,1
53734,120,11664,16801,27740,0,0,0,1,1
53735,120,11665,15672;16075,27740,0,0,0,2,2
53736,120,11667,15870;16523,27740,0,0,0,2,2
53737,120,11670,16295;16859;20322,27740,0,0,1,2,3
53738,120,11671,16720;17100,27740,0,0,1,1,2
53739,120,11673,16074;16391,27740,0,0,0,2,2
53740,120,11674,16393;16991;20052;22753;23249;23456;23872;23986,27740,2,3,1,2,8
53741,120,11675,16616;16774,27740,0,0,0,2,2
53742,120,11676,16441;17221,27740,0,0,1,1,2
53743,120,11677,16244;17072,27740,0,0,1,1,2
53744,120,11678,16449;16585,27740,0,0,0,2,2
53745,120,11679,16451;16935,27740,0,0,0,2,2
53746,120,11682,16825;17038,27740,0,0,1,1,2
53747,120,11683,16316;16968;21248,27740,0,0,1,2,3
53748,120,11684,16640;16840,27740,0,0,0,2,2
53749,120,11685,16642;20244,27740,0,0,1,1,2
53750,120,11686,16202;16675,27740,0,0,0,2,2
53751,120,11687,16678;16858,27740,0,0,0,2,2
53752,120,11688,17408;21665,27740,0,0,2,0,2
53753,120,11689,16688;16820;20830;24141,27740,1,0,1,2,4
53754,120,11690,16178;16692,27740,0,0,0,2,2
53755,120,11691,16698;16869,27740,0,0,0,2,2
53756,120,11692,16838,27740,0,0,0,1,1
53757,120,11693,16656;20612,27740,0,0,1,1,2
53758,120,11694,16605;16741,27740,0,0,0,2,2
53759,120,11696,16733,27740,0,0,0,1,1
53760,120,11697,16918;17124,27740,0,0,1,1,2
53761,120,11698,17047;17475;21223;21643;23503;24165,27740,1,1,4,0,6
53762,120,11699,16843,27740,0,0,0,1,1
53763,120,11700,17301,27740,0,0,1,0,1
53764,120,11701,16877;17397,27740,0,0,1,1,2
53765,120,11702,17277;17357,27740,0,0,2,0,2
53766,120,11703,17157,27740,0,0,1,0,1
53767,120,11704,16922;21707,27740,0,0,1,1,2
53768,120,11706,16795;17125;21077,27740,0,0,2,1,3
53769,120,11707,16990;17322,27740,0,0,1,1,2
53770,120,11709,16632;17005,27740,0,0,1,1,2
53771,120,11710,16923;17084,27740,0,0,1,1,2
53772,120,11711,17048,27740,0,0,1,0,1
53773,120,11712,16592;17040,27740,0,0,1,1,2
53774,120,11713,17044;17337;20908,27740,0,0,3,0,3
53775,120,11714,16359;16897,27740,0,0,0,2,2
53776,120,11715,16597;17181,27740,0,0,1,1,2
53777,120,11716,16672;17079,27740,0,0,1,1,2
53778,120,11717,17308;17473,27740,0,0,2,0,2
53779,120,11730,12857;13306,28105,0,0,0,2,2
53780,120,11748,14909,28105,0,0,0,1,1
53781,120,11750,15327,28105,0,0,0,1,1
53782,120,11751,15443,28105,0,0,0,1,1
53783,120,11755,15312,28105,0,0,0,1,1
53784,120,11756,15344,28105,0,0,0,1,1
53785,120,11757,15554,28105,0,0,0,1,1
53786,120,11761,14914;15470,28105,0,0,0,2,2
53787,120,11762,16070,28105,0,0,0,1,1
53788,120,11763,16482,28105,0,0,0,1,1
53789,120,11765,15806;19835,28105,0,0,1,1,2
53790,120,11767,15490;15873,28105,0,0,0,2,2
53791,120,11772,16414,28105,0,0,0,1,1
53792,120,11773,16171;16241;19912;22358;22853,28105,0,1,2,2,5
53793,120,11774,16345;16438,28105,0,0,0,2,2
53794,120,11775,16311;16714,28105,0,0,0,2,2
53795,120,11777,16366;16637,28105,0,0,0,2,2
53796,120,11778,16909;20967,28105,0,0,1,1,2
53797,120,11779,16457,28105,0,0,0,1,1
53798,120,11780,16474;16823;20019;22260,28105,0,0,2,2,4
53799,120,11781,16215;16540,28105,0,0,0,2,2
53800,120,11782,16437;16665,28105,0,0,0,2,2
53801,120,11783,16722;20328;23575;24110,28105,1,1,1,1,4
53802,120,11784,15913;15961,28105,0,0,0,2,2
53803,120,11785,16647;17041,28105,0,0,1,1,2
53804,120,11788,17266,28105,0,0,1,0,1
53805,120,11789,16773;17140,28105,0,0,1,1,2
53806,120,11790,16073;16313,28105,0,0,0,2,2
53807,120,11791,16639;17098,28105,0,0,1,1,2
53808,120,11793,16788,28105,0,0,0,1,1
53809,120,11794,16508;16790,28105,0,0,0,2,2
53810,120,11795,16791;17423,28105,0,0,1,1,2
53811,120,11797,16534;16809,28105,0,0,0,2,2
53812,120,11798,16826;17061;21478,28105,0,0,2,1,3
53813,120,11799,16784;16831,28105,0,0,0,2,2
53814,120,11800,16921;16995,28105,0,0,0,2,2
53815,120,11801,17214;17298;21365,28105,0,0,3,0,3
53816,120,11802,16851;17420,28105,0,0,1,1,2
53817,120,11803,16863;17314;20453,28105,0,0,2,1,3
53818,120,11804,16866;21150,28105,0,0,1,1,2
53819,120,11806,16465,28105,0,0,0,1,1
53820,120,11807,17520;20796;21674,28105,0,0,3,0,3
53821,120,11808,16836;16969,28105,0,0,0,2,2
53822,120,11809,16369;16975,28105,0,0,0,2,2
53823,120,11810,17073,28105,0,0,1,0,1
53824,120,11812,16796;17054,28105,0,0,1,1,2
53825,120,11813,17321;17429,28105,0,0,2,0,2
53826,120,11814,17105;17536;22503,28105,0,1,2,0,3
53827,120,11815,17497;17511,28105,0,0,2,0,2
53828,120,11816,16986;17162,28105,0,0,1,1,2
53829,120,11817,16985;17108;20742,28105,0,0,2,1,3
53830,120,11818,17405;17590,28105,0,0,2,0,2
53831,120,11819,17027;17152,28105,0,0,2,0,2
53832,120,11820,17142;17269,28105,0,0,2,0,2
53833,120,11821,17347;17519;19926;23868,28105,1,0,3,0,4
53834,120,11822,17193,28105,0,0,1,0,1
53835,120,11824,17215;17222,28105,0,0,2,0,2
53836,120,11825,16805;17223,28105,0,0,1,1,2
53837,120,11826,12690,28470,0,0,0,1,1
53838,120,11844,13075,28470,0,0,0,1,1
53839,120,11846,12964,28470,0,0,0,1,1
53840,120,11859,13767,28470,0,0,0,1,1
53841,120,11860,13485,28470,0,0,0,1,1
53842,120,11863,13967,28470,0,0,0,1,1
53843,120,11864,14265,28470,0,0,0,1,1
53844,120,11865,14751,28470,0,0,0,1,1
53845,120,11866,14592,28470,0,0,0,1,1
53846,120,11873,14896,28470,0,0,0,1,1
53847,120,11877,14969;20108,28470,0,0,1,1,2
53848,120,11878,14875,28470,0,0,0,1,1
53849,120,11879,14848,28470,0,0,0,1,1
53850,120,11884,15242,28470,0,0,0,1,1
53851,120,11886,15585;15852,28470,0,0,0,2,2
53852,120,11889,16083,28470,0,0,0,1,1
53853,120,11890,15503,28470,0,0,0,1,1
53854,120,11891,16566,28470,0,0,0,1,1
53855,120,11894,15980;16158;20633;23097;23913,28470,1,1,1,2,5
53856,120,11895,15969,28470,0,0,0,1,1
53857,120,11896,15963;16129,28470,0,0,0,2,2
53858,120,11898,15887,28470,0,0,0,1,1
53859,120,11900,16351,28470,0,0,0,1,1
53860,120,11901,16056;16499,28470,0,0,0,2,2
53861,120,11902,16242;16484,28470,0,0,0,2,2
53862,120,11904,16259;16485,28470,0,0,0,2,2
53863,120,11905,16285;16780,28470,0,0,0,2,2
53864,120,11906,16380;17272,28470,0,0,1,1,2
53865,120,11907,16207;16406,28470,0,0,0,2,2
53866,120,11908,16710;16949,28470,0,0,0,2,2
53867,120,11909,17082,28470,0,0,1,0,1
53868,120,11910,16408,28470,0,0,0,1,1
53869,120,11911,16515;16885,28470,0,0,0,2,2
53870,120,11912,16876;20573;23372;24020,28470,1,1,1,1,4
53871,120,11913,16702,28470,0,0,0,1,1
53872,120,11914,16682;16900,28470,0,0,0,2,2
53873,120,11915,16392;16730,28470,0,0,0,2,2
53874,120,11916,16587;16747,28470,0,0,0,2,2
53875,120,11917,17375,28470,0,0,1,0,1
53876,120,11918,17512;21567;23957,28470,1,0,2,0,3
53877,120,11919,16905;17008,28470,0,0,1,1,2
53878,120,11920,16950,28470,0,0,0,1,1
53879,120,11921,16962;17016,28470,0,0,1,1,2
53880,120,11923,17440;17441;21492,28470,0,0,3,0,3
53881,120,11924,16989;17424,28470,0,0,1,1,2
53882,120,11925,16911;17496,28470,0,0,1,1,2
53883,120,11926,17438;17499,28470,0,0,2,0,2
53884,120,11927,17191;17402;21923,28470,0,0,3,0,3
53885,120,11928,16917;17036,28470,0,0,1,1,2
53886,120,11929,17508;21234;24167,28470,1,0,2,0,3
53887,120,11930,16931;17097;20395;23477,28470,0,1,2,1,4
53888,120,11931,16793;17104,28470,0,0,1,1,2
53889,120,11932,17422;17575;21007;23717;24157,28470,1,1,3,0,5
53890,120,11933,16839;17148,28470,0,0,1,1,2
53891,120,11934,17011;17156,28470,0,0,2,0,2
53892,120,11935,17189;20614,28470,0,0,2,0,2
53893,120,11936,17767;17845,28470,0,0,2,0,2
53894,120,11937,17014;17201,28470,0,0,2,0,2
53895,120,11938,17089;17200,28470,0,0,2,0,2
53896,120,11940,17147;17227;21853,28470,0,0,3,0,3
53897,120,11941,16892;17231,28470,0,0,1,1,2
53898,120,11942,16666;17234,28470,0,0,1,1,2
53899,120,11943,17244;17246,28470,0,0,2,0,2
53900,120,11944,17256;17320;20107,28470,0,0,3,0,3
53901,120,11946,17284;17673,28470,0,0,2,0,2
53902,120,11947,17237;17509;21824,28470,0,0,3,0,3
53903,120,11948,17312;17457,28470,0,0,2,0,2
53904,120,11949,17344;17492,28470,0,0,2,0,2
53905,120,11967,13337,28835,0,0,0,1,1
53906,120,11982,14598,28835,0,0,0,1,1
53907,120,11985,14688;15100,28835,0,0,0,2,2
53908,120,11990,15213;15553,28835,0,0,0,2,2
53909,120,11991,15345;16150,28835,0,0,0,2,2
53910,120,11992,15369;16170,28835,0,0,0,2,2
53911,120,11995,15074;15235,28835,0,0,0,2,2
53912,120,11997,16053;16142;20558;24121;24233,28835,2,0,1,2,5
53913,120,11998,16210,28835,0,0,0,1,1
53914,120,12000,16076,28835,0,0,0,1,1
53915,120,12006,16301,28835,0,0,0,1,1
53916,120,12007,16387,28835,0,0,0,1,1
53917,120,12009,16196;16558,28835,0,0,0,2,2
53918,120,12011,16104;16611,28835,0,0,0,2,2
53919,120,12012,16356,28835,0,0,0,1,1
53920,120,12013,16735;16983;20355,28835,0,0,1,2,3
53921,120,12016,16700;17174,28835,0,0,1,1,2
53922,120,12017,17218;17374,28835,0,0,2,0,2
53923,120,12019,16517;17059,28835,0,0,1,1,2
53924,120,12020,17595,28835,0,0,1,0,1
53925,120,12021,16847;16874,28835,0,0,0,2,2
53926,120,12022,16349;16810,28835,0,0,0,2,2
53927,120,12023,16852;17213,28835,0,0,1,1,2
53928,120,12025,17326,28835,0,0,1,0,1
53929,120,12027,16770;16926;20907,28835,0,0,1,2,3
53930,120,12028,16942;17533,28835,0,0,1,1,2
53931,120,12029,17210;17527,28835,0,0,2,0,2
53932,120,12032,17632,28835,0,0,1,0,1
53933,120,12033,17551;21593,28835,0,0,2,0,2
53934,120,12034,17605,28835,0,0,1,0,1
53935,120,12035,17034;17531,28835,0,0,2,0,2
53936,120,12036,17052;17131,28835,0,0,2,0,2
53937,120,12037,17274;17395;20599;21742,28835,0,0,4,0,4
53938,120,12038,17066;17381;21444,28835,0,0,3,0,3
53939,120,12039,17295;17406,28835,0,0,2,0,2
53940,120,12040,17687,28835,0,0,1,0,1
53941,120,12041,16830;17123,28835,0,0,1,1,2
53942,120,12042,17091;17143;21570,28835,0,0,3,0,3
53943,120,12043,17144;17207,28835,0,0,2,0,2
53944,120,12044,16888;17166;20862;24248,28835,1,0,2,1,4
53945,120,12045,17430;20082,28835,0,0,2,0,2
53946,120,12046,17232;17493,28835,0,0,2,0,2
53947,120,12047,17435;17557;20631,28835,0,0,3,0,3
53948,120,12048,17704;17956;21687;23848,28835,1,0,3,0,4
53949,120,12049,17060;17239,28835,0,0,2,0,2
53950,120,12051,16982;17248,28835,0,0,1,1,2
53951,120,12053,16817;17288,28835,0,0,1,1,2
53952,120,12054,16477;17307;20880,28835,0,0,2,1,3
53953,120,12055,17323;17580,28835,0,0,2,0,2
53954,120,12056,17331;17392,28835,0,0,2,0,2
53955,120,12059,17206;17372;22502,28835,0,1,2,0,3
53956,120,12060,17393,28835,0,0,1,0,1
53957,120,12061,17620;17788;20056,28835,0,0,3,0,3
53958,120,12062,17467;17671;21928,28835,0,0,3,0,3
53959,120,12063,17270;17588,28835,0,0,2,0,2
53960,120,12064,17619,28835,0,0,1,0,1
53961,120,12082,14092,29200,0,0,0,1,1
53962,120,12083,13713,29200,0,0,0,1,1
53963,120,12097,14617,29200,0,0,0,1,1
53964,120,12098,14554;14994,29200,0,0,0,2,2
53965,120,12100,14380;14850,29200,0,0,0,2,2
53966,120,12101,15167,29200,0,0,0,1,1
53967,120,12106,15408,29200,0,0,0,1,1
53968,120,12111,16204,29200,0,0,0,1,1
53969,120,12112,15935,29200,0,0,0,1,1
53970,120,12115,16206;16711,29200,0,0,0,2,2
53971,120,12117,16342;21639,29200,0,0,1,1,2
53972,120,12118,16004;16862,29200,0,0,0,2,2
53973,120,12119,16462,29200,0,0,0,1,1
53974,120,12120,16109;16165,29200,0,0,0,2,2
53975,120,12123,15946;16298,29200,0,0,0,2,2
53976,120,12124,17107,29200,0,0,1,0,1
53977,120,12125,16505;16800,29200,0,0,0,2,2
53978,120,12126,16518;16904,29200,0,0,0,2,2
53979,120,12127,16528;16977,29200,0,0,0,2,2
53980,120,12128,16200,29200,0,0,0,1,1
53981,120,12129,16591;17133,29200,0,0,1,1,2
53982,120,12131,15861;16621,29200,0,0,0,2,2
53983,120,12132,16813;17447,29200,0,0,1,1,2
53984,120,12133,16535,29200,0,0,0,1,1
53985,120,12134,16658;16719;20760;23286,29200,0,1,1,2,4
53986,120,12135,16933;17010,29200,0,0,1,1,2
53987,120,12136,16828;17296,29200,0,0,1,1,2
53988,120,12137,16834;17195,29200,0,0,1,1,2
53989,120,12138,16014;16306,29200,0,0,0,2,2
53990,120,12141,17348,29200,0,0,1,0,1
53991,120,12142,17019;17165,29200,0,0,2,0,2
53992,120,12143,16997;17042;21421,29200,0,0,2,1,3
53993,120,12144,17706;20326;22647,29200,0,1,2,0,3
53994,120,12145,17075;17230,29200,0,0,2,0,2
53995,120,12146,17129;21620,29200,0,0,2,0,2
53996,120,12147,17006;17139,29200,0,0,2,0,2
53997,120,12149,17145;17327,29200,0,0,2,0,2
53998,120,12150,17485,29200,0,0,1,0,1
53999,120,12151,17672,29200,0,0,1,0,1
54000,120,12152,17093;17294,29200,0,0,2,0,2
54001,120,12153,16871;17254,29200,0,0,1,1,2
54002,120,12154,17368;17747;20475;22680,29200,0,1,3,0,4
54003,120,12155,17280;17875,29200,0,0,2,0,2
54004,120,12156,17300;21127,29200,0,0,2,0,2
54005,120,12157,17184;17316;21149,29200,0,0,3,0,3
54006,120,12158,17171;17360,29200,0,0,2,0,2
54007,120,12160,17602;17616;21926,29200,0,0,3,0,3
54008,120,12161,17403;17635;21424;23297,29200,0,1,3,0,4
54009,120,12162,17710;17896,29200,0,0,2,0,2
54010,120,12163,17500;17846;22505,29200,0,1,2,0,3
54011,120,12164,17340;17505,29200,0,0,2,0,2
54012,120,12165,17828;21935,29200,0,0,2,0,2
54013,120,12166,17733,29200,0,0,1,0,1
54014,120,12167,17413;17761;21875,29200,0,0,3,0,3
54015,120,12168,17554,29200,0,0,1,0,1
54016,120,12169,17643;17878;20741;22066,29200,0,0,4,0,4
54017,120,12184,12716,29565,0,0,0,1,1
54018,120,12195,13780,29565,0,0,0,1,1
54019,120,12198,13872,29565,0,0,0,1,1
54020,120,12201,14100,29565,0,0,0,1,1
54021,120,12203,14847,29565,0,0,0,1,1
54022,120,12206,14880,29565,0,0,0,1,1
54023,120,12208,14745;15133,29565,0,0,0,2,2
54024,120,12215,15659,29565,0,0,0,1,1
54025,120,12218,15840,29565,0,0,0,1,1
54026,120,12219,15960;16400;20669,29565,0,0,1,2,3
54027,120,12221,15404;15983,29565,0,0,0,2,2
54028,120,12222,16062,29565,0,0,0,1,1
54029,120,12223,16071,29565,0,0,0,1,1
54030,120,12226,16612;21014,29565,0,0,1,1,2
54031,120,12227,15668;16134,29565,0,0,0,2,2
54032,120,12228,20501,29565,0,0,1,0,1
54033,120,12229,15482;16309,29565,0,0,0,2,2
54034,120,12231,17050,29565,0,0,1,0,1
54035,120,12234,15572;16415,29565,0,0,0,2,2
54036,120,12236,16156;16496,29565,0,0,0,2,2
54037,120,12237,16564;16646,29565,0,0,0,2,2
54038,120,12238,16128;16824,29565,0,0,0,2,2
54039,120,12239,16906,29565,0,0,0,1,1
54040,120,12240,17247;21368,29565,0,0,2,0,2
54041,120,12241,16511;16683,29565,0,0,0,2,2
54042,120,12242,16715;17329;21601,29565,0,0,2,1,3
54043,120,12243,16767;17469;21663;23847,29565,1,0,2,1,4
54044,120,12244,16781;17122,29565,0,0,1,1,2
54045,120,12246,16555;16690,29565,0,0,0,2,2
54046,120,12247,17116,29565,0,0,1,0,1
54047,120,12248,16643;16916,29565,0,0,0,2,2
54048,120,12249,16956;17154,29565,0,0,1,1,2
54049,120,12250,17217;17541,29565,0,0,2,0,2
54050,120,12251,17004;17522;20602;24024,29565,1,0,3,0,4
54051,120,12253,17146,29565,0,0,1,0,1
54052,120,12254,17045;17464;21330;23616,29565,0,1,3,0,4
54053,120,12255,17088;17163,29565,0,0,2,0,2
54054,120,12256,16946;17099,29565,0,0,1,1,2
54055,120,12257,17380;17401;20315;22872;23086;23359,29565,0,3,3,0,6
54056,120,12258,16680;17176,29565,0,0,1,1,2
54057,120,12259,17017;17663;21391,29565,0,0,3,0,3
54058,120,12260,17134;17404;20274;21194,29565,0,0,4,0,4
54059,120,12262,16878;17243,29565,0,0,1,1,2
54060,120,12263,17109;17245,29565,0,0,2,0,2
54061,120,12264,17077;17262,29565,0,0,2,0,2
54062,120,12265,17271;17662;20784;24034,29565,1,0,3,0,4
54063,120,12266,16901;17285;20846,29565,0,0,2,1,3
54064,120,12267,17364;22172,29565,0,0,2,0,2
54065,120,12268,17198;17389,29565,0,0,2,0,2
54066,120,12269,17400;17923;22067,29565,0,0,3,0,3
54067,120,12270,18042;21404;22280,29565,0,0,3,0,3
54068,120,12271,21772,29565,0,0,1,0,1
54069,120,12272,17431;17491,29565,0,0,2,0,2
54070,120,12273,17566;17742;20004,29565,0,0,3,0,3
54071,120,12274,17459;17670,29565,0,0,2,0,2
54072,120,12275,17453;17460;20855;23817,29565,1,0,3,0,4
54073,120,12276,17507;21924,29565,0,0,2,0,2
54074,120,12277,17003;17463,29565,0,0,2,0,2
54075,120,12278,17487;17807;20325;23171;23786,29565,1,1,3,0,5
54076,120,12279,17118;17489;21082,29565,0,0,3,0,3
54077,120,12280,17768;20852;23498;24247,29565,1,1,2,0,4
54078,120,12281,17658;18034;22179,29565,0,0,3,0,3
54079,120,12282,17182;17523;21092,29565,0,0,3,0,3
54080,120,12283,17832;17955;21653;22376,29565,0,1,3,0,4
54081,120,12285,17591;17805,29565,0,0,2,0,2
54082,120,12287,17433;17604;21815,29565,0,0,3,0,3
54083,120,12288,17069;17617;20371;22874,29565,0,1,3,0,4
54084,120,12289,17333;17621;21927;22173,29565,0,0,4,0,4
54085,120,12290,17572;17622,29565,0,0,2,0,2
54086,120,12292,17330;17656,29565,0,0,2,0,2
54087,120,12293,17684,29565,0,0,1,0,1
54088,120,12316,13541;13902,29930,0,0,0,2,2
54089,120,12318,13145,29930,0,0,0,1,1
54090,120,12321,14218,29930,0,0,0,1,1
54091,120,12324,14328,29930,0,0,0,1,1
54092,120,12327,14403;15124,29930,0,0,0,2,2
54093,120,12331,14469;14561,29930,0,0,0,2,2
54094,120,12333,14947;15777,29930,0,0,0,2,2
54095,120,12334,15243,29930,0,0,0,1,1
54096,120,12335,15590;15724,29930,0,0,0,2,2
54097,120,12340,16268,29930,0,0,0,1,1
54098,120,12342,15804;16068,29930,0,0,0,2,2
54099,120,12345,17136,29930,0,0,1,0,1
54100,120,12347,16384,29930,0,0,0,1,1
54101,120,12348,16816,29930,0,0,0,1,1
54102,120,12349,16943;16959;21655;24187,29930,1,0,1,2,4
54103,120,12350,16743;16879,29930,0,0,0,2,2
54104,120,12352,16827;21608,29930,0,0,1,1,2
54105,120,12356,16818,29930,0,0,0,1,1
54106,120,12357,16848;17112;21063;24158,29930,1,0,2,1,4
54107,120,12358,16993;17024,29930,0,0,1,1,2
54108,120,12359,17439;17445;20695,29930,0,0,3,0,3
54109,120,12360,16410;17051,29930,0,0,1,1,2
54110,120,12361,17002;17126;21344,29930,0,0,2,1,3
54111,120,12362,16445;17135,29930,0,0,1,1,2
54112,120,12363,18088;21543;22181,29930,0,0,3,0,3
54113,120,12365,16776;17179;21787,29930,0,0,2,1,3
54114,120,12366,17185;17690,29930,0,0,2,0,2
54115,120,12367,17315,29930,0,0,1,0,1
54116,120,12368,16860;17278,29930,0,0,1,1,2
54117,120,12369,17437;21190,29930,0,0,2,0,2
54118,120,12370,16624;17164;21244,29930,0,0,2,1,3
54119,120,12371,17418;17972;21694;21944,29930,0,0,4,0,4
54120,120,12372,17007;17449,29930,0,0,2,0,2
54121,120,12374,17675;17717;22372,29930,0,1,2,0,3
54122,120,12375,17488;17943;21324,29930,0,0,3,0,3
54123,120,12376,17540;17840;21279;22273,29930,0,0,4,0,4
54124,120,12377,17335;17586;21554,29930,0,0,3,0,3
54125,120,12378,17451;17719,29930,0,0,2,0,2
54126,120,12380,17637;17756;21776;21918;22269,29930,0,0,5,0,5
54127,120,12381,17661;18067;20704,29930,0,0,3,0,3
54128,120,12382,16881;17669,29930,0,0,1,1,2
54129,120,12383,17385;17677;21761,29930,0,0,3,0,3
54130,120,12384,17723;20409;21729;21929,29930,0,0,4,0,4
54131,120,12385,17456;17737;20834;20877,29930,0,0,4,0,4
54132,120,12387,17994;18512;21852;22177,29930,0,0,4,0,4
54133,120,12388,17483;17796;21838,29930,0,0,3,0,3
54134,120,12390,17382;17801,29930,0,0,2,0,2
54135,120,12403,13418,30295,0,0,0,1,1
54136,120,12407,13804,30295,0,0,0,1,1
54137,120,12408,13900,30295,0,0,0,1,1
54138,120,12424,15054;15329,30295,0,0,0,2,2
54139,120,12425,15253;15455,30295,0,0,0,2,2
54140,120,12432,15357;15417,30295,0,0,0,2,2
54141,120,12433,15468,30295,0,0,0,1,1
54142,120,12434,15793,30295,0,0,0,1,1
54143,120,12436,16334;16354,30295,0,0,0,2,2
54144,120,12440,16782;16973,30295,0,0,0,2,2
54145,120,12443,16325;16746,30295,0,0,0,2,2
54146,120,12444,16430;16494,30295,0,0,0,2,2
54147,120,12445,16516;16867,30295,0,0,0,2,2
54148,120,12446,16652;17023,30295,0,0,1,1,2
54149,120,12447,16513;16655,30295,0,0,0,2,2
54150,120,12448,16161;16536,30295,0,0,0,2,2
54151,120,12449,16961;17175,30295,0,0,1,1,2
54152,120,12450,16619;16754;21351,30295,0,0,1,2,3
54153,120,12453,16789,30295,0,0,0,1,1
54154,120,12455,16677;16955,30295,0,0,0,2,2
54155,120,12457,16936;17482,30295,0,0,1,1,2
54156,120,12458,16807;17219,30295,0,0,1,1,2
54157,120,12460,16998;17211,30295,0,0,1,1,2
54158,120,12461,17535;17538;20609;23592;24125,30295,1,1,3,0,5
54159,120,12462,16910,30295,0,0,0,1,1
54160,120,12463,17197;17394;22171,30295,0,0,3,0,3
54161,120,12465,18203;21170,30295,0,0,2,0,2
54162,120,12466,16913;16996,30295,0,0,0,2,2
54163,120,12467,17289;17547;21026;21925;24260,30295,1,0,4,0,5
54164,120,12468,16954;17302,30295,0,0,1,1,2
54165,120,12471,17346,30295,0,0,1,0,1
54166,120,12473,17765;21346,30295,0,0,2,0,2
54167,120,12474,17141;17371;20367;22761;23789;23896,30295,2,1,3,0,6
54168,120,12475,17376;17378;21581,30295,0,0,3,0,3
54169,120,12476,17057;17411,30295,0,0,2,0,2
54170,120,12477,17546;21784,30295,0,0,2,0,2
54171,120,12478,17502;17824,30295,0,0,2,0,2
54172,120,12479,17349;17514,30295,0,0,2,0,2
54173,120,12480,17377;17739;21274;22373,30295,0,1,3,0,4
54174,120,12481,17537;17653;21822,30295,0,0,3,0,3
54175,120,12482,17574;17623,30295,0,0,2,0,2
54176,120,12483,17888;18021;21059;22508;24052,30295,1,1,3,0,5
54177,120,12484,17585;17703;21312,30295,0,0,3,0,3
54178,120,12485,18103;18221,30295,0,0,2,0,2
54179,120,12486,17606;18262,30295,0,0,2,0,2
54180,120,12487,17242;17608;21447,30295,0,0,3,0,3
54181,120,12489,17685;17819,30295,0,0,2,0,2
54182,120,12490,18073;18160;21955,30295,0,0,3,0,3
54183,120,12491,17726;17867;20693;20921;23700;23808,30295,1,1,4,0,6
54184,120,12492,18235;20523;22880,30295,0,1,2,0,3
54185,120,12493,17750;21900,30295,0,0,2,0,2
54186,120,12494,17396;17811,30295,0,0,2,0,2
54187,120,12495,17813,30295,0,0,1,0,1
54188,120,12496,16872;17900;21079,30295,0,0,2,1,3
54189,120,12497,17646;17834,30295,0,0,2,0,2
54190,120,12499,17849,30295,0,0,1,0,1
54191,120,12500,17795;17902,30295,0,0,2,0,2
54192,120,12501,17526;17857,30295,0,0,2,0,2
54193,120,12502,17866;17975;22176,30295,0,0,3,0,3
54194,120,12503,17645,30295,0,0,1,0,1
54195,120,12504,17205;17880,30295,0,0,2,0,2
54196,120,12505,17883;18135,30295,0,0,2,0,2
54197,120,12506,17561;17898;21812;22276,30295,0,0,4,0,4
54198,120,12507,17918;18197;21509;21767;21958;22285;23622;23841;23964,30295,2,1,6,0,9
54199,120,12509,12749,30660,0,0,0,1,1
54200,120,12512,12461,30660,0,0,0,1,1
54201,120,12520,12689,30660,0,0,0,1,1
54202,120,12531,13768,30660,0,0,0,1,1
54203,120,12538,14805,30660,0,0,0,1,1
54204,120,12545,15161;16120,30660,0,0,0,2,2
54205,120,12554,16166,30660,0,0,0,1,1
54206,120,12565,16108;16582,30660,0,0,0,2,2
54207,120,12566,16405;16598,30660,0,0,0,2,2
54208,120,12569,16487;16634,30660,0,0,0,2,2
54209,120,12575,17720;21919,30660,0,0,2,0,2
54210,120,12576,16978;17241,30660,0,0,1,1,2
54211,120,12577,17110;17524;21610;24076;24277,30660,2,0,3,0,5
54212,120,12578,17121;17132,30660,0,0,2,0,2
54213,120,12579,17186,30660,0,0,1,0,1
54214,120,12580,17268;17387,30660,0,0,2,0,2
54215,120,12581,16844;17305;21611,30660,0,0,2,1,3
54216,120,12582,16762;17317,30660,0,0,1,1,2
54217,120,12583,17318;17352,30660,0,0,2,0,2
54218,120,12584,16976;17455;22268,30660,0,0,2,1,3
54219,120,12585,17762;17887;22649,30660,0,1,2,0,3
54220,120,12586,17177;17630,30660,0,0,2,0,2
54221,120,12587,17130;17903;21538,30660,0,0,3,0,3
54222,120,12588,17432;17826;20381,30660,0,0,3,0,3
54223,120,12589,17638;18072;21575;24185,30660,1,0,3,0,4
54224,120,12592,17427;17510,30660,0,0,2,0,2
54225,120,12593,17568;21452,30660,0,0,2,0,2
54226,120,12595,17250;17766;22374,30660,0,1,2,0,3
54227,120,12596,17276;17882,30660,0,0,2,0,2
54228,120,12597,17861;17908;21220;24058,30660,1,0,3,0,4
54229,120,12599,18122,30660,0,0,1,0,1
54230,120,12600,17833;17959,30660,0,0,2,0,2
54231,120,12601,17711,30660,0,0,1,0,1
54232,120,12603,17713;18164;21568,30660,0,0,3,0,3
54233,120,12604,17696;17735,30660,0,0,2,0,2
54234,120,12605,17741;18354,30660,0,0,2,0,2
54235,120,12606,17759;18215,30660,0,0,2,0,2
54236,120,12607,17550;17783,30660,0,0,2,0,2
54237,120,12608,17151;17609;21892,30660,0,0,3,0,3
54238,120,12609,17838;18216,30660,0,0,2,0,2
54239,120,12610,17862;18126;22379,30660,0,1,2,0,3
54240,120,12611,17494;17782;21516,30660,0,0,3,0,3
54241,120,12612,17899;17951;21034,30660,0,0,3,0,3
54242,120,12614,18232;18371,30660,0,0,2,0,2
54243,120,12615,17563;17926,30660,0,0,2,0,2
54244,120,12618,17598;17957;21750,30660,0,0,3,0,3
54245,120,12619,17789;17979;21764;22278,30660,0,0,4,0,4
54246,120,12620,17850;22274,30660,0,0,2,0,2
54247,120,12621,18131;18349;21134;21564,30660,0,0,4,0,4
54248,120,12622,17837;18007;21205;23835,30660,1,0,3,0,4
54249,120,12623,18097;18230;21961,30660,0,0,3,0,3
54250,120,12624,17872;18024,30660,0,0,2,0,2
54251,120,12625,17515;17870,30660,0,0,2,0,2
54252,120,12626,18121;18340,30660,0,0,2,0,2
54253,120,12627,17398;18046;22075;22180,30660,0,0,4,0,4
54254,120,12639,13707,31025,0,0,0,1,1
54255,120,12642,13671,31025,0,0,0,1,1
54256,120,12647,14008,31025,0,0,0,1,1
54257,120,12652,14512,31025,0,0,0,1,1
54258,120,12653,14267;15140,31025,0,0,0,2,2
54259,120,12667,15632;16466,31025,0,0,0,2,2
54260,120,12668,15299;16029,31025,0,0,0,2,2
54261,120,12673,16684;17102,31025,0,0,1,1,2
54262,120,12674,15996,31025,0,0,0,1,1
54263,120,12676,17085,31025,0,0,1,0,1
54264,120,12677,16079;16718;21219;23836;24164,31025,2,0,1,2,5
54265,120,12678,16525;16758,31025,0,0,0,2,2
54266,120,12680,17259,31025,0,0,1,0,1
54267,120,12682,16740;17255,31025,0,0,1,1,2
54268,120,12684,15908;17064,31025,0,0,1,1,2
54269,120,12689,17282;17738,31025,0,0,2,0,2
54270,120,12690,17192;17299;21091;24262,31025,1,0,3,0,4
54271,120,12692,17383;17660,31025,0,0,2,0,2
54272,120,12693,17096;17370,31025,0,0,2,0,2
54273,120,12694,17033;17490,31025,0,0,2,0,2
54274,120,12697,18190;18200;20831;22888;23713,31025,0,2,3,0,5
54275,120,12698,17577,31025,0,0,1,0,1
54276,120,12699,18109,31025,0,0,1,0,1
54277,120,12700,17503;17674;21414,31025,0,0,3,0,3
54278,120,12703,17534;17731;21352;22061,31025,0,0,4,0,4
54279,120,12704,17252;17803,31025,0,0,2,0,2
54280,120,12705,17942;18052;21228;21943;23724,31025,0,1,4,0,5
54281,120,12706,17769;21695,31025,0,0,2,0,2
54282,120,12707,17644;17858,31025,0,0,2,0,2
54283,120,12708,17873;17986,31025,0,0,2,0,2
54284,120,12709,17558;17889,31025,0,0,2,0,2
54285,120,12710,18133;21089;24055;24159,31025,2,0,2,0,4
54286,120,12711,17932;18376;22779,31025,0,1,2,0,3
54287,120,12712,17976;18249;22516,31025,0,1,2,0,3
54288,120,12713,18199;22514,31025,0,1,1,0,2
54289,120,12714,18130;18274;22774,31025,0,1,2,0,3
54290,120,12715,17744;18016;22507,31025,0,1,2,0,3
54291,120,12716,17960;18022;21788,31025,0,0,3,0,3
54292,120,12717,17869;18032;22178,31025,0,0,3,0,3
54293,120,12718,18050;18281,31025,0,0,2,0,2
54294,120,12719,17599;18053,31025,0,0,2,0,2
54295,120,12720,18075;18258;20534;21596;21963;22768;23488;23581;24016,31025,1,3,5,0,9
54296,120,12721,18163,31025,0,0,1,0,1
54297,120,12723,18185;18279;22288,31025,0,0,3,0,3
54298,120,12724,18225;21859;22654,31025,0,1,2,0,3
54299,120,12725,17935;18134;20670;20874;22079,31025,0,0,5,0,5
54300,120,12726,18096;18147;22512,31025,0,1,2,0,3
54301,120,12733,13667,31390,0,0,0,1,1
54302,120,12737,13248,31390,0,0,0,1,1
54303,120,12740,14058,31390,0,0,0,1,1
54304,120,12741,14144,31390,0,0,0,1,1
54305,120,12747,14543;14687,31390,0,0,0,2,2
54306,120,12748,14741;14882,31390,0,0,0,2,2
54307,120,12762,15306;15904,31390,0,0,0,2,2
54308,120,12766,16017;16141,31390,0,0,0,2,2
54309,120,12767,16061;16463,31390,0,0,0,2,2
54310,120,12772,16041,31390,0,0,0,1,1
54311,120,12774,16731;16944;20954,31390,0,0,1,2,3
54312,120,12777,16388;16727,31390,0,0,0,2,2
54313,120,12780,16653;17190,31390,0,0,1,1,2
54314,120,12781,16721;17345,31390,0,0,1,1,2
54315,120,12784,16864,31390,0,0,0,1,1
54316,120,12785,16868;17080,31390,0,0,1,1,2
54317,120,12786,16614;17013,31390,0,0,1,1,2
54318,120,12788,17081;17183;20740,31390,0,0,3,0,3
54319,120,12790,17158;20710,31390,0,0,2,0,2
54320,120,12791,17115,31390,0,0,1,0,1
54321,120,12795,17555;17570;20749;21497,31390,0,0,4,0,4
54322,120,12796,17094;17434;20571,31390,0,0,3,0,3
54323,120,12798,17728;17729;22060,31390,0,0,3,0,3
54324,120,12799,16615;17238,31390,0,0,1,1,2
54325,120,12801,16952;17313;21317;23950;24175,31390,2,0,2,1,5
54326,120,12802,17319;17495,31390,0,0,2,0,2
54327,120,12804,17351;17353,31390,0,0,2,0,2
54328,120,12806,17559;17560;21179;24162,31390,1,0,3,0,4
54329,120,12808,17513;17865,31390,0,0,2,0,2
54330,120,12809,17155;17172,31390,0,0,2,0,2
54331,120,12810,17194;17528;21183,31390,0,0,3,0,3
54332,120,12811,17569;17615,31390,0,0,2,0,2
54333,120,12812,17624;18277;20705,31390,0,0,3,0,3
54334,120,12813,18089;18427,31390,0,0,2,0,2
54335,120,12814,17553;21112,31390,0,0,2,0,2
54336,120,12815,17468;17714;21485,31390,0,0,3,0,3
54337,120,12816,17715;17917;21939,31390,0,0,3,0,3
54338,120,12817,17764;18114;21350;23729,31390,0,1,3,0,4
54339,120,12818,17787;18259;21730,31390,0,0,3,0,3
54340,120,12819,17874;18006;21121;21781,31390,0,0,4,0,4
54341,120,12821,17679;17854;21873,31390,0,0,3,0,3
54342,120,12822,18405;18471,31390,0,0,2,0,2
54343,120,12823,17628;17920,31390,0,0,2,0,2
54344,120,12824,17937;21942,31390,0,0,2,0,2
54345,120,12825,17871;17985;22069,31390,0,0,3,0,3
54346,120,12826,18233;18398;22515,31390,0,1,2,0,3
54347,120,12827,17618;18267;21388,31390,0,0,3,0,3
54348,120,12828,18348;18483;23001,31390,0,1,2,0,3
54349,120,12829,17830;18004,31390,0,0,2,0,2
54350,120,12831,18083,31390,0,0,1,0,1
54351,120,12832,18179;18260;21733,31390,0,0,3,0,3
54352,120,12833,18090;18178;22076,31390,0,0,3,0,3
54353,120,12834,17949;18401;21972,31390,0,0,3,0,3
54354,120,12835,17745;18162,31390,0,0,2,0,2
54355,120,12836,18895;18925;22321,31390,0,0,3,0,3
54356,120,12837,18725;18785;22901;23300,31390,0,2,2,0,4
54357,120,12839,17984;18238;22655,31390,0,1,2,0,3
54358,120,12844,13326,31755,0,0,0,1,1
54359,120,12847,13831,31755,0,0,0,1,1
54360,120,12849,13966,31755,0,0,0,1,1
54361,120,12854,14366;14685,31755,0,0,0,2,2
54362,120,12863,15089;15813,31755,0,0,0,2,2
54363,120,12865,15179,31755,0,0,0,1,1
54364,120,12871,15740,31755,0,0,0,1,1
54365,120,12877,16819;17160,31755,0,0,1,1,2
54366,120,12879,17071;17419,31755,0,0,2,0,2
54367,120,12880,16419;16595,31755,0,0,0,2,2
54368,120,12881,16706;17076;21720,31755,0,0,2,1,3
54369,120,12882,17149;21491,31755,0,0,2,0,2
54370,120,12883,16105;16723;21721,31755,0,0,1,2,3
54371,120,12884,17481;17665;21229,31755,0,0,3,0,3
54372,120,12886,17249;17779;21877,31755,0,0,3,0,3
54373,120,12887,17114;17465;21459,31755,0,0,3,0,3
54374,120,12889,17354;17573,31755,0,0,2,0,2
54375,120,12890,16963,31755,0,0,0,1,1
54376,120,12891,17342;17379,31755,0,0,2,0,2
54377,120,12892,17391;17444;20671;23098,31755,0,1,3,0,4
54378,120,12893,17466;17654;21390,31755,0,0,3,0,3
54379,120,12894,17472;18328;22384,31755,0,1,2,0,3
54380,120,12895,17273,31755,0,0,1,0,1
54381,120,12896,17350;17611,31755,0,0,2,0,2
54382,120,12897,18166,31755,0,0,1,0,1
54383,120,12898,17641,31755,0,0,1,0,1
54384,120,12899,17369;17517,31755,0,0,2,0,2
54385,120,12900,17695;18336;22087,31755,0,0,3,0,3
54386,120,12901,17128;17652,31755,0,0,2,0,2
54387,120,12902,17478;17780,31755,0,0,2,0,2
54388,120,12903,17790;17821;20920;21104,31755,0,0,4,0,4
54389,120,12904,17579;17825,31755,0,0,2,0,2
54390,120,12905,17855;18091;22511,31755,0,1,2,0,3
54391,120,12906,17362;17892;21894,31755,0,0,3,0,3
54392,120,12907,18214;18437;22653,31755,0,1,2,0,3
54393,120,12908,17734;18161,31755,0,0,2,0,2
54394,120,12909,18081;21148;21380;24179,31755,1,0,3,0,4
54395,120,12910,18690;18721;21035;22676;23011,31755,0,2,3,0,5
54396,120,12911,18626;22533,31755,0,1,1,0,2
54397,120,12912,17730;17995;21863,31755,0,0,3,0,3
54398,120,12913,17358;18001;21187,31755,0,0,3,0,3
54399,120,12914,18014;18241;22287,31755,0,0,3,0,3
54400,120,12915,18044;18187,31755,0,0,2,0,2
54401,120,12916,17954;18507;20891;22099;23384;24142,31755,1,1,4,0,6
54402,120,12917,18171;18705;22002;22110,31755,0,0,4,0,4
54403,120,12918,18085;22773,31755,0,1,1,0,2
54404,120,12919,18697;18911;21128;21472,31755,0,0,4,0,4
54405,120,12920,18289;22519,31755,0,1,1,0,2
54406,120,12921,18099;18389;21138;21606;22091;22292;22891;24075,31755,1,1,6,0,8
54407,120,12922,18227;18639;21797,31755,0,0,3,0,3
54408,120,12923,17977;18079,31755,0,0,2,0,2
54409,120,12924,18609;21726;21988;22201;22399,31755,0,1,4,0,5
54410,120,12925,18415;18495;22394;22664,31755,0,2,2,0,4
54411,120,12927,18107;18457;22096,31755,0,0,3,0,3
54412,120,12928,17692;17868,31755,0,0,2,0,2
54413,120,12929,17757;18157,31755,0,0,2,0,2
54414,120,12930,18311;18393;22290;22776,31755,0,1,3,0,4
54415,120,12931,18025;18247;21301,31755,0,0,3,0,3
54416,120,12932,18284;18343;21970;22385,31755,0,1,3,0,4
54417,120,12933,17996;18041;22074,31755,0,0,3,0,3
54418,120,12934,18396;18770;22006;22114;22682,31755,0,1,4,0,5
54419,120,12935,18784,31755,0,0,1,0,1
54420,120,12937,17939;18346,31755,0,0,2,0,2
54421,120,12938,18347;18381,31755,0,0,2,0,2
54422,120,12940,17667;18306;21696;22289,31755,0,0,4,0,4
54423,120,12941,13007,32120,0,0,0,1,1
54424,120,12943,13486,32120,0,0,0,1,1
54425,120,12947,13757,32120,0,0,0,1,1
54426,120,12952,13973,32120,0,0,0,1,1
54427,120,12957,14140,32120,0,0,0,1,1
54428,120,12958,14612,32120,0,0,0,1,1
54429,120,12961,14915,32120,0,0,0,1,1
54430,120,12962,14246,32120,0,0,0,1,1
54431,120,12970,14792,32120,0,0,0,1,1
54432,120,12981,16230;16473,32120,0,0,0,2,2
54433,120,12982,16303;16530,32120,0,0,0,2,2
54434,120,12987,16842,32120,0,0,0,1,1
54435,120,12989,17386;17458;21709,32120,0,0,3,0,3
54436,120,12990,17388,32120,0,0,1,0,1
54437,120,12993,16960;17339,32120,0,0,1,1,2
54438,120,12994,17518;21738,32120,0,0,2,0,2
54439,120,12995,17355;17936,32120,0,0,2,0,2
54440,120,12998,17689;17893;22059,32120,0,0,3,0,3
54441,120,12999,17678;17835,32120,0,0,2,0,2
54442,120,13000,17666,32120,0,0,1,0,1
54443,120,13002,17967,32120,0,0,1,0,1
54444,120,13003,17749;21463;21931,32120,0,0,3,0,3
54445,120,13004,17709;17758;22270,32120,0,0,3,0,3
54446,120,13005,17797;18063;21174,32120,0,0,3,0,3
54447,120,13006,17773;17800;21885,32120,0,0,3,0,3
54448,120,13007,17856;18288;21966,32120,0,0,3,0,3
54449,120,13008,17836;17894;22506,32120,0,1,2,0,3
54450,120,13009,17919;18146;21625;22182,32120,0,0,4,0,4
54451,120,13010,17601;17930,32120,0,0,2,0,2
54452,120,13011,18039;18397;21524;21886,32120,0,0,4,0,4
54453,120,13012,18486;18584;21698;22391,32120,0,1,3,0,4
54454,120,13013,17712;17983,32120,0,0,2,0,2
54455,120,13014,18048;18070,32120,0,0,2,0,2
54456,120,13015,18104;18561;22103;22398;22530;22667,32120,0,3,3,0,6
54457,120,13016,18110;18142,32120,0,0,2,0,2
54458,120,13017,18229;18248;22082,32120,0,0,3,0,3
54459,120,13018,18137;18670;20997;21207,32120,0,0,4,0,4
54460,120,13019,18168;22652,32120,0,1,1,0,2
54461,120,13021,18093;18604;21450;22305,32120,0,0,4,0,4
54462,120,13022,18212;18499;21888,32120,0,0,3,0,3
54463,120,13023,18223;18735;23014,32120,0,1,2,0,3
54464,120,13024,18587;21073;22197;22669,32120,0,1,3,0,4
54465,120,13025,17891;18282;21775;22657,32120,0,1,3,0,4
54466,120,13026,18286;18321;22775,32120,0,1,2,0,3
54467,120,13027,18523;18645;21658;22674;22787,32120,0,2,3,0,5
54468,120,13028,18378;21727;21769,32120,0,0,3,0,3
54469,120,13029,17963;18408,32120,0,0,2,0,2
54470,120,13030,18419;18729,32120,0,0,2,0,2
54471,120,13031,18613,32120,0,0,1,0,1
54472,120,13033,18452;21759;22389;23000,32120,0,2,2,0,4
54473,120,13034,18494;22198;22782,32120,0,1,2,0,3
54474,120,13035,18461;22523;22663,32120,0,2,1,0,3
54475,120,13036,17760;18342;21762,32120,0,0,3,0,3
54476,120,13037,18426,32120,0,0,1,0,1
54477,120,13038,18530,32120,0,0,1,0,1
54478,120,13039,17823;17852;21225;22271,32120,0,0,4,0,4
54479,120,13040,18237;18505;21519;24071,32120,1,0,3,0,4
54480,120,13041,18246;18515;22298,32120,0,0,3,0,3
54481,120,13042,18517;18663,32120,0,0,2,0,2
54482,120,13046,13347,32485,0,0,0,1,1
54483,120,13047,13309;13646,32485,0,0,0,2,2
54484,120,13048,13668,32485,0,0,0,1,1
54485,120,13050,14073,32485,0,0,0,1,1
54486,120,13052,14098,32485,0,0,0,1,1
54487,120,13053,14356,32485,0,0,0,1,1
54488,120,13054,14145,32485,0,0,0,1,1
54489,120,13057,14666,32485,0,0,0,1,1
54490,120,13060,15333,32485,0,0,0,1,1
54491,120,13064,15080,32485,0,0,0,1,1
54492,120,13070,15214;15528,32485,0,0,0,2,2
54493,120,13071,15385;15734,32485,0,0,0,2,2
54494,120,13072,15577,32485,0,0,0,1,1
54495,120,13081,16663;17212,32485,0,0,1,1,2
54496,120,13085,16988;16992,32485,0,0,0,2,2
54497,120,13086,17022;17501,32485,0,0,2,0,2
54498,120,13088,17111;17425,32485,0,0,2,0,2
54499,120,13090,17657;21794,32485,0,0,2,0,2
54500,120,13091,17681;22058,32485,0,0,2,0,2
54501,120,13092,17421;17655,32485,0,0,2,0,2
54502,120,13093,17416;17471;21051,32485,0,0,3,0,3
54503,120,13098,17613;21265;23186,32485,0,1,2,0,3
54504,120,13099,17265;17614;21442;24180,32485,1,0,3,0,4
54505,120,13100,17639;17934,32485,0,0,2,0,2
54506,120,13101,18506;21983;22098,32485,0,0,3,0,3
54507,120,13102,17682;18254,32485,0,0,2,0,2
54508,120,13104,17906;18060;21948;22510,32485,0,1,3,0,4
54509,120,13106,17839;18027;21932;22073,32485,0,0,4,0,4
54510,120,13108,17938;18209;22186,32485,0,0,3,0,3
54511,120,13109,17549;17958;21688;22175,32485,0,0,4,0,4
54512,120,13110,17532;17816,32485,0,0,2,0,2
54513,120,13111,17792;18023,32485,0,0,2,0,2
54514,120,13112,18028;18431,32485,0,0,2,0,2
54515,120,13113,17629;18033,32485,0,0,2,0,2
54516,120,13114,18049;18677,32485,0,0,2,0,2
54517,120,13115,17946;18054;22281,32485,0,0,3,0,3
54518,120,13116,18078;18155;20885;21954;22993;24044,32485,1,1,4,0,6
54519,120,13117,18153;18651;22537,32485,0,1,2,0,3
54520,120,13118,18156;18196;21302;22183,32485,0,0,4,0,4
54521,120,13119,18076;18180;21540,32485,0,0,3,0,3
54522,120,13120,17941;18208,32485,0,0,2,0,2
54523,120,13121,18008;18222;21253,32485,0,0,3,0,3
54524,120,13122,17827;18251;21569;21862;21962;22187,32485,0,0,6,0,6
54525,120,13123,18519;18749;22211;22409;22681,32485,0,2,3,0,5
54526,120,13124,18731;19000;22209;22407,32485,0,1,3,0,4
54527,120,13125,18637;22401,32485,0,1,1,0,2
54528,120,13127,17916;18319;21915,32485,0,0,3,0,3
54529,120,13128,18331;18548;22199,32485,0,0,3,0,3
54530,120,13129,17785;17877;21934,32485,0,0,3,0,3
54531,120,13131,18330;18429;22658,32485,0,1,2,0,3
54532,120,13132,18472;19016,32485,0,0,2,0,2
54533,120,13133,17950;18479,32485,0,0,2,0,2
54534,120,13134,18374;18496,32485,0,0,2,0,2
54535,120,13135,18502;23105,32485,0,1,1,0,2
54536,120,13136,18514;22665,32485,0,1,1,0,2
54537,120,13137,17968;18516;21537;21718;22101;22527,32485,0,1,5,0,6
54538,120,13138,18532;22395,32485,0,1,1,0,2
54539,120,13140,18575;21255;22302;23396;24267,32485,1,1,3,0,5
54540,120,13141,18170;18783,32485,0,0,2,0,2
54541,120,13142,18598;18738;21986;22200,32485,0,0,4,0,4
54542,120,13143,18612;18698;21406,32485,0,0,3,0,3
54543,120,13144,18867;19019;21609;22547;23846,32485,1,1,3,0,5
54544,120,13149,13867;14032,32850,0,0,0,2,2
54545,120,13153,13741,32850,0,0,0,1,1
54546,120,13159,13953,32850,0,0,0,1,1
54547,120,13164,14643;14988,32850,0,0,0,2,2
54548,120,13166,15117,32850,0,0,0,1,1
54549,120,13182,16127,32850,0,0,0,1,1
54550,120,13183,16326,32850,0,0,0,1,1
54551,120,13184,16328;16460,32850,0,0,0,2,2
54552,120,13186,16503,32850,0,0,0,1,1
54553,120,13192,16467,32850,0,0,0,1,1
54554,120,13195,17260;17407;21916;24081;24191,32850,2,0,3,0,5
54555,120,13197,17304;17525,32850,0,0,2,0,2
54556,120,13200,17659;17748,32850,0,0,2,0,2
54557,120,13201,17988;18098;21586,32850,0,0,3,0,3
54558,120,13202,17417;17755,32850,0,0,2,0,2
54559,120,13203,17721;18192,32850,0,0,2,0,2
54560,120,13204,17664;17925;21940,32850,0,0,3,0,3
54561,120,13205,17763;17802,32850,0,0,2,0,2
54562,120,13206,17565;17912,32850,0,0,2,0,2
54563,120,13207,17498;17810;21381,32850,0,0,3,0,3
54564,120,13208,17812;17991,32850,0,0,2,0,2
54565,120,13209,17691;21413,32850,0,0,2,0,2
54566,120,13210,17886;18562;22104;24290,32850,1,0,3,0,4
54567,120,13212,17909;18565,32850,0,0,2,0,2
54568,120,13213,17753;17927,32850,0,0,2,0,2
54569,120,13214,17683;17929;21311,32850,0,0,3,0,3
54570,120,13216,18313;18820;23190,32850,0,1,2,0,3
54571,120,13217,18102;18353;21971;22777,32850,0,1,3,0,4
54572,120,13218,18106;18655;23010,32850,0,1,2,0,3
54573,120,13219,17904;18116;22077;22513;22651,32850,0,2,3,0,5
54574,120,13220,18123;18620;22672,32850,0,1,2,0,3
54575,120,13221,18167,32850,0,0,1,0,1
54576,120,13222,18186;18323;23103,32850,0,1,2,0,3
54577,120,13223,18017;18206;21640;23958,32850,1,0,3,0,4
54578,120,13224,17594;18265;21830,32850,0,0,3,0,3
54579,120,13225,17897;18278;22518,32850,0,1,2,0,3
54580,120,13226,18293;18402;22188,32850,0,0,3,0,3
54581,120,13227,18317;18883;21215;21462;22548;23109;23509;23722;23944,32850,1,4,4,0,9
54582,120,13228,18334;18642;22202,32850,0,0,3,0,3
54583,120,13229,18189;18357;23104,32850,0,1,2,0,3
54584,120,13230,18253;18361;22191,32850,0,0,3,0,3
54585,120,13231,18600;18627;21294;22786;24170,32850,1,1,3,0,5
54586,120,13232,18244;18417;21855,32850,0,0,3,0,3
54587,120,13233,18447;22294,32850,0,0,2,0,2
54588,120,13234,17940;18450,32850,0,0,2,0,2
54589,120,13235,18435;18454;21638;22095;22390;22893,32850,0,2,4,0,6
54590,120,13236,18469;18864;23626,32850,0,1,2,0,3
54591,120,13237,18866;18929;22687,32850,0,1,2,0,3
54592,120,13238,18569;18597;23004,32850,0,1,2,0,3
54593,120,13239,18958;21711;22431;22555;22695,32850,0,3,2,0,5
54594,120,13240,18948;22911;23738,32850,1,1,1,0,3
54595,120,13241,18301;18786;23016;23108,32850,0,2,2,0,4
54596,120,13243,18283;18778;22543,32850,0,1,2,0,3
54597,120,13244,19065;19186;22565,32850,0,1,2,0,3
54598,120,13245,18667;18971;22432,32850,0,1,2,0,3
54599,120,13246,18560;18761;21768,32850,0,0,3,0,3
54600,120,13247,18549;19091;21083;22136;22231;23199,32850,0,1,5,0,6
54601,120,13248,19158;23119;23200,32850,0,2,1,0,3
54602,120,13249,18716;18861;22207;22312;22678,32850,0,1,4,0,5
54603,120,13250,18722;18920;22900,32850,0,1,2,0,3
54604,120,13252,18743;19059;23027,32850,0,1,2,0,3
54605,120,13254,18465;18763;22212;22313;22410,32850,0,1,4,0,5
54606,120,13255,18490;18765;21208;22213,32850,0,0,4,0,4
54607,120,13256,13863,33215,0,0,0,1,1
54608,120,13261,14064,33215,0,0,0,1,1
54609,120,13263,14150,33215,0,0,0,1,1
54610,120,13266,15165,33215,0,0,0,1,1
54611,120,13267,14936,33215,0,0,0,1,1
54612,120,13270,15025,33215,0,0,0,1,1
54613,120,13272,14765;15450,33215,0,0,0,2,2
54614,120,13280,15175;15176,33215,0,0,0,2,2
54615,120,13282,15291,33215,0,0,0,1,1
54616,120,13288,15374,33215,0,0,0,1,1
54617,120,13296,16920;17058;21144,33215,0,0,2,1,3
54618,120,13303,17818,33215,0,0,1,0,1
54619,120,13304,17582;21573,33215,0,0,2,0,2
54620,120,13306,17732,33215,0,0,1,0,1
54621,120,13307,17820;18148,33215,0,0,2,0,2
54622,120,13308,18141;18392;21552;22092,33215,0,0,4,0,4
54623,120,13309,17367;18128;22887,33215,0,1,2,0,3
54624,120,13310,17962;18019;21375;22068;23423;23954,33215,1,1,4,0,6
54625,120,13313,17552;17948;22174,33215,0,0,3,0,3
54626,120,13314,17848;17980,33215,0,0,2,0,2
54627,120,13315,18234;18297;21905,33215,0,0,3,0,3
54628,120,13318,17597;18020,33215,0,0,2,0,2
54629,120,13320,18038;18573,33215,0,0,2,0,2
54630,120,13321,18058;22378;22509,33215,0,2,1,0,3
54631,120,13322,18064;18510,33215,0,0,2,0,2
54632,120,13324,17914;18242,33215,0,0,2,0,2
54633,120,13325,17859;18143;22080,33215,0,0,3,0,3
54634,120,13326,18528;18649;22402,33215,0,1,2,0,3
54635,120,13328,18000;18210,33215,0,0,2,0,2
54636,120,13329,17945;18226;21814;23962,33215,1,0,3,0,4
54637,120,13330,18183;18231,33215,0,0,2,0,2
54638,120,13331,17634;18252;21813,33215,0,0,3,0,3
54639,120,13333,18269;18700;21140;21329;22311;22792,33215,0,1,5,0,6
54640,120,13334,18539;21119,33215,0,0,2,0,2
54641,120,13335,18296;18497;21563;22189;22382,33215,0,1,4,0,5
54642,120,13336,18300;18858;21882;22015;22546;23963,33215,1,1,4,0,6
54643,120,13337,18901;22217;22319,33215,0,0,3,0,3
54644,120,13338,18243;18366,33215,0,0,2,0,2
54645,120,13339,18352;18607,33215,0,0,2,0,2
54646,120,13340,18174;18356,33215,0,0,2,0,2
54647,120,13341,18195;18383;22890,33215,0,1,2,0,3
54648,120,13342,18272;18619;21989;22671,33215,0,1,3,0,4
54649,120,13343,18410;18897;23510,33215,0,1,2,0,3
54650,120,13344,18074;18413;21649,33215,0,0,3,0,3
54651,120,13345,18430;18544;21757;21975;22387;23507,33215,0,2,4,0,6
54652,120,13346,18433;22388;22662,33215,0,2,1,0,3
54653,120,13347,18475;19027;21906;22128;23024;24287,33215,1,1,4,0,6
54654,120,13348,18489;18590;21883;21981;22525,33215,0,1,4,0,5
54655,120,13349,18387;18513;23002,33215,0,1,2,0,3
54656,120,13350,19051;22918,33215,0,1,1,0,2
54657,120,13351,19083;22567;22920;23303,33215,0,3,1,0,4
54658,120,13352,18638;21354;22535,33215,0,1,2,0,3
54659,120,13353,18339;18669;22108;22204;22538,33215,0,1,4,0,5
54660,120,13354,18659;18678;22310;22790,33215,0,1,3,0,4
54661,120,13355,19147;19530;22233;22329,33215,0,0,4,0,4
54662,120,13356,19040;22130;22226,33215,0,0,3,0,3
54663,120,13357,18704;22109;22540;22793;23508,33215,0,3,2,0,5
54664,120,13358,18503;18741;22408,33215,0,1,2,0,3
54665,120,13359,18591;18747,33215,0,0,2,0,2
54666,120,13360,19237;21435;21837;22141;22813;23305,33215,0,2,4,0,6
54667,120,13361,19101;19331;22325;22701,33215,0,1,3,0,4
54668,120,13362,18779;21874,33215,0,0,2,0,2
54669,120,13363,18307;18602;22531;22784,33215,0,2,2,0,4
54670,120,13364,18728;18787;22413,33215,0,1,2,0,3
54671,120,13365,18805;19121;22442;23410,33215,0,2,2,0,4
54672,120,13366,18795;18807;21791;21870;22684,33215,0,1,4,0,5
54673,120,13367,18686;18797,33215,0,0,2,0,2
54674,120,13368,18842;18984;23302,33215,0,1,2,0,3
54675,120,13369,18845;18865;21122;21451;22120;22544;23830;23839,33215,2,1,5,0,8
54676,120,13371,18832;18892,33215,0,0,2,0,2
54677,120,13372,18902;19044,33215,0,0,2,0,2
54678,120,13373,18910;19271;22550,33215,0,1,2,0,3
54679,120,13376,13726,33580,0,0,0,1,1
54680,120,13377,13835,33580,0,0,0,1,1
54681,120,13381,13909,33580,0,0,0,1,1
54682,120,13389,14827,33580,0,0,0,1,1
54683,120,13391,14545,33580,0,0,0,1,1
54684,120,13394,15337,33580,0,0,0,1,1
54685,120,13395,15171,33580,0,0,0,1,1
54686,120,13398,14852;15228,33580,0,0,0,2,2
54687,120,13405,15789;15896,33580,0,0,0,2,2
54688,120,13410,16854;17303,33580,0,0,1,1,2
54689,120,13411,16979;17324,33580,0,0,1,1,2
54690,120,13412,17235;17293;21216,33580,0,0,3,0,3
54691,120,13415,17030;17292,33580,0,0,2,0,2
54692,120,13418,18026,33580,0,0,1,0,1
54693,120,13419,17529;21242;21529,33580,0,0,3,0,3
54694,120,13422,17596;18150;21752,33580,0,0,3,0,3
54695,120,13423,17649;17885,33580,0,0,2,0,2
54696,120,13425,17631;18139,33580,0,0,2,0,2
54697,120,13426,17817;22063;22504,33580,0,1,2,0,3
54698,120,13427,17668;17853;21666,33580,0,0,3,0,3
54699,120,13428,17970;18351;22088,33580,0,0,3,0,3
54700,120,13429,17953;21493,33580,0,0,2,0,2
54701,120,13430,18101;18236;21474,33580,0,0,3,0,3
54702,120,13432,18368,33580,0,0,1,0,1
54703,120,13434,17851;17993;22070,33580,0,0,3,0,3
54704,120,13435,18159;18176,33580,0,0,2,0,2
54705,120,13437,18204;18742,33580,0,0,2,0,2
54706,120,13438,18683;18896;21901;22296;22690;22909,33580,0,2,4,0,6
54707,120,13439,18857;23191,33580,0,1,1,0,2
54708,120,13440,18298;18543;21175;22299;22529,33580,0,1,4,0,5
54709,120,13441,18309;18470,33580,0,0,2,0,2
54710,120,13442,18520;18583,33580,0,0,2,0,2
54711,120,13443,18012;18327;21331;21969;23952;24176,33580,2,0,4,0,6
54712,120,13444,18344;18556;22300,33580,0,0,3,0,3
54713,120,13445,18364;18919;21627;22018;22218,33580,0,0,5,0,5
54714,120,13446,18191;18407;21739;22521;22660,33580,0,2,3,0,5
54715,120,13447,18360;18524;23003,33580,0,1,2,0,3
54716,120,13452,19072;22134;23198,33580,0,1,2,0,3
54717,120,13453,18559;22896,33580,0,1,1,0,2
54718,120,13454,18434;18879;21740;22420,33580,0,1,3,0,4
54719,120,13456,18423;18982;22021;22802;23023;23112;23195,33580,0,4,3,0,7
54720,120,13458,18622;18877,33580,0,0,2,0,2
54721,120,13459,18245;18631;21991,33580,0,0,3,0,3
54722,120,13460,18648;18874;22688;22907,33580,0,2,2,0,4
54723,120,13461,19141;23029,33580,0,1,1,0,2
54724,120,13462,18577;18630;21396;21995;22203;22534,33580,0,1,5,0,6
54725,120,13463,18624;18699;21723,33580,0,0,3,0,3
54726,120,13464,18708;19064,33580,0,0,2,0,2
54727,120,13465,18217;18727;22004;22679;22794,33580,0,2,3,0,5
54728,120,13466,19060;21254;22564,33580,0,1,2,0,3
54729,120,13467,18757;18894;22795;23015,33580,0,2,2,0,4
54730,120,13468,18294;18793;21438;21808;22683;24273,33580,1,1,4,0,6
54731,120,13469,18801;18996;22011;22414,33580,0,1,3,0,4
54732,120,13470,18815;21810,33580,0,0,2,0,2
54733,120,13471,18821;19321;22459;23125;23415,33580,0,3,2,0,5
54734,120,13472,18830;19070,33580,0,0,2,0,2
54735,120,13473,19210;22450;22574;23201,33580,0,3,1,0,4
54736,120,13474,18836;18969,33580,0,0,2,0,2
54737,120,13475,18945;21419;22221;22427;22692;22800,33580,0,3,3,0,6
54738,120,13476,18422;18848;21753;23017,33580,0,1,3,0,4
54739,120,13477,18967;21590;23022;23733,33580,0,2,2,0,4
54740,120,13478,18912;19004,33580,0,0,2,0,2
54741,120,13479,18970;19296;22125;22556;23628,33580,0,2,3,0,5
54742,120,13480,19261;22454;23032,33580,0,2,1,0,3
54743,120,13487,13891,33945,0,0,0,1,1
54744,120,13488,13724,33945,0,0,0,1,1
54745,120,13489,13787;14000,33945,0,0,0,2,2
54746,120,13498,14564,33945,0,0,0,1,1
54747,120,13507,15576,33945,0,0,0,1,1
54748,120,13508,14814;15280,33945,0,0,0,2,2
54749,120,13510,15837,33945,0,0,0,1,1
54750,120,13524,16829;16870,33945,0,0,0,2,2
54751,120,13525,16172;16919,33945,0,0,0,2,2
54752,120,13529,17178;17428,33945,0,0,2,0,2
54753,120,13532,17290;18201;21959;22185;24289,33945,1,0,4,0,5
54754,120,13538,17356;17793;21574;22375,33945,0,1,3,0,4
54755,120,13539,18261,33945,0,0,1,0,1
54756,120,13540,17881;18529,33945,0,0,2,0,2
54757,120,13541,18188,33945,0,0,1,0,1
54758,120,13542,17981;18003,33945,0,0,2,0,2
54759,120,13544,17450;17702,33945,0,0,2,0,2
54760,120,13545,18057,33945,0,0,1,0,1
54761,120,13546,18182,33945,0,0,1,0,1
54762,120,13547,18080;18399;21656,33945,0,0,3,0,3
54763,120,13548,18380;22193;22781,33945,0,1,2,0,3
54764,120,13549,18218;18466;21604;21659,33945,0,0,4,0,4
54765,120,13550,18325;18332,33945,0,0,2,0,2
54766,120,13551,18386;18672;21846;21997,33945,0,0,4,0,4
54767,120,13552,18817;18875;22908,33945,0,1,2,0,3
54768,120,13553,18484;18944;22124;23021,33945,0,1,3,0,4
54769,120,13555,18847;19129;22571;22807,33945,0,2,2,0,4
54770,120,13556,18563;18782;21821,33945,0,0,3,0,3
54771,120,13557,18589;18652;21993;22562;22788;22899,33945,0,3,3,0,6
54772,120,13559,18635;18753,33945,0,0,2,0,2
54773,120,13560,18676;19132;22921,33945,0,1,2,0,3
54774,120,13561,18679;19096,33945,0,0,2,0,2
54775,120,13562,18718;21398;21644,33945,0,0,3,0,3
54776,120,13563,19280;19508;21774;22243;22336;24189,33945,1,0,5,0,6
54777,120,13564,18709;22206,33945,0,0,2,0,2
54778,120,13565,18570;18739;22897,33945,0,1,2,0,3
54779,120,13566,19217;19521;22830;22955,33945,0,2,2,0,4
54780,120,13567,18193;18762,33945,0,0,2,0,2
54781,120,13568,18764;19017;21572;22225,33945,0,0,4,0,4
54782,120,13569,19541;22250;22601;22833;23746,33945,1,2,2,0,5
54783,120,13570,18835;18922;22320,33945,0,0,3,0,3
54784,120,13571,18800;18899;21845;22691,33945,0,1,3,0,4
54785,120,13572,18628;18885;22689,33945,0,1,2,0,3
54786,120,13573,18733;18926;22019;22219;24084,33945,1,0,4,0,5
54787,120,13574,18949;22693,33945,0,1,1,0,2
54788,120,13575,18936;18955;21693;22430;22554,33945,0,2,3,0,5
54789,120,13576,18715;18959;22112;23012,33945,0,1,3,0,4
54790,120,13577,18240;18961;23111,33945,0,1,2,0,3
54791,120,13578,18965,33945,0,0,1,0,1
54792,120,13579,18572;18988;23407,33945,0,1,2,0,3
54793,120,13580,19229;19234;22928,33945,0,1,2,0,3
54794,120,13581,18837;19046;22698;22917,33945,0,2,2,0,4
54795,120,13582,19047;22437;23115,33945,0,2,1,0,3
54796,120,13583,18737;19049,33945,0,0,2,0,2
54797,120,13584,18914;19053;22122;22424;22798;23019,33945,0,3,3,0,6
54798,120,13585,19068;22324;23116,33945,0,1,2,0,3
54799,120,13586,19069;19145;23030,33945,0,1,2,0,3
54800,120,13587,19218;19494;22044;22475;23046,33945,0,2,3,0,5
54801,120,13588,19082;19311;22457;23123,33945,0,2,2,0,4
54802,120,13589,18841;19094;21504,33945,0,0,3,0,3
54803,120,13591,19109;19364;21373,33945,0,0,3,0,3
54804,120,13592,19119;23512,33945,0,1,1,0,2
54805,120,13593,19312;22458,33945,0,1,1,0,2
54806,120,13594,18696;19136;22028;22137,33945,0,0,4,0,4
54807,120,13595,18335;19137;22444;22922,33945,0,2,2,0,4
54808,120,13596,19143;19160;22809;23412,33945,0,2,2,0,4
54809,120,13597,19173;19196;22032;24195,33945,1,0,3,0,4
54810,120,13598,19388;19492;22727;23218,33945,0,2,2,0,4
54811,120,13601,14028,34310,0,0,0,1,1
54812,120,13602,14047,34310,0,0,0,1,1
54813,120,13604,14304,34310,0,0,0,1,1
54814,120,13610,14937,34310,0,0,0,1,1
54815,120,13614,14922,34310,0,0,0,1,1
54816,120,13615,14952;15135,34310,0,0,0,2,2
54817,120,13618,15488,34310,0,0,0,1,1
54818,120,13622,15839;15949,34310,0,0,0,2,2
54819,120,13624,15766;16067,34310,0,0,0,2,2
54820,120,13631,16433,34310,0,0,0,1,1
54821,120,13635,16542;16765,34310,0,0,0,2,2
54822,120,13638,16999,34310,0,0,0,1,1
54823,120,13640,16907;17291;21541,34310,0,0,2,1,3
54824,120,13641,17390;17701,34310,0,0,2,0,2
54825,120,13643,17924;18263;22084,34310,0,0,3,0,3
54826,120,13645,17251;17842;21548;21818,34310,0,0,4,0,4
54827,120,13646,17366;17905;21891,34310,0,0,3,0,3
54828,120,13647,17944;18318;22291,34310,0,0,3,0,3
54829,120,13648,18125,34310,0,0,1,0,1
54830,120,13649,17814;18127,34310,0,0,2,0,2
54831,120,13650,17961,34310,0,0,1,0,1
54832,120,13651,17636;18036,34310,0,0,2,0,2
54833,120,13653,18194;18768,34310,0,0,2,0,2
54834,120,13654,18930;19022;21584;21654;24280,34310,1,0,4,0,5
54835,120,13655,18207;18337,34310,0,0,2,0,2
54836,120,13656,18350,34310,0,0,1,0,1
54837,120,13657,18355;18508;22895,34310,0,1,2,0,3
54838,120,13658,18365;18522;21825,34310,0,0,3,0,3
54839,120,13659,18129;18538;22528,34310,0,1,2,0,3
54840,120,13660,18567,34310,0,0,1,0,1
54841,120,13661,18476;21979;22295;22524,34310,0,1,3,0,4
54842,120,13662,18458;19015,34310,0,0,2,0,2
54843,120,13663,18460;18781,34310,0,0,2,0,2
54844,120,13665,18477;21499;21980,34310,0,0,3,0,3
54845,120,13667,18571;18744,34310,0,0,2,0,2
54846,120,13668,18504;18574;22526;22894,34310,0,2,2,0,4
54847,120,13669,18568;18878,34310,0,0,2,0,2
54848,120,13670,19052;19118;22227;22438,34310,0,1,3,0,4
54849,120,13671,18276;18664;21965,34310,0,0,3,0,3
54850,120,13672,19356;21889;22592,34310,0,1,2,0,3
54851,120,13673,19128;19256,34310,0,0,2,0,2
54852,120,13674,19319;22585;22713,34310,0,2,1,0,3
54853,120,13675,18444;18585;22303;23006;23187,34310,0,2,3,0,5
54854,120,13676,18772;19008;22435,34310,0,1,2,0,3
54855,120,13678,18802,34310,0,0,1,0,1
54856,120,13681,18367;18825;21686;22118;22415,34310,0,1,4,0,5
54857,120,13682,18849;18863;22215;22318,34310,0,0,4,0,4
54858,120,13683,19135;22327;23513,34310,0,1,2,0,3
54859,120,13684,18220;18898;22797,34310,0,1,2,0,3
54860,120,13685,18992;22558;22803,34310,0,2,1,0,3
54861,120,13686,18921;19150,34310,0,0,2,0,2
54862,120,13687,18871;18927,34310,0,0,2,0,2
54863,120,13688,18942;22552,34310,0,1,1,0,2
54864,120,13689,18576;18850;22904,34310,0,1,2,0,3
54865,120,13690,18968;19546;21672;22479;23316;23524,34310,0,3,3,0,6
54866,120,13691,18980;19411;22467,34310,0,1,2,0,3
54867,120,13692,18993;19478;22023;22224;23113,34310,0,1,4,0,5
54868,120,13693,19551;23049;23425;23525,34310,0,3,1,0,4
54869,120,13695,19014;19389,34310,0,0,2,0,2
54870,120,13696,18908;19023;22127;22804,34310,0,1,3,0,4
54871,120,13697,19431;22719;22827,34310,0,2,1,0,3
54872,120,13698,18803;19036,34310,0,0,2,0,2
54873,120,13699,18603;19043;22916;23026;23114;23196,34310,0,4,2,0,6
54874,120,13700,19504;19596,34310,0,0,2,0,2
54875,120,13701,18665;19260;22143;22453,34310,0,1,3,0,4
54876,120,13702,19134;19393;22466,34310,0,1,2,0,3
54877,120,13703,18966;19172;21521;22448;22812;23514;24072,34310,1,3,3,0,7
54878,120,13704,19157;19191;22704;22924,34310,0,2,2,0,4
54879,120,13705,19011;19192;21641;21907,34310,0,0,4,0,4
54880,120,13707,19410;19471;22828;23216,34310,0,2,2,0,4
54881,120,13708,19230;19449;21843;22469,34310,0,1,3,0,4
54882,120,13709,19322;19335;22587;22938,34310,0,2,2,0,4
54883,120,13710,18540;19215;21661;21771;22451;22926;24282,34310,1,2,4,0,7
54884,120,13711,19278;19516,34310,0,0,2,0,2
54885,120,13712,18759;19281;22816;23631,34310,0,2,2,0,4
54886,120,13713,19276;19282;22242;22933,34310,0,1,3,0,4
54887,120,13714,18924;19293;22455,34310,0,1,2,0,3
54888,120,13715,19303;19304;21903;22818;23122,34310,0,2,3,0,5
54889,120,13716,14141;14384,34675,0,0,0,2,2
54890,120,13720,14094,34675,0,0,0,1,1
54891,120,13721,14020,34675,0,0,0,1,1
54892,120,13724,14870,34675,0,0,0,1,1
54893,120,13731,14943;15236,34675,0,0,0,2,2
54894,120,13736,15036;15210,34675,0,0,0,2,2
54895,120,13737,15666,34675,0,0,0,1,1
54896,120,13739,15997,34675,0,0,0,1,1
54897,120,13741,15912;16026,34675,0,0,0,2,2
54898,120,13744,16340;16934,34675,0,0,0,2,2
54899,120,13747,16769;17199,34675,0,0,1,1,2
54900,120,13750,16538;16971,34675,0,0,0,2,2
54901,120,13755,17169,34675,0,0,1,0,1
54902,120,13757,16539;17409,34675,0,0,1,1,2
54903,120,13759,17361;17412,34675,0,0,2,0,2
54904,120,13764,18082;18119,34675,0,0,2,0,2
54905,120,13765,18086;18362;22192,34675,0,0,3,0,3
54906,120,13766,18055;18151,34675,0,0,2,0,2
54907,120,13768,18314;18403;21967,34675,0,0,3,0,3
54908,120,13769,18257;18370;21908,34675,0,0,3,0,3
54909,120,13770,18100;18440,34675,0,0,2,0,2
54910,120,13772,18498;22297,34675,0,0,2,0,2
54911,120,13773,18553;18840;22119;22417,34675,0,1,3,0,4
54912,120,13774,18595;22105;22304;22670;22898,34675,0,2,3,0,5
54913,120,13775,18056;18616;22785,34675,0,1,2,0,3
54914,120,13777,18647;18788,34675,0,0,2,0,2
54915,120,13778,18545;18695;22000;22791,34675,0,1,3,0,4
54916,120,13779,18767;19104;22702;23408,34675,0,2,2,0,4
54917,120,13780,18776;18791,34675,0,0,2,0,2
54918,120,13781,18794;19198;22330,34675,0,0,3,0,3
54919,120,13782,18796,34675,0,0,1,0,1
54920,120,13784,18692;18855;22545;22906,34675,0,2,2,0,4
54921,120,13785,18789;18860;22121;22418;23018,34675,0,2,3,0,5
54922,120,13787,18724;19078;21660;22135,34675,0,0,4,0,4
54923,120,13788,18937;19130;22910;23851,34675,1,1,2,0,4
54924,120,13789,19162;19259;22931;23853,34675,1,1,2,0,4
54925,120,13790,18838;19029;22129;22561;23025,34675,0,2,3,0,5
54926,120,13791,18579;19048,34675,0,0,2,0,2
54927,120,13792,19166;22140;22811,34675,0,1,2,0,3
54928,120,13793,19071;19289;21530;23307,34675,0,1,3,0,4
54929,120,13794,18903;19074;22423,34675,0,1,2,0,3
54930,120,13795,19374,34675,0,0,1,0,1
54931,120,13796,19120;19349,34675,0,0,2,0,2
54932,120,13797,19126;23117;23411,34675,0,2,1,0,3
54933,120,13798,19153;22446,34675,0,1,1,0,2
54934,120,13799,19177;19206;21578;22572,34675,0,1,3,0,4
54935,120,13800,19211;19391;22945;23211,34675,0,2,2,0,4
54936,120,13801,19375;19633;23318;23431,34675,0,2,2,0,4
54937,120,13802,19224;22332,34675,0,0,2,0,2
54938,120,13803,19228,34675,0,0,1,0,1
54939,120,13804,19031;19283;22582;23034;23121;23203;23741,34675,1,4,2,0,7
54940,120,13805,19298;22583,34675,0,1,1,0,2
54941,120,13807,19367;19578;23220;23427,34675,0,2,2,0,4
54942,120,13809,19310;19437;22721;23042,34675,0,2,2,0,4
54943,120,13810,19250;19320;22586;22937,34675,0,2,2,0,4
54944,120,13811,19079;19350;22039;22591;23036;23127;23209;24085,34675,1,4,3,0,8
54945,120,13812,18886;19353;21561;23210,34675,0,1,3,0,4
54946,120,13813,19385;22716;23131,34675,0,2,1,0,3
54947,120,13814,19275;19440;22595;23633,34675,0,2,2,0,4
54948,120,13815,19495;19509;23136,34675,0,1,2,0,3
54949,120,13816,19733;21500;23063;23228;23621,34675,0,3,2,0,5
54950,120,13821,14897,35040,0,0,0,1,1
54951,120,13822,14783,35040,0,0,0,1,1
54952,120,13826,15001;15250,35040,0,0,0,2,2
54953,120,13828,14855,35040,0,0,0,1,1
54954,120,13829,15159,35040,0,0,0,1,1
54955,120,13830,15276,35040,0,0,0,1,1
54956,120,13835,15662,35040,0,0,0,1,1
54957,120,13839,16163,35040,0,0,0,1,1
54958,120,13840,15545,35040,0,0,0,1,1
54959,120,13842,16221,35040,0,0,0,1,1
54960,120,13844,16567;16775,35040,0,0,0,2,2
54961,120,13849,17043;17092,35040,0,0,2,0,2
54962,120,13856,17676;17922,35040,0,0,2,0,2
54963,120,13864,18172;18509;22184,35040,0,0,3,0,3
54964,120,13865,18315;18526;21984,35040,0,0,3,0,3
54965,120,13866,18656;22403;22675,35040,0,2,1,0,3
54966,120,13868,18388;19252;22578,35040,0,1,2,0,3
54967,120,13870,18406;19266;21865,35040,0,0,3,0,3
54968,120,13871,18421;18808,35040,0,0,2,0,2
54969,120,13872,18268;18439;21976;24192,35040,1,0,3,0,4
54970,120,13873,18441;18661;22107;22308;22404,35040,0,1,4,0,5
54971,120,13874,18448;18480,35040,0,0,2,0,2
54972,120,13875,18113;18451,35040,0,0,2,0,2
54973,120,13876,18463,35040,0,0,1,0,1
54974,120,13877,17727;18492;22097,35040,0,0,3,0,3
54975,120,13878,18391;18500,35040,0,0,2,0,2
54976,120,13880,18363;19067;22027;22566,35040,0,1,3,0,4
54977,120,13881,18653;18859;22686;22796,35040,0,2,2,0,4
54978,120,13882,18239;18552;21857;22397,35040,0,1,3,0,4
54979,120,13884,18487;18606;21805;22392,35040,0,1,3,0,4
54980,120,13885,18872;22419,35040,0,1,1,0,2
54981,120,13886,18449;18693;22205;23188,35040,0,1,3,0,4
54982,120,13887,18132;18611,35040,0,0,2,0,2
54983,120,13888,18424;18707;22111;22677,35040,0,1,3,0,4
54984,120,13889,18271;18710,35040,0,0,2,0,2
54985,120,13890,18775;18986;22117;22412,35040,0,1,3,0,4
54986,120,13891,18228;18799;23189,35040,0,1,2,0,3
54987,120,13892,18934;19483;22344,35040,0,0,3,0,3
54988,120,13893,18951;22222,35040,0,0,2,0,2
54989,120,13894,18459;18952;22428;22553,35040,0,2,2,0,4
54990,120,13895,18436;18974;23194;23406,35040,0,2,2,0,4
54991,120,13896,19003;19486;22726;23636,35040,0,2,2,0,4
54992,120,13897,19161;19342;21713;23735,35040,0,1,3,0,4
54993,120,13898,19009;19236,35040,0,0,2,0,2
54994,120,13899,19041;22025,35040,0,0,2,0,2
54995,120,13900,19025;19333;22589;22939,35040,0,2,2,0,4
54996,120,13901,19661;22605;23644,35040,0,2,1,0,3
54997,120,13902,18684;19075;21871,35040,0,0,3,0,3
54998,120,13903,19088;19476;22343;23421,35040,0,1,3,0,4
54999,120,13904,18713;19056;22563,35040,0,1,2,0,3
55000,120,13905,19117;19610,35040,0,0,2,0,2
55001,120,13906,18888;19139;22328,35040,0,0,3,0,3
55002,120,13907,18983;19140;22029,35040,0,0,3,0,3
55003,120,13908,19171;19323;22460;22714;23516;24197,35040,1,3,2,0,6
55004,120,13909,19579;21790;22960,35040,0,1,2,0,3
55005,120,13910,18935;19209;22449;22705,35040,0,2,2,0,4
55006,120,13911,19213;19316;22244;22711;22936;23632,35040,0,3,3,0,6
55007,120,13912,19219;19405;22824,35040,0,1,2,0,3
55008,120,13913,19233;19531;23424;23638,35040,0,2,2,0,4
55009,120,13914,19240;22240;22814;22929,35040,0,2,2,0,4
55010,120,13917,19032;19268;22581,35040,0,1,2,0,3
55011,120,13918,19286;19748;24089,35040,1,0,2,0,3
55012,120,13919,18913;19294;21699;22146;22456;23204,35040,0,2,4,0,6
55013,120,13920,19500;19590;23641;23748,35040,1,1,2,0,4
55014,120,13921,19317;19386;22712;23207,35040,0,2,2,0,4
55015,120,13922,19245;19644;23054,35040,0,1,2,0,3
55016,120,13923,19377;22464;23039,35040,0,2,1,0,3
55017,120,13924,19203;19383;22943;23744,35040,1,1,2,0,4
55018,120,13925,19338;19400;23745,35040,1,0,2,0,3
55019,120,13927,19629;19649;23858,35040,1,0,2,0,3
55020,120,13928,19057;19532;22831,35040,0,1,2,0,3
55021,120,13929,19086;19542;22478;23140,35040,0,2,2,0,4
55022,120,13930,19279;19552;22834;23526,35040,0,2,2,0,4
55023,120,13931,19183;19668;23057,35040,0,1,2,0,3
55024,120,13932,19499;19872;23543;24093,35040,1,1,2,0,4
55025,120,13935,14506,35405,0,0,0,1,1
55026,120,13937,14551,35405,0,0,0,1,1
55027,120,13938,14901,35405,0,0,0,1,1
55028,120,13940,15156,35405,0,0,0,1,1
55029,120,13942,15356,35405,0,0,0,1,1
55030,120,13943,15382,35405,0,0,0,1,1
55031,120,13945,14861;15173,35405,0,0,0,2,2
55032,120,13949,15838;15922,35405,0,0,0,2,2
55033,120,13952,16231,35405,0,0,0,1,1
55034,120,13955,16144;16363,35405,0,0,0,2,2
55035,120,13960,17180,35405,0,0,1,0,1
55036,120,13968,17477,35405,0,0,1,0,1
55037,120,13971,17804;17831;22272,35405,0,0,3,0,3
55038,120,13974,17952;18531;22102,35405,0,0,3,0,3
55039,120,13975,18266;22517;22656,35405,0,2,1,0,3
55040,120,13976,17775;17808;21913,35405,0,0,3,0,3
55041,120,13977,17651;18030;21782;24190,35405,1,0,3,0,4
55042,120,13978,17725;17754;22648,35405,0,1,2,0,3
55043,120,13979,17910;18051;23401,35405,0,1,2,0,3
55044,120,13980,17864;18065;21783;22650;22772,35405,0,2,3,0,5
55045,120,13981,18087;18581;22668;23005,35405,0,2,2,0,4
55046,120,13982,18270;18442;21977;22999;23298,35405,0,2,3,0,5
55047,120,13984,18324;22383;22889,35405,0,2,1,0,3
55048,120,13985,18117;18333,35405,0,0,2,0,2
55049,120,13987,18369;22778,35405,0,1,1,0,2
55050,120,13989,18379;21800;21914;22659;22780,35405,0,2,3,0,5
55051,120,13990,18416;18953;22429;22801;23193,35405,0,3,2,0,5
55052,120,13991,18443;18703;22406,35405,0,1,2,0,3
55053,120,13992,18464;18662;21996;22405,35405,0,1,3,0,4
55054,120,13993,18485;18521;22783;23403,35405,0,2,2,0,4
55055,120,13995,18534;18769;22005;22113,35405,0,0,4,0,4
55056,120,13996,18594;19089;22439,35405,0,1,2,0,3
55057,120,13997,18411;18621;21990,35405,0,0,3,0,3
55058,120,14000,19454;19455;22470;22725;22950;23134;23310,35405,0,5,2,0,7
55059,120,14002,18593;18748;22541,35405,0,1,2,0,3
55060,120,14003,19001;22560,35405,0,1,1,0,2
55061,120,14004,18870;19107,35405,0,0,2,0,2
55062,120,14006,18975;22433,35405,0,1,1,0,2
55063,120,14007,18985,35405,0,0,1,0,1
55064,120,14008,19696;22162;22968;23226,35405,0,2,2,0,4
55065,120,14009,19446;19768;22970,35405,0,1,2,0,3
55066,120,14010,19098;19741;22355,35405,0,0,3,0,3
55067,120,14011,19100;19178;22440,35405,0,1,2,0,3
55068,120,14012,18792;19133;22443;23739,35405,1,1,2,0,4
55069,120,14013,19604;19697,35405,0,0,2,0,2
55070,120,14014,19080;19148,35405,0,0,2,0,2
55071,120,14015,18854;22905,35405,0,1,1,0,2
55072,120,14016,19176;19358;22246,35405,0,0,3,0,3
55073,120,14017,18869;19180,35405,0,0,2,0,2
55074,120,14018,19201;19475;22342;23420,35405,0,1,3,0,4
55075,120,14019,19654;19774;22738,35405,0,1,2,0,3
55076,120,14021,19285;23035;23414,35405,0,2,1,0,3
55077,120,14022,19329;19878;23237,35405,0,1,2,0,3
55078,120,14023,19336;19576;22959;23426,35405,0,2,2,0,4
55079,120,14024,18876;19339;22245;22339,35405,0,0,4,0,4
55080,120,14026,19390;19824;23066,35405,0,1,2,0,3
55081,120,14027,18605;19401;22718;22946,35405,0,2,2,0,4
55082,120,14029,18671;19417;23041,35405,0,1,2,0,3
55083,120,14030,19396;19453;22154;22341;22949;23043;23967,35405,1,2,4,0,7
55084,120,14031,19473;19498,35405,0,0,2,0,2
55085,120,14032,19482;19974,35405,0,0,2,0,2
55086,120,14034,18688;19503;22345;22728;23138,35405,0,2,3,0,5
55087,120,14035,19616;19669;23530,35405,0,1,2,0,3
55088,120,14037,19334;19420;22825;23309,35405,0,2,2,0,4
55089,120,14038,19443;19493;22468;22722,35405,0,2,2,0,4
55090,120,14039,19263;19771;22847;23540,35405,0,2,2,0,4
55091,120,14040,19512;19553;22251;23141;23970,35405,1,1,3,0,5
55092,120,14041,18998;19875;23443;23655,35405,0,2,2,0,4
55093,120,14042,19461;19556,35405,0,0,2,0,2
55094,120,14043,19300;19564,35405,0,0,2,0,2
55095,120,14044,19572;19612;22837;22962;23429,35405,0,3,2,0,5
55096,120,14045,19589;19716;22609;23148,35405,0,2,2,0,4
55097,120,14046,19605;19712;22735,35405,0,1,2,0,3
55098,120,14048,19675;19751;21851;22050;22969;23230;23439,35405,0,3,4,0,7
55099,120,14049,19736;19934;23240,35405,0,1,2,0,3
55100,120,14050,19092;19609;23317,35405,0,1,2,0,3
55101,120,14051,19595;22047;22835,35405,0,1,2,0,3
55102,120,14052,14085,35770,0,0,0,1,1
55103,120,14053,14715,35770,0,0,0,1,1
55104,120,14054,14257,35770,0,0,0,1,1
55105,120,14055,14236,35770,0,0,0,1,1
55106,120,14059,15000;15372,35770,0,0,0,2,2
55107,120,14060,15079;15667,35770,0,0,0,2,2
55108,120,14066,14531,35770,0,0,0,1,1
55109,120,14067,15410,35770,0,0,0,1,1
55110,120,14069,14720,35770,0,0,0,1,1
55111,120,14071,15718;16019,35770,0,0,0,2,2
55112,120,14072,15750;15970,35770,0,0,0,2,2
55113,120,14074,16089,35770,0,0,0,1,1
55114,120,14082,17225;17724,35770,0,0,2,0,2
55115,120,14088,18382;22090,35770,0,0,2,0,2
55116,120,14089,17806,35770,0,0,1,0,1
55117,120,14090,17829;17997,35770,0,0,2,0,2
55118,120,14091,17693;17809,35770,0,0,2,0,2
55119,120,14092,18681;23107;23299,35770,0,2,1,0,3
55120,120,14093,18112;18446,35770,0,0,2,0,2
55121,120,14094,18674;18826;22315;22416;22422,35770,0,2,3,0,5
55122,120,14095,17564;18303;22998,35770,0,1,2,0,3
55123,120,14097,17863;18418;21974;22386;22661,35770,0,2,3,0,5
55124,120,14098,19144;19384;22944,35770,0,1,2,0,3
55125,120,14099,18798,35770,0,0,1,0,1
55126,120,14100,18582;19039;22323,35770,0,0,3,0,3
55127,120,14101,18145;18640;22536;23106,35770,0,2,2,0,4
55128,120,14102,18625;22400;23008,35770,0,2,1,0,3
55129,120,14105,18963;22223;22696,35770,0,1,2,0,3
55130,120,14106,18960,35770,0,0,1,0,1
55131,120,14107,18467;18844,35770,0,0,2,0,2
55132,120,14109,18542;18943;22799,35770,0,1,2,0,3
55133,120,14110,18973;19305;22709;23742,35770,1,1,2,0,4
55134,120,14112,18675;19529,35770,0,0,2,0,2
55135,120,14113,18823;19146,35770,0,0,2,0,2
55136,120,14114,19220;19232,35770,0,0,2,0,2
55137,120,14115,19243;19398;22142;22577;23031,35770,0,2,3,0,5
55138,120,14116,19244;19753;23231,35770,0,1,2,0,3
55139,120,14117,19798,35770,0,0,1,0,1
55140,120,14119,18814;19277;22035;23033;23740,35770,1,1,3,0,5
55141,120,14120,19295;19681;23645,35770,0,1,2,0,3
55142,120,14121,19325;22461;22588,35770,0,2,1,0,3
55143,120,14122,19993;23074;23452,35770,0,2,1,0,3
55144,120,14123,18923;19360;22593,35770,0,1,2,0,3
55145,120,14124,19297;19302;22817;22935,35770,0,2,2,0,4
55146,120,14125,19370;22820;23038;23130;23519,35770,0,4,1,0,5
55147,120,14126,19409;19734;22612;23538;23976,35770,1,2,2,0,5
55148,120,14127,19430;19533,35770,0,0,2,0,2
55149,120,14128,19891;23069,35770,0,1,1,0,2
55150,120,14129,19421;22826,35770,0,1,1,0,2
55151,120,14130,19432,35770,0,0,1,0,1
55152,120,14131,19462;19657;22965,35770,0,1,2,0,3
55153,120,14132,19249;19470;22155;23215;23968,35770,1,1,3,0,5
55154,120,14133,19554;19699;22352,35770,0,0,3,0,3
55155,120,14134,19484;19543;22158;23747,35770,1,0,3,0,4
55156,120,14135,19511;22729,35770,0,1,1,0,2
55157,120,14136,19776;22971;23232,35770,0,2,1,0,3
55158,120,14138,19539;19791;22600;22832;23315;23639,35770,0,4,2,0,6
55159,120,14139,19558;19809,35770,0,0,2,0,2
55160,120,14140,19258;19573;22602,35770,0,1,2,0,3
55161,120,14141,19602;19635;23053,35770,0,1,2,0,3
55162,120,14142,19627;19790;23065;23651,35770,0,2,2,0,4
55163,120,14143,19099;22568;22700;22805,35770,0,3,1,0,4
55164,120,14144,19548;19680;22842,35770,0,1,2,0,3
55165,120,14145,19652;19682;22484;23145,35770,0,2,2,0,4
55166,120,14146,19362;19844;22488;22616;23757,35770,1,2,2,0,5
55167,120,14147,19125;19703;23320,35770,0,1,2,0,3
55168,120,14148,19357;19718;23059;23436;23861,35770,1,2,2,0,5
55169,120,14149,19659;19837;22615;22849;23067,35770,0,3,2,0,5
55170,120,14150,19738;19914;23867,35770,1,0,2,0,3
55171,120,14151,19980;22860;23246;23550;23869;23982,35770,2,3,1,0,6
55172,120,14152,19800;19843;23151;23652;24091,35770,1,2,2,0,5
55173,120,14153,19775;20027;22752;23870,35770,1,1,2,0,4
55174,120,14156,14105,36135,0,0,0,1,1
55175,120,14159,15042,36135,0,0,0,1,1
55176,120,14161,15162,36135,0,0,0,1,1
55177,120,14162,15248;15822,36135,0,0,0,2,2
55178,120,14166,15377,36135,0,0,0,1,1
55179,120,14168,15694;15708,36135,0,0,0,2,2
55180,120,14169,15272,36135,0,0,0,1,1
55181,120,14170,15591;15895,36135,0,0,0,2,2
55182,120,14171,15844;16421,36135,0,0,0,2,2
55183,120,14173,15825;16032,36135,0,0,0,2,2
55184,120,14178,16106,36135,0,0,0,1,1
55185,120,14179,15587;15816,36135,0,0,0,2,2
55186,120,14180,16581;16760,36135,0,0,0,2,2
55187,120,14195,17771;18169,36135,0,0,2,0,2
55188,120,14201,18420;19254;22579;22930;23202;23306;23515,36135,0,5,2,0,7
55189,120,14203,18341;18933;22020;22551;23020,36135,0,2,3,0,5
55190,120,14205,18468;22196;23402,36135,0,1,2,0,3
55191,120,14206,18546;19267;22334;22932;23630,36135,0,2,3,0,5
55192,120,14207,18853;18956,36135,0,0,2,0,2
55193,120,14211,18691;19599;22347;22480;23052;23428,36135,0,3,3,0,6
55194,120,14212,18954;19189;22034;22925,36135,0,1,3,0,4
55195,120,14213,18995;19732;22845;23537;23649;24199,36135,1,3,2,0,6
55196,120,14214,19024;19105;23409,36135,0,1,2,0,3
55197,120,14215,18990;19045;23197,36135,0,1,2,0,3
55198,120,14216,19005,36135,0,0,1,0,1
55199,120,14218,19062;19783;22739,36135,0,1,2,0,3
55200,120,14219,19154,36135,0,0,1,0,1
55201,120,14220,19155;19601,36135,0,0,2,0,2
55202,120,14221,18976;19212;22238;22575,36135,0,1,3,0,4
55203,120,14222,19106;19284;22232;22569,36135,0,1,3,0,4
55204,120,14223,19163;19346;22715;23517,36135,0,2,2,0,4
55205,120,14225,19255;19306;23206,36135,0,1,2,0,3
55206,120,14226,19197;19328;23208,36135,0,1,2,0,3
55207,120,14228,19185;19351;23037;23128;23518,36135,0,3,2,0,5
55208,120,14229,19058;19355,36135,0,0,2,0,2
55209,120,14230,19238;19369;22150;22463,36135,0,1,3,0,4
55210,120,14231,19641;22839,36135,0,1,1,0,2
55211,120,14232,19526;19860,36135,0,0,2,0,2
55212,120,14233,20047;20221;23077;23455,36135,0,2,2,0,4
55213,120,14234,19963;23244,36135,0,1,1,0,2
55214,120,14236,19803;22973;24092,36135,1,1,1,0,3
55215,120,14237,19707;19909,36135,0,0,2,0,2
55216,120,14238,19721;19793;23233;23862;23977;24090,36135,3,1,2,0,6
55217,120,14239,19076;19724;23062;23437;23536,36135,0,3,2,0,5
55218,120,14240,19737;19743;23064;23229,36135,0,2,2,0,4
55219,120,14241,19744,36135,0,0,1,0,1
55220,120,14242,20133;20332;22864;23255;24102,36135,1,2,2,0,5
55221,120,14243,19686;22734;23225,36135,0,2,1,0,3
55222,120,14244,19802,36135,0,0,1,0,1
55223,120,14245,19810;19950,36135,0,0,2,0,2
55224,120,14246,19813;20064,36135,0,0,2,0,2
55225,120,14247,19826;20036;23665,36135,0,1,2,0,3
55226,120,14248,19829;20364,36135,0,0,2,0,2
55227,120,14249,19987;22166;22623,36135,0,1,2,0,3
55228,120,14250,19781;20141;22980,36135,0,1,2,0,3
55229,120,14251,19852;20118;23253;24100,36135,1,1,2,0,4
55230,120,14253,19859;20102;23557;23768,36135,1,1,2,0,4
55231,120,14254,19662;19861;22743;23653,36135,0,2,2,0,4
55232,120,14255,19864;20195;23344,36135,0,1,2,0,3
55233,120,14256,19719;19880;22353;22736;22843,36135,0,2,3,0,5
55234,120,14257,19569;19886;23544;23979,36135,1,1,2,0,4
55235,120,14259,14825,36500,0,0,0,1,1
55236,120,14260,14876;15429,36500,0,0,0,2,2
55237,120,14262,14529,36500,0,0,0,1,1
55238,120,14263,15264,36500,0,0,0,1,1
55239,120,14269,15566,36500,0,0,0,1,1
55240,120,14270,16133,36500,0,0,0,1,1
55241,120,14278,17209;17913,36500,0,0,2,0,2
55242,120,14280,17640;17784,36500,0,0,2,0,2
55243,120,14284,18144;18629;22673,36500,0,1,2,0,3
55244,120,14285,18184,36500,0,0,1,0,1
55245,120,14289,18198;18946,36500,0,0,2,0,2
55246,120,14292,18275;18491;22393,36500,0,1,2,0,3
55247,120,14293,18219;22093;22892,36500,0,1,2,0,3
55248,120,14294,18596;18599,36500,0,0,2,0,2
55249,120,14296,18654;18931;22425,36500,0,1,2,0,3
55250,120,14297,18666;18977;22434;23301,36500,0,2,2,0,4
55251,120,14299,18493;18701,36500,0,0,2,0,2
55252,120,14300,19426;22043;23522,36500,0,1,2,0,3
55253,120,14301,18610;18909;22549,36500,0,1,2,0,3
55254,120,14302,18525;18828;22903,36500,0,1,2,0,3
55255,120,14304,18987;19381;23416,36500,0,1,2,0,3
55256,120,14305,19013;19645;22603;23055;23221,36500,0,3,2,0,5
55257,120,14306,19123;19488;22248;22598;23045,36500,0,2,3,0,5
55258,120,14307,19226;19273;22927;23413,36500,0,2,2,0,4
55259,120,14308,19077;19632;22838;23643,36500,0,2,2,0,4
55260,120,14309,18736;19142;23118,36500,0,1,2,0,3
55261,120,14310,19175;19448;22596;22724;23634,36500,0,3,2,0,5
55262,120,14311,19222;20010;23767,36500,1,0,2,0,3
55263,120,14312,19216;22331,36500,0,0,2,0,2
55264,120,14313,19291,36500,0,0,1,0,1
55265,120,14315,18851;19344;22038,36500,0,0,3,0,3
55266,120,14316,19365;19452;22948,36500,0,1,2,0,3
55267,120,14317,19168;19392;22717;23212;23521,36500,0,3,2,0,5
55268,120,14318,18856;19403;22947,36500,0,1,2,0,3
55269,120,14319,19037;19407;22594;23213,36500,0,2,2,0,4
55270,120,14320,19442;20179;23878;23993,36500,2,0,2,0,4
55271,120,14321,19257;19445;22723,36500,0,1,2,0,3
55272,120,14322,19451;19889;22974;23326;23656;23759;23865,36500,2,3,2,0,7
55273,120,14323,19457;23135;23635,36500,0,2,1,0,3
55274,120,14324,19562;19577,36500,0,0,2,0,2
55275,120,14325,19786;22740,36500,0,1,1,0,2
55276,120,14326,19518;19693;22049,36500,0,0,3,0,3
55277,120,14327,19187;19642;22840;22963,36500,0,2,2,0,4
55278,120,14328,19354;19631,36500,0,0,2,0,2
55279,120,14329,19643;19673;23433,36500,0,1,2,0,3
55280,120,14330,19124;19647;23529;23859,36500,1,1,2,0,4
55281,120,14331,19650;20129;23770,36500,1,0,2,0,3
55282,120,14332,19784;19807;23541,36500,0,1,2,0,3
55283,120,14333,19687;19874;22161;23434;23860,36500,1,1,3,0,5
55284,120,14334,20092;20306;23670;24099,36500,1,1,2,0,4
55285,120,14335,19740;19755;22354;22737;23149;23650;23752,36500,1,3,3,0,7
55286,120,14336,19747;19827;23441,36500,0,1,2,0,3
55287,120,14337,19363;19780;23754,36500,1,0,2,0,3
55288,120,14338,20142,36500,0,0,1,0,1
55289,120,14339,20260;22370;22632,36500,0,1,2,0,3
55290,120,14340,19828;20177,36500,0,0,2,0,2
55291,120,14341,19834;19853;23154;23323,36500,0,2,2,0,4
55292,120,14342,19805;19842;23153;23542,36500,0,2,2,0,4
55293,120,14343,20174;23992;24207,36500,2,0,1,0,3
55294,120,14344,19855;19990;23324;23864,36500,1,1,2,0,4
55295,120,14345,19422;19857,36500,0,0,2,0,2
55296,120,14346,19876;19894,36500,0,0,2,0,2
55297,120,14348,19819;19898;23322,36500,0,1,2,0,3
55298,120,14349,19746;19929;23660;23763,36500,1,1,2,0,4
55299,120,14350,19566;19945;22620,36500,0,1,2,0,3
55300,120,14351,19947;20283;24216,36500,1,0,2,0,3
55301,120,14352,19685;19958;22492;22622,36500,0,2,2,0,4
55302,120,14353,19960;20000;22750;23766;24203,36500,2,1,2,0,5
55303,120,14354,19816;19964;22487;23440;23756,36500,1,2,2,0,5
55304,120,14355,20249;20416;23260;23777,36500,1,1,2,0,4
55305,120,14356,19983;20109;23460;23769,36500,1,1,2,0,4
55306,120,14357,14405,36865,0,0,0,1,1
55307,120,14358,14732,36865,0,0,0,1,1
55308,120,14359,15601,36865,0,0,0,1,1
55309,120,14361,14772,36865,0,0,0,1,1
55310,120,14362,15541,36865,0,0,0,1,1
55311,120,14364,15335;15461,36865,0,0,0,2,2
55312,120,14367,15502;16296,36865,0,0,0,2,2
55313,120,14369,15860,36865,0,0,0,1,1
55314,120,14370,16018,36865,0,0,0,1,1
55315,120,14373,15629,36865,0,0,0,1,1
55316,120,14376,16569,36865,0,0,0,1,1
55317,120,14380,16929,36865,0,0,0,1,1
55318,120,14381,16880;17168,36865,0,0,1,1,2
55319,120,14382,17504;17770,36865,0,0,2,0,2
55320,120,14386,17264;17479,36865,0,0,2,0,2
55321,120,14390,17286,36865,0,0,1,0,1
55322,120,14393,17746;18359,36865,0,0,2,0,2
55323,120,14397,18326;18535,36865,0,0,2,0,2
55324,120,14398,18047,36865,0,0,1,0,1
55325,120,14402,18482,36865,0,0,1,0,1
55326,120,14403,18136;18264;22381;23102,36865,0,2,2,0,4
55327,120,14404,18290;18592,36865,0,0,2,0,2
55328,120,14405,18551;22396;22666,36865,0,2,1,0,3
55329,120,14406,18358;18474;22089,36865,0,0,3,0,3
55330,120,14407,18375;18882;23192,36865,0,1,2,0,3
55331,120,14410,18751,36865,0,0,1,0,1
55332,120,14411,18425;18978;22557,36865,0,1,2,0,3
55333,120,14412,18533;18608;21987;22306;22532,36865,0,1,4,0,5
55334,120,14414,18711;18717;23013,36865,0,1,2,0,3
55335,120,14415,18730;18997;22559;23511,36865,0,2,2,0,4
55336,120,14416,18831;19138,36865,0,0,2,0,2
55337,120,14417,18843;19318;22338,36865,0,0,3,0,3
55338,120,14419,18537;19127;22326,36865,0,0,3,0,3
55339,120,14420,19102;22806,36865,0,1,1,0,2
55340,120,14422,19395;22823;23040,36865,0,2,1,0,3
55341,120,14423,19182;19184;22033,36865,0,0,3,0,3
55342,120,14424,19202;19324,36865,0,0,2,0,2
55343,120,14425,18834;19308;22337;22584,36865,0,1,3,0,4
55344,120,14426,19337;22148,36865,0,0,2,0,2
55345,120,14427,19397;22614;23152,36865,0,2,1,0,3
55346,120,14428,18906;19376;22942,36865,0,1,2,0,3
55347,120,14429,19911;23547;23658,36865,0,2,1,0,3
55348,120,14430,19429;19765;22051;23753,36865,1,0,3,0,4
55349,120,14431,19156;19615;22159,36865,0,0,3,0,3
55350,120,14432,20152;23463,36865,0,1,1,0,2
55351,120,14433,19505;19517;22045;22476,36865,0,1,3,0,4
55352,120,14434,19565;19888;23444,36865,0,1,2,0,3
55353,120,14435,18972;19568;22046;22253;23050,36865,0,1,4,0,5
55354,120,14436,19598;19925;23328,36865,0,1,2,0,3
55355,120,14437,19611;19634;22481,36865,0,1,2,0,3
55356,120,14438,19549;19665;23219,36865,0,1,2,0,3
55357,120,14440,19606;19636;22348,36865,0,0,3,0,3
55358,120,14441,19535;19660;22604;23143,36865,0,2,2,0,4
55359,120,14442,19477;19672,36865,0,0,2,0,2
55360,120,14443,19506;19678;24198,36865,1,0,2,0,3
55361,120,14444,19702;19799;23532;23647,36865,0,2,2,0,4
55362,120,14445,19708;20098;23459,36865,0,1,2,0,3
55363,120,14446,19472;19709,36865,0,0,2,0,2
55364,120,14447,19777;19823,36865,0,0,2,0,2
55365,120,14449,19836;20103,36865,0,0,2,0,2
55366,120,14450,19841;20418,36865,0,0,2,0,2
55367,120,14451,19849;22164;23863,36865,1,0,2,0,3
55368,120,14452,19879;19955;23072;23159;23330;23449;23548,36865,0,5,2,0,7
55369,120,14453,20237;23351;23674;23776,36865,1,2,1,0,4
55370,120,14454,19639;19899;23760;24095,36865,2,0,2,0,4
55371,120,14455,19933;20292;23571,36865,0,1,2,0,3
55372,120,14456,19935;20380;23578;24224,36865,1,1,2,0,4
55373,120,14457,19962;20115;22755;23337,36865,0,2,2,0,4
55374,120,14458,20013;20111;22169,36865,0,0,3,0,3
55375,120,14459,19763;19978;22054;23662,36865,0,1,3,0,4
55376,120,14460,19986;23073,36865,0,1,1,0,2
55377,120,14461,19739;19994;22861;23160,36865,0,2,2,0,4
55378,120,14462,20006;20202;23162,36865,0,1,2,0,3
55379,120,14463,20022;20143;23664,36865,0,1,2,0,3
55380,120,14464,20030;20383;22637;22985;24112,36865,1,2,2,0,5
55381,120,14465,20046;20429,36865,0,0,2,0,2
55382,120,14469,14795,37230,0,0,0,1,1
55383,120,14470,15486,37230,0,0,0,1,1
55384,120,14472,15539,37230,0,0,0,1,1
55385,120,14473,14978,37230,0,0,0,1,1
55386,120,14474,15286,37230,0,0,0,1,1
55387,120,14475,15203,37230,0,0,0,1,1
55388,120,14476,15698,37230,0,0,0,1,1
55389,120,14477,15905,37230,0,0,0,1,1
55390,120,14480,16289;16385,37230,0,0,0,2,2
55391,120,14481,15563,37230,0,0,0,1,1
55392,120,14485,16957;16981,37230,0,0,0,2,2
55393,120,14486,17032;17373,37230,0,0,2,0,2
55394,120,14494,16902,37230,0,0,0,1,1
55395,120,14498,18011;18061,37230,0,0,2,0,2
55396,120,14499,17159,37230,0,0,1,0,1
55397,120,14502,18312;19194,37230,0,0,2,0,2
55398,120,14503,18702;19264;22580;22707,37230,0,2,2,0,4
55399,120,14504,18740;18839,37230,0,0,2,0,2
55400,120,14506,18819;18991;22913,37230,0,1,2,0,3
55401,120,14507,18887;19122;23629,37230,0,1,2,0,3
55402,120,14508,18752;18928,37230,0,0,2,0,2
55403,120,14509,19021;22436,37230,0,1,1,0,2
55404,120,14510,19103;19667;22349,37230,0,0,3,0,3
55405,120,14511,19313,37230,0,0,1,0,1
55406,120,14512,19151;19251;22452,37230,0,1,2,0,3
55407,120,14514,18941;19270;22335,37230,0,0,3,0,3
55408,120,14515,19368;19415,37230,0,0,2,0,2
55409,120,14516,19290;19465;22952;23418,37230,0,2,2,0,4
55410,120,14517,19480;19592;22471;23217;23855,37230,1,2,2,0,5
55411,120,14518,19485;19607;22597;22829;23312;23422,37230,0,4,2,0,6
55412,120,14519,19764;22846,37230,0,1,1,0,2
55413,120,14520,19525;19887,37230,0,0,2,0,2
55414,120,14521,19538;19608;22477;22957,37230,0,2,2,0,4
55415,120,14522,19402;19583;23527,37230,0,1,2,0,3
55416,120,14523,19593;19797;22052;22356;23234;24201,37230,1,1,4,0,6
55417,120,14524,19795;20148;22972;23978,37230,1,1,2,0,4
55418,120,14525,19227;19655;22255;22733;22964;23223,37230,0,3,3,0,6
55419,120,14526,19528;19591;23051,37230,0,1,2,0,3
55420,120,14527,19630;19691;22607;23972,37230,1,1,2,0,4
55421,120,14528,19705;20247;23999,37230,1,0,2,0,3
55422,120,14529,19729;19730;23975,37230,1,0,2,0,3
55423,120,14530,20058;20059;22977;23336;23873,37230,1,2,2,0,5
55424,120,14531,19772;19970;22363,37230,0,0,3,0,3
55425,120,14532,19779;23150,37230,0,1,1,0,2
55426,120,14533,20042;20189;22261;22624;23335,37230,0,2,3,0,5
55427,120,14534,19838;20135;22865;23340;23462;24103,37230,1,3,2,0,6
55428,120,14535,19481;19868;22489;22617,37230,0,2,2,0,4
55429,120,14536,19897;19904;23447,37230,0,1,2,0,3
55430,120,14537,20187;20482;23688,37230,0,1,2,0,3
55431,120,14538,19937;19995;23661;24097,37230,1,1,2,0,4
55432,120,14539,19459;19941,37230,0,0,2,0,2
55433,120,14540,19991;20126;23672,37230,0,1,2,0,3
55434,120,14541,20009;20479;23365;23482;24013,37230,1,2,2,0,5
55435,120,14542,20024;20213;23166;23347,37230,0,2,2,0,4
55436,120,14543,20028,37230,0,0,1,0,1
55437,120,14544,20039;20323;23785;23894,37230,2,0,2,0,4
55438,120,14545,20050;20365,37230,0,0,2,0,2
55439,120,14546,19954;20074;23164;23457,37230,0,2,2,0,4
55440,120,14547,20075;20222,37230,0,0,2,0,2
55441,120,14548,20018;20091;22367;23669;23988,37230,1,1,3,0,5
55442,120,14550,19679;20097;22978;23251,37230,0,2,2,0,4
55443,120,14551,19727;20112;23461,37230,0,1,2,0,3
55444,120,14552,20458;23089;23580,37230,0,2,1,0,3
55445,120,14553,20219;20316;23472,37230,0,1,2,0,3
55446,120,14554,20147;20261;22368,37230,0,0,3,0,3
55447,120,14555,19944;20154;22981;23771;24206,37230,2,1,2,0,5
55448,120,14556,20119,37230,0,0,1,0,1
55449,120,14557,14665,37595,0,0,0,1,1
55450,120,14558,15322,37595,0,0,0,1,1
55451,120,14559,15292,37595,0,0,0,1,1
55452,120,14560,15652,37595,0,0,0,1,1
55453,120,14562,15114,37595,0,0,0,1,1
55454,120,14564,15701,37595,0,0,0,1,1
55455,120,14565,16096,37595,0,0,0,1,1
55456,120,14566,15687,37595,0,0,0,1,1
55457,120,14570,16412;16448,37595,0,0,0,2,2
55458,120,14573,16590,37595,0,0,0,1,1
55459,120,14574,15653,37595,0,0,0,1,1
55460,120,14575,16696;16772,37595,0,0,0,2,2
55461,120,14576,16355;16739,37595,0,0,0,2,2
55462,120,14580,17021,37595,0,0,1,0,1
55463,120,14592,17895;18255;22380,37595,0,1,2,0,3
55464,120,14596,18305;18384,37595,0,0,2,0,2
55465,120,14597,18111;18412;22293;22522,37595,0,1,3,0,4
55466,120,14599,18673;19028;22789,37595,0,1,2,0,3
55467,120,14600,18636;19239,37595,0,0,2,0,2
55468,120,14602,18806;18833;22314;22685;23404,37595,0,2,3,0,5
55469,120,14604,18964;19640;22482;22732,37595,0,2,2,0,4
55470,120,14606,19095;19326,37595,0,0,2,0,2
55471,120,14607,18745;19111,37595,0,0,2,0,2
55472,120,14609,18950;19090;22694;22912,37595,0,2,2,0,4
55473,120,14610,19332;19428;23133;23214;23417;23523,37595,0,4,2,0,6
55474,120,14611,19706;19895,37595,0,0,2,0,2
55475,120,14612,19646;22483;22841,37595,0,2,1,0,3
55476,120,14613,19469;19988;23984,37595,1,0,2,0,3
55477,120,14614,19496,37595,0,0,1,0,1
55478,120,14615,19519;19767;22473;22613,37595,0,2,2,0,4
55479,120,14616,19750;20002;23161;23331;23453,37595,0,3,2,0,5
55480,120,14617,19200;19600;22836,37595,0,1,2,0,3
55481,120,14618,19623;19684;22256;22351;22606;22967;23646;23749,37595,1,3,4,0,8
55482,120,14619,19695;20099;23079;23252;23555,37595,0,3,2,0,5
55483,120,14620,19957;23243,37595,0,1,1,0,2
55484,120,14621,19544;19700;22608;24087,37595,1,1,2,0,4
55485,120,14622,19752;20173;23877,37595,1,0,2,0,3
55486,120,14623,19766;20194,37595,0,0,2,0,2
55487,120,14624,19770;19905;23327;23761;23866,37595,2,1,2,0,5
55488,120,14625,19999,37595,0,0,1,0,1
55489,120,14626,20359;22636;23476;23895,37595,1,2,1,0,4
55490,120,14627,20539;22642,37595,0,1,1,0,2
55491,120,14628,19081;22229;23028;23852,37595,1,1,2,0,4
55492,120,14629,19871;20149;22496;23559,37595,0,2,2,0,4
55493,120,14630,19923;19984;22749,37595,0,1,2,0,3
55494,120,14631,20071;20184;23773,37595,1,0,2,0,3
55495,120,14632,19806;19982,37595,0,0,2,0,2
55496,120,14633,20049;20347;22635;23265;23361,37595,0,3,2,0,5
55497,120,14634,19758;19936;22362;23241,37595,0,1,3,0,4
55498,120,14635,19942;22619;22857,37595,0,2,1,0,3
55499,120,14636,19882;19951;23242;24098,37595,1,1,2,0,4
55500,120,14637,19972,37595,0,0,1,0,1
55501,120,14638,19833;20167;23673,37595,0,1,2,0,3
55502,120,14639,20038;20628;22494;22976;23666,37595,0,3,2,0,5
55503,120,14640,20491;20557;23689;24014,37595,1,1,2,0,4
55504,120,14641,20084;20299,37595,0,0,2,0,2
55505,120,14645,20138;20288;22983;23263;23354;23470,37595,0,4,2,0,6
55506,120,14646,20255;23352;23562,37595,0,2,1,0,3
55507,120,14647,20550;23794;24017,37595,2,0,1,0,3
55508,120,14648,20191;23465,37595,0,1,1,0,2
55509,120,14649,19938;20176;22757;23256;23343;23560;24208,37595,1,4,2,0,7
55510,120,14650,20185;20227;22497,37595,0,1,2,0,3
55511,120,14651,20352;23266;24002,37595,1,1,1,0,3
55512,120,14652,20168;20212,37595,0,0,2,0,2
55513,120,14653,20239;23675;23997,37595,1,1,1,0,3
55514,120,14654,19839;20242;23882,37595,1,0,2,0,3
55515,120,14655,19975;20017;22259;22493;23163,37595,0,2,3,0,5
55516,120,14656,20272;20362;23782,37595,1,0,2,0,3
55517,120,14657,20279;20456,37595,0,0,2,0,2
55518,120,14658,20304;20428;22878,37595,0,1,2,0,3
55519,120,14659,14853,37960,0,0,0,1,1
55520,120,14660,15411,37960,0,0,0,1,1
55521,120,14662,15674,37960,0,0,0,1,1
55522,120,14663,14782,37960,0,0,0,1,1
55523,120,14664,15756,37960,0,0,0,1,1
55524,120,14666,15186,37960,0,0,0,1,1
55525,120,14667,15795,37960,0,0,0,1,1
55526,120,14668,16002,37960,0,0,0,1,1
55527,120,14670,16101;16314,37960,0,0,0,2,2
55528,120,14671,16153,37960,0,0,0,1,1
55529,120,14672,16085,37960,0,0,0,1,1
55530,120,14673,16237;16657,37960,0,0,0,2,2
55531,120,14677,16604,37960,0,0,0,1,1
55532,120,14678,16726,37960,0,0,0,1,1
55533,120,14682,16984,37960,0,0,0,1,1
55534,120,14687,16436,37960,0,0,0,1,1
55535,120,14689,16559,37960,0,0,0,1,1
55536,120,14695,17436;17716,37960,0,0,2,0,2
55537,120,14697,17486,37960,0,0,1,0,1
55538,120,14698,17694;18068,37960,0,0,2,0,2
55539,120,14700,17543;17931,37960,0,0,2,0,2
55540,120,14701,17740;17998,37960,0,0,2,0,2
55541,120,14703,17911;18045,37960,0,0,2,0,2
55542,120,14704,17545;18084;22283,37960,0,0,3,0,3
55543,120,14710,18154;18181,37960,0,0,2,0,2
55544,120,14711,18031;18302,37960,0,0,2,0,2
55545,120,14713,18907,37960,0,0,1,0,1
55546,120,14715,19007;19359;22462;23129;23308,37960,0,3,2,0,5
55547,120,14717,18862;18893,37960,0,0,2,0,2
55548,120,14718,18884;19497;22156;22249;23047;23137,37960,0,2,4,0,6
55549,120,14719,18372;18999;22322,37960,0,0,3,0,3
55550,120,14722,18755;19165;22447,37960,0,1,2,0,3
55551,120,14723,19683;22048;22350,37960,0,0,3,0,3
55552,120,14724,19534;19561,37960,0,0,2,0,2
55553,120,14725,18827;19423;22247;22340,37960,0,0,4,0,4
55554,120,14726,19169,37960,0,0,1,0,1
55555,120,14727,19674;23224,37960,0,1,1,0,2
55556,120,14730,19487;19863;23155;23758,37960,1,1,2,0,4
55557,120,14731,19490;19594;22254;22731;22961;23971,37960,1,2,3,0,6
55558,120,14732,18813;19034;22902,37960,0,1,2,0,3
55559,120,14734,19467;19903,37960,0,0,2,0,2
55560,120,14736,19613;19943;23071,37960,0,1,2,0,3
55561,120,14737,19653;19694;23222,37960,0,1,2,0,3
55562,120,14738,19676;19731;22611,37960,0,1,2,0,3
55563,120,14739,19586,37960,0,0,1,0,1
55564,120,14741,19513;19715;22485;23147;23534,37960,0,3,2,0,5
55565,120,14742,19436;19725;22486;22610;22844;23438;23750,37960,1,4,2,0,7
55566,120,14743,19989;22975;23451,37960,0,2,1,0,3
55567,120,14744,19883;20081;23250,37960,0,1,2,0,3
55568,120,14745,19570;19924;22360;22855,37960,0,1,3,0,4
55569,120,14746,19917;19928;22490;22618,37960,0,2,2,0,4
55570,120,14747,19885;19952;22747;23329,37960,0,2,2,0,4
55571,120,14748,20003;20621;23279,37960,0,1,2,0,3
55572,120,14749,20284;20349;22266;23787,37960,1,0,3,0,4
55573,120,14750,20020,37960,0,0,1,0,1
55574,120,14751,20029;23075;23333,37960,0,2,1,0,3
55575,120,14752,20085;20476,37960,0,0,2,0,2
55576,120,14753,20090;20404;24006,37960,1,0,2,0,3
55577,120,14754,20169;20681,37960,0,0,2,0,2
55578,120,14755,20190;20510;23485,37960,0,1,2,0,3
55579,120,14756,20057;23667,37960,0,1,1,0,2
55580,120,14757,20280;20423;23568,37960,0,1,2,0,3
55581,120,14759,20218;20297;23169;23356,37960,0,2,2,0,4
55582,120,14760,20308;20448;23687,37960,0,1,2,0,3
55583,120,14761,19946;20314;22633;23680,37960,0,2,2,0,4
55584,120,14762,20267;20320;23892,37960,1,0,2,0,3
55585,120,14763,20462;23270;24012,37960,1,1,1,0,3
55586,120,14764,20353;20431,37960,0,0,2,0,2
55587,120,14765,20368;20664;23697;23915,37960,1,1,2,0,4
55588,120,14766,20025;20386;24113;24225,37960,2,0,2,0,4
55589,120,14768,20294;20424;23579,37960,0,1,2,0,3
55590,120,14769,15485,38325,0,0,0,1,1
55591,120,14770,15565,38325,0,0,0,1,1
55592,120,14773,16348;16578,38325,0,0,0,2,2
55593,120,14774,16475;17220,38325,0,0,1,1,2
55594,120,14776,16925,38325,0,0,0,1,1
55595,120,14777,16423;16501,38325,0,0,0,2,2
55596,120,14779,16704,38325,0,0,0,1,1
55597,120,14781,17216,38325,0,0,1,0,1
55598,120,14784,17772;18059,38325,0,0,2,0,2
55599,120,14787,17699;17966,38325,0,0,2,0,2
55600,120,14793,17879;18373,38325,0,0,2,0,2
55601,120,14795,17847;18304;22520,38325,0,1,2,0,3
55602,120,14802,17890;18385,38325,0,0,2,0,2
55603,120,14803,18438;18462,38325,0,0,2,0,2
55604,120,14804,17969;18115,38325,0,0,2,0,2
55605,120,14808,18173;18689;22539,38325,0,1,2,0,3
55606,120,14813,18900;19371,38325,0,0,2,0,2
55607,120,14815,19110;19253,38325,0,0,2,0,2
55608,120,14816,19248;19710;23973,38325,1,0,2,0,3
55609,120,14819,19419;19620;23142;23642,38325,0,2,2,0,4
55610,120,14820,19274;19373;22821,38325,0,1,2,0,3
55611,120,14823,19690;19858,38325,0,0,2,0,2
55612,120,14825,19262;19433;22720;23966,38325,1,1,2,0,4
55613,120,14826,19159;19468;23311,38325,0,1,2,0,3
55614,120,14827,19524;19815;23236;23755,38325,1,1,2,0,4
55615,120,14828,19540;23139,38325,0,1,1,0,2
55616,120,14829,19998,38325,0,0,1,0,1
55617,120,14830,19625;19900;22357;22851;23657,38325,0,2,3,0,5
55618,120,14831,19677;20286;23570,38325,0,1,2,0,3
55619,120,14832,19688;19717,38325,0,0,2,0,2
55620,120,14833,19418,38325,0,0,1,0,1
55621,120,14834,19814;20203;23082;23346;23466,38325,0,3,2,0,5
55622,120,14835,19656;19818;22257,38325,0,0,3,0,3
55623,120,14836,19821;20502,38325,0,0,2,0,2
55624,120,14837,19916;20503,38325,0,0,2,0,2
55625,120,14838,19932;22361;22856,38325,0,1,2,0,3
55626,120,14842,20048,38325,0,0,1,0,1
55627,120,14843,20170;23772;23991,38325,2,0,1,0,3
55628,120,14844,19956;20069;23668,38325,0,1,2,0,3
55629,120,14845,20086;20555;22883;23692,38325,0,2,2,0,4
55630,120,14846,20096;22627;23554,38325,0,2,1,0,3
55631,120,14847,19638;20110;23989,38325,1,0,2,0,3
55632,120,14848,20159;20161;22867,38325,0,1,2,0,3
55633,120,14849,20094;20165,38325,0,0,2,0,2
55634,120,14850,20178;20390,38325,0,0,2,0,2
55635,120,14851,20198;20376;23172,38325,0,1,2,0,3
55636,120,14852,20210;20419;22763;23269;23686;24007,38325,1,3,2,0,6
55637,120,14854,20197;20232;23348,38325,0,1,2,0,3
55638,120,14855,20200;20289;23471;23783,38325,1,1,2,0,4
55639,120,14856,19820;20295;23572;23678,38325,0,2,2,0,4
55640,120,14857,19927;20307;23679;23890,38325,1,1,2,0,4
55641,120,14858,20330;20911;23819,38325,1,0,2,0,3
55642,120,14859,20685;22501;23494;24131;24241,38325,2,2,1,0,5
55643,120,14860,20343,38325,0,0,1,0,1
55644,120,14861,20350;20713,38325,0,0,2,0,2
55645,120,14862,20425;24008,38325,1,0,1,0,2
55646,120,14863,20384;22875;23898,38325,1,1,1,0,3
55647,120,14864,20393;20579,38325,0,0,2,0,2
55648,120,14865,20063;20397;23478;23685,38325,0,2,2,0,4
55649,120,14866,20402;20793;24246,38325,1,0,2,0,3
55650,120,14867,20407;20668;23479,38325,0,1,2,0,3
55651,120,14868,20718;24132,38325,1,0,1,0,2
55652,120,14869,20224;20484;23366,38325,0,1,2,0,3
55653,120,14870,20909;21000;24154;24256,38325,2,0,2,0,4
55654,120,14871,20430;20497;24015;24229,38325,2,0,2,0,4
55655,120,14872,20499;20820;23291;23815,38325,1,1,2,0,4
55656,120,14873,20649;20650;24239,38325,1,0,2,0,3
55657,120,14874,19831;20505;23791,38325,1,0,2,0,3
55658,120,14876,20792;23813;23922,38325,2,0,1,0,3
55659,120,14877,20564;20640;23798,38325,1,0,2,0,3
55660,120,14878,20469;20528,38325,0,0,2,0,2
55661,120,14880,15856,38690,0,0,0,1,1
55662,120,14882,15341,38690,0,0,0,1,1
55663,120,14885,16777,38690,0,0,0,1,1
55664,120,14886,15600,38690,0,0,0,1,1
55665,120,14887,15993,38690,0,0,0,1,1
55666,120,14888,16785;17627,38690,0,0,1,1,2
55667,120,14889,16434,38690,0,0,0,1,1
55668,120,14890,16046,38690,0,0,0,1,1
55669,120,14891,15743,38690,0,0,0,1,1
55670,120,14896,16691,38690,0,0,0,1,1
55671,120,14902,17426;18035;22279;22377;22886;22997,38690,0,3,3,0,6
55672,120,14905,17083,38690,0,0,1,0,1
55673,120,14906,17578;17791,38690,0,0,2,0,2
55674,120,14907,17589;17964;22277,38690,0,0,3,0,3
55675,120,14913,17844;18140;21952,38690,0,0,3,0,3
55676,120,14914,17786;17860;22275,38690,0,0,3,0,3
55677,120,14915,17556,38690,0,0,1,0,1
55678,120,14916,17990,38690,0,0,1,0,1
55679,120,14920,18527;19235;22706;23304,38690,0,2,2,0,4
55680,120,14921,18994;22126,38690,0,0,2,0,2
55681,120,14923,19404;19582;22346,38690,0,0,3,0,3
55682,120,14924,18720;19372,38690,0,0,2,0,2
55683,120,14925,18643;23009,38690,0,1,1,0,2
55684,120,14926,18719;18829;22316,38690,0,0,3,0,3
55685,120,14928,18932;22220;23110;23627,38690,0,2,2,0,4
55686,120,14931,18918;19012;22915,38690,0,1,2,0,3
55687,120,14932,19174;19223,38690,0,0,2,0,2
55688,120,14933,19241;19670;23432,38690,0,1,2,0,3
55689,120,14935,19199;19742;23539;24200,38690,1,1,2,0,4
55690,120,14936,19379,38690,0,0,1,0,1
55691,120,14938,19425;19953;22858;23765,38690,1,1,2,0,4
55692,120,14939,19434;19722;23060;23535,38690,0,2,2,0,4
55693,120,14940,19447;19563;22252,38690,0,0,3,0,3
55694,120,14941,19085;19536;23048,38690,0,1,2,0,3
55695,120,14942,19817;19921;23238,38690,0,1,2,0,3
55696,120,14943,19621;20067;23553;23874,38690,1,1,2,0,4
55697,120,14945,19728;20199;23345,38690,0,1,2,0,3
55698,120,14946,19507;19628;23528;23857,38690,1,1,2,0,4
55699,120,14947,20055;22626;23078,38690,0,2,1,0,3
55700,120,14948,19788;19915;22163,38690,0,0,3,0,3
55701,120,14949,19869;23156;23325;23442,38690,0,3,1,0,4
55702,120,14950,20196;20214;23467;23774;24209,38690,2,1,2,0,5
55703,120,14951,19847;20051,38690,0,0,2,0,2
55704,120,14952,19867;23654,38690,0,1,1,0,2
55705,120,14953,19413,38690,0,0,1,0,1
55706,120,14954,20245;20493;23883;23998;24211,38690,3,0,2,0,5
55707,120,14955,19961;19981,38690,0,0,2,0,2
55708,120,14956,19959;20034,38690,0,0,2,0,2
55709,120,14957,19756;20040;23985,38690,1,0,2,0,3
55710,120,14958,19992;20121;23671;23876,38690,1,1,2,0,4
55711,120,14959,20128;20413;22877;23268;23899,38690,1,2,2,0,5
55712,120,14960,20130;20394;22639;23364;24114,38690,1,2,2,0,5
55713,120,14961,19439;20134;22628;23080;23339,38690,0,3,2,0,5
55714,120,14962,19704;20145;23146;23321;23648;24088,38690,1,3,2,0,6
55715,120,14963,20474;23902,38690,1,0,1,0,2
55716,120,14964,19840;20181;24105,38690,1,0,2,0,3
55717,120,14965,20204;20720;23376,38690,0,1,2,0,3
55718,120,14966,20235;20290;22631;23259;23469;23775,38690,1,3,2,0,6
55719,120,14967,20246;20536;22769;23583;23908,38690,1,2,2,0,5
55720,120,14968,20373;23362;24004,38690,1,1,1,0,3
55721,120,14969,20014;20275;22498;23085;23567;24107,38690,1,3,2,0,6
55722,120,14970,19918;20300;23357;23573;23887,38690,1,2,2,0,5
55723,120,14971,20231;20379,38690,0,0,2,0,2
55724,120,14972,20333;20399;22873;22984;24220,38690,1,2,2,0,5
55725,120,14973,20346;20595;22885;24235,38690,1,1,2,0,4
55726,120,14974,20672;24240,38690,1,0,1,0,2
55727,120,14976,20420;20651,38690,0,0,2,0,2
55728,120,14977,20021;20412;22986;23267,38690,0,2,2,0,4
55729,120,14978,20162;20442;24117,38690,1,0,2,0,3
55730,120,14979,20449;20802,38690,0,0,2,0,2
55731,120,14980,20451;20940;24254,38690,1,0,2,0,3
55732,120,14981,20403;20486;22876;24226,38690,1,1,2,0,4
55733,120,14982,20488;20569;23371,38690,0,1,2,0,3
55734,120,14983,20490;20605,38690,0,0,2,0,2
55735,120,14984,20053;20378;23897;24005,38690,2,0,2,0,4
55736,120,14985,20415;20495;23484;23690,38690,0,2,2,0,4
55737,120,14986,20525;20527;22881,38690,0,1,2,0,3
55738,120,14987,20540;20570;23588;24019,38690,1,1,2,0,4
55739,120,14988,20553;20559;23369;23693;24018,38690,1,2,2,0,5
55740,120,14989,20511;20576,38690,0,0,2,0,2
55741,120,14990,20587;20863,38690,0,0,2,0,2
55742,120,14991,20624;20627;23373,38690,0,1,2,0,3
55743,120,14992,15752,39055,0,0,0,1,1
55744,120,14993,15702,39055,0,0,0,1,1
55745,120,14994,15878,39055,0,0,0,1,1
55746,120,14995,15899,39055,0,0,0,1,1
55747,120,14996,15603,39055,0,0,0,1,1
55748,120,14997,16023,39055,0,0,0,1,1
55749,120,14998,16143,39055,0,0,0,1,1
55750,120,14999,16367,39055,0,0,0,1,1
55751,120,15000,16009,39055,0,0,0,1,1
55752,120,15001,16806,39055,0,0,0,1,1
55753,120,15002,15889,39055,0,0,0,1,1
55754,120,15004,16594;16893,39055,0,0,0,2,2
55755,120,15005,15914,39055,0,0,0,1,1
55756,120,15017,17933,39055,0,0,1,0,1
55757,120,15020,17921,39055,0,0,1,0,1
55758,120,15021,17989,39055,0,0,1,0,1
55759,120,15022,18287;19170,39055,0,0,2,0,2
55760,120,15026,18623;18915;23405,39055,0,1,2,0,3
55761,120,15027,18550;19061;22026;22228;22699;22919,39055,0,2,4,0,6
55762,120,15029,18812;19330;22819,39055,0,1,2,0,3
55763,120,15030,18726,39055,0,0,1,0,1
55764,120,15033,18536;18650,39055,0,0,2,0,2
55765,120,15034,18979;22914,39055,0,1,1,0,2
55766,120,15035,19272;19463;22951;24086,39055,1,1,2,0,4
55767,120,15038,19087;19231;22239;22576;23120,39055,0,2,3,0,5
55768,120,15041,18947;19618,39055,0,0,2,0,2
55769,120,15042,19352;19559;23640,39055,0,1,2,0,3
55770,120,15043,19414;19614;23430,39055,0,1,2,0,3
55771,120,15044,19456,39055,0,0,1,0,1
55772,120,15047,19689;19856,39055,0,0,2,0,2
55773,120,15048,18981;19581,39055,0,0,2,0,2
55774,120,15049,19214;19723;23061;23974,39055,1,1,2,0,4
55775,120,15051,19808;20144;22756;22866,39055,0,2,2,0,4
55776,120,15052,19830;19846;22850;23068,39055,0,2,2,0,4
55777,120,15053,20087;20268;22264;23565;23779,39055,1,1,3,0,5
55778,120,15056,19754;19931;23764;23981,39055,2,0,2,0,4
55779,120,15057,19510;19648;22954;23969,39055,1,1,2,0,4
55780,120,15058,20498;23904;24118,39055,2,0,1,0,3
55781,120,15059,20008;20088;22258;23332;23454;23663,39055,0,3,3,0,6
55782,120,15060,20011;20298;22365;22751,39055,0,1,3,0,4
55783,120,15061,20043,39055,0,0,1,0,1
55784,120,15062,20073;20688,39055,0,0,2,0,2
55785,120,15063,20680;20708;23283,39055,0,1,2,0,3
55786,120,15064,20114;20344;23474,39055,0,1,2,0,3
55787,120,15065,20113;20120,39055,0,0,2,0,2
55788,120,15066,20157;20642;24237,39055,1,0,2,0,3
55789,120,15067,20166;20766;22645;23811;23921,39055,2,1,2,0,5
55790,120,15068,20220;20535;23489;23582,39055,0,2,2,0,4
55791,120,15069,20259;20606;23277,39055,0,1,2,0,3
55792,120,15070,20730;20803;22990;23284,39055,0,2,2,0,4
55793,120,15071,20265;20585;23589;24234,39055,1,1,2,0,4
55794,120,15072,20281;20809;23290,39055,0,1,2,0,3
55795,120,15073,20240;20291,39055,0,0,2,0,2
55796,120,15074,20296,39055,0,0,1,0,1
55797,120,15076,20434;20548;23177,39055,0,1,2,0,3
55798,120,15077,20201;20435,39055,0,0,2,0,2
55799,120,15078,20156;20443,39055,0,0,2,0,2
55800,120,15079,20100;20455;22640;22764,39055,0,2,2,0,4
55801,120,15080,20461;20538;23368;24231,39055,1,1,2,0,4
55802,120,15081,20463;20890,39055,0,0,2,0,2
55803,120,15082,20150;20375;24223,39055,1,0,2,0,3
55804,120,15083,20172,39055,0,0,1,0,1
55805,120,15084,20652;20932;23820,39055,1,0,2,0,3
55806,120,15085,20869;23383,39055,0,1,1,0,2
55807,120,15086,20825;20949,39055,0,0,2,0,2
55808,120,15087,20530,39055,0,0,1,0,1
55809,120,15089,20252;20547;23586,39055,0,1,2,0,3
55810,120,15090,20317;20552;23490;23796,39055,1,1,2,0,4
55811,120,15091,20340;20574;23274;24021,39055,1,1,2,0,4
55812,120,15092,20580;21048;24051,39055,1,0,2,0,3
55813,120,15093,20598;24023,39055,1,0,1,0,2
55814,120,15094,20568;20626;23695;24126,39055,1,1,2,0,4
55815,120,15095,20636;23805,39055,1,0,1,0,2
55816,120,15096,20473;20653,39055,0,0,2,0,2
55817,120,15097,20661;20717;23809;24030,39055,2,0,2,0,4
55818,120,15098,20634;20692;23280,39055,0,1,2,0,3
55819,120,15099,20924;23184;24148,39055,1,1,1,0,3
55820,120,15100,20638;20746;23918,39055,1,0,2,0,3
55821,120,15102,16013,39420,0,0,0,1,1
55822,120,15104,16155,39420,0,0,0,1,1
55823,120,15105,16519,39420,0,0,0,1,1
55824,120,15106,16822,39420,0,0,0,1,1
55825,120,15107,16712;17240,39420,0,0,1,1,2
55826,120,15111,16205;16618,39420,0,0,0,2,2
55827,120,15116,17414,39420,0,0,1,0,1
55828,120,15123,17593,39420,0,0,1,0,1
55829,120,15124,17947,39420,0,0,1,0,1
55830,120,15133,18291;18488,39420,0,0,2,0,2
55831,120,15135,18404;18682,39420,0,0,2,0,2
55832,120,15136,18518;18588;23007,39420,0,1,2,0,3
55833,120,15137,19474;19502;22953;23419,39420,0,2,2,0,4
55834,120,15141,19188,39420,0,0,1,0,1
55835,120,15142,19026;19042,39420,0,0,2,0,2
55836,120,15144,19208;20193;23257,39420,0,1,2,0,3
55837,120,15145,19242;19714;23058;23227;23533,39420,0,3,2,0,5
55838,120,15147,19205;19292;22237,39420,0,0,3,0,3
55839,120,15149,19464;19537;22599;22730;22956,39420,0,3,2,0,5
55840,120,15150,19651,39420,0,0,1,0,1
55841,120,15151,19713;20035;23076;23247;23551,39420,0,3,2,0,5
55842,120,15152,19637,39420,0,0,1,0,1
55843,120,15154,19801;20369;24003;24222,39420,2,0,2,0,4
55844,120,15155,19845;20101;23556;24204,39420,1,1,2,0,4
55845,120,15156,19460;19877,39420,0,0,2,0,2
55846,120,15157,20033,39420,0,0,1,0,1
55847,120,15158,19968,39420,0,0,1,0,1
55848,120,15159,20083;20643,39420,0,0,2,0,2
55849,120,15160,20123;20206;23165;23254;23338;24205,39420,1,3,2,0,6
55850,120,15161,20125;20155,39420,0,0,2,0,2
55851,120,15162,20180;20556;23909,39420,1,0,2,0,3
55852,120,15164,20879;20935,39420,0,0,2,0,2
55853,120,15165,19997;20354;23576,39420,0,1,2,0,3
55854,120,15168,20093;20363,39420,0,0,2,0,2
55855,120,15169,20392;20635;23696;23804;24025;24127;24236,39420,4,1,2,0,7
55856,120,15170,20405;20472;23481,39420,0,1,2,0,3
55857,120,15171,20438;20777;24032,39420,1,0,2,0,3
55858,120,15172,20441;20756;23601;23704,39420,0,2,2,0,4
55859,120,15173,20459,39420,0,0,1,0,1
55860,120,15174,20471;21044,39420,0,0,2,0,2
55861,120,15175,20513;21163;23941,39420,1,0,2,0,3
55862,120,15176,20524;20592;22643;23800;23912,39420,2,1,2,0,5
55863,120,15177,20216;20537;22882;23793,39420,1,1,2,0,4
55864,120,15178,20549;24120;24232,39420,2,0,1,0,3
55865,120,15179,20565;20861;24042,39420,1,0,2,0,3
55866,120,15180,20567;20781;24136,39420,1,0,2,0,3
55867,120,15181,20583;20753;23492;23694,39420,0,2,2,0,4
55868,120,15182,20622;21100;23185;24056,39420,1,1,2,0,4
55869,120,15183,20632;20931;24252,39420,1,0,2,0,3
55870,120,15184,20266;20641;23806,39420,1,0,2,0,3
55871,120,15185,20817;21143,39420,0,0,2,0,2
55872,120,15186,20658;20859;23499;23715;24041,39420,1,2,2,0,5
55873,120,15187,20659;23594;24129,39420,1,1,1,0,3
55874,120,15188,20645;20660,39420,0,0,2,0,2
55875,120,15189,20182;20690;23374;23495;23699;24028,39420,1,3,2,0,6
55876,120,15190,21020,39420,0,0,1,0,1
55877,120,15191,20743;20956;23388;23933,39420,1,1,2,0,4
55878,120,15192,20225;20751;23919,39420,1,0,2,0,3
55879,120,15193,20516;20769;23181,39420,0,1,2,0,3
55880,120,15194,20785;20984,39420,0,0,2,0,2
55881,120,15195,20808;20971;24149,39420,1,0,2,0,3
55882,120,15196,20810,39420,0,0,1,0,1
55883,120,15197,20827;20948;23712,39420,0,1,2,0,3
55884,120,15198,20833;21050;23714,39420,0,1,2,0,3
55885,120,15199,20843;20892;23928,39420,1,0,2,0,3
55886,120,15200,15803,39785,0,0,0,1,1
55887,120,15202,16266;16379,39785,0,0,0,2,2
55888,120,15204,16370,39785,0,0,0,1,1
55889,120,15205,16374;16709,39785,0,0,0,2,2
55890,120,15206,16491;16797,39785,0,0,0,2,2
55891,120,15208,16524,39785,0,0,0,1,1
55892,120,15209,16638,39785,0,0,0,1,1
55893,120,15213,17078,39785,0,0,1,0,1
55894,120,15215,16882,39785,0,0,0,1,1
55895,120,15221,17138;17297,39785,0,0,2,0,2
55896,120,15223,17063,39785,0,0,1,0,1
55897,120,15226,16804,39785,0,0,0,1,1
55898,120,15227,17686,39785,0,0,1,0,1
55899,120,15230,17987,39785,0,0,1,0,1
55900,120,15231,17799,39785,0,0,1,0,1
55901,120,15232,17973,39785,0,0,1,0,1
55902,120,15235,19050;22132,39785,0,0,2,0,2
55903,120,15236,18322,39785,0,0,1,0,1
55904,120,15243,18657;19394;23132,39785,0,1,2,0,3
55905,120,15247,19523;23314,39785,0,1,1,0,2
55906,120,15248,19692;20160,39785,0,0,2,0,2
55907,120,15249,19701;19760;23435,39785,0,1,2,0,3
55908,120,15250,20062;22495,39785,0,1,1,0,2
55909,120,15251,19870;20209;22369;22868,39785,0,1,3,0,4
55910,120,15252,19940;20226;22629;22869;23468,39785,0,3,2,0,5
55911,120,15253,19976;23549,39785,0,1,1,0,2
55912,120,15255,20044;20361;23248;23552;23871,39785,1,2,2,0,5
55913,120,15256,20065;20171;23342,39785,0,1,2,0,3
55914,120,15257,20072;20188;22366;23987,39785,1,0,3,0,4
55915,120,15258,20104;20321;23170;23360;23574;23784;23893,39785,2,3,2,0,7
55916,120,15259,20163;20426;23088;24009,39785,1,1,2,0,4
55917,120,15260,20542;20745;23100,39785,0,1,2,0,3
55918,120,15261,20230;20301;23358;23888,39785,1,1,2,0,4
55919,120,15262,20234;22263;23083,39785,0,1,2,0,3
55920,120,15263,20591;23275;24022,39785,1,1,1,0,3
55921,120,15264,19769;20264;23564;23676,39785,0,2,2,0,4
55922,120,15265,20302;20389;22371,39785,0,0,3,0,3
55923,120,15266,20324;20551;23587;23691;23795,39785,1,2,2,0,5
55924,120,15267,20329;20737,39785,0,0,2,0,2
55925,120,15268,20334;20358,39785,0,0,2,0,2
55926,120,15269,20345;23475;23682;24001,39785,1,2,1,0,4
55927,120,15270,20357;23577;23788,39785,1,1,1,0,3
55928,120,15271,20400,39785,0,0,1,0,1
55929,120,15272,20377;20526;22767,39785,0,1,2,0,3
55930,120,15273,20153;20427;23173;23900;24227,39785,2,1,2,0,5
55931,120,15274,20445;20506;22879;23905;24230,39785,2,1,2,0,5
55932,120,15275,20512;20515;23486;23792,39785,1,1,2,0,4
55933,120,15276,20822;23382;23711,39785,0,2,1,0,3
55934,120,15277,20269;20563;23273,39785,0,1,2,0,3
55935,120,15278,20566;20899,39785,0,0,2,0,2
55936,120,15279,20590;20963,39785,0,0,2,0,2
55937,120,15280,21204;21266;23612,39785,0,1,2,0,3
55938,120,15281,20619;21055;23393,39785,0,1,2,0,3
55939,120,15282,20739,39785,0,0,1,0,1
55940,120,15283,20644;20677,39785,0,0,2,0,2
55941,120,15284,20691;20778,39785,0,0,2,0,2
55942,120,15285,20694;20857;23596,39785,0,1,2,0,3
55943,120,15286,20466,39785,0,0,1,0,1
55944,120,15287,20385;20714;23375,39785,0,1,2,0,3
55945,120,15288,20715;21036,39785,0,0,2,0,2
55946,120,15289,20724;20976;23823,39785,1,0,2,0,3
55947,120,15290,20731;20962;24133,39785,1,0,2,0,3
55948,120,15291,20735,39785,0,0,1,0,1
55949,120,15292,20748;20964,39785,0,0,2,0,2
55950,120,15293,20577;20762;23179;23379,39785,0,2,2,0,4
55951,120,15294,20763;23101;23705;24031,39785,1,2,1,0,4
55952,120,15295,20773;20945;24135,39785,1,0,2,0,3
55953,120,15296,20783,39785,0,0,1,0,1
55954,120,15297,20844;21058,39785,0,0,2,0,2
55955,120,15298,20847;20939,39785,0,0,2,0,2
55956,120,15299,20853;21072,39785,0,0,2,0,2
55957,120,15300,20868;21171,39785,0,0,2,0,2
55958,120,15301,20770;20871;24043,39785,1,0,2,0,3
55959,120,15302,20893;21124;23719;24057,39785,1,1,2,0,4
55960,120,15303,20918;21052;23392,39785,0,1,2,0,3
55961,120,15304,20923,39785,0,0,1,0,1
55962,120,15306,21096;23395;23610;24160,39785,1,2,1,0,4
55963,120,15307,21038;23827,39785,1,0,1,0,2
55964,120,15308,16015,40150,0,0,0,1,1
55965,120,15310,16502;17150,40150,0,0,1,1,2
55966,120,15314,16649,40150,0,0,0,1,1
55967,120,15315,15954,40150,0,0,0,1,1
55968,120,15316,16713,40150,0,0,0,1,1
55969,120,15318,16908,40150,0,0,0,1,1
55970,120,15320,16914;17633,40150,0,0,1,1,2
55971,120,15322,17067;17261,40150,0,0,2,0,2
55972,120,15326,17584;17612,40150,0,0,2,0,2
55973,120,15328,17443,40150,0,0,1,0,1
55974,120,15332,18069;18633,40150,0,0,2,0,2
55975,120,15336,18618;19152;22923,40150,0,1,2,0,3
55976,120,15341,18846;19348;22590;22941;23743,40150,1,2,2,0,5
55977,120,15342,18601,40150,0,0,1,0,1
55978,120,15344,19054;19113;22441,40150,0,1,2,0,3
55979,120,15347,19378;19458,40150,0,0,2,0,2
55980,120,15349,19424,40150,0,0,1,0,1
55981,120,15351,19441,40150,0,0,1,0,1
55982,120,15354,19865;19890;22744;23445;24094,40150,1,2,2,0,5
55983,120,15355,19866,40150,0,0,1,0,1
55984,120,15356,20001;20600,40150,0,0,2,0,2
55985,120,15357,19588;20175;23081,40150,0,1,2,0,3
55986,120,15358,20016;20251;22758;24106,40150,1,1,2,0,4
55987,120,15360,19792;20061;22754,40150,0,1,2,0,3
55988,120,15361,20077;20374;23087;23790,40150,1,1,2,0,4
55989,120,15363,19902;20131;22979;23990,40150,1,1,2,0,4
55990,120,15364,19825;20410,40150,0,0,2,0,2
55991,120,15365,20478;22759;23261;23563;23778,40150,1,3,1,0,5
55992,120,15366,20319;20335;22760;23681,40150,0,2,2,0,4
55993,120,15367,20337;20520;23906,40150,1,0,2,0,3
55994,120,15369,20408;20927,40150,0,0,2,0,2
55995,120,15370,20421;20696;23597,40150,0,1,2,0,3
55996,120,15371,20432,40150,0,0,1,0,1
55997,120,15372,20439;20594;23901;24116,40150,2,0,2,0,4
55998,120,15373,20440;20485;22499;22987;23174;23367,40150,0,4,2,0,6
55999,120,15374,20492;23091;24228,40150,1,1,1,0,3
56000,120,15375,20005,40150,0,0,1,0,1
56001,120,15376,20508;20811,40150,0,0,2,0,2
56002,120,15377,20630,40150,0,0,1,0,1
56003,120,15378,20483;20504,40150,0,0,2,0,2
56004,120,15379,20667;20998;24153,40150,1,0,2,0,3
56005,120,15380,20875,40150,0,0,1,0,1
56006,120,15381,20959;24255,40150,1,0,1,0,2
56007,120,15382,20341;20754;23920,40150,1,0,2,0,3
56008,120,15383,20782;21281,40150,0,0,2,0,2
56009,120,15384,21284;23949,40150,1,0,1,0,2
56010,120,15385,20816;20882;23710;24038,40150,1,1,2,0,4
56011,120,15386,20828;21022,40150,0,0,2,0,2
56012,120,15387,20837,40150,0,0,1,0,1
56013,120,15388,20854;20966;23389;23934;24049,40150,2,1,2,0,5
56014,120,15389,20856;21154,40150,0,0,2,0,2
56015,120,15390,20866;21196;23721;23943,40150,1,1,2,0,4
56016,120,15392,20883;20985,40150,0,0,2,0,2
56017,120,15393,20895;21198,40150,0,0,2,0,2
56018,120,15394,20926;20943;23386,40150,0,1,2,0,3
56019,120,15395,20682;20929;23387,40150,0,1,2,0,3
56020,120,15396,21338,40150,0,0,1,0,1
56021,120,15397,21103,40150,0,0,1,0,1
56022,120,15398,20977;21181;23390,40150,0,1,2,0,3
56023,120,15399,20987;21238,40150,0,0,2,0,2
56024,120,15400,20970;21011;24050,40150,1,0,2,0,3
56025,120,15401,21012;23295,40150,0,1,1,0,2
56026,120,15402,16521;16752,40515,0,0,0,2,2
56027,120,15404,16331;16814,40515,0,0,0,2,2
56028,120,15405,17113,40515,0,0,1,0,1
56029,120,15407,17170,40515,0,0,1,0,1
56030,120,15408,16755,40515,0,0,0,1,1
56031,120,15412,17446,40515,0,0,1,0,1
56032,120,15416,17978,40515,0,0,1,0,1
56033,120,15417,18077;18816;22013,40515,0,0,3,0,3
56034,120,15420,18005,40515,0,0,1,0,1
56035,120,15425,18660,40515,0,0,1,0,1
56036,120,15426,18685;19164;22810,40515,0,1,2,0,3
56037,120,15427,18773;19340;23126,40515,0,1,2,0,3
56038,120,15429,19179,40515,0,0,1,0,1
56039,120,15432,19520,40515,0,0,1,0,1
56040,120,15435,19307;19778;22848,40515,0,1,2,0,3
56041,120,15436,19762;20070;22168;23875,40515,1,0,3,0,4
56042,120,15437,19720,40515,0,0,1,0,1
56043,120,15438,19796;19811;22741,40515,0,1,2,0,3
56044,120,15439,19584;19812;22742;23235,40515,0,2,2,0,4
56045,120,15440,19862;20137,40515,0,0,2,0,2
56046,120,15443,19893;20127;23558;24101,40515,1,1,2,0,4
56047,120,15444,19597,40515,0,0,1,0,1
56048,120,15445,19896;20611,40515,0,0,2,0,2
56049,120,15446,19967;20311;23891,40515,1,0,2,0,3
56050,120,15447,20078;20095,40515,0,0,2,0,2
56051,120,15448,20327;20814;23709;23923;24140,40515,2,1,2,0,5
56052,120,15449,20124;20208;22863,40515,0,1,2,0,3
56053,120,15451,20370,40515,0,0,1,0,1
56054,120,15454,20256;20795;22646;22992;24035,40515,1,2,2,0,5
56055,120,15455,20254;20303;23889;24109,40515,2,0,2,0,4
56056,120,15456,20310;20684,40515,0,0,2,0,2
56057,120,15457,20607;23095;23591,40515,0,2,1,0,3
56058,120,15458,20372;20437;23480,40515,0,1,2,0,3
56059,120,15459,20422;20457;22641,40515,0,1,2,0,3
56060,120,15460,20450;20818;23924,40515,1,0,2,0,3
56061,120,15461,20480;20736;22644;23099;24134;24243,40515,2,2,2,0,6
56062,120,15463,20500;20728;23917,40515,1,0,2,0,3
56063,120,15464,20519,40515,0,0,1,0,1
56064,120,15465,20342;20541,40515,0,0,2,0,2
56065,120,15466,20582;20995,40515,0,0,2,0,2
56066,120,15467,20780;23602;24033;24245,40515,2,1,1,0,4
56067,120,15468,20613;21025;23825;23938,40515,2,0,2,0,4
56068,120,15470,20679;20996;23935,40515,1,0,2,0,3
56069,120,15471,20338;20807;24037;24139,40515,2,0,2,0,4
56070,120,15472,20697;23598;23701;23916,40515,1,2,1,0,4
56071,120,15473,20507;20699,40515,0,0,2,0,2
56072,120,15474,20712;24029;24242,40515,2,0,1,0,3
56073,120,15475,20747;20801;23182;23381;24036,40515,1,2,2,0,5
56074,120,15476,20646;20791;23380;23707;23812;24137,40515,2,2,2,0,6
56075,120,15477,20707;20823;24039,40515,1,0,2,0,3
56076,120,15478,20841;21015;22994;23937,40515,1,1,2,0,4
56077,120,15479,20872;21164;23942,40515,1,0,2,0,3
56078,120,15480,20886;21114,40515,0,0,2,0,2
56079,120,15481,20912,40515,0,0,1,0,1
56080,120,15482,20917;24047;24146,40515,2,0,1,0,3
56081,120,15483,20930,40515,0,0,1,0,1
56082,120,15484,20889;20942,40515,0,0,2,0,2
56083,120,15485,20947;21066,40515,0,0,2,0,2
56084,120,15486,20732;20952,40515,0,0,2,0,2
56085,120,15487,20965;21201,40515,0,0,2,0,2
56086,120,15488,20968;21487,40515,0,0,2,0,2
56087,120,15489,20983;21037;23294,40515,0,1,2,0,3
56088,120,15490,20703;21008;23608;23936,40515,1,1,2,0,4
56089,120,15491,21028;21130,40515,0,0,2,0,2
56090,120,15492,21049;21412,40515,0,0,2,0,2
56091,120,15493,21053;21298,40515,0,0,2,0,2
56092,120,15494,21065;21232;23725;23945;24059,40515,2,1,2,0,5
56093,120,15495,21085;21321;23951,40515,1,0,2,0,3
56094,120,15496,21113,40515,0,0,1,0,1
56095,120,15497,20958;21120,40515,0,0,2,0,2
56096,120,15498,21118;21427;24069,40515,1,0,2,0,3
56097,120,15499,21151;21308,40515,0,0,2,0,2
56098,120,15500,21153;21486,40515,0,0,2,0,2
56099,120,15501,21200;21408,40515,0,0,2,0,2
56100,120,15502,21160;21245,40515,0,0,2,0,2
56101,120,15503,16486,40880,0,0,0,1,1
56102,120,15504,16444,40880,0,0,0,1,1
56103,120,15505,16488,40880,0,0,0,1,1
56104,120,15506,16965;17208,40880,0,0,1,1,2
56105,120,15511,16886,40880,0,0,0,1,1
56106,120,15512,16939;17338,40880,0,0,1,1,2
56107,120,15513,17343,40880,0,0,1,0,1
56108,120,15515,17127,40880,0,0,1,0,1
56109,120,15518,17798,40880,0,0,1,0,1
56110,120,15519,18390,40880,0,0,1,0,1
56111,120,15520,17442,40880,0,0,1,0,1
56112,120,15523,18345,40880,0,0,1,0,1
56113,120,15524,18478;18586,40880,0,0,2,0,2
56114,120,15525,18758,40880,0,0,1,0,1
56115,120,15526,18818;19269,40880,0,0,2,0,2
56116,120,15529,19010;19073,40880,0,0,2,0,2
56117,120,15530,18824;19501,40880,0,0,2,0,2
56118,120,15532,19466;19966;22859;23245,40880,0,2,2,0,4
56119,120,15536,19666;19749;22966;23056,40880,0,2,2,0,4
56120,120,15538,19906;20007,40880,0,0,2,0,2
56121,120,15539,19622;19948;22165;22491,40880,0,1,3,0,4
56122,120,15540,19979;20223;23258;23994,40880,1,1,2,0,4
56123,120,15541,19873;19985;23983,40880,1,0,2,0,3
56124,120,15542,20068;20391;23363;23684,40880,0,2,2,0,4
56125,120,15543,20054,40880,0,0,1,0,1
56126,120,15544,20066;20285;23569;23886;24217,40880,2,1,2,0,5
56127,120,15545,20164,40880,0,0,1,0,1
56128,120,15546,20248;20701,40880,0,0,2,0,2
56129,120,15547,19908;20045;22262;22625,40880,0,1,3,0,4
56130,120,15548,20436;20616;23278,40880,0,1,2,0,3
56131,120,15549,20522;23092;23487;23907,40880,1,2,1,0,4
56132,120,15550,20531;20727;22770;23377;23703;23810,40880,1,3,2,0,6
56133,120,15551,20572;21031;22995;23826,40880,1,1,2,0,4
56134,120,15552,20589;21440,40880,0,0,2,0,2
56135,120,15553,20604;20950;23821;23932,40880,2,0,2,0,4
56136,120,15554,20618;23593;23803,40880,1,1,1,0,3
56137,120,15555,20934;21004,40880,0,0,2,0,2
56138,120,15556,20207;20544;23176,40880,0,1,2,0,3
56139,120,15557,20794;20994;24152,40880,1,0,2,0,3
56140,120,15558,20800;20978;23288;23603;23708;23814,40880,1,3,2,0,6
56141,120,15559,20804;20813;23289;23604;24138,40880,1,2,2,0,5
56142,120,15560,20815;20919;23930;24147;24251,40880,3,0,2,0,5
56143,120,15561,20842;23816,40880,1,0,1,0,2
56144,120,15562,20897;21088,40880,0,0,2,0,2
56145,120,15563,20898;21464;24274,40880,1,0,2,0,3
56146,120,15564,20662;20850,40880,0,0,2,0,2
56147,120,15565,20928;21057,40880,0,0,2,0,2
56148,120,15566,20933;21420;23620,40880,0,1,2,0,3
56149,120,15568,21064;21341,40880,0,0,2,0,2
56150,120,15569,20992,40880,0,0,1,0,1
56151,120,15570,20993;21479;23731,40880,0,1,2,0,3
56152,120,15571,20581;21010;24258,40880,1,0,2,0,3
56153,120,15572,20733;21017,40880,0,0,2,0,2
56154,120,15573,21054;21416;23619,40880,0,1,2,0,3
56155,120,15574,21081;21315;23504;24174,40880,1,1,2,0,4
56156,120,15575,20951,40880,0,0,1,0,1
56157,120,15576,21236,40880,0,0,1,0,1
56158,120,15577,20982;21137;24161,40880,1,0,2,0,3
56159,120,15578,21161;23834;24265,40880,2,0,1,0,3
56160,120,15579,21159,40880,0,0,1,0,1
56161,120,15580,20915;21172,40880,0,0,2,0,2
56162,120,15581,21098;21177,40880,0,0,2,0,2
56163,120,15582,21188;21547,40880,0,0,2,0,2
56164,120,15583,20758;21206,40880,0,0,2,0,2
56165,120,15584,21211,40880,0,0,1,0,1
56166,120,15585,20990;21230,40880,0,0,2,0,2
56167,120,15586,21249;21355;23726,40880,0,1,2,0,3
56168,120,15587,21168;21256,40880,0,0,2,0,2
56169,120,15588,21262;21353;23947,40880,1,0,2,0,3
56170,120,15589,21009;21276,40880,0,0,2,0,2
56171,120,15590,21280;21313;24173,40880,1,0,2,0,3
56172,120,15591,21283;21370;24066,40880,1,0,2,0,3
56173,120,15592,21286;22996;24269,40880,1,1,1,0,3
56174,120,15593,17202,41245,0,0,1,0,1
56175,120,15594,17506,41245,0,0,1,0,1
56176,120,15596,17587;17648,41245,0,0,2,0,2
56177,120,15598,17650;18177,41245,0,0,2,0,2
56178,120,15599,17778,41245,0,0,1,0,1
56179,120,15600,17267,41245,0,0,1,0,1
56180,120,15601,17415;17774,41245,0,0,2,0,2
56181,120,15605,17707,41245,0,0,1,0,1
56182,120,15608,17822,41245,0,0,1,0,1
56183,120,15609,18124,41245,0,0,1,0,1
56184,120,15612,18066,41245,0,0,1,0,1
56185,120,15614,18712;19301;22708;22934;23205,41245,0,3,2,0,5
56186,120,15616,18809,41245,0,0,1,0,1
56187,120,15620,19412;19567,41245,0,0,2,0,2
56188,120,15621,19664,41245,0,0,1,0,1
56189,120,15622,19382,41245,0,0,1,0,1
56190,120,15627,19624,41245,0,0,1,0,1
56191,120,15629,20116;20593;23094;23590;23801,41245,1,2,2,0,5
56192,120,15631,19977;20312;24219,41245,1,0,2,0,3
56193,120,15632,20414,41245,0,0,1,0,1
56194,120,15633,20545;21167,41245,0,0,2,0,2
56195,120,15634,20839,41245,0,0,1,0,1
56196,120,15635,20588;20617,41245,0,0,2,0,2
56197,120,15636,20654;20870,41245,0,0,2,0,2
56198,120,15637,20663;21123,41245,0,0,2,0,2
56199,120,15638,20629;20678;23282;23595;24130,41245,1,2,2,0,5
56200,120,15639,20470;20683;23807;24027,41245,2,0,2,0,4
56201,120,15640,20768;20910;23929;24046;24145,41245,3,0,2,0,5
56202,120,15641,20799;23496,41245,0,1,1,0,2
56203,120,15642,20858,41245,0,0,1,0,1
56204,120,15643,20864;21142,41245,0,0,2,0,2
56205,120,15644,20865;21465,41245,0,0,2,0,2
56206,120,15645,20674,41245,0,0,1,0,1
56207,120,15646,20887;21045;23500;24261,41245,1,1,2,0,4
56208,120,15647,20829;20888;23927;24045,41245,2,0,2,0,4
56209,120,15648,20787,41245,0,0,1,0,1
56210,120,15649,21002;21074;23939;24053,41245,2,0,2,0,4
56211,120,15650,20961,41245,0,0,1,0,1
56212,120,15651,20873;20989,41245,0,0,2,0,2
56213,120,15652,21047;21397;23618,41245,0,1,2,0,3
56214,120,15653,21061;21110,41245,0,0,2,0,2
56215,120,15654,21070;21415,41245,0,0,2,0,2
56216,120,15655,21097;21115,41245,0,0,2,0,2
56217,120,15656,21102;21428,41245,0,0,2,0,2
56218,120,15657,21449;21482;23400,41245,0,1,2,0,3
56219,120,15658,21145;23611;24264,41245,1,1,1,0,3
56220,120,15659,21162;21243;24266,41245,1,0,2,0,3
56221,120,15660,20744;21217;23613;23723;24163,41245,1,2,2,0,5
56222,120,15661,21218;21591;24276,41245,1,0,2,0,3
56223,120,15662,21226;21680,41245,0,0,2,0,2
56224,120,15663,21197;21247;23946,41245,1,0,2,0,3
56225,120,15664,21086;21250;24060,41245,1,0,2,0,3
56226,120,15665,21258;21683,41245,0,0,2,0,2
56227,120,15666,20819;21259;23614,41245,0,1,2,0,3
56228,120,15667,21268;21613,41245,0,0,2,0,2
56229,120,15668,21270;21662,41245,0,0,2,0,2
56230,120,15669,20925;21278,41245,0,0,2,0,2
56231,120,15670,21291;21534;23844,41245,1,0,2,0,3
56232,120,15671,21304;21471,41245,0,0,2,0,2
56233,120,15672,20986;21305;23727,41245,0,1,2,0,3
56234,120,15673,20946;21320;24062,41245,1,0,2,0,3
56235,120,15674,21332;21525;24063,41245,1,0,2,0,3
56236,120,15675,21297;21345;23399;24177,41245,1,1,2,0,4
56237,120,15676,21326;21348,41245,0,0,2,0,2
56238,120,15677,21360;21511,41245,0,0,2,0,2
56239,120,15678,21376;21600;23845,41245,1,0,2,0,3
56240,120,15679,21260;21393,41245,0,0,2,0,2
56241,120,15680,21400;21446,41245,0,0,2,0,2
56242,120,15681,21401;21426,41245,0,0,2,0,2
56243,120,15682,16873,41610,0,0,0,1,1
56244,120,15683,17012,41610,0,0,1,0,1
56245,120,15685,17103,41610,0,0,1,0,1
56246,120,15687,17309,41610,0,0,1,0,1
56247,120,15693,17203,41610,0,0,1,0,1
56248,120,15701,18329,41610,0,0,1,0,1
56249,120,15702,18852;19287,41610,0,0,2,0,2
56250,120,15703,18149;18211,41610,0,0,2,0,2
56251,120,15704,18062;18256,41610,0,0,2,0,2
56252,120,15705,18617,41610,0,0,1,0,1
56253,120,15706,18680,41610,0,0,1,0,1
56254,120,15709,18766;19116;22570;22703,41610,0,2,2,0,4
56255,120,15710,18904;19550;22958;23856,41610,1,1,2,0,4
56256,120,15711,18939,41610,0,0,1,0,1
56257,120,15713,18760;18880,41610,0,0,2,0,2
56258,120,15715,19006,41610,0,0,1,0,1
56259,120,15717,19560,41610,0,0,1,0,1
56260,120,15718,19580;19973;22748;23450,41610,0,2,2,0,4
56261,120,15719,19557,41610,0,0,1,0,1
56262,120,15720,19658,41610,0,0,1,0,1
56263,120,15722,19514,41610,0,0,1,0,1
56264,120,15725,19435;19996;22167;22862,41610,0,1,3,0,4
56265,120,15726,20012;20233;22630;23349;23881,41610,1,2,2,0,5
56266,120,15727,20015;20276;23262,41610,0,1,2,0,3
56267,120,15728,20041;20487;23090,41610,0,1,2,0,3
56268,120,15729,19587,41610,0,0,1,0,1
56269,120,15731,19782;20257;22982;23084,41610,0,2,2,0,4
56270,120,15732,20186,41610,0,0,1,0,1
56271,120,15733,20192;20253;23884;24212,41610,2,0,2,0,4
56272,120,15734,20282;20309;24215,41610,1,0,2,0,3
56273,120,15735,20356,41610,0,0,1,0,1
56274,120,15736,20533;23093,41610,0,1,1,0,2
56275,120,15737,20464;21240;24168,41610,1,0,2,0,3
56276,120,15738,20698;20991,41610,0,0,2,0,2
56277,120,15740,20615;20711;23599;23702,41610,0,2,2,0,4
56278,120,15741,20623,41610,0,0,1,0,1
56279,120,15742,20676;20979;23391,41610,0,1,2,0,3
56280,120,15743,20560;20721;23370;23491;23797;23910,41610,2,2,2,0,6
56281,120,15744,20467;20757,41610,0,0,2,0,2
56282,120,15745,20765;21060;23828,41610,1,0,2,0,3
56283,120,15746,20665;20771,41610,0,0,2,0,2
56284,120,15747,20776;21271,41610,0,0,2,0,2
56285,120,15748,20779;23287,41610,0,1,1,0,2
56286,120,15749,20596,41610,0,0,1,0,1
56287,120,15750,20798;20835,41610,0,0,2,0,2
56288,120,15751,20454;20878;23292,41610,0,1,2,0,3
56289,120,15752,20884;21056;23296,41610,0,1,2,0,3
56290,120,15754,20726;20936;23293;23931,41610,1,1,2,0,4
56291,120,15755,20750;20938;24253,41610,1,0,2,0,3
56292,120,15756,20973,41610,0,0,1,0,1
56293,120,15757,20988;21069,41610,0,0,2,0,2
56294,120,15758,20786;21076,41610,0,0,2,0,2
56295,120,15760,21084;21133;23501;23940,41610,1,1,2,0,4
56296,120,15761,20944;21147;23502;23832,41610,1,1,2,0,4
56297,120,15762,21156;21314;23615,41610,0,1,2,0,3
56298,120,15763,21166;21327,41610,0,0,2,0,2
56299,120,15764,21180;21339,41610,0,0,2,0,2
56300,120,15765,21233;21378,41610,0,0,2,0,2
56301,120,15766,20896;21157,41610,0,0,2,0,2
56302,120,15767,20916;21269;24268,41610,1,0,2,0,3
56303,120,15768,21273;21433;24070,41610,1,0,2,0,3
56304,120,15769,21277;21342;23398,41610,0,1,2,0,3
56305,120,15770,21101;21290,41610,0,0,2,0,2
56306,120,15771,21019;21335,41610,0,0,2,0,2
56307,120,15772,21829,41610,0,0,1,0,1
56308,120,15773,21221;21716,41610,0,0,2,0,2
56309,120,15774,21371,41610,0,0,1,0,1
56310,120,15775,21203;21383,41610,0,0,2,0,2
56311,120,15776,21202;21384;24068,41610,1,0,2,0,3
56312,120,15777,21425;21621,41610,0,0,2,0,2
56313,120,15778,16903,41975,0,0,0,1,1
56314,120,15779,17039,41975,0,0,1,0,1
56315,120,15780,16953,41975,0,0,0,1,1
56316,120,15781,16686,41975,0,0,0,1,1
56317,120,15782,17120,41975,0,0,1,0,1
56318,120,15785,17462,41975,0,0,1,0,1
56319,120,15786,16890,41975,0,0,0,1,1
56320,120,15787,17776,41975,0,0,1,0,1
56321,120,15788,17610,41975,0,0,1,0,1
56322,120,15789,18152,41975,0,0,1,0,1
56323,120,15790,18273;18558,41975,0,0,2,0,2
56324,120,15796,18723,41975,0,0,1,0,1
56325,120,15798,18566,41975,0,0,1,0,1
56326,120,15801,19207;19854,41975,0,0,2,0,2
56327,120,15802,19055,41975,0,0,1,0,1
56328,120,15803,19571,41975,0,0,1,0,1
56329,120,15806,19851;19930;23239,41975,0,1,2,0,3
56330,120,15807,20106;20183;23879,41975,1,0,2,0,3
56331,120,15808,20387;20465;22765,41975,0,1,2,0,3
56332,120,15811,20360;20805,41975,0,0,2,0,2
56333,120,15812,20388;20446;22638;22762,41975,0,2,2,0,4
56334,120,15813,20396,41975,0,0,1,0,1
56335,120,15814,20366;20477;22766;23903,41975,1,1,2,0,4
56336,120,15815,19920;20023;22746;22854;23070;23659,41975,0,4,2,0,6
56337,120,15816,20514,41975,0,0,1,0,1
56338,120,15817,20657;23281;23493,41975,0,2,1,0,3
56339,120,15818,20489,41975,0,0,1,0,1
56340,120,15819,20584;22884;23799;24123,41975,2,1,1,0,4
56341,120,15820,20447,41975,0,0,1,0,1
56342,120,15821,20610;21018,41975,0,0,2,0,2
56343,120,15822,20999;23824,41975,1,0,1,0,2
56344,120,15823,20411,41975,0,0,1,0,1
56345,120,15824,20675;20840;24040,41975,1,0,2,0,3
56346,120,15825,20974,41975,0,0,1,0,1
56347,120,15826,20639,41975,0,0,1,0,1
56348,120,15827,20755;21042,41975,0,0,2,0,2
56349,120,15828,20313;20788,41975,0,0,2,0,2
56350,120,15829,20876;20937;24048,41975,1,0,2,0,3
56351,120,15830,20906;21040,41975,0,0,2,0,2
56352,120,15831,21184;21295;24171,41975,1,0,2,0,3
56353,120,15832,20723,41975,0,0,1,0,1
56354,120,15833,21001;21394,41975,0,0,2,0,2
56355,120,15834,21027;21607,41975,0,0,2,0,2
56356,120,15835,21029;21347;23837;24270,41975,2,0,2,0,4
56357,120,15836,21111;21318;23728,41975,0,1,2,0,3
56358,120,15837,21116;21475,41975,0,0,2,0,2
56359,120,15838,21132;23831,41975,1,0,1,0,2
56360,120,15839,21078;21152;23833,41975,1,0,2,0,3
56361,120,15840,21560,41975,0,0,1,0,1
56362,120,15841,21192;21532,41975,0,0,2,0,2
56363,120,15842,21209;21579,41975,0,0,2,0,2
56364,120,15843,21224;24166,41975,1,0,1,0,2
56365,120,15844,21411;21633,41975,0,0,2,0,2
56366,120,15845,21231;21264,41975,0,0,2,0,2
56367,120,15846,21241;21763;23736,41975,0,1,2,0,3
56368,120,15847,20772;20797;22771;23706,41975,0,2,2,0,4
56369,120,15848,21285,41975,0,0,1,0,1
56370,120,15849,21288;21374,41975,0,0,2,0,2
56371,120,15850,21043;21306,41975,0,0,2,0,2
56372,120,15851,21316;21551,41975,0,0,2,0,2
56373,120,15852,21358;21719,41975,0,0,2,0,2
56374,120,15853,21359;21531;23624,41975,0,1,2,0,3
56375,120,15854,21369,41975,0,0,1,0,1
56376,120,15855,21030;21395,41975,0,0,2,0,2
56377,120,15856,21402;21651;24078,41975,1,0,2,0,3
56378,120,15857,21443;21480,41975,0,0,2,0,2
56379,120,15858,21109,41975,0,0,1,0,1
56380,120,15859,21062;21494,41975,0,0,2,0,2
56381,120,15860,21514;24183,41975,1,0,1,0,2
56382,120,15861,21456;21550,41975,0,0,2,0,2
56383,120,15863,21328;21589;23625,41975,0,1,2,0,3
56384,120,15864,21453;21595;23734,41975,0,1,2,0,3
56385,120,15865,16915,42340,0,0,0,1,1
56386,120,15866,17173,42340,0,0,1,0,1
56387,120,15867,17341,42340,0,0,1,0,1
56388,120,15868,17542,42340,0,0,1,0,1
56389,120,15870,17548;17562,42340,0,0,2,0,2
56390,120,15871,17781,42340,0,0,1,0,1
56391,120,15872,17777,42340,0,0,1,0,1
56392,120,15876,18002;18320,42340,0,0,2,0,2
56393,120,15881,18455,42340,0,0,1,0,1
56394,120,15883,17982;18310,42340,0,0,2,0,2
56395,120,15885,18957,42340,0,0,1,0,1
56396,120,15886,18714;18917,42340,0,0,2,0,2
56397,120,15887,19181;19555,42340,0,0,2,0,2
56398,120,15888,19114,42340,0,0,1,0,1
56399,120,15890,19343,42340,0,0,1,0,1
56400,120,15891,19427;19759,42340,0,0,2,0,2
56401,120,15892,19757,42340,0,0,1,0,1
56402,120,15893,19761,42340,0,0,1,0,1
56403,120,15894,19663,42340,0,0,1,0,1
56404,120,15895,19545,42340,0,0,1,0,1
56405,120,15897,19971;20079;23458,42340,0,1,2,0,3
56406,120,15898,20037;20578;23178;23911;24122,42340,2,1,2,0,5
56407,120,15899,20060;20271;23781;24213,42340,2,0,2,0,4
56408,120,15901,20076;20151,42340,0,0,2,0,2
56409,120,15902,20140,42340,0,0,1,0,1
56410,120,15904,20211,42340,0,0,1,0,1
56411,120,15905,20228;20238;22170;23167;23880;23995,42340,2,1,3,0,6
56412,120,15906,20305,42340,0,0,1,0,1
56413,120,15907,20032;20351;23683;24111;24221,42340,2,1,2,0,5
56414,120,15909,20586,42340,0,0,1,0,1
56415,120,15910,20406,42340,0,0,1,0,1
56416,120,15911,20655;21093,42340,0,0,2,0,2
56417,120,15912,20689,42340,0,0,1,0,1
56418,120,15913,20719;21107;23718,42340,0,1,2,0,3
56419,120,15914,20722,42340,0,0,1,0,1
56420,120,15915,20725;21003;24155,42340,1,0,2,0,3
56421,120,15917,20444;20790,42340,0,0,2,0,2
56422,120,15918,20836;20900;23183;24143,42340,1,1,2,0,4
56423,120,15919,20849;21199,42340,0,0,2,0,2
56424,120,15920,20287,42340,0,0,1,0,1
56425,120,15921,20401;20881;23926,42340,1,0,2,0,3
56426,120,15922,20905;20914,42340,0,0,2,0,2
56427,120,15923,20953;21067;23829,42340,1,0,2,0,3
56428,120,15924,21075;21675,42340,0,0,2,0,2
56429,120,15925,21125;21481;23732,42340,0,1,2,0,3
56430,120,15926,21213,42340,0,0,1,0,1
56431,120,15927,20666;21227,42340,0,0,2,0,2
56432,120,15928,21282;21978,42340,0,0,2,0,2
56433,120,15929,21189;21292,42340,0,0,2,0,2
56434,120,15930,21303,42340,0,0,1,0,1
56435,120,15931,21325,42340,0,0,1,0,1
56436,120,15932,21158,42340,0,0,1,0,1
56437,120,15933,21006;21387;23617,42340,0,1,2,0,3
56438,120,15934,21399;21909,42340,0,0,2,0,2
56439,120,15935,21417;21828,42340,0,0,2,0,2
56440,120,15936,21418,42340,0,0,1,0,1
56441,120,15937,21431;22017,42340,0,0,2,0,2
56442,120,15938,21434;21833,42340,0,0,2,0,2
56443,120,15939,21436;21458,42340,0,0,2,0,2
56444,120,15940,21466;21467;24275,42340,1,0,2,0,3
56445,120,15941,21483;21508,42340,0,0,2,0,2
56446,120,15942,21515;23956,42340,1,0,1,0,2
56447,120,15943,21496,42340,0,0,1,0,1
56448,120,15944,21577;21670,42340,0,0,2,0,2
56449,120,15945,21557;21562,42340,0,0,2,0,2
56450,120,15946,21580,42340,0,0,1,0,1
56451,120,15947,21582;21844,42340,0,0,2,0,2
56452,120,15948,21457;21583,42340,0,0,2,0,2
56453,120,15949,21212;21587;24186,42340,1,0,2,0,3
56454,120,15950,21605,42340,0,0,1,0,1
56455,120,15951,21517;21612,42340,0,0,2,0,2
56456,120,15952,21362;21614;24077,42340,1,0,2,0,3
56457,120,15953,21616;21827,42340,0,0,2,0,2
56458,120,15954,21631;21840;24279,42340,1,0,2,0,3
56459,120,15955,21309;21645,42340,0,0,2,0,2
56460,120,15956,21648;22024,42340,0,0,2,0,2
56461,120,15957,21615;21678,42340,0,0,2,0,2
56462,120,15958,21546;21692,42340,0,0,2,0,2
56463,120,15959,21703;21951,42340,0,0,2,0,2
56464,120,15960,21477;21704;23961,42340,1,0,2,0,3
56465,120,15961,17228,42705,0,0,1,0,1
56466,120,15962,17325,42705,0,0,1,0,1
56467,120,15963,17474,42705,0,0,1,0,1
56468,120,15964,17480,42705,0,0,1,0,1
56469,120,15965,17705,42705,0,0,1,0,1
56470,120,15966,18009,42705,0,0,1,0,1
56471,120,15967,16889,42705,0,0,0,1,1
56472,120,15970,18108;18668,42705,0,0,2,0,2
56473,120,15972,18280,42705,0,0,1,0,1
56474,120,15973,18409,42705,0,0,1,0,1
56475,120,15974,18501,42705,0,0,1,0,1
56476,120,15975,18989,42705,0,0,1,0,1
56477,120,15979,19246,42705,0,0,1,0,1
56478,120,15981,19366,42705,0,0,1,0,1
56479,120,15982,19084,42705,0,0,1,0,1
56480,120,15983,19347,42705,0,0,1,0,1
56481,120,15985,19884,42705,0,0,1,0,1
56482,120,15986,19617,42705,0,0,1,0,1
56483,120,15987,20132;20608;23096;23802,42705,1,1,2,0,4
56484,120,15988,20217;20543;22500;22989;23584,42705,0,3,2,0,5
56485,120,15989,19822,42705,0,0,1,0,1
56486,120,15990,20080,42705,0,0,1,0,1
56487,120,15992,20546;23272;23585,42705,0,2,1,0,3
56488,120,15993,20575,42705,0,0,1,0,1
56489,120,15994,20250,42705,0,0,1,0,1
56490,120,15995,20601,42705,0,0,1,0,1
56491,120,15996,20620,42705,0,0,1,0,1
56492,120,15997,20716;20764;22991;23180;24244,42705,1,2,2,0,5
56493,120,15998,20789;21522;23623;24073,42705,1,1,2,0,4
56494,120,15999,20821;20826;23497;23605,42705,0,2,2,0,4
56495,120,16000,20851,42705,0,0,1,0,1
56496,120,16001,20767;20901;23385;24250,42705,1,1,2,0,4
56497,120,16002,20494;20517;22988;23175;23483,42705,0,3,2,0,5
56498,120,16003,20775;21222,42705,0,0,2,0,2
56499,120,16004,21136;21261;23720,42705,0,1,2,0,3
56500,120,16005,21090;21191,42705,0,0,2,0,2
56501,120,16006,21210;21533,42705,0,0,2,0,2
56502,120,16007,21235;21263,42705,0,0,2,0,2
56503,120,16008,21724;24285,42705,1,0,1,0,2
56504,120,16009,21275;21712,42705,0,0,2,0,2
56505,120,16010,21336;23505,42705,0,1,1,0,2
56506,120,16011,21319;21340,42705,0,0,2,0,2
56507,120,16012,21322;21357;23506;24064,42705,1,1,2,0,4
56508,120,16013,21363,42705,0,0,1,0,1
56509,120,16014,21364;21468,42705,0,0,2,0,2
56510,120,16015,21131;21377;23730,42705,0,1,2,0,3
56511,120,16016,21094;21386,42705,0,0,2,0,2
56512,120,16017,21422;21636,42705,0,0,2,0,2
56513,120,16018,21429;21689;24283,42705,1,0,2,0,3
56514,120,16019,21409;21461,42705,0,0,2,0,2
56515,120,16020,21389;21473;24271,42705,1,0,2,0,3
56516,120,16021,21382;21490,42705,0,0,2,0,2
56517,120,16022,21498;21858,42705,0,0,2,0,2
56518,120,16023,21214;21503,42705,0,0,2,0,2
56519,120,16024,21506;21618,42705,0,0,2,0,2
56520,120,16025,21523;22138;23850,42705,1,0,2,0,3
56521,120,16026,21505;21527,42705,0,0,2,0,2
56522,120,16027,21535;21912,42705,0,0,2,0,2
56523,120,16028,21549;22131,42705,0,0,2,0,2
56524,120,16029,21293;21558;24074,42705,1,0,2,0,3
56525,120,16030,21571;22071,42705,0,0,2,0,2
56526,120,16031,21576;21895,42705,0,0,2,0,2
56527,120,16032,21728;24079,42705,1,0,1,0,2
56528,120,16033,21671;21676,42705,0,0,2,0,2
56529,120,16034,21455;24181,42705,1,0,1,0,2
56530,120,16035,21677;22053,42705,0,0,2,0,2
56531,120,16036,21715;22008,42705,0,0,2,0,2
56532,120,16037,21722;21789,42705,0,0,2,0,2
56533,120,16038,21766;21866,42705,0,0,2,0,2
56534,120,16039,21773;22056,42705,0,0,2,0,2
56535,120,16040,21668;21777;24080,42705,1,0,2,0,3
56536,120,16041,21780;21819,42705,0,0,2,0,2
56537,120,16042,21272;21792,42705,0,0,2,0,2
56538,120,16043,21798;22160;23965,42705,1,0,2,0,3
56539,120,16044,21410;21801,42705,0,0,2,0,2
56540,120,16045,21826;21893,42705,0,0,2,0,2
56541,120,16046,17263,43070,0,0,1,0,1
56542,120,16047,17287,43070,0,0,1,0,1
56543,120,16048,16898,43070,0,0,0,1,1
56544,120,16049,17310,43070,0,0,1,0,1
56545,120,16050,17233,43070,0,0,1,0,1
56546,120,16052,17743,43070,0,0,1,0,1
56547,120,16054,18250,43070,0,0,1,0,1
56548,120,16056,17567,43070,0,0,1,0,1
56549,120,16057,18094,43070,0,0,1,0,1
56550,120,16061,17974;18010,43070,0,0,2,0,2
56551,120,16062,18615,43070,0,0,1,0,1
56552,120,16063,18754,43070,0,0,1,0,1
56553,120,16064,18822,43070,0,0,1,0,1
56554,120,16065,18891,43070,0,0,1,0,1
56555,120,16066,18790,43070,0,0,1,0,1
56556,120,16068,19131,43070,0,0,1,0,1
56557,120,16074,19794,43070,0,0,1,0,1
56558,120,16075,19204,43070,0,0,1,0,1
56559,120,16077,20158;23341;23464;24104,43070,1,2,1,0,4
56560,120,16078,19711,43070,0,0,1,0,1
56561,120,16079,20339,43070,0,0,1,0,1
56562,120,16080,20382,43070,0,0,1,0,1
56563,120,16081,20468,43070,0,0,1,0,1
56564,120,16082,20518,43070,0,0,1,0,1
56565,120,16084,20729;21155,43070,0,0,2,0,2
56566,120,16085,20700;20738,43070,0,0,2,0,2
56567,120,16086,20398,43070,0,0,1,0,1
56568,120,16087,20806,43070,0,0,1,0,1
56569,120,16088,20848,43070,0,0,1,0,1
56570,120,16089,20903,43070,0,0,1,0,1
56571,120,16090,20972;21135;24150,43070,1,0,2,0,3
56572,120,16091,21024;24259,43070,1,0,1,0,2
56573,120,16092,21039;21361;24065,43070,1,0,2,0,3
56574,120,16093,21099;21518;24184,43070,1,0,2,0,3
56575,120,16094,20960,43070,0,0,1,0,1
56576,120,16095,21106,43070,0,0,1,0,1
56577,120,16096,21117,43070,0,0,1,0,1
56578,120,16097,20867;21129;23818;23925;24249,43070,3,0,2,0,5
56579,120,16098,21165;21544,43070,0,0,2,0,2
56580,120,16099,21169;21816,43070,0,0,2,0,2
56581,120,16100,21176;21796;23737,43070,0,1,2,0,3
56582,120,16101,20975;21178,43070,0,0,2,0,2
56583,120,16102,20980;21267;23948;24169,43070,2,0,2,0,4
56584,120,16103,21289;21343,43070,0,0,2,0,2
56585,120,16104,20812;21310;23397;24172,43070,1,1,2,0,4
56586,120,16105,21323;21333,43070,0,0,2,0,2
56587,120,16106,21423,43070,0,0,1,0,1
56588,120,16107,21366;21526;23843,43070,1,0,2,0,3
56589,120,16108,21403;21679;24272,43070,1,0,2,0,3
56590,120,16109,21405;21904,43070,0,0,2,0,2
56591,120,16110,21407;21746,43070,0,0,2,0,2
56592,120,16111,21237;21437,43070,0,0,2,0,2
56593,120,16112,21439;21460;23840,43070,1,0,2,0,3
56594,120,16113,21448;22065,43070,0,0,2,0,2
56595,120,16114,21947,43070,0,0,1,0,1
56596,120,16115,21510;21876,43070,0,0,2,0,2
56597,120,16116,21495,43070,0,0,1,0,1
56598,120,16117,21536;21542,43070,0,0,2,0,2
56599,120,16118,21592;21734,43070,0,0,2,0,2
56600,120,16119,21603;21831,43070,0,0,2,0,2
56601,120,16120,21489;21619,43070,0,0,2,0,2
56602,120,16121,21624;21650;24278,43070,1,0,2,0,3
56603,120,16122,21629;21999,43070,0,0,2,0,2
56604,120,16123,21630,43070,0,0,1,0,1
56605,120,16124,21634;21795,43070,0,0,2,0,2
56606,120,16125,21652;21841,43070,0,0,2,0,2
56607,120,16126,21513;21701;23842,43070,1,0,2,0,3
56608,120,16127,21367;21642,43070,0,0,2,0,2
56609,120,16128,21246,43070,0,0,1,0,1
56610,120,16129,21732;21747,43070,0,0,2,0,2
56611,120,16130,21628;21736,43070,0,0,2,0,2
56612,120,16131,21685;21744,43070,0,0,2,0,2
56613,120,16132,21745;22010;24193,43070,1,0,2,0,3
56614,120,16133,21779,43070,0,0,1,0,1
56615,120,16134,21802;22230,43070,0,0,2,0,2
56616,120,16135,21807;22081,43070,0,0,2,0,2
56617,120,16136,21637;21811,43070,0,0,2,0,2
56618,120,16137,21817;22153,43070,0,0,2,0,2
56619,120,16138,21835;21861,43070,0,0,2,0,2
56620,120,16139,21257;21836,43070,0,0,2,0,2
56621,120,16140,21847;22003,43070,0,0,2,0,2
56622,120,16141,21848;21922,43070,0,0,2,0,2
56623,120,16142,21682;21850,43070,0,0,2,0,2
56624,120,16143,21743;21856;24286,43070,1,0,2,0,3
56625,120,16144,21864;22210,43070,0,0,2,0,2
56626,120,16145,21731;21884,43070,0,0,2,0,2
56627,120,16146,21737;21896,43070,0,0,2,0,2
56628,120,16147,21735;21899,43070,0,0,2,0,2
56629,120,16148,21920;22235,43070,0,0,2,0,2
56630,120,16149,21921;22195,43070,0,0,2,0,2
56631,120,16150,17484,43435,0,0,1,0,1
56632,120,16151,17530,43435,0,0,1,0,1
56633,120,16152,17571,43435,0,0,1,0,1
56634,120,16153,17229,43435,0,0,1,0,1
56635,120,16154,17257,43435,0,0,1,0,1
56636,120,16157,17915;18015,43435,0,0,2,0,2
56637,120,16160,18316,43435,0,0,1,0,1
56638,120,16161,17815,43435,0,0,1,0,1
56639,120,16162,18694,43435,0,0,1,0,1
56640,120,16164,18564,43435,0,0,1,0,1
56641,120,16166,19020,43435,0,0,1,0,1
56642,120,16167,19066,43435,0,0,1,0,1
56643,120,16168,19038,43435,0,0,1,0,1
56644,120,16169,18889;19408,43435,0,0,2,0,2
56645,120,16170,19585,43435,0,0,1,0,1
56646,120,16171,19380;19406;23520,43435,0,1,2,0,3
56647,120,16172,18940,43435,0,0,1,0,1
56648,120,16173,19489,43435,0,0,1,0,1
56649,120,16174,19603,43435,0,0,1,0,1
56650,120,16175,19309,43435,0,0,1,0,1
56651,120,16176,19969;20318;22634,43435,0,1,2,0,3
56652,120,16177,19881,43435,0,0,1,0,1
56653,120,16178,19698,43435,0,0,1,0,1
56654,120,16179,19939,43435,0,0,1,0,1
56655,120,16180,20136,43435,0,0,1,0,1
56656,120,16181,19965,43435,0,0,1,0,1
56657,120,16182,20241,43435,0,0,1,0,1
56658,120,16183,20278,43435,0,0,1,0,1
56659,120,16185,20146;20262,43435,0,0,2,0,2
56660,120,16186,20969,43435,0,0,1,0,1
56661,120,16187,20656;20752;23285;23600,43435,0,2,2,0,4
56662,120,16188,20774,43435,0,0,1,0,1
56663,120,16189,20561,43435,0,0,1,0,1
56664,120,16190,20838,43435,0,0,1,0,1
56665,120,16191,20845,43435,0,0,1,0,1
56666,120,16192,20761;21005;24156;24257,43435,2,0,2,0,4
56667,120,16193,21013,43435,0,0,1,0,1
56668,120,16194,21071;23394,43435,0,1,1,0,2
56669,120,16195,21087;21095;23609;24054,43435,1,1,2,0,4
56670,120,16196,21108;21657;24281,43435,1,0,2,0,3
56671,120,16197,20832;21139;24263,43435,1,0,2,0,3
56672,120,16198,21080;21173,43435,0,0,2,0,2
56673,120,16199,21251;21307,43435,0,0,2,0,2
56674,120,16200,21068;21356;24178,43435,1,0,2,0,3
56675,120,16201,21337,43435,0,0,1,0,1
56676,120,16202,21372;21441,43435,0,0,2,0,2
56677,120,16203,21673,43435,0,0,1,0,1
56678,120,16204,21185;21469,43435,0,0,2,0,2
56679,120,16205,21501;22078,43435,0,0,2,0,2
56680,120,16206,21555;22194,43435,0,0,2,0,2
56681,120,16207,21186,43435,0,0,1,0,1
56682,120,16208,21296;21565,43435,0,0,2,0,2
56683,120,16209,21598;21985,43435,0,0,2,0,2
56684,120,16210,21599,43435,0,0,1,0,1
56685,120,16211,21602;21868,43435,0,0,2,0,2
56686,120,16212,21632;21748,43435,0,0,2,0,2
56687,120,16213,21646,43435,0,0,1,0,1
56688,120,16214,21706;22241,43435,0,0,2,0,2
56689,120,16215,21681;21708,43435,0,0,2,0,2
56690,120,16216,21710,43435,0,0,1,0,1
56691,120,16217,21714;22208,43435,0,0,2,0,2
56692,120,16218,21717;21751;24188,43435,1,0,2,0,3
56693,120,16219,21749;22094,43435,0,0,2,0,2
56694,120,16220,21754;21937,43435,0,0,2,0,2
56695,120,16221,21476;21755,43435,0,0,2,0,2
56696,120,16222,21667;21760,43435,0,0,2,0,2
56697,120,16223,21770;21872,43435,0,0,2,0,2
56698,120,16224,21785;21806,43435,0,0,2,0,2
56699,120,16225,21786,43435,0,0,1,0,1
56700,120,16226,21528;21820,43435,0,0,2,0,2
56701,120,16227,21700;21823,43435,0,0,2,0,2
56702,120,16228,21804;21832,43435,0,0,2,0,2
56703,120,16229,21834;21941;24288,43435,1,0,2,0,3
56704,120,16230,21849;21881,43435,0,0,2,0,2
56705,120,16231,21520;21867,43435,0,0,2,0,2
56706,120,16232,21725;21880,43435,0,0,2,0,2
56707,120,16233,21897,43435,0,0,1,0,1
56708,120,16234,21933;22152,43435,0,0,2,0,2
56709,120,16235,21938;22309,43435,0,0,2,0,2
56710,120,16236,21949,43435,0,0,1,0,1
56711,120,16237,21392;21953,43435,0,0,2,0,2
56712,120,16238,21956,43435,0,0,1,0,1
56713,120,16239,21960;22151,43435,0,0,2,0,2
56714,120,16240,21964;22064,43435,0,0,2,0,2
56715,120,16241,21968;22301,43435,0,0,2,0,2
56716,120,16242,21994;22139,43435,0,0,2,0,2
56717,120,16243,21623;21998,43435,0,0,2,0,2
56718,120,16244,21898;22014;24194,43435,1,0,2,0,3
56719,120,16245,22016;22214,43435,0,0,2,0,2
56720,120,16246,22022;22307,43435,0,0,2,0,2
56721,120,16247,22031,43435,0,0,1,0,1
56722,120,16248,22037;22123;24083,43435,1,0,2,0,3
56723,120,16249,22040,43435,0,0,1,0,1
56724,120,16250,17521,43800,0,0,1,0,1
56725,120,16251,17275,43800,0,0,1,0,1
56726,120,16252,17736,43800,0,0,1,0,1
56727,120,16254,17722,43800,0,0,1,0,1
56728,120,16256,17901,43800,0,0,1,0,1
56729,120,16257,17992,43800,0,0,1,0,1
56730,120,16258,18071,43800,0,0,1,0,1
56731,120,16259,17581,43800,0,0,1,0,1
56732,120,16260,18285,43800,0,0,1,0,1
56733,120,16261,18295,43800,0,0,1,0,1
56734,120,16262,18395,43800,0,0,1,0,1
56735,120,16263,18453,43800,0,0,1,0,1
56736,120,16264,18557,43800,0,0,1,0,1
56737,120,16265,18632,43800,0,0,1,0,1
56738,120,16266,18641,43800,0,0,1,0,1
56739,120,16267,18810,43800,0,0,1,0,1
56740,120,16268,19093,43800,0,0,1,0,1
56741,120,16269,19018,43800,0,0,1,0,1
56742,120,16270,19115;19515;23637,43800,0,1,2,0,3
56743,120,16271,18811,43800,0,0,1,0,1
56744,120,16272,19399,43800,0,0,1,0,1
56745,120,16273,19574,43800,0,0,1,0,1
56746,120,16274,19575;20031;23334,43800,0,1,2,0,3
56747,120,16275,19726,43800,0,0,1,0,1
56748,120,16276,19789,43800,0,0,1,0,1
56749,120,16277,19907;23546;23762,43800,1,1,1,0,3
56750,120,16278,19438,43800,0,0,1,0,1
56751,120,16279,19619,43800,0,0,1,0,1
56752,120,16280,20243,43800,0,0,1,0,1
56753,120,16281,20139,43800,0,0,1,0,1
56754,120,16282,20481,43800,0,0,1,0,1
56755,120,16283,20597,43800,0,0,1,0,1
56756,120,16284,20562;20648;24128,43800,1,0,2,0,3
56757,120,16285,20673,43800,0,0,1,0,1
56758,120,16286,20702,43800,0,0,1,0,1
56759,120,16287,20417,43800,0,0,1,0,1
56760,120,16288,20904,43800,0,0,1,0,1
56761,120,16289,20824;23606,43800,0,1,1,0,2
56762,120,16290,20860;20981;24151,43800,1,0,2,0,3
56763,120,16291,20913,43800,0,0,1,0,1
56764,120,16292,20941;21033;23607;23716,43800,0,2,2,0,4
56765,120,16293,20706,43800,0,0,1,0,1
56766,120,16294,21021;21126,43800,0,0,2,0,2
56767,120,16295,21141,43800,0,0,1,0,1
56768,120,16296,21193;21470;23955;24182,43800,2,0,2,0,4
56769,120,16297,21195;21635,43800,0,0,2,0,2
56770,120,16298,21239,43800,0,0,1,0,1
56771,120,16299,21287;21430,43800,0,0,2,0,2
56772,120,16300,21299;21488;24061,43800,1,0,2,0,3
56773,120,16301,21041;21349;23953,43800,1,0,2,0,3
56774,120,16302,21484;21878,43800,0,0,2,0,2
56775,120,16303,21507,43800,0,0,1,0,1
56776,120,16304,21512;21765,43800,0,0,2,0,2
56777,120,16305,21545;21705,43800,0,0,2,0,2
56778,120,16306,21559;21702,43800,0,0,2,0,2
56779,120,16307,21566;21854;23849,43800,1,0,2,0,3
56780,120,16308,21252;21588,43800,0,0,2,0,2
56781,120,16309,21594;21669;23959,43800,1,0,2,0,3
56782,120,16310,21617,43800,0,0,1,0,1
56783,120,16311,21432;21622,43800,0,0,2,0,2
56784,120,16312,21626;21930,43800,0,0,2,0,2
56785,120,16313,21597,43800,0,0,1,0,1
56786,120,16314,21647;21869,43800,0,0,2,0,2
56787,120,16315,21585;21664,43800,0,0,2,0,2
56788,120,16316,21684;21890,43800,0,0,2,0,2
56789,120,16317,21553;21690;23960,43800,1,0,2,0,3
56790,120,16318,21691;21957,43800,0,0,2,0,2
56791,120,16319,21454;21697;24284,43800,1,0,2,0,3
56792,120,16320,21756;21799,43800,0,0,2,0,2
56793,120,16321,21778;22062;24196,43800,1,0,2,0,3
56794,120,16322,21445,43800,0,0,1,0,1
56795,120,16323,21809,43800,0,0,1,0,1
56796,120,16324,21839;22472,43800,0,1,1,0,2
56797,120,16325,21860;22364,43800,0,0,2,0,2
56798,120,16326,21879;22284,43800,0,0,2,0,2
56799,120,16327,21842,43800,0,0,1,0,1
56800,120,16328,21902,43800,0,0,1,0,1
56801,120,16329,21910;22147,43800,0,0,2,0,2
56802,120,16330,21911,43800,0,0,1,0,1
56803,120,16331,21917;22286,43800,0,0,2,0,2
56804,120,16332,21741;21936,43800,0,0,2,0,2
56805,120,16333,21946;22282,43800,0,0,2,0,2
56806,120,16334,21502,43800,0,0,1,0,1
56807,120,16335,21950;22036;24082,43800,1,0,2,0,3
56808,120,16336,21982;22474,43800,0,1,1,0,2
56809,120,16337,22001;22267,43800,0,0,2,0,2
56810,120,16338,21793;22009,43800,0,0,2,0,2
56811,120,16339,22012;22083,43800,0,0,2,0,2
56812,120,16340,22041;22133,43800,0,0,2,0,2
56813,120,16341,22042,43800,0,0,1,0,1
56814,120,16342,22055,43800,0,0,1,0,1
56815,120,16343,21887;22057,43800,0,0,2,0,2
56816,120,16344,22072;22421,43800,0,1,1,0,2
56817,120,16345,21758;22085,43800,0,0,2,0,2
56818,120,16346,22086;22317,43800,0,0,2,0,2
56819,120,16347,22100;22333,43800,0,0,2,0,2
56820,120,16348,21803;22106,43800,0,0,2,0,2
56821,120,16349,22144;22190,43800,0,0,2,0,2
56822,120,16350,22145;22411,43800,0,1,1,0,2
56823,120,16351,22149,43800,0,0,1,0,1
56824,120,16352,22157;22216,43800,0,0,2,0,2
56825,130,8182,16940;17167;17336,15695,0,0,0,3,3
56826,130,8190,16283;16550,15695,0,0,0,2,2
56827,130,8491,16641;21300;24525,16790,0,1,1,1,3
56828,130,8521,17253;17306,17155,0,0,0,2,2
56829,130,8713,16470;16707,17885,0,0,0,2,2
56830,130,8743,17384,17885,0,0,0,1,1
56831,130,8884,13539,18250,0,0,0,1,1
56832,130,8967,13963,18615,0,0,0,1,1
56833,130,8977,13752;13856,18615,0,0,0,2,2
56834,130,9036,18771;22542,18980,0,0,2,0,2
56835,130,9068,13372,18980,0,0,0,1,1
56836,130,9088,13930,18980,0,0,0,1,1
56837,130,9091,13938,18980,0,0,0,1,1
56838,130,9134,17020;17226,19345,0,0,0,2,2
56839,130,9138,13611,19345,0,0,0,1,1
56840,130,9152,14090;14339,19345,0,0,0,2,2
56841,130,9154,14115,19345,0,0,0,1,1
56842,130,9157,14063,19345,0,0,0,1,1
56843,130,9161,13677,19345,0,0,0,1,1
56844,130,9172,13858,19345,0,0,0,1,1
56845,130,9219,13676,19710,0,0,0,1,1
56846,130,9233,13477,19710,0,0,0,1,1
56847,130,9236,14110,19710,0,0,0,1,1
56848,130,9243,14314,19710,0,0,0,1,1
56849,130,9245,13702,19710,0,0,0,1,1
56850,130,9265,13813,19710,0,0,0,1,1
56851,130,9267,14080;14451,19710,0,0,0,2,2
56852,130,9333,14443,20075,0,0,0,1,1
56853,130,9335,14186,20075,0,0,0,1,1
56854,130,9340,14130,20075,0,0,0,1,1
56855,130,9343,13912,20075,0,0,0,1,1
56856,130,9351,14225,20075,0,0,0,1,1
56857,130,9354,14546,20075,0,0,0,1,1
56858,130,9355,14530,20075,0,0,0,1,1
56859,130,9361,14369,20075,0,0,0,1,1
56860,130,9409,13572,20440,0,0,0,1,1
56861,130,9426,13331,20440,0,0,0,1,1
56862,130,9438,13961;14168,20440,0,0,0,2,2
56863,130,9441,14318,20440,0,0,0,1,1
56864,130,9443,18344;18756,20440,0,0,2,0,2
56865,130,9445,13934,20440,0,0,0,1,1
56866,130,9446,13276,20440,0,0,0,1,1
56867,130,9452,14234,20440,0,0,0,1,1
56868,130,9456,14320,20440,0,0,0,1,1
56869,130,9457,14677,20440,0,0,0,1,1
56870,130,9464,14088,20440,0,0,0,1,1
56871,130,9465,14537,20440,0,0,0,1,1
56872,130,9468,14379;14468,20440,0,0,0,2,2
56873,130,9476,14243,20440,0,0,0,1,1
56874,130,9480,14354,20440,0,0,0,1,1
56875,130,9534,13346,20805,0,0,0,1,1
56876,130,9539,13451;13962,20805,0,0,0,2,2
56877,130,9546,13807,20805,0,0,0,1,1
56878,130,9549,14446,20805,0,0,0,1,1
56879,130,9552,13881,20805,0,0,0,1,1
56880,130,9553,14162,20805,0,0,0,1,1
56881,130,9562,14118,20805,0,0,0,1,1
56882,130,9563,14132,20805,0,0,0,1,1
56883,130,9565,14845,20805,0,0,0,1,1
56884,130,9567,14093;14478,20805,0,0,0,2,2
56885,130,9568,14194,20805,0,0,0,1,1
56886,130,9573,14500,20805,0,0,0,1,1
56887,130,9574,14532,20805,0,0,0,1,1
56888,130,9576,19196;19314;23124,20805,0,0,3,0,3
56889,130,9577,17999,20805,0,0,0,1,1
56890,130,9579,14418,20805,0,0,0,1,1
56891,130,9580,14678,20805,0,0,0,1,1
56892,130,9632,13635,21170,0,0,0,1,1
56893,130,9645,13589,21170,0,0,0,1,1
56894,130,9646,14223,21170,0,0,0,1,1
56895,130,9656,13989,21170,0,0,0,1,1
56896,130,9657,14026,21170,0,0,0,1,1
56897,130,9660,13969;14067,21170,0,0,0,2,2
56898,130,9661,14828,21170,0,0,0,1,1
56899,130,9663,17049;17311;18338;18614;18734;18938;22426,21170,0,0,5,2,7
56900,130,9665,14707,21170,0,0,0,1,1
56901,130,9667,14018,21170,0,0,0,1,1
56902,130,9668,14585,21170,0,0,0,1,1
56903,130,9671,13748;14353,21170,0,0,0,2,2
56904,130,9672,14572,21170,0,0,0,1,1
56905,130,9676,14415,21170,0,0,0,1,1
56906,130,9681,14768,21170,0,0,0,1,1
56907,130,9684,14525,21170,0,0,0,1,1
56908,130,9688,14555,21170,0,0,0,1,1
56909,130,9692,14930,21170,0,0,0,1,1
56910,130,9740,13770,21535,0,0,0,1,1
56911,130,9750,14425,21535,0,0,0,1,1
56912,130,9754,19108;19288;19671;19919;23319;23531,21535,0,1,5,0,6
56913,130,9758,18732;19030;22697,21535,0,0,3,0,3
56914,130,9761,14965,21535,0,0,0,1,1
56915,130,9765,14548,21535,0,0,0,1,1
56916,130,9768,14726,21535,0,0,0,1,1
56917,130,9769,14220,21535,0,0,0,1,1
56918,130,9770,14179,21535,0,0,0,1,1
56919,130,9773,14976,21535,0,0,0,1,1
56920,130,9776,14763,21535,0,0,0,1,1
56921,130,9779,14406,21535,0,0,0,1,1
56922,130,9783,14453,21535,0,0,0,1,1
56923,130,9785,15139,21535,0,0,0,1,1
56924,130,9786,15058,21535,0,0,0,1,1
56925,130,9790,14544,21535,0,0,0,1,1
56926,130,9791,14573,21535,0,0,0,1,1
56927,130,9792,14581,21535,0,0,0,1,1
56928,130,9795,15099,21535,0,0,0,1,1
56929,130,9800,14816,21535,0,0,0,1,1
56930,130,9852,14305,21900,0,0,0,1,1
56931,130,9857,14200,21900,0,0,0,1,1
56932,130,9863,15325,21900,0,0,0,1,1
56933,130,9865,14195,21900,0,0,0,1,1
56934,130,9870,14593;19149;22234,21900,0,0,2,1,3
56935,130,9871,15003,21900,0,0,0,1,1
56936,130,9876,14594;18580,21900,0,0,1,1,2
56937,130,9878,14753,21900,0,0,0,1,1
56938,130,9879,14430,21900,0,0,0,1,1
56939,130,9881,14813,21900,0,0,0,1,1
56940,130,9882,14843,21900,0,0,0,1,1
56941,130,9886,14641,21900,0,0,0,1,1
56942,130,9888,14567,21900,0,0,0,1,1
56943,130,9892,14628,21900,0,0,0,1,1
56944,130,9895,15005,21900,0,0,0,1,1
56945,130,9896,15229,21900,0,0,0,1,1
56946,130,9899,14428;18962,21900,0,0,1,1,2
56947,130,9901,15265,21900,0,0,0,1,1
56948,130,9904,14391,21900,0,0,0,1,1
56949,130,9948,14338,22265,0,0,0,1,1
56950,130,9954,14268;14541,22265,0,0,0,2,2
56951,130,9955,14713,22265,0,0,0,1,1
56952,130,9957,14122,22265,0,0,0,1,1
56953,130,9961,15320,22265,0,0,0,1,1
56954,130,9962,14309,22265,0,0,0,1,1
56955,130,9965,14377,22265,0,0,0,1,1
56956,130,9966,14383;14703,22265,0,0,0,2,2
56957,130,9968,17700;18202,22265,0,0,1,1,2
56958,130,9970,14631,22265,0,0,0,1,1
56959,130,9971,15031,22265,0,0,0,1,1
56960,130,9973,14553,22265,0,0,0,1,1
56961,130,9974,14796,22265,0,0,0,1,1
56962,130,9981,14670,22265,0,0,0,1,1
56963,130,9985,14742,22265,0,0,0,1,1
56964,130,9987,14869,22265,0,0,0,1,1
56965,130,9995,15462,22265,0,0,0,1,1
56966,130,9997,18449;18644,22265,0,0,2,0,2
56967,130,9999,14964,22265,0,0,0,1,1
56968,130,10001,14981,22265,0,0,0,1,1
56969,130,10002,15016;15120,22265,0,0,0,2,2
56970,130,10049,13794,22630,0,0,0,1,1
56971,130,10055,14589,22630,0,0,0,1,1
56972,130,10063,14712;14839,22630,0,0,0,2,2
56973,130,10064,14590,22630,0,0,0,1,1
56974,130,10066,14306,22630,0,0,0,1,1
56975,130,10078,14502,22630,0,0,0,1,1
56976,130,10082,14419,22630,0,0,0,1,1
56977,130,10083,15458,22630,0,0,0,1,1
56978,130,10085,14299,22630,0,0,0,1,1
56979,130,10088,15136,22630,0,0,0,1,1
56980,130,10089,15105;15475,22630,0,0,0,2,2
56981,130,10090,15261,22630,0,0,0,1,1
56982,130,10091,15225,22630,0,0,0,1,1
56983,130,10092,14854,22630,0,0,0,1,1
56984,130,10093,15449,22630,0,0,0,1,1
56985,130,10095,14919,22630,0,0,0,1,1
56986,130,10098,15300,22630,0,0,0,1,1
56987,130,10099,14770,22630,0,0,0,1,1
56988,130,10101,15023,22630,0,0,0,1,1
56989,130,10104,15034,22630,0,0,0,1,1
56990,130,10107,15081;15147,22630,0,0,0,2,2
56991,130,10109,19754;19910;23448;24096,22630,0,1,3,0,4
56992,130,10112,15198;15388,22630,0,0,0,2,2
56993,130,10113,15273,22630,0,0,0,1,1
56994,130,10114,15170;15230,22630,0,0,0,2,2
56995,130,10162,14136,22995,0,0,0,1,1
56996,130,10170,14370,22995,0,0,0,1,1
56997,130,10172,14163;14221,22995,0,0,0,2,2
56998,130,10176,14248,22995,0,0,0,1,1
56999,130,10179,14300,22995,0,0,0,1,1
57000,130,10182,14887,22995,0,0,0,1,1
57001,130,10185,15061,22995,0,0,0,1,1
57002,130,10187,14281,22995,0,0,0,1,1
57003,130,10189,15029,22995,0,0,0,1,1
57004,130,10192,15041,22995,0,0,0,1,1
57005,130,10194,14693,22995,0,0,0,1,1
57006,130,10195,14706,22995,0,0,0,1,1
57007,130,10197,14863,22995,0,0,0,1,1
57008,130,10198,14873,22995,0,0,0,1,1
57009,130,10199,15060,22995,0,0,0,1,1
57010,130,10202,15532,22995,0,0,0,1,1
57011,130,10204,14929,22995,0,0,0,1,1
57012,130,10205,15269;15430,22995,0,0,0,2,2
57013,130,10206,14692,22995,0,0,0,1,1
57014,130,10208,15595,22995,0,0,0,1,1
57015,130,10211,14966;15492,22995,0,0,0,2,2
57016,130,10212,15560,22995,0,0,0,1,1
57017,130,10215,16192,22995,0,0,0,1,1
57018,130,10216,15524,22995,0,0,0,1,1
57019,130,10217,15209,22995,0,0,0,1,1
57020,130,10218,15625,22995,0,0,0,1,1
57021,130,10219,15636,22995,0,0,0,1,1
57022,130,10251,13917,23360,0,0,0,1,1
57023,130,10256,15212,23360,0,0,0,1,1
57024,130,10257,15059,23360,0,0,0,1,1
57025,130,10259,14714;19361,23360,0,0,1,1,2
57026,130,10260,14579,23360,0,0,0,1,1
57027,130,10267,15380,23360,0,0,0,1,1
57028,130,10269,15394;15480,23360,0,0,0,2,2
57029,130,10270,14820,23360,0,0,0,1,1
57030,130,10271,14874,23360,0,0,0,1,1
57031,130,10273,14895;14933,23360,0,0,0,2,2
57032,130,10274,15206,23360,0,0,0,1,1
57033,130,10276,15439,23360,0,0,0,1,1
57034,130,10278,15193,23360,0,0,0,1,1
57035,130,10279,15819,23360,0,0,0,1,1
57036,130,10281,14912,23360,0,0,0,1,1
57037,130,10287,15827,23360,0,0,0,1,1
57038,130,10288,15849,23360,0,0,0,1,1
57039,130,10291,14886,23360,0,0,0,1,1
57040,130,10293,15809,23360,0,0,0,1,1
57041,130,10294,15334,23360,0,0,0,1,1
57042,130,10295,15348,23360,0,0,0,1,1
57043,130,10299,15710;15855,23360,0,0,0,2,2
57044,130,10302,15440,23360,0,0,0,1,1
57045,130,10305,15818,23360,0,0,0,1,1
57046,130,10306,15467,23360,0,0,0,1,1
57047,130,10352,14754,23725,0,0,0,1,1
57048,130,10354,14499,23725,0,0,0,1,1
57049,130,10356,14519,23725,0,0,0,1,1
57050,130,10364,15830,23725,0,0,0,1,1
57051,130,10365,15301,23725,0,0,0,1,1
57052,130,10366,14858,23725,0,0,0,1,1
57053,130,10368,15487,23725,0,0,0,1,1
57054,130,10370,14913,23725,0,0,0,1,1
57055,130,10372,15270,23725,0,0,0,1,1
57056,130,10373,14568;14948,23725,0,0,0,2,2
57057,130,10375,14582,23725,0,0,0,1,1
57058,130,10379,15044;15048,23725,0,0,0,2,2
57059,130,10381,15049;15233,23725,0,0,0,2,2
57060,130,10382,14826;15464,23725,0,0,0,2,2
57061,130,10383,14902;15038,23725,0,0,0,2,2
57062,130,10387,15107,23725,0,0,0,1,1
57063,130,10390,14998;15489,23725,0,0,0,2,2
57064,130,10394,15342,23725,0,0,0,1,1
57065,130,10397,14944;15881,23725,0,0,0,2,2
57066,130,10398,15695,23725,0,0,0,1,1
57067,130,10399,15763,23725,0,0,0,1,1
57068,130,10402,15973,23725,0,0,0,1,1
57069,130,10403,15425,23725,0,0,0,1,1
57070,130,10405,15453,23725,0,0,0,1,1
57071,130,10406,15184,23725,0,0,0,1,1
57072,130,10407,15848,23725,0,0,0,1,1
57073,130,10410,14931;15500,23725,0,0,0,2,2
57074,130,10411,15501,23725,0,0,0,1,1
57075,130,10414,15396;15582,23725,0,0,0,2,2
57076,130,10415,15614;16031,23725,0,0,0,2,2
57077,130,10417,15547;15990,23725,0,0,0,2,2
57078,130,10418,15359;15550,23725,0,0,0,2,2
57079,130,10419,15556,23725,0,0,0,1,1
57080,130,10453,13352,24090,0,0,0,1,1
57081,130,10463,14313,24090,0,0,0,1,1
57082,130,10468,14829,24090,0,0,0,1,1
57083,130,10481,14851,24090,0,0,0,1,1
57084,130,10483,15087,24090,0,0,0,1,1
57085,130,10484,14956,24090,0,0,0,1,1
57086,130,10486,14997,24090,0,0,0,1,1
57087,130,10489,14818,24090,0,0,0,1,1
57088,130,10490,15542,24090,0,0,0,1,1
57089,130,10491,15043,24090,0,0,0,1,1
57090,130,10492,15892,24090,0,0,0,1,1
57091,130,10493,15246;15509,24090,0,0,0,2,2
57092,130,10497,19848;19892;24202,24090,0,1,2,0,3
57093,130,10498,14982;15172,24090,0,0,0,2,2
57094,130,10500,15294,24090,0,0,0,1,1
57095,130,10501,15222;15367,24090,0,0,0,2,2
57096,130,10502,16050,24090,0,0,0,1,1
57097,130,10504,15872,24090,0,0,0,1,1
57098,130,10505,15586,24090,0,0,0,1,1
57099,130,10506,15696,24090,0,0,0,1,1
57100,130,10507,15730,24090,0,0,0,1,1
57101,130,10508,15207,24090,0,0,0,1,1
57102,130,10509,15338,24090,0,0,0,1,1
57103,130,10510,15339,24090,0,0,0,1,1
57104,130,10511,15361,24090,0,0,0,1,1
57105,130,10512,15402,24090,0,0,0,1,1
57106,130,10513,15869,24090,0,0,0,1,1
57107,130,10514,15426,24090,0,0,0,1,1
57108,130,10515,15650,24090,0,0,0,1,1
57109,130,10517,15604;16103,24090,0,0,0,2,2
57110,130,10518,15444,24090,0,0,0,1,1
57111,130,10519,15622,24090,0,0,0,1,1
57112,130,10520,15831,24090,0,0,0,1,1
57113,130,10521,15316;15530,24090,0,0,0,2,2
57114,130,10522,15581,24090,0,0,0,1,1
57115,130,10524,15307,24090,0,0,0,1,1
57116,130,10525,15613,24090,0,0,0,1,1
57117,130,10526,15615;16024,24090,0,0,0,2,2
57118,130,10527,15799,24090,0,0,0,1,1
57119,130,10528,15635;15655,24090,0,0,0,2,2
57120,130,10530,15649;15891,24090,0,0,0,2,2
57121,130,10531,15835,24090,0,0,0,1,1
57122,130,10533,15680;15741,24090,0,0,0,2,2
57123,130,10534,15540;15689,24090,0,0,0,2,2
57124,130,10573,15282,24455,0,0,0,1,1
57125,130,10579,14490,24455,0,0,0,1,1
57126,130,10581,14396,24455,0,0,0,1,1
57127,130,10584,14841,24455,0,0,0,1,1
57128,130,10585,14662,24455,0,0,0,1,1
57129,130,10590,14752,24455,0,0,0,1,1
57130,130,10595,15030;15387,24455,0,0,0,2,2
57131,130,10597,15037,24455,0,0,0,1,1
57132,130,10600,15149,24455,0,0,0,1,1
57133,130,10602,15146,24455,0,0,0,1,1
57134,130,10603,15168,24455,0,0,0,1,1
57135,130,10604,15360,24455,0,0,0,1,1
57136,130,10605,15174,24455,0,0,0,1,1
57137,130,10606,15677,24455,0,0,0,1,1
57138,130,10608,16035,24455,0,0,0,1,1
57139,130,10610,15523,24455,0,0,0,1,1
57140,130,10612,15621,24455,0,0,0,1,1
57141,130,10613,15386,24455,0,0,0,1,1
57142,130,10615,15454,24455,0,0,0,1,1
57143,130,10617,15497;15505,24455,0,0,0,2,2
57144,130,10618,16152,24455,0,0,0,1,1
57145,130,10620,15544,24455,0,0,0,1,1
57146,130,10622,15669,24455,0,0,0,1,1
57147,130,10623,15584,24455,0,0,0,1,1
57148,130,10625,15362;15927,24455,0,0,0,2,2
57149,130,10626,15642,24455,0,0,0,1,1
57150,130,10627,16182,24455,0,0,0,1,1
57151,130,10632,15714,24455,0,0,0,1,1
57152,130,10633,15721;15874,24455,0,0,0,2,2
57153,130,10634,15736,24455,0,0,0,1,1
57154,130,10635,15868,24455,0,0,0,1,1
57155,130,10636,16275,24455,0,0,0,1,1
57156,130,10637,16011;16330,24455,0,0,0,2,2
57157,130,10641,15964,24455,0,0,0,1,1
57158,130,10642,15846,24455,0,0,0,1,1
57159,130,10643,16049,24455,0,0,0,1,1
57160,130,10644,16173,24455,0,0,0,1,1
57161,130,10645,15866,24455,0,0,0,1,1
57162,130,10646,15711,24455,0,0,0,1,1
57163,130,10647,15691,24455,0,0,0,1,1
57164,130,10683,14444,24820,0,0,0,1,1
57165,130,10690,14812,24820,0,0,0,1,1
57166,130,10695,15006,24820,0,0,0,1,1
57167,130,10696,20089,24820,0,0,1,0,1
57168,130,10699,14760,24820,0,0,0,1,1
57169,130,10700,14878,24820,0,0,0,1,1
57170,130,10701,16048,24820,0,0,0,1,1
57171,130,10702,14971;15511,24820,0,0,0,2,2
57172,130,10704,15218;15423,24820,0,0,0,2,2
57173,130,10705,15298,24820,0,0,0,1,1
57174,130,10706,14989;15084,24820,0,0,0,2,2
57175,130,10709,15484,24820,0,0,0,1,1
57176,130,10711,15676,24820,0,0,0,1,1
57177,130,10713,16312,24820,0,0,0,1,1
57178,130,10718,15336,24820,0,0,0,1,1
57179,130,10721,15661;16025,24820,0,0,0,2,2
57180,130,10722,15102,24820,0,0,0,1,1
57181,130,10723,15422,24820,0,0,0,1,1
57182,130,10726,15349;15810,24820,0,0,0,2,2
57183,130,10727,15373,24820,0,0,0,1,1
57184,130,10732,15033,24820,0,0,0,1,1
57185,130,10734,15295;15920,24820,0,0,0,2,2
57186,130,10737,16222,24820,0,0,0,1,1
57187,130,10739,16027,24820,0,0,0,1,1
57188,130,10741,15418,24820,0,0,0,1,1
57189,130,10742,15771;15794,24820,0,0,0,2,2
57190,130,10744,16186;16497,24820,0,0,0,2,2
57191,130,10745,16347;16372,24820,0,0,0,2,2
57192,130,10746,16227,24820,0,0,0,1,1
57193,130,10747,15917,24820,0,0,0,1,1
57194,130,10750,15952;16300,24820,0,0,0,2,2
57195,130,10751,15968;16299,24820,0,0,0,2,2
57196,130,10752,15982,24820,0,0,0,1,1
57197,130,10753,15787;15989,24820,0,0,0,2,2
57198,130,10754,15624;16189,24820,0,0,0,2,2
57199,130,10795,14420;14885,25185,0,0,0,2,2
57200,130,10796,14127;14410,25185,0,0,0,2,2
57201,130,10804,14696;14710,25185,0,0,0,2,2
57202,130,10807,15118,25185,0,0,0,1,1
57203,130,10808,15026,25185,0,0,0,1,1
57204,130,10809,15534,25185,0,0,0,1,1
57205,130,10810,15110,25185,0,0,0,1,1
57206,130,10813,15722,25185,0,0,0,1,1
57207,130,10814,15767,25185,0,0,0,1,1
57208,130,10815,15285,25185,0,0,0,1,1
57209,130,10817,15824,25185,0,0,0,1,1
57210,130,10820,15617,25185,0,0,0,1,1
57211,130,10821,15143,25185,0,0,0,1,1
57212,130,10822,16160,25185,0,0,0,1,1
57213,130,10825,15863;15871,25185,0,0,0,2,2
57214,130,10827,15610,25185,0,0,0,1,1
57215,130,10830,15448;15623,25185,0,0,0,2,2
57216,130,10831,15459;15634,25185,0,0,0,2,2
57217,130,10832,15641;15682,25185,0,0,0,2,2
57218,130,10834,15665,25185,0,0,0,1,1
57219,130,10835,16119,25185,0,0,0,1,1
57220,130,10836,16304,25185,0,0,0,1,1
57221,130,10838,16341,25185,0,0,0,1,1
57222,130,10839,16043;16327,25185,0,0,0,2,2
57223,130,10843,15266,25185,0,0,0,1,1
57224,130,10844,16188;16265,25185,0,0,0,2,2
57225,130,10845,20331;20509;23473,25185,0,0,3,0,3
57226,130,10846,15981,25185,0,0,0,1,1
57227,130,10847,15944,25185,0,0,0,1,1
57228,130,10848,15947,25185,0,0,0,1,1
57229,130,10849,16360;16749,25185,0,0,0,2,2
57230,130,10851,15389;15972,25185,0,0,0,2,2
57231,130,10854,16054,25185,0,0,0,1,1
57232,130,10856,16059,25185,0,0,0,1,1
57233,130,10857,16315,25185,0,0,0,1,1
57234,130,10858,16095;16154,25185,0,0,0,2,2
57235,130,10859,16116;16375,25185,0,0,0,2,2
57236,130,10860,15850,25185,0,0,0,1,1
57237,130,10862,16124;16551,25185,0,0,0,2,2
57238,130,10864,16138;20452;24579,25185,0,1,1,1,3
57239,130,10865,16262,25185,0,0,0,1,1
57240,130,10866,15761,25185,0,0,0,1,1
57241,130,10867,16190,25185,0,0,0,1,1
57242,130,10906,14501,25550,0,0,0,1,1
57243,130,10907,14600;14785,25550,0,0,0,2,2
57244,130,10909,14888,25550,0,0,0,1,1
57245,130,10911,14552,25550,0,0,0,1,1
57246,130,10917,14697,25550,0,0,0,1,1
57247,130,10918,15180,25550,0,0,0,1,1
57248,130,10923,15201;15495,25550,0,0,0,2,2
57249,130,10924,15216;15303,25550,0,0,0,2,2
57250,130,10925,15991;16284,25550,0,0,0,2,2
57251,130,10927,15728,25550,0,0,0,1,1
57252,130,10929,15354,25550,0,0,0,1,1
57253,130,10930,15940,25550,0,0,0,1,1
57254,130,10932,15516;15537,25550,0,0,0,2,2
57255,130,10935,15611,25550,0,0,0,1,1
57256,130,10936,15648,25550,0,0,0,1,1
57257,130,10937,15311,25550,0,0,0,1,1
57258,130,10938,15962,25550,0,0,0,1,1
57259,130,10939,15897,25550,0,0,0,1,1
57260,130,10940,16147,25550,0,0,0,1,1
57261,130,10941,15986,25550,0,0,0,1,1
57262,130,10943,15365;15765,25550,0,0,0,2,2
57263,130,10945,15783,25550,0,0,0,1,1
57264,130,10946,15463,25550,0,0,0,1,1
57265,130,10947,15823;16185,25550,0,0,0,2,2
57266,130,10948,15658;16132,25550,0,0,0,2,2
57267,130,10950,16125;16302,25550,0,0,0,2,2
57268,130,10951,15330,25550,0,0,0,1,1
57269,130,10952,15929,25550,0,0,0,1,1
57270,130,10953,16628,25550,0,0,0,1,1
57271,130,10955,15821;16180,25550,0,0,0,2,2
57272,130,10956,15978;16000,25550,0,0,0,2,2
57273,130,10957,15646;16001,25550,0,0,0,2,2
57274,130,10958,15948;16417,25550,0,0,0,2,2
57275,130,10959,16033;16060,25550,0,0,0,2,2
57276,130,10961,16395,25550,0,0,0,1,1
57277,130,10962,16121,25550,0,0,0,1,1
57278,130,10963,16131;16489,25550,0,0,0,2,2
57279,130,10965,16201;16644,25550,0,0,0,2,2
57280,130,10966,16114;16602,25550,0,0,0,2,2
57281,130,10967,16255,25550,0,0,0,1,1
57282,130,10968,16065;16218,25550,0,0,0,2,2
57283,130,10969,16625;16716,25550,0,0,0,2,2
57284,130,10972,16264,25550,0,0,0,1,1
57285,130,10973,16645,25550,0,0,0,1,1
57286,130,10974,16229;16279,25550,0,0,0,2,2
57287,130,10975,15679;16324,25550,0,0,0,2,2
57288,130,11018,14835,25915,0,0,0,1,1
57289,130,11024,14570,25915,0,0,0,1,1
57290,130,11029,15602,25915,0,0,0,1,1
57291,130,11030,15121,25915,0,0,0,1,1
57292,130,11036,14705,25915,0,0,0,1,1
57293,130,11037,14932,25915,0,0,0,1,1
57294,130,11039,15183,25915,0,0,0,1,1
57295,130,11041,15570,25915,0,0,0,1,1
57296,130,11042,15690,25915,0,0,0,1,1
57297,130,11044,15988;16225,25915,0,0,0,2,2
57298,130,11045,15138,25915,0,0,0,1,1
57299,130,11046,15739,25915,0,0,0,1,1
57300,130,11047,15885,25915,0,0,0,1,1
57301,130,11048,16468,25915,0,0,0,1,1
57302,130,11050,15865,25915,0,0,0,1,1
57303,130,11051,15867,25915,0,0,0,1,1
57304,130,11053,15876,25915,0,0,0,1,1
57305,130,11054,15907;15925,25915,0,0,0,2,2
57306,130,11055,15910,25915,0,0,0,1,1
57307,130,11056,16209,25915,0,0,0,1,1
57308,130,11057,16452;20686;23698,25915,0,1,1,1,3
57309,130,11058,16428,25915,0,0,0,1,1
57310,130,11059,16318,25915,0,0,0,1,1
57311,130,11060,16036,25915,0,0,0,1,1
57312,130,11061,16037,25915,0,0,0,1,1
57313,130,11062,16411,25915,0,0,0,1,1
57314,130,11063,15768,25915,0,0,0,1,1
57315,130,11064,16107,25915,0,0,0,1,1
57316,130,11065,15706,25915,0,0,0,1,1
57317,130,11066,16418,25915,0,0,0,1,1
57318,130,11067,16118,25915,0,0,0,1,1
57319,130,11068,20293;23264;23355;24108;24218,25915,0,2,3,0,5
57320,130,11069,16599,25915,0,0,0,1,1
57321,130,11070,16123,25915,0,0,0,1,1
57322,130,11072,16601,25915,0,0,0,1,1
57323,130,11075,16112;16650,25915,0,0,0,2,2
57324,130,11076,16483;16861,25915,0,0,0,2,2
57325,130,11077,16282,25915,0,0,0,1,1
57326,130,11078,16177,25915,0,0,0,1,1
57327,130,11079,16251,25915,0,0,0,1,1
57328,130,11081,16338;16610,25915,0,0,0,2,2
57329,130,11082,16586,25915,0,0,0,1,1
57330,130,11083,16157,25915,0,0,0,1,1
57331,130,11084,16272;16787,25915,0,0,0,2,2
57332,130,11085,16381;16544,25915,0,0,0,2,2
57333,130,11086,16778,25915,0,0,0,1,1
57334,130,11088,16353;16461,25915,0,0,0,2,2
57335,130,11089,16213;16471,25915,0,0,0,2,2
57336,130,11090,16368;16472,25915,0,0,0,2,2
57337,130,11137,14575,26280,0,0,0,1,1
57338,130,11139,14663,26280,0,0,0,1,1
57339,130,11141,14557,26280,0,0,0,1,1
57340,130,11142,14766,26280,0,0,0,1,1
57341,130,11143,15244,26280,0,0,0,1,1
57342,130,11150,14954,26280,0,0,0,1,1
57343,130,11151,14960,26280,0,0,0,1,1
57344,130,11153,15077,26280,0,0,0,1,1
57345,130,11154,15078,26280,0,0,0,1,1
57346,130,11158,19913;19965;23158,26280,0,0,3,0,3
57347,130,11162,15943,26280,0,0,0,1,1
57348,130,11164,15383,26280,0,0,0,1,1
57349,130,11165,14533,26280,0,0,0,1,1
57350,130,11166,15890,26280,0,0,0,1,1
57351,130,11167,15397;15630,26280,0,0,0,2,2
57352,130,11168,15399,26280,0,0,0,1,1
57353,130,11169,15479,26280,0,0,0,1,1
57354,130,11170,16039,26280,0,0,0,1,1
57355,130,11171,15499;15514,26280,0,0,0,2,2
57356,130,11172,15573;16187,26280,0,0,0,2,2
57357,130,11173,15588,26280,0,0,0,1,1
57358,130,11174,16753,26280,0,0,0,1,1
57359,130,11176,16337,26280,0,0,0,1,1
57360,130,11177,15705,26280,0,0,0,1,1
57361,130,11178,16439,26280,0,0,0,1,1
57362,130,11180,16030;16323,26280,0,0,0,2,2
57363,130,11182,16589,26280,0,0,0,1,1
57364,130,11183,15802;16288,26280,0,0,0,2,2
57365,130,11184,15936,26280,0,0,0,1,1
57366,130,11186,15880,26280,0,0,0,1,1
57367,130,11187,15901;16547,26280,0,0,0,2,2
57368,130,11188,16211,26280,0,0,0,1,1
57369,130,11189,15673;15918,26280,0,0,0,2,2
57370,130,11191,15932,26280,0,0,0,1,1
57371,130,11192,15939,26280,0,0,0,1,1
57372,130,11194,15814;15992,26280,0,0,0,2,2
57373,130,11195,15994,26280,0,0,0,1,1
57374,130,11199,16500,26280,0,0,0,1,1
57375,130,11200,16069;16464,26280,0,0,0,2,2
57376,130,11201,16078,26280,0,0,0,1,1
57377,130,11202,16383,26280,0,0,0,1,1
57378,130,11203,16135,26280,0,0,0,1,1
57379,130,11204,16228;16512,26280,0,0,0,2,2
57380,130,11205,16389,26280,0,0,0,1,1
57381,130,11206,15605;16110,26280,0,0,0,2,2
57382,130,11207,16572,26280,0,0,0,1,1
57383,130,11209,16087;16145,26280,0,0,0,2,2
57384,130,11210,16490,26280,0,0,0,1,1
57385,130,11211,16425,26280,0,0,0,1,1
57386,130,11212,16193,26280,0,0,0,1,1
57387,130,11215,16493,26280,0,0,0,1,1
57388,130,11216,16269;16276,26280,0,0,0,2,2
57389,130,11217,15898;16280,26280,0,0,0,2,2
57390,130,11218,15663,26280,0,0,0,1,1
57391,130,11220,16833;16835,26280,0,0,0,2,2
57392,130,11221,16212;16841,26280,0,0,0,2,2
57393,130,11222,16248;16856;21379;23838;24067,26280,0,2,1,2,5
57394,130,11223,16671,26280,0,0,0,1,1
57395,130,11225,16086,26280,0,0,0,1,1
57396,130,11227,16373;16514,26280,0,0,0,2,2
57397,130,11229,16399;16426,26280,0,0,0,2,2
57398,130,11230,16416;16670,26280,0,0,0,2,2
57399,130,11231,16693;17000,26280,0,0,0,2,2
57400,130,11232,16453;16469,26280,0,0,0,2,2
57401,130,11233,16802,26280,0,0,0,1,1
57402,130,11234,20258;20532;20603;20647;23276;23914;24026;24124;24238;24698;24811;25018,26280,2,5,5,0,12
57403,130,11235,16504;16674,26280,0,0,0,2,2
57404,130,11236,16629,26280,0,0,0,1,1
57405,130,11237,16527;16865,26280,0,0,0,2,2
57406,130,11271,14006,26645,0,0,0,1,1
57407,130,11279,14535,26645,0,0,0,1,1
57408,130,11286,15211,26645,0,0,0,1,1
57409,130,11288,14534,26645,0,0,0,1,1
57410,130,11290,15046;15893,26645,0,0,0,2,2
57411,130,11291,15815;15909,26645,0,0,0,2,2
57412,130,11295,20236;20517;22870;23350;23561;23996;24210,26645,0,3,4,0,7
57413,130,11298,14949;15493,26645,0,0,0,2,2
57414,130,11301,15451;15538,26645,0,0,0,2,2
57415,130,11304,15753,26645,0,0,0,1,1
57416,130,11309,15931,26645,0,0,0,1,1
57417,130,11310,15764,26645,0,0,0,1,1
57418,130,11311,15841,26645,0,0,0,1,1
57419,130,11312,16394,26645,0,0,0,1,1
57420,130,11314,15919;16480,26645,0,0,0,2,2
57421,130,11316,15953,26645,0,0,0,1,1
57422,130,11317,16443;16479,26645,0,0,0,2,2
57423,130,11318,15999,26645,0,0,0,1,1
57424,130,11319,16214;20894,26645,0,0,1,1,2
57425,130,11320,16016;16198,26645,0,0,0,2,2
57426,130,11322,16038;16088,26645,0,0,0,2,2
57427,130,11323,15977;16603,26645,0,0,0,2,2
57428,130,11324,16958,26645,0,0,0,1,1
57429,130,11325,16250,26645,0,0,0,1,1
57430,130,11327,16532,26645,0,0,0,1,1
57431,130,11330,16277;16855,26645,0,0,0,2,2
57432,130,11331,16633,26645,0,0,0,1,1
57433,130,11332,15616;16164,26645,0,0,0,2,2
57434,130,11333,16398,26645,0,0,0,1,1
57435,130,11334,15732;16420,26645,0,0,0,2,2
57436,130,11336,16223,26645,0,0,0,1,1
57437,130,11337,16495;16732,26645,0,0,0,2,2
57438,130,11338,16256;16506,26645,0,0,0,2,2
57439,130,11339,16232;16798,26645,0,0,0,2,2
57440,130,11340,16378;16529,26645,0,0,0,2,2
57441,130,11341,16560,26645,0,0,0,1,1
57442,130,11342,16543;16561,26645,0,0,0,2,2
57443,130,11344,16576,26645,0,0,0,1,1
57444,130,11345,16008;16577,26645,0,0,0,2,2
57445,130,11347,16811,26645,0,0,0,1,1
57446,130,11348,16593,26645,0,0,0,1,1
57447,130,11349,16557;16606,26645,0,0,0,2,2
57448,130,11350,16607;17062,26645,0,0,0,2,2
57449,130,11351,16620,26645,0,0,0,1,1
57450,130,11352,16622;16966,26645,0,0,0,2,2
57451,130,11353,17046,26645,0,0,0,1,1
57452,130,11354,16635,26645,0,0,0,1,1
57453,130,11355,16648,26645,0,0,0,1,1
57454,130,11356,15951;16093,26645,0,0,0,2,2
57455,130,11357,16654,26645,0,0,0,1,1
57456,130,11358,16703,26645,0,0,0,1,1
57457,130,11359,16413;16728,26645,0,0,0,2,2
57458,130,11397,15157,27010,0,0,0,1,1
57459,130,11410,15513,27010,0,0,0,1,1
57460,130,11411,15518,27010,0,0,0,1,1
57461,130,11413,15071,27010,0,0,0,1,1
57462,130,11415,15188,27010,0,0,0,1,1
57463,130,11421,15371,27010,0,0,0,1,1
57464,130,11425,16350,27010,0,0,0,1,1
57465,130,11426,16308,27010,0,0,0,1,1
57466,130,11427,15028;15692,27010,0,0,0,2,2
57467,130,11428,15656,27010,0,0,0,1,1
57468,130,11429,15725,27010,0,0,0,1,1
57469,130,11430,16537,27010,0,0,0,1,1
57470,130,11433,15836,27010,0,0,0,1,1
57471,130,11434,15685;15780,27010,0,0,0,2,2
57472,130,11437,15934;15984,27010,0,0,0,2,2
57473,130,11440,15820,27010,0,0,0,1,1
57474,130,11442,16042;16446,27010,0,0,0,2,2
57475,130,11443,15903;16084,27010,0,0,0,2,2
57476,130,11445,16492;16664,27010,0,0,0,2,2
57477,130,11447,16183,27010,0,0,0,1,1
57478,130,11448,16623;17037,27010,0,0,0,2,2
57479,130,11449,16552;17065,27010,0,0,0,2,2
57480,130,11450,15800;16440,27010,0,0,0,2,2
57481,130,11452,16307;16761,27010,0,0,0,2,2
57482,130,11453,16759,27010,0,0,0,1,1
57483,130,11455,16376;16588,27010,0,0,0,2,2
57484,130,11456,16404,27010,0,0,0,1,1
57485,130,11458,16422,27010,0,0,0,1,1
57486,130,11459,16679;16756,27010,0,0,0,2,2
57487,130,11460,16972;17204,27010,0,0,0,2,2
57488,130,11463,16260;16779,27010,0,0,0,2,2
57489,130,11464,16751;16857,27010,0,0,0,2,2
57490,130,11465,16148;16546,27010,0,0,0,2,2
57491,130,11466,16553,27010,0,0,0,1,1
57492,130,11467,16159;16562,27010,0,0,0,2,2
57493,130,11468,16270;16563;20433;24010;24115,27010,0,2,1,2,5
57494,130,11469,16764,27010,0,0,0,1,1
57495,130,11470,16245,27010,0,0,0,1,1
57496,130,11471,16608;16930,27010,0,0,0,2,2
57497,130,11472,16432;16815,27010,0,0,0,2,2
57498,130,11473,16685,27010,0,0,0,1,1
57499,130,11474,16694;17106,27010,0,0,0,2,2
57500,130,11475,16875,27010,0,0,0,1,1
57501,130,11476,16659;16947;19949;22621,27010,0,0,2,2,4
57502,130,11477,16725;17068,27010,0,0,0,2,2
57503,130,11478,16980;17074,27010,0,0,0,2,2
57504,130,11479,16386;16738,27010,0,0,0,2,2
57505,130,11480,16974,27010,0,0,0,1,1
57506,130,11481,16766;17119,27010,0,0,0,2,2
57507,130,11482,16343;16783,27010,0,0,0,2,2
57508,130,11483,16799;17015,27010,0,0,0,2,2
57509,130,11484,16305;16357,27010,0,0,0,2,2
57510,130,11485,16520;16617,27010,0,0,0,2,2
57511,130,11486,16850,27010,0,0,0,1,1
57512,130,11525,15190,27375,0,0,0,1,1
57513,130,11528,14926,27375,0,0,0,1,1
57514,130,11529,14653;15232,27375,0,0,0,2,2
57515,130,11535,14793,27375,0,0,0,1,1
57516,130,11536,14950,27375,0,0,0,1,1
57517,130,11540,15343,27375,0,0,0,1,1
57518,130,11544,15987,27375,0,0,0,1,1
57519,130,11546,15955,27375,0,0,0,1,1
57520,130,11548,15812,27375,0,0,0,1,1
57521,130,11549,15434;15817,27375,0,0,0,2,2
57522,130,11550,16249,27375,0,0,0,1,1
57523,130,11552,15879,27375,0,0,0,1,1
57524,130,11555,15717,27375,0,0,0,1,1
57525,130,11556,16179,27375,0,0,0,1,1
57526,130,11557,16278,27375,0,0,0,1,1
57527,130,11558,20273;20305;23353;23566,27375,0,1,3,0,4
57528,130,11561,15491,27375,0,0,0,1,1
57529,130,11562,16194,27375,0,0,0,1,1
57530,130,11563,15704;16081,27375,0,0,0,2,2
57531,130,11564,16339,27375,0,0,0,1,1
57532,130,11565,16195,27375,0,0,0,1,1
57533,130,11566,16364,27375,0,0,0,1,1
57534,130,11567,16234;16771,27375,0,0,0,2,2
57535,130,11568,16236,27375,0,0,0,1,1
57536,130,11570,16097;16286,27375,0,0,0,2,2
57537,130,11572,16226,27375,0,0,0,1,1
57538,130,11573,16072;16310,27375,0,0,0,2,2
57539,130,11574,16580,27375,0,0,0,1,1
57540,130,11575,16396;16821,27375,0,0,0,2,2
57541,130,11576,16613,27375,0,0,0,1,1
57542,130,11577,16293,27375,0,0,0,1,1
57543,130,11578,16476,27375,0,0,0,1,1
57544,130,11579,16254;16661,27375,0,0,0,2,2
57545,130,11580,16549,27375,0,0,0,1,1
57546,130,11582,16424,27375,0,0,0,1,1
57547,130,11583,16297;16565;20460;24011;25015,27375,1,1,1,2,5
57548,130,11584,16609,27375,0,0,0,1,1
57549,130,11586,16812,27375,0,0,0,1,1
57550,130,11587,17188;17592,27375,0,0,0,2,2
57551,130,11588,16427,27375,0,0,0,1,1
57552,130,11589,17137,27375,0,0,0,1,1
57553,130,11590,17117,27375,0,0,0,1,1
57554,130,11595,16763;16927,27375,0,0,0,2,2
57555,130,11596,16768,27375,0,0,0,1,1
57556,130,11597,16845;17035,27375,0,0,0,2,2
57557,130,11598,16455;16846,27375,0,0,0,2,2
57558,130,11599,17053,27375,0,0,0,1,1
57559,130,11600,17029;17101,27375,0,0,0,2,2
57560,130,11601,17328,27375,0,0,0,1,1
57561,130,11602,16545;16891,27375,0,0,0,2,2
57562,130,11603,16294,27375,0,0,0,1,1
57563,130,11604,16941;17087,27375,0,0,0,2,2
57564,130,11605,16792;16899,27375,0,0,0,2,2
57565,130,11606,16924;16928,27375,0,0,0,2,2
57566,130,11607,16932,27375,0,0,0,1,1
57567,130,11608,16945,27375,0,0,0,1,1
57568,130,11609,16697,27375,0,0,0,1,1
57569,130,11610,16964,27375,0,0,0,1,1
57570,130,11648,14980,27740,0,0,0,1,1
57571,130,11649,15407,27740,0,0,0,1,1
57572,130,11653,15633,27740,0,0,0,1,1
57573,130,11657,15237;15620,27740,0,0,0,2,2
57574,130,11658,15751,27740,0,0,0,1,1
57575,130,11659,16570,27740,0,0,0,1,1
57576,130,11660,15805,27740,0,0,0,1,1
57577,130,11662,16750;16837,27740,0,0,0,2,2
57578,130,11663,16579,27740,0,0,0,1,1
57579,130,11664,16801,27740,0,0,0,1,1
57580,130,11665,16075,27740,0,0,0,1,1
57581,130,11667,15870;16523,27740,0,0,0,2,2
57582,130,11670,16859,27740,0,0,0,1,1
57583,130,11671,16720;17100,27740,0,0,0,2,2
57584,130,11673,16074,27740,0,0,0,1,1
57585,130,11674,16393;16991,27740,0,0,0,2,2
57586,130,11675,16774,27740,0,0,0,1,1
57587,130,11676,16441;17221,27740,0,0,0,2,2
57588,130,11677,16244,27740,0,0,0,1,1
57589,130,11678,16449;16585,27740,0,0,0,2,2
57590,130,11679,16451;16935,27740,0,0,0,2,2
57591,130,11682,16825;17038,27740,0,0,0,2,2
57592,130,11683,16316;16968;21248,27740,0,0,1,2,3
57593,130,11684,16640;16840,27740,0,0,0,2,2
57594,130,11685,16642,27740,0,0,0,1,1
57595,130,11686,16202;16675,27740,0,0,0,2,2
57596,130,11687,16678,27740,0,0,0,1,1
57597,130,11688,17408,27740,0,0,0,1,1
57598,130,11689,16688;16820;20830;24141;24327;24712;24922,27740,1,3,1,2,7
57599,130,11690,16178;16692,27740,0,0,0,2,2
57600,130,11691,16698;16869,27740,0,0,0,2,2
57601,130,11692,16838,27740,0,0,0,1,1
57602,130,11693,16656,27740,0,0,0,1,1
57603,130,11694,16605,27740,0,0,0,1,1
57604,130,11696,16733,27740,0,0,0,1,1
57605,130,11697,16918;17124,27740,0,0,0,2,2
57606,130,11698,17047;17475,27740,0,0,0,2,2
57607,130,11699,16843,27740,0,0,0,1,1
57608,130,11700,17301,27740,0,0,0,1,1
57609,130,11701,16877;17397,27740,0,0,0,2,2
57610,130,11702,17277;17357,27740,0,0,0,2,2
57611,130,11703,17157,27740,0,0,0,1,1
57612,130,11704,16922,27740,0,0,0,1,1
57613,130,11706,16795;17125,27740,0,0,0,2,2
57614,130,11707,16990;17322,27740,0,0,0,2,2
57615,130,11709,16632;17005,27740,0,0,0,2,2
57616,130,11710,16923;17084,27740,0,0,0,2,2
57617,130,11711,17048,27740,0,0,0,1,1
57618,130,11712,16592;17040,27740,0,0,0,2,2
57619,130,11713,17044;17337,27740,0,0,0,2,2
57620,130,11714,16359;16897,27740,0,0,0,2,2
57621,130,11715,16597;17181,27740,0,0,0,2,2
57622,130,11716,16672;17079,27740,0,0,0,2,2
57623,130,11717,17308;17473,27740,0,0,0,2,2
57624,130,11748,14909,28105,0,0,0,1,1
57625,130,11750,15327,28105,0,0,0,1,1
57626,130,11751,15443,28105,0,0,0,1,1
57627,130,11756,15344,28105,0,0,0,1,1
57628,130,11757,15554,28105,0,0,0,1,1
57629,130,11761,14914;15470,28105,0,0,0,2,2
57630,130,11763,16482,28105,0,0,0,1,1
57631,130,11765,15806,28105,0,0,0,1,1
57632,130,11767,15873,28105,0,0,0,1,1
57633,130,11772,16414,28105,0,0,0,1,1
57634,130,11773,16171;16241,28105,0,0,0,2,2
57635,130,11774,16345;16438,28105,0,0,0,2,2
57636,130,11775,16714,28105,0,0,0,1,1
57637,130,11778,16909,28105,0,0,0,1,1
57638,130,11779,16457,28105,0,0,0,1,1
57639,130,11780,16474;16823,28105,0,0,0,2,2
57640,130,11781,16540,28105,0,0,0,1,1
57641,130,11782,16665,28105,0,0,0,1,1
57642,130,11783,16722,28105,0,0,0,1,1
57643,130,11784,15913;15961,28105,0,0,0,2,2
57644,130,11785,17041,28105,0,0,0,1,1
57645,130,11789,16773;17140,28105,0,0,0,2,2
57646,130,11790,16313,28105,0,0,0,1,1
57647,130,11791,17098,28105,0,0,0,1,1
57648,130,11793,16788,28105,0,0,0,1,1
57649,130,11794,16508;16790,28105,0,0,0,2,2
57650,130,11795,16791;17423,28105,0,0,0,2,2
57651,130,11797,16534;16809,28105,0,0,0,2,2
57652,130,11798,16826;17061;21478,28105,0,0,1,2,3
57653,130,11799,16784;16831,28105,0,0,0,2,2
57654,130,11800,16921;16995,28105,0,0,0,2,2
57655,130,11801,17214;17298,28105,0,0,0,2,2
57656,130,11802,17420,28105,0,0,0,1,1
57657,130,11803,17314,28105,0,0,0,1,1
57658,130,11806,16465,28105,0,0,0,1,1
57659,130,11807,17520,28105,0,0,0,1,1
57660,130,11808,16969,28105,0,0,0,1,1
57661,130,11809,16975,28105,0,0,0,1,1
57662,130,11810,17073,28105,0,0,0,1,1
57663,130,11812,16796;17054,28105,0,0,0,2,2
57664,130,11813,17429,28105,0,0,0,1,1
57665,130,11814,17105;17536,28105,0,0,0,2,2
57666,130,11815,17497,28105,0,0,0,1,1
57667,130,11816,16986;17162,28105,0,0,0,2,2
57668,130,11817,16985;17108,28105,0,0,0,2,2
57669,130,11818,17405;17590,28105,0,0,0,2,2
57670,130,11819,17027;17152,28105,0,0,0,2,2
57671,130,11820,17142;17269,28105,0,0,0,2,2
57672,130,11821,17347;17519;19926;23868,28105,0,1,1,2,4
57673,130,11822,17193,28105,0,0,0,1,1
57674,130,11824,17222,28105,0,0,0,1,1
57675,130,11825,17223,28105,0,0,0,1,1
57676,130,11864,14265,28470,0,0,0,1,1
57677,130,11866,14592,28470,0,0,0,1,1
57678,130,11873,14896,28470,0,0,0,1,1
57679,130,11877,14969,28470,0,0,0,1,1
57680,130,11879,14848,28470,0,0,0,1,1
57681,130,11886,15852,28470,0,0,0,1,1
57682,130,11890,15503,28470,0,0,0,1,1
57683,130,11894,15980;16158,28470,0,0,0,2,2
57684,130,11895,15969,28470,0,0,0,1,1
57685,130,11896,16129,28470,0,0,0,1,1
57686,130,11898,15887,28470,0,0,0,1,1
57687,130,11900,16351,28470,0,0,0,1,1
57688,130,11901,16499,28470,0,0,0,1,1
57689,130,11902,16242;16484,28470,0,0,0,2,2
57690,130,11904,16259;16485,28470,0,0,0,2,2
57691,130,11905,16285,28470,0,0,0,1,1
57692,130,11906,16380;17272,28470,0,0,0,2,2
57693,130,11907,16406,28470,0,0,0,1,1
57694,130,11908,16710;16949,28470,0,0,0,2,2
57695,130,11909,17082,28470,0,0,0,1,1
57696,130,11910,16408,28470,0,0,0,1,1
57697,130,11911,16885,28470,0,0,0,1,1
57698,130,11912,16876,28470,0,0,0,1,1
57699,130,11913,16702,28470,0,0,0,1,1
57700,130,11914,16682;16900,28470,0,0,0,2,2
57701,130,11915,16392;16730,28470,0,0,0,2,2
57702,130,11916,16587;16747,28470,0,0,0,2,2
57703,130,11917,17375,28470,0,0,0,1,1
57704,130,11918,17512;21567;23957;24367,28470,0,2,1,1,4
57705,130,11919,16905;17008,28470,0,0,0,2,2
57706,130,11920,16950,28470,0,0,0,1,1
57707,130,11921,16962,28470,0,0,0,1,1
57708,130,11923,17440;17441,28470,0,0,0,2,2
57709,130,11924,16989;17424,28470,0,0,0,2,2
57710,130,11925,16911;17496,28470,0,0,0,2,2
57711,130,11926,17438;17499,28470,0,0,0,2,2
57712,130,11927,17191;17402;21923,28470,0,0,1,2,3
57713,130,11928,16917;17036,28470,0,0,0,2,2
57714,130,11929,20771;21234;24167;24628,28470,0,2,2,0,4
57715,130,11930,16931;17097,28470,0,0,0,2,2
57716,130,11931,17104,28470,0,0,0,1,1
57717,130,11932,17422;17575,28470,0,0,0,2,2
57718,130,11933,16839;17148,28470,0,0,0,2,2
57719,130,11934,17011;17156,28470,0,0,0,2,2
57720,130,11935,17189,28470,0,0,0,1,1
57721,130,11936,17845,28470,0,0,0,1,1
57722,130,11937,17014;17201,28470,0,0,0,2,2
57723,130,11938,17200,28470,0,0,0,1,1
57724,130,11940,17147;17227,28470,0,0,0,2,2
57725,130,11941,16892;17231,28470,0,0,0,2,2
57726,130,11942,16666;17234,28470,0,0,0,2,2
57727,130,11943,17244;17246,28470,0,0,0,2,2
57728,130,11944,17256;17320;20107,28470,0,0,1,2,3
57729,130,11946,17284;17673,28470,0,0,0,2,2
57730,130,11947,17237;17509,28470,0,0,0,2,2
57731,130,11948,17312;17457,28470,0,0,0,2,2
57732,130,11949,17344;17492,28470,0,0,0,2,2
57733,130,11985,14688;15100,28835,0,0,0,2,2
57734,130,11990,15553,28835,0,0,0,1,1
57735,130,11991,15345;16150,28835,0,0,0,2,2
57736,130,11992,16170,28835,0,0,0,1,1
57737,130,11995,15235,28835,0,0,0,1,1
57738,130,11997,16053;16142,28835,0,0,0,2,2
57739,130,12000,16076,28835,0,0,0,1,1
57740,130,12007,16387,28835,0,0,0,1,1
57741,130,12009,16558,28835,0,0,0,1,1
57742,130,12012,16356,28835,0,0,0,1,1
57743,130,12013,16735;16983,28835,0,0,0,2,2
57744,130,12016,17174,28835,0,0,0,1,1
57745,130,12017,17218;17374,28835,0,0,0,2,2
57746,130,12019,16517;17059,28835,0,0,0,2,2
57747,130,12020,17595,28835,0,0,0,1,1
57748,130,12021,16847;16874,28835,0,0,0,2,2
57749,130,12023,17213,28835,0,0,0,1,1
57750,130,12025,17326,28835,0,0,0,1,1
57751,130,12027,16770;16926,28835,0,0,0,2,2
57752,130,12028,17533,28835,0,0,0,1,1
57753,130,12029,17210;17527,28835,0,0,0,2,2
57754,130,12032,17632,28835,0,0,0,1,1
57755,130,12033,17551,28835,0,0,0,1,1
57756,130,12034,17605,28835,0,0,0,1,1
57757,130,12035,17034;17531,28835,0,0,0,2,2
57758,130,12036,17052;17131,28835,0,0,0,2,2
57759,130,12037,17395,28835,0,0,0,1,1
57760,130,12038,17066;17381,28835,0,0,0,2,2
57761,130,12039,17295;17406,28835,0,0,0,2,2
57762,130,12040,17687,28835,0,0,0,1,1
57763,130,12041,16830;17123,28835,0,0,0,2,2
57764,130,12042,17091;17143,28835,0,0,0,2,2
57765,130,12043,17144;17207,28835,0,0,0,2,2
57766,130,12044,16888,28835,0,0,0,1,1
57767,130,12045,17430,28835,0,0,0,1,1
57768,130,12046,17493,28835,0,0,0,1,1
57769,130,12047,17435;17557,28835,0,0,0,2,2
57770,130,12048,17704;17956;21687;23848;24655,28835,0,2,1,2,5
57771,130,12049,17060;17239,28835,0,0,0,2,2
57772,130,12051,16982;17248,28835,0,0,0,2,2
57773,130,12053,16817;17288,28835,0,0,0,2,2
57774,130,12054,16477;17307,28835,0,0,0,2,2
57775,130,12055,17323;17580,28835,0,0,0,2,2
57776,130,12056,17331;17392,28835,0,0,0,2,2
57777,130,12059,17206;17372;22502,28835,0,0,1,2,3
57778,130,12061,17788,28835,0,0,0,1,1
57779,130,12062,17671;21928,28835,0,0,1,1,2
57780,130,12063,17270;17588,28835,0,0,0,2,2
57781,130,12064,17619,28835,0,0,0,1,1
57782,130,12083,13713,29200,0,0,0,1,1
57783,130,12098,14554;14994,29200,0,0,0,2,2
57784,130,12101,15167,29200,0,0,0,1,1
57785,130,12106,15408,29200,0,0,0,1,1
57786,130,12111,16204,29200,0,0,0,1,1
57787,130,12112,15935,29200,0,0,0,1,1
57788,130,12115,16711,29200,0,0,0,1,1
57789,130,12117,16342,29200,0,0,0,1,1
57790,130,12118,16004;16862,29200,0,0,0,2,2
57791,130,12119,16462,29200,0,0,0,1,1
57792,130,12120,16109;16165,29200,0,0,0,2,2
57793,130,12123,16298,29200,0,0,0,1,1
57794,130,12124,17107,29200,0,0,0,1,1
57795,130,12125,16800,29200,0,0,0,1,1
57796,130,12126,16518;16904,29200,0,0,0,2,2
57797,130,12127,16528;16977,29200,0,0,0,2,2
57798,130,12129,16591;17133,29200,0,0,0,2,2
57799,130,12131,15861;16621,29200,0,0,0,2,2
57800,130,12132,16813;17447,29200,0,0,0,2,2
57801,130,12133,16535,29200,0,0,0,1,1
57802,130,12134,16658;16719;20760;23286;24498,29200,0,1,2,2,5
57803,130,12135,16933;17010,29200,0,0,0,2,2
57804,130,12136,16828;17296,29200,0,0,0,2,2
57805,130,12137,16834,29200,0,0,0,1,1
57806,130,12138,16014,29200,0,0,0,1,1
57807,130,12141,17348,29200,0,0,0,1,1
57808,130,12142,17019;17165,29200,0,0,0,2,2
57809,130,12143,16997;17042,29200,0,0,0,2,2
57810,130,12144,17706,29200,0,0,0,1,1
57811,130,12145,17075;17230,29200,0,0,0,2,2
57812,130,12146,17129;21620;25241,29200,1,0,1,1,3
57813,130,12149,17327,29200,0,0,0,1,1
57814,130,12150,17485,29200,0,0,0,1,1
57815,130,12151,17672,29200,0,0,0,1,1
57816,130,12152,17093;17294,29200,0,0,0,2,2
57817,130,12153,16871;17254,29200,0,0,0,2,2
57818,130,12154,20475,29200,0,0,1,0,1
57819,130,12155,17280;17875,29200,0,0,0,2,2
57820,130,12156,17300,29200,0,0,0,1,1
57821,130,12157,17184;17316,29200,0,0,0,2,2
57822,130,12158,17171;17360,29200,0,0,0,2,2
57823,130,12160,17602;17616,29200,0,0,0,2,2
57824,130,12161,17635,29200,0,0,0,1,1
57825,130,12162,17710;17896,29200,0,0,0,2,2
57826,130,12163,17500;17846,29200,0,0,0,2,2
57827,130,12164,17340;17505,29200,0,0,0,2,2
57828,130,12165,17828,29200,0,0,0,1,1
57829,130,12166,17733,29200,0,0,0,1,1
57830,130,12167,17761;21875,29200,0,0,1,1,2
57831,130,12168,17554,29200,0,0,0,1,1
57832,130,12169,17643;17878,29200,0,0,0,2,2
57833,130,12208,14745,29565,0,0,0,1,1
57834,130,12218,15840,29565,0,0,0,1,1
57835,130,12219,16400,29565,0,0,0,1,1
57836,130,12221,15404;15983,29565,0,0,0,2,2
57837,130,12222,16062,29565,0,0,0,1,1
57838,130,12226,16612,29565,0,0,0,1,1
57839,130,12227,16134,29565,0,0,0,1,1
57840,130,12228,20501,29565,0,0,1,0,1
57841,130,12229,16309,29565,0,0,0,1,1
57842,130,12231,17050,29565,0,0,0,1,1
57843,130,12234,15572;16415,29565,0,0,0,2,2
57844,130,12236,16156;16496,29565,0,0,0,2,2
57845,130,12237,16564,29565,0,0,0,1,1
57846,130,12238,16128;16824,29565,0,0,0,2,2
57847,130,12239,16906,29565,0,0,0,1,1
57848,130,12240,17247,29565,0,0,0,1,1
57849,130,12242,16715;17329,29565,0,0,0,2,2
57850,130,12243,16767;17469;21663;23847,29565,0,1,1,2,4
57851,130,12244,16781,29565,0,0,0,1,1
57852,130,12246,16555,29565,0,0,0,1,1
57853,130,12247,17116,29565,0,0,0,1,1
57854,130,12248,16643;16916,29565,0,0,0,2,2
57855,130,12249,16956;17154,29565,0,0,0,2,2
57856,130,12250,17541,29565,0,0,0,1,1
57857,130,12251,17004;17522,29565,0,0,0,2,2
57858,130,12253,17146,29565,0,0,0,1,1
57859,130,12254,17045;17464,29565,0,0,0,2,2
57860,130,12255,17088;17163,29565,0,0,0,2,2
57861,130,12256,16946;17099,29565,0,0,0,2,2
57862,130,12257,17380;17401,29565,0,0,0,2,2
57863,130,12258,16680;17176,29565,0,0,0,2,2
57864,130,12259,17017;17663,29565,0,0,0,2,2
57865,130,12260,17134;17404,29565,0,0,0,2,2
57866,130,12262,17243,29565,0,0,0,1,1
57867,130,12263,17109;17245,29565,0,0,0,2,2
57868,130,12264,17077;17262,29565,0,0,0,2,2
57869,130,12265,17271;17662;20784;24034,29565,0,1,1,2,4
57870,130,12266,16901;17285,29565,0,0,0,2,2
57871,130,12267,17364,29565,0,0,0,1,1
57872,130,12268,17198;17389,29565,0,0,0,2,2
57873,130,12269,17400;17923;22067,29565,0,0,1,2,3
57874,130,12270,18042;18047;21404;22280;24568;25056;25190,29565,2,1,2,2,7
57875,130,12271,21772;21815,29565,0,0,2,0,2
57876,130,12272,17431;17491,29565,0,0,0,2,2
57877,130,12273,17566;17742,29565,0,0,0,2,2
57878,130,12275,17453;17460,29565,0,0,0,2,2
57879,130,12276,17507;21924,29565,0,0,1,1,2
57880,130,12277,17003;17463,29565,0,0,0,2,2
57881,130,12278,17487;17807;20325;23171;23786,29565,0,1,2,2,5
57882,130,12279,17118;17489,29565,0,0,0,2,2
57883,130,12280,17768,29565,0,0,0,1,1
57884,130,12281,17658;18034,29565,0,0,0,2,2
57885,130,12282,17182;17523;21092,29565,0,0,1,2,3
57886,130,12283,17832;17955,29565,0,0,0,2,2
57887,130,12285,17591;17805,29565,0,0,0,2,2
57888,130,12287,17433;17604,29565,0,0,0,2,2
57889,130,12288,17069;17617,29565,0,0,0,2,2
57890,130,12289,17333;17621,29565,0,0,0,2,2
57891,130,12290,17572;17622,29565,0,0,0,2,2
57892,130,12292,17330;17656,29565,0,0,0,2,2
57893,130,12293,17684,29565,0,0,0,1,1
57894,130,12321,14218,29930,0,0,0,1,1
57895,130,12327,14403,29930,0,0,0,1,1
57896,130,12333,15777,29930,0,0,0,1,1
57897,130,12334,15243,29930,0,0,0,1,1
57898,130,12335,15590;15724,29930,0,0,0,2,2
57899,130,12342,15804,29930,0,0,0,1,1
57900,130,12345,17136,29930,0,0,0,1,1
57901,130,12347,16384,29930,0,0,0,1,1
57902,130,12348,16816,29930,0,0,0,1,1
57903,130,12349,16943,29930,0,0,0,1,1
57904,130,12350,16743,29930,0,0,0,1,1
57905,130,12352,16827,29930,0,0,0,1,1
57906,130,12356,16818,29930,0,0,0,1,1
57907,130,12357,16848;17112,29930,0,0,0,2,2
57908,130,12358,16993;17024,29930,0,0,0,2,2
57909,130,12359,17439;17445;20695;24315;24591,29930,0,2,1,2,5
57910,130,12360,16410;17051,29930,0,0,0,2,2
57911,130,12361,17002;17126,29930,0,0,0,2,2
57912,130,12362,16445;17135,29930,0,0,0,2,2
57913,130,12363,18088,29930,0,0,0,1,1
57914,130,12365,16776;17179,29930,0,0,0,2,2
57915,130,12366,17185,29930,0,0,0,1,1
57916,130,12367,17315,29930,0,0,0,1,1
57917,130,12368,16860;17278,29930,0,0,0,2,2
57918,130,12369,17437;21190;24843,29930,1,0,1,1,3
57919,130,12370,16624;17164,29930,0,0,0,2,2
57920,130,12371,17418;17972;21944;24882,29930,1,0,1,2,4
57921,130,12372,17007,29930,0,0,0,1,1
57922,130,12374,17675;17717,29930,0,0,0,2,2
57923,130,12375,17488;17943;21324;24441,29930,0,1,1,2,4
57924,130,12376,17540;17840,29930,0,0,0,2,2
57925,130,12377,17335;17586,29930,0,0,0,2,2
57926,130,12378,17451;17719,29930,0,0,0,2,2
57927,130,12380,17637;17756,29930,0,0,0,2,2
57928,130,12381,17661;18067;20704,29930,0,0,1,2,3
57929,130,12382,16881;17669,29930,0,0,0,2,2
57930,130,12383,17385;17677;21761,29930,0,0,1,2,3
57931,130,12384,17723,29930,0,0,0,1,1
57932,130,12385,17456;17737;20877,29930,0,0,1,2,3
57933,130,12387,17994;18512;22177,29930,0,0,2,1,3
57934,130,12388,17483;17796,29930,0,0,0,2,2
57935,130,12390,17382;17801,29930,0,0,0,2,2
57936,130,12407,13804,30295,0,0,0,1,1
57937,130,12424,15054,30295,0,0,0,1,1
57938,130,12425,15455,30295,0,0,0,1,1
57939,130,12432,15417,30295,0,0,0,1,1
57940,130,12433,15468,30295,0,0,0,1,1
57941,130,12436,16334;16354,30295,0,0,0,2,2
57942,130,12440,16973,30295,0,0,0,1,1
57943,130,12443,16325;16746,30295,0,0,0,2,2
57944,130,12444,16430;16494,30295,0,0,0,2,2
57945,130,12445,16516;16867,30295,0,0,0,2,2
57946,130,12446,17023,30295,0,0,0,1,1
57947,130,12447,16513;16655,30295,0,0,0,2,2
57948,130,12449,17175,30295,0,0,0,1,1
57949,130,12450,16619,30295,0,0,0,1,1
57950,130,12453,16789,30295,0,0,0,1,1
57951,130,12455,16677;16955,30295,0,0,0,2,2
57952,130,12457,16936;17482,30295,0,0,0,2,2
57953,130,12458,17219,30295,0,0,0,1,1
57954,130,12460,16998;17211,30295,0,0,0,2,2
57955,130,12461,17535;17538,30295,0,0,0,2,2
57956,130,12462,16910,30295,0,0,0,1,1
57957,130,12463,17197;17394,30295,0,0,0,2,2
57958,130,12465,18203,30295,0,0,1,0,1
57959,130,12466,16913;16996,30295,0,0,0,2,2
57960,130,12467,17289;17547;21925,30295,0,0,1,2,3
57961,130,12468,16954;17302,30295,0,0,0,2,2
57962,130,12471,17346,30295,0,0,0,1,1
57963,130,12473,17765,30295,0,0,0,1,1
57964,130,12474,17141;17371,30295,0,0,0,2,2
57965,130,12475,17376;17378,30295,0,0,0,2,2
57966,130,12476,17057;17411,30295,0,0,0,2,2
57967,130,12477,17546,30295,0,0,0,1,1
57968,130,12478,17502;17824,30295,0,0,0,2,2
57969,130,12479,17349;17514,30295,0,0,0,2,2
57970,130,12480,17377;17739;22373,30295,0,0,1,2,3
57971,130,12481,17537;17653,30295,0,0,0,2,2
57972,130,12482,17574;17623,30295,0,0,0,2,2
57973,130,12483,17888;18021,30295,0,0,0,2,2
57974,130,12484,17585;17703,30295,0,0,0,2,2
57975,130,12485,18103;18221,30295,0,0,1,1,2
57976,130,12486,17606;18262,30295,0,0,1,1,2
57977,130,12487,17242;17608,30295,0,0,0,2,2
57978,130,12489,17685;17819,30295,0,0,0,2,2
57979,130,12490,18073;18160,30295,0,0,1,1,2
57980,130,12491,17726;17867,30295,0,0,0,2,2
57981,130,12492,18235,30295,0,0,1,0,1
57982,130,12493,17750,30295,0,0,0,1,1
57983,130,12494,17396,30295,0,0,0,1,1
57984,130,12495,17813,30295,0,0,0,1,1
57985,130,12496,16872;17900,30295,0,0,0,2,2
57986,130,12497,17646;17834,30295,0,0,0,2,2
57987,130,12500,17795;17902,30295,0,0,0,2,2
57988,130,12501,17526;17857,30295,0,0,0,2,2
57989,130,12502,17866;17975,30295,0,0,0,2,2
57990,130,12503,17645,30295,0,0,0,1,1
57991,130,12504,17205;17880,30295,0,0,0,2,2
57992,130,12505,17883;18135,30295,0,0,0,2,2
57993,130,12506,17561,30295,0,0,0,1,1
57994,130,12507,17918;18197,30295,0,0,1,1,2
57995,130,12538,14805,30660,0,0,0,1,1
57996,130,12545,16120,30660,0,0,0,1,1
57997,130,12565,16582,30660,0,0,0,1,1
57998,130,12566,16405;16598,30660,0,0,0,2,2
57999,130,12569,16487,30660,0,0,0,1,1
58000,130,12575,17720,30660,0,0,0,1,1
58001,130,12576,16978;17241,30660,0,0,0,2,2
58002,130,12577,17110;17524,30660,0,0,0,2,2
58003,130,12578,17121;17132,30660,0,0,0,2,2
58004,130,12579,17186,30660,0,0,0,1,1
58005,130,12580,17268;17387,30660,0,0,0,2,2
58006,130,12581,16844;17305;21611,30660,0,0,1,2,3
58007,130,12582,16762;17317,30660,0,0,0,2,2
58008,130,12583,17318;17352,30660,0,0,0,2,2
58009,130,12584,16976;17455,30660,0,0,0,2,2
58010,130,12585,17762;17887;22649,30660,0,0,1,2,3
58011,130,12586,17177;17630,30660,0,0,0,2,2
58012,130,12587,17130;17903,30660,0,0,0,2,2
58013,130,12589,17638;18072,30660,0,0,0,2,2
58014,130,12592,17510,30660,0,0,0,1,1
58015,130,12593,17568,30660,0,0,0,1,1
58016,130,12595,17250;17766,30660,0,0,0,2,2
58017,130,12596,17276;17882,30660,0,0,0,2,2
58018,130,12597,17861;17908,30660,0,0,0,2,2
58019,130,12599,18122,30660,0,0,0,1,1
58020,130,12600,17959,30660,0,0,0,1,1
58021,130,12601,17711,30660,0,0,0,1,1
58022,130,12603,17713;18164;21568,30660,0,0,2,1,3
58023,130,12604,17696;17735,30660,0,0,0,2,2
58024,130,12605,17741;18354,30660,0,0,1,1,2
58025,130,12606,18215,30660,0,0,1,0,1
58026,130,12607,17550;17783,30660,0,0,0,2,2
58027,130,12608,17151;17609,30660,0,0,0,2,2
58028,130,12610,17862;18126,30660,0,0,0,2,2
58029,130,12611,17494;17782,30660,0,0,0,2,2
58030,130,12612,17899;17951,30660,0,0,0,2,2
58031,130,12614,18232;18371,30660,0,0,2,0,2
58032,130,12615,17926,30660,0,0,0,1,1
58033,130,12618,17598;17957,30660,0,0,0,2,2
58034,130,12619,17789;17979,30660,0,0,0,2,2
58035,130,12620,17850,30660,0,0,0,1,1
58036,130,12621,18131;18349,30660,0,0,1,1,2
58037,130,12622,17837;18007;21205;23835;24731;25044,30660,1,2,1,2,6
58038,130,12623,18097;18230;21961,30660,0,0,2,1,3
58039,130,12624,17872;18024,30660,0,0,0,2,2
58040,130,12625,17515;17870,30660,0,0,0,2,2
58041,130,12626,18340,30660,0,0,1,0,1
58042,130,12627,17398;18046,30660,0,0,0,2,2
58043,130,12652,14512,31025,0,0,0,1,1
58044,130,12653,15140,31025,0,0,0,1,1
58045,130,12667,15632;16466,31025,0,0,0,2,2
58046,130,12668,15299;16029,31025,0,0,0,2,2
58047,130,12673,16684;17102,31025,0,0,0,2,2
58048,130,12674,15996,31025,0,0,0,1,1
58049,130,12677,16079;16718,31025,0,0,0,2,2
58050,130,12678,16525;16758,31025,0,0,0,2,2
58051,130,12680,17259,31025,0,0,0,1,1
58052,130,12682,16740;17255,31025,0,0,0,2,2
58053,130,12684,15908;17064,31025,0,0,0,2,2
58054,130,12689,17282;17738,31025,0,0,0,2,2
58055,130,12690,17192;17299,31025,0,0,0,2,2
58056,130,12692,17383,31025,0,0,0,1,1
58057,130,12693,17096;17370,31025,0,0,0,2,2
58058,130,12694,17033;17490,31025,0,0,0,2,2
58059,130,12697,18190;18200;22888,31025,0,0,3,0,3
58060,130,12699,18109,31025,0,0,0,1,1
58061,130,12700,17503;17674,31025,0,0,0,2,2
58062,130,12703,17534;17731,31025,0,0,0,2,2
58063,130,12704,17252;17803,31025,0,0,0,2,2
58064,130,12705,17942;18005;21228;23724,31025,0,1,1,2,4
58065,130,12706,17769;21695,31025,0,0,1,1,2
58066,130,12707,17644;17858,31025,0,0,0,2,2
58067,130,12708,17873;17986,31025,0,0,0,2,2
58068,130,12709,17558;17889,31025,0,0,0,2,2
58069,130,12710,18133,31025,0,0,0,1,1
58070,130,12711,17932,31025,0,0,0,1,1
58071,130,12712,17976,31025,0,0,0,1,1
58072,130,12713,17736;18199;22514,31025,0,0,2,1,3
58073,130,12714,18274;22774,31025,0,0,2,0,2
58074,130,12715,17744;18016,31025,0,0,0,2,2
58075,130,12716,17960;18022,31025,0,0,0,2,2
58076,130,12717,17869;18032,31025,0,0,0,2,2
58077,130,12718,18050;18281,31025,0,0,1,1,2
58078,130,12719,17599;18053,31025,0,0,0,2,2
58079,130,12720,18075;21963,31025,0,0,1,1,2
58080,130,12721,18163,31025,0,0,1,0,1
58081,130,12723,18185;18279,31025,0,0,2,0,2
58082,130,12724,18225,31025,0,0,1,0,1
58083,130,12725,17935;18134,31025,0,0,0,2,2
58084,130,12726,18096;18147;22512,31025,0,0,1,2,3
58085,130,12747,14543;14687,31390,0,0,0,2,2
58086,130,12748,14882,31390,0,0,0,1,1
58087,130,12762,15306;15904,31390,0,0,0,2,2
58088,130,12766,16017;16141,31390,0,0,0,2,2
58089,130,12767,16061;16463,31390,0,0,0,2,2
58090,130,12772,16041,31390,0,0,0,1,1
58091,130,12774,16731;16944,31390,0,0,0,2,2
58092,130,12777,16388;16727,31390,0,0,0,2,2
58093,130,12780,17190,31390,0,0,0,1,1
58094,130,12781,17345,31390,0,0,0,1,1
58095,130,12784,16864,31390,0,0,0,1,1
58096,130,12785,16868;17080,31390,0,0,0,2,2
58097,130,12786,16614,31390,0,0,0,1,1
58098,130,12788,17081,31390,0,0,0,1,1
58099,130,12790,17158,31390,0,0,0,1,1
58100,130,12791,17115,31390,0,0,0,1,1
58101,130,12795,17555;17570;21497;24956,31390,1,0,1,2,4
58102,130,12796,17094;17434,31390,0,0,0,2,2
58103,130,12798,17728;17729,31390,0,0,0,2,2
58104,130,12799,17238,31390,0,0,0,1,1
58105,130,12801,16952;17313,31390,0,0,0,2,2
58106,130,12802,17319;17495,31390,0,0,0,2,2
58107,130,12804,17351;17353,31390,0,0,0,2,2
58108,130,12806,17559,31390,0,0,0,1,1
58109,130,12808,17513;17865,31390,0,0,0,2,2
58110,130,12809,17155;17172,31390,0,0,0,2,2
58111,130,12810,17194;17528,31390,0,0,0,2,2
58112,130,12811,17615,31390,0,0,0,1,1
58113,130,12812,18277,31390,0,0,1,0,1
58114,130,12813,18089;18427,31390,0,0,1,1,2
58115,130,12814,17553,31390,0,0,0,1,1
58116,130,12815,17468;17714,31390,0,0,0,2,2
58117,130,12816,17715;17917,31390,0,0,0,2,2
58118,130,12817,17764;18114,31390,0,0,0,2,2
58119,130,12818,17787;18259;21730,31390,0,0,2,1,3
58120,130,12819,17874;18006,31390,0,0,0,2,2
58121,130,12821,17679;17854,31390,0,0,0,2,2
58122,130,12822,18405;18471,31390,0,0,2,0,2
58123,130,12823,17628;17920,31390,0,0,0,2,2
58124,130,12824,17937,31390,0,0,0,1,1
58125,130,12825,17871;17985,31390,0,0,0,2,2
58126,130,12826,18233;18398;22515,31390,0,0,3,0,3
58127,130,12827,17618;18267,31390,0,0,1,1,2
58128,130,12828,18348;18483;23001;25309,31390,1,0,3,0,4
58129,130,12829,17830;18004,31390,0,0,0,2,2
58130,130,12831,18083,31390,0,0,0,1,1
58131,130,12832,18179,31390,0,0,1,0,1
58132,130,12833,18090;18178,31390,0,0,1,1,2
58133,130,12834,17949;18401;21972,31390,0,0,2,1,3
58134,130,12835,17745,31390,0,0,0,1,1
58135,130,12836,18925,31390,0,0,1,0,1
58136,130,12837,18725;18785;22901,31390,0,0,3,0,3
58137,130,12839,17984;18238;22655,31390,0,0,2,1,3
58138,130,12854,14685,31755,0,0,0,1,1
58139,130,12863,15813,31755,0,0,0,1,1
58140,130,12865,15179,31755,0,0,0,1,1
58141,130,12871,15740,31755,0,0,0,1,1
58142,130,12877,16819,31755,0,0,0,1,1
58143,130,12879,17071;17419,31755,0,0,0,2,2
58144,130,12880,16419;16595,31755,0,0,0,2,2
58145,130,12881,16706;17076,31755,0,0,0,2,2
58146,130,12882,17149,31755,0,0,0,1,1
58147,130,12883,16105;16723,31755,0,0,0,2,2
58148,130,12884,17481;17665,31755,0,0,0,2,2
58149,130,12886,17249;17779,31755,0,0,0,2,2
58150,130,12887,17465,31755,0,0,0,1,1
58151,130,12889,17354,31755,0,0,0,1,1
58152,130,12890,16963,31755,0,0,0,1,1
58153,130,12891,17342,31755,0,0,0,1,1
58154,130,12892,17391;17444,31755,0,0,0,2,2
58155,130,12893,17466,31755,0,0,0,1,1
58156,130,12894,17472;18328,31755,0,0,1,1,2
58157,130,12895,17273,31755,0,0,0,1,1
58158,130,12896,17350;17611,31755,0,0,0,2,2
58159,130,12898,17641,31755,0,0,0,1,1
58160,130,12899,17369;17517,31755,0,0,0,2,2
58161,130,12900,17695;18336,31755,0,0,1,1,2
58162,130,12901,17128;17652,31755,0,0,0,2,2
58163,130,12902,17478;17780,31755,0,0,0,2,2
58164,130,12903,17790;21104;24839;24930;25037,31755,3,0,1,1,5
58165,130,12904,17579;17825,31755,0,0,0,2,2
58166,130,12905,18091,31755,0,0,0,1,1
58167,130,12906,17892,31755,0,0,0,1,1
58168,130,12907,18214;18437;22653;24684;25298,31755,1,1,3,0,5
58169,130,12908,17734;18161,31755,0,0,1,1,2
58170,130,12909,17567;18081,31755,0,0,0,2,2
58171,130,12910,18690;18772;23011,31755,0,0,3,0,3
58172,130,12911,18066;18626;22533,31755,0,0,2,1,3
58173,130,12912,17995,31755,0,0,0,1,1
58174,130,12913,17358;18001,31755,0,0,0,2,2
58175,130,12914,18014;18241,31755,0,0,1,1,2
58176,130,12915,18044;18187,31755,0,0,1,1,2
58177,130,12916,17954;18507;22099,31755,0,0,2,1,3
58178,130,12917,18171;18705;22002;22110,31755,0,0,4,0,4
58179,130,12918,18085;22773,31755,0,0,1,1,2
58180,130,12920,18289,31755,0,0,1,0,1
58181,130,12921,18389;21138,31755,0,0,2,0,2
58182,130,12922,18227;18639,31755,0,0,2,0,2
58183,130,12923,17977;18079,31755,0,0,0,2,2
58184,130,12924,18609;21988;24669,31755,0,1,2,0,3
58185,130,12925,18415;18495;22664,31755,0,0,3,0,3
58186,130,12927,18107;18457,31755,0,0,1,1,2
58187,130,12928,17692;17868,31755,0,0,0,2,2
58188,130,12929,17757;18157,31755,0,0,0,2,2
58189,130,12930,18311;18393,31755,0,0,2,0,2
58190,130,12931,18025;18247,31755,0,0,1,1,2
58191,130,12932,18284;18366;22385,31755,0,0,3,0,3
58192,130,12933,18041;22074,31755,0,0,1,1,2
58193,130,12934,18396;18770;22682,31755,0,0,3,0,3
58194,130,12935,18617;18784,31755,0,0,2,0,2
58195,130,12937,17939;18346,31755,0,0,1,1,2
58196,130,12938,18347;18381,31755,0,0,2,0,2
58197,130,12940,17667;18306,31755,0,0,1,1,2
58198,130,12957,14140,32120,0,0,0,1,1
58199,130,12958,14612,32120,0,0,0,1,1
58200,130,12961,14915,32120,0,0,0,1,1
58201,130,12981,16230;16473,32120,0,0,0,2,2
58202,130,12982,16303;16530,32120,0,0,0,2,2
58203,130,12987,16842,32120,0,0,0,1,1
58204,130,12989,17386;17458,32120,0,0,0,2,2
58205,130,12990,17388,32120,0,0,0,1,1
58206,130,12993,16960;17339,32120,0,0,0,2,2
58207,130,12994,17518,32120,0,0,0,1,1
58208,130,12995,17355;17936,32120,0,0,0,2,2
58209,130,12998,17689;17893,32120,0,0,0,2,2
58210,130,12999,17678;17835,32120,0,0,0,2,2
58211,130,13000,17666,32120,0,0,0,1,1
58212,130,13002,17967,32120,0,0,0,1,1
58213,130,13003,17749,32120,0,0,0,1,1
58214,130,13004,17709;17758,32120,0,0,0,2,2
58215,130,13005,17797;18063,32120,0,0,0,2,2
58216,130,13006,17800,32120,0,0,0,1,1
58217,130,13007,17856;18288;21966,32120,0,0,2,1,3
58218,130,13008,17836;17894;22506,32120,0,0,1,2,3
58219,130,13009,17919;18146;21625,32120,0,0,1,2,3
58220,130,13010,17601;17930,32120,0,0,0,2,2
58221,130,13011,18039;18397,32120,0,0,1,1,2
58222,130,13012,18486;18584;22391;25198,32120,1,0,3,0,4
58223,130,13013,17712;17983,32120,0,0,0,2,2
58224,130,13014,18048;18070,32120,0,0,0,2,2
58225,130,13015,18104;18561;22103,32120,0,0,2,1,3
58226,130,13016,18110;18142,32120,0,0,0,2,2
58227,130,13017,18229;18248;22082,32120,0,0,3,0,3
58228,130,13018,18137;18670,32120,0,0,1,1,2
58229,130,13019,18168;22652,32120,0,0,2,0,2
58230,130,13021,18604,32120,0,0,1,0,1
58231,130,13022,18212;18499,32120,0,0,2,0,2
58232,130,13023,18223;18735,32120,0,0,2,0,2
58233,130,13024,18587;22669,32120,0,0,2,0,2
58234,130,13025,17891;18282;22657,32120,0,0,2,1,3
58235,130,13026,18286;18321,32120,0,0,2,0,2
58236,130,13028,18378;21727,32120,0,0,2,0,2
58237,130,13029,17963;18408,32120,0,0,1,1,2
58238,130,13030,18419;18729,32120,0,0,2,0,2
58239,130,13031,18613,32120,0,0,1,0,1
58240,130,13033,18452;18550;22389;25110,32120,1,0,3,0,4
58241,130,13034,18494;22782,32120,0,0,2,0,2
58242,130,13035,18461;22663;25202,32120,1,0,2,0,3
58243,130,13036,17947;18342;21762,32120,0,0,2,1,3
58244,130,13039,17823;17852,32120,0,0,0,2,2
58245,130,13040,18237;18505,32120,0,0,2,0,2
58246,130,13041,18515,32120,0,0,1,0,1
58247,130,13042,18517;18663,32120,0,0,2,0,2
58248,130,13054,14145,32485,0,0,0,1,1
58249,130,13060,15333,32485,0,0,0,1,1
58250,130,13064,15080,32485,0,0,0,1,1
58251,130,13071,15734,32485,0,0,0,1,1
58252,130,13072,15577,32485,0,0,0,1,1
58253,130,13081,16663;17212,32485,0,0,0,2,2
58254,130,13085,16988;16992,32485,0,0,0,2,2
58255,130,13086,17022;17501,32485,0,0,0,2,2
58256,130,13088,17111;17425,32485,0,0,0,2,2
58257,130,13090,17657,32485,0,0,0,1,1
58258,130,13091,17681,32485,0,0,0,1,1
58259,130,13092,17421;17655,32485,0,0,0,2,2
58260,130,13093,17416;17471,32485,0,0,0,2,2
58261,130,13098,17593;17613,32485,0,0,0,2,2
58262,130,13099,17265;17614,32485,0,0,0,2,2
58263,130,13100,17934,32485,0,0,0,1,1
58264,130,13101,18506;21983,32485,0,0,2,0,2
58265,130,13102,17682;18254,32485,0,0,1,1,2
58266,130,13104,17906;18060;22510,32485,0,0,1,2,3
58267,130,13106,17839;18027;21932,32485,0,0,1,2,3
58268,130,13108,17938;18209,32485,0,0,1,1,2
58269,130,13109,17549;17958;22175,32485,0,0,1,2,3
58270,130,13110,17532;17816,32485,0,0,0,2,2
58271,130,13111,17792;18023,32485,0,0,0,2,2
58272,130,13112,18028,32485,0,0,0,1,1
58273,130,13113,17629;18033,32485,0,0,0,2,2
58274,130,13114,18049;18677,32485,0,0,1,1,2
58275,130,13115,17946;18054,32485,0,0,0,2,2
58276,130,13116,18078;18155;20885;24044,32485,0,1,1,2,4
58277,130,13117,18153;18651;22537,32485,0,0,2,1,3
58278,130,13118,18156;18196,32485,0,0,1,1,2
58279,130,13119,18076;18180;21540,32485,0,0,2,1,3
58280,130,13120,17941;18208,32485,0,0,1,1,2
58281,130,13121,18008;18222,32485,0,0,1,1,2
58282,130,13122,17827;18251;21962,32485,0,0,2,1,3
58283,130,13123,18519;18749;22211;22409,32485,0,0,4,0,4
58284,130,13124,18731;19000,32485,0,0,2,0,2
58285,130,13125,18637,32485,0,0,1,0,1
58286,130,13127,17916;18319,32485,0,0,1,1,2
58287,130,13128,18331;18548;22199;24679;24896,32485,1,1,3,0,5
58288,130,13129,17785;17877;21934,32485,0,0,1,2,3
58289,130,13131,18330;18429;22658,32485,0,0,3,0,3
58290,130,13132,18472;19016,32485,0,0,2,0,2
58291,130,13133,17950;18479,32485,0,0,1,1,2
58292,130,13134,18374;18496,32485,0,0,2,0,2
58293,130,13135,18087;18502;23105,32485,0,0,2,1,3
58294,130,13136,18514;22665,32485,0,0,2,0,2
58295,130,13137,17968;18516;21718;22527,32485,0,0,3,1,4
58296,130,13140,18575,32485,0,0,1,0,1
58297,130,13141,18170;18783,32485,0,0,2,0,2
58298,130,13142,18598;18738,32485,0,0,2,0,2
58299,130,13143,18612;18698,32485,0,0,2,0,2
58300,130,13144,18867;19019;22547,32485,0,0,3,0,3
58301,130,13149,14032,32850,0,0,0,1,1
58302,130,13164,14643;14988,32850,0,0,0,2,2
58303,130,13166,15117,32850,0,0,0,1,1
58304,130,13183,16326,32850,0,0,0,1,1
58305,130,13184,16328;16460,32850,0,0,0,2,2
58306,130,13186,16503,32850,0,0,0,1,1
58307,130,13195,17260;17407,32850,0,0,0,2,2
58308,130,13197,17304,32850,0,0,0,1,1
58309,130,13200,17659;17748,32850,0,0,0,2,2
58310,130,13201,17988;18098,32850,0,0,0,2,2
58311,130,13202,17417;17755,32850,0,0,0,2,2
58312,130,13203,17721;18192,32850,0,0,1,1,2
58313,130,13204,17664;17925;21940,32850,0,0,1,2,3
58314,130,13205,17763;17802,32850,0,0,0,2,2
58315,130,13206,17565;17912,32850,0,0,0,2,2
58316,130,13207,17498;17810,32850,0,0,0,2,2
58317,130,13208,17812;17991,32850,0,0,0,2,2
58318,130,13209,17691;17826;21413,32850,0,0,1,2,3
58319,130,13210,18562,32850,0,0,1,0,1
58320,130,13212,17909;18565,32850,0,0,1,1,2
58321,130,13213,17753;17927,32850,0,0,0,2,2
58322,130,13214,17683;17929,32850,0,0,0,2,2
58323,130,13216,18313;18820;23190,32850,0,0,3,0,3
58324,130,13217,18353,32850,0,0,1,0,1
58325,130,13218,18106;18655,32850,0,0,1,1,2
58326,130,13219,17904;18116;22513,32850,0,0,1,2,3
58327,130,13220,18123;18620;22672,32850,0,0,2,1,3
58328,130,13222,18186;18323;23103;23213,32850,0,0,4,0,4
58329,130,13223,18017;18206;21640;23958,32850,0,1,2,1,4
58330,130,13224,18265,32850,0,0,1,0,1
58331,130,13225,17897;18278;22518,32850,0,0,2,1,3
58332,130,13226,18293;22188,32850,0,0,2,0,2
58333,130,13227,18317;18883;22548;23509,32850,0,1,3,0,4
58334,130,13228,18334;18642,32850,0,0,2,0,2
58335,130,13229,18357;23104,32850,0,0,2,0,2
58336,130,13230,18361,32850,0,0,1,0,1
58337,130,13231,18600;18627;21294;24170,32850,0,1,3,0,4
58338,130,13232,18244;18417,32850,0,0,2,0,2
58339,130,13233,18094;18447;22294,32850,0,0,2,1,3
58340,130,13234,17940;18450,32850,0,0,1,1,2
58341,130,13235,18435;18454;22095;22893;25305,32850,1,0,4,0,5
58342,130,13236,18469;18864;23626,32850,0,1,2,0,3
58343,130,13237,18866;18929;22687,32850,0,0,3,0,3
58344,130,13238,18569;18597;23004,32850,0,0,3,0,3
58345,130,13239,18758;18958;21711;22431,32850,0,0,4,0,4
58346,130,13240,18948;22911;23738,32850,0,1,2,0,3
58347,130,13241,18301;18786,32850,0,0,2,0,2
58348,130,13243,18283;18778;22543,32850,0,0,3,0,3
58349,130,13244,19065;19186,32850,0,0,2,0,2
58350,130,13245,18667;18971,32850,0,0,2,0,2
58351,130,13246,18761,32850,0,0,1,0,1
58352,130,13247,18549;19091;22136,32850,0,0,3,0,3
58353,130,13248,19158;19162;23200,32850,0,0,3,0,3
58354,130,13249,18716;18861;22207;22678,32850,0,0,4,0,4
58355,130,13250,18722;18920,32850,0,0,2,0,2
58356,130,13252,18743;19059;23027,32850,0,0,3,0,3
58357,130,13254,18465;18763;22212;22410;24795,32850,0,1,4,0,5
58358,130,13255,18490;18765,32850,0,0,2,0,2
58359,130,13261,14064,33215,0,0,0,1,1
58360,130,13266,15165,33215,0,0,0,1,1
58361,130,13280,15175;15176,33215,0,0,0,2,2
58362,130,13296,16920;17058,33215,0,0,0,2,2
58363,130,13303,17818,33215,0,0,0,1,1
58364,130,13304,17582,33215,0,0,0,1,1
58365,130,13306,17707;17732,33215,0,0,0,2,2
58366,130,13307,17820;18148,33215,0,0,0,2,2
58367,130,13308,18141;18392,33215,0,0,1,1,2
58368,130,13309,17367;18128;22887,33215,0,0,1,2,3
58369,130,13310,17962;18019;23423,33215,0,0,1,2,3
58370,130,13313,17552;17948,33215,0,0,0,2,2
58371,130,13314,17980,33215,0,0,0,1,1
58372,130,13315,18234;18297,33215,0,0,2,0,2
58373,130,13318,17597;18020,33215,0,0,0,2,2
58374,130,13320,18038;18573,33215,0,0,1,1,2
58375,130,13321,18058,33215,0,0,0,1,1
58376,130,13322,18064;18510,33215,0,0,1,1,2
58377,130,13324,17914;18242,33215,0,0,1,1,2
58378,130,13325,17859;18143,33215,0,0,0,2,2
58379,130,13326,18528;18649;22402,33215,0,0,3,0,3
58380,130,13328,18000;18210,33215,0,0,1,1,2
58381,130,13329,17945;18226,33215,0,0,1,1,2
58382,130,13330,18183;18231,33215,0,0,2,0,2
58383,130,13331,17634;18252,33215,0,0,1,1,2
58384,130,13333,18700;21140,33215,0,0,2,0,2
58385,130,13334,18539;21119,33215,0,0,2,0,2
58386,130,13335,18296;18497;22189,33215,0,0,3,0,3
58387,130,13336,18300;18858,33215,0,0,2,0,2
58388,130,13337,18901;19055,33215,0,0,2,0,2
58389,130,13339,18352;18607,33215,0,0,2,0,2
58390,130,13340,18174,33215,0,0,1,0,1
58391,130,13341,18195;18383,33215,0,0,2,0,2
58392,130,13342,18272;18619;21989,33215,0,0,3,0,3
58393,130,13343,18410;18897;23510,33215,0,1,2,0,3
58394,130,13344,18074;18413,33215,0,0,1,1,2
58395,130,13345,18430;18501;21757;21975;23507,33215,0,1,4,0,5
58396,130,13346,18216;18433;22388,33215,0,0,3,0,3
58397,130,13347,18475;19027;22128,33215,0,0,3,0,3
58398,130,13348,18489;18590;22525,33215,0,0,3,0,3
58399,130,13349,18387;18513;23002,33215,0,0,3,0,3
58400,130,13350,19051;22918,33215,0,0,2,0,2
58401,130,13351,19083;19234;22567,33215,0,0,3,0,3
58402,130,13352,18638,33215,0,0,1,0,1
58403,130,13353,18339;18669,33215,0,0,2,0,2
58404,130,13354,18678;22310,33215,0,0,2,0,2
58405,130,13355,19147;19530;22233,33215,0,0,3,0,3
58406,130,13356,18660;19040,33215,0,0,2,0,2
58407,130,13357,18173;18704;23508,33215,0,1,2,0,3
58408,130,13358,18488;18741;22408,33215,0,0,3,0,3
58409,130,13359,18747,33215,0,0,1,0,1
58410,130,13360,19183;19237;21435;23305,33215,0,0,4,0,4
58411,130,13361,19101;19331;22701,33215,0,0,3,0,3
58412,130,13362,18779,33215,0,0,1,0,1
58413,130,13363,18307;18602;22531,33215,0,0,3,0,3
58414,130,13364,18728;18787,33215,0,0,2,0,2
58415,130,13365,19121;23410,33215,0,0,2,0,2
58416,130,13366,18795;18807;22684,33215,0,0,3,0,3
58417,130,13367,18686;18797,33215,0,0,2,0,2
58418,130,13368,18984;23302,33215,0,0,2,0,2
58419,130,13369,18845;18865;22544,33215,0,0,3,0,3
58420,130,13371,18892,33215,0,0,1,0,1
58421,130,13372,18902;19044,33215,0,0,2,0,2
58422,130,13373,19271;19342;22550,33215,0,0,3,0,3
58423,130,13389,14827,33580,0,0,0,1,1
58424,130,13391,14545,33580,0,0,0,1,1
58425,130,13395,15171,33580,0,0,0,1,1
58426,130,13398,14852,33580,0,0,0,1,1
58427,130,13405,15896,33580,0,0,0,1,1
58428,130,13410,16854;17303,33580,0,0,0,2,2
58429,130,13411,16979;17324,33580,0,0,0,2,2
58430,130,13412,17235;17293,33580,0,0,0,2,2
58431,130,13415,17030;17292,33580,0,0,0,2,2
58432,130,13418,18026,33580,0,0,0,1,1
58433,130,13419,17529,33580,0,0,0,1,1
58434,130,13422,17596;18150,33580,0,0,0,2,2
58435,130,13423,17649;17885,33580,0,0,0,2,2
58436,130,13425,17631;18139,33580,0,0,0,2,2
58437,130,13426,17817,33580,0,0,0,1,1
58438,130,13427,17668;17853;21666,33580,0,0,1,2,3
58439,130,13428,17970;18351;22088,33580,0,0,2,1,3
58440,130,13429,17953;21493,33580,0,0,1,1,2
58441,130,13434,17851;17993;22070,33580,0,0,1,2,3
58442,130,13435,18176,33580,0,0,1,0,1
58443,130,13437,18204;18742,33580,0,0,2,0,2
58444,130,13438,18683;18896;22690;22909,33580,0,0,4,0,4
58445,130,13439,18857;23191,33580,0,0,2,0,2
58446,130,13440,18298;18543,33580,0,0,2,0,2
58447,130,13441,18309;18470,33580,0,0,2,0,2
58448,130,13442,18520;18583,33580,0,0,2,0,2
58449,130,13443,18012;18327,33580,0,0,1,1,2
58450,130,13444,18556,33580,0,0,1,0,1
58451,130,13445,18884;18919;21627;22218;24862,33580,1,0,4,0,5
58452,130,13446,18191;18407;22660,33580,0,0,3,0,3
58453,130,13447,18360;18524;23003,33580,0,0,3,0,3
58454,130,13452,19072;19291;23198,33580,0,0,3,0,3
58455,130,13453,18295;18559;22896,33580,0,0,3,0,3
58456,130,13454,18434;18879;22420,33580,0,0,3,0,3
58457,130,13456,18423;18982;22802;23112;23195,33580,0,0,5,0,5
58458,130,13458,18622;18877,33580,0,0,2,0,2
58459,130,13459,18245;18631;21991,33580,0,0,3,0,3
58460,130,13460,18648;18874;22688;22907,33580,0,0,4,0,4
58461,130,13461,19141;23029,33580,0,0,2,0,2
58462,130,13462,18577;18630;21995;22534,33580,0,0,4,0,4
58463,130,13463,18624;18699,33580,0,0,2,0,2
58464,130,13464,18708;19064,33580,0,0,2,0,2
58465,130,13465,18217;18727,33580,0,0,2,0,2
58466,130,13466,18713;19060;21254,33580,0,0,3,0,3
58467,130,13467,18757;18894;22795;23015,33580,0,0,4,0,4
58468,130,13468,18294;18793,33580,0,0,2,0,2
58469,130,13469,18801;18996;22414;24796,33580,0,1,3,0,4
58470,130,13470,18723;18815,33580,0,0,2,0,2
58471,130,13471,18821;19321;23125;23415,33580,0,0,4,0,4
58472,130,13472,18830;19070,33580,0,0,2,0,2
58473,130,13473,18833;19210;22574;23201;25012,33580,1,0,4,0,5
58474,130,13474,18836;18969,33580,0,0,2,0,2
58475,130,13475,18945;22692;22800,33580,0,0,3,0,3
58476,130,13476,18422;18848;23017,33580,0,0,3,0,3
58477,130,13477,18967,33580,0,0,1,0,1
58478,130,13478,18912;19004,33580,0,0,2,0,2
58479,130,13479,18970;23628,33580,0,1,1,0,2
58480,130,13480,19261;23032,33580,0,0,2,0,2
58481,130,13489,13787,33945,0,0,0,1,1
58482,130,13498,14564,33945,0,0,0,1,1
58483,130,13507,15576,33945,0,0,0,1,1
58484,130,13508,14814,33945,0,0,0,1,1
58485,130,13510,15837,33945,0,0,0,1,1
58486,130,13524,16829;16870,33945,0,0,0,2,2
58487,130,13525,16172;16919,33945,0,0,0,2,2
58488,130,13529,17178;17428,33945,0,0,0,2,2
58489,130,13532,17290;18201,33945,0,0,1,1,2
58490,130,13538,17356;17793,33945,0,0,0,2,2
58491,130,13539,18261,33945,0,0,1,0,1
58492,130,13540,17881;18529,33945,0,0,1,1,2
58493,130,13542,17981;18003,33945,0,0,0,2,2
58494,130,13544,17450;17702,33945,0,0,0,2,2
58495,130,13546,18182,33945,0,0,1,0,1
58496,130,13547,18399;21656,33945,0,0,2,0,2
58497,130,13548,18380;22193,33945,0,0,2,0,2
58498,130,13549,18466,33945,0,0,1,0,1
58499,130,13550,18325;18332,33945,0,0,2,0,2
58500,130,13551,18386;18672,33945,0,0,2,0,2
58501,130,13552,18817;18875;22908,33945,0,0,3,0,3
58502,130,13553,18484;18944,33945,0,0,2,0,2
58503,130,13555,18847;19129;22571;22807,33945,0,0,4,0,4
58504,130,13556,18563;18782;21821;25254,33945,1,0,3,0,4
58505,130,13557,18589;18652;22562;22788;22899,33945,0,0,5,0,5
58506,130,13559,18635;18753,33945,0,0,2,0,2
58507,130,13560,18676;19132;22921;25011,33945,1,0,3,0,4
58508,130,13561,19096,33945,0,0,1,0,1
58509,130,13562,18718;21644,33945,0,0,2,0,2
58510,130,13565,18570;18739;22897,33945,0,0,3,0,3
58511,130,13566,19217;19521;22830;22955,33945,0,0,4,0,4
58512,130,13567,18762,33945,0,0,1,0,1
58513,130,13569,19541;22601;23746,33945,0,1,2,0,3
58514,130,13570,18835;18922,33945,0,0,2,0,2
58515,130,13571,18800;18899;22691,33945,0,0,3,0,3
58516,130,13572,18628;18885;22689,33945,0,0,3,0,3
58517,130,13573,18733;18926;22019;24778;25265,33945,1,1,3,0,5
58518,130,13575,18955;21693;22430,33945,0,0,3,0,3
58519,130,13576,18715;18959;23012,33945,0,0,3,0,3
58520,130,13577,18240;18961;23111,33945,0,0,3,0,3
58521,130,13578,18965,33945,0,0,1,0,1
58522,130,13579,18988;23407,33945,0,0,2,0,2
58523,130,13581,18837;19046,33945,0,0,2,0,2
58524,130,13582,19047;23115,33945,0,0,2,0,2
58525,130,13584,18914;19053;23019,33945,0,0,3,0,3
58526,130,13585,19068;22324;23116,33945,0,0,3,0,3
58527,130,13586,19069;19145,33945,0,0,2,0,2
58528,130,13587,19250;19494;23046,33945,0,0,3,0,3
58529,130,13588,19037;19311;23123,33945,0,0,3,0,3
58530,130,13589,18841;19094,33945,0,0,2,0,2
58531,130,13591,21373;24944;25151,33945,2,0,1,0,3
58532,130,13592,19119;23512,33945,0,1,1,0,2
58533,130,13593,18832;19312;22458,33945,0,0,3,0,3
58534,130,13594,19136,33945,0,0,1,0,1
58535,130,13595,19137;22444;22922,33945,0,0,3,0,3
58536,130,13596,19160;23412,33945,0,0,2,0,2
58537,130,13597,19173,33945,0,0,1,0,1
58538,130,13598,19388;19492;22727;23218,33945,0,0,4,0,4
58539,130,13610,14937,34310,0,0,0,1,1
58540,130,13615,15135,34310,0,0,0,1,1
58541,130,13618,15488,34310,0,0,0,1,1
58542,130,13622,15839;15949,34310,0,0,0,2,2
58543,130,13624,15766;16067,34310,0,0,0,2,2
58544,130,13631,16433,34310,0,0,0,1,1
58545,130,13635,16542;16765,34310,0,0,0,2,2
58546,130,13638,16999,34310,0,0,0,1,1
58547,130,13640,16907;17291;21541;25238,34310,1,0,1,2,4
58548,130,13641,17390,34310,0,0,0,1,1
58549,130,13643,17924;18263,34310,0,0,1,1,2
58550,130,13645,17842,34310,0,0,0,1,1
58551,130,13646,17366;17905,34310,0,0,0,2,2
58552,130,13647,18318;22291,34310,0,0,2,0,2
58553,130,13649,17814;18127,34310,0,0,0,2,2
58554,130,13650,17961;18059,34310,0,0,0,2,2
58555,130,13651,17636;18036,34310,0,0,0,2,2
58556,130,13654,18930;19022,34310,0,0,2,0,2
58557,130,13655,18207;18337,34310,0,0,2,0,2
58558,130,13657,18355;18508,34310,0,0,2,0,2
58559,130,13658,18522,34310,0,0,1,0,1
58560,130,13659,18129,34310,0,0,0,1,1
58561,130,13660,18567,34310,0,0,1,0,1
58562,130,13661,18476;18636;22524,34310,0,0,3,0,3
58563,130,13662,18458;19015,34310,0,0,2,0,2
58564,130,13663,18460,34310,0,0,1,0,1
58565,130,13667,18571;18744,34310,0,0,2,0,2
58566,130,13668,18504;18574;22526;22894;25123,34310,1,0,4,0,5
58567,130,13669,18568;18878,34310,0,0,2,0,2
58568,130,13670,18838;19052;22438;24797;24998,34310,1,1,3,0,5
58569,130,13672,19356;22592,34310,0,0,2,0,2
58570,130,13673,19128;19256,34310,0,0,2,0,2
58571,130,13674,18764;19319;22585;22713,34310,0,0,4,0,4
58572,130,13675,18444;18585;23006;23187,34310,0,0,4,0,4
58573,130,13676,19008,34310,0,0,1,0,1
58574,130,13681,18367;18825,34310,0,0,2,0,2
58575,130,13682,18849;18863,34310,0,0,2,0,2
58576,130,13683,19084;19135;23513,34310,0,1,2,0,3
58577,130,13684,18220;18898;22797,34310,0,0,3,0,3
58578,130,13685,18992;22803,34310,0,0,2,0,2
58579,130,13686,18921;19150,34310,0,0,2,0,2
58580,130,13687,18871;18927,34310,0,0,2,0,2
58581,130,13688,18942;22552,34310,0,0,2,0,2
58582,130,13689,18850,34310,0,0,1,0,1
58583,130,13690,19546;23316;23524,34310,0,1,2,0,3
58584,130,13691,18980;19411,34310,0,0,2,0,2
58585,130,13692,18993;19478;22023;23113,34310,0,0,4,0,4
58586,130,13693,19551;23425;23525,34310,0,1,2,0,3
58587,130,13695,19014;19389,34310,0,0,2,0,2
58588,130,13696,19023;22804,34310,0,0,2,0,2
58589,130,13697,19199;19431;22719;24910,34310,1,0,3,0,4
58590,130,13698,18803;19036,34310,0,0,2,0,2
58591,130,13699,18603;19043;23114;23196,34310,0,0,4,0,4
58592,130,13700,19504;19596,34310,0,0,2,0,2
58593,130,13701,18665;19260;22453,34310,0,0,3,0,3
58594,130,13702,19134;19393,34310,0,0,2,0,2
58595,130,13703,18966;19172;21521;23514;24072;24645,34310,0,3,3,0,6
58596,130,13704,19058;19157;22924,34310,0,0,3,0,3
58597,130,13705,19011;19192,34310,0,0,2,0,2
58598,130,13707,19471;23216,34310,0,0,2,0,2
58599,130,13708,19230;19449;22469;25288,34310,1,0,3,0,4
58600,130,13709,19322;22938,34310,0,0,2,0,2
58601,130,13710,18540;19215;22926,34310,0,0,3,0,3
58602,130,13711,19516,34310,0,0,1,0,1
58603,130,13712,18759;19281;22816;23631,34310,0,1,3,0,4
58604,130,13713,19276;19282;22933;25307,34310,1,0,3,0,4
58605,130,13714,19293,34310,0,0,1,0,1
58606,130,13715,19303;19304;21903;22818;23122,34310,0,0,5,0,5
58607,130,13716,14384,34675,0,0,0,1,1
58608,130,13720,14094,34675,0,0,0,1,1
58609,130,13731,14943;15236,34675,0,0,0,2,2
58610,130,13736,15036;15210,34675,0,0,0,2,2
58611,130,13737,15666,34675,0,0,0,1,1
58612,130,13739,15997,34675,0,0,0,1,1
58613,130,13741,16026,34675,0,0,0,1,1
58614,130,13744,16340;16934,34675,0,0,0,2,2
58615,130,13747,16769;17199,34675,0,0,0,2,2
58616,130,13750,16538;16971,34675,0,0,0,2,2
58617,130,13755,17169,34675,0,0,0,1,1
58618,130,13757,16539;17409,34675,0,0,0,2,2
58619,130,13759,17361;17412,34675,0,0,0,2,2
58620,130,13764,18082;18119,34675,0,0,0,2,2
58621,130,13765,18362,34675,0,0,1,0,1
58622,130,13766,18055;18151,34675,0,0,0,2,2
58623,130,13768,18314;21967,34675,0,0,2,0,2
58624,130,13769,18257;18370,34675,0,0,2,0,2
58625,130,13770,18100;18440,34675,0,0,1,1,2
58626,130,13772,18498,34675,0,0,1,0,1
58627,130,13773,18553;18840;22119;22417,34675,0,0,4,0,4
58628,130,13774,17978;18595;22105;25096,34675,1,0,2,1,4
58629,130,13775,18056;18616,34675,0,0,1,1,2
58630,130,13777,18647;18788,34675,0,0,2,0,2
58631,130,13778,18695;22791;25120,34675,1,0,2,0,3
58632,130,13779,18767;19104;23408,34675,0,0,3,0,3
58633,130,13780,18776;18791,34675,0,0,2,0,2
58634,130,13781,18794;19198,34675,0,0,2,0,2
58635,130,13784,18855;22906,34675,0,0,2,0,2
58636,130,13785,18789;18860,34675,0,0,2,0,2
58637,130,13787,18724;19078;22135,34675,0,0,3,0,3
58638,130,13788,18937;19130;22910;23851,34675,0,1,3,0,4
58639,130,13789,18557;19259;22931;23853,34675,0,1,3,0,4
58640,130,13790,19029;22129,34675,0,0,2,0,2
58641,130,13791,18579;19048,34675,0,0,2,0,2
58642,130,13792,19166,34675,0,0,1,0,1
58643,130,13793,19071;19289;23307,34675,0,0,3,0,3
58644,130,13794,18903;19074,34675,0,0,2,0,2
58645,130,13795,19374,34675,0,0,1,0,1
58646,130,13796,19120;19349,34675,0,0,2,0,2
58647,130,13797,18754;19126;23117;23411,34675,0,0,4,0,4
58648,130,13798,19153;19222,34675,0,0,2,0,2
58649,130,13799,19177;19206,34675,0,0,2,0,2
58650,130,13800,19211;19391,34675,0,0,2,0,2
58651,130,13801,19375;19633;23431,34675,0,0,3,0,3
58652,130,13802,19224;22332,34675,0,0,2,0,2
58653,130,13804,19031;19283;23034;23203;23741,34675,0,1,4,0,5
58654,130,13805,19131;19298;22583,34675,0,0,3,0,3
58655,130,13807,19367;19578;23220;23427,34675,0,0,4,0,4
58656,130,13809,19437;22721;23042,34675,0,0,3,0,3
58657,130,13810,19320;22586,34675,0,0,2,0,2
58658,130,13811,19079;19350;22591;23127;23209;24085;25113,34675,1,1,5,0,7
58659,130,13812,18886;19353;21561;23210,34675,0,0,4,0,4
58660,130,13813,19006;19385;22716,34675,0,0,3,0,3
58661,130,13814,19275;19673;23433;23633,34675,0,1,3,0,4
58662,130,13815,19495;19509;23136,34675,0,0,3,0,3
58663,130,13816,19733;23228,34675,0,0,2,0,2
58664,130,13821,14897,35040,0,0,0,1,1
58665,130,13828,14855,35040,0,0,0,1,1
58666,130,13829,15159,35040,0,0,0,1,1
58667,130,13830,15276,35040,0,0,0,1,1
58668,130,13835,15662,35040,0,0,0,1,1
58669,130,13840,15545,35040,0,0,0,1,1
58670,130,13842,16221,35040,0,0,0,1,1
58671,130,13844,16567;16775,35040,0,0,0,2,2
58672,130,13849,17043,35040,0,0,0,1,1
58673,130,13856,17676,35040,0,0,0,1,1
58674,130,13864,18172;18509,35040,0,0,2,0,2
58675,130,13865,18526,35040,0,0,1,0,1
58676,130,13866,18503;18656;22675;24907,35040,1,0,3,0,4
58677,130,13868,18388;19252;22578;25112,35040,1,0,3,0,4
58678,130,13870,18406;19266,35040,0,0,2,0,2
58679,130,13871,18421;18808,35040,0,0,2,0,2
58680,130,13872,18268;18439,35040,0,0,2,0,2
58681,130,13873,18441;18645;22107;22787,35040,0,0,4,0,4
58682,130,13874,18448;18480,35040,0,0,2,0,2
58683,130,13875,18113;18451,35040,0,0,1,1,2
58684,130,13876,18463,35040,0,0,1,0,1
58685,130,13877,17727;18492,35040,0,0,1,1,2
58686,130,13878,18500,35040,0,0,1,0,1
58687,130,13880,18363;19067;22566;25001;25200,35040,2,0,3,0,5
58688,130,13881,18790;18859,35040,0,0,2,0,2
58689,130,13882,18239;18552;21857;22397;24470;24902,35040,1,1,4,0,6
58690,130,13884,18487;18606;21805;22392,35040,0,0,4,0,4
58691,130,13885,18872,35040,0,0,1,0,1
58692,130,13886,18329;18693;23188,35040,0,0,3,0,3
58693,130,13888,18424;18707;22677,35040,0,0,3,0,3
58694,130,13889,18271;18710,35040,0,0,2,0,2
58695,130,13890,18775;22117,35040,0,0,2,0,2
58696,130,13891,18228;18799;23189,35040,0,0,3,0,3
58697,130,13892,18934;19483,35040,0,0,2,0,2
58698,130,13894,18459;18952;22428,35040,0,0,3,0,3
58699,130,13895,18436;18974;23406,35040,0,0,3,0,3
58700,130,13896,19003;19486;23636,35040,0,1,2,0,3
58701,130,13898,19009;19236,35040,0,0,2,0,2
58702,130,13899,19041,35040,0,0,1,0,1
58703,130,13900,19025;19333;22589,35040,0,0,3,0,3
58704,130,13901,19577;19661;23644,35040,0,1,2,0,3
58705,130,13902,18684;19075,35040,0,0,2,0,2
58706,130,13903,19088;19476;23421,35040,0,0,3,0,3
58707,130,13904,19056,35040,0,0,1,0,1
58708,130,13905,19117;19610,35040,0,0,2,0,2
58709,130,13906,18888;19139;22328,35040,0,0,3,0,3
58710,130,13907,18983;19140,35040,0,0,2,0,2
58711,130,13908,19171;19323;23516;24197,35040,0,2,2,0,4
58712,130,13909,19579,35040,0,0,1,0,1
58713,130,13910,18935;19209;22705,35040,0,0,3,0,3
58714,130,13911,19213;19316;23632,35040,0,1,2,0,3
58715,130,13912,19219;19405;22824,35040,0,0,3,0,3
58716,130,13913,19531;23424;23638,35040,0,1,2,0,3
58717,130,13914,19077;19240;22814,35040,0,0,3,0,3
58718,130,13917,19032;19268;22581,35040,0,0,3,0,3
58719,130,13918,19286;19748;24089,35040,0,1,2,0,3
58720,130,13919,19294;23204,35040,0,0,2,0,2
58721,130,13920,19500;19590;23641;23748,35040,0,2,2,0,4
58722,130,13921,19317;23207,35040,0,0,2,0,2
58723,130,13922,19245;19644;23054,35040,0,0,3,0,3
58724,130,13923,19377;22464;23039,35040,0,0,3,0,3
58725,130,13924,19203;19383;22943;23744,35040,0,1,3,0,4
58726,130,13925,19400;23745,35040,0,1,1,0,2
58727,130,13928,19057;19532;22831,35040,0,0,3,0,3
58728,130,13929,19086;19542;23140,35040,0,0,3,0,3
58729,130,13930,19279;19552;22834;23526,35040,0,1,3,0,4
58730,130,13931,19498;19668,35040,0,0,2,0,2
58731,130,13932,19499;19872;23543;24093,35040,0,2,2,0,4
58732,130,13942,15356,35405,0,0,0,1,1
58733,130,13943,15382,35405,0,0,0,1,1
58734,130,13945,14861;15173,35405,0,0,0,2,2
58735,130,13949,15922,35405,0,0,0,1,1
58736,130,13952,16231,35405,0,0,0,1,1
58737,130,13955,16144,35405,0,0,0,1,1
58738,130,13960,17180,35405,0,0,0,1,1
58739,130,13968,17477,35405,0,0,0,1,1
58740,130,13971,17804;17831,35405,0,0,0,2,2
58741,130,13974,18531,35405,0,0,1,0,1
58742,130,13975,18236;18266;22517,35405,0,0,3,0,3
58743,130,13976,17775;17808,35405,0,0,0,2,2
58744,130,13977,18030,35405,0,0,0,1,1
58745,130,13978,17725;17754,35405,0,0,0,2,2
58746,130,13979,17910;23401,35405,0,0,1,1,2
58747,130,13980,17864;22650,35405,0,0,1,1,2
58748,130,13981,18581;22668,35405,0,0,2,0,2
58749,130,13982,18270;18442;22999;23298,35405,0,0,4,0,4
58750,130,13984,18250;18324;22889,35405,0,0,3,0,3
58751,130,13985,18117;18333,35405,0,0,1,1,2
58752,130,13987,18369;22778,35405,0,0,2,0,2
58753,130,13989,18379,35405,0,0,1,0,1
58754,130,13990,18416;18953,35405,0,0,2,0,2
58755,130,13991,18443;18703,35405,0,0,2,0,2
58756,130,13992,18464;18662,35405,0,0,2,0,2
58757,130,13993,18485;18521;23403,35405,0,0,3,0,3
58758,130,13995,18534;18769,35405,0,0,2,0,2
58759,130,13996,18594;19089;22439,35405,0,0,3,0,3
58760,130,13997,18411;18621;21990;24670;24885,35405,1,1,3,0,5
58761,130,14000,19454;19455;22950;23134;23310,35405,0,0,5,0,5
58762,130,14002,18593;18748;22541,35405,0,0,3,0,3
58763,130,14004,18870;19107,35405,0,0,2,0,2
58764,130,14006,18975;18979;22433,35405,0,0,3,0,3
58765,130,14008,19123;19696;22968;23226,35405,0,0,4,0,4
58766,130,14010,19098;19741,35405,0,0,2,0,2
58767,130,14011,19100;19178,35405,0,0,2,0,2
58768,130,14012,18792;19133;23739,35405,0,1,2,0,3
58769,130,14013,19604;19697,35405,0,0,2,0,2
58770,130,14014,19080;19148,35405,0,0,2,0,2
58771,130,14015,18493;18854;22905;25306,35405,1,0,3,0,4
58772,130,14016,19176;19358,35405,0,0,2,0,2
58773,130,14017,18869;19180,35405,0,0,2,0,2
58774,130,14018,19399;19475;23420,35405,0,0,3,0,3
58775,130,14019,19774;22738,35405,0,0,2,0,2
58776,130,14021,19285;23414,35405,0,0,2,0,2
58777,130,14022,19329;19878;23237,35405,0,0,3,0,3
58778,130,14023,19336;19576;22959;23426,35405,0,0,4,0,4
58779,130,14024,18876;19339,35405,0,0,2,0,2
58780,130,14026,19390;19824;23066,35405,0,0,3,0,3
58781,130,14027,18605;19401;22946,35405,0,0,3,0,3
58782,130,14029,18671;19417;23041,35405,0,0,3,0,3
58783,130,14030,19396;19453;22154;22341;22949;23967,35405,0,1,5,0,6
58784,130,14031,19473,35405,0,0,1,0,1
58785,130,14034,18688;19503;22345;23138,35405,0,0,4,0,4
58786,130,14035,19616;19669;23530;24917,35405,1,1,2,0,4
58787,130,14037,19420;23309,35405,0,0,2,0,2
58788,130,14038,19443;19493;22468;22722,35405,0,0,4,0,4
58789,130,14039,19263;19771;22847;23540,35405,0,1,3,0,4
58790,130,14040,19512;19553;23141;23970,35405,0,1,3,0,4
58791,130,14041,18998;19875;23443;23655,35405,0,1,3,0,4
58792,130,14042,19461;19556,35405,0,0,2,0,2
58793,130,14044,19163;19612;22962;23429,35405,0,0,4,0,4
58794,130,14045,19589;19716;22609;23148,35405,0,0,4,0,4
58795,130,14046,19560;19712;22735,35405,0,0,3,0,3
58796,130,14048,19675;19751;22050;23439,35405,0,0,4,0,4
58797,130,14049,19736;19934;23240,35405,0,0,3,0,3
58798,130,14050,19092;19609;23317,35405,0,0,3,0,3
58799,130,14051,19111;19595,35405,0,0,2,0,2
58800,130,14052,14085,35770,0,0,0,1,1
58801,130,14054,14257,35770,0,0,0,1,1
58802,130,14067,15410,35770,0,0,0,1,1
58803,130,14069,14720,35770,0,0,0,1,1
58804,130,14071,15718;16019,35770,0,0,0,2,2
58805,130,14082,17225;17724,35770,0,0,0,2,2
58806,130,14088,18382,35770,0,0,1,0,1
58807,130,14089,17806,35770,0,0,0,1,1
58808,130,14090,17829;17997,35770,0,0,0,2,2
58809,130,14091,17809,35770,0,0,0,1,1
58810,130,14094,18674;18826,35770,0,0,2,0,2
58811,130,14095,17564;18303;22998,35770,0,0,2,1,3
58812,130,14097,17863;18418;21974;22386,35770,0,0,3,1,4
58813,130,14098,19144;19384,35770,0,0,2,0,2
58814,130,14099,18798,35770,0,0,1,0,1
58815,130,14100,18582;19039;22323,35770,0,0,3,0,3
58816,130,14101,18145;18640,35770,0,0,1,1,2
58817,130,14102,18625,35770,0,0,1,0,1
58818,130,14105,18273;18963,35770,0,0,2,0,2
58819,130,14107,18467;18844,35770,0,0,2,0,2
58820,130,14109,18542;18943;22799,35770,0,0,3,0,3
58821,130,14110,18973;19305;22709;23742;25300,35770,1,1,3,0,5
58822,130,14112,18675;19529,35770,0,0,2,0,2
58823,130,14113,18823;19146,35770,0,0,2,0,2
58824,130,14114,19220,35770,0,0,1,0,1
58825,130,14115,19243;19398;23031,35770,0,0,3,0,3
58826,130,14116,19429;19753;23231,35770,0,0,3,0,3
58827,130,14117,19514;19798,35770,0,0,2,0,2
58828,130,14119,19277;23740,35770,0,1,1,0,2
58829,130,14120,19295;19681;23645,35770,0,1,2,0,3
58830,130,14121,19093;19325;22588,35770,0,0,3,0,3
58831,130,14122,19574;19993;23452,35770,0,0,3,0,3
58832,130,14123,18923;19360;22593,35770,0,0,3,0,3
58833,130,14124,19297;19302;22935,35770,0,0,3,0,3
58834,130,14125,19370;23130;23519,35770,0,1,2,0,3
58835,130,14126,19409;19734;23538;23976,35770,0,2,2,0,4
58836,130,14127,19430;19533,35770,0,0,2,0,2
58837,130,14128,19617;19891,35770,0,0,2,0,2
58838,130,14129,18818;19421,35770,0,0,2,0,2
58839,130,14130,19432,35770,0,0,1,0,1
58840,130,14131,19462;19657,35770,0,0,2,0,2
58841,130,14132,19249;19470;23215;23968,35770,0,1,3,0,4
58842,130,14133,19554;19699;22352;24995,35770,1,0,3,0,4
58843,130,14134,19484;19778;23747,35770,0,1,2,0,3
58844,130,14135,19416;19511,35770,0,0,2,0,2
58845,130,14136,19776;23232,35770,0,0,2,0,2
58846,130,14138,19539;19791;22600;23315;23639,35770,0,1,4,0,5
58847,130,14140,19573,35770,0,0,1,0,1
58848,130,14141,19602;19635,35770,0,0,2,0,2
58849,130,14142,19627;19790;23065;23651,35770,0,1,3,0,4
58850,130,14143,18425;19099;22568;22805,35770,0,0,4,0,4
58851,130,14144,19548;19680;22842,35770,0,0,3,0,3
58852,130,14145,19652;19682;23145,35770,0,0,3,0,3
58853,130,14146,19362;19844;22488;22616;23757,35770,0,1,4,0,5
58854,130,14147,19125;19703;23320,35770,0,0,3,0,3
58855,130,14148,19357;19718;23059;23436;23861,35770,0,1,4,0,5
58856,130,14149,19585;19837;22615;22849,35770,0,0,4,0,4
58857,130,14150,19738;19914;23867,35770,0,1,2,0,3
58858,130,14151,19980;23246;23550;23869;23982,35770,0,3,2,0,5
58859,130,14152,19800;23151;23652;24091,35770,0,2,2,0,4
58860,130,14153,19775;20027;23870,35770,0,1,2,0,3
58861,130,14156,14105,36135,0,0,0,1,1
58862,130,14159,15042,36135,0,0,0,1,1
58863,130,14161,15162,36135,0,0,0,1,1
58864,130,14162,15248;15822,36135,0,0,0,2,2
58865,130,14166,15377,36135,0,0,0,1,1
58866,130,14168,15694;15708,36135,0,0,0,2,2
58867,130,14171,15844;16421,36135,0,0,0,2,2
58868,130,14178,16106,36135,0,0,0,1,1
58869,130,14179,15816,36135,0,0,0,1,1
58870,130,14180,16581;16760,36135,0,0,0,2,2
58871,130,14195,17771;18169,36135,0,0,1,1,2
58872,130,14201,18420;19254;22579;23202;23306;23515,36135,0,1,5,0,6
58873,130,14203,18341,36135,0,0,1,0,1
58874,130,14205,18468;23402,36135,0,0,2,0,2
58875,130,14206,18546;19267;23630,36135,0,1,2,0,3
58876,130,14211,18691;19599;22480;23428,36135,0,0,4,0,4
58877,130,14212,18842;19189,36135,0,0,2,0,2
58878,130,14213,18995;19732;23537;23649;24199,36135,0,3,2,0,5
58879,130,14214,19024;19105;23409;25209,36135,1,0,3,0,4
58880,130,14215,18990;19045;23197,36135,0,0,3,0,3
58881,130,14218,19062;19783;22739,36135,0,0,3,0,3
58882,130,14220,19155;19601,36135,0,0,2,0,2
58883,130,14221,18697;19212;22575,36135,0,0,3,0,3
58884,130,14222,19106;19284;22569,36135,0,0,3,0,3
58885,130,14223,18891;19346;23517,36135,0,1,2,0,3
58886,130,14225,19306,36135,0,0,1,0,1
58887,130,14226,19197;19328;23208,36135,0,0,3,0,3
58888,130,14228,19185;19351;23128;23518,36135,0,1,3,0,4
58889,130,14229,19355,36135,0,0,1,0,1
58890,130,14230,19238;19369;22463,36135,0,0,3,0,3
58891,130,14231,19366;19641,36135,0,0,2,0,2
58892,130,14232,19526;19860,36135,0,0,2,0,2
58893,130,14233,20047;20221;23077;23455,36135,0,0,4,0,4
58894,130,14234,19664;19963;23244,36135,0,0,3,0,3
58895,130,14236,19204;19803;24092,36135,0,1,2,0,3
58896,130,14237,19909,36135,0,0,1,0,1
58897,130,14238,19793;19850;23233;23862;23977;24090,36135,0,3,3,0,6
58898,130,14239,19076;19724;23437;23536,36135,0,1,3,0,4
58899,130,14240,19737;19743;23064;23229,36135,0,0,4,0,4
58900,130,14241,19744,36135,0,0,1,0,1
58901,130,14242,20133;23255;24102;24296,36135,0,2,2,0,4
58902,130,14243,19686,36135,0,0,1,0,1
58903,130,14244,19296;19802,36135,0,0,2,0,2
58904,130,14245,19810;19950,36135,0,0,2,0,2
58905,130,14246,19813;20064,36135,0,0,2,0,2
58906,130,14247,19826;20036;23665,36135,0,1,2,0,3
58907,130,14248,20364;24577,36135,0,1,1,0,2
58908,130,14249,19987,36135,0,0,1,0,1
58909,130,14250,20141;22980;24297,36135,0,1,2,0,3
58910,130,14251,19852;20118;23253;24100;24295,36135,0,2,3,0,5
58911,130,14253,20102;23557;23768,36135,0,2,1,0,3
58912,130,14254,19662;19861;23653,36135,0,1,2,0,3
58913,130,14255,19864;20195;23344,36135,0,0,3,0,3
58914,130,14256,19719;19880;22736;22843,36135,0,0,4,0,4
58915,130,14257,19569;19886;23544;23979,36135,0,2,2,0,4
58916,130,14259,14825,36500,0,0,0,1,1
58917,130,14260,15429,36500,0,0,0,1,1
58918,130,14262,14529,36500,0,0,0,1,1
58919,130,14270,16133,36500,0,0,0,1,1
58920,130,14278,17209;17913,36500,0,0,0,2,2
58921,130,14280,17640;17784,36500,0,0,0,2,2
58922,130,14284,18144;18629,36500,0,0,1,1,2
58923,130,14289,18198;18946,36500,0,0,2,0,2
58924,130,14292,18275;18491;22393;24386;24793,36500,0,2,3,0,5
58925,130,14293,18681;22892;23107,36500,0,0,3,0,3
58926,130,14296,18654;18931;22425;24997,36500,1,0,3,0,4
58927,130,14297,18977,36500,0,0,1,0,1
58928,130,14299,18701,36500,0,0,1,0,1
58929,130,14300,19082;19426;23522,36500,0,1,2,0,3
58930,130,14301,18610;18909,36500,0,0,2,0,2
58931,130,14302,18525;18828;22903,36500,0,0,3,0,3
58932,130,14304,19381;23416,36500,0,0,2,0,2
58933,130,14305,19645;23055;23221,36500,0,0,3,0,3
58934,130,14306,19309;22248;25277,36500,1,0,2,0,3
58935,130,14307,19226;19273;23413,36500,0,0,3,0,3
58936,130,14308,19439;19632;23643,36500,0,1,2,0,3
58937,130,14309,18736;19142;23118,36500,0,0,3,0,3
58938,130,14310,19448;19520;23634,36500,0,1,2,0,3
58939,130,14311,19882;20010;23767,36500,0,1,2,0,3
58940,130,14312,19216,36500,0,0,1,0,1
58941,130,14315,18851;19344;22038,36500,0,0,3,0,3
58942,130,14316,19365;19452,36500,0,0,2,0,2
58943,130,14317,19310;19392;23521,36500,0,1,2,0,3
58944,130,14318,18856;19403,36500,0,0,2,0,2
58945,130,14320,19442;20179;23878;23993,36500,0,2,2,0,4
58946,130,14321,19257;19445;22723,36500,0,0,3,0,3
58947,130,14322,19451;19889;22974;23326;23656;23759;23865,36500,0,3,4,0,7
58948,130,14323,19457;23635,36500,0,1,1,0,2
58949,130,14325,19450;19786,36500,0,0,2,0,2
58950,130,14326,19518;19693,36500,0,0,2,0,2
58951,130,14327,19187;19642,36500,0,0,2,0,2
58952,130,14328,19354;19631,36500,0,0,2,0,2
58953,130,14330,19124;19647;23529;23859,36500,0,2,2,0,4
58954,130,14331,19650;20129;23770,36500,0,1,2,0,3
58955,130,14332,19784;19807;23541,36500,0,1,2,0,3
58956,130,14333,19687;19874;23434;23860,36500,0,1,3,0,4
58957,130,14334,20092;20306;23670;24099,36500,0,2,2,0,4
58958,130,14335,19740;19755;22737;23650;23752,36500,0,2,3,0,5
58959,130,14336,19747;19827;23441,36500,0,0,3,0,3
58960,130,14337,19624;19780;23754,36500,0,1,2,0,3
58961,130,14338,20142;20287,36500,0,0,2,0,2
58962,130,14339,19698;20260;22632;24574,36500,0,1,3,0,4
58963,130,14340,19828;20177,36500,0,0,2,0,2
58964,130,14341,19834;19853;23323,36500,0,0,3,0,3
58965,130,14342,19805;19842;23153;23542,36500,0,1,3,0,4
58966,130,14343,19884;20174;23992;24207,36500,0,2,2,0,4
58967,130,14344,19855;19990;23324;23864,36500,0,1,3,0,4
58968,130,14345,19422;19857,36500,0,0,2,0,2
58969,130,14346,19876;19894,36500,0,0,2,0,2
58970,130,14348,19649;23322;23858;24690,36500,0,2,2,0,4
58971,130,14349,19663;19929;23660;23763,36500,0,2,2,0,4
58972,130,14350,19566;19945;22620,36500,0,0,3,0,3
58973,130,14351,19947;20283;24216;24397,36500,0,2,2,0,4
58974,130,14352,19685;19958,36500,0,0,2,0,2
58975,130,14353,19960;20000;23766;24203,36500,0,2,2,0,4
58976,130,14354,19816;19964;23440;23756,36500,0,1,3,0,4
58977,130,14355,20132;20249;23260;23777,36500,0,1,3,0,4
58978,130,14356,19983;20109;23769;24474,36500,0,2,2,0,4
58979,130,14359,15601,36865,0,0,0,1,1
58980,130,14362,15541,36865,0,0,0,1,1
58981,130,14364,15461,36865,0,0,0,1,1
58982,130,14367,16296,36865,0,0,0,1,1
58983,130,14370,16018,36865,0,0,0,1,1
58984,130,14376,16569,36865,0,0,0,1,1
58985,130,14380,16929,36865,0,0,0,1,1
58986,130,14381,16880;17168,36865,0,0,0,2,2
58987,130,14382,17504;17770,36865,0,0,0,2,2
58988,130,14386,17264;17479,36865,0,0,0,2,2
58989,130,14390,17286,36865,0,0,0,1,1
58990,130,14393,17746;18359,36865,0,0,1,1,2
58991,130,14397,18535,36865,0,0,1,0,1
58992,130,14402,18391;18482,36865,0,0,2,0,2
58993,130,14403,18136;18264,36865,0,0,1,1,2
58994,130,14404,18592,36865,0,0,1,0,1
58995,130,14405,18285;18551;22666;25002,36865,1,0,3,0,4
58996,130,14406,18358;18474,36865,0,0,2,0,2
58997,130,14407,18375;18882;23192,36865,0,0,3,0,3
58998,130,14411,18978,36865,0,0,1,0,1
58999,130,14412,18533;18608,36865,0,0,2,0,2
59000,130,14414,18711;18717,36865,0,0,2,0,2
59001,130,14415,18997;23511,36865,0,1,1,0,2
59002,130,14416,18831;19138,36865,0,0,2,0,2
59003,130,14417,18843;19318,36865,0,0,2,0,2
59004,130,14419,18537;19127,36865,0,0,2,0,2
59005,130,14420,19102;22806,36865,0,0,2,0,2
59006,130,14422,19395,36865,0,0,1,0,1
59007,130,14423,19184,36865,0,0,1,0,1
59008,130,14424,19202;19324,36865,0,0,2,0,2
59009,130,14425,18834;19308,36865,0,0,2,0,2
59010,130,14426,19337,36865,0,0,1,0,1
59011,130,14427,19397;22614;23152,36865,0,0,3,0,3
59012,130,14428,18906;19376,36865,0,0,2,0,2
59013,130,14429,19227;19911;23547;23658,36865,0,2,2,0,4
59014,130,14430,19343;19765;23753,36865,0,1,2,0,3
59015,130,14431,19156;19615;22159,36865,0,0,3,0,3
59016,130,14432,20152;23463,36865,0,0,2,0,2
59017,130,14433,19505;19517;22045,36865,0,0,3,0,3
59018,130,14434,19888;19898;23444,36865,0,0,3,0,3
59019,130,14435,19568;22046;23050,36865,0,0,3,0,3
59020,130,14436,19598;19925;23328,36865,0,0,3,0,3
59021,130,14437,19611;19634,36865,0,0,2,0,2
59022,130,14440,19606;19636,36865,0,0,2,0,2
59023,130,14441,19535;19660;22604;23143,36865,0,0,4,0,4
59024,130,14442,19477;19672,36865,0,0,2,0,2
59025,130,14443,19506;19678;24198,36865,0,1,2,0,3
59026,130,14444,19702;19799;23532;23647,36865,0,2,2,0,4
59027,130,14445,19708;20098;23459,36865,0,0,3,0,3
59028,130,14446,19472;19709,36865,0,0,2,0,2
59029,130,14447,19823;19836,36865,0,0,2,0,2
59030,130,14449,19940;20103;24293,36865,0,1,2,0,3
59031,130,14450,19841;20418,36865,0,0,2,0,2
59032,130,14451,19638;19849;23863,36865,0,1,2,0,3
59033,130,14452,19955;23159;23330;23449;23548,36865,0,1,4,0,5
59034,130,14453,20050;20237;23674;23776;24299,36865,0,3,2,0,5
59035,130,14454,19899;23760;24095,36865,0,2,1,0,3
59036,130,14455,20292,36865,0,0,1,0,1
59037,130,14456,19935;20380;23578;24224,36865,0,2,2,0,4
59038,130,14457,19962;20115;23337;24294,36865,0,1,3,0,4
59039,130,14458,20013;20111,36865,0,0,2,0,2
59040,130,14459,19763;19978;23662,36865,0,1,2,0,3
59041,130,14460,19466;19986;24292,36865,0,1,2,0,3
59042,130,14461,19739;19994;22861;23160,36865,0,0,4,0,4
59043,130,14462,20006;20202;23162,36865,0,0,3,0,3
59044,130,14463,20022;20143;23664,36865,0,1,2,0,3
59045,130,14464,20030;20383;24112,36865,0,1,2,0,3
59046,130,14465,20429,36865,0,0,1,0,1
59047,130,14470,15486,37230,0,0,0,1,1
59048,130,14472,15539,37230,0,0,0,1,1
59049,130,14473,14978,37230,0,0,0,1,1
59050,130,14474,15286,37230,0,0,0,1,1
59051,130,14480,16289;16385,37230,0,0,0,2,2
59052,130,14481,15563,37230,0,0,0,1,1
59053,130,14485,16957,37230,0,0,0,1,1
59054,130,14486,17032;17373,37230,0,0,0,2,2
59055,130,14494,16902,37230,0,0,0,1,1
59056,130,14498,18011;18061,37230,0,0,0,2,2
59057,130,14499,17159,37230,0,0,0,1,1
59058,130,14502,18312;19194,37230,0,0,2,0,2
59059,130,14503,22580;22707;25299,37230,1,0,2,0,3
59060,130,14504,18740,37230,0,0,1,0,1
59061,130,14506,18819;18991;22913,37230,0,0,3,0,3
59062,130,14507,18887;19122;23629,37230,0,1,2,0,3
59063,130,14508,18752;18928,37230,0,0,2,0,2
59064,130,14509,18572;19021;22436,37230,0,0,3,0,3
59065,130,14510,19103;19667,37230,0,0,2,0,2
59066,130,14511,19313,37230,0,0,1,0,1
59067,130,14512,19151;19251,37230,0,0,2,0,2
59068,130,14514,18941;19270,37230,0,0,2,0,2
59069,130,14515,19368;19415,37230,0,0,2,0,2
59070,130,14516,19290;19465;22952;23418,37230,0,0,4,0,4
59071,130,14517,19480;19592;23217;23855,37230,0,1,3,0,4
59072,130,14518,19485;22829;23312;23422,37230,0,0,4,0,4
59073,130,14519,19481;19764;22846,37230,0,0,3,0,3
59074,130,14520,19887,37230,0,0,1,0,1
59075,130,14521,19538;19726;22957,37230,0,0,3,0,3
59076,130,14522,19402;19583;23527,37230,0,1,2,0,3
59077,130,14523,19571;19797;23234;24201,37230,0,1,3,0,4
59078,130,14524,19795;20148;22972;23978,37230,0,1,3,0,4
59079,130,14525,19424;19655;22733,37230,0,0,3,0,3
59080,130,14526,19528;19591,37230,0,0,2,0,2
59081,130,14527,19630;19691;23972,37230,0,1,2,0,3
59082,130,14528,19705;20247;23999,37230,0,1,2,0,3
59083,130,14529,19729;19730;23975,37230,0,1,2,0,3
59084,130,14530,20058;20059;22977;23336;23873,37230,0,1,4,0,5
59085,130,14531,19970;22363,37230,0,0,2,0,2
59086,130,14532,19779;23150,37230,0,0,2,0,2
59087,130,14533,20042;20189;23335,37230,0,0,3,0,3
59088,130,14534,20135;22865;23462;24103,37230,0,1,3,0,4
59089,130,14536,19897;19904;23447,37230,0,0,3,0,3
59090,130,14537,20482;23688,37230,0,1,1,0,2
59091,130,14538,19937;19995;23661;24097,37230,0,2,2,0,4
59092,130,14539,19459;19941,37230,0,0,2,0,2
59093,130,14540,20126;23672,37230,0,1,1,0,2
59094,130,14541,20009;20479;23365;23482;24013,37230,0,1,4,0,5
59095,130,14542,20024;20213;23347,37230,0,0,3,0,3
59096,130,14544,20039;20323;23785;23894,37230,0,2,2,0,4
59097,130,14545,20365;20381,37230,0,0,2,0,2
59098,130,14546,19954;20074;23164;23457,37230,0,0,4,0,4
59099,130,14547,20075;20222,37230,0,0,2,0,2
59100,130,14548,20018;20091;23669;23988,37230,0,2,2,0,4
59101,130,14550,19679;20097;22978;23251;24392,37230,0,1,4,0,5
59102,130,14551,20112;23461;24691,37230,0,1,2,0,3
59103,130,14552,20458;23089;23580,37230,0,1,2,0,3
59104,130,14553,20219;20316;23472;24806,37230,1,0,3,0,4
59105,130,14554,20147;20261,37230,0,0,2,0,2
59106,130,14555,20154;22981;23771;24206,37230,0,2,2,0,4
59107,130,14558,15322,37595,0,0,0,1,1
59108,130,14559,15292,37595,0,0,0,1,1
59109,130,14560,15652,37595,0,0,0,1,1
59110,130,14562,15114,37595,0,0,0,1,1
59111,130,14564,15701,37595,0,0,0,1,1
59112,130,14565,16096,37595,0,0,0,1,1
59113,130,14570,16412;16448,37595,0,0,0,2,2
59114,130,14573,16590,37595,0,0,0,1,1
59115,130,14574,15653,37595,0,0,0,1,1
59116,130,14575,16696,37595,0,0,0,1,1
59117,130,14576,16355;16739,37595,0,0,0,2,2
59118,130,14580,17021,37595,0,0,0,1,1
59119,130,14592,17895;18255;22380,37595,0,0,2,1,3
59120,130,14596,18305;18384,37595,0,0,2,0,2
59121,130,14597,18111;18412;22522,37595,0,0,2,1,3
59122,130,14599,18673;19028,37595,0,0,2,0,2
59123,130,14600,19239,37595,0,0,1,0,1
59124,130,14602,18806;23404,37595,0,0,2,0,2
59125,130,14604,18964;19640;22482;22732,37595,0,0,4,0,4
59126,130,14606,19095;19326,37595,0,0,2,0,2
59127,130,14607,18745,37595,0,0,1,0,1
59128,130,14609,18950;19090,37595,0,0,2,0,2
59129,130,14610,19332;19428;23214;23523,37595,0,1,3,0,4
59130,130,14611,19706;19895,37595,0,0,2,0,2
59131,130,14612,19646;22483,37595,0,0,2,0,2
59132,130,14613,19469;19988;23984,37595,0,1,2,0,3
59133,130,14614,19496,37595,0,0,1,0,1
59134,130,14615,19519;19767;22613,37595,0,0,3,0,3
59135,130,14616,19750;20002;23331;23453;24473,37595,0,1,4,0,5
59136,130,14617,19200;19600,37595,0,0,2,0,2
59137,130,14618,19623;19684;22256;23646;23749,37595,0,2,3,0,5
59138,130,14619,19695;20099;23079;23252;23555,37595,0,1,4,0,5
59139,130,14621,19544;19700;24087,37595,0,1,2,0,3
59140,130,14622,19752;20173;23877,37595,0,1,2,0,3
59141,130,14623,20194;24396,37595,0,1,1,0,2
59142,130,14624,19770;19905;23327;23761;23866,37595,0,2,3,0,5
59143,130,14626,20359;22636;23895;25297,37595,1,1,2,0,4
59144,130,14627,20356;20539;22642;24402,37595,0,1,3,0,4
59145,130,14628,18560;19081;23852,37595,0,1,2,0,3
59146,130,14629,19871;20149;23559;24298;24395,37595,0,3,2,0,5
59147,130,14630,19923;19984,37595,0,0,2,0,2
59148,130,14631,20071;20184;23773,37595,0,1,2,0,3
59149,130,14632,19806;19982,37595,0,0,2,0,2
59150,130,14633,20049;20347;22635;23361;25296,37595,1,0,4,0,5
59151,130,14634,19936;23241,37595,0,0,2,0,2
59152,130,14635,19746;19942;22857;25008,37595,1,0,3,0,4
59153,130,14636,19766;19951;23242;24098,37595,0,1,3,0,4
59154,130,14637,19972,37595,0,0,1,0,1
59155,130,14638,19833;20167;23673,37595,0,1,2,0,3
59156,130,14639,20038;20628;22494;23666,37595,0,1,3,0,4
59157,130,14640,20491;20557;23689;24014,37595,0,2,2,0,4
59158,130,14645,19991;20288;22983;23263;23354,37595,0,0,5,0,5
59159,130,14646,20255;23352;23562,37595,0,1,2,0,3
59160,130,14647,20432;20550;23794;24017,37595,0,2,2,0,4
59161,130,14648,20082;20191;23465,37595,0,0,3,0,3
59162,130,14649,19938;20176;23256;23343;23560;24208;25206,37595,1,2,4,0,7
59163,130,14650,20185;20227,37595,0,0,2,0,2
59164,130,14651,19908;20352;23266;24002,37595,0,1,3,0,4
59165,130,14652,20168;20212,37595,0,0,2,0,2
59166,130,14653,20139;20239;23675;23997,37595,0,2,2,0,4
59167,130,14654,19839;20242;23882;24477,37595,0,2,2,0,4
59168,130,14655,19975;20017;23163;24389,37595,0,1,3,0,4
59169,130,14656,20272;20362;23782,37595,0,1,2,0,3
59170,130,14657,20279;20456,37595,0,0,2,0,2
59171,130,14658,20428,37595,0,0,1,0,1
59172,130,14659,14853,37960,0,0,0,1,1
59173,130,14666,15186,37960,0,0,0,1,1
59174,130,14670,16101,37960,0,0,0,1,1
59175,130,14671,16153,37960,0,0,0,1,1
59176,130,14672,16085,37960,0,0,0,1,1
59177,130,14673,16237;16657,37960,0,0,0,2,2
59178,130,14677,16604,37960,0,0,0,1,1
59179,130,14678,16726,37960,0,0,0,1,1
59180,130,14682,16984,37960,0,0,0,1,1
59181,130,14687,16436,37960,0,0,0,1,1
59182,130,14689,16559,37960,0,0,0,1,1
59183,130,14697,17486,37960,0,0,0,1,1
59184,130,14698,17694;18068,37960,0,0,0,2,2
59185,130,14700,17543;17931,37960,0,0,0,2,2
59186,130,14701,17740;17998,37960,0,0,0,2,2
59187,130,14703,18045,37960,0,0,0,1,1
59188,130,14710,18154;18181,37960,0,0,1,1,2
59189,130,14711,18031;18302,37960,0,0,1,1,2
59190,130,14713,18641;18907,37960,0,0,2,0,2
59191,130,14715,18986;19359;23129;23308,37960,0,0,4,0,4
59192,130,14717,18862;18893,37960,0,0,2,0,2
59193,130,14718,19497;23047;23137,37960,0,0,3,0,3
59194,130,14719,18372;18999,37960,0,0,2,0,2
59195,130,14722,19165;22447,37960,0,0,2,0,2
59196,130,14723,19683,37960,0,0,1,0,1
59197,130,14724,19534,37960,0,0,1,0,1
59198,130,14725,18827;19423,37960,0,0,2,0,2
59199,130,14726,19005;19169,37960,0,0,2,0,2
59200,130,14727,19066;19674;23224,37960,0,0,3,0,3
59201,130,14730,19487;19863;23758,37960,0,1,2,0,3
59202,130,14731,19594;23971,37960,0,1,1,0,2
59203,130,14732,18813;19034;22902,37960,0,0,3,0,3
59204,130,14734,19903,37960,0,0,1,0,1
59205,130,14736,19613;19943,37960,0,0,2,0,2
59206,130,14737,19653;19694;23222,37960,0,0,3,0,3
59207,130,14738,19676;19731,37960,0,0,2,0,2
59208,130,14741,19715;23147;23534,37960,0,1,2,0,3
59209,130,14742,19436;19725;23438;23750,37960,0,1,3,0,4
59210,130,14743,19564;19989;23451,37960,0,0,3,0,3
59211,130,14744,19883;20081,37960,0,0,2,0,2
59212,130,14745,19570;19924,37960,0,0,2,0,2
59213,130,14746,19721;19928;22490,37960,0,0,3,0,3
59214,130,14747,19885;19952,37960,0,0,2,0,2
59215,130,14748,20003;20621,37960,0,0,2,0,2
59216,130,14749,20349;22266;23787,37960,0,1,2,0,3
59217,130,14751,20029;23075;23333;25127,37960,1,0,3,0,4
59218,130,14752,20476;24306,37960,0,1,1,0,2
59219,130,14753,20090;20404;24006,37960,0,1,2,0,3
59220,130,14754,20169;20681,37960,0,0,2,0,2
59221,130,14755,20190;20510;23485,37960,0,0,3,0,3
59222,130,14756,20057;20198;23667,37960,0,1,2,0,3
59223,130,14757,20280;20423;23568,37960,0,1,2,0,3
59224,130,14759,20218;20297;23169;23356,37960,0,0,4,0,4
59225,130,14760,20308;20448;23687,37960,0,1,2,0,3
59226,130,14761,19946;20314;22633;23680,37960,0,1,3,0,4
59227,130,14762,20267;20320;23892,37960,0,1,2,0,3
59228,130,14763,20205;20462;23270;24012;25016,37960,1,1,3,0,5
59229,130,14764,20353;20431,37960,0,0,2,0,2
59230,130,14765,20664;21168;23697;23915,37960,0,2,2,0,4
59231,130,14766,20025;20386;24113;24225,37960,0,2,2,0,4
59232,130,14768,20294;20424;23579;24484,37960,0,2,2,0,4
59233,130,14769,15485,38325,0,0,0,1,1
59234,130,14770,15565,38325,0,0,0,1,1
59235,130,14773,16348;16578,38325,0,0,0,2,2
59236,130,14774,16475;17220,38325,0,0,0,2,2
59237,130,14777,16423;16501,38325,0,0,0,2,2
59238,130,14781,17216,38325,0,0,0,1,1
59239,130,14787,17699;17966,38325,0,0,0,2,2
59240,130,14793,17879;18373,38325,0,0,1,1,2
59241,130,14795,17847;18304;22520,38325,0,0,2,1,3
59242,130,14802,18385,38325,0,0,1,0,1
59243,130,14803,18438;18462,38325,0,0,2,0,2
59244,130,14804,17969,38325,0,0,0,1,1
59245,130,14808,18523;18689,38325,0,0,2,0,2
59246,130,14813,18900;19371,38325,0,0,2,0,2
59247,130,14815,19110;19253,38325,0,0,2,0,2
59248,130,14816,19248;19710;23973,38325,0,1,2,0,3
59249,130,14819,19419;19620;23142;23642,38325,0,1,3,0,4
59250,130,14820,19274;19373,38325,0,0,2,0,2
59251,130,14823,19557;19690,38325,0,0,2,0,2
59252,130,14825,19262;19433;23966,38325,0,1,2,0,3
59253,130,14826,19468;23311,38325,0,0,2,0,2
59254,130,14827,19524;19815;23236;23755,38325,0,1,3,0,4
59255,130,14828,19540;23139,38325,0,0,2,0,2
59256,130,14829,19998,38325,0,0,1,0,1
59257,130,14830,19625;19900;23657,38325,0,1,2,0,3
59258,130,14831,20246;20286;23570,38325,0,1,2,0,3
59259,130,14832,19717,38325,0,0,1,0,1
59260,130,14834,19835;20203;23082;23346;23466;25316,38325,1,0,5,0,6
59261,130,14836,19821;20502;24582,38325,0,1,2,0,3
59262,130,14837,19916;20503;24308;24487,38325,0,2,2,0,4
59263,130,14838,19932;22361;22856,38325,0,0,3,0,3
59264,130,14843,19881;20170;23772;23991,38325,0,2,2,0,4
59265,130,14844,19956;20069;23668,38325,0,1,2,0,3
59266,130,14845,20086;20555;22883;23692,38325,0,1,3,0,4
59267,130,14846,20096;22627;23554,38325,0,1,2,0,3
59268,130,14847,20110;23989,38325,0,1,1,0,2
59269,130,14848,20159;20161;22867;24915,38325,1,0,3,0,4
59270,130,14849,20094;20165,38325,0,0,2,0,2
59271,130,14850,20178;20390,38325,0,0,2,0,2
59272,130,14851,20046;20376;23172,38325,0,0,3,0,3
59273,130,14852,20419;23686;24007,38325,0,2,1,0,3
59274,130,14854,20232;23348,38325,0,0,2,0,2
59275,130,14855,20200;20289;23471;23783,38325,0,1,3,0,4
59276,130,14856,19820;20295;23572;23678,38325,0,2,2,0,4
59277,130,14857,20307;23679;23890,38325,0,2,1,0,3
59278,130,14858,20911;20973;23819;25028;25213,38325,2,1,2,0,5
59279,130,14859,20685;23494;24131;24241,38325,0,2,2,0,4
59280,130,14860,20343,38325,0,0,1,0,1
59281,130,14861,20350;20713,38325,0,0,2,0,2
59282,130,14862,20108;20425;24008,38325,0,1,2,0,3
59283,130,14863,20384;22875;23898,38325,0,1,2,0,3
59284,130,14864,20393;20579;24918,38325,1,0,2,0,3
59285,130,14865,20063;20397;23478;23685,38325,0,1,3,0,4
59286,130,14866,20402;20793;24246;24710;24816,38325,1,2,2,0,5
59287,130,14867,20407;20668,38325,0,0,2,0,2
59288,130,14868,20355;20718;24132,38325,0,1,2,0,3
59289,130,14869,20224;20484;23366,38325,0,0,3,0,3
59290,130,14870,20909;21000;24154;24256;24925,38325,1,2,2,0,5
59291,130,14871,20430;20497;24015;24229;24307;24581,38325,0,4,2,0,6
59292,130,14872,20499;20820;23291;23815,38325,0,1,3,0,4
59293,130,14873,20649;20650;24239,38325,0,1,2,0,3
59294,130,14874,20505;23791,38325,0,1,1,0,2
59295,130,14876,20792;23813;23922;25023,38325,1,2,1,0,4
59296,130,14877,20564;20640;23798,38325,0,1,2,0,3
59297,130,14878,20528,38325,0,0,1,0,1
59298,130,14880,15856,38690,0,0,0,1,1
59299,130,14885,16777,38690,0,0,0,1,1
59300,130,14886,15600,38690,0,0,0,1,1
59301,130,14887,15993,38690,0,0,0,1,1
59302,130,14888,16785;17627,38690,0,0,0,2,2
59303,130,14890,16046,38690,0,0,0,1,1
59304,130,14891,15743,38690,0,0,0,1,1
59305,130,14896,16691,38690,0,0,0,1,1
59306,130,14902,17426;18035;22997,38690,0,0,1,2,3
59307,130,14905,17083,38690,0,0,0,1,1
59308,130,14906,17578;17791,38690,0,0,0,2,2
59309,130,14907,17589;17964,38690,0,0,0,2,2
59310,130,14913,17844;18140,38690,0,0,0,2,2
59311,130,14914,17860,38690,0,0,0,1,1
59312,130,14915,17556,38690,0,0,0,1,1
59313,130,14916,17990,38690,0,0,0,1,1
59314,130,14920,19235;23304;25207,38690,1,0,2,0,3
59315,130,14921,18805;18994;22126,38690,0,0,3,0,3
59316,130,14923,19404;19582,38690,0,0,2,0,2
59317,130,14924,19372,38690,0,0,1,0,1
59318,130,14925,18576;18643;23009,38690,0,0,3,0,3
59319,130,14926,18719;18829,38690,0,0,2,0,2
59320,130,14928,18932;22220;23110;23627,38690,0,1,3,0,4
59321,130,14931,18918;19012,38690,0,0,2,0,2
59322,130,14932,19174;19223,38690,0,0,2,0,2
59323,130,14933,19241;19670;23432,38690,0,0,3,0,3
59324,130,14935,19742;23539;24200,38690,0,2,1,0,3
59325,130,14936,19379,38690,0,0,1,0,1
59326,130,14938,19425;19953;22858;23765,38690,0,1,3,0,4
59327,130,14939,19434;19722;23060;23535,38690,0,1,3,0,4
59328,130,14940,19447;19563,38690,0,0,2,0,2
59329,130,14941,19085;19536,38690,0,0,2,0,2
59330,130,14942,19817;19921;23238,38690,0,0,3,0,3
59331,130,14943,19621;20067;23553;23874,38690,0,2,2,0,4
59332,130,14945,19728;20199;23345,38690,0,0,3,0,3
59333,130,14946,19507;19628;23528;23857,38690,0,2,2,0,4
59334,130,14947,19979;20055;23078;24391,38690,0,1,3,0,4
59335,130,14948,19788;19915,38690,0,0,2,0,2
59336,130,14949,19654;19869;23156;23325;23442,38690,0,0,5,0,5
59337,130,14950,20196;20214;23467;23774;24209,38690,0,2,3,0,5
59338,130,14951,19847;20051,38690,0,0,2,0,2
59339,130,14952,19246;19867;23654,38690,0,1,2,0,3
59340,130,14953,19413,38690,0,0,1,0,1
59341,130,14954,20245;20493;23883;23998;24211,38690,0,3,2,0,5
59342,130,14955,19961;19981,38690,0,0,2,0,2
59343,130,14956,20034,38690,0,0,1,0,1
59344,130,14957,19756;20040;23985,38690,0,1,2,0,3
59345,130,14958,19720;20121;23671;23876,38690,0,2,2,0,4
59346,130,14959,20413;23268;23899,38690,0,1,2,0,3
59347,130,14960,20130;20394;22639;23364;24114,38690,0,1,4,0,5
59348,130,14961,20134;22628;24394,38690,0,1,2,0,3
59349,130,14962,19704;20145;23321;23648;24088,38690,0,2,3,0,5
59350,130,14963,20474;23902,38690,0,1,1,0,2
59351,130,14964,20181;24105,38690,0,1,1,0,2
59352,130,14965,20204;20720;23376;24319;24705,38690,0,2,3,0,5
59353,130,14966,20235;20290;22631;23469;23775,38690,0,1,4,0,5
59354,130,14967,20056;20536;22769;23583;23908;24488,38690,0,3,3,0,6
59355,130,14968,20373;23362;24004,38690,0,1,2,0,3
59356,130,14969,20014;20275;22498;23567;24107,38690,0,2,3,0,5
59357,130,14970,19918;20300;23357;23573;23887,38690,0,2,3,0,5
59358,130,14971,20379,38690,0,0,1,0,1
59359,130,14972,20333;20399;24220,38690,0,1,2,0,3
59360,130,14973,20225;20595;24235,38690,0,1,2,0,3
59361,130,14974,20672;20723;24240,38690,0,1,2,0,3
59362,130,14976,20651,38690,0,0,1,0,1
59363,130,14977,20021;20412;22986;24304;24578,38690,0,2,3,0,5
59364,130,14978,20162;20442;24117,38690,0,1,2,0,3
59365,130,14979,20449;20802,38690,0,0,2,0,2
59366,130,14980,20451;20940;24254;24821,38690,1,1,2,0,4
59367,130,14981,19997;20403;22876;24226,38690,0,1,3,0,4
59368,130,14982,20488;20569;23371,38690,0,0,3,0,3
59369,130,14983,20490;20605;24311,38690,0,1,2,0,3
59370,130,14984,20053;20378;23897;24005,38690,0,2,2,0,4
59371,130,14985,20415;20495;23484;23690,38690,0,1,3,0,4
59372,130,14986,20525;20527;22881,38690,0,0,3,0,3
59373,130,14987,20540;20570;23588;24019;24403,38690,0,3,2,0,5
59374,130,14988,20553;20559;23369;23693;24018,38690,0,2,3,0,5
59375,130,14989,20511;20576;24401,38690,0,1,2,0,3
59376,130,14990,20587;20863,38690,0,0,2,0,2
59377,130,14991,20624;20627;23373,38690,0,0,3,0,3
59378,130,14993,15702,39055,0,0,0,1,1
59379,130,14998,16143,39055,0,0,0,1,1
59380,130,15001,16806,39055,0,0,0,1,1
59381,130,15002,15889,39055,0,0,0,1,1
59382,130,15004,16594;16893,39055,0,0,0,2,2
59383,130,15021,17989,39055,0,0,0,1,1
59384,130,15022,18287;19170,39055,0,0,2,0,2
59385,130,15026,18623;18915;23405,39055,0,0,3,0,3
59386,130,15027,18322;19061;22228;24567,39055,0,1,3,0,4
59387,130,15029,18812;19330;22819,39055,0,0,3,0,3
59388,130,15030,18316;18726,39055,0,0,2,0,2
59389,130,15033,18536;18650,39055,0,0,2,0,2
59390,130,15035,19272;19463;24086,39055,0,1,2,0,3
59391,130,15038,19231;22239;23120,39055,0,0,3,0,3
59392,130,15041,18947;19618,39055,0,0,2,0,2
59393,130,15042,19352;19559;23640,39055,0,1,2,0,3
59394,130,15043,19327;19614;23430,39055,0,0,3,0,3
59395,130,15044,19456,39055,0,0,1,0,1
59396,130,15047,19689;19856,39055,0,0,2,0,2
59397,130,15048,18981;19581,39055,0,0,2,0,2
59398,130,15049,19214;19723;23061;23974,39055,0,1,3,0,4
59399,130,15051,19808;20144,39055,0,0,2,0,2
59400,130,15052,19830;19846;23068,39055,0,0,3,0,3
59401,130,15053,20087;20268;23565;23779;24301,39055,0,3,2,0,5
59402,130,15056,19931;23764;23981,39055,0,2,1,0,3
59403,130,15057,19510;19648;22954;23969,39055,0,1,3,0,4
59404,130,15058,20498;23904;24118,39055,0,2,1,0,3
59405,130,15059,20008;20088;23332;23454;23663,39055,0,1,4,0,5
59406,130,15060,20011;22751,39055,0,0,2,0,2
59407,130,15062,20688;24406;24701,39055,0,2,1,0,3
59408,130,15063,20680;20708;23283;24405,39055,0,1,3,0,4
59409,130,15064,20114;20344;23474,39055,0,0,3,0,3
59410,130,15065,20113;20120;24393,39055,0,1,2,0,3
59411,130,15066,19927;20642;24237;24697;24810,39055,1,2,2,0,5
59412,130,15067,20166;20766;23811;23921;24708,39055,0,3,2,0,5
59413,130,15068,20220;20535;23489;23582,39055,0,1,3,0,4
59414,130,15069,20259;20606;23277;24312,39055,0,1,3,0,4
59415,130,15070,20730;20803;23284,39055,0,0,3,0,3
59416,130,15071,20585;23589;24234,39055,0,2,1,0,3
59417,130,15072,20281;20809;23290,39055,0,0,3,0,3
59418,130,15073,20291;24692,39055,0,1,1,0,2
59419,130,15074,20296,39055,0,0,1,0,1
59420,130,15076,20630;20862;24248,39055,0,1,2,0,3
59421,130,15077,20201;20435,39055,0,0,2,0,2
59422,130,15078,20443,39055,0,0,1,0,1
59423,130,15079,20100;20455;22764,39055,0,0,3,0,3
59424,130,15080,20461;20538;23368;24231,39055,0,1,3,0,4
59425,130,15081,20463;20890,39055,0,0,2,0,2
59426,130,15082,20150;20375;24223,39055,0,1,2,0,3
59427,130,15083,20172;24475,39055,0,1,1,0,2
59428,130,15084,20932;23820,39055,0,1,1,0,2
59429,130,15085,20869;21013;23383;24818,39055,1,0,3,0,4
59430,130,15086,20812;20949;24335;24603;24718,39055,0,3,2,0,5
59431,130,15089,20252;20547;23586;24585,39055,0,2,2,0,4
59432,130,15090,20317;20552;23490;23796;24490,39055,0,2,3,0,5
59433,130,15091,20340;20574;23274;24021;24491,39055,0,2,3,0,5
59434,130,15092,21048;24051;24512,39055,0,2,1,0,3
59435,130,15093,20043;20598;24023,39055,0,1,2,0,3
59436,130,15094,20524;20626;23695;24126;24696,39055,0,3,2,0,5
59437,130,15095,20326;20636;23805,39055,0,1,2,0,3
59438,130,15096,20473;20653,39055,0,0,2,0,2
59439,130,15097,20661;20717;23809;24030,39055,0,2,2,0,4
59440,130,15098,20634;20692;23280;24588,39055,0,1,3,0,4
59441,130,15099,20845;20924;24148;24600,39055,0,2,2,0,4
59442,130,15100,20638;20746;23918,39055,0,1,2,0,3
59443,130,15102,16013,39420,0,0,0,1,1
59444,130,15104,16155,39420,0,0,0,1,1
59445,130,15105,16519,39420,0,0,0,1,1
59446,130,15107,17240,39420,0,0,0,1,1
59447,130,15111,16205;16618,39420,0,0,0,2,2
59448,130,15116,17414,39420,0,0,0,1,1
59449,130,15133,18291,39420,0,0,1,0,1
59450,130,15135,18682,39420,0,0,1,0,1
59451,130,15136,18518;18588,39420,0,0,2,0,2
59452,130,15137,19474;19502;22953;23419,39420,0,0,4,0,4
59453,130,15142,19026;19042,39420,0,0,2,0,2
59454,130,15144,20193;23257;24476,39420,0,1,2,0,3
59455,130,15145,19714;23058;23227;23533,39420,0,1,3,0,4
59456,130,15147,19205;19292,39420,0,0,2,0,2
59457,130,15149,19464,39420,0,0,1,0,1
59458,130,15150,19651,39420,0,0,1,0,1
59459,130,15151,19713;20035;23076;23247;23551;25013,39420,1,1,4,0,6
59460,130,15152,19637,39420,0,0,1,0,1
59461,130,15154,20250;20369;24003;24222,39420,0,2,2,0,4
59462,130,15155,19845;20101;23556;24204,39420,0,2,2,0,4
59463,130,15156,19460;19877,39420,0,0,2,0,2
59464,130,15158,19586;19968,39420,0,0,2,0,2
59465,130,15159,20083;20643;24589,39420,0,1,2,0,3
59466,130,15160,20123;23165;23254;24205,39420,0,1,3,0,4
59467,130,15161,20125;20155,39420,0,0,2,0,2
59468,130,15162,20556;23909,39420,0,1,1,0,2
59469,130,15164,20879;20935;24421,39420,0,1,2,0,3
59470,130,15165,20354;23576,39420,0,1,1,0,2
59471,130,15168,20093;20363;24398,39420,0,1,2,0,3
59472,130,15169,20392;20635;23696;23804;24025;24127;24236,39420,0,5,2,0,7
59473,130,15170,20405;20472;23481,39420,0,0,3,0,3
59474,130,15171,20438;20777;24032;24323;24414,39420,0,3,2,0,5
59475,130,15172,20441;20756;23601;23704;24595,39420,0,3,2,0,5
59476,130,15173,20140;20459;24305,39420,0,1,2,0,3
59477,130,15174,20471;21044,39420,0,0,2,0,2
59478,130,15175,21163;23941;24347,39420,0,2,1,0,3
59479,130,15176,20322;20592;23800;23912;24310,39420,0,3,2,0,5
59480,130,15177,20216;20537;22882;23793,39420,0,1,3,0,4
59481,130,15178,20210;20549;24120;24232;24489,39420,0,3,2,0,5
59482,130,15179,20565;20861;24042;24419,39420,0,2,2,0,4
59483,130,15180,20567;20781;24136,39420,0,1,2,0,3
59484,130,15181,20583;20753;23694;24309,39420,0,2,2,0,4
59485,130,15182,20622;21100;24056;25140,39420,1,1,2,0,4
59486,130,15183,20632;20931;24252;24601,39420,0,2,2,0,4
59487,130,15184,20599;20641;23806,39420,0,1,2,0,3
59488,130,15185,20817;21143,39420,0,0,2,0,2
59489,130,15186,20658;20859;23499;23715;24041,39420,0,2,3,0,5
59490,130,15187,20659;20673;23594;24129;24699,39420,0,3,2,0,5
59491,130,15188,20645;20660;24590,39420,0,1,2,0,3
59492,130,15189,20182;20690;23374;23495;23699;24028;24314;24407;24702,39420,0,5,4,0,9
59493,130,15191,20597;20956;23388;23933;25135,39420,1,1,3,0,5
59494,130,15192,20382;20751;23919;24594;25020,39420,1,2,2,0,5
59495,130,15193,20542;20769,39420,0,0,2,0,2
59496,130,15194,20785;20984;24826,39420,1,0,2,0,3
59497,130,15195,20808;20971;24149;25136,39420,1,1,2,0,4
59498,130,15196,20810;24500,39420,0,1,1,0,2
59499,130,15197,20827;20948;23712,39420,0,1,2,0,3
59500,130,15198,20833;21050;23714;24598;25025,39420,1,2,2,0,5
59501,130,15199,20892;23928;25131,39420,1,1,1,0,3
59502,130,15200,15803,39785,0,0,0,1,1
59503,130,15202,16266;16379,39785,0,0,0,2,2
59504,130,15204,16370,39785,0,0,0,1,1
59505,130,15205,16709,39785,0,0,0,1,1
59506,130,15206,16491;16797,39785,0,0,0,2,2
59507,130,15209,16638,39785,0,0,0,1,1
59508,130,15215,16882,39785,0,0,0,1,1
59509,130,15221,17138;17297,39785,0,0,0,2,2
59510,130,15223,17063,39785,0,0,0,1,1
59511,130,15226,16804,39785,0,0,0,1,1
59512,130,15227,17686,39785,0,0,0,1,1
59513,130,15230,17987,39785,0,0,0,1,1
59514,130,15231,17799,39785,0,0,0,1,1
59515,130,15235,19050;22132,39785,0,0,2,0,2
59516,130,15243,18657;19394;23132,39785,0,0,3,0,3
59517,130,15247,19523;23314,39785,0,0,2,0,2
59518,130,15248,19692;20160;24573,39785,0,1,2,0,3
59519,130,15249,19701,39785,0,0,1,0,1
59520,130,15250,19659;20062;22495,39785,0,0,3,0,3
59521,130,15251,19870;20209;22868;25122,39785,1,0,3,0,4
59522,130,15252,20048;20226;22629;22869;23468,39785,0,0,5,0,5
59523,130,15253,19976;23549,39785,0,1,1,0,2
59524,130,15255,20044;23552;23871,39785,0,2,1,0,3
59525,130,15256,20171;23342,39785,0,0,2,0,2
59526,130,15257,20072;20188;23987,39785,0,1,2,0,3
59527,130,15258,20104;20321;23170;23360;23574;23784;23893,39785,0,3,4,0,7
59528,130,15259,20163;20426;23088;24009,39785,0,1,3,0,4
59529,130,15260,20745;23100;24321,39785,0,1,2,0,3
59530,130,15261,20230;20301;23358;23888,39785,0,1,3,0,4
59531,130,15262,20234;23083,39785,0,0,2,0,2
59532,130,15263,20422;20591;23275;24022;24492,39785,0,2,3,0,5
59533,130,15264,19769;20264;23564;23676,39785,0,2,2,0,4
59534,130,15265,20302;20389,39785,0,0,2,0,2
59535,130,15266,20324;20551;23587;23691;23795,39785,0,3,2,0,5
59536,130,15267,20396;20737;24496,39785,0,1,2,0,3
59537,130,15268,20334;20358;24575,39785,0,1,2,0,3
59538,130,15269,20026;20345;23475;23682;24001;24480,39785,0,3,3,0,6
59539,130,15270,20357;23577;23788;24303,39785,0,3,1,0,4
59540,130,15272,20377;20526;24583,39785,0,1,2,0,3
59541,130,15273,20153;20427;23173;23900;24227;25312,39785,1,2,3,0,6
59542,130,15274,20445;20506;22879;23905;24230;24693,39785,0,3,3,0,6
59543,130,15275,20512;20515;23486;23792,39785,0,1,3,0,4
59544,130,15276,20822;23382;23711,39785,0,1,2,0,3
59545,130,15277,20269;20563,39785,0,0,2,0,2
59546,130,15278,20899;25132;25212,39785,2,0,1,0,3
59547,130,15279,20590;20963,39785,0,0,2,0,2
59548,130,15280,21204;21266;23612;25043;25319,39785,2,1,2,0,5
59549,130,15281,20619;21055;24834,39785,1,0,2,0,3
59550,130,15282,20739;24497;24707,39785,0,2,1,0,3
59551,130,15283,20644;20677,39785,0,0,2,0,2
59552,130,15284,20691;20778;24596,39785,0,1,2,0,3
59553,130,15285,20694;20857;23596,39785,0,1,2,0,3
59554,130,15286,20466;20689;24400;24485,39785,0,2,2,0,4
59555,130,15287,20529;20714;23375;24409;24812,39785,1,1,3,0,5
59556,130,15288,21036;24611,39785,0,1,1,0,2
59557,130,15289,20976;23823;24605;24823,39785,1,2,1,0,4
59558,130,15290,20731;20962;24133;25129,39785,1,1,2,0,4
59559,130,15292,20748;20964;24337,39785,0,1,2,0,3
59560,130,15293,20762;23179;23379;24813;25211,39785,2,0,3,0,5
59561,130,15294,20568;20763;23705;24031;24412;24814,39785,1,3,2,0,6
59562,130,15295,20773;20945;24135,39785,0,1,2,0,3
59563,130,15296,20508;20783;24324;24415,39785,0,2,2,0,4
59564,130,15297,20844;21058,39785,0,0,2,0,2
59565,130,15298,20847;20939;24503,39785,0,1,2,0,3
59566,130,15299,20853;21072,39785,0,0,2,0,2
59567,130,15300,20868;21171;25041,39785,1,0,2,0,3
59568,130,15301,20770;20871;24043;24420,39785,0,2,2,0,4
59569,130,15302,20893;21124;23719;24057;24516;24841;25219,39785,2,3,2,0,7
59570,130,15303,20918;21052;23392,39785,0,0,3,0,3
59571,130,15304,20923;20997;24717,39785,0,1,2,0,3
59572,130,15306,20960;21096;23395;23610;24160;25218,39785,1,2,3,0,6
59573,130,15307,20385;21038;23827;24833,39785,1,1,2,0,4
59574,130,15308,16015,40150,0,0,0,1,1
59575,130,15310,17150,40150,0,0,0,1,1
59576,130,15314,16649,40150,0,0,0,1,1
59577,130,15316,16713,40150,0,0,0,1,1
59578,130,15318,16908,40150,0,0,0,1,1
59579,130,15320,16914;17633,40150,0,0,0,2,2
59580,130,15322,17067;17261,40150,0,0,0,2,2
59581,130,15326,17584;17612,40150,0,0,0,2,2
59582,130,15328,17443,40150,0,0,0,1,1
59583,130,15332,18069;18633,40150,0,0,1,1,2
59584,130,15336,18618;19152,40150,0,0,2,0,2
59585,130,15341,18846;19348;22590;23743,40150,0,1,3,0,4
59586,130,15344,19054;19113;22441,40150,0,0,3,0,3
59587,130,15347,19378;19458,40150,0,0,2,0,2
59588,130,15351,19441,40150,0,0,1,0,1
59589,130,15354,19890;22744;23445;24094,40150,0,1,3,0,4
59590,130,15356,20001;20600;24694,40150,0,1,2,0,3
59591,130,15357,19588;20175;23081,40150,0,0,3,0,3
59592,130,15358,20016;20251;24106,40150,0,1,2,0,3
59593,130,15360,19792;20061,40150,0,0,2,0,2
59594,130,15361,20077;20374;23790,40150,0,1,2,0,3
59595,130,15363,19902;20131;22979;23990,40150,0,1,3,0,4
59596,130,15364,19825;20410;24483,40150,0,1,2,0,3
59597,130,15365,20478;20922;22759;23261;23563;23778;24422,40150,0,3,4,0,7
59598,130,15366,20319;20335;23681;24479,40150,0,2,2,0,4
59599,130,15367,20520;20594;23906,40150,0,1,2,0,3
59600,130,15369,20408;20927;24423,40150,0,1,2,0,3
59601,130,15370,20421;20696;23597;24703,40150,0,2,2,0,4
59602,130,15372,20339;20439;23901;24116,40150,0,2,2,0,4
59603,130,15373,20440;20485;23174;23367,40150,0,0,4,0,4
59604,130,15374,20409;20492;24228;24486;24580,40150,0,3,2,0,5
59605,130,15375,20277;23885;24214,40150,0,2,1,0,3
59606,130,15376,20811;24817,40150,1,0,1,0,2
59607,130,15378,20483;20504,40150,0,0,2,0,2
59608,130,15379,20667;20998;24153;24719,40150,0,2,2,0,4
59609,130,15381,20639;20959;24255,40150,0,1,2,0,3
59610,130,15382,20341;20754;23920,40150,0,1,2,0,3
59611,130,15383,21281;24734,40150,0,1,1,0,2
59612,130,15384,20896;21284;23949;24353;24937,40150,1,2,2,0,5
59613,130,15385,20816;20882;23710;24038,40150,0,2,2,0,4
59614,130,15386,20828;21022;25138,40150,1,0,2,0,3
59615,130,15388,20854;20966;23389;23934;24049;24338;24425;24822,40150,1,4,3,0,8
59616,130,15389,21154;24729,40150,0,1,1,0,2
59617,130,15390,20866;21196;23721;23943;24519;24622;24933;25221,40150,2,4,2,0,8
59618,130,15392,20946;20985;24606,40150,0,1,2,0,3
59619,130,15393,20895;21198,40150,0,0,2,0,2
59620,130,15394,20926;20943;23386;25134,40150,1,0,3,0,4
59621,130,15395,20929;23387,40150,0,0,2,0,2
59622,130,15397,20874;21103;24929,40150,1,0,2,0,3
59623,130,15398,20977;21181;23390;24340,40150,0,1,3,0,4
59624,130,15399,21238;21344;24437;24522;25046,40150,1,2,2,0,5
59625,130,15400,21011;21159;24050;24721,40150,0,2,2,0,4
59626,130,15401,21012;23295,40150,0,0,2,0,2
59627,130,15402,16521;16752,40515,0,0,0,2,2
59628,130,15404,16331,40515,0,0,0,1,1
59629,130,15405,17113,40515,0,0,0,1,1
59630,130,15407,17170,40515,0,0,0,1,1
59631,130,15417,18077;18816;22013,40515,0,0,2,1,3
59632,130,15426,18685;19164;22810,40515,0,0,3,0,3
59633,130,15427,18773;19340;23126,40515,0,0,3,0,3
59634,130,15429,18802;19179,40515,0,0,2,0,2
59635,130,15436,19762;20070;23875,40515,0,1,2,0,3
59636,130,15438,19796,40515,0,0,1,0,1
59637,130,15439,19584;19812;23235,40515,0,0,3,0,3
59638,130,15440,20137,40515,0,0,1,0,1
59639,130,15443,19893;20127;23558;24101,40515,0,2,2,0,4
59640,130,15444,19597,40515,0,0,1,0,1
59641,130,15445,19896;20611,40515,0,0,2,0,2
59642,130,15446,19967;20311;23891,40515,0,1,2,0,3
59643,130,15447,20078,40515,0,0,1,0,1
59644,130,15448,20327;20814;23709;23923;24140,40515,0,3,2,0,5
59645,130,15449,20124;20208,40515,0,0,2,0,2
59646,130,15451,20370;24481,40515,0,1,1,0,2
59647,130,15454,20256;20795;22992;24035,40515,0,1,3,0,4
59648,130,15455,20303;23889;24109;24302,40515,0,3,1,0,4
59649,130,15456,20310;20684,40515,0,0,2,0,2
59650,130,15457,20607;20620;23591;24809;24919,40515,2,1,2,0,5
59651,130,15458,20372;20437;23480,40515,0,0,3,0,3
59652,130,15459,20457;22641;25014,40515,1,0,2,0,3
59653,130,15460,20450;20818;23924,40515,0,1,2,0,3
59654,130,15461,20480;20736;23099;24134;24243;24320;24411;24495;24593;25205,40515,1,6,3,0,10
59655,130,15463,20728;23917;24410;24921,40515,1,2,1,0,4
59656,130,15465,20342;20541,40515,0,0,2,0,2
59657,130,15466,20995;25137,40515,1,0,1,0,2
59658,130,15467,20674;20780;23602;24033;24245,40515,0,3,2,0,5
59659,130,15468,20613;21025;23825;23938;24431,40515,0,3,2,0,5
59660,130,15470,20679;20996;23935;24429;24924,40515,1,2,2,0,5
59661,130,15471,20338;20807;24037;24139,40515,0,2,2,0,4
59662,130,15472,20453;20697;23598;23701;23916,40515,0,3,2,0,5
59663,130,15473,20699;24316;24920,40515,1,1,1,0,3
59664,130,15474,20417;20712;24029;24242;24318,40515,0,3,2,0,5
59665,130,15475,20747;20801;23381;24036;25024,40515,1,1,3,0,5
59666,130,15476,20646;20791;23707;23812;24137;24325;25022,40515,1,4,2,0,7
59667,130,15477,20707;20823;24039;24326;24501,40515,0,3,2,0,5
59668,130,15478,20841;21015;23937;24830,40515,1,1,2,0,4
59669,130,15479,21164;23942;25040,40515,1,1,1,0,3
59670,130,15480,20886;21114,40515,0,0,2,0,2
59671,130,15481,20912;25029,40515,1,0,1,0,2
59672,130,15482,20702;20917;24047;24146;24506,40515,0,3,2,0,5
59673,130,15483,20930;21311,40515,0,0,2,0,2
59674,130,15484,20889;20942,40515,0,0,2,0,2
59675,130,15485,20947;21066;24433,40515,0,1,2,0,3
59676,130,15486,20732;20952;24424;24508,40515,0,2,2,0,4
59677,130,15487,20965;21201;24623;24730,40515,0,2,2,0,4
59678,130,15488,20968;21487;24643,40515,0,1,2,0,3
59679,130,15489,20983;21037;23294;24825,40515,1,0,3,0,4
59680,130,15490,20703;21008;23608;23936;24510;24610,40515,0,4,2,0,6
59681,130,15491,21028;21130;24842,40515,1,0,2,0,3
59682,130,15492,21412;24449;25231,40515,1,1,1,0,3
59683,130,15493,21053;21298;24633,40515,0,1,2,0,3
59684,130,15494,21065;21232;23725;23945;24059;25223,40515,1,3,2,0,6
59685,130,15495,21085;21321;23951;24737;24939,40515,1,2,2,0,5
59686,130,15496,21113;21814;23962;24555,40515,0,2,2,0,4
59687,130,15497,21120,40515,0,0,1,0,1
59688,130,15498,21176;21427;24069;24852,40515,1,1,2,0,4
59689,130,15499,21151;21308;24735;24938;25049,40515,2,1,2,0,5
59690,130,15500,21153;21486,40515,0,0,2,0,2
59691,130,15501,21200;21408;25222,40515,1,0,2,0,3
59692,130,15502,21160;21245;24523,40515,0,1,2,0,3
59693,130,15504,16444,40880,0,0,0,1,1
59694,130,15505,16488,40880,0,0,0,1,1
59695,130,15506,16965,40880,0,0,0,1,1
59696,130,15511,16886,40880,0,0,0,1,1
59697,130,15512,16939;17338,40880,0,0,0,2,2
59698,130,15513,17343,40880,0,0,0,1,1
59699,130,15515,17127,40880,0,0,0,1,1
59700,130,15518,17798,40880,0,0,0,1,1
59701,130,15520,17442,40880,0,0,0,1,1
59702,130,15523,18345,40880,0,0,1,0,1
59703,130,15524,18478;18586,40880,0,0,2,0,2
59704,130,15529,19010;19073,40880,0,0,2,0,2
59705,130,15530,18824;19501,40880,0,0,2,0,2
59706,130,15532,19966,40880,0,0,1,0,1
59707,130,15536,19666;19749;23056,40880,0,0,3,0,3
59708,130,15539,19948;22165;22491,40880,0,0,3,0,3
59709,130,15540,20223;23258;23994,40880,0,1,2,0,3
59710,130,15541,19985;23983,40880,0,1,1,0,2
59711,130,15542,20068;20391;23684,40880,0,1,2,0,3
59712,130,15543,20054;20315;23086;23359,40880,0,0,4,0,4
59713,130,15544,20285;23569;23886;24217,40880,0,3,1,0,4
59714,130,15545,20742;20774;25019,40880,1,0,2,0,3
59715,130,15546,20248;20701;24317;24408;24494;24704,40880,0,4,2,0,6
59716,130,15547,20045;20138;22625,40880,0,0,3,0,3
59717,130,15548,20436;20616;23278,40880,0,0,3,0,3
59718,130,15549,20522;23092;23487;23907;25125,40880,1,1,3,0,5
59719,130,15550,20531;20727;23377;23703;23810;24706,40880,0,3,3,0,6
59720,130,15551,21031;21106;22995;23826,40880,0,1,3,0,4
59721,130,15552,20589;21440,40880,0,0,2,0,2
59722,130,15553,20604;20950;23821;23932,40880,0,2,2,0,4
59723,130,15554,20157;20618;23593;23803;24587,40880,0,3,2,0,5
59724,130,15555,20934;21004;24829,40880,1,0,2,0,3
59725,130,15556,20207;20544;23176,40880,0,0,3,0,3
59726,130,15557,20994;24152,40880,0,1,1,0,2
59727,130,15558,20800;20978;23288;23603;23708;23814;24499;24711,40880,0,5,3,0,8
59728,130,15559,20804;20813;23289;23604;24138,40880,0,2,3,0,5
59729,130,15560,20919;23930;24147;24251;24716,40880,0,4,1,0,5
59730,130,15561,20398;20842;23816,40880,0,1,2,0,3
59731,130,15562,20897;21088;24928,40880,1,0,2,0,3
59732,130,15563,20898;21464;24274;25156;25233,40880,2,1,2,0,5
59733,130,15564,20662;20850;25128,40880,1,0,2,0,3
59734,130,15565,20615;21057;24723,40880,0,1,2,0,3
59735,130,15566,20933;21420;23620;24743;25153,40880,1,2,2,0,5
59736,130,15568,21064;21341;24528,40880,0,1,2,0,3
59737,130,15569,20992;21046,40880,0,0,2,0,2
59738,130,15570,21479;23731;24748,40880,0,2,1,0,3
59739,130,15571,21010;24258,40880,0,1,1,0,2
59740,130,15572,21017,40880,0,0,1,0,1
59741,130,15573,21054;21416;23619;24851,40880,1,1,2,0,4
59742,130,15574,21081;21315;23504;24174;24736;25050,40880,1,2,3,0,6
59743,130,15575,20951;21463;24855,40880,1,0,2,0,3
59744,130,15576,21236;24935;25143,40880,2,0,1,0,3
59745,130,15577,20982;21137;24161,40880,0,1,2,0,3
59746,130,15578,20843;21161;23834;24265,40880,0,2,2,0,4
59747,130,15580,20915;21172,40880,0,0,2,0,2
59748,130,15581,20970;21177,40880,0,0,2,0,2
59749,130,15582,21188;21547;25239,40880,1,0,2,0,3
59750,130,15583,20758;21206;24844,40880,1,0,2,0,3
59751,130,15584,21211;24520;24624,40880,0,2,1,0,3
59752,130,15585,20990;21230;24627;24934,40880,1,1,2,0,4
59753,130,15586,21249;21355;23726,40880,0,1,2,0,3
59754,130,15587,21256,40880,0,0,1,0,1
59755,130,15588,21262;21353;23947,40880,0,1,2,0,3
59756,130,15589,21009;21276,40880,0,0,2,0,2
59757,130,15590,21280;21313;24173;24355;24527,40880,0,3,2,0,5
59758,130,15591,21283;21370;24066;24848;24943;25053,40880,3,1,2,0,6
59759,130,15592,21128;21286;24269,40880,0,1,2,0,3
59760,130,15593,17202,41245,0,0,0,1,1
59761,130,15594,17506,41245,0,0,0,1,1
59762,130,15596,17587;17648,41245,0,0,0,2,2
59763,130,15598,17650;18177,41245,0,0,1,1,2
59764,130,15599,17778,41245,0,0,0,1,1
59765,130,15600,17267,41245,0,0,0,1,1
59766,130,15601,17415;17774,41245,0,0,0,2,2
59767,130,15608,17822,41245,0,0,0,1,1
59768,130,15609,18124,41245,0,0,0,1,1
59769,130,15614,19301;22934,41245,0,0,2,0,2
59770,130,15616,18809;19167,41245,0,0,2,0,2
59771,130,15620,19567,41245,0,0,1,0,1
59772,130,15622,19382,41245,0,0,1,0,1
59773,130,15629,20116;20593;23590;23801,41245,0,2,2,0,4
59774,130,15631,19977;20312;24219,41245,0,1,2,0,3
59775,130,15632,20414;20523,41245,0,0,2,0,2
59776,130,15633,21167,41245,0,0,1,0,1
59777,130,15634,20839;24418,41245,0,1,1,0,2
59778,130,15635,20588;20617,41245,0,0,2,0,2
59779,130,15636,20654;20870,41245,0,0,2,0,2
59780,130,15637,20663;21123;24614;24840;24931,41245,2,1,2,0,5
59781,130,15638,20629;20678;23282;23595;24130;24404;24700,41245,0,4,3,0,7
59782,130,15639,20470;20683;23807;24027,41245,0,2,2,0,4
59783,130,15640,20768;20910;23929;24046;24145;24715,41245,0,4,2,0,6
59784,130,15641,20278;20799;23496,41245,0,0,3,0,3
59785,130,15642,20858,41245,0,0,1,0,1
59786,130,15643,20864;21142,41245,0,0,2,0,2
59787,130,15644,20865;21465;25157,41245,1,0,2,0,3
59788,130,15646,20887;21045;23500;24261;24926,41245,1,1,3,0,5
59789,130,15647,20829;20888;23927;24045,41245,0,2,2,0,4
59790,130,15649,21002;21074;23939;24053;24515,41245,0,3,2,0,5
59791,130,15650,20961;21220;24058;24436;25045,41245,1,2,2,0,5
59792,130,15651,20873;20989;24607;24827;25215,41245,2,1,2,0,5
59793,130,15652,21047;21397;23618,41245,0,1,2,0,3
59794,130,15653,21110;24434,41245,0,1,1,0,2
59795,130,15654,21070;21415,41245,0,0,2,0,2
59796,130,15655,21097;21115,41245,0,0,2,0,2
59797,130,15656,21102;21428,41245,0,0,2,0,2
59798,130,15657,21449;21482;23400,41245,0,0,3,0,3
59799,130,15658,20993;21145;23611;24264;24619,41245,0,3,2,0,5
59800,130,15659,21162;21243;24266;24630;24936;25047,41245,2,2,2,0,6
59801,130,15660,20744;21217;23613;23723;24163,41245,0,3,2,0,5
59802,130,15661,21218;21591;24276,41245,0,1,2,0,3
59803,130,15662,21226;21680;24767,41245,0,1,2,0,3
59804,130,15663,21197;21247;23946;25144;25224,41245,2,1,2,0,5
59805,130,15664,21250;24060,41245,0,1,1,0,2
59806,130,15665,21329;21683;24768,41245,0,1,2,0,3
59807,130,15666,20819;21259;23614;24350;24631;24732,41245,0,4,2,0,6
59808,130,15667,21187;21613;25065,41245,1,0,2,0,3
59809,130,15668,21270;21662,41245,0,0,2,0,2
59810,130,15669,20925;21278,41245,0,0,2,0,2
59811,130,15670,21291;21534;23844;25237,41245,1,1,2,0,4
59812,130,15671,21304;21471,41245,0,0,2,0,2
59813,130,15672,20986;21305;23727;24526,41245,0,2,2,0,4
59814,130,15673,21105;21320;24062;24440;24634;25147,41245,1,3,2,0,6
59815,130,15674,21332;21525;24063,41245,0,1,2,0,3
59816,130,15675,21297;21345;23399;24177;24529,41245,0,2,3,0,5
59817,130,15676,21326,41245,0,0,1,0,1
59818,130,15677,21511;24752,41245,0,1,1,0,2
59819,130,15678,21600;23845,41245,0,1,1,0,2
59820,130,15679,21260;21393;24448,41245,0,1,2,0,3
59821,130,15680,21400;21446;24534;25230,41245,1,1,2,0,4
59822,130,15681,21401;21426;24360;24535,41245,0,2,2,0,4
59823,130,15687,17309,41610,0,0,0,1,1
59824,130,15693,17203,41610,0,0,0,1,1
59825,130,15703,18149;18211,41610,0,0,1,1,2
59826,130,15704,18062,41610,0,0,0,1,1
59827,130,15706,18532;18680,41610,0,0,2,0,2
59828,130,15709,19116;22703,41610,0,0,2,0,2
59829,130,15710,18904;19550;22958;23856,41610,0,1,3,0,4
59830,130,15713,18880,41610,0,0,1,0,1
59831,130,15718,19580;19973;23450,41610,0,0,3,0,3
59832,130,15720,19974,41610,0,0,1,0,1
59833,130,15725,19435;19996;22167;22862;25100,41610,1,0,4,0,5
59834,130,15726,20012;20233;23349;23881,41610,0,1,3,0,4
59835,130,15727,20015;20276;23262,41610,0,0,3,0,3
59836,130,15728,20041;20487;23090,41610,0,0,3,0,3
59837,130,15729,19587,41610,0,0,1,0,1
59838,130,15731,19782;20257;23084,41610,0,0,3,0,3
59839,130,15733,20192;20253;23884;24212;24478,41610,0,3,2,0,5
59840,130,15734,20282;20309;24215,41610,0,1,2,0,3
59841,130,15736,20533;20575;23093;24807,41610,1,0,3,0,4
59842,130,15737,20464;21240;24168;24349;24629,41610,0,3,2,0,5
59843,130,15738,20698;20991;24428,41610,0,1,2,0,3
59844,130,15740,20711;23599;23702;24592,41610,0,3,1,0,4
59845,130,15741,20623;20831;23713,41610,0,1,2,0,3
59846,130,15742,20979;23391,41610,0,0,2,0,2
59847,130,15743,20560;20721;23370;23491;23797;23910,41610,0,2,4,0,6
59848,130,15744,20467;20757,41610,0,0,2,0,2
59849,130,15745,20765;21060;23828;24432;24836;25216,41610,2,2,2,0,6
59850,130,15746,20665,41610,0,0,1,0,1
59851,130,15747,20776;21271,41610,0,0,2,0,2
59852,130,15748,20710;20779;23287;24815,41610,1,0,3,0,4
59853,130,15749,20596;20855;23817;24599,41610,0,2,2,0,4
59854,130,15750,20798;20835;24417;24502,41610,0,2,2,0,4
59855,130,15751,20454;20878;23292;24505;24714,41610,0,2,3,0,5
59856,130,15752,20884;21056;23296;24722,41610,0,1,3,0,4
59857,130,15754,20726;20936;23931,41610,0,1,2,0,3
59858,130,15755,20938;21112;24253;24507;25214,41610,1,2,2,0,5
59859,130,15757,20988;21069,41610,0,0,2,0,2
59860,130,15758,21076;24725,41610,0,1,1,0,2
59861,130,15760,21084;21133;23501;23940;24342,41610,0,2,3,0,5
59862,130,15761,20944;21147;23502;23832,41610,0,1,3,0,4
59863,130,15762,21156;21314;23615,41610,0,1,2,0,3
59864,130,15763,21166;21327,41610,0,0,2,0,2
59865,130,15764,21180;21339,41610,0,0,2,0,2
59866,130,15766,20825;21157;24346;24518;24621,41610,0,3,2,0,5
59867,130,15767,20916;21269;24268;24351;24439,41610,0,3,2,0,5
59868,130,15768,21273;21433;24070;24361;25154,41610,1,2,2,0,5
59869,130,15769,21342;23398,41610,0,0,2,0,2
59870,130,15770,21101;21290;24632;25145,41610,1,1,2,0,4
59871,130,15771,21082;21335,41610,0,0,2,0,2
59872,130,15772,21608;21829;25255,41610,1,0,2,0,3
59873,130,15773,21221;21716,41610,0,0,2,0,2
59874,130,15774,21371,41610,0,0,1,0,1
59875,130,15775,21203;21383,41610,0,0,2,0,2
59876,130,15776,21202;21384;24068,41610,0,1,2,0,3
59877,130,15777,21621;25242,41610,1,0,1,0,2
59878,130,15778,16903,41975,0,0,0,1,1
59879,130,15779,17039,41975,0,0,0,1,1
59880,130,15780,16953,41975,0,0,0,1,1
59881,130,15781,16686,41975,0,0,0,1,1
59882,130,15782,17120,41975,0,0,0,1,1
59883,130,15785,17462,41975,0,0,0,1,1
59884,130,15786,16890,41975,0,0,0,1,1
59885,130,15787,17776,41975,0,0,0,1,1
59886,130,15788,17610;18057,41975,0,0,0,2,2
59887,130,15789,18152,41975,0,0,0,1,1
59888,130,15790,18558,41975,0,0,1,0,1
59889,130,15798,18566;18985,41975,0,0,2,0,2
59890,130,15801,19207;19854,41975,0,0,2,0,2
59891,130,15806,19851;19930,41975,0,0,2,0,2
59892,130,15807,20106;20183;23879,41975,0,1,2,0,3
59893,130,15808,20298;20465;22765;24399;25017,41975,1,1,3,0,5
59894,130,15811,20360;20805,41975,0,0,2,0,2
59895,130,15812,20388;20446,41975,0,0,2,0,2
59896,130,15814,20366;20477;23903,41975,0,1,2,0,3
59897,130,15815,19920;22746;23070;23659;25302,41975,1,1,3,0,5
59898,130,15817,20337;20657;23281;23493;24493,41975,0,1,4,0,5
59899,130,15818,20489,41975,0,0,1,0,1
59900,130,15819,20186;20584;23799;24123,41975,0,2,2,0,4
59901,130,15820,20447;21020;24430,41975,0,1,2,0,3
59902,130,15821,20610;21018;24831,41975,1,0,2,0,3
59903,130,15822,20920;20999;23824;24509;24608;24828,41975,1,3,2,0,6
59904,130,15823,20411;20631,41975,0,0,2,0,2
59905,130,15824,20675;20840;24040,41975,0,1,2,0,3
59906,130,15825,20572;20974;24427,41975,0,1,2,0,3
59907,130,15827,20755;21042;24341;24511,41975,0,2,2,0,4
59908,130,15828,20313;20788;24597,41975,0,1,2,0,3
59909,130,15829,20876;20937;24048;24334;24602,41975,0,3,2,0,5
59910,130,15830,20906;21040,41975,0,0,2,0,2
59911,130,15831,21184;21295;24171;24354,41975,0,2,2,0,4
59912,130,15833,21001;21394;24609;24720,41975,0,2,2,0,4
59913,130,15834,21027;21607,41975,0,0,2,0,2
59914,130,15835,20921;21347;23837;24270;24941,41975,1,2,2,0,5
59915,130,15836,21111;21318;23728;25227,41975,1,1,2,0,4
59916,130,15837,21116;21475;24857,41975,1,0,2,0,3
59917,130,15838,20709;21132;23831;24616;24932,41975,1,2,2,0,5
59918,130,15839,21078;21152;23833;24345;24517;24728,41975,0,4,2,0,6
59919,130,15841,21192;21532,41975,0,0,2,0,2
59920,130,15842,21209;21579;24648,41975,0,1,2,0,3
59921,130,15843,21224;24166;25141,41975,1,1,1,0,3
59922,130,15844,21411;21633;24370;24653,41975,0,2,2,0,4
59923,130,15845,21231;24845,41975,1,0,1,0,2
59924,130,15846,21763;23736,41975,0,1,1,0,2
59925,130,15847,20772;20797;23706;24413;24709,41975,0,3,2,0,5
59926,130,15848,21277;21285,41975,0,0,2,0,2
59927,130,15849,21288;21374;24636,41975,0,1,2,0,3
59928,130,15850,21043;21306,41975,0,0,2,0,2
59929,130,15851,21316;21551;24758,41975,0,1,2,0,3
59930,130,15852,21358;21719,41975,0,0,2,0,2
59931,130,15853,21359;21531;23624,41975,0,1,2,0,3
59932,130,15854,21182;21369;24942;25052,41975,2,0,2,0,4
59933,130,15855,21030;21395;24533;24638,41975,0,2,2,0,4
59934,130,15856,21651;24078,41975,0,1,1,0,2
59935,130,15858,21109;21787;24554;24872;25073,41975,2,1,2,0,5
59936,130,15859,21062;21494;24955;25158;25234,41975,3,0,2,0,5
59937,130,15860,21514;24183;25159,41975,1,1,1,0,3
59938,130,15861,21456;21550;24757;25061,41975,1,1,2,0,4
59939,130,15863,21328;21589;23625;24650,41975,0,2,2,0,4
59940,130,15864,21595;23734,41975,0,1,1,0,2
59941,130,15865,16915,42340,0,0,0,1,1
59942,130,15866,17173,42340,0,0,0,1,1
59943,130,15867,17341,42340,0,0,0,1,1
59944,130,15868,17542,42340,0,0,0,1,1
59945,130,15870,17548;17562,42340,0,0,0,2,2
59946,130,15871,17781,42340,0,0,0,1,1
59947,130,15872,17777,42340,0,0,0,1,1
59948,130,15876,18320,42340,0,0,1,0,1
59949,130,15881,18166;18455,42340,0,0,2,0,2
59950,130,15883,18310,42340,0,0,1,0,1
59951,130,15885,18957,42340,0,0,1,0,1
59952,130,15886,18714;18917,42340,0,0,2,0,2
59953,130,15887,19181;19555,42340,0,0,2,0,2
59954,130,15888,19114;19549,42340,0,0,2,0,2
59955,130,15891,19427;19759,42340,0,0,2,0,2
59956,130,15892,19757;20052;23249;23872;23986,42340,0,2,3,0,5
59957,130,15893,19761,42340,0,0,1,0,1
59958,130,15895,19545;19735;23751,42340,0,1,2,0,3
59959,130,15897,19971;20079;23458,42340,0,0,3,0,3
59960,130,15898,20037;20578;23911;24122,42340,0,2,2,0,4
59961,130,15899,20060;20271;23781;24213,42340,0,2,2,0,4
59962,130,15901,20076;20151,42340,0,0,2,0,2
59963,130,15905,20228;20238;23167;23880;23995,42340,0,2,3,0,5
59964,130,15907,20032;20351;23683;24111;24221;24576,42340,0,4,2,0,6
59965,130,15909,20586;20670,42340,0,0,2,0,2
59966,130,15911,20655;21093;24613,42340,0,1,2,0,3
59967,130,15913,20954;21107;23718;25038,42340,1,1,2,0,4
59968,130,15914,20722,42340,0,0,1,0,1
59969,130,15915,21003;24155;25032,42340,1,1,1,0,3
59970,130,15917,20790,42340,0,0,1,0,1
59971,130,15918,20836;20900;24143;24820,42340,1,1,2,0,4
59972,130,15919,20849;21199,42340,0,0,2,0,2
59973,130,15921,20401;20881;23926;24331;25130,42340,1,2,2,0,5
59974,130,15922,20905;20914;25030,42340,1,0,2,0,3
59975,130,15923,20953;21067;23829;24514,42340,0,2,2,0,4
59976,130,15924,21075;21675;24968;25245,42340,2,0,2,0,4
59977,130,15925,21125;21481;23732;24363;24539;24953,42340,1,3,2,0,6
59978,130,15927,20666;21227,42340,0,0,2,0,2
59979,130,15928,21978;24465;24562,42340,0,2,1,0,3
59980,130,15929,21189;21292,42340,0,0,2,0,2
59981,130,15930,21158;21303,42340,0,0,2,0,2
59982,130,15931,21141;21301,42340,0,0,2,0,2
59983,130,15933,21006;21387;23617;24637,42340,0,2,2,0,4
59984,130,15934,21399;21909,42340,0,0,2,0,2
59985,130,15935,21417;21828,42340,0,0,2,0,2
59986,130,15936,21418,42340,0,0,1,0,1
59987,130,15937,21431;22017,42340,0,0,2,0,2
59988,130,15938,21434;21833,42340,0,0,2,0,2
59989,130,15939,21436;24536;24853,42340,1,1,1,0,3
59990,130,15940,21466;21467;24275;24362;24642,42340,0,3,2,0,5
59991,130,15941,21483;21508;24540;24954,42340,1,1,2,0,4
59992,130,15942,21354;21515;23956;25235,42340,1,1,2,0,4
59993,130,15943,21421;21496;24750,42340,0,1,2,0,3
59994,130,15944,21577;21670;24549,42340,0,1,2,0,3
59995,130,15945,21562;24963,42340,1,0,1,0,2
59996,130,15946,21580,42340,0,0,1,0,1
59997,130,15947,21582;21844;24876;25077,42340,2,0,2,0,4
59998,130,15948,21553;21583;24762,42340,0,1,2,0,3
59999,130,15949,21212;21587;24186;24860,42340,1,1,2,0,4
60000,130,15950,21605;21913,42340,0,0,2,0,2
60001,130,15951,21517;21612;24543;24861;24964,42340,2,1,2,0,5
60002,130,15952,21362;21614;24077;25066,42340,1,1,2,0,4
60003,130,15953,21616;21827;24461,42340,0,1,2,0,3
60004,130,15954,21631;21840;24279;24652;25067,42340,1,2,2,0,5
60005,130,15955,21309;21645;25243,42340,1,0,2,0,3
60006,130,15956,21648;22024;24565,42340,0,1,2,0,3
60007,130,15957,21615;21678,42340,0,0,2,0,2
60008,130,15958,21546;21692;24372;24657;25166,42340,1,2,2,0,5
60009,130,15959,21703;21951;25088;25260,42340,2,0,2,0,4
60010,130,15960,21477;21704;23961,42340,0,1,2,0,3
60011,130,15961,17228,42705,0,0,0,1,1
60012,130,15962,17325,42705,0,0,0,1,1
60013,130,15963,17474,42705,0,0,0,1,1
60014,130,15965,17705,42705,0,0,0,1,1
60015,130,15966,18009;18167,42705,0,0,1,1,2
60016,130,15967,16889,42705,0,0,0,1,1
60017,130,15972,18280,42705,0,0,1,0,1
60018,130,15973,18368;18409,42705,0,0,2,0,2
60019,130,15983,19347,42705,0,0,1,0,1
60020,130,15987,20608;23096;23802;24695,42705,0,2,2,0,4
60021,130,15988,20217;20543;23584,42705,0,1,2,0,3
60022,130,15989,19822;20270;23677;23780;24000,42705,0,3,2,0,5
60023,130,15990,19809;20080,42705,0,0,2,0,2
60024,130,15992,20546;23272;23585;24808,42705,1,1,2,0,4
60025,130,15995,20601;20957;23822,42705,0,1,2,0,3
60026,130,15997,20716;20764;22991;23180;24244;25021,42705,1,1,4,0,6
60027,130,15998,21522;23623;24073,42705,0,2,1,0,3
60028,130,15999,20821;20826;23497;23605;24416,42705,0,2,3,0,5
60029,130,16001,20901;23385;24250;24923,42705,1,1,2,0,4
60030,130,16002,20494;22988;23175;23483;25210,42705,1,0,4,0,5
60031,130,16003,20775;21222,42705,0,0,2,0,2
60032,130,16004,21136;21261;23720;24617,42705,0,2,2,0,4
60033,130,16005,21191,42705,0,0,1,0,1
60034,130,16006,21210;21533;24647;25161,42705,1,1,2,0,4
60035,130,16007,21235;21263;24846,42705,1,0,2,0,3
60036,130,16008,21244;21724;24285,42705,0,1,2,0,3
60037,130,16009,21275;21712,42705,0,0,2,0,2
60038,130,16010,20796;21336;23505;24738,42705,0,1,3,0,4
60039,130,16011,21319;21340,42705,0,0,2,0,2
60040,130,16012,21322;21357;23506;24064;24443,42705,0,2,3,0,5
60041,130,16013,21363;21452;24531;24740,42705,0,2,2,0,4
60042,130,16014,21364;21468;24538;24856,42705,1,1,2,0,4
60043,130,16015,21131;21377;23730;24850,42705,1,1,2,0,4
60044,130,16016,21368;21386;24357;24445,42705,0,2,2,0,4
60045,130,16017,21422;21636;24765;24863,42705,1,1,2,0,4
60046,130,16018,21429;21689;24283;24969;25068,42705,2,1,2,0,5
60047,130,16019,21409;21461;24946,42705,1,0,2,0,3
60048,130,16020,21389;24271;24447;25229,42705,1,2,1,0,4
60049,130,16021,21382;21490;24364;24454,42705,0,2,2,0,4
60050,130,16022,21498;21858;25078,42705,1,0,2,0,3
60051,130,16023,21214;21503,42705,0,0,2,0,2
60052,130,16024,21506;21618,42705,0,0,2,0,2
60053,130,16025,21523;22138;23850;25272,42705,1,1,2,0,4
60054,130,16026,21505;21527;24755;25060,42705,1,1,2,0,4
60055,130,16027,21912;25178,42705,1,0,1,0,2
60056,130,16028,21549;22131,42705,0,0,2,0,2
60057,130,16029,21558;24074,42705,0,1,1,0,2
60058,130,16030,21571;22071;24676,42705,0,1,2,0,3
60059,130,16031,21576;21895;25177,42705,1,0,2,0,3
60060,130,16032,21225;21728;24079;24459;25170,42705,1,2,2,0,5
60061,130,16033,21671;24865;24967,42705,2,0,1,0,3
60062,130,16034,21455;21646;24181;24854;25232,42705,2,1,2,0,5
60063,130,16035,21677;22053;24674;24889,42705,1,1,2,0,4
60064,130,16036,21715;22008;24378;24987,42705,1,1,2,0,4
60065,130,16037,21722;21789;24770;24971,42705,1,1,2,0,4
60066,130,16038,21766;21866;24981;25257,42705,2,0,2,0,4
60067,130,16039,21773;22056,42705,0,0,2,0,2
60068,130,16040,21668;21777;24080;25072,42705,1,1,2,0,4
60069,130,16041,21780;21819,42705,0,0,2,0,2
60070,130,16042,21272;21792;25251,42705,1,0,2,0,3
60071,130,16043,21798;22160;23965,42705,0,1,2,0,3
60072,130,16044,21410;21801;25074,42705,1,0,2,0,3
60073,130,16045,21826;21893;25081,42705,1,0,2,0,3
60074,130,16046,17263,43070,0,0,0,1,1
60075,130,16047,17287,43070,0,0,0,1,1
60076,130,16048,16898,43070,0,0,0,1,1
60077,130,16049,17310,43070,0,0,0,1,1
60078,130,16050,17233,43070,0,0,0,1,1
60079,130,16052,17743,43070,0,0,0,1,1
60080,130,16061,17974;18010,43070,0,0,0,2,2
60081,130,16062,18709,43070,0,0,1,0,1
60082,130,16064,18822;19479;23854,43070,0,1,2,0,3
60083,130,16074,19794;20033,43070,0,0,2,0,2
60084,130,16077,19418;20158;23341;23464;24104,43070,0,1,4,0,5
60085,130,16078,19711;20119,43070,0,0,2,0,2
60086,130,16081,20468,43070,0,0,1,0,1
60087,130,16082,20518;21007;23717;24157;25033,43070,1,2,2,0,5
60088,130,16084,20729;21155,43070,0,0,2,0,2
60089,130,16085,20700;20738,43070,0,0,2,0,2
60090,130,16087,20806;20875;24819;25027,43070,2,0,2,0,4
60091,130,16088,20848,43070,0,0,1,0,1
60092,130,16089,20903;21174,43070,0,0,2,0,2
60093,130,16090,20972;21135;24150,43070,0,1,2,0,3
60094,130,16091,21024;24259,43070,0,1,1,0,2
60095,130,16092,21361;24065;24444,43070,0,2,1,0,3
60096,130,16093,21099;21518;24184;24644;24859;25236,43070,2,2,2,0,6
60097,130,16096,21117;21480;24952,43070,1,0,2,0,3
60098,130,16097,20867;21129;23818;23925;24249;24330;24713;25026,43070,1,5,2,0,8
60099,130,16098,21544;24756,43070,0,1,1,0,2
60100,130,16099,21169;21816;24556;25253,43070,1,1,2,0,4
60101,130,16100,21796;23737;24460;25252,43070,1,2,1,0,4
60102,130,16101,20975;21178,43070,0,0,2,0,2
60103,130,16102,20980;21267;23948;24169,43070,0,2,2,0,4
60104,130,16103,21289;21343,43070,0,0,2,0,2
60105,130,16104,21310;23397;24172,43070,0,1,2,0,3
60106,130,16105,21323;21333;25051,43070,1,0,2,0,3
60107,130,16106,21144;21423,43070,0,0,2,0,2
60108,130,16107,21366;21526;23843;24754;24960,43070,1,2,2,0,5
60109,130,16108,21403;21679;24272;24639;24742,43070,0,3,2,0,5
60110,130,16109,21405;21904;24560;24667;24985,43070,1,2,2,0,5
60111,130,16110,21407;21746;24659,43070,0,1,2,0,3
60112,130,16111,21237;21437;24948,43070,1,0,2,0,3
60113,130,16112,21439;21460;23840;24452;24537;24951,43070,1,3,2,0,6
60114,130,16113,21448;22065;24675;25183;25269,43070,2,1,2,0,5
60115,130,16114,21947,43070,0,0,1,0,1
60116,130,16115,21510;21876;24666;24983,43070,1,1,2,0,4
60117,130,16116,20834;21495;24328,43070,0,1,2,0,3
60118,130,16117,21536;21542,43070,0,0,2,0,2
60119,130,16118,21734;24974;25171;25247,43070,3,0,1,0,4
60120,130,16119,21603;21831;25075,43070,1,0,2,0,3
60121,130,16120,21489;21619;24651,43070,0,1,2,0,3
60122,130,16121,21624;24278,43070,0,1,1,0,2
60123,130,16122,21629;21999,43070,0,0,2,0,2
60124,130,16124,21634;21795;24977,43070,1,0,2,0,3
60125,130,16125,21652;21841;25076,43070,1,0,2,0,3
60126,130,16126,21513;21701;23842;24365,43070,0,2,2,0,4
60127,130,16128,21246,43070,0,0,1,0,1
60128,130,16129,21747;24869;24975,43070,2,0,1,0,3
60129,130,16130,21628,43070,0,0,1,0,1
60130,130,16131,21685;21744;24552,43070,0,1,2,0,3
60131,130,16132,21745;22010;24193;25093,43070,1,1,2,0,4
60132,130,16134,21802;22230,43070,0,0,2,0,2
60133,130,16135,21807;22081,43070,0,0,2,0,2
60134,130,16136,21637;21811;24663;24772;24978,43070,1,2,2,0,5
60135,130,16137,21817;22153;24782;24895;25098;25186,43070,3,1,2,0,6
60136,130,16138,21835;21861;24878,43070,1,0,2,0,3
60137,130,16139,21836;24979,43070,1,0,1,0,2
60138,130,16140,21847;22003,43070,0,0,2,0,2
60139,130,16141,21736;21922;24376;25259,43070,1,1,2,0,4
60140,130,16142,21682;21850,43070,0,0,2,0,2
60141,130,16143,21743;21856;24286;25070;25172,43070,2,1,2,0,5
60142,130,16144,21864;22210;25102,43070,1,0,2,0,3
60143,130,16145,21731;21884;24559,43070,0,1,2,0,3
60144,130,16146,21552;21896;25083,43070,1,0,2,0,3
60145,130,16147,21899,43070,0,0,1,0,1
60146,130,16148,21920;22235;25106,43070,1,0,2,0,3
60147,130,16149,21921;22195,43070,0,0,2,0,2
60148,130,16150,17484,43435,0,0,0,1,1
60149,130,16151,17530,43435,0,0,0,1,1
60150,130,16152,17571,43435,0,0,0,1,1
60151,130,16153,17229,43435,0,0,0,1,1
60152,130,16154,17257,43435,0,0,0,1,1
60153,130,16157,17915;18015,43435,0,0,0,2,2
60154,130,16161,17815;17921,43435,0,0,0,2,2
60155,130,16162,18446;18694,43435,0,0,2,0,2
60156,130,16169,18889;19408,43435,0,0,2,0,2
60157,130,16171,19380;23520,43435,0,1,1,0,2
60158,130,16172,18940,43435,0,0,1,0,1
60159,130,16174,19603;20028;24390,43435,0,1,2,0,3
60160,130,16176,19969;20318;22634,43435,0,0,3,0,3
60161,130,16179,19939,43435,0,0,1,0,1
60162,130,16180,20136;20637,43435,0,0,2,0,2
60163,130,16182,20241;20395;23477;25318,43435,1,0,3,0,4
60164,130,16185,20262;20406;24300,43435,0,1,2,0,3
60165,130,16186,20969,43435,0,0,1,0,1
60166,130,16187,20656;20787;23285;23600;24322,43435,0,2,3,0,5
60167,130,16188,21216;24626,43435,0,1,1,0,2
60168,130,16189,20561;20852;23498;24247;24329;24504,43435,0,3,3,0,6
60169,130,16190,20838,43435,0,0,1,0,1
60170,130,16191,20416;23700;23808,43435,0,2,1,0,3
60171,130,16192,20761;21005;24156;24257,43435,0,2,2,0,4
60172,130,16194,20851;21071;23394;24724;24837,43435,1,1,3,0,5
60173,130,16195,20928;21087;23609;24054;24343;25036,43435,1,3,2,0,6
60174,130,16196,21657;24281;25244,43435,1,1,1,0,3
60175,130,16197,20832;21139;24263;24618,43435,0,2,2,0,4
60176,130,16198,21080;21173,43435,0,0,2,0,2
60177,130,16199,21251;21307;24438,43435,0,1,2,0,3
60178,130,16200,20735;21356;24178;24739;24847;25150,43435,2,2,2,0,6
60179,130,16201,21337;21658;24864,43435,1,0,2,0,3
60180,130,16202,21372;21441;24744,43435,0,1,2,0,3
60181,130,16203,21673;21873;24463,43435,0,1,2,0,3
60182,130,16204,21469,43435,0,0,1,0,1
60183,130,16205,21501;22078;25095,43435,1,0,2,0,3
60184,130,16206,21555;22194,43435,0,0,2,0,2
60185,130,16207,21186,43435,0,0,1,0,1
60186,130,16208,21296;21565;24760,43435,0,1,2,0,3
60187,130,16209,21598;21985;24563,43435,0,1,2,0,3
60188,130,16210,21346;21599;24542,43435,0,1,2,0,3
60189,130,16211,21868;24375;24462;24982,43435,1,2,1,0,4
60190,130,16212,21632;21748;24544,43435,0,1,2,0,3
60191,130,16214,21706;22241;24786,43435,0,1,2,0,3
60192,130,16215,21681;21708;24550;25069,43435,1,1,2,0,4
60193,130,16216,21710;24551,43435,0,1,1,0,2
60194,130,16217,22208;25187,43435,1,0,1,0,2
60195,130,16218,21717;21751;24188;24553,43435,0,2,2,0,4
60196,130,16219,21749;22094;24780;24893;24989,43435,2,1,2,0,5
60197,130,16220,21754;21937,43435,0,0,2,0,2
60198,130,16221,21476;21755;24660;25249,43435,1,1,2,0,4
60199,130,16222,21667;21760,43435,0,0,2,0,2
60200,130,16223,21770;21872,43435,0,0,2,0,2
60201,130,16224,21785;21806;24662;24976,43435,1,1,2,0,4
60202,130,16225,21564;21786;24366;24759;25062,43435,1,2,2,0,5
60203,130,16226,21528;21820,43435,0,0,2,0,2
60204,130,16227,21700;21823,43435,0,0,2,0,2
60205,130,16228,21832;25256,43435,1,0,1,0,2
60206,130,16229,21834;21941;24288,43435,0,1,2,0,3
60207,130,16230,21849;21881,43435,0,0,2,0,2
60208,130,16231,21520;21867;24557,43435,0,1,2,0,3
60209,130,16232,21880;25176,43435,1,0,1,0,2
60210,130,16233,21672;21897,43435,0,0,2,0,2
60211,130,16234,21933;22152;25097,43435,1,0,2,0,3
60212,130,16235,21938;22309;25193,43435,1,0,2,0,3
60213,130,16237,21392;21953;25089,43435,1,0,2,0,3
60214,130,16238,21473;21956,43435,0,0,2,0,2
60215,130,16239,21960;22151;24677,43435,0,1,2,0,3
60216,130,16240,21964;22064,43435,0,0,2,0,2
60217,130,16241,21968;22301,43435,0,0,2,0,2
60218,130,16242,21994;22139;24894;25185,43435,2,0,2,0,4
60219,130,16243,21926;21998,43435,0,0,2,0,2
60220,130,16244,21818;22014;24194;24672,43435,0,2,2,0,4
60221,130,16245,22016;22214;24784,43435,0,1,2,0,3
60222,130,16246,22022;22307,43435,0,0,2,0,2
60223,130,16247,21870;22031;24673,43435,0,1,2,0,3
60224,130,16248,22037;22123;24083,43435,0,1,2,0,3
60225,130,16249,21653;22040;25182,43435,1,0,2,0,3
60226,130,16250,17521,43800,0,0,0,1,1
60227,130,16251,17275,43800,0,0,0,1,1
60228,130,16254,17722,43800,0,0,0,1,1
60229,130,16256,17901;18184,43800,0,0,1,1,2
60230,130,16257,17992;18125,43800,0,0,0,2,2
60231,130,16258,18071,43800,0,0,0,1,1
60232,130,16259,17581;17933,43800,0,0,0,2,2
60233,130,16262,18188;18395,43800,0,0,2,0,2
60234,130,16263,18453;18511,43800,0,0,2,0,2
60235,130,16265,18596;18632,43800,0,0,2,0,2
60236,130,16267,18554;18810,43800,0,0,2,0,2
60237,130,16269,19228,43800,0,0,1,0,1
60238,130,16270,19115;19515;23637,43800,0,1,2,0,3
60239,130,16271,18668;18811,43800,0,0,2,0,2
60240,130,16274,19575;20031;23334,43800,0,0,3,0,3
60241,130,16276,19789,43800,0,0,1,0,1
60242,130,16277,19907;20117;23546;23762,43800,0,2,2,0,4
60243,130,16278,19438,43800,0,0,1,0,1
60244,130,16280,20243;20602;24024,43800,0,1,2,0,3
60245,130,16282,20481,43800,0,0,1,0,1
60246,130,16284,20562;20648;24128,43800,0,1,2,0,3
60247,130,16289,20519;20824;23606,43800,0,1,2,0,3
60248,130,16290,20860;20981;24151;24824;25031,43800,2,1,2,0,5
60249,130,16291,20913;21265;23186,43800,0,0,3,0,3
60250,130,16292,20941;21033;23607;23716,43800,0,2,2,0,4
60251,130,16294,21021;21126;24615,43800,0,1,2,0,3
60252,130,16296,21193;21470;23955;24182;24453;24747,43800,0,4,2,0,6
60253,130,16297,21535;21635;24654,43800,0,1,2,0,3
60254,130,16298,21239;21660;24457;24547,43800,0,2,2,0,4
60255,130,16299,21430;24451;24641;24947,43800,1,2,1,0,4
60256,130,16300,21299;21488;24061;25048,43800,1,1,2,0,4
60257,130,16301,21041;21349;23953;24530,43800,0,2,2,0,4
60258,130,16302,21484;21878,43800,0,0,2,0,2
60259,130,16303,21127;21507;24958,43800,1,0,2,0,3
60260,130,16304,21512;21765,43800,0,0,2,0,2
60261,130,16305,21545;21705;24970,43800,1,0,2,0,3
60262,130,16306,21559;21702,43800,0,0,2,0,2
60263,130,16307,21566;21854;23849;24774,43800,0,2,2,0,4
60264,130,16308,21588;24541;24649;24763;25240,43800,1,3,1,0,5
60265,130,16309,21594;21669;23959,43800,0,1,2,0,3
60266,130,16310,21617,43800,0,0,1,0,1
60267,130,16311,21622;21768,43800,0,0,2,0,2
60268,130,16312,21626;21930;25085,43800,1,0,2,0,3
60269,130,16313,21499;21597;24751,43800,0,1,2,0,3
60270,130,16314,21869;25175;25258,43800,2,0,1,0,3
60271,130,16315,21585;21664;24368;25162,43800,1,1,2,0,4
60272,130,16316,21890;21939,43800,0,0,2,0,2
60273,130,16317,21690;22007;23960,43800,0,1,2,0,3
60274,130,16318,21691;21957,43800,0,0,2,0,2
60275,130,16319,21454;21697;24284;24769,43800,0,2,2,0,4
60276,130,16320,21756;21799,43800,0,0,2,0,2
60277,130,16321,21778;22062;24196,43800,0,1,2,0,3
60278,130,16322,21445;21560;24962,43800,1,0,2,0,3
60279,130,16323,21584;22227,43800,0,0,2,0,2
60280,130,16324,22472,43800,0,0,1,0,1
60281,130,16325,21860;22364,43800,0,0,2,0,2
60282,130,16326,21879;22284,43800,0,0,2,0,2
60283,130,16327,21842;22141;24781,43800,0,1,2,0,3
60284,130,16329,21910;22147;24382;25273,43800,1,1,2,0,4
60285,130,16330,21965;22315;24777;24883,43800,1,1,2,0,4
60286,130,16331,21917;22286,43800,0,0,2,0,2
60287,130,16332,21936;25086,43800,1,0,1,0,2
60288,130,16333,21946;22282;24385,43800,0,1,2,0,3
60289,130,16335,21950;24082,43800,0,1,1,0,2
60290,130,16336,21982;22474;24799;25199,43800,1,1,2,0,4
60291,130,16337,22001;22267,43800,0,0,2,0,2
60292,130,16338,22009;24887;25264,43800,2,0,1,0,3
60293,130,16339,22012,43800,0,0,1,0,1
60294,130,16340,22041;22133,43800,0,0,2,0,2
60295,130,16341,22042,43800,0,0,1,0,1
60296,130,16342,22030;22055;25266,43800,1,0,2,0,3
60297,130,16343,21604;22057,43800,0,0,2,0,2
60298,130,16344,22260;22421,43800,0,0,2,0,2
60299,130,16345,22085;22215,43800,0,0,2,0,2
60300,130,16346,22086;22317;24790;25194,43800,1,1,2,0,4
60301,130,16347,22100;22333,43800,0,0,2,0,2
60302,130,16348,21803;22106;25270,43800,1,0,2,0,3
60303,130,16349,22144;22190;24991,43800,1,0,2,0,3
60304,130,16350,22145;22411,43800,0,0,2,0,2
60305,130,16351,21812;22149;24990;25274,43800,2,0,2,0,4
60306,130,16352,22157;22216;24680,43800,0,1,2,0,3
60307,130,16353,17651,44165,0,0,0,1,1
60308,130,16354,17620,44165,0,0,0,1,1
60309,130,16355,17773,44165,0,0,0,1,1
60310,130,16356,17693;18350,44165,0,0,1,1,2
60311,130,16357,18052;18477,44165,0,0,1,1,2
60312,130,16358,17545,44165,0,0,0,1,1
60313,130,16361,18243;18426,44165,0,0,2,0,2
60314,130,16362,18080,44165,0,0,0,1,1
60315,130,16365,18721;18853,44165,0,0,2,0,2
60316,130,16367,18852;19387;22822,44165,0,0,3,0,3
60317,130,16368,18956;19190;22236,44165,0,0,3,0,3
60318,130,16371,19201;19229,44165,0,0,2,0,2
60319,130,16373,19258;19265;22815,44165,0,0,3,0,3
60320,130,16376,19334,44165,0,0,1,0,1
60321,130,16379,19017;19218,44165,0,0,2,0,2
60322,130,16381,19838;20105,44165,0,0,2,0,2
60323,130,16390,20908;21215;23722;23944;24348;24521;24625,44165,0,5,2,0,7
60324,130,16391,20815;21686,44165,0,0,2,0,2
60325,130,16393,20883;21150;24435;24620;24727;25220,44165,1,3,2,0,6
60326,130,16394,20987;24749;25058,44165,1,1,1,0,3
60327,130,16395,21019;21089;24055;24159;24612;24838,44165,1,3,2,0,6
60328,130,16396,21051;21375;23954;24532;24849;25054,44165,2,2,2,0,6
60329,130,16397,20705;21059;24052;24835;25034,44165,2,1,2,0,5
60330,130,16398,21014;21077;24927;25035,44165,2,0,2,0,4
60331,130,16399,20719;20837,44165,0,0,2,0,2
60332,130,16400,21098;21424;23297;24359;24450;24640,44165,0,3,3,0,6
60333,130,16401,21194;21572;24761,44165,0,1,2,0,3
60334,130,16402,21207;22004;24986;25092,44165,2,0,2,0,4
60335,130,16403,21229;21302;25142,44165,1,0,2,0,3
60336,130,16404,21179;21233;24162;25042,44165,1,1,2,0,4
60337,130,16405,21086,44165,0,0,1,0,1
60338,130,16406,21029;21390,44165,0,0,2,0,2
60339,130,16407,21350;21351;23729;25149;25228,44165,2,1,2,0,5
60340,130,16408,21367;21610;24076;24277;24369;24764,44165,0,4,2,0,6
60341,130,16409,21118;21775,44165,0,0,2,0,2
60342,130,16410,21458;21655;24187;24371;24546,44165,0,3,2,0,5
60343,130,16411,21447;21959;24289;25261,44165,1,1,2,0,4
60344,130,16412,21491;21569;24455;24858,44165,1,1,2,0,4
60345,130,16413,21556;21639;24965,44165,1,0,2,0,3
60346,130,16414,21606;21674;24075,44165,0,1,2,0,3
60347,130,16415,21767;22311,44165,0,0,2,0,2
60348,130,16416,21516;21824;24664;25174,44165,1,1,2,0,4
60349,130,16418,22113;22196;24467,44165,0,1,2,0,3
60350,130,16419,21885;22192;24566,44165,0,1,2,0,3
60351,130,16420,21894;22264;24776;24984;25082,44165,2,1,2,0,5
60352,130,16421,21900;22367;24792,44165,0,1,2,0,3
60353,130,16422,21901;22302;25279,44165,1,0,2,0,3
60354,130,16423,21874;21977,44165,0,0,2,0,2
60355,130,16424,21282;21444;25057,44165,1,0,2,0,3
60356,130,16425,21987;22033;24564;24668,44165,0,2,2,0,4
60357,130,16426,21771;21996;24886,44165,1,0,2,0,3
60358,130,16427,22250,44165,0,0,1,0,1
60359,130,16428,21908;22029,44165,0,0,2,0,2
60360,130,16429,22047;22549;25292,44165,1,0,2,0,3
60361,130,16430,21843;22049,44165,0,0,2,0,2
60362,130,16431,21791;22066;24466,44165,0,1,2,0,3
60363,130,16432,22080;22368;25282,44165,1,0,2,0,3
60364,130,16433,22032;22083;24195,44165,0,1,2,0,3
60365,130,16435,22096;22176;24383,44165,0,1,2,0,3
60366,130,16436,22115;22298;25192,44165,1,0,2,0,3
60367,130,16437,22179;22499,44165,0,0,2,0,2
60368,130,16438,22180;22455,44165,0,0,2,0,2
60369,130,16439,22102;22191,44165,0,0,2,0,2
60370,130,16440,22198;22555,44165,0,0,2,0,2
60371,130,16441,21906;22202;24287,44165,0,1,2,0,3
60372,130,16442,22206,44165,0,0,1,0,1
60373,130,16443,22232;22395,44165,0,0,2,0,2
60374,130,16444,22238;22331;24994,44165,1,0,2,0,3
60375,130,16445,22015,44165,0,0,1,0,1
60376,130,16446,17368,44530,0,0,0,1,1
60377,130,16448,18002,44530,0,0,0,1,1
60378,130,16450,18290;18796,44530,0,0,2,0,2
60379,130,16451,18664;18751,44530,0,0,2,0,2
60380,130,16453,18987,44530,0,0,1,0,1
60381,130,16456,19335,44530,0,0,1,0,1
60382,130,16457,19414,44530,0,0,1,0,1
60383,130,16459,19508,44530,0,0,1,0,1
60384,130,16463,19665,44530,0,0,1,0,1
60385,130,16464,19768;19840,44530,0,0,2,0,2
60386,130,16468,19959;19999,44530,0,0,2,0,2
60387,130,16469,19862;20367;22761;23789;23896,44530,0,2,3,0,5
60388,130,16470,19814,44530,0,0,1,0,1
60389,130,16471,20244,44530,0,0,1,0,1
60390,130,16473,19829,44530,0,0,1,0,1
60391,130,16475,20516;20521;24119,44530,0,1,2,0,3
60392,130,16476,20571;21026;24260;24832,44530,1,1,2,0,4
60393,130,16477,20073,44530,0,0,1,0,1
60394,130,16478,20614;20734;23378,44530,0,0,3,0,3
60395,130,16479,20329,44530,0,0,1,0,1
60396,130,16480,20740;20967;24339;24426;24604,44530,0,3,2,0,5
60397,130,16481,20907;21331;23952;24176,44530,0,2,2,0,4
60398,130,16482,20955;24336,44530,0,1,1,0,2
60399,130,16483,20724,44530,0,0,1,0,1
60400,130,16484,21195,44530,0,0,1,0,1
60401,130,16486,21083;21365;24726,44530,0,1,2,0,3
60402,130,16487,21450;24746,44530,0,1,1,0,2
60403,130,16488,22084;24891,44530,1,0,1,0,2
60404,130,16489,21539;21740,44530,0,0,2,0,2
60405,130,16490,21570;22508;25291,44530,1,0,2,0,3
60406,130,16491,21581;21980;25263,44530,1,0,2,0,3
60407,130,16492,21432;21726;25169;25246,44530,2,0,2,0,4
60408,130,16493,21590;21776;23733;25064,44530,1,1,2,0,4
60409,130,16494,21659;22134,44530,0,0,2,0,2
60410,130,16495,21462;21665;25165,44530,1,0,2,0,3
60411,130,16496,21258,44530,0,0,1,0,1
60412,130,16497,21694;21782;24190;25250,44530,1,1,2,0,4
60413,130,16498,21601;21797;24374;24874,44530,1,1,2,0,4
60414,130,16499,21825;22060,44530,0,0,2,0,2
60415,130,16500,21804,44530,0,0,1,0,1
60416,130,16501,21853;22296;25191,44530,1,0,2,0,3
60417,130,16502,21758;21883;24558;24880,44530,1,1,2,0,4
60418,130,16503,21871;22137;25271,44530,1,0,2,0,3
60419,130,16504,21886;22052;25080,44530,1,0,2,0,3
60420,130,16505,21911,44530,0,0,1,0,1
60421,130,16506,21927;22006;24671,44530,0,1,2,0,3
60422,130,16507,21931;21981,44530,0,0,2,0,2
60423,130,16508,21892;21986;24884,44530,1,0,2,0,3
60424,130,16509,22406,44530,0,0,1,0,1
60425,130,16510,22027;22171,44530,0,0,2,0,2
60426,130,16511,21752;21889;24870;25071,44530,2,0,2,0,4
60427,130,16512,22090;22558;24903,44530,1,0,2,0,3
60428,130,16514,21902;22489,44530,0,0,2,0,2
60429,130,16515,21855;22104;24290,44530,0,1,2,0,3
60430,130,16516,22699,44530,0,0,1,0,1
60431,130,16517,22156;22178,44530,0,0,2,0,2
60432,130,16518,22161,44530,0,0,1,0,1
60433,130,16519,22034;25267,44530,1,0,1,0,2
60434,130,16520,22170;22505,44530,0,0,2,0,2
60435,130,16521,22181;22347,44530,0,0,2,0,2
60436,130,16522,22242;22330,44530,0,0,2,0,2
60437,130,16523,22412;25287,44530,1,0,1,0,2
60438,130,16524,22292;22485,44530,0,0,2,0,2
60439,130,16525,22028;22297,44530,0,0,2,0,2
60440,130,16526,22304;24569,44530,0,1,1,0,2
60441,130,16527,22316;22528,44530,0,0,2,0,2
60442,130,16528,22319;22696;24908,44530,1,0,2,0,3
60443,130,16529,22108;22355,44530,0,0,2,0,2
60444,130,16530,22168;22356,44530,0,0,2,0,2
60445,130,16531,22365;22671;25003,44530,1,0,2,0,3
60446,130,16536,18696,44895,0,0,1,0,1
60447,130,16537,18615;18774;22116,44895,0,0,3,0,3
60448,130,16542,19161;19522;23313,44895,0,0,3,0,3
60449,130,16543,19182,44895,0,0,1,0,1
60450,130,16546,19608,44895,0,0,1,0,1
60451,130,16550,19745,44895,0,0,1,0,1
60452,130,16552,19801,44895,0,0,1,0,1
60453,130,16553,20146;20573;23372;24020;25208,44895,1,1,3,0,5
60454,130,16555,20330;20496,44895,0,0,2,0,2
60455,130,16556,20336;20609;23592;24125;24313;24586,44895,0,4,2,0,6
60456,130,16558,20486;21122;23830;25039,44895,1,1,2,0,4
60457,130,16560,20434,44895,0,0,1,0,1
60458,130,16561,20266,44895,0,0,1,0,1
60459,130,16563,21348;21380;24179;25055,44895,1,1,2,0,4
60460,130,16565,21091;24262;24344;25139,44895,1,2,1,0,4
60461,130,16567,21148;21442;24180;24745,44895,0,2,2,0,4
60462,130,16570,21079;21330;23616;24356;25148,44895,1,2,2,0,5
60463,130,16571,21068;21378,44895,0,0,2,0,2
60464,130,16572,21396;21764,44895,0,0,2,0,2
60465,130,16573,21398;21838;24773;24875,44895,1,1,2,0,4
60466,130,16574,21406,44895,0,0,1,0,1
60467,130,16576,21381;21661;24282;24548,44895,0,2,2,0,4
60468,130,16577,21388;21504;24358;24446,44895,0,2,2,0,4
60469,130,16579,21554;22011;24888,44895,1,0,2,0,3
60470,130,16580,21573;21919;24464,44895,0,1,2,0,3
60471,130,16581,21578;25063,44895,1,0,1,0,2
60472,130,16582,21882;22025;23963;24879;25079,44895,2,1,2,0,5
60473,130,16583,21252,44895,0,0,1,0,1
60474,130,16585,21453;21779,44895,0,0,2,0,2
60475,130,16586,21688;24656;24866,44895,1,1,1,0,3
60476,130,16587,21721,44895,0,0,1,0,1
60477,130,16588,22187,44895,0,0,1,0,1
60478,130,16589,21783;22035;25181,44895,1,0,2,0,3
60479,130,16590,21830;22303;25108,44895,1,0,2,0,3
60480,130,16591,21851;22127,44895,0,0,2,0,2
60481,130,16592,21852;22327;24570,44895,0,1,2,0,3
60482,130,16593,21898;21997;25179,44895,1,0,2,0,3
60483,130,16594,21915;22263,44895,0,0,2,0,2
60484,130,16595,21916;24081;24191,44895,0,2,1,0,3
60485,130,16596,21877;21943;24775,44895,0,1,2,0,3
60486,130,16597,21948;22295,44895,0,0,2,0,2
60487,130,16598,22021;22336;25280,44895,1,0,2,0,3
60488,130,16599,22068;22434,44895,0,0,2,0,2
60489,130,16600,21649;22075;24988,44895,1,0,2,0,3
60490,130,16601,21800;22077,44895,0,0,2,0,2
60491,130,16602,22079;22122,44895,0,0,2,0,2
60492,130,16603,22087;22322;24469;24791,44895,0,2,2,0,4
60493,130,16604,22101;22757;24912,44895,1,0,2,0,3
60494,130,16605,22109;22273;24468,44895,0,1,2,0,3
60495,130,16606,21759;22140,44895,0,0,2,0,2
60496,130,16607,22693,44895,0,0,1,0,1
60497,130,16608,22162;22564,44895,0,0,2,0,2
60498,130,16609,22186;22740,44895,0,0,2,0,2
60499,130,16610,22204;22724,44895,0,0,2,0,2
60500,130,16611,21863;22243,44895,0,0,2,0,2
60501,130,16612,22496;25289,44895,1,0,1,0,2
60502,130,16613,22051;22262,44895,0,0,2,0,2
60503,130,16614,22314;22335;24789;25109,44895,1,1,2,0,4
60504,130,16615,22224;22354;24898,44895,1,0,2,0,3
60505,130,16616,22225;22379;24901;24996,44895,2,0,2,0,4
60506,130,16617,22394;22466,44895,0,0,2,0,2
60507,130,16618,22018;22396,44895,0,0,2,0,2
60508,130,16619,22288;22401;25284,44895,1,0,2,0,3
60509,130,16620,22183;22404;24794;25285,44895,1,1,2,0,4
60510,130,16621,22440;22756;24804,44895,0,1,2,0,3
60511,130,16622,22442;22695,44895,0,0,2,0,2
60512,130,16623,22446;22859;25121,44895,1,0,2,0,3
60513,130,16624,22346;22461,44895,0,0,2,0,2
60514,130,16625,22484;22741,44895,0,0,2,0,2
60515,130,16626,22747,44895,0,0,1,0,1
60516,130,16627,17855;18276,45260,0,0,1,1,2
60517,130,16628,17624,45260,0,0,0,1,1
60518,130,16630,17890,45260,0,0,0,1,1
60519,130,16632,17886;18611,45260,0,0,1,1,2
60520,130,16634,18781;19154,45260,0,0,2,0,2
60521,130,16637,18951;19018,45260,0,0,2,0,2
60522,130,16639,19118;19562,45260,0,0,2,0,2
60523,130,16640,19168,45260,0,0,1,0,1
60524,130,16642,19188;19278,45260,0,0,2,0,2
60525,130,16643,19007,45260,0,0,1,0,1
60526,130,16646,19622;19901;22852;23157;23446;23545;23980;24291,45260,0,3,5,0,8
60527,130,16647,19957,45260,0,0,1,0,1
60528,130,16648,19525,45260,0,0,1,0,1
60529,130,16650,19992,45260,0,0,1,0,1
60530,130,16652,20274,45260,0,0,1,0,1
60531,130,16653,20020,45260,0,0,1,0,1
60532,130,16654,20206;20371;24482,45260,0,1,2,0,3
60533,130,16656,20240,45260,0,0,1,0,1
60534,130,16659,20469,45260,0,0,1,0,1
60535,130,16663,20558;20904;24121;24233,45260,0,2,2,0,4
60536,130,16664,21035;21219;23836;24164,45260,0,2,2,0,4
60537,130,16665,21094,45260,0,0,1,0,1
60538,130,16666,21183;21530;24646,45260,0,1,2,0,3
60539,130,16667,21385;21548,45260,0,0,2,0,2
60540,130,16668,21586;21609;23846,45260,0,1,2,0,3
60541,130,16669,21414;21641;24966;25163,45260,2,0,2,0,4
60542,130,16670,21643;22359,45260,0,0,2,0,2
60543,130,16671,21647,45260,0,0,1,0,1
60544,130,16672,21108,45260,0,0,1,0,1
60545,130,16673,21654;21698;24280;24456;24545;24766;25164,45260,1,4,2,0,7
60546,130,16674,21443;21709;24458;24867;25167,45260,2,1,2,0,5
60547,130,16675,21723;24868;24972;25168,45260,3,0,1,0,4
60548,130,16676,21769;24661,45260,0,1,1,0,2
60549,130,16677,21735;22020;25180,45260,1,0,2,0,3
60550,130,16678,21737,45260,0,0,1,0,1
60551,130,16679,21742;22203;25101;25275,45260,2,0,2,0,4
60552,130,16680,22261;24993,45260,1,0,1,0,2
60553,130,16681,21859;21905,45260,0,0,2,0,2
60554,130,16682,21630;21684,45260,0,0,2,0,2
60555,130,16683,21971;24377,45260,0,1,1,0,2
60556,130,16684,22000,45260,0,0,1,0,1
60557,130,16685,21887;22043;25268,45260,1,0,2,0,3
60558,130,16686,22063;22158;24783;25099,45260,1,1,2,0,4
60559,130,16687,22097;22285,45260,0,0,2,0,2
60560,130,16688,22114;22270;24682,45260,0,1,2,0,3
60561,130,16689,22125;22221,45260,0,0,2,0,2
60562,130,16690,22200;22651;25116,45260,1,0,2,0,3
60563,130,16691,22536,45260,0,0,1,0,1
60564,130,16692,22252;22349,45260,0,0,2,0,2
60565,130,16693,22272;22400,45260,0,0,2,0,2
60566,130,16694,22320;22915,45260,0,0,2,0,2
60567,130,16695,22222;22326;25195,45260,1,0,2,0,3
60568,130,16696,22387;22398,45260,0,0,2,0,2
60569,130,16697,22539;22793,45260,0,0,2,0,2
60570,130,16698,22253;22437,45260,0,0,2,0,2
60571,130,16699,22710;22885,45260,0,0,2,0,2
60572,130,16700,22098;22478,45260,0,0,2,0,2
60573,130,16701,22492;22796;24914,45260,1,0,2,0,3
60574,130,16702,22493,45260,0,0,1,0,1
60575,130,16703,22501;22619;25114,45260,1,0,2,0,3
60576,130,16704,22523;22780,45260,0,0,2,0,2
60577,130,16705,22529;22532,45260,0,0,2,0,2
60578,130,16706,22473;22535,45260,0,0,2,0,2
60579,130,16707,22553;22596;24388,45260,0,1,2,0,3
60580,130,16708,22076;22556,45260,0,0,2,0,2
60581,130,16709,22560;22645;24802,45260,0,1,2,0,3
60582,130,16710,22269;22577;24801,45260,0,1,2,0,3
60583,130,16711,22470;22618;25201,45260,1,0,2,0,3
60584,130,16712,22338;22623,45260,0,0,2,0,2
60585,130,16713,22275;22626,45260,0,0,2,0,2
60586,130,16714,18102,45625,0,0,0,1,1
60587,130,16716,18403,45625,0,0,1,0,1
60588,130,16718,18086,45625,0,0,0,1,1
60589,130,16720,18530;18591,45625,0,0,2,0,2
60590,130,16721,18404,45625,0,0,1,0,1
60591,130,16722,18545,45625,0,0,1,0,1
60592,130,16724,18895;19049,45625,0,0,2,0,2
60593,130,16725,18939;18960,45625,0,0,2,0,2
60594,130,16726,19087,45625,0,0,1,0,1
60595,130,16727,18755;19341,45625,0,0,2,0,2
60596,130,16729,19244;19280,45625,0,0,2,0,2
60597,130,16731,19159,45625,0,0,1,0,1
60598,130,16732,19561,45625,0,0,1,0,1
60599,130,16734,19643,45625,0,0,1,0,1
60600,130,16735,19707,45625,0,0,1,0,1
60601,130,16736,19565,45625,0,0,1,0,1
60602,130,16737,20065;20299,45625,0,0,2,0,2
60603,130,16740,20332,45625,0,0,1,0,1
60604,130,16745,20743;21223;23503;24165,45625,0,1,3,0,4
60605,130,16746,21034;21063;24158;24513;25217,45625,1,2,2,0,5
60606,130,16748,21170;21519;24071;24753;24959;25160,45625,2,2,2,0,6
60607,130,16749,21264,45625,0,0,1,0,1
60608,130,16750,21253;21451;23839;24950,45625,1,1,2,0,4
60609,130,16751,21325;21790;24873;25173,45625,2,0,2,0,4
60610,130,16752,21352;21563;24442;24635,45625,0,2,2,0,4
60611,130,16753,21185,45625,0,0,1,0,1
60612,130,16754,21472;21942;24881;25087,45625,2,0,2,0,4
60613,130,16755,21529;21949,45625,0,0,2,0,2
60614,130,16756,21538;21788;24771,45625,0,1,2,0,3
60615,130,16757,21457,45625,0,0,1,0,1
60616,130,16759,21638;22026,45625,0,0,2,0,2
60617,130,16761,21419;21774;24189;24871,45625,1,1,2,0,4
60618,130,16762,21945;22768;25119,45625,1,0,2,0,3
60619,130,16763,21955;22184,45625,0,0,2,0,2
60620,130,16764,21958;21970;23964;24561;25090,45625,1,2,2,0,5
60621,130,16765,22093;22259,45625,0,0,2,0,2
60622,130,16766,21993;22362,45625,0,0,2,0,2
60623,130,16767,22039;22245;24787,45625,0,1,2,0,3
60624,130,16768,22048;22476;24571,45625,0,1,2,0,3
60625,130,16769,22073;22112;25184,45625,1,0,2,0,3
60626,130,16770,22124;22561;24572,45625,0,1,2,0,3
60627,130,16771,22251;22357,45625,0,0,2,0,2
60628,130,16772,22281;25278,45625,1,0,1,0,2
60629,130,16773,22481;22890,45625,0,0,2,0,2
60630,130,16774,22305;22638;25115,45625,1,0,2,0,3
60631,130,16775,22276;22350;25107,45625,1,0,2,0,3
60632,130,16776,22146;22462,45625,0,0,2,0,2
60633,130,16777,22237;22403;24471,45625,0,1,2,0,3
60634,130,16778,22422;22681,45625,0,0,2,0,2
60635,130,16779,22808,45625,0,0,1,0,1
60636,130,16780,22435;22817,45625,0,0,2,0,2
60637,130,16781,22504;22622;24800;25290,45625,1,1,2,0,4
60638,130,16782,22540,45625,0,0,1,0,1
60639,130,16783,22418;22545,45625,0,0,2,0,2
60640,130,16784,22374;22570,45625,0,0,2,0,2
60641,130,16785,22456;22584,45625,0,0,2,0,2
60642,130,16786,22611;23052,45625,0,0,2,0,2
60643,130,16787,22644;23098,45625,0,0,2,0,2
60644,130,16788,22939;25308,45625,1,0,1,0,2
60645,130,16789,22673;22851,45625,0,0,2,0,2
60646,130,16790,22679;22961,45625,0,0,2,0,2
60647,130,16791,22680;22839,45625,0,0,2,0,2
60648,130,16792,22612;22685;25203,45625,1,0,2,0,3
60649,130,16793,22120,45625,0,0,1,0,1
60650,130,16794,22704;22812;24687,45625,0,1,2,0,3
60651,130,16795,22708;22749,45625,0,0,2,0,2
60652,130,16796,22714;25004,45625,1,0,1,0,2
60653,130,16797,22725;22944,45625,0,0,2,0,2
60654,130,16798,22742,45625,0,0,1,0,1
60655,130,16799,22572;22745;25293,45625,1,0,2,0,3
60656,130,16800,22766,45625,0,0,1,0,1
60657,130,16801,22770,45625,0,0,1,0,1
60658,130,16802,18260,45990,0,0,1,0,1
60659,130,16803,18194,45990,0,0,1,0,1
60660,130,16804,18218,45990,0,0,1,0,1
60661,130,16805,17952,45990,0,0,0,1,1
60662,130,16806,18659,45990,0,0,1,0,1
60663,130,16807,18219,45990,0,0,1,0,1
60664,130,16810,18692;19287,45990,0,0,2,0,2
60665,130,16812,18936,45990,0,0,1,0,1
60666,130,16814,19038,45990,0,0,1,0,1
60667,130,16815,18335,45990,0,0,1,0,1
60668,130,16817,19109,45990,0,0,1,0,1
60669,130,16819,19410,45990,0,0,1,0,1
60670,130,16820,19688;20019,45990,0,0,2,0,2
60671,130,16821,19781,45990,0,0,1,0,1
60672,130,16822,19831,45990,0,0,1,0,1
60673,130,16828,20346,45990,0,0,1,0,1
60674,130,16832,20187;20534;23488;23581;24016;24584,45990,0,3,3,0,6
60675,130,16833,20582,45990,0,0,1,0,1
60676,130,16834,20633;23913,45990,0,1,1,0,2
60677,130,16836,20500;20902;24144;24333;25133,45990,1,2,2,0,5
60678,130,16837,20741;21032,45990,0,0,2,0,2
60679,130,16839,20750,45990,0,0,1,0,1
60680,130,16840,20733,45990,0,0,1,0,1
60681,130,16841,21134;21713;23735,45990,0,1,2,0,3
60682,130,16842,21338;21360;24940,45990,1,0,2,0,3
60683,130,16843,21500;21707;23621;24957;25059,45990,2,1,2,0,5
60684,130,16844,21575;24185,45990,0,1,1,0,2
60685,130,16845,21596;22166,45990,0,0,2,0,2
60686,130,16846,21602,45990,0,0,1,0,1
60687,130,16847,21696;22069;24380,45990,0,1,2,0,3
60688,130,16848,21720;22054;24379;24779;24890;25094,45990,2,2,2,0,6
60689,130,16849,21733;22150,45990,0,0,2,0,2
60690,130,16850,21732,45990,0,0,1,0,1
60691,130,16851,21524;21846;24877,45990,1,0,2,0,3
60692,130,16852,21865;22217;25104,45990,1,0,2,0,3
60693,130,16853,21837;21914;24665;24980,45990,1,1,2,0,4
60694,130,16854,21918;22231;24785;25105,45990,1,1,2,0,4
60695,130,16855,21952,45990,0,0,1,0,1
60696,130,16856,21794;21976;24192;25091;25262,45990,2,1,2,0,5
60697,130,16857,22121;22246;24788,45990,0,1,2,0,3
60698,130,16858,22169,45990,0,0,1,0,1
60699,130,16859,22240;22329,45990,0,0,2,0,2
60700,130,16860,22277;22278;24683,45990,0,1,2,0,3
60701,130,16861,22351;22370,45990,0,0,2,0,2
60702,130,16862,22372;22734,45990,0,0,2,0,2
60703,130,16863,22413;22743,45990,0,0,2,0,2
60704,130,16864,22432;22784;25006,45990,1,0,2,0,3
60705,130,16865,22197;22450;25000,45990,1,0,2,0,3
60706,130,16866,22452;22917,45990,0,0,2,0,2
60707,130,16867,22465;22617,45990,0,0,2,0,2
60708,130,16868,22477;22936;24689,45990,0,1,2,0,3
60709,130,16869,22538;22726;25204;25301,45990,2,0,2,0,4
60710,130,16870,22597;22659,45990,0,0,2,0,2
60711,130,16871,22557;22646,45990,0,0,2,0,2
60712,130,16872,22648;22715;24685;24803,45990,0,2,2,0,4
60713,130,16873,22656;22771,45990,0,0,2,0,2
60714,130,16874,22676;22914,45990,0,0,2,0,2
60715,130,16875,22683;22855,45990,0,0,2,0,2
60716,130,16876,22300;22694,45990,0,0,2,0,2
60717,130,16877,22755,45990,0,0,1,0,1
60718,130,16878,22763;23014,45990,0,0,2,0,2
60719,130,16879,22809;22941,45990,0,0,2,0,2
60720,130,16880,22813,45990,0,0,1,0,1
60721,130,16881,22863;22884,45990,0,0,2,0,2
60722,130,16882,18365,46355,0,0,1,0,1
60723,130,16883,18730,46355,0,0,1,0,1
60724,130,16886,19001,46355,0,0,1,0,1
60725,130,16890,19191,46355,0,0,1,0,1
60726,130,16891,19232,46355,0,0,1,0,1
60727,130,16894,18712,46355,0,0,1,0,1
60728,130,16895,19338,46355,0,0,1,0,1
60729,130,16896,19607,46355,0,0,1,0,1
60730,130,16897,19558,46355,0,0,1,0,1
60731,130,16899,19758,46355,0,0,1,0,1
60732,130,16900,20023,46355,0,0,1,0,1
60733,130,16901,19444,46355,0,0,1,0,1
60734,130,16902,19906;20005,46355,0,0,2,0,2
60735,130,16903,20007,46355,0,0,1,0,1
60736,130,16904,20004,46355,0,0,1,0,1
60737,130,16905,20284,46355,0,0,1,0,1
60738,130,16908,20545;20749,46355,0,0,2,0,2
60739,130,16909,20652,46355,0,0,1,0,1
60740,130,16910,20387,46355,0,0,1,0,1
60741,130,16911,20156,46355,0,0,1,0,1
60742,130,16913,20566;20891;23384;24142;24332,46355,0,2,3,0,5
60743,130,16915,20794,46355,0,0,1,0,1
60744,130,16916,21023;21438;24273;24949;25155,46355,2,1,2,0,5
60745,130,16919,21274,46355,0,0,1,0,1
60746,130,16921,21391;21459;24741;24945;25152,46355,2,1,2,0,5
60747,130,16922,21485;21699;24373,46355,0,1,2,0,3
60748,130,16924,21293;21642,46355,0,0,2,0,2
60749,130,16925,21574;21729;24658;24973,46355,1,1,2,0,4
60750,130,16927,21241,46355,0,0,1,0,1
60751,130,16928,21845;22185,46355,0,0,2,0,2
60752,130,16929,21848;22229;25276,46355,1,0,2,0,3
60753,130,16930,21929;22058;25084,46355,1,0,2,0,3
60754,130,16931,22164,46355,0,0,1,0,1
60755,130,16932,21784;22173,46355,0,0,2,0,2
60756,130,16933,21714,46355,0,0,1,0,1
60757,130,16934,22244;22449;24387,46355,0,1,2,0,3
60758,130,16935,22247,46355,0,0,1,0,1
60759,130,16936,22249;22274,46355,0,0,2,0,2
60760,130,16937,22306;22820,46355,0,0,2,0,2
60761,130,16938,22313;23166,46355,0,0,2,0,2
60762,130,16939,22340,46355,0,0,1,0,1
60763,130,16940,22342;22598,46355,0,0,2,0,2
60764,130,16941,22353;22866,46355,0,0,2,0,2
60765,130,16942,22369,46355,0,0,1,0,1
60766,130,16943,22118;22371,46355,0,0,2,0,2
60767,130,16944,22376;22785,46355,0,0,2,0,2
60768,130,16945,22384;22670,46355,0,0,2,0,2
60769,130,16946,22415;22948;24805,46355,0,1,2,0,3
60770,130,16947,22072,46355,0,0,1,0,1
60771,130,16948,22423;22563,46355,0,0,2,0,2
60772,130,16949,22427;22451;24798,46355,0,1,2,0,3
60773,130,16950,22448;22792,46355,0,0,2,0,2
60774,130,16951,21969;22475,46355,0,0,2,0,2
60775,130,16952,22290;22487,46355,0,0,2,0,2
60776,130,16953,22500,46355,0,0,1,0,1
60777,130,16954,22559;22731;24911,46355,1,0,2,0,3
60778,130,16955,22312;22594,46355,0,0,2,0,2
60779,130,16956,22602;22872;25294,46355,1,0,2,0,3
60780,130,16957,22603;22864,46355,0,0,2,0,2
60781,130,16958,22624;23219,46355,0,0,2,0,2
60782,130,16959,22637;22777,46355,0,0,2,0,2
60783,130,16960,22607;22667,46355,0,0,2,0,2
60784,130,16961,22647;22698,46355,0,0,2,0,2
60785,130,16962,22700;23008,46355,0,0,2,0,2
60786,130,16963,22730;22965,46355,0,0,2,0,2
60787,130,16964,22174;22750;24686;25303,46355,1,1,2,0,4
60788,130,16965,22762;22823,46355,0,0,2,0,2
60789,130,16966,22497;22775,46355,0,0,2,0,2
60790,130,16967,22835;23205,46355,0,0,2,0,2
60791,130,16968,22848,46355,0,0,1,0,1
60792,130,16969,22850;22989,46355,0,0,2,0,2
60793,130,16970,22459,46355,0,0,1,0,1
60794,130,16971,22886;23250,46355,0,0,2,0,2
60795,130,16972,22706;22895;25009,46355,1,0,2,0,3
60796,130,16973,22916;23178,46355,0,0,2,0,2
60797,130,16974,22530;22937;25111,46355,1,0,2,0,3
60798,130,16975,22940;23206,46355,0,0,2,0,2
60799,130,16976,22969;23109,46355,0,0,2,0,2
60800,130,16977,22975;22987,46355,0,0,2,0,2
60801,130,16978,22930;22990,46355,0,0,2,0,2
60802,130,16979,22993;23248,46355,0,0,2,0,2
60803,130,16980,18315,46720,0,0,1,0,1
60804,130,16981,18564;18949,46720,0,0,2,0,2
60805,130,16982,18760;18768,46720,0,0,2,0,2
60806,130,16986,19406,46720,0,0,1,0,1
60807,130,16988,19677,46720,0,0,1,0,1
60808,130,16991,19760,46720,0,0,1,0,1
60809,130,16992,19777;19912,46720,0,0,2,0,2
60810,130,16993,20211,46720,0,0,1,0,1
60811,130,16994,20361,46720,0,0,1,0,1
60812,130,16995,20095,46720,0,0,1,0,1
60813,130,16997,19944,46720,0,0,1,0,1
60814,130,16998,20197,46720,0,0,1,0,1
60815,130,16999,19818;20066,46720,0,0,2,0,2
60816,130,17000,20084,46720,0,0,1,0,1
60817,130,17001,19917,46720,0,0,1,0,1
60818,130,17003,20580,46720,0,0,1,0,1
60819,130,17004,20581,46720,0,0,1,0,1
60820,130,17006,20368,46720,0,0,1,0,1
60821,130,17007,20715,46720,0,0,1,0,1
60822,130,17008,20444,46720,0,0,1,0,1
60823,130,17009,21095,46720,0,0,1,0,1
60824,130,17010,21376,46720,0,0,1,0,1
60825,130,17011,21425;21509;23622;23841,46720,0,2,2,0,4
60826,130,17012,21537;21738;25248,46720,1,0,2,0,3
60827,130,17013,21474,46720,0,0,1,0,1
60828,130,17014,21593;22044,46720,0,0,2,0,2
60829,130,17015,21650,46720,0,0,1,0,1
60830,130,17016,21402,46720,0,0,1,0,1
60831,130,17017,21810,46720,0,0,1,0,1
60832,130,17018,21907;22142,46720,0,0,2,0,2
60833,130,17019,21891,46720,0,0,1,0,1
60834,130,17020,21984;22213;24992;25103,46720,2,0,2,0,4
60835,130,17021,22005;22454,46720,0,0,2,0,2
60836,130,17022,22163;22674;25117,46720,1,0,2,0,3
60837,130,17023,22205;24897,46720,1,0,1,0,2
60838,130,17024,22223;22565;24904,46720,1,0,2,0,3
60839,130,17025,22226,46720,0,0,1,0,1
60840,130,17026,21888;22265;24681;25189,46720,1,1,2,0,4
60841,130,17027,22209;22279;24900,46720,1,0,2,0,3
60842,130,17028,22283;22752,46720,0,0,2,0,2
60843,130,17029,22219;22325;24084;24384;25188,46720,1,2,2,0,5
60844,130,17030,22360;22825,46720,0,0,2,0,2
60845,130,17031,22381;25197,46720,1,0,1,0,2
60846,130,17032,22383;22871,46720,0,0,2,0,2
60847,130,17033,22318;22399,46720,0,0,2,0,2
60848,130,17034,22059;22407;25286,46720,1,0,2,0,3
60849,130,17035,22429,46720,0,0,1,0,1
60850,130,17036,22457;22503,46720,0,0,2,0,2
60851,130,17037,22519;23020,46720,0,0,2,0,2
60852,130,17038,22521;22821,46720,0,0,2,0,2
60853,130,17039,22344;22551,46720,0,0,2,0,2
60854,130,17040,22606;22643,46720,0,0,2,0,2
60855,130,17041,22686;23146,46720,0,0,2,0,2
60856,130,17042,22712;22956,46720,0,0,2,0,2
60857,130,17043,22718;23279,46720,0,0,2,0,2
60858,130,17044,22554;22767,46720,0,0,2,0,2
60859,130,17045,22728;22786,46720,0,0,2,0,2
60860,130,17046,22790;23101,46720,0,0,2,0,2
60861,130,17047,22827;23062,46720,0,0,2,0,2
60862,130,17048,22840,46720,0,0,1,0,1
60863,130,17049,22898,46720,0,0,1,0,1
60864,130,17050,22912;23380;25317,46720,1,0,2,0,3
60865,130,17051,22789;22919;25010,46720,1,0,2,0,3
60866,130,17052,22925;23045,46720,0,0,2,0,2
60867,130,17053,22801;22928,46720,0,0,2,0,2
60868,130,17054,22945;23094,46720,0,0,2,0,2
60869,130,17055,22951;22973,46720,0,0,2,0,2
60870,130,17056,22976;23038,46720,0,0,2,0,2
60871,130,17057,23016;23243,46720,0,0,2,0,2
60872,130,17058,22985,46720,0,0,1,0,1
60873,130,17059,23022;23049,46720,0,0,2,0,2
60874,130,17060,23023;23230;25315,46720,1,0,2,0,3
60875,130,17061,23036;23044;25124;25311,46720,2,0,2,0,4
60876,130,17062,23026;23043,46720,0,0,2,0,2
60877,130,17063,23051;23194,46720,0,0,2,0,2
60878,130,17064,23057;23267,46720,0,0,2,0,2
60879,130,17065,23024;23067,46720,0,0,2,0,2
60880,130,17066,23074;23239,46720,0,0,2,0,2
60881,130,17067,23102,46720,0,0,1,0,1
60882,130,17068,18527,47085,0,0,1,0,1
60883,130,17069,18653,47085,0,0,1,0,1
60884,130,17070,18766,47085,0,0,1,0,1
60885,130,17071,18913,47085,0,0,1,0,1
60886,130,17072,19020,47085,0,0,1,0,1
60887,130,17073,18679,47085,0,0,1,0,1
60888,130,17074,19175,47085,0,0,1,0,1
60889,130,17075,19386,47085,0,0,1,0,1
60890,130,17076,19656,47085,0,0,1,0,1
60891,130,17077,19242,47085,0,0,1,0,1
60892,130,17078,19811,47085,0,0,1,0,1
60893,130,17079,19467,47085,0,0,1,0,1
60894,130,17080,19658,47085,0,0,1,0,1
60895,130,17081,19858,47085,0,0,1,0,1
60896,130,17082,19208,47085,0,0,1,0,1
60897,130,17083,20231,47085,0,0,1,0,1
60898,130,17084,20265;20671,47085,0,0,2,0,2
60899,130,17085,20254,47085,0,0,1,0,1
60900,130,17086,20328;23575;24110,47085,0,2,1,0,3
60901,130,17087,20304,47085,0,0,1,0,1
60902,130,17088,20085,47085,0,0,1,0,1
60903,130,17089,20507,47085,0,0,1,0,1
60904,130,17090,20513,47085,0,0,1,0,1
60905,130,17092,20180,47085,0,0,1,0,1
60906,130,17093,20612,47085,0,0,1,0,1
60907,130,17094,20676,47085,0,0,1,0,1
60908,130,17095,20725,47085,0,0,1,0,1
60909,130,17097,20856,47085,0,0,1,0,1
60910,130,17098,20767,47085,0,0,1,0,1
60911,130,17099,20514,47085,0,0,1,0,1
60912,130,17100,20706,47085,0,0,1,0,1
60913,130,17101,21061,47085,0,0,1,0,1
60914,130,17103,21213,47085,0,0,1,0,1
60915,130,17104,21312,47085,0,0,1,0,1
60916,130,17105,21175;21317;23950;24175;25146;25226,47085,2,2,2,0,6
60917,130,17108,21165,47085,0,0,1,0,1
60918,130,17109,21676,47085,0,0,1,0,1
60919,130,17110,21753;22061,47085,0,0,2,0,2
60920,130,17111,21750,47085,0,0,1,0,1
60921,130,17112,21935;22271;24899,47085,1,0,2,0,3
60922,130,17113,21623,47085,0,0,1,0,1
60923,130,17114,22130;22760;24913;25005;25304,47085,3,0,2,0,5
60924,130,17115,22143,47085,0,0,1,0,1
60925,130,17116,22155;22445;24678,47085,0,1,2,0,3
60926,130,17117,22172,47085,0,0,1,0,1
60927,130,17118,21809,47085,0,0,1,0,1
60928,130,17119,22257,47085,0,0,1,0,1
60929,130,17120,22287;22837,47085,0,0,2,0,2
60930,130,17121,22293;22873,47085,0,0,2,0,2
60931,130,17122,22321;22366,47085,0,0,2,0,2
60932,130,17123,22378,47085,0,0,1,0,1
60933,130,17124,22268;22460,47085,0,0,2,0,2
60934,130,17125,22471;22509,47085,0,0,2,0,2
60935,130,17126,22479,47085,0,0,1,0,1
60936,130,17127,22092;22486,47085,0,0,2,0,2
60937,130,17128,22516,47085,0,0,1,0,1
60938,130,17129,22546;23063,47085,0,0,2,0,2
60939,130,17130,22576;22654,47085,0,0,2,0,2
60940,130,17131,22582,47085,0,0,1,0,1
60941,130,17132,22419;22608,47085,0,0,2,0,2
60942,130,17133,22640;22853,47085,0,0,2,0,2
60943,130,17134,22662,47085,0,0,1,0,1
60944,130,17135,22201;22702;24909,47085,1,0,2,0,3
60945,130,17136,22289;22711,47085,0,0,2,0,2
60946,130,17137,22182,47085,0,0,1,0,1
60947,130,17138,22729;22841;24688,47085,0,1,2,0,3
60948,130,17139,22630;22717;24906;25295,47085,2,0,2,0,4
60949,130,17140,22811;23030;24916,47085,1,0,2,0,3
60950,130,17141,22375;22828,47085,0,0,2,0,2
60951,130,17142,22833;22920,47085,0,0,2,0,2
60952,130,17143,22845;23069,47085,0,0,2,0,2
60953,130,17144,22854;23363,47085,0,0,2,0,2
60954,130,17145,22891;23300,47085,0,0,2,0,2
60955,130,17146,22927;23301,47085,0,0,2,0,2
60956,130,17147,22299;22929,47085,0,0,2,0,2
60957,130,17148,22932;23108,47085,0,0,2,0,2
60958,130,17149,22836;22960,47085,0,0,2,0,2
60959,130,17150,22964;23269,47085,0,0,2,0,2
60960,130,17151,22970;23393,47085,0,0,2,0,2
60961,130,17152,23010;23149,47085,0,0,2,0,2
60962,130,17153,22779;23053,47085,0,0,2,0,2
60963,130,17154,23000;23071,47085,0,0,2,0,2
60964,130,17155,23073;23476,47085,0,0,2,0,2
60965,130,17156,23097,47085,0,0,1,0,1
60966,130,17157,22971;23131,47085,0,0,2,0,2
60967,130,17158,23144;23470,47085,0,0,2,0,2
60968,130,17159,23087;23161,47085,0,0,2,0,2
60969,130,17160,22860;23168,47085,0,0,2,0,2
60970,130,17161,23007;23177;25313,47085,1,0,2,0,3
60971,130,17162,23181,47085,0,0,1,0,1
60972,130,17163,23133;23183,47085,0,0,2,0,2
60973,130,17164,23184;23299,47085,0,0,2,0,2
60974,130,17165,18666,47450,0,0,1,0,1
60975,130,17166,18737,47450,0,0,1,0,1
60976,130,17167,18989,47450,0,0,1,0,1
60977,130,17168,19489,47450,0,0,1,0,1
60978,130,17169,18908,47450,0,0,1,0,1
60979,130,17170,19255,47450,0,0,1,0,1
60980,130,17171,18924,47450,0,0,1,0,1
60981,130,17172,18720,47450,0,0,1,0,1
60982,130,17173,19446,47450,0,0,1,0,1
60983,130,17174,18972,47450,0,0,1,0,1
60984,130,17175,19639,47450,0,0,1,0,1
60985,130,17176,19013,47450,0,0,1,0,1
60986,130,17177,19843,47450,0,0,1,0,1
60987,130,17178,19873,47450,0,0,1,0,1
60988,130,17179,19879,47450,0,0,1,0,1
60989,130,17180,19859,47450,0,0,1,0,1
60990,130,17181,19605,47450,0,0,1,0,1
60991,130,17182,20577,47450,0,0,1,0,1
60992,130,17183,20669;21255;23396;24267,47450,0,1,3,0,4
60993,130,17184,20682,47450,0,0,1,0,1
60994,130,17185,20846,47450,0,0,1,0,1
60995,130,17186,20530,47450,0,0,1,0,1
60996,130,17187,20958,47450,0,0,1,0,1
60997,130,17188,21149;21822,47450,0,0,2,0,2
60998,130,17189,20872,47450,0,0,1,0,1
60999,130,17190,21208,47450,0,0,1,0,1
61000,130,17191,20880;21279;24352;24524;24733;25225,47450,1,3,2,0,6
61001,130,17192,21287,47450,0,0,1,0,1
61002,130,17193,21039,47450,0,0,1,0,1
61003,130,17194,21121,47450,0,0,1,0,1
61004,130,17195,21242;21543;24961,47450,1,0,2,0,3
61005,130,17196,21557,47450,0,0,1,0,1
61006,130,17197,21592,47450,0,0,1,0,1
61007,130,17198,21257,47450,0,0,1,0,1
61008,130,17199,21839,47450,0,0,1,0,1
61009,130,17201,21862;22377;25196;25283,47450,2,0,2,0,4
61010,130,17202,21739,47450,0,0,1,0,1
61011,130,17203,21979,47450,0,0,1,0,1
61012,130,17204,21992;22308,47450,0,0,2,0,2
61013,130,17205,22089;22091;24381;24892,47450,1,1,2,0,4
61014,130,17206,22111;22343;25281,47450,1,0,2,0,3
61015,130,17207,21781,47450,0,0,1,0,1
61016,130,17208,21808,47450,0,0,1,0,1
61017,130,17209,22255,47450,0,0,1,0,1
61018,130,17210,21813,47450,0,0,1,0,1
61019,130,17211,22258,47450,0,0,1,0,1
61020,130,17212,22337;22844;25007,47450,1,0,2,0,3
61021,130,17213,22339;22573;24905,47450,1,0,2,0,3
61022,130,17214,22405;23048,47450,0,0,2,0,2
61023,130,17215,22254,47450,0,0,1,0,1
61024,130,17216,22348;22416,47450,0,0,2,0,2
61025,130,17217,22467;22826,47450,0,0,2,0,2
61026,130,17218,22443;22507;24999,47450,1,0,2,0,3
61027,130,17219,22511;22758;25118,47450,1,0,2,0,3
61028,130,17220,22148,47450,0,0,1,0,1
61029,130,17221,22382;22587,47450,0,0,2,0,2
61030,130,17222,22595;22967,47450,0,0,2,0,2
61031,130,17223,22605;22610,47450,0,0,2,0,2
61032,130,17224,22661;23155,47450,0,0,2,0,2
61033,130,17225,22334;22748,47450,0,0,2,0,2
61034,130,17226,22753;23013,47450,0,0,2,0,2
61035,130,17227,22776;22798,47450,0,0,2,0,2
61036,130,17228,22781;22838;24472,47450,0,1,2,0,3
61037,130,17229,22783;22794,47450,0,0,2,0,2
61038,130,17230,22832;23492,47450,0,0,2,0,2
61039,130,17231,22877;23095,47450,0,0,2,0,2
61040,130,17232,22878;23085,47450,0,0,2,0,2
61041,130,17233,22900,47450,0,0,1,0,1
61042,130,17234,22904;23318,47450,0,0,2,0,2
61043,130,17235,22923;23571,47450,0,1,1,0,2
61044,130,17236,22754;22947,47450,0,0,2,0,2
61045,130,17237,22963,47450,0,0,1,0,1
61046,130,17238,22982;23303,47450,0,0,2,0,2
61047,130,17239,22984;23456,47450,0,0,2,0,2
61048,130,17240,23018,47450,0,0,1,0,1
61049,130,17241,22599;22994,47450,0,0,2,0,2
61050,130,17242,22390;22996,47450,0,0,2,0,2
61051,130,17243,22720;23005;25310,47450,1,0,2,0,3
61052,130,17244,23021;23154;25126,47450,1,0,2,0,3
61053,130,17245,22358;23025,47450,0,0,2,0,2
61054,130,17246,23028;23417,47450,0,0,2,0,2
61055,130,17247,23033;23035,47450,0,0,2,0,2
61056,130,17248,23037;23185,47450,0,0,2,0,2
61057,130,17249,23040;23121,47450,0,0,2,0,2
61058,130,17250,23091,47450,0,0,1,0,1
61059,130,17251,23106;23479,47450,0,0,2,0,2
61060,130,17252,23119;23245,47450,0,0,2,0,2
61061,130,17253,23135;23435,47450,0,0,2,0,2
61062,130,17254,23182;23339,47450,0,0,2,0,2
61063,130,17255,23199;23338;25314,47450,1,0,2,0,3
61064,130,17256,23211;23273,47450,0,0,2,0,2
61065,130,17257,23212;23351,47450,0,0,2,0,2
61066,130,17258,22772;23223,47450,0,0,2,0,2
61067,130,17259,23225;23460,47450,0,0,2,0,2
61068,130,17260,22942;23259,47450,0,0,2,0,2
61069,130,17261,22874;23265,47450,0,0,2,0,2
61070,130,17262,23271;23340,47450,0,0,2,0,2
61071,130,17263,23080;23293,47450,0,0,2,0,2
61072,140,8182,16940;17336,15695,0,0,0,2,2
61073,140,8190,16550,15695,0,0,0,1,1
61074,140,8491,16641;21300;24525;25424,16790,0,1,2,1,4
61075,140,8521,17253;17306,17155,0,0,0,2,2
61076,140,8743,17384,17885,0,0,0,1,1
61077,140,9036,18771,18980,0,0,0,1,1
61078,140,9134,17226,19345,0,0,0,1,1
61079,140,9443,18344;18756,20440,0,0,0,2,2
61080,140,9565,14845,20805,0,0,0,1,1
61081,140,9576,19314,20805,0,0,0,1,1
61082,140,9577,17999,20805,0,0,0,1,1
61083,140,9661,14828,21170,0,0,0,1,1
61084,140,9663,17311;18338;18734;18938,21170,0,0,0,4,4
61085,140,9754,19108;19627;19671;19919,21535,0,0,3,1,4
61086,140,9758,18732;19030;22697,21535,0,0,1,2,3
61087,140,9785,15139,21535,0,0,0,1,1
61088,140,9863,15325,21900,0,0,0,1,1
61089,140,9870,19149,21900,0,0,0,1,1
61090,140,9876,18580,21900,0,0,0,1,1
61091,140,9955,14713,22265,0,0,0,1,1
61092,140,9968,17700;18202,22265,0,0,0,2,2
61093,140,9971,15031,22265,0,0,0,1,1
61094,140,9997,18449;18644,22265,0,0,0,2,2
61095,140,10083,15458,22630,0,0,0,1,1
61096,140,10088,15136,22630,0,0,0,1,1
61097,140,10107,15081,22630,0,0,0,1,1
61098,140,10109,19754;19910;24096,22630,0,0,3,0,3
61099,140,10206,14692,22995,0,0,0,1,1
61100,140,10215,16192,22995,0,0,0,1,1
61101,140,10218,15625,22995,0,0,0,1,1
61102,140,10219,15636,22995,0,0,0,1,1
61103,140,10256,15212,23360,0,0,0,1,1
61104,140,10267,15380,23360,0,0,0,1,1
61105,140,10270,14820,23360,0,0,0,1,1
61106,140,10271,14874,23360,0,0,0,1,1
61107,140,10366,14858,23725,0,0,0,1,1
61108,140,10368,15487,23725,0,0,0,1,1
61109,140,10373,14948,23725,0,0,0,1,1
61110,140,10379,15048,23725,0,0,0,1,1
61111,140,10399,15763,23725,0,0,0,1,1
61112,140,10411,15501,23725,0,0,0,1,1
61113,140,10415,16031,23725,0,0,0,1,1
61114,140,10417,15990,23725,0,0,0,1,1
61115,140,10493,15509,24090,0,0,0,1,1
61116,140,10497,19848;19892,24090,0,0,2,0,2
61117,140,10498,14982,24090,0,0,0,1,1
61118,140,10508,15207,24090,0,0,0,1,1
61119,140,10517,15604;16103,24090,0,0,0,2,2
61120,140,10518,15444,24090,0,0,0,1,1
61121,140,10520,15831,24090,0,0,0,1,1
61122,140,10522,15581,24090,0,0,0,1,1
61123,140,10530,15891,24090,0,0,0,1,1
61124,140,10534,15540,24090,0,0,0,1,1
61125,140,10604,15360,24455,0,0,0,1,1
61126,140,10606,15677,24455,0,0,0,1,1
61127,140,10608,16035,24455,0,0,0,1,1
61128,140,10617,15497,24455,0,0,0,1,1
61129,140,10625,15927,24455,0,0,0,1,1
61130,140,10633,15721,24455,0,0,0,1,1
61131,140,10636,16275,24455,0,0,0,1,1
61132,140,10642,15846,24455,0,0,0,1,1
61133,140,10695,15006,24820,0,0,0,1,1
61134,140,10701,16048,24820,0,0,0,1,1
61135,140,10704,15218,24820,0,0,0,1,1
61136,140,10726,15810,24820,0,0,0,1,1
61137,140,10727,15373,24820,0,0,0,1,1
61138,140,10739,16027,24820,0,0,0,1,1
61139,140,10744,16497,24820,0,0,0,1,1
61140,140,10747,15917,24820,0,0,0,1,1
61141,140,10750,15952,24820,0,0,0,1,1
61142,140,10751,16299,24820,0,0,0,1,1
61143,140,10754,15624,24820,0,0,0,1,1
61144,140,10804,14696,25185,0,0,0,1,1
61145,140,10810,15110,25185,0,0,0,1,1
61146,140,10813,15722,25185,0,0,0,1,1
61147,140,10814,15767,25185,0,0,0,1,1
61148,140,10822,16160,25185,0,0,0,1,1
61149,140,10845,20331;20509,25185,0,0,2,0,2
61150,140,10847,15944,25185,0,0,0,1,1
61151,140,10854,16054,25185,0,0,0,1,1
61152,140,10856,16059,25185,0,0,0,1,1
61153,140,10859,16116;16375,25185,0,0,0,2,2
61154,140,10862,16124,25185,0,0,0,1,1
61155,140,10864,16138,25185,0,0,0,1,1
61156,140,10865,16262,25185,0,0,0,1,1
61157,140,10867,16190,25185,0,0,0,1,1
61158,140,10924,15216,25550,0,0,0,1,1
61159,140,10925,15991;16284,25550,0,0,0,2,2
61160,140,10935,15611,25550,0,0,0,1,1
61161,140,10936,15648,25550,0,0,0,1,1
61162,140,10937,15311,25550,0,0,0,1,1
61163,140,10939,15897,25550,0,0,0,1,1
61164,140,10940,16147,25550,0,0,0,1,1
61165,140,10948,16132,25550,0,0,0,1,1
61166,140,10952,15929,25550,0,0,0,1,1
61167,140,10955,15821,25550,0,0,0,1,1
61168,140,10956,15978;16000,25550,0,0,0,2,2
61169,140,10958,15948;16417,25550,0,0,0,2,2
61170,140,10959,16060,25550,0,0,0,1,1
61171,140,10961,16395,25550,0,0,0,1,1
61172,140,10963,16131,25550,0,0,0,1,1
61173,140,10965,16201;16644,25550,0,0,0,2,2
61174,140,10966,16602,25550,0,0,0,1,1
61175,140,10968,16218,25550,0,0,0,1,1
61176,140,10973,16645,25550,0,0,0,1,1
61177,140,11037,14932,25915,0,0,0,1,1
61178,140,11042,15690,25915,0,0,0,1,1
61179,140,11044,16225,25915,0,0,0,1,1
61180,140,11054,15925,25915,0,0,0,1,1
61181,140,11056,16209,25915,0,0,0,1,1
61182,140,11057,16452;20686,25915,0,0,1,1,2
61183,140,11062,16411,25915,0,0,0,1,1
61184,140,11064,16107,25915,0,0,0,1,1
61185,140,11066,16418,25915,0,0,0,1,1
61186,140,11067,16118,25915,0,0,0,1,1
61187,140,11068,20293;24108,25915,0,0,2,0,2
61188,140,11069,16599,25915,0,0,0,1,1
61189,140,11072,16601,25915,0,0,0,1,1
61190,140,11075,16650,25915,0,0,0,1,1
61191,140,11076,16483;16861,25915,0,0,0,2,2
61192,140,11077,16282,25915,0,0,0,1,1
61193,140,11078,16177,25915,0,0,0,1,1
61194,140,11082,16586,25915,0,0,0,1,1
61195,140,11084,16787,25915,0,0,0,1,1
61196,140,11085,16381,25915,0,0,0,1,1
61197,140,11086,16778,25915,0,0,0,1,1
61198,140,11088,16353;16461,25915,0,0,0,2,2
61199,140,11089,16471,25915,0,0,0,1,1
61200,140,11158,19913;19965,26280,0,0,2,0,2
61201,140,11162,15943,26280,0,0,0,1,1
61202,140,11166,15890,26280,0,0,0,1,1
61203,140,11167,15397,26280,0,0,0,1,1
61204,140,11170,16039,26280,0,0,0,1,1
61205,140,11172,16187,26280,0,0,0,1,1
61206,140,11174,16753,26280,0,0,0,1,1
61207,140,11178,16439,26280,0,0,0,1,1
61208,140,11180,16030,26280,0,0,0,1,1
61209,140,11189,15918,26280,0,0,0,1,1
61210,140,11191,15932,26280,0,0,0,1,1
61211,140,11192,15939,26280,0,0,0,1,1
61212,140,11194,15814;15992,26280,0,0,0,2,2
61213,140,11199,16500,26280,0,0,0,1,1
61214,140,11200,16464,26280,0,0,0,1,1
61215,140,11201,16078,26280,0,0,0,1,1
61216,140,11204,16512,26280,0,0,0,1,1
61217,140,11206,16110,26280,0,0,0,1,1
61218,140,11207,16572,26280,0,0,0,1,1
61219,140,11209,16087,26280,0,0,0,1,1
61220,140,11210,16490,26280,0,0,0,1,1
61221,140,11211,16425,26280,0,0,0,1,1
61222,140,11215,16493,26280,0,0,0,1,1
61223,140,11217,16280,26280,0,0,0,1,1
61224,140,11220,16833;16835,26280,0,0,0,2,2
61225,140,11222,16856,26280,0,0,0,1,1
61226,140,11223,16671,26280,0,0,0,1,1
61227,140,11229,16399,26280,0,0,0,1,1
61228,140,11230,16416,26280,0,0,0,1,1
61229,140,11231,17000,26280,0,0,0,1,1
61230,140,11234,20258;20603;20647;24124;24238;24698;24811;25018,26280,0,3,5,0,8
61231,140,11236,16629,26280,0,0,0,1,1
61232,140,11237,16865,26280,0,0,0,1,1
61233,140,11290,15046,26645,0,0,0,1,1
61234,140,11291,15909,26645,0,0,0,1,1
61235,140,11295,20162;20236;24210,26645,0,0,3,0,3
61236,140,11301,15451,26645,0,0,0,1,1
61237,140,11304,15753,26645,0,0,0,1,1
61238,140,11309,15931,26645,0,0,0,1,1
61239,140,11314,16480,26645,0,0,0,1,1
61240,140,11317,16479,26645,0,0,0,1,1
61241,140,11318,15999,26645,0,0,0,1,1
61242,140,11319,16214,26645,0,0,0,1,1
61243,140,11323,15977;16603,26645,0,0,0,2,2
61244,140,11324,16958,26645,0,0,0,1,1
61245,140,11325,16250,26645,0,0,0,1,1
61246,140,11327,16532,26645,0,0,0,1,1
61247,140,11331,16633,26645,0,0,0,1,1
61248,140,11332,16164,26645,0,0,0,1,1
61249,140,11333,16398,26645,0,0,0,1,1
61250,140,11334,15732;16420,26645,0,0,0,2,2
61251,140,11337,16732,26645,0,0,0,1,1
61252,140,11338,16506,26645,0,0,0,1,1
61253,140,11339,16798,26645,0,0,0,1,1
61254,140,11340,16378;16529,26645,0,0,0,2,2
61255,140,11341,16560,26645,0,0,0,1,1
61256,140,11342,16561,26645,0,0,0,1,1
61257,140,11344,16576,26645,0,0,0,1,1
61258,140,11345,16008;16577,26645,0,0,0,2,2
61259,140,11347,16811,26645,0,0,0,1,1
61260,140,11348,16593,26645,0,0,0,1,1
61261,140,11349,16606,26645,0,0,0,1,1
61262,140,11350,16607,26645,0,0,0,1,1
61263,140,11352,16622;16966,26645,0,0,0,2,2
61264,140,11353,17046,26645,0,0,0,1,1
61265,140,11358,16703,26645,0,0,0,1,1
61266,140,11359,16413;16728,26645,0,0,0,2,2
61267,140,11410,15513,27010,0,0,0,1,1
61268,140,11425,16350,27010,0,0,0,1,1
61269,140,11426,16308,27010,0,0,0,1,1
61270,140,11427,15692,27010,0,0,0,1,1
61271,140,11428,15656,27010,0,0,0,1,1
61272,140,11434,15780,27010,0,0,0,1,1
61273,140,11442,16446,27010,0,0,0,1,1
61274,140,11443,16084,27010,0,0,0,1,1
61275,140,11445,16664,27010,0,0,0,1,1
61276,140,11448,16623;17037,27010,0,0,0,2,2
61277,140,11449,17065,27010,0,0,0,1,1
61278,140,11450,15800,27010,0,0,0,1,1
61279,140,11452,16307,27010,0,0,0,1,1
61280,140,11453,16759,27010,0,0,0,1,1
61281,140,11460,17204,27010,0,0,0,1,1
61282,140,11463,16260;16779,27010,0,0,0,2,2
61283,140,11465,16546,27010,0,0,0,1,1
61284,140,11466,16553,27010,0,0,0,1,1
61285,140,11467,16562,27010,0,0,0,1,1
61286,140,11468,16563;20433;24115,27010,0,0,2,1,3
61287,140,11473,16685,27010,0,0,0,1,1
61288,140,11474,17106,27010,0,0,0,1,1
61289,140,11477,16725;17068,27010,0,0,0,2,2
61290,140,11478,16980;17074,27010,0,0,0,2,2
61291,140,11481,16766,27010,0,0,0,1,1
61292,140,11482,16783,27010,0,0,0,1,1
61293,140,11483,16799;17015,27010,0,0,0,2,2
61294,140,11484,16305,27010,0,0,0,1,1
61295,140,11485,16520,27010,0,0,0,1,1
61296,140,11486,16850,27010,0,0,0,1,1
61297,140,11536,14950,27375,0,0,0,1,1
61298,140,11546,15955,27375,0,0,0,1,1
61299,140,11549,15817,27375,0,0,0,1,1
61300,140,11550,16249,27375,0,0,0,1,1
61301,140,11556,16179,27375,0,0,0,1,1
61302,140,11558,20273;23566,27375,0,0,2,0,2
61303,140,11564,16339,27375,0,0,0,1,1
61304,140,11566,16364,27375,0,0,0,1,1
61305,140,11567,16771,27375,0,0,0,1,1
61306,140,11572,16226,27375,0,0,0,1,1
61307,140,11573,16310,27375,0,0,0,1,1
61308,140,11574,16580,27375,0,0,0,1,1
61309,140,11575,16396,27375,0,0,0,1,1
61310,140,11576,16613,27375,0,0,0,1,1
61311,140,11578,16476,27375,0,0,0,1,1
61312,140,11579,16254;16661,27375,0,0,0,2,2
61313,140,11583,16565;20460;24011;25015,27375,0,1,2,1,4
61314,140,11584,16609,27375,0,0,0,1,1
61315,140,11587,17592,27375,0,0,0,1,1
61316,140,11589,17137,27375,0,0,0,1,1
61317,140,11590,17117,27375,0,0,0,1,1
61318,140,11595,16763;16927,27375,0,0,0,2,2
61319,140,11596,16768,27375,0,0,0,1,1
61320,140,11597,16845;17035,27375,0,0,0,2,2
61321,140,11598,16846,27375,0,0,0,1,1
61322,140,11600,17029;17101,27375,0,0,0,2,2
61323,140,11601,17328,27375,0,0,0,1,1
61324,140,11602,16545;16891,27375,0,0,0,2,2
61325,140,11603,16294,27375,0,0,0,1,1
61326,140,11604,16941,27375,0,0,0,1,1
61327,140,11605,16899,27375,0,0,0,1,1
61328,140,11606,16924;16928,27375,0,0,0,2,2
61329,140,11608,16945,27375,0,0,0,1,1
61330,140,11657,15620,27740,0,0,0,1,1
61331,140,11658,15751,27740,0,0,0,1,1
61332,140,11660,15805,27740,0,0,0,1,1
61333,140,11662,16837,27740,0,0,0,1,1
61334,140,11663,16579,27740,0,0,0,1,1
61335,140,11664,16801,27740,0,0,0,1,1
61336,140,11665,16075,27740,0,0,0,1,1
61337,140,11667,15870,27740,0,0,0,1,1
61338,140,11670,16859,27740,0,0,0,1,1
61339,140,11671,16720;17100,27740,0,0,0,2,2
61340,140,11673,16074,27740,0,0,0,1,1
61341,140,11675,16774,27740,0,0,0,1,1
61342,140,11677,16244,27740,0,0,0,1,1
61343,140,11678,16585,27740,0,0,0,1,1
61344,140,11679,16935,27740,0,0,0,1,1
61345,140,11683,21248,27740,0,0,1,0,1
61346,140,11684,16640;16840,27740,0,0,0,2,2
61347,140,11685,16642,27740,0,0,0,1,1
61348,140,11686,16675,27740,0,0,0,1,1
61349,140,11689,16820,27740,0,0,0,1,1
61350,140,11690,16178,27740,0,0,0,1,1
61351,140,11691,16869,27740,0,0,0,1,1
61352,140,11696,16733,27740,0,0,0,1,1
61353,140,11697,16918,27740,0,0,0,1,1
61354,140,11698,17047;17475,27740,0,0,0,2,2
61355,140,11699,16843,27740,0,0,0,1,1
61356,140,11700,17301,27740,0,0,0,1,1
61357,140,11701,16877;17397,27740,0,0,0,2,2
61358,140,11702,17277;17357,27740,0,0,0,2,2
61359,140,11703,17157,27740,0,0,0,1,1
61360,140,11704,16922,27740,0,0,0,1,1
61361,140,11707,16990;17322,27740,0,0,0,2,2
61362,140,11709,17005,27740,0,0,0,1,1
61363,140,11710,16923;17084,27740,0,0,0,2,2
61364,140,11711,17048,27740,0,0,0,1,1
61365,140,11712,16592;17040,27740,0,0,0,2,2
61366,140,11713,17044;17337,27740,0,0,0,2,2
61367,140,11714,16359;16897,27740,0,0,0,2,2
61368,140,11715,16597;17181,27740,0,0,0,2,2
61369,140,11716,16672,27740,0,0,0,1,1
61370,140,11717,17308,27740,0,0,0,1,1
61371,140,11748,14909,28105,0,0,0,1,1
61372,140,11756,15344,28105,0,0,0,1,1
61373,140,11763,16482,28105,0,0,0,1,1
61374,140,11767,15873,28105,0,0,0,1,1
61375,140,11772,16414,28105,0,0,0,1,1
61376,140,11775,16714,28105,0,0,0,1,1
61377,140,11778,16909,28105,0,0,0,1,1
61378,140,11779,16457,28105,0,0,0,1,1
61379,140,11780,16823,28105,0,0,0,1,1
61380,140,11784,15913,28105,0,0,0,1,1
61381,140,11785,17041,28105,0,0,0,1,1
61382,140,11789,16773;17140,28105,0,0,0,2,2
61383,140,11790,16313,28105,0,0,0,1,1
61384,140,11791,17098,28105,0,0,0,1,1
61385,140,11794,16508,28105,0,0,0,1,1
61386,140,11795,16791;17423,28105,0,0,0,2,2
61387,140,11797,16809,28105,0,0,0,1,1
61388,140,11798,16826,28105,0,0,0,1,1
61389,140,11799,16784;16831,28105,0,0,0,2,2
61390,140,11800,16921;16995,28105,0,0,0,2,2
61391,140,11801,17214;17298,28105,0,0,0,2,2
61392,140,11802,17420,28105,0,0,0,1,1
61393,140,11803,17314,28105,0,0,0,1,1
61394,140,11808,16969,28105,0,0,0,1,1
61395,140,11812,16796;17054,28105,0,0,0,2,2
61396,140,11814,17105;17536,28105,0,0,0,2,2
61397,140,11815,17497,28105,0,0,0,1,1
61398,140,11816,17162,28105,0,0,0,1,1
61399,140,11817,16985,28105,0,0,0,1,1
61400,140,11818,17405,28105,0,0,0,1,1
61401,140,11819,17027;17152,28105,0,0,0,2,2
61402,140,11820,17142;17269,28105,0,0,0,2,2
61403,140,11821,17347;17519,28105,0,0,0,2,2
61404,140,11822,17193,28105,0,0,0,1,1
61405,140,11825,17223,28105,0,0,0,1,1
61406,140,11873,14896,28470,0,0,0,1,1
61407,140,11896,16129,28470,0,0,0,1,1
61408,140,11904,16485,28470,0,0,0,1,1
61409,140,11906,16380;17272,28470,0,0,0,2,2
61410,140,11909,17082,28470,0,0,0,1,1
61411,140,11915,16730,28470,0,0,0,1,1
61412,140,11916,16587;16747,28470,0,0,0,2,2
61413,140,11918,17512,28470,0,0,0,1,1
61414,140,11920,16950,28470,0,0,0,1,1
61415,140,11923,17440;17441,28470,0,0,0,2,2
61416,140,11924,16989,28470,0,0,0,1,1
61417,140,11925,16911;17496,28470,0,0,0,2,2
61418,140,11926,17438;17499,28470,0,0,0,2,2
61419,140,11927,17191;17402,28470,0,0,0,2,2
61420,140,11928,16917;17036,28470,0,0,0,2,2
61421,140,11929,20771;21234;24167;24628,28470,0,1,3,0,4
61422,140,11930,16931;17097,28470,0,0,0,2,2
61423,140,11932,17422;17575,28470,0,0,0,2,2
61424,140,11933,16839;17148,28470,0,0,0,2,2
61425,140,11934,17156,28470,0,0,0,1,1
61426,140,11935,17189,28470,0,0,0,1,1
61427,140,11936,17845,28470,0,0,0,1,1
61428,140,11937,17014,28470,0,0,0,1,1
61429,140,11938,17200,28470,0,0,0,1,1
61430,140,11940,17147,28470,0,0,0,1,1
61431,140,11941,17231,28470,0,0,0,1,1
61432,140,11943,17244;17246,28470,0,0,0,2,2
61433,140,11946,17284;17673,28470,0,0,0,2,2
61434,140,11947,17509,28470,0,0,0,1,1
61435,140,11948,17312;17457,28470,0,0,0,2,2
61436,140,11949,17344;17492,28470,0,0,0,2,2
61437,140,11985,14688,28835,0,0,0,1,1
61438,140,11992,16170,28835,0,0,0,1,1
61439,140,12007,16387,28835,0,0,0,1,1
61440,140,12009,16558,28835,0,0,0,1,1
61441,140,12013,16983,28835,0,0,0,1,1
61442,140,12016,17174,28835,0,0,0,1,1
61443,140,12017,17218;17374,28835,0,0,0,2,2
61444,140,12019,16517;17059,28835,0,0,0,2,2
61445,140,12020,17595,28835,0,0,0,1,1
61446,140,12021,16847;16874,28835,0,0,0,2,2
61447,140,12023,17213,28835,0,0,0,1,1
61448,140,12025,17326,28835,0,0,0,1,1
61449,140,12028,17533,28835,0,0,0,1,1
61450,140,12029,17527,28835,0,0,0,1,1
61451,140,12032,17632,28835,0,0,0,1,1
61452,140,12033,17551,28835,0,0,0,1,1
61453,140,12034,17605,28835,0,0,0,1,1
61454,140,12035,17034;17531,28835,0,0,0,2,2
61455,140,12036,17131,28835,0,0,0,1,1
61456,140,12037,17395,28835,0,0,0,1,1
61457,140,12038,17066,28835,0,0,0,1,1
61458,140,12039,17295;17406,28835,0,0,0,2,2
61459,140,12040,17687,28835,0,0,0,1,1
61460,140,12041,17123,28835,0,0,0,1,1
61461,140,12042,17091;17143,28835,0,0,0,2,2
61462,140,12043,17144;17207,28835,0,0,0,2,2
61463,140,12044,16888,28835,0,0,0,1,1
61464,140,12046,17493,28835,0,0,0,1,1
61465,140,12047,17435,28835,0,0,0,1,1
61466,140,12048,17704;17956;21687;23848;24655,28835,0,1,2,2,5
61467,140,12049,17239,28835,0,0,0,1,1
61468,140,12051,16982,28835,0,0,0,1,1
61469,140,12053,16817;17288,28835,0,0,0,2,2
61470,140,12054,16477;17307,28835,0,0,0,2,2
61471,140,12055,17323;17580,28835,0,0,0,2,2
61472,140,12056,17331;17392,28835,0,0,0,2,2
61473,140,12059,17206;17372,28835,0,0,0,2,2
61474,140,12061,17788,28835,0,0,0,1,1
61475,140,12062,17671,28835,0,0,0,1,1
61476,140,12063,17270;17588,28835,0,0,0,2,2
61477,140,12111,16204,29200,0,0,0,1,1
61478,140,12117,16342,29200,0,0,0,1,1
61479,140,12118,16862,29200,0,0,0,1,1
61480,140,12119,16462,29200,0,0,0,1,1
61481,140,12120,16165,29200,0,0,0,1,1
61482,140,12123,16298,29200,0,0,0,1,1
61483,140,12124,17107,29200,0,0,0,1,1
61484,140,12126,16518,29200,0,0,0,1,1
61485,140,12127,16528;16977,29200,0,0,0,2,2
61486,140,12129,17133,29200,0,0,0,1,1
61487,140,12131,16621,29200,0,0,0,1,1
61488,140,12132,16813;17447,29200,0,0,0,2,2
61489,140,12134,16658;16719,29200,0,0,0,2,2
61490,140,12135,16933;17010,29200,0,0,0,2,2
61491,140,12136,16828;17296,29200,0,0,0,2,2
61492,140,12137,16834,29200,0,0,0,1,1
61493,140,12142,17019;17165,29200,0,0,0,2,2
61494,140,12143,17042,29200,0,0,0,1,1
61495,140,12144,17706,29200,0,0,0,1,1
61496,140,12145,17075;17230,29200,0,0,0,2,2
61497,140,12149,17327,29200,0,0,0,1,1
61498,140,12150,17485,29200,0,0,0,1,1
61499,140,12151,17672,29200,0,0,0,1,1
61500,140,12152,17294,29200,0,0,0,1,1
61501,140,12153,16871,29200,0,0,0,1,1
61502,140,12154,20475,29200,0,0,1,0,1
61503,140,12155,17280;17875,29200,0,0,0,2,2
61504,140,12156,17300,29200,0,0,0,1,1
61505,140,12157,17184;17316,29200,0,0,0,2,2
61506,140,12158,17171;17360,29200,0,0,0,2,2
61507,140,12160,17602;17616,29200,0,0,0,2,2
61508,140,12162,17710;17896,29200,0,0,0,2,2
61509,140,12164,17340;17505,29200,0,0,0,2,2
61510,140,12165,17828,29200,0,0,0,1,1
61511,140,12167,17761;21875,29200,0,0,1,1,2
61512,140,12221,15983,29565,0,0,0,1,1
61513,140,12227,16134,29565,0,0,0,1,1
61514,140,12228,20501,29565,0,0,1,0,1
61515,140,12229,16309,29565,0,0,0,1,1
61516,140,12231,17050,29565,0,0,0,1,1
61517,140,12234,16415,29565,0,0,0,1,1
61518,140,12236,16496,29565,0,0,0,1,1
61519,140,12239,16906,29565,0,0,0,1,1
61520,140,12242,17329,29565,0,0,0,1,1
61521,140,12243,16767;17469;21663;23847;25827;25917,29565,2,0,2,2,6
61522,140,12244,16781,29565,0,0,0,1,1
61523,140,12247,17116,29565,0,0,0,1,1
61524,140,12248,16916,29565,0,0,0,1,1
61525,140,12249,17154,29565,0,0,0,1,1
61526,140,12251,17522,29565,0,0,0,1,1
61527,140,12253,17146,29565,0,0,0,1,1
61528,140,12254,17045;17464,29565,0,0,0,2,2
61529,140,12256,16946;17099,29565,0,0,0,2,2
61530,140,12257,17380,29565,0,0,0,1,1
61531,140,12258,16680;17176,29565,0,0,0,2,2
61532,140,12259,17017;17663,29565,0,0,0,2,2
61533,140,12260,17134;17404,29565,0,0,0,2,2
61534,140,12263,17109;17245,29565,0,0,0,2,2
61535,140,12264,17077,29565,0,0,0,1,1
61536,140,12265,17271;17662,29565,0,0,0,2,2
61537,140,12266,17285,29565,0,0,0,1,1
61538,140,12267,17364,29565,0,0,0,1,1
61539,140,12268,17389,29565,0,0,0,1,1
61540,140,12269,17400;17923,29565,0,0,0,2,2
61541,140,12270,18047,29565,0,0,0,1,1
61542,140,12271,21772;21815,29565,0,0,2,0,2
61543,140,12272,17431;17491,29565,0,0,0,2,2
61544,140,12273,17566;17742,29565,0,0,0,2,2
61545,140,12275,17460,29565,0,0,0,1,1
61546,140,12276,17507,29565,0,0,0,1,1
61547,140,12277,17003;17463,29565,0,0,0,2,2
61548,140,12278,17807;20325,29565,0,0,1,1,2
61549,140,12280,17768,29565,0,0,0,1,1
61550,140,12281,17658;18034,29565,0,0,0,2,2
61551,140,12282,17182;17523,29565,0,0,0,2,2
61552,140,12285,17591;17805,29565,0,0,0,2,2
61553,140,12287,17604,29565,0,0,0,1,1
61554,140,12288,17069;17617,29565,0,0,0,2,2
61555,140,12289,17621,29565,0,0,0,1,1
61556,140,12290,17572,29565,0,0,0,1,1
61557,140,12292,17656,29565,0,0,0,1,1
61558,140,12293,17684,29565,0,0,0,1,1
61559,140,12347,16384,29930,0,0,0,1,1
61560,140,12348,16816,29930,0,0,0,1,1
61561,140,12350,16743,29930,0,0,0,1,1
61562,140,12357,16848,29930,0,0,0,1,1
61563,140,12358,17024,29930,0,0,0,1,1
61564,140,12359,17439;17445,29930,0,0,0,2,2
61565,140,12360,16410;17051,29930,0,0,0,2,2
61566,140,12361,17002;17126,29930,0,0,0,2,2
61567,140,12362,16445;17135,29930,0,0,0,2,2
61568,140,12363,18088,29930,0,0,0,1,1
61569,140,12365,16776;17179,29930,0,0,0,2,2
61570,140,12366,17185,29930,0,0,0,1,1
61571,140,12367,17315,29930,0,0,0,1,1
61572,140,12368,17278,29930,0,0,0,1,1
61573,140,12369,17437,29930,0,0,0,1,1
61574,140,12371,17418;17972,29930,0,0,0,2,2
61575,140,12372,17007,29930,0,0,0,1,1
61576,140,12374,17675,29930,0,0,0,1,1
61577,140,12375,17488;17943;21324;24441,29930,0,0,2,2,4
61578,140,12376,17540,29930,0,0,0,1,1
61579,140,12377,17335,29930,0,0,0,1,1
61580,140,12378,17451;17719,29930,0,0,0,2,2
61581,140,12380,17637;17756,29930,0,0,0,2,2
61582,140,12381,17661;18067,29930,0,0,0,2,2
61583,140,12382,16881;17669,29930,0,0,0,2,2
61584,140,12383,17677,29930,0,0,0,1,1
61585,140,12384,17723,29930,0,0,0,1,1
61586,140,12385,17456;20877,29930,0,0,1,1,2
61587,140,12387,17994;18512,29930,0,0,0,2,2
61588,140,12388,17483;17796,29930,0,0,0,2,2
61589,140,12390,17382;17801,29930,0,0,0,2,2
61590,140,12436,16354,30295,0,0,0,1,1
61591,140,12440,16973,30295,0,0,0,1,1
61592,140,12443,16325;16746,30295,0,0,0,2,2
61593,140,12444,16430,30295,0,0,0,1,1
61594,140,12445,16516;16867,30295,0,0,0,2,2
61595,140,12447,16513;16655,30295,0,0,0,2,2
61596,140,12449,17175,30295,0,0,0,1,1
61597,140,12450,16619,30295,0,0,0,1,1
61598,140,12453,16789,30295,0,0,0,1,1
61599,140,12455,16677;16955,30295,0,0,0,2,2
61600,140,12457,16936;17482,30295,0,0,0,2,2
61601,140,12458,17219,30295,0,0,0,1,1
61602,140,12460,16998;17211,30295,0,0,0,2,2
61603,140,12461,17538,30295,0,0,0,1,1
61604,140,12462,16910,30295,0,0,0,1,1
61605,140,12463,17197;17394,30295,0,0,0,2,2
61606,140,12465,18203,30295,0,0,0,1,1
61607,140,12467,17289;17547;21925,30295,0,0,1,2,3
61608,140,12468,16954;17302,30295,0,0,0,2,2
61609,140,12471,17346,30295,0,0,0,1,1
61610,140,12473,17765,30295,0,0,0,1,1
61611,140,12474,17141;17371,30295,0,0,0,2,2
61612,140,12475,17378,30295,0,0,0,1,1
61613,140,12476,17411,30295,0,0,0,1,1
61614,140,12477,17546,30295,0,0,0,1,1
61615,140,12478,17502;17824,30295,0,0,0,2,2
61616,140,12479,17349;17514,30295,0,0,0,2,2
61617,140,12480,17377;17739,30295,0,0,0,2,2
61618,140,12481,17537;17653,30295,0,0,0,2,2
61619,140,12482,17574;17623,30295,0,0,0,2,2
61620,140,12483,17888;18021,30295,0,0,0,2,2
61621,140,12484,17585;17703,30295,0,0,0,2,2
61622,140,12485,18103;18221,30295,0,0,0,2,2
61623,140,12486,17606;18262,30295,0,0,0,2,2
61624,140,12487,17242;17608,30295,0,0,0,2,2
61625,140,12489,17685;17819,30295,0,0,0,2,2
61626,140,12490,18160,30295,0,0,0,1,1
61627,140,12491,17726;17867,30295,0,0,0,2,2
61628,140,12492,18235,30295,0,0,0,1,1
61629,140,12493,17750,30295,0,0,0,1,1
61630,140,12494,17396,30295,0,0,0,1,1
61631,140,12495,17813,30295,0,0,0,1,1
61632,140,12496,16872,30295,0,0,0,1,1
61633,140,12497,17646;17834,30295,0,0,0,2,2
61634,140,12500,17795;17902,30295,0,0,0,2,2
61635,140,12501,17526;17857,30295,0,0,0,2,2
61636,140,12502,17866;17975,30295,0,0,0,2,2
61637,140,12503,17645,30295,0,0,0,1,1
61638,140,12504,17205;17880,30295,0,0,0,2,2
61639,140,12505,18135,30295,0,0,0,1,1
61640,140,12506,17561,30295,0,0,0,1,1
61641,140,12507,18197,30295,0,0,0,1,1
61642,140,12538,14805,30660,0,0,0,1,1
61643,140,12545,16120,30660,0,0,0,1,1
61644,140,12566,16405;16598,30660,0,0,0,2,2
61645,140,12569,16487,30660,0,0,0,1,1
61646,140,12575,17720,30660,0,0,0,1,1
61647,140,12576,16978,30660,0,0,0,1,1
61648,140,12577,17110,30660,0,0,0,1,1
61649,140,12578,17121;17132,30660,0,0,0,2,2
61650,140,12579,17186,30660,0,0,0,1,1
61651,140,12580,17268,30660,0,0,0,1,1
61652,140,12581,16844;17305,30660,0,0,0,2,2
61653,140,12582,16762;17317,30660,0,0,0,2,2
61654,140,12583,17318,30660,0,0,0,1,1
61655,140,12584,16976;17455,30660,0,0,0,2,2
61656,140,12585,17762;17887,30660,0,0,0,2,2
61657,140,12586,17630,30660,0,0,0,1,1
61658,140,12587,17130;17903,30660,0,0,0,2,2
61659,140,12589,17638;18072,30660,0,0,0,2,2
61660,140,12593,17568,30660,0,0,0,1,1
61661,140,12595,17250,30660,0,0,0,1,1
61662,140,12596,17276;17882,30660,0,0,0,2,2
61663,140,12597,17861,30660,0,0,0,1,1
61664,140,12599,18122,30660,0,0,0,1,1
61665,140,12601,17711,30660,0,0,0,1,1
61666,140,12603,18164,30660,0,0,0,1,1
61667,140,12604,17735,30660,0,0,0,1,1
61668,140,12605,18354,30660,0,0,0,1,1
61669,140,12607,17783,30660,0,0,0,1,1
61670,140,12608,17151;17609,30660,0,0,0,2,2
61671,140,12610,17862;18126,30660,0,0,0,2,2
61672,140,12611,17494;17782,30660,0,0,0,2,2
61673,140,12612,17899;17951,30660,0,0,0,2,2
61674,140,12614,18232;18371,30660,0,0,0,2,2
61675,140,12615,17926,30660,0,0,0,1,1
61676,140,12618,17598;17957,30660,0,0,0,2,2
61677,140,12619,17789;17979,30660,0,0,0,2,2
61678,140,12620,17850,30660,0,0,0,1,1
61679,140,12621,18131;18349,30660,0,0,0,2,2
61680,140,12622,17837;18007;21205;24731;25044,30660,0,2,1,2,5
61681,140,12623,18230,30660,0,0,0,1,1
61682,140,12624,17872;18024,30660,0,0,0,2,2
61683,140,12625,17515;17870,30660,0,0,0,2,2
61684,140,12626,18340,30660,0,0,0,1,1
61685,140,12627,18046,30660,0,0,0,1,1
61686,140,12667,16466,31025,0,0,0,1,1
61687,140,12673,17102,31025,0,0,0,1,1
61688,140,12677,16718,31025,0,0,0,1,1
61689,140,12678,16525;16758,31025,0,0,0,2,2
61690,140,12682,17255,31025,0,0,0,1,1
61691,140,12689,17282;17738,31025,0,0,0,2,2
61692,140,12690,17192;17299,31025,0,0,0,2,2
61693,140,12692,17383,31025,0,0,0,1,1
61694,140,12693,17370,31025,0,0,0,1,1
61695,140,12694,17033;17490,31025,0,0,0,2,2
61696,140,12697,18190;18200,31025,0,0,0,2,2
61697,140,12699,18109,31025,0,0,0,1,1
61698,140,12700,17503;17674,31025,0,0,0,2,2
61699,140,12703,17534;17731,31025,0,0,0,2,2
61700,140,12704,17252,31025,0,0,0,1,1
61701,140,12705,17942;18005;21228;23724;25915,31025,1,0,2,2,5
61702,140,12706,17769,31025,0,0,0,1,1
61703,140,12708,17873;17986,31025,0,0,0,2,2
61704,140,12709,17558;17889,31025,0,0,0,2,2
61705,140,12710,18133,31025,0,0,0,1,1
61706,140,12711,17932,31025,0,0,0,1,1
61707,140,12712,17976,31025,0,0,0,1,1
61708,140,12713,17736,31025,0,0,0,1,1
61709,140,12714,18274,31025,0,0,0,1,1
61710,140,12715,17744,31025,0,0,0,1,1
61711,140,12716,18022,31025,0,0,0,1,1
61712,140,12717,17869;18032,31025,0,0,0,2,2
61713,140,12718,18050;18281,31025,0,0,0,2,2
61714,140,12719,18053,31025,0,0,0,1,1
61715,140,12720,18075,31025,0,0,0,1,1
61716,140,12721,18163,31025,0,0,0,1,1
61717,140,12723,18185;18279,31025,0,0,0,2,2
61718,140,12724,18225,31025,0,0,0,1,1
61719,140,12725,17935;18134,31025,0,0,0,2,2
61720,140,12726,18096;18147,31025,0,0,0,2,2
61721,140,12767,16061;16463,31390,0,0,0,2,2
61722,140,12774,16731;16944,31390,0,0,0,2,2
61723,140,12777,16727,31390,0,0,0,1,1
61724,140,12781,17345,31390,0,0,0,1,1
61725,140,12785,16868,31390,0,0,0,1,1
61726,140,12790,17158,31390,0,0,0,1,1
61727,140,12791,17115,31390,0,0,0,1,1
61728,140,12795,17555,31390,0,0,0,1,1
61729,140,12796,17094;17434,31390,0,0,0,2,2
61730,140,12798,17729,31390,0,0,0,1,1
61731,140,12799,17238,31390,0,0,0,1,1
61732,140,12801,17313,31390,0,0,0,1,1
61733,140,12802,17495,31390,0,0,0,1,1
61734,140,12804,17351;17353,31390,0,0,0,2,2
61735,140,12808,17513;17865,31390,0,0,0,2,2
61736,140,12809,17155;17172,31390,0,0,0,2,2
61737,140,12810,17194;17528,31390,0,0,0,2,2
61738,140,12812,18277,31390,0,0,0,1,1
61739,140,12813,18089;18427,31390,0,0,0,2,2
61740,140,12814,17553,31390,0,0,0,1,1
61741,140,12815,17468;17714,31390,0,0,0,2,2
61742,140,12816,17715;17917,31390,0,0,0,2,2
61743,140,12817,17764;18114,31390,0,0,0,2,2
61744,140,12818,17787;18259,31390,0,0,0,2,2
61745,140,12819,17874;18006,31390,0,0,0,2,2
61746,140,12821,17854,31390,0,0,0,1,1
61747,140,12822,18405;18471,31390,0,0,0,2,2
61748,140,12823,17628;17920,31390,0,0,0,2,2
61749,140,12824,17937,31390,0,0,0,1,1
61750,140,12825,17871,31390,0,0,0,1,1
61751,140,12826,18398,31390,0,0,0,1,1
61752,140,12827,17618;18267,31390,0,0,0,2,2
61753,140,12828,18348;18483,31390,0,0,0,2,2
61754,140,12829,17830;18004,31390,0,0,0,2,2
61755,140,12832,18179,31390,0,0,0,1,1
61756,140,12833,18090;18178,31390,0,0,0,2,2
61757,140,12834,17949;18401;21972,31390,0,0,1,2,3
61758,140,12836,18925,31390,0,0,0,1,1
61759,140,12837,18725;18785,31390,0,0,0,2,2
61760,140,12839,17984;18238,31390,0,0,0,2,2
61761,140,12863,15813,31755,0,0,0,1,1
61762,140,12879,17419,31755,0,0,0,1,1
61763,140,12880,16595,31755,0,0,0,1,1
61764,140,12881,16706;17076,31755,0,0,0,2,2
61765,140,12883,16723,31755,0,0,0,1,1
61766,140,12884,17665,31755,0,0,0,1,1
61767,140,12887,17465,31755,0,0,0,1,1
61768,140,12891,17342,31755,0,0,0,1,1
61769,140,12892,17391,31755,0,0,0,1,1
61770,140,12894,17472;18328,31755,0,0,0,2,2
61771,140,12895,17273,31755,0,0,0,1,1
61772,140,12896,17350;17611,31755,0,0,0,2,2
61773,140,12898,17641,31755,0,0,0,1,1
61774,140,12900,17695,31755,0,0,0,1,1
61775,140,12901,17128;17652,31755,0,0,0,2,2
61776,140,12902,17478;17780,31755,0,0,0,2,2
61777,140,12904,17825,31755,0,0,0,1,1
61778,140,12905,18091,31755,0,0,0,1,1
61779,140,12906,17892,31755,0,0,0,1,1
61780,140,12907,18214;18437,31755,0,0,0,2,2
61781,140,12908,17734;18161,31755,0,0,0,2,2
61782,140,12909,17567;18081,31755,0,0,0,2,2
61783,140,12910,18690;18772,31755,0,0,0,2,2
61784,140,12911,18066;18626,31755,0,0,0,2,2
61785,140,12912,17995,31755,0,0,0,1,1
61786,140,12913,17358;18001,31755,0,0,0,2,2
61787,140,12914,18014;18241,31755,0,0,0,2,2
61788,140,12915,18044;18187,31755,0,0,0,2,2
61789,140,12916,17954;18507,31755,0,0,0,2,2
61790,140,12917,18171;18705,31755,0,0,0,2,2
61791,140,12918,18085,31755,0,0,0,1,1
61792,140,12920,18289,31755,0,0,0,1,1
61793,140,12921,18389,31755,0,0,0,1,1
61794,140,12922,18227;18639,31755,0,0,0,2,2
61795,140,12923,17977;18079,31755,0,0,0,2,2
61796,140,12924,18609,31755,0,0,0,1,1
61797,140,12925,18415;18495,31755,0,0,0,2,2
61798,140,12927,18107;18457,31755,0,0,0,2,2
61799,140,12928,17692,31755,0,0,0,1,1
61800,140,12929,17757;18157,31755,0,0,0,2,2
61801,140,12930,18311,31755,0,0,0,1,1
61802,140,12931,18025;18247,31755,0,0,0,2,2
61803,140,12932,18284;18366,31755,0,0,0,2,2
61804,140,12933,18041,31755,0,0,0,1,1
61805,140,12934,18396;18770,31755,0,0,0,2,2
61806,140,12935,18617;18784,31755,0,0,0,2,2
61807,140,12937,17939;18346,31755,0,0,0,2,2
61808,140,12938,18347;18381,31755,0,0,0,2,2
61809,140,12961,14915,32120,0,0,0,1,1
61810,140,12981,16473,32120,0,0,0,1,1
61811,140,12982,16530,32120,0,0,0,1,1
61812,140,12987,16842,32120,0,0,0,1,1
61813,140,12989,17386,32120,0,0,0,1,1
61814,140,12993,16960,32120,0,0,0,1,1
61815,140,12994,17518,32120,0,0,0,1,1
61816,140,12995,17355;17936,32120,0,0,0,2,2
61817,140,12998,17689,32120,0,0,0,1,1
61818,140,12999,17678;17835,32120,0,0,0,2,2
61819,140,13000,17666,32120,0,0,0,1,1
61820,140,13002,17967,32120,0,0,0,1,1
61821,140,13003,17749,32120,0,0,0,1,1
61822,140,13004,17709;17758,32120,0,0,0,2,2
61823,140,13005,17797;18063,32120,0,0,0,2,2
61824,140,13007,17856,32120,0,0,0,1,1
61825,140,13008,17836;17894,32120,0,0,0,2,2
61826,140,13009,18146,32120,0,0,0,1,1
61827,140,13010,17601;17930,32120,0,0,0,2,2
61828,140,13011,18039;18397,32120,0,0,0,2,2
61829,140,13012,18486;18584;22391;25198;25396,32120,0,2,1,2,5
61830,140,13013,17712;17983,32120,0,0,0,2,2
61831,140,13014,18048,32120,0,0,0,1,1
61832,140,13015,18104;18561,32120,0,0,0,2,2
61833,140,13016,18110;18142,32120,0,0,0,2,2
61834,140,13017,18229;18248,32120,0,0,0,2,2
61835,140,13018,18137;18670,32120,0,0,0,2,2
61836,140,13019,18168,32120,0,0,0,1,1
61837,140,13022,18212;18499,32120,0,0,0,2,2
61838,140,13023,18735,32120,0,0,0,1,1
61839,140,13024,18587,32120,0,0,0,1,1
61840,140,13025,17891;18282;22657;25781,32120,0,1,1,2,4
61841,140,13026,18286;18321,32120,0,0,0,2,2
61842,140,13028,18378,32120,0,0,0,1,1
61843,140,13029,17963;18408,32120,0,0,0,2,2
61844,140,13030,18419;18729,32120,0,0,0,2,2
61845,140,13033,18452;18550,32120,0,0,0,2,2
61846,140,13034,18494,32120,0,0,0,1,1
61847,140,13035,18461,32120,0,0,0,1,1
61848,140,13036,17947;21762,32120,0,0,1,1,2
61849,140,13039,17852,32120,0,0,0,1,1
61850,140,13040,18237,32120,0,0,0,1,1
61851,140,13041,18515,32120,0,0,0,1,1
61852,140,13042,18517;18663,32120,0,0,0,2,2
61853,140,13086,17501,32485,0,0,0,1,1
61854,140,13088,17425,32485,0,0,0,1,1
61855,140,13090,17657,32485,0,0,0,1,1
61856,140,13091,17681,32485,0,0,0,1,1
61857,140,13092,17421,32485,0,0,0,1,1
61858,140,13093,17416;17471,32485,0,0,0,2,2
61859,140,13098,17593,32485,0,0,0,1,1
61860,140,13099,17265,32485,0,0,0,1,1
61861,140,13100,17934,32485,0,0,0,1,1
61862,140,13101,18506,32485,0,0,0,1,1
61863,140,13102,17682;18254,32485,0,0,0,2,2
61864,140,13104,17906;18060;22510,32485,0,0,1,2,3
61865,140,13106,17839;18027,32485,0,0,0,2,2
61866,140,13108,17938;18209,32485,0,0,0,2,2
61867,140,13109,17549;17958;22175,32485,0,0,1,2,3
61868,140,13110,17816,32485,0,0,0,1,1
61869,140,13111,17792;18023,32485,0,0,0,2,2
61870,140,13113,18033,32485,0,0,0,1,1
61871,140,13114,18049;18677,32485,0,0,0,2,2
61872,140,13115,18054,32485,0,0,0,1,1
61873,140,13116,18155;20885,32485,0,0,1,1,2
61874,140,13117,18153;18651,32485,0,0,0,2,2
61875,140,13118,18156;18196,32485,0,0,0,2,2
61876,140,13119,18076;18180;21540,32485,0,0,1,2,3
61877,140,13120,17941;18208,32485,0,0,0,2,2
61878,140,13121,18008;18222,32485,0,0,0,2,2
61879,140,13122,17827;18251,32485,0,0,0,2,2
61880,140,13123,18519;18749,32485,0,0,0,2,2
61881,140,13124,18731;19000,32485,0,0,0,2,2
61882,140,13125,18637,32485,0,0,0,1,1
61883,140,13127,17916;18319,32485,0,0,0,2,2
61884,140,13128,18331;18548,32485,0,0,0,2,2
61885,140,13129,17785;17877,32485,0,0,0,2,2
61886,140,13131,18330;18429;22658,32485,0,0,1,2,3
61887,140,13132,18472,32485,0,0,0,1,1
61888,140,13133,18479,32485,0,0,0,1,1
61889,140,13134,18374;18496,32485,0,0,0,2,2
61890,140,13135,18502,32485,0,0,0,1,1
61891,140,13136,18514,32485,0,0,0,1,1
61892,140,13137,17968;18516,32485,0,0,0,2,2
61893,140,13140,18575,32485,0,0,0,1,1
61894,140,13141,18170;18783,32485,0,0,0,2,2
61895,140,13142,18598;18738,32485,0,0,0,2,2
61896,140,13143,18612;18698,32485,0,0,0,2,2
61897,140,13144,18867;19019,32485,0,0,0,2,2
61898,140,13183,16326,32850,0,0,0,1,1
61899,140,13186,16503,32850,0,0,0,1,1
61900,140,13195,17407,32850,0,0,0,1,1
61901,140,13200,17659;17748,32850,0,0,0,2,2
61902,140,13201,17988,32850,0,0,0,1,1
61903,140,13202,17755,32850,0,0,0,1,1
61904,140,13203,17721,32850,0,0,0,1,1
61905,140,13204,17925,32850,0,0,0,1,1
61906,140,13205,17763;17802,32850,0,0,0,2,2
61907,140,13206,17565,32850,0,0,0,1,1
61908,140,13207,17810,32850,0,0,0,1,1
61909,140,13208,17991,32850,0,0,0,1,1
61910,140,13209,17691;17826;21413,32850,0,0,1,2,3
61911,140,13210,18562,32850,0,0,0,1,1
61912,140,13212,18565,32850,0,0,0,1,1
61913,140,13213,17753;17927,32850,0,0,0,2,2
61914,140,13214,17683;17929,32850,0,0,0,2,2
61915,140,13216,18313;18820,32850,0,0,0,2,2
61916,140,13217,18353,32850,0,0,0,1,1
61917,140,13218,18106;18655,32850,0,0,0,2,2
61918,140,13219,18116;22513,32850,0,0,1,1,2
61919,140,13220,18123;18620;22672,32850,0,0,1,2,3
61920,140,13222,18186;18323,32850,0,0,0,2,2
61921,140,13223,18017;18206,32850,0,0,0,2,2
61922,140,13224,18265,32850,0,0,0,1,1
61923,140,13225,18278,32850,0,0,0,1,1
61924,140,13226,18293,32850,0,0,0,1,1
61925,140,13227,18317;18883,32850,0,0,0,2,2
61926,140,13228,18334,32850,0,0,0,1,1
61927,140,13229,18357,32850,0,0,0,1,1
61928,140,13230,18361,32850,0,0,0,1,1
61929,140,13231,18600;21294,32850,0,0,1,1,2
61930,140,13232,18244;18417,32850,0,0,0,2,2
61931,140,13233,18094;18447,32850,0,0,0,2,2
61932,140,13234,18450,32850,0,0,0,1,1
61933,140,13235,18435;18454,32850,0,0,0,2,2
61934,140,13236,18469;18864;23626,32850,0,0,1,2,3
61935,140,13237,18866,32850,0,0,0,1,1
61936,140,13238,18569;18597;23004,32850,0,0,1,2,3
61937,140,13239,18958;22431,32850,0,0,1,1,2
61938,140,13240,18948;23738,32850,0,0,1,1,2
61939,140,13241,18301;18786,32850,0,0,0,2,2
61940,140,13243,18283;18778,32850,0,0,0,2,2
61941,140,13244,19065;19186,32850,0,0,0,2,2
61942,140,13245,18667;18971,32850,0,0,0,2,2
61943,140,13247,19091;22136,32850,0,0,1,1,2
61944,140,13248,19158;19162,32850,0,0,0,2,2
61945,140,13249,18716;18861,32850,0,0,0,2,2
61946,140,13250,18920,32850,0,0,0,1,1
61947,140,13252,19059,32850,0,0,0,1,1
61948,140,13254,18465;18763,32850,0,0,0,2,2
61949,140,13255,18490;18765,32850,0,0,0,2,2
61950,140,13280,15175,33215,0,0,0,1,1
61951,140,13296,17058,33215,0,0,0,1,1
61952,140,13303,17818,33215,0,0,0,1,1
61953,140,13304,17582,33215,0,0,0,1,1
61954,140,13306,17707;17732,33215,0,0,0,2,2
61955,140,13307,17820;18148,33215,0,0,0,2,2
61956,140,13308,18141;18392,33215,0,0,0,2,2
61957,140,13309,18128;22887,33215,0,0,1,1,2
61958,140,13310,17962;18019;23423,33215,0,0,1,2,3
61959,140,13313,17552;17948,33215,0,0,0,2,2
61960,140,13314,17980,33215,0,0,0,1,1
61961,140,13315,18234;18297,33215,0,0,0,2,2
61962,140,13318,17597;18020,33215,0,0,0,2,2
61963,140,13320,18038;18573,33215,0,0,0,2,2
61964,140,13321,18058,33215,0,0,0,1,1
61965,140,13322,18064;18510,33215,0,0,0,2,2
61966,140,13324,18242,33215,0,0,0,1,1
61967,140,13325,17859,33215,0,0,0,1,1
61968,140,13326,18528;18649,33215,0,0,0,2,2
61969,140,13328,18000;18210,33215,0,0,0,2,2
61970,140,13329,17945,33215,0,0,0,1,1
61971,140,13330,18183;18231,33215,0,0,0,2,2
61972,140,13331,17634;18252,33215,0,0,0,2,2
61973,140,13333,18700,33215,0,0,0,1,1
61974,140,13334,18539,33215,0,0,0,1,1
61975,140,13335,18296,33215,0,0,0,1,1
61976,140,13336,18300;18858,33215,0,0,0,2,2
61977,140,13337,18901;19055,33215,0,0,0,2,2
61978,140,13339,18352;18607,33215,0,0,0,2,2
61979,140,13340,18174,33215,0,0,0,1,1
61980,140,13341,18195;18383,33215,0,0,0,2,2
61981,140,13342,18272;18619,33215,0,0,0,2,2
61982,140,13343,18897;23510;26117,33215,1,0,1,1,3
61983,140,13344,18074;18413,33215,0,0,0,2,2
61984,140,13345,18430;18501,33215,0,0,0,2,2
61985,140,13346,18216;18433;22388,33215,0,0,1,2,3
61986,140,13347,18475;19027,33215,0,0,0,2,2
61987,140,13348,18489,33215,0,0,0,1,1
61988,140,13349,18387;18513,33215,0,0,0,2,2
61989,140,13350,19051;19175,33215,0,0,0,2,2
61990,140,13351,19083;19234,33215,0,0,0,2,2
61991,140,13352,18638,33215,0,0,0,1,1
61992,140,13353,18339;18669,33215,0,0,0,2,2
61993,140,13354,18678,33215,0,0,0,1,1
61994,140,13355,19147;19530,33215,0,0,1,1,2
61995,140,13356,19040,33215,0,0,0,1,1
61996,140,13357,18704,33215,0,0,0,1,1
61997,140,13358,18488;18741;22408,33215,0,0,1,2,3
61998,140,13359,18747,33215,0,0,0,1,1
61999,140,13360,19183;21435,33215,0,0,1,1,2
62000,140,13361,19101,33215,0,0,0,1,1
62001,140,13362,18779,33215,0,0,0,1,1
62002,140,13363,18602;22531,33215,0,0,1,1,2
62003,140,13364,18728;18787,33215,0,0,0,2,2
62004,140,13365,19121,33215,0,0,0,1,1
62005,140,13366,18795;18807,33215,0,0,0,2,2
62006,140,13367,18686;18797,33215,0,0,0,2,2
62007,140,13368,18984,33215,0,0,0,1,1
62008,140,13369,18845;18865,33215,0,0,0,2,2
62009,140,13371,18892,33215,0,0,0,1,1
62010,140,13372,18902;19044,33215,0,0,0,2,2
62011,140,13373,18913;19342;22550,33215,0,0,1,2,3
62012,140,13411,17324,33580,0,0,0,1,1
62013,140,13412,17235;17293,33580,0,0,0,2,2
62014,140,13415,17030,33580,0,0,0,1,1
62015,140,13418,18026,33580,0,0,0,1,1
62016,140,13419,17529,33580,0,0,0,1,1
62017,140,13422,18150,33580,0,0,0,1,1
62018,140,13423,17885,33580,0,0,0,1,1
62019,140,13425,17631;18139,33580,0,0,0,2,2
62020,140,13426,17817,33580,0,0,0,1,1
62021,140,13427,17853,33580,0,0,0,1,1
62022,140,13428,17970;18351,33580,0,0,0,2,2
62023,140,13429,17953,33580,0,0,0,1,1
62024,140,13434,17993,33580,0,0,0,1,1
62025,140,13435,18176,33580,0,0,0,1,1
62026,140,13437,18204;18742,33580,0,0,0,2,2
62027,140,13438,18683;18896,33580,0,0,0,2,2
62028,140,13439,18857,33580,0,0,0,1,1
62029,140,13440,18298;18543,33580,0,0,0,2,2
62030,140,13441,18309;18470,33580,0,0,0,2,2
62031,140,13442,18520;18583,33580,0,0,0,2,2
62032,140,13443,18012;18327,33580,0,0,0,2,2
62033,140,13444,18556,33580,0,0,0,1,1
62034,140,13445,18884;18919,33580,0,0,0,2,2
62035,140,13446,18191;18407,33580,0,0,0,2,2
62036,140,13447,18360;18524,33580,0,0,0,2,2
62037,140,13452,19072;19291,33580,0,0,0,2,2
62038,140,13453,18295;18559;22896,33580,0,0,1,2,3
62039,140,13454,18434;18879;22420,33580,0,0,1,2,3
62040,140,13456,18423;18982;22802,33580,0,0,1,2,3
62041,140,13458,18622;18877,33580,0,0,0,2,2
62042,140,13459,18245;18631,33580,0,0,0,2,2
62043,140,13460,18648;18874;22688,33580,0,0,1,2,3
62044,140,13461,19141,33580,0,0,0,1,1
62045,140,13462,18577;18630;21995,33580,0,0,1,2,3
62046,140,13463,18624,33580,0,0,0,1,1
62047,140,13464,18708;19064,33580,0,0,0,2,2
62048,140,13465,18217;18727,33580,0,0,0,2,2
62049,140,13466,18713;19060,33580,0,0,0,2,2
62050,140,13467,18757;18894,33580,0,0,0,2,2
62051,140,13468,18793,33580,0,0,0,1,1
62052,140,13469,18801;18996;22414;24796;25955;26253,33580,2,1,1,2,6
62053,140,13470,18815,33580,0,0,0,1,1
62054,140,13471,19321,33580,0,0,0,1,1
62055,140,13472,19070,33580,0,0,0,1,1
62056,140,13473,19210;23201;25012,33580,0,1,1,1,3
62057,140,13474,18836;18969,33580,0,0,0,2,2
62058,140,13475,18945,33580,0,0,0,1,1
62059,140,13476,18848,33580,0,0,0,1,1
62060,140,13477,18967,33580,0,0,0,1,1
62061,140,13478,18912;19004,33580,0,0,0,2,2
62062,140,13479,18970;23628,33580,0,0,1,1,2
62063,140,13480,19013;19261,33580,0,0,0,2,2
62064,140,13507,15576,33945,0,0,0,1,1
62065,140,13524,16829;16870,33945,0,0,0,2,2
62066,140,13525,16919,33945,0,0,0,1,1
62067,140,13529,17428,33945,0,0,0,1,1
62068,140,13532,17290;18201,33945,0,0,0,2,2
62069,140,13538,17356;17793,33945,0,0,0,2,2
62070,140,13539,18261,33945,0,0,0,1,1
62071,140,13540,17881;18529,33945,0,0,0,2,2
62072,140,13542,17981;18003,33945,0,0,0,2,2
62073,140,13544,17450;17702,33945,0,0,0,2,2
62074,140,13546,18182,33945,0,0,0,1,1
62075,140,13547,18399,33945,0,0,0,1,1
62076,140,13548,18380;22193,33945,0,0,1,1,2
62077,140,13549,18466,33945,0,0,0,1,1
62078,140,13550,18325,33945,0,0,0,1,1
62079,140,13551,18386;18672,33945,0,0,0,2,2
62080,140,13552,18817;18875,33945,0,0,0,2,2
62081,140,13553,18484;18944,33945,0,0,0,2,2
62082,140,13555,18847;19129,33945,0,0,0,2,2
62083,140,13556,18563;18782,33945,0,0,0,2,2
62084,140,13557,18589;18652,33945,0,0,0,2,2
62085,140,13559,18635;18753,33945,0,0,0,2,2
62086,140,13560,18676;19132;22921;25011;26086;26280,33945,2,1,1,2,6
62087,140,13561,19096,33945,0,0,0,1,1
62088,140,13562,18718,33945,0,0,0,1,1
62089,140,13565,18570;18739;22897,33945,0,0,1,2,3
62090,140,13566,19217;19521,33945,0,0,1,1,2
62091,140,13567,18762,33945,0,0,0,1,1
62092,140,13569,19541,33945,0,0,1,0,1
62093,140,13570,18835;18922,33945,0,0,0,2,2
62094,140,13571,18800;18899,33945,0,0,0,2,2
62095,140,13572,18628;18885;22689,33945,0,0,1,2,3
62096,140,13573,18733;18926,33945,0,0,0,2,2
62097,140,13575,18955;22430,33945,0,0,1,1,2
62098,140,13576,18715;18959,33945,0,0,0,2,2
62099,140,13577,18240;18961;23111,33945,0,0,1,2,3
62100,140,13578,18965,33945,0,0,0,1,1
62101,140,13579,18988,33945,0,0,0,1,1
62102,140,13581,18837;19046,33945,0,0,0,2,2
62103,140,13582,19047,33945,0,0,0,1,1
62104,140,13584,18914;19053,33945,0,0,0,2,2
62105,140,13585,19068,33945,0,0,0,1,1
62106,140,13586,19145,33945,0,0,0,1,1
62107,140,13587,19250;19494,33945,0,0,1,1,2
62108,140,13588,19037;19311,33945,0,0,0,2,2
62109,140,13589,18841;19094,33945,0,0,0,2,2
62110,140,13591,21373;21445;24944;25151,33945,0,2,2,0,4
62111,140,13592,19119;23512,33945,0,0,1,1,2
62112,140,13593,18832;19312,33945,0,0,0,2,2
62113,140,13594,19136,33945,0,0,0,1,1
62114,140,13595,19137,33945,0,0,0,1,1
62115,140,13596,19160,33945,0,0,0,1,1
62116,140,13598,19388;19492;22727;23218,33945,0,0,3,1,4
62117,140,13615,15135,34310,0,0,0,1,1
62118,140,13624,15766,34310,0,0,0,1,1
62119,140,13631,16433,34310,0,0,0,1,1
62120,140,13635,16542,34310,0,0,0,1,1
62121,140,13638,16999,34310,0,0,0,1,1
62122,140,13640,16907;17291;21541;25238;25525,34310,0,2,1,2,5
62123,140,13641,17390,34310,0,0,0,1,1
62124,140,13643,17924;18263,34310,0,0,0,2,2
62125,140,13645,17842,34310,0,0,0,1,1
62126,140,13647,18318,34310,0,0,0,1,1
62127,140,13649,17814;18127,34310,0,0,0,2,2
62128,140,13650,17961;18059,34310,0,0,0,2,2
62129,140,13651,17636;18036,34310,0,0,0,2,2
62130,140,13654,18930;19022,34310,0,0,0,2,2
62131,140,13655,18207;18337,34310,0,0,0,2,2
62132,140,13657,18355;18508,34310,0,0,0,2,2
62133,140,13658,18522,34310,0,0,0,1,1
62134,140,13659,18129,34310,0,0,0,1,1
62135,140,13660,18567,34310,0,0,0,1,1
62136,140,13661,18476;18636;22524,34310,0,0,1,2,3
62137,140,13662,18458;19015,34310,0,0,0,2,2
62138,140,13663,18460,34310,0,0,0,1,1
62139,140,13667,18571;18744,34310,0,0,0,2,2
62140,140,13668,18504;22526,34310,0,0,1,1,2
62141,140,13669,18568;18878,34310,0,0,0,2,2
62142,140,13670,18838;19052,34310,0,0,0,2,2
62143,140,13672,22310;22592;26167;26259,34310,2,0,2,0,4
62144,140,13673,19128;19256,34310,0,0,0,2,2
62145,140,13674,18764;19319;22585;22713,34310,0,0,2,2,4
62146,140,13675,18444;23187,34310,0,0,1,1,2
62147,140,13676,19008,34310,0,0,0,1,1
62148,140,13681,18367;18825,34310,0,0,0,2,2
62149,140,13682,18849;18863,34310,0,0,0,2,2
62150,140,13683,19084;19135,34310,0,0,0,2,2
62151,140,13684,18220;18898,34310,0,0,0,2,2
62152,140,13685,18992,34310,0,0,0,1,1
62153,140,13686,18921;19150,34310,0,0,0,2,2
62154,140,13687,18871;18927,34310,0,0,0,2,2
62155,140,13688,18942,34310,0,0,0,1,1
62156,140,13689,18850,34310,0,0,0,1,1
62157,140,13690,19546;23524,34310,0,0,2,0,2
62158,140,13691,18980;19411,34310,0,0,0,2,2
62159,140,13692,18993;19478;22023,34310,0,0,2,1,3
62160,140,13693,19551,34310,0,0,1,0,1
62161,140,13695,19014;19389,34310,0,0,0,2,2
62162,140,13696,19023,34310,0,0,0,1,1
62163,140,13697,19199;19431,34310,0,0,1,1,2
62164,140,13698,18803;19036,34310,0,0,0,2,2
62165,140,13699,19043,34310,0,0,0,1,1
62166,140,13700,19504;19596,34310,0,0,2,0,2
62167,140,13701,18665;19260,34310,0,0,0,2,2
62168,140,13702,19393,34310,0,0,0,1,1
62169,140,13703,18966;19172,34310,0,0,0,2,2
62170,140,13704,19058;19157;22924,34310,0,0,1,2,3
62171,140,13705,19011;19192,34310,0,0,0,2,2
62172,140,13707,19471,34310,0,0,1,0,1
62173,140,13708,19230;19449,34310,0,0,1,1,2
62174,140,13709,19322;22938,34310,0,0,1,1,2
62175,140,13710,18540;19215,34310,0,0,0,2,2
62176,140,13712,18759;19281;23631;25818,34310,0,1,1,2,4
62177,140,13713,19276;19282,34310,0,0,0,2,2
62178,140,13714,19271;19293,34310,0,0,0,2,2
62179,140,13715,19303;19304;22818,34310,0,0,1,2,3
62180,140,13744,16340;16934,34675,0,0,0,2,2
62181,140,13747,17199,34675,0,0,0,1,1
62182,140,13750,16538;16971,34675,0,0,0,2,2
62183,140,13757,16539,34675,0,0,0,1,1
62184,140,13759,17361;17412,34675,0,0,0,2,2
62185,140,13764,18082,34675,0,0,0,1,1
62186,140,13765,18362,34675,0,0,0,1,1
62187,140,13766,18055;18151,34675,0,0,0,2,2
62188,140,13768,18314;21967,34675,0,0,1,1,2
62189,140,13769,18370,34675,0,0,0,1,1
62190,140,13770,18440,34675,0,0,0,1,1
62191,140,13772,18498,34675,0,0,0,1,1
62192,140,13773,18553;18840;22417,34675,0,0,1,2,3
62193,140,13774,17978;18595;22105;25096;26146,34675,1,1,1,2,5
62194,140,13775,18056;18616,34675,0,0,0,2,2
62195,140,13777,18647;18788,34675,0,0,0,2,2
62196,140,13778,18695,34675,0,0,0,1,1
62197,140,13779,18767;19104,34675,0,0,0,2,2
62198,140,13780,18776;18791,34675,0,0,0,2,2
62199,140,13781,18794;19198,34675,0,0,0,2,2
62200,140,13784,18855;18908,34675,0,0,0,2,2
62201,140,13785,18789;18860,34675,0,0,0,2,2
62202,140,13787,19078,34675,0,0,0,1,1
62203,140,13788,18937;19130,34675,0,0,0,2,2
62204,140,13789,18557;19259,34675,0,0,0,2,2
62205,140,13790,19029,34675,0,0,0,1,1
62206,140,13791,18579;19048,34675,0,0,0,2,2
62207,140,13792,19166,34675,0,0,0,1,1
62208,140,13793,19071;19289;23307;25907,34675,1,0,1,2,4
62209,140,13794,18903;19074,34675,0,0,0,2,2
62210,140,13796,19120;19349,34675,0,0,0,2,2
62211,140,13797,18754;19126,34675,0,0,0,2,2
62212,140,13798,19153;19222,34675,0,0,0,2,2
62213,140,13799,19177,34675,0,0,0,1,1
62214,140,13800,19211;19391,34675,0,0,0,2,2
62215,140,13801,19375;19633,34675,0,0,1,1,2
62216,140,13802,19224,34675,0,0,0,1,1
62217,140,13804,19031;19283;23203;23741;26102;26200,34675,2,0,2,2,6
62218,140,13805,19131;19298,34675,0,0,0,2,2
62219,140,13807,19367;19578,34675,0,0,1,1,2
62220,140,13809,19437,34675,0,0,1,0,1
62221,140,13810,19320;22586,34675,0,0,1,1,2
62222,140,13811,19079;19350,34675,0,0,0,2,2
62223,140,13812,18886;19353,34675,0,0,0,2,2
62224,140,13813,19006;19385,34675,0,0,0,2,2
62225,140,13814,19275;19673;23633;25622,34675,0,1,2,1,4
62226,140,13815,19495;19509,34675,0,0,2,0,2
62227,140,13816,19733,34675,0,0,1,0,1
62228,140,13821,14897,35040,0,0,0,1,1
62229,140,13835,15662,35040,0,0,0,1,1
62230,140,13842,16221,35040,0,0,0,1,1
62231,140,13856,17676,35040,0,0,0,1,1
62232,140,13864,18172;18509,35040,0,0,0,2,2
62233,140,13865,18526,35040,0,0,0,1,1
62234,140,13866,18503;18656;22675;24907;26267,35040,1,1,1,2,5
62235,140,13868,18388;19252,35040,0,0,0,2,2
62236,140,13870,18406;19266,35040,0,0,0,2,2
62237,140,13871,18808,35040,0,0,0,1,1
62238,140,13872,18268;18439,35040,0,0,0,2,2
62239,140,13873,18441;18645,35040,0,0,0,2,2
62240,140,13874,18448;18480,35040,0,0,0,2,2
62241,140,13875,18113;18451,35040,0,0,0,2,2
62242,140,13876,18463,35040,0,0,0,1,1
62243,140,13877,17727,35040,0,0,0,1,1
62244,140,13878,18500,35040,0,0,0,1,1
62245,140,13880,18363;19067,35040,0,0,0,2,2
62246,140,13881,18790;18859,35040,0,0,0,2,2
62247,140,13882,18239;18552,35040,0,0,0,2,2
62248,140,13884,18606,35040,0,0,0,1,1
62249,140,13885,18872,35040,0,0,0,1,1
62250,140,13886,18329;18693,35040,0,0,0,2,2
62251,140,13888,18424;18707,35040,0,0,0,2,2
62252,140,13889,18271;18710,35040,0,0,0,2,2
62253,140,13890,18775,35040,0,0,0,1,1
62254,140,13891,18228;18799,35040,0,0,0,2,2
62255,140,13892,18934;19483,35040,0,0,1,1,2
62256,140,13894,18459;18952,35040,0,0,0,2,2
62257,140,13895,18436;18974,35040,0,0,0,2,2
62258,140,13896,19003;19486,35040,0,0,1,1,2
62259,140,13898,19009;19236,35040,0,0,0,2,2
62260,140,13899,19041,35040,0,0,0,1,1
62261,140,13900,19333;22589;25682,35040,0,1,1,1,3
62262,140,13901,19577;19661;23644,35040,0,0,3,0,3
62263,140,13902,18684;19075,35040,0,0,0,2,2
62264,140,13903,19476,35040,0,0,1,0,1
62265,140,13904,19056,35040,0,0,0,1,1
62266,140,13905,19117;19610,35040,0,0,1,1,2
62267,140,13906,18888;19139,35040,0,0,0,2,2
62268,140,13907,18983;19140,35040,0,0,0,2,2
62269,140,13908,19171;19323;24197,35040,0,0,1,2,3
62270,140,13910,18935;19209,35040,0,0,0,2,2
62271,140,13911,19213;19316,35040,0,0,0,2,2
62272,140,13912,19219;19405,35040,0,0,0,2,2
62273,140,13913,19531,35040,0,0,1,0,1
62274,140,13914,19077;19240;22814,35040,0,0,1,2,3
62275,140,13917,19268,35040,0,0,0,1,1
62276,140,13918,19286;19748;24089,35040,0,0,2,1,3
62277,140,13920,19500;19590;23748,35040,0,0,3,0,3
62278,140,13921,18720;19317,35040,0,0,0,2,2
62279,140,13922,19245;19644,35040,0,0,1,1,2
62280,140,13923,18545;19377,35040,0,0,0,2,2
62281,140,13924,19383,35040,0,0,0,1,1
62282,140,13925,19178;19400,35040,0,0,0,2,2
62283,140,13928,19057;19532,35040,0,0,1,1,2
62284,140,13929,19086;19542,35040,0,0,1,1,2
62285,140,13930,19552,35040,0,0,1,0,1
62286,140,13932,19499;19872;24093,35040,0,0,3,0,3
62287,140,13960,17180,35405,0,0,0,1,1
62288,140,13968,17477,35405,0,0,0,1,1
62289,140,13971,17804;17831,35405,0,0,0,2,2
62290,140,13974,18531,35405,0,0,0,1,1
62291,140,13975,18236;18266,35405,0,0,0,2,2
62292,140,13976,17808,35405,0,0,0,1,1
62293,140,13977,18030,35405,0,0,0,1,1
62294,140,13978,17725;17754,35405,0,0,0,2,2
62295,140,13979,23401;23441;26307,35405,1,0,2,0,3
62296,140,13980,17864;22650;25407,35405,0,1,1,1,3
62297,140,13981,18581,35405,0,0,0,1,1
62298,140,13982,18270;18442,35405,0,0,0,2,2
62299,140,13984,18250;18324,35405,0,0,0,2,2
62300,140,13985,18117;18333,35405,0,0,0,2,2
62301,140,13987,18369;22778,35405,0,0,1,1,2
62302,140,13989,18379,35405,0,0,0,1,1
62303,140,13990,18416;18953,35405,0,0,0,2,2
62304,140,13991,18443;18703,35405,0,0,0,2,2
62305,140,13992,18464;18662,35405,0,0,0,2,2
62306,140,13993,18521,35405,0,0,0,1,1
62307,140,13995,18534;18769,35405,0,0,0,2,2
62308,140,13996,18594;19089;22439,35405,0,0,1,2,3
62309,140,13997,18621,35405,0,0,0,1,1
62310,140,14000,19454;19455;23310,35405,0,0,3,0,3
62311,140,14002,18593;18748;25162,35405,0,1,0,2,3
62312,140,14004,18870;19107,35405,0,0,0,2,2
62313,140,14006,18975;18979,35405,0,0,0,2,2
62314,140,14008,19123;19696,35405,0,0,1,1,2
62315,140,14010,19098;19741,35405,0,0,1,1,2
62316,140,14011,19100,35405,0,0,0,1,1
62317,140,14012,18792;19133;23739,35405,0,0,1,2,3
62318,140,14013,19604;19697,35405,0,0,2,0,2
62319,140,14014,19080;19148,35405,0,0,0,2,2
62320,140,14015,18493;18854,35405,0,0,0,2,2
62321,140,14016,19176;19358,35405,0,0,0,2,2
62322,140,14017,19180,35405,0,0,0,1,1
62323,140,14018,19399;19475;23420,35405,0,0,2,1,3
62324,140,14019,19774;22738,35405,0,0,2,0,2
62325,140,14021,19285,35405,0,0,0,1,1
62326,140,14022,19329;19878,35405,0,0,1,1,2
62327,140,14023,19336;19576,35405,0,0,1,1,2
62328,140,14024,19339,35405,0,0,0,1,1
62329,140,14026,19824,35405,0,0,1,0,1
62330,140,14027,19401,35405,0,0,0,1,1
62331,140,14029,18671;19417,35405,0,0,0,2,2
62332,140,14030,19398;19453,35405,0,0,1,1,2
62333,140,14031,19473,35405,0,0,1,0,1
62334,140,14034,18688;19503;22345,35405,0,0,2,1,3
62335,140,14035,19669;24917,35405,0,1,1,0,2
62336,140,14037,19420;23309,35405,0,0,1,1,2
62337,140,14038,19443;19493;22722,35405,0,0,3,0,3
62338,140,14039,19263;19771,35405,0,0,1,1,2
62339,140,14040,19553;19658;23970,35405,0,0,3,0,3
62340,140,14041,18998;19875,35405,0,0,1,1,2
62341,140,14042,19461;19556,35405,0,0,2,0,2
62342,140,14044,19163;19612,35405,0,0,1,1,2
62343,140,14045,19589;19716,35405,0,0,2,0,2
62344,140,14046,19560;19712,35405,0,0,2,0,2
62345,140,14048,19751;22050,35405,0,0,2,0,2
62346,140,14049,19770;19934;23240,35405,0,0,3,0,3
62347,140,14050,19092;19609,35405,0,0,1,1,2
62348,140,14051,19111;19595,35405,0,0,1,1,2
62349,140,14067,15410,35770,0,0,0,1,1
62350,140,14082,17724,35770,0,0,0,1,1
62351,140,14088,18382,35770,0,0,0,1,1
62352,140,14089,17806,35770,0,0,0,1,1
62353,140,14090,17997,35770,0,0,0,1,1
62354,140,14091,17809,35770,0,0,0,1,1
62355,140,14094,18674;18826,35770,0,0,0,2,2
62356,140,14095,18303,35770,0,0,0,1,1
62357,140,14097,21974,35770,0,0,1,0,1
62358,140,14098,19144;19384,35770,0,0,0,2,2
62359,140,14099,18798,35770,0,0,0,1,1
62360,140,14100,18582;19039,35770,0,0,0,2,2
62361,140,14101,18145;18640,35770,0,0,0,2,2
62362,140,14102,18625,35770,0,0,0,1,1
62363,140,14105,18273;18963,35770,0,0,0,2,2
62364,140,14107,18467;18844,35770,0,0,0,2,2
62365,140,14109,18542;18943;22799,35770,0,0,1,2,3
62366,140,14110,18973;19305;23742;26024;26125,35770,2,0,1,2,5
62367,140,14112,18675;19529,35770,0,0,1,1,2
62368,140,14113,18823;19146,35770,0,0,0,2,2
62369,140,14114,19220,35770,0,0,0,1,1
62370,140,14115,19243,35770,0,0,0,1,1
62371,140,14116,19429;19753,35770,0,0,2,0,2
62372,140,14117,19514;19798,35770,0,0,2,0,2
62373,140,14119,19277,35770,0,0,0,1,1
62374,140,14120,19295;19681,35770,0,0,1,1,2
62375,140,14121,19093;19325;22588,35770,0,0,1,2,3
62376,140,14122,19574;19993,35770,0,0,2,0,2
62377,140,14123,19360,35770,0,0,0,1,1
62378,140,14124,19297;19302,35770,0,0,0,2,2
62379,140,14125,19370;23130,35770,0,0,1,1,2
62380,140,14126,19409;19734;23976,35770,0,0,2,1,3
62381,140,14127,19430;19533,35770,0,0,2,0,2
62382,140,14128,19617;19891,35770,0,0,2,0,2
62383,140,14129,18818;19421,35770,0,0,0,2,2
62384,140,14131,19462;19657,35770,0,0,2,0,2
62385,140,14132,19249;23968,35770,0,0,1,1,2
62386,140,14133,19554;19699,35770,0,0,2,0,2
62387,140,14134,19484;19778,35770,0,0,2,0,2
62388,140,14135,19416;19511,35770,0,0,1,1,2
62389,140,14136,19776,35770,0,0,1,0,1
62390,140,14138,19539;19791,35770,0,0,2,0,2
62391,140,14140,19467;19573,35770,0,0,2,0,2
62392,140,14141,19602;19635,35770,0,0,2,0,2
62393,140,14142,19790,35770,0,0,1,0,1
62394,140,14143,18425;19099,35770,0,0,0,2,2
62395,140,14144,19548;19680,35770,0,0,2,0,2
62396,140,14145,19652;19682,35770,0,0,2,0,2
62397,140,14146,19362;19844,35770,0,0,1,1,2
62398,140,14147,19125;19703,35770,0,0,1,1,2
62399,140,14148,19357;19718,35770,0,0,1,1,2
62400,140,14149,19585;19837,35770,0,0,2,0,2
62401,140,14150,19738;19914,35770,0,0,2,0,2
62402,140,14151,19944;19980;23550;25912,35770,1,0,3,0,4
62403,140,14152,19800;24091,35770,0,0,2,0,2
62404,140,14153,19775;20027,35770,0,0,2,0,2
62405,140,14168,15694,36135,0,0,0,1,1
62406,140,14171,15844,36135,0,0,0,1,1
62407,140,14180,16581;16760,36135,0,0,0,2,2
62408,140,14195,17771;18169,36135,0,0,0,2,2
62409,140,14201,19254,36135,0,0,0,1,1
62410,140,14203,18341,36135,0,0,0,1,1
62411,140,14205,18468,36135,0,0,0,1,1
62412,140,14206,18546;19267,36135,0,0,0,2,2
62413,140,14211,18691;19599,36135,0,0,1,1,2
62414,140,14212,18842;19189,36135,0,0,0,2,2
62415,140,14213,18995;19732;23649;24199,36135,0,0,3,1,4
62416,140,14214,19024;19105,36135,0,0,0,2,2
62417,140,14215,18990;19045,36135,0,0,0,2,2
62418,140,14218,19062;19783;22739,36135,0,0,2,1,3
62419,140,14220,19155;19601,36135,0,0,1,1,2
62420,140,14221,18697,36135,0,0,0,1,1
62421,140,14222,19106;19284;22569,36135,0,0,1,2,3
62422,140,14223,18891;19346,36135,0,0,0,2,2
62423,140,14225,19306,36135,0,0,0,1,1
62424,140,14226,19197;19328;23208;26202;26289,36135,2,0,1,2,5
62425,140,14229,19255;19355,36135,0,0,0,2,2
62426,140,14230,19238;19369,36135,0,0,0,2,2
62427,140,14231,19641,36135,0,0,1,0,1
62428,140,14232,19526;19860,36135,0,0,2,0,2
62429,140,14233,20047;20221,36135,0,0,2,0,2
62430,140,14234,19664;19963,36135,0,0,2,0,2
62431,140,14236,19204;19803,36135,0,0,1,1,2
62432,140,14238,19793;19850;24090,36135,0,0,3,0,3
62433,140,14239,19335;19724;23437;23536;25515;25815,36135,0,2,3,1,6
62434,140,14240,19737;19743,36135,0,0,2,0,2
62435,140,14241,19744,36135,0,0,1,0,1
62436,140,14242,20133;24102;24296,36135,0,0,3,0,3
62437,140,14244,19296;19802,36135,0,0,1,1,2
62438,140,14245,19810;19950,36135,0,0,2,0,2
62439,140,14246,19813;20064,36135,0,0,2,0,2
62440,140,14247,19826;23665,36135,0,0,2,0,2
62441,140,14248,20364,36135,0,0,1,0,1
62442,140,14249,19987,36135,0,0,1,0,1
62443,140,14250,19745;20141,36135,0,0,2,0,2
62444,140,14253,19829;20102,36135,0,0,2,0,2
62445,140,14254,19662;19861,36135,0,0,2,0,2
62446,140,14255,19864;20195,36135,0,0,2,0,2
62447,140,14256,19719;19880,36135,0,0,2,0,2
62448,140,14257,19569;19886;23544;23979,36135,0,0,4,0,4
62449,140,14270,16133,36500,0,0,0,1,1
62450,140,14278,17913,36500,0,0,0,1,1
62451,140,14280,17784,36500,0,0,0,1,1
62452,140,14284,18144;18629,36500,0,0,0,2,2
62453,140,14289,18198;18946,36500,0,0,0,2,2
62454,140,14292,18275;18491,36500,0,0,0,2,2
62455,140,14293,18681,36500,0,0,0,1,1
62456,140,14296,18654;18931,36500,0,0,0,2,2
62457,140,14297,18977,36500,0,0,0,1,1
62458,140,14299,18701,36500,0,0,0,1,1
62459,140,14300,19082;19426,36500,0,0,0,2,2
62460,140,14301,18610;18909,36500,0,0,0,2,2
62461,140,14302,18525;18828,36500,0,0,0,2,2
62462,140,14304,19381,36500,0,0,0,1,1
62463,140,14305,19587;19645;23055,36500,0,0,3,0,3
62464,140,14306,19294;19309,36500,0,0,0,2,2
62465,140,14307,19226;19273,36500,0,0,0,2,2
62466,140,14308,19439;19632,36500,0,0,2,0,2
62467,140,14309,18736;19142,36500,0,0,0,2,2
62468,140,14310,19448,36500,0,0,1,0,1
62469,140,14311,19882;20010;23767,36500,0,0,3,0,3
62470,140,14315,19344,36500,0,0,0,1,1
62471,140,14316,19365;19452,36500,0,0,1,1,2
62472,140,14317,19310;19392,36500,0,0,0,2,2
62473,140,14318,18856;19403,36500,0,0,0,2,2
62474,140,14320,19442;20179;23993,36500,0,0,3,0,3
62475,140,14321,19257;19445,36500,0,0,1,1,2
62476,140,14322,19885;19889;23326;23656,36500,0,0,4,0,4
62477,140,14323,19457,36500,0,0,1,0,1
62478,140,14325,19786,36500,0,0,1,0,1
62479,140,14326,19693,36500,0,0,1,0,1
62480,140,14327,19187;19642,36500,0,0,1,1,2
62481,140,14328,19631,36500,0,0,1,0,1
62482,140,14330,19124;19647;23859,36500,0,0,2,1,3
62483,140,14331,19650;20129,36500,0,0,2,0,2
62484,140,14332,19807;23541,36500,0,0,2,0,2
62485,140,14333,19687;19874;23860,36500,0,0,3,0,3
62486,140,14334,20092;20306,36500,0,0,2,0,2
62487,140,14335,19740;19755,36500,0,0,2,0,2
62488,140,14336,19747;19827,36500,0,0,2,0,2
62489,140,14337,19624;19780,36500,0,0,2,0,2
62490,140,14338,20287,36500,0,0,1,0,1
62491,140,14339,19698;20260;24574,36500,0,1,2,0,3
62492,140,14340,19828;20177,36500,0,0,2,0,2
62493,140,14341,19834;19853,36500,0,0,2,0,2
62494,140,14342,19842,36500,0,0,1,0,1
62495,140,14343,19884;20174;23992;24207,36500,0,0,4,0,4
62496,140,14344,19397;19855;23864,36500,0,0,2,1,3
62497,140,14345,19422;19857,36500,0,0,1,1,2
62498,140,14346,19876;19894,36500,0,0,2,0,2
62499,140,14348,19649;20078;23858;24690,36500,0,1,3,0,4
62500,140,14349,19663;19929;23660,36500,0,0,3,0,3
62501,140,14350,19566;19945,36500,0,0,2,0,2
62502,140,14351,19947;20283;24397,36500,0,0,3,0,3
62503,140,14352,19685;19958,36500,0,0,2,0,2
62504,140,14353,19960;20000;24203;26033,36500,1,0,3,0,4
62505,140,14354,19816,36500,0,0,1,0,1
62506,140,14355,20132;20249,36500,0,0,2,0,2
62507,140,14356,19983;20109;23769;24474,36500,0,0,4,0,4
62508,140,14364,15461,36865,0,0,0,1,1
62509,140,14370,16018,36865,0,0,0,1,1
62510,140,14376,16569,36865,0,0,0,1,1
62511,140,14381,16880;17168,36865,0,0,0,2,2
62512,140,14382,17504;17770,36865,0,0,0,2,2
62513,140,14390,17286,36865,0,0,0,1,1
62514,140,14393,18359,36865,0,0,0,1,1
62515,140,14397,18535,36865,0,0,0,1,1
62516,140,14402,18391;18482,36865,0,0,0,2,2
62517,140,14403,18136;18264,36865,0,0,0,2,2
62518,140,14404,18592,36865,0,0,0,1,1
62519,140,14405,18285;18551,36865,0,0,0,2,2
62520,140,14406,18474,36865,0,0,0,1,1
62521,140,14407,18375;18882,36865,0,0,0,2,2
62522,140,14411,18978,36865,0,0,0,1,1
62523,140,14412,18533;18608,36865,0,0,0,2,2
62524,140,14414,18711;18717,36865,0,0,0,2,2
62525,140,14415,18997,36865,0,0,0,1,1
62526,140,14416,18831;19138,36865,0,0,0,2,2
62527,140,14417,18843;19318,36865,0,0,0,2,2
62528,140,14419,18537;19127,36865,0,0,0,2,2
62529,140,14420,19102,36865,0,0,0,1,1
62530,140,14422,19395,36865,0,0,0,1,1
62531,140,14423,19184,36865,0,0,0,1,1
62532,140,14424,19202;19324,36865,0,0,0,2,2
62533,140,14425,18834;19308,36865,0,0,0,2,2
62534,140,14426,19337,36865,0,0,0,1,1
62535,140,14428,18906;19376,36865,0,0,0,2,2
62536,140,14429,19227;19911;23658,36865,0,0,2,1,3
62537,140,14430,19343;19765,36865,0,0,1,1,2
62538,140,14431,19156;19615,36865,0,0,1,1,2
62539,140,14432,20089;20152;23463,36865,0,0,3,0,3
62540,140,14433,19505;19517,36865,0,0,2,0,2
62541,140,14434,19888;19898;23444;25513;26311,36865,1,1,3,0,5
62542,140,14435,19191;19568,36865,0,0,1,1,2
62543,140,14436,19598;19925,36865,0,0,2,0,2
62544,140,14437,19611,36865,0,0,1,0,1
62545,140,14440,19606;19636,36865,0,0,2,0,2
62546,140,14441,19535;19660;22604,36865,0,0,3,0,3
62547,140,14442,19477;19672,36865,0,0,2,0,2
62548,140,14443,19506;19678,36865,0,0,2,0,2
62549,140,14444,19702;19799;23647,36865,0,0,3,0,3
62550,140,14445,19708;20098,36865,0,0,2,0,2
62551,140,14446,19472;19709,36865,0,0,2,0,2
62552,140,14447,19823;19835,36865,0,0,2,0,2
62553,140,14449,19940;20103;24293,36865,0,0,3,0,3
62554,140,14451,19638;19849,36865,0,0,2,0,2
62555,140,14452,19707;19955,36865,0,0,2,0,2
62556,140,14453,20050;20237,36865,0,0,2,0,2
62557,140,14454,19654;19899;24095,36865,0,0,3,0,3
62558,140,14456,19935;20380;24224,36865,0,0,3,0,3
62559,140,14457,19962;20115;24294;26238,36865,1,0,3,0,4
62560,140,14458,20013;20111,36865,0,0,2,0,2
62561,140,14459,19763;19978,36865,0,0,2,0,2
62562,140,14460,19843;19986;24292,36865,0,0,3,0,3
62563,140,14461,19739;19994,36865,0,0,2,0,2
62564,140,14462,19879;20006,36865,0,0,2,0,2
62565,140,14463,20022;20143,36865,0,0,2,0,2
62566,140,14464,19811;20383,36865,0,0,2,0,2
62567,140,14472,15539,37230,0,0,0,1,1
62568,140,14473,14978,37230,0,0,0,1,1
62569,140,14474,15286,37230,0,0,0,1,1
62570,140,14480,16289,37230,0,0,0,1,1
62571,140,14486,17032;17373,37230,0,0,0,2,2
62572,140,14494,16902,37230,0,0,0,1,1
62573,140,14498,18011;18061,37230,0,0,0,2,2
62574,140,14502,18312,37230,0,0,0,1,1
62575,140,14503,22580;22707;22716;22985;25299;25410;26092,37230,1,2,4,0,7
62576,140,14504,18740,37230,0,0,0,1,1
62577,140,14506,18819;18991,37230,0,0,0,2,2
62578,140,14508,18752;18928,37230,0,0,0,2,2
62579,140,14509,18572;19021,37230,0,0,0,2,2
62580,140,14510,19667,37230,0,0,1,0,1
62581,140,14511,19313,37230,0,0,0,1,1
62582,140,14512,19151,37230,0,0,0,1,1
62583,140,14514,18941;19270,37230,0,0,0,2,2
62584,140,14515,19368;19415,37230,0,0,0,2,2
62585,140,14516,19465,37230,0,0,1,0,1
62586,140,14517,19480;19592,37230,0,0,2,0,2
62587,140,14518,19485,37230,0,0,1,0,1
62588,140,14519,19481;19764,37230,0,0,2,0,2
62589,140,14520,19852;19887,37230,0,0,2,0,2
62590,140,14521,19538;19726,37230,0,0,2,0,2
62591,140,14522,19402;19583,37230,0,0,1,1,2
62592,140,14523,19571;19797;24201,37230,0,0,3,0,3
62593,140,14524,19795;20148;22972,37230,0,0,3,0,3
62594,140,14525,19424;19655,37230,0,0,1,1,2
62595,140,14526,19591,37230,0,0,1,0,1
62596,140,14527,19691,37230,0,0,1,0,1
62597,140,14528,19705;20247;23999,37230,0,0,3,0,3
62598,140,14529,19729;19730,37230,0,0,2,0,2
62599,140,14530,20058;20059;23873,37230,0,0,3,0,3
62600,140,14531,19915;19970,37230,0,0,2,0,2
62601,140,14533,20042;20189,37230,0,0,2,0,2
62602,140,14534,20135;20150;24103,37230,0,0,3,0,3
62603,140,14536,19897;19904;23447,37230,0,0,3,0,3
62604,140,14537,20482,37230,0,0,1,0,1
62605,140,14538,19937;24097,37230,0,0,2,0,2
62606,140,14539,19459;19941,37230,0,0,2,0,2
62607,140,14540,20126;20185,37230,0,0,2,0,2
62608,140,14541,20009;20479,37230,0,0,2,0,2
62609,140,14542,20024;20213,37230,0,0,2,0,2
62610,140,14544,20323,37230,0,0,1,0,1
62611,140,14545,20365;20381,37230,0,0,2,0,2
62612,140,14546,19954;20074,37230,0,0,2,0,2
62613,140,14547,20075;20222,37230,0,0,2,0,2
62614,140,14548,20018;20091;23669,37230,0,0,3,0,3
62615,140,14550,19679;20097;24392,37230,0,0,3,0,3
62616,140,14551,19752;20112;24691,37230,0,1,2,0,3
62617,140,14553,20219;20316;24806,37230,0,1,2,0,3
62618,140,14554,20147;20261,37230,0,0,2,0,2
62619,140,14555,20154;24206,37230,0,0,2,0,2
62620,140,14560,15652,37595,0,0,0,1,1
62621,140,14564,15701,37595,0,0,0,1,1
62622,140,14575,16696,37595,0,0,0,1,1
62623,140,14576,16739,37595,0,0,0,1,1
62624,140,14580,17021,37595,0,0,0,1,1
62625,140,14592,18255;22380,37595,0,0,1,1,2
62626,140,14596,18305;18384,37595,0,0,0,2,2
62627,140,14597,18111;18412,37595,0,0,0,2,2
62628,140,14599,18673;19028,37595,0,0,0,2,2
62629,140,14600,19239,37595,0,0,0,1,1
62630,140,14602,18806,37595,0,0,0,1,1
62631,140,14604,18964;19640,37595,0,0,1,1,2
62632,140,14606,19326,37595,0,0,0,1,1
62633,140,14607,18745,37595,0,0,0,1,1
62634,140,14609,18950;19090,37595,0,0,0,2,2
62635,140,14610,19332;19428;23214,37595,0,0,2,1,3
62636,140,14613,19469;19988;23984,37595,0,0,3,0,3
62637,140,14615,19519;19767,37595,0,0,2,0,2
62638,140,14616,19639;20002;24473,37595,0,0,3,0,3
62639,140,14617,19200;19600,37595,0,0,1,1,2
62640,140,14618,19623;19684;23646;23749,37595,0,0,4,0,4
62641,140,14619,19695;20099;23252,37595,0,0,3,0,3
62642,140,14621,19700;24087,37595,0,0,2,0,2
62643,140,14623,19967;20194;24396,37595,0,0,3,0,3
62644,140,14624,19905;23327;23761;23866,37595,0,0,4,0,4
62645,140,14626,20359;23895;25721,37595,0,1,2,0,3
62646,140,14627,20356;20539;24402,37595,0,0,3,0,3
62647,140,14628,18560;19081;23852,37595,0,0,1,2,3
62648,140,14629,19871;20149;24298;24395,37595,0,0,4,0,4
62649,140,14630,19923;19984,37595,0,0,2,0,2
62650,140,14632,19806;19982,37595,0,0,2,0,2
62651,140,14633,20049;20347,37595,0,0,2,0,2
62652,140,14634,19936;23241,37595,0,0,2,0,2
62653,140,14636,19766;19951,37595,0,0,2,0,2
62654,140,14638,19833;20167,37595,0,0,2,0,2
62655,140,14639,20038;20628;22494;23666,37595,0,0,4,0,4
62656,140,14640,20491;20557,37595,0,0,2,0,2
62657,140,14645,19991;20288,37595,0,0,2,0,2
62658,140,14646,19820;20255,37595,0,0,2,0,2
62659,140,14647,20432;20550;23794;24017;26230,37595,1,0,4,0,5
62660,140,14648,20082;20191,37595,0,0,2,0,2
62661,140,14649,19964;20176;23560,37595,0,0,3,0,3
62662,140,14650,20227,37595,0,0,1,0,1
62663,140,14651,20352;24002,37595,0,0,2,0,2
62664,140,14652,20168;20212,37595,0,0,2,0,2
62665,140,14653,20139;20239;23997,37595,0,0,3,0,3
62666,140,14654,19839;20242;24477,37595,0,0,3,0,3
62667,140,14655,19975;20017;23163;24389,37595,0,0,4,0,4
62668,140,14656,20272;20362,37595,0,0,2,0,2
62669,140,14657,20279;20456,37595,0,0,2,0,2
62670,140,14671,16153,37960,0,0,0,1,1
62671,140,14673,16657,37960,0,0,0,1,1
62672,140,14677,16604,37960,0,0,0,1,1
62673,140,14687,16436,37960,0,0,0,1,1
62674,140,14697,17486,37960,0,0,0,1,1
62675,140,14698,18068,37960,0,0,0,1,1
62676,140,14700,17931,37960,0,0,0,1,1
62677,140,14701,17740;17998,37960,0,0,0,2,2
62678,140,14703,18045,37960,0,0,0,1,1
62679,140,14710,18181,37960,0,0,0,1,1
62680,140,14711,18031;18302,37960,0,0,0,2,2
62681,140,14713,18641;18907,37960,0,0,0,2,2
62682,140,14715,18986;19359,37960,0,0,0,2,2
62683,140,14717,18862;18893,37960,0,0,0,2,2
62684,140,14718,19497,37960,0,0,1,0,1
62685,140,14719,18372;18999,37960,0,0,0,2,2
62686,140,14722,19165;22447,37960,0,0,1,1,2
62687,140,14724,19534,37960,0,0,1,0,1
62688,140,14725,19423,37960,0,0,0,1,1
62689,140,14726,19005;19169,37960,0,0,0,2,2
62690,140,14727,19066;19674,37960,0,0,1,1,2
62691,140,14730,19508;19863,37960,0,0,2,0,2
62692,140,14731,19525;19594,37960,0,0,2,0,2
62693,140,14732,18813,37960,0,0,0,1,1
62694,140,14734,19903,37960,0,0,1,0,1
62695,140,14736,19613;19943,37960,0,0,2,0,2
62696,140,14737,19653;19694,37960,0,0,2,0,2
62697,140,14738,19676;19731,37960,0,0,2,0,2
62698,140,14741,19386;19715;23147,37960,0,0,2,1,3
62699,140,14742,19436;19725,37960,0,0,2,0,2
62700,140,14743,19564;19989,37960,0,0,2,0,2
62701,140,14744,19883;20081,37960,0,0,2,0,2
62702,140,14745,19570;19924,37960,0,0,2,0,2
62703,140,14746,19498;19928;22490,37960,0,0,3,0,3
62704,140,14747,19952,37960,0,0,1,0,1
62705,140,14748,20003;20621,37960,0,0,2,0,2
62706,140,14749,20349;23787,37960,0,0,2,0,2
62707,140,14751,19558;20029,37960,0,0,2,0,2
62708,140,14752,20037;20476;24306,37960,0,0,3,0,3
62709,140,14753,20404,37960,0,0,1,0,1
62710,140,14754,20169;20681,37960,0,0,2,0,2
62711,140,14755,20510;23485,37960,0,0,2,0,2
62712,140,14756,20198;23667,37960,0,0,2,0,2
62713,140,14757,20280,37960,0,0,1,0,1
62714,140,14759,20218;20297;23356;25614;25811;26211,37960,1,2,3,0,6
62715,140,14760,20448;23687,37960,0,0,2,0,2
62716,140,14761,20314;23680,37960,0,0,2,0,2
62717,140,14762,20267;20320;23892,37960,0,0,3,0,3
62718,140,14763,20205;20462;24012;25016,37960,0,1,3,0,4
62719,140,14764,20353;20431,37960,0,0,2,0,2
62720,140,14765,20664;21168;23915,37960,0,0,3,0,3
62721,140,14766,20025;20386;24113;26332,37960,1,0,3,0,4
62722,140,14768,20294;20424,37960,0,0,2,0,2
62723,140,14773,16348;16578,38325,0,0,0,2,2
62724,140,14774,16475;17220,38325,0,0,0,2,2
62725,140,14777,16501,38325,0,0,0,1,1
62726,140,14781,17216,38325,0,0,0,1,1
62727,140,14787,17966,38325,0,0,0,1,1
62728,140,14793,17879;18373,38325,0,0,0,2,2
62729,140,14795,17847;18304;22520,38325,0,0,1,2,3
62730,140,14802,18385,38325,0,0,0,1,1
62731,140,14803,18438;18462,38325,0,0,0,2,2
62732,140,14804,17969,38325,0,0,0,1,1
62733,140,14808,18689,38325,0,0,0,1,1
62734,140,14813,18900;19371,38325,0,0,0,2,2
62735,140,14815,19110;19253,38325,0,0,0,2,2
62736,140,14816,19248;19710;23973,38325,0,0,2,1,3
62737,140,14819,19419;19620,38325,0,0,1,1,2
62738,140,14820,19274;19373,38325,0,0,0,2,2
62739,140,14823,19557;19690,38325,0,0,2,0,2
62740,140,14825,19262;19433,38325,0,0,1,1,2
62741,140,14827,19815;23755,38325,0,0,2,0,2
62742,140,14828,19540,38325,0,0,1,0,1
62743,140,14829,19410;19998,38325,0,0,1,1,2
62744,140,14830,19625;19900,38325,0,0,2,0,2
62745,140,14831,20246;20286;23570,38325,0,0,3,0,3
62746,140,14832,19717,38325,0,0,1,0,1
62747,140,14834,19756;20203;23466,38325,0,0,3,0,3
62748,140,14836,19821;20502;24582,38325,0,1,2,0,3
62749,140,14837,19916;20503;24308;24487,38325,0,0,4,0,4
62750,140,14838,19706;19932,38325,0,0,2,0,2
62751,140,14843,20005;20170;23772;23991,38325,0,0,4,0,4
62752,140,14844,19956;20069;23668,38325,0,0,3,0,3
62753,140,14845,20555,38325,0,0,1,0,1
62754,140,14846,20096,38325,0,0,1,0,1
62755,140,14847,23989,38325,0,0,1,0,1
62756,140,14848,20159;20161,38325,0,0,2,0,2
62757,140,14849,20094;20165,38325,0,0,2,0,2
62758,140,14850,20390,38325,0,0,1,0,1
62759,140,14851,20046;20376,38325,0,0,2,0,2
62760,140,14854,20232,38325,0,0,1,0,1
62761,140,14855,20200;20289,38325,0,0,2,0,2
62762,140,14856,19946;20295;23678,38325,0,0,3,0,3
62763,140,14857,23679;23890,38325,0,0,2,0,2
62764,140,14858,20911;20973;23819;25028;25213,38325,0,2,3,0,5
62765,140,14859,20581;20685;24131;24241,38325,0,0,4,0,4
62766,140,14861,20350,38325,0,0,1,0,1
62767,140,14862,20240;20425,38325,0,0,2,0,2
62768,140,14863,20384;23898,38325,0,0,2,0,2
62769,140,14864,20393;24918,38325,0,1,1,0,2
62770,140,14865,20063;20397,38325,0,0,2,0,2
62771,140,14866,20402;20793;24246;24710;24816;26334,38325,1,2,3,0,6
62772,140,14867,20407;20668,38325,0,0,2,0,2
62773,140,14868,20355;20718;24132,38325,0,0,3,0,3
62774,140,14869,20224;20484,38325,0,0,2,0,2
62775,140,14870,20909;21000;24154;24256;24925;26232;26237,38325,2,1,4,0,7
62776,140,14871,20015;20497;24229;24307;24581,38325,0,1,4,0,5
62777,140,14872,20499;20820;23815,38325,0,0,3,0,3
62778,140,14873,20649;20650;24239,38325,0,0,3,0,3
62779,140,14874,20231;20505,38325,0,0,2,0,2
62780,140,14876,20792;20990;23813;23922;25023,38325,0,1,4,0,5
62781,140,14877,20564;20640,38325,0,0,2,0,2
62782,140,14886,15600,38690,0,0,0,1,1
62783,140,14888,17627,38690,0,0,0,1,1
62784,140,14896,16691,38690,0,0,0,1,1
62785,140,14902,17426;18035,38690,0,0,0,2,2
62786,140,14906,17578;17791,38690,0,0,0,2,2
62787,140,14907,17589,38690,0,0,0,1,1
62788,140,14913,17844;18140,38690,0,0,0,2,2
62789,140,14915,17556,38690,0,0,0,1,1
62790,140,14916,17990,38690,0,0,0,1,1
62791,140,14920,19235,38690,0,0,0,1,1
62792,140,14921,18805;18994,38690,0,0,0,2,2
62793,140,14923,19582,38690,0,0,1,0,1
62794,140,14924,19372,38690,0,0,0,1,1
62795,140,14925,18576;18643;23009,38690,0,0,1,2,3
62796,140,14926,18719;18829,38690,0,0,0,2,2
62797,140,14928,18932,38690,0,0,0,1,1
62798,140,14931,18918;19012,38690,0,0,0,2,2
62799,140,14932,19174;19223,38690,0,0,0,2,2
62800,140,14933,19241;19670,38690,0,0,1,1,2
62801,140,14935,19742;24200;26234,38690,1,0,2,0,3
62802,140,14938,19425;19953,38690,0,0,1,1,2
62803,140,14939,19722,38690,0,0,1,0,1
62804,140,14940,19447;19563,38690,0,0,2,0,2
62805,140,14941,19085;19536,38690,0,0,1,1,2
62806,140,14942,19567;19921,38690,0,0,2,0,2
62807,140,14943,19621;20067,38690,0,0,2,0,2
62808,140,14945,19728;20199,38690,0,0,2,0,2
62809,140,14946,19507;19628,38690,0,0,2,0,2
62810,140,14947,19979;20055;24391,38690,0,0,3,0,3
62811,140,14948,19788,38690,0,0,1,0,1
62812,140,14949,19338;19869,38690,0,0,1,1,2
62813,140,14950,20106;20214;24209,38690,0,0,3,0,3
62814,140,14951,19847;20051,38690,0,0,2,0,2
62815,140,14952,19246;19867,38690,0,0,1,1,2
62816,140,14953,19413,38690,0,0,0,1,1
62817,140,14954,20245;20493;23998,38690,0,0,3,0,3
62818,140,14955,19961,38690,0,0,1,0,1
62819,140,14957,20040,38690,0,0,1,0,1
62820,140,14958,19720;20121;23876,38690,0,0,3,0,3
62821,140,14959,19992;20413;23899,38690,0,0,3,0,3
62822,140,14960,20394;24114,38690,0,0,2,0,2
62823,140,14961,19761;20134;24394,38690,0,0,3,0,3
62824,140,14962,19704;20145;23321;23648;24088,38690,0,0,5,0,5
62825,140,14963,20474,38690,0,0,1,0,1
62826,140,14964,19805;20181;24105,38690,0,0,3,0,3
62827,140,14965,20720;23376;24319;24705,38690,0,1,3,0,4
62828,140,14966,20235;20290;23775,38690,0,0,3,0,3
62829,140,14967,20056;20536;24488,38690,0,0,3,0,3
62830,140,14968,20373;24004,38690,0,0,2,0,2
62831,140,14969,20275;23567;24107,38690,0,0,3,0,3
62832,140,14970,20300;23357;23887,38690,0,0,3,0,3
62833,140,14972,20333;20399;24220,38690,0,0,3,0,3
62834,140,14973,20225;20595;24235,38690,0,0,3,0,3
62835,140,14974,20672;20723;24240,38690,0,0,3,0,3
62836,140,14977,20412;24304;24578,38690,0,1,2,0,3
62837,140,14978,20442;24117,38690,0,0,2,0,2
62838,140,14979,20802,38690,0,0,1,0,1
62839,140,14980,20451;20940;24254;24821,38690,0,1,3,0,4
62840,140,14981,20403;24226,38690,0,0,2,0,2
62841,140,14982,20488;20569,38690,0,0,2,0,2
62842,140,14983,20490;20605;24311,38690,0,0,3,0,3
62843,140,14984,20053;20378;23897;24005,38690,0,0,4,0,4
62844,140,14985,20415;20495;23484;23690,38690,0,0,4,0,4
62845,140,14986,20527;22881,38690,0,0,2,0,2
62846,140,14987,20570;24019;24403,38690,0,0,3,0,3
62847,140,14988,20007;20559,38690,0,0,2,0,2
62848,140,14989,20511;20576;24401,38690,0,0,3,0,3
62849,140,14990,20587;20863,38690,0,0,2,0,2
62850,140,14991,20624;20627,38690,0,0,2,0,2
62851,140,15004,16893,39055,0,0,0,1,1
62852,140,15022,18287;19170,39055,0,0,0,2,2
62853,140,15026,18915,39055,0,0,0,1,1
62854,140,15027,18322;19061,39055,0,0,0,2,2
62855,140,15029,18812,39055,0,0,0,1,1
62856,140,15030,18316;18726,39055,0,0,0,2,2
62857,140,15033,18536;18650,39055,0,0,0,2,2
62858,140,15035,19272;19463;24086,39055,0,0,2,1,3
62859,140,15038,19231,39055,0,0,0,1,1
62860,140,15041,19618,39055,0,0,1,0,1
62861,140,15042,19352;19559;23640,39055,0,0,2,1,3
62862,140,15043,19327;19614;23430,39055,0,0,2,1,3
62863,140,15044,19456,39055,0,0,1,0,1
62864,140,15047,19689;19856,39055,0,0,2,0,2
62865,140,15048,18981;19581,39055,0,0,1,1,2
62866,140,15049,19214;19723;23974,39055,0,0,2,1,3
62867,140,15051,19808;20144,39055,0,0,2,0,2
62868,140,15052,19651;19846;23068,39055,0,0,3,0,3
62869,140,15053,20087;20268;23565;24301,39055,0,0,4,0,4
62870,140,15057,19510;19648,39055,0,0,2,0,2
62871,140,15058,20498;23904,39055,0,0,2,0,2
62872,140,15059,20008;20088;23663;26319,39055,1,0,3,0,4
62873,140,15060,19605;20011,39055,0,0,2,0,2
62874,140,15062,20434;20688;24406;24701,39055,0,1,3,0,4
62875,140,15063,20680;20708;23283,39055,0,0,3,0,3
62876,140,15064,20114;20344,39055,0,0,2,0,2
62877,140,15065,20113;20120;24393,39055,0,0,3,0,3
62878,140,15066,20642;24237;24697;24810,39055,0,2,2,0,4
62879,140,15067,20166;20766;23811;23921;24708;25922,39055,1,1,4,0,6
62880,140,15068,20535,39055,0,0,1,0,1
62881,140,15069,20259;20606,39055,0,0,2,0,2
62882,140,15070,20553;20730;23284,39055,0,0,3,0,3
62883,140,15071,20440;20585;24234,39055,0,0,3,0,3
62884,140,15072,20281;20809,39055,0,0,2,0,2
62885,140,15073,20180;20291;24692,39055,0,1,2,0,3
62886,140,15076,20630;20862;24248,39055,0,0,3,0,3
62887,140,15077,20201;20435,39055,0,0,2,0,2
62888,140,15079,20100;20455,39055,0,0,2,0,2
62889,140,15080,20461;20538;23368;24231,39055,0,0,4,0,4
62890,140,15081,20463;20890,39055,0,0,2,0,2
62891,140,15082,20329;20375;24223,39055,0,0,3,0,3
62892,140,15083,20172;24475,39055,0,0,2,0,2
62893,140,15084,20932;25321,39055,0,1,1,0,2
62894,140,15085,20869;21013;24818,39055,0,1,2,0,3
62895,140,15086,20812;20949;24603;24718,39055,0,2,2,0,4
62896,140,15089,20547;24585,39055,0,1,1,0,2
62897,140,15090,20317;20552;23796;24490,39055,0,0,4,0,4
62898,140,15091,20340;20574;24491,39055,0,0,3,0,3
62899,140,15092,21048;24051;24512,39055,0,0,3,0,3
62900,140,15093,20598;24023,39055,0,0,2,0,2
62901,140,15094,20524;20626;23695;24126;24696,39055,0,1,4,0,5
62902,140,15095,20326;20636;23805,39055,0,0,3,0,3
62903,140,15096,20653,39055,0,0,1,0,1
62904,140,15097,20717,39055,0,0,1,0,1
62905,140,15098,20634;20692;24588,39055,0,1,2,0,3
62906,140,15099,20845;20924;24148;24600;26138,39055,1,1,3,0,5
62907,140,15100,20638;20746,39055,0,0,2,0,2
62908,140,15102,16013,39420,0,0,0,1,1
62909,140,15107,17240,39420,0,0,0,1,1
62910,140,15111,16618,39420,0,0,0,1,1
62911,140,15116,17414,39420,0,0,0,1,1
62912,140,15133,18291,39420,0,0,0,1,1
62913,140,15135,18682,39420,0,0,0,1,1
62914,140,15136,18518;18588,39420,0,0,0,2,2
62915,140,15137,19474;19502,39420,0,0,2,0,2
62916,140,15142,19026;19042,39420,0,0,0,2,2
62917,140,15144,20193;24476,39420,0,0,2,0,2
62918,140,15145,19406;19714;23227,39420,0,0,2,1,3
62919,140,15147,19205,39420,0,0,0,1,1
62920,140,15149,19464,39420,0,0,1,0,1
62921,140,15151,19713;20035,39420,0,0,2,0,2
62922,140,15154,20250;20369;24222,39420,0,0,3,0,3
62923,140,15155,19845;20101;23556;24204,39420,0,0,4,0,4
62924,140,15156,19460;19877,39420,0,0,2,0,2
62925,140,15158,19586;19968,39420,0,0,2,0,2
62926,140,15159,20643,39420,0,0,1,0,1
62927,140,15160,20123;24205,39420,0,0,2,0,2
62928,140,15161,20125;20155,39420,0,0,2,0,2
62929,140,15162,20130;20556,39420,0,0,2,0,2
62930,140,15164,20879;20935;24421,39420,0,0,3,0,3
62931,140,15165,20354,39420,0,0,1,0,1
62932,140,15168,20093;20363;24398,39420,0,0,3,0,3
62933,140,15169,20392;20635;24025;24127;26231,39420,1,0,4,0,5
62934,140,15170,20405;20472;23481,39420,0,0,3,0,3
62935,140,15171,20438;20777;24032;24323;24414,39420,0,0,5,0,5
62936,140,15172,20441;20756;23704;24595,39420,0,1,3,0,4
62937,140,15173,20140;20459;24305,39420,0,0,3,0,3
62938,140,15175,21163;23941;24347;26131,39420,1,0,3,0,4
62939,140,15176,20592;23800;23912;24310,39420,0,0,4,0,4
62940,140,15177,20216;20537;23793,39420,0,0,3,0,3
62941,140,15178,20210;20549;24232;24489,39420,0,0,4,0,4
62942,140,15179,20565;20861;24042;24419,39420,0,0,4,0,4
62943,140,15180,20567;20781,39420,0,0,2,0,2
62944,140,15181,20583;20753;23694;24309,39420,0,0,4,0,4
62945,140,15182,21100;24056;25140,39420,0,1,2,0,3
62946,140,15183,20632;20931;24252;24601,39420,0,1,3,0,4
62947,140,15184,20599;20641,39420,0,0,2,0,2
62948,140,15185,20817;21143,39420,0,0,2,0,2
62949,140,15186,20859,39420,0,0,1,0,1
62950,140,15187,20659;20673;24699,39420,0,1,2,0,3
62951,140,15188,20579;20660;24590,39420,0,1,2,0,3
62952,140,15189,20182;20690;24028;24407;24702;26134,39420,1,1,4,0,6
62953,140,15191,20597;20956;25135,39420,0,1,2,0,3
62954,140,15192,20382;20751;23919;24594;25020,39420,0,2,3,0,5
62955,140,15193,20769,39420,0,0,1,0,1
62956,140,15194,20785;20984;24826;25323,39420,0,2,2,0,4
62957,140,15195,20808;20971;24149;25136,39420,0,1,3,0,4
62958,140,15196,20810;24500,39420,0,0,2,0,2
62959,140,15197,20827;20948;23712,39420,0,0,3,0,3
62960,140,15198,20833;21050;24598;25025,39420,0,2,2,0,4
62961,140,15199,20652;20892;23928;25131,39420,0,1,3,0,4
62962,140,15202,16266,39785,0,0,0,1,1
62963,140,15206,16491;16797,39785,0,0,0,2,2
62964,140,15215,16882,39785,0,0,0,1,1
62965,140,15226,16804,39785,0,0,0,1,1
62966,140,15227,17686,39785,0,0,0,1,1
62967,140,15230,17987,39785,0,0,0,1,1
62968,140,15231,17799,39785,0,0,0,1,1
62969,140,15235,19050;22132,39785,0,0,1,1,2
62970,140,15243,19394,39785,0,0,0,1,1
62971,140,15247,19292;19523;23314,39785,0,0,2,1,3
62972,140,15248,19692;20160;24573,39785,0,1,2,0,3
62973,140,15250,19659;20062,39785,0,0,2,0,2
62974,140,15251,20209,39785,0,0,1,0,1
62975,140,15252,20048;20226,39785,0,0,2,0,2
62976,140,15253,19643;19976,39785,0,0,2,0,2
62977,140,15255,20044;23871,39785,0,0,2,0,2
62978,140,15257,19825;20072;23987,39785,0,0,3,0,3
62979,140,15258,20104;20321;23170;23784;23893;26225,39785,1,0,5,0,6
62980,140,15259,20163;20426,39785,0,0,2,0,2
62981,140,15260,20447;20745;24321,39785,0,0,3,0,3
62982,140,15261,20230;20301;23888,39785,0,0,3,0,3
62983,140,15262,20234,39785,0,0,1,0,1
62984,140,15263,20422;20591;24022;24492,39785,0,0,4,0,4
62985,140,15264,20264;23564;23676,39785,0,0,3,0,3
62986,140,15266,20324;20551;23691,39785,0,0,3,0,3
62987,140,15267,20396;20737;24496,39785,0,0,3,0,3
62988,140,15268,20334;20358;24575,39785,0,1,2,0,3
62989,140,15269,20345;23682;24480,39785,0,0,3,0,3
62990,140,15270,20357,39785,0,0,1,0,1
62991,140,15272,20377;20526;24583,39785,0,1,2,0,3
62992,140,15273,20153;20427;24227;26236,39785,1,0,3,0,4
62993,140,15274,20445;20506;23905;24230;24693,39785,0,1,4,0,5
62994,140,15275,20512;20515;23486;23792,39785,0,0,4,0,4
62995,140,15276,20368;20822,39785,0,0,2,0,2
62996,140,15277,20269;20563,39785,0,0,2,0,2
62997,140,15278,20682;20899;25132;25212,39785,0,2,2,0,4
62998,140,15279,20590;20963,39785,0,0,2,0,2
62999,140,15280,21204;21266;25043,39785,0,1,2,0,3
63000,140,15281,21055;24834,39785,0,1,1,0,2
63001,140,15282,20507;20739;24497;24707,39785,0,1,3,0,4
63002,140,15283,20644;20677,39785,0,0,2,0,2
63003,140,15284,20691;20778;24596,39785,0,1,2,0,3
63004,140,15285,20694,39785,0,0,1,0,1
63005,140,15286,20466;20689;24400;24485,39785,0,0,4,0,4
63006,140,15287,20529;20714;24409;24812,39785,0,1,3,0,4
63007,140,15288,21036;21138;24611,39785,0,1,2,0,3
63008,140,15289,20725;20976;23823;24605;24823,39785,0,2,3,0,5
63009,140,15290,20731;24133;25129,39785,0,1,2,0,3
63010,140,15292,20748;20964,39785,0,0,2,0,2
63011,140,15293,20762;23379;24813;25211,39785,0,2,2,0,4
63012,140,15294,20568;20763;23705;24412;24814,39785,0,1,4,0,5
63013,140,15295,20773;20945;24135,39785,0,0,3,0,3
63014,140,15296,20783;24415,39785,0,0,2,0,2
63015,140,15297,20844;21058,39785,0,0,2,0,2
63016,140,15298,20847;20939;24503,39785,0,0,3,0,3
63017,140,15299,20724;21072;25326,39785,0,1,2,0,3
63018,140,15300,21119;21171;25041,39785,0,1,2,0,3
63019,140,15301,20770;20871;24043;24420,39785,0,0,4,0,4
63020,140,15302,20893;21124;23719;24057;24516;24841;25219,39785,0,2,5,0,7
63021,140,15303,20961;21052,39785,0,0,2,0,2
63022,140,15304,20923;24717,39785,0,1,1,0,2
63023,140,15306,21086;21096;25218,39785,0,1,2,0,3
63024,140,15307,20385;21038;24833,39785,0,1,2,0,3
63025,140,15314,16649,40150,0,0,0,1,1
63026,140,15316,16713,40150,0,0,0,1,1
63027,140,15320,16914;17633,40150,0,0,0,2,2
63028,140,15322,17067;17261,40150,0,0,0,2,2
63029,140,15326,17584;17612,40150,0,0,0,2,2
63030,140,15328,17443,40150,0,0,0,1,1
63031,140,15332,18069;18633,40150,0,0,0,2,2
63032,140,15336,18618;19152,40150,0,0,0,2,2
63033,140,15341,18846;19348;23743;26223,40150,1,0,1,2,4
63034,140,15344,19113,40150,0,0,0,1,1
63035,140,15347,19378;19458,40150,0,0,1,1,2
63036,140,15351,19441,40150,0,0,1,0,1
63037,140,15354,19758;19890;23445,40150,0,0,3,0,3
63038,140,15356,20001;20600;24694,40150,0,1,2,0,3
63039,140,15357,19588;20175,40150,0,0,2,0,2
63040,140,15358,20016;20251;24106,40150,0,0,3,0,3
63041,140,15360,19792;20061,40150,0,0,2,0,2
63042,140,15361,20077;20374;23790,40150,0,0,3,0,3
63043,140,15363,19902;20131,40150,0,0,2,0,2
63044,140,15364,20080;20410;24483,40150,0,0,3,0,3
63045,140,15365,20922;23778;24422;25320,40150,0,1,3,0,4
63046,140,15366,20319;20335;24479,40150,0,0,3,0,3
63047,140,15367,20520;20594;23906;25722,40150,0,1,3,0,4
63048,140,15369,20408;20927;24423,40150,0,0,3,0,3
63049,140,15370,20421;20696;23597;24703,40150,0,1,3,0,4
63050,140,15372,20339;20439,40150,0,0,2,0,2
63051,140,15373,20485;20613,40150,0,0,2,0,2
63052,140,15374,20409;20492;24228;24486;24580,40150,0,1,4,0,5
63053,140,15375,20277,40150,0,0,1,0,1
63054,140,15376,20811;24817,40150,0,1,1,0,2
63055,140,15378,20483,40150,0,0,1,0,1
63056,140,15379,20667;20998;24153;24719;26333,40150,1,1,3,0,5
63057,140,15381,20639;20959;24255,40150,0,0,3,0,3
63058,140,15382,20341;20754,40150,0,0,2,0,2
63059,140,15383,21281;24734,40150,0,1,1,0,2
63060,140,15384,20896;21284;23949;24353;24937,40150,0,1,4,0,5
63061,140,15385,20816;23710,40150,0,0,2,0,2
63062,140,15386,20828;21022;25138,40150,0,1,2,0,3
63063,140,15388,20854;20966;23934;24425;24822,40150,0,1,4,0,5
63064,140,15389,20710;21154;24729,40150,0,1,2,0,3
63065,140,15390,21196;21312;23721;24519;24622;24933;25221;25624,40150,0,4,4,0,8
63066,140,15392,20946;20985;24606,40150,0,1,2,0,3
63067,140,15393,20895;21198,40150,0,0,2,0,2
63068,140,15394,20926;20943;25134,40150,0,1,2,0,3
63069,140,15397,20874;21103;24929,40150,0,1,2,0,3
63070,140,15398,20977;21181;24340;25519;26335,40150,1,1,3,0,5
63071,140,15399,21238;21344;24437;24522;25046,40150,0,1,4,0,5
63072,140,15400,21011;21159;24050;24721,40150,0,1,3,0,4
63073,140,15401,21012,40150,0,0,1,0,1
63074,140,15402,16752,40515,0,0,0,1,1
63075,140,15405,17113,40515,0,0,0,1,1
63076,140,15407,17170,40515,0,0,0,1,1
63077,140,15417,18077;18816,40515,0,0,0,2,2
63078,140,15426,18685;19164,40515,0,0,0,2,2
63079,140,15427,18773;19340,40515,0,0,0,2,2
63080,140,15429,18802;19179,40515,0,0,0,2,2
63081,140,15436,19762;20070,40515,0,0,2,0,2
63082,140,15438,19607;19796,40515,0,0,2,0,2
63083,140,15439,19584;19812,40515,0,0,2,0,2
63084,140,15443,19893;20118;24101;24295,40515,0,0,4,0,4
63085,140,15444,19597,40515,0,0,1,0,1
63086,140,15445,19896;20611,40515,0,0,2,0,2
63087,140,15446,20311;23891,40515,0,0,2,0,2
63088,140,15448,20327;20814;23709;23923;24140;26031,40515,1,0,5,0,6
63089,140,15449,20124;20208,40515,0,0,2,0,2
63090,140,15451,20302;20370;24481,40515,0,0,3,0,3
63091,140,15454,20256;20795,40515,0,0,2,0,2
63092,140,15455,20039;20303;23889;24109;24302,40515,0,0,5,0,5
63093,140,15456,20310;20684,40515,0,0,2,0,2
63094,140,15457,20607;20620;24809;24919,40515,0,2,2,0,4
63095,140,15458,20372;20437;23480,40515,0,0,3,0,3
63096,140,15459,20156;20457;25014,40515,0,1,2,0,3
63097,140,15460,20450;20818;23924;25517,40515,0,1,3,0,4
63098,140,15461,20480;20736;24243;24320;24411;24495;24593,40515,0,1,6,0,7
63099,140,15463,20728;24410;24921,40515,0,1,2,0,3
63100,140,15465,20342;20541,40515,0,0,2,0,2
63101,140,15466,20995;25137,40515,0,1,1,0,2
63102,140,15467,20674;20780;24033,40515,0,0,3,0,3
63103,140,15468,20826;21025;23938;25923,40515,1,0,3,0,4
63104,140,15470,20679;20996;23935;24429;24924,40515,0,1,4,0,5
63105,140,15471,20338;20807;24037;24139,40515,0,0,4,0,4
63106,140,15472,20453;20697,40515,0,0,2,0,2
63107,140,15473,20489;20699;24316;24920,40515,0,1,3,0,4
63108,140,15474,20712;24242;24318,40515,0,0,3,0,3
63109,140,15475,20801;25024,40515,0,1,1,0,2
63110,140,15476,20646;20791;23707;24137;24325;25022,40515,0,1,5,0,6
63111,140,15477,20707;20823;24326;24501,40515,0,0,4,0,4
63112,140,15478,21015;23937;24830,40515,0,1,2,0,3
63113,140,15479,21164;25040,40515,0,1,1,0,2
63114,140,15480,21114,40515,0,0,1,0,1
63115,140,15481,20912;20997;25029,40515,0,1,2,0,3
63116,140,15482,20917;24506,40515,0,0,2,0,2
63117,140,15483,21311,40515,0,0,1,0,1
63118,140,15484,20889;20942,40515,0,0,2,0,2
63119,140,15485,20947;21066;24433,40515,0,0,3,0,3
63120,140,15486,20732;20952;24424;24508,40515,0,0,4,0,4
63121,140,15487,21201;21254;24623;24730,40515,0,2,2,0,4
63122,140,15488,20968;21487;24643;25348;25924,40515,1,2,2,0,5
63123,140,15489,20983;21037;24825,40515,0,1,2,0,3
63124,140,15490,20656;21008;23936;24510;24610,40515,0,1,4,0,5
63125,140,15491,21028;21130;24842;25329,40515,0,2,2,0,4
63126,140,15492,21412;21552;24449;25231,40515,0,1,3,0,4
63127,140,15493,21053;21298;24633,40515,0,1,2,0,3
63128,140,15494,21065;21232;24059;25223,40515,0,1,3,0,4
63129,140,15495,21085;21321;23951;24737;24939,40515,0,2,3,0,5
63130,140,15496,21814;23962;24555,40515,0,0,3,0,3
63131,140,15497,21120,40515,0,0,1,0,1
63132,140,15498,21121;21427;24069;24852,40515,0,1,3,0,4
63133,140,15499,21151;21308;24735;24938;25049,40515,0,3,2,0,5
63134,140,15500,21153;21486,40515,0,0,2,0,2
63135,140,15501,21200;21408;25222,40515,0,1,2,0,3
63136,140,15502,21160;21245;24523,40515,0,0,3,0,3
63137,140,15504,16444,40880,0,0,0,1,1
63138,140,15515,17127,40880,0,0,0,1,1
63139,140,15518,17798,40880,0,0,0,1,1
63140,140,15520,17442,40880,0,0,0,1,1
63141,140,15523,18345,40880,0,0,0,1,1
63142,140,15524,18478;18586,40880,0,0,0,2,2
63143,140,15529,19010;19073,40880,0,0,0,2,2
63144,140,15530,18824;19501,40880,0,0,1,1,2
63145,140,15536,19666;19749,40880,0,0,2,0,2
63146,140,15539,19948;22165,40880,0,0,2,0,2
63147,140,15540,20107;20223;23994,40880,0,0,3,0,3
63148,140,15541,19677,40880,0,0,1,0,1
63149,140,15542,20068;20391,40880,0,0,2,0,2
63150,140,15543,20054;20315;23086,40880,0,0,3,0,3
63151,140,15544,20084;20285;23569;24217;26120,40880,1,0,4,0,5
63152,140,15545,20742;20774;25019,40880,0,1,2,0,3
63153,140,15546,20248;20701;24317;24408;24494;24704,40880,0,1,5,0,6
63154,140,15547,20045;20138,40880,0,0,2,0,2
63155,140,15548,20436;23278,40880,0,0,2,0,2
63156,140,15549,20085;20522;23907;26029,40880,1,0,3,0,4
63157,140,15550,20727;23810;24706,40880,0,1,2,0,3
63158,140,15551,21031;21106,40880,0,0,2,0,2
63159,140,15552,20589;21440,40880,0,0,2,0,2
63160,140,15553,20604;20950;23821,40880,0,0,3,0,3
63161,140,15554,20157;20618;23803;24587;25822,40880,0,2,3,0,5
63162,140,15555,20934;21004;24829,40880,0,1,2,0,3
63163,140,15556,20207;20544;23176,40880,0,0,3,0,3
63164,140,15557,20704;20994,40880,0,0,2,0,2
63165,140,15558,20800;20978;23603;23814;24499;24711;26028,40880,1,1,5,0,7
63166,140,15559,20804;20813;24138,40880,0,0,3,0,3
63167,140,15560,20919;23930;24147;24251;24716,40880,0,1,4,0,5
63168,140,15561,20842,40880,0,0,1,0,1
63169,140,15562,20722;21088;24928;25327,40880,0,2,2,0,4
63170,140,15563,20898;21464;24274;25156;25233,40880,0,2,3,0,5
63171,140,15564,20662;25128,40880,0,1,1,0,2
63172,140,15565,20615;21057;24723,40880,0,1,2,0,3
63173,140,15566,21420;21422;24743;25153,40880,0,2,2,0,4
63174,140,15568,21064;21341;24528;25426,40880,0,1,3,0,4
63175,140,15569,20992;21046;25324,40880,0,1,2,0,3
63176,140,15570,21410;21479;23731;24748,40880,0,1,3,0,4
63177,140,15571,21010;24258;25520,40880,0,1,2,0,3
63178,140,15573,21054;21416;24851,40880,0,1,2,0,3
63179,140,15574,21081;21315;24174;24736;25050,40880,0,2,3,0,5
63180,140,15575,21287;21463;24855,40880,0,1,2,0,3
63181,140,15576,21236;21732;24935;25143;25335,40880,0,3,2,0,5
63182,140,15577,20700;21137;24161,40880,0,0,3,0,3
63183,140,15578,20843;21161;23834;25332,40880,0,1,3,0,4
63184,140,15580,21172;21457;25423,40880,0,1,2,0,3
63185,140,15581,20970;21177,40880,0,0,2,0,2
63186,140,15582,21188;21547;25239,40880,0,1,2,0,3
63187,140,15583,20758;21206;24844,40880,0,1,2,0,3
63188,140,15584,21021;21211;24520;24624,40880,0,1,3,0,4
63189,140,15585,21230;24627;24934,40880,0,2,1,0,3
63190,140,15586,21249;21355,40880,0,0,2,0,2
63191,140,15587,20794;21256,40880,0,0,2,0,2
63192,140,15588,21262;21353;23947,40880,0,0,3,0,3
63193,140,15589,21009;21276;25823,40880,1,0,2,0,3
63194,140,15590,21280;21313;24173;24355;24527;25339;25425,40880,0,2,5,0,7
63195,140,15591,21283;24066;24848;24943;25053,40880,0,3,2,0,5
63196,140,15592,21128;21286;24269,40880,0,0,3,0,3
63197,140,15596,17587;17648,41245,0,0,0,2,2
63198,140,15598,17650;18177,41245,0,0,0,2,2
63199,140,15599,17778,41245,0,0,0,1,1
63200,140,15600,17267,41245,0,0,0,1,1
63201,140,15601,17415;17774,41245,0,0,0,2,2
63202,140,15608,17822,41245,0,0,0,1,1
63203,140,15609,18124,41245,0,0,0,1,1
63204,140,15614,18833;19301,41245,0,0,0,2,2
63205,140,15616,19167,41245,0,0,0,1,1
63206,140,15622,19382,41245,0,0,0,1,1
63207,140,15629,20116;20593,41245,0,0,2,0,2
63208,140,15631,19977;20312;24219,41245,0,0,3,0,3
63209,140,15632,20414;20523,41245,0,0,2,0,2
63210,140,15633,21039;21167;25422,41245,0,1,2,0,3
63211,140,15634,20513;20839;24418,41245,0,0,3,0,3
63212,140,15636,20654;20870,41245,0,0,2,0,2
63213,140,15637,20663;21123;24614;24840;24931,41245,0,3,2,0,5
63214,140,15638,20629;20678;23595;24404;24700;26220,41245,1,1,4,0,6
63215,140,15639,20470;20683;23807,41245,0,0,3,0,3
63216,140,15640,20768;20910;23929;24046;24715,41245,0,1,4,0,5
63217,140,15641,20278;20799,41245,0,0,2,0,2
63218,140,15643,20864;21142,41245,0,0,2,0,2
63219,140,15644,21465;25157,41245,0,1,1,0,2
63220,140,15646,20887;21045;24261;24926,41245,0,1,3,0,4
63221,140,15647,20829;20888;24045,41245,0,0,3,0,3
63222,140,15649,21002;21074;23939;24515;26229;26329,41245,2,0,4,0,6
63223,140,15650,20951;21220;24436;25045;25521,41245,0,2,3,0,5
63224,140,15651,20907;20989;24607;24827;25215,41245,0,3,2,0,5
63225,140,15652,21047;21397,41245,0,0,2,0,2
63226,140,15653,21110;24434,41245,0,0,2,0,2
63227,140,15654,21070;21415,41245,0,0,2,0,2
63228,140,15655,21092;21115,41245,0,0,2,0,2
63229,140,15656,21428;25523,41245,0,1,1,0,2
63230,140,15657,21449;21482,41245,0,0,2,0,2
63231,140,15658,20993;21145;24264;24619;25330,41245,0,2,3,0,5
63232,140,15659,21162;21243;24630;24936;25047,41245,0,3,2,0,5
63233,140,15660,20744;21217,41245,0,0,2,0,2
63234,140,15661,21418;21591;24276;25733,41245,0,1,3,0,4
63235,140,15662,21680;24767,41245,0,1,1,0,2
63236,140,15663,21197;21247;23946;25144;25224,41245,0,2,3,0,5
63237,140,15664,21250,41245,0,0,1,0,1
63238,140,15665,21329;21683;24768;25439,41245,0,2,2,0,4
63239,140,15666,20849;21259;24350;24631;24732,41245,0,2,3,0,5
63240,140,15667,21253;21613;25065,41245,0,1,2,0,3
63241,140,15668,21270;21662,41245,0,0,2,0,2
63242,140,15669,20925;21278;25337,41245,0,1,2,0,3
63243,140,15670,21291;21534;25237;25436;25732,41245,0,3,2,0,5
63244,140,15671,21304;21471,41245,0,0,2,0,2
63245,140,15672,20986;21305;24526,41245,0,0,3,0,3
63246,140,15673,21320;24440;24634;25147;25630,41245,0,3,2,0,5
63247,140,15674,21061;21332;24063;25341,41245,0,1,3,0,4
63248,140,15675,21297;21345;23399;24529,41245,0,0,4,0,4
63249,140,15676,21186;21326;25340;25631;26034,41245,1,2,2,0,5
63250,140,15677,21511;24752,41245,0,1,1,0,2
63251,140,15678,21600;23845,41245,0,0,2,0,2
63252,140,15679,21260;21393;24448,41245,0,0,3,0,3
63253,140,15680,21400;21446;24534;25230,41245,0,1,3,0,4
63254,140,15681,21401;21426;24535;25345,41245,0,1,3,0,4
63255,140,15693,17203,41610,0,0,0,1,1
63256,140,15703,18149;18211,41610,0,0,0,2,2
63257,140,15704,18062,41610,0,0,0,1,1
63258,140,15706,18532;18680,41610,0,0,0,2,2
63259,140,15709,19116;22703,41610,0,0,1,1,2
63260,140,15710,18904;23856,41610,0,0,1,1,2
63261,140,15718,19580;19973,41610,0,0,2,0,2
63262,140,15720,19974,41610,0,0,1,0,1
63263,140,15725,19435;19996,41610,0,0,2,0,2
63264,140,15726,20012;20233;23881,41610,0,0,3,0,3
63265,140,15727,19782;20276,41610,0,0,2,0,2
63266,140,15728,20041;20487,41610,0,0,2,0,2
63267,140,15731,20257;23084,41610,0,0,2,0,2
63268,140,15733,20192;20253;23884;24478;25920,41610,1,0,4,0,5
63269,140,15734,20282;20309;24215,41610,0,0,3,0,3
63270,140,15736,20533;20575;24807,41610,0,1,2,0,3
63271,140,15737,20464;21240;24168;24349;24629,41610,0,1,4,0,5
63272,140,15738,20991;24428,41610,0,0,2,0,2
63273,140,15740,20612;20711;24592,41610,0,1,2,0,3
63274,140,15741,20623;20831;23713,41610,0,0,3,0,3
63275,140,15742,20960;20979,41610,0,0,2,0,2
63276,140,15743,20560;20721;23910,41610,0,0,3,0,3
63277,140,15744,20467;20757,41610,0,0,2,0,2
63278,140,15745,20765;21060;24432;24836;25216;25325,41610,0,3,3,0,6
63279,140,15746,20665,41610,0,0,1,0,1
63280,140,15747,20776;21271;25336,41610,0,1,2,0,3
63281,140,15748,20779;23287;24815,41610,0,1,2,0,3
63282,140,15749,20596;20855;23817;24599,41610,0,1,3,0,4
63283,140,15750,20798;20835;24417;24502,41610,0,0,4,0,4
63284,140,15751,20454;20878;24505;24714,41610,0,1,3,0,4
63285,140,15752,20884;21056;24722,41610,0,1,2,0,3
63286,140,15754,20726;20936,41610,0,0,2,0,2
63287,140,15755,20938;21112;24253;24507;25214,41610,0,1,4,0,5
63288,140,15758,21014;21076;24725;25726,41610,0,2,2,0,4
63289,140,15760,20897;21084;23940;24342,41610,0,0,4,0,4
63290,140,15761,21147,41610,0,0,1,0,1
63291,140,15762,21156;21314,41610,0,0,2,0,2
63292,140,15763,21202;21327,41610,0,0,2,0,2
63293,140,15764,21180;21339,41610,0,0,2,0,2
63294,140,15766,20825;21157;24346;24518;24621,41610,0,1,4,0,5
63295,140,15767,20916;21269;24268;24351;24439;25522;25629,41610,0,2,5,0,7
63296,140,15768,21273;21433;24070;24361;25154;25430,41610,0,2,4,0,6
63297,140,15769,21342,41610,0,0,1,0,1
63298,140,15770,21290;24632;25145,41610,0,2,1,0,3
63299,140,15771,21335,41610,0,0,1,0,1
63300,140,15772,21608;21829;25255,41610,0,1,2,0,3
63301,140,15773,21716,41610,0,0,1,0,1
63302,140,15775,21203;21383,41610,0,0,2,0,2
63303,140,15776,21364;21384;24068,41610,0,0,3,0,3
63304,140,15777,21221;21621;25242;25531,41610,0,2,2,0,4
63305,140,15778,16903,41975,0,0,0,1,1
63306,140,15779,17039,41975,0,0,0,1,1
63307,140,15780,16953,41975,0,0,0,1,1
63308,140,15782,17120,41975,0,0,0,1,1
63309,140,15785,17462,41975,0,0,0,1,1
63310,140,15787,17776,41975,0,0,0,1,1
63311,140,15788,17610;18057,41975,0,0,0,2,2
63312,140,15789,18152,41975,0,0,0,1,1
63313,140,15790,18558,41975,0,0,0,1,1
63314,140,15798,18566;18985,41975,0,0,0,2,2
63315,140,15801,19207;19854,41975,0,0,1,1,2
63316,140,15806,19851;19930,41975,0,0,2,0,2
63317,140,15807,20178;20183;23879,41975,0,0,3,0,3
63318,140,15808,20465;22765;24399;25017;25502,41975,0,2,3,0,5
63319,140,15811,20360;20805,41975,0,0,2,0,2
63320,140,15812,20388,41975,0,0,1,0,1
63321,140,15814,20366;20477,41975,0,0,2,0,2
63322,140,15815,19675;19920;22746;23659;25302;25879;26072,41975,2,1,4,0,7
63323,140,15817,20337;20657;24493,41975,0,0,3,0,3
63324,140,15819,20186;20584,41975,0,0,2,0,2
63325,140,15820,20918;21020;24430,41975,0,0,3,0,3
63326,140,15821,20610;21018;24831,41975,0,1,2,0,3
63327,140,15822,20920;20999;24509;24608;24828,41975,0,2,3,0,5
63328,140,15823,20411;20631,41975,0,0,2,0,2
63329,140,15824,20675;20840,41975,0,0,2,0,2
63330,140,15825,20572;20974;24427,41975,0,0,3,0,3
63331,140,15827,20755;21042;24341;24511,41975,0,0,4,0,4
63332,140,15828,20313;20788;24597;25421,41975,0,2,2,0,4
63333,140,15829,20876;20937;24048;24334;24602,41975,0,1,4,0,5
63334,140,15830,20906;21040,41975,0,0,2,0,2
63335,140,15831,21184;21295;24171,41975,0,0,3,0,3
63336,140,15833,21001;21394;24609;24720,41975,0,2,2,0,4
63337,140,15834,21027;21607,41975,0,0,2,0,2
63338,140,15835,20921;21347;23837;24270;24941;25625,41975,0,2,4,0,6
63339,140,15836,21111;21318;23728;25227,41975,0,1,3,0,4
63340,140,15837,21475;24857,41975,0,1,1,0,2
63341,140,15838,20709;21132;23831;24616;24932,41975,0,2,3,0,5
63342,140,15839,21078;21152;24345;24517;24728,41975,0,1,4,0,5
63343,140,15841,21192;21532;25731,41975,0,1,2,0,3
63344,140,15842,21209;21579;24648,41975,0,1,2,0,3
63345,140,15843,21224;24166;25141,41975,0,1,2,0,3
63346,140,15844,21411;21633;24370;24653,41975,0,1,3,0,4
63347,140,15845,20882;21231;24845,41975,0,1,2,0,3
63348,140,15846,21664;21763;25541,41975,0,1,2,0,3
63349,140,15847,20772;20797;24413;24709,41975,0,1,3,0,4
63350,140,15848,21277;21285,41975,0,0,2,0,2
63351,140,15849,21023;21374;24636,41975,0,1,2,0,3
63352,140,15850,21043;21306,41975,0,0,2,0,2
63353,140,15851,21316;21551;24758;25526;25926,41975,1,2,2,0,5
63354,140,15852,21358;21719,41975,0,0,2,0,2
63355,140,15853,21359;21531,41975,0,0,2,0,2
63356,140,15854,21182;21369;24942;25052,41975,0,2,2,0,4
63357,140,15855,21030;21395;24533;24638,41975,0,1,3,0,4
63358,140,15858,21109;21787;24554;24872;25073,41975,0,2,3,0,5
63359,140,15859,21402;21494;24955;25158;25234,41975,0,3,2,0,5
63360,140,15860,21514;21623;25159;25434,41975,0,2,2,0,4
63361,140,15861,21456;21550;24757;25061,41975,0,2,2,0,4
63362,140,15863,21328;21589;23625;24650,41975,0,1,3,0,4
63363,140,15864,21302;21595,41975,0,0,2,0,2
63364,140,15865,16915,42340,0,0,0,1,1
63365,140,15866,17173,42340,0,0,0,1,1
63366,140,15867,17341,42340,0,0,0,1,1
63367,140,15870,17562,42340,0,0,0,1,1
63368,140,15871,17781,42340,0,0,0,1,1
63369,140,15876,18320,42340,0,0,0,1,1
63370,140,15881,18166,42340,0,0,0,1,1
63371,140,15885,18957;19468,42340,0,0,1,1,2
63372,140,15886,18714;18917,42340,0,0,0,2,2
63373,140,15887,19181;19555,42340,0,0,1,1,2
63374,140,15888,19114;19549,42340,0,0,1,1,2
63375,140,15891,19427;19759,42340,0,0,2,0,2
63376,140,15892,19757;23872;25919,42340,1,0,2,0,3
63377,140,15895,19545;19735,42340,0,0,2,0,2
63378,140,15897,19971;20079,42340,0,0,2,0,2
63379,140,15898,20187;20578;24122,42340,0,0,3,0,3
63380,140,15899,20060;20271;24213,42340,0,0,3,0,3
63381,140,15901,20076;20151,42340,0,0,2,0,2
63382,140,15905,20228;20238;23880,42340,0,0,3,0,3
63383,140,15907,20032;20351;24576,42340,0,1,2,0,3
63384,140,15909,20586;20670,42340,0,0,2,0,2
63385,140,15911,20655;21093;24613,42340,0,1,2,0,3
63386,140,15913,20954;21107;25038,42340,0,1,2,0,3
63387,140,15915,20747;21003;24155;25032,42340,0,1,3,0,4
63388,140,15918,20836;20900;24143;24820,42340,0,1,3,0,4
63389,140,15919,20619;21199;25628,42340,0,1,2,0,3
63390,140,15921,20881;25130;25518,42340,0,2,1,0,3
63391,140,15922,20905;20914;25030,42340,0,1,2,0,3
63392,140,15923,20953;21067;24514,42340,0,0,3,0,3
63393,140,15924,21075;21675;24968;25245,42340,0,2,2,0,4
63394,140,15925,21125;21481;24539;24953,42340,0,1,3,0,4
63395,140,15927,21227,42340,0,0,1,0,1
63396,140,15928,21523;21978;24465;24562;25751,42340,0,1,4,0,5
63397,140,15929,21189;21292;25333,42340,0,1,2,0,3
63398,140,15930,21158;21303,42340,0,0,2,0,2
63399,140,15931,21141;21301,42340,0,0,2,0,2
63400,140,15933,21006;21387;23617;24637,42340,0,1,3,0,4
63401,140,15934,21761;21909,42340,0,0,2,0,2
63402,140,15935,21417;21828,42340,0,0,2,0,2
63403,140,15937,21431;22017;26242,42340,1,0,2,0,3
63404,140,15938,21434;21833,42340,0,0,2,0,2
63405,140,15939,21376;21436;24536;24853;25346,42340,0,2,3,0,5
63406,140,15940,21466;21561;24362;24642;25431,42340,0,2,3,0,5
63407,140,15941,21176;21483;24540;24954,42340,0,1,3,0,4
63408,140,15942,21354;21515;25235;25633,42340,0,2,2,0,4
63409,140,15943,20962;21496;24750,42340,0,1,2,0,3
63410,140,15944,21670;24549,42340,0,0,2,0,2
63411,140,15945,21562;24963;25528,42340,0,2,1,0,3
63412,140,15946,21580,42340,0,0,1,0,1
63413,140,15947,21844;24876;25077;25930,42340,1,2,1,0,4
63414,140,15948,21553;21583;24762,42340,0,1,2,0,3
63415,140,15949,21212;21587;24860,42340,0,1,2,0,3
63416,140,15950,21605;21913,42340,0,0,2,0,2
63417,140,15951,21612;24543;24861;24964,42340,0,2,2,0,4
63418,140,15952,21185;21614;24077;25066,42340,0,1,3,0,4
63419,140,15953,21616;21827;24461,42340,0,0,3,0,3
63420,140,15954,21631;21840;24279;24652;25067;25534,42340,0,3,3,0,6
63421,140,15955,21309;21645;25243,42340,0,1,2,0,3
63422,140,15956,21648;22024;24565;25372,42340,0,1,3,0,4
63423,140,15957,21615,42340,0,0,1,0,1
63424,140,15958,21062;21692;24372;24657;25166;25538;25828,42340,1,3,3,0,7
63425,140,15959,21703;21951;25088;25260,42340,0,2,2,0,4
63426,140,15960,21213;21704;23961,42340,0,0,3,0,3
63427,140,15961,17228,42705,0,0,0,1,1
63428,140,15965,17705,42705,0,0,0,1,1
63429,140,15967,16889,42705,0,0,0,1,1
63430,140,15972,18280,42705,0,0,0,1,1
63431,140,15973,18409,42705,0,0,0,1,1
63432,140,15983,19347,42705,0,0,0,1,1
63433,140,15987,20387;20608;24695,42705,0,1,2,0,3
63434,140,15988,20217;20543,42705,0,0,2,0,2
63435,140,15989,20270;24000,42705,0,0,2,0,2
63436,140,15990,19809,42705,0,0,1,0,1
63437,140,15992,20546;23272;24808,42705,0,1,2,0,3
63438,140,15995,20601;20957;25322,42705,0,1,2,0,3
63439,140,15997,20764;24244;25021,42705,0,1,2,0,3
63440,140,15998,21522;23623;24073,42705,0,0,3,0,3
63441,140,15999,20504;20821;23605;24416,42705,0,0,4,0,4
63442,140,16001,20901;20987;24250;24749;24923;25058,42705,0,3,3,0,6
63443,140,16002,20254;20494,42705,0,0,2,0,2
63444,140,16003,20775;21222,42705,0,0,2,0,2
63445,140,16004,21136;21261;24617,42705,0,1,2,0,3
63446,140,16005,21191;25334;25627;25727,42705,0,3,1,0,4
63447,140,16006,21210;21533;24647;25161,42705,0,2,2,0,4
63448,140,16007,20614;21263;24846;25728,42705,0,2,2,0,4
63449,140,16008,21724,42705,0,0,1,0,1
63450,140,16009,21275;21712,42705,0,0,2,0,2
63451,140,16010,20796;21336;24738,42705,0,1,2,0,3
63452,140,16012,20856;21357;24064;24443,42705,0,0,4,0,4
63453,140,16013,21363;24531;24740,42705,0,1,2,0,3
63454,140,16014,21468;24538;24856;25432,42705,0,2,2,0,4
63455,140,16015,21105;21377;24850,42705,0,1,2,0,3
63456,140,16016,21368;24357;24445,42705,0,0,3,0,3
63457,140,16017,21636;24765;24863;25734;25826,42705,1,3,1,0,5
63458,140,16018,21429;21689;24969;25068,42705,0,2,2,0,4
63459,140,16019,21409;21461;24946;25344,42705,0,2,2,0,4
63460,140,16020,20858;21389;24271;24447;25229,42705,0,1,4,0,5
63461,140,16021,21382;21490;24364;24454;25433,42705,0,1,4,0,5
63462,140,16022,21804;21858;25078;25362;25833,42705,1,2,2,0,5
63463,140,16023,21214;21503,42705,0,0,2,0,2
63464,140,16024,21618;21625,42705,0,0,2,0,2
63465,140,16025,21750;22138;25272,42705,0,1,2,0,3
63466,140,16026,21505;21527;24755;25060,42705,0,2,2,0,4
63467,140,16027,21666;21912;25178;25837,42705,1,1,2,0,4
63468,140,16028,21549;22131,42705,0,0,2,0,2
63469,140,16029,21558,42705,0,0,1,0,1
63470,140,16030,21571;24676,42705,0,1,1,0,2
63471,140,16031,21406;21895;25177;25550,42705,0,2,2,0,4
63472,140,16032,21225;21728;24459;25170;25830,42705,1,1,3,0,5
63473,140,16033,21447;21671;24865;24967,42705,0,2,2,0,4
63474,140,16034,21274;21455;24854;25232;25632,42705,0,3,2,0,5
63475,140,16035,22053;24674;24889,42705,0,2,1,0,3
63476,140,16036,21715;22008;24378;24987,42705,0,1,3,0,4
63477,140,16037,21722;24770;24971,42705,0,2,1,0,3
63478,140,16038,21766;21866;24981;25257,42705,0,2,2,0,4
63479,140,16039,21773;22056;25357;25444,42705,0,2,2,0,4
63480,140,16040,21668;21777;24080;25072,42705,0,1,3,0,4
63481,140,16041,21780;21819;25639,42705,0,1,2,0,3
63482,140,16042,21272;21792;25251,42705,0,1,2,0,3
63483,140,16043,21798;22160;25658,42705,0,1,2,0,3
63484,140,16044,21781;21801;25074,42705,0,1,2,0,3
63485,140,16045,21678;21893;25081;25744,42705,0,2,2,0,4
63486,140,16046,17263,43070,0,0,0,1,1
63487,140,16047,17287,43070,0,0,0,1,1
63488,140,16049,17310,43070,0,0,0,1,1
63489,140,16050,17233,43070,0,0,0,1,1
63490,140,16052,17743,43070,0,0,0,1,1
63491,140,16061,17974,43070,0,0,0,1,1
63492,140,16062,18709,43070,0,0,0,1,1
63493,140,16064,18822;19479;23854,43070,0,0,2,1,3
63494,140,16074,19794;20033,43070,0,0,2,0,2
63495,140,16077,19418;20158,43070,0,0,1,1,2
63496,140,16078,19711;20119,43070,0,0,2,0,2
63497,140,16081,20468,43070,0,0,1,0,1
63498,140,16082,20518;21007;25033,43070,0,1,2,0,3
63499,140,16084,20729;21155,43070,0,0,2,0,2
63500,140,16085,20449;20738,43070,0,0,2,0,2
63501,140,16087,20266;20875;24819;25027,43070,0,2,2,0,4
63502,140,16089,20903;21174,43070,0,0,2,0,2
63503,140,16090,20972;21135;24150,43070,0,0,3,0,3
63504,140,16091,21024;21140,43070,0,0,2,0,2
63505,140,16092,21257;21361;24065;24444;25724;26135,43070,1,1,4,0,6
63506,140,16093,21099;21518;24184;24644;24859;25236;25825,43070,1,3,3,0,7
63507,140,16096,21480;24952,43070,0,1,1,0,2
63508,140,16097,20867;21129;23818;23925;24249;24330;24713;25026,43070,0,2,6,0,8
63509,140,16098,21544;21581;24756,43070,0,1,2,0,3
63510,140,16099,21574;21816;24556;25253,43070,0,1,3,0,4
63511,140,16100,21718;21796;23737;25252;25542,43070,0,2,3,0,5
63512,140,16101,20975;21178,43070,0,0,2,0,2
63513,140,16102,20980;21267;23948;24169,43070,0,0,4,0,4
63514,140,16103,21289,43070,0,0,1,0,1
63515,140,16104,20886;21310,43070,0,0,2,0,2
63516,140,16105,21323;21333;25051,43070,0,1,2,0,3
63517,140,16106,21144;21423,43070,0,0,2,0,2
63518,140,16107,21366;21526;23843;24754;24960,43070,0,2,3,0,5
63519,140,16108,21403;21679;24272;24639;24742,43070,0,2,3,0,5
63520,140,16109,21904;24667;24985;25746,43070,0,3,1,0,4
63521,140,16110,21746;24659;25539,43070,0,2,1,0,3
63522,140,16111,21237;21437;24948,43070,0,1,2,0,3
63523,140,16112,21439;21460;23840;24452;24537;24951;26128,43070,1,1,5,0,7
63524,140,16113,21448;22065;24675;25183;25269,43070,0,3,2,0,5
63525,140,16114,21947;22119;25839,43070,1,0,2,0,3
63526,140,16115,21510;21876;24666;24983;25363;25934,43070,1,3,2,0,6
63527,140,16116,20834;21495;24328,43070,0,0,3,0,3
63528,140,16117,21536;25351,43070,0,1,1,0,2
63529,140,16118,21367;21734;24974;25171;25247;25636,43070,0,4,2,0,6
63530,140,16119,21603;21831;25075;25543,43070,0,2,2,0,4
63531,140,16120,21489;21619;24651;25354,43070,0,2,2,0,4
63532,140,16121,21624;24278,43070,0,0,2,0,2
63533,140,16124,21498;21795;24977,43070,0,1,2,0,3
63534,140,16125,21652;21841;25076,43070,0,1,2,0,3
63535,140,16126,21513;23842;25925,43070,1,0,2,0,3
63536,140,16129,21694;21747;24869;24975,43070,0,2,2,0,4
63537,140,16130,21476;21628;25532,43070,0,1,2,0,3
63538,140,16131,21477;21744;24552;25355,43070,0,1,3,0,4
63539,140,16132,21745;22010;25093;25370;25842,43070,1,2,2,0,5
63540,140,16134,21802;22230,43070,0,0,2,0,2
63541,140,16135,21807;22081;25846;26243,43070,2,0,2,0,4
63542,140,16136,21637;21811;24663;24772;24978,43070,0,3,2,0,5
63543,140,16137,21757;22153;24782;24895;25098;25186,43070,0,4,2,0,6
63544,140,16138,21835;21861;24878;25451;25641;25740,43070,0,4,2,0,6
63545,140,16139,21836;24979;25448;25929,43070,1,2,1,0,4
63546,140,16140,21847;22003;25555;25937,43070,1,1,2,0,4
63547,140,16141,21736;21922;24376;25259;25552;26039,43070,1,2,3,0,6
63548,140,16142,21682;21850,43070,0,0,2,0,2
63549,140,16143,21743;24286;25070;25172;25442,43070,0,3,2,0,5
63550,140,16144,21864;22210;25102,43070,0,1,2,0,3
63551,140,16145,21731;21884;24559;25364;25454;25743,43070,0,3,3,0,6
63552,140,16146,21896;25083;25366;25456;25551;25745,43070,0,5,1,0,6
63553,140,16147,21899;25457,43070,0,1,1,0,2
63554,140,16148,21920;22235;25106;25472;25761;25945,43070,1,3,2,0,6
63555,140,16149,22195;25851,43070,1,0,1,0,2
63556,140,16150,17484,43435,0,0,0,1,1
63557,140,16151,17530,43435,0,0,0,1,1
63558,140,16152,17571,43435,0,0,0,1,1
63559,140,16153,17229,43435,0,0,0,1,1
63560,140,16154,17257,43435,0,0,0,1,1
63561,140,16157,17915,43435,0,0,0,1,1
63562,140,16161,17815;17921,43435,0,0,0,2,2
63563,140,16162,18446;18694,43435,0,0,0,2,2
63564,140,16169,18889;19408,43435,0,0,0,2,2
63565,140,16171,19380;23520;25910,43435,1,0,1,1,3
63566,140,16172,18940,43435,0,0,0,1,1
63567,140,16174,19603;20028;24390,43435,0,0,3,0,3
63568,140,16176,19969;20318;22634,43435,0,0,3,0,3
63569,140,16179,19939;20137,43435,0,0,2,0,2
63570,140,16180,20136;20637,43435,0,0,2,0,2
63571,140,16182,20241;20395,43435,0,0,2,0,2
63572,140,16185,20262;20406;24300,43435,0,0,3,0,3
63573,140,16186,20969,43435,0,0,1,0,1
63574,140,16187,20787;24322,43435,0,0,2,0,2
63575,140,16188,20851;21216;24626,43435,0,1,2,0,3
63576,140,16189,20852;24247;24329;24504,43435,0,0,4,0,4
63577,140,16191,20416;20419;23686;23700,43435,0,0,4,0,4
63578,140,16192,20761;21005;24156;24257,43435,0,0,4,0,4
63579,140,16194,21033;21071;24724;24837,43435,0,2,2,0,4
63580,140,16195,20928;21087;23609;24343;25036,43435,0,1,4,0,5
63581,140,16196,21657;24281;25244,43435,0,1,2,0,3
63582,140,16197,20832;21139;24263;24618,43435,0,1,3,0,4
63583,140,16198,21080;21173,43435,0,0,2,0,2
63584,140,16199,21251;21307;24438,43435,0,0,3,0,3
63585,140,16200,20735;21356;24739;24847;25150;25343,43435,0,4,2,0,6
63586,140,16201,21337;21658;24864;26035,43435,1,1,2,0,4
63587,140,16202,21372;21441;24744;25347;25730,43435,0,3,2,0,5
63588,140,16203,21673;21873;24463;25741,43435,0,1,3,0,4
63589,140,16204,21469,43435,0,0,1,0,1
63590,140,16205,21501;22078;25095;25379;25940,43435,1,2,2,0,5
63591,140,16206,22194;22212;25383;25566;25660,43435,0,3,2,0,5
63592,140,16208,21296;21565;24760,43435,0,1,2,0,3
63593,140,16209,21598;21985;24563,43435,0,0,3,0,3
63594,140,16210,21346;21599;24542;26337,43435,1,0,3,0,4
63595,140,16211,21695;21868;24375;24462;24982,43435,0,1,4,0,5
63596,140,16212,21632;21748;24544,43435,0,0,3,0,3
63597,140,16214,21706;22241;24786,43435,0,1,2,0,3
63598,140,16215,21681;21708;24550;25069,43435,0,1,3,0,4
63599,140,16216,21710;24551;25735,43435,0,1,2,0,3
63600,140,16217,22042;22208;25187;25384;25760,43435,0,3,2,0,5
63601,140,16218,21717;21751;24553,43435,0,0,3,0,3
63602,140,16219,22094;24780;24893;24989;25380,43435,0,4,1,0,5
63603,140,16220,21754;21937,43435,0,0,2,0,2
63604,140,16221,21398;21755;24660;25249,43435,0,2,2,0,4
63605,140,16222,21667;21760;25356;25443;25540,43435,0,3,2,0,5
63606,140,16223,21647;21872;25933,43435,1,0,2,0,3
63607,140,16224,21785;21806;24662;24976,43435,0,2,2,0,4
63608,140,16225,21564;21786;24366;24759;25062,43435,0,2,3,0,5
63609,140,16226,21528;21820;25359;25446,43435,0,2,2,0,4
63610,140,16227,21700;21823,43435,0,0,2,0,2
63611,140,16228,21493;21832;25256;25447;25544,43435,0,3,2,0,5
63612,140,16229,21834;21941;25553;25838,43435,1,1,2,0,4
63613,140,16230,21849;21881,43435,0,0,2,0,2
63614,140,16231,21520;21867;24557;25547;25932;26145,43435,2,1,3,0,6
63615,140,16232,21698;21880;25176;25453;25643;25742,43435,0,4,2,0,6
63616,140,16233,21897,43435,0,0,1,0,1
63617,140,16234,21933;22152;25097;25382;25657,43435,0,3,2,0,5
63618,140,16235,21938;22309;25193;25667,43435,0,2,2,0,4
63619,140,16237,21392;21953;25089;25749,43435,0,2,2,0,4
63620,140,16238,21473;21956;25647,43435,0,1,2,0,3
63621,140,16239,21960;22151;24677;25470;25656;26149,43435,1,3,2,0,6
63622,140,16240,21964;25649;25750,43435,0,2,1,0,3
63623,140,16241,21968;22301,43435,0,0,2,0,2
63624,140,16242,22139;24894;25185;25655,43435,0,3,1,0,4
63625,140,16243,21926;21998,43435,0,0,2,0,2
63626,140,16244,21818;22014;24194;24672;25651,43435,0,2,3,0,5
63627,140,16245,22016;22214;24784;25944;26153;26246,43435,3,1,2,0,6
63628,140,16246,22307;22517;25665,43435,0,1,2,0,3
63629,140,16247,22031;24673,43435,0,1,1,0,2
63630,140,16248,22037;22123;26147,43435,1,0,2,0,3
63631,140,16249,22013;22040;25182;25844;25939,43435,2,1,2,0,5
63632,140,16251,17275,43800,0,0,0,1,1
63633,140,16254,17722,43800,0,0,0,1,1
63634,140,16256,17901;18184,43800,0,0,0,2,2
63635,140,16257,17992,43800,0,0,0,1,1
63636,140,16259,17581;17933,43800,0,0,0,2,2
63637,140,16262,18188;18395,43800,0,0,0,2,2
63638,140,16263,18453;18511,43800,0,0,0,2,2
63639,140,16265,18596;18632,43800,0,0,0,2,2
63640,140,16267,18554;18810,43800,0,0,0,2,2
63641,140,16270,19115;19515;23637;26022,43800,1,0,2,1,4
63642,140,16271,18668;18811,43800,0,0,0,2,2
63643,140,16274,19575;20031,43800,0,0,2,0,2
63644,140,16277,19907;20117;23546,43800,0,0,3,0,3
63645,140,16280,20243;20602;24024,43800,0,0,3,0,3
63646,140,16282,20481,43800,0,0,1,0,1
63647,140,16284,20562;20648;24128,43800,0,0,3,0,3
63648,140,16289,20519;20824,43800,0,0,2,0,2
63649,140,16290,20860;20981;24151;24824;25031,43800,0,2,3,0,5
63650,140,16291,20913;21265,43800,0,0,2,0,2
63651,140,16292,20941;23716;26124,43800,1,0,2,0,3
63652,140,16294,21126;24615;25328,43800,0,2,1,0,3
63653,140,16296,21193;21470;24182;24453;24747,43800,0,1,4,0,5
63654,140,16297,21535;21635;24654;25535,43800,0,2,2,0,4
63655,140,16298,21239;21660;24457;24547,43800,0,0,4,0,4
63656,140,16299,21430;24451;24641;24947,43800,0,2,2,0,4
63657,140,16300,21299;21488;24061;25048;25338,43800,0,2,3,0,5
63658,140,16301,21349;24530;25342,43800,0,1,2,0,3
63659,140,16303,21127;21507;24958;25824,43800,1,1,2,0,4
63660,140,16304,21512;21765;25738;26037,43800,1,1,2,0,4
63661,140,16305,21705;24970;25635,43800,0,2,1,0,3
63662,140,16306,21559;21702,43800,0,0,2,0,2
63663,140,16307,21854;23849;24774;25546,43800,0,2,2,0,4
63664,140,16308,21467;21588;24541;24649;24763;25240;25353,43800,0,4,3,0,7
63665,140,16309,21594;21669;23959,43800,0,0,3,0,3
63666,140,16311,21622;21768,43800,0,0,2,0,2
63667,140,16312,21930;25085;25459,43800,0,2,1,0,3
63668,140,16313,21499;21597;24751,43800,0,1,2,0,3
63669,140,16314,21869;21963;25175;25258;25452;25548;25642,43800,0,5,2,0,7
63670,140,16316,21890;21939,43800,0,0,2,0,2
63671,140,16317,21690;22007,43800,0,0,2,0,2
63672,140,16318,21691;21957;25648,43800,0,1,2,0,3
63673,140,16319,21697;24284;24769,43800,0,1,2,0,3
63674,140,16320,21555;21799;25739,43800,0,1,2,0,3
63675,140,16321,21778;22062;25465;25755,43800,0,2,2,0,4
63676,140,16322,21560;24962;25527,43800,0,2,1,0,3
63677,140,16323,21584;22227;25386,43800,0,1,2,0,3
63678,140,16325,21860;22364;25572,43800,0,1,2,0,3
63679,140,16327,21842;22141;24781,43800,0,1,2,0,3
63680,140,16329,21910;22147;24382;25273,43800,0,1,3,0,4
63681,140,16330,21965;22315;24777;24883,43800,0,2,2,0,4
63682,140,16331,21917;22286;25390,43800,0,1,2,0,3
63683,140,16332,21936;22148;25086;25367,43800,0,2,2,0,4
63684,140,16333,21946;22282;24385;25389;25571;25855,43800,1,2,3,0,6
63685,140,16335,21950;24082,43800,0,0,2,0,2
63686,140,16336,22385;22474;24799;25199;25581,43800,0,3,2,0,5
63687,140,16337,22001;22267,43800,0,0,2,0,2
63688,140,16338,22009;24887;25264;25556,43800,0,3,1,0,4
63689,140,16340,22041;22133;25559,43800,0,1,2,0,3
63690,140,16342,22030;22055;25266;26042,43800,1,1,2,0,4
63691,140,16343,22057,43800,0,0,1,0,1
63692,140,16344,22260;22421,43800,0,0,2,0,2
63693,140,16345,22085;22215,43800,0,0,2,0,2
63694,140,16346,22086;22317;24790;25194,43800,0,2,2,0,4
63695,140,16347,22333,43800,0,0,1,0,1
63696,140,16348,21803;22106;25270;25941,43800,1,1,2,0,4
63697,140,16349,21935;22190;24991,43800,0,1,2,0,3
63698,140,16350,22145;22411;26052,43800,1,0,2,0,3
63699,140,16351,22149;24990;25274;25469;25563,43800,0,4,1,0,5
63700,140,16352,22157;22216;24680,43800,0,1,2,0,3
63701,140,16353,17651,44165,0,0,0,1,1
63702,140,16354,17620,44165,0,0,0,1,1
63703,140,16355,17773,44165,0,0,0,1,1
63704,140,16356,17693;18350,44165,0,0,0,2,2
63705,140,16357,18052;18477,44165,0,0,0,2,2
63706,140,16358,17545,44165,0,0,0,1,1
63707,140,16361,18243;18426,44165,0,0,0,2,2
63708,140,16362,18080,44165,0,0,0,1,1
63709,140,16365,18721;18853,44165,0,0,0,2,2
63710,140,16367,18852;19387,44165,0,0,0,2,2
63711,140,16368,18956;19190,44165,0,0,0,2,2
63712,140,16371,19201;19229,44165,0,0,0,2,2
63713,140,16373,19258;19265,44165,0,0,0,2,2
63714,140,16376,19334,44165,0,0,0,1,1
63715,140,16379,19017;19218,44165,0,0,0,2,2
63716,140,16381,19838;20105,44165,0,0,2,0,2
63717,140,16390,20577;21215;23944;24521;24625,44165,0,1,4,0,5
63718,140,16391,20815;21686;25634,44165,0,1,2,0,3
63719,140,16393,20883;21150;24620;24727;25220;25331,44165,0,4,2,0,6
63720,140,16395,21019;21089;24055;24159;24612;24838;26140,44165,1,2,4,0,7
63721,140,16396,21051;21375;24532;24849;25054,44165,0,2,3,0,5
63722,140,16397,20705;21059;24052;24835;25034,44165,0,2,3,0,5
63723,140,16398,21077;21546;24927;25035,44165,0,2,2,0,4
63724,140,16399,20837,44165,0,0,1,0,1
63725,140,16400,21098;21424;24359;24450;24640,44165,0,1,4,0,5
63726,140,16401,21194;21572;24761,44165,0,1,2,0,3
63727,140,16402,21207;22004;24986;25092;25650;26041,44165,1,3,2,0,6
63728,140,16403,21229;25142,44165,0,1,1,0,2
63729,140,16404,21179;21233;25042;25626,44165,0,2,2,0,4
63730,140,16406,21029;21390,44165,0,0,2,0,2
63731,140,16407,21165;21350;23729;25149;25228,44165,0,2,3,0,5
63732,140,16408,21610;24369;24764,44165,0,1,2,0,3
63733,140,16409,21118;21775;25445;26038,44165,1,1,2,0,4
63734,140,16410,21458;21655;24371;24546;26143,44165,1,0,4,0,5
63735,140,16411,21756;21959;25261,44165,0,1,2,0,3
63736,140,16412,21491;21569;24455;24858;25349,44165,0,2,3,0,5
63737,140,16413,21639;24965;25536,44165,0,2,1,0,3
63738,140,16414,21606,44165,0,0,1,0,1
63739,140,16415,21767;22311;25478,44165,0,1,2,0,3
63740,140,16416,21405;21824;24664;25174;25360,44165,0,3,2,0,5
63741,140,16418,22113;22196;24467,44165,0,0,3,0,3
63742,140,16419,21885;22192;24566;26044,44165,1,0,3,0,4
63743,140,16420,21894;22264;24776;24984;25082;25455;25836,44165,1,4,2,0,7
63744,140,16421,21900;22367;24792;25393;25573;26050,44165,1,3,2,0,6
63745,140,16422,21901;22302;25279;25477;25949;26158,44165,2,2,2,0,6
63746,140,16423,21874;21977,44165,0,0,2,0,2
63747,140,16424,21282;21444;25057,44165,0,1,2,0,3
63748,140,16425,21987;22033;24564;24668;26040,44165,1,1,3,0,5
63749,140,16426,21771;21996;24886,44165,0,1,2,0,3
63750,140,16427,21656;22250,44165,0,0,2,0,2
63751,140,16428,21908;22029;25373,44165,0,1,2,0,3
63752,140,16429,22549;25292,44165,0,1,1,0,2
63753,140,16430,21843;22049;25652;25754,44165,0,2,2,0,4
63754,140,16431,21791;22066;24466;25377;25756,44165,0,2,3,0,5
63755,140,16432,22368;25282;25671,44165,0,2,1,0,3
63756,140,16433,22032;22083;25374;25463;25938,44165,1,2,2,0,5
63757,140,16435,22096;22176;24383,44165,0,0,3,0,3
63758,140,16436,22115;22298;25192;25858;26157,44165,2,1,2,0,5
63759,140,16437,22179;22499,44165,0,0,2,0,2
63760,140,16438,22180;22455;25401,44165,0,1,2,0,3
63761,140,16439,22102;22191,44165,0,0,2,0,2
63762,140,16440,22198;22555,44165,0,0,2,0,2
63763,140,16441,21906;22202;24287,44165,0,0,3,0,3
63764,140,16442,21617;22206,44165,0,0,2,0,2
63765,140,16443,22232;22395;25577,44165,0,1,2,0,3
63766,140,16444,22238;22331;24994,44165,0,1,2,0,3
63767,140,16446,17368,44530,0,0,0,1,1
63768,140,16448,18002,44530,0,0,0,1,1
63769,140,16450,18290;18796,44530,0,0,0,2,2
63770,140,16451,18664;18751,44530,0,0,0,2,2
63771,140,16457,19374;19414,44530,0,0,0,2,2
63772,140,16464,19768;19840,44530,0,0,2,0,2
63773,140,16468,19959;19999,44530,0,0,2,0,2
63774,140,16469,19862;20367;22761;23896,44530,0,0,4,0,4
63775,140,16470,19814;20418,44530,0,0,2,0,2
63776,140,16471,20244,44530,0,0,1,0,1
63777,140,16475,20516;20521;24119,44530,0,0,3,0,3
63778,140,16476,20571;21026;24260;24832,44530,0,1,3,0,4
63779,140,16477,20073;20184,44530,0,0,2,0,2
63780,140,16478,20734;23378,44530,0,0,2,0,2
63781,140,16480,20740;20967;24339;24426;24604,44530,0,1,4,0,5
63782,140,16481,21331;24176,44530,0,0,2,0,2
63783,140,16482,20955,44530,0,0,1,0,1
63784,140,16484,21195,44530,0,0,1,0,1
63785,140,16486,21083;21365;24726,44530,0,1,2,0,3
63786,140,16487,21450;24746;25524,44530,0,2,1,0,3
63787,140,16488,22084;22099;24891,44530,0,1,2,0,3
63788,140,16489,21539;21740,44530,0,0,2,0,2
63789,140,16490,21570;22508;25291,44530,0,1,2,0,3
63790,140,16491,21653;21980;25263;25461,44530,0,2,2,0,4
63791,140,16492,21726;25169;25246,44530,0,2,1,0,3
63792,140,16493,21590;21776;23733;25064,44530,0,1,3,0,4
63793,140,16494,21659;22134;26148,44530,1,0,2,0,3
63794,140,16495,21462;21665;25165;25537,44530,0,2,2,0,4
63795,140,16497,21714;21782;24190;25250,44530,0,1,3,0,4
63796,140,16498,21797;24374;24874,44530,0,1,2,0,3
63797,140,16499,22060;25375;25845,44530,1,1,1,0,3
63798,140,16501,21853;22296;25191;25857;25948,44530,2,1,2,0,5
63799,140,16502,21883;24558;24880;25644;26239,44530,1,2,2,0,5
63800,140,16503,21871;22137;25271;25467;25562,44530,0,3,2,0,5
63801,140,16504,21484;21886;25080;25365,44530,0,2,2,0,4
63802,140,16505,21911;22012,44530,0,0,2,0,2
63803,140,16506,21927;22006;24671,44530,0,1,2,0,3
63804,140,16507,21931;21981;25368;25936,44530,1,1,2,0,4
63805,140,16508,21892;21986;24884,44530,0,1,2,0,3
63806,140,16509,22406,44530,0,0,1,0,1
63807,140,16510,22027;22171;25757;25942;26150,44530,2,1,2,0,5
63808,140,16511,21752;21889;24870;25071,44530,0,2,2,0,4
63809,140,16512,22090;22558;24903,44530,0,1,2,0,3
63810,140,16514,22489;25864;25961,44530,2,0,1,0,3
63811,140,16515,21934;22104;25847,44530,1,0,2,0,3
63812,140,16516,22614;22699,44530,0,0,2,0,2
63813,140,16517,22156;22178;25659;25850;26244,44530,2,1,2,0,5
63814,140,16518,22161;22632,44530,0,0,2,0,2
63815,140,16519,21674;22034;25267;25464,44530,0,2,2,0,4
63816,140,16520,22170;22505;25865;26057,44530,2,0,2,0,4
63817,140,16521,22181;22347;26151,44530,1,0,2,0,3
63818,140,16522,22242;22330;25391;26049;26159,44530,2,1,2,0,5
63819,140,16523,22412;25287,44530,0,1,1,0,2
63820,140,16524,22292;22485,44530,0,0,2,0,2
63821,140,16525,22028;22297,44530,0,0,2,0,2
63822,140,16526,21975;22304;24569;26048,44530,1,0,3,0,4
63823,140,16527,22316;22528;25489;25774,44530,0,2,2,0,4
63824,140,16528,22696;24908;25593;25783;25977;26170;26269,44530,3,3,1,0,7
63825,140,16529,22108;22355,44530,0,0,2,0,2
63826,140,16530,22168;22356;25565,44530,0,1,2,0,3
63827,140,16531,22365;22671;25003,44530,0,1,2,0,3
63828,140,16536,18696,44895,0,0,0,1,1
63829,140,16537,18774,44895,0,0,0,1,1
63830,140,16542,19161;19522,44895,0,0,1,1,2
63831,140,16543,19182,44895,0,0,0,1,1
63832,140,16546,19608,44895,0,0,1,0,1
63833,140,16552,19801,44895,0,0,1,0,1
63834,140,16553,20417;20573;24020,44895,0,0,3,0,3
63835,140,16555,20330;20496,44895,0,0,2,0,2
63836,140,16556,20336;20609;24125;24313;24586,44895,0,1,4,0,5
63837,140,16558,20486;21122;25039,44895,0,1,2,0,3
63838,140,16563,21117;21380;25055,44895,0,1,2,0,3
63839,140,16565,20894;21091;24344;25139,44895,0,1,3,0,4
63840,140,16567,21148;21442;24180;24745,44895,0,1,3,0,4
63841,140,16570,21079;21330;24356;25148,44895,0,1,3,0,4
63842,140,16571,21252;21378;25427,44895,0,1,2,0,3
63843,140,16572,21396;21764,44895,0,0,2,0,2
63844,140,16573,21838;24773;24875,44895,0,2,1,0,3
63845,140,16576,21381;21661;24548,44895,0,0,3,0,3
63846,140,16577,21388;24358;24446;25428,44895,0,1,3,0,4
63847,140,16579,22011;24888;25557,44895,0,2,1,0,3
63848,140,16580,21573;21919;24464;25458,44895,0,1,3,0,4
63849,140,16581,21578;25063;25437;25529,44895,0,3,1,0,4
63850,140,16582,21882;24879;25079;25835,44895,1,2,1,0,4
63851,140,16585,21453;21779;25638,44895,0,1,2,0,3
63852,140,16586,21644;21688;24656;24866,44895,0,2,2,0,4
63853,140,16588,21830;22187;25943,44895,1,0,2,0,3
63854,140,16589,21783;22035;25181;25558,44895,0,2,2,0,4
63855,140,16590,22303;25108;25664,44895,0,2,1,0,3
63856,140,16591,21851;22127;25931,44895,1,0,2,0,3
63857,140,16592,21852;22327;24570;25764,44895,0,1,3,0,4
63858,140,16593,21997;25179;25462,44895,0,2,1,0,3
63859,140,16595,21916;24081;25645;25747,44895,0,2,2,0,4
63860,140,16596,21877;21943;24775;25549,44895,0,2,2,0,4
63861,140,16597,22295,44895,0,0,1,0,1
63862,140,16598,22021;22336;25280,44895,0,1,2,0,3
63863,140,16599,22068;22434;25676;26054,44895,1,1,2,0,4
63864,140,16600,21649;22075;24988;25466;25654,44895,0,3,2,0,5
63865,140,16601,21800;22077,44895,0,0,2,0,2
63866,140,16602,22079;22122,44895,0,0,2,0,2
63867,140,16603,22322;24469;24791;25479,44895,0,2,2,0,4
63868,140,16604,22101;22757;24912;25501,44895,0,2,2,0,4
63869,140,16605,22109;22273;24468,44895,0,0,3,0,3
63870,140,16606,21759;22140;25737;26036,44895,1,1,2,0,4
63871,140,16607,22291;22693,44895,0,0,2,0,2
63872,140,16608,22162;22564;26063,44895,1,0,2,0,3
63873,140,16609,22740,44895,0,0,1,0,1
63874,140,16610,22070;22724;26172,44895,1,0,2,0,3
63875,140,16611,21863;22243;25473;25568,44895,0,2,2,0,4
63876,140,16612,21952;22496;25289;25772;25962;26255,44895,2,2,2,0,6
63877,140,16613,22051;22262;25762,44895,0,1,2,0,3
63878,140,16614,22314;22335;24789;25109;25669,44895,0,3,2,0,5
63879,140,16615,22224;24898;25385,44895,0,2,1,0,3
63880,140,16616,22225;22379;24901;24996;25395;25672,44895,0,4,2,0,6
63881,140,16617,22394;22466;25397,44895,0,1,2,0,3
63882,140,16618,22018;22396;25483,44895,0,1,2,0,3
63883,140,16619,22288;22401;25284;25675;26163,44895,1,2,2,0,5
63884,140,16620,22183;22404;24794;25285;26252,44895,1,2,2,0,5
63885,140,16621,22756;22865;24804;26270,44895,1,1,2,0,4
63886,140,16622,22442;22695,44895,0,0,2,0,2
63887,140,16623,22446;22859;25121,44895,0,1,2,0,3
63888,140,16624,22346;22461;25765,44895,0,1,2,0,3
63889,140,16625,22484;22741;25959,44895,1,0,2,0,3
63890,140,16626,22582;22747;25596,44895,0,1,2,0,3
63891,140,16627,17855,45260,0,0,0,1,1
63892,140,16628,17624,45260,0,0,0,1,1
63893,140,16630,17890,45260,0,0,0,1,1
63894,140,16632,17886;18611,45260,0,0,0,2,2
63895,140,16634,18781;19154,45260,0,0,0,2,2
63896,140,16637,18951;19018,45260,0,0,0,2,2
63897,140,16639,19118,45260,0,0,0,1,1
63898,140,16640,19168,45260,0,0,0,1,1
63899,140,16642,19188;19278,45260,0,0,0,2,2
63900,140,16643,18880;19007,45260,0,0,0,2,2
63901,140,16646,19622;19901;24291,45260,0,0,3,0,3
63902,140,16647,19957;19995,45260,0,0,2,0,2
63903,140,16653,20020;20034,45260,0,0,2,0,2
63904,140,16654,20206;20371;24482,45260,0,0,3,0,3
63905,140,16659,20469,45260,0,0,1,0,1
63906,140,16663,20558;20904;24233,45260,0,0,3,0,3
63907,140,16664,21035;21219;23836,45260,0,0,3,0,3
63908,140,16665,21094;21379,45260,0,0,2,0,2
63909,140,16666,21183;21530;24646;25435,45260,0,2,2,0,4
63910,140,16667,21385;21548,45260,0,0,2,0,2
63911,140,16668,21586;21609;25530,45260,0,1,2,0,3
63912,140,16669,21414;21641;24966;25163,45260,0,2,2,0,4
63913,140,16670,21643;22359;25480;25670;26250,45260,1,2,2,0,5
63914,140,16672,21108,45260,0,0,1,0,1
63915,140,16673,21537;21654;24456;24545;24766;25164,45260,0,2,4,0,6
63916,140,16674,21709;24867;25167;25440;25829,45260,1,3,1,0,5
63917,140,16675,21723;24868;24972;25168;25928,45260,1,3,1,0,5
63918,140,16676,21646;21769;24661,45260,0,1,2,0,3
63919,140,16677,21735;22020;25180;25843,45260,1,1,2,0,4
63920,140,16678,21737;21878;25834,45260,1,0,2,0,3
63921,140,16679,22203;25101;25275;25759,45260,0,3,1,0,4
63922,140,16680,22261;24993;25947,45260,1,1,1,0,3
63923,140,16681,21859;21905,45260,0,0,2,0,2
63924,140,16682,21630;21684;25438;25533,45260,0,2,2,0,4
63925,140,16683,21650;21971;24377;25935,45260,1,0,3,0,4
63926,140,16684,22000;22207;26045,45260,1,0,2,0,3
63927,140,16685,21888;22043;25268,45260,0,1,2,0,3
63928,140,16686,22063;22158;24783;25099;25848,45260,1,2,2,0,5
63929,140,16687,22097;22285;25476;25663;25856,45260,1,2,2,0,5
63930,140,16688,22114;22270;24682,45260,0,1,2,0,3
63931,140,16689,22125;22221;25853;26046,45260,2,0,2,0,4
63932,140,16690,22329;22651;25116;25973;26066,45260,2,1,2,0,5
63933,140,16691,22536;22807;25967,45260,1,0,2,0,3
63934,140,16692,22252;22349,45260,0,0,2,0,2
63935,140,16693,22038;22400;26251,45260,1,0,2,0,3
63936,140,16694,22320;22915,45260,0,0,2,0,2
63937,140,16695,22222;22326;25195;26249,45260,1,1,2,0,4
63938,140,16696,22387;22398,45260,0,0,2,0,2
63939,140,16697,22539;22793;25598;26177,45260,1,1,2,0,4
63940,140,16698,22437;25399,45260,0,1,1,0,2
63941,140,16699,22710;22885,45260,0,0,2,0,2
63942,140,16700,22098;22478,45260,0,0,2,0,2
63943,140,16701,22492;22796;24914;26077,45260,1,1,2,0,4
63944,140,16702,22493,45260,0,0,1,0,1
63945,140,16703,22501;22619;25114;26168,45260,1,1,2,0,4
63946,140,16704,22780,45260,0,0,1,0,1
63947,140,16705,22169;22529;25679,45260,0,1,2,0,3
63948,140,16706,22300;22535;25587;25680;25775;25966,45260,1,3,2,0,6
63949,140,16707,22553;22596;24388;25588;25968,45260,1,1,3,0,5
63950,140,16708,22507;22556,45260,0,0,2,0,2
63951,140,16709,22560;22645;24802;25872;25972,45260,2,1,2,0,5
63952,140,16710,22269;22577;24801;25868;26064,45260,2,1,2,0,5
63953,140,16711,22618;25201;25592,45260,0,2,1,0,3
63954,140,16712,22338;22623;25951,45260,1,0,2,0,3
63955,140,16713,22275;22626;25871,45260,1,0,2,0,3
63956,140,16714,18102,45625,0,0,0,1,1
63957,140,16718,18086,45625,0,0,0,1,1
63958,140,16720,18530;18591,45625,0,0,0,2,2
63959,140,16721,18404,45625,0,0,0,1,1
63960,140,16724,18895;19049,45625,0,0,0,2,2
63961,140,16725,18939;18960,45625,0,0,0,2,2
63962,140,16726,19087,45625,0,0,0,1,1
63963,140,16727,18755;19341,45625,0,0,0,2,2
63964,140,16729,19244;19280,45625,0,0,0,2,2
63965,140,16731,19159,45625,0,0,0,1,1
63966,140,16732,19561;19779,45625,0,0,2,0,2
63967,140,16736,19565,45625,0,0,1,0,1
63968,140,16737,20065;20299,45625,0,0,2,0,2
63969,140,16745,21223;24165,45625,0,0,2,0,2
63970,140,16746,21034;21063;24158;24513;25217,45625,0,1,4,0,5
63971,140,16748,21170;21519;24071;24753;24959;25160,45625,0,3,3,0,6
63972,140,16749,21264,45625,0,0,1,0,1
63973,140,16750,21399;21451;24950,45625,0,1,2,0,3
63974,140,16751,21325;21790;24873;25173;25358,45625,0,3,2,0,5
63975,140,16752,21352;21563;24442;24635,45625,0,1,3,0,4
63976,140,16754,21472;21942;24881;25087,45625,0,2,2,0,4
63977,140,16755,21949;22015,45625,0,0,2,0,2
63978,140,16756,21538;21788;24771;26144,45625,1,1,2,0,4
63979,140,16759,21638;22026,45625,0,0,2,0,2
63980,140,16761,21419;21774;24871,45625,0,1,2,0,3
63981,140,16762,21945;22768;25119,45625,0,1,2,0,3
63982,140,16763,22184,45625,0,0,1,0,1
63983,140,16764,21958;21970;24561;25090;25554,45625,0,2,3,0,5
63984,140,16765,21721;22093;25561,45625,0,1,2,0,3
63985,140,16766,21993;22362;25953,45625,1,0,2,0,3
63986,140,16767,22039;22245;24787;25569;26247,45625,1,2,2,0,5
63987,140,16768,22048;22476;24571;25402,45625,0,1,3,0,4
63988,140,16769,22073;22112;25184;25378,45625,0,2,2,0,4
63989,140,16770,22124;22561;24572,45625,0,0,3,0,3
63990,140,16771,22251;22357,45625,0,0,2,0,2
63991,140,16772,22281;25278;25662;26248,45625,1,2,1,0,4
63992,140,16773,22481;22890,45625,0,0,2,0,2
63993,140,16774,22126;22638;25115,45625,0,1,2,0,3
63994,140,16775,22276;22350;25107;25475;25570;26154,45625,1,3,2,0,6
63995,140,16776,22146;22462,45625,0,0,2,0,2
63996,140,16777,22237;22403;25398;26164,45625,1,1,2,0,4
63997,140,16778,22422;22681;25684;25876,45625,1,1,2,0,4
63998,140,16779,22154;22808;25789,45625,0,1,2,0,3
63999,140,16780,22590;22817,45625,0,0,2,0,2
64000,140,16781,22504;22622;24800;25290;25585;26256,45625,1,3,2,0,6
64001,140,16782,22540;25866,45625,1,0,1,0,2
64002,140,16783,22418;22545;26059,45625,1,0,2,0,3
64003,140,16784,22374;22570;25394;25574;25767,45625,0,3,2,0,5
64004,140,16785,22456;22584,45625,0,0,2,0,2
64005,140,16786,22611;23052,45625,0,0,2,0,2
64006,140,16787,22644;23098,45625,0,0,2,0,2
64007,140,16788,22939;25308;25414;25698;26281,45625,1,3,1,0,5
64008,140,16789,22673;22851,45625,0,0,2,0,2
64009,140,16790,22679;22961,45625,0,0,2,0,2
64010,140,16791,22680;22839;25599;25691;25883;26273,45625,2,2,2,0,6
64011,140,16792,22612;22685;25203;25494,45625,0,2,2,0,4
64012,140,16793,22120;22218,45625,0,0,2,0,2
64013,140,16794,22812;24687,45625,0,1,1,0,2
64014,140,16795,22708;22749,45625,0,0,2,0,2
64015,140,16796,22714;25004;25979,45625,1,1,1,0,3
64016,140,16797,22725;22944,45625,0,0,2,0,2
64017,140,16798,22409;22742;25498;25878;26174,45625,2,1,2,0,5
64018,140,16799,22572;22745;25293,45625,0,1,2,0,3
64019,140,16800,22822;25986;26078,45625,2,0,1,0,3
64020,140,16801,22328;22770;25690;25981;26175,45625,2,1,2,0,5
64021,140,16803,18194,45990,0,0,0,1,1
64022,140,16804,18218,45990,0,0,0,1,1
64023,140,16805,17952,45990,0,0,0,1,1
64024,140,16806,18659,45990,0,0,0,1,1
64025,140,16807,18219,45990,0,0,0,1,1
64026,140,16810,18692;19287,45990,0,0,0,2,2
64027,140,16812,18936,45990,0,0,0,1,1
64028,140,16815,18335,45990,0,0,0,1,1
64029,140,16817,19109,45990,0,0,0,1,1
64030,140,16820,19688;20019,45990,0,0,2,0,2
64031,140,16822,19831,45990,0,0,1,0,1
64032,140,16832,20346;20534;24584,45990,0,1,2,0,3
64033,140,16833,20582,45990,0,0,1,0,1
64034,140,16834,20284;20633;23913,45990,0,0,3,0,3
64035,140,16836,20500;20902;24144;24333;25133,45990,0,1,4,0,5
64036,140,16837,20741;21032,45990,0,0,2,0,2
64037,140,16839,20750;21044,45990,0,0,2,0,2
64038,140,16840,20929,45990,0,0,1,0,1
64039,140,16841,21134;21713;23735,45990,0,0,3,0,3
64040,140,16842,21338;21360;24940,45990,0,1,2,0,3
64041,140,16843,21500;21707;24957;25059,45990,0,2,2,0,4
64042,140,16844,21575;21891;24185,45990,0,0,3,0,3
64043,140,16845,21596;22166;25564,45990,0,1,2,0,3
64044,140,16846,21602,45990,0,0,1,0,1
64045,140,16847,22069;24380,45990,0,0,2,0,2
64046,140,16848,21720;22054;24379;24779;24890;25094;25653,45990,0,4,3,0,7
64047,140,16849,21733;22150;25381,45990,0,1,2,0,3
64048,140,16851,21524;21846;24877;25361;25450;25640,45990,0,4,2,0,6
64049,140,16852,21813;22217;25104;25471,45990,0,2,2,0,4
64050,140,16853,21837;21914;24665;24980;25449;25545;25832,45990,1,4,2,0,7
64051,140,16854,21918;22231;24785;25105,45990,0,2,2,0,4
64052,140,16856,21794;21976;24192;25091;25262;25460;25840,45990,1,3,3,0,7
64053,140,16857,22121;22246;24788;26047,45990,1,1,2,0,4
64054,140,16859,21809;22240;25387,45990,0,1,2,0,3
64055,140,16860,22277;22278;24683;25854,45990,1,1,2,0,4
64056,140,16861,22351;22370,45990,0,0,2,0,2
64057,140,16862,22372;22734;25497;25688,45990,0,2,2,0,4
64058,140,16863,22413;22743,45990,0,0,2,0,2
64059,140,16864,22432;22784;25006,45990,0,1,2,0,3
64060,140,16865,22197;22450;25000;25677,45990,0,2,2,0,4
64061,140,16866,22452;22917,45990,0,0,2,0,2
64062,140,16867,22465;22617;25491,45990,0,1,2,0,3
64063,140,16868,22936;24689;25794;26087,45990,1,2,1,0,4
64064,140,16869,22538;22726;25204;25301,45990,0,2,2,0,4
64065,140,16870,22597;22659;25408,45990,0,1,2,0,3
64066,140,16871,22557;25969;26061,45990,2,0,1,0,3
64067,140,16872,22648;22715;24685;24803;25686,45990,0,3,2,0,5
64068,140,16873,22656;22771;25875,45990,1,0,2,0,3
64069,140,16874,22676;22914;25782,45990,0,1,2,0,3
64070,140,16875,22683;22754;25975,45990,1,0,2,0,3
64071,140,16876,22694,45990,0,0,1,0,1
64072,140,16877,22755,45990,0,0,1,0,1
64073,140,16878,22095;23014,45990,0,0,2,0,2
64074,140,16879,22809;22941;25699,45990,0,1,2,0,3
64075,140,16881,22863;22884,45990,0,0,2,0,2
64076,140,16882,18365,46355,0,0,0,1,1
64077,140,16883,18730,46355,0,0,0,1,1
64078,140,16886,19001,46355,0,0,0,1,1
64079,140,16891,19232;19701,46355,0,0,1,1,2
64080,140,16900,20296,46355,0,0,1,0,1
64081,140,16902,19906,46355,0,0,1,0,1
64082,140,16908,20749,46355,0,0,1,0,1
64083,140,16913,20566;20891;24142;24332,46355,0,0,4,0,4
64084,140,16916,21322;21438;24273;24949;25155;25729,46355,0,3,3,0,6
64085,140,16921,21391;21459;24741;24945;25152,46355,0,3,2,0,5
64086,140,16922,21699;24373,46355,0,0,2,0,2
64087,140,16924,21293;21642,46355,0,0,2,0,2
64088,140,16925,21729;24658;24973;25736,46355,0,3,1,0,4
64089,140,16927,21241,46355,0,0,1,0,1
64090,140,16928,21845;22185;26043,46355,1,0,2,0,3
64091,140,16929,21848;22229;25276,46355,0,1,2,0,3
64092,140,16930,21929;22058;25084;25748;26240,46355,1,2,2,0,5
64093,140,16931,22164,46355,0,0,1,0,1
64094,140,16932,21784;22173;25758;25849,46355,1,1,2,0,4
64095,140,16934,22449;24387;25861,46355,1,0,2,0,3
64096,140,16936,22249;22274;25661;25946,46355,1,1,2,0,4
64097,140,16937,22306;22820,46355,0,0,2,0,2
64098,140,16938,22313;23166;26199,46355,1,0,2,0,3
64099,140,16939,22340;22578;25112;25405;25777;25869,46355,1,3,2,0,6
64100,140,16940,22342;22598;26260,46355,1,0,2,0,3
64101,140,16941,22866;25694;26080,46355,1,1,1,0,3
64102,140,16942,22369;22677,46355,0,0,2,0,2
64103,140,16943,22118;22371;25766;26161,46355,1,1,2,0,4
64104,140,16944,22376;22785;26176,46355,1,0,2,0,3
64105,140,16945,22384;22670,46355,0,0,2,0,2
64106,140,16946,22415;22948;24805,46355,0,1,2,0,3
64107,140,16947,22072,46355,0,0,1,0,1
64108,140,16948,22163;22563;25867,46355,1,0,2,0,3
64109,140,16949,22451;24798;25862,46355,1,1,1,0,3
64110,140,16950,22448;22792;26076,46355,1,0,2,0,3
64111,140,16951,21969;22475;25582;25771,46355,0,2,2,0,4
64112,140,16952,22290;22487;25485;25584;26056,46355,1,2,2,0,5
64113,140,16953,22500;22687;25976;26068;26268,46355,3,0,2,0,5
64114,140,16954,22629;22731;24911;25595;25687,46355,0,3,2,0,5
64115,140,16955,22312;22594;25668,46355,0,1,2,0,3
64116,140,16956,22602;22872;25294;25406;25591;25970,46355,1,3,2,0,6
64117,140,16957,22294;22864,46355,0,0,2,0,2
64118,140,16958,22624;23219;25608;26292,46355,1,1,2,0,4
64119,140,16959,22637;22777,46355,0,0,2,0,2
64120,140,16960,22607;22667;25409,46355,0,1,2,0,3
64121,140,16961,22647;22698,46355,0,0,2,0,2
64122,140,16962,22700;23008;25798,46355,0,1,2,0,3
64123,140,16963,22730;22965;25505;25886;25994;26090,46355,3,1,2,0,6
64124,140,16964,22174;22750;24686;25303;25499;25980,46355,1,3,2,0,6
64125,140,16965,22762;25689;25788;26073,46355,1,2,1,0,4
64126,140,16966,22497;22775;25411,46355,0,1,2,0,3
64127,140,16967,22835;23205;26103,46355,1,0,2,0,3
64128,140,16968,22848,46355,0,0,1,0,1
64129,140,16969,22850;22989,46355,0,0,2,0,2
64130,140,16971,22886;23250;25609,46355,0,1,2,0,3
64131,140,16972,22763;22895;25009,46355,0,1,2,0,3
64132,140,16973,22916;23178,46355,0,0,2,0,2
64133,140,16974,22530;22937;25111,46355,0,1,2,0,3
64134,140,16975,23206;25606,46355,0,1,1,0,2
64135,140,16976,22969;23109;25900,46355,1,0,2,0,3
64136,140,16977,22975;22987,46355,0,0,2,0,2
64137,140,16978,22706;22990;25997,46355,1,0,2,0,3
64138,140,16979,23248,46355,0,0,1,0,1
64139,140,16980,18315,46720,0,0,0,1,1
64140,140,16981,18949,46720,0,0,0,1,1
64141,140,16982,18760;18768,46720,0,0,0,2,2
64142,140,16991,19683;19760,46720,0,0,2,0,2
64143,140,16992,19912,46720,0,0,1,0,1
64144,140,16993,19966;20211,46720,0,0,2,0,2
64145,140,16995,20095,46720,0,0,1,0,1
64146,140,16998,20197;20379,46720,0,0,2,0,2
64147,140,16999,19818,46720,0,0,1,0,1
64148,140,17001,19917,46720,0,0,1,0,1
64149,140,17003,20429;20580,46720,0,0,2,0,2
64150,140,17007,20715;21017,46720,0,0,2,0,2
64151,140,17008,20444,46720,0,0,1,0,1
64152,140,17011,21425;21509;23841,46720,0,0,3,0,3
64153,140,17012,21351;21738;25248;25637,46720,0,2,2,0,4
64154,140,17013,21104;21474;24839;24930;25037,46720,0,3,2,0,5
64155,140,17014,22044,46720,0,0,1,0,1
64156,140,17017,21810,46720,0,0,1,0,1
64157,140,17018,21907;22142;25468,46720,0,1,2,0,3
64158,140,17020,21826;22213;24992;25103,46720,0,2,2,0,4
64159,140,17021,22005;22454;25400;25580;25957,46720,1,2,2,0,5
64160,140,17022,22234;22674;25117;26266,46720,1,1,2,0,4
64161,140,17023,21923;22205;24897;26152,46720,1,1,2,0,4
64162,140,17024,22565;22652;24904,46720,0,1,2,0,3
64163,140,17025,22226,46720,0,0,1,0,1
64164,140,17026,22143;22265;24681;25189;25388;25763,46720,0,4,2,0,6
64165,140,17027,22209;22279;24900,46720,0,1,2,0,3
64166,140,17028,22283;22752;25500,46720,0,1,2,0,3
64167,140,17029,22219;22325;24384;25188;25567,46720,0,2,3,0,5
64168,140,17030,22360;22825;25882;26179,46720,2,0,2,0,4
64169,140,17031,22236;22381;25197;25575,46720,0,2,2,0,4
64170,140,17032,22383;22871;25602;26276,46720,1,1,2,0,4
64171,140,17033,22318;22399;25674,46720,0,1,2,0,3
64172,140,17034,22059;22407;25286;25578,46720,0,2,2,0,4
64173,140,17035,22429;25860;26053,46720,2,0,1,0,3
64174,140,17036,22457;22503;25486;25963,46720,1,1,2,0,4
64175,140,17037,22525;23020,46720,0,0,2,0,2
64176,140,17038,22433;22521,46720,0,0,2,0,2
64177,140,17039,22344;22551;26060,46720,1,0,2,0,3
64178,140,17040,22606;22643,46720,0,0,2,0,2
64179,140,17041,22686;23146;26196,46720,1,0,2,0,3
64180,140,17042,22712;22956;25796;25993,46720,1,1,2,0,4
64181,140,17043,22718;23279,46720,0,0,2,0,2
64182,140,17044,22519;22767;25597;26074,46720,1,1,2,0,4
64183,140,17045,22728;22786,46720,0,0,2,0,2
64184,140,17046,22790;23101;25801,46720,0,1,2,0,3
64185,140,17047,22459;23062,46720,0,0,2,0,2
64186,140,17048,22669;22840;25412;25600,46720,0,2,2,0,4
64187,140,17049,22898;22918;25990;26084,46720,2,0,2,0,4
64188,140,17050,22912;23380;25317,46720,0,1,2,0,3
64189,140,17051,22833;22919;25010;25603;26085,46720,1,2,2,0,5
64190,140,17052,22925;23045;25800,46720,0,1,2,0,3
64191,140,17053,22801;22928;25880,46720,1,0,2,0,3
64192,140,17054,22945;23094;25795;25991,46720,1,1,2,0,4
64193,140,17055,22951;22973;26089;26282,46720,2,0,2,0,4
64194,140,17056,22976;23038,46720,0,0,2,0,2
64195,140,17057,23016;23243;26105,46720,1,0,2,0,3
64196,140,17059,23022;23049,46720,0,0,2,0,2
64197,140,17060,23230;25315,46720,0,1,1,0,2
64198,140,17061,23036;25124;25311,46720,0,2,1,0,3
64199,140,17062,23026;23043;25892,46720,1,0,2,0,3
64200,140,17063,23051;23194,46720,0,0,2,0,2
64201,140,17064,23057;23267;25809;26204,46720,1,1,2,0,4
64202,140,17065,23024;23067,46720,0,0,2,0,2
64203,140,17066,23074;23239,46720,0,0,2,0,2
64204,140,17067,23050;23102;25604;25705;26193,46720,1,2,2,0,5
64205,140,17068,18527,47085,0,0,0,1,1
64206,140,17069,18653,47085,0,0,0,1,1
64207,140,17070,18766,47085,0,0,0,1,1
64208,140,17072,19020,47085,0,0,0,1,1
64209,140,17076,19656,47085,0,0,1,0,1
64210,140,17077,19242,47085,0,0,0,1,1
64211,140,17081,19858,47085,0,0,1,0,1
64212,140,17082,19208;19216,47085,0,0,0,2,2
64213,140,17084,20265;20671,47085,0,0,2,0,2
64214,140,17086,20202;20328;24110,47085,0,0,3,0,3
64215,140,17087,20304;20528,47085,0,0,2,0,2
64216,140,17094,20676,47085,0,0,1,0,1
64217,140,17098,20767;20830;24141;24712;24922,47085,0,2,3,0,5
64218,140,17099,20514,47085,0,0,1,0,1
64219,140,17100,20343;20706,47085,0,0,2,0,2
64220,140,17101,21258;21497;24956;25350,47085,0,2,2,0,4
64221,140,17105,21175;21317;24175;25146;25226;26032,47085,1,2,3,0,6
64222,140,17109,21676;21928,47085,0,0,2,0,2
64223,140,17110,21753;22061;25376,47085,0,1,2,0,3
64224,140,17112,22271;22480;24899;25474,47085,0,2,2,0,4
64225,140,17114,22760;24913;25005;25304,47085,0,3,1,0,4
64226,140,17116,22155;22445;24678,47085,0,1,2,0,3
64227,140,17117,22172;22566;25001;25200,47085,0,2,2,0,4
64228,140,17119,22257;22869;25413;26081,47085,1,1,2,0,4
64229,140,17120,22287;22837;25987,47085,1,0,2,0,3
64230,140,17121,22873;26082,47085,1,0,1,0,2
64231,140,17122,22177;22366,47085,0,0,2,0,2
64232,140,17124,22460;25484,47085,0,1,1,0,2
64233,140,17125,22509;25773,47085,0,1,1,0,2
64234,140,17126,22479,47085,0,0,1,0,1
64235,140,17127,22092;22486;25583;25863;25960,47085,2,1,2,0,5
64236,140,17128,22117;22516;25487,47085,0,1,2,0,3
64237,140,17129,22813;23063;26190,47085,1,0,2,0,3
64238,140,17130,22576;22654,47085,0,0,2,0,2
64239,140,17132,22419;22608;26262,47085,1,0,2,0,3
64240,140,17133,22640;22853,47085,0,0,2,0,2
64241,140,17135,22201;22702;24909;25784;25877,47085,1,2,2,0,5
64242,140,17136,22711;25786;25978,47085,1,1,1,0,3
64243,140,17137,22182;22352;24995;25392;25952;26160,47085,2,2,2,0,6
64244,140,17138,22729;22841;24688;26180;26274,47085,2,1,2,0,5
64245,140,17139,22630;22717;24906;25295;25778;26263,47085,1,3,2,0,6
64246,140,17140,22811;23030;24916;25700,47085,0,2,2,0,4
64247,140,17141,22375;22828,47085,0,0,2,0,2
64248,140,17142,22920;25697,47085,0,1,1,0,2
64249,140,17143,22845;23069;26191;26284,47085,2,0,2,0,4
64250,140,17144,22854;23363,47085,0,0,2,0,2
64251,140,17145,22891;23300;26107;26207,47085,2,0,2,0,4
64252,140,17146,22927;23301;25611,47085,0,1,2,0,3
64253,140,17147,22929;25504,47085,0,1,1,0,2
64254,140,17148,22932;23108;25802,47085,0,1,2,0,3
64255,140,17149,22836;22960,47085,0,0,2,0,2
64256,140,17150,22964;23269,47085,0,0,2,0,2
64257,140,17151,23393;26015;26306,47085,2,0,1,0,3
64258,140,17152,23010;25799,47085,0,1,1,0,2
64259,140,17153,22779;23053,47085,0,0,2,0,2
64260,140,17154,22547;23071,47085,0,0,2,0,2
64261,140,17155,23073;23476;26018,47085,1,0,2,0,3
64262,140,17156,23061;23097,47085,0,0,2,0,2
64263,140,17157,22971,47085,0,0,1,0,1
64264,140,17158,23144;23470;25617;26315,47085,1,1,2,0,4
64265,140,17159,23087;23161;25805,47085,0,1,2,0,3
64266,140,17160,22860;23168;26005,47085,1,0,2,0,3
64267,140,17161,23007;23177;25313;26099;26287,47085,2,1,2,0,5
64268,140,17162,23181,47085,0,0,1,0,1
64269,140,17163,23133;23183;25508,47085,0,1,2,0,3
64270,140,17164,23299;23438;25610;26010;26206,47085,2,1,2,0,5
64271,140,17165,18666,47450,0,0,0,1,1
64272,140,17166,18737,47450,0,0,0,1,1
64273,140,17167,18989,47450,0,0,0,1,1
64274,140,17168,19489,47450,0,0,1,0,1
64275,140,17171,18924,47450,0,0,0,1,1
64276,140,17173,19446,47450,0,0,1,0,1
64277,140,17174,18972,47450,0,0,0,1,1
64278,140,17178,19873;19926,47450,0,0,2,0,2
64279,140,17180,19859,47450,0,0,1,0,1
64280,140,17183,21255;24267,47450,0,0,2,0,2
64281,140,17186,20530,47450,0,0,1,0,1
64282,140,17187,20958,47450,0,0,1,0,1
64283,140,17188,21149;21822,47450,0,0,2,0,2
64284,140,17190,21208,47450,0,0,1,0,1
64285,140,17191,20880;21279;24524;24733;25225,47450,0,2,3,0,5
64286,140,17195,21242;21543;24961,47450,0,1,2,0,3
64287,140,17196,21557;21999,47450,0,0,2,0,2
64288,140,17197,21592;22019;24778;25265;25371,47450,0,3,2,0,5
64289,140,17199,21839,47450,0,0,1,0,1
64290,140,17201,22377;25196;25283;25481,47450,0,3,1,0,4
64291,140,17203,21979,47450,0,0,1,0,1
64292,140,17204,22308;25666;25950,47450,1,1,1,0,3
64293,140,17205,22089;22091;24381;24892,47450,0,1,3,0,4
64294,140,17206,22111;22343;25281,47450,0,1,2,0,3
64295,140,17208,21808,47450,0,0,1,0,1
64296,140,17209,22255,47450,0,0,1,0,1
64297,140,17211,22258,47450,0,0,1,0,1
64298,140,17212,22337;22844;25007;26181,47450,1,1,2,0,4
64299,140,17213,22339;22573;24905,47450,0,1,2,0,3
64300,140,17214,22405;23048;25702;26189,47450,1,1,2,0,4
64301,140,17215,22254,47450,0,0,1,0,1
64302,140,17216,22348;22416,47450,0,0,2,0,2
64303,140,17217,22826,47450,0,0,1,0,1
64304,140,17218,22443;24999;25579;25769;25956,47450,1,3,1,0,5
64305,140,17219,22511;22758;25118,47450,0,1,2,0,3
64306,140,17221,22382;22587;26258,47450,1,0,2,0,3
64307,140,17222,22967;25995;26091,47450,2,0,1,0,3
64308,140,17223,22082;22605;26261,47450,1,0,2,0,3
64309,140,17224,22701;23155;25804;25903,47450,1,1,2,0,4
64310,140,17225,22334;22748,47450,0,0,2,0,2
64311,140,17226,22753;23013,47450,0,0,2,0,2
64312,140,17227,22776;22798,47450,0,0,2,0,2
64313,140,17228,22781;22940;24472;26075,47450,1,0,3,0,4
64314,140,17229,22783;22794;25982,47450,1,0,2,0,3
64315,140,17230,22832;23492;26116,47450,1,0,2,0,3
64316,140,17231,22877;23095;26192;26285,47450,2,0,2,0,4
64317,140,17232,22751;23085;25896,47450,1,0,2,0,3
64318,140,17233,22900,47450,0,0,1,0,1
64319,140,17234,23318;26011;26108,47450,2,0,1,0,3
64320,140,17235,22923;23571,47450,0,0,2,0,2
64321,140,17236,22947;26088;26186,47450,2,0,1,0,3
64322,140,17237,22963;22992,47450,0,0,2,0,2
64323,140,17238,22982;23303;25612,47450,0,1,2,0,3
64324,140,17239,23456;26115,47450,1,0,1,0,2
64325,140,17240,23018,47450,0,0,1,0,1
64326,140,17241,22599;22994;26093,47450,1,0,2,0,3
64327,140,17242,22390;22996;25889;25998,47450,2,0,2,0,4
64328,140,17243,22720;23005;25310;25506;25890,47450,1,2,2,0,5
64329,140,17244,23021;23154;25126,47450,0,1,2,0,3
64330,140,17245,22358;23025,47450,0,0,2,0,2
64331,140,17246,23028;23417,47450,0,0,2,0,2
64332,140,17247,23033;23035,47450,0,0,2,0,2
64333,140,17248,23185;23262;25806,47450,0,1,2,0,3
64334,140,17249,23040;23121,47450,0,0,2,0,2
64335,140,17250,22903;23091;26279,47450,1,0,2,0,3
64336,140,17251,23106;23479;26019,47450,1,0,2,0,3
64337,140,17252,23119;23245,47450,0,0,2,0,2
64338,140,17253,23135;23435,47450,0,0,2,0,2
64339,140,17254,23339;23390;25712;26300,47450,1,1,2,0,4
64340,140,17255,23199;25314;25808;25904,47450,1,2,1,0,4
64341,140,17256,23211;23273;26205,47450,1,0,2,0,3
64342,140,17257,23212;23351;25810;26210;26302,47450,2,1,2,0,5
64343,140,17258,23223;23235,47450,0,0,2,0,2
64344,140,17259,23225;23460;26313,47450,1,0,2,0,3
64345,140,17260,23259;25418;25509;26293,47450,1,2,1,0,4
64346,140,17261,22874;23265,47450,0,0,2,0,2
64347,140,17262,23271;23340;26301,47450,1,0,2,0,3
64348,140,17263,23080;23293,47450,0,0,2,0,2
64349,140,17264,18421,47815,0,0,0,1,1
64350,140,17265,18723,47815,0,0,0,1,1
64351,140,17266,18887;19379,47815,0,0,0,2,2
64352,140,17267,19025;19228,47815,0,0,0,2,2
64353,140,17268,19088,47815,0,0,0,1,1
64354,140,17269,19095,47815,0,0,0,1,1
64355,140,17270,19103,47815,0,0,0,1,1
64356,140,17271,19206;19516,47815,0,0,1,1,2
64357,140,17272,19361,47815,0,0,0,1,1
64358,140,17273,19432;19520,47815,0,0,2,0,2
64359,140,17274,19630,47815,0,0,1,0,1
64360,140,17278,20196;20428,47815,0,0,2,0,2
64361,140,17280,20531,47815,0,0,1,0,1
64362,140,17283,20853,47815,0,0,1,0,1
64363,140,17288,20982;21340,47815,0,0,2,0,2
64364,140,17289,20930,47815,0,0,1,0,1
64365,140,17290,21190;21319;24843,47815,0,1,2,0,3
64366,140,17291,21166,47815,0,0,1,0,1
64367,140,17292,21348;21521;24645,47815,0,1,2,0,3
64368,140,17295,21640;21727;23958;25927,47815,1,0,3,0,4
64369,140,17301,22088;22655;25493;25780;25974;26067,47815,2,2,2,0,6
64370,140,17303,22810;25984,47815,1,0,1,0,2
64371,140,17304,22188;22512;25586;25964,47815,1,1,2,0,4
64372,140,17305,21991;22256,47815,0,0,2,0,2
64373,140,17307,22427;22666;25002,47815,0,1,2,0,3
64374,140,17308,22436;22705;25495;25785,47815,0,2,2,0,4
64375,140,17310,22129;22482;25403;26165;26254,47815,2,1,2,0,5
64376,140,17311,22491;22847;25692;25790;26182,47815,1,2,2,0,5
64377,140,17312,22568,47815,0,0,1,0,1
64378,140,17313,22502;22562;25589;26062,47815,1,1,2,0,4
64379,140,17314,22046;22583;25681;26257,47815,1,1,2,0,4
64380,140,17315,22537;23015,47815,0,0,2,0,2
64381,140,17316,22682;22931;25792,47815,0,1,2,0,3
64382,140,17317,22386;22735;26070,47815,1,0,2,0,3
64383,140,17318,22641;22737;25787;26071;26173,47815,2,1,2,0,5
64384,140,17319,22363;22759,47815,0,0,2,0,2
64385,140,17320,22130,47815,0,0,1,0,1
64386,140,17321,22660;22721;26069,47815,1,0,2,0,3
64387,140,17322,22855;23349,47815,0,0,2,0,2
64388,140,17323,22883;22888;25884,47815,1,0,2,0,3
64389,140,17324,22782;22892,47815,0,0,2,0,2
64390,140,17325,22906;23100;25791,47815,0,1,2,0,3
64391,140,17326,22922;23065,47815,0,0,2,0,2
64392,140,17327,22603;23115,47815,0,0,2,0,2
64393,140,17328,22977;23134;25803;26003,47815,1,1,2,0,4
64394,140,17329,22983;23186;25807,47815,0,1,2,0,3
64395,140,17330,22993;23554;26218,47815,1,0,2,0,3
64396,140,17331,22997;23192;26100;26288,47815,2,0,2,0,4
64397,140,17332,23000;25127;25613;26110,47815,1,2,1,0,4
64398,140,17333,22662;23001;25309,47815,0,1,2,0,3
64399,140,17334,23244,47815,0,0,1,0,1
64400,140,17335,22878;23059,47815,0,0,2,0,2
64401,140,17336,22831;23281;25906;26009;26296,47815,3,0,2,0,5
64402,140,17337,23089;23581,47815,0,0,2,0,2
64403,140,17338,23090;23153,47815,0,0,2,0,2
64404,140,17339,23120;23127,47815,0,0,2,0,2
64405,140,17340,22875;23137;25415,47815,0,1,2,0,3
64406,140,17341,23140;23681,47815,0,0,2,0,2
64407,140,17342,23114;23145;25706;26194,47815,1,1,2,0,4
64408,140,17343,23160;23288,47815,0,0,2,0,2
64409,140,17344,23200;23216;25416,47815,0,1,2,0,3
64410,140,17345,23079;23226;26104;26203,47815,2,0,2,0,4
64411,140,17346,23294;23498,47815,0,0,2,0,2
64412,140,17347,23188;25710,47815,0,1,1,0,2
64413,140,17348,23264;26294,47815,1,0,1,0,2
64414,140,17349,23096;23274;25510;26008;26295,47815,2,1,2,0,5
64415,140,17350,23323;23639,47815,0,0,2,0,2
64416,140,17351,22962;23503;25717;26020,47815,1,1,2,0,4
64417,140,17352,23362;23572;26219,47815,1,0,2,0,3
64418,140,17353,23364;23616;26318,47815,1,0,2,0,3
64419,140,17354,23277;23366,47815,0,0,2,0,2
64420,140,17355,23384;23732,47815,0,0,2,0,2
64421,140,17356,23251;23398,47815,0,0,2,0,2
64422,140,17357,23263;23400,47815,0,0,2,0,2
64423,140,17358,19032,48180,0,0,0,1,1
64424,140,17359,19054,48180,0,0,0,1,1
64425,140,17360,18809;19173,48180,0,0,0,2,2
64426,140,17362,19331,48180,0,0,0,1,1
64427,140,17364,19518;19686,48180,0,0,2,0,2
64428,140,17365,19496;19528,48180,0,0,2,0,2
64429,140,17366,19637,48180,0,0,1,0,1
64430,140,17367,19736;20292,48180,0,0,2,0,2
64431,140,17372,20090,48180,0,0,1,0,1
64432,140,17376,20517,48180,0,0,1,0,1
64433,140,17378,20561,48180,0,0,1,0,1
64434,140,17380,20784,48180,0,0,1,0,1
64435,140,17383,20866,48180,0,0,1,0,1
64436,140,17385,21133;21478,48180,0,0,2,0,2
64437,140,17387,21068;21404;25056;25429,48180,0,2,2,0,4
64438,140,17389,21576,48180,0,0,1,0,1
64439,140,17392,21620;21857;25241,48180,0,1,2,0,3
64440,140,17393,21711;21988;24669;25369,48180,0,2,2,0,4
64441,140,17394,21567;21693;24367;25352,48180,0,1,3,0,4
64442,140,17395,21749,48180,0,0,1,0,1
64443,140,17397,21805;21821;25254;25831,48180,1,1,2,0,4
64444,140,17398,21990;22052;24670;24885;25753,48180,0,3,2,0,5
64445,140,17401,21924;22581;25870,48180,1,0,2,0,3
64446,140,17402,21961;22280;24568;25190;26155,48180,1,1,3,0,5
64447,140,17403,21994,48180,0,0,1,0,1
64448,140,17405,22045;22159,48180,0,0,2,0,2
64449,140,17407,21862;22167;25100,48180,0,1,2,0,3
64450,140,17408,21865;22067;25560,48180,0,1,2,0,3
64451,140,17409,22849;25601;25693;26275,48180,1,2,1,0,4
64452,140,17410,22268;23099;25205,48180,0,1,2,0,3
64453,140,17411,22468;22631;26264,48180,1,0,2,0,3
64454,140,17412,22361;22469;25288,48180,0,1,2,0,3
64455,140,17413,22220;22483;25404;25678;25958,48180,1,2,2,0,5
64456,140,17414,22498;23142,48180,0,0,2,0,2
64457,140,17415,22107;22515;25965,48180,1,0,2,0,3
64458,140,17416,22527;22846;25503,48180,0,1,2,0,3
64459,140,17417,22534;22636;25297,48180,0,1,2,0,3
64460,140,17418,22473,48180,0,0,1,0,1
64461,140,17419,22239;22571;25490;25776;26166,48180,1,2,2,0,5
64462,140,17420,22593;23104;25898,48180,1,0,2,0,3
64463,140,17421,22600;22893;25305;26277,48180,1,1,2,0,4
64464,140,17422,22911,48180,0,0,1,0,1
64465,140,17423,22341;22635;25296;26065,48180,1,1,2,0,4
64466,140,17424,22639;23143,48180,0,0,2,0,2
64467,140,17425,22805;25983;26178,48180,2,0,1,0,3
64468,140,17426,22668;22882,48180,0,0,2,0,2
64469,140,17427,22601;22691;25590,48180,0,1,2,0,3
64470,140,17428,22692;22829,48180,0,0,2,0,2
64471,140,17429,22324;22719;24910;25496,48180,0,2,2,0,4
64472,140,17430,22591;25113,48180,0,1,1,0,2
64473,140,17431,22186;22199;24679;24896;25852;26245,48180,2,2,2,0,6
64474,140,17432,22440,48180,0,0,1,0,1
64475,140,17433,22803;22830,48180,0,0,2,0,2
64476,140,17434,22823;23064;25893,48180,1,0,2,0,3
64477,140,17435,22870;25988,48180,1,0,1,0,2
64478,140,17436,22842;22876;26185,48180,1,0,2,0,3
64479,140,17437,22933;22958;25307,48180,0,1,2,0,3
64480,140,17438,22935;23173;25312;25709,48180,0,2,2,0,4
64481,140,17439,22899;22981,48180,0,0,2,0,2
64482,140,17440,22986;23526,48180,0,0,2,0,2
64483,140,17441,22980;23002,48180,0,0,2,0,2
64484,140,17442,22862;23029,48180,0,0,2,0,2
64485,140,17443,22910;23060;25703,48180,0,1,2,0,3
64486,140,17444,23124;23382,48180,0,0,2,0,2
64487,140,17445,23575;25913;26121,48180,2,0,1,0,3
64488,140,17446,23180;23452;25616;25814;26215,48180,1,2,2,0,5
64489,140,17447,23189;23599,48180,0,0,2,0,2
64490,140,17448,23191;23374,48180,0,0,2,0,2
64491,140,17449,23229;23726;25916,48180,1,0,2,0,3
64492,140,17450,23231;23247;25013,48180,0,1,2,0,3
64493,140,17451,23238,48180,0,0,1,0,1
64494,140,17452,23254;23846,48180,0,0,2,0,2
64495,140,17453,22995;23260,48180,0,0,2,0,2
64496,140,17454,23286;23290,48180,0,0,2,0,2
64497,140,17455,23184,48180,0,0,1,0,1
64498,140,17456,23315,48180,0,0,1,0,1
64499,140,17457,23316;23589;26316,48180,1,0,2,0,3
64500,140,17458,23324;23718,48180,0,0,2,0,2
64501,140,17459,23105;23464,48180,0,0,2,0,2
64502,140,17460,22970;23370;25813,48180,0,1,2,0,3
64503,140,17461,23396;23621,48180,0,0,2,0,2
64504,140,17462,23397;23521;25618,48180,0,1,2,0,3
64505,140,17463,23232;23402,48180,0,0,2,0,2
64506,140,17464,23334;23418;26310,48180,1,0,2,0,3
64507,140,17465,23421;23472;25716,48180,0,1,2,0,3
64508,140,17466,23332;23432,48180,0,0,2,0,2
64509,140,17467,23627,48180,0,0,1,0,1
64510,140,17468,23424;23459;25715;26017;26214,48180,2,1,2,0,5
64511,140,17469,23253;23465;26314,48180,1,0,2,0,3
64512,140,17470,23469;23751,48180,0,0,2,0,2
64513,140,17471,23471;23606;26317,48180,1,0,2,0,3
64514,140,17472,23490;23505;25908;26021,48180,2,0,2,0,4
64515,140,17473,23499;23697;25623;25720;26122,48180,1,2,2,0,5
64516,140,17474,18724,48545,0,0,0,1,1
64517,140,17476,19185,48545,0,0,0,1,1
64518,140,17478,18420,48545,0,0,0,1,1
64519,140,17479,18605,48545,0,0,0,1,1
64520,140,17483,19646;19769,48545,0,0,2,0,2
64521,140,17484,19949;20014,48545,0,0,2,0,2
64522,140,17487,20021;20173,48545,0,0,2,0,2
64523,140,17489,20545;20848,48545,0,0,2,0,2
64524,140,17494,20908,48545,0,0,1,0,1
64525,140,17497,21097,48545,0,0,1,0,1
64526,140,17498,21131,48545,0,0,1,0,1
64527,140,17499,21218,48545,0,0,1,0,1
64528,140,17501,21288,48545,0,0,1,0,1
64529,140,17510,21582,48545,0,0,1,0,1
64530,140,17512,22867;24915;26183,48545,1,1,1,0,3
64531,140,17513,21898;21944;24882;25646,48545,0,2,2,0,4
64532,140,17514,22064,48545,0,0,1,0,1
64533,140,17515,22103;22621;25492,48545,0,1,2,0,3
64534,140,17516,22135;22248;25277,48545,0,1,2,0,3
64535,140,17518,22189;22620;25971,48545,1,0,2,0,3
64536,140,17519,22211;22518;25488;26058,48545,1,1,2,0,4
64537,140,17521,22354,48545,0,0,1,0,1
64538,140,17522,22266;22868;25122;26184,48545,1,1,2,0,4
64539,140,17524,21962;22392;25859,48545,1,0,2,0,3
64540,140,17525,22323;22397;24470;24902,48545,0,1,3,0,4
64541,140,17526,22426;23209,48545,0,0,2,0,2
64542,140,17527,22477,48545,0,0,1,0,1
64543,140,17528,21902;22284;26156,48545,1,0,2,0,3
64544,140,17529,22522;23158,48545,0,0,2,0,2
64545,140,17530,22567;22791;25120,48545,0,1,2,0,3
64546,140,17531,22661,48545,0,0,1,0,1
64547,140,17532,22690;23003;26095,48545,1,0,2,0,3
64548,140,17533,23126;23162;25707;26198,48545,1,1,2,0,4
64549,140,17534,22736;22926,48545,0,0,2,0,2
64550,140,17535,22554,48545,0,0,1,0,1
64551,140,17536,22633;22769,48545,0,0,2,0,2
64552,140,17537,22788;23358,48545,0,0,2,0,2
64553,140,17538,22795;23171;25605;25708,48545,0,2,2,0,4
64554,140,17539,22806,48545,0,0,1,0,1
64555,140,17540,22665;22824;26079;26272,48545,2,0,2,0,4
64556,140,17541,22541;23093;25897,48545,1,0,2,0,3
64557,140,17542,22955;23600;26188,48545,1,0,2,0,3
64558,140,17543,22625;22907;25696,48545,0,1,2,0,3
64559,140,17544,23034;23116;25901;26195,48545,2,0,2,0,4
64560,140,17545,23070;23744,48545,0,0,2,0,2
64561,140,17546,23011;23088;25891;25999,48545,2,0,2,0,4
64562,140,17547,23117;23311,48545,0,0,2,0,2
64563,140,17548,23136;23458;26312,48545,1,0,2,0,3
64564,140,17549,23150;23257;26007,48545,1,0,2,0,3
64565,140,17550,23157;23754,48545,0,0,2,0,2
64566,140,17551,23174;23942,48545,0,0,2,0,2
64567,140,17552,22909;23217;25417;25607;25905;26291,48545,2,2,2,0,6
64568,140,17553,23275;23559,48545,0,0,2,0,2
64569,140,17554,23075;23337,48545,0,0,2,0,2
64570,140,17555,23112;23304;25207,48545,0,1,2,0,3
64571,140,17556,23103;23319;25511;26012;26298,48545,2,1,2,0,5
64572,140,17557,23342;23502;25419;26209,48545,1,1,2,0,4
64573,140,17558,23386;23405,48545,0,0,2,0,2
64574,140,17559,23395,48545,0,0,1,0,1
64575,140,17560,23414;23689,48545,0,0,2,0,2
64576,140,17561,23428;23662,48545,0,0,2,0,2
64577,140,17562,23107;23433;25899;26001;26286,48545,3,0,2,0,5
64578,140,17563,23415;23439;25714,48545,0,1,2,0,3
64579,140,17564,23453;23615,48545,0,0,2,0,2
64580,140,17565,23388;23454,48545,0,0,2,0,2
64581,140,17566,23361;23870,48545,0,0,2,0,2
64582,140,17567,23493;23785,48545,0,0,2,0,2
64583,140,17568,23377;23515;26118,48545,1,0,2,0,3
64584,140,17569,23019;23538,48545,0,0,2,0,2
64585,140,17570,23549;23806,48545,0,0,2,0,2
64586,140,17571,23501;23562;25621,48545,0,1,2,0,3
64587,140,17572,23568;23918,48545,0,0,2,0,2
64588,140,17573,23468;23618,48545,0,0,2,0,2
64589,140,17574,19203,48910,0,0,0,1,1
64590,140,17576,19487,48910,0,0,1,0,1
64591,140,17577,20188,48910,0,0,1,0,1
64592,140,17580,20617,48910,0,0,1,0,1
64593,140,17581,20645;20760;24498,48910,0,0,3,0,3
64594,140,17583,20398;20651,48910,0,0,2,0,2
64595,140,17585,20703,48910,0,0,1,0,1
64596,140,17589,20846;20988,48910,0,0,2,0,2
64597,140,17592,21235,48910,0,0,1,0,1
64598,140,17595,21421;21730;25441,48910,0,1,2,0,3
64599,140,17596,21504,48910,0,0,1,0,1
64600,140,17599,21789;22458,48910,0,0,2,0,2
64601,140,17600,21856;21989;25752;25841;26241,48910,2,1,2,0,5
64602,140,17603,21672;22393;24386;24793;25482;26051;26162,48910,2,2,3,0,7
64603,140,17604,22663;25202;25683;26169;26265,48910,2,2,1,0,5
64604,140,17606,22472;25770,48910,0,1,1,0,2
64605,140,17608,22435;22438;24797;24998;26055,48910,1,2,2,0,5
64606,140,17609,22463,48910,0,0,1,0,1
64607,140,17610,22464;23031;26096,48910,1,0,2,0,3
64608,140,17611,22533;23152;25902;26197,48910,2,0,2,0,4
64609,140,17612,22402,48910,0,0,1,0,1
64610,140,17614,22543;22653;24684;25298;25779;25874,48910,1,3,2,0,6
64611,140,17615,22642;23078,48910,0,0,2,0,2
64612,140,17616,21932,48910,0,0,1,0,1
64613,140,17617,22797;23475,48910,0,0,2,0,2
64614,140,17618,22804;23394;26112,48910,1,0,2,0,3
64615,140,17619,22815;22819;25985,48910,1,0,2,0,3
64616,140,17620,22838,48910,0,0,1,0,1
64617,140,17621,22856;22978,48910,0,0,2,0,2
64618,140,17623,22843;22894;25123,48910,0,1,2,0,3
64619,140,17626,22979;22991;25887;25996,48910,2,0,2,0,4
64620,140,17627,22988;23076;25888,48910,1,0,2,0,3
64621,140,17628,22999;23233;25711,48910,0,1,2,0,3
64622,140,17629,23017;23141;26283,48910,1,0,2,0,3
64623,140,17630,23032;23138;26098,48910,1,0,2,0,3
64624,140,17631,22787;23042;25701,48910,0,1,2,0,3
64625,140,17632,23167;23372;25208;25615;26111,48910,1,2,2,0,5
64626,140,17633,23037;23607,48910,0,0,2,0,2
64627,140,17634,23202;26006;26101,48910,2,0,1,0,3
64628,140,17635,23221;23350,48910,0,0,2,0,2
64629,140,17636,22542;23224,48910,0,0,2,0,2
64630,140,17637,23242,48910,0,0,1,0,1
64631,140,17638,23255;23696,48910,0,0,2,0,2
64632,140,17639,23195;23722;25821,48910,0,1,2,0,3
64633,140,17640,23270;23736,48910,0,0,2,0,2
64634,140,17641,23148;23292;26004,48910,1,0,2,0,3
64635,140,17642,23313;23330,48910,0,0,2,0,2
64636,140,17643,23548;26217,48910,1,0,1,0,2
64637,140,17644,23302;23343,48910,0,0,2,0,2
64638,140,17645,23359;23781,48910,0,0,2,0,2
64639,140,17646,23385;23482,48910,0,0,2,0,2
64640,140,17647,23341;23387,48910,0,0,2,0,2
64641,140,17648,23198;23410;26309,48910,1,0,2,0,3
64642,140,17649,23422;23966,48910,0,0,2,0,2
64643,140,17650,24015,48910,0,0,1,0,1
64644,140,17651,23256;23449;25206,48910,0,1,2,0,3
64645,140,17652,23451;23874,48910,0,0,2,0,2
64646,140,17653,23577,48910,0,0,1,0,1
64647,140,17654,23489;23612;25319;25817,48910,0,2,2,0,4
64648,140,17655,23496;23525,48910,0,0,2,0,2
64649,140,17656,23110;23506;25909,48910,1,0,2,0,3
64650,140,17657,23507;24067,48910,0,0,2,0,2
64651,140,17658,23511;23747,48910,0,0,2,0,2
64652,140,17659,23523;23835,48910,0,0,2,0,2
64653,140,17660,23759;23780,48910,0,0,2,0,2
64654,140,17661,23537;25911,48910,1,0,1,0,2
64655,140,17662,23579;23699;25820,48910,0,1,2,0,3
64656,140,17663,23580;23585,48910,0,0,2,0,2
64657,140,17664,23596;24058,48910,0,0,2,0,2
64658,140,17665,23598;23642;26023,48910,1,0,2,0,3
64659,140,17666,23664;24079,48910,0,0,2,0,2
64660,140,17667,23688;23698,48910,0,0,2,0,2
64661,140,17668,23123;23703;26322,48910,1,0,2,0,3
64662,140,17670,19396,49275,0,0,0,1,1
64663,140,17673,19836,49275,0,0,1,0,1
64664,140,17674,19746,49275,0,0,1,0,1
64665,140,17676,20030,49275,0,0,1,0,1
64666,140,17677,19870,49275,0,0,1,0,1
64667,140,17680,20423,49275,0,0,1,0,1
64668,140,17682,19909;20086,49275,0,0,2,0,2
64669,140,17686,21069,49275,0,0,1,0,1
64670,140,17688,21095,49275,0,0,1,0,1
64671,140,17693,21452;21568,49275,0,0,2,0,2
64672,140,17698,21634,49275,0,0,1,0,1
64673,140,17699,21685;22228;24567,49275,0,0,3,0,3
64674,140,17702,22002;22410;24795;25954,49275,1,1,2,0,4
64675,140,17703,22428,49275,0,0,1,0,1
64676,140,17704,22253,49275,0,0,1,0,1
64677,140,17705,22453;23215,49275,0,0,2,0,2
64678,140,17706,22506;22901;26083;26278,49275,2,0,2,0,4
64679,140,17707,22544;22857;25008,49275,0,1,2,0,3
64680,140,17708,22423,49275,0,0,1,0,1
64681,140,17709,22834,49275,0,0,1,0,1
64682,140,17710,22610;22649;25873,49275,1,0,2,0,3
64683,140,17711,22616;23012,49275,0,0,2,0,2
64684,140,17712,22200,49275,0,0,1,0,1
64685,140,17714,22704,49275,0,0,1,0,1
64686,140,17715,22289,49275,0,0,1,0,1
64687,140,17716,22514;22723;25594,49275,0,1,2,0,3
64688,140,17717,22732;22954,49275,0,0,2,0,2
64689,140,17719,22800;22852,49275,0,0,2,0,2
64690,140,17720,22821;22902;25695;25989,49275,1,1,2,0,4
64691,140,17723,23353;26013;26303,49275,2,0,1,0,3
64692,140,17724,22488;23041;26000,49275,1,0,2,0,3
64693,140,17726,23220;23312,49275,0,0,2,0,2
64694,140,17727,23296;23708,49275,0,0,2,0,2
64695,140,17728,23317;23825;26325,49275,1,0,2,0,3
64696,140,17729,23328;26208;26299,49275,2,0,1,0,3
64697,140,17730,23336;23952,49275,0,0,2,0,2
64698,140,17731,23383;23391,49275,0,0,2,0,2
64699,140,17732,23411;23461;26016;26113,49275,2,0,2,0,4
64700,140,17733,23164;23491;25514,49275,0,1,2,0,3
64701,140,17734,23504;24041,49275,0,0,2,0,2
64702,140,17735,23516;23675,49275,0,0,2,0,2
64703,140,17736,23517;23916;25723,49275,0,1,2,0,3
64704,140,17737,23522;24145,49275,0,0,2,0,2
64705,140,17738,23360;23542;25718,49275,0,1,2,0,3
64706,140,17739,23587;23614,49275,0,0,2,0,2
64707,140,17740,23590;23977,49275,0,0,2,0,2
64708,140,17741,23632;23963,49275,0,0,2,0,2
64709,140,17742,23635;23771,49275,0,0,2,0,2
64710,140,17743,23552;23638,49275,0,0,2,0,2
64711,140,17744,23630;23641,49275,0,0,2,0,2
64712,140,17745,23653;26221,49275,1,0,1,0,2
64713,140,17746,23289;23670;26320,49275,1,0,2,0,3
64714,140,17747,24120;26137,49275,1,0,1,0,2
64715,140,17748,23693;24111,49275,0,0,2,0,2
64716,140,17749,23717;23782;26324,49275,1,0,2,0,3
64717,140,17750,23730;24018,49275,0,0,2,0,2
64718,140,17751,23745;23877,49275,0,0,2,0,2
64719,140,17752,23495;23762;26127,49275,1,0,2,0,3
64720,140,17753,23764;23965;26330,49275,1,0,2,0,3
64721,140,17754,23558;23768,49275,0,0,2,0,2
64722,140,17755,23529,49275,0,0,1,0,1
64723,140,17756,23711;23820,49275,0,0,2,0,2
64724,140,17757,23645;23822,49275,0,0,2,0,2
64725,140,17758,23789;23830,49275,0,0,2,0,2
64726,140,17759,23795;25516,49275,0,1,1,0,2
64727,140,17761,19434,49640,0,0,1,0,1
64728,140,17762,19822,49640,0,0,1,0,1
64729,140,17763,19830,49640,0,0,1,0,1
64730,140,17764,19881,49640,0,0,1,0,1
64731,140,17765,19908;19942,49640,0,0,2,0,2
64732,140,17767,19972,49640,0,0,1,0,1
64733,140,17768,20252;20389,49640,0,0,2,0,2
64734,140,17770,20322,49640,0,0,1,0,1
64735,140,17771,20473,49640,0,0,1,0,1
64736,140,17772,20478,49640,0,0,1,0,1
64737,140,17773,20540;20695;24315;24591,49640,0,1,3,0,4
64738,140,17776,20658,49640,0,0,1,0,1
64739,140,17777,20661,49640,0,0,1,0,1
64740,140,17778,20857,49640,0,0,1,0,1
64741,140,17779,20698;20790,49640,0,0,2,0,2
64742,140,17780,20915,49640,0,0,1,0,1
64743,140,17787,21525,49640,0,0,1,0,1
64744,140,17788,21545,49640,0,0,1,0,1
64745,140,17791,21443;21651,49640,0,0,2,0,2
64746,140,17792,21915,49640,0,0,1,0,1
64747,140,17793,21921,49640,0,0,1,0,1
64748,140,17794,21983;22110,49640,0,0,2,0,2
64749,140,17795,21855,49640,0,0,1,0,1
64750,140,17796,21817,49640,0,0,1,0,1
64751,140,17797,22319,49640,0,0,1,0,1
64752,140,17798,22378,49640,0,0,1,0,1
64753,140,17800,22532,49640,0,0,1,0,1
64754,140,17801,22548;23139,49640,0,0,2,0,2
64755,140,17802,22949;25992,49640,1,0,1,0,2
64756,140,17803,22615;22709;25300;25685;26171,49640,1,2,2,0,5
64757,140,17804,22470,49640,0,0,1,0,1
64758,140,17805,22305,49640,0,0,1,0,1
64759,140,17806,22934;25793,49640,0,1,1,0,2
64760,140,17807,22247;22816;25881,49640,1,0,2,0,3
64761,140,17808,22879;23426,49640,0,0,2,0,2
64762,140,17809,23054;23457,49640,0,0,2,0,2
64763,140,17810,22889,49640,0,0,1,0,1
64764,140,17811,23082;23196,49640,0,0,2,0,2
64765,140,17812,23125;23128;26002,49640,1,0,2,0,3
64766,140,17813,23132;23774,49640,0,0,2,0,2
64767,140,17814,23237;23586,49640,0,0,2,0,2
64768,140,17815,22942,49640,0,0,1,0,1
64769,140,17816,23066;23280,49640,0,0,2,0,2
64770,140,17817,23348,49640,0,0,1,0,1
64771,140,17818,23335;23706,49640,0,0,2,0,2
64772,140,17819,23113;23346;25316,49640,0,1,2,0,3
64773,140,17820,23371;23513;26305,49640,1,0,2,0,3
64774,140,17821,23403;23903,49640,0,0,2,0,2
64775,140,17822,23129;23408,49640,0,0,2,0,2
64776,140,17823,23375;23478;26212,49640,1,0,2,0,3
64777,140,17824,23539;23551,49640,0,0,2,0,2
64778,140,17825,23555;23983,49640,0,0,2,0,2
64779,140,17826,23588;23673,49640,0,0,2,0,2
64780,140,17827,23827,49640,0,0,1,0,1
64781,140,17828,23620;23650,49640,0,0,2,0,2
64782,140,17829,23446,49640,0,0,1,0,1
64783,140,17830,23561;23655;25819,49640,0,1,2,0,3
64784,140,17831,23431;23677;26321,49640,1,0,2,0,3
64785,140,17832,23058;23756;26126,49640,1,0,2,0,3
64786,140,17833,23798;24208,49640,0,0,2,0,2
64787,140,17834,23801;23885,49640,0,0,2,0,2
64788,140,17835,23828;24118,49640,0,0,2,0,2
64789,140,17836,23838;24188,49640,0,0,2,0,2
64790,140,17837,23409;23878;25209,49640,0,1,2,0,3
64791,140,17838,23909;24179,49640,0,0,2,0,2
64792,140,17839,23816;23926,49640,0,0,2,0,2
64793,140,17840,23932;26228,49640,1,0,1,0,2
64794,140,17841,23955,49640,0,0,1,0,1
64795,140,17842,23956;24031,49640,0,0,2,0,2
64796,140,17844,19634,50005,0,0,1,0,1
64797,140,17845,19544,50005,0,0,1,0,1
64798,140,17846,19789,50005,0,0,1,0,1
64799,140,17847,19438,50005,0,0,1,0,1
64800,140,17849,20071;20443,50005,0,0,2,0,2
64801,140,17850,19931,50005,0,0,1,0,1
64802,140,17852,20471,50005,0,0,1,0,1
64803,140,17853,20430,50005,0,0,1,0,1
64804,140,17858,20401;20588,50005,0,0,2,0,2
64805,140,17859,20702,50005,0,0,1,0,1
64806,140,17861,21454,50005,0,0,1,0,1
64807,140,17862,21611,50005,0,0,1,0,1
64808,140,17864,21879,50005,0,0,1,0,1
64809,140,17865,21984;22074,50005,0,0,2,0,2
64810,140,17866,21887,50005,0,0,1,0,1
64811,140,17867,22076,50005,0,0,1,0,1
64812,140,17869,22144;22263,50005,0,0,2,0,2
64813,140,17870,22293,50005,0,0,1,0,1
64814,140,17871,21948,50005,0,0,1,0,1
64815,140,17872,21992,50005,0,0,1,0,1
64816,140,17873,22080,50005,0,0,1,0,1
64817,140,17874,22373;22953;25885;26187,50005,2,0,2,0,4
64818,140,17875,22116;22389;25110;25576;25673;25768,50005,0,4,2,0,6
64819,140,17876,22441,50005,0,0,1,0,1
64820,140,17877,22471,50005,0,0,1,0,1
64821,140,17878,21982,50005,0,0,1,0,1
64822,140,17880,22574;22774;26271,50005,1,0,2,0,3
64823,140,17883,22299,50005,0,0,1,0,1
64824,140,17884,22943;23306,50005,0,0,2,0,2
64825,140,17885,22974,50005,0,0,1,0,1
64826,140,17886,23006;23197,50005,0,0,2,0,2
64827,140,17887,23685;25719;26222,50005,1,1,1,0,3
64828,140,17888,22744;23081;25704;25894,50005,1,1,2,0,4
64829,140,17889,22913;23083;25507;25895,50005,1,1,2,0,4
64830,140,17890,22959;23092;25125;26097,50005,1,1,2,0,4
64831,140,17891,23169;23450;26114,50005,1,0,2,0,3
64832,140,17892,22905;23172;25306,50005,0,1,2,0,3
64833,140,17893,23338;23592,50005,0,0,2,0,2
64834,140,17894,23624,50005,0,0,1,0,1
64835,140,17895,23249;23750,50005,0,0,2,0,2
64836,140,17896,23352,50005,0,0,1,0,1
64837,140,17897,23291;23381,50005,0,0,2,0,2
64838,140,17898,23331;23404;26109,50005,1,0,2,0,3
64839,140,17899,23557;23933,50005,0,0,2,0,2
64840,140,17900,23027;23427,50005,0,0,2,0,2
64841,140,17901,23365,50005,0,0,1,0,1
64842,140,17902,23389,50005,0,0,1,0,1
64843,140,17903,23440;23824,50005,0,0,2,0,2
64844,140,17904,23591;25816,50005,0,1,1,0,2
64845,140,17905,23519,50005,0,0,1,0,1
64846,140,17906,23528;23758,50005,0,0,2,0,2
64847,140,17907,23535;23908;26130,50005,1,0,2,0,3
64848,140,17908,23295;23547,50005,0,0,2,0,2
64849,140,17909,23473;23657,50005,0,0,2,0,2
64850,140,17910,23578;23964,50005,0,0,2,0,2
64851,140,17911,23582;23702,50005,0,0,2,0,2
64852,140,17912,23611;23799,50005,0,0,2,0,2
64853,140,17913,23636;23960,50005,0,0,2,0,2
64854,140,17914,23671,50005,0,0,1,0,1
64855,140,17915,23701;23900;25921;26227,50005,2,0,2,0,4
64856,140,17916,23723;24029,50005,0,0,2,0,2
64857,140,17917,23746,50005,0,0,1,0,1
64858,140,17918,23508;23773;26026,50005,1,0,2,0,3
64859,140,17919,23777;24100,50005,0,0,2,0,2
64860,140,17920,23533;23783,50005,0,0,2,0,2
64861,140,17921,23518;23791;26027,50005,1,0,2,0,3
64862,140,17922,23652;23802,50005,0,0,2,0,2
64863,140,17923,24152;26139,50005,1,0,1,0,2
64864,140,17924,23797;23826,50005,0,0,2,0,2
64865,140,17925,23832;23982,50005,0,0,2,0,2
64866,140,17926,23619;23851,50005,0,0,2,0,2
64867,140,17927,23863;24245;26141,50005,1,0,2,0,3
64868,140,17928,23865,50005,0,0,1,0,1
64869,140,17929,23911;24112;26136,50005,1,0,2,0,3
64870,140,17930,23914;24221,50005,0,0,2,0,2
64871,140,17931,23931;24277,50005,0,0,2,0,2
64872,140,17932,23276;23954,50005,0,0,2,0,2
64873,140,17933,23488;23957,50005,0,0,2,0,2
64874,140,17934,23654;23969;26133,50005,1,0,2,0,3
64875,140,17935,23978;24001,50005,0,0,2,0,2
64876,140,17936,23986;24049,50005,0,0,2,0,2
64877,140,17937,23990;24348,50005,0,0,2,0,2
64878,140,17938,23995;24099,50005,0,0,2,0,2
64879,140,17939,23443;23917;26030,50005,1,0,2,0,3
64880,140,17940,24016,50005,0,0,1,0,1
64881,140,17941,23808;24027,50005,0,0,2,0,2
64882,140,17942,24030;24266,50005,0,0,2,0,2
64883,140,17944,24008;24044;26331,50005,1,0,2,0,3
64884,140,17945,24062;24280;26142,50005,1,0,2,0,3
64885,140,17946,24078;24259,50005,0,0,2,0,2
64886,140,17947,23981;24083,50005,0,0,2,0,2
64887,140,17948,19721,50370,0,0,1,0,1
64888,140,17949,19750,50370,0,0,1,0,1
64889,140,17951,19784,50370,0,0,1,0,1
64890,140,17953,19990;20274,50370,0,0,2,0,2
64891,140,17956,20190;20452;24579,50370,0,1,2,0,3
64892,140,17957,20204,50370,0,0,1,0,1
64893,140,17959,19918;20171,50370,0,0,2,0,2
64894,140,17961,20298,50370,0,0,1,0,1
64895,140,17962,20666,50370,0,0,1,0,1
64896,140,17964,20743,50370,0,0,1,0,1
64897,140,17965,20542,50370,0,0,1,0,1
64898,140,17968,21082,50370,0,0,1,0,1
64899,140,17969,20819,50370,0,0,1,0,1
64900,140,17970,21102,50370,0,0,1,0,1
64901,140,17971,21116,50370,0,0,1,0,1
64902,140,17972,21516,50370,0,0,1,0,1
64903,140,17973,21542,50370,0,0,1,0,1
64904,140,17974,21593,50370,0,0,1,0,1
64905,140,17976,21627;24862,50370,0,1,1,0,2
64906,140,17977,21742,50370,0,0,1,0,1
64907,140,17978,21701,50370,0,0,1,0,1
64908,140,17979,21758,50370,0,0,1,0,1
64909,140,17980,21955,50370,0,0,1,0,1
64910,140,17982,22087,50370,0,0,1,0,1
64911,140,17983,22204,50370,0,0,1,0,1
64912,140,17984,21903;22425;24997,50370,0,1,2,0,3
64913,140,17985,22223,50370,0,0,1,0,1
64914,140,17986,22244,50370,0,0,1,0,1
64915,140,17990,22047,50370,0,0,1,0,1
64916,140,17991,22613;22968,50370,0,0,2,0,2
64917,140,17994,22904,50370,0,0,1,0,1
64918,140,17995,22950,50370,0,0,1,0,1
64919,140,17996,22930,50370,0,0,1,0,1
64920,140,17997,22952;22998;25797;26094,50370,1,1,2,0,4
64921,140,17998,23056;23483;25210,50370,0,1,2,0,3
64922,140,17999,22861,50370,0,0,1,0,1
64923,140,18000,23159,50370,0,0,1,0,1
64924,140,18001,23190;23298;26106;26297,50370,2,0,2,0,4
64925,140,18002,23246;23563,50370,0,0,2,0,2
64926,140,18003,23258;23683;25420,50370,0,1,2,0,3
64927,140,18004,22946;23285,50370,0,0,2,0,2
64928,140,18005,23325,50370,0,0,1,0,1
64929,140,18006,23039,50370,0,0,1,0,1
64930,140,18007,23354;23788,50370,0,0,2,0,2
64931,140,18008,23369;23988,50370,0,0,2,0,2
64932,140,18009,23406,50370,0,0,1,0,1
64933,140,18010,23434,50370,0,0,1,0,1
64934,140,18011,23448;23574,50370,0,0,2,0,2
64935,140,18012,22984,50370,0,0,1,0,1
64936,140,18013,23462;23839,50370,0,0,2,0,2
64937,140,18014,23416;23474,50370,0,0,2,0,2
64938,140,18015,23282;23531,50370,0,0,2,0,2
64939,140,18016,23046,50370,0,0,1,0,1
64940,140,18017,23543;23760;26025,50370,1,0,2,0,3
64941,140,18018,23532;23545;26119,50370,1,0,2,0,3
64942,140,18019,23182,50370,0,0,1,0,1
64943,140,18020,23540;23553;25620,50370,0,1,2,0,3
64944,140,18021,23268;23576,50370,0,0,2,0,2
64945,140,18022,23534;23608;25619,50370,0,1,2,0,3
64946,140,18023,23643;24003,50370,0,0,2,0,2
64947,140,18024,24178,50370,0,0,1,0,1
64948,140,18025,23661;23763,50370,0,0,2,0,2
64949,140,18026,23345;23715;26123,50370,1,0,2,0,3
64950,140,18027,23308;23734,50370,0,0,2,0,2
64951,140,18028,23234;23322;25512,50370,0,1,2,0,3
64952,140,18029,23833,50370,0,0,1,0,1
64953,140,18030,23804;24084,50370,0,0,2,0,2
64954,140,18031,23467;23844,50370,0,0,2,0,2
64955,140,18032,23629;23850,50370,0,0,2,0,2
64956,140,18033,23425;23867,50370,0,0,2,0,2
64957,140,18034,23583;23868;26226;26327,50370,2,0,2,0,4
64958,140,18035,23875;24202;26235,50370,1,0,2,0,3
64959,140,18036,23901;24288,50370,0,0,2,0,2
64960,140,18037,23927;24021,50370,0,0,2,0,2
64961,140,18038,24094;24146,50370,0,0,2,0,2
64962,140,18039,23980;24285,50370,0,0,2,0,2
64963,140,18040,23985;24214,50370,0,0,2,0,2
64964,140,18041,23684;24010,50370,0,0,2,0,2
64965,140,18042,24034;24289,50370,0,0,2,0,2
64966,140,18043,23971;24039,50370,0,0,2,0,2
64967,140,18044,23634;24040,50370,0,0,2,0,2
64968,140,18045,24047,50370,0,0,1,0,1
64969,140,18046,24116;24460,50370,0,0,2,0,2
64970,140,18047,23770;24160,50370,0,0,2,0,2
64971,140,18048,24172;24186,50370,0,0,2,0,2
64972,140,18049,24181;24265,50370,0,0,2,0,2
64973,140,18050,24183;24314,50370,0,0,2,0,2
64974,140,18051,24189;24368,50370,0,0,2,0,2
64975,140,18052,19450,50735,0,0,1,0,1
64976,140,18053,19390,50735,0,0,0,1,1
64977,140,18054,19777,50735,0,0,1,0,1
64978,140,18055,19288,50735,0,0,0,1,1
64979,140,18056,19981,50735,0,0,1,0,1
64980,140,18058,20023,50735,0,0,1,0,1
64981,140,18061,19997,50735,0,0,1,0,1
64982,140,18062,20083,50735,0,0,1,0,1
64983,140,18063,20716,50735,0,0,1,0,1
64984,140,18064,20508,50735,0,0,1,0,1
64985,140,18065,20719,50735,0,0,1,0,1
64986,140,18066,20838,50735,0,0,1,0,1
64987,140,18067,20944,50735,0,0,1,0,1
64988,140,18068,20841,50735,0,0,1,0,1
64989,140,18069,21343,50735,0,0,1,0,1
64990,140,18070,21041,50735,0,0,1,0,1
64991,140,18071,21508,50735,0,0,1,0,1
64992,140,18072,21554,50735,0,0,1,0,1
64993,140,18073,21629,50735,0,0,1,0,1
64994,140,18075,21226,50735,0,0,1,0,1
64995,140,18076,21739,50735,0,0,1,0,1
64996,140,18077,21812,50735,0,0,1,0,1
64997,140,18078,21169,50735,0,0,1,0,1
64998,140,18079,22025,50735,0,0,1,0,1
64999,140,18080,21529,50735,0,0,1,0,1
65000,140,18081,21677,50735,0,0,1,0,1
65001,140,18082,22128,50735,0,0,1,0,1
65002,140,18083,22646,50735,0,0,1,0,1
65003,140,18084,22559,50735,0,0,1,0,1
65004,140,18085,22678;23210;26290,50735,1,0,2,0,3
65005,140,18086,22733,50735,0,0,1,0,1
65006,140,18087,22764;23228,50735,0,0,2,0,2
65007,140,18088,22773,50735,0,0,1,0,1
65008,140,18089,22523,50735,0,0,1,0,1
65009,140,18090,22789,50735,0,0,1,0,1
65010,140,18091,22766,50735,0,0,1,0,1
65011,140,18092,22957,50735,0,0,1,0,1
65012,140,18093,22827,50735,0,0,1,0,1
65013,140,18094,23118;23861,50735,0,0,2,0,2
65014,140,18095,23149,50735,0,0,1,0,1
65015,140,18096,23204,50735,0,0,1,0,1
65016,140,18097,23122;23222,50735,0,0,2,0,2
65017,140,18098,23236;23766,50735,0,0,2,0,2
65018,140,18099,23207;23261;26201,50735,1,0,2,0,3
65019,140,18100,23305,50735,0,0,1,0,1
65020,140,18101,23175;23392;26014,50735,1,0,2,0,3
65021,140,18102,23213;23407;26213;26308,50735,2,0,2,0,4
65022,140,18103,23412;23862;25918,50735,1,0,2,0,3
65023,140,18104,23429;23692,50735,0,0,2,0,2
65024,140,18105,23442,50735,0,0,1,0,1
65025,140,18106,23373;23509;26216,50735,1,0,2,0,3
65026,140,18107,23584,50735,0,0,1,0,1
65027,140,18108,23487,50735,0,0,1,0,1
65028,140,18109,23593,50735,0,0,1,0,1
65029,140,18110,23604,50735,0,0,1,0,1
65030,140,18111,23610;23757;25914,50735,1,0,2,0,3
65031,140,18112,23500;23613,50735,0,0,2,0,2
65032,140,18113,23344;23714;26323,50735,1,0,2,0,3
65033,140,18114,23455;23765,50735,0,0,2,0,2
65034,140,18115,23494;23776;26224,50735,1,0,2,0,3
65035,140,18116,23809,50735,0,0,1,0,1
65036,140,18117,23882,50735,0,0,1,0,1
65037,140,18118,23886;24338,50735,0,0,2,0,2
65038,140,18119,23920,50735,0,0,1,0,1
65039,140,18120,23945;26132,50735,1,0,1,0,2
65040,140,18121,23727;23967,50735,0,0,2,0,2
65041,140,18122,23786;24006,50735,0,0,2,0,2
65042,140,18123,24026;24164,50735,0,0,2,0,2
65043,140,18124,23883;24053,50735,0,0,2,0,2
65044,140,18125,23740;24074,50735,0,0,2,0,2
65045,140,18126,23779;24098,50735,0,0,2,0,2
65046,140,18127,24104;24458;26336,50735,1,0,2,0,3
65047,140,18128,24130;24282,50735,0,0,2,0,2
65048,140,18129,24072;24134,50735,0,0,2,0,2
65049,140,18130,24157,50735,0,0,1,0,1
65050,140,18131,23753;24177;25725;26233,50735,1,1,2,0,4
65051,140,18132,24060;24191,50735,0,0,2,0,2
65052,140,18133,24236;24405,50735,0,0,2,0,2
65053,140,18134,24262;24431,50735,0,0,2,0,2
65054,140,18135,19927,51100,0,0,1,0,1
65055,140,18136,19938,51100,0,0,1,0,1
65056,140,18137,20043,51100,0,0,1,0,1
65057,140,18138,20305,51100,0,0,1,0,1
65058,140,18139,20026,51100,0,0,1,0,1
65059,140,18140,20446,51100,0,0,1,0,1
65060,140,18141,20525,51100,0,0,1,0,1
65061,140,18142,20850,51100,0,0,1,0,1
65062,140,18143,20713,51100,0,0,1,0,1
65063,140,18144,20803,51100,0,0,1,0,1
65064,140,18145,20872,51100,0,0,1,0,1
65065,140,18146,20733,51100,0,0,1,0,1
65066,140,18147,20933,51100,0,0,1,0,1
65067,140,18148,20669,51100,0,0,1,0,1
65068,140,18150,21485,51100,0,0,1,0,1
65069,140,18151,21604,51100,0,0,1,0,1
65070,140,18152,21517,51100,0,0,1,0,1
65071,140,18153,21556,51100,0,0,1,0,1
65072,140,18154,21696,51100,0,0,1,0,1
65073,140,18155,21407,51100,0,0,1,0,1
65074,140,18156,21770,51100,0,0,1,0,1
65075,140,18157,21601,51100,0,0,1,0,1
65076,140,18158,21113,51100,0,0,1,0,1
65077,140,18159,21566,51100,0,0,1,0,1
65078,140,18160,21825,51100,0,0,1,0,1
65079,140,18161,22233,51100,0,0,1,0,1
65080,140,18162,22259,51100,0,0,1,0,1
65081,140,18163,22100,51100,0,0,1,0,1
65082,140,18164,22353,51100,0,0,1,0,1
65083,140,18165,22332,51100,0,0,1,0,1
65084,140,18166,22321,51100,0,0,1,0,1
65085,140,18167,22444,51100,0,0,1,0,1
65086,140,18168,22546,51100,0,0,1,0,1
65087,140,18169,22579,51100,0,0,1,0,1
65088,140,18170,22609,51100,0,0,1,0,1
65089,140,18171,22627,51100,0,0,1,0,1
65090,140,18172,22664,51100,0,0,1,0,1
65091,140,18173,22467,51100,0,0,1,0,1
65092,140,18174,22575,51100,0,0,1,0,1
65093,140,18175,22858;23367;25713;25812;26304,51100,1,2,2,0,5
65094,140,18176,21966,51100,0,0,1,0,1
65095,140,18177,22908,51100,0,0,1,0,1
65096,140,18178,22628,51100,0,0,1,0,1
65097,140,18179,22684,51100,0,0,1,0,1
65098,140,18180,22595,51100,0,0,1,0,1
65099,140,18181,23044,51100,0,0,1,0,1
65100,140,18182,23047,51100,0,0,1,0,1
65101,140,18183,23077,51100,0,0,1,0,1
65102,140,18184,23151,51100,0,0,1,0,1
65103,140,18185,23156,51100,0,0,1,0,1
65104,140,18186,23023,51100,0,0,1,0,1
65105,140,18187,22552,51100,0,0,1,0,1
65106,140,18188,23297;23902;26328,51100,1,0,2,0,3
65107,140,18189,23165;23436,51100,0,0,2,0,2
65108,140,18190,23477;23594;25318,51100,0,1,2,0,3
65109,140,18191,23320;23497,51100,0,0,2,0,2
65110,140,18192,23347;23527,51100,0,0,2,0,2
65111,140,18193,23355;23530,51100,0,0,2,0,2
65112,140,18194,23573;23720,51100,0,0,2,0,2
65113,140,18195,23266;23602,51100,0,0,2,0,2
65114,140,18196,23179;23622,51100,0,0,2,0,2
65115,140,18197,23651,51100,0,0,1,0,1
65116,140,18198,23672;24013,51100,0,0,2,0,2
65117,140,18199,23812;24162,51100,0,0,2,0,2
65118,140,18200,23601,51100,0,0,1,0,1
65119,140,18201,23829;24352,51100,0,0,2,0,2
65120,140,18202,23752;23853;26129;26326,51100,2,0,2,0,4
65121,140,18203,23857,51100,0,0,1,0,1
65122,140,18204,23943,51100,0,0,1,0,1
65123,140,18205,23950;24076,51100,0,0,2,0,2
65124,140,18206,23514;23953,51100,0,0,2,0,2
65125,140,18207,23419;23972,51100,0,0,2,0,2
65126,140,18208,23975;24035,51100,0,0,2,0,2
65127,140,18209,24007,51100,0,0,1,0,1
65128,140,18210,24009;24336,51100,0,0,2,0,2
65129,140,18211,24014,51100,0,0,1,0,1
65130,140,18212,24036;24484,51100,0,0,2,0,2
65131,140,18213,23855;24038,51100,0,0,2,0,2
65132,140,18214,24054;24212,51100,0,0,2,0,2
65133,140,18215,23674,51100,0,0,1,0,1
65134,140,18216,24121;24275,51100,0,0,2,0,2
65135,140,18217,24123;24187,51100,0,0,2,0,2
65136,140,18218,24136;24283,51100,0,0,2,0,2
65137,140,18219,24170;24218,51100,0,0,2,0,2
65138,140,18220,24163;24193,51100,0,0,2,0,2
65139,140,18221,23894;24195,51100,0,0,2,0,2
65140,140,18222,24196;24471,51100,0,0,2,0,2
65141,140,18223,23725;24211,51100,0,0,2,0,2
65142,140,18224,24216;24577,51100,0,1,1,0,2
65143,140,18225,24225;24327,51100,0,0,2,0,2
65144,140,18226,24075;24290,51100,0,0,2,0,2
65145,140,18227,24297,51100,0,0,1,0,1
65146,140,18228,24299,51100,0,0,1,0,1
65147,140,18229,23996;24303,51100,0,0,2,0,2
65148,140,18230,24324,51100,0,0,1,0,1
65149,140,18231,24331;24435,51100,0,0,2,0,2
65150,140,18232,24129;24335,51100,0,0,2,0,2
65151,140,18233,24337,51100,0,0,1,0,1
65152,140,18234,24312;24354,51100,0,0,2,0,2
65153,140,18235,24360;24560,51100,0,0,2,0,2
65154,140,18236,23869;24363,51100,0,0,2,0,2
65155,140,18237,24365;24589,51100,0,1,1,0,2
65156,150,8182,17336,15695,0,0,0,1,1
65157,150,8491,21300,16790,0,0,1,0,1
65158,150,9036,18771,18980,0,0,0,1,1
65159,150,9443,18344;18756,20440,0,0,0,2,2
65160,150,9576,19314,20805,0,0,0,1,1
65161,150,9663,17311;18338;18734;18938,21170,0,0,0,4,4
65162,150,9754,19108;19627;19671;19919,21535,0,0,0,4,4
65163,150,9758,19030;22697,21535,0,0,1,1,2
65164,150,9870,19149,21900,0,0,0,1,1
65165,150,9876,18580,21900,0,0,0,1,1
65166,150,9968,18202,22265,0,0,0,1,1
65167,150,10109,19754;19910,22630,0,0,0,2,2
65168,150,10497,19848;19892,24090,0,0,0,2,2
65169,150,10845,20331,25185,0,0,0,1,1
65170,150,10966,16602,25550,0,0,0,1,1
65171,150,11044,16225,25915,0,0,0,1,1
65172,150,11057,16452,25915,0,0,0,1,1
65173,150,11068,20293;24108,25915,0,0,1,1,2
65174,150,11069,16599,25915,0,0,0,1,1
65175,150,11072,16601,25915,0,0,0,1,1
65176,150,11075,16650,25915,0,0,0,1,1
65177,150,11076,16483,25915,0,0,0,1,1
65178,150,11084,16787,25915,0,0,0,1,1
65179,150,11085,16381,25915,0,0,0,1,1
65180,150,11158,19913;19965,26280,0,0,0,2,2
65181,150,11172,16187,26280,0,0,0,1,1
65182,150,11207,16572,26280,0,0,0,1,1
65183,150,11215,16493,26280,0,0,0,1,1
65184,150,11220,16835,26280,0,0,0,1,1
65185,150,11230,16416,26280,0,0,0,1,1
65186,150,11231,17000,26280,0,0,0,1,1
65187,150,11234,20258;20603;20647;24238;25018,26280,0,0,4,1,5
65188,150,11295,20162;20236;24210,26645,0,0,1,2,3
65189,150,11325,16250,26645,0,0,0,1,1
65190,150,11327,16532,26645,0,0,0,1,1
65191,150,11341,16560,26645,0,0,0,1,1
65192,150,11352,16622,26645,0,0,0,1,1
65193,150,11359,16728,26645,0,0,0,1,1
65194,150,11442,16446,27010,0,0,0,1,1
65195,150,11460,17204,27010,0,0,0,1,1
65196,150,11466,16553,27010,0,0,0,1,1
65197,150,11468,20433,27010,0,0,0,1,1
65198,150,11558,23566;23962;26902;27281,27375,2,0,2,0,4
65199,150,11574,16580,27375,0,0,0,1,1
65200,150,11583,20460,27375,0,0,0,1,1
65201,150,11595,16927,27375,0,0,0,1,1
65202,150,11597,16845,27375,0,0,0,1,1
65203,150,11600,17029;17101,27375,0,0,0,2,2
65204,150,11663,16579,27740,0,0,0,1,1
65205,150,11679,16935,27740,0,0,0,1,1
65206,150,11700,17301,27740,0,0,0,1,1
65207,150,11701,17397,27740,0,0,0,1,1
65208,150,11702,17357,27740,0,0,0,1,1
65209,150,11703,17157,27740,0,0,0,1,1
65210,150,11710,17084,27740,0,0,0,1,1
65211,150,11711,17048,27740,0,0,0,1,1
65212,150,11713,17337,27740,0,0,0,1,1
65213,150,11717,17308,27740,0,0,0,1,1
65214,150,11800,16995,28105,0,0,0,1,1
65215,150,11801,17298,28105,0,0,0,1,1
65216,150,11802,17420,28105,0,0,0,1,1
65217,150,11803,17314,28105,0,0,0,1,1
65218,150,11812,16796,28105,0,0,0,1,1
65219,150,11818,17405,28105,0,0,0,1,1
65220,150,11819,17152,28105,0,0,0,1,1
65221,150,11821,17347,28105,0,0,0,1,1
65222,150,11916,16587,28470,0,0,0,1,1
65223,150,11918,17512,28470,0,0,0,1,1
65224,150,11923,17440;17441,28470,0,0,0,2,2
65225,150,11924,16989,28470,0,0,0,1,1
65226,150,11926,17438;17499,28470,0,0,0,2,2
65227,150,11929,20771;21234;24628,28470,0,0,3,0,3
65228,150,11932,17575,28470,0,0,0,1,1
65229,150,11934,17156,28470,0,0,0,1,1
65230,150,11938,17200,28470,0,0,0,1,1
65231,150,11940,17147,28470,0,0,0,1,1
65232,150,11941,17231,28470,0,0,0,1,1
65233,150,11943,17244;17246,28470,0,0,0,2,2
65234,150,11947,17509,28470,0,0,0,1,1
65235,150,11948,17312,28470,0,0,0,1,1
65236,150,11949,17344,28470,0,0,0,1,1
65237,150,12013,16983,28835,0,0,0,1,1
65238,150,12020,17595,28835,0,0,0,1,1
65239,150,12021,16847,28835,0,0,0,1,1
65240,150,12028,17533,28835,0,0,0,1,1
65241,150,12033,17551,28835,0,0,0,1,1
65242,150,12034,17605,28835,0,0,0,1,1
65243,150,12036,17131,28835,0,0,0,1,1
65244,150,12038,17066,28835,0,0,0,1,1
65245,150,12040,17687,28835,0,0,0,1,1
65246,150,12041,17123,28835,0,0,0,1,1
65247,150,12042,17091,28835,0,0,0,1,1
65248,150,12046,17493,28835,0,0,0,1,1
65249,150,12048,17704,28835,0,0,0,1,1
65250,150,12049,17239,28835,0,0,0,1,1
65251,150,12053,17288,28835,0,0,0,1,1
65252,150,12054,17307,28835,0,0,0,1,1
65253,150,12055,17323,28835,0,0,0,1,1
65254,150,12062,17671,28835,0,0,0,1,1
65255,150,12119,16462,29200,0,0,0,1,1
65256,150,12131,16621,29200,0,0,0,1,1
65257,150,12142,17019;17165,29200,0,0,0,2,2
65258,150,12145,17075,29200,0,0,0,1,1
65259,150,12149,17327,29200,0,0,0,1,1
65260,150,12154,20475,29200,0,0,0,1,1
65261,150,12157,17184;17316,29200,0,0,0,2,2
65262,150,12160,17616,29200,0,0,0,1,1
65263,150,12162,17710;17896,29200,0,0,0,2,2
65264,150,12164,17505,29200,0,0,0,1,1
65265,150,12236,16496,29565,0,0,0,1,1
65266,150,12243,25917,29565,0,1,0,0,1
65267,150,12248,16916,29565,0,0,0,1,1
65268,150,12249,17154,29565,0,0,0,1,1
65269,150,12251,17522,29565,0,0,0,1,1
65270,150,12254,17464,29565,0,0,0,1,1
65271,150,12257,17380,29565,0,0,0,1,1
65272,150,12260,17134,29565,0,0,0,1,1
65273,150,12263,17109;17245,29565,0,0,0,2,2
65274,150,12265,17662,29565,0,0,0,1,1
65275,150,12267,17364,29565,0,0,0,1,1
65276,150,12269,17923,29565,0,0,0,1,1
65277,150,12271,21767;21772;26726,29565,0,1,2,0,3
65278,150,12273,17566;17742,29565,0,0,0,2,2
65279,150,12275,17460,29565,0,0,0,1,1
65280,150,12277,17463,29565,0,0,0,1,1
65281,150,12281,17658,29565,0,0,0,1,1
65282,150,12282,17523,29565,0,0,0,1,1
65283,150,12285,17591,29565,0,0,0,1,1
65284,150,12292,17656,29565,0,0,0,1,1
65285,150,12293,17684,29565,0,0,0,1,1
65286,150,12348,16816,29930,0,0,0,1,1
65287,150,12359,17439;17445,29930,0,0,0,2,2
65288,150,12362,17135,29930,0,0,0,1,1
65289,150,12363,18088,29930,0,0,0,1,1
65290,150,12371,17972,29930,0,0,0,1,1
65291,150,12372,17007,29930,0,0,0,1,1
65292,150,12374,17675,29930,0,0,0,1,1
65293,150,12381,17661;18067,29930,0,0,0,2,2
65294,150,12382,16881,29930,0,0,0,1,1
65295,150,12384,17723,29930,0,0,0,1,1
65296,150,12387,18512,29930,0,0,0,1,1
65297,150,12388,17483;17796,29930,0,0,0,2,2
65298,150,12390,17801,29930,0,0,0,1,1
65299,150,12436,16354,30295,0,0,0,1,1
65300,150,12440,16973,30295,0,0,0,1,1
65301,150,12443,16746,30295,0,0,0,1,1
65302,150,12445,16516,30295,0,0,0,1,1
65303,150,12447,16513,30295,0,0,0,1,1
65304,150,12450,16619,30295,0,0,0,1,1
65305,150,12455,16677,30295,0,0,0,1,1
65306,150,12461,17538,30295,0,0,0,1,1
65307,150,12465,18203,30295,0,0,0,1,1
65308,150,12467,17289;17547;21925,30295,0,0,1,2,3
65309,150,12468,16954;17302,30295,0,0,0,2,2
65310,150,12474,17141,30295,0,0,0,1,1
65311,150,12477,17546,30295,0,0,0,1,1
65312,150,12480,17377,30295,0,0,0,1,1
65313,150,12482,17623,30295,0,0,0,1,1
65314,150,12483,17888,30295,0,0,0,1,1
65315,150,12484,17703,30295,0,0,0,1,1
65316,150,12485,18103,30295,0,0,0,1,1
65317,150,12486,18262,30295,0,0,0,1,1
65318,150,12490,18160,30295,0,0,0,1,1
65319,150,12492,18235,30295,0,0,0,1,1
65320,150,12493,17750,30295,0,0,0,1,1
65321,150,12494,17396,30295,0,0,0,1,1
65322,150,12500,17795,30295,0,0,0,1,1
65323,150,12501,17526;17857,30295,0,0,0,2,2
65324,150,12503,17645,30295,0,0,0,1,1
65325,150,12504,17880,30295,0,0,0,1,1
65326,150,12505,18135,30295,0,0,0,1,1
65327,150,12507,18197,30295,0,0,0,1,1
65328,150,12566,16598,30660,0,0,0,1,1
65329,150,12575,17720,30660,0,0,0,1,1
65330,150,12578,17132,30660,0,0,0,1,1
65331,150,12580,17268,30660,0,0,0,1,1
65332,150,12584,16976,30660,0,0,0,1,1
65333,150,12586,17630,30660,0,0,0,1,1
65334,150,12587,17903,30660,0,0,0,1,1
65335,150,12596,17882,30660,0,0,0,1,1
65336,150,12599,18122,30660,0,0,0,1,1
65337,150,12601,17711,30660,0,0,0,1,1
65338,150,12604,17735,30660,0,0,0,1,1
65339,150,12608,17151;17609,30660,0,0,0,2,2
65340,150,12610,17862,30660,0,0,0,1,1
65341,150,12611,17494;17782,30660,0,0,0,2,2
65342,150,12612,17951,30660,0,0,0,1,1
65343,150,12614,18232,30660,0,0,0,1,1
65344,150,12618,17598,30660,0,0,0,1,1
65345,150,12620,17850,30660,0,0,0,1,1
65346,150,12621,18131,30660,0,0,0,1,1
65347,150,12622,18007;21205;25044,30660,0,0,2,1,3
65348,150,12623,18230,30660,0,0,0,1,1
65349,150,12625,17870,30660,0,0,0,1,1
65350,150,12626,18340,30660,0,0,0,1,1
65351,150,12673,17102,31025,0,0,0,1,1
65352,150,12678,16758,31025,0,0,0,1,1
65353,150,12689,17282,31025,0,0,0,1,1
65354,150,12690,17192;17299,31025,0,0,0,2,2
65355,150,12693,17370,31025,0,0,0,1,1
65356,150,12694,17033,31025,0,0,0,1,1
65357,150,12697,18190;18200,31025,0,0,0,2,2
65358,150,12700,17674,31025,0,0,0,1,1
65359,150,12703,17731,31025,0,0,0,1,1
65360,150,12705,17942;18005;21228;23724;25915;26962;27263,31025,2,1,2,2,7
65361,150,12706,17769,31025,0,0,0,1,1
65362,150,12708,17873,31025,0,0,0,1,1
65363,150,12709,17889,31025,0,0,0,1,1
65364,150,12710,18133,31025,0,0,0,1,1
65365,150,12714,18274,31025,0,0,0,1,1
65366,150,12718,18281,31025,0,0,0,1,1
65367,150,12719,18053,31025,0,0,0,1,1
65368,150,12720,18075,31025,0,0,0,1,1
65369,150,12721,18163,31025,0,0,0,1,1
65370,150,12723,18185,31025,0,0,0,1,1
65371,150,12724,18225,31025,0,0,0,1,1
65372,150,12726,18096;18147,31025,0,0,0,2,2
65373,150,12767,16463,31390,0,0,0,1,1
65374,150,12781,17345,31390,0,0,0,1,1
65375,150,12791,17115,31390,0,0,0,1,1
65376,150,12796,17094;17434,31390,0,0,0,2,2
65377,150,12799,17238,31390,0,0,0,1,1
65378,150,12802,17495,31390,0,0,0,1,1
65379,150,12809,17155;17172,31390,0,0,0,2,2
65380,150,12812,18277,31390,0,0,0,1,1
65381,150,12813,18427,31390,0,0,0,1,1
65382,150,12814,17553,31390,0,0,0,1,1
65383,150,12815,17468,31390,0,0,0,1,1
65384,150,12816,17917,31390,0,0,0,1,1
65385,150,12817,18114,31390,0,0,0,1,1
65386,150,12818,18259,31390,0,0,0,1,1
65387,150,12819,17874;18006,31390,0,0,0,2,2
65388,150,12822,18405;18471,31390,0,0,0,2,2
65389,150,12823,17628;17920,31390,0,0,0,2,2
65390,150,12825,17871,31390,0,0,0,1,1
65391,150,12826,18398,31390,0,0,0,1,1
65392,150,12827,17618;18267,31390,0,0,0,2,2
65393,150,12828,18348,31390,0,0,0,1,1
65394,150,12829,17830;18004,31390,0,0,0,2,2
65395,150,12833,18090,31390,0,0,0,1,1
65396,150,12834,18401,31390,0,0,0,1,1
65397,150,12836,18925,31390,0,0,0,1,1
65398,150,12837,18725;18785,31390,0,0,0,2,2
65399,150,12839,18238,31390,0,0,0,1,1
65400,150,12881,16706,31755,0,0,0,1,1
65401,150,12884,17665,31755,0,0,0,1,1
65402,150,12892,17391,31755,0,0,0,1,1
65403,150,12894,18328,31755,0,0,0,1,1
65404,150,12896,17611,31755,0,0,0,1,1
65405,150,12902,17780,31755,0,0,0,1,1
65406,150,12907,18214;18437,31755,0,0,0,2,2
65407,150,12909,18081,31755,0,0,0,1,1
65408,150,12910,18690;18772,31755,0,0,0,2,2
65409,150,12911,18626,31755,0,0,0,1,1
65410,150,12912,17995,31755,0,0,0,1,1
65411,150,12913,17358,31755,0,0,0,1,1
65412,150,12914,18241,31755,0,0,0,1,1
65413,150,12915,18044;18187,31755,0,0,0,2,2
65414,150,12916,18507,31755,0,0,0,1,1
65415,150,12917,18171;18705,31755,0,0,0,2,2
65416,150,12918,18085,31755,0,0,0,1,1
65417,150,12920,18289,31755,0,0,0,1,1
65418,150,12921,18389,31755,0,0,0,1,1
65419,150,12922,18227;18639,31755,0,0,0,2,2
65420,150,12923,17977,31755,0,0,0,1,1
65421,150,12924,18609,31755,0,0,0,1,1
65422,150,12925,18415;18495,31755,0,0,0,2,2
65423,150,12927,18107;18457,31755,0,0,0,2,2
65424,150,12929,17757,31755,0,0,0,1,1
65425,150,12930,18311,31755,0,0,0,1,1
65426,150,12931,18247,31755,0,0,0,1,1
65427,150,12932,18284;18366,31755,0,0,0,2,2
65428,150,12933,18041,31755,0,0,0,1,1
65429,150,12934,18396;18770,31755,0,0,0,2,2
65430,150,12935,18617;18784,31755,0,0,0,2,2
65431,150,12937,17939;18346,31755,0,0,0,2,2
65432,150,12938,18347;18381,31755,0,0,0,2,2
65433,150,12981,16473,32120,0,0,0,1,1
65434,150,12995,17936,32120,0,0,0,1,1
65435,150,12999,17678,32120,0,0,0,1,1
65436,150,13000,17666,32120,0,0,0,1,1
65437,150,13002,17967,32120,0,0,0,1,1
65438,150,13003,17749,32120,0,0,0,1,1
65439,150,13004,17709;17758,32120,0,0,0,2,2
65440,150,13005,17797;18063,32120,0,0,0,2,2
65441,150,13007,17856,32120,0,0,0,1,1
65442,150,13008,17836;17894,32120,0,0,0,2,2
65443,150,13009,18146,32120,0,0,0,1,1
65444,150,13011,18397,32120,0,0,0,1,1
65445,150,13012,18486;18584,32120,0,0,0,2,2
65446,150,13013,17712,32120,0,0,0,1,1
65447,150,13014,18048,32120,0,0,0,1,1
65448,150,13015,18561,32120,0,0,0,1,1
65449,150,13016,18142,32120,0,0,0,1,1
65450,150,13017,18229;18248,32120,0,0,0,2,2
65451,150,13018,18670,32120,0,0,0,1,1
65452,150,13019,18168,32120,0,0,0,1,1
65453,150,13022,18499,32120,0,0,0,1,1
65454,150,13023,18735,32120,0,0,0,1,1
65455,150,13024,18587,32120,0,0,0,1,1
65456,150,13025,17891;18282,32120,0,0,0,2,2
65457,150,13026,18286;18321,32120,0,0,0,2,2
65458,150,13028,18378,32120,0,0,0,1,1
65459,150,13029,17963;18408,32120,0,0,0,2,2
65460,150,13030,18729,32120,0,0,0,1,1
65461,150,13033,18452;18550,32120,0,0,0,2,2
65462,150,13035,18461,32120,0,0,0,1,1
65463,150,13040,18237,32120,0,0,0,1,1
65464,150,13041,18515,32120,0,0,0,1,1
65465,150,13042,18517;18663,32120,0,0,0,2,2
65466,150,13086,17501,32485,0,0,0,1,1
65467,150,13088,17425,32485,0,0,0,1,1
65468,150,13090,17657,32485,0,0,0,1,1
65469,150,13093,17471,32485,0,0,0,1,1
65470,150,13100,17934,32485,0,0,0,1,1
65471,150,13101,18506,32485,0,0,0,1,1
65472,150,13102,17682;18254,32485,0,0,0,2,2
65473,150,13106,18027,32485,0,0,0,1,1
65474,150,13108,17938;18209,32485,0,0,0,2,2
65475,150,13109,17549;17958,32485,0,0,0,2,2
65476,150,13110,17816,32485,0,0,0,1,1
65477,150,13114,18049;18677,32485,0,0,0,2,2
65478,150,13116,18155;20885,32485,0,0,1,1,2
65479,150,13117,18651,32485,0,0,0,1,1
65480,150,13118,18156,32485,0,0,0,1,1
65481,150,13119,18076;21540,32485,0,0,1,1,2
65482,150,13120,17941;18208,32485,0,0,0,2,2
65483,150,13121,18008;18222,32485,0,0,0,2,2
65484,150,13122,17827,32485,0,0,0,1,1
65485,150,13123,18519;18749,32485,0,0,0,2,2
65486,150,13124,18731,32485,0,0,0,1,1
65487,150,13125,18637,32485,0,0,0,1,1
65488,150,13127,18319,32485,0,0,0,1,1
65489,150,13128,18331,32485,0,0,0,1,1
65490,150,13129,17785,32485,0,0,0,1,1
65491,150,13131,18429,32485,0,0,0,1,1
65492,150,13132,18472,32485,0,0,0,1,1
65493,150,13134,18374,32485,0,0,0,1,1
65494,150,13135,18502,32485,0,0,0,1,1
65495,150,13136,18514,32485,0,0,0,1,1
65496,150,13137,18516,32485,0,0,0,1,1
65497,150,13140,18575,32485,0,0,0,1,1
65498,150,13141,18783,32485,0,0,0,1,1
65499,150,13142,18598;18738,32485,0,0,0,2,2
65500,150,13143,18612;18698,32485,0,0,0,2,2
65501,150,13144,18867;19019,32485,0,0,0,2,2
65502,150,13195,17407,32850,0,0,0,1,1
65503,150,13204,17925,32850,0,0,0,1,1
65504,150,13205,17802,32850,0,0,0,1,1
65505,150,13209,17826,32850,0,0,0,1,1
65506,150,13210,18562,32850,0,0,0,1,1
65507,150,13212,18565,32850,0,0,0,1,1
65508,150,13213,17753;17927,32850,0,0,0,2,2
65509,150,13214,17929,32850,0,0,0,1,1
65510,150,13216,18313;18820,32850,0,0,0,2,2
65511,150,13217,18353,32850,0,0,0,1,1
65512,150,13218,18106;18655,32850,0,0,0,2,2
65513,150,13219,18116;22513,32850,0,0,1,1,2
65514,150,13220,18123;18620,32850,0,0,0,2,2
65515,150,13223,18017,32850,0,0,0,1,1
65516,150,13224,18265,32850,0,0,0,1,1
65517,150,13225,18278,32850,0,0,0,1,1
65518,150,13227,18317;18883,32850,0,0,0,2,2
65519,150,13230,18361,32850,0,0,0,1,1
65520,150,13231,18600,32850,0,0,0,1,1
65521,150,13232,18244;18417,32850,0,0,0,2,2
65522,150,13233,18094;18447,32850,0,0,0,2,2
65523,150,13234,18450,32850,0,0,0,1,1
65524,150,13235,18435;18454,32850,0,0,0,2,2
65525,150,13236,18469;18864,32850,0,0,0,2,2
65526,150,13237,18866,32850,0,0,0,1,1
65527,150,13238,18569;18597,32850,0,0,0,2,2
65528,150,13239,18958;22431,32850,0,0,1,1,2
65529,150,13240,18948,32850,0,0,0,1,1
65530,150,13241,18301;18786,32850,0,0,0,2,2
65531,150,13243,18283;18778,32850,0,0,0,2,2
65532,150,13244,19065;19186,32850,0,0,0,2,2
65533,150,13245,18667;18971,32850,0,0,0,2,2
65534,150,13248,19158,32850,0,0,0,1,1
65535,150,13249,18716;18861,32850,0,0,0,2,2
65536,150,13254,18465,32850,0,0,0,1,1
65537,150,13255,18490,32850,0,0,0,1,1
65538,150,13296,17058,33215,0,0,0,1,1
65539,150,13306,17707;17732,33215,0,0,0,2,2
65540,150,13307,18148,33215,0,0,0,1,1
65541,150,13308,18141;18392,33215,0,0,0,2,2
65542,150,13309,18128;22887,33215,0,0,1,1,2
65543,150,13310,17962;18019;23423,33215,0,0,1,2,3
65544,150,13313,17948,33215,0,0,0,1,1
65545,150,13314,17980,33215,0,0,0,1,1
65546,150,13315,18297,33215,0,0,0,1,1
65547,150,13318,17597;18020,33215,0,0,0,2,2
65548,150,13320,18573,33215,0,0,0,1,1
65549,150,13321,18058,33215,0,0,0,1,1
65550,150,13322,18064;18510,33215,0,0,0,2,2
65551,150,13325,17859,33215,0,0,0,1,1
65552,150,13326,18528;18649,33215,0,0,0,2,2
65553,150,13328,18000;18210,33215,0,0,0,2,2
65554,150,13329,17945,33215,0,0,0,1,1
65555,150,13330,18183;18231,33215,0,0,0,2,2
65556,150,13331,18252,33215,0,0,0,1,1
65557,150,13333,18700,33215,0,0,0,1,1
65558,150,13334,18539,33215,0,0,0,1,1
65559,150,13335,18296,33215,0,0,0,1,1
65560,150,13337,18901;19055,33215,0,0,0,2,2
65561,150,13339,18352;18607,33215,0,0,0,2,2
65562,150,13341,18383,33215,0,0,0,1,1
65563,150,13342,18272,33215,0,0,0,1,1
65564,150,13343,18897;23510;26117;27041,33215,1,1,1,1,4
65565,150,13344,18074,33215,0,0,0,1,1
65566,150,13345,18501,33215,0,0,0,1,1
65567,150,13346,18433,33215,0,0,0,1,1
65568,150,13347,19027,33215,0,0,0,1,1
65569,150,13348,18489,33215,0,0,0,1,1
65570,150,13349,18387;18513,33215,0,0,0,2,2
65571,150,13350,19051,33215,0,0,0,1,1
65572,150,13351,19083,33215,0,0,0,1,1
65573,150,13352,18638,33215,0,0,0,1,1
65574,150,13354,18678,33215,0,0,0,1,1
65575,150,13355,19147,33215,0,0,0,1,1
65576,150,13357,18704,33215,0,0,0,1,1
65577,150,13358,18741,33215,0,0,0,1,1
65578,150,13359,18747,33215,0,0,0,1,1
65579,150,13360,19183,33215,0,0,0,1,1
65580,150,13361,19101,33215,0,0,0,1,1
65581,150,13362,18779,33215,0,0,0,1,1
65582,150,13363,18602;22531,33215,0,0,1,1,2
65583,150,13364,18728;18787,33215,0,0,0,2,2
65584,150,13365,19121,33215,0,0,0,1,1
65585,150,13366,18795;18807,33215,0,0,0,2,2
65586,150,13367,18797,33215,0,0,0,1,1
65587,150,13368,18984,33215,0,0,0,1,1
65588,150,13369,18845,33215,0,0,0,1,1
65589,150,13371,18892,33215,0,0,0,1,1
65590,150,13372,19044,33215,0,0,0,1,1
65591,150,13373,18913;19342;22550,33215,0,0,1,2,3
65592,150,13411,17324,33580,0,0,0,1,1
65593,150,13418,18026,33580,0,0,0,1,1
65594,150,13422,18150,33580,0,0,0,1,1
65595,150,13423,17885,33580,0,0,0,1,1
65596,150,13425,17631;18139,33580,0,0,0,2,2
65597,150,13426,17817,33580,0,0,0,1,1
65598,150,13428,17970;18351,33580,0,0,0,2,2
65599,150,13434,17993,33580,0,0,0,1,1
65600,150,13437,18204;18742,33580,0,0,0,2,2
65601,150,13438,18683;18896,33580,0,0,0,2,2
65602,150,13439,18857,33580,0,0,0,1,1
65603,150,13440,18298,33580,0,0,0,1,1
65604,150,13441,18309;18470,33580,0,0,0,2,2
65605,150,13442,18520;18583,33580,0,0,0,2,2
65606,150,13443,18327,33580,0,0,0,1,1
65607,150,13444,18556,33580,0,0,0,1,1
65608,150,13445,18884;18919,33580,0,0,0,2,2
65609,150,13446,18407,33580,0,0,0,1,1
65610,150,13447,18360;18524,33580,0,0,0,2,2
65611,150,13452,19072;19291,33580,0,0,0,2,2
65612,150,13453,18295;18559,33580,0,0,0,2,2
65613,150,13454,18434;18879;22420,33580,0,0,1,2,3
65614,150,13456,18423;18982;22802,33580,0,0,1,2,3
65615,150,13458,18622;18877,33580,0,0,0,2,2
65616,150,13459,18245;18631,33580,0,0,0,2,2
65617,150,13460,18648,33580,0,0,0,1,1
65618,150,13461,19141,33580,0,0,0,1,1
65619,150,13462,18577,33580,0,0,0,1,1
65620,150,13463,18624,33580,0,0,0,1,1
65621,150,13464,18708;19064,33580,0,0,0,2,2
65622,150,13465,18727,33580,0,0,0,1,1
65623,150,13466,18713;19060,33580,0,0,0,2,2
65624,150,13467,18757;18894,33580,0,0,0,2,2
65625,150,13468,18793,33580,0,0,0,1,1
65626,150,13469,18801;18996,33580,0,0,0,2,2
65627,150,13470,18815,33580,0,0,0,1,1
65628,150,13471,19321,33580,0,0,0,1,1
65629,150,13472,19070,33580,0,0,0,1,1
65630,150,13473,19210,33580,0,0,0,1,1
65631,150,13474,18836;18969,33580,0,0,0,2,2
65632,150,13475,18945,33580,0,0,0,1,1
65633,150,13476,18848,33580,0,0,0,1,1
65634,150,13477,18967,33580,0,0,0,1,1
65635,150,13478,18912;19004,33580,0,0,0,2,2
65636,150,13479,18970,33580,0,0,0,1,1
65637,150,13480,19013;19261,33580,0,0,0,2,2
65638,150,13532,17290;18201,33945,0,0,0,2,2
65639,150,13538,17356;17793,33945,0,0,0,2,2
65640,150,13540,18529,33945,0,0,0,1,1
65641,150,13544,17450;17702,33945,0,0,0,2,2
65642,150,13546,18182,33945,0,0,0,1,1
65643,150,13547,18399,33945,0,0,0,1,1
65644,150,13548,18380,33945,0,0,0,1,1
65645,150,13550,18325,33945,0,0,0,1,1
65646,150,13551,18386;18672,33945,0,0,0,2,2
65647,150,13552,18875,33945,0,0,0,1,1
65648,150,13555,19129,33945,0,0,0,1,1
65649,150,13556,18563,33945,0,0,0,1,1
65650,150,13557,18589;18652,33945,0,0,0,2,2
65651,150,13559,18635;18753,33945,0,0,0,2,2
65652,150,13560,18676;19132;22921;25011;26086;26280;26736;26936,33945,1,3,2,2,8
65653,150,13561,19096,33945,0,0,0,1,1
65654,150,13566,19217;19521,33945,0,0,0,2,2
65655,150,13567,18762,33945,0,0,0,1,1
65656,150,13569,19541,33945,0,0,0,1,1
65657,150,13570,18835;18922,33945,0,0,0,2,2
65658,150,13571,18800;18899,33945,0,0,0,2,2
65659,150,13572,18628;18885,33945,0,0,0,2,2
65660,150,13573,18733;18926,33945,0,0,0,2,2
65661,150,13575,18955,33945,0,0,0,1,1
65662,150,13577,18240;18961;23111,33945,0,0,1,2,3
65663,150,13579,18988,33945,0,0,0,1,1
65664,150,13581,18837,33945,0,0,0,1,1
65665,150,13582,19047,33945,0,0,0,1,1
65666,150,13584,18914;19053,33945,0,0,0,2,2
65667,150,13585,19068,33945,0,0,0,1,1
65668,150,13586,19145,33945,0,0,0,1,1
65669,150,13587,19250;19494,33945,0,0,0,2,2
65670,150,13588,19037,33945,0,0,0,1,1
65671,150,13589,19094,33945,0,0,0,1,1
65672,150,13591,21373;21445,33945,0,0,2,0,2
65673,150,13592,19119,33945,0,0,0,1,1
65674,150,13593,18832;19312,33945,0,0,0,2,2
65675,150,13594,19136,33945,0,0,0,1,1
65676,150,13595,19137,33945,0,0,0,1,1
65677,150,13596,19160,33945,0,0,0,1,1
65678,150,13598,19388;19492,33945,0,0,0,2,2
65679,150,13631,16433,34310,0,0,0,1,1
65680,150,13641,17390,34310,0,0,0,1,1
65681,150,13643,17924;18263,34310,0,0,0,2,2
65682,150,13645,17842,34310,0,0,0,1,1
65683,150,13647,18318,34310,0,0,0,1,1
65684,150,13649,17814,34310,0,0,0,1,1
65685,150,13651,17636,34310,0,0,0,1,1
65686,150,13654,18930,34310,0,0,0,1,1
65687,150,13657,18355;18508,34310,0,0,0,2,2
65688,150,13658,18522,34310,0,0,0,1,1
65689,150,13659,18129,34310,0,0,0,1,1
65690,150,13660,18567,34310,0,0,0,1,1
65691,150,13661,18476;18636;22524,34310,0,0,1,2,3
65692,150,13662,18458;19015,34310,0,0,0,2,2
65693,150,13667,18571;18744,34310,0,0,0,2,2
65694,150,13668,18504,34310,0,0,0,1,1
65695,150,13669,18568,34310,0,0,0,1,1
65696,150,13670,18838;19052,34310,0,0,0,2,2
65697,150,13672,22310;22592;26167;26259;26521,34310,0,3,2,0,5
65698,150,13673,19128;19256,34310,0,0,0,2,2
65699,150,13674,18764;19319,34310,0,0,0,2,2
65700,150,13675,18444,34310,0,0,0,1,1
65701,150,13676,19008,34310,0,0,0,1,1
65702,150,13681,18367;18825,34310,0,0,0,2,2
65703,150,13682,18863,34310,0,0,0,1,1
65704,150,13683,19084;19135,34310,0,0,0,2,2
65705,150,13684,18220,34310,0,0,0,1,1
65706,150,13685,18992,34310,0,0,0,1,1
65707,150,13686,19150,34310,0,0,0,1,1
65708,150,13687,18927,34310,0,0,0,1,1
65709,150,13688,18942,34310,0,0,0,1,1
65710,150,13689,18850,34310,0,0,0,1,1
65711,150,13690,19546,34310,0,0,0,1,1
65712,150,13691,18980;19411,34310,0,0,0,2,2
65713,150,13692,18993;19478,34310,0,0,0,2,2
65714,150,13693,19551,34310,0,0,0,1,1
65715,150,13695,19014;19389,34310,0,0,0,2,2
65716,150,13696,19023,34310,0,0,0,1,1
65717,150,13697,19199;19431,34310,0,0,0,2,2
65718,150,13698,19036,34310,0,0,0,1,1
65719,150,13699,19043,34310,0,0,0,1,1
65720,150,13700,19504;19596,34310,0,0,0,2,2
65721,150,13701,18665;19260,34310,0,0,0,2,2
65722,150,13703,18966;19172,34310,0,0,0,2,2
65723,150,13704,19058;19157,34310,0,0,0,2,2
65724,150,13705,19011;19192,34310,0,0,0,2,2
65725,150,13707,19471,34310,0,0,0,1,1
65726,150,13708,19230;19449,34310,0,0,0,2,2
65727,150,13709,19322;22938,34310,0,0,1,1,2
65728,150,13710,18540;19215,34310,0,0,0,2,2
65729,150,13712,18759;23631;25818;26576;27257,34310,1,2,1,1,5
65730,150,13713,19282,34310,0,0,0,1,1
65731,150,13714,19271;19293,34310,0,0,0,2,2
65732,150,13715,19303;19304;22818,34310,0,0,1,2,3
65733,150,13744,16340;16934,34675,0,0,0,2,2
65734,150,13757,16539,34675,0,0,0,1,1
65735,150,13759,17412,34675,0,0,0,1,1
65736,150,13765,18362,34675,0,0,0,1,1
65737,150,13766,18055,34675,0,0,0,1,1
65738,150,13768,18314,34675,0,0,0,1,1
65739,150,13769,18370,34675,0,0,0,1,1
65740,150,13770,18440,34675,0,0,0,1,1
65741,150,13772,18498,34675,0,0,0,1,1
65742,150,13773,18840,34675,0,0,0,1,1
65743,150,13774,18595,34675,0,0,0,1,1
65744,150,13775,18056;18616,34675,0,0,0,2,2
65745,150,13777,18647;18788,34675,0,0,0,2,2
65746,150,13778,18695,34675,0,0,0,1,1
65747,150,13779,19104,34675,0,0,0,1,1
65748,150,13780,18776;18791,34675,0,0,0,2,2
65749,150,13781,18794;19198,34675,0,0,0,2,2
65750,150,13784,18855;18908,34675,0,0,0,2,2
65751,150,13785,18789;18860,34675,0,0,0,2,2
65752,150,13787,19078,34675,0,0,0,1,1
65753,150,13788,18937;19130,34675,0,0,0,2,2
65754,150,13790,19029,34675,0,0,0,1,1
65755,150,13791,19048,34675,0,0,0,1,1
65756,150,13792,19166,34675,0,0,0,1,1
65757,150,13793,19071;19289,34675,0,0,0,2,2
65758,150,13794,18903;19074,34675,0,0,0,2,2
65759,150,13796,19120;19349,34675,0,0,0,2,2
65760,150,13797,19126,34675,0,0,0,1,1
65761,150,13798,19153;19222,34675,0,0,0,2,2
65762,150,13799,19177,34675,0,0,0,1,1
65763,150,13800,19211;19391,34675,0,0,0,2,2
65764,150,13801,19375;19633,34675,0,0,0,2,2
65765,150,13802,19224,34675,0,0,0,1,1
65766,150,13804,19031;19283,34675,0,0,0,2,2
65767,150,13805,19131;19298,34675,0,0,0,2,2
65768,150,13807,19367;19578,34675,0,0,0,2,2
65769,150,13809,19437,34675,0,0,0,1,1
65770,150,13810,19320,34675,0,0,0,1,1
65771,150,13811,19079;19350,34675,0,0,0,2,2
65772,150,13812,18886;19353,34675,0,0,0,2,2
65773,150,13813,19006;19385,34675,0,0,0,2,2
65774,150,13814,19275;19673;23633;25622,34675,0,0,2,2,4
65775,150,13815,19495;19509,34675,0,0,0,2,2
65776,150,13856,17676,35040,0,0,0,1,1
65777,150,13864,18172;18509,35040,0,0,0,2,2
65778,150,13865,18526,35040,0,0,0,1,1
65779,150,13866,18656,35040,0,0,0,1,1
65780,150,13868,18388;19252,35040,0,0,0,2,2
65781,150,13870,18406;19266,35040,0,0,0,2,2
65782,150,13871,18808,35040,0,0,0,1,1
65783,150,13872,18268;18439,35040,0,0,0,2,2
65784,150,13873,18441;18645,35040,0,0,0,2,2
65785,150,13874,18448;18480,35040,0,0,0,2,2
65786,150,13875,18113;18451,35040,0,0,0,2,2
65787,150,13876,18463,35040,0,0,0,1,1
65788,150,13878,18500,35040,0,0,0,1,1
65789,150,13880,18363,35040,0,0,0,1,1
65790,150,13881,18790,35040,0,0,0,1,1
65791,150,13882,18239;18552,35040,0,0,0,2,2
65792,150,13884,18606,35040,0,0,0,1,1
65793,150,13885,18872,35040,0,0,0,1,1
65794,150,13886,18329,35040,0,0,0,1,1
65795,150,13888,18707,35040,0,0,0,1,1
65796,150,13889,18271,35040,0,0,0,1,1
65797,150,13891,18228;18799,35040,0,0,0,2,2
65798,150,13892,18934;19483,35040,0,0,0,2,2
65799,150,13894,18459;18952,35040,0,0,0,2,2
65800,150,13895,18436;18974,35040,0,0,0,2,2
65801,150,13896,19003;19486,35040,0,0,0,2,2
65802,150,13898,19009;19236,35040,0,0,0,2,2
65803,150,13900,19333,35040,0,0,0,1,1
65804,150,13901,19577;25542,35040,0,0,1,1,2
65805,150,13902,18684;19075,35040,0,0,0,2,2
65806,150,13903,19476,35040,0,0,0,1,1
65807,150,13904,19056,35040,0,0,0,1,1
65808,150,13905,19117;19610,35040,0,0,0,2,2
65809,150,13906,18888;19139,35040,0,0,0,2,2
65810,150,13907,19140,35040,0,0,0,1,1
65811,150,13908,19171;19323,35040,0,0,0,2,2
65812,150,13910,18935;19209,35040,0,0,0,2,2
65813,150,13911,19316,35040,0,0,0,1,1
65814,150,13912,19219;19405,35040,0,0,0,2,2
65815,150,13913,19531,35040,0,0,0,1,1
65816,150,13914,19077;19240,35040,0,0,0,2,2
65817,150,13917,19268,35040,0,0,0,1,1
65818,150,13918,19286;19748,35040,0,0,0,2,2
65819,150,13920,19500;19590,35040,0,0,0,2,2
65820,150,13921,19317,35040,0,0,0,1,1
65821,150,13922,19644,35040,0,0,0,1,1
65822,150,13923,18545;19377,35040,0,0,0,2,2
65823,150,13924,19383,35040,0,0,0,1,1
65824,150,13925,19400,35040,0,0,0,1,1
65825,150,13928,19532,35040,0,0,0,1,1
65826,150,13929,19542,35040,0,0,0,1,1
65827,150,13930,19552,35040,0,0,0,1,1
65828,150,13932,19499;19872,35040,0,0,0,2,2
65829,150,13960,17180,35405,0,0,0,1,1
65830,150,13971,17831,35405,0,0,0,1,1
65831,150,13974,18531,35405,0,0,0,1,1
65832,150,13975,18236;18266,35405,0,0,0,2,2
65833,150,13976,17808,35405,0,0,0,1,1
65834,150,13977,18030,35405,0,0,0,1,1
65835,150,13979,23401;23441;26307;26655,35405,0,2,2,0,4
65836,150,13981,18581,35405,0,0,0,1,1
65837,150,13982,18270,35405,0,0,0,1,1
65838,150,13985,18333,35405,0,0,0,1,1
65839,150,13987,18369,35405,0,0,0,1,1
65840,150,13990,18416;18953,35405,0,0,0,2,2
65841,150,13991,18443,35405,0,0,0,1,1
65842,150,13992,18662,35405,0,0,0,1,1
65843,150,13995,18534;18769,35405,0,0,0,2,2
65844,150,13996,19089,35405,0,0,0,1,1
65845,150,13997,18621,35405,0,0,0,1,1
65846,150,14000,19454;19455,35405,0,0,0,2,2
65847,150,14002,18593;25162,35405,0,0,1,1,2
65848,150,14004,18870;19107,35405,0,0,0,2,2
65849,150,14006,18975;18979,35405,0,0,0,2,2
65850,150,14008,19123;19696,35405,0,0,0,2,2
65851,150,14010,19098;19741,35405,0,0,0,2,2
65852,150,14011,19100,35405,0,0,0,1,1
65853,150,14012,18792,35405,0,0,0,1,1
65854,150,14013,19604;19697,35405,0,0,0,2,2
65855,150,14014,19080;19148,35405,0,0,0,2,2
65856,150,14015,18493;18854,35405,0,0,0,2,2
65857,150,14016,19176;19358,35405,0,0,0,2,2
65858,150,14017,19180,35405,0,0,0,1,1
65859,150,14018,19475,35405,0,0,0,1,1
65860,150,14019,19774,35405,0,0,0,1,1
65861,150,14022,19329;19878,35405,0,0,0,2,2
65862,150,14023,19336;19576,35405,0,0,0,2,2
65863,150,14024,19339,35405,0,0,0,1,1
65864,150,14026,19824,35405,0,0,0,1,1
65865,150,14027,19401,35405,0,0,0,1,1
65866,150,14029,18671;19417,35405,0,0,0,2,2
65867,150,14030,19398,35405,0,0,0,1,1
65868,150,14034,18688;19503,35405,0,0,0,2,2
65869,150,14035,19669;24917,35405,0,0,1,1,2
65870,150,14038,19443;19493,35405,0,0,0,2,2
65871,150,14039,19263;19771,35405,0,0,0,2,2
65872,150,14040,19553;19658,35405,0,0,0,2,2
65873,150,14041,18998,35405,0,0,0,1,1
65874,150,14042,19461;19556,35405,0,0,0,2,2
65875,150,14044,19163;19612,35405,0,0,0,2,2
65876,150,14045,19589;19716,35405,0,0,0,2,2
65877,150,14046,19560;19712,35405,0,0,0,2,2
65878,150,14048,19751,35405,0,0,0,1,1
65879,150,14049,19770;19934,35405,0,0,0,2,2
65880,150,14050,19092;19609,35405,0,0,0,2,2
65881,150,14051,19111;19595,35405,0,0,0,2,2
65882,150,14088,18382,35770,0,0,0,1,1
65883,150,14094,18674;18826,35770,0,0,0,2,2
65884,150,14095,18303,35770,0,0,0,1,1
65885,150,14097,21974,35770,0,0,1,0,1
65886,150,14098,19144;19384,35770,0,0,0,2,2
65887,150,14099,18798,35770,0,0,0,1,1
65888,150,14101,18145,35770,0,0,0,1,1
65889,150,14102,18625,35770,0,0,0,1,1
65890,150,14105,18963,35770,0,0,0,1,1
65891,150,14107,18467;18844,35770,0,0,0,2,2
65892,150,14110,18973;19305;25252,35770,0,0,1,2,3
65893,150,14112,19529,35770,0,0,0,1,1
65894,150,14114,19220,35770,0,0,0,1,1
65895,150,14115,19243,35770,0,0,0,1,1
65896,150,14116,19429;19753,35770,0,0,0,2,2
65897,150,14117,19514;19798,35770,0,0,0,2,2
65898,150,14119,19277,35770,0,0,0,1,1
65899,150,14120,19295;19681,35770,0,0,0,2,2
65900,150,14121,19093;19325,35770,0,0,0,2,2
65901,150,14122,19574;19993,35770,0,0,0,2,2
65902,150,14123,19360,35770,0,0,0,1,1
65903,150,14124,19297;19302,35770,0,0,0,2,2
65904,150,14125,19370,35770,0,0,0,1,1
65905,150,14126,19409;19734,35770,0,0,0,2,2
65906,150,14127,19430,35770,0,0,0,1,1
65907,150,14128,19617;19891,35770,0,0,0,2,2
65908,150,14129,18818;19421,35770,0,0,0,2,2
65909,150,14131,19462;19657,35770,0,0,0,2,2
65910,150,14133,19554;19699,35770,0,0,0,2,2
65911,150,14134,19778,35770,0,0,0,1,1
65912,150,14135,19511,35770,0,0,0,1,1
65913,150,14136,19776,35770,0,0,0,1,1
65914,150,14138,19539;19791,35770,0,0,0,2,2
65915,150,14140,19467;19573,35770,0,0,0,2,2
65916,150,14141,19602;19635,35770,0,0,0,2,2
65917,150,14142,19790,35770,0,0,0,1,1
65918,150,14143,18425;19099,35770,0,0,0,2,2
65919,150,14144,19548;19680,35770,0,0,0,2,2
65920,150,14145,19682,35770,0,0,0,1,1
65921,150,14146,19362;19844,35770,0,0,0,2,2
65922,150,14147,19125;19703,35770,0,0,0,2,2
65923,150,14148,19357;19718,35770,0,0,0,2,2
65924,150,14149,19585;19837,35770,0,0,0,2,2
65925,150,14150,19738;19914,35770,0,0,0,2,2
65926,150,14151,19944;19980,35770,0,0,0,2,2
65927,150,14152,19800,35770,0,0,0,1,1
65928,150,14153,19775;20027,35770,0,0,0,2,2
65929,150,14201,19254,36135,0,0,0,1,1
65930,150,14203,18341,36135,0,0,0,1,1
65931,150,14205,18468,36135,0,0,0,1,1
65932,150,14206,19267,36135,0,0,0,1,1
65933,150,14211,18691;19599,36135,0,0,0,2,2
65934,150,14212,18842;19189,36135,0,0,0,2,2
65935,150,14213,18995;19732;23649,36135,0,0,1,2,3
65936,150,14214,19105,36135,0,0,0,1,1
65937,150,14215,19045,36135,0,0,0,1,1
65938,150,14218,19783,36135,0,0,0,1,1
65939,150,14220,19155;19601,36135,0,0,0,2,2
65940,150,14221,18697,36135,0,0,0,1,1
65941,150,14222,19106;19284,36135,0,0,0,2,2
65942,150,14223,18891;19346,36135,0,0,0,2,2
65943,150,14225,19306,36135,0,0,0,1,1
65944,150,14226,19328,36135,0,0,0,1,1
65945,150,14229,19355,36135,0,0,0,1,1
65946,150,14230,19238;19369,36135,0,0,0,2,2
65947,150,14231,19641,36135,0,0,0,1,1
65948,150,14232,19526;19860,36135,0,0,0,2,2
65949,150,14233,20047;20221,36135,0,0,0,2,2
65950,150,14234,19664;19963,36135,0,0,0,2,2
65951,150,14236,19803,36135,0,0,0,1,1
65952,150,14238,19793;19850,36135,0,0,0,2,2
65953,150,14239,19335;19724,36135,0,0,0,2,2
65954,150,14240,19737;19743,36135,0,0,0,2,2
65955,150,14241,19744,36135,0,0,0,1,1
65956,150,14242,20133,36135,0,0,0,1,1
65957,150,14244,19296;19802,36135,0,0,0,2,2
65958,150,14245,19810;19950,36135,0,0,0,2,2
65959,150,14246,19813;20064,36135,0,0,0,2,2
65960,150,14247,19826,36135,0,0,0,1,1
65961,150,14248,20364,36135,0,0,0,1,1
65962,150,14250,19745;20141,36135,0,0,0,2,2
65963,150,14253,19829,36135,0,0,0,1,1
65964,150,14254,19662;19861,36135,0,0,0,2,2
65965,150,14255,19864;20195,36135,0,0,0,2,2
65966,150,14256,19719;19880,36135,0,0,0,2,2
65967,150,14257,19569;19886,36135,0,0,0,2,2
65968,150,14278,17913,36500,0,0,0,1,1
65969,150,14284,18144;18629,36500,0,0,0,2,2
65970,150,14289,18946,36500,0,0,0,1,1
65971,150,14292,18491,36500,0,0,0,1,1
65972,150,14293,18681,36500,0,0,0,1,1
65973,150,14296,18654;18931,36500,0,0,0,2,2
65974,150,14299,18701,36500,0,0,0,1,1
65975,150,14300,19082;19426,36500,0,0,0,2,2
65976,150,14301,18610;18909,36500,0,0,0,2,2
65977,150,14302,18828,36500,0,0,0,1,1
65978,150,14304,19381,36500,0,0,0,1,1
65979,150,14305,19587,36500,0,0,0,1,1
65980,150,14306,19294;19309,36500,0,0,0,2,2
65981,150,14307,19226;19273,36500,0,0,0,2,2
65982,150,14308,19439;19632,36500,0,0,0,2,2
65983,150,14309,18736;19142,36500,0,0,0,2,2
65984,150,14310,19448,36500,0,0,0,1,1
65985,150,14311,20010;23767,36500,0,0,1,1,2
65986,150,14315,19344,36500,0,0,0,1,1
65987,150,14316,19452,36500,0,0,0,1,1
65988,150,14317,19310;19392,36500,0,0,0,2,2
65989,150,14318,19403,36500,0,0,0,1,1
65990,150,14320,19442;20179,36500,0,0,0,2,2
65991,150,14321,19257,36500,0,0,0,1,1
65992,150,14322,19885;19889,36500,0,0,0,2,2
65993,150,14323,19457,36500,0,0,0,1,1
65994,150,14325,19786,36500,0,0,0,1,1
65995,150,14326,19693,36500,0,0,0,1,1
65996,150,14327,19187;19642,36500,0,0,0,2,2
65997,150,14328,19631,36500,0,0,0,1,1
65998,150,14330,19124;19647,36500,0,0,0,2,2
65999,150,14331,19650;20129,36500,0,0,0,2,2
66000,150,14332,19807,36500,0,0,0,1,1
66001,150,14333,19687;19874;23860,36500,0,0,1,2,3
66002,150,14334,20092,36500,0,0,0,1,1
66003,150,14335,19740;19755,36500,0,0,0,2,2
66004,150,14336,19747;19827,36500,0,0,0,2,2
66005,150,14337,19624;19780,36500,0,0,0,2,2
66006,150,14338,20287,36500,0,0,0,1,1
66007,150,14339,19698;20260,36500,0,0,0,2,2
66008,150,14340,19828;20177,36500,0,0,0,2,2
66009,150,14341,19834;19853,36500,0,0,0,2,2
66010,150,14342,19842,36500,0,0,0,1,1
66011,150,14343,19884;20174,36500,0,0,0,2,2
66012,150,14344,19397;19855,36500,0,0,0,2,2
66013,150,14345,19422;19857,36500,0,0,0,2,2
66014,150,14346,19876;19894,36500,0,0,0,2,2
66015,150,14348,19649;20078;24690,36500,0,0,1,2,3
66016,150,14349,19663;19929,36500,0,0,0,2,2
66017,150,14350,19566;19945,36500,0,0,0,2,2
66018,150,14351,20283,36500,0,0,0,1,1
66019,150,14352,19685;19958,36500,0,0,0,2,2
66020,150,14353,19960;20000,36500,0,0,0,2,2
66021,150,14354,19816,36500,0,0,0,1,1
66022,150,14355,20132;20249,36500,0,0,0,2,2
66023,150,14356,19983;20109;23769;27166,36500,1,0,1,2,4
66024,150,14381,17168,36865,0,0,0,1,1
66025,150,14382,17504;17770,36865,0,0,0,2,2
66026,150,14393,18359,36865,0,0,0,1,1
66027,150,14397,18535,36865,0,0,0,1,1
66028,150,14403,18136;18264,36865,0,0,0,2,2
66029,150,14405,18285;18551,36865,0,0,0,2,2
66030,150,14407,18882,36865,0,0,0,1,1
66031,150,14411,18978,36865,0,0,0,1,1
66032,150,14412,18533,36865,0,0,0,1,1
66033,150,14414,18711,36865,0,0,0,1,1
66034,150,14415,18997,36865,0,0,0,1,1
66035,150,14416,19138,36865,0,0,0,1,1
66036,150,14417,18843;19318,36865,0,0,0,2,2
66037,150,14419,19127,36865,0,0,0,1,1
66038,150,14420,19102,36865,0,0,0,1,1
66039,150,14422,19395,36865,0,0,0,1,1
66040,150,14423,19184,36865,0,0,0,1,1
66041,150,14424,19202;19324,36865,0,0,0,2,2
66042,150,14425,18834;19308,36865,0,0,0,2,2
66043,150,14426,19337,36865,0,0,0,1,1
66044,150,14428,18906,36865,0,0,0,1,1
66045,150,14429,19227;19911;23658,36865,0,0,1,2,3
66046,150,14430,19343;19765,36865,0,0,0,2,2
66047,150,14431,19156;19615,36865,0,0,0,2,2
66048,150,14432,20089;20152;23463,36865,0,0,1,2,3
66049,150,14433,19505;19517,36865,0,0,0,2,2
66050,150,14434,19888;19898,36865,0,0,0,2,2
66051,150,14435,19191;19568,36865,0,0,0,2,2
66052,150,14436,19598;19925,36865,0,0,0,2,2
66053,150,14437,19611,36865,0,0,0,1,1
66054,150,14440,19606;19636,36865,0,0,0,2,2
66055,150,14441,19535;19660;22604,36865,0,0,1,2,3
66056,150,14442,19477;19672,36865,0,0,0,2,2
66057,150,14443,19506;19678,36865,0,0,0,2,2
66058,150,14444,19702;19799,36865,0,0,0,2,2
66059,150,14445,19708,36865,0,0,0,1,1
66060,150,14446,19472;19709,36865,0,0,0,2,2
66061,150,14447,19823;19835,36865,0,0,0,2,2
66062,150,14449,20103,36865,0,0,0,1,1
66063,150,14451,19638;19849,36865,0,0,0,2,2
66064,150,14452,19707;19955,36865,0,0,0,2,2
66065,150,14453,20050;20237,36865,0,0,0,2,2
66066,150,14454,19654;19899;24095,36865,0,0,1,2,3
66067,150,14456,20380,36865,0,0,0,1,1
66068,150,14457,19962;20115;24294;26238,36865,0,1,1,2,4
66069,150,14458,20111,36865,0,0,0,1,1
66070,150,14459,19763;19978,36865,0,0,0,2,2
66071,150,14460,19843;19986,36865,0,0,0,2,2
66072,150,14461,19739;19994,36865,0,0,0,2,2
66073,150,14462,19879;20006,36865,0,0,0,2,2
66074,150,14463,20022;20143,36865,0,0,0,2,2
66075,150,14464,19811;20383,36865,0,0,0,2,2
66076,150,14498,18011;18061,37230,0,0,0,2,2
66077,150,14502,18312,37230,0,0,0,1,1
66078,150,14503,22707;22716;22985;26092,37230,0,1,3,0,4
66079,150,14504,18740,37230,0,0,0,1,1
66080,150,14506,18819,37230,0,0,0,1,1
66081,150,14508,18928,37230,0,0,0,1,1
66082,150,14509,18572;19021,37230,0,0,0,2,2
66083,150,14510,19667,37230,0,0,0,1,1
66084,150,14511,19313,37230,0,0,0,1,1
66085,150,14512,19151,37230,0,0,0,1,1
66086,150,14514,18941;19270,37230,0,0,0,2,2
66087,150,14515,19415,37230,0,0,0,1,1
66088,150,14516,19465,37230,0,0,0,1,1
66089,150,14517,19480;19592,37230,0,0,0,2,2
66090,150,14518,19485,37230,0,0,0,1,1
66091,150,14519,19481;19764,37230,0,0,0,2,2
66092,150,14520,19852;19887,37230,0,0,0,2,2
66093,150,14521,19538;19726,37230,0,0,0,2,2
66094,150,14522,19402;19583,37230,0,0,0,2,2
66095,150,14523,19571;19797;24201;26997,37230,1,0,1,2,4
66096,150,14524,20148,37230,0,0,0,1,1
66097,150,14525,19424;19655,37230,0,0,0,2,2
66098,150,14526,19591,37230,0,0,0,1,1
66099,150,14527,19691,37230,0,0,0,1,1
66100,150,14528,19705;20247,37230,0,0,0,2,2
66101,150,14529,19729;19730,37230,0,0,0,2,2
66102,150,14530,20058;20059;23873,37230,0,0,1,2,3
66103,150,14531,19915;19970,37230,0,0,0,2,2
66104,150,14533,20042;20189,37230,0,0,0,2,2
66105,150,14534,20135;20150,37230,0,0,0,2,2
66106,150,14537,20482,37230,0,0,0,1,1
66107,150,14538,19937,37230,0,0,0,1,1
66108,150,14539,19459;19941,37230,0,0,0,2,2
66109,150,14540,20126;20185,37230,0,0,0,2,2
66110,150,14541,20009;20479,37230,0,0,0,2,2
66111,150,14542,20024;20213,37230,0,0,0,2,2
66112,150,14544,20323,37230,0,0,0,1,1
66113,150,14545,20365;20381,37230,0,0,0,2,2
66114,150,14546,19954,37230,0,0,0,1,1
66115,150,14547,20222,37230,0,0,0,1,1
66116,150,14548,20018;20091,37230,0,0,0,2,2
66117,150,14550,19679;20097,37230,0,0,0,2,2
66118,150,14551,19752;20112;24691,37230,0,0,1,2,3
66119,150,14553,20219;20316,37230,0,0,0,2,2
66120,150,14554,20147;20261,37230,0,0,0,2,2
66121,150,14555,20154;24206,37230,0,0,1,1,2
66122,150,14592,18255;22380,37595,0,0,1,1,2
66123,150,14596,18305;18384,37595,0,0,0,2,2
66124,150,14597,18111;18412,37595,0,0,0,2,2
66125,150,14599,18673;19028,37595,0,0,0,2,2
66126,150,14602,18806,37595,0,0,0,1,1
66127,150,14604,18964,37595,0,0,0,1,1
66128,150,14606,19326,37595,0,0,0,1,1
66129,150,14607,18745,37595,0,0,0,1,1
66130,150,14609,18950;19090,37595,0,0,0,2,2
66131,150,14610,19332;19428,37595,0,0,0,2,2
66132,150,14613,19988,37595,0,0,0,1,1
66133,150,14615,19519;19767,37595,0,0,0,2,2
66134,150,14616,19639;20002,37595,0,0,0,2,2
66135,150,14617,19200;19600,37595,0,0,0,2,2
66136,150,14618,19623;19684,37595,0,0,0,2,2
66137,150,14619,19695;20099;23252,37595,0,0,1,2,3
66138,150,14621,19700,37595,0,0,0,1,1
66139,150,14623,19967;20194,37595,0,0,0,2,2
66140,150,14624,19905,37595,0,0,0,1,1
66141,150,14626,20359;23895;25721;27174,37595,1,1,1,1,4
66142,150,14627,20539,37595,0,0,0,1,1
66143,150,14628,18560;19081,37595,0,0,0,2,2
66144,150,14629,19871;20149,37595,0,0,0,2,2
66145,150,14630,19923;19984,37595,0,0,0,2,2
66146,150,14632,19806;19982,37595,0,0,0,2,2
66147,150,14633,20049;20347,37595,0,0,0,2,2
66148,150,14636,19766;19951,37595,0,0,0,2,2
66149,150,14638,19833;20167,37595,0,0,0,2,2
66150,150,14639,20038;20628,37595,0,0,1,1,2
66151,150,14640,20491;20557,37595,0,0,1,1,2
66152,150,14645,19991;20288,37595,0,0,0,2,2
66153,150,14646,19820;20255,37595,0,0,0,2,2
66154,150,14647,20432;20550;24017;26230,37595,0,1,1,2,4
66155,150,14648,20191,37595,0,0,0,1,1
66156,150,14649,19964;20176,37595,0,0,0,2,2
66157,150,14650,20227,37595,0,0,0,1,1
66158,150,14651,20352;24002;27072,37595,1,0,1,1,3
66159,150,14652,20168;20212,37595,0,0,0,2,2
66160,150,14653,20139;20239,37595,0,0,0,2,2
66161,150,14654,19839;20242,37595,0,0,0,2,2
66162,150,14655,19975;20017,37595,0,0,0,2,2
66163,150,14656,20272;20362,37595,0,0,0,2,2
66164,150,14657,20279;20456,37595,0,0,0,2,2
66165,150,14698,18068,37960,0,0,0,1,1
66166,150,14700,17931,37960,0,0,0,1,1
66167,150,14701,17998,37960,0,0,0,1,1
66168,150,14703,18045,37960,0,0,0,1,1
66169,150,14710,18181,37960,0,0,0,1,1
66170,150,14711,18302,37960,0,0,0,1,1
66171,150,14713,18641;18907,37960,0,0,0,2,2
66172,150,14715,18986;19359,37960,0,0,0,2,2
66173,150,14717,18862,37960,0,0,0,1,1
66174,150,14718,19497,37960,0,0,0,1,1
66175,150,14719,18372,37960,0,0,0,1,1
66176,150,14722,19165,37960,0,0,0,1,1
66177,150,14725,19423,37960,0,0,0,1,1
66178,150,14726,19005;19169,37960,0,0,0,2,2
66179,150,14727,19066;19674,37960,0,0,0,2,2
66180,150,14730,19508;19863,37960,0,0,0,2,2
66181,150,14731,19525;19594,37960,0,0,0,2,2
66182,150,14734,19903,37960,0,0,0,1,1
66183,150,14736,19613;19943,37960,0,0,0,2,2
66184,150,14737,19653;19694,37960,0,0,0,2,2
66185,150,14738,19676;19731,37960,0,0,0,2,2
66186,150,14741,19386;19715,37960,0,0,0,2,2
66187,150,14742,19436;19725,37960,0,0,0,2,2
66188,150,14743,19564;19989,37960,0,0,0,2,2
66189,150,14744,20081,37960,0,0,0,1,1
66190,150,14745,19570;19924,37960,0,0,0,2,2
66191,150,14746,19498;19928;22490,37960,0,0,1,2,3
66192,150,14747,19952,37960,0,0,0,1,1
66193,150,14748,20003;20621,37960,0,0,1,1,2
66194,150,14749,20349,37960,0,0,0,1,1
66195,150,14751,19558;20029,37960,0,0,0,2,2
66196,150,14752,20037;20476,37960,0,0,0,2,2
66197,150,14753,20404,37960,0,0,0,1,1
66198,150,14754,20169;20681,37960,0,0,1,1,2
66199,150,14755,20510,37960,0,0,0,1,1
66200,150,14756,20198,37960,0,0,0,1,1
66201,150,14757,20280,37960,0,0,0,1,1
66202,150,14759,20218;20297,37960,0,0,0,2,2
66203,150,14760,20448,37960,0,0,0,1,1
66204,150,14761,20314;23680,37960,0,0,1,1,2
66205,150,14762,20267;20320,37960,0,0,0,2,2
66206,150,14763,20462;25016,37960,0,0,1,1,2
66207,150,14764,20353;20431,37960,0,0,0,2,2
66208,150,14765,20664;21168,37960,0,0,2,0,2
66209,150,14766,20025;20386,37960,0,0,0,2,2
66210,150,14768,20424,37960,0,0,0,1,1
66211,150,14787,17966,38325,0,0,0,1,1
66212,150,14793,18373,38325,0,0,0,1,1
66213,150,14795,18304;22520,38325,0,0,1,1,2
66214,150,14804,17969,38325,0,0,0,1,1
66215,150,14808,18689,38325,0,0,0,1,1
66216,150,14813,18900,38325,0,0,0,1,1
66217,150,14815,19110,38325,0,0,0,1,1
66218,150,14816,19248;19710,38325,0,0,0,2,2
66219,150,14819,19419;19620,38325,0,0,0,2,2
66220,150,14820,19274;19373,38325,0,0,0,2,2
66221,150,14823,19557,38325,0,0,0,1,1
66222,150,14825,19433,38325,0,0,0,1,1
66223,150,14827,19815;23755;27266,38325,1,0,1,1,3
66224,150,14828,19540,38325,0,0,0,1,1
66225,150,14829,19410;19998,38325,0,0,0,2,2
66226,150,14830,19625;19900,38325,0,0,0,2,2
66227,150,14831,20246;20286;23570,38325,0,0,1,2,3
66228,150,14832,19717,38325,0,0,0,1,1
66229,150,14834,20203;23466,38325,0,0,1,1,2
66230,150,14836,19821;20502,38325,0,0,0,2,2
66231,150,14837,19916;20503,38325,0,0,0,2,2
66232,150,14838,19706;19932,38325,0,0,0,2,2
66233,150,14843,20005;20170;23991,38325,0,0,1,2,3
66234,150,14844,19956;20069,38325,0,0,0,2,2
66235,150,14845,20571,38325,0,0,1,0,1
66236,150,14846,20096,38325,0,0,0,1,1
66237,150,14847,23989;24346,38325,0,0,2,0,2
66238,150,14848,20159;20161,38325,0,0,0,2,2
66239,150,14849,20094;20165,38325,0,0,0,2,2
66240,150,14851,20046;20376,38325,0,0,0,2,2
66241,150,14854,20232,38325,0,0,0,1,1
66242,150,14855,20200;20289,38325,0,0,0,2,2
66243,150,14856,19946;20295,38325,0,0,0,2,2
66244,150,14857,23345;23679;23739;23890;26679;26773;26884,38325,1,2,4,0,7
66245,150,14858,20911;20973;25028;25213,38325,0,0,4,0,4
66246,150,14862,20240,38325,0,0,0,1,1
66247,150,14863,20384,38325,0,0,0,1,1
66248,150,14864,20393;20542,38325,0,0,0,2,2
66249,150,14865,20063;20397,38325,0,0,0,2,2
66250,150,14866,20402;20793;24710,38325,0,0,2,1,3
66251,150,14867,20407;20668,38325,0,0,1,1,2
66252,150,14868,20355;20718,38325,0,0,1,1,2
66253,150,14869,20224;20484,38325,0,0,0,2,2
66254,150,14870,20909;21000;24154;26232,38325,0,1,3,0,4
66255,150,14871,20015;20497;24229;26705,38325,0,1,1,2,4
66256,150,14872,20499;20820,38325,0,0,1,1,2
66257,150,14873,20650,38325,0,0,1,0,1
66258,150,14874,20505,38325,0,0,0,1,1
66259,150,14876,20792;25023,38325,0,0,2,0,2
66260,150,14877,20564;20640,38325,0,0,2,0,2
66261,150,14902,18035,38690,0,0,0,1,1
66262,150,14906,17791,38690,0,0,0,1,1
66263,150,14907,17589,38690,0,0,0,1,1
66264,150,14913,18140,38690,0,0,0,1,1
66265,150,14920,19235,38690,0,0,0,1,1
66266,150,14921,18805,38690,0,0,0,1,1
66267,150,14923,19582,38690,0,0,0,1,1
66268,150,14924,19372,38690,0,0,0,1,1
66269,150,14925,18576;18643;23009,38690,0,0,1,2,3
66270,150,14926,18719;18829,38690,0,0,0,2,2
66271,150,14928,18932,38690,0,0,0,1,1
66272,150,14931,18918;19012,38690,0,0,0,2,2
66273,150,14932,19174;19223,38690,0,0,0,2,2
66274,150,14933,19241;19670,38690,0,0,0,2,2
66275,150,14935,19742,38690,0,0,0,1,1
66276,150,14938,19425;19953,38690,0,0,0,2,2
66277,150,14939,19722,38690,0,0,0,1,1
66278,150,14940,19563,38690,0,0,0,1,1
66279,150,14941,19085;19536,38690,0,0,0,2,2
66280,150,14942,19567;19921,38690,0,0,0,2,2
66281,150,14943,19621;20067,38690,0,0,0,2,2
66282,150,14945,19728;20199,38690,0,0,0,2,2
66283,150,14946,19628,38690,0,0,0,1,1
66284,150,14947,19979;20055,38690,0,0,0,2,2
66285,150,14948,19788,38690,0,0,0,1,1
66286,150,14949,19338;19869,38690,0,0,0,2,2
66287,150,14950,20106;20214,38690,0,0,0,2,2
66288,150,14951,19847;20051,38690,0,0,0,2,2
66289,150,14952,19246;19867,38690,0,0,0,2,2
66290,150,14953,19413,38690,0,0,0,1,1
66291,150,14954,20245,38690,0,0,0,1,1
66292,150,14955,19961,38690,0,0,0,1,1
66293,150,14957,20040,38690,0,0,0,1,1
66294,150,14958,19720;20121,38690,0,0,0,2,2
66295,150,14959,19992;20413,38690,0,0,0,2,2
66296,150,14960,20394,38690,0,0,0,1,1
66297,150,14961,19761;20134,38690,0,0,0,2,2
66298,150,14962,20145;24088,38690,0,0,1,1,2
66299,150,14964,19805;20181,38690,0,0,0,2,2
66300,150,14965,20469;20720;23376,38690,0,0,2,1,3
66301,150,14966,20290,38690,0,0,0,1,1
66302,150,14967,20536;20620;24488;26608,38690,0,1,2,1,4
66303,150,14968,20373,38690,0,0,0,1,1
66304,150,14969,20275,38690,0,0,0,1,1
66305,150,14970,20114;20300,38690,0,0,0,2,2
66306,150,14972,20333;20399,38690,0,0,0,2,2
66307,150,14973,20225;20595,38690,0,0,1,1,2
66308,150,14974,20672;20723,38690,0,0,2,0,2
66309,150,14977,20412,38690,0,0,0,1,1
66310,150,14978,20442;20481;24117,38690,0,0,1,2,3
66311,150,14980,20895;20940;24254;24821,38690,0,0,4,0,4
66312,150,14981,20403,38690,0,0,0,1,1
66313,150,14982,20488;20569,38690,0,0,1,1,2
66314,150,14983,20605,38690,0,0,1,0,1
66315,150,14984,20053;20378;23897,38690,0,0,1,2,3
66316,150,14985,20495;23690;26675,38690,0,1,1,1,3
66317,150,14986,20527,38690,0,0,0,1,1
66318,150,14987,20570,38690,0,0,1,0,1
66319,150,14988,20007;20559,38690,0,0,1,1,2
66320,150,14989,20511;20576,38690,0,0,1,1,2
66321,150,14990,20587;20863,38690,0,0,2,0,2
66322,150,14991,20624;20627,38690,0,0,2,0,2
66323,150,15022,18287,39055,0,0,0,1,1
66324,150,15027,18322;19061,39055,0,0,0,2,2
66325,150,15029,18812,39055,0,0,0,1,1
66326,150,15030,18726,39055,0,0,0,1,1
66327,150,15033,18536;18650,39055,0,0,0,2,2
66328,150,15035,19272;19463;24086,39055,0,0,1,2,3
66329,150,15041,19618,39055,0,0,0,1,1
66330,150,15042,19352;19559;23640,39055,0,0,1,2,3
66331,150,15043,19327;19614;23430,39055,0,0,1,2,3
66332,150,15044,19456,39055,0,0,0,1,1
66333,150,15047,19689;19856,39055,0,0,0,2,2
66334,150,15049,19214;19723;23974,39055,0,0,1,2,3
66335,150,15051,19808;20144,39055,0,0,0,2,2
66336,150,15052,19651;19846;23068,39055,0,0,1,2,3
66337,150,15053,20087;20268;24301,39055,0,0,1,2,3
66338,150,15057,19510;19648,39055,0,0,0,2,2
66339,150,15058,20498;23904,39055,0,0,1,1,2
66340,150,15059,20008;20088,39055,0,0,0,2,2
66341,150,15060,19605;20011,39055,0,0,0,2,2
66342,150,15062,20688;24701;26721,39055,0,1,2,0,3
66343,150,15063,20680;20708;23283,39055,0,0,3,0,3
66344,150,15064,20344,39055,0,0,0,1,1
66345,150,15065,20113;20120,39055,0,0,0,2,2
66346,150,15066,24237;24697;24810,39055,0,0,3,0,3
66347,150,15067,20166;20766;23921;25922;26498;26690,39055,0,3,2,1,6
66348,150,15068,20535,39055,0,0,0,1,1
66349,150,15069,20259;20606,39055,0,0,1,1,2
66350,150,15070,20553;20730,39055,0,0,2,0,2
66351,150,15071,20440;20585,39055,0,0,1,1,2
66352,150,15072,20281;20809,39055,0,0,1,1,2
66353,150,15073,20180;20291,39055,0,0,0,2,2
66354,150,15076,20862,39055,0,0,1,0,1
66355,150,15077,20201;20435,39055,0,0,0,2,2
66356,150,15079,20100;20455,39055,0,0,0,2,2
66357,150,15080,20461;20538,39055,0,0,0,2,2
66358,150,15081,20463;20890,39055,0,0,1,1,2
66359,150,15082,20329;20375;24223,39055,0,0,1,2,3
66360,150,15083,20172;24475,39055,0,0,1,1,2
66361,150,15084,20932;21381;25321,39055,0,0,3,0,3
66362,150,15085,20869;21013,39055,0,0,2,0,2
66363,150,15086,20812;20949,39055,0,0,2,0,2
66364,150,15089,20547;24585,39055,0,0,1,1,2
66365,150,15090,20317;20552,39055,0,0,1,1,2
66366,150,15091,20340;20574,39055,0,0,1,1,2
66367,150,15092,21048,39055,0,0,1,0,1
66368,150,15093,20598,39055,0,0,1,0,1
66369,150,15094,20524;20626;24126,39055,0,0,2,1,3
66370,150,15095,20326;20636,39055,0,0,1,1,2
66371,150,15096,20653,39055,0,0,1,0,1
66372,150,15097,20717,39055,0,0,1,0,1
66373,150,15098,20634,39055,0,0,1,0,1
66374,150,15099,20845;20924;24148;26138;26914,39055,1,1,3,0,5
66375,150,15100,20746,39055,0,0,1,0,1
66376,150,15136,18588,39420,0,0,0,1,1
66377,150,15137,19474;19502,39420,0,0,0,2,2
66378,150,15142,19026,39420,0,0,0,1,1
66379,150,15144,20193;24476,39420,0,0,1,1,2
66380,150,15145,19714,39420,0,0,0,1,1
66381,150,15147,19205,39420,0,0,0,1,1
66382,150,15149,19464,39420,0,0,0,1,1
66383,150,15151,19713;20035,39420,0,0,0,2,2
66384,150,15154,20250;20369,39420,0,0,0,2,2
66385,150,15155,19845;20101;23556;26392;27147,39420,1,1,1,2,5
66386,150,15156,19877,39420,0,0,0,1,1
66387,150,15158,19586;19968,39420,0,0,0,2,2
66388,150,15160,20123,39420,0,0,0,1,1
66389,150,15161,20125;20155,39420,0,0,0,2,2
66390,150,15162,20130;20556,39420,0,0,1,1,2
66391,150,15164,20879,39420,0,0,1,0,1
66392,150,15168,20093;20363,39420,0,0,0,2,2
66393,150,15169,20635;24025;26231;26985,39420,1,1,2,0,4
66394,150,15170,20405;20472,39420,0,0,0,2,2
66395,150,15171,20438;20777;24414,39420,0,0,2,1,3
66396,150,15172,20756,39420,0,0,1,0,1
66397,150,15173,20140;20459,39420,0,0,0,2,2
66398,150,15175,20958;21163;23941;24347;26131;26591;26694,39420,0,3,4,0,7
66399,150,15176,20298;20592,39420,0,0,1,1,2
66400,150,15177,20216;20537;23793,39420,0,0,1,2,3
66401,150,15178,20549;24489,39420,0,0,1,1,2
66402,150,15179,20565;20861;24042,39420,0,0,3,0,3
66403,150,15181,20583;20753,39420,0,0,2,0,2
66404,150,15182,20872;21100;25140,39420,0,0,3,0,3
66405,150,15184,20599;20641,39420,0,0,2,0,2
66406,150,15185,20817;21143,39420,0,0,2,0,2
66407,150,15187,20659;20673,39420,0,0,2,0,2
66408,150,15188,20473;20660,39420,0,0,1,1,2
66409,150,15189,20182;20690;24407,39420,0,0,2,1,3
66410,150,15191,20597;20956;25135;27227,39420,1,0,3,0,4
66411,150,15192,20382;20751;23919;24594;27210,39420,1,0,3,1,5
66412,150,15193,20769,39420,0,0,1,0,1
66413,150,15194,20785;20984;24826;25323;26614,39420,0,1,4,0,5
66414,150,15195,20971;24149,39420,0,0,2,0,2
66415,150,15196,20810,39420,0,0,1,0,1
66416,150,15197,20827;20948,39420,0,0,2,0,2
66417,150,15198,20833;25025,39420,0,0,2,0,2
66418,150,15199,20652;20892,39420,0,0,2,0,2
66419,150,15206,16797,39785,0,0,0,1,1
66420,150,15215,16882,39785,0,0,0,1,1
66421,150,15227,17686,39785,0,0,0,1,1
66422,150,15235,19050,39785,0,0,0,1,1
66423,150,15243,19394,39785,0,0,0,1,1
66424,150,15247,19523;23314,39785,0,0,1,1,2
66425,150,15248,19692;20160;24573,39785,0,0,1,2,3
66426,150,15250,19659;20062,39785,0,0,0,2,2
66427,150,15251,20209,39785,0,0,0,1,1
66428,150,15252,20048;20226,39785,0,0,0,2,2
66429,150,15253,19643;19976,39785,0,0,0,2,2
66430,150,15255,20044,39785,0,0,0,1,1
66431,150,15257,19825;20072;23987;26696,39785,0,1,1,2,4
66432,150,15258,20321,39785,0,0,0,1,1
66433,150,15259,20163;20426,39785,0,0,0,2,2
66434,150,15260,20447;20745,39785,0,0,1,1,2
66435,150,15261,20230;20301,39785,0,0,0,2,2
66436,150,15262,20234,39785,0,0,0,1,1
66437,150,15263,20422;20591,39785,0,0,1,1,2
66438,150,15264,20264,39785,0,0,0,1,1
66439,150,15266,20324;20551;23691,39785,0,0,2,1,3
66440,150,15267,20396;20737,39785,0,0,1,1,2
66441,150,15268,20334,39785,0,0,0,1,1
66442,150,15269,20430,39785,0,0,0,1,1
66443,150,15270,20322;20357,39785,0,0,0,2,2
66444,150,15272,20377,39785,0,0,0,1,1
66445,150,15273,20153;20427,39785,0,0,0,2,2
66446,150,15274,20445;20506,39785,0,0,0,2,2
66447,150,15275,20512;20515,39785,0,0,0,2,2
66448,150,15276,20368;20822,39785,0,0,1,1,2
66449,150,15277,20563,39785,0,0,1,0,1
66450,150,15278,20682;20899;25212,39785,0,0,3,0,3
66451,150,15279,20590;20963,39785,0,0,2,0,2
66452,150,15280,21204,39785,0,0,1,0,1
66453,150,15281,20866;21055;24834;27216,39785,1,0,3,0,4
66454,150,15282,20507;20739,39785,0,0,1,1,2
66455,150,15283,20644;20677,39785,0,0,2,0,2
66456,150,15284,20691;24596,39785,0,0,2,0,2
66457,150,15285,20694,39785,0,0,1,0,1
66458,150,15286,20466;20689;24485,39785,0,0,2,1,3
66459,150,15287,20529;20714,39785,0,0,1,1,2
66460,150,15288,21036;21138,39785,0,0,2,0,2
66461,150,15289,20725;20976;23823,39785,0,0,3,0,3
66462,150,15290,20731,39785,0,0,1,0,1
66463,150,15292,20748;20964,39785,0,0,2,0,2
66464,150,15293,20762,39785,0,0,1,0,1
66465,150,15294,20568;20763,39785,0,0,2,0,2
66466,150,15295,20773;20945,39785,0,0,2,0,2
66467,150,15296,24242;24415;27002,39785,1,0,2,0,3
66468,150,15297,20844;21058,39785,0,0,2,0,2
66469,150,15298,20847;20939,39785,0,0,2,0,2
66470,150,15299,20724;21072;25326,39785,0,0,3,0,3
66471,150,15300,21171,39785,0,0,1,0,1
66472,150,15301,20871,39785,0,0,1,0,1
66473,150,15302,20893;21124;24841;25219,39785,0,0,4,0,4
66474,150,15303,21052,39785,0,0,1,0,1
66475,150,15304,20715;20923,39785,0,0,2,0,2
66476,150,15306,21096;25218,39785,0,0,2,0,2
66477,150,15307,20385;21038,39785,0,0,1,1,2
66478,150,15314,16649,40150,0,0,0,1,1
66479,150,15320,17633,40150,0,0,0,1,1
66480,150,15326,17584,40150,0,0,0,1,1
66481,150,15336,18618;19152,40150,0,0,0,2,2
66482,150,15341,18846;19348,40150,0,0,0,2,2
66483,150,15344,19113,40150,0,0,0,1,1
66484,150,15347,19458,40150,0,0,0,1,1
66485,150,15351,19441,40150,0,0,0,1,1
66486,150,15354,19758;19890,40150,0,0,0,2,2
66487,150,15356,20001;20600,40150,0,0,1,1,2
66488,150,15357,19588;20175,40150,0,0,0,2,2
66489,150,15358,20016;20251,40150,0,0,0,2,2
66490,150,15360,19792;20061,40150,0,0,0,2,2
66491,150,15361,20077;20374,40150,0,0,0,2,2
66492,150,15363,19902;20131,40150,0,0,0,2,2
66493,150,15364,20080;20410,40150,0,0,0,2,2
66494,150,15365,20922;20961;25320,40150,0,0,3,0,3
66495,150,15366,20319;20335,40150,0,0,0,2,2
66496,150,15367,20520;20594;23906;27065,40150,1,0,2,1,4
66497,150,15369,20408;20927,40150,0,0,1,1,2
66498,150,15370,20421;20696,40150,0,0,1,1,2
66499,150,15372,20339;20439,40150,0,0,0,2,2
66500,150,15373,20485;20613,40150,0,0,1,1,2
66501,150,15374,20409;20492,40150,0,0,0,2,2
66502,150,15375,20277,40150,0,0,0,1,1
66503,150,15376,20582;20811,40150,0,0,2,0,2
66504,150,15379,20667;20998,40150,0,0,2,0,2
66505,150,15381,20639;20959,40150,0,0,2,0,2
66506,150,15382,20341;20754,40150,0,0,1,1,2
66507,150,15383,21281;24734,40150,0,0,2,0,2
66508,150,15384,21284;24937,40150,0,0,2,0,2
66509,150,15385,20816,40150,0,0,1,0,1
66510,150,15386,21022;25138,40150,0,0,2,0,2
66511,150,15388,20854;20966;24425;24822,40150,0,0,4,0,4
66512,150,15390,21196;21312;24622;24933,40150,0,0,4,0,4
66513,150,15392,20985,40150,0,0,1,0,1
66514,150,15394,20926;25134,40150,0,0,2,0,2
66515,150,15397,20874;21103,40150,0,0,2,0,2
66516,150,15398,20977;21181;25519,40150,0,0,3,0,3
66517,150,15399,21238;21344;25046,40150,0,0,3,0,3
66518,150,15400,21011;24050;24721,40150,0,0,3,0,3
66519,150,15401,20713;21012,40150,0,0,2,0,2
66520,150,15417,18816,40515,0,0,0,1,1
66521,150,15426,19164,40515,0,0,0,1,1
66522,150,15427,18773;19340,40515,0,0,0,2,2
66523,150,15429,18802;19179,40515,0,0,0,2,2
66524,150,15436,19762;20070,40515,0,0,0,2,2
66525,150,15438,19607;19796,40515,0,0,0,2,2
66526,150,15439,19584;19812,40515,0,0,0,2,2
66527,150,15443,19893;20118;24101;27183,40515,1,0,1,2,4
66528,150,15445,19896;20611,40515,0,0,1,1,2
66529,150,15446,20311,40515,0,0,0,1,1
66530,150,15448,20327;20814;23923;24140;26031;26691,40515,0,2,3,1,6
66531,150,15449,20124;20208,40515,0,0,0,2,2
66532,150,15451,20302;20370;24481,40515,0,0,1,2,3
66533,150,15454,20256;20795,40515,0,0,1,1,2
66534,150,15455,20039;20303;23889,40515,0,0,1,2,3
66535,150,15456,20310;20684,40515,0,0,1,1,2
66536,150,15457,20607,40515,0,0,1,0,1
66537,150,15458,20372;20437,40515,0,0,0,2,2
66538,150,15459,20156;20457,40515,0,0,0,2,2
66539,150,15460,20450;20818,40515,0,0,1,1,2
66540,150,15461,20480;20736;24411,40515,0,0,2,1,3
66541,150,15463,20728;20930,40515,0,0,2,0,2
66542,150,15465,20342;20541,40515,0,0,0,2,2
66543,150,15466,20995,40515,0,0,1,0,1
66544,150,15467,20674;20780;24033,40515,0,0,3,0,3
66545,150,15468,20826;21025,40515,0,0,2,0,2
66546,150,15470,20996,40515,0,0,1,0,1
66547,150,15472,20453;20697,40515,0,0,1,1,2
66548,150,15473,20489;20699;24316;26708;27196,40515,1,1,2,1,5
66549,150,15474,20712,40515,0,0,1,0,1
66550,150,15476,20646;20791,40515,0,0,2,0,2
66551,150,15477,20707;20823;24326;24501,40515,0,0,4,0,4
66552,150,15478,21015;21254;23937;24830;26499,40515,0,1,4,0,5
66553,150,15479,21027;21164;25040,40515,0,0,3,0,3
66554,150,15480,21114,40515,0,0,1,0,1
66555,150,15481,20912;20997;25029,40515,0,0,3,0,3
66556,150,15482,20917,40515,0,0,1,0,1
66557,150,15484,20889;20942,40515,0,0,2,0,2
66558,150,15485,20947;21066,40515,0,0,2,0,2
66559,150,15486,20732;20952;24424;26811;26926,40515,1,1,3,0,5
66560,150,15487,21201;24730,40515,0,0,2,0,2
66561,150,15488,20968;21487;25348;25924,40515,0,1,3,0,4
66562,150,15489,20983;21037,40515,0,0,2,0,2
66563,150,15490,21008;23936,40515,0,0,2,0,2
66564,150,15491,21028;21130;24842,40515,0,0,3,0,3
66565,150,15492,21412;25231,40515,0,0,2,0,2
66566,150,15493,21053;21298;24633;27105,40515,1,0,3,0,4
66567,150,15494,21065;21232,40515,0,0,2,0,2
66568,150,15495,21085;21321;24939,40515,0,0,3,0,3
66569,150,15496,21553;21814;24555,40515,0,0,3,0,3
66570,150,15498,21121;21427,40515,0,0,2,0,2
66571,150,15499,21151;21308;24735;25049,40515,0,0,4,0,4
66572,150,15500,21153;21486,40515,0,0,2,0,2
66573,150,15501,21200;21408,40515,0,0,2,0,2
66574,150,15502,21245,40515,0,0,1,0,1
66575,150,15520,17442,40880,0,0,0,1,1
66576,150,15523,18345,40880,0,0,0,1,1
66577,150,15524,18586,40880,0,0,0,1,1
66578,150,15529,19073,40880,0,0,0,1,1
66579,150,15530,18824,40880,0,0,0,1,1
66580,150,15536,19666;19749,40880,0,0,0,2,2
66581,150,15539,19948,40880,0,0,0,1,1
66582,150,15540,20107;20223;23994,40880,0,0,1,2,3
66583,150,15541,19677,40880,0,0,0,1,1
66584,150,15542,20391,40880,0,0,0,1,1
66585,150,15543,20315,40880,0,0,0,1,1
66586,150,15544,20285;24217,40880,0,0,1,1,2
66587,150,15545,20392;20742,40880,0,0,1,1,2
66588,150,15546,20701;24704;27111,40880,1,0,2,0,3
66589,150,15547,20045;20138,40880,0,0,0,2,2
66590,150,15548,20436,40880,0,0,0,1,1
66591,150,15549,20085;20522,40880,0,0,0,2,2
66592,150,15550,20727,40880,0,0,1,0,1
66593,150,15551,21031;21106,40880,0,0,2,0,2
66594,150,15552,20589;21440,40880,0,0,2,0,2
66595,150,15553,20604;20950,40880,0,0,2,0,2
66596,150,15555,20934;21004,40880,0,0,2,0,2
66597,150,15556,20207;20544;23176,40880,0,0,1,2,3
66598,150,15557,20704;20994,40880,0,0,2,0,2
66599,150,15558,20800;20978;23603;26485,40880,0,1,3,0,4
66600,150,15559,20804,40880,0,0,1,0,1
66601,150,15560,20919;23930;24251;24716,40880,0,0,4,0,4
66602,150,15562,20722;21088;25327,40880,0,0,3,0,3
66603,150,15563,20898;21464;25233,40880,0,0,3,0,3
66604,150,15564,20266;20662,40880,0,0,1,1,2
66605,150,15565,20615;21057,40880,0,0,2,0,2
66606,150,15566,21420;21422;25153,40880,0,0,3,0,3
66607,150,15568,21064;21341;25426,40880,0,0,3,0,3
66608,150,15569,20992;21046,40880,0,0,2,0,2
66609,150,15570,21410;21479,40880,0,0,2,0,2
66610,150,15571,20692;21010;25520,40880,0,0,3,0,3
66611,150,15573,21054;21416;24851,40880,0,0,3,0,3
66612,150,15574,21315;21411;25050,40880,0,0,3,0,3
66613,150,15575,21287;21463;24855,40880,0,0,3,0,3
66614,150,15576,21236;21732;25335,40880,0,0,3,0,3
66615,150,15577,20700;21137,40880,0,0,2,0,2
66616,150,15578,21161,40880,0,0,1,0,1
66617,150,15580,21172;25423,40880,0,0,2,0,2
66618,150,15581,21177,40880,0,0,1,0,1
66619,150,15582,21188;21547;25239,40880,0,0,3,0,3
66620,150,15583,20758;21206,40880,0,0,2,0,2
66621,150,15584,20776;21211;24520,40880,0,0,3,0,3
66622,150,15586,21249;21355,40880,0,0,2,0,2
66623,150,15587,20794;21256,40880,0,0,2,0,2
66624,150,15588,21262,40880,0,0,1,0,1
66625,150,15590,21280;21313;25339;25425,40880,0,0,4,0,4
66626,150,15591,21283;21550;24943;25053,40880,0,0,4,0,4
66627,150,15592,21128;21286,40880,0,0,2,0,2
66628,150,15600,17267,41245,0,0,0,1,1
66629,150,15608,17822,41245,0,0,0,1,1
66630,150,15609,18124,41245,0,0,0,1,1
66631,150,15614,19301,41245,0,0,0,1,1
66632,150,15616,19167,41245,0,0,0,1,1
66633,150,15622,19382,41245,0,0,0,1,1
66634,150,15629,20593,41245,0,0,1,0,1
66635,150,15631,19977;20312;24219,41245,0,0,1,2,3
66636,150,15632,20523,41245,0,0,0,1,1
66637,150,15633,21039;21167;25422,41245,0,0,3,0,3
66638,150,15634,20839,41245,0,0,1,0,1
66639,150,15636,20654;20870,41245,0,0,2,0,2
66640,150,15637,20663;21123,41245,0,0,2,0,2
66641,150,15638,20629;20678,41245,0,0,2,0,2
66642,150,15639,20470;20683,41245,0,0,1,1,2
66643,150,15640,20768;20910,41245,0,0,2,0,2
66644,150,15641,20278;20799,41245,0,0,1,1,2
66645,150,15644,21465,41245,0,0,1,0,1
66646,150,15646,20887,41245,0,0,1,0,1
66647,150,15647,20829;20888,41245,0,0,2,0,2
66648,150,15649,21002;21074,41245,0,0,2,0,2
66649,150,15650,20951;21220,41245,0,0,2,0,2
66650,150,15651,20907;20989,41245,0,0,2,0,2
66651,150,15652,21397,41245,0,0,1,0,1
66652,150,15653,21110;24434;26814,41245,0,1,2,0,3
66653,150,15654,21415,41245,0,0,1,0,1
66654,150,15655,21092;21115,41245,0,0,2,0,2
66655,150,15656,21428;25523,41245,0,0,2,0,2
66656,150,15657,21449;21482,41245,0,0,2,0,2
66657,150,15658,20993;21145;24619;25330,41245,0,0,4,0,4
66658,150,15659,21162;21243,41245,0,0,2,0,2
66659,150,15660,20744;21217,41245,0,0,2,0,2
66660,150,15661,21418;21591;25733,41245,0,1,2,0,3
66661,150,15662,21680,41245,0,0,1,0,1
66662,150,15663,21247;25224,41245,0,0,2,0,2
66663,150,15665,21329;21683;24768;25439,41245,0,0,4,0,4
66664,150,15666,20849;21259,41245,0,0,2,0,2
66665,150,15667,21253;21613;25065,41245,0,0,3,0,3
66666,150,15668,21270;21662,41245,0,0,2,0,2
66667,150,15669,21278;25337,41245,0,0,2,0,2
66668,150,15670,21291;21534;25237;25436;25732,41245,0,1,4,0,5
66669,150,15671,21304;21471,41245,0,0,2,0,2
66670,150,15672,20986;21305,41245,0,0,2,0,2
66671,150,15673,21320;25147;25630,41245,0,1,2,0,3
66672,150,15674,21332;25341,41245,0,0,2,0,2
66673,150,15675,21297;24529,41245,0,0,2,0,2
66674,150,15676,21326;25631;26034,41245,0,2,1,0,3
66675,150,15677,21394;21511,41245,0,0,2,0,2
66676,150,15678,21097;21600,41245,0,0,2,0,2
66677,150,15679,21393;24448,41245,0,0,2,0,2
66678,150,15680,21400,41245,0,0,1,0,1
66679,150,15681,21401;21426;25345,41245,0,0,3,0,3
66680,150,15703,18149,41610,0,0,0,1,1
66681,150,15706,18532;18680,41610,0,0,0,2,2
66682,150,15709,19116,41610,0,0,0,1,1
66683,150,15710,18904,41610,0,0,0,1,1
66684,150,15718,19580;19973,41610,0,0,0,2,2
66685,150,15720,19974,41610,0,0,0,1,1
66686,150,15725,19435;19996,41610,0,0,0,2,2
66687,150,15726,20012;20233,41610,0,0,0,2,2
66688,150,15727,19782;20276,41610,0,0,0,2,2
66689,150,15728,20041;20487,41610,0,0,0,2,2
66690,150,15731,20257;23084,41610,0,0,1,1,2
66691,150,15733,20192;20253,41610,0,0,0,2,2
66692,150,15734,20282;20309,41610,0,0,0,2,2
66693,150,15736,20533;20575;24807,41610,0,0,2,1,3
66694,150,15737,21208;21240,41610,0,0,2,0,2
66695,150,15738,20991,41610,0,0,1,0,1
66696,150,15740,20612;20711;24592,41610,0,0,3,0,3
66697,150,15741,20623;20831,41610,0,0,2,0,2
66698,150,15742,20825;20979,41610,0,0,2,0,2
66699,150,15743,20560;20721,41610,0,0,2,0,2
66700,150,15744,20467;20757,41610,0,0,1,1,2
66701,150,15745,21060;24836;25325;26615,41610,0,1,3,0,4
66702,150,15746,20665,41610,0,0,1,0,1
66703,150,15747,21271;25336,41610,0,0,2,0,2
66704,150,15748,20779;24815,41610,0,0,2,0,2
66705,150,15749,20855,41610,0,0,1,0,1
66706,150,15750,20441;20835,41610,0,0,1,1,2
66707,150,15752,20884;21056;24722,41610,0,0,3,0,3
66708,150,15754,20726;20936,41610,0,0,2,0,2
66709,150,15755,20938;21112;25214,41610,0,0,3,0,3
66710,150,15758,21014;21076;24725;25726,41610,0,1,3,0,4
66711,150,15760,20897;21084,41610,0,0,2,0,2
66712,150,15762,21156;21314,41610,0,0,2,0,2
66713,150,15763,21327,41610,0,0,1,0,1
66714,150,15766,21337;24518;24621;26928,41610,1,0,3,0,4
66715,150,15767,20916;21269;24268;24351;25522;25629,41610,0,1,5,0,6
66716,150,15768,21273;21433;25154,41610,0,0,3,0,3
66717,150,15770,21290;25145,41610,0,0,2,0,2
66718,150,15772,21608;21829,41610,0,0,2,0,2
66719,150,15775,21203;21383,41610,0,0,2,0,2
66720,150,15776,21364;21384,41610,0,0,2,0,2
66721,150,15777,21221;21621;25242;25531,41610,0,0,4,0,4
66722,150,15782,17120,41975,0,0,0,1,1
66723,150,15787,17776,41975,0,0,0,1,1
66724,150,15789,18152,41975,0,0,0,1,1
66725,150,15790,18558,41975,0,0,0,1,1
66726,150,15798,18566;18985,41975,0,0,0,2,2
66727,150,15801,19854,41975,0,0,0,1,1
66728,150,15806,19851;19930,41975,0,0,0,2,2
66729,150,15807,20178;20183;23879,41975,0,0,1,2,3
66730,150,15808,24399;24819;25017;25114,41975,0,0,4,0,4
66731,150,15811,20360;20805,41975,0,0,1,1,2
66732,150,15812,20388,41975,0,0,0,1,1
66733,150,15814,20366;20477,41975,0,0,0,2,2
66734,150,15815,19675;22746;25302;25879;26072;26830,41975,0,3,2,1,6
66735,150,15817,20337;20657;24493,41975,0,0,2,1,3
66736,150,15819,20186;20584,41975,0,0,1,1,2
66737,150,15820,20882;21020;24430,41975,0,0,3,0,3
66738,150,15821,21018;21021,41975,0,0,2,0,2
66739,150,15822,20920;20999;24828;27215,41975,1,0,3,0,4
66740,150,15823,20411;20631,41975,0,0,1,1,2
66741,150,15824,20840,41975,0,0,1,0,1
66742,150,15825,20974;24427,41975,0,0,2,0,2
66743,150,15827,20755;21042;24511,41975,0,0,3,0,3
66744,150,15828,20788;24597;25421;27234,41975,1,0,3,0,4
66745,150,15829,20876;20937,41975,0,0,2,0,2
66746,150,15830,20906;21040,41975,0,0,2,0,2
66747,150,15831,21184;21295,41975,0,0,2,0,2
66748,150,15833,20841;21001;24720,41975,0,0,3,0,3
66749,150,15834,21593;21607,41975,0,0,2,0,2
66750,150,15835,20921;21347;24941,41975,0,0,3,0,3
66751,150,15836,21318;23728;25227;26677,41975,0,1,3,0,4
66752,150,15837,21475;24857,41975,0,0,2,0,2
66753,150,15838,20709;21132;24616;24932,41975,0,0,4,0,4
66754,150,15839,21078;21152;24517;24728,41975,0,0,4,0,4
66755,150,15841,21192;21532;25731,41975,0,1,2,0,3
66756,150,15842,21365;21579;24648,41975,0,0,3,0,3
66757,150,15843,21224;21288,41975,0,0,2,0,2
66758,150,15844,21633,41975,0,0,1,0,1
66759,150,15845,21231;24845,41975,0,0,2,0,2
66760,150,15846,21664;21763;25541,41975,0,0,3,0,3
66761,150,15847,20797,41975,0,0,1,0,1
66762,150,15849,21023;21374,41975,0,0,2,0,2
66763,150,15850,21043;21306,41975,0,0,2,0,2
66764,150,15851,21316;21551;25526;25926,41975,0,1,3,0,4
66765,150,15852,21358;21719,41975,0,0,2,0,2
66766,150,15853,21435;21531,41975,0,0,2,0,2
66767,150,15854,21182;21369;25052;27225,41975,1,0,3,0,4
66768,150,15858,21109;21787;24872;27219,41975,1,0,3,0,4
66769,150,15859,21402;21494;25234,41975,0,0,3,0,3
66770,150,15860,21623;25159,41975,0,0,2,0,2
66771,150,15863,21589,41975,0,0,1,0,1
66772,150,15864,21302;21595,41975,0,0,2,0,2
66773,150,15866,17173,42340,0,0,0,1,1
66774,150,15870,17562,42340,0,0,0,1,1
66775,150,15876,18320,42340,0,0,0,1,1
66776,150,15881,18166,42340,0,0,0,1,1
66777,150,15885,18957;19468,42340,0,0,0,2,2
66778,150,15886,18714;18917,42340,0,0,0,2,2
66779,150,15887,19181;19555,42340,0,0,0,2,2
66780,150,15888,19549,42340,0,0,0,1,1
66781,150,15891,19427;19759,42340,0,0,0,2,2
66782,150,15892,19757,42340,0,0,0,1,1
66783,150,15895,19545;19735,42340,0,0,0,2,2
66784,150,15897,19971;20079,42340,0,0,0,2,2
66785,150,15898,20578,42340,0,0,1,0,1
66786,150,15899,20060;20271,42340,0,0,0,2,2
66787,150,15901,20076;20151,42340,0,0,0,2,2
66788,150,15905,20238,42340,0,0,0,1,1
66789,150,15907,20351;24576,42340,0,0,1,1,2
66790,150,15909,20586;20670,42340,0,0,2,0,2
66791,150,15911,20655;21093,42340,0,0,2,0,2
66792,150,15913,20954;21107,42340,0,0,2,0,2
66793,150,15915,20747;21003;24155,42340,0,0,3,0,3
66794,150,15918,20836;20900;24820,42340,0,0,3,0,3
66795,150,15919,20619;21199;25628,42340,0,1,2,0,3
66796,150,15921,20881;25130;25518,42340,0,0,3,0,3
66797,150,15922,20905;20914,42340,0,0,2,0,2
66798,150,15923,20953,42340,0,0,1,0,1
66799,150,15924,21675;24968,42340,0,0,2,0,2
66800,150,15925,21353;21481;24953,42340,0,0,3,0,3
66801,150,15928,21523;21978;24465;25751;27099,42340,1,1,3,0,5
66802,150,15929,21189;21292;25333,42340,0,0,3,0,3
66803,150,15930,21303,42340,0,0,1,0,1
66804,150,15931,21141;21301,42340,0,0,2,0,2
66805,150,15933,21387,42340,0,0,1,0,1
66806,150,15934,21602;21909,42340,0,0,2,0,2
66807,150,15935,21417;21828,42340,0,0,2,0,2
66808,150,15937,21431;22017;26242,42340,0,1,2,0,3
66809,150,15938,21434;21833,42340,0,0,2,0,2
66810,150,15939,21376;21436;24853;25346;26825,42340,0,1,4,0,5
66811,150,15940,21466;21561;24362;25431;26511;26714,42340,0,2,4,0,6
66812,150,15941,21176;21483;24954,42340,0,0,3,0,3
66813,150,15942,21354;21515;25633,42340,0,1,2,0,3
66814,150,15943,20962;21496,42340,0,0,2,0,2
66815,150,15945,21169;21562;25528,42340,0,0,3,0,3
66816,150,15946,21580,42340,0,0,1,0,1
66817,150,15947,21844;22050;25930,42340,0,1,2,0,3
66818,150,15949,21212;21587;24860,42340,0,0,3,0,3
66819,150,15950,21605;21913,42340,0,0,2,0,2
66820,150,15951,21612,42340,0,0,1,0,1
66821,150,15952,21614,42340,0,0,1,0,1
66822,150,15953,21616;21827,42340,0,0,2,0,2
66823,150,15954,21631;21840;25534,42340,0,0,3,0,3
66824,150,15955,21645;25243,42340,0,0,2,0,2
66825,150,15956,21995;22024;25372,42340,0,0,3,0,3
66826,150,15957,21615,42340,0,0,1,0,1
66827,150,15958,21062;21294;24372;25538;25828,42340,0,1,4,0,5
66828,150,15959,21703;21951,42340,0,0,2,0,2
66829,150,15960,21213;21704,42340,0,0,2,0,2
66830,150,15965,17705,42705,0,0,0,1,1
66831,150,15972,18280,42705,0,0,0,1,1
66832,150,15973,18409,42705,0,0,0,1,1
66833,150,15983,19347,42705,0,0,0,1,1
66834,150,15987,20387;20608;24695;27211,42705,1,0,2,1,4
66835,150,15989,20270,42705,0,0,0,1,1
66836,150,15992,20546;20702;24808,42705,0,0,2,1,3
66837,150,15995,20601;20957;25322,42705,0,0,3,0,3
66838,150,15997,20710;20764;25021,42705,0,0,3,0,3
66839,150,15998,21522;24073,42705,0,0,2,0,2
66840,150,15999,20504;20821;24416;26426,42705,0,1,2,1,4
66841,150,16001,20901;20987;24923;25058;27021,42705,1,0,4,0,5
66842,150,16002,20254;20494,42705,0,0,0,2,2
66843,150,16003,21222,42705,0,0,1,0,1
66844,150,16004,21261,42705,0,0,1,0,1
66845,150,16005,21191;25627;25727,42705,0,2,1,0,3
66846,150,16006,21210;21533;24647;25161,42705,0,0,4,0,4
66847,150,16007,20614;21263;24846;25728,42705,0,1,3,0,4
66848,150,16009,21712,42705,0,0,1,0,1
66849,150,16010,20796;21336,42705,0,0,2,0,2
66850,150,16012,20856;24064;27077,42705,1,0,2,0,3
66851,150,16013,21241;21363;24740,42705,0,0,3,0,3
66852,150,16014,21425;21468;24538;24856,42705,0,0,4,0,4
66853,150,16015,21105;21377,42705,0,0,2,0,2
66854,150,16016,21368;21670;24445;27201,42705,1,0,3,0,4
66855,150,16017,21538;21636;24765;25734;25826,42705,0,2,3,0,5
66856,150,16018,21429;21689;24969;25068,42705,0,0,4,0,4
66857,150,16019,21409;21461;25344;27231,42705,1,0,3,0,4
66858,150,16020,20858;21389;25229,42705,0,0,3,0,3
66859,150,16021,21382;21490,42705,0,0,2,0,2
66860,150,16022,21439;21858;25362;25833;26339,42705,0,2,3,0,5
66861,150,16023,21214;21503,42705,0,0,2,0,2
66862,150,16024,21618;21625,42705,0,0,2,0,2
66863,150,16025,21750;22138;25272;26517,42705,0,1,3,0,4
66864,150,16026,21527,42705,0,0,1,0,1
66865,150,16027,21912;25837,42705,0,1,1,0,2
66866,150,16028,21549;22131,42705,0,0,2,0,2
66867,150,16029,21558,42705,0,0,1,0,1
66868,150,16030,21469;21571,42705,0,0,2,0,2
66869,150,16031,21406;21895;25177;25550,42705,0,0,4,0,4
66870,150,16032,21728;25170;25830;27325,42705,1,1,2,0,4
66871,150,16033,21671,42705,0,0,1,0,1
66872,150,16034,21274;21455;25632,42705,0,1,2,0,3
66873,150,16035,22053;24889,42705,0,0,2,0,2
66874,150,16036,21715;22008;24378;27095,42705,1,0,3,0,4
66875,150,16037,21722,42705,0,0,1,0,1
66876,150,16038,21653;21866;24981;25257,42705,0,0,4,0,4
66877,150,16039,21773;22056;25357;25444,42705,0,0,4,0,4
66878,150,16040,21668;21777;24080;25072,42705,0,0,4,0,4
66879,150,16041,21235;21780;25639,42705,0,1,2,0,3
66880,150,16042,21458;21792;25251,42705,0,0,3,0,3
66881,150,16043,21525;22160;25658,42705,0,1,2,0,3
66882,150,16044,21781;21801,42705,0,0,2,0,2
66883,150,16045,21678;21893;25744,42705,0,1,2,0,3
66884,150,16049,17310,43070,0,0,0,1,1
66885,150,16052,17743,43070,0,0,0,1,1
66886,150,16062,18709,43070,0,0,0,1,1
66887,150,16064,19479,43070,0,0,0,1,1
66888,150,16074,19794;20033,43070,0,0,0,2,2
66889,150,16077,19418;20158,43070,0,0,0,2,2
66890,150,16078,19711;20119,43070,0,0,0,2,2
66891,150,16081,20468,43070,0,0,0,1,1
66892,150,16082,20518;21007;25033,43070,0,0,2,1,3
66893,150,16084,20729;21155,43070,0,0,2,0,2
66894,150,16085,20449;20738,43070,0,0,1,1,2
66895,150,16087,20703;20875;25027,43070,0,0,3,0,3
66896,150,16089,20903;21174,43070,0,0,2,0,2
66897,150,16090,20972;21135;24150;26800;27185,43070,1,1,3,0,5
66898,150,16091,21024,43070,0,0,1,0,1
66899,150,16092,21361;24444,43070,0,0,2,0,2
66900,150,16093,21518;24184;25825,43070,0,1,2,0,3
66901,150,16096,21480,43070,0,0,1,0,1
66902,150,16097,20867;21129;24249,43070,0,0,3,0,3
66903,150,16098,21544;21581;24756;26822,43070,0,1,3,0,4
66904,150,16099,21574;21816;25253,43070,0,0,3,0,3
66905,150,16100,23737,43070,0,0,1,0,1
66906,150,16101,20975;21178,43070,0,0,2,0,2
66907,150,16102,20980;21267,43070,0,0,2,0,2
66908,150,16104,21310,43070,0,0,1,0,1
66909,150,16105,21323;21333,43070,0,0,2,0,2
66910,150,16106,21144;21423,43070,0,0,2,0,2
66911,150,16107,21366;21526;24754;24960,43070,0,0,4,0,4
66912,150,16108,21403;21679;24742;27113,43070,1,0,3,0,4
66913,150,16109,21604;21904;24667;25746,43070,0,1,3,0,4
66914,150,16110,21116;21746;24659;25539,43070,0,0,4,0,4
66915,150,16111,21237;21437,43070,0,0,2,0,2
66916,150,16112,21117;21460;24951,43070,0,0,3,0,3
66917,150,16113,21448;22065;25183;25269;26938,43070,1,0,4,0,5
66918,150,16114,21947;22119;25839,43070,0,1,2,0,3
66919,150,16115,21510;21876;24983;25363;25934,43070,0,1,4,0,5
66920,150,16116,20834;21495,43070,0,0,2,0,2
66921,150,16117,21069;21536;25351,43070,0,0,3,0,3
66922,150,16118,21248;21734;24974;25171;25636;27020,43070,1,1,4,0,6
66923,150,16119,21603;21831,43070,0,0,2,0,2
66924,150,16120,21489;21619,43070,0,0,2,0,2
66925,150,16121,21624;24278,43070,0,0,2,0,2
66926,150,16124,21498;21795,43070,0,0,2,0,2
66927,150,16125,21652;21841;25076;27321,43070,1,0,3,0,4
66928,150,16126,21513;25925,43070,0,1,1,0,2
66929,150,16129,21694;21747;26338,43070,0,1,2,0,3
66930,150,16130,21476;21628,43070,0,0,2,0,2
66931,150,16131,21477;21744;25355,43070,0,0,3,0,3
66932,150,16132,21967;22010;25093;25842,43070,0,1,3,0,4
66933,150,16134,21802;22230,43070,0,0,2,0,2
66934,150,16135,22042;22081;25846;26243,43070,0,2,2,0,4
66935,150,16136,21637;21811;24663;24772,43070,0,0,4,0,4
66936,150,16137,21757;22153;24782;24895;25098;25186;27022;27318;27327,43070,3,0,6,0,9
66937,150,16138,21835;21861;25451;25641;25740,43070,0,2,3,0,5
66938,150,16139,21459;21836;24979;25448;25929,43070,0,1,4,0,5
66939,150,16140,21847;22003;25555;25937,43070,0,1,3,0,4
66940,150,16141,21736;21922;25259;25552;26039,43070,0,1,4,0,5
66941,150,16142,21682;21850,43070,0,0,2,0,2
66942,150,16143,21701;21743;24286;25070;25442;26919;27001,43070,2,0,5,0,7
66943,150,16144,21864;22210;25102;27023,43070,1,0,3,0,4
66944,150,16145,21731;21884;25454;25743,43070,0,1,3,0,4
66945,150,16146,21770;21896;25083;25366;25456;25745,43070,0,1,5,0,6
66946,150,16147,21552;21899;25457,43070,0,0,3,0,3
66947,150,16148,21920;22235;25106;25472;25761;25945,43070,0,2,4,0,6
66948,150,16149,22195;25851,43070,0,1,1,0,2
66949,150,16152,17571,43435,0,0,0,1,1
66950,150,16162,18446;18694,43435,0,0,0,2,2
66951,150,16169,18889;19408,43435,0,0,0,2,2
66952,150,16171,19380;23520;25910,43435,0,1,1,1,3
66953,150,16172,18940,43435,0,0,0,1,1
66954,150,16174,19603;20028,43435,0,0,0,2,2
66955,150,16176,19969;20318;22634,43435,0,0,1,2,3
66956,150,16179,19939;20137,43435,0,0,0,2,2
66957,150,16180,20136;20637,43435,0,0,1,1,2
66958,150,16185,20262;20406,43435,0,0,0,2,2
66959,150,16187,20493;20787,43435,0,0,1,1,2
66960,150,16188,21216,43435,0,0,1,0,1
66961,150,16189,20852;24504,43435,0,0,2,0,2
66962,150,16191,20419,43435,0,0,0,1,1
66963,150,16192,20761;21005;24257,43435,0,0,3,0,3
66964,150,16194,21033;21071;24724,43435,0,0,3,0,3
66965,150,16195,20928;21087,43435,0,0,2,0,2
66966,150,16196,21264;21657,43435,0,0,2,0,2
66967,150,16197,20832;21139,43435,0,0,2,0,2
66968,150,16198,21080;21173,43435,0,0,2,0,2
66969,150,16199,21251;21307,43435,0,0,2,0,2
66970,150,16200,20735;21356;24847;25150;25343,43435,0,0,5,0,5
66971,150,16201,20946;21658;24864;26035;27217,43435,1,1,3,0,5
66972,150,16202,21372;21441;24744;25347;25730,43435,0,1,4,0,5
66973,150,16203,21673;21873;25741,43435,0,1,2,0,3
66974,150,16205,22078;25095;25379;25940,43435,0,1,3,0,4
66975,150,16206,22194;22212;25383;25566;25660,43435,0,1,4,0,5
66976,150,16208,21296;21565,43435,0,0,2,0,2
66977,150,16209,21598,43435,0,0,1,0,1
66978,150,16210,21599,43435,0,0,1,0,1
66979,150,16211,21695;21868;24462;24982;26828,43435,0,1,4,0,5
66980,150,16212,21632;21748;24544;26609;27208,43435,1,1,3,0,5
66981,150,16214,21706;22241,43435,0,0,2,0,2
66982,150,16215,21681;21708;25069,43435,0,0,3,0,3
66983,150,16216,21677;21710;25735,43435,0,1,2,0,3
66984,150,16217,22208;22526;25384;25760,43435,0,1,3,0,4
66985,150,16218,21717;21751,43435,0,0,2,0,2
66986,150,16219,21359;22094;25380,43435,0,0,3,0,3
66987,150,16220,21754;21937,43435,0,0,2,0,2
66988,150,16221,21398;21755;25249,43435,0,0,3,0,3
66989,150,16222,21667;21760;25356;25443;25540,43435,0,0,5,0,5
66990,150,16223,21647;21872;25933,43435,0,1,2,0,3
66991,150,16224,21785;21806;24976,43435,0,0,3,0,3
66992,150,16225,21564;21786;25062,43435,0,0,3,0,3
66993,150,16226,21528;21820;25359;25446,43435,0,0,4,0,4
66994,150,16227,21700;21823,43435,0,0,2,0,2
66995,150,16228,21832;25256;25447;25544,43435,0,0,4,0,4
66996,150,16229,21834;21941;25553;25838,43435,0,1,3,0,4
66997,150,16230,21849;21881,43435,0,0,2,0,2
66998,150,16231,21520;21867;25547;25932;26145,43435,0,2,3,0,5
66999,150,16232,21762;21880;25453;25643;25742,43435,0,2,3,0,5
67000,150,16233,21601;21897,43435,0,0,2,0,2
67001,150,16234,21933;22152;25097;25382;25657,43435,0,1,4,0,5
67002,150,16235,21938;22309;25667,43435,0,1,2,0,3
67003,150,16237,21392;21953;25749,43435,0,1,2,0,3
67004,150,16238,21956;25647,43435,0,1,1,0,2
67005,150,16239,21960;22151;25656;26149,43435,0,2,2,0,4
67006,150,16240,21964;21992;25649;25750,43435,0,2,2,0,4
67007,150,16241,21968;22301,43435,0,0,2,0,2
67008,150,16242,22139;22350;25185;25655,43435,0,1,3,0,4
67009,150,16243,21926;21998,43435,0,0,2,0,2
67010,150,16244,22014;24672;25651,43435,0,1,2,0,3
67011,150,16245,22016;22214;24784;25944;26153;26246;27115,43435,1,3,3,0,7
67012,150,16246,22307;22517;25665,43435,0,1,2,0,3
67013,150,16247,21932;22031,43435,0,0,2,0,2
67014,150,16248,22037;22123;26147,43435,0,1,2,0,3
67015,150,16249,22013;22040;25844;25939,43435,0,2,2,0,4
67016,150,16251,17275,43800,0,0,0,1,1
67017,150,16254,17722,43800,0,0,0,1,1
67018,150,16256,17901;18184,43800,0,0,0,2,2
67019,150,16259,17933,43800,0,0,0,1,1
67020,150,16262,18188;18395,43800,0,0,0,2,2
67021,150,16263,18453;18511,43800,0,0,0,2,2
67022,150,16265,18596;18632,43800,0,0,0,2,2
67023,150,16267,18554;18810,43800,0,0,0,2,2
67024,150,16270,19115;19515,43800,0,0,0,2,2
67025,150,16271,18668;18811,43800,0,0,0,2,2
67026,150,16274,19575;20031,43800,0,0,0,2,2
67027,150,16277,19907,43800,0,0,0,1,1
67028,150,16280,20602,43800,0,0,1,0,1
67029,150,16284,20562;20648,43800,0,0,2,0,2
67030,150,16289,20519;20824,43800,0,0,1,1,2
67031,150,16290,20981;25031,43800,0,0,2,0,2
67032,150,16291,21265,43800,0,0,1,0,1
67033,150,16294,20908;21126,43800,0,0,2,0,2
67034,150,16296,21470;24747,43800,0,0,2,0,2
67035,150,16297,21635;24654;25535,43800,0,0,3,0,3
67036,150,16298,21239;21660;24547,43800,0,0,3,0,3
67037,150,16299,21158;21430;24641,43800,0,0,3,0,3
67038,150,16300,21299;21488;25048;25338,43800,0,0,4,0,4
67039,150,16301,21041;21349;25342,43800,0,0,3,0,3
67040,150,16303,21507;24958;25824,43800,0,1,2,0,3
67041,150,16304,21512;21765;25738;26037,43800,0,2,2,0,4
67042,150,16305,21257;21705;24970;25635,43800,0,1,3,0,4
67043,150,16306,21559;21702,43800,0,0,2,0,2
67044,150,16307,21644;21854;25546,43800,0,0,3,0,3
67045,150,16308,21588;24541;24763;25240;25353,43800,0,0,5,0,5
67046,150,16309,21594;21669,43800,0,0,2,0,2
67047,150,16311,21622,43800,0,0,1,0,1
67048,150,16312,21930;25085;25459,43800,0,0,3,0,3
67049,150,16313,21499;21597;24751,43800,0,0,3,0,3
67050,150,16314,21869;21963;25175;25258;25452;25548;25642,43800,0,1,6,0,7
67051,150,16316,21890;21939,43800,0,0,2,0,2
67052,150,16317,21690;22007,43800,0,0,2,0,2
67053,150,16318,21691;21957;25648,43800,0,1,2,0,3
67054,150,16319,21697,43800,0,0,1,0,1
67055,150,16320,21555;21799;25739,43800,0,1,2,0,3
67056,150,16321,21629;22062;25465;25755,43800,0,1,3,0,4
67057,150,16322,21560;25527,43800,0,0,2,0,2
67058,150,16323,21961;22227;25386,43800,0,0,3,0,3
67059,150,16325,21860;22364;25572;26347,43800,0,1,3,0,4
67060,150,16327,21842;22141;24781,43800,0,0,3,0,3
67061,150,16329,21910;22147;25273,43800,0,0,3,0,3
67062,150,16330,21965;22315,43800,0,0,2,0,2
67063,150,16331,21917;22286;25390,43800,0,0,3,0,3
67064,150,16332,21936;22148;25367,43800,0,0,3,0,3
67065,150,16333,21946;22282;25389;25571;25855,43800,0,1,4,0,5
67066,150,16335,21950,43800,0,0,1,0,1
67067,150,16336,22385;22474;25581,43800,0,0,3,0,3
67068,150,16337,21696;22267,43800,0,0,2,0,2
67069,150,16338,21576;22009;25264;25556,43800,0,0,4,0,4
67070,150,16340,22041;22133;25559,43800,0,0,3,0,3
67071,150,16342,22030;25266;26042,43800,0,1,2,0,3
67072,150,16344,22260;22421,43800,0,0,2,0,2
67073,150,16345,22085;22215,43800,0,0,2,0,2
67074,150,16346,22317;25194,43800,0,0,2,0,2
67075,150,16347,22136;22333;26346,43800,0,1,2,0,3
67076,150,16348,21803;22106;25270;25941,43800,0,1,3,0,4
67077,150,16349,21935;22190,43800,0,0,2,0,2
67078,150,16350,22145;22411;26052,43800,0,1,2,0,3
67079,150,16351,21758;22149;24990;25274;25469;25563,43800,0,0,6,0,6
67080,150,16352,22157;22216;24680,43800,0,0,3,0,3
67081,150,16354,17620,44165,0,0,0,1,1
67082,150,16361,18243;18426,44165,0,0,0,2,2
67083,150,16365,18721;18853,44165,0,0,0,2,2
67084,150,16367,19387,44165,0,0,0,1,1
67085,150,16368,18956;19190,44165,0,0,0,2,2
67086,150,16371,19201,44165,0,0,0,1,1
67087,150,16376,19334,44165,0,0,0,1,1
67088,150,16379,19017;19218,44165,0,0,0,2,2
67089,150,16381,20105,44165,0,0,0,1,1
67090,150,16390,20577;21215;23944;27067,44165,1,0,3,0,4
67091,150,16391,21686;25634,44165,0,1,1,0,2
67092,150,16393,20883;21150;25220;25331,44165,0,0,4,0,4
67093,150,16395,21019;21089;24838,44165,0,0,3,0,3
67094,150,16396,21095;21375,44165,0,0,2,0,2
67095,150,16397,20850;21059;25034,44165,0,0,3,0,3
67096,150,16398,21077;21546;24927,44165,0,0,3,0,3
67097,150,16399,20837,44165,0,0,1,0,1
67098,150,16400,21098;21424;24450,44165,0,0,3,0,3
67099,150,16401,21194;21572,44165,0,0,2,0,2
67100,150,16402,21207;22004;24986;25650;26041,44165,0,2,3,0,5
67101,150,16403,21229,44165,0,0,1,0,1
67102,150,16404,21179;21233;25626,44165,0,1,2,0,3
67103,150,16406,21029;21390,44165,0,0,2,0,2
67104,150,16407,21165;21350;25228,44165,0,0,3,0,3
67105,150,16408,21610;24369,44165,0,0,2,0,2
67106,150,16409,21775;21887;25445;26038,44165,0,1,3,0,4
67107,150,16410,21655;24546;26143,44165,0,1,2,0,3
67108,150,16411,21756;21959;25261,44165,0,0,3,0,3
67109,150,16412,21491;21569;25349,44165,0,0,3,0,3
67110,150,16413,21407;21639;25536,44165,0,0,3,0,3
67111,150,16414,21606;21875,44165,0,0,2,0,2
67112,150,16415,22311,44165,0,0,1,0,1
67113,150,16416,21718;21824;24664;25360,44165,0,0,4,0,4
67114,150,16418,22113;22196;24467,44165,0,0,3,0,3
67115,150,16419,22192;26044,44165,0,1,1,0,2
67116,150,16420,21894;24984;25455;25836,44165,0,1,3,0,4
67117,150,16421,21900;22367;25393;25573;26050,44165,0,1,4,0,5
67118,150,16422,21901;22302;25279;25949;26158,44165,0,2,3,0,5
67119,150,16423,21874;21977,44165,0,0,2,0,2
67120,150,16424,21282;21444;25057,44165,0,0,3,0,3
67121,150,16425,21987;22033;26040,44165,0,1,2,0,3
67122,150,16426,21996,44165,0,0,1,0,1
67123,150,16427,21656;22250,44165,0,0,2,0,2
67124,150,16428,21908;22029,44165,0,0,2,0,2
67125,150,16429,22549;25292,44165,0,0,2,0,2
67126,150,16430,21843;22049;25754,44165,0,1,2,0,3
67127,150,16431,22066;24466;25377;25756,44165,0,1,3,0,4
67128,150,16432,22368;25671;26348,44165,0,2,1,0,3
67129,150,16433,22032;22083;25374;25463;25938,44165,0,1,4,0,5
67130,150,16435,22096;22176,44165,0,0,2,0,2
67131,150,16436,22115;22298;25192;25858;26157,44165,0,2,3,0,5
67132,150,16437,22499;26622,44165,0,1,1,0,2
67133,150,16438,22180;22455;25401;26349;26728,44165,0,2,3,0,5
67134,150,16439,22102;22191,44165,0,0,2,0,2
67135,150,16440,22198;22555,44165,0,0,2,0,2
67136,150,16441,21906;22202,44165,0,0,2,0,2
67137,150,16442,21617;22206;26342,44165,0,1,2,0,3
67138,150,16443,22232;22395;25577;26519,44165,0,1,3,0,4
67139,150,16444,22238;22331,44165,0,0,2,0,2
67140,150,16446,17368,44530,0,0,0,1,1
67141,150,16448,18002,44530,0,0,0,1,1
67142,150,16451,18664,44530,0,0,0,1,1
67143,150,16457,19374;19414,44530,0,0,0,2,2
67144,150,16464,19840,44530,0,0,0,1,1
67145,150,16468,19959;19999,44530,0,0,0,2,2
67146,150,16469,19862;20367,44530,0,0,0,2,2
67147,150,16470,20418,44530,0,0,0,1,1
67148,150,16471,20244,44530,0,0,0,1,1
67149,150,16475,20521,44530,0,0,0,1,1
67150,150,16476,21026;21070,44530,0,0,2,0,2
67151,150,16477,20073;20184,44530,0,0,0,2,2
67152,150,16478,20734,44530,0,0,1,0,1
67153,150,16480,20877;20967;24426;27303,44530,1,0,3,0,4
67154,150,16481,20733;21331,44530,0,0,2,0,2
67155,150,16486,21083;21195;24726,44530,0,0,3,0,3
67156,150,16487,21328;21450;25524,44530,0,0,3,0,3
67157,150,16488,21817;22084;24891,44530,0,0,3,0,3
67158,150,16489,21539;21740,44530,0,0,2,0,2
67159,150,16490,21570;22508;25291,44530,0,0,3,0,3
67160,150,16491,21902;21980;25263;25461,44530,0,0,4,0,4
67161,150,16492,21726;25246,44530,0,0,2,0,2
67162,150,16493,21590;21776;25064,44530,0,0,3,0,3
67163,150,16494,21659;22134;26148,44530,0,1,2,0,3
67164,150,16495,21462;21665;25537,44530,0,0,3,0,3
67165,150,16497,21714;21782,44530,0,0,2,0,2
67166,150,16498,21343;21797,44530,0,0,2,0,2
67167,150,16499,22060;25375;25845;26618;27331,44530,1,2,2,0,5
67168,150,16501,21994;22296;25191;25857;25948;26172,44530,0,3,3,0,6
67169,150,16502,21883;24558;25644;26239;27311,44530,1,2,2,0,5
67170,150,16503,21871;22137;25467;25562,44530,0,0,4,0,4
67171,150,16504,21484;21886,44530,0,0,2,0,2
67172,150,16505,21911;22012,44530,0,0,2,0,2
67173,150,16506,22006;24671;26430;27107,44530,1,1,2,0,4
67174,150,16507,21931;21981;25368;25936,44530,0,1,3,0,4
67175,150,16508,21892;21986,44530,0,0,2,0,2
67176,150,16510,22128;22171;25757;25942;26150,44530,0,3,2,0,5
67177,150,16511,21752;21889;24870,44530,0,0,3,0,3
67178,150,16512,22090;22558;24903;26351;26439;26834,44530,1,2,3,0,6
67179,150,16514,22164;22489;25864;25961,44530,0,2,2,0,4
67180,150,16515,21934;22104;25847,44530,0,1,2,0,3
67181,150,16516,22614;22699;26445,44530,0,1,2,0,3
67182,150,16517,22156;22178;25659;25850;26244,44530,0,3,2,0,5
67183,150,16518,22264;22632,44530,0,0,2,0,2
67184,150,16519,21674;22034;25267;25464,44530,0,0,4,0,4
67185,150,16520,22170;22505;25865;26057,44530,0,2,2,0,4
67186,150,16521,22181;22347;26151,44530,0,1,2,0,3
67187,150,16522,22242;22330;25391;26049;26159,44530,0,2,3,0,5
67188,150,16523,22412;22470;25287,44530,0,0,3,0,3
67189,150,16524,22292;22485;26344,44530,0,1,2,0,3
67190,150,16525,22023;22297,44530,0,0,2,0,2
67191,150,16526,21975;22304;26048;26345;26518,44530,0,3,2,0,5
67192,150,16527,21943;22528;25489;25774,44530,0,1,3,0,4
67193,150,16528,22378;22696;25593;25783;25977;26170;26269,44530,0,4,3,0,7
67194,150,16529,22355,44530,0,0,1,0,1
67195,150,16530,22168;22356;25565,44530,0,0,3,0,3
67196,150,16531,22365;22671;26836,44530,1,0,2,0,3
67197,150,16536,18696,44895,0,0,0,1,1
67198,150,16537,18774,44895,0,0,0,1,1
67199,150,16542,19161;19522,44895,0,0,0,2,2
67200,150,16543,19182,44895,0,0,0,1,1
67201,150,16553,20417;20573,44895,0,0,1,1,2
67202,150,16555,20330;20496,44895,0,0,0,2,2
67203,150,16556,20336;20609,44895,0,0,1,1,2
67204,150,16558,20486;21122;25039,44895,0,0,2,1,3
67205,150,16563,21380,44895,0,0,1,0,1
67206,150,16565,20894;21091;25139,44895,0,0,3,0,3
67207,150,16567,21148;21442,44895,0,0,2,0,2
67208,150,16570,21079;21330;25148,44895,0,0,3,0,3
67209,150,16571,21378;25427,44895,0,0,2,0,2
67210,150,16572,21396;21764,44895,0,0,2,0,2
67211,150,16573,21807;21838,44895,0,0,2,0,2
67212,150,16576,21661,44895,0,0,1,0,1
67213,150,16577,21388;25428,44895,0,0,2,0,2
67214,150,16579,22011;25557,44895,0,0,2,0,2
67215,150,16580,21919;25458,44895,0,0,2,0,2
67216,150,16581,21578;21634;25437;25529,44895,0,0,4,0,4
67217,150,16582,21542;21882;25079;25835;26937,44895,1,1,3,0,5
67218,150,16585,21453;21779,44895,0,0,2,0,2
67219,150,16586,21493;21688;24866,44895,0,0,3,0,3
67220,150,16588,22187;22254;25943,44895,0,1,2,0,3
67221,150,16589,21783;22035;25558,44895,0,0,3,0,3
67222,150,16590,22259;22303;25108;25664,44895,0,1,3,0,4
67223,150,16591,21851;22127;25931,44895,0,1,2,0,3
67224,150,16592,21852;22327;24570;25764,44895,0,1,3,0,4
67225,150,16593,21650;21997;25179;25462,44895,0,0,4,0,4
67226,150,16595,21916;22165;25747,44895,0,1,2,0,3
67227,150,16596,21877,44895,0,0,1,0,1
67228,150,16597,22293;22295,44895,0,0,2,0,2
67229,150,16598,22222;22336,44895,0,0,2,0,2
67230,150,16599,22068;22251;25676;26054;26434,44895,0,3,2,0,5
67231,150,16600,21649;22075;25466;25654,44895,0,1,3,0,4
67232,150,16601,21800;22077;26431,44895,0,1,2,0,3
67233,150,16603,21859;22322;24791;25479;27235,44895,1,0,4,0,5
67234,150,16604,22101;22757;24912;25501,44895,0,0,4,0,4
67235,150,16605,22109;22273,44895,0,0,2,0,2
67236,150,16606,21759;25737;26036,44895,0,2,1,0,3
67237,150,16607,22291;22693;26838,44895,1,0,2,0,3
67238,150,16608,22162;22564;26063,44895,0,1,2,0,3
67239,150,16609,22740,44895,0,0,1,0,1
67240,150,16611,21863;22243;25473;25568,44895,0,0,4,0,4
67241,150,16612,22316;22496;25772;25962;26255;26729,44895,0,4,2,0,6
67242,150,16613,22051;22262;25762,44895,0,1,2,0,3
67243,150,16614,22314;22335;25669;26831,44895,1,1,2,0,4
67244,150,16615,22224;22257;25385,44895,0,0,3,0,3
67245,150,16616,22379;24996;25672,44895,0,1,2,0,3
67246,150,16617,22394;22466,44895,0,0,2,0,2
67247,150,16618,22018;22396;25483,44895,0,0,3,0,3
67248,150,16619,22288;22401;25675;26163,44895,0,2,2,0,4
67249,150,16620,22404;25285;26252;27127,44895,1,1,2,0,4
67250,150,16621,22756;26270,44895,0,1,1,0,2
67251,150,16622,22442;22695,44895,0,0,2,0,2
67252,150,16623,22446;22859,44895,0,0,2,0,2
67253,150,16624,22346;22461;25765,44895,0,1,2,0,3
67254,150,16625,22484;22741;25959,44895,0,1,2,0,3
67255,150,16626,22582;22747;25596,44895,0,0,3,0,3
67256,150,16632,17886;18611,45260,0,0,0,2,2
67257,150,16634,18781;19154,45260,0,0,0,2,2
67258,150,16637,18951,45260,0,0,0,1,1
67259,150,16639,19118,45260,0,0,0,1,1
67260,150,16640,19168,45260,0,0,0,1,1
67261,150,16642,19278,45260,0,0,0,1,1
67262,150,16643,18880;19007,45260,0,0,0,2,2
67263,150,16646,19622;19901,45260,0,0,0,2,2
67264,150,16647,19957;19995,45260,0,0,0,2,2
67265,150,16653,20020;20034,45260,0,0,0,2,2
67266,150,16654,20206;20371;24482;26927;27008;27100,45260,3,0,1,2,6
67267,150,16663,20558;20904,45260,0,0,2,0,2
67268,150,16664,21035;21219,45260,0,0,2,0,2
67269,150,16665,21094;21379,45260,0,0,2,0,2
67270,150,16666,21183;21530;25435,45260,0,0,3,0,3
67271,150,16668,21609;25530,45260,0,0,2,0,2
67272,150,16669,21414;21641;24966;27221,45260,1,0,3,0,4
67273,150,16670,21643;22359;25480;25670;26250,45260,0,2,3,0,5
67274,150,16672,21108,45260,0,0,1,0,1
67275,150,16673,21537;21654;24766;25164;27017,45260,1,0,4,0,5
67276,150,16674,21709;21815;25167;25440;25829,45260,0,1,4,0,5
67277,150,16675,21102;21723;24868;25928;27018,45260,1,1,3,0,5
67278,150,16676,21646;21769,45260,0,0,2,0,2
67279,150,16677,21735;22020;25843;26340,45260,0,2,2,0,4
67280,150,16678,21737;21878;25834,45260,0,1,2,0,3
67281,150,16679,22203;25759,45260,0,1,1,0,2
67282,150,16680,21504;22261;25947,45260,0,1,2,0,3
67283,150,16681,21517;21905,45260,0,0,2,0,2
67284,150,16682,21630;21684;25438;25533,45260,0,0,4,0,4
67285,150,16683,21971;25935,45260,0,1,1,0,2
67286,150,16684,22080;22207;26045,45260,0,1,2,0,3
67287,150,16685,21888;22043;25268;27229,45260,1,0,3,0,4
67288,150,16686,22063;22158;25848,45260,0,1,2,0,3
67289,150,16687,22097;22285;25476;25663;25856,45260,0,2,3,0,5
67290,150,16688,22270,45260,0,0,1,0,1
67291,150,16689,22125;22221;25853;26046;26343,45260,0,3,2,0,5
67292,150,16690,22651;25116;25973;26066,45260,0,2,2,0,4
67293,150,16691,22536;22807;25967,45260,0,1,2,0,3
67294,150,16692,22252;22349,45260,0,0,2,0,2
67295,150,16693,22038;22400;26251,45260,0,1,2,0,3
67296,150,16694,22320;22915;26735;27132,45260,1,1,2,0,4
67297,150,16695,22326;22417;25195;26249;26832,45260,1,1,3,0,5
67298,150,16696,22387;22398,45260,0,0,2,0,2
67299,150,16697,22686;22793;25598;26177;26364,45260,0,2,3,0,5
67300,150,16698,21839;22437;25399,45260,0,0,3,0,3
67301,150,16699,22710;22885;26370,45260,0,1,2,0,3
67302,150,16700,22098;22478,45260,0,0,2,0,2
67303,150,16701,22492;22796;26077,45260,0,1,2,0,3
67304,150,16702,22493,45260,0,0,1,0,1
67305,150,16703,22501;22619;26168,45260,0,1,2,0,3
67306,150,16704,22780;22814;26630,45260,0,1,2,0,3
67307,150,16705,22169;22529;25679,45260,0,1,2,0,3
67308,150,16706,22535;25587;25680;25775;25966,45260,0,3,2,0,5
67309,150,16707,22553;22596;25588;25968,45260,0,1,3,0,4
67310,150,16708,22507;22556;26438,45260,0,1,2,0,3
67311,150,16709,22560;22645;24802;25872;25972,45260,0,2,3,0,5
67312,150,16710,22269;22577;25868;26064,45260,0,2,2,0,4
67313,150,16711,22059;25592;26835,45260,1,0,2,0,3
67314,150,16712,22338;22623;25951;26619,45260,0,2,2,0,4
67315,150,16713,22275;22626;25871;26357,45260,0,2,2,0,4
67316,150,16718,18086,45625,0,0,0,1,1
67317,150,16720,18530;18591,45625,0,0,0,2,2
67318,150,16721,18404,45625,0,0,0,1,1
67319,150,16724,19049,45625,0,0,0,1,1
67320,150,16725,18939;18960,45625,0,0,0,2,2
67321,150,16726,19087,45625,0,0,0,1,1
67322,150,16727,18755,45625,0,0,0,1,1
67323,150,16729,19244;19280,45625,0,0,0,2,2
67324,150,16732,19561;19779,45625,0,0,0,2,2
67325,150,16736,19565,45625,0,0,0,1,1
67326,150,16737,20065;20299,45625,0,0,0,2,2
67327,150,16746,21034;21063;25217,45625,0,0,3,0,3
67328,150,16748,21170;21519;25160,45625,0,0,3,0,3
67329,150,16750,21399;21451;24950,45625,0,0,3,0,3
67330,150,16751,21325;21790;25173;25358;27326,45625,1,0,4,0,5
67331,150,16752,21352;24635,45625,0,0,2,0,2
67332,150,16754,21745;21942;25087,45625,0,0,3,0,3
67333,150,16755,21949;22015,45625,0,0,2,0,2
67334,150,16756,21788;24771;26144,45625,0,1,2,0,3
67335,150,16759,21638;22026,45625,0,0,2,0,2
67336,150,16761,21419;21774,45625,0,0,2,0,2
67337,150,16762,21945;22768;25119,45625,0,0,3,0,3
67338,150,16764,21958;21970;24561;25554,45625,0,0,4,0,4
67339,150,16765,21721;22093;25561,45625,0,0,3,0,3
67340,150,16766,21993;22362;25953,45625,0,1,2,0,3
67341,150,16767,22039;22245;26247,45625,0,1,2,0,3
67342,150,16768,22048;22476;25402;26621,45625,0,1,3,0,4
67343,150,16769,21648;22073;25184;25378,45625,0,0,4,0,4
67344,150,16770,22124;22561;26623,45625,0,1,2,0,3
67345,150,16772,22122;22281;25278;25662;26248;26435,45625,0,3,3,0,6
67346,150,16773,22481;22890;26841,45625,1,0,2,0,3
67347,150,16774,22126;22638,45625,0,0,2,0,2
67348,150,16775,22276;25475;25570;26154,45625,0,1,3,0,4
67349,150,16776,22146;22462,45625,0,0,2,0,2
67350,150,16777,22237;22403;26164,45625,0,1,2,0,3
67351,150,16778,22422;22681;25684;25876,45625,0,2,2,0,4
67352,150,16779,22154;22808;25789,45625,0,1,2,0,3
67353,150,16780,22817;26365,45625,0,1,1,0,2
67354,150,16781,22504;22622;24800;25290;25585;26256,45625,0,1,5,0,6
67355,150,16782,22435;22540;25866,45625,0,1,2,0,3
67356,150,16783,22418;22545;26059;26437,45625,0,2,2,0,4
67357,150,16784,22374;25574;25767,45625,0,1,2,0,3
67358,150,16785,22456;22584,45625,0,0,2,0,2
67359,150,16786,23052;26946;27135,45625,2,0,1,0,3
67360,150,16787,22428;23098,45625,0,0,2,0,2
67361,150,16788,22939;25308;25414;25698;26281,45625,0,2,3,0,5
67362,150,16789,22673;22851;26368,45625,0,1,2,0,3
67363,150,16790,22679;22961,45625,0,0,2,0,2
67364,150,16791,22839;22862;25599;25691;25883;26273;26529,45625,0,4,3,0,7
67365,150,16792,22612;22685;25494;26522,45625,0,1,3,0,4
67366,150,16793,22218,45625,0,0,1,0,1
67367,150,16794,22586;22812;24687;26527;26943,45625,1,1,3,0,5
67368,150,16795,22708;26629,45625,0,1,1,0,2
67369,150,16796,22701;22714;25979,45625,0,1,2,0,3
67370,150,16797,22725;22944;27028,45625,1,0,2,0,3
67371,150,16798,22409;22742;25498;25878;26174,45625,0,2,3,0,5
67372,150,16799,22572;22745;25293,45625,0,0,3,0,3
67373,150,16800,22658;22822;25986;26078;26730,45625,0,3,2,0,5
67374,150,16801,22328;22770;25690;25981;26175,45625,0,3,2,0,5
67375,150,16806,18659,45990,0,0,0,1,1
67376,150,16807,18219,45990,0,0,0,1,1
67377,150,16810,18692;19287,45990,0,0,0,2,2
67378,150,16812,18936,45990,0,0,0,1,1
67379,150,16815,18335,45990,0,0,0,1,1
67380,150,16817,19109,45990,0,0,0,1,1
67381,150,16820,19688;20019,45990,0,0,0,2,2
67382,150,16822,19831,45990,0,0,0,1,1
67383,150,16832,20346;20534,45990,0,0,0,2,2
67384,150,16834,20284;20633,45990,0,0,1,1,2
67385,150,16836,20500;20902;24333;25133;26710;27197,45990,1,1,3,1,6
67386,150,16837,20741;21032,45990,0,0,2,0,2
67387,150,16839,20750;21044,45990,0,0,2,0,2
67388,150,16840,20929,45990,0,0,1,0,1
67389,150,16841,21134;21713,45990,0,0,2,0,2
67390,150,16842,21338;21360;24940,45990,0,0,3,0,3
67391,150,16843,21500;21707;25059,45990,0,0,3,0,3
67392,150,16844,21575;21891,45990,0,0,2,0,2
67393,150,16845,21596;22166;25564,45990,0,0,3,0,3
67394,150,16847,22069;22345;24380,45990,0,0,3,0,3
67395,150,16848,21720;22054;24779;25653,45990,0,1,3,0,4
67396,150,16849,21733;22150;25381,45990,0,0,3,0,3
67397,150,16851,21524;21846;25361;25450;25640,45990,0,1,4,0,5
67398,150,16852,21813;22217;25104;25471,45990,0,0,4,0,4
67399,150,16853,21837;24665;25449;25545;25832,45990,0,1,4,0,5
67400,150,16854,22231,45990,0,0,1,0,1
67401,150,16856,21794;21976;25460;25840,45990,0,1,3,0,4
67402,150,16857,22246;26047;26433,45990,0,2,1,0,3
67403,150,16859,21809;22240,45990,0,0,2,0,2
67404,150,16860,22277;22278;25854,45990,0,1,2,0,3
67405,150,16861,22351;22370,45990,0,0,2,0,2
67406,150,16862,22372;22734;25497;25688;26360,45990,0,2,3,0,5
67407,150,16863,22413;22743,45990,0,0,2,0,2
67408,150,16864,22784;23097;25006;26363;26942,45990,1,1,3,0,5
67409,150,16865,22197;22450;25000;25677,45990,0,1,3,0,4
67410,150,16866,22688;22917,45990,0,0,2,0,2
67411,150,16867,22465;22617;25491,45990,0,0,3,0,3
67412,150,16868,22761;22936;25794;26087;26635,45990,0,3,2,0,5
67413,150,16869,22538;22726;25204;25301,45990,0,0,4,0,4
67414,150,16870,22597;22659;25408,45990,0,0,3,0,3
67415,150,16871,22471;22557;25969;26061,45990,0,2,2,0,4
67416,150,16872,22661;22715;25686;26446,45990,0,2,2,0,4
67417,150,16873,22656;22771;25875,45990,0,1,2,0,3
67418,150,16874,22255;22676;25782;26443;26837,45990,1,2,2,0,5
67419,150,16875,22683;22754;25975,45990,0,1,2,0,3
67420,150,16876,22694;26523;26628,45990,0,2,1,0,3
67421,150,16878,22095;23014;26373,45990,0,1,2,0,3
67422,150,16879,22809;22941;25699,45990,0,1,2,0,3
67423,150,16881,22863;22884,45990,0,0,2,0,2
67424,150,16882,18365,46355,0,0,0,1,1
67425,150,16883,18730,46355,0,0,0,1,1
67426,150,16886,19001,46355,0,0,0,1,1
67427,150,16891,19232;19701,46355,0,0,0,2,2
67428,150,16900,20296,46355,0,0,0,1,1
67429,150,16902,19906,46355,0,0,0,1,1
67430,150,16913,20891;24332,46355,0,0,2,0,2
67431,150,16916,21322;21438;24949;25729,46355,0,1,3,0,4
67432,150,16921,21391,46355,0,0,1,0,1
67433,150,16922,21699;21739;24373,46355,0,0,3,0,3
67434,150,16924,21293;21642,46355,0,0,2,0,2
67435,150,16925,21729;25736,46355,0,1,1,0,2
67436,150,16928,21845;22185;26043,46355,0,1,2,0,3
67437,150,16929,21848;22229,46355,0,0,2,0,2
67438,150,16930,21929;22058;25748;26240,46355,0,2,2,0,4
67439,150,16932,22173;25758;25849,46355,0,2,1,0,3
67440,150,16934,22449;25861,46355,0,1,1,0,2
67441,150,16936,22200;22249;25661;25946,46355,0,2,2,0,4
67442,150,16937,22306;22820,46355,0,0,2,0,2
67443,150,16938,22313;23166;26199,46355,0,1,2,0,3
67444,150,16939,22340;22578;25112;25405;25777;25869;26440,46355,0,3,4,0,7
67445,150,16940,22342;22598;26260,46355,0,1,2,0,3
67446,150,16941,22479;22866;25694;26080,46355,0,2,2,0,4
67447,150,16942,22677,46355,0,0,1,0,1
67448,150,16943,22118;22371;25766;26161,46355,0,2,2,0,4
67449,150,16944,22376;22785;26176,46355,0,1,2,0,3
67450,150,16945,22384;22670,46355,0,0,2,0,2
67451,150,16946,22415;22948;24805,46355,0,0,3,0,3
67452,150,16947,22072,46355,0,0,1,0,1
67453,150,16948,22163;22563;25867;26352,46355,0,2,2,0,4
67454,150,16949,21966;22451;25862,46355,0,1,2,0,3
67455,150,16950,22525;22792;26076,46355,0,1,2,0,3
67456,150,16951,22475;25582;25771,46355,0,1,2,0,3
67457,150,16952,22290;22487;25485;25584;26056;26350,46355,0,2,4,0,6
67458,150,16953,22500;22687;25976;26068;26268,46355,0,3,2,0,5
67459,150,16954,22629;22731;25595;25687,46355,0,1,3,0,4
67460,150,16955,22312;22594;25668,46355,0,1,2,0,3
67461,150,16956,22225;22602;25294;25406;25591;25970;26940,46355,1,1,5,0,7
67462,150,16957,22294;22864,46355,0,0,2,0,2
67463,150,16958,22624;23219;25608;26292;26379;26468;26551;26854,46355,1,4,3,0,8
67464,150,16959,22637;22777,46355,0,0,2,0,2
67465,150,16960,22607;22667;25409,46355,0,0,3,0,3
67466,150,16961,22647;22698,46355,0,0,2,0,2
67467,150,16962,22700;23008;25798,46355,0,1,2,0,3
67468,150,16963,22940;22965;25505;25886;25994;26090,46355,0,3,3,0,6
67469,150,16964,22174;22750;25499;25980;26447,46355,0,2,3,0,5
67470,150,16965,22569;22762;25689;25788;26073;27025,46355,1,3,2,0,6
67471,150,16966,22497;22775;25411,46355,0,0,3,0,3
67472,150,16967,22835;23205;26103,46355,0,1,2,0,3
67473,150,16969,22850;22989;26367;26632,46355,0,2,2,0,4
67474,150,16971,22886;23250;25609;26471,46355,0,1,3,0,4
67475,150,16972,22763;22895,46355,0,0,2,0,2
67476,150,16973,22916;23178;26644,46355,0,1,2,0,3
67477,150,16974,22530;22937;25111,46355,0,0,3,0,3
67478,150,16975,23080;23206;25606;26646,46355,0,1,3,0,4
67479,150,16976,22969;23109;25900,46355,0,1,2,0,3
67480,150,16977,22975;22987;26945,46355,1,0,2,0,3
67481,150,16978,22990;25997,46355,0,1,1,0,2
67482,150,16979,23241;23248;26381;26648,46355,0,2,2,0,4
67483,150,16981,18949,46720,0,0,0,1,1
67484,150,16982,18768,46720,0,0,0,1,1
67485,150,16991,19683;19760,46720,0,0,0,2,2
67486,150,16992,19912,46720,0,0,0,1,1
67487,150,16993,19966;20211,46720,0,0,0,2,2
67488,150,16995,20095,46720,0,0,0,1,1
67489,150,16998,20197;20379,46720,0,0,0,2,2
67490,150,17001,20325,46720,0,0,0,1,1
67491,150,17003,20429;20580,46720,0,0,1,1,2
67492,150,17007,20774;21017,46720,0,0,2,0,2
67493,150,17008,20444,46720,0,0,0,1,1
67494,150,17011,21127;21509,46720,0,0,2,0,2
67495,150,17012,21351;21738;25248;25637,46720,0,1,3,0,4
67496,150,17014,21413;22044,46720,0,0,2,0,2
67497,150,17018,21907;22142;25468,46720,0,0,3,0,3
67498,150,17020,21979;22213;25103,46720,0,0,3,0,3
67499,150,17021,22005;22454;25580;25957,46720,0,1,3,0,4
67500,150,17022,22674;26266,46720,0,1,1,0,2
67501,150,17023,21923;22205;24897;26152,46720,0,1,3,0,4
67502,150,17024,22565;22652,46720,0,0,2,0,2
67503,150,17026,22143;22265;24681;25388;25763,46720,0,1,4,0,5
67504,150,17027,22209;22279;24900,46720,0,0,3,0,3
67505,150,17028,22283;22752;25500,46720,0,0,3,0,3
67506,150,17029,22219;22325;25188;25567,46720,0,0,4,0,4
67507,150,17030,22360;22825;25882;26179,46720,0,2,2,0,4
67508,150,17031,22236;22381;25197;25575,46720,0,0,4,0,4
67509,150,17032,22383;22871;25602;26276;26633,46720,0,2,3,0,5
67510,150,17033,22399;25674,46720,0,1,1,0,2
67511,150,17034,22407;25286;25578,46720,0,0,3,0,3
67512,150,17035,22429;25860;26053,46720,0,2,1,0,3
67513,150,17036,22457;22503;25486;25963,46720,0,1,3,0,4
67514,150,17038,22433;22521,46720,0,0,2,0,2
67515,150,17039,22344;22551;26060,46720,0,1,2,0,3
67516,150,17040,22606;22690;26624,46720,0,1,2,0,3
67517,150,17041,22799;23146;26196;26545,46720,0,2,2,0,4
67518,150,17042,22712;22956;25796;25993,46720,0,2,2,0,4
67519,150,17043,23279;23369;26856,46720,1,0,2,0,3
67520,150,17044,22519;22767;25597;26074,46720,0,1,3,0,4
67521,150,17045,22728;22786;27024,46720,1,0,2,0,3
67522,150,17046,22790;23101;25801,46720,0,1,2,0,3
67523,150,17047,22459;23062;26460;26540,46720,0,2,2,0,4
67524,150,17048,22669;22840;25412;25600,46720,0,0,4,0,4
67525,150,17049,22918;25990;26084;26634,46720,0,3,1,0,4
67526,150,17050,22912;23380;25317,46720,0,0,3,0,3
67527,150,17051,22833;22919;25603;26085;26457;27133,46720,1,2,3,0,6
67528,150,17052,23045;25800,46720,0,1,1,0,2
67529,150,17053,22801;25880;26526;26631,46720,0,3,1,0,4
67530,150,17054,22945;23094;25795;25991,46720,0,2,2,0,4
67531,150,17055,22951;26089;26282;27134,46720,1,2,1,0,4
67532,150,17056,22976;23038;26374;26539;26742,46720,0,3,2,0,5
67533,150,17057,23016;23243;26105;26469,46720,0,2,2,0,4
67534,150,17059,23022;23049;26459;26538;27029,46720,1,2,2,0,5
67535,150,17060,23023;23230;25315,46720,0,0,3,0,3
67536,150,17061,23036;25124;25311,46720,0,0,3,0,3
67537,150,17062,23026;23043;25892,46720,0,1,2,0,3
67538,150,17063,23194,46720,0,0,1,0,1
67539,150,17064,23216;23267;25809;26204,46720,0,2,2,0,4
67540,150,17065,23024;23067,46720,0,0,2,0,2
67541,150,17066,23074;23239;27031,46720,1,0,2,0,3
67542,150,17067,23027;23102;25604;25705;26193;26376;26641,46720,0,4,3,0,7
67543,150,17068,18527,47085,0,0,0,1,1
67544,150,17069,18653,47085,0,0,0,1,1
67545,150,17070,18766,47085,0,0,0,1,1
67546,150,17072,19020,47085,0,0,0,1,1
67547,150,17076,19656,47085,0,0,0,1,1
67548,150,17077,19242,47085,0,0,0,1,1
67549,150,17082,19208;19216,47085,0,0,0,2,2
67550,150,17086,20328,47085,0,0,0,1,1
67551,150,17087,20528,47085,0,0,0,1,1
67552,150,17094,20676,47085,0,0,1,0,1
67553,150,17098,20767;20830,47085,0,0,2,0,2
67554,150,17099,20514,47085,0,0,0,1,1
67555,150,17100,20343;20706,47085,0,0,1,1,2
67556,150,17101,21258;21497;24956;25350;26827,47085,0,1,4,0,5
67557,150,17105,21175;21317;25226,47085,0,0,3,0,3
67558,150,17109,21676;21928,47085,0,0,2,0,2
67559,150,17110,21753;22061,47085,0,0,2,0,2
67560,150,17112,22271;22480;25474,47085,0,0,3,0,3
67561,150,17114,22448;22760;24913;25304,47085,0,0,4,0,4
67562,150,17116,22155;22445,47085,0,0,2,0,2
67563,150,17117,22172;22566;25200,47085,0,0,3,0,3
67564,150,17119,22869;25413;26081,47085,0,1,2,0,3
67565,150,17120,22730;22837;25987;26731,47085,0,2,2,0,4
67566,150,17121,22778;22873;26082;27236,47085,1,1,2,0,4
67567,150,17124,22460,47085,0,0,1,0,1
67568,150,17125,22509;25773,47085,0,1,1,0,2
67569,150,17127,22092;22486;25583;25863;25960,47085,0,2,3,0,5
67570,150,17128,22117;22516;25487,47085,0,0,3,0,3
67571,150,17129,22813;23063;26190,47085,0,1,2,0,3
67572,150,17130,22576;22654,47085,0,0,2,0,2
67573,150,17132,22321;22608;26262,47085,0,1,2,0,3
67574,150,17133,22640;22853;26453;26533;26840;27130,47085,2,2,2,0,6
67575,150,17135,22702;25784;25877,47085,0,2,1,0,3
67576,150,17136,22244;22711;25786;25978,47085,0,2,2,0,4
67577,150,17137,22182;22352;25392;25952;26160,47085,0,2,3,0,5
67578,150,17138,22841;26180;26274;26530;26944;27027,47085,2,3,1,0,6
67579,150,17139,22630;22717;25778;26263,47085,0,2,2,0,4
67580,150,17140,22811;23030;24916;25700;27124,47085,1,1,3,0,5
67581,150,17141,22375;22828;26451,47085,0,1,2,0,3
67582,150,17142,22920;25697,47085,0,1,1,0,2
67583,150,17143,22845;23069;26191;26284;26541;26947,47085,1,3,2,0,6
67584,150,17144,22854;23363;26384,47085,0,1,2,0,3
67585,150,17145,23300;23379;26107;26207;26382;26753;26859;27139,47085,2,4,2,0,8
67586,150,17146,23187;23301;26653,47085,0,1,2,0,3
67587,150,17147,22672;22929;25504,47085,0,0,3,0,3
67588,150,17148,22848;23108;25802;26544,47085,0,2,2,0,4
67589,150,17149,22836;22960,47085,0,0,2,0,2
67590,150,17150,23269;27240,47085,1,0,1,0,2
67591,150,17151,23368;23393;26015;26306,47085,0,2,2,0,4
67592,150,17152,22727;23010;25799;26537;26739,47085,0,3,2,0,5
67593,150,17153,22995;23053;26846,47085,1,0,2,0,3
67594,150,17154,22547;23071;26375;26462,47085,0,2,2,0,4
67595,150,17155,23073;23476;26018;26390;26865,47085,1,2,2,0,5
67596,150,17157,22971,47085,0,0,1,0,1
67597,150,17158,23144;23470;25617;26315;26481,47085,0,2,3,0,5
67598,150,17159,23087;23161;25805;26547;26849,47085,1,2,2,0,5
67599,150,17160,22860;23168;26005;26377,47085,0,2,2,0,4
67600,150,17161,23007;23177;26099;26287;26378,47085,0,3,2,0,5
67601,150,17163,23133;23183;25508;26642,47085,0,1,3,0,4
67602,150,17164,23218;23299;25610;26010;26206;26652;26752;26950,47085,1,4,3,0,8
67603,150,17166,18737,47450,0,0,0,1,1
67604,150,17168,19489,47450,0,0,0,1,1
67605,150,17173,19446,47450,0,0,0,1,1
67606,150,17174,18972,47450,0,0,0,1,1
67607,150,17178,19873;19926,47450,0,0,0,2,2
67608,150,17180,19859,47450,0,0,0,1,1
67609,150,17183,21255,47450,0,0,1,0,1
67610,150,17186,20530,47450,0,0,0,1,1
67611,150,17188,21456;21822,47450,0,0,2,0,2
67612,150,17191,20880;21279;24733;26821;27212,47450,1,1,3,0,5
67613,150,17195,21242;21543,47450,0,0,2,0,2
67614,150,17196,21557;21999,47450,0,0,2,0,2
67615,150,17197,21592;22019;25371,47450,0,0,3,0,3
67616,150,17201,22377;22548;25196;25481;26833,47450,1,0,4,0,5
67617,150,17204,22308;25666;25950,47450,0,2,1,0,3
67618,150,17205,21825;22089;24892;26432,47450,0,1,3,0,4
67619,150,17206,22343;25281,47450,0,0,2,0,2
67620,150,17208,21716;21808,47450,0,0,2,0,2
67621,150,17212,22337;22844;25007;26181;26531,47450,0,2,3,0,5
67622,150,17213,22339;22573;26354,47450,0,1,2,0,3
67623,150,17214,22838;23048;25702;26189;26640,47450,0,3,2,0,5
67624,150,17216,22348;22416,47450,0,0,2,0,2
67625,150,17217,22704;22826;26366,47450,0,1,2,0,3
67626,150,17218,22443;24999;25579;25769;25956,47450,0,2,3,0,5
67627,150,17219,22511;22758;25118;26361;26525,47450,0,2,3,0,5
67628,150,17221,22382;22587;26258,47450,0,1,2,0,3
67629,150,17222,22967;23058;25995;26091,47450,0,2,2,0,4
67630,150,17223,22082;22605;26261,47450,0,1,2,0,3
67631,150,17224,22773;23155;25804;25903,47450,0,2,2,0,4
67632,150,17225,22334;22748,47450,0,0,2,0,2
67633,150,17226,22753;23013,47450,0,0,2,0,2
67634,150,17227,22776;22798;27026,47450,1,0,2,0,3
67635,150,17228,22738;22781;26075,47450,0,1,2,0,3
67636,150,17229,22609;22783;25982;26449,47450,0,2,2,0,4
67637,150,17230,23018;23492;26116,47450,0,1,2,0,3
67638,150,17231,22877;23095;26192;26285,47450,0,2,2,0,4
67639,150,17232,22751;23085;25896;26542,47450,0,2,2,0,4
67640,150,17233,22900,47450,0,0,1,0,1
67641,150,17234,22914;23318;26011;26108,47450,0,2,2,0,4
67642,150,17235,22923;23571;26766;27048,47450,1,1,2,0,4
67643,150,17236,22947;23151;26088;26186;26535,47450,0,3,2,0,5
67644,150,17237,22963;22992,47450,0,0,2,0,2
67645,150,17238,22982;23303;25612,47450,0,0,3,0,3
67646,150,17239,23112;23456;26115,47450,0,1,2,0,3
67647,150,17241,22599;22994;26093,47450,0,1,2,0,3
67648,150,17242,22390;22996;25889;25998;26738,47450,0,3,2,0,5
67649,150,17243,22720;23005;25310;25506;25890,47450,0,1,4,0,5
67650,150,17244,22827;23154;25126,47450,0,0,3,0,3
67651,150,17245,23025,47450,0,0,1,0,1
67652,150,17246,23028;23417,47450,0,0,2,0,2
67653,150,17248,23185;23262;25806;27030,47450,1,1,2,0,4
67654,150,17250,22903;23091;26279,47450,0,1,2,0,3
67655,150,17251,23106;23479;26019;26569;26661,47450,0,3,2,0,5
67656,150,17252,22974;23119,47450,0,0,2,0,2
67657,150,17253,23135;23435;26759;27141,47450,1,1,2,0,4
67658,150,17254,23339;25712;26300,47450,0,2,1,0,3
67659,150,17255,23199;25808;25904;26745,47450,0,3,1,0,4
67660,150,17256,23211;23273;26205,47450,0,1,2,0,3
67661,150,17257,23212;23351;25810;26210;26302;26562;27037,47450,1,4,2,0,7
67662,150,17258,23223;23235,47450,0,0,2,0,2
67663,150,17259,23225;23460;26313,47450,0,1,2,0,3
67664,150,17260,23259;23360;25418;25509;26293;27233;27333,47450,2,1,4,0,7
67665,150,17261,22874;23265,47450,0,0,2,0,2
67666,150,17262,23271;23340;26301;26560,47450,0,2,2,0,4
67667,150,17263,23293;26473;26651;27033,47450,1,2,1,0,4
67668,150,17265,18723,47815,0,0,0,1,1
67669,150,17266,18887;19379,47815,0,0,0,2,2
67670,150,17267,19025;19228,47815,0,0,0,2,2
67671,150,17268,19088,47815,0,0,0,1,1
67672,150,17269,19095,47815,0,0,0,1,1
67673,150,17270,19103,47815,0,0,0,1,1
67674,150,17271,19206;19516,47815,0,0,0,2,2
67675,150,17272,19361,47815,0,0,0,1,1
67676,150,17273,19432;19520,47815,0,0,0,2,2
67677,150,17274,19630,47815,0,0,0,1,1
67678,150,17278,20196;20428,47815,0,0,0,2,2
67679,150,17283,20853,47815,0,0,1,0,1
67680,150,17288,20982;21340,47815,0,0,2,0,2
67681,150,17290,21190;21319,47815,0,0,2,0,2
67682,150,17291,21166,47815,0,0,1,0,1
67683,150,17292,21348;21521;24645,47815,0,0,3,0,3
67684,150,17295,21454;21640;23958;25927,47815,0,1,3,0,4
67685,150,17301,22088;22655;25493;25780;25974;26067;26441,47815,0,4,3,0,7
67686,150,17303,22402;22810;25984,47815,0,1,2,0,3
67687,150,17304,21879;22512;25586;25964,47815,0,1,3,0,4
67688,150,17305,21991;22256,47815,0,0,2,0,2
67689,150,17307,22427;22666;25002;26358,47815,0,1,3,0,4
67690,150,17308,22436;22705;25495;25785;26524,47815,0,2,3,0,5
67691,150,17310,22482;25403;26165;26254,47815,0,2,2,0,4
67692,150,17311,22491;22847;25692;25790;26182;27129,47815,1,3,2,0,6
67693,150,17312,22258;22568;26353;26520,47815,0,2,2,0,4
67694,150,17313,22502;22562;25589;26062,47815,0,1,3,0,4
67695,150,17314,22583;25681;26257;26356,47815,0,3,1,0,4
67696,150,17315,22537;23015,47815,0,0,2,0,2
67697,150,17316,22682;22931;25792;26534,47815,0,2,2,0,4
67698,150,17317,22735;26070,47815,0,1,1,0,2
67699,150,17318,22641;22737;25787;26071;26173,47815,0,3,2,0,5
67700,150,17319,22363;22759,47815,0,0,2,0,2
67701,150,17320,22130,47815,0,0,1,0,1
67702,150,17321,22660;22721;26069,47815,0,1,2,0,3
67703,150,17322,22855;23349;27036,47815,1,0,2,0,3
67704,150,17323,22883;22888;25884;26369;26454,47815,0,3,2,0,5
67705,150,17324,22782;22892;26371;26455;26732,47815,0,3,2,0,5
67706,150,17325,22906;25791;26733,47815,0,2,1,0,3
67707,150,17327,22603;23115,47815,0,0,2,0,2
67708,150,17328,22977;23134;25803;26003,47815,0,2,2,0,4
67709,150,17329,22983;23186;25807,47815,0,1,2,0,3
67710,150,17330,22993;23554;26218;26572;27252,47815,1,2,2,0,5
67711,150,17331,22997;23192;26100;26288;26744,47815,0,3,2,0,5
67712,150,17332,23000;25613;26110,47815,0,1,2,0,3
67713,150,17333,22662;23001;25309,47815,0,0,3,0,3
67714,150,17334,23244;26470,47815,0,1,1,0,2
67715,150,17335,22878;23059,47815,0,0,2,0,2
67716,150,17336,23281;23508;25906;26009;26296;26555;26857,47815,1,4,2,0,7
67717,150,17337,23089;23581;26393;27149,47815,1,1,2,0,4
67718,150,17338,23090;23153,47815,0,0,2,0,2
67719,150,17339,23120;23127,47815,0,0,2,0,2
67720,150,17340,22875;23137;25415,47815,0,0,3,0,3
67721,150,17341,23140;23681,47815,0,0,2,0,2
67722,150,17342,23114;23145;25706;26194,47815,0,2,2,0,4
67723,150,17343,23160;23288,47815,0,0,2,0,2
67724,150,17344,23200;25416,47815,0,0,2,0,2
67725,150,17345,23079;23226;26104;26203;26749,47815,0,3,2,0,5
67726,150,17346,23498;27040,47815,1,0,1,0,2
67727,150,17347,22430;23188;25710,47815,0,1,2,0,3
67728,150,17348,23044;23264;26294;26650;26751;27032,47815,1,3,2,0,6
67729,150,17349,23096;23274;25510;26008;26295,47815,0,2,3,0,5
67730,150,17350,23323;23639;26396;26489,47815,0,2,2,0,4
67731,150,17351,22962;23503;25717;26020;26761,47815,0,3,2,0,5
67732,150,17352,23572;26219,47815,0,1,1,0,2
67733,150,17353,23364;23616;26318,47815,0,1,2,0,3
67734,150,17354,23277;23366;26385,47815,0,1,2,0,3
67735,150,17355,23384;23732;26882;27264,47815,2,0,2,0,4
67736,150,17356,23251;23398;26565,47815,0,1,2,0,3
67737,150,17357,23263;23400,47815,0,0,2,0,2
67738,150,17358,19032,48180,0,0,0,1,1
67739,150,17360,18809;19173,48180,0,0,0,2,2
67740,150,17362,19331,48180,0,0,0,1,1
67741,150,17364,19518;19686,48180,0,0,0,2,2
67742,150,17365,19496;19528,48180,0,0,0,2,2
67743,150,17366,19637,48180,0,0,0,1,1
67744,150,17367,19736;20292,48180,0,0,0,2,2
67745,150,17372,20090,48180,0,0,0,1,1
67746,150,17376,20517,48180,0,0,0,1,1
67747,150,17378,20561,48180,0,0,1,0,1
67748,150,17380,20784,48180,0,0,1,0,1
67749,150,17385,21478,48180,0,0,1,0,1
67750,150,17387,21068;21404;25429,48180,0,0,3,0,3
67751,150,17392,21620;21857;25241,48180,0,0,3,0,3
67752,150,17393,21988;25369,48180,0,0,2,0,2
67753,150,17394,21567;25352,48180,0,0,2,0,2
67754,150,17395,21749,48180,0,0,1,0,1
67755,150,17397,21805;21821;25254;25831,48180,0,1,3,0,4
67756,150,17398,21990;22052;24670;24885;25753;26725;27122,48180,1,2,4,0,7
67757,150,17401,21924;22581;25870;26355,48180,0,2,2,0,4
67758,150,17402,22280;22299;25190;26155,48180,0,1,3,0,4
67759,150,17405,22045;22159;26341,48180,0,1,2,0,3
67760,150,17407,21862;22167;25100,48180,0,0,3,0,3
67761,150,17408,21915;22067;25560,48180,0,0,3,0,3
67762,150,17409,22354;22849;25601;25693;26275;26532,48180,0,3,3,0,6
67763,150,17410,22268;23099;25205,48180,0,0,3,0,3
67764,150,17411,22468;22631;26264;26626,48180,0,2,2,0,4
67765,150,17412,22361;22469;25288,48180,0,0,3,0,3
67766,150,17413,22220;22483;25404;25678;25958,48180,0,2,3,0,5
67767,150,17414,22498;23142,48180,0,0,2,0,2
67768,150,17415,22515;22733;25965,48180,0,1,2,0,3
67769,150,17416,22527;22846;25503,48180,0,0,3,0,3
67770,150,17417,22534;22636;25297,48180,0,0,3,0,3
67771,150,17419,22239;22571;25490;25776;26166,48180,0,2,3,0,5
67772,150,17420,22593;23104;25898;26543,48180,0,2,2,0,4
67773,150,17421,22749;22893;26277,48180,0,1,2,0,3
67774,150,17422,22444;22911;26734,48180,0,1,2,0,3
67775,150,17423,22341;22635;25296;26065,48180,0,1,3,0,4
67776,150,17424,22639;23143;27238,48180,1,0,2,0,3
67777,150,17425,22318;22805;25983;26178,48180,0,2,2,0,4
67778,150,17426,22668;22882;26442,48180,0,1,2,0,3
67779,150,17427,22601;22691;25590,48180,0,0,3,0,3
67780,150,17428,22692;22829,48180,0,0,2,0,2
67781,150,17429,22719;24910;25496;26617,48180,0,1,3,0,4
67782,150,17430,22591;25113,48180,0,0,2,0,2
67783,150,17431,22186;22199;24679;25852;26245,48180,0,2,3,0,5
67784,150,17432,22406;22440,48180,0,0,2,0,2
67785,150,17433,22803;22830,48180,0,0,2,0,2
67786,150,17434,22823;23064;25893;26461,48180,0,2,2,0,4
67787,150,17435,22473;22870;25988,48180,0,1,2,0,3
67788,150,17436,22842;22876;26185,48180,0,1,2,0,3
67789,150,17437,22933;22958;25307;26737,48180,0,1,3,0,4
67790,150,17438,22467;23173;25312;25709,48180,0,1,3,0,4
67791,150,17439,22899;22981;26456,48180,0,1,2,0,3
67792,150,17440,23526,48180,0,0,1,0,1
67793,150,17441,22980;23002,48180,0,0,2,0,2
67794,150,17442,22795;23029,48180,0,0,2,0,2
67795,150,17443,22910;23060;25703,48180,0,1,2,0,3
67796,150,17444,23124;23382;26564;27140,48180,1,1,2,0,4
67797,150,17445,23287;23575;25913;26121;26667;26870,48180,1,3,2,0,6
67798,150,17446,23086;23452;25616;25814;26215,48180,0,2,3,0,5
67799,150,17447,22532;23189;26850,48180,1,0,2,0,3
67800,150,17448,23191;23374,48180,0,0,2,0,2
67801,150,17449,23726;25916;26494,48180,0,2,1,0,3
67802,150,17450,23247,48180,0,0,1,0,1
67803,150,17452,23846;26785;27273,48180,1,1,1,0,3
67804,150,17453,23260,48180,0,0,1,0,1
67805,150,17454,22514;23286;26556,48180,0,1,2,0,3
67806,150,17455,23184,48180,0,0,1,0,1
67807,150,17456,23315,48180,0,0,1,0,1
67808,150,17457,23589;23601;26316;26767,48180,0,2,2,0,4
67809,150,17458,23324;23718,48180,0,0,2,0,2
67810,150,17459,23105;23464,48180,0,0,2,0,2
67811,150,17460,22970;23370;25813,48180,0,1,2,0,3
67812,150,17461,23621;23645;26488,48180,0,1,2,0,3
67813,150,17462,23442;23521;25618;26570;27042,48180,1,1,3,0,5
67814,150,17463,23232;23402;26863,48180,1,0,2,0,3
67815,150,17464,23334;23418;26310;26387;26954,48180,1,2,2,0,5
67816,150,17465,23421;23472;25716;26660;27039,48180,1,2,2,0,5
67817,150,17466,23332;23432;26658,48180,0,1,2,0,3
67818,150,17467,23227;23627;26957,48180,1,0,2,0,3
67819,150,17468,23424;23459;25715;26017;26214,48180,0,3,2,0,5
67820,150,17469,22964;23465;26314;26659,48180,0,2,2,0,4
67821,150,17470,23316;23751;26402,48180,0,1,2,0,3
67822,150,17471,23471;23606;26317,48180,0,1,2,0,3
67823,150,17472,23490;23505;25908;26021;27248,48180,1,2,2,0,5
67824,150,17473,23499;23938;25623;25720;25923;26122;26399;26898;27066,48180,2,4,3,0,9
67825,150,17474,18724,48545,0,0,0,1,1
67826,150,17476,19185,48545,0,0,0,1,1
67827,150,17478,18420,48545,0,0,0,1,1
67828,150,17479,18605,48545,0,0,0,1,1
67829,150,17483,19646;19769,48545,0,0,0,2,2
67830,150,17484,19949;20014,48545,0,0,0,2,2
67831,150,17487,20021;20173,48545,0,0,0,2,2
67832,150,17489,20848;20933,48545,0,0,2,0,2
67833,150,17498,21131,48545,0,0,1,0,1
67834,150,17512,22867;22881;26183,48545,0,1,2,0,3
67835,150,17513,21944;25646,48545,0,1,1,0,2
67836,150,17515,22103;22621;25492;27128,48545,1,0,3,0,4
67837,150,17516,22135;22248,48545,0,0,2,0,2
67838,150,17518,22189;22620;25971;26625,48545,0,2,2,0,4
67839,150,17519,22211;22518;25488;26058,48545,0,1,3,0,4
67840,150,17522,22266;22868;25122;26184,48545,0,1,3,0,4
67841,150,17524,21962;22392;25859;26620,48545,0,2,2,0,4
67842,150,17525,22323;22397;24902;26727,48545,0,1,3,0,4
67843,150,17526,22426;23209;26853,48545,1,0,2,0,3
67844,150,17527,22477,48545,0,0,1,0,1
67845,150,17528,22284;26156,48545,0,1,1,0,2
67846,150,17529,22522;23158,48545,0,0,2,0,2
67847,150,17530,22567;22791;25120,48545,0,0,3,0,3
67848,150,17532,23003;26095;26536,48545,0,2,1,0,3
67849,150,17533,23126;23162;25707;26198;26548;26643,48545,0,4,2,0,6
67850,150,17534,22736;22926,48545,0,0,2,0,2
67851,150,17536,22633;22769,48545,0,0,2,0,2
67852,150,17537,22788;23358;26383;26476;26755,48545,0,3,2,0,5
67853,150,17538,22806;23171;25605;25708;26549,48545,0,2,3,0,5
67854,150,17540,22665;22824;26079;26272;26450;26528;26839,48545,1,4,2,0,7
67855,150,17541,22541;23093;25897,48545,0,1,2,0,3
67856,150,17542,22955;23600;26188;26843,48545,1,1,2,0,4
67857,150,17543,22625;22907;25696,48545,0,1,2,0,3
67858,150,17544,23034;23116;25901;26195,48545,0,2,2,0,4
67859,150,17545,23070;23744;26776;27162,48545,1,1,2,0,4
67860,150,17546,23011;23088;25891;25999;26639,48545,0,3,2,0,5
67861,150,17547,23311;26474;26860,48545,1,1,1,0,3
67862,150,17548,23458;23544;26312;26480;27245,48545,1,2,2,0,5
67863,150,17549,23150;23257;26007;26649,48545,0,2,2,0,4
67864,150,17550,23157;23754;26777,48545,0,1,2,0,3
67865,150,17551,23174;23942,48545,0,0,2,0,2
67866,150,17552,22909;23217;25417;25607;25905;26291;26467,48545,0,3,4,0,7
67867,150,17553,23050;23559,48545,0,0,2,0,2
67868,150,17554,23075;23337;26951,48545,1,0,2,0,3
67869,150,17555,22972;23304;25207;26557,48545,0,1,3,0,4
67870,150,17556,23103;23319;25511;26012;26298,48545,0,2,3,0,5
67871,150,17557,23342;23502;25419;26209,48545,0,1,3,0,4
67872,150,17558,23386;23405;26953,48545,1,0,2,0,3
67873,150,17559,22984;23395,48545,0,0,2,0,2
67874,150,17560,23689;24032,48545,0,0,2,0,2
67875,150,17561,23428;23662;26397;26491;26671;26959,48545,1,3,2,0,6
67876,150,17562,23107;23433;25899;26001;26286;26463;26847;27136,48545,2,4,2,0,8
67877,150,17563,23415;23439;25714;26479;27243,48545,1,2,2,0,5
67878,150,17564,23615;26487;26769,48545,0,2,1,0,3
67879,150,17565,23388;23454,48545,0,0,2,0,2
67880,150,17567,23493;23785;26682,48545,0,1,2,0,3
67881,150,17568,23377;23515;26118;27250,48545,1,1,2,0,4
67882,150,17569,23538;27045,48545,1,0,1,0,2
67883,150,17570,23549;23806;26408;26587,48545,0,2,2,0,4
67884,150,17571,23308;23562;25621;26765,48545,0,1,3,0,4
67885,150,17572,23568;23918,48545,0,0,2,0,2
67886,150,17573,23468;23618,48545,0,0,2,0,2
67887,150,17574,19203,48910,0,0,0,1,1
67888,150,17577,20188,48910,0,0,0,1,1
67889,150,17580,20350;20617,48910,0,0,1,1,2
67890,150,17581,20645;20760,48910,0,0,2,0,2
67891,150,17583,20651,48910,0,0,1,0,1
67892,150,17589,20846;20988,48910,0,0,2,0,2
67893,150,17595,21421;21730;25441,48910,0,0,3,0,3
67894,150,17599,21789;22458,48910,0,0,2,0,2
67895,150,17600,21989;25752;25841;26241,48910,0,3,1,0,4
67896,150,17603,21672;22393;24386;25482;26051;26162,48910,0,2,4,0,6
67897,150,17604,22408;22663;25202;25683;26169;26265,48910,0,3,3,0,6
67898,150,17606,21865;22472;25770,48910,0,1,2,0,3
67899,150,17608,22423;22438;26055,48910,0,1,2,0,3
67900,150,17609,22463;22554,48910,0,0,2,0,2
67901,150,17610,22464;23031;26096;26741;26844,48910,1,2,2,0,5
67902,150,17611,22533;23152;25902;26197,48910,0,2,2,0,4
67903,150,17614,22543;22653;24684;25298;25779;25874,48910,0,2,4,0,6
67904,150,17615,22642;23078,48910,0,0,2,0,2
67905,150,17617,22797;23475,48910,0,0,2,0,2
67906,150,17618,22804;23394;26112;26477;26757,48910,0,3,2,0,5
67907,150,17619,22815;22819;25985,48910,0,1,2,0,3
67908,150,17621,22856;22978;26637,48910,0,1,2,0,3
67909,150,17623,22843;22894;25123;26372,48910,0,1,3,0,4
67910,150,17626,22979;22991;25887;25996;26638,48910,0,3,2,0,5
67911,150,17627,22988;23076;25888,48910,0,1,2,0,3
67912,150,17628,22999;23233;25711;26552;26647,48910,0,3,2,0,5
67913,150,17629,23017;23141;26283,48910,0,1,2,0,3
67914,150,17630,23032;23138;26098,48910,0,1,2,0,3
67915,150,17631,23042;25701;26743,48910,0,2,1,0,3
67916,150,17632,23167;23372;25615;26111;26386;26756;26862,48910,1,3,3,0,7
67917,150,17633,23037;23607,48910,0,0,2,0,2
67918,150,17634,23202;26006;26101,48910,0,2,1,0,3
67919,150,17635,23350;23709,48910,0,0,2,0,2
67920,150,17637,23242;26380;26750,48910,0,2,1,0,3
67921,150,17638,23696;23829;26579;26878;26961;27157,48910,3,1,2,0,6
67922,150,17639,23722;25821;26493;27160,48910,1,2,1,0,4
67923,150,17640,23736,48910,0,0,1,0,1
67924,150,17641,23148;23292;26004;26464;26546;26948,48910,1,3,2,0,6
67925,150,17642,23313;23330;26754,48910,0,1,2,0,3
67926,150,17643,23365;23548;26217,48910,0,1,2,0,3
67927,150,17644,23302;23343,48910,0,0,2,0,2
67928,150,17645,23359;23781;26889,48910,1,0,2,0,3
67929,150,17646,23385;23482;26866,48910,1,0,2,0,3
67930,150,17647,23341;23387,48910,0,0,2,0,2
67931,150,17648,23198;23410;26309;26656,48910,0,2,2,0,4
67932,150,17649,23422;23966;26695,48910,0,1,2,0,3
67933,150,17650,23836;24015,48910,0,0,2,0,2
67934,150,17651,23256;23449,48910,0,0,2,0,2
67935,150,17652,23451;23874,48910,0,0,2,0,2
67936,150,17653,23181;23577;26668;26955,48910,1,1,2,0,4
67937,150,17654,23489;23612;25319;25817,48910,0,1,3,0,4
67938,150,17655,23496;23525;26762,48910,0,1,2,0,3
67939,150,17656,23110;23506;25909;26482;27249,48910,1,2,2,0,5
67940,150,17657,23507;24067,48910,0,0,2,0,2
67941,150,17658,23511;23747,48910,0,0,2,0,2
67942,150,17659,23523;23835;26969,48910,1,0,2,0,3
67943,150,17660,23780,48910,0,0,1,0,1
67944,150,17661,23537;25911;27145,48910,1,1,1,0,3
67945,150,17662,23579;23699;25820;26879,48910,1,1,2,0,4
67946,150,17663,23580;23585;26394;27254,48910,1,1,2,0,4
67947,150,17664,23596;24058;26987,48910,1,0,2,0,3
67948,150,17665,23598;23642;26023;27152,48910,1,1,2,0,4
67949,150,17666,24079,48910,0,0,1,0,1
67950,150,17667,23688;23698;26676,48910,0,1,2,0,3
67951,150,17668,23123;23703;26322,48910,0,1,2,0,3
67952,150,17670,19396,49275,0,0,0,1,1
67953,150,17673,19836,49275,0,0,0,1,1
67954,150,17676,20030,49275,0,0,0,1,1
67955,150,17677,19870,49275,0,0,0,1,1
67956,150,17682,19909,49275,0,0,0,1,1
67957,150,17693,21452;21568,49275,0,0,2,0,2
67958,150,17699,21685;22228,49275,0,0,2,0,2
67959,150,17702,22002;22410;25954,49275,0,1,2,0,3
67960,150,17704,22253,49275,0,0,1,0,1
67961,150,17705,22453;23215,49275,0,0,2,0,2
67962,150,17706,22506;22901;26083;26278;26842,49275,1,2,2,0,5
67963,150,17707,22544;22857;25008,49275,0,0,3,0,3
67964,150,17709,22523;22834;26452,49275,0,1,2,0,3
67965,150,17710,22649;25873,49275,0,1,1,0,2
67966,150,17711,22616;23012;26458;26740,49275,0,2,2,0,4
67967,150,17715,22289;22689;26444,49275,0,1,2,0,3
67968,150,17716,22064;22723;25594;26359,49275,0,1,3,0,4
67969,150,17717,22732;22954,49275,0,0,2,0,2
67970,150,17719,22800;22852,49275,0,0,2,0,2
67971,150,17720,22821;22902;25695;25989,49275,0,2,2,0,4
67972,150,17723,23130;23353;26013;26303,49275,0,2,2,0,4
67973,150,17724,22488;23041;26000;26845,49275,1,1,2,0,4
67974,150,17726,23220;23312;26558,49275,0,1,2,0,3
67975,150,17727,23296;23708;26580,49275,0,1,2,0,3
67976,150,17728,23825;26325;26894,49275,1,1,1,0,3
67977,150,17729,23328;23678;26208;26299;26559,49275,0,3,2,0,5
67978,150,17730,23336;23952,49275,0,0,2,0,2
67979,150,17731,23383;23391,49275,0,0,2,0,2
67980,150,17732,23411;26016;26113;26478,49275,0,3,1,0,4
67981,150,17733,23164;23491;25514;27247,49275,1,0,3,0,4
67982,150,17734,24041;26699,49275,0,1,1,0,2
67983,150,17735,23516;23675;26876,49275,1,0,2,0,3
67984,150,17736,23764;23916;25723;26792,49275,0,2,2,0,4
67985,150,17737,24145,49275,0,0,1,0,1
67986,150,17738,23542;25718;26869,49275,1,1,1,0,3
67987,150,17739,23587;23614;26484,49275,0,1,2,0,3
67988,150,17740,23590;23977;26982,49275,1,0,2,0,3
67989,150,17741,23963,49275,0,0,1,0,1
67990,150,17742,23771,49275,0,0,1,0,1
67991,150,17743,23310;23552;26664,49275,0,1,2,0,3
67992,150,17744,23630;23641;26575;26958,49275,1,1,2,0,4
67993,150,17745,23653;23668;26221,49275,0,1,2,0,3
67994,150,17746,23289;23670;26320,49275,0,1,2,0,3
67995,150,17747,23849;24120;26137,49275,0,1,2,0,3
67996,150,17748,24111;27082,49275,1,0,1,0,2
67997,150,17749,23782;26324;26681,49275,0,2,1,0,3
67998,150,17750,23730;24018;26799,49275,0,1,2,0,3
67999,150,17751,23326;23877;26790;26975,49275,1,1,2,0,4
68000,150,17752,23495;23762;26127;26403,49275,0,2,2,0,4
68001,150,17753,23965;26330;26593;26981;27282,49275,2,2,1,0,5
68002,150,17754,23558;23768;26585,49275,0,1,2,0,3
68003,150,17755,23543;23716;26124;26492,49275,0,2,2,0,4
68004,150,17756,23820;26588;27271,49275,1,1,1,0,3
68005,150,17758,23789;23830;27057,49275,1,0,2,0,3
68006,150,17759,23609;23795;25516,49275,0,0,3,0,3
68007,150,17761,19434,49640,0,0,0,1,1
68008,150,17762,19822,49640,0,0,0,1,1
68009,150,17763,19830,49640,0,0,0,1,1
68010,150,17764,19881,49640,0,0,0,1,1
68011,150,17765,19908;19942,49640,0,0,0,2,2
68012,150,17767,19972,49640,0,0,0,1,1
68013,150,17768,20252;20389,49640,0,0,0,2,2
68014,150,17772,20478,49640,0,0,0,1,1
68015,150,17773,20540;20695;24315,49640,0,0,2,1,3
68016,150,17776,20658,49640,0,0,1,0,1
68017,150,17777,20661;20686,49640,0,0,2,0,2
68018,150,17778,20857,49640,0,0,1,0,1
68019,150,17779,20790,49640,0,0,1,0,1
68020,150,17780,20915;21311,49640,0,0,2,0,2
68021,150,17788,21545,49640,0,0,1,0,1
68022,150,17791,21443;21651,49640,0,0,2,0,2
68023,150,17793,21921,49640,0,0,1,0,1
68024,150,17794,21983;22110,49640,0,0,2,0,2
68025,150,17795,21855;22193,49640,0,0,2,0,2
68026,150,17797,22319,49640,0,0,1,0,1
68027,150,17801,22585;23139,49640,0,0,2,0,2
68028,150,17802,22949;23040;25992,49640,0,1,2,0,3
68029,150,17803,22709;25300;25685;26171,49640,0,2,2,0,4
68030,150,17805,22305,49640,0,0,1,0,1
68031,150,17806,22934;25793,49640,0,1,1,0,2
68032,150,17807,22247;22816;25881,49640,0,1,2,0,3
68033,150,17808,23055;23426;26388;26657,49640,0,2,2,0,4
68034,150,17809,23054;23457,49640,0,0,2,0,2
68035,150,17810,22889,49640,0,0,1,0,1
68036,150,17811,23196;26550;26645;27137,49640,1,2,1,0,4
68037,150,17812,23125;23128;26002;26848,49640,1,1,2,0,4
68038,150,17813,23774;23947;26887,49640,1,0,2,0,3
68039,150,17816,23066;23280;26472;26554,49640,0,2,2,0,4
68040,150,17818,23335;23706;27052;27261,49640,2,0,2,0,4
68041,150,17819,23113;23346;25316;26561,49640,0,1,3,0,4
68042,150,17820,23371;23513;26305;26654,49640,0,2,2,0,4
68043,150,17821,23903,49640,0,0,1,0,1
68044,150,17822,23129;23408;26566,49640,0,1,2,0,3
68045,150,17823,23375;23478;26212;26563;26952,49640,1,2,2,0,5
68046,150,17824,23539,49640,0,0,1,0,1
68047,150,17825,23983;26411;26983,49640,1,1,1,0,3
68048,150,17826,23588;23673,49640,0,0,2,0,2
68049,150,17827,23664;23827;27272,49640,1,0,2,0,3
68050,150,17828,23620;23650,49640,0,0,2,0,2
68051,150,17829,23446,49640,0,0,1,0,1
68052,150,17830,23561;23655;25819,49640,0,1,2,0,3
68053,150,17831,23431;23677;26321;26578;27156,49640,1,2,2,0,5
68054,150,17832,23453;23756;26126;27055;27164,49640,2,1,2,0,5
68055,150,17833,23798;24208,49640,0,0,2,0,2
68056,150,17834,23801;23885;26405;26497;26586;26781;26890,49640,1,4,2,0,7
68057,150,17835,23828;24118;26992;27083,49640,2,0,2,0,4
68058,150,17836,23838;24188,49640,0,0,2,0,2
68059,150,17837,23409;23878,49640,0,0,2,0,2
68060,150,17838,23909;24179;26917;26996,49640,2,0,2,0,4
68061,150,17839,23816;23926,49640,0,0,2,0,2
68062,150,17840,23932;26228;26897,49640,1,1,1,0,3
68063,150,17841,23955;24241,49640,0,0,2,0,2
68064,150,17842,24031;27180,49640,1,0,1,0,2
68065,150,17844,19634,50005,0,0,0,1,1
68066,150,17845,19544,50005,0,0,0,1,1
68067,150,17846,19789;20483,50005,0,0,0,2,2
68068,150,17847,19438,50005,0,0,0,1,1
68069,150,17849,20071;20443,50005,0,0,0,2,2
68070,150,17850,19931,50005,0,0,0,1,1
68071,150,17852,20471,50005,0,0,0,1,1
68072,150,17858,20401;20588,50005,0,0,1,1,2
68073,150,17862,21611,50005,0,0,1,0,1
68074,150,17865,21984;22074,50005,0,0,2,0,2
68075,150,17867,22076;22366,50005,0,0,2,0,2
68076,150,17869,22144;22263,50005,0,0,2,0,2
68077,150,17874,22373;22953;25885;26187;26636,50005,0,3,2,0,5
68078,150,17875,22116;22389;25576;25673;25768,50005,0,2,3,0,5
68079,150,17876,22079;22441,50005,0,0,2,0,2
68080,150,17878,21982,50005,0,0,1,0,1
68081,150,17880,22574;22774;26271;26362,50005,0,2,2,0,4
68082,150,17884,22943;23306;27034,50005,1,0,2,0,3
68083,150,17886,23006;23197,50005,0,0,2,0,2
68084,150,17887,23685;26222;26674;27051,50005,1,2,1,0,4
68085,150,17888,22744;23081;25704;25894,50005,0,2,2,0,4
68086,150,17889,22913;23083;25507;25895,50005,0,1,3,0,4
68087,150,17890,22959;23092;25125;26097,50005,0,1,3,0,4
68088,150,17891,23169;23450;26114;26864;27142,50005,2,1,2,0,5
68089,150,17892,22905;23172;25306;27131,50005,1,0,3,0,4
68090,150,17893,23592;26669;26871,50005,1,1,1,0,3
68091,150,17894,23624;26395,50005,0,1,1,0,2
68092,150,17895,23249;23750;27163,50005,1,0,2,0,3
68093,150,17896,23352;23880;26976,50005,1,0,2,0,3
68094,150,17897,23291;23381,50005,0,0,2,0,2
68095,150,17898,23331;26109;26861,50005,1,1,1,0,3
68096,150,17899,23557;23933;26692;26794,50005,0,2,2,0,4
68097,150,17900,23284;23427,50005,0,0,2,0,2
68098,150,17902,23389,50005,0,0,1,0,1
68099,150,17903,23440;23824,50005,0,0,2,0,2
68100,150,17904,23348;23591;25816,50005,0,1,2,0,3
68101,150,17905,23399;23519,50005,0,0,2,0,2
68102,150,17906,23528;23758;27267,50005,1,0,2,0,3
68103,150,17907,23535;23908;26130,50005,0,1,2,0,3
68104,150,17908,23295;23547;26763;27046,50005,1,1,2,0,4
68105,150,17909,23473;23657,50005,0,0,2,0,2
68106,150,17910,23578;23964;27175,50005,1,0,2,0,3
68107,150,17911,23582;23702,50005,0,0,2,0,2
68108,150,17912,23672;23799;26780;26967,50005,1,1,2,0,4
68109,150,17913,23636;23960;27151,50005,1,0,2,0,3
68110,150,17914,23671;26673;27259,50005,1,1,1,0,3
68111,150,17915,23701;23900;25921;26227,50005,0,2,2,0,4
68112,150,17916,23723;24029;26414;27286,50005,1,1,2,0,4
68113,150,17917,23746;24248;27000,50005,1,0,2,0,3
68114,150,17918,23546;23773;26026,50005,0,1,2,0,3
68115,150,17919,23777;24100;26680;26888,50005,1,1,2,0,4
68116,150,17920,23533;23783;26964,50005,1,0,2,0,3
68117,150,17921,23717;23791;26027,50005,0,1,2,0,3
68118,150,17922,23802;24063;26406,50005,0,1,2,0,3
68119,150,17923,24152;26139;27289,50005,1,1,1,0,3
68120,150,17924,23604;23826;26684;26784,50005,0,2,2,0,4
68121,150,17925,23832;23982;26501,50005,0,1,2,0,3
68122,150,17926,23619;23851;26686;27274,50005,1,1,2,0,4
68123,150,17927,23863;24245;26141,50005,0,1,2,0,3
68124,150,17928,24226;27087,50005,1,0,1,0,2
68125,150,17929,23911;24112;26136,50005,0,1,2,0,3
68126,150,17930,24221;24328;26999,50005,1,0,2,0,3
68127,150,17931,23931;24277,50005,0,0,2,0,2
68128,150,17932,23276;23954;27280,50005,1,0,2,0,3
68129,150,17933,23488;23957,50005,0,0,2,0,2
68130,150,17934,23654;23969;26133,50005,0,1,2,0,3
68131,150,17935,23978;24001;26412;27071;27178,50005,2,1,2,0,5
68132,150,17936,23986;24049,50005,0,0,2,0,2
68133,150,17937,23990;24348;26509,50005,0,1,2,0,3
68134,150,17938,23995;24099;26594;26796,50005,0,2,2,0,4
68135,150,17939,23443;23917;26030;26793,50005,0,2,2,0,4
68136,150,17940,23748;24016;26413;26798,50005,0,2,2,0,4
68137,150,17941,24027,50005,0,0,1,0,1
68138,150,17942,24030;24266;27191,50005,1,0,2,0,3
68139,150,17944,24008;24044;26331;26797;26984,50005,1,2,2,0,5
68140,150,17945,24280;26142;26604;27297,50005,1,2,1,0,4
68141,150,17946,24078;26599;27079,50005,1,1,1,0,3
68142,150,17947,23981;24083;26795,50005,0,1,2,0,3
68143,150,17948,19721,50370,0,0,0,1,1
68144,150,17951,19784,50370,0,0,0,1,1
68145,150,17953,19990,50370,0,0,0,1,1
68146,150,17956,20190;20452;24579,50370,0,0,1,2,3
68147,150,17957,20204;20685,50370,0,0,1,1,2
68148,150,17959,19918;20171,50370,0,0,0,2,2
68149,150,17962,20666,50370,0,0,1,0,1
68150,150,17968,21082,50370,0,0,1,0,1
68151,150,17976,21218;21627;24862,50370,0,0,3,0,3
68152,150,17982,22087,50370,0,0,1,0,1
68153,150,17983,22204,50370,0,0,1,0,1
68154,150,17984,21903;22425;24997;26939,50370,1,0,3,0,4
68155,150,17985,22223,50370,0,0,1,0,1
68156,150,17990,22047,50370,0,0,1,0,1
68157,150,17991,22613;22968;27237,50370,1,0,2,0,3
68158,150,17994,22904;23065,50370,0,0,2,0,2
68159,150,17995,23224;26855,50370,1,0,1,0,2
68160,150,17996,22930,50370,0,0,1,0,1
68161,150,17997,22952;22998;25797;26094,50370,0,2,2,0,4
68162,150,17998,23056;23483;27246,50370,1,0,2,0,3
68163,150,17999,22861,50370,0,0,1,0,1
68164,150,18000,23159,50370,0,0,1,0,1
68165,150,18001,23190;23298;26106;26297,50370,0,2,2,0,4
68166,150,18002,23246;23563;26665;27253,50370,1,1,2,0,4
68167,150,18003,23258;23683;25420;26877,50370,1,0,3,0,4
68168,150,18004,22946;23285;26858;27138,50370,2,0,2,0,4
68169,150,18005,23325,50370,0,0,1,0,1
68170,150,18007,23354;23788;26496;26966,50370,1,1,2,0,4
68171,150,18008,23894;23988;27069,50370,1,0,2,0,3
68172,150,18009,23406;23864;27172;27275,50370,2,0,2,0,4
68173,150,18010,24091,50370,0,0,1,0,1
68174,150,18011,23448;23574;27148,50370,1,0,2,0,3
68175,150,18013,23462;23839;26970,50370,1,0,2,0,3
68176,150,18014,23416;23474,50370,0,0,2,0,2
68177,150,18015,23282;23531,50370,0,0,2,0,2
68178,150,18016,23046,50370,0,0,1,0,1
68179,150,18017,23760;26025,50370,0,1,1,0,2
68180,150,18018,23532;23545;26119;26391;26868,50370,1,2,2,0,5
68181,150,18019,23182;23646;26490;27258,50370,1,1,2,0,4
68182,150,18020,23540;23553;25620;26571;26764;27146,50370,1,2,3,0,6
68183,150,18021,23268;23576,50370,0,0,2,0,2
68184,150,18022,23534;23608;25619,50370,0,0,3,0,3
68185,150,18023,23643;24003;27179;27285,50370,2,0,2,0,4
68186,150,18024,24178,50370,0,0,1,0,1
68187,150,18025,23661;23763;26584,50370,0,1,2,0,3
68188,150,18026,23309;23715;26123;27053;27158,50370,2,1,2,0,5
68189,150,18027,23734;27265,50370,1,0,1,0,2
68190,150,18028,23322;25512,50370,0,0,2,0,2
68191,150,18029,23833;24228,50370,0,0,2,0,2
68192,150,18030,23804;24084;26700,50370,0,1,2,0,3
68193,150,18031,23467;23844;26685,50370,0,1,2,0,3
68194,150,18032,23629;23850;26771,50370,0,1,2,0,3
68195,150,18033,23425;23867,50370,0,0,2,0,2
68196,150,18034,23469;23868;26226;26327;26787;27063;27173,50370,2,3,2,0,7
68197,150,18035,23875;24202;26235,50370,0,1,2,0,3
68198,150,18036,23901;24288,50370,0,0,2,0,2
68199,150,18037,23927;24021,50370,0,0,2,0,2
68200,150,18038,24094;24146,50370,0,0,2,0,2
68201,150,18039,23980;24285;26805,50370,0,1,2,0,3
68202,150,18040,23985;24214;26420,50370,0,1,2,0,3
68203,150,18041,24010;26903;27073,50370,2,0,1,0,3
68204,150,18042,24034;24289,50370,0,0,2,0,2
68205,150,18043,23971;24039;26986,50370,1,0,2,0,3
68206,150,18044,23634;24040;27075,50370,1,0,2,0,3
68207,150,18045,24047;26415,50370,0,1,1,0,2
68208,150,18046,24116;24460,50370,0,0,2,0,2
68209,150,18047,24160,50370,0,0,1,0,1
68210,150,18048,24172;24186;27187,50370,1,0,2,0,3
68211,150,18049,24181;24265;27294,50370,1,0,2,0,3
68212,150,18050,24183;24314;26807,50370,0,1,2,0,3
68213,150,18051,23973;24368;27299,50370,1,0,2,0,3
68214,150,18052,19450,50735,0,0,0,1,1
68215,150,18054,19777,50735,0,0,0,1,1
68216,150,18055,19288,50735,0,0,0,1,1
68217,150,18056,19981,50735,0,0,0,1,1
68218,150,18058,20023,50735,0,0,0,1,1
68219,150,18061,19997,50735,0,0,0,1,1
68220,150,18062,20083,50735,0,0,0,1,1
68221,150,18063,20716;20878,50735,0,0,2,0,2
68222,150,18064,20508,50735,0,0,0,1,1
68223,150,18066,20802;20838,50735,0,0,2,0,2
68224,150,18067,20859;20944,50735,0,0,2,0,2
68225,150,18071,21508,50735,0,0,1,0,1
68226,150,18072,21554,50735,0,0,1,0,1
68227,150,18075,21226;21687;23848;24655,50735,0,0,4,0,4
68228,150,18077,21812,50735,0,0,1,0,1
68229,150,18079,22025,50735,0,0,1,0,1
68230,150,18080,21529,50735,0,0,1,0,1
68231,150,18083,22646,50735,0,0,1,0,1
68232,150,18085,22678;23210;26290,50735,0,1,2,0,3
68233,150,18087,22764;23228,50735,0,0,2,0,2
68234,150,18090,22789,50735,0,0,1,0,1
68235,150,18091,23004;23208;26202;26289;26747,50735,0,3,2,0,5
68236,150,18092,22957,50735,0,0,1,0,1
68237,150,18094,23118;23861,50735,0,0,2,0,2
68238,150,18096,23204;23845;26971;27170,50735,2,0,2,0,4
68239,150,18097,23122;23222;26748,50735,0,1,2,0,3
68240,150,18098,23236;23766;26779;27165,50735,1,1,2,0,4
68241,150,18099,23207;23261;26201;27239,50735,1,1,2,0,4
68242,150,18100,23305,50735,0,0,1,0,1
68243,150,18101,23175;23392;26014;27241,50735,1,1,2,0,4
68244,150,18102,23213;23407;26213;26308;26758;27242,50735,1,3,2,0,6
68245,150,18103,23412;23862;25918;27062,50735,1,1,2,0,4
68246,150,18104,23429;23692;26398;26774;27260,50735,1,2,2,0,5
68247,150,18105,23814;24060;26028;26783;27058;27167;27268,50735,3,2,2,0,7
68248,150,18106,23373;23509;26216,50735,0,1,2,0,3
68249,150,18107,23584,50735,0,0,1,0,1
68250,150,18108,23487;24169;26916;26995;27186,50735,3,0,2,0,5
68251,150,18109,23800,50735,0,0,1,0,1
68252,150,18111,23610;23757;25914;26574,50735,0,2,2,0,4
68253,150,18112,23500;23613;26486,50735,0,1,2,0,3
68254,150,18113,23344;23714;26323;26581;27262,50735,1,2,2,0,5
68255,150,18114,23455;23765;26404;26778,50735,0,2,2,0,4
68256,150,18115,23494;23776;26224;26963,50735,1,1,2,0,4
68257,150,18118,23886;24338;26423,50735,0,1,2,0,3
68258,150,18119,23920,50735,0,0,1,0,1
68259,150,18120,23945;26132;27068,50735,1,1,1,0,3
68260,150,18121,23727;23967;26500;27283,50735,1,1,2,0,4
68261,150,18122,23786;24006,50735,0,0,2,0,2
68262,150,18123,24026;24164,50735,0,0,2,0,2
68263,150,18124,23883;24053;26502;27076;27182,50735,2,1,2,0,5
68264,150,18125,23740;24074;26989,50735,1,0,2,0,3
68265,150,18126,23779;24098;26908,50735,1,0,2,0,3
68266,150,18127,24104;24458;26336,50735,0,1,2,0,3
68267,150,18128,24130;24282;27193,50735,1,0,2,0,3
68268,150,18129,24072;24134;26988;27078,50735,2,0,2,0,4
68269,150,18130,24157;24256;26237,50735,0,1,2,0,3
68270,150,18131,24070;24177;25725;26233;26802;27293,50735,1,3,2,0,6
68271,150,18132,23888;24191;26601,50735,0,1,2,0,3
68272,150,18133,24236;24405,50735,0,0,2,0,2
68273,150,18134,24262;24431;26813,50735,0,1,2,0,3
68274,150,18135,19927,51100,0,0,0,1,1
68275,150,18137,20043,51100,0,0,0,1,1
68276,150,18138,20305,51100,0,0,0,1,1
68277,150,18140,20446,51100,0,0,0,1,1
68278,150,18141,20525,51100,0,0,0,1,1
68279,150,18144,20803,51100,0,0,1,0,1
68280,150,18148,20669;21276,51100,0,0,2,0,2
68281,150,18150,21485,51100,0,0,1,0,1
68282,150,18153,21556,51100,0,0,1,0,1
68283,150,18155,21663;23847;25827,51100,0,1,2,0,3
68284,150,18158,21113;21223,51100,0,0,2,0,2
68285,150,18159,21566,51100,0,0,1,0,1
68286,150,18161,22233;22765;25502;26448,51100,0,1,3,0,4
68287,150,18163,22100;22105;26146,51100,0,1,2,0,3
68288,150,18164,22353,51100,0,0,1,0,1
68289,150,18165,22332,51100,0,0,1,0,1
68290,150,18168,22546,51100,0,0,1,0,1
68291,150,18169,22579,51100,0,0,1,0,1
68292,150,18172,23061,51100,0,0,1,0,1
68293,150,18174,22575;22675;26267;26627,51100,0,2,2,0,4
68294,150,18175,22858;23367;25713;25812;26304;27038,51100,1,3,2,0,6
68295,150,18182,23047,51100,0,0,1,0,1
68296,150,18183,23077;23201;26465;26851;26949,51100,2,1,2,0,5
68297,150,18188,23297;23902;26328;27277,51100,1,1,2,0,4
68298,150,18189,23165;23436;27244,51100,1,0,2,0,3
68299,150,18190,23477;23594;25318,51100,0,0,3,0,3
68300,150,18191,22703;23497;26662,51100,0,1,2,0,3
68301,150,18192,23357;23527;26867;27043;27143,51100,3,0,2,0,5
68302,150,18193,23355;23530;27044,51100,1,0,2,0,3
68303,150,18194,23720;26582,51100,0,1,1,0,2
68304,150,18195,23266;23602;26573;26768;27150;27255,51100,2,2,2,0,6
68305,150,18196,23179;23622;26872,51100,1,0,2,0,3
68306,150,18197,23651,51100,0,0,1,0,1
68307,150,18198,24013;26697;26904,51100,1,1,1,0,3
68308,150,18199,24141;24162;27085;27291,51100,2,0,2,0,4
68309,150,18201,24352;24423;26923,51100,1,0,2,0,3
68310,150,18202,23752;23853;26129;26326;26895,51100,1,2,2,0,5
68311,150,18203,23857;24007;26786;26973,51100,1,1,2,0,4
68312,150,18204,23943;24376,51100,0,0,2,0,2
68313,150,18205,23950;24076;26900,51100,1,0,2,0,3
68314,150,18206,23514;23953;26980,51100,1,0,2,0,3
68315,150,18207,23419;23972,51100,0,0,2,0,2
68316,150,18208,24035,51100,0,0,1,0,1
68317,150,18210,23564;24336;26920,51100,1,0,2,0,3
68318,150,18211,24081;26503;27080,51100,1,1,1,0,3
68319,150,18212,24449;24484,51100,0,0,2,0,2
68320,150,18213,23855;24038;26698;26906,51100,1,1,2,0,4
68321,150,18214,24054;24212;26998,51100,1,0,2,0,3
68322,150,18216,24121;24275,51100,0,0,2,0,2
68323,150,18217,24123;24187,51100,0,0,2,0,2
68324,150,18218,24136;24283;26707;27194,51100,1,1,2,0,4
68325,150,18219,24170;24218;27295,51100,1,0,2,0,3
68326,150,18220,24163;24193;26506,51100,0,1,2,0,3
68327,150,18221,24195;26419;26704,51100,0,2,1,0,3
68328,150,18222,24196;24471,51100,0,0,2,0,2
68329,150,18223,23725;24211,51100,0,0,2,0,2
68330,150,18224,24216;24577;27104,51100,1,0,2,0,3
68331,150,18225,24225;24327;26507,51100,0,1,2,0,3
68332,150,18226,24290;26422,51100,0,1,1,0,2
68333,150,18227,24297,51100,0,0,1,0,1
68334,150,18228,24299;24598;27313,51100,1,0,2,0,3
68335,150,18229,23996;24303;27195,51100,1,0,2,0,3
68336,150,18230,24324,51100,0,0,1,0,1
68337,150,18231,24331;24435;26427;27200,51100,1,1,2,0,4
68338,150,18232,24129;24335,51100,0,0,2,0,2
68339,150,18233,23893;24337;26712;26921,51100,1,1,2,0,4
68340,150,18234,24312;24354;26713;26809;27199,51100,1,2,2,0,5
68341,150,18235,24360;24560;27012,51100,1,0,2,0,3
68342,150,18236,23869;24363;27094,51100,1,0,2,0,3
68343,150,18237,24589;26718,51100,0,1,1,0,2
68344,150,18238,20056,51465,0,0,0,1,1
68345,150,18240,20086,51465,0,0,0,1,1
68346,150,18241,20306;20390,51465,0,0,0,2,2
68347,150,18243,20157,51465,0,0,0,1,1
68348,150,18244,20082,51465,0,0,0,1,1
68349,150,18246,20501,51465,0,0,0,1,1
68350,150,18247,20265,51465,0,0,0,1,1
68351,150,18248,20248,51465,0,0,0,1,1
68352,150,18249,20990;21335,51465,0,0,2,0,2
68353,150,18250,21009;21147,51465,0,0,2,0,2
68354,150,18255,21447,51465,0,0,1,0,1
68355,150,18258,21819,51465,0,0,1,0,1
68356,150,18260,22099,51465,0,0,1,0,1
68357,150,18261,22112;22184,51465,0,0,2,0,2
68358,150,18262,22057;22177,51465,0,0,2,0,2
68359,150,18263,22357,51465,0,0,1,0,1
68360,150,18264,22028,51465,0,0,1,0,1
68361,150,18266,22388;23321;26475;27035,51465,1,1,2,0,4
68362,150,18267,22405;22650;25407;26941,51465,1,0,3,0,4
68363,150,18268,22542,51465,0,0,1,0,1
68364,150,18269,22611,51465,0,0,1,0,1
68365,150,18271,22070,51465,0,0,1,0,1
68366,150,18272,22680;22722,51465,0,0,2,0,2
68367,150,18276,23163;23203;26102;26200;26746;26852,51465,1,3,2,0,6
68368,150,18277,23237,51465,0,0,1,0,1
68369,150,18279,23378;23834;26589,51465,0,1,2,0,3
68370,150,18280,23437;23817;26683;26892;27059;27270,51465,3,1,2,0,6
68371,150,18281,23721;25624;26400;27159,51465,1,1,2,0,4
68372,150,18282,23524;23803;25822;26407;26782,51465,0,3,2,0,5
68373,150,18283,23501;23837;25625;27061;27168,51465,2,0,3,0,5
68374,150,18284,23327;23595;26220,51465,0,1,2,0,3
68375,150,18285,23648;24137;26912;26994;27084,51465,3,0,2,0,5
68376,150,18286,23665;23735,51465,0,0,2,0,2
68377,150,18287,23599;23669;26577;26672,51465,0,2,2,0,4
68378,150,18288,23307;23414;25907,51465,0,1,2,0,3
68379,150,18289,23485;23815;26891;26968;27269,51465,3,0,2,0,5
68380,150,18290,23270;23481,51465,0,0,2,0,2
68381,150,18291,23761;23819,51465,0,0,2,0,2
68382,150,18292,23676;23787;26965,51465,1,0,2,0,3
68383,150,18293,23794;23899;26896;27064,51465,2,0,2,0,4
68384,150,18294,23583;23993,51465,0,0,2,0,2
68385,150,18295,23745;23876;26689;26789;27276,51465,1,2,2,0,5
68386,150,18296,23949;24168;26505;26915;27086,51465,2,1,2,0,5
68387,150,18297,23790;24020;26905,51465,1,0,2,0,3
68388,150,18298,24023;24432;26607,51465,0,1,2,0,3
68389,150,18299,24037;27074,51465,1,0,1,0,2
68390,150,18300,23910;24048;26595,51465,0,1,2,0,3
68391,150,18301,24057;24463;27005;27204,51465,2,0,2,0,4
68392,150,18302,24068,51465,0,0,1,0,1
68393,150,18304,24176;24398,51465,0,0,2,0,2
68394,150,18305,23693;23884;25920,51465,0,1,2,0,3
68395,150,18306,24139;24428;27096,51465,1,0,2,0,3
68396,150,18307,23731;24144,51465,0,0,2,0,2
68397,150,18308,23647;24174,51465,0,0,2,0,2
68398,150,18309,24182;24213;26703,51465,0,1,2,0,3
68399,150,18310,24215;24574;26930,51465,1,0,2,0,3
68400,150,18311,24267;24322,51465,0,0,2,0,2
68401,150,18312,23882;24293,51465,0,0,2,0,2
68402,150,18313,24295;24755,51465,0,0,2,0,2
68403,150,18314,24319;24350;27198,51465,1,0,2,0,3
68404,150,18315,24321;24374;26709;26808,51465,0,2,2,0,4
68405,150,18316,24349;24614,51465,0,0,2,0,2
68406,150,18317,24090;24377;26924,51465,1,0,2,0,3
68407,150,18318,24408;24649;26820,51465,0,1,2,0,3
68408,150,18319,23792;24420;26513;27302,51465,1,1,2,0,4
68409,150,18320,24436;24442;27304,51465,1,0,2,0,3
68410,150,18321,24457;24477,51465,0,0,2,0,2
68411,150,18322,20294,51830,0,0,0,1,1
68412,150,18323,20054,51830,0,0,0,1,1
68413,150,18324,20104,51830,0,0,0,1,1
68414,150,18326,20454,51830,0,0,0,1,1
68415,150,18327,20231;20354,51830,0,0,0,2,2
68416,150,18331,20801;20813,51830,0,0,2,0,2
68417,150,18332,20545,51830,0,0,0,1,1
68418,150,18333,20572,51830,0,0,1,0,1
68419,150,18338,21180;21541;25525,51830,0,0,3,0,3
68420,150,18345,21853,51830,0,0,1,0,1
68421,150,18350,22001,51830,0,0,1,0,1
68422,150,18351,22274,51830,0,0,1,0,1
68423,150,18352,22391;25396,51830,0,0,2,0,2
68424,150,18353,21952,51830,0,0,1,0,1
68425,150,18358,22794,51830,0,0,1,0,1
68426,150,18359,22927,51830,0,0,1,0,1
68427,150,18361,23272;23278;26553,51830,0,1,2,0,3
68428,150,18362,23444;25513;26311;26567;26760,51830,0,3,2,0,5
68429,150,18363,23221;23870,51830,0,0,2,0,2
68430,150,18366,24103;26909;26990,51830,2,0,1,0,3
68431,150,18367,23551;24159;26140;26504;26801,51830,0,3,2,0,5
68432,150,18368,23611;23660;26670;27153,51830,1,1,2,0,4
68433,150,18369,23617;23656;27256,51830,1,0,2,0,3
68434,150,18370,24166;24173;26702;27292,51830,1,1,2,0,4
68435,150,18371,23713;24302,51830,0,0,2,0,2
68436,150,18373,23240;23733;26883,51830,1,0,2,0,3
68437,150,18374,23805;24205,51830,0,0,2,0,2
68438,150,18375,23810;24227;26236;26803,51830,0,2,2,0,4
68439,150,18376,23738;23896;26401;26678,51830,0,2,2,0,4
68440,150,18377,23447;23898;26791,51830,0,1,2,0,3
68441,150,18378,23913;23998;27176;27284,51830,2,0,2,0,4
68442,150,18379,24012;24310,51830,0,0,2,0,2
68443,150,18380,24045;24356;26605;27298,51830,1,1,2,0,4
68444,150,18381,24055;24539;27309,51830,1,0,2,0,3
68445,150,18383,23560;24066;26597,51830,0,1,2,0,3
68446,150,18384,24656,51830,0,0,1,0,1
68447,150,18385,23719;24122;26416;26910;26978,51830,2,1,2,0,5
68448,150,18386,24125,51830,0,0,1,0,1
68449,150,18387,24180;24318,51830,0,0,2,0,2
68450,150,18388,24190;24192,51830,0,0,2,0,2
68451,150,18389,24077;24200;26234;27188,51830,1,1,2,0,4
68452,150,18390,24209;24643,51830,0,0,2,0,2
68453,150,18392,24276;24620,51830,0,0,2,0,2
68454,150,18394,24309;24629;26932,51830,1,0,2,0,3
68455,150,18395,24323,51830,0,0,1,0,1
68456,150,18396,24329;24788;26824;27214,51830,1,1,2,0,4
68457,150,18397,24396;24473;26512,51830,0,1,2,0,3
68458,150,18398,24317;24406,51830,0,0,2,0,2
68459,150,18399,24439;24694,51830,0,0,2,0,2
68460,150,18400,24854;27320,51830,1,0,1,0,2
68461,150,18401,24452;24718,51830,0,0,2,0,2
68462,150,18402,24281;24459;26918,51830,1,0,2,0,3
68463,150,18403,24483;24850,51830,0,0,2,0,2
68464,150,18404,24507;24632,51830,0,0,2,0,2
68465,150,18405,24526;24527;26815;27308,51830,1,1,2,0,4
68466,150,18406,24528;24646;26612,51830,0,1,2,0,3
68467,150,18407,24530;24626;26931,51830,1,0,2,0,3
68468,150,18408,24142;24534;26514;26717,51830,0,2,2,0,4
68469,150,18409,24548;24799;27010;27310,51830,2,0,2,0,4
68470,150,18410,24549;24797;27319,51830,1,0,2,0,3
68471,150,18411,24404;24553,51830,0,0,2,0,2
68472,150,18412,24128;24556,51830,0,0,2,0,2
68473,150,18414,20084,52195,0,0,0,1,1
68474,150,18415,19814,52195,0,0,0,1,1
68475,150,18416,20516,52195,0,0,0,1,1
68476,150,18417,20356;20842,52195,0,0,1,1,2
68477,150,18418,20217,52195,0,0,0,1,1
68478,150,18420,20581;20671,52195,0,0,2,0,2
68479,150,18422,20649;20941,52195,0,0,2,0,2
68480,150,18423,20434;20749,52195,0,0,1,1,2
68481,150,18428,21118;21198,52195,0,0,2,0,2
68482,150,18429,21149,52195,0,0,1,0,1
68483,150,18431,21225,52195,0,0,1,0,1
68484,150,18434,21830,52195,0,0,1,0,1
68485,150,18436,21927;22414;25955;26253,52195,0,2,2,0,4
68486,150,18437,22091,52195,0,0,1,0,1
68487,150,18438,22107,52195,0,0,1,0,1
68488,150,18442,22447;22510,52195,0,0,2,0,2
68489,150,18443,22188,52195,0,0,1,0,1
68490,150,18446,22648;22657;25781,52195,0,1,2,0,3
68491,150,18448,22897;23356;25614;25811;26211,52195,0,2,3,0,5
68492,150,18449,22739,52195,0,0,1,0,1
68493,150,18450,23021,52195,0,0,1,0,1
68494,150,18452,23195;23625;26770;26874;27049,52195,2,1,2,0,5
68495,150,18453,23743;26223,52195,0,1,1,0,2
68496,150,18455,23361,52195,0,0,1,0,1
68497,150,18458,23704;23999;27070;27177,52195,2,0,2,0,4
68498,150,18459,23753;24153;26333;27290,52195,1,1,2,0,4
68499,150,18460,23569;23843;26120;26666,52195,0,2,2,0,4
68500,150,18461,23979;24113;26332,52195,0,1,2,0,3
68501,150,18462,23684;23822;26893;27060,52195,2,0,2,0,4
68502,150,18463,24019;24087;26701,52195,0,1,2,0,3
68503,150,18464,24024;24469;27006,52195,1,0,2,0,3
68504,150,18465,24046;24361;26510,52195,0,1,2,0,3
68505,150,18467,24127;24292,52195,0,0,2,0,2
68506,150,18468,23486;24165,52195,0,0,2,0,2
68507,150,18469,24203;24253;26033,52195,0,1,2,0,3
68508,150,18470,24156;24232;27088;27189,52195,2,0,2,0,4
68509,150,18471,24230;24234,52195,0,0,2,0,2
68510,150,18473,24246;26334,52195,0,1,1,0,2
68511,150,18474,24255;24258;26804,52195,0,1,2,0,3
68512,150,18475,24291;24580,52195,0,0,2,0,2
68513,150,18476,24235;24320;26602;27089;27296,52195,2,1,2,0,5
68514,150,18477,24334;26711,52195,0,1,1,0,2
68515,150,18479,23659;24370,52195,0,0,2,0,2
68516,150,18480,24397;24611,52195,0,0,2,0,2
68517,150,18481,24341;24421,52195,0,0,2,0,2
68518,150,18482,24453;27098,52195,1,0,1,0,2
68519,150,18483,24437;24468,52195,0,0,2,0,2
68520,150,18484,24525;24774,52195,0,0,2,0,2
68521,150,18485,24487;24793;27116,52195,1,0,2,0,3
68522,150,18486,24497;24531,52195,0,0,2,0,2
68523,150,18487,24533;24617;26716;26816;27207,52195,1,2,2,0,5
68524,150,18488,24540,52195,0,0,1,0,1
68525,150,18489,24550;24583,52195,0,0,2,0,2
68526,150,18490,24514;24551;27011,52195,1,0,2,0,3
68527,150,18492,24587;24878,52195,0,0,2,0,2
68528,150,18493,24590;24739,52195,0,0,2,0,2
68529,150,18494,24371;24602;26428,52195,0,1,2,0,3
68530,150,18495,24494;24609;26515,52195,0,1,2,0,3
68531,150,18496,24612;24849;26616,52195,0,1,2,0,3
68532,150,18497,24613;25004,52195,0,0,2,0,2
68533,150,18498,24760;24906,52195,0,0,2,0,2
68534,150,18499,24637;24835;26818,52195,0,1,2,0,3
68535,150,18500,24651;24712;27112,52195,1,0,2,0,3
68536,150,18501,24652;24668,52195,0,0,2,0,2
68537,150,18502,24669;26516,52195,0,1,1,0,2
68538,150,18503,24683;24961,52195,0,0,2,0,2
68539,150,18504,20414;20643,52560,0,0,1,1,2
68540,150,18505,20451,52560,0,0,0,1,1
68541,150,18506,20205;20543,52560,0,0,0,2,2
68542,150,18507,20187,52560,0,0,0,1,1
68543,150,18509,20705,52560,0,0,1,0,1
68544,150,18510,20596,52560,0,0,1,0,1
68545,150,18513,20864,52560,0,0,1,0,1
68546,150,18516,21119;21342,52560,0,0,2,0,2
68547,150,18519,20851;20955,52560,0,0,2,0,2
68548,150,18520,21266;21339,52560,0,0,2,0,2
68549,150,18521,21277;21289,52560,0,0,2,0,2
68550,150,18523,21133;21285,52560,0,0,2,0,2
68551,150,18528,21766,52560,0,0,1,0,1
68552,150,18529,21768,52560,0,0,1,0,1
68553,150,18531,21818,52560,0,0,1,0,1
68554,150,18532,22027,52560,0,0,1,0,1
68555,150,18533,22129,52560,0,0,1,0,1
68556,150,18536,22452,52560,0,0,1,0,1
68557,150,18537,22386,52560,0,0,1,0,1
68558,150,18539,22432,52560,0,0,1,0,1
68559,150,18540,22787,52560,0,0,1,0,1
68560,150,18541,22590,52560,0,0,1,0,1
68561,150,18542,22628,52560,0,0,1,0,1
68562,150,18544,23033,52560,0,0,1,0,1
68563,150,18545,23132,52560,0,0,1,0,1
68564,150,18546,22935,52560,0,0,1,0,1
68565,150,18547,23253,52560,0,0,1,0,1
68566,150,18549,23170;23565;27047,52560,1,0,2,0,3
68567,150,18550,23705;24260,52560,0,0,2,0,2
68568,150,18551,23712;24131,52560,0,0,2,0,2
68569,150,18552,23567;23742;26024;26125;26583;26885,52560,1,3,2,0,6
68570,150,18553,23811;24065;25724;26135,52560,0,2,2,0,4
68571,150,18554,23842;24388,52560,0,0,2,0,2
68572,150,18555,23686;23856,52560,0,0,2,0,2
68573,150,18556,23778;23892,52560,0,0,2,0,2
68574,150,18557,23929;24440,52560,0,0,2,0,2
68575,150,18558,23632;23951;26592;26979,52560,1,1,2,0,4
68576,150,18560,24043;24105;26991,52560,1,0,2,0,3
68577,150,18561,24107;24133;27287,52560,1,0,2,0,3
68578,150,18562,24607,52560,0,0,1,0,1
68579,150,18563,24199;24502;27101;27306,52560,2,0,2,0,4
68580,150,18564,24207;24389;26715;27300,52560,1,1,2,0,4
68581,150,18565,23928;24231,52560,0,0,2,0,2
68582,150,18566,24247;24803;27117,52560,1,0,2,0,3
68583,150,18567,24252;24340;26335;26922,52560,1,1,2,0,4
68584,150,18568,24342;24500,52560,0,0,2,0,2
68585,150,18569,24343;24400,52560,0,0,2,0,2
68586,150,18570,23984;24381,52560,0,0,2,0,2
68587,150,18571,24410;24606;27314,52560,1,0,2,0,3
68588,150,18572,24417;24948,52560,0,0,2,0,2
68589,150,18573,24418;27003,52560,1,0,1,0,2
68590,150,18574,23887;24480;27305,52560,1,0,2,0,3
68591,150,18575,24498,52560,0,0,1,0,1
68592,150,18576,24499,52560,0,0,1,0,1
68593,150,18577,24508;24639;27106,52560,1,0,2,0,3
68594,150,18578,24600,52560,0,0,1,0,1
68595,150,18579,24572;24700;26610,52560,0,1,2,0,3
68596,150,18580,24586;25092;26817;27312,52560,1,1,2,0,4
68597,150,18581,24510;24642;26819;27015,52560,1,1,2,0,4
68598,150,18582,24554;24661;26929,52560,1,0,2,0,3
68599,150,18583,24688,52560,0,0,1,0,1
68600,150,18584,24566;24723,52560,0,0,2,0,2
68601,150,18585,24392;24745,52560,0,0,2,0,2
68602,150,18586,24762;24920;26935,52560,1,0,2,0,3
68603,150,18587,24615;24769,52560,0,0,2,0,2
68604,150,18588,24818,52560,0,0,1,0,1
68605,150,18589,20656,52925,0,0,1,0,1
68606,150,18591,20610;20618,52925,0,0,2,0,2
68607,150,18596,21583;21584,52925,0,0,2,0,2
68608,150,18597,21324;21474,52925,0,0,2,0,2
68609,150,18599,21154;21367,52925,0,0,2,0,2
68610,150,18601,21711;21724,52925,0,0,2,0,2
68611,150,18603,22140,52925,0,0,1,0,1
68612,150,18604,22161,52925,0,0,1,0,1
68613,150,18605,22588;22589,52925,0,0,2,0,2
68614,150,18606,22234,52925,0,0,1,0,1
68615,150,18607,22831,52925,0,0,1,0,1
68616,150,18608,22879,52925,0,0,1,0,1
68617,150,18609,23147;23445;26389;26568,52925,0,2,2,0,4
68618,150,18610,22908,52925,0,0,1,0,1
68619,150,18611,22922;23623;26873,52925,1,0,2,0,3
68620,150,18613,22644,52925,0,0,1,0,1
68621,150,18614,23245,52925,0,0,1,0,1
68622,150,18615,23254;23628,52925,0,0,2,0,2
68623,150,18616,23275,52925,0,0,1,0,1
68624,150,18617,23347;23597;26956,52925,1,0,2,0,3
68625,150,18618,23403,52925,0,0,1,0,1
68626,150,18619,23518,52925,0,0,1,0,1
68627,150,18621,23522,52925,0,0,1,0,1
68628,150,18622,23638;24022,52925,0,0,2,0,2
68629,150,18623,23644;24082;27081,52925,1,0,2,0,3
68630,150,18624,23775,52925,0,0,1,0,1
68631,150,18625,23707,52925,0,0,1,0,1
68632,150,18626,23710;24135;26993,52925,1,0,2,0,3
68633,150,18627,23711;23859,52925,0,0,2,0,2
68634,150,18628,23687;23741;26495;26775,52925,0,2,2,0,4
68635,150,18631,23784;26225,52925,0,1,1,0,2
68636,150,18632,23831;23948;27279,52925,1,0,2,0,3
68637,150,18633,23854;24306;26687;26972;27171,52925,2,1,2,0,5
68638,150,18634,23881;24102,52925,0,0,2,0,2
68639,150,18635,23807;23891,52925,0,0,2,0,2
68640,150,18636,23940;24250,52925,0,0,2,0,2
68641,150,18637,23976;24271,52925,0,0,2,0,2
68642,150,18639,23821;24028;26134,52925,0,1,2,0,3
68643,150,18640,23939;24052;26229;26329;26590;26693;26899;27278,52925,2,4,2,0,8
68644,150,18641,24222;24259,52925,0,0,2,0,2
68645,150,18642,23809;24093;26600,52925,0,1,2,0,3
68646,150,18643,23541,52925,0,0,1,0,1
68647,150,18644,24132;24464,52925,0,0,2,0,2
68648,150,18645,24151;24451;27097,52925,1,0,2,0,3
68649,150,18646,23812,52925,0,0,1,0,1
68650,150,18647,23997;24175;26032,52925,0,1,2,0,3
68651,150,18648,24263;24591,52925,0,0,2,0,2
68652,150,18649,24279;24383;26706,52925,0,1,2,0,3
68653,150,18650,24366;24513;26425,52925,0,1,2,0,3
68654,150,18651,24311;24705;26933,52925,1,0,2,0,3
68655,150,18652,24313;24403,52925,0,0,2,0,2
68656,150,18653,24345;24563;27103,52925,1,0,2,0,3
68657,150,18654,24355;24409;26810,52925,0,1,2,0,3
68658,150,18655,24394;24542;26337,52925,0,1,2,0,3
68659,150,18656,24454;24521;27205,52925,1,0,2,0,3
68660,150,18657,24455;24565;27202,52925,1,0,2,0,3
68661,150,18658,24474,52925,0,0,1,0,1
68662,150,18659,24568;24693,52925,0,0,2,0,2
68663,150,18660,24036;24143;27184;27288,52925,2,0,2,0,4
68664,150,18661,24490;24731,52925,0,0,2,0,2
68665,150,18662,24390;24506,52925,0,0,2,0,2
68666,150,18663,24233;24523;27206,52925,1,0,2,0,3
68667,150,18664,24532;24809;27118,52925,1,0,2,0,3
68668,150,18665,24535;24911,52925,0,0,2,0,2
68669,150,18666,24567;25047,52925,0,0,2,0,2
68670,150,18667,24625;25051,52925,0,0,2,0,2
68671,150,18668,24627;24945,52925,0,0,2,0,2
68672,150,18669,24630,52925,0,0,1,0,1
68673,150,18670,24640,52925,0,0,1,0,1
68674,150,18671,24359;24650;27093,52925,1,0,2,0,3
68675,150,18672,24653;24972,52925,0,0,2,0,2
68676,150,18673,24491;24715,52925,0,0,2,0,2
68677,150,18674,24727;25096,52925,0,0,2,0,2
68678,150,18675,24729;24749,52925,0,0,2,0,2
68679,150,18676,24759,52925,0,0,1,0,1
68680,150,18677,24662;24778;27317,52925,1,0,2,0,3
68681,150,18678,24780;25151,52925,0,0,2,0,2
68682,150,18679,24581;24786,52925,0,0,2,0,2
68683,150,18680,24595;24798,52925,0,0,2,0,2
68684,150,18681,24801;24804;26613,52925,0,1,2,0,3
68685,150,18682,24837;25045,52925,0,0,2,0,2
68686,150,18683,24852;24934,52925,0,0,2,0,2
68687,150,18684,24859;24928,52925,0,0,2,0,2
68688,150,18685,24562;24863,52925,0,0,2,0,2
68689,150,18686,24871;24978,52925,0,0,2,0,2
68690,150,18687,24709;24879,52925,0,0,2,0,2
68691,150,18688,24880;25208;27329,52925,1,0,2,0,3
68692,150,18689,24882;24985;27222,52925,1,0,2,0,3
68693,150,18690,24817;24888,52925,0,0,2,0,2
68694,150,18691,24896;24899,52925,0,0,2,0,2
68695,150,18692,24901;24973,52925,0,0,2,0,2
68696,150,18693,24915,52925,0,0,1,0,1
68697,150,18694,20116,53290,0,0,0,1,1
68698,150,18695,20632,53290,0,0,1,0,1
68699,150,18696,20743,53290,0,0,1,0,1
68700,150,18697,20765;21120,53290,0,0,2,0,2
68701,150,18698,20770,53290,0,0,1,0,1
68702,150,18699,20698,53290,0,0,1,0,1
68703,150,18702,20960,53290,0,0,1,0,1
68704,150,18704,21193;21548,53290,0,0,2,0,2
68705,150,18705,21160,53290,0,0,1,0,1
68706,150,18707,21405,53290,0,0,1,0,1
68707,150,18709,21099,53290,0,0,1,0,1
68708,150,18710,21227;21385,53290,0,0,2,0,2
68709,150,18717,21472,53290,0,0,1,0,1
68710,150,18720,21778,53290,0,0,1,0,1
68711,150,18722,21784,53290,0,0,1,0,1
68712,150,18724,22086,53290,0,0,1,0,1
68713,150,18728,22684;23020,53290,0,0,2,0,2
68714,150,18729,22643,53290,0,0,1,0,1
68715,150,18730,22718,53290,0,0,1,0,1
68716,150,18731,22872,53290,0,0,1,0,1
68717,150,18732,22891,53290,0,0,1,0,1
68718,150,18734,23858;26688;26974,53290,1,1,1,0,3
68719,150,18736,22896;23035,53290,0,0,2,0,2
68720,150,18737,23480;23666;27154,53290,1,0,2,0,3
68721,150,18738,22832,53290,0,0,1,0,1
68722,150,18740,23338,53290,0,0,1,0,1
68723,150,18741,23229,53290,0,0,1,0,1
68724,150,18742,23797,53290,0,0,1,0,1
68725,150,18743,23818;24261;27090,53290,1,0,2,0,3
68726,150,18744,23905;23912,53290,0,0,2,0,2
68727,150,18745,23729;23925;26881;27054;27161,53290,3,0,2,0,5
68728,150,18747,24005,53290,0,0,1,0,1
68729,150,18748,24011;24287;26806,53290,0,1,2,0,3
68730,150,18749,24243,53290,0,0,1,0,1
68731,150,18750,24069,53290,0,0,1,0,1
68732,150,18751,24089,53290,0,0,1,0,1
68733,150,18752,23872;24097;25919;26409;26788,53290,0,3,2,0,5
68734,150,18753,23770;24051;26596;27181,53290,1,1,2,0,4
68735,150,18754,24189,53290,0,0,1,0,1
68736,150,18755,23922;24240;26421,53290,0,1,2,0,3
68737,150,18756,24270;24636;26719;27014,53290,1,1,2,0,4
68738,150,18757,24325;24584,53290,0,0,2,0,2
68739,150,18758,24220;24353,53290,0,0,2,0,2
68740,150,18759,24224;24358;26606,53290,0,1,2,0,3
68741,150,18760,24367;24673,53290,0,0,2,0,2
68742,150,18761,24375;24379,53290,0,0,2,0,2
68743,150,18762,24385;24536,53290,0,0,2,0,2
68744,150,18763,24391;26925,53290,1,0,1,0,2
68745,150,18764,24401;24519,53290,0,0,2,0,2
68746,150,18765,24115,53290,0,0,1,0,1
68747,150,18766,24443;24905,53290,0,0,2,0,2
68748,150,18767,24478;24894;27019,53290,1,0,2,0,3
68749,150,18768,24512;24702,53290,0,0,2,0,2
68750,150,18769,24461;24515,53290,0,0,2,0,2
68751,150,18770,24516,53290,0,0,1,0,1
68752,150,18771,24161;24569,53290,0,0,2,0,2
68753,150,18772,24402;24618;27315,53290,1,0,2,0,3
68754,150,18773,24634;24674;26611,53290,0,1,2,0,3
68755,150,18774,24660;24840,53290,0,0,2,0,2
68756,150,18775,24675;24714;26722,53290,0,1,2,0,3
68757,150,18776,24682;25080,53290,0,0,2,0,2
68758,150,18777,24686;24998,53290,0,0,2,0,2
68759,150,18778,24564;24699,53290,0,0,2,0,2
68760,150,18779,24677;24711,53290,0,0,2,0,2
68761,150,18780,24698;24713;26720,53290,0,1,2,0,3
68762,150,18781,24719;27316,53290,1,0,1,0,2
68763,150,18782,24736;25005;27125,53290,1,0,2,0,3
68764,150,18783,24685;24750;27109,53290,1,0,2,0,3
68765,150,18784,24761;24874,53290,0,0,2,0,2
68766,150,18785,24767;25043,53290,0,0,2,0,2
68767,150,18786,24886,53290,0,0,1,0,1
68768,150,18787,24764;24795,53290,0,0,2,0,2
68769,150,18788,24812;24827;27119,53290,1,0,2,0,3
68770,150,18789,24813;25121,53290,0,0,2,0,2
68771,150,18790,24658;24833,53290,0,0,2,0,2
68772,150,18791,25216,53290,0,0,1,0,1
68773,150,18792,24876;25180,53290,0,0,2,0,2
68774,150,18793,24789;24890,53290,0,0,2,0,2
68775,150,18794,25260,53290,0,0,1,0,1
68776,150,18795,24486;24909,53290,0,0,2,0,2
68777,150,18796,24898;24964,53290,0,0,2,0,2
68778,150,18797,24858;24977,53290,0,0,2,0,2
68779,150,18798,24992;25199,53290,0,0,2,0,2
68780,150,18799,25001,53290,0,0,1,0,1
68781,150,18800,24980;25013,53290,0,0,2,0,2
68782,150,18801,20740,53655,0,0,1,0,1
68783,150,18802,20567;20931,53655,0,0,2,0,2
68784,150,18803,20338,53655,0,0,0,1,1
68785,150,18804,20808,53655,0,0,1,0,1
68786,150,18805,21081,53655,0,0,1,0,1
68787,150,18806,21159,53655,0,0,1,0,1
68788,150,18808,21563,53655,0,0,1,0,1
68789,150,18810,21030;21104,53655,0,0,2,0,2
68790,150,18811,21501,53655,0,0,1,0,1
68791,150,18812,21505,53655,0,0,1,0,1
68792,150,18817,21761,53655,0,0,1,0,1
68793,150,18819,21948,53655,0,0,1,0,1
68794,150,18821,22610,53655,0,0,1,0,1
68795,150,18823,22928,53655,0,0,1,0,1
68796,150,18824,22898,53655,0,0,1,0,1
68797,150,18825,22986,53655,0,0,1,0,1
68798,150,18827,22664,53655,0,0,1,0,1
68799,150,18828,23082,53655,0,0,1,0,1
68800,150,18829,23255,53655,0,0,1,0,1
68801,150,18830,23438;23840;26128,53655,0,1,2,0,3
68802,150,18831,23290;23663;26319;26772;26875;26960;27050,53655,3,2,2,0,7
68803,150,18833,23517,53655,0,0,1,0,1
68804,150,18834,23555;23959;26901,53655,1,0,2,0,3
68805,150,18835,23667;23694;27155,53655,1,0,2,0,3
68806,150,18836,23700;26880,53655,1,0,1,0,2
68807,150,18837,22932,53655,0,0,1,0,1
68808,150,18838,23652,53655,0,0,1,0,1
68809,150,18839,23317,53655,0,0,1,0,1
68810,150,18841,23956,53655,0,0,1,0,1
68811,150,18842,24000;24109,53655,0,0,2,0,2
68812,150,18843,23772;24009;27056,53655,1,0,2,0,3
68813,150,18844,23992;24147;26913,53655,1,0,2,0,3
68814,150,18846,24284;24505,53655,0,0,2,0,2
68815,150,18847,24296,53655,0,0,1,0,1
68816,150,18849,24305,53655,0,0,1,0,1
68817,150,18850,24393;25003,53655,0,0,2,0,2
68818,150,18851,24419;24783,53655,0,0,2,0,2
68819,150,18852,24357;24422;27092,53655,1,0,2,0,3
68820,150,18853,24185;24429;26812,53655,0,1,2,0,3
68821,150,18854,24472;24624;26429,53655,0,1,2,0,3
68822,150,18855,24503;24770,53655,0,0,2,0,2
68823,150,18856,24433;24601,53655,0,0,2,0,2
68824,150,18857,24446;24509;27307,53655,1,0,2,0,3
68825,150,18858,24307,53655,0,0,1,0,1
68826,150,18859,24610;24741,53655,0,0,2,0,2
68827,150,18860,24638;25187;27328,53655,1,0,2,0,3
68828,150,18861,24495;24717;26723,53655,0,1,2,0,3
68829,150,18862,24748;24796,53655,0,0,2,0,2
68830,150,18863,24603;24753,53655,0,0,2,0,2
68831,150,18864,24806;25088;27323,53655,1,0,2,0,3
68832,150,18865,24814;25010,53655,0,0,2,0,2
68833,150,18866,24575;24829,53655,0,0,2,0,2
68834,150,18867,24832;24861,53655,0,0,2,0,2
68835,150,18868,25166,53655,0,0,1,0,1
68836,150,18870,24877;24930,53655,0,0,2,0,2
68837,150,18871,24919;25156;27324,53655,1,0,2,0,3
68838,150,18872,24738;24931,53655,0,0,2,0,2
68839,150,18873,24944;24991,53655,0,0,2,0,2
68840,150,18874,24904;24946;26934;27123,53655,2,0,2,0,4
68841,150,18875,24955;25110,53655,0,0,2,0,2
68842,150,18876,24963;25168,53655,0,0,2,0,2
68843,150,18877,24989;27223,53655,1,0,1,0,2
68844,150,18878,25142;25221,53655,0,0,2,0,2
68845,150,18879,25012;25332,53655,0,0,2,0,2
68846,150,18880,25022,53655,0,0,1,0,1
68847,150,18881,25024;25137,53655,0,0,2,0,2
68848,150,18882,25060;25276,53655,0,0,2,0,2
68849,150,18883,25061;25155;27228,53655,1,0,2,0,3
68850,150,18884,25063;25136,53655,0,0,2,0,2
68851,150,18885,24924;25071;27126,53655,1,0,2,0,3
68852,150,18886,25077;25283,53655,0,0,2,0,2
68853,150,18887,25078;27226,53655,1,0,1,0,2
68854,150,18888,25091;25178,53655,0,0,2,0,2
68855,150,18889,25101;25280,53655,0,0,2,0,2
68856,150,18891,20935,54020,0,0,1,0,1
68857,150,18892,20828,54020,0,0,1,0,1
68858,150,18894,20566,54020,0,0,1,0,1
68859,150,18895,20679,54020,0,0,1,0,1
68860,150,18896,21047;21395,54020,0,0,2,0,2
68861,150,18897,21346,54020,0,0,1,0,1
68862,150,18898,20815,54020,0,0,1,0,1
68863,150,18899,21698,54020,0,0,1,0,1
68864,150,18900,21810,54020,0,0,1,0,1
68865,150,18901,21771,54020,0,0,1,0,1
68866,150,18903,21804,54020,0,0,1,0,1
68867,150,18904,21898,54020,0,0,1,0,1
68868,150,18905,21666,54020,0,0,1,0,1
68869,150,18906,21969,54020,0,0,1,0,1
68870,150,18907,22021,54020,0,0,1,0,1
68871,150,18908,22132,54020,0,0,1,0,1
68872,150,18909,21798,54020,0,0,1,0,1
68873,150,18910,22000,54020,0,0,1,0,1
68874,150,18911,22329,54020,0,0,1,0,1
68875,150,18912,22369,54020,0,0,1,0,1
68876,150,18914,22439,54020,0,0,1,0,1
68877,150,18915,22494,54020,0,0,1,0,1
68878,150,18916,22570,54020,0,0,1,0,1
68879,150,18917,22755,54020,0,0,1,0,1
68880,150,18918,22615,54020,0,0,1,0,1
68881,150,18919,22324,54020,0,0,1,0,1
68882,150,18921,22942,54020,0,0,1,0,1
68883,150,18922,23156;23586,54020,0,0,2,0,2
68884,150,18924,22539,54020,0,0,1,0,1
68885,150,18925,22779,54020,0,0,1,0,1
68886,150,18926,23149,54020,0,0,1,0,1
68887,150,18929,23390,54020,0,0,1,0,1
68888,150,18930,23396,54020,0,0,1,0,1
68889,150,18931,23674,54020,0,0,1,0,1
68890,150,18932,23695,54020,0,0,1,0,1
68891,150,18933,23573,54020,0,0,1,0,1
68892,150,18934,23759,54020,0,0,1,0,1
68893,150,18935,23635,54020,0,0,1,0,1
68894,150,18936,23866,54020,0,0,1,0,1
68895,150,18937,23484;23924;25517;26410,54020,0,1,3,0,4
68896,150,18939,23813,54020,0,0,1,0,1
68897,150,18940,23915;24344,54020,0,0,2,0,2
68898,150,18941,24119;24124;26417;26911,54020,1,1,2,0,4
68899,150,18942,24158;24364;26424,54020,0,1,2,0,3
68900,150,18943,24194;24204,54020,0,0,2,0,2
68901,150,18944,24197;24908,54020,0,0,2,0,2
68902,150,18945,24056;24456;27004;27203,54020,2,0,2,0,4
68903,150,18946,24059;24274;27091;27192,54020,2,0,2,0,4
68904,150,18947,24300;24308,54020,0,0,2,0,2
68905,150,18948,24239;24382,54020,0,0,2,0,2
68906,150,18949,24387;24537;27009,54020,1,0,2,0,3
68907,150,18950,24496;24545,54020,0,0,2,0,2
68908,150,18951,24479;24593;27007,54020,1,0,2,0,3
68909,150,18952,24599;25141,54020,0,0,2,0,2
68910,150,18953,24608;25042,54020,0,0,2,0,2
68911,150,18954,24644;24926,54020,0,0,2,0,2
68912,150,18955,24689;24825,54020,0,0,2,0,2
68913,150,18956,24692;25055,54020,0,0,2,0,2
68914,150,18957,24696;25089,54020,0,0,2,0,2
68915,150,18958,24703;24757;27110,54020,1,0,2,0,3
68916,150,18959,24707;24935,54020,0,0,2,0,2
68917,150,18960,24708;24743;26724;27016,54020,1,1,2,0,4
68918,150,18961,24732;24887,54020,0,0,2,0,2
68919,150,18962,24666;24844,54020,0,0,2,0,2
68920,150,18963,24873;24947,54020,0,0,2,0,2
68921,150,18964,24952;25244,54020,0,0,2,0,2
68922,150,18965,24737;24957,54020,0,0,2,0,2
68923,150,18966,24965;25081,54020,0,0,2,0,2
68924,150,18967,24971;25157,54020,0,0,2,0,2
68925,150,18968,24987;25284,54020,0,0,2,0,2
68926,150,18969,24993;25210,54020,0,0,2,0,2
68927,150,18970,24994,54020,0,0,1,0,1
68928,150,18971,24884;25009,54020,0,0,2,0,2
68929,150,18972,25014;25324,54020,0,0,2,0,2
68930,150,18973,24787;25015;27224,54020,1,0,2,0,3
68931,150,18974,25020,54020,0,0,1,0,1
68932,150,18975,24831;25056,54020,0,0,2,0,2
68933,150,18976,25073;25094,54020,0,0,2,0,2
68934,150,18977,24918;25075,54020,0,0,2,0,2
68935,150,18978,25090;25127,54020,0,0,2,0,2
68936,150,18979,25128;25182,54020,0,0,2,0,2
68937,150,18980,25129,54020,0,0,1,0,1
68938,150,18981,25074;25144,54020,0,0,2,0,2
68939,150,18982,25181;25354,54020,0,0,2,0,2
68940,150,18983,24967;25193,54020,0,0,2,0,2
68941,150,18984,25203;25222,54020,0,0,2,0,2
68942,150,18985,25206;25225,54020,0,0,2,0,2
68943,150,18986,20579,54385,0,0,1,0,1
68944,150,18987,20943,54385,0,0,1,0,1
68945,150,18988,20969,54385,0,0,1,0,1
68946,150,18989,20970,54385,0,0,1,0,1
68947,150,18990,20819,54385,0,0,1,0,1
68948,150,18992,21061,54385,0,0,1,0,1
68949,150,18993,21185,54385,0,0,1,0,1
68950,150,18994,21197,54385,0,0,1,0,1
68951,150,18995,20886,54385,0,0,1,0,1
68952,150,18996,21535,54385,0,0,1,0,1
68953,150,18997,21309,54385,0,0,1,0,1
68954,150,18998,21275,54385,0,0,1,0,1
68955,150,18999,21727,54385,0,0,1,0,1
68956,150,19000,21826,54385,0,0,1,0,1
68957,150,19001,21457,54385,0,0,1,0,1
68958,150,19003,21914,54385,0,0,1,0,1
68959,150,19004,22179,54385,0,0,1,0,1
68960,150,19005,22226,54385,0,0,1,0,1
68961,150,19008,22300,54385,0,0,1,0,1
68962,150,19009,22595,54385,0,0,1,0,1
68963,150,19010,22600,54385,0,0,1,0,1
68964,150,19012,22924,54385,0,0,1,0,1
68965,150,19013,22358,54385,0,0,1,0,1
68966,150,19014,23039,54385,0,0,1,0,1
68967,150,19015,23057,54385,0,0,1,0,1
68968,150,19016,23180;23214;26466,54385,0,1,2,0,3
68969,150,19018,22766,54385,0,0,1,0,1
68970,150,19019,23234,54385,0,0,1,0,1
68971,150,19020,23238,54385,0,0,1,0,1
68972,150,19021,23117,54385,0,0,1,0,1
68973,150,19022,23404,54385,0,0,1,0,1
68974,150,19024,23529,54385,0,0,1,0,1
68975,150,19025,23512;23536;25515;25815;26663;27144;27251,54385,2,2,3,0,7
68976,150,19027,23397,54385,0,0,1,0,1
68977,150,19028,23637;26022,54385,0,1,1,0,2
68978,150,19029,23593,54385,0,0,1,0,1
68979,150,19030,23626;23907;26029;26977,54385,1,1,2,0,4
68980,150,19031,23935;24096;26907,54385,1,0,2,0,3
68981,150,19032,23946;24138,54385,0,0,2,0,2
68982,150,19033,23968,54385,0,0,1,0,1
68983,150,19034,24106;24304,54385,0,0,2,0,2
68984,150,19035,24330;24339;26508,54385,0,1,2,0,3
68985,150,19036,24412;24438;27301,54385,1,0,2,0,3
68986,150,19037,24441;24582;27013,54385,1,0,2,0,3
68987,150,19038,24447;24867,54385,0,0,2,0,2
68988,150,19039,24522;24676,54385,0,0,2,0,2
68989,150,19040,24543,54385,0,0,1,0,1
68990,150,19041,24298;24557,54385,0,0,2,0,2
68991,150,19042,24395;24571;27209,54385,1,0,2,0,3
68992,150,19043,24604,54385,0,0,1,0,1
68993,150,19044,24605;25038,54385,0,0,2,0,2
68994,150,19045,24623;24925,54385,0,0,2,0,2
68995,150,19046,24114,54385,0,0,1,0,1
68996,150,19047,24413;24678;27108,54385,1,0,2,0,3
68997,150,19048,24758;25152,54385,0,0,2,0,2
68998,150,19049,24470;24823;27120,54385,1,0,2,0,3
68999,150,19050,24773;24824,54385,0,0,2,0,2
69000,150,19051,24777;24839;27121,54385,1,0,2,0,3
69001,150,19052,24706;24843,54385,0,0,2,0,2
69002,150,19053,24848,54385,0,0,1,0,1
69003,150,19054,24875;25430,54385,0,0,2,0,2
69004,150,19055,24881;24942,54385,0,0,2,0,2
69005,150,19056,24914;24922;27220,54385,1,0,2,0,3
69006,150,19057,25037,54385,0,0,1,0,1
69007,150,19058,24936;24988;26829,54385,0,1,2,0,3
69008,150,19059,25026;25262,54385,0,0,2,0,2
69009,150,19060,24865;24929,54385,0,0,2,0,2
69010,150,19061,25132;25201,54385,0,0,2,0,2
69011,150,19062,25067;25158,54385,0,0,2,0,2
69012,150,19063,25163;25209,54385,0,0,2,0,2
69013,150,19064,24811;25169,54385,0,0,2,0,2
69014,150,19065,25211;25521,54385,0,0,2,0,2
69015,150,19066,25238;25477,54385,0,0,2,0,2
69016,150,19067,25250;25543,54385,0,0,2,0,2
69017,150,19068,25255;25275,54385,0,0,2,0,2
69018,150,19069,24907,54385,0,0,1,0,1
69019,150,19070,25107;25265,54385,0,0,2,0,2
69020,150,19071,25299;25478,54385,0,0,2,0,2
69021,150,19072,20719,54750,0,0,1,0,1
69022,150,19073,21086,54750,0,0,1,0,1
69023,150,19074,21140,54750,0,0,1,0,1
69024,150,19075,20913,54750,0,0,1,0,1
69025,150,19076,20925,54750,0,0,1,0,1
69026,150,19077,20918,54750,0,0,1,0,1
69027,150,19078,21006,54750,0,0,1,0,1
69028,150,19080,21573,54750,0,0,1,0,1
69029,150,19081,21856,54750,0,0,1,0,1
69030,150,19082,22114,54750,0,0,1,0,1
69031,150,19083,22120,54750,0,0,1,0,1
69032,150,19084,22121,54750,0,0,1,0,1
69033,150,19085,22183,54750,0,0,1,0,1
69034,150,19086,21885,54750,0,0,1,0,1
69035,150,19087,22201,54750,0,0,1,0,1
69036,150,19088,21918,54750,0,0,1,0,1
69037,150,19089,22287,54750,0,0,1,0,1
69038,150,19090,21742,54750,0,0,1,0,1
69039,150,19091,22175,54750,0,0,1,0,1
69040,150,19092,22559,54750,0,0,1,0,1
69041,150,19093,22046,54750,0,0,1,0,1
69042,150,19094,22111,54750,0,0,1,0,1
69043,150,19095,22706,54750,0,0,1,0,1
69044,150,19096,22729,54750,0,0,1,0,1
69045,150,19097,22713,54750,0,0,1,0,1
69046,150,19098,22865,54750,0,0,1,0,1
69047,150,19099,22925,54750,0,0,1,0,1
69048,150,19100,22950,54750,0,0,1,0,1
69049,150,19101,22580,54750,0,0,1,0,1
69050,150,19102,23136,54750,0,0,1,0,1
69051,150,19103,23231,54750,0,0,1,0,1
69052,150,19104,23362,54750,0,0,1,0,1
69053,150,19105,23434,54750,0,0,1,0,1
69054,150,19106,23461,54750,0,0,1,0,1
69055,150,19107,23504,54750,0,0,1,0,1
69056,150,19108,23550;23605;25912;26483,54750,0,2,2,0,4
69057,150,19109,23420,54750,0,0,1,0,1
69058,150,19110,23682;23841;27169,54750,1,0,2,0,3
69059,150,19111,23749;26886,54750,1,0,1,0,2
69060,150,19112,23871;24264;26603;27190,54750,1,1,2,0,4
69061,150,19113,23961;24492,54750,0,0,2,0,2
69062,150,19114,23975,54750,0,0,1,0,1
69063,150,19115,24004,54750,0,0,1,0,1
69064,150,19116,23852,54750,0,0,1,0,1
69065,150,19117,23808,54750,0,0,1,0,1
69066,150,19118,23796,54750,0,0,1,0,1
69067,150,19119,24061;24071;26598,54750,0,1,2,0,3
69068,150,19120,24014,54750,0,0,1,0,1
69069,150,19121,24110;24776;26823,54750,0,1,2,0,3
69070,150,19122,23865,54750,0,0,1,0,1
69071,150,19123,24269;24578,54750,0,0,2,0,2
69072,150,19124,24062,54750,0,0,1,0,1
69073,150,19125,24075,54750,0,0,1,0,1
69074,150,19126,24365,54750,0,0,1,0,1
69075,150,19127,24384;24631,54750,0,0,2,0,2
69076,150,19128,24273;24552;27102,54750,1,0,2,0,3
69077,150,19129,24559;24785,54750,0,0,2,0,2
69078,150,19130,24588,54750,0,0,1,0,1
69079,150,19131,24524;24657,54750,0,0,2,0,2
69080,150,19132,24746;24790,54750,0,0,2,0,2
69081,150,19133,24272;24752;27114;27213,54750,2,0,2,0,4
69082,150,19134,24794,54750,0,0,1,0,1
69083,150,19135,24869;26826;27218,54750,1,1,1,0,3
69084,150,19136,24775,54750,0,0,1,0,1
69085,150,19137,24921;25215,54750,0,0,2,0,2
69086,150,19138,24938;25532,54750,0,0,2,0,2
69087,150,19139,24959;25032,54750,0,0,2,0,2
69088,150,19140,24792;24962,54750,0,0,2,0,2
69089,150,19141,24975;25432,54750,0,0,2,0,2
69090,150,19142,25019;25109,54750,0,0,2,0,2
69091,150,19143,25030;25410;27232,54750,1,0,2,0,3
69092,150,19144,25035;25645,54750,0,1,1,0,2
69093,150,19145,25041;25370,54750,0,0,2,0,2
69094,150,19146,25054;25569,54750,0,0,2,0,2
69095,150,19147,25082;25282,54750,0,0,2,0,2
69096,150,19148,25084;25099,54750,0,0,2,0,2
69097,150,19149,25086;25105;27322,54750,1,0,2,0,3
69098,150,19150,24816;25117,54750,0,0,2,0,2
69099,150,19151,25036;25131,54750,0,0,2,0,2
69100,150,19152,25143,54750,0,0,1,0,1
69101,150,19153,25146;25235,54750,0,0,2,0,2
69102,150,19154,25149;25470,54750,0,0,2,0,2
69103,150,19155,25165,54750,0,0,1,0,1
69104,150,19156,25174;25271,54750,0,0,2,0,2
69105,150,19157,25172;25176,54750,0,0,2,0,2
69106,150,19158,25189;25289,54750,0,0,2,0,2
69107,150,19159,25223;25682,54750,0,1,1,0,2
69108,150,19160,25230;25424,54750,0,0,2,0,2
69109,150,19161,25232;25434,54750,0,0,2,0,2
69110,150,19162,25236;25295,54750,0,0,2,0,2
69111,150,19163,25245;25722,54750,0,1,1,0,2
69112,150,19164,25247;25373,54750,0,0,2,0,2
69113,150,19165,25277;25652,54750,0,1,1,0,2
69114,150,19166,24883;25303;27330,54750,1,0,2,0,3
69115,150,19167,25305;25433,54750,0,0,2,0,2
69116,150,19168,25313;25611,54750,0,0,2,0,2
69117,150,19169,24995;25314;27230,54750,1,0,2,0,3
69118,150,19170,25328;25484,54750,0,0,2,0,2
69119,150,19171,25329,54750,0,0,1,0,1
69120,150,19172,25334;25387;27332,54750,1,0,2,0,3
69121,150,19173,25340;25719,54750,0,1,1,0,2
69122,150,19174,25364;25551,54750,0,0,2,0,2
69123,150,19175,25365;25549,54750,0,0,2,0,2
69124,150,19176,25115;25376,54750,0,0,2,0,2
69125,150,19177,25394;25638,54750,0,1,1,0,2
69126,150,19178,25066;25397,54750,0,0,2,0,2
69127,150,19179,25198;25398,54750,0,0,2,0,2
69128,150,19180,25395;25400,54750,0,0,2,0,2
69129,160,8491,21185;21300,16790,0,0,0,2,2
69130,160,9443,18344;18756,20440,0,0,0,2,2
69131,160,9576,19314,20805,0,0,0,1,1
69132,160,9663,18938,21170,0,0,0,1,1
69133,160,9754,19627;19919,21535,0,0,0,2,2
69134,160,9870,19149,21900,0,0,0,1,1
69135,160,9876,18580,21900,0,0,0,1,1
69136,160,10109,19910,22630,0,0,0,1,1
69137,160,10497,19848;19892,24090,0,0,0,2,2
69138,160,10845,20331,25185,0,0,0,1,1
69139,160,11068,20293,25915,0,0,0,1,1
69140,160,11158,19913;19965,26280,0,0,0,2,2
69141,160,11234,20258;20603;20647,26280,0,0,0,3,3
69142,160,11295,20162;20236,26645,0,0,0,2,2
69143,160,11468,20433,27010,0,0,0,1,1
69144,160,11558,23566;23962;26902;27281,27375,0,2,2,0,4
69145,160,11583,20460,27375,0,0,0,1,1
69146,160,11926,17438,28470,0,0,0,1,1
69147,160,11929,20771;24628;27710,28470,0,1,1,1,3
69148,160,12154,20475,29200,0,0,0,1,1
69149,160,12160,17616,29200,0,0,0,1,1
69150,160,12164,17505,29200,0,0,0,1,1
69151,160,12251,17522,29565,0,0,0,1,1
69152,160,12271,21772;26726,29565,0,1,1,0,2
69153,160,12292,17656,29565,0,0,0,1,1
69154,160,12359,17445,29930,0,0,0,1,1
69155,160,12384,17723,29930,0,0,0,1,1
69156,160,12390,17801,29930,0,0,0,1,1
69157,160,12467,17547,30295,0,0,0,1,1
69158,160,12480,17377,30295,0,0,0,1,1
69159,160,12486,18262,30295,0,0,0,1,1
69160,160,12490,18160,30295,0,0,0,1,1
69161,160,12492,18235,30295,0,0,0,1,1
69162,160,12507,18197,30295,0,0,0,1,1
69163,160,12596,17882,30660,0,0,0,1,1
69164,160,12622,21205,30660,0,0,0,1,1
69165,160,12697,18190,31025,0,0,0,1,1
69166,160,12705,18005;21228,31025,0,0,0,2,2
69167,160,12709,17889,31025,0,0,0,1,1
69168,160,12714,18274,31025,0,0,0,1,1
69169,160,12721,18163,31025,0,0,0,1,1
69170,160,12812,18277,31390,0,0,0,1,1
69171,160,12813,18427,31390,0,0,0,1,1
69172,160,12816,17917,31390,0,0,0,1,1
69173,160,12818,18259,31390,0,0,0,1,1
69174,160,12822,18405,31390,0,0,0,1,1
69175,160,12826,18398,31390,0,0,0,1,1
69176,160,12827,18267,31390,0,0,0,1,1
69177,160,12834,18401,31390,0,0,0,1,1
69178,160,12837,18725,31390,0,0,0,1,1
69179,160,12894,18328,31755,0,0,0,1,1
69180,160,12907,18214,31755,0,0,0,1,1
69181,160,12910,18690,31755,0,0,0,1,1
69182,160,12912,17995,31755,0,0,0,1,1
69183,160,12913,17358,31755,0,0,0,1,1
69184,160,12914,18241,31755,0,0,0,1,1
69185,160,12915,18044,31755,0,0,0,1,1
69186,160,12916,18507,31755,0,0,0,1,1
69187,160,12917,18171,31755,0,0,0,1,1
69188,160,12918,18085,31755,0,0,0,1,1
69189,160,12921,18389,31755,0,0,0,1,1
69190,160,12923,17977,31755,0,0,0,1,1
69191,160,12932,18284,31755,0,0,0,1,1
69192,160,12933,18041,31755,0,0,0,1,1
69193,160,12937,18346,31755,0,0,0,1,1
69194,160,12938,18347;18381,31755,0,0,0,2,2
69195,160,12995,17936,32120,0,0,0,1,1
69196,160,13003,17749,32120,0,0,0,1,1
69197,160,13005,17797,32120,0,0,0,1,1
69198,160,13011,18397,32120,0,0,0,1,1
69199,160,13012,18486,32120,0,0,0,1,1
69200,160,13015,18561,32120,0,0,0,1,1
69201,160,13016,18142,32120,0,0,0,1,1
69202,160,13018,18670,32120,0,0,0,1,1
69203,160,13022,18499,32120,0,0,0,1,1
69204,160,13024,18587,32120,0,0,0,1,1
69205,160,13025,18282,32120,0,0,0,1,1
69206,160,13026,18286,32120,0,0,0,1,1
69207,160,13029,17963,32120,0,0,0,1,1
69208,160,13030,18729,32120,0,0,0,1,1
69209,160,13033,18452;18550,32120,0,0,0,2,2
69210,160,13035,18461,32120,0,0,0,1,1
69211,160,13042,18663,32120,0,0,0,1,1
69212,160,13106,18027,32485,0,0,0,1,1
69213,160,13116,20885,32485,0,0,0,1,1
69214,160,13117,18651,32485,0,0,0,1,1
69215,160,13118,18156,32485,0,0,0,1,1
69216,160,13119,18076,32485,0,0,0,1,1
69217,160,13120,17941,32485,0,0,0,1,1
69218,160,13121,18222,32485,0,0,0,1,1
69219,160,13123,18519;18749,32485,0,0,0,2,2
69220,160,13127,18319,32485,0,0,0,1,1
69221,160,13141,18783,32485,0,0,0,1,1
69222,160,13142,18738,32485,0,0,0,1,1
69223,160,13143,18698,32485,0,0,0,1,1
69224,160,13144,18867,32485,0,0,0,1,1
69225,160,13205,17802,32850,0,0,0,1,1
69226,160,13210,18562,32850,0,0,0,1,1
69227,160,13212,18565,32850,0,0,0,1,1
69228,160,13217,18353,32850,0,0,0,1,1
69229,160,13218,18655,32850,0,0,0,1,1
69230,160,13225,18278,32850,0,0,0,1,1
69231,160,13230,18361,32850,0,0,0,1,1
69232,160,13232,18417,32850,0,0,0,1,1
69233,160,13235,18435,32850,0,0,0,1,1
69234,160,13236,18864,32850,0,0,0,1,1
69235,160,13238,18597,32850,0,0,0,1,1
69236,160,13241,18301,32850,0,0,0,1,1
69237,160,13244,19065,32850,0,0,0,1,1
69238,160,13245,18971,32850,0,0,0,1,1
69239,160,13249,18716,32850,0,0,0,1,1
69240,160,13254,18465,32850,0,0,0,1,1
69241,160,13255,18490,32850,0,0,0,1,1
69242,160,13308,18392,33215,0,0,0,1,1
69243,160,13309,18128;22887,33215,0,0,1,1,2
69244,160,13313,17948,33215,0,0,0,1,1
69245,160,13322,18064;18510,33215,0,0,0,2,2
69246,160,13326,18649,33215,0,0,0,1,1
69247,160,13328,18000,33215,0,0,0,1,1
69248,160,13329,17945,33215,0,0,0,1,1
69249,160,13331,18252,33215,0,0,0,1,1
69250,160,13334,18539,33215,0,0,0,1,1
69251,160,13337,19055,33215,0,0,0,1,1
69252,160,13343,18897,33215,0,0,0,1,1
69253,160,13344,18074,33215,0,0,0,1,1
69254,160,13346,18433,33215,0,0,0,1,1
69255,160,13347,19027,33215,0,0,0,1,1
69256,160,13349,18387;18513,33215,0,0,0,2,2
69257,160,13350,19051,33215,0,0,0,1,1
69258,160,13354,18678,33215,0,0,0,1,1
69259,160,13357,18704,33215,0,0,0,1,1
69260,160,13360,19183,33215,0,0,0,1,1
69261,160,13364,18787,33215,0,0,0,1,1
69262,160,13365,19121,33215,0,0,0,1,1
69263,160,13368,18984,33215,0,0,0,1,1
69264,160,13369,18845,33215,0,0,0,1,1
69265,160,13372,19044,33215,0,0,0,1,1
69266,160,13428,17970;18351,33580,0,0,0,2,2
69267,160,13434,17993,33580,0,0,0,1,1
69268,160,13441,18470,33580,0,0,0,1,1
69269,160,13442,18520;18583,33580,0,0,0,2,2
69270,160,13445,18919,33580,0,0,0,1,1
69271,160,13446,18407,33580,0,0,0,1,1
69272,160,13447,18360,33580,0,0,0,1,1
69273,160,13452,19291,33580,0,0,0,1,1
69274,160,13453,18559,33580,0,0,0,1,1
69275,160,13454,18434;18879,33580,0,0,0,2,2
69276,160,13459,18631,33580,0,0,0,1,1
69277,160,13461,19141,33580,0,0,0,1,1
69278,160,13462,18577,33580,0,0,0,1,1
69279,160,13464,19064,33580,0,0,0,1,1
69280,160,13467,18757;18894,33580,0,0,0,2,2
69281,160,13470,18815,33580,0,0,0,1,1
69282,160,13471,19321,33580,0,0,0,1,1
69283,160,13473,19210,33580,0,0,0,1,1
69284,160,13478,18912;19004,33580,0,0,0,2,2
69285,160,13548,18380,33945,0,0,0,1,1
69286,160,13550,18325,33945,0,0,0,1,1
69287,160,13551,18672,33945,0,0,0,1,1
69288,160,13555,19129,33945,0,0,0,1,1
69289,160,13557,18589;18652,33945,0,0,0,2,2
69290,160,13559,18753,33945,0,0,0,1,1
69291,160,13560,22550;22921;26086;26280;26736,33945,0,1,4,0,5
69292,160,13567,18762,33945,0,0,0,1,1
69293,160,13569,19541,33945,0,0,0,1,1
69294,160,13570,18835;18922,33945,0,0,0,2,2
69295,160,13571,18800;18899,33945,0,0,0,2,2
69296,160,13572,18628;18885,33945,0,0,0,2,2
69297,160,13573,18733,33945,0,0,0,1,1
69298,160,13577,18961,33945,0,0,0,1,1
69299,160,13579,18988,33945,0,0,0,1,1
69300,160,13581,18837,33945,0,0,0,1,1
69301,160,13584,19053,33945,0,0,0,1,1
69302,160,13585,19068,33945,0,0,0,1,1
69303,160,13586,19145,33945,0,0,0,1,1
69304,160,13587,19250,33945,0,0,0,1,1
69305,160,13591,21373;21445,33945,0,0,0,2,2
69306,160,13593,19312,33945,0,0,0,1,1
69307,160,13596,19160,33945,0,0,0,1,1
69308,160,13598,19388,33945,0,0,0,1,1
69309,160,13654,18930,34310,0,0,0,1,1
69310,160,13657,18508,34310,0,0,0,1,1
69311,160,13658,18522,34310,0,0,0,1,1
69312,160,13660,18567,34310,0,0,0,1,1
69313,160,13661,22524,34310,0,0,1,0,1
69314,160,13662,19015,34310,0,0,0,1,1
69315,160,13670,19052,34310,0,0,0,1,1
69316,160,13672,22310;22592;26259,34310,0,0,3,0,3
69317,160,13673,19256,34310,0,0,0,1,1
69318,160,13674,19319,34310,0,0,0,1,1
69319,160,13675,18444,34310,0,0,0,1,1
69320,160,13681,18825,34310,0,0,0,1,1
69321,160,13682,18863,34310,0,0,0,1,1
69322,160,13683,19084;19135,34310,0,0,0,2,2
69323,160,13685,18992,34310,0,0,0,1,1
69324,160,13686,19150,34310,0,0,0,1,1
69325,160,13688,18942,34310,0,0,0,1,1
69326,160,13691,18980;19411,34310,0,0,0,2,2
69327,160,13692,18993,34310,0,0,0,1,1
69328,160,13693,19551,34310,0,0,0,1,1
69329,160,13697,19199;19431,34310,0,0,0,2,2
69330,160,13700,19504;19596,34310,0,0,0,2,2
69331,160,13701,19260,34310,0,0,0,1,1
69332,160,13703,19172,34310,0,0,0,1,1
69333,160,13704,19157,34310,0,0,0,1,1
69334,160,13707,19471,34310,0,0,0,1,1
69335,160,13708,19230;19449,34310,0,0,0,2,2
69336,160,13709,19322;22938,34310,0,0,1,1,2
69337,160,13712,23631;26576;27257;27447,34310,0,2,2,0,4
69338,160,13713,19282,34310,0,0,0,1,1
69339,160,13714,19271;19293,34310,0,0,0,2,2
69340,160,13715,22818,34310,0,0,1,0,1
69341,160,13769,18370,34675,0,0,0,1,1
69342,160,13774,18595,34675,0,0,0,1,1
69343,160,13775,18056,34675,0,0,0,1,1
69344,160,13778,18695,34675,0,0,0,1,1
69345,160,13779,19104,34675,0,0,0,1,1
69346,160,13780,18776;18791,34675,0,0,0,2,2
69347,160,13787,19078,34675,0,0,0,1,1
69348,160,13788,19130,34675,0,0,0,1,1
69349,160,13791,19048,34675,0,0,0,1,1
69350,160,13792,19166,34675,0,0,0,1,1
69351,160,13793,19289,34675,0,0,0,1,1
69352,160,13794,18903,34675,0,0,0,1,1
69353,160,13796,19349,34675,0,0,0,1,1
69354,160,13797,19126,34675,0,0,0,1,1
69355,160,13798,19222,34675,0,0,0,1,1
69356,160,13800,19211;19391,34675,0,0,0,2,2
69357,160,13801,19375;19633,34675,0,0,0,2,2
69358,160,13804,19031;19283,34675,0,0,0,2,2
69359,160,13807,19367,34675,0,0,0,1,1
69360,160,13809,19437,34675,0,0,0,1,1
69361,160,13810,19320,34675,0,0,0,1,1
69362,160,13811,19079;19350,34675,0,0,0,2,2
69363,160,13812,18886,34675,0,0,0,1,1
69364,160,13813,19385,34675,0,0,0,1,1
69365,160,13814,19673;23633;25622;27843,34675,0,1,2,1,4
69366,160,13815,19495,34675,0,0,0,1,1
69367,160,13856,17676,35040,0,0,0,1,1
69368,160,13866,18656,35040,0,0,0,1,1
69369,160,13870,19266,35040,0,0,0,1,1
69370,160,13871,18808,35040,0,0,0,1,1
69371,160,13872,18268;18439,35040,0,0,0,2,2
69372,160,13873,18441,35040,0,0,0,1,1
69373,160,13874,18448,35040,0,0,0,1,1
69374,160,13875,18113,35040,0,0,0,1,1
69375,160,13878,18500,35040,0,0,0,1,1
69376,160,13880,18363,35040,0,0,0,1,1
69377,160,13885,18872,35040,0,0,0,1,1
69378,160,13886,18329,35040,0,0,0,1,1
69379,160,13892,18934;19483,35040,0,0,0,2,2
69380,160,13894,18459;18952,35040,0,0,0,2,2
69381,160,13895,18436,35040,0,0,0,1,1
69382,160,13896,19486,35040,0,0,0,1,1
69383,160,13898,19236,35040,0,0,0,1,1
69384,160,13901,19577,35040,0,0,0,1,1
69385,160,13902,18684;19075,35040,0,0,0,2,2
69386,160,13903,19476,35040,0,0,0,1,1
69387,160,13904,19056,35040,0,0,0,1,1
69388,160,13905,19117;19610,35040,0,0,0,2,2
69389,160,13910,18935,35040,0,0,0,1,1
69390,160,13913,19531,35040,0,0,0,1,1
69391,160,13914,19077;19240,35040,0,0,0,2,2
69392,160,13917,19268,35040,0,0,0,1,1
69393,160,13918,19286,35040,0,0,0,1,1
69394,160,13921,19317,35040,0,0,0,1,1
69395,160,13923,19377,35040,0,0,0,1,1
69396,160,13928,19532,35040,0,0,0,1,1
69397,160,13929,19542,35040,0,0,0,1,1
69398,160,13930,19552,35040,0,0,0,1,1
69399,160,13932,19872,35040,0,0,0,1,1
69400,160,13975,18266,35405,0,0,0,1,1
69401,160,13976,17808,35405,0,0,0,1,1
69402,160,13979,23401;26307;26655,35405,0,1,2,0,3
69403,160,13982,18270,35405,0,0,0,1,1
69404,160,13985,18333,35405,0,0,0,1,1
69405,160,13990,18416;18953,35405,0,0,0,2,2
69406,160,13997,18621,35405,0,0,0,1,1
69407,160,14000,19454;19455,35405,0,0,0,2,2
69408,160,14002,25162;25327,35405,0,0,2,0,2
69409,160,14004,19107,35405,0,0,0,1,1
69410,160,14008,19123,35405,0,0,0,1,1
69411,160,14010,19741,35405,0,0,0,1,1
69412,160,14013,19697,35405,0,0,0,1,1
69413,160,14014,19080;19148,35405,0,0,0,2,2
69414,160,14016,19358,35405,0,0,0,1,1
69415,160,14017,19180,35405,0,0,0,1,1
69416,160,14018,19475,35405,0,0,0,1,1
69417,160,14019,19774,35405,0,0,0,1,1
69418,160,14022,19329;19878,35405,0,0,0,2,2
69419,160,14023,19576,35405,0,0,0,1,1
69420,160,14024,19339,35405,0,0,0,1,1
69421,160,14026,19824,35405,0,0,0,1,1
69422,160,14027,19401,35405,0,0,0,1,1
69423,160,14029,18671;19417,35405,0,0,0,2,2
69424,160,14034,18688;19503,35405,0,0,0,2,2
69425,160,14035,24830;24917;27918;28110,35405,2,0,2,0,4
69426,160,14039,19771,35405,0,0,0,1,1
69427,160,14040,19553,35405,0,0,0,1,1
69428,160,14042,19461;19556,35405,0,0,0,2,2
69429,160,14044,19163;19612,35405,0,0,0,2,2
69430,160,14045,19589;19716,35405,0,0,0,2,2
69431,160,14046,19560;19712,35405,0,0,0,2,2
69432,160,14049,19934,35405,0,0,0,1,1
69433,160,14050,19609,35405,0,0,0,1,1
69434,160,14051,19111;19595,35405,0,0,0,2,2
69435,160,14102,18625,35770,0,0,0,1,1
69436,160,14105,18963,35770,0,0,0,1,1
69437,160,14110,18973;19305,35770,0,0,0,2,2
69438,160,14112,19529,35770,0,0,0,1,1
69439,160,14115,19243,35770,0,0,0,1,1
69440,160,14116,19753,35770,0,0,0,1,1
69441,160,14117,19798,35770,0,0,0,1,1
69442,160,14119,19277,35770,0,0,0,1,1
69443,160,14120,19295,35770,0,0,0,1,1
69444,160,14122,19574;19993,35770,0,0,0,2,2
69445,160,14124,19297;19302,35770,0,0,0,2,2
69446,160,14126,19409;19734,35770,0,0,0,2,2
69447,160,14127,19430,35770,0,0,0,1,1
69448,160,14128,19891,35770,0,0,0,1,1
69449,160,14129,18818;19421,35770,0,0,0,2,2
69450,160,14131,19462;19657,35770,0,0,0,2,2
69451,160,14133,19554;19699,35770,0,0,0,2,2
69452,160,14134,19778,35770,0,0,0,1,1
69453,160,14135,19511,35770,0,0,0,1,1
69454,160,14136,19776,35770,0,0,0,1,1
69455,160,14138,19539;19791,35770,0,0,0,2,2
69456,160,14140,19467;19573,35770,0,0,0,2,2
69457,160,14141,19635,35770,0,0,0,1,1
69458,160,14142,19790,35770,0,0,0,1,1
69459,160,14143,19099,35770,0,0,0,1,1
69460,160,14144,19548;19680,35770,0,0,0,2,2
69461,160,14145,19682,35770,0,0,0,1,1
69462,160,14146,19362;19844,35770,0,0,0,2,2
69463,160,14147,19125;19703,35770,0,0,0,2,2
69464,160,14148,19718,35770,0,0,0,1,1
69465,160,14149,19837,35770,0,0,0,1,1
69466,160,14150,19738;19914,35770,0,0,0,2,2
69467,160,14151,19980,35770,0,0,0,1,1
69468,160,14152,19800,35770,0,0,0,1,1
69469,160,14153,19775;20027,35770,0,0,0,2,2
69470,160,14203,18341,36135,0,0,0,1,1
69471,160,14206,19267,36135,0,0,0,1,1
69472,160,14213,18995;19732;23649,36135,0,0,1,2,3
69473,160,14214,19105,36135,0,0,0,1,1
69474,160,14215,19045,36135,0,0,0,1,1
69475,160,14218,19783,36135,0,0,0,1,1
69476,160,14220,19601,36135,0,0,0,1,1
69477,160,14223,18891;19346,36135,0,0,0,2,2
69478,160,14225,19306,36135,0,0,0,1,1
69479,160,14229,19355,36135,0,0,0,1,1
69480,160,14230,19369,36135,0,0,0,1,1
69481,160,14231,19641,36135,0,0,0,1,1
69482,160,14232,19526,36135,0,0,0,1,1
69483,160,14233,20047;20221,36135,0,0,0,2,2
69484,160,14234,19664;19963,36135,0,0,0,2,2
69485,160,14236,19803,36135,0,0,0,1,1
69486,160,14238,19793,36135,0,0,0,1,1
69487,160,14239,19335;19724,36135,0,0,0,2,2
69488,160,14240,19737;19743,36135,0,0,0,2,2
69489,160,14241,19744,36135,0,0,0,1,1
69490,160,14242,20133,36135,0,0,0,1,1
69491,160,14244,19296,36135,0,0,0,1,1
69492,160,14246,19813;20064,36135,0,0,0,2,2
69493,160,14248,20364,36135,0,0,0,1,1
69494,160,14250,19745;20141,36135,0,0,0,2,2
69495,160,14253,19829,36135,0,0,0,1,1
69496,160,14254,19662;19861,36135,0,0,0,2,2
69497,160,14255,19864,36135,0,0,0,1,1
69498,160,14256,19719,36135,0,0,0,1,1
69499,160,14257,19569,36135,0,0,0,1,1
69500,160,14289,18946,36500,0,0,0,1,1
69501,160,14293,18681,36500,0,0,0,1,1
69502,160,14299,18701,36500,0,0,0,1,1
69503,160,14300,19082;19426,36500,0,0,0,2,2
69504,160,14301,18909,36500,0,0,0,1,1
69505,160,14302,18828,36500,0,0,0,1,1
69506,160,14304,19381,36500,0,0,0,1,1
69507,160,14305,19587,36500,0,0,0,1,1
69508,160,14306,19294,36500,0,0,0,1,1
69509,160,14307,19226;19273,36500,0,0,0,2,2
69510,160,14308,19439;19632,36500,0,0,0,2,2
69511,160,14309,18736;19142,36500,0,0,0,2,2
69512,160,14315,19344,36500,0,0,0,1,1
69513,160,14316,19452,36500,0,0,0,1,1
69514,160,14317,19392,36500,0,0,0,1,1
69515,160,14318,19403,36500,0,0,0,1,1
69516,160,14320,19442;20179,36500,0,0,0,2,2
69517,160,14321,19257,36500,0,0,0,1,1
69518,160,14322,19885;19889,36500,0,0,0,2,2
69519,160,14323,19457,36500,0,0,0,1,1
69520,160,14325,19786,36500,0,0,0,1,1
69521,160,14327,19187;19642,36500,0,0,0,2,2
69522,160,14328,19631,36500,0,0,0,1,1
69523,160,14330,19124,36500,0,0,0,1,1
69524,160,14331,20129,36500,0,0,0,1,1
69525,160,14332,19807,36500,0,0,0,1,1
69526,160,14333,19687;19874,36500,0,0,0,2,2
69527,160,14334,20092,36500,0,0,0,1,1
69528,160,14335,19740;19755,36500,0,0,0,2,2
69529,160,14336,19827,36500,0,0,0,1,1
69530,160,14337,19624;19780,36500,0,0,0,2,2
69531,160,14338,20287,36500,0,0,0,1,1
69532,160,14339,20260,36500,0,0,0,1,1
69533,160,14340,19828;20177,36500,0,0,0,2,2
69534,160,14341,19834,36500,0,0,0,1,1
69535,160,14343,19884;20174,36500,0,0,0,2,2
69536,160,14344,19855,36500,0,0,0,1,1
69537,160,14345,19422;19857,36500,0,0,0,2,2
69538,160,14346,19876;19894,36500,0,0,0,2,2
69539,160,14348,19649;20078,36500,0,0,0,2,2
69540,160,14349,19663;19929,36500,0,0,0,2,2
69541,160,14350,19566;19945,36500,0,0,0,2,2
69542,160,14352,19685;19958,36500,0,0,0,2,2
69543,160,14353,19960;20000,36500,0,0,0,2,2
69544,160,14354,19816,36500,0,0,0,1,1
69545,160,14356,19983;20109;23769;27166,36500,0,1,1,2,4
69546,160,14397,18535,36865,0,0,0,1,1
69547,160,14403,18264,36865,0,0,0,1,1
69548,160,14405,18551,36865,0,0,0,1,1
69549,160,14411,18978,36865,0,0,0,1,1
69550,160,14412,18533,36865,0,0,0,1,1
69551,160,14414,18711,36865,0,0,0,1,1
69552,160,14415,18997,36865,0,0,0,1,1
69553,160,14417,18843,36865,0,0,0,1,1
69554,160,14419,19127,36865,0,0,0,1,1
69555,160,14422,19395,36865,0,0,0,1,1
69556,160,14424,19202;19324,36865,0,0,0,2,2
69557,160,14425,18834,36865,0,0,0,1,1
69558,160,14428,18906,36865,0,0,0,1,1
69559,160,14429,19227,36865,0,0,0,1,1
69560,160,14430,19765,36865,0,0,0,1,1
69561,160,14432,20089,36865,0,0,0,1,1
69562,160,14433,19505,36865,0,0,0,1,1
69563,160,14434,19888,36865,0,0,0,1,1
69564,160,14436,19598;19925,36865,0,0,0,2,2
69565,160,14437,19611,36865,0,0,0,1,1
69566,160,14440,19636,36865,0,0,0,1,1
69567,160,14442,19672,36865,0,0,0,1,1
69568,160,14443,19506;19678,36865,0,0,0,2,2
69569,160,14444,19702,36865,0,0,0,1,1
69570,160,14445,19708,36865,0,0,0,1,1
69571,160,14446,19472;19709,36865,0,0,0,2,2
69572,160,14447,19823,36865,0,0,0,1,1
69573,160,14449,20103,36865,0,0,0,1,1
69574,160,14451,19638;19849,36865,0,0,0,2,2
69575,160,14452,19707;19955,36865,0,0,0,2,2
69576,160,14453,20050;20237,36865,0,0,0,2,2
69577,160,14454,19654;19899,36865,0,0,0,2,2
69578,160,14456,20380,36865,0,0,0,1,1
69579,160,14457,20115,36865,0,0,0,1,1
69580,160,14458,20111,36865,0,0,0,1,1
69581,160,14459,19978,36865,0,0,0,1,1
69582,160,14460,19986,36865,0,0,0,1,1
69583,160,14461,19994,36865,0,0,0,1,1
69584,160,14462,19879;20006,36865,0,0,0,2,2
69585,160,14463,20022,36865,0,0,0,1,1
69586,160,14464,20383,36865,0,0,0,1,1
69587,160,14498,18061,37230,0,0,0,1,1
69588,160,14503,22358;22707;22716;22985,37230,0,0,4,0,4
69589,160,14504,18740,37230,0,0,0,1,1
69590,160,14506,18819,37230,0,0,0,1,1
69591,160,14508,18928,37230,0,0,0,1,1
69592,160,14509,19021,37230,0,0,0,1,1
69593,160,14510,19667,37230,0,0,0,1,1
69594,160,14512,19151,37230,0,0,0,1,1
69595,160,14514,19270,37230,0,0,0,1,1
69596,160,14515,19415,37230,0,0,0,1,1
69597,160,14517,19480,37230,0,0,0,1,1
69598,160,14519,19764,37230,0,0,0,1,1
69599,160,14520,19852;19887,37230,0,0,0,2,2
69600,160,14521,19538;19726,37230,0,0,0,2,2
69601,160,14522,19402;19583,37230,0,0,0,2,2
69602,160,14523,19571;19797,37230,0,0,0,2,2
69603,160,14524,20148,37230,0,0,0,1,1
69604,160,14525,19424;19655,37230,0,0,0,2,2
69605,160,14526,19591,37230,0,0,0,1,1
69606,160,14527,19691,37230,0,0,0,1,1
69607,160,14528,20247,37230,0,0,0,1,1
69608,160,14529,19729;19730,37230,0,0,0,2,2
69609,160,14530,20058;20059,37230,0,0,0,2,2
69610,160,14531,19915,37230,0,0,0,1,1
69611,160,14533,20042;20189,37230,0,0,0,2,2
69612,160,14534,20135;20150,37230,0,0,0,2,2
69613,160,14537,20482,37230,0,0,0,1,1
69614,160,14538,19937,37230,0,0,0,1,1
69615,160,14539,19459;19941,37230,0,0,0,2,2
69616,160,14540,20126;20185,37230,0,0,0,2,2
69617,160,14541,20009;20479,37230,0,0,0,2,2
69618,160,14542,20213,37230,0,0,0,1,1
69619,160,14544,20323,37230,0,0,0,1,1
69620,160,14545,20365;20381,37230,0,0,0,2,2
69621,160,14546,19954,37230,0,0,0,1,1
69622,160,14547,20222,37230,0,0,0,1,1
69623,160,14548,20018;20091,37230,0,0,0,2,2
69624,160,14550,19679;20097,37230,0,0,0,2,2
69625,160,14551,24691,37230,0,0,1,0,1
69626,160,14553,20219,37230,0,0,0,1,1
69627,160,14554,20261,37230,0,0,0,1,1
69628,160,14555,20154,37230,0,0,0,1,1
69629,160,14592,18255;22380,37595,0,0,1,1,2
69630,160,14597,18111,37595,0,0,0,1,1
69631,160,14602,18806,37595,0,0,0,1,1
69632,160,14606,19326,37595,0,0,0,1,1
69633,160,14607,18745,37595,0,0,0,1,1
69634,160,14609,18950,37595,0,0,0,1,1
69635,160,14610,19332;19428,37595,0,0,0,2,2
69636,160,14616,19639;20002,37595,0,0,0,2,2
69637,160,14618,19623;19684,37595,0,0,0,2,2
69638,160,14619,19695,37595,0,0,0,1,1
69639,160,14621,19700,37595,0,0,0,1,1
69640,160,14623,20194,37595,0,0,0,1,1
69641,160,14624,19905,37595,0,0,0,1,1
69642,160,14626,20359;23895;27174,37595,0,1,1,1,3
69643,160,14627,20539,37595,0,0,0,1,1
69644,160,14628,19081,37595,0,0,0,1,1
69645,160,14630,19923;19984,37595,0,0,0,2,2
69646,160,14632,19982,37595,0,0,0,1,1
69647,160,14633,20049,37595,0,0,0,1,1
69648,160,14636,19766;19951,37595,0,0,0,2,2
69649,160,14638,19833;20167,37595,0,0,0,2,2
69650,160,14639,20038;20628,37595,0,0,0,2,2
69651,160,14640,20491;20557,37595,0,0,0,2,2
69652,160,14645,19991;20288,37595,0,0,0,2,2
69653,160,14646,19820;20255,37595,0,0,0,2,2
69654,160,14647,20432;20550,37595,0,0,0,2,2
69655,160,14648,20191,37595,0,0,0,1,1
69656,160,14649,19964;20176,37595,0,0,0,2,2
69657,160,14650,20227,37595,0,0,0,1,1
69658,160,14651,20352,37595,0,0,0,1,1
69659,160,14652,20168;20212,37595,0,0,0,2,2
69660,160,14653,20139;20239,37595,0,0,0,2,2
69661,160,14654,19839;20242,37595,0,0,0,2,2
69662,160,14655,19975;20017,37595,0,0,0,2,2
69663,160,14656,20272;20362,37595,0,0,0,2,2
69664,160,14657,20279;20456,37595,0,0,0,2,2
69665,160,14698,18068,37960,0,0,0,1,1
69666,160,14700,17931,37960,0,0,0,1,1
69667,160,14701,17998,37960,0,0,0,1,1
69668,160,14710,18181,37960,0,0,0,1,1
69669,160,14713,18641;18907,37960,0,0,0,2,2
69670,160,14715,19359,37960,0,0,0,1,1
69671,160,14717,18862,37960,0,0,0,1,1
69672,160,14718,19497,37960,0,0,0,1,1
69673,160,14722,19165,37960,0,0,0,1,1
69674,160,14725,19423,37960,0,0,0,1,1
69675,160,14726,19005,37960,0,0,0,1,1
69676,160,14727,19066;19674,37960,0,0,0,2,2
69677,160,14730,19508;19863,37960,0,0,0,2,2
69678,160,14731,19525;19594,37960,0,0,0,2,2
69679,160,14734,19903,37960,0,0,0,1,1
69680,160,14737,19653,37960,0,0,0,1,1
69681,160,14738,19676;19731,37960,0,0,0,2,2
69682,160,14742,19436;19725,37960,0,0,0,2,2
69683,160,14743,19989,37960,0,0,0,1,1
69684,160,14745,19924,37960,0,0,0,1,1
69685,160,14746,19498;19928,37960,0,0,0,2,2
69686,160,14747,19952,37960,0,0,0,1,1
69687,160,14748,20003;20621,37960,0,0,0,2,2
69688,160,14749,20349,37960,0,0,0,1,1
69689,160,14752,20037,37960,0,0,0,1,1
69690,160,14753,20404,37960,0,0,0,1,1
69691,160,14754,20169;20681,37960,0,0,0,2,2
69692,160,14755,20510,37960,0,0,0,1,1
69693,160,14756,20198,37960,0,0,0,1,1
69694,160,14757,20280,37960,0,0,0,1,1
69695,160,14759,20297,37960,0,0,0,1,1
69696,160,14760,20448,37960,0,0,0,1,1
69697,160,14761,20314;23680;27347,37960,0,1,1,1,3
69698,160,14762,20267,37960,0,0,0,1,1
69699,160,14763,20462,37960,0,0,0,1,1
69700,160,14764,20353;20431,37960,0,0,0,2,2
69701,160,14765,20664;21168,37960,0,0,0,2,2
69702,160,14766,20025,37960,0,0,0,1,1
69703,160,14768,20424,37960,0,0,0,1,1
69704,160,14787,17966,38325,0,0,0,1,1
69705,160,14793,18373,38325,0,0,0,1,1
69706,160,14795,18304,38325,0,0,0,1,1
69707,160,14808,18689,38325,0,0,0,1,1
69708,160,14813,18900,38325,0,0,0,1,1
69709,160,14816,19248;19710,38325,0,0,0,2,2
69710,160,14819,19419;19620,38325,0,0,0,2,2
69711,160,14820,19274,38325,0,0,0,1,1
69712,160,14823,19557,38325,0,0,0,1,1
69713,160,14825,19433,38325,0,0,0,1,1
69714,160,14827,19815,38325,0,0,0,1,1
69715,160,14828,19540,38325,0,0,0,1,1
69716,160,14829,19410;19998,38325,0,0,0,2,2
69717,160,14830,19625;19900,38325,0,0,0,2,2
69718,160,14831,20246;20286;23570;27762,38325,0,1,1,2,4
69719,160,14834,20203,38325,0,0,0,1,1
69720,160,14836,20502,38325,0,0,0,1,1
69721,160,14837,20503,38325,0,0,0,1,1
69722,160,14838,19706;19932,38325,0,0,0,2,2
69723,160,14843,20005;20170,38325,0,0,0,2,2
69724,160,14844,20069,38325,0,0,0,1,1
69725,160,14847,23989;24346;27874,38325,1,0,2,0,3
69726,160,14849,20094,38325,0,0,0,1,1
69727,160,14851,20376,38325,0,0,0,1,1
69728,160,14854,20232,38325,0,0,0,1,1
69729,160,14855,20200;20289,38325,0,0,0,2,2
69730,160,14856,20295,38325,0,0,0,1,1
69731,160,14857,23345;23679;23739;23890;26679;26773;26884;27449;27568,38325,0,5,4,0,9
69732,160,14858,20911;20973;25213;28232,38325,1,0,1,2,4
69733,160,14863,20384,38325,0,0,0,1,1
69734,160,14864,20393;20542,38325,0,0,0,2,2
69735,160,14865,20063;20397,38325,0,0,0,2,2
69736,160,14866,20402;20793,38325,0,0,0,2,2
69737,160,14867,20407;20668,38325,0,0,0,2,2
69738,160,14868,20718,38325,0,0,0,1,1
69739,160,14869,20224;20484,38325,0,0,0,2,2
69740,160,14870,20909;21000,38325,0,0,0,2,2
69741,160,14871,20015;20497,38325,0,0,0,2,2
69742,160,14872,20499;20820,38325,0,0,0,2,2
69743,160,14873,20650,38325,0,0,0,1,1
69744,160,14874,20505,38325,0,0,0,1,1
69745,160,14876,20792;25023;27430,38325,0,1,1,1,3
69746,160,14877,20564;20640,38325,0,0,0,2,2
69747,160,14907,17589,38690,0,0,0,1,1
69748,160,14913,18140,38690,0,0,0,1,1
69749,160,14923,19582,38690,0,0,0,1,1
69750,160,14924,19372,38690,0,0,0,1,1
69751,160,14925,23009,38690,0,0,1,0,1
69752,160,14926,18719;18829,38690,0,0,0,2,2
69753,160,14928,18932,38690,0,0,0,1,1
69754,160,14932,19174;19223,38690,0,0,0,2,2
69755,160,14933,19670,38690,0,0,0,1,1
69756,160,14935,19742,38690,0,0,0,1,1
69757,160,14938,19425;19953,38690,0,0,0,2,2
69758,160,14940,19563,38690,0,0,0,1,1
69759,160,14942,19567;19921,38690,0,0,0,2,2
69760,160,14943,19621;20067,38690,0,0,0,2,2
69761,160,14945,19728;20199,38690,0,0,0,2,2
69762,160,14946,19628,38690,0,0,0,1,1
69763,160,14947,19979;20055,38690,0,0,0,2,2
69764,160,14948,19788,38690,0,0,0,1,1
69765,160,14949,19869,38690,0,0,0,1,1
69766,160,14950,20106;20214,38690,0,0,0,2,2
69767,160,14951,20051,38690,0,0,0,1,1
69768,160,14952,19246;19867,38690,0,0,0,2,2
69769,160,14954,20245,38690,0,0,0,1,1
69770,160,14955,19961,38690,0,0,0,1,1
69771,160,14957,20040,38690,0,0,0,1,1
69772,160,14958,20121,38690,0,0,0,1,1
69773,160,14959,19992;20413,38690,0,0,0,2,2
69774,160,14960,20394,38690,0,0,0,1,1
69775,160,14961,19761;20134,38690,0,0,0,2,2
69776,160,14962,20145,38690,0,0,0,1,1
69777,160,14965,20469,38690,0,0,0,1,1
69778,160,14966,20290,38690,0,0,0,1,1
69779,160,14967,20536;20620,38690,0,0,0,2,2
69780,160,14968,20373,38690,0,0,0,1,1
69781,160,14969,20275,38690,0,0,0,1,1
69782,160,14970,20114;20300,38690,0,0,0,2,2
69783,160,14972,20333;20399,38690,0,0,0,2,2
69784,160,14973,20595,38690,0,0,0,1,1
69785,160,14974,20672;20723,38690,0,0,0,2,2
69786,160,14977,20412,38690,0,0,0,1,1
69787,160,14978,20442;20481;24117,38690,0,0,1,2,3
69788,160,14980,20895;20940;24254,38690,0,0,1,2,3
69789,160,14981,20403,38690,0,0,0,1,1
69790,160,14982,20488,38690,0,0,0,1,1
69791,160,14983,20605,38690,0,0,0,1,1
69792,160,14984,20378,38690,0,0,0,1,1
69793,160,14985,20495;23690;26675;27450,38690,0,2,1,1,4
69794,160,14986,20527,38690,0,0,0,1,1
69795,160,14988,20559,38690,0,0,0,1,1
69796,160,14989,20511;20576,38690,0,0,0,2,2
69797,160,14990,20587;20863,38690,0,0,0,2,2
69798,160,14991,20627,38690,0,0,0,1,1
69799,160,15027,19061,39055,0,0,0,1,1
69800,160,15030,18726,39055,0,0,0,1,1
69801,160,15033,18650,39055,0,0,0,1,1
69802,160,15035,19463;24086,39055,0,0,1,1,2
69803,160,15041,19618,39055,0,0,0,1,1
69804,160,15042,19352,39055,0,0,0,1,1
69805,160,15043,19614,39055,0,0,0,1,1
69806,160,15044,19456,39055,0,0,0,1,1
69807,160,15047,19856,39055,0,0,0,1,1
69808,160,15049,19723;23974,39055,0,0,1,1,2
69809,160,15051,19808;20144,39055,0,0,0,2,2
69810,160,15052,19846,39055,0,0,0,1,1
69811,160,15053,20087;20268,39055,0,0,0,2,2
69812,160,15057,19510;19648,39055,0,0,0,2,2
69813,160,15058,20498,39055,0,0,0,1,1
69814,160,15059,20008;20088,39055,0,0,0,2,2
69815,160,15060,20011,39055,0,0,0,1,1
69816,160,15062,24444;24701;26721;27906,39055,1,1,2,0,4
69817,160,15063,20680;20708,39055,0,0,0,2,2
69818,160,15064,20344,39055,0,0,0,1,1
69819,160,15065,20113;20120,39055,0,0,0,2,2
69820,160,15066,24237;24405;24697;24810;25078;27226;27538,39055,0,2,5,0,7
69821,160,15067,20166;20766;23921;26498;26690,39055,0,1,2,2,5
69822,160,15068,20535,39055,0,0,0,1,1
69823,160,15069,20259;20606,39055,0,0,0,2,2
69824,160,15070,20553;20730,39055,0,0,0,2,2
69825,160,15071,20440;20585,39055,0,0,0,2,2
69826,160,15072,20281;20809,39055,0,0,0,2,2
69827,160,15073,20180;20291,39055,0,0,0,2,2
69828,160,15076,20862,39055,0,0,0,1,1
69829,160,15077,20201;20435,39055,0,0,0,2,2
69830,160,15079,20455,39055,0,0,0,1,1
69831,160,15080,20461;20538,39055,0,0,0,2,2
69832,160,15081,20463;20890,39055,0,0,0,2,2
69833,160,15082,20329;20375,39055,0,0,0,2,2
69834,160,15083,20172;24475,39055,0,0,1,1,2
69835,160,15084,20932;21381;25321,39055,0,0,1,2,3
69836,160,15085,20869;21013,39055,0,0,0,2,2
69837,160,15086,20949,39055,0,0,0,1,1
69838,160,15089,20547;24585;27409,39055,0,1,1,1,3
69839,160,15090,20317;20552,39055,0,0,0,2,2
69840,160,15091,20574,39055,0,0,0,1,1
69841,160,15092,21048,39055,0,0,0,1,1
69842,160,15093,20598,39055,0,0,0,1,1
69843,160,15094,20524;20626;24126,39055,0,0,1,2,3
69844,160,15095,20326;20636,39055,0,0,0,2,2
69845,160,15096,20653,39055,0,0,0,1,1
69846,160,15097,20717,39055,0,0,0,1,1
69847,160,15098,20634,39055,0,0,0,1,1
69848,160,15099,20845;20924,39055,0,0,0,2,2
69849,160,15100,20746,39055,0,0,0,1,1
69850,160,15137,19474,39420,0,0,0,1,1
69851,160,15142,19026,39420,0,0,0,1,1
69852,160,15144,20193;24476,39420,0,0,1,1,2
69853,160,15145,19714,39420,0,0,0,1,1
69854,160,15147,19205,39420,0,0,0,1,1
69855,160,15149,19464,39420,0,0,0,1,1
69856,160,15151,19713;20035,39420,0,0,0,2,2
69857,160,15154,20250;20369,39420,0,0,0,2,2
69858,160,15155,20101,39420,0,0,0,1,1
69859,160,15156,19877,39420,0,0,0,1,1
69860,160,15158,19968,39420,0,0,0,1,1
69861,160,15160,20123,39420,0,0,0,1,1
69862,160,15161,20125,39420,0,0,0,1,1
69863,160,15162,20130;20556,39420,0,0,0,2,2
69864,160,15164,20879,39420,0,0,0,1,1
69865,160,15168,20093,39420,0,0,0,1,1
69866,160,15169,20635;24025;26985,39420,0,1,1,1,3
69867,160,15170,20405;20472,39420,0,0,0,2,2
69868,160,15171,20438;20777,39420,0,0,0,2,2
69869,160,15172,20756,39420,0,0,0,1,1
69870,160,15173,20459,39420,0,0,0,1,1
69871,160,15175,20958;21163,39420,0,0,0,2,2
69872,160,15176,20592,39420,0,0,0,1,1
69873,160,15177,20216;20537,39420,0,0,0,2,2
69874,160,15178,24633;27105;27711;27895,39420,1,2,1,0,4
69875,160,15179,20565;20861,39420,0,0,0,2,2
69876,160,15181,20583;20753,39420,0,0,0,2,2
69877,160,15182,20872;21100,39420,0,0,0,2,2
69878,160,15184,20599,39420,0,0,0,1,1
69879,160,15185,20817;21143,39420,0,0,0,2,2
69880,160,15187,20659,39420,0,0,0,1,1
69881,160,15188,20473;20660,39420,0,0,0,2,2
69882,160,15189,20182;20690,39420,0,0,0,2,2
69883,160,15191,20597;20956,39420,0,0,0,2,2
69884,160,15192,20382;20751;24594;27210;27613;27707;27802,39420,0,4,1,2,7
69885,160,15193,20769,39420,0,0,0,1,1
69886,160,15194,20785;20984;24826;26614;27625;28104,39420,1,1,2,2,6
69887,160,15195,20971,39420,0,0,0,1,1
69888,160,15196,20810,39420,0,0,0,1,1
69889,160,15197,20827;20948,39420,0,0,0,2,2
69890,160,15198,24672;25025;27930,39420,1,0,2,0,3
69891,160,15199,20652;20892,39420,0,0,0,2,2
69892,160,15227,17686,39785,0,0,0,1,1
69893,160,15235,19050,39785,0,0,0,1,1
69894,160,15243,19394,39785,0,0,0,1,1
69895,160,15247,23314,39785,0,0,1,0,1
69896,160,15248,19692;24573,39785,0,0,1,1,2
69897,160,15250,20062,39785,0,0,0,1,1
69898,160,15251,20209,39785,0,0,0,1,1
69899,160,15252,20226,39785,0,0,0,1,1
69900,160,15253,19643;19976,39785,0,0,0,2,2
69901,160,15255,20044,39785,0,0,0,1,1
69902,160,15257,20072,39785,0,0,0,1,1
69903,160,15258,20321,39785,0,0,0,1,1
69904,160,15259,20163;20426,39785,0,0,0,2,2
69905,160,15260,20447;20745,39785,0,0,0,2,2
69906,160,15261,20230;20301,39785,0,0,0,2,2
69907,160,15262,20234,39785,0,0,0,1,1
69908,160,15263,20422;20591,39785,0,0,0,2,2
69909,160,15264,20264,39785,0,0,0,1,1
69910,160,15266,20324;20551;23691,39785,0,0,1,2,3
69911,160,15267,20396,39785,0,0,0,1,1
69912,160,15268,20334,39785,0,0,0,1,1
69913,160,15269,20430,39785,0,0,0,1,1
69914,160,15270,20322;20357,39785,0,0,0,2,2
69915,160,15273,20427,39785,0,0,0,1,1
69916,160,15274,20445;20506,39785,0,0,0,2,2
69917,160,15275,20512;20515,39785,0,0,0,2,2
69918,160,15276,20368;20822,39785,0,0,0,2,2
69919,160,15277,20563,39785,0,0,0,1,1
69920,160,15278,20682;20899,39785,0,0,0,2,2
69921,160,15279,20963,39785,0,0,0,1,1
69922,160,15281,20866;21055,39785,0,0,0,2,2
69923,160,15282,20507,39785,0,0,0,1,1
69924,160,15283,20677,39785,0,0,0,1,1
69925,160,15284,20691,39785,0,0,0,1,1
69926,160,15285,20694,39785,0,0,0,1,1
69927,160,15286,20466;20689,39785,0,0,0,2,2
69928,160,15287,20529;20714,39785,0,0,0,2,2
69929,160,15288,21036;21138,39785,0,0,0,2,2
69930,160,15289,20725;20976,39785,0,0,0,2,2
69931,160,15290,20731,39785,0,0,0,1,1
69932,160,15292,20748;20964,39785,0,0,0,2,2
69933,160,15293,20762,39785,0,0,0,1,1
69934,160,15294,20763,39785,0,0,0,1,1
69935,160,15295,20773;20945,39785,0,0,0,2,2
69936,160,15296,24415;27002,39785,0,1,1,0,2
69937,160,15297,20844;21058,39785,0,0,0,2,2
69938,160,15298,20847;20939,39785,0,0,0,2,2
69939,160,15299,20724;21072,39785,0,0,0,2,2
69940,160,15300,21171,39785,0,0,0,1,1
69941,160,15301,20871,39785,0,0,0,1,1
69942,160,15302,20893;21124;25219;27736,39785,0,1,1,2,4
69943,160,15303,21052,39785,0,0,0,1,1
69944,160,15304,20715;20923,39785,0,0,0,2,2
69945,160,15306,21096,39785,0,0,0,1,1
69946,160,15307,21038,39785,0,0,0,1,1
69947,160,15320,17633,40150,0,0,0,1,1
69948,160,15344,19113,40150,0,0,0,1,1
69949,160,15347,19458,40150,0,0,0,1,1
69950,160,15354,19758;19890,40150,0,0,0,2,2
69951,160,15356,20600,40150,0,0,0,1,1
69952,160,15357,19588;20175,40150,0,0,0,2,2
69953,160,15358,20016,40150,0,0,0,1,1
69954,160,15360,19792;20061,40150,0,0,0,2,2
69955,160,15363,19902,40150,0,0,0,1,1
69956,160,15364,20410,40150,0,0,0,1,1
69957,160,15365,20922;20961,40150,0,0,0,2,2
69958,160,15366,20319;20335,40150,0,0,0,2,2
69959,160,15367,20520;20594;23906;27065;27460,40150,0,2,1,2,5
69960,160,15369,20408,40150,0,0,0,1,1
69961,160,15370,20421;20696,40150,0,0,0,2,2
69962,160,15372,20339;20439,40150,0,0,0,2,2
69963,160,15373,20613,40150,0,0,0,1,1
69964,160,15374,20409;20492,40150,0,0,0,2,2
69965,160,15375,20277,40150,0,0,0,1,1
69966,160,15376,20811,40150,0,0,0,1,1
69967,160,15381,20959,40150,0,0,0,1,1
69968,160,15382,20754,40150,0,0,0,1,1
69969,160,15383,21281,40150,0,0,0,1,1
69970,160,15385,20816,40150,0,0,0,1,1
69971,160,15386,21022;25138,40150,0,0,1,1,2
69972,160,15388,20854;20966;24822;27529;28103;28209,40150,2,1,1,2,6
69973,160,15390,21196;21312;24622,40150,0,0,1,2,3
69974,160,15394,20926,40150,0,0,0,1,1
69975,160,15397,20874;21103,40150,0,0,0,2,2
69976,160,15398,20977;21181,40150,0,0,0,2,2
69977,160,15399,21238;21344,40150,0,0,0,2,2
69978,160,15400,21011,40150,0,0,0,1,1
69979,160,15401,20713;21012,40150,0,0,0,2,2
69980,160,15427,19340,40515,0,0,0,1,1
69981,160,15436,20070,40515,0,0,0,1,1
69982,160,15438,19607,40515,0,0,0,1,1
69983,160,15439,19584;19812,40515,0,0,0,2,2
69984,160,15443,19893;20118,40515,0,0,0,2,2
69985,160,15445,19896;20611,40515,0,0,0,2,2
69986,160,15448,20327;20814;26031,40515,0,0,1,2,3
69987,160,15449,20124;20208,40515,0,0,0,2,2
69988,160,15451,20370,40515,0,0,0,1,1
69989,160,15454,20256;20795,40515,0,0,0,2,2
69990,160,15455,20303,40515,0,0,0,1,1
69991,160,15456,20684,40515,0,0,0,1,1
69992,160,15457,20607,40515,0,0,0,1,1
69993,160,15458,20372;20437,40515,0,0,0,2,2
69994,160,15459,20156;20457,40515,0,0,0,2,2
69995,160,15460,20450,40515,0,0,0,1,1
69996,160,15461,20480;20736,40515,0,0,0,2,2
69997,160,15463,20930,40515,0,0,0,1,1
69998,160,15465,20342;20541,40515,0,0,0,2,2
69999,160,15466,20995,40515,0,0,0,1,1
70000,160,15467,20674;20780,40515,0,0,0,2,2
70001,160,15468,20826;21025,40515,0,0,0,2,2
70002,160,15470,20996,40515,0,0,0,1,1
70003,160,15472,20453;20697,40515,0,0,0,2,2
70004,160,15473,20489;20699,40515,0,0,0,2,2
70005,160,15474,20712,40515,0,0,0,1,1
70006,160,15476,20646;20791,40515,0,0,0,2,2
70007,160,15477,20823,40515,0,0,0,1,1
70008,160,15478,21015;21254;23937;26499,40515,0,0,2,2,4
70009,160,15479,21027;21164,40515,0,0,0,2,2
70010,160,15480,21114,40515,0,0,0,1,1
70011,160,15481,20912;20997,40515,0,0,0,2,2
70012,160,15482,20917,40515,0,0,0,1,1
70013,160,15484,20889;20942,40515,0,0,0,2,2
70014,160,15485,20947;21066,40515,0,0,0,2,2
70015,160,15486,20732;20952,40515,0,0,0,2,2
70016,160,15487,20803;21201,40515,0,0,0,2,2
70017,160,15488,20968;21487;25924,40515,0,0,1,2,3
70018,160,15489,20983;21037,40515,0,0,0,2,2
70019,160,15490,21008,40515,0,0,0,1,1
70020,160,15491,21028;21130,40515,0,0,0,2,2
70021,160,15492,21412,40515,0,0,0,1,1
70022,160,15493,21298,40515,0,0,0,1,1
70023,160,15494,21065,40515,0,0,0,1,1
70024,160,15495,21321,40515,0,0,0,1,1
70025,160,15496,21553;21814,40515,0,0,1,1,2
70026,160,15498,21121;21427,40515,0,0,0,2,2
70027,160,15499,21151;21308,40515,0,0,0,2,2
70028,160,15500,21486,40515,0,0,0,1,1
70029,160,15501,21200;21408,40515,0,0,0,2,2
70030,160,15502,21245,40515,0,0,0,1,1
70031,160,15529,19073,40880,0,0,0,1,1
70032,160,15530,18824,40880,0,0,0,1,1
70033,160,15539,19948,40880,0,0,0,1,1
70034,160,15540,20223;23994,40880,0,0,1,1,2
70035,160,15541,19677,40880,0,0,0,1,1
70036,160,15542,20391,40880,0,0,0,1,1
70037,160,15543,20315,40880,0,0,0,1,1
70038,160,15544,20285,40880,0,0,0,1,1
70039,160,15545,20742,40880,0,0,0,1,1
70040,160,15546,20701,40880,0,0,0,1,1
70041,160,15547,20045;20138,40880,0,0,0,2,2
70042,160,15548,20436,40880,0,0,0,1,1
70043,160,15549,20085;20522,40880,0,0,0,2,2
70044,160,15550,20727,40880,0,0,0,1,1
70045,160,15551,21031,40880,0,0,0,1,1
70046,160,15552,20589;21440,40880,0,0,0,2,2
70047,160,15553,20604;20950,40880,0,0,0,2,2
70048,160,15555,20934;21004,40880,0,0,0,2,2
70049,160,15556,20544;23176,40880,0,0,1,1,2
70050,160,15557,20704;20994,40880,0,0,0,2,2
70051,160,15558,20800;20978,40880,0,0,0,2,2
70052,160,15560,20919,40880,0,0,0,1,1
70053,160,15562,20722;21088,40880,0,0,0,2,2
70054,160,15563,20898;21464,40880,0,0,0,2,2
70055,160,15564,20266;20662,40880,0,0,0,2,2
70056,160,15565,20615;21057,40880,0,0,0,2,2
70057,160,15566,21420;21422,40880,0,0,0,2,2
70058,160,15568,21064;21341,40880,0,0,0,2,2
70059,160,15569,20992;21046,40880,0,0,0,2,2
70060,160,15571,20692;21010,40880,0,0,0,2,2
70061,160,15573,21054;21416,40880,0,0,0,2,2
70062,160,15574,21315;21411,40880,0,0,0,2,2
70063,160,15575,21463,40880,0,0,0,1,1
70064,160,15576,21236,40880,0,0,0,1,1
70065,160,15577,21137,40880,0,0,0,1,1
70066,160,15578,21161,40880,0,0,0,1,1
70067,160,15580,21172,40880,0,0,0,1,1
70068,160,15581,21177,40880,0,0,0,1,1
70069,160,15582,21547;25239,40880,0,0,1,1,2
70070,160,15583,20758;21206,40880,0,0,0,2,2
70071,160,15584,20776;21211,40880,0,0,0,2,2
70072,160,15586,21249;21355,40880,0,0,0,2,2
70073,160,15587,20794;21256,40880,0,0,0,2,2
70074,160,15588,21262,40880,0,0,0,1,1
70075,160,15590,21313;25339;25425,40880,0,0,2,1,3
70076,160,15591,21283;21550,40880,0,0,0,2,2
70077,160,15592,21128;21286,40880,0,0,0,2,2
70078,160,15609,18124,41245,0,0,0,1,1
70079,160,15614,19301,41245,0,0,0,1,1
70080,160,15616,19167,41245,0,0,0,1,1
70081,160,15629,20593,41245,0,0,0,1,1
70082,160,15631,19977;20312,41245,0,0,0,2,2
70083,160,15633,21039;21167,41245,0,0,0,2,2
70084,160,15634,20839,41245,0,0,0,1,1
70085,160,15636,20654;20870,41245,0,0,0,2,2
70086,160,15637,21123,41245,0,0,0,1,1
70087,160,15638,20629;20678,41245,0,0,0,2,2
70088,160,15639,20470,41245,0,0,0,1,1
70089,160,15640,20768;20910,41245,0,0,0,2,2
70090,160,15641,20799,41245,0,0,0,1,1
70091,160,15644,21465,41245,0,0,0,1,1
70092,160,15646,20887,41245,0,0,0,1,1
70093,160,15647,20829;20888,41245,0,0,0,2,2
70094,160,15649,21002;21074,41245,0,0,0,2,2
70095,160,15650,21220,41245,0,0,0,1,1
70096,160,15651,20907;20989,41245,0,0,0,2,2
70097,160,15653,21110;24434;26814;28190,41245,1,1,1,1,4
70098,160,15654,21415,41245,0,0,0,1,1
70099,160,15655,21092;21115,41245,0,0,0,2,2
70100,160,15656,21428,41245,0,0,0,1,1
70101,160,15657,21449;21482,41245,0,0,0,2,2
70102,160,15658,20993;21145;24619,41245,0,0,1,2,3
70103,160,15659,21162;21243,41245,0,0,0,2,2
70104,160,15660,20744;21217,41245,0,0,0,2,2
70105,160,15661,21418;21591,41245,0,0,0,2,2
70106,160,15663,21247;25224,41245,0,0,1,1,2
70107,160,15665,21329;21683,41245,0,0,1,1,2
70108,160,15666,20849;21259,41245,0,0,0,2,2
70109,160,15667,21253;21613,41245,0,0,0,2,2
70110,160,15668,21270;21662,41245,0,0,1,1,2
70111,160,15669,21278;21401;25337,41245,0,0,1,2,3
70112,160,15670,21291;21534,41245,0,0,0,2,2
70113,160,15671,21304,41245,0,0,0,1,1
70114,160,15672,20986;21305,41245,0,0,0,2,2
70115,160,15673,21320;25630,41245,0,0,1,1,2
70116,160,15674,21332;25341,41245,0,0,1,1,2
70117,160,15675,21297;21310,41245,0,0,0,2,2
70118,160,15676,21326,41245,0,0,0,1,1
70119,160,15677,21394;21511,41245,0,0,0,2,2
70120,160,15678,21097;21600,41245,0,0,0,2,2
70121,160,15679,21393;24448;27690;28078,41245,1,1,1,1,4
70122,160,15680,21400,41245,0,0,0,1,1
70123,160,15681,21426,41245,0,0,0,1,1
70124,160,15703,18149,41610,0,0,0,1,1
70125,160,15706,18532,41610,0,0,0,1,1
70126,160,15709,19116,41610,0,0,0,1,1
70127,160,15718,19580,41610,0,0,0,1,1
70128,160,15720,19974,41610,0,0,0,1,1
70129,160,15725,19435;19996,41610,0,0,0,2,2
70130,160,15726,20012,41610,0,0,0,1,1
70131,160,15727,20276,41610,0,0,0,1,1
70132,160,15728,20041;20487,41610,0,0,0,2,2
70133,160,15733,20192;20253,41610,0,0,0,2,2
70134,160,15734,20282,41610,0,0,0,1,1
70135,160,15736,20575,41610,0,0,0,1,1
70136,160,15737,21208;21240,41610,0,0,0,2,2
70137,160,15738,20991,41610,0,0,0,1,1
70138,160,15740,20612;20711,41610,0,0,0,2,2
70139,160,15741,20831,41610,0,0,0,1,1
70140,160,15742,20825;20979,41610,0,0,0,2,2
70141,160,15743,20560;20721,41610,0,0,0,2,2
70142,160,15744,20757,41610,0,0,0,1,1
70143,160,15745,21060,41610,0,0,0,1,1
70144,160,15746,20665,41610,0,0,0,1,1
70145,160,15747,21271,41610,0,0,0,1,1
70146,160,15748,20779,41610,0,0,0,1,1
70147,160,15749,20855,41610,0,0,0,1,1
70148,160,15750,20441;20835,41610,0,0,0,2,2
70149,160,15752,20884;21056,41610,0,0,0,2,2
70150,160,15754,20726;20936,41610,0,0,0,2,2
70151,160,15755,20938;21112,41610,0,0,0,2,2
70152,160,15758,21076,41610,0,0,0,1,1
70153,160,15760,20897;21084,41610,0,0,0,2,2
70154,160,15762,21314,41610,0,0,0,1,1
70155,160,15766,21989;22140;24518;24621;26928;27410;28200;28284,41610,2,2,4,0,8
70156,160,15767,20916;21269;25522;27959,41610,1,0,1,2,4
70157,160,15768,21273;21433,41610,0,0,0,2,2
70158,160,15770,21290,41610,0,0,0,1,1
70159,160,15772,21608;21829,41610,0,0,1,1,2
70160,160,15775,21203;21383,41610,0,0,0,2,2
70161,160,15776,21384,41610,0,0,0,1,1
70162,160,15777,21221;21621,41610,0,0,1,1,2
70163,160,15789,18152,41975,0,0,0,1,1
70164,160,15798,18985,41975,0,0,0,1,1
70165,160,15801,19854,41975,0,0,0,1,1
70166,160,15806,19851,41975,0,0,0,1,1
70167,160,15807,20178;20183,41975,0,0,0,2,2
70168,160,15808,24399;24819;25017;25114;27833;28029;28102,41975,2,1,4,0,7
70169,160,15811,20360;20805,41975,0,0,0,2,2
70170,160,15812,20388,41975,0,0,0,1,1
70171,160,15814,20366;20477,41975,0,0,0,2,2
70172,160,15815,19675;26830,41975,0,1,0,1,2
70173,160,15817,20337;20657;24493;28081;28279,41975,2,0,1,2,5
70174,160,15820,20882;21020,41975,0,0,0,2,2
70175,160,15821,21018;21021,41975,0,0,0,2,2
70176,160,15822,20920;20999;24828;27215,41975,0,1,1,2,4
70177,160,15823,20411;20631,41975,0,0,0,2,2
70178,160,15824,20840,41975,0,0,0,1,1
70179,160,15825,20974,41975,0,0,0,1,1
70180,160,15827,20755;21042;24511;27509,41975,0,1,1,2,4
70181,160,15828,24597,41975,0,0,1,0,1
70182,160,15829,20876;20937,41975,0,0,0,2,2
70183,160,15830,21040,41975,0,0,0,1,1
70184,160,15831,21184,41975,0,0,0,1,1
70185,160,15833,21001;24720,41975,0,0,1,1,2
70186,160,15834,21593,41975,0,0,0,1,1
70187,160,15835,21347,41975,0,0,0,1,1
70188,160,15836,21318,41975,0,0,0,1,1
70189,160,15837,21475,41975,0,0,0,1,1
70190,160,15838,20709;21132,41975,0,0,0,2,2
70191,160,15839,21078;21152,41975,0,0,0,2,2
70192,160,15841,21192;21532;25731;27437,41975,0,1,1,2,4
70193,160,15842,21365;21579,41975,0,0,0,2,2
70194,160,15843,21224;21288,41975,0,0,0,2,2
70195,160,15845,21231;24845;28011,41975,1,0,1,1,3
70196,160,15846,21664;21763;25541,41975,0,0,3,0,3
70197,160,15847,20797,41975,0,0,0,1,1
70198,160,15849,21023;21374,41975,0,0,0,2,2
70199,160,15850,21043,41975,0,0,0,1,1
70200,160,15851,21316;21551,41975,0,0,0,2,2
70201,160,15852,21358;21719,41975,0,0,1,1,2
70202,160,15853,21435;21531,41975,0,0,0,2,2
70203,160,15854,21369,41975,0,0,0,1,1
70204,160,15858,21109;21787,41975,0,0,1,1,2
70205,160,15859,21402;21494,41975,0,0,0,2,2
70206,160,15860,21623,41975,0,0,1,0,1
70207,160,15863,21589,41975,0,0,0,1,1
70208,160,15864,21595,41975,0,0,0,1,1
70209,160,15876,18320,42340,0,0,0,1,1
70210,160,15885,19468,42340,0,0,0,1,1
70211,160,15887,19181,42340,0,0,0,1,1
70212,160,15888,19549,42340,0,0,0,1,1
70213,160,15891,19427;19759,42340,0,0,0,2,2
70214,160,15895,19545;19735,42340,0,0,0,2,2
70215,160,15897,19971;20079,42340,0,0,0,2,2
70216,160,15898,20578,42340,0,0,0,1,1
70217,160,15899,20060;20271,42340,0,0,0,2,2
70218,160,15901,20076;20151,42340,0,0,0,2,2
70219,160,15905,20238,42340,0,0,0,1,1
70220,160,15907,20351;24576,42340,0,0,1,1,2
70221,160,15909,20670,42340,0,0,0,1,1
70222,160,15911,21093,42340,0,0,0,1,1
70223,160,15913,20954;21107,42340,0,0,0,2,2
70224,160,15915,20747;21003,42340,0,0,0,2,2
70225,160,15918,20836;20900,42340,0,0,0,2,2
70226,160,15919,20619;21199;25628,42340,0,0,1,2,3
70227,160,15921,20881;25130;25518;28130,42340,1,0,2,1,4
70228,160,15922,20905;20914,42340,0,0,0,2,2
70229,160,15923,20953,42340,0,0,0,1,1
70230,160,15924,21675,42340,0,0,1,0,1
70231,160,15925,21353;21481,42340,0,0,0,2,2
70232,160,15928,21523;21978;25751,42340,0,0,2,1,3
70233,160,15929,21189;21292,42340,0,0,0,2,2
70234,160,15930,21303,42340,0,0,0,1,1
70235,160,15931,21141;21301,42340,0,0,0,2,2
70236,160,15933,21387,42340,0,0,0,1,1
70237,160,15934,21602;21909,42340,0,0,1,1,2
70238,160,15935,21417;21828,42340,0,0,1,1,2
70239,160,15937,21431;22017;26242,42340,0,0,2,1,3
70240,160,15938,21434;21833,42340,0,0,1,1,2
70241,160,15939,21376;21436,42340,0,0,0,2,2
70242,160,15940,21466;21561;24362;26511;26714;27492;27602;27875,42340,1,3,2,2,8
70243,160,15941,21176;21483,42340,0,0,0,2,2
70244,160,15942,21354;21515,42340,0,0,0,2,2
70245,160,15943,20962;21496,42340,0,0,0,2,2
70246,160,15945,21169;21562;25528,42340,0,0,1,2,3
70247,160,15946,21580,42340,0,0,0,1,1
70248,160,15947,21844;22050,42340,0,0,2,0,2
70249,160,15949,21212;21587,42340,0,0,0,2,2
70250,160,15950,21605;21913,42340,0,0,1,1,2
70251,160,15952,21614,42340,0,0,0,1,1
70252,160,15953,21616;21827,42340,0,0,2,0,2
70253,160,15954,21631;25534,42340,0,0,2,0,2
70254,160,15955,21645,42340,0,0,1,0,1
70255,160,15957,21615,42340,0,0,0,1,1
70256,160,15958,21062;21294;24372,42340,0,0,1,2,3
70257,160,15959,21703;21951,42340,0,0,2,0,2
70258,160,15960,21213;21704,42340,0,0,1,1,2
70259,160,15965,17705,42705,0,0,0,1,1
70260,160,15972,18280,42705,0,0,0,1,1
70261,160,15987,20608,42705,0,0,0,1,1
70262,160,15989,20270,42705,0,0,0,1,1
70263,160,15992,20546;20702;24808;27417;27913,42705,1,1,1,2,5
70264,160,15995,20601;20957,42705,0,0,0,2,2
70265,160,15997,20710;20764,42705,0,0,0,2,2
70266,160,15998,21364;21522,42705,0,0,0,2,2
70267,160,15999,20504,42705,0,0,0,1,1
70268,160,16001,20901;20987;25058;27021;28122,42705,1,1,1,2,5
70269,160,16002,20254;20494,42705,0,0,0,2,2
70270,160,16003,21222,42705,0,0,0,1,1
70271,160,16004,21261,42705,0,0,0,1,1
70272,160,16005,21191;25627;25727,42705,0,0,2,1,3
70273,160,16006,21210;21533,42705,0,0,0,2,2
70274,160,16007,21263;25728,42705,0,0,1,1,2
70275,160,16009,21712,42705,0,0,1,0,1
70276,160,16010,20796;21336,42705,0,0,0,2,2
70277,160,16012,20856;21265;24064;27077,42705,0,1,1,2,4
70278,160,16013,21241;21363,42705,0,0,0,2,2
70279,160,16014,21468,42705,0,0,0,1,1
70280,160,16015,21105;21377,42705,0,0,0,2,2
70281,160,16016,21368;21670,42705,0,0,1,1,2
70282,160,16017,21538;21636;24765,42705,0,0,2,1,3
70283,160,16018,21429;21689,42705,0,0,1,1,2
70284,160,16019,21409;21461,42705,0,0,0,2,2
70285,160,16020,20858;21389,42705,0,0,0,2,2
70286,160,16021,21490,42705,0,0,0,1,1
70287,160,16022,21439;21858;26339,42705,0,0,2,1,3
70288,160,16023,21214;21503,42705,0,0,0,2,2
70289,160,16024,21618;21625,42705,0,0,2,0,2
70290,160,16025,22138;26517,42705,0,0,2,0,2
70291,160,16026,21527,42705,0,0,0,1,1
70292,160,16027,21912;25837,42705,0,0,2,0,2
70293,160,16028,22131,42705,0,0,1,0,1
70294,160,16029,21558;21566,42705,0,0,0,2,2
70295,160,16030,21469;21571,42705,0,0,0,2,2
70296,160,16031,21406;21895,42705,0,0,1,1,2
70297,160,16032,21728,42705,0,0,1,0,1
70298,160,16033,21671,42705,0,0,1,0,1
70299,160,16034,21274;21455,42705,0,0,0,2,2
70300,160,16035,22053;22183;24889,42705,0,0,3,0,3
70301,160,16036,21715;22008;24378;27095,42705,0,1,3,0,4
70302,160,16037,21722,42705,0,0,1,0,1
70303,160,16038,21653;21866,42705,0,0,2,0,2
70304,160,16039,21773,42705,0,0,1,0,1
70305,160,16040,21777,42705,0,0,1,0,1
70306,160,16041,21235;21780,42705,0,0,1,1,2
70307,160,16042,21458;21792,42705,0,0,1,1,2
70308,160,16043,21525,42705,0,0,0,1,1
70309,160,16044,21781;21801,42705,0,0,2,0,2
70310,160,16045,21678;21893,42705,0,0,2,0,2
70311,160,16062,18709,43070,0,0,0,1,1
70312,160,16064,19479,43070,0,0,0,1,1
70313,160,16074,19794;20033,43070,0,0,0,2,2
70314,160,16077,20158,43070,0,0,0,1,1
70315,160,16078,20119,43070,0,0,0,1,1
70316,160,16081,20468,43070,0,0,0,1,1
70317,160,16082,21007;25033,43070,0,0,1,1,2
70318,160,16084,21155,43070,0,0,0,1,1
70319,160,16085,20738,43070,0,0,0,1,1
70320,160,16087,20703;20875,43070,0,0,0,2,2
70321,160,16089,20903;21174,43070,0,0,0,2,2
70322,160,16090,20972;21135,43070,0,0,0,2,2
70323,160,16091,21024,43070,0,0,0,1,1
70324,160,16092,21361,43070,0,0,0,1,1
70325,160,16093,21518,43070,0,0,0,1,1
70326,160,16096,21480,43070,0,0,0,1,1
70327,160,16097,20867;21129,43070,0,0,0,2,2
70328,160,16098,21544,43070,0,0,0,1,1
70329,160,16099,21574;21816,43070,0,0,1,1,2
70330,160,16100,23737,43070,0,0,1,0,1
70331,160,16101,20975;21178,43070,0,0,0,2,2
70332,160,16102,20980;21267,43070,0,0,0,2,2
70333,160,16105,21323;21333,43070,0,0,0,2,2
70334,160,16106,21144;21423,43070,0,0,0,2,2
70335,160,16107,21366;21526,43070,0,0,0,2,2
70336,160,16108,21403;21679,43070,0,0,1,1,2
70337,160,16109,21604,43070,0,0,0,1,1
70338,160,16110,21116;21746;25539,43070,0,0,2,1,3
70339,160,16112,21117;21460,43070,0,0,0,2,2
70340,160,16113,21448;22065,43070,0,0,1,1,2
70341,160,16114,21947,43070,0,0,1,0,1
70342,160,16115,21510;21876;24983;25934;27821;28116;28303,43070,2,1,3,1,7
70343,160,16116,20834;21495,43070,0,0,0,2,2
70344,160,16117,21069;21536,43070,0,0,0,2,2
70345,160,16118,21248;21734;25171,43070,0,0,2,1,3
70346,160,16120,21489;21619,43070,0,0,1,1,2
70347,160,16121,21624,43070,0,0,1,0,1
70348,160,16124,21498;21795,43070,0,0,1,1,2
70349,160,16125,21652;21841,43070,0,0,2,0,2
70350,160,16126,21513;25925,43070,0,0,1,1,2
70351,160,16129,21694;21747;26338,43070,0,0,3,0,3
70352,160,16130,21476;21628,43070,0,0,1,1,2
70353,160,16131,21477;21744;25355;28142,43070,1,0,2,1,4
70354,160,16132,21967;22010;25842,43070,0,0,3,0,3
70355,160,16134,21802;22230,43070,0,0,2,0,2
70356,160,16135,22042;22081;26243,43070,0,0,3,0,3
70357,160,16136,21637;21811,43070,0,0,2,0,2
70358,160,16137,22153,43070,0,0,1,0,1
70359,160,16138,21835;21861;25451,43070,0,0,3,0,3
70360,160,16139,21459;21836;25448;25929;27749;27760;28060;28246,43070,2,2,3,1,8
70361,160,16140,21847;22003;25937,43070,0,0,3,0,3
70362,160,16141,21736;21922;26039,43070,0,0,3,0,3
70363,160,16142,21682;21850,43070,0,0,2,0,2
70364,160,16143,21743,43070,0,0,1,0,1
70365,160,16144,21864;22210,43070,0,0,2,0,2
70366,160,16145,21731;21884;25743,43070,0,0,3,0,3
70367,160,16146,21770;21896,43070,0,0,2,0,2
70368,160,16147,21552;21899,43070,0,0,1,1,2
70369,160,16148,22235;25761;27556,43070,0,1,2,0,3
70370,160,16149,21948;22195;25851,43070,0,0,3,0,3
70371,160,16152,17571,43435,0,0,0,1,1
70372,160,16169,19408,43435,0,0,0,1,1
70373,160,16171,19380,43435,0,0,0,1,1
70374,160,16176,19969;20318,43435,0,0,0,2,2
70375,160,16179,19939;20137,43435,0,0,0,2,2
70376,160,16180,20637,43435,0,0,0,1,1
70377,160,16185,20406,43435,0,0,0,1,1
70378,160,16187,20493;20787,43435,0,0,0,2,2
70379,160,16188,21216,43435,0,0,0,1,1
70380,160,16189,20852,43435,0,0,0,1,1
70381,160,16191,20419,43435,0,0,0,1,1
70382,160,16192,21005,43435,0,0,0,1,1
70383,160,16194,21033;21071,43435,0,0,0,2,2
70384,160,16195,20928,43435,0,0,0,1,1
70385,160,16196,21264;21657,43435,0,0,1,1,2
70386,160,16197,20832;21139,43435,0,0,0,2,2
70387,160,16198,21080;21173,43435,0,0,0,2,2
70388,160,16199,21251;21307,43435,0,0,0,2,2
70389,160,16200,20735;21356,43435,0,0,0,2,2
70390,160,16201,20946;21658;26035,43435,0,0,2,1,3
70391,160,16202,21372;21441,43435,0,0,0,2,2
70392,160,16203,21673;21873,43435,0,0,2,0,2
70393,160,16205,21611;22078,43435,0,0,1,1,2
70394,160,16206,22194;25566,43435,0,0,2,0,2
70395,160,16208,21296;21565,43435,0,0,0,2,2
70396,160,16211,21695;21868,43435,0,0,2,0,2
70397,160,16212,21632,43435,0,0,1,0,1
70398,160,16214,21706;22241,43435,0,0,2,0,2
70399,160,16215,21708,43435,0,0,1,0,1
70400,160,16216,21677;21710;25735;28054,43435,1,0,3,0,4
70401,160,16217,22208;22526,43435,0,0,2,0,2
70402,160,16218,21535;21751,43435,0,0,1,1,2
70403,160,16219,21359;22094,43435,0,0,1,1,2
70404,160,16220,21754;21937,43435,0,0,2,0,2
70405,160,16221,21755;25249,43435,0,0,2,0,2
70406,160,16222,21667;21760;25356;25540,43435,0,0,4,0,4
70407,160,16223,21647,43435,0,0,1,0,1
70408,160,16224,21785,43435,0,0,1,0,1
70409,160,16225,21564;21786,43435,0,0,1,1,2
70410,160,16226,21820,43435,0,0,1,0,1
70411,160,16227,21700;21823,43435,0,0,2,0,2
70412,160,16228,21832;25447,43435,0,0,2,0,2
70413,160,16229,21941;25553,43435,0,0,2,0,2
70414,160,16230,21849;21881,43435,0,0,2,0,2
70415,160,16231,21867;25932,43435,0,0,2,0,2
70416,160,16232,21762;21880,43435,0,0,2,0,2
70417,160,16233,21601;21897,43435,0,0,1,1,2
70418,160,16234,21933;22152,43435,0,0,2,0,2
70419,160,16235,21938;22309,43435,0,0,2,0,2
70420,160,16237,21392;21953;25749,43435,0,0,2,1,3
70421,160,16238,21749;21956,43435,0,0,2,0,2
70422,160,16240,21964;21992;25750,43435,0,0,3,0,3
70423,160,16241,21968;22301,43435,0,0,2,0,2
70424,160,16242,22139;22350,43435,0,0,2,0,2
70425,160,16243,21926;21998,43435,0,0,2,0,2
70426,160,16244,22014,43435,0,0,1,0,1
70427,160,16245,22016;22214;25944;26153;26246;28061,43435,1,0,5,0,6
70428,160,16246,22307,43435,0,0,1,0,1
70429,160,16247,22031,43435,0,0,1,0,1
70430,160,16248,22123;26147,43435,0,0,2,0,2
70431,160,16249,22013;22040;25844;25939,43435,0,0,4,0,4
70432,160,16256,18184,43800,0,0,0,1,1
70433,160,16265,18596;18632,43800,0,0,0,2,2
70434,160,16267,18554,43800,0,0,0,1,1
70435,160,16271,18668,43800,0,0,0,1,1
70436,160,16274,20031,43800,0,0,0,1,1
70437,160,16280,20602,43800,0,0,0,1,1
70438,160,16284,20562;20648,43800,0,0,0,2,2
70439,160,16289,20519;20824,43800,0,0,0,2,2
70440,160,16290,20981,43800,0,0,0,1,1
70441,160,16294,20908;21126,43800,0,0,0,2,2
70442,160,16296,21470,43800,0,0,0,1,1
70443,160,16297,21635;25535,43800,0,0,2,0,2
70444,160,16298,21239;21660,43800,0,0,1,1,2
70445,160,16299,21158;21430,43800,0,0,0,2,2
70446,160,16300,25338;28239,43800,1,0,1,0,2
70447,160,16301,21041;21349,43800,0,0,0,2,2
70448,160,16303,20935;21507;24958;25824;27964;28258,43800,2,0,2,2,6
70449,160,16304,21512;21765;26037,43800,0,0,2,1,3
70450,160,16305,21257;21705;24970;27927;28301,43800,2,0,2,1,5
70451,160,16306,21702,43800,0,0,1,0,1
70452,160,16307,21854,43800,0,0,1,0,1
70453,160,16308,21588,43800,0,0,0,1,1
70454,160,16309,21594,43800,0,0,0,1,1
70455,160,16311,21622;21804,43800,0,0,2,0,2
70456,160,16312,21784;21930,43800,0,0,2,0,2
70457,160,16313,21499;21597;24751,43800,0,0,1,2,3
70458,160,16314,21869;25452;25548,43800,0,0,3,0,3
70459,160,16316,21890;21939,43800,0,0,2,0,2
70460,160,16317,21690;22007,43800,0,0,2,0,2
70461,160,16318,21691;21957,43800,0,0,2,0,2
70462,160,16319,21697,43800,0,0,1,0,1
70463,160,16321,21629;22062;25755,43800,0,0,3,0,3
70464,160,16322,21309;21560,43800,0,0,0,2,2
70465,160,16323,21961;22227,43800,0,0,2,0,2
70466,160,16325,21860;22364;26347,43800,0,0,3,0,3
70467,160,16327,21842;22141,43800,0,0,2,0,2
70468,160,16329,21910;22147,43800,0,0,2,0,2
70469,160,16331,21917;22286,43800,0,0,2,0,2
70470,160,16332,21936;22148,43800,0,0,2,0,2
70471,160,16333,21946;22282,43800,0,0,2,0,2
70472,160,16336,22474,43800,0,0,1,0,1
70473,160,16337,21696;22267,43800,0,0,2,0,2
70474,160,16338,21644;22009;25556,43800,0,0,3,0,3
70475,160,16340,22041;22133,43800,0,0,2,0,2
70476,160,16342,22030;26042,43800,0,0,2,0,2
70477,160,16344,22260;22421,43800,0,0,2,0,2
70478,160,16345,22085;22215,43800,0,0,2,0,2
70479,160,16346,22317,43800,0,0,1,0,1
70480,160,16347,22136;22333;26346,43800,0,0,3,0,3
70481,160,16348,21803;22106;25941,43800,0,0,3,0,3
70482,160,16349,21935;22190,43800,0,0,2,0,2
70483,160,16350,22411;22493,43800,0,0,2,0,2
70484,160,16351,21758;22149;24990,43800,0,0,3,0,3
70485,160,16352,22157;22216,43800,0,0,2,0,2
70486,160,16361,18243;18426,44165,0,0,0,2,2
70487,160,16365,18721,44165,0,0,0,1,1
70488,160,16367,19387,44165,0,0,0,1,1
70489,160,16368,19190,44165,0,0,0,1,1
70490,160,16376,19334,44165,0,0,0,1,1
70491,160,16379,19218,44165,0,0,0,1,1
70492,160,16381,20105,44165,0,0,0,1,1
70493,160,16390,20577;21215,44165,0,0,0,2,2
70494,160,16391,21472;21686,44165,0,0,1,1,2
70495,160,16393,20883;21150,44165,0,0,0,2,2
70496,160,16395,21019;21089,44165,0,0,0,2,2
70497,160,16396,21375,44165,0,0,0,1,1
70498,160,16397,20850;21059,44165,0,0,0,2,2
70499,160,16398,21077;21546,44165,0,0,0,2,2
70500,160,16399,20837,44165,0,0,0,1,1
70501,160,16400,21424,44165,0,0,0,1,1
70502,160,16401,21194;21572,44165,0,0,0,2,2
70503,160,16402,21207;22004;24986,44165,0,0,2,1,3
70504,160,16404,21179;21233,44165,0,0,0,2,2
70505,160,16406,21029;21390,44165,0,0,0,2,2
70506,160,16407,21165;21350;25228;28317,44165,1,0,1,2,4
70507,160,16408,21610,44165,0,0,0,1,1
70508,160,16409,21775;21887;26038,44165,0,0,3,0,3
70509,160,16410,21655;26143,44165,0,0,2,0,2
70510,160,16411,21756;21959,44165,0,0,2,0,2
70511,160,16412,21491;21569,44165,0,0,0,2,2
70512,160,16413,21407;21639;25536,44165,0,0,2,1,3
70513,160,16414,21606;21875,44165,0,0,1,1,2
70514,160,16415,22311;22390,44165,0,0,2,0,2
70515,160,16416,21718,44165,0,0,1,0,1
70516,160,16418,22113;22196,44165,0,0,2,0,2
70517,160,16419,22192;22332;26044,44165,0,0,3,0,3
70518,160,16420,21505;21894;25455,44165,0,0,2,1,3
70519,160,16421,21900;22367;26050;28264,44165,1,0,3,0,4
70520,160,16422,21901;22302,44165,0,0,2,0,2
70521,160,16423,21874,44165,0,0,1,0,1
70522,160,16424,21282;21444,44165,0,0,0,2,2
70523,160,16425,21987;22033;26040,44165,0,0,3,0,3
70524,160,16427,21656;22250,44165,0,0,2,0,2
70525,160,16428,21908;22029,44165,0,0,2,0,2
70526,160,16429,22446;22549,44165,0,0,2,0,2
70527,160,16430,21843;22049;25754,44165,0,0,3,0,3
70528,160,16431,22066;22114,44165,0,0,2,0,2
70529,160,16432,22025;22368;26348,44165,0,0,3,0,3
70530,160,16433,21815;22032;25938,44165,0,0,3,0,3
70531,160,16435,21767;22176,44165,0,0,2,0,2
70532,160,16436,22298;25858;26157;28261,44165,1,0,3,0,4
70533,160,16437,21932;22499;26622,44165,0,1,2,0,3
70534,160,16438,22455;26728,44165,0,1,1,0,2
70535,160,16440,22198;22555,44165,0,0,2,0,2
70536,160,16441,21906,44165,0,0,1,0,1
70537,160,16442,21617;22206;26342,44165,0,0,3,0,3
70538,160,16443,22395;26519,44165,0,0,2,0,2
70539,160,16444,22238;22331,44165,0,0,2,0,2
70540,160,16451,18664,44530,0,0,0,1,1
70541,160,16457,19374,44530,0,0,0,1,1
70542,160,16464,19840,44530,0,0,0,1,1
70543,160,16468,19959;19999,44530,0,0,0,2,2
70544,160,16469,19862;20367,44530,0,0,0,2,2
70545,160,16471,20244,44530,0,0,0,1,1
70546,160,16475,20521,44530,0,0,0,1,1
70547,160,16477,20184,44530,0,0,0,1,1
70548,160,16478,20734,44530,0,0,0,1,1
70549,160,16480,20877;20967,44530,0,0,0,2,2
70550,160,16481,20733,44530,0,0,0,1,1
70551,160,16486,21083;21195,44530,0,0,0,2,2
70552,160,16487,21328;21450;25524;28148,44530,1,0,1,2,4
70553,160,16488,21817;22084,44530,0,0,2,0,2
70554,160,16489,21539;21740,44530,0,0,1,1,2
70555,160,16490,21570;22508,44530,0,0,1,1,2
70556,160,16491,21902;21980;25461,44530,0,0,3,0,3
70557,160,16492,21726;25246,44530,0,0,2,0,2
70558,160,16493,21590;21776;25064;28123,44530,1,0,2,1,4
70559,160,16494,21659;22134,44530,0,0,2,0,2
70560,160,16495,21462;21665,44530,0,0,1,1,2
70561,160,16497,21714;21782,44530,0,0,2,0,2
70562,160,16498,21343;21797,44530,0,0,1,1,2
70563,160,16499,21891;22060;25592;26618;26835,44530,0,2,3,0,5
70564,160,16501,21994;22296;25191;26172,44530,0,0,4,0,4
70565,160,16502,21555;21883;24558;27311;27406,44530,0,2,2,1,5
70566,160,16503,21871;22137;25467,44530,0,0,3,0,3
70567,160,16504,21886,44530,0,0,1,0,1
70568,160,16505,21911;22012,44530,0,0,2,0,2
70569,160,16506,22006;24671;26430;27107,44530,0,1,3,0,4
70570,160,16507,21931;21981,44530,0,0,2,0,2
70571,160,16510,22128;22171;25942;26150,44530,0,0,4,0,4
70572,160,16511,21752;21889,44530,0,0,2,0,2
70573,160,16512,22090;22558;26351;26439;26834,44530,0,1,4,0,5
70574,160,16514,22328;22489;25961,44530,0,0,3,0,3
70575,160,16515,21934;22104,44530,0,0,2,0,2
70576,160,16516,22614;22699;26445,44530,0,0,3,0,3
70577,160,16517,22156;22178;25850;26244;27439,44530,0,1,4,0,5
70578,160,16518,22264;22632,44530,0,0,2,0,2
70579,160,16519,21674;22034;25464,44530,0,0,3,0,3
70580,160,16520,22170;22505,44530,0,0,2,0,2
70581,160,16521,22181;22347,44530,0,0,2,0,2
70582,160,16522,22242;22330;26049;26159,44530,0,0,4,0,4
70583,160,16524,22292;22485;26344,44530,0,0,3,0,3
70584,160,16525,22023;22297,44530,0,0,2,0,2
70585,160,16526,21975;22304;26048;26345;26518,44530,0,0,5,0,5
70586,160,16527,22528;22634,44530,0,0,2,0,2
70587,160,16528,22378;22696;25593;25783;27650,44530,0,1,4,0,5
70588,160,16529,22046;22355,44530,0,0,2,0,2
70589,160,16530,22168;22356,44530,0,0,2,0,2
70590,160,16531,22365;22671;26836,44530,0,1,2,0,3
70591,160,16536,18696,44895,0,0,0,1,1
70592,160,16542,19161,44895,0,0,0,1,1
70593,160,16543,19182,44895,0,0,0,1,1
70594,160,16553,20417;20573,44895,0,0,0,2,2
70595,160,16555,20330;20496,44895,0,0,0,2,2
70596,160,16556,20336;20609,44895,0,0,0,2,2
70597,160,16558,20486;21122,44895,0,0,0,2,2
70598,160,16563,21380,44895,0,0,0,1,1
70599,160,16565,20894;21091;25139;28131,44895,1,0,1,2,4
70600,160,16567,21148;21442,44895,0,0,0,2,2
70601,160,16570,21079;21330,44895,0,0,0,2,2
70602,160,16571,21378,44895,0,0,0,1,1
70603,160,16572,21396;21764,44895,0,0,1,1,2
70604,160,16573,21807;21838,44895,0,0,2,0,2
70605,160,16576,21661,44895,0,0,1,0,1
70606,160,16577,21388,44895,0,0,0,1,1
70607,160,16579,21337;22011,44895,0,0,1,1,2
70608,160,16580,21830;21919,44895,0,0,2,0,2
70609,160,16581,21578;21634,44895,0,0,1,1,2
70610,160,16582,21542;21882,44895,0,0,1,1,2
70611,160,16585,21453;21779,44895,0,0,1,1,2
70612,160,16586,21688,44895,0,0,1,0,1
70613,160,16588,22187;22254,44895,0,0,2,0,2
70614,160,16589,22035;22080,44895,0,0,2,0,2
70615,160,16590,22259;22303;25664,44895,0,0,3,0,3
70616,160,16591,21851;22127,44895,0,0,2,0,2
70617,160,16592,21852;22327,44895,0,0,2,0,2
70618,160,16593,21650;21997;25462,44895,0,0,3,0,3
70619,160,16595,21916;22165;25747,44895,0,0,3,0,3
70620,160,16596,21877,44895,0,0,1,0,1
70621,160,16597,22293;22295,44895,0,0,2,0,2
70622,160,16598,22222;22336,44895,0,0,2,0,2
70623,160,16599,22251;25676;26434,44895,0,0,3,0,3
70624,160,16600,21649;22075;25654,44895,0,0,3,0,3
70625,160,16601,21800;22077;26431,44895,0,0,3,0,3
70626,160,16603,21859;22322;25479;27235,44895,0,1,3,0,4
70627,160,16604,22101;22757,44895,0,0,2,0,2
70628,160,16605,22273;22531,44895,0,0,2,0,2
70629,160,16606,21759;26036,44895,0,0,2,0,2
70630,160,16607,22291;22693;26838,44895,0,1,2,0,3
70631,160,16608,22564;22604,44895,0,0,2,0,2
70632,160,16609,22713;22740,44895,0,0,2,0,2
70633,160,16611,22243,44895,0,0,1,0,1
70634,160,16612,22496;25772;26255;26729,44895,0,1,3,0,4
70635,160,16613,22051;22262;25762,44895,0,0,3,0,3
70636,160,16614,22314;22335;26831,44895,0,1,2,0,3
70637,160,16615,22257,44895,0,0,1,0,1
70638,160,16616,22253;22379;24996;28118,44895,1,0,3,0,4
70639,160,16617,22353;22394,44895,0,0,2,0,2
70640,160,16618,22018;22396;25483,44895,0,0,3,0,3
70641,160,16619,22288;22401,44895,0,0,2,0,2
70642,160,16620,21969;22404;26252,44895,0,0,3,0,3
70643,160,16621,22386;22756;26270,44895,0,0,3,0,3
70644,160,16622,22442;22695,44895,0,0,2,0,2
70645,160,16623,22452;22859,44895,0,0,2,0,2
70646,160,16624,22346;22542;25765,44895,0,0,3,0,3
70647,160,16625,22484;25959,44895,0,0,2,0,2
70648,160,16626,22582;22747,44895,0,0,2,0,2
70649,160,16634,19154,45260,0,0,0,1,1
70650,160,16646,19622,45260,0,0,0,1,1
70651,160,16647,19957;19995,45260,0,0,0,2,2
70652,160,16653,20020;20034,45260,0,0,0,2,2
70653,160,16663,20558;20904,45260,0,0,0,2,2
70654,160,16664,21035;21219,45260,0,0,0,2,2
70655,160,16665,21379,45260,0,0,0,1,1
70656,160,16666,21183;21530,45260,0,0,0,2,2
70657,160,16668,21609;25530,45260,0,0,1,1,2
70658,160,16669,21414;21641,45260,0,0,1,1,2
70659,160,16670,21643;22359;26250,45260,0,0,3,0,3
70660,160,16673,21654;25164,45260,0,0,2,0,2
70661,160,16674,21709,45260,0,0,1,0,1
70662,160,16675,21102;25928,45260,0,0,1,1,2
70663,160,16676,21646;21769,45260,0,0,2,0,2
70664,160,16677,21960;22020;26149;26340,45260,0,0,4,0,4
70665,160,16678,21737;21878,45260,0,0,2,0,2
70666,160,16679,21915;22203;25759,45260,0,0,3,0,3
70667,160,16680,21504;22261,45260,0,0,1,1,2
70668,160,16681,21517;21905,45260,0,0,1,1,2
70669,160,16682,21630;25438,45260,0,0,2,0,2
70670,160,16684,22207,45260,0,0,1,0,1
70671,160,16685,22043,45260,0,0,1,0,1
70672,160,16686,22063;22158,45260,0,0,2,0,2
70673,160,16687,22097;22285,45260,0,0,2,0,2
70674,160,16688,22270,45260,0,0,1,0,1
70675,160,16689,21914;22221;26343,45260,0,0,3,0,3
70676,160,16690,22329;22651,45260,0,0,2,0,2
70677,160,16691,22536;22807;25967,45260,0,0,3,0,3
70678,160,16692,22252;22349,45260,0,0,2,0,2
70679,160,16693,22038;22400;26251,45260,0,0,3,0,3
70680,160,16694,22915;26735;27132,45260,0,2,1,0,3
70681,160,16695,22326;22417;25195;26832,45260,0,1,3,0,4
70682,160,16696,22387;22398,45260,0,0,2,0,2
70683,160,16697,22686;22793,45260,0,0,2,0,2
70684,160,16698,21839;22437;25399,45260,0,0,3,0,3
70685,160,16699,22885;26370,45260,0,0,2,0,2
70686,160,16700,22098;22478,45260,0,0,2,0,2
70687,160,16701,22492;22796,45260,0,0,2,0,2
70688,160,16703,22501;22619;26168,45260,0,0,3,0,3
70689,160,16704,22780;22814;26630,45260,0,1,2,0,3
70690,160,16705,22169;22529,45260,0,0,2,0,2
70691,160,16706,22201;22535;25680,45260,0,0,3,0,3
70692,160,16707,22553;25968,45260,0,0,2,0,2
70693,160,16708,22507;22556;26438,45260,0,0,3,0,3
70694,160,16709,22560;22645;25972,45260,0,0,3,0,3
70695,160,16710,22269;22577;25868;26064,45260,0,0,4,0,4
70696,160,16712,22338;22623;26619,45260,0,1,2,0,3
70697,160,16713,22275;22626;26357,45260,0,0,3,0,3
70698,160,16729,19280,45625,0,0,0,1,1
70699,160,16732,19779,45625,0,0,0,1,1
70700,160,16736,19565,45625,0,0,0,1,1
70701,160,16737,20065;20299,45625,0,0,0,2,2
70702,160,16746,21034;21063,45625,0,0,0,2,2
70703,160,16748,21519,45625,0,0,0,1,1
70704,160,16750,21399;21451,45625,0,0,0,2,2
70705,160,16751,21325;21790,45625,0,0,1,1,2
70706,160,16752,21352,45625,0,0,0,1,1
70707,160,16754,21885;21942,45625,0,0,2,0,2
70708,160,16755,21949;22015,45625,0,0,2,0,2
70709,160,16759,21638;22026,45625,0,0,2,0,2
70710,160,16761,21419;21774,45625,0,0,1,1,2
70711,160,16762,21945;22768,45625,0,0,2,0,2
70712,160,16764,21958;21970,45625,0,0,2,0,2
70713,160,16765,21721;22093;25561;27753;28250,45625,1,1,3,0,5
70714,160,16766,21993;22362,45625,0,0,2,0,2
70715,160,16767,22039;22245;26247,45625,0,0,3,0,3
70716,160,16768,22048;22476;26621,45625,0,1,2,0,3
70717,160,16769,21853;22073;25378;27641,45625,0,1,3,0,4
70718,160,16770,22124;22561;26623,45625,0,1,2,0,3
70719,160,16772,22122;22281;25278;26248;26435,45625,0,0,5,0,5
70720,160,16773,22878;22890;26841,45625,0,1,2,0,3
70721,160,16774,22126;22638,45625,0,0,2,0,2
70722,160,16775,22001;22276;25570;27552,45625,0,1,3,0,4
70723,160,16777,22237;22403;26164,45625,0,0,3,0,3
70724,160,16778,22422;22681,45625,0,0,2,0,2
70725,160,16779,22154;22808;25789,45625,0,0,3,0,3
70726,160,16780,22021;22817;26365,45625,0,0,3,0,3
70727,160,16781,22504;22622;24800;26256,45625,0,0,4,0,4
70728,160,16782,22070;22540,45625,0,0,2,0,2
70729,160,16783,22418;22545;26437,45625,0,0,3,0,3
70730,160,16784,22319;22374;25767,45625,0,0,3,0,3
70731,160,16785,22456;22584,45625,0,0,2,0,2
70732,160,16786,22891;23052;26946;27135,45625,0,2,2,0,4
70733,160,16787,23098,45625,0,0,1,0,1
70734,160,16788,22939;25698;26281;28345,45625,1,0,3,0,4
70735,160,16789,22673;22851;26368,45625,0,0,3,0,3
70736,160,16790,22679;22961,45625,0,0,2,0,2
70737,160,16791,22839;22862;25599;25883;26273;26529,45625,0,0,6,0,6
70738,160,16792,22685;26522,45625,0,0,2,0,2
70739,160,16793,22218,45625,0,0,1,0,1
70740,160,16794,22586;22812;26527;26943,45625,0,1,3,0,4
70741,160,16795,22708;22832;26629,45625,0,1,2,0,3
70742,160,16796,22701;22714;25979,45625,0,0,3,0,3
70743,160,16797,22725;22944;27028,45625,0,1,2,0,3
70744,160,16798,22409;22742;26174,45625,0,0,3,0,3
70745,160,16799,22572;22745,45625,0,0,2,0,2
70746,160,16800,22658;22822;25986;26078;26730;27851;28064,45625,1,2,4,0,7
70747,160,16801,22770;25690;26175;27845,45625,0,1,3,0,4
70748,160,16817,19109,45990,0,0,0,1,1
70749,160,16822,19831,45990,0,0,0,1,1
70750,160,16832,20346;20534,45990,0,0,0,2,2
70751,160,16834,20284;20633,45990,0,0,0,2,2
70752,160,16836,20500;20902;25133,45990,0,0,1,2,3
70753,160,16837,20741;21032,45990,0,0,0,2,2
70754,160,16839,20750,45990,0,0,0,1,1
70755,160,16840,20929,45990,0,0,0,1,1
70756,160,16841,21134;21713,45990,0,0,1,1,2
70757,160,16842,21338;21360,45990,0,0,0,2,2
70758,160,16843,21500,45990,0,0,0,1,1
70759,160,16844,21575,45990,0,0,0,1,1
70760,160,16845,22166,45990,0,0,1,0,1
70761,160,16847,22069;22345,45990,0,0,2,0,2
70762,160,16848,21720;22054,45990,0,0,2,0,2
70763,160,16849,21733;22150,45990,0,0,2,0,2
70764,160,16851,21382;21846,45990,0,0,1,1,2
70765,160,16852,21813;22217;25104;25471,45990,0,0,4,0,4
70766,160,16853,21837;22130,45990,0,0,2,0,2
70767,160,16854,21598;22231,45990,0,0,1,1,2
70768,160,16856,21794;21976,45990,0,0,2,0,2
70769,160,16857,22246;26047,45990,0,0,2,0,2
70770,160,16860,22278,45990,0,0,1,0,1
70771,160,16861,22351;22370,45990,0,0,2,0,2
70772,160,16862,22461;22734;25497;26360,45990,0,0,4,0,4
70773,160,16863,22413;22743,45990,0,0,2,0,2
70774,160,16864,22784;26363;26942,45990,0,1,2,0,3
70775,160,16865,22197;22450;25677,45990,0,0,3,0,3
70776,160,16866,22688;22917,45990,0,0,2,0,2
70777,160,16867,22465;22617;25491,45990,0,0,3,0,3
70778,160,16868,22761;22936;26087;26635,45990,0,1,3,0,4
70779,160,16869,22538;22726,45990,0,0,2,0,2
70780,160,16870,22597;22659,45990,0,0,2,0,2
70781,160,16871,22471;22557;25969,45990,0,0,3,0,3
70782,160,16872,22661;22715;25686,45990,0,0,3,0,3
70783,160,16874,22255;22676;25782;26443;26837,45990,0,1,4,0,5
70784,160,16875,22683;22754,45990,0,0,2,0,2
70785,160,16876,22694;22852;26523;26628,45990,0,1,3,0,4
70786,160,16878,23014;26373,45990,0,0,2,0,2
70787,160,16879,22809;22941,45990,0,0,2,0,2
70788,160,16881,22340;22884,45990,0,0,2,0,2
70789,160,16882,18365,46355,0,0,0,1,1
70790,160,16886,19001,46355,0,0,0,1,1
70791,160,16891,19232,46355,0,0,0,1,1
70792,160,16900,20296,46355,0,0,0,1,1
70793,160,16902,19906,46355,0,0,0,1,1
70794,160,16913,20891,46355,0,0,0,1,1
70795,160,16916,21322;21438;24949,46355,0,0,1,2,3
70796,160,16921,21391,46355,0,0,0,1,1
70797,160,16922,21699;21739,46355,0,0,2,0,2
70798,160,16925,21729,46355,0,0,1,0,1
70799,160,16928,22185;26043,46355,0,0,2,0,2
70800,160,16929,21848;22229,46355,0,0,2,0,2
70801,160,16930,21929;22058;25748;26240;28055,46355,1,0,4,0,5
70802,160,16932,22173,46355,0,0,1,0,1
70803,160,16934,22449,46355,0,0,1,0,1
70804,160,16936,22200;22249;25661,46355,0,0,3,0,3
70805,160,16937,22306;22820,46355,0,0,2,0,2
70806,160,16938,22313;23166;26199,46355,0,0,3,0,3
70807,160,16939,22578;25777;26440;28156,46355,1,0,3,0,4
70808,160,16940,22342;22598,46355,0,0,2,0,2
70809,160,16941,22866,46355,0,0,1,0,1
70810,160,16942,22677,46355,0,0,1,0,1
70811,160,16943,22118;22371;25766;26161,46355,0,0,4,0,4
70812,160,16944,22376;22785;26176,46355,0,0,3,0,3
70813,160,16945,22384;22670,46355,0,0,2,0,2
70814,160,16946,22415;22948,46355,0,0,2,0,2
70815,160,16948,22163;22563;25867;26352,46355,0,0,4,0,4
70816,160,16949,21966;22451,46355,0,0,2,0,2
70817,160,16950,22525;22792,46355,0,0,2,0,2
70818,160,16951,25582,46355,0,0,1,0,1
70819,160,16952,22290;22487;26056;26350,46355,0,0,4,0,4
70820,160,16953,22500;22687;25976;26268,46355,0,0,4,0,4
70821,160,16954,22629;22731;25687,46355,0,0,3,0,3
70822,160,16955,22102;22312;25668,46355,0,0,3,0,3
70823,160,16956,22225;22602;25406;25591;25970;26940,46355,0,1,5,0,6
70824,160,16957,22864,46355,0,0,1,0,1
70825,160,16958,22624;23219;25608;26292;26379;26468;26551;26854,46355,0,1,7,0,8
70826,160,16959,22637;22777,46355,0,0,2,0,2
70827,160,16960,22607;22667,46355,0,0,2,0,2
70828,160,16961,22647;22698,46355,0,0,2,0,2
70829,160,16962,22700;23008,46355,0,0,2,0,2
70830,160,16963,22940;22965;25505;26090,46355,0,0,4,0,4
70831,160,16964,22174;22750;25499;25980;26447,46355,0,0,5,0,5
70832,160,16965,22204;22762;27025,46355,0,1,2,0,3
70833,160,16966,22497;22775,46355,0,0,2,0,2
70834,160,16967,22835;23205;26103,46355,0,0,3,0,3
70835,160,16969,22850;22989;26632,46355,0,1,2,0,3
70836,160,16971,22886;23250;26471,46355,0,0,3,0,3
70837,160,16972,22763;22895,46355,0,0,2,0,2
70838,160,16973,22916;23178;26644,46355,0,1,2,0,3
70839,160,16974,22530;22937,46355,0,0,2,0,2
70840,160,16975,23080;23206;25606;26646,46355,0,1,3,0,4
70841,160,16976,23109,46355,0,0,1,0,1
70842,160,16977,22975;22987;26945,46355,0,1,2,0,3
70843,160,16978,22459;22990;25997,46355,0,0,3,0,3
70844,160,16979,23248;26381;26648,46355,0,1,2,0,3
70845,160,16981,18949,46720,0,0,0,1,1
70846,160,16982,18768,46720,0,0,0,1,1
70847,160,16991,19683;19760,46720,0,0,0,2,2
70848,160,16998,20197;20379,46720,0,0,0,2,2
70849,160,17001,20325,46720,0,0,0,1,1
70850,160,17003,20429;20580,46720,0,0,0,2,2
70851,160,17007,20774;21017,46720,0,0,0,2,2
70852,160,17008,20444,46720,0,0,0,1,1
70853,160,17011,21127;21509,46720,0,0,0,2,2
70854,160,17012,21351;21738,46720,0,0,1,1,2
70855,160,17018,21907;22142,46720,0,0,2,0,2
70856,160,17020,21979;22213;25103,46720,0,0,3,0,3
70857,160,17021,22005;22454,46720,0,0,2,0,2
70858,160,17022,22674;22794;26266,46720,0,0,3,0,3
70859,160,17023,22205,46720,0,0,1,0,1
70860,160,17024,22565;22652,46720,0,0,2,0,2
70861,160,17026,22265;24681,46720,0,0,2,0,2
70862,160,17027,22209;22279;24900;28016;28216,46720,2,0,3,0,5
70863,160,17028,22283;22752,46720,0,0,2,0,2
70864,160,17029,22219;22325;25567,46720,0,0,3,0,3
70865,160,17030,22360;22825,46720,0,0,2,0,2
70866,160,17031,22236;22381;25197;28137,46720,1,0,3,0,4
70867,160,17032,22383;22871;26276;26633,46720,0,1,3,0,4
70868,160,17033,22047;22399,46720,0,0,2,0,2
70869,160,17034,21925;22407;25578,46720,0,0,3,0,3
70870,160,17035,22305;22429;26053,46720,0,0,3,0,3
70871,160,17036,22457;22503;25963,46720,0,0,3,0,3
70872,160,17038,22433;22521,46720,0,0,2,0,2
70873,160,17039,22344;22551;26060,46720,0,0,3,0,3
70874,160,17040,22120;22606;26624,46720,0,1,2,0,3
70875,160,17041,22799;23146;26196;26545,46720,0,0,4,0,4
70876,160,17042,22712;22956,46720,0,0,2,0,2
70877,160,17043,22786;23279;26856,46720,0,1,2,0,3
70878,160,17044,22519;22767;26074,46720,0,0,3,0,3
70879,160,17045,22444;22728;27024,46720,0,1,2,0,3
70880,160,17046,22790;23101,46720,0,0,2,0,2
70881,160,17047,22643;23062;26460;26540,46720,0,0,4,0,4
70882,160,17048,22669;22840,46720,0,0,2,0,2
70883,160,17049,22861;22918;26084;26634;27853,46720,0,2,3,0,5
70884,160,17050,23136;23380,46720,0,0,2,0,2
70885,160,17051,22833;22919;25603;26085;26457;27133,46720,0,1,5,0,6
70886,160,17052,22718;23045;25800;28256,46720,1,0,3,0,4
70887,160,17053,22223;22801;25880;26526;26631,46720,0,1,4,0,5
70888,160,17054,22945;23094,46720,0,0,2,0,2
70889,160,17055,22951;26089;27134,46720,0,1,2,0,3
70890,160,17056,22976;23038;26374;26539;26742,46720,0,1,4,0,5
70891,160,17057,23016;23243;26105,46720,0,0,3,0,3
70892,160,17059,23022;23049;26459;26538;27029,46720,0,1,4,0,5
70893,160,17060,23023;23230,46720,0,0,2,0,2
70894,160,17061,22559;23036;25311,46720,0,0,3,0,3
70895,160,17062,22706;23026;25892;28350,46720,1,0,3,0,4
70896,160,17063,23194;27335,46720,0,1,1,0,2
70897,160,17064,23216;23267;25809;26204,46720,0,0,4,0,4
70898,160,17065,23024,46720,0,0,1,0,1
70899,160,17066,23074;23239;27031,46720,0,1,2,0,3
70900,160,17067,23027;23102;26376;26641,46720,0,1,3,0,4
70901,160,17069,18653,47085,0,0,0,1,1
70902,160,17076,19656,47085,0,0,0,1,1
70903,160,17077,19242,47085,0,0,0,1,1
70904,160,17082,19216,47085,0,0,0,1,1
70905,160,17086,20328,47085,0,0,0,1,1
70906,160,17087,20528,47085,0,0,0,1,1
70907,160,17094,20676,47085,0,0,0,1,1
70908,160,17098,20767;20830,47085,0,0,0,2,2
70909,160,17099,20514,47085,0,0,0,1,1
70910,160,17100,20343;20706,47085,0,0,0,2,2
70911,160,17101,21258;21497,47085,0,0,0,2,2
70912,160,17105,21175;21317,47085,0,0,0,2,2
70913,160,17109,21676;21928,47085,0,0,2,0,2
70914,160,17110,21753;22061,47085,0,0,2,0,2
70915,160,17112,22271;22480;25474,47085,0,0,3,0,3
70916,160,17114,22513;22760;25304;28236,47085,1,0,3,0,4
70917,160,17116,22155;22445,47085,0,0,2,0,2
70918,160,17117,22172;22566,47085,0,0,2,0,2
70919,160,17119,22615;22869;26081,47085,0,0,3,0,3
70920,160,17120,22730;22837;26731,47085,0,1,2,0,3
70921,160,17121,22778;22873;27236,47085,0,1,2,0,3
70922,160,17124,22460,47085,0,0,1,0,1
70923,160,17125,22448;22509;25773,47085,0,0,3,0,3
70924,160,17127,22092;22486;25960,47085,0,0,3,0,3
70925,160,17128,22117;22516;25487,47085,0,0,3,0,3
70926,160,17129,22813;23063;26190,47085,0,0,3,0,3
70927,160,17130,22576;22654,47085,0,0,2,0,2
70928,160,17132,22321;22608,47085,0,0,2,0,2
70929,160,17133,22640;22853;26453;26533;26840;27130,47085,0,2,4,0,6
70930,160,17135,22072;22702;25877,47085,0,0,3,0,3
70931,160,17136,22244;22711;25978,47085,0,0,3,0,3
70932,160,17137,22352;25952;26160;27849,47085,0,1,3,0,4
70933,160,17138,22357;22841;26180;26274;26530;26944;27027,47085,0,2,5,0,7
70934,160,17139,22630;22717;25778,47085,0,0,3,0,3
70935,160,17140,22811;23030;25700,47085,0,0,3,0,3
70936,160,17141,22375;22828;26451,47085,0,0,3,0,3
70937,160,17142,22920;25697,47085,0,0,2,0,2
70938,160,17143,22845;26191;26284;26541;26947,47085,0,1,4,0,5
70939,160,17144,23363,47085,0,0,1,0,1
70940,160,17145,23300;23379;26207;26382;26753;26859;27139,47085,0,3,4,0,7
70941,160,17146,23187;23301;26653,47085,0,1,2,0,3
70942,160,17147,22672;22929,47085,0,0,2,0,2
70943,160,17148,22848;23108;26544,47085,0,0,3,0,3
70944,160,17149,22836,47085,0,0,1,0,1
70945,160,17150,22935;23269;27240,47085,0,1,2,0,3
70946,160,17151,23393,47085,0,0,1,0,1
70947,160,17152,22727;23010;25799;26537;26739,47085,0,1,4,0,5
70948,160,17153,22995;23053;26846,47085,0,1,2,0,3
70949,160,17154,22547;23071;26375;26462,47085,0,0,4,0,4
70950,160,17155,23073;23476;26390;26865,47085,0,1,3,0,4
70951,160,17157,22971,47085,0,0,1,0,1
70952,160,17158,23144;23470;26315;26481,47085,0,0,4,0,4
70953,160,17159,23087;23161;26547;26849,47085,0,1,3,0,4
70954,160,17160,22860;23168;26377,47085,0,0,3,0,3
70955,160,17161,23007;23177;26378,47085,0,0,3,0,3
70956,160,17163,23183;25508;26642;27647,47085,0,2,2,0,4
70957,160,17164,23218;23299;25610;26010;26206;26652;26752;26950;27336,47085,0,4,5,0,9
70958,160,17168,19489,47450,0,0,0,1,1
70959,160,17174,18972,47450,0,0,0,1,1
70960,160,17178,19873;19926,47450,0,0,0,2,2
70961,160,17180,19859,47450,0,0,0,1,1
70962,160,17183,21255,47450,0,0,0,1,1
70963,160,17186,20530,47450,0,0,0,1,1
70964,160,17188,21456;21822,47450,0,0,1,1,2
70965,160,17191,20880;21279,47450,0,0,0,2,2
70966,160,17195,21242;21543,47450,0,0,0,2,2
70967,160,17196,21557;21999,47450,0,0,1,1,2
70968,160,17197,22019,47450,0,0,1,0,1
70969,160,17201,22377;22548;26833,47450,0,1,2,0,3
70970,160,17204,22287;22308;25666;25950,47450,0,0,4,0,4
70971,160,17205,21825;22089;26432,47450,0,0,3,0,3
70972,160,17206,22343,47450,0,0,1,0,1
70973,160,17208,21716;21808,47450,0,0,2,0,2
70974,160,17212,22844;26181;26531,47450,0,0,3,0,3
70975,160,17213,22339;22573;26354,47450,0,0,3,0,3
70976,160,17214,22838;23048;25702;26640,47450,0,1,3,0,4
70977,160,17216,22348;22416,47450,0,0,2,0,2
70978,160,17217,22704;22826;26366,47450,0,0,3,0,3
70979,160,17218,22188;22443;25956;28353,47450,1,0,3,0,4
70980,160,17219,22511;22758;26361;26525,47450,0,0,4,0,4
70981,160,17221,22382;22587;26258,47450,0,0,3,0,3
70982,160,17222,22967;25995;26091,47450,0,0,3,0,3
70983,160,17223,22082;22605,47450,0,0,2,0,2
70984,160,17224,22798;23155,47450,0,0,2,0,2
70985,160,17225,22334;22748,47450,0,0,2,0,2
70986,160,17226,22753;23013,47450,0,0,2,0,2
70987,160,17227,22226;22776;27026,47450,0,1,2,0,3
70988,160,17228,22738;22781,47450,0,0,2,0,2
70989,160,17229,22477;22783;26449,47450,0,0,3,0,3
70990,160,17230,23018;23492,47450,0,0,2,0,2
70991,160,17231,22829;23095;26192;26285,47450,0,0,4,0,4
70992,160,17232,22435;23085;26542,47450,0,0,3,0,3
70993,160,17233,22900,47450,0,0,1,0,1
70994,160,17234,22914;23318;26011;27968,47450,1,0,3,0,4
70995,160,17235,22923;23571;26766;27048;27763,47450,0,3,2,0,5
70996,160,17236,22947;23039;26088;26186;26535,47450,0,0,5,0,5
70997,160,17237,22963;22992,47450,0,0,2,0,2
70998,160,17238,22982;23303,47450,0,0,2,0,2
70999,160,17239,23112;23456;26115,47450,0,0,3,0,3
71000,160,17241,22994;26093,47450,0,0,2,0,2
71001,160,17242,22751;22996;26738,47450,0,1,2,0,3
71002,160,17243,22720;23005;25310,47450,0,0,3,0,3
71003,160,17244,23154;23406,47450,0,0,2,0,2
71004,160,17246,23028;23417,47450,0,0,2,0,2
71005,160,17248,23180;23185;27030,47450,0,1,2,0,3
71006,160,17250,22903;23091;26279,47450,0,0,3,0,3
71007,160,17251,23106;23479;26019;26569;26661;27444,47450,0,2,4,0,6
71008,160,17252,22974;23119,47450,0,0,2,0,2
71009,160,17253,23135;23435;26759;27141,47450,0,2,2,0,4
71010,160,17254,23111;23339;26300,47450,0,0,3,0,3
71011,160,17255,23199;26745,47450,0,1,1,0,2
71012,160,17256,23273,47450,0,0,1,0,1
71013,160,17257,23351;26302;26562;27037,47450,0,1,3,0,4
71014,160,17258,23223;23235,47450,0,0,2,0,2
71015,160,17260,23259;23360;26293,47450,0,0,3,0,3
71016,160,17261,23265,47450,0,0,1,0,1
71017,160,17262,23271;23340;26301;27441,47450,0,1,3,0,4
71018,160,17263,22803;23293;26473;26651;27033,47450,0,2,3,0,5
71019,160,17265,18723,47815,0,0,0,1,1
71020,160,17266,19379,47815,0,0,0,1,1
71021,160,17267,19025;19228,47815,0,0,0,2,2
71022,160,17269,19095,47815,0,0,0,1,1
71023,160,17271,19206;19516,47815,0,0,0,2,2
71024,160,17274,19630,47815,0,0,0,1,1
71025,160,17278,20196;20428,47815,0,0,0,2,2
71026,160,17283,20853,47815,0,0,0,1,1
71027,160,17288,20982;21340,47815,0,0,0,2,2
71028,160,17290,21190;21319,47815,0,0,0,2,2
71029,160,17291,21166,47815,0,0,0,1,1
71030,160,17292,21348;21521,47815,0,0,0,2,2
71031,160,17295,21454;21640,47815,0,0,1,1,2
71032,160,17301,22088;22655;25493;25974;26441,47815,0,0,5,0,5
71033,160,17303,22402;22810;25984,47815,0,0,3,0,3
71034,160,17304,21879;22512;25964,47815,0,0,3,0,3
71035,160,17305,21991;22256,47815,0,0,2,0,2
71036,160,17307,22666;26358,47815,0,0,2,0,2
71037,160,17308,22436;22705,47815,0,0,2,0,2
71038,160,17310,22482;26254,47815,0,0,2,0,2
71039,160,17311,22491;22847;25692;27129,47815,0,1,3,0,4
71040,160,17312,22258;22568;26353;26520,47815,0,0,4,0,4
71041,160,17313,22115;22562,47815,0,0,2,0,2
71042,160,17314,21952;22583;26257;26356,47815,0,0,4,0,4
71043,160,17315,22537;23015,47815,0,0,2,0,2
71044,160,17316,22682;22931;26534,47815,0,0,3,0,3
71045,160,17317,22099;22735;26070,47815,0,0,3,0,3
71046,160,17318,22641;22737;25787;26173;28057,47815,1,0,4,0,5
71047,160,17319,22363;22759,47815,0,0,2,0,2
71048,160,17321,22721;22872;26069,47815,0,0,3,0,3
71049,160,17322,22927;23349;27036,47815,0,1,2,0,3
71050,160,17323,22883;22888;26369;26454,47815,0,0,4,0,4
71051,160,17324,22782;22892;26371;26455;26732,47815,0,1,4,0,5
71052,160,17325,22787;22906;25791;26733,47815,0,1,3,0,4
71053,160,17327,22603;23115,47815,0,0,2,0,2
71054,160,17328,22977;23134,47815,0,0,2,0,2
71055,160,17329,23186,47815,0,0,1,0,1
71056,160,17330,22993;23554;26572;27252,47815,0,1,3,0,4
71057,160,17331,23132;23192;26100;26288;26744,47815,0,1,4,0,5
71058,160,17332,23000;23460;26110,47815,0,0,3,0,3
71059,160,17333,22662;23001;25309;27944,47815,1,0,3,0,4
71060,160,17334,23184;23244;26470,47815,0,0,3,0,3
71061,160,17336,23281;23508;26009;26296;26555;26857;27440,47815,0,2,5,0,7
71062,160,17337,23089;23581;26393;27149;27653,47815,0,2,3,0,5
71063,160,17338,23153,47815,0,0,1,0,1
71064,160,17339,23120;23127,47815,0,0,2,0,2
71065,160,17340,22875;23137,47815,0,0,2,0,2
71066,160,17341,23140;23681,47815,0,0,2,0,2
71067,160,17342,23114;23145;25706,47815,0,0,3,0,3
71068,160,17343,23160;23288,47815,0,0,2,0,2
71069,160,17344,23200;25416;27953,47815,1,0,2,0,3
71070,160,17345,23079;23226;26749,47815,0,1,2,0,3
71071,160,17346,23498;27040,47815,0,1,1,0,2
71072,160,17347,23188,47815,0,0,1,0,1
71073,160,17348,23264;26294;26650;26751;27032,47815,0,3,2,0,5
71074,160,17349,23096;23274;26295,47815,0,0,3,0,3
71075,160,17350,23488;23639;26396,47815,0,0,3,0,3
71076,160,17351,22962;23503;25717;26761;27758,47815,0,2,3,0,5
71077,160,17352,23572;26219;27343;27563,47815,0,2,2,0,4
71078,160,17353,23255;23616,47815,0,0,2,0,2
71079,160,17354,23277;23366,47815,0,0,2,0,2
71080,160,17355,23384;23732;26882;27264;27567,47815,0,3,2,0,5
71081,160,17356,23251;23398;26565,47815,0,0,3,0,3
71082,160,17357,23263;23400,47815,0,0,2,0,2
71083,160,17358,19032,48180,0,0,0,1,1
71084,160,17364,19518;19686,48180,0,0,0,2,2
71085,160,17365,19496;19528,48180,0,0,0,2,2
71086,160,17366,19637,48180,0,0,0,1,1
71087,160,17367,20292,48180,0,0,0,1,1
71088,160,17376,20517,48180,0,0,0,1,1
71089,160,17378,20561,48180,0,0,0,1,1
71090,160,17380,20784,48180,0,0,0,1,1
71091,160,17385,21478,48180,0,0,0,1,1
71092,160,17387,21068;21404;25429;28245,48180,1,0,1,2,4
71093,160,17392,21620,48180,0,0,1,0,1
71094,160,17394,21567;25352,48180,0,0,1,1,2
71095,160,17397,21805;21821,48180,0,0,2,0,2
71096,160,17398,21990;22052;24670,48180,0,0,3,0,3
71097,160,17401,21924;22581;25870,48180,0,0,3,0,3
71098,160,17402,22280;26155;28266,48180,1,0,2,0,3
71099,160,17405,22045;22159;26341,48180,0,0,3,0,3
71100,160,17407,21995;22167;25100;28026,48180,1,0,3,0,4
71101,160,17408,22067,48180,0,0,1,0,1
71102,160,17409,22354;22849;25601,48180,0,0,3,0,3
71103,160,17410,22268;23099,48180,0,0,2,0,2
71104,160,17411,22468;22631;26264;26626,48180,0,1,3,0,4
71105,160,17412,22361;22469,48180,0,0,2,0,2
71106,160,17413,22220;22483;25404;25678,48180,0,0,4,0,4
71107,160,17414,22498;23142,48180,0,0,2,0,2
71108,160,17415,22733;25965,48180,0,0,2,0,2
71109,160,17416,22527;22846,48180,0,0,2,0,2
71110,160,17417,21963;22636,48180,0,0,2,0,2
71111,160,17419,22239;22571;25776;26166,48180,0,0,4,0,4
71112,160,17420,22593;23104;25898;26543,48180,0,0,4,0,4
71113,160,17421,22749;22893;26277,48180,0,0,3,0,3
71114,160,17422,22802;22911;26734,48180,0,1,2,0,3
71115,160,17423,22341;22635;26065,48180,0,0,3,0,3
71116,160,17424,23143;27238,48180,0,1,1,0,2
71117,160,17425,22710;22805;25983;26178,48180,0,0,4,0,4
71118,160,17426,22668;22882;26442,48180,0,0,3,0,3
71119,160,17427,22601;22691,48180,0,0,2,0,2
71120,160,17428,22692;22969,48180,0,0,2,0,2
71121,160,17429,22611;22719;24910;26617;28017;28109,48180,2,0,4,0,6
71122,160,17430,22111;22591;25113,48180,0,0,3,0,3
71123,160,17431,22186;22199;24679,48180,0,0,3,0,3
71124,160,17432,22406;22440,48180,0,0,2,0,2
71125,160,17434,22823;23064;25893;26461,48180,0,0,4,0,4
71126,160,17435,22473;22870;25988,48180,0,0,3,0,3
71127,160,17436,22842;22876;26185,48180,0,0,3,0,3
71128,160,17437,22933;26737,48180,0,1,1,0,2
71129,160,17438,22467;23173;25312;25709;27945,48180,1,0,4,0,5
71130,160,17439,22899;22981;26456,48180,0,0,3,0,3
71131,160,17440,23237;23526,48180,0,0,2,0,2
71132,160,17441,22980;23002,48180,0,0,2,0,2
71133,160,17442,22795;23029;27558,48180,0,1,2,0,3
71134,160,17443,23060;25703,48180,0,0,2,0,2
71135,160,17444,23124;23382;26564;27140;28173,48180,1,1,3,0,5
71136,160,17445,23287;23575;26667;26870;27344,48180,0,3,2,0,5
71137,160,17446,23086;23452;25616;26215;27554,48180,0,1,4,0,5
71138,160,17447,23189;26850,48180,0,1,1,0,2
71139,160,17449,23726;23865;26494,48180,0,0,3,0,3
71140,160,17452,23846;26785;27273,48180,0,2,1,0,3
71141,160,17453,23260,48180,0,0,1,0,1
71142,160,17454,22514;23286;26556,48180,0,0,3,0,3
71143,160,17456,23272;23510;27041,48180,0,1,2,0,3
71144,160,17457,23589;23601;26316;26767,48180,0,1,3,0,4
71145,160,17459,23105;23464;27561,48180,0,1,2,0,3
71146,160,17460,22970;23370,48180,0,0,2,0,2
71147,160,17461,23621;23645;26488,48180,0,0,3,0,3
71148,160,17462,23442;23521;26570;27042,48180,0,1,3,0,4
71149,160,17463,23232;23402;26863,48180,0,1,2,0,3
71150,160,17464,23334;23418;26310;26387;26954,48180,0,1,4,0,5
71151,160,17465,23421;23472;26660;27039;27340,48180,0,3,2,0,5
71152,160,17466,23332;23432;26658;27338,48180,0,2,2,0,4
71153,160,17467,23227;23627;26957;27345,48180,0,2,2,0,4
71154,160,17468,23424;23459;26214;28067,48180,1,0,3,0,4
71155,160,17469,22964;23465;26314;26659,48180,0,1,3,0,4
71156,160,17470,23316;23751;26402,48180,0,0,3,0,3
71157,160,17471,23606;26317,48180,0,0,2,0,2
71158,160,17472,23490;23505;26021;27248,48180,0,1,3,0,4
71159,160,17473,23499;23938;25923;26399;26898;27066;27361;27579,48180,0,4,4,0,8
71160,160,17474,18724,48545,0,0,0,1,1
71161,160,17476,19185,48545,0,0,0,1,1
71162,160,17479,18605,48545,0,0,0,1,1
71163,160,17483,19646;19769,48545,0,0,0,2,2
71164,160,17484,19949;20014,48545,0,0,0,2,2
71165,160,17487,20173,48545,0,0,0,1,1
71166,160,17489,20848;20933,48545,0,0,0,2,2
71167,160,17498,21131,48545,0,0,0,1,1
71168,160,17512,22867;22881;26183;28066,48545,1,0,3,0,4
71169,160,17513,21540;21944,48545,0,0,1,1,2
71170,160,17515,22520;22621;27128,48545,0,1,2,0,3
71171,160,17516,22135;22248,48545,0,0,2,0,2
71172,160,17518,22189;22620;26625,48545,0,1,2,0,3
71173,160,17519,22439;22518;26058,48545,0,0,3,0,3
71174,160,17522,22266;22868;26184,48545,0,0,3,0,3
71175,160,17524,21962;22392;26620,48545,0,1,2,0,3
71176,160,17525,22323;22397;26727,48545,0,1,2,0,3
71177,160,17526,23209;26853,48545,0,1,1,0,2
71178,160,17528,22284;22430,48545,0,0,2,0,2
71179,160,17529,22522;23158,48545,0,0,2,0,2
71180,160,17530,22567;22791,48545,0,0,2,0,2
71181,160,17532,23003;26095;26536,48545,0,0,3,0,3
71182,160,17533,23126;23162;26643,48545,0,1,2,0,3
71183,160,17534,22736;22926,48545,0,0,2,0,2
71184,160,17536,22633;22769,48545,0,0,2,0,2
71185,160,17537,23358;23564;26383;26476;26755,48545,0,1,4,0,5
71186,160,17538,22806;23171;26549,48545,0,0,3,0,3
71187,160,17540,22665;22824;26079;26450;26528;26839;28362,48545,1,1,5,0,7
71188,160,17541,22541;23093,48545,0,0,2,0,2
71189,160,17542,22955;23600;26188;26843,48545,0,1,3,0,4
71190,160,17543,22625;22907,48545,0,0,2,0,2
71191,160,17544,23034;23116,48545,0,0,2,0,2
71192,160,17545,23070;23744;26776;27162,48545,0,2,2,0,4
71193,160,17546,23011;23088;26639,48545,0,1,2,0,3
71194,160,17547,23311;23361;26474;26860,48545,0,1,3,0,4
71195,160,17548,23084;23458;26312;26480;27245,48545,0,1,4,0,5
71196,160,17549,23150;23257;26649,48545,0,1,2,0,3
71197,160,17550,23157;23754;26777;27768,48545,0,2,2,0,4
71198,160,17551,23174;23942,48545,0,0,2,0,2
71199,160,17552,22909;23217;25417;25607;26291;26467;28171,48545,1,0,6,0,7
71200,160,17553,23050;23559;27445,48545,0,1,2,0,3
71201,160,17554,23075;23337;26951,48545,0,1,2,0,3
71202,160,17555,22972;23304;25207;26557;27559,48545,0,1,4,0,5
71203,160,17556,23103;23319;25511;26012,48545,0,0,4,0,4
71204,160,17557,23342;23502,48545,0,0,2,0,2
71205,160,17558,23386;23405;26953,48545,0,1,2,0,3
71206,160,17559,22942;23395,48545,0,0,2,0,2
71207,160,17560,23689;24032,48545,0,0,2,0,2
71208,160,17561,23428;23662;26397;26491;26671;26959,48545,0,2,4,0,6
71209,160,17562,22294;23107;25899;26001;26286;26463;26847;27136;28351,48545,1,2,6,0,9
71210,160,17563,23415;23439;26479;27243,48545,0,1,3,0,4
71211,160,17564,23283;23615;26487;26769,48545,0,1,3,0,4
71212,160,17565,23388;23454;27442,48545,0,1,2,0,3
71213,160,17567,23493;23785;26682,48545,0,1,2,0,3
71214,160,17568,23377;23515;27250,48545,0,1,2,0,3
71215,160,17569,23538;27045,48545,0,1,1,0,2
71216,160,17570,23806;26408;26587;27353,48545,0,1,3,0,4
71217,160,17571,23308;23562;26765,48545,0,1,2,0,3
71218,160,17572,23568;23918,48545,0,0,2,0,2
71219,160,17573,22739;23468,48545,0,0,2,0,2
71220,160,17574,19203,48910,0,0,0,1,1
71221,160,17577,20188,48910,0,0,0,1,1
71222,160,17580,20350,48910,0,0,0,1,1
71223,160,17581,20645;20760,48910,0,0,0,2,2
71224,160,17583,20651,48910,0,0,0,1,1
71225,160,17589,20846;20988,48910,0,0,0,2,2
71226,160,17595,21421;21730,48910,0,0,1,1,2
71227,160,17599,21789;22458,48910,0,0,2,0,2
71228,160,17603,21812;22393,48910,0,0,2,0,2
71229,160,17604,22369;22663;26169;26265,48910,0,0,4,0,4
71230,160,17606,21865;22472,48910,0,0,2,0,2
71231,160,17608,22423;22438;26055,48910,0,0,3,0,3
71232,160,17609,22463;22554,48910,0,0,2,0,2
71233,160,17610,22464;23031;26096;26741;26844,48910,0,2,3,0,5
71234,160,17611,22453;23152;25902;26197,48910,0,0,4,0,4
71235,160,17614,22543;22653;24684;25779;25874,48910,0,0,5,0,5
71236,160,17615,22642;23078,48910,0,0,2,0,2
71237,160,17617,22797;23475,48910,0,0,2,0,2
71238,160,17618,23394;26477;26757,48910,0,1,2,0,3
71239,160,17619,22815;22819,48910,0,0,2,0,2
71240,160,17621,22978;26637,48910,0,1,1,0,2
71241,160,17623,22894;26372,48910,0,0,2,0,2
71242,160,17626,22729;22979;25996;26638,48910,0,1,3,0,4
71243,160,17627,22988;23076;25888,48910,0,0,3,0,3
71244,160,17628,22999;23233;26552;26647,48910,0,1,3,0,4
71245,160,17629,22879;23017,48910,0,0,2,0,2
71246,160,17630,22431;23138;26098,48910,0,0,3,0,3
71247,160,17631,23042;23258;25701;26743,48910,0,1,3,0,4
71248,160,17632,23167;23372;26111;26386;26756;26862,48910,0,2,4,0,6
71249,160,17633,23037;23607,48910,0,0,2,0,2
71250,160,17634,22950;23202,48910,0,0,2,0,2
71251,160,17635,23350;23709,48910,0,0,2,0,2
71252,160,17637,23242;23434;26380;26750,48910,0,1,3,0,4
71253,160,17638,23696;26579;26878;26961;27157,48910,0,3,2,0,5
71254,160,17639,23722;23812;25821;26493;27160,48910,0,1,4,0,5
71255,160,17640,23252;23736,48910,0,0,2,0,2
71256,160,17641,23148;23149;26004;26546;26948,48910,0,1,4,0,5
71257,160,17642,23313;23330;26754,48910,0,1,2,0,3
71258,160,17643,23066;23548;26217;27342,48910,0,1,3,0,4
71259,160,17645,23359;23781;26889,48910,0,1,2,0,3
71260,160,17646,23385;23482;26866,48910,0,1,2,0,3
71261,160,17647,23341;23387,48910,0,0,2,0,2
71262,160,17648,23198;23410;26309;26656,48910,0,1,3,0,4
71263,160,17649,23966;24075;26695;27365;27463;27581,48910,0,4,2,0,6
71264,160,17650,24015;27661,48910,0,1,1,0,2
71265,160,17651,23256;23449,48910,0,0,2,0,2
71266,160,17652,23874;27972,48910,1,0,1,0,2
71267,160,17653,23181;23577;26668;26955,48910,0,2,2,0,4
71268,160,17654,23489;23612,48910,0,0,2,0,2
71269,160,17655,23496;23525;26762,48910,0,1,2,0,3
71270,160,17656,23506;26482;27249,48910,0,1,2,0,3
71271,160,17657,23507;24067,48910,0,0,2,0,2
71272,160,17658,23511;23747;27570;27767,48910,0,2,2,0,4
71273,160,17659,23523;23835;26969;27859,48910,1,1,2,0,4
71274,160,17660,23403;23780;27352,48910,0,1,2,0,3
71275,160,17661,23529;23537;25911;27145,48910,0,1,3,0,4
71276,160,17662,23579;23699;25820;26879,48910,0,1,3,0,4
71277,160,17663,23585;26394;27254;27654,48910,0,2,2,0,4
71278,160,17664,23596;24058;26987;27471;28177,48910,1,2,2,0,5
71279,160,17665,23598;23642;27152,48910,0,1,2,0,3
71280,160,17667,23688;23698;26676,48910,0,1,2,0,3
71281,160,17668,23123;23703;26322,48910,0,0,3,0,3
71282,160,17673,19836,49275,0,0,0,1,1
71283,160,17676,20030,49275,0,0,0,1,1
71284,160,17682,19909,49275,0,0,0,1,1
71285,160,17693,21452;21568,49275,0,0,0,2,2
71286,160,17699,21685;22228,49275,0,0,2,0,2
71287,160,17702,22002;22410,49275,0,0,2,0,2
71288,160,17705,23215,49275,0,0,1,0,1
71289,160,17706,22506;22901;26083;26842,49275,0,1,3,0,4
71290,160,17707,22544;22857,49275,0,0,2,0,2
71291,160,17709,22523;22834;26452,49275,0,0,3,0,3
71292,160,17710,22274;22649,49275,0,0,2,0,2
71293,160,17711,23012;26740,49275,0,1,1,0,2
71294,160,17715,22289;22689;26444,49275,0,0,3,0,3
71295,160,17716,22064;22723;25594;26359;27553,49275,0,1,4,0,5
71296,160,17717,22954,49275,0,0,1,0,1
71297,160,17719,22800,49275,0,0,1,0,1
71298,160,17720,22588;22902,49275,0,0,2,0,2
71299,160,17723,23130;23353;26013;26303,49275,0,0,4,0,4
71300,160,17724,22488;23041;26000;26845,49275,0,1,3,0,4
71301,160,17726,23220;23312;26558,49275,0,0,3,0,3
71302,160,17727,23296;23708;26580,49275,0,0,3,0,3
71303,160,17728,23033;23825;26325;26894,49275,0,1,3,0,4
71304,160,17729,23328;23678;26299;26559;26691,49275,0,1,4,0,5
71305,160,17730,23336;23952;27462,49275,0,1,2,0,3
71306,160,17731,23383;23391,49275,0,0,2,0,2
71307,160,17732,23411;26113;26478;27560,49275,0,1,3,0,4
71308,160,17733,23164;23491;27247,49275,0,1,2,0,3
71309,160,17734,24041;26699;27370,49275,0,2,1,0,3
71310,160,17735,23516;23675;26876,49275,0,1,2,0,3
71311,160,17736,23431;23916;25723;26792;27578,49275,0,2,3,0,5
71312,160,17737,24100;24145;27376;27477;27778;27868,49275,1,3,2,0,6
71313,160,17738,23068;23542;26869,49275,0,1,2,0,3
71314,160,17739,23587;23614;26484,49275,0,0,3,0,3
71315,160,17740,23590;23977;26982,49275,0,1,2,0,3
71316,160,17741,23850;23963;27862,49275,1,0,2,0,3
71317,160,17742,23640;23771,49275,0,0,2,0,2
71318,160,17743,23310;23552;26664,49275,0,1,2,0,3
71319,160,17744,23573;23630;26575;26958;27346,49275,0,2,3,0,5
71320,160,17745,23653;23668;26221,49275,0,0,3,0,3
71321,160,17746,23289;23670;26320,49275,0,0,3,0,3
71322,160,17747,23849;24120;27374;28181,49275,1,1,2,0,4
71323,160,17748,23593;24111;27082;27668;28180,49275,1,2,2,0,5
71324,160,17749,23309;23782;26324;26681,49275,0,1,3,0,4
71325,160,17750,23730;24018;26799,49275,0,1,2,0,3
71326,160,17751,23326;23877;26790;26975;27576,49275,0,3,2,0,5
71327,160,17752,23495;23762;26127,49275,0,0,3,0,3
71328,160,17753,23965;26330;26593;26981;27282;27364;28170;28361,49275,2,3,3,0,8
71329,160,17754,23466;23768;26585,49275,0,0,3,0,3
71330,160,17755,23543;23716;26492,49275,0,0,3,0,3
71331,160,17756,23422;23820;26588;27271;28172,49275,1,1,3,0,5
71332,160,17758,23789;23830;27057,49275,0,1,2,0,3
71333,160,17759,23609;23795,49275,0,0,2,0,2
71334,160,17761,19434,49640,0,0,0,1,1
71335,160,17762,19822,49640,0,0,0,1,1
71336,160,17763,19830,49640,0,0,0,1,1
71337,160,17764,19881,49640,0,0,0,1,1
71338,160,17765,19908;19942,49640,0,0,0,2,2
71339,160,17767,19972,49640,0,0,0,1,1
71340,160,17768,20252;20389,49640,0,0,0,2,2
71341,160,17772,20478,49640,0,0,0,1,1
71342,160,17773,20695,49640,0,0,0,1,1
71343,160,17776,20658,49640,0,0,0,1,1
71344,160,17777,20661;20686,49640,0,0,0,2,2
71345,160,17778,20857,49640,0,0,0,1,1
71346,160,17779,20790,49640,0,0,0,1,1
71347,160,17780,20915;21311,49640,0,0,0,2,2
71348,160,17788,21545,49640,0,0,0,1,1
71349,160,17791,21443;21651,49640,0,0,1,1,2
71350,160,17793,21921;21996,49640,0,0,2,0,2
71351,160,17794,21983;22110,49640,0,0,2,0,2
71352,160,17795,21855;22193,49640,0,0,2,0,2
71353,160,17801,23139;27334,49640,0,1,1,0,2
71354,160,17802,22949;23040,49640,0,0,2,0,2
71355,160,17803,22697;22709;26171,49640,0,0,3,0,3
71356,160,17806,22644;22934;25793,49640,0,0,3,0,3
71357,160,17807,22247;22816;25881,49640,0,0,3,0,3
71358,160,17808,23055;23426;26388;26657,49640,0,1,3,0,4
71359,160,17809,23457;27443,49640,0,1,1,0,2
71360,160,17810,22889;23247,49640,0,0,2,0,2
71361,160,17811,23196;23433;26550;26645;27137;28365,49640,1,2,3,0,6
71362,160,17812,23125;23128;26002;26848,49640,0,1,3,0,4
71363,160,17813,23774;23947;26887,49640,0,1,2,0,3
71364,160,17816,22932;23280;26472;26554,49640,0,0,4,0,4
71365,160,17818,23335;23706;27052;27261,49640,0,2,2,0,4
71366,160,17819,23113;23346;26561,49640,0,0,3,0,3
71367,160,17820,23371;23513;26305;26654,49640,0,1,3,0,4
71368,160,17822,23129;23408;26566,49640,0,0,3,0,3
71369,160,17823,23478;26212;26563;26952,49640,0,1,3,0,4
71370,160,17825,23522;23983;26411;26983,49640,0,1,3,0,4
71371,160,17826,23588;23673,49640,0,0,2,0,2
71372,160,17827,23664;23827;27272,49640,0,1,2,0,3
71373,160,17828,23620;23650,49640,0,0,2,0,2
71374,160,17829,23446;23870,49640,0,0,2,0,2
71375,160,17830,23561;23655,49640,0,0,2,0,2
71376,160,17831,23677;26578;27156,49640,0,1,2,0,3
71377,160,17832,23756;26126;27055;27164;27452,49640,0,3,2,0,5
71378,160,17833,23798;24208;27482;27592,49640,0,2,2,0,4
71379,160,17834,23801;23885;26405;26497;26586;26781;26890,49640,0,2,5,0,7
71380,160,17835,24118;26992;27083;27777,49640,0,3,1,0,4
71381,160,17836,23838;24188,49640,0,0,2,0,2
71382,160,17837,23409;23878,49640,0,0,2,0,2
71383,160,17838,23909;24179;26917;26996;27869,49640,1,2,2,0,5
71384,160,17839,23816;23926,49640,0,0,2,0,2
71385,160,17840,23518;23932;26897,49640,0,1,2,0,3
71386,160,17841,23955;24241;27980,49640,1,0,2,0,3
71387,160,17842,24031;27180,49640,0,1,1,0,2
71388,160,17844,19634,50005,0,0,0,1,1
71389,160,17846,19789;20483,50005,0,0,0,2,2
71390,160,17849,20071;20443,50005,0,0,0,2,2
71391,160,17850,19931,50005,0,0,0,1,1
71392,160,17852,20471,50005,0,0,0,1,1
71393,160,17858,20401,50005,0,0,0,1,1
71394,160,17865,21984;22074,50005,0,0,2,0,2
71395,160,17867,22076;22366,50005,0,0,2,0,2
71396,160,17869,22144;22263,50005,0,0,2,0,2
71397,160,17874,22570;22953;26187;26636,50005,0,1,3,0,4
71398,160,17875,22116;22389,50005,0,0,2,0,2
71399,160,17876,22079;22441,50005,0,0,2,0,2
71400,160,17878,21982;22191,50005,0,0,2,0,2
71401,160,17880,22574;22774;26271;26362,50005,0,0,4,0,4
71402,160,17884,22943;23306;27034,50005,0,1,2,0,3
71403,160,17886,23006;23197,50005,0,0,2,0,2
71404,160,17887,23685;26222;26674;27051,50005,0,2,2,0,4
71405,160,17889,22913;23083;25895,50005,0,0,3,0,3
71406,160,17890,22959;23092,50005,0,0,2,0,2
71407,160,17891,23450;26114;26864;27142,50005,0,2,2,0,4
71408,160,17892,22905;23172;27131,50005,0,1,2,0,3
71409,160,17893,23295;23592;26669;26871,50005,0,2,2,0,4
71410,160,17894,23624;23626;26395;27564,50005,0,1,3,0,4
71411,160,17895,23750;27163,50005,0,1,1,0,2
71412,160,17896,23352;23880;26976,50005,0,1,2,0,3
71413,160,17897,23291;23381,50005,0,0,2,0,2
71414,160,17898,23331;26861,50005,0,1,1,0,2
71415,160,17899,23557;23933;26692;26794,50005,0,2,2,0,4
71416,160,17900,23284;23427,50005,0,0,2,0,2
71417,160,17902,23389,50005,0,0,1,0,1
71418,160,17903,23440;23824,50005,0,0,2,0,2
71419,160,17904,23348;23591,50005,0,0,2,0,2
71420,160,17905,23519;27341,50005,0,1,1,0,2
71421,160,17906,23528;23758;27267,50005,0,1,2,0,3
71422,160,17907,23535;23908,50005,0,0,2,0,2
71423,160,17908,23547;26763;27046,50005,0,2,1,0,3
71424,160,17909,23657;27448,50005,0,1,1,0,2
71425,160,17910,23578;23964;27175,50005,0,1,2,0,3
71426,160,17911,23582;23702;27451,50005,0,1,2,0,3
71427,160,17912,23672;23799;26780;26967,50005,0,2,2,0,4
71428,160,17913,23636;23960;27151,50005,0,1,2,0,3
71429,160,17914,23671;26673;27259,50005,0,2,1,0,3
71430,160,17915,23701;23900;25921;26227;27357;27577,50005,0,2,4,0,6
71431,160,17916,23723;24029;27286;27368,50005,0,2,2,0,4
71432,160,17917,24248;27000,50005,0,1,1,0,2
71433,160,17918,23546;23773,50005,0,0,2,0,2
71434,160,17919,23777;23887;26680;26888,50005,0,2,2,0,4
71435,160,17920,23533;23783;26964;27656,50005,0,2,2,0,4
71436,160,17921,23717;23791;27455,50005,0,1,2,0,3
71437,160,17922,23802;26406,50005,0,0,2,0,2
71438,160,17923,24152;26139;27289;27479;27587,50005,0,3,2,0,5
71439,160,17924,23604;23826;26684;26784,50005,0,2,2,0,4
71440,160,17925,23832;23982;26501;28070,50005,1,0,3,0,4
71441,160,17926,23619;23851;26686;27274,50005,0,2,2,0,4
71442,160,17927,23863;24245;26141;27783,50005,0,1,3,0,4
71443,160,17928,23978;24226;27087;27594;27672,50005,0,3,2,0,5
71444,160,17929,23911;24112;27373,50005,0,1,2,0,3
71445,160,17930,24221;24328;26999;27382;27671,50005,0,3,2,0,5
71446,160,17931,23931;24277;27983;28185,50005,2,0,2,0,4
71447,160,17932,23276;23954;27280,50005,0,1,2,0,3
71448,160,17933,23957,50005,0,0,1,0,1
71449,160,17934,23654;23969;26133,50005,0,0,3,0,3
71450,160,17935,24001;27071;27178,50005,0,2,1,0,3
71451,160,17936,23986;24049,50005,0,0,2,0,2
71452,160,17937,23990;24348;26509;27389;27489;27986;28274,50005,2,2,3,0,7
71453,160,17938,23995;24099;26594;26796;28364,50005,1,1,3,0,5
71454,160,17939,23917;26793,50005,0,1,1,0,2
71455,160,17940,23748;24016;26413;26798,50005,0,1,3,0,4
71456,160,17942,24030;24266;27191;27676,50005,0,2,2,0,4
71457,160,17944,23544;24008;26331;26797;26984;27865,50005,1,2,3,0,6
71458,160,17945,23866;24280;26604;27297,50005,0,1,3,0,4
71459,160,17946,24078;24108;26599;27079;27371;27867,50005,1,2,3,0,6
71460,160,17947,23981;24083;26795;27863;28069,50005,2,1,2,0,5
71461,160,17951,19784,50370,0,0,0,1,1
71462,160,17953,19990,50370,0,0,0,1,1
71463,160,17956,20190;20452;24579;28086,50370,1,0,1,2,4
71464,160,17957,20204;20685,50370,0,0,0,2,2
71465,160,17959,20171,50370,0,0,0,1,1
71466,160,17962,20666,50370,0,0,0,1,1
71467,160,17968,21082,50370,0,0,0,1,1
71468,160,17976,21218;21627,50370,0,0,1,1,2
71469,160,17982,22087,50370,0,0,1,0,1
71470,160,17984,21903;22425;26939,50370,0,1,2,0,3
71471,160,17991,22613;22968;27237,50370,0,1,2,0,3
71472,160,17994,22904;23065,50370,0,0,2,0,2
71473,160,17995,22930;23224;26855,50370,0,1,2,0,3
71474,160,17997,22952;22998,50370,0,0,2,0,2
71475,160,17998,23056;23483;27246,50370,0,1,2,0,3
71476,160,18000,23159,50370,0,0,1,0,1
71477,160,18001,23298;23399;26106;26297,50370,0,0,4,0,4
71478,160,18002,23246;23563;26665;27253,50370,0,2,2,0,4
71479,160,18003,23683;26877,50370,0,1,1,0,2
71480,160,18004,22946;23285;26858;27138,50370,0,2,2,0,4
71481,160,18007,23788;26496;26966;27657,50370,0,2,2,0,4
71482,160,18008,23894;23988;27069;27864,50370,1,1,2,0,4
71483,160,18009,23864;27172;27275,50370,0,2,1,0,3
71484,160,18010,24091,50370,0,0,1,0,1
71485,160,18011,23448;23574;27148,50370,0,1,2,0,3
71486,160,18013,23462;23839;26970,50370,0,1,2,0,3
71487,160,18014,23416;23474,50370,0,0,2,0,2
71488,160,18015,23282;23531,50370,0,0,2,0,2
71489,160,18017,23541;23760,50370,0,0,2,0,2
71490,160,18018,23532;23545;26119;26868;27854,50370,1,1,3,0,5
71491,160,18019,23182;23646;26490;27258,50370,0,1,3,0,4
71492,160,18020,23540;23553;26571;26764;27146;27856,50370,1,2,3,0,6
71493,160,18021,23268;23576,50370,0,0,2,0,2
71494,160,18022,23534;23608;27855,50370,1,0,2,0,3
71495,160,18023,24003;24004;27179;27285;27465,50370,0,3,2,0,5
71496,160,18024,24178;27378,50370,0,1,1,0,2
71497,160,18025,23661;23763;26584,50370,0,0,3,0,3
71498,160,18026,23487;23715;26123;27053;27158,50370,0,2,3,0,5
71499,160,18027,23734;23920;27265,50370,0,1,2,0,3
71500,160,18028,23322,50370,0,0,1,0,1
71501,160,18029,23833;24228;27595,50370,0,1,2,0,3
71502,160,18030,23804;24084;26700;27372;27473,50370,0,3,2,0,5
71503,160,18031,23599;23844;26685,50370,0,1,2,0,3
71504,160,18032,23420;23629;26771;27764,50370,0,2,2,0,4
71505,160,18033,23425;23867,50370,0,0,2,0,2
71506,160,18034,23469;23868;26226;26327;26787;27063;27173;27575,50370,0,4,4,0,8
71507,160,18035,24202;26235;27670;27782,50370,0,2,2,0,4
71508,160,18036,23901;24288,50370,0,0,2,0,2
71509,160,18037,23927;24021,50370,0,0,2,0,2
71510,160,18038,24094;24146;27586,50370,0,1,2,0,3
71511,160,18039,23980;24285;26805,50370,0,1,2,0,3
71512,160,18040,23985;24214;27381;28183,50370,1,1,2,0,4
71513,160,18041,24010;26903;27073;27467,50370,0,3,1,0,4
71514,160,18042,24034;24289,50370,0,0,2,0,2
71515,160,18043,23971;24039;26986;27369;27774,50370,0,3,2,0,5
71516,160,18044,24040;27075,50370,0,1,1,0,2
71517,160,18045,24047;26415;27469;27583,50370,0,2,2,0,4
71518,160,18046,24116;24460,50370,0,0,2,0,2
71519,160,18047,23860;24160,50370,0,0,2,0,2
71520,160,18048,24033;24172;27187,50370,0,1,2,0,3
71521,160,18049,24181;27294,50370,0,1,1,0,2
71522,160,18050,24183;24314;26807,50370,0,1,2,0,3
71523,160,18051,23973;24368;27299;28075,50370,1,1,2,0,4
71524,160,18054,19777,50735,0,0,0,1,1
71525,160,18055,19288,50735,0,0,0,1,1
71526,160,18056,19981,50735,0,0,0,1,1
71527,160,18058,20023,50735,0,0,0,1,1
71528,160,18061,19997,50735,0,0,0,1,1
71529,160,18062,20083,50735,0,0,0,1,1
71530,160,18063,20716;20878,50735,0,0,0,2,2
71531,160,18064,20508,50735,0,0,0,1,1
71532,160,18066,20838,50735,0,0,0,1,1
71533,160,18067,20859;20944,50735,0,0,0,2,2
71534,160,18071,21508,50735,0,0,0,1,1
71535,160,18072,21554,50735,0,0,0,1,1
71536,160,18075,21226;21687,50735,0,0,1,1,2
71537,160,18085,22678;23210,50735,0,0,2,0,2
71538,160,18087,22764;23228;27971,50735,1,0,2,0,3
71539,160,18091,23004;23208;26202;26289;26747,50735,0,1,4,0,5
71540,160,18092,22957,50735,0,0,1,0,1
71541,160,18094,23118;23861;27459,50735,0,1,2,0,3
71542,160,18096,23204;23845;26971;27170;27457,50735,0,3,2,0,5
71543,160,18097,23222;26748,50735,0,1,1,0,2
71544,160,18098,23236;23766;26779;27165,50735,0,2,2,0,4
71545,160,18099,23207;23261;27239,50735,0,1,2,0,3
71546,160,18101,23175;23392;26014;27241,50735,0,1,3,0,4
71547,160,18102,23407;26308;26758;27242,50735,0,2,2,0,4
71548,160,18103,23412;23862;27062,50735,0,1,2,0,3
71549,160,18104,23429;23692;26398;26774;27260;28366,50735,1,2,3,0,6
71550,160,18105,23814;24060;26028;26783;27058;27167;27268;27354,50735,0,5,3,0,8
71551,160,18106,23373;23509;27562,50735,0,1,2,0,3
71552,160,18108,24169;26916;26995;27186,50735,0,3,1,0,4
71553,160,18109,23355;23800,50735,0,0,2,0,2
71554,160,18111,23610;23757;25914;26574;27446,50735,0,1,4,0,5
71555,160,18112,23500;23613,50735,0,0,2,0,2
71556,160,18113,23714;26323;26581;27262,50735,0,1,3,0,4
71557,160,18114,23455;23765;26404;26778;27453,50735,0,2,3,0,5
71558,160,18115,23494;23776;26224;26963;27351,50735,0,2,3,0,5
71559,160,18118,23886;24338;26423;27488,50735,0,1,3,0,4
71560,160,18120,23945;27068,50735,0,1,1,0,2
71561,160,18121,23727;23967;26500;27283;27582,50735,0,2,3,0,5
71562,160,18122,24006;27466,50735,0,1,1,0,2
71563,160,18123,24026;24164;27377;27481;27779,50735,0,3,2,0,5
71564,160,18124,23883;24053;26502;27076;27182,50735,0,2,3,0,5
71565,160,18125,23338;24074;26989;28270,50735,1,1,2,0,4
71566,160,18126,23779;24098;26908;27665;27974;28072,50735,2,2,2,0,6
71567,160,18127,24104;24458;26336;27398;27499,50735,0,2,3,0,5
71568,160,18128,24130;24282;27193,50735,0,1,2,0,3
71569,160,18129,24072;24134;26988;27078;28178,50735,1,2,2,0,5
71570,160,18130,24157;24256;26237;28168,50735,1,0,3,0,4
71571,160,18131,24070;24177;26802;27293,50735,0,2,2,0,4
71572,160,18132,23888;24191;26601;27669,50735,0,1,3,0,4
71573,160,18134,24431;26813,50735,0,1,1,0,2
71574,160,18135,19927,51100,0,0,0,1,1
71575,160,18140,20446,51100,0,0,0,1,1
71576,160,18141,20525,51100,0,0,0,1,1
71577,160,18148,21276,51100,0,0,0,1,1
71578,160,18150,21397;21485,51100,0,0,0,2,2
71579,160,18155,21663,51100,0,0,1,0,1
71580,160,18158,21113;21223,51100,0,0,0,2,2
71581,160,18161,22765;26448,51100,0,0,2,0,2
71582,160,18163,22105,51100,0,0,1,0,1
71583,160,18168,22546,51100,0,0,1,0,1
71584,160,18169,22579,51100,0,0,1,0,1
71585,160,18172,22466;23061,51100,0,0,2,0,2
71586,160,18174,22575;22675;26267;26627,51100,0,1,3,0,4
71587,160,18175,23367;25713;26304;27038;27337,51100,0,2,3,0,5
71588,160,18182,23059,51100,0,0,1,0,1
71589,160,18183,23077;23201;26465;26851;26949,51100,0,2,3,0,5
71590,160,18188,23902;27277;27358,51100,0,2,1,0,3
71591,160,18189,23165;23436;27244,51100,0,1,2,0,3
71592,160,18190,23477;23594,51100,0,0,2,0,2
71593,160,18191,22703;23497;26662;28269,51100,1,1,2,0,4
71594,160,18192,23527;26867;27043;27143,51100,0,3,1,0,4
71595,160,18193,23443;23530;27044,51100,0,1,2,0,3
71596,160,18194,23504;23720;26582,51100,0,0,3,0,3
71597,160,18195,23266;23602;26573;26768;27150;27255,51100,0,3,3,0,6
71598,160,18196,23179;23622;26872,51100,0,1,2,0,3
71599,160,18197,23651,51100,0,0,1,0,1
71600,160,18198,23793;24013;26697;26904,51100,0,2,2,0,4
71601,160,18199,24080;24162;27085;27291,51100,0,2,2,0,4
71602,160,18201,24352;24423;26923;27788,51100,0,2,2,0,4
71603,160,18202,23752;23853;26129;26895,51100,0,1,3,0,4
71604,160,18203,23857;24007;26786;26973,51100,0,2,2,0,4
71605,160,18204,24217;24376,51100,0,0,2,0,2
71606,160,18205,23950;26900;27362,51100,0,2,1,0,3
71607,160,18206,23514;23953;26980;27363,51100,0,2,2,0,4
71608,160,18207,23419;23972,51100,0,0,2,0,2
71609,160,18210,24336;26920,51100,0,1,1,0,2
71610,160,18211,24081;26503;27080,51100,0,1,2,0,3
71611,160,18212,24449;24484;27503;27695,51100,0,2,2,0,4
71612,160,18213,24038;26698;26906,51100,0,2,1,0,3
71613,160,18214,24212;24291;26998,51100,0,1,2,0,3
71614,160,18216,24121;24275,51100,0,0,2,0,2
71615,160,18217,24123;24187,51100,0,0,2,0,2
71616,160,18218,24136;24283;26707;27194,51100,0,2,2,0,4
71617,160,18219,24218;27295,51100,0,1,1,0,2
71618,160,18220,24163;24193;26506;27977,51100,1,0,3,0,4
71619,160,18221,23517;24195;26419;26704,51100,0,1,3,0,4
71620,160,18223,23725;24211;27380,51100,0,1,2,0,3
71621,160,18224,24216;24577;27104,51100,0,1,2,0,3
71622,160,18225,24327,51100,0,0,1,0,1
71623,160,18226,24278;24290;27677,51100,0,1,2,0,3
71624,160,18228,24299;24598;27313,51100,0,1,2,0,3
71625,160,18229,23996;24303;27195;27599,51100,0,2,2,0,4
71626,160,18230,24324;24500,51100,0,0,2,0,2
71627,160,18231,24331;24435;27200;27396,51100,0,2,2,0,4
71628,160,18232,24129;24335,51100,0,0,2,0,2
71629,160,18233,23893;24337;26712;26921;27785;28273,51100,1,3,2,0,6
71630,160,18234,23991;24354;26713;26809;27199;27684,51100,0,4,2,0,6
71631,160,18235,24360;24560;27012,51100,0,1,2,0,3
71632,160,18236,23869;24363;27094;27685,51100,0,2,2,0,4
71633,160,18237,24589;26718;27612;28087;28281,51100,2,2,1,0,5
71634,160,18238,20056,51465,0,0,0,1,1
71635,160,18240,20086,51465,0,0,0,1,1
71636,160,18241,20306;20390,51465,0,0,0,2,2
71637,160,18246,20501,51465,0,0,0,1,1
71638,160,18247,20265,51465,0,0,0,1,1
71639,160,18248,20248,51465,0,0,0,1,1
71640,160,18249,20990;21335,51465,0,0,0,2,2
71641,160,18250,21009;21147,51465,0,0,0,2,2
71642,160,18258,21819;21965,51465,0,0,2,0,2
71643,160,18261,22112;22184,51465,0,0,2,0,2
71644,160,18262,22057;22177,51465,0,0,2,0,2
71645,160,18264,22028,51465,0,0,1,0,1
71646,160,18266,22388;23321;26475;27035,51465,0,1,3,0,4
71647,160,18267,22405;22650;26941,51465,0,1,2,0,3
71648,160,18272,22722,51465,0,0,1,0,1
71649,160,18276,23163;23203;26746;26852,51465,0,2,2,0,4
71650,160,18279,23378;23834;26589;27572,51465,0,1,3,0,4
71651,160,18280,23430;23817;26683;26892;27059;27270;27857;28174,51465,2,4,2,0,8
71652,160,18281,23376;23721;25624;26400;27159;27348,51465,0,2,4,0,6
71653,160,18282,23524;23803;26407;26782,51465,0,1,3,0,4
71654,160,18283,23501;23837;27061;27168;27769,51465,0,3,2,0,5
71655,160,18284,23327;23595,51465,0,0,2,0,2
71656,160,18285,23648;24137;26912;26994;27084,51465,0,3,2,0,5
71657,160,18286,23665,51465,0,0,1,0,1
71658,160,18287,23365;23669;26577;26672,51465,0,1,3,0,4
71659,160,18288,23307;23414,51465,0,0,2,0,2
71660,160,18289,23485;23815;26891;26968;27269,51465,0,3,2,0,5
71661,160,18290,23270;23481,51465,0,0,2,0,2
71662,160,18291,23761;27571;27655,51465,0,2,1,0,3
71663,160,18292,23676;23787;26965,51465,0,1,2,0,3
71664,160,18293,23794;23899;26896;27064;27356,51465,0,3,2,0,5
71665,160,18294,23583;23993,51465,0,0,2,0,2
71666,160,18295,23764;23876;26689;26789;27276;27355,51465,0,4,2,0,6
71667,160,18296,23949;24168;26915;27086;27976,51465,1,2,2,0,5
71668,160,18297,23790;24020;26905;28071,51465,1,1,2,0,4
71669,160,18298,24023;24432;26607,51465,0,0,3,0,3
71670,160,18299,24037;24220;27074,51465,0,1,2,0,3
71671,160,18300,24048;26595,51465,0,0,2,0,2
71672,160,18301,24057;24463;27005;27204,51465,0,2,2,0,4
71673,160,18302,23823;24068;27776,51465,0,1,2,0,3
71674,160,18304,24398;27392;27496,51465,0,2,1,0,3
71675,160,18305,23693;23884,51465,0,0,2,0,2
71676,160,18306,24139;24428;27096;28077,51465,1,1,2,0,4
71677,160,18307,23731;24144,51465,0,0,2,0,2
71678,160,18308,23647;24174,51465,0,0,2,0,2
71679,160,18309,24182;24213;26703,51465,0,1,2,0,3
71680,160,18310,24265;24574;26930;27705;28085;28198,51465,2,2,2,0,6
71681,160,18311,24155;24322,51465,0,0,2,0,2
71682,160,18312,23882;24293,51465,0,0,2,0,2
71683,160,18313,24295;24755;27871,51465,1,0,2,0,3
71684,160,18314,24319;24350;27198;27490,51465,0,2,2,0,4
71685,160,18315,24321;26709;26808;27387;27681,51465,0,4,1,0,5
71686,160,18316,24349;24614,51465,0,0,2,0,2
71687,160,18317,24090;24377;26924;27877;28276,51465,2,1,2,0,5
71688,160,18318,24408;24649;26820;27520;27896,51465,1,2,2,0,5
71689,160,18319,24420;26513;27302;27393,51465,0,2,2,0,4
71690,160,18320,24436;24442;27304;27397,51465,0,2,2,0,4
71691,160,18321,24457;24477;27791,51465,0,1,2,0,3
71692,160,18322,20294,51830,0,0,0,1,1
71693,160,18323,20054,51830,0,0,0,1,1
71694,160,18324,20104,51830,0,0,0,1,1
71695,160,18326,20454,51830,0,0,0,1,1
71696,160,18327,20231;20354,51830,0,0,0,2,2
71697,160,18331,20801;20813,51830,0,0,0,2,2
71698,160,18332,20545,51830,0,0,0,1,1
71699,160,18338,21180;21541,51830,0,0,0,2,2
71700,160,18352,22027;22391,51830,0,0,2,0,2
71701,160,18361,23278;23397;26553,51830,0,0,3,0,3
71702,160,18362,23364;23444;26311;26567;26760,51830,0,1,4,0,5
71703,160,18366,23813;24103;26909;26990;27474;27666,51830,0,4,2,0,6
71704,160,18367,23551;24159;26504;26801;27480,51830,0,2,3,0,5
71705,160,18368,23369;23660;26670;27153;27565,51830,0,3,2,0,5
71706,160,18369,23617;23656;27256,51830,0,1,2,0,3
71707,160,18370,24166;24173;26702;27292;27780,51830,0,3,2,0,5
71708,160,18371,23713;24302;27487;27784;28186,51830,1,2,2,0,5
71709,160,18373,23240;23733;26883;27766,51830,0,2,2,0,4
71710,160,18374,23805;24205,51830,0,0,2,0,2
71711,160,18375,23810;24227;26236;26803;28184,51830,1,1,3,0,5
71712,160,18376,23738;23896;26401;26678,51830,0,1,3,0,4
71713,160,18377,23447;23898;26791,51830,0,1,2,0,3
71714,160,18378,23913;23998;27176;27284;27464;27772,51830,0,4,2,0,6
71715,160,18379,24012;24310;27600;27678,51830,0,2,2,0,4
71716,160,18380,24045;24356;26605;27298;27491;28188,51830,1,2,3,0,6
71717,160,18381,24055;24539;27309;28084,51830,1,1,2,0,4
71718,160,18383,23560;24066;26597,51830,0,0,3,0,3
71719,160,18384,24307;24656;27898;28000;28287,51830,3,0,2,0,5
71720,160,18385,23719;24122;26416;26910;26978,51830,0,2,3,0,5
71721,160,18386,24125;24450;27604;28079,51830,1,1,2,0,4
71722,160,18387,24180;24318;27680,51830,0,1,2,0,3
71723,160,18388,24190;24192;27589,51830,0,1,2,0,3
71724,160,18389,24200;27188;27379;27590,51830,0,3,1,0,4
71725,160,18390,24209;24643;27519;27712,51830,0,2,2,0,4
71726,160,18392,24276;24620;27803,51830,0,1,2,0,3
71727,160,18394,24629;26932;27517,51830,0,2,1,0,3
71728,160,18395,24323;27873;28074,51830,2,0,1,0,3
71729,160,18396,24329;24788;26824;27214;27623;28206,51830,1,3,2,0,6
71730,160,18397,24396;24473;26512,51830,0,0,3,0,3
71731,160,18398,24406;27988,51830,1,0,1,0,2
71732,160,18399,24439;24694;27413;28003,51830,1,1,2,0,4
71733,160,18400,24854;27320;27420,51830,0,2,1,0,3
71734,160,18401,24452;24718;28096;28202,51830,2,0,2,0,4
71735,160,18402,24281;24459;26918,51830,0,1,2,0,3
71736,160,18403,24483;24850,51830,0,0,2,0,2
71737,160,18404,24507;24632;27403;27507;27796;27884,51830,1,3,2,0,6
71738,160,18405,24062;24526;26815;27308;27700,51830,0,3,2,0,5
71739,160,18406,24528;24646;26612;27411,51830,0,1,3,0,4
71740,160,18407,24530;24626;26931;27516,51830,0,2,2,0,4
71741,160,18408,24142;24534;26514;26717;28083,51830,1,1,3,0,5
71742,160,18409,24485;24548;27010;27310,51830,0,2,2,0,4
71743,160,18410,24549;24797;27319,51830,0,1,2,0,3
71744,160,18411,24404;24553,51830,0,0,2,0,2
71745,160,18412,24128;24556;27405;27513;27888,51830,1,2,2,0,5
71746,160,18414,20084,52195,0,0,0,1,1
71747,160,18415,19814,52195,0,0,0,1,1
71748,160,18417,20356;20842,52195,0,0,0,2,2
71749,160,18418,20217,52195,0,0,0,1,1
71750,160,18420,20581;20671,52195,0,0,0,2,2
71751,160,18422,20649;20941,52195,0,0,0,2,2
71752,160,18423,20434;20749,52195,0,0,0,2,2
71753,160,18428,21118;21198,52195,0,0,0,2,2
71754,160,18429,21149,52195,0,0,0,1,1
71755,160,18431,21225,52195,0,0,0,1,1
71756,160,18436,21927;22414;26253,52195,0,0,3,0,3
71757,160,18437,22091,52195,0,0,1,0,1
71758,160,18438,22107,52195,0,0,1,0,1
71759,160,18442,22447;22510,52195,0,0,2,0,2
71760,160,18446,22648;22657,52195,0,0,2,0,2
71761,160,18448,22897;23356;25614;26211,52195,0,0,4,0,4
71762,160,18450,23021,52195,0,0,1,0,1
71763,160,18452,23625;26770;26874;27049,52195,0,3,1,0,4
71764,160,18453,23212;23743;26223,52195,0,0,3,0,3
71765,160,18458,23704;23999;27070;27177,52195,0,2,2,0,4
71766,160,18459,23753;24153;26333;27290;27588,52195,0,2,3,0,5
71767,160,18460,23569;23843;26666,52195,0,1,2,0,3
71768,160,18461,23979;24113;27475,52195,0,1,2,0,3
71769,160,18462,23325;23822;26893;27060;27456;27858,52195,1,3,2,0,6
71770,160,18463,24019;24087;26701,52195,0,1,2,0,3
71771,160,18464,24024;24469;27006;27501,52195,0,2,2,0,4
71772,160,18465,24052;24361;27391;27789,52195,0,2,2,0,4
71773,160,18467,24127;24292;27386;27985,52195,1,1,2,0,4
71774,160,18468,23486;24165,52195,0,0,2,0,2
71775,160,18469,24203;24253;26033;27591,52195,0,1,3,0,4
71776,160,18470,24156;24232;27088;27189,52195,0,2,2,0,4
71777,160,18471,24230;24234;27384,52195,0,1,2,0,3
71778,160,18473,24246;26334,52195,0,0,2,0,2
71779,160,18474,24255;24258;26804;27485,52195,0,2,2,0,4
71780,160,18475,24317;24580;27408;27514,52195,0,2,2,0,4
71781,160,18476,24235;24320;26602;27089;27296;27979;28272,52195,2,2,3,0,7
71782,160,18477,24334;24410;26711,52195,0,1,2,0,3
71783,160,18479,23659;24370;27495,52195,0,1,2,0,3
71784,160,18481,24341;24421;28277,52195,1,0,2,0,3
71785,160,18482,23915;24453;27098,52195,0,1,2,0,3
71786,160,18483,24437;24468;27688;27881;27989,52195,2,1,2,0,5
71787,160,18484,24774;27717,52195,0,1,1,0,2
71788,160,18485,24487;24793;27116;27910,52195,1,1,2,0,4
71789,160,18486,24497;24531;27401,52195,0,1,2,0,3
71790,160,18487,24395;24533;26716;26816;27207;27607,52195,0,4,2,0,6
71791,160,18488,24540;27996,52195,1,0,1,0,2
71792,160,18489,24550;24583;27512;27608,52195,0,2,2,0,4
71793,160,18490,24514;24551;27011;27404,52195,0,2,2,0,4
71794,160,18492,24878;28014;28107,52195,2,0,1,0,3
71795,160,18493,24739,52195,0,0,1,0,1
71796,160,18494,24602;26428;27515,52195,0,1,2,0,3
71797,160,18495,24609;24680;26515,52195,0,0,3,0,3
71798,160,18496,24612;24849;26616;28212,52195,1,0,3,0,4
71799,160,18497,24613;25004;28119,52195,1,0,2,0,3
71800,160,18498,24760;24906,52195,0,0,2,0,2
71801,160,18499,24513;24637;26818;28286,52195,1,1,2,0,4
71802,160,18500,24651;24712;27112;28095,52195,1,1,2,0,4
71803,160,18501,24652;24668,52195,0,0,2,0,2
71804,160,18502,24669;26516;27901;28002,52195,2,0,2,0,4
71805,160,18503,24683;24961;28300,52195,1,0,2,0,3
71806,160,18504,20414;20643,52560,0,0,0,2,2
71807,160,18505,20451,52560,0,0,0,1,1
71808,160,18506,20205;20543,52560,0,0,0,2,2
71809,160,18507,20187,52560,0,0,0,1,1
71810,160,18509,20705,52560,0,0,0,1,1
71811,160,18513,20864,52560,0,0,0,1,1
71812,160,18516,21119;21342,52560,0,0,0,2,2
71813,160,18519,20851,52560,0,0,0,1,1
71814,160,18520,21339,52560,0,0,0,1,1
71815,160,18521,21277;21289,52560,0,0,0,2,2
71816,160,18523,21133;21285,52560,0,0,0,2,2
71817,160,18528,21766,52560,0,0,1,0,1
71818,160,18529,21768,52560,0,0,1,0,1
71819,160,18533,22129,52560,0,0,1,0,1
71820,160,18539,22432,52560,0,0,1,0,1
71821,160,18542,22628,52560,0,0,1,0,1
71822,160,18547,23253,52560,0,0,1,0,1
71823,160,18549,23170;23565;27047,52560,0,1,2,0,3
71824,160,18550,23792;24260;27674;27870;27981,52560,2,1,2,0,5
71825,160,18551,23712;24131;27585;27975,52560,1,1,2,0,4
71826,160,18552,23567;23742;26024;26125;26583;26885,52560,0,1,5,0,6
71827,160,18553,23811;24065;26135;27663;27775,52560,0,2,3,0,5
71828,160,18554,23842;24388,52560,0,0,2,0,2
71829,160,18555,23686;23856,52560,0,0,2,0,2
71830,160,18556,23778;23892,52560,0,0,2,0,2
71831,160,18557,23929;24440;27689;27990,52560,1,1,2,0,4
71832,160,18558,23632;23951;26592;26979;27861,52560,1,1,3,0,5
71833,160,18560,24043;24105;26991;27667;28179,52560,1,2,2,0,5
71834,160,18561,24107;24133;27287;27375,52560,0,2,2,0,4
71835,160,18562,24607;28199,52560,1,0,1,0,2
71836,160,18563,24199;24502;27101;27306;27505,52560,0,3,2,0,5
71837,160,18564,24207;24389;26715;27300;27987,52560,1,2,2,0,5
71838,160,18565,23928;24231;27596;27673,52560,0,2,2,0,4
71839,160,18566,24247;24803;27117,52560,0,1,2,0,3
71840,160,18567,24252;24340;26335;26922;27682,52560,0,2,3,0,5
71841,160,18569,24343;24400;27878,52560,1,0,2,0,3
71842,160,18571,24606;27314;27708;28282,52560,1,2,1,0,4
71843,160,18572,24298;24417;28019,52560,1,0,2,0,3
71844,160,18573,24088;24418;27003,52560,0,1,2,0,3
71845,160,18574,24115;24480;27305;27693,52560,0,2,2,0,4
71846,160,18575,24498;27402,52560,0,1,1,0,2
71847,160,18576,24499;27795;27992;28191,52560,2,1,1,0,4
71848,160,18577,24508;24639;27106;27615,52560,0,2,2,0,4
71849,160,18578,24600;27890,52560,1,0,1,0,2
71850,160,18579,24572;24700;26610;27704;27800;27889,52560,1,2,3,0,6
71851,160,18580,24586;26817;27312;27611,52560,0,3,1,0,4
71852,160,18581,24510;24642;26819;27015,52560,0,2,2,0,4
71853,160,18582,24554;24661;26929;27997,52560,1,1,2,0,4
71854,160,18583,24617;24688;27902;28288,52560,2,0,2,0,4
71855,160,18584,24723,52560,0,0,1,0,1
71856,160,18585,24392;24745;27620;28005;28289,52560,2,1,2,0,5
71857,160,18586,24838;24920;26935;27627;27920,52560,1,2,2,0,5
71858,160,18587,24615;24769;28007,52560,1,0,2,0,3
71859,160,18588,24818;27418;28208,52560,1,1,1,0,3
71860,160,18589,20656,52925,0,0,0,1,1
71861,160,18591,20610;20618,52925,0,0,0,2,2
71862,160,18596,21583;21584,52925,0,0,0,2,2
71863,160,18597,21324;21474,52925,0,0,0,2,2
71864,160,18599,21154;21367,52925,0,0,0,2,2
71865,160,18601,21711;21724,52925,0,0,2,0,2
71866,160,18604,22161,52925,0,0,1,0,1
71867,160,18605,22420;22589,52925,0,0,2,0,2
71868,160,18606,22234;22746;25302;28320,52925,1,0,3,0,4
71869,160,18607,22831,52925,0,0,1,0,1
71870,160,18609,23147;23445;26389;26568;27339,52925,0,1,4,0,5
71871,160,18610,22908,52925,0,0,1,0,1
71872,160,18611,23623;26873,52925,0,1,1,0,2
71873,160,18614,23603;26485,52925,0,0,2,0,2
71874,160,18615,23254;23628,52925,0,0,2,0,2
71875,160,18617,23347;23597;26956,52925,0,1,2,0,3
71876,160,18622,23638;24022;27662,52925,0,1,2,0,3
71877,160,18623,23644;24082;27081;27664,52925,0,2,2,0,4
71878,160,18624,23775,52925,0,0,1,0,1
71879,160,18625,23707;24154;26232;28182,52925,1,0,3,0,4
71880,160,18626,24135;26993,52925,0,1,1,0,2
71881,160,18627,23711;23859,52925,0,0,2,0,2
71882,160,18628,23687;23741;26495;26775;27569,52925,0,2,3,0,5
71883,160,18631,23784;26225,52925,0,0,2,0,2
71884,160,18632,23831;23948;27279;27659,52925,0,2,2,0,4
71885,160,18633,23611;23854;26687;26972;27171,52925,0,3,2,0,5
71886,160,18634,24102;24249,52925,0,0,2,0,2
71887,160,18635,23807;23891;27860,52925,1,0,2,0,3
71888,160,18636,24250;27484,52925,0,1,1,0,2
71889,160,18637,23976;24271;27982,52925,1,0,2,0,3
71890,160,18639,23821;24028;27367,52925,0,1,2,0,3
71891,160,18640,23808;23939;26229;26329;26590;26693;26899;27278,52925,0,3,5,0,8
71892,160,18641,24222;24259;27383;27483;27593,52925,0,3,2,0,5
71893,160,18642,23809;24093;26600,52925,0,0,3,0,3
71894,160,18644,24464;24494,52925,0,0,2,0,2
71895,160,18645,24151;24451;27097;27498,52925,0,2,2,0,4
71896,160,18647,23997;24175,52925,0,0,2,0,2
71897,160,18648,24263;24591;27706;27801;28088,52925,1,2,2,0,5
71898,160,18649,24279;26706;27385;27486,52925,0,3,1,0,4
71899,160,18650,24366;26425;27494,52925,0,1,2,0,3
71900,160,18651,24311;24705;26933;27907,52925,1,1,2,0,4
71901,160,18652,24313;24403,52925,0,0,2,0,2
71902,160,18653,24345;24563;27103;27703;28196,52925,1,2,2,0,5
71903,160,18654,24355;24409;26810;27879,52925,1,1,2,0,4
71904,160,18655,24542;26337,52925,0,0,2,0,2
71905,160,18656,24454;24521;27205;27699;27994,52925,1,2,2,0,5
71906,160,18657,24455;24565;27202,52925,0,1,2,0,3
71907,160,18658,24474;24730;27715,52925,0,1,2,0,3
71908,160,18659,24568;24693,52925,0,0,2,0,2
71909,160,18660,24143;27184;27288;27476,52925,0,3,1,0,4
71910,160,18661,24490;24731;27619,52925,0,1,2,0,3
71911,160,18662,24390;24506;27506;27698,52925,0,2,2,0,4
71912,160,18663,24393;24523;27206,52925,0,1,2,0,3
71913,160,18664,24532;24809;27118;28101,52925,1,1,2,0,4
71914,160,18665,24535;24911;27817,52925,0,1,2,0,3
71915,160,18666,24567;25047,52925,0,0,2,0,2
71916,160,18667,24625;25051;27824,52925,0,1,2,0,3
71917,160,18668,24627;24945;27709;27893,52925,1,1,2,0,4
71918,160,18669,24630,52925,0,0,1,0,1
71919,160,18670,24640;24847;27626;28012;28211,52925,2,1,2,0,5
71920,160,18671,24359;27093,52925,0,1,1,0,2
71921,160,18672,24653;24972;28302,52925,1,0,2,0,3
71922,160,18673,24715,52925,0,0,1,0,1
71923,160,18674,24727;25096,52925,0,0,2,0,2
71924,160,18675,24729;24749;28098,52925,1,0,2,0,3
71925,160,18676,24740;24759,52925,0,0,2,0,2
71926,160,18677,24662;24778;27317;27719,52925,0,2,2,0,4
71927,160,18678,25151;28032,52925,1,0,1,0,2
71928,160,18679,24581;24786;28205,52925,1,0,2,0,3
71929,160,18681,24754;24804;26613;28008,52925,1,0,3,0,4
71930,160,18682,24837;25045;28222,52925,1,0,2,0,3
71931,160,18683,24852;24934;27630,52925,0,1,2,0,3
71932,160,18684,24859;24928;27423;27628,52925,0,2,2,0,4
71933,160,18685,24562;24863;27421,52925,0,1,2,0,3
71934,160,18686,24978;27426,52925,0,1,1,0,2
71935,160,18687,24709;24879;27714,52925,0,1,2,0,3
71936,160,18688,24880;25208;27329,52925,0,1,2,0,3
71937,160,18689,24985;25119;27222;28117;28219,52925,2,1,2,0,5
71938,160,18690,24817;24888;28108,52925,1,0,2,0,3
71939,160,18691,24896,52925,0,0,1,0,1
71940,160,18692,24296;24973;27425,52925,0,1,2,0,3
71941,160,18693,25098;27022;27540;27830,52925,0,3,1,0,4
71942,160,18694,20116,53290,0,0,0,1,1
71943,160,18695,20632,53290,0,0,0,1,1
71944,160,18696,20743,53290,0,0,0,1,1
71945,160,18697,20765;21120,53290,0,0,0,2,2
71946,160,18698,20770,53290,0,0,0,1,1
71947,160,18699,20698,53290,0,0,0,1,1
71948,160,18702,20960,53290,0,0,0,1,1
71949,160,18704,21193;21548,53290,0,0,0,2,2
71950,160,18707,21405,53290,0,0,0,1,1
71951,160,18709,21099,53290,0,0,0,1,1
71952,160,18710,21227;21385,53290,0,0,0,2,2
71953,160,18720,21778,53290,0,0,1,0,1
71954,160,18724,21988;22086,53290,0,0,2,0,2
71955,160,18728,22684;23020,53290,0,0,2,0,2
71956,160,18734,23618;23858;26688;26974;27458,53290,0,3,2,0,5
71957,160,18736,22896;23035,53290,0,0,2,0,2
71958,160,18737,23480;23666;27154,53290,0,1,2,0,3
71959,160,18741,23229,53290,0,0,1,0,1
71960,160,18743,23818;24261;27090;27597,53290,0,2,2,0,4
71961,160,18744,23905;23912;27359,53290,0,1,2,0,3
71962,160,18745,23729;23925;26881;27054;27161,53290,0,3,2,0,5
71963,160,18747,23740;24005;27660,53290,0,1,2,0,3
71964,160,18748,24011;24287;26806;27984,53290,1,1,2,0,4
71965,160,18749,24095;24243,53290,0,0,2,0,2
71966,160,18750,24044;24426;27303;28076,53290,1,1,2,0,4
71967,160,18751,23975;24089,53290,0,0,2,0,2
71968,160,18752,23872;24097;25919;26409;26788,53290,0,1,4,0,5
71969,160,18753,23770;24051;27181;27470,53290,0,2,2,0,4
71970,160,18754,23987;24189;26696,53290,0,1,2,0,3
71971,160,18755,23922;24240,53290,0,0,2,0,2
71972,160,18756,24270;24636;26719;27014,53290,0,2,2,0,4
71973,160,18757,24325;24584,53290,0,0,2,0,2
71974,160,18758,24353;27390,53290,0,1,1,0,2
71975,160,18759,24358;26606,53290,0,0,2,0,2
71976,160,18760,24367;24673,53290,0,0,2,0,2
71977,160,18761,24375;27876;28275,53290,2,0,1,0,3
71978,160,18762,24385;24536;27510,53290,0,1,2,0,3
71979,160,18763,24391;26925;27686,53290,0,2,1,0,3
71980,160,18764,24401;24519;28194,53290,1,0,2,0,3
71981,160,18766,24443;24905;28297,53290,1,0,2,0,3
71982,160,18767,24894;25008;27019;27723,53290,0,2,2,0,4
71983,160,18768,24512;24702,53290,0,0,2,0,2
71984,160,18769,24297;24515;27606;28082,53290,1,1,2,0,4
71985,160,18770,25040;27932,53290,1,0,1,0,2
71986,160,18771,24161;24569;28197,53290,1,0,2,0,3
71987,160,18772,24618;24835;27315;27892;27999,53290,2,1,2,0,5
71988,160,18773,24634;24674;26611;27518;27804,53290,0,2,3,0,5
71989,160,18774,24811;24840;28105,53290,1,0,2,0,3
71990,160,18775,24675;24714;26722,53290,0,1,2,0,3
71991,160,18776,24682;25080;28125,53290,1,0,2,0,3
71992,160,18777,24998;27428;27534,53290,0,2,1,0,3
71993,160,18778,24699,53290,0,0,1,0,1
71994,160,18779,24677;24711;28094,53290,1,0,2,0,3
71995,160,18780,24698;24713;26720,53290,0,1,2,0,3
71996,160,18781,24595;24719;27316;27523,53290,0,2,2,0,4
71997,160,18782,24736;25005;27125;28021,53290,1,1,2,0,4
71998,160,18783,24685;24750;27109,53290,0,1,2,0,3
71999,160,18784,24761;24874;27526;28204,53290,1,1,2,0,4
72000,160,18785,24767;25043;27808,53290,0,1,2,0,3
72001,160,18786,24855;24886;27815;27917,53290,1,1,2,0,4
72002,160,18787,24647;24764;27621,53290,0,1,2,0,3
72003,160,18788,24812;24827;27119,53290,0,1,2,0,3
72004,160,18789,24960;25121;27834,53290,0,1,2,0,3
72005,160,18790,24658;24833;28010,53290,1,0,2,0,3
72006,160,18791,25216;28233,53290,1,0,1,0,2
72007,160,18792,24876;25180;27638;27938;28034;28136,53290,3,1,2,0,6
72008,160,18793,24789;24890;27416;28207,53290,1,1,2,0,4
72009,160,18794,25260;27941,53290,1,0,1,0,2
72010,160,18795,24486;24909,53290,0,0,2,0,2
72011,160,18796,24964,53290,0,0,1,0,1
72012,160,18797,24858;24977,53290,0,0,2,0,2
72013,160,18798,24992;25199,53290,0,0,2,0,2
72014,160,18799,25001;28304,53290,1,0,1,0,2
72015,160,18800,24980;27427,53290,0,1,1,0,2
72016,160,18801,20740,53655,0,0,0,1,1
72017,160,18802,20931,53655,0,0,0,1,1
72018,160,18805,21081,53655,0,0,0,1,1
72019,160,18806,21159,53655,0,0,0,1,1
72020,160,18808,21563,53655,0,0,0,1,1
72021,160,18810,21030;21104,53655,0,0,0,2,2
72022,160,18811,21501,53655,0,0,0,1,1
72023,160,18817,21761,53655,0,0,1,0,1
72024,160,18821,22610,53655,0,0,1,0,1
72025,160,18823,22928,53655,0,0,1,0,1
72026,160,18824,22898,53655,0,0,1,0,1
72027,160,18825,22986,53655,0,0,1,0,1
72028,160,18827,22664,53655,0,0,1,0,1
72029,160,18828,23082,53655,0,0,1,0,1
72030,160,18830,23438;27573,53655,0,1,1,0,2
72031,160,18831,23290;23663;26772;26875;26960;27050,53655,0,4,2,0,6
72032,160,18834,23555;23959;26901,53655,0,1,2,0,3
72033,160,18835,23667;23694;27155;27765,53655,0,2,2,0,4
72034,160,18836,23700;26880,53655,0,1,1,0,2
72035,160,18838,23652,53655,0,0,1,0,1
72036,160,18841,23936;23956,53655,0,0,2,0,2
72037,160,18842,24000;24109;28176,53655,1,0,2,0,3
72038,160,18843,23772;24009;27056;27454,53655,0,2,2,0,4
72039,160,18844,23759;24147;26913,53655,0,1,2,0,3
72040,160,18846,24284;24505;27697;27883,53655,1,1,2,0,4
72041,160,18849,24305;24561;27407;27610,53655,0,2,2,0,4
72042,160,18850,25003;27429,53655,0,1,1,0,2
72043,160,18851,24419;24783;28292,53655,1,0,2,0,3
72044,160,18852,24357;24422;27092,53655,0,1,2,0,3
72045,160,18853,24429;24638;26812;27395,53655,0,2,2,0,4
72046,160,18854,24472;24624;26429;27614;28285,53655,1,1,3,0,5
72047,160,18855,24503;24770;27909,53655,1,0,2,0,3
72048,160,18856,24433;24601;27891,53655,1,0,2,0,3
72049,160,18857,24446;24509;27307;27508;27993;28192;28280,53655,3,2,2,0,7
72050,160,18859,24741,53655,0,0,1,0,1
72051,160,18860,24780;25187;27328,53655,0,1,2,0,3
72052,160,18861,24495;24717;26723,53655,0,1,2,0,3
72053,160,18862,24748;24796;27716,53655,0,1,2,0,3
72054,160,18863,24603;24753;27415;28006,53655,1,1,2,0,4
72055,160,18864,24806;25088;27323;27539;27828,53655,0,3,2,0,5
72056,160,18865,24814;25010;28305,53655,1,0,2,0,3
72057,160,18866,24575;24829;27915,53655,1,0,2,0,3
72058,160,18867,24861;27916,53655,1,0,1,0,2
72059,160,18868,24943;25166;27936;28315,53655,2,0,2,0,4
72060,160,18870,24877;24930,53655,0,0,2,0,2
72061,160,18871,24919;25156;27324,53655,0,1,2,0,3
72062,160,18872,24738;24931;27629;27725,53655,0,2,2,0,4
72063,160,18873,24944;24991,53655,0,0,2,0,2
72064,160,18874,24904;24946;26934;27123,53655,0,2,2,0,4
72065,160,18875,24955;25110;27636;27729;28028;28224,53655,2,2,2,0,6
72066,160,18876,24963;25168;27424,53655,0,1,2,0,3
72067,160,18877,24504;24989;27223,53655,0,1,2,0,3
72068,160,18878,25142;25221,53655,0,0,2,0,2
72069,160,18879,25332,53655,0,0,1,0,1
72070,160,18880,25022;25200;27733,53655,0,1,2,0,3
72071,160,18881,25024;25137;27727;28022,53655,1,1,2,0,4
72072,160,18882,25276;27943;28139;28234,53655,3,0,1,0,4
72073,160,18883,25061;25155;27228,53655,0,1,2,0,3
72074,160,18884,25136;27835;28312,53655,1,1,1,0,3
72075,160,18885,24924;25071;27126;27826,53655,0,2,2,0,4
72076,160,18886,25077;25283,53655,0,0,2,0,2
72077,160,18888,25091;25178;28309,53655,1,0,2,0,3
72078,160,18889,25101;25280;28235,53655,1,0,2,0,3
72079,160,18892,20828,54020,0,0,0,1,1
72080,160,18895,20679,54020,0,0,0,1,1
72081,160,18896,21047;21395,54020,0,0,0,2,2
72082,160,18897,21346;21633,54020,0,0,1,1,2
72083,160,18898,20815,54020,0,0,0,1,1
72084,160,18899,21698,54020,0,0,1,0,1
72085,160,18904,21898,54020,0,0,1,0,1
72086,160,18908,22132,54020,0,0,1,0,1
72087,160,18909,21798,54020,0,0,1,0,1
72088,160,18912,22059;22490,54020,0,0,2,0,2
72089,160,18915,22494,54020,0,0,1,0,1
72090,160,18919,22324,54020,0,0,1,0,1
72091,160,18922,23156;23586,54020,0,0,2,0,2
72092,160,18924,22539,54020,0,0,1,0,1
72093,160,18925,22779,54020,0,0,1,0,1
72094,160,18929,23390,54020,0,0,1,0,1
72095,160,18931,23674;23724;26962;27263;27349,54020,0,3,2,0,5
72096,160,18932,23461;23695,54020,0,0,2,0,2
72097,160,18935,23635,54020,0,0,1,0,1
72098,160,18937,23484;23924;27360,54020,0,1,2,0,3
72099,160,18940,24170;24344;27683;27787,54020,0,2,2,0,4
72100,160,18941,24119;24124;26417;26911,54020,0,1,3,0,4
72101,160,18942,24158;24364;26424;27493,54020,0,1,3,0,4
72102,160,18943,24194;24204;28271,54020,1,0,2,0,3
72103,160,18944,24461;24908;27816,54020,0,1,2,0,3
72104,160,18945,24056;24456;27004;27203;27691,54020,0,3,2,0,5
72105,160,18946,24059;24274;27091;27192;28073,54020,1,2,2,0,5
72106,160,18947,24308;27872,54020,1,0,1,0,2
72107,160,18948,24239;24382,54020,0,0,2,0,2
72108,160,18949,24387;24537;27009;27511;27701;27797;27886,54020,1,4,2,0,7
72109,160,18950,24496;24545;27400;27794,54020,0,2,2,0,4
72110,160,18951,24479;24722;27007;27399;27502;27692,54020,0,4,2,0,6
72111,160,18952,24599;25141;28132;28313,54020,2,0,2,0,4
72112,160,18953,25042;28120,54020,1,0,1,0,2
72113,160,18954,24926;27724,54020,0,1,1,0,2
72114,160,18955,24689;24825;27903;28093,54020,2,0,2,0,4
72115,160,18956,24692;25055;27904,54020,1,0,2,0,3
72116,160,18957,24696;25089;27829,54020,0,1,2,0,3
72117,160,18958,24703;27110,54020,0,1,1,0,2
72118,160,18959,24707;24935;27922;28111;28217,54020,3,0,2,0,5
72119,160,18960,24708;24743;26724;27016;27524;28097,54020,1,3,2,0,6
72120,160,18961,24732;24887;28214,54020,1,0,2,0,3
72121,160,18962,24844,54020,0,0,1,0,1
72122,160,18963,24873;24947,54020,0,0,2,0,2
72123,160,18964,24952;25244;28318,54020,1,0,2,0,3
72124,160,18965,24737;24957,54020,0,0,2,0,2
72125,160,18966,24965;25081;28113,54020,1,0,2,0,3
72126,160,18967,24971;25157,54020,0,0,2,0,2
72127,160,18968,25284,54020,0,0,1,0,1
72128,160,18969,24993;25210;27734,54020,0,1,2,0,3
72129,160,18970,24982;24994;26828;27726;28020;28115,54020,2,2,2,0,6
72130,160,18971,24884,54020,0,0,1,0,1
72131,160,18972,25324;25494,54020,0,0,2,0,2
72132,160,18973,24787;25015;27224;27822;28306,54020,1,2,2,0,5
72133,160,18974,24781;25020,54020,0,0,2,0,2
72134,160,18975,24831;25056,54020,0,0,2,0,2
72135,160,18976,25073;25094,54020,0,0,2,0,2
72136,160,18977,24918;27919,54020,1,0,1,0,2
72137,160,18978,25090;25127;28225,54020,1,0,2,0,3
72138,160,18979,25128;25182;27637,54020,0,1,2,0,3
72139,160,18980,25129,54020,0,0,1,0,1
72140,160,18981,25074;25144;28307,54020,1,0,2,0,3
72141,160,18982,25181;25354,54020,0,0,2,0,2
72142,160,18983,24967;25193;28036;28231,54020,2,0,2,0,4
72143,160,18984,25203;25222;27838;28037,54020,1,1,2,0,4
72144,160,18985,25206;25225;27640;28038,54020,1,1,2,0,4
72145,160,18986,20579,54385,0,0,0,1,1
72146,160,18988,20969,54385,0,0,0,1,1
72147,160,18989,20970,54385,0,0,0,1,1
72148,160,18990,20819,54385,0,0,0,1,1
72149,160,18992,21061,54385,0,0,0,1,1
72150,160,18994,21197,54385,0,0,0,1,1
72151,160,18995,20886,54385,0,0,0,1,1
72152,160,18998,21275,54385,0,0,0,1,1
72153,160,18999,21727,54385,0,0,1,0,1
72154,160,19000,21826;21971,54385,0,0,2,0,2
72155,160,19001,21457,54385,0,0,0,1,1
72156,160,19004,22179,54385,0,0,1,0,1
72157,160,19008,22300,54385,0,0,1,0,1
72158,160,19009,22595,54385,0,0,1,0,1
72159,160,19012,22924,54385,0,0,1,0,1
72160,160,19016,23110;23214;26466,54385,0,0,3,0,3
72161,160,19018,22766,54385,0,0,1,0,1
72162,160,19019,23234;23520,54385,0,0,2,0,2
72163,160,19020,23238,54385,0,0,1,0,1
72164,160,19021,23117,54385,0,0,1,0,1
72165,160,19022,23404;23718,54385,0,0,2,0,2
72166,160,19025,23536;25815;26663;27144;27251,54385,0,3,2,0,5
72167,160,19028,23324;23637,54385,0,0,2,0,2
72168,160,19030,23907;26977;27461,54385,0,2,1,0,3
72169,160,19031,23935;24096;26907,54385,0,1,2,0,3
72170,160,19032,23946;24138;27973,54385,1,0,2,0,3
72171,160,19034,24106;24304,54385,0,0,2,0,2
72172,160,19035,24330;24339;26508;27388;27786,54385,0,2,3,0,5
72173,160,19036,24063;24412;27301,54385,0,1,2,0,3
72174,160,19037,24441;24582;27013,54385,0,1,2,0,3
72175,160,19038,24447;24867,54385,0,0,2,0,2
72176,160,19039,24522;24676;28092,54385,1,0,2,0,3
72177,160,19042,24571;27209,54385,0,1,1,0,2
72178,160,19044,24541;25038;27632,54385,0,1,2,0,3
72179,160,19045,24925;25093;27533;27770;27818;28018;28298,54385,2,3,2,0,7
72180,160,19046,24042;24114;27468,54385,0,1,2,0,3
72181,160,19047,24413;24678;27108,54385,0,1,2,0,3
72182,160,19048,24758;25152;28033;28226,54385,2,0,2,0,4
72183,160,19049,24470;24823;27120;27624;28009,54385,1,2,2,0,5
72184,160,19050,24773;24824;27914,54385,1,0,2,0,3
72185,160,19051,24777;24839;27121,54385,0,1,2,0,3
72186,160,19052,24706;24843;27805;27908;28004,54385,2,1,2,0,5
72187,160,19053,24848,54385,0,0,1,0,1
72188,160,19054,24875;25430;27747,54385,0,1,2,0,3
72189,160,19055,24881;24942,54385,0,0,2,0,2
72190,160,19056,24922;27220;27532;27921,54385,1,2,1,0,4
72191,160,19057,25037;28023;28221,54385,2,0,1,0,3
72192,160,19058,24936;24988;26829,54385,0,1,2,0,3
72193,160,19059,25026;25262,54385,0,0,2,0,2
72194,160,19060,24865;24929;27722,54385,0,1,2,0,3
72195,160,19061,25132;25201,54385,0,0,2,0,2
72196,160,19062,25067;25158;28134;28314,54385,2,0,2,0,4
72197,160,19063,25163;25209,54385,0,0,2,0,2
72198,160,19064,25169;27837,54385,0,1,1,0,2
72199,160,19065,25521;25552;27752;28249,54385,1,1,2,0,4
72200,160,19066,25477,54385,0,0,1,0,1
72201,160,19067,25543,54385,0,0,1,0,1
72202,160,19069,24907;25183;26938;27544,54385,0,2,2,0,4
72203,160,19070,25107;25265;28039,54385,1,0,2,0,3
72204,160,19071,25299;25478;28044,54385,1,0,2,0,3
72205,160,19072,20719,54750,0,0,0,1,1
72206,160,19073,21086,54750,0,0,0,1,1
72207,160,19074,21140,54750,0,0,0,1,1
72208,160,19075,20913,54750,0,0,0,1,1
72209,160,19076,20925,54750,0,0,0,1,1
72210,160,19077,20918;21204,54750,0,0,0,2,2
72211,160,19078,21006,54750,0,0,0,1,1
72212,160,19081,21856,54750,0,0,1,0,1
72213,160,19084,21986;22121,54750,0,0,2,0,2
72214,160,19088,21918,54750,0,0,1,0,1
72215,160,19090,21742,54750,0,0,1,0,1
72216,160,19098,22865,54750,0,0,1,0,1
72217,160,19099,22925;23025,54750,0,0,2,0,2
72218,160,19104,23362,54750,0,0,1,0,1
72219,160,19108,23550;23605;26483,54750,0,0,3,0,3
72220,160,19110,23682;23841;27169,54750,0,1,2,0,3
72221,160,19111,23749;26886,54750,0,1,1,0,2
72222,160,19112,23871;24264;26603;27190;27675,54750,0,2,3,0,5
72223,160,19113,23961;24492;27504;27991,54750,1,1,2,0,4
72224,160,19116,23852,54750,0,0,1,0,1
72225,160,19118,23796;24219,54750,0,0,2,0,2
72226,160,19119,24061;24071;26598;27472,54750,0,1,3,0,4
72227,160,19120,24014,54750,0,0,1,0,1
72228,160,19121,24588;24776;26823;27622;27718,54750,0,3,2,0,5
72229,160,19123,24269;24578;27998,54750,1,0,2,0,3
72230,160,19126,24872;27219;27814;28213,54750,1,2,1,0,4
72231,160,19127,24384;24631;27894,54750,1,0,2,0,3
72232,160,19128,24273;24552;27102;27609;27799;28195,54750,1,3,2,0,6
72233,160,19129,24559;24785,54750,0,0,2,0,2
72234,160,19131,24407;24657;27899;28001,54750,2,0,2,0,4
72235,160,19132,24746;24790;27414;27525,54750,0,2,2,0,4
72236,160,19133,24272;24752;27114;27213;27806;28099;28290,54750,2,3,2,0,7
72237,160,19135,24771;24869;26826;27218,54750,0,2,2,0,4
72238,160,19136,24775;25145;27732;28133,54750,1,1,2,0,4
72239,160,19137,24921;25215;27735,54750,0,1,2,0,3
72240,160,19138,25532,54750,0,0,1,0,1
72241,160,19139,24959;25032,54750,0,0,2,0,2
72242,160,19140,24792;24962,54750,0,0,2,0,2
72243,160,19141,24975;25432,54750,0,0,2,0,2
72244,160,19142,25019;25109;27536,54750,0,1,2,0,3
72245,160,19143,25030;25410;27232;27550;27952;28244,54750,2,2,2,0,6
72246,160,19144,25035;25645,54750,0,0,2,0,2
72247,160,19145,25041;25370;27744,54750,0,1,2,0,3
72248,160,19146,25054;25569,54750,0,0,2,0,2
72249,160,19147,25282,54750,0,0,1,0,1
72250,160,19148,25084;25099;27831;28310,54750,1,1,2,0,4
72251,160,19149,24913;25086;27322;28308,54750,1,1,2,0,4
72252,160,19150,24938;25117;27935;28128,54750,2,0,2,0,4
72253,160,19151,25131;27730,54750,0,1,1,0,2
72254,160,19152,25143,54750,0,0,1,0,1
72255,160,19153,25146;25235;27542,54750,0,1,2,0,3
72256,160,19154,25149;25470;28335,54750,1,0,2,0,3
72257,160,19155,25059;25165;27933;28223,54750,2,0,2,0,4
72258,160,19156,25174;25271,54750,0,0,2,0,2
72259,160,19157,25172;25176;27543;27937,54750,1,1,2,0,4
72260,160,19158,25189;25289;28229,54750,1,0,2,0,3
72261,160,19159,25223;25682,54750,0,0,2,0,2
72262,160,19160,25230;25424,54750,0,0,2,0,2
72263,160,19161,25434,54750,0,0,1,0,1
72264,160,19162,25236;25295;27939,54750,1,0,2,0,3
72265,160,19163,25245,54750,0,0,1,0,1
72266,160,19164,25247;25373,54750,0,0,2,0,2
72267,160,19165,25402;25652,54750,0,0,2,0,2
72268,160,19166,25303;27330;27740,54750,0,2,1,0,3
72269,160,19167,25305;25433;27551,54750,0,1,2,0,3
72270,160,19168,25313;25611,54750,0,0,2,0,2
72271,160,19169,25314;27230;28237;28321,54750,2,1,1,0,4
72272,160,19170,25328;25484;27956,54750,1,0,2,0,3
72273,160,19171,25329;25758;27759,54750,0,1,2,0,3
72274,160,19172,25334;25387;27332,54750,0,1,2,0,3
72275,160,19173,25340;25719,54750,0,0,2,0,2
72276,160,19174,25551;25699,54750,0,0,2,0,2
72277,160,19175,25365;25549,54750,0,0,2,0,2
72278,160,19176,25115;25376;27745,54750,0,1,2,0,3
72279,160,19177,25394;25638,54750,0,0,2,0,2
72280,160,19178,25066;25397,54750,0,0,2,0,2
72281,160,19179,25083;25398;27951,54750,1,0,2,0,3
72282,160,19180,25395;25400,54750,0,0,2,0,2
72283,160,19181,21170;21229,55115,0,0,0,2,2
72284,160,19182,21182,55115,0,0,0,1,1
72285,160,19184,21156,55115,0,0,0,1,1
72286,160,19186,21287,55115,0,0,0,1,1
72287,160,19187,21410;21680,55115,0,0,1,1,2
72288,160,19189,21493,55115,0,0,0,1,1
72289,160,19190,21681,55115,0,0,1,0,1
72290,160,19191,21717,55115,0,0,1,0,1
72291,160,19192,21892,55115,0,0,1,0,1
72292,160,19193,22083,55115,0,0,1,0,1
72293,160,19194,21943,55115,0,0,1,0,1
72294,160,19196,22660,55115,0,0,1,0,1
72295,160,19203,23292,55115,0,0,1,0,1
72296,160,19205,23191,55115,0,0,1,0,1
72297,160,19207,23225,55115,0,0,1,0,1
72298,160,19211,23556;23930;26392;27147,55115,0,1,3,0,4
72299,160,19213,24101;27183,55115,0,1,1,0,2
72300,160,19217,23797;24017;27366,55115,0,1,2,0,3
72301,160,19219,23958;24141,55115,0,0,2,0,2
72302,160,19220,24054,55115,0,0,1,0,1
72303,160,19221,24309;24782;27318;27528,55115,0,2,2,0,4
72304,160,19222,24312,55115,0,0,1,0,1
72305,160,19223,24424;24425;26811;26926;27687,55115,0,3,2,0,5
72306,160,19224,24373;24430;27603;27790;28189,55115,1,2,2,0,5
72307,160,19226,24544;26609;27208;27702;27887,55115,1,2,2,0,5
72308,160,19227,24547;24733;26821;27212,55115,0,2,2,0,4
72309,160,19228,25092;25306;28140,55115,1,0,2,0,3
72310,160,19231,24623,55115,0,0,1,0,1
72311,160,19232,24659;25286,55115,0,0,2,0,2
72312,160,19233,24660;24742;27113;28203,55115,1,1,2,0,4
72313,160,19234,24210;24663;27412;28090,55115,1,1,2,0,4
72314,160,19235,24981;25266;27547,55115,0,1,2,0,3
72315,160,19236,24667;27618;27900,55115,1,1,1,0,3
72316,160,19238,24762,55115,0,0,1,0,1
72317,160,19239,24791;25428;28331,55115,1,0,2,0,3
72318,160,19240,24842;25050;27537,55115,0,1,2,0,3
72319,160,19241,24735;24853;26825;28013;28106;28296,55115,3,1,2,0,6
72320,160,19242,24529;24892;27422;28015,55115,1,1,2,0,4
72321,160,19243,24937;25069;27819;27923,55115,1,1,2,0,4
72322,160,19245,24747;24951;28112,55115,1,0,2,0,3
72323,160,19246,24968;25445;28333,55115,1,0,2,0,3
72324,160,19247,24901;25118,55115,0,0,2,0,2
72325,160,19248,25036,55115,0,0,1,0,1
72326,160,19249,25062;25170;27325,55115,0,1,2,0,3
72327,160,19250,24794;25108;27541;27832;28027,55115,1,2,2,0,5
72328,160,19251,24813;25490,55115,0,0,2,0,2
72329,160,19253,25102;25204;27023;27431;28127,55115,1,2,2,0,5
72330,160,19254,25212;25651;27961;28052;28343,55115,3,0,2,0,5
72331,160,19255,24939;25252;27738,55115,0,1,2,0,3
72332,160,19256,25253;25665;27436,55115,0,1,2,0,3
72333,160,19257,25316;25612;28342,55115,1,0,2,0,3
72334,160,19258,25388;25681,55115,0,0,2,0,2
72335,160,19259,25391;25817,55115,0,0,2,0,2
72336,160,19260,25393;25656,55115,0,0,2,0,2
72337,160,19261,25437;25671,55115,0,0,2,0,2
72338,160,19262,25348;25597;27648;27960,55115,1,1,2,0,4
72339,160,19263,21237;21479,55480,0,0,0,2,2
72340,160,19267,21707,55480,0,0,1,0,1
72341,160,19268,21524,55480,0,0,0,1,1
72342,160,19269,21581,55480,0,0,0,1,1
72343,160,19272,22024;22125,55480,0,0,2,0,2
72344,160,19277,22773,55480,0,0,1,0,1
72345,160,19279,23151,55480,0,0,1,0,1
72346,160,19281,22240;22426,55480,0,0,2,0,2
72347,160,19282,23221,55480,0,0,1,0,1
72348,160,19283,23275;23374,55480,0,0,2,0,2
72349,160,19288,23302;23558,55480,0,0,2,0,2
72350,160,19290,24306,55480,0,0,1,0,1
72351,160,19291,23897;24315,55480,0,0,2,0,2
72352,160,19293,24186;24333;26710;27197;27601,55480,0,3,2,0,5
72353,160,19294,23992,55480,0,0,1,0,1
72354,160,19295,23879;24148;26914,55480,0,1,2,0,3
72355,160,19296,24149;24695;27211;27905;28201,55480,2,1,2,0,5
72356,160,19297,24332;24465;27099;27605,55480,0,2,2,0,4
72357,160,19298,23875;24201;26997;27781;27978,55480,1,2,2,0,5
72358,160,19299,24236,55480,0,0,1,0,1
72359,160,19300,24267;24466;27500,55480,0,1,2,0,3
72360,160,19301,24371,55480,0,0,1,0,1
72361,160,19302,24397;24798;28100;28294,55480,2,0,2,0,4
72362,160,19303,24411;24756;26822;27807,55480,0,2,2,0,4
72363,160,19304,24520;24704;27111,55480,0,1,2,0,3
72364,160,19305,24027;24215;27773;27866,55480,1,1,2,0,4
72365,160,19306,24517;24665;27885;28193,55480,2,0,2,0,4
72366,160,19307,25263;25317,55480,0,0,2,0,2
72367,160,19308,24655;24864;27217;27813,55480,0,2,2,0,4
72368,160,19309,24686;24805;27911,55480,1,0,2,0,3
72369,160,19310,24546;24821;27811;28295,55480,1,1,2,0,4
72370,160,19311,24883;25297,55480,0,0,2,0,2
72371,160,19312,24891;25251;28138,55480,1,0,2,0,3
72372,160,19313,24478;25072;27934,55480,1,0,2,0,3
72373,160,19314,24954;27924,55480,1,0,1,0,2
72374,160,19315,24728;25000;27929,55480,1,0,2,0,3
72375,160,19316,25016;25018,55480,0,0,2,0,2
72376,160,19317,25031;25290;27823;27931;28220,55480,2,1,2,0,5
72377,160,19318,24608,55480,0,0,1,0,1
72378,160,19319,25097;25555,55480,0,0,2,0,2
72379,160,19321,25006;25177;27535,55480,0,1,2,0,3
72380,160,19322,25186;25188;27327;28228,55480,1,1,2,0,4
72381,160,19323,25258;25362;28324,55480,1,0,2,0,3
72382,160,19324,25259;25330,55480,0,0,2,0,2
72383,160,19325,25272;25443;27548;27739;28319,55480,1,2,2,0,5
72384,160,19326,25296;25298,55480,0,0,2,0,2
72385,160,19327,25346,55480,0,0,1,0,1
72386,160,19328,25371;25922;28161,55480,1,0,2,0,3
72387,160,19329,25198;25275;27839,55480,0,1,2,0,3
72388,160,19330,25415;25641,55480,0,0,2,0,2
72389,160,19331,25232;25476;27954,55480,1,0,2,0,3
72390,160,19332,25623;25707;27846;28346,55480,1,1,2,0,4
72391,160,19333,25288;25488;28336,55480,1,0,2,0,3
72392,160,19334,25489;25523;28147,55480,1,0,2,0,3
72393,160,19335,25498;25873,55480,0,0,2,0,2
72394,160,19336,25427;25515;27958,55480,1,0,2,0,3
72395,160,19337,25529;25784,55480,0,0,2,0,2
72396,160,19338,25675;25849;27965;28260,55480,2,0,2,0,4
72397,160,19339,25565;25693,55480,0,0,2,0,2
72398,160,19340,25571;25643,55480,0,0,2,0,2
72399,160,19341,25862;28349,55480,1,0,1,0,2
72400,160,19342,25525;25579,55480,0,0,2,0,2
72401,160,19343,25670,55480,0,0,1,0,1
72402,160,19344,25822;27963;28257,55480,2,0,1,0,3
72403,160,19345,25589;25878,55480,0,0,2,0,2
72404,160,19346,25595;25833,55480,0,0,2,0,2
72405,160,19347,25516;25596;27435,55480,0,1,2,0,3
72406,160,19348,25621;25792,55480,0,0,2,0,2
72407,160,19349,21085,55845,0,0,0,1,1
72408,160,19351,21302,55845,0,0,0,1,1
72409,160,19352,21748,55845,0,0,1,0,1
72410,160,19354,21783,55845,0,0,1,0,1
72411,160,19358,21745,55845,0,0,1,0,1
72412,160,19359,22119,55845,0,0,1,0,1
72413,160,19361,22146,55845,0,0,1,0,1
72414,160,19362,22096,55845,0,0,1,0,1
72415,160,19363,22315,55845,0,0,1,0,1
72416,160,19364,22337,55845,0,0,1,0,1
72417,160,19366,22164,55845,0,0,1,0,1
72418,160,19370,22481,55845,0,0,1,0,1
72419,160,19371,22912,55845,0,0,1,0,1
72420,160,19375,22874,55845,0,0,1,0,1
72421,160,19376,23305,55845,0,0,1,0,1
72422,160,19378,23423;24002;27072,55845,0,1,2,0,3
72423,160,19379,23755;27266,55845,0,1,1,0,2
72424,160,19382,23641,55845,0,0,1,0,1
72425,160,19388,23919;24286;26919;27001,55845,0,2,2,0,4
72426,160,19389,23889;24316;26708;27196;27679;28187,55845,1,3,2,0,6
72427,160,19391,23943;24079,55845,0,0,2,0,2
72428,160,19392,24294;26238;27598,55845,0,1,2,0,3
72429,160,19393,24132;24604,55845,0,0,2,0,2
72430,160,19395,24462;24482;26927;27008;27100;27694;27793,55845,0,5,2,0,7
72431,160,19396,24799,55845,0,0,1,0,1
72432,160,19397,24648;25285;27127,55845,0,1,2,0,3
72433,160,19398,24414;24687;27522,55845,0,1,2,0,3
72434,160,19399,24690;24868;27018,55845,0,1,2,0,3
72435,160,19400,24734;24956;26827;27925;28299,55845,2,1,2,0,5
72436,160,19401,24525,55845,0,0,1,0,1
72437,160,19402,24820,55845,0,0,1,0,1
72438,160,19404,24257;24862,55845,0,0,2,0,2
72439,160,19405,24197;24467,55845,0,0,2,0,2
72440,160,19406,24933;25359,55845,0,0,2,0,2
72441,160,19407,24725;25048,55845,0,0,2,0,2
72442,160,19408,24915;25065,55845,0,0,2,0,2
72443,160,19409,25029;25068;27634;27825,55845,0,2,2,0,4
72444,160,19410,25076;25122;27321;28124,55845,1,1,2,0,4
72445,160,19411,25116;25134;27731,55845,0,1,2,0,3
72446,160,19412,25135;25140;27227,55845,0,1,2,0,3
72447,160,19413,25161;25442;28042;28332,55845,2,0,2,0,4
72448,160,19414,25816;28058;28347,55845,2,0,1,0,3
72449,160,19415,25175;28135,55845,1,0,1,0,2
72450,160,19416,24866;25192;28230,55845,1,0,2,0,3
72451,160,19417,25218;25486;28248,55845,1,0,2,0,3
72452,160,19418,25233,55845,0,0,1,0,1
72453,160,19419,25248;25720,55845,0,0,2,0,2
72454,160,19420,25254;25300,55845,0,0,2,0,2
72455,160,19421,25261;26023,55845,0,0,2,0,2
72456,160,19422,25808;26027;28165,55845,1,0,2,0,3
72457,160,19423,25274;25577;28149,55845,1,0,2,0,3
72458,160,19424,25650;28152,55845,1,0,1,0,2
72459,160,19426,25106;25358;27840;28323,55845,1,1,2,0,4
72460,160,19427,25886;25930,55845,0,0,2,0,2
72461,160,19428,25374;25705,55845,0,0,2,0,2
72462,160,19429,25349;25385,55845,0,0,2,0,2
72463,160,19430,25456;25739,55845,0,0,2,0,2
72464,160,19431,25194;25469,55845,0,0,2,0,2
72465,160,19432,25345;25482;27955,55845,1,0,2,0,3
72466,160,19433,25021;25512;28047,55845,1,0,2,0,3
72467,160,19434,25517,55845,0,0,1,0,1
72468,160,19435,25519;25756,55845,0,0,2,0,2
72469,160,19436,25211;25500;27646;28045;28337,55845,2,1,2,0,5
72470,160,19437,25533;25729,55845,0,0,2,0,2
72471,160,19438,25405;25544;27642;28328,55845,1,1,2,0,4
72472,160,19439,25323;25545,55845,0,0,2,0,2
72473,160,19440,25861;28159,55845,1,0,1,0,2
72474,160,19441,25364;25480,55845,0,0,2,0,2
72475,160,19442,25575;26005,55845,0,0,2,0,2
72476,160,19443,25828,55845,0,0,1,0,1
72477,160,19444,25629;25900,55845,0,0,2,0,2
72478,160,19445,25635;25855,55845,0,0,2,0,2
72479,160,19446,25154;25710;28053;28253,55845,2,0,2,0,4
72480,160,19447,25655;25771;27555;27844,55845,0,2,2,0,4
72481,160,19448,25503;25683;28252,55845,1,0,2,0,3
72482,160,19449,25708;26018,55845,0,0,2,0,2
72483,160,19450,25718;25945,55845,0,0,2,0,2
72484,160,19451,21488,56210,0,0,0,1,1
72485,160,19452,21537,56210,0,0,0,1,1
72486,160,19453,21559,56210,0,0,0,1,1
72487,160,19454,21599;21668,56210,0,0,1,1,2
72488,160,19455,21528,56210,0,0,0,1,1
72489,160,19458,21818,56210,0,0,1,0,1
72490,160,19459,22037,56210,0,0,1,0,1
72491,160,19460,21648,56210,0,0,1,0,1
72492,160,19467,22534,56210,0,0,1,0,1
72493,160,19468,22162,56210,0,0,1,0,1
72494,160,19469,22427,56210,0,0,1,0,1
72495,160,19470,22680,56210,0,0,1,0,1
72496,160,19472,23044,56210,0,0,1,0,1
72497,160,19473,22788,56210,0,0,1,0,1
72498,160,19474,23368,56210,0,0,1,0,1
72499,160,19478,23512;23903,56210,0,0,2,0,2
72500,160,19479,23437,56210,0,0,1,0,1
72501,160,19482,23941;24268;26131;26591;28175,56210,1,0,4,0,5
72502,160,19483,23735;23944;27067;27580;27658;27771,56210,0,4,2,0,6
72503,160,19484,23786;24427;27394;27880,56210,1,1,2,0,4
72504,160,19485,24050;24555,56210,0,0,2,0,2
72505,160,19486,24176,56210,0,0,1,0,1
72506,160,19487,24251;24766;27017;27527;28291,56210,1,2,2,0,5
72507,160,19488,24351;24445;27201;27497,56210,0,2,2,0,4
72508,160,19489,24301;24481;27792;28080,56210,1,1,2,0,4
72509,160,19490,24587;24916;27124,56210,0,1,2,0,3
72510,160,19491,24557;25057;27633;27728,56210,0,2,2,0,4
72511,160,19493,24641;24974;27020;27928,56210,1,1,2,0,4
72512,160,19494,24524;24857;27531;27721,56210,0,2,2,0,4
72513,160,19495,24564,56210,0,0,1,0,1
72514,160,19496,24710,56210,0,0,1,0,1
72515,160,19497,24491,56210,0,0,1,0,1
72516,160,19498,24923,56210,0,0,1,0,1
72517,160,19499,24768;24999,56210,0,0,2,0,2
72518,160,19500,25472;27645,56210,0,1,1,0,2
72519,160,19501,24596;24895;28215,56210,1,0,2,0,3
72520,160,19502,25414;27841,56210,0,1,1,0,2
72521,160,19503,24997;25342;27741;27947;28240,56210,2,1,2,0,5
72522,160,19504,24912;25011;26936,56210,0,1,2,0,3
72523,160,19505,25039;25644;27755,56210,0,1,2,0,3
72524,160,19507,25105,56210,0,0,1,0,1
72525,160,19508,25112,56210,0,0,1,0,1
72526,160,19511,25153;25572,56210,0,0,2,0,2
72527,160,19512,24846;25205,56210,0,0,2,0,2
72528,160,19513,25241;25268;27229;27942,56210,1,1,2,0,4
72529,160,19514,25685,56210,0,0,1,0,1
72530,160,19515,25287;25392,56210,0,0,2,0,2
72531,160,19517,25291;25375;27331;27434,56210,0,2,2,0,4
72532,160,19518,25386;25468;28043;28247,56210,2,0,2,0,4
72533,160,19519,24927;25418;27233;27333;28329,56210,1,2,2,0,5
72534,160,19520,25431;25679;28344,56210,1,0,2,0,3
72535,160,19521,25307;25439;27748,56210,0,1,2,0,3
72536,160,19522,25446,56210,0,0,1,0,1
72537,160,19523,25111;25449;28334,56210,1,0,2,0,3
72538,160,19524,25458,56210,0,0,1,0,1
72539,160,19525,25460;25827,56210,0,0,2,0,2
72540,160,19526,25526;25882;27557,56210,0,1,2,0,3
72541,160,19527,25585;26138,56210,0,0,2,0,2
72542,160,19528,25441,56210,0,0,1,0,1
72543,160,19529,25320;25625;27433;28141;28238,56210,2,1,2,0,5
72544,160,19530,25632;26054,56210,0,0,2,0,2
72545,160,19531,25647;25894,56210,0,0,2,0,2
72546,160,19532,25649;25891;28160,56210,1,0,2,0,3
72547,160,19533,25657;25985;28063,56210,1,0,2,0,3
72548,160,19534,25672;25757,56210,0,0,2,0,2
72549,160,19535,25674;25946,56210,0,0,2,0,2
72550,160,19536,25712;25918,56210,0,0,2,0,2
72551,160,19537,25760,56210,0,0,1,0,1
72552,160,19538,25795;26034,56210,0,0,2,0,2
72553,160,19539,25797;25802,56210,0,0,2,0,2
72554,160,19540,25774;25805,56210,0,0,2,0,2
72555,160,19541,25806;26026,56210,0,0,2,0,2
72556,160,19542,25688;25810,56210,0,0,2,0,2
72557,160,19543,25318;25811,56210,0,0,2,0,2
72558,160,19544,21573,56575,0,0,0,1,1
72559,160,19545,21857,56575,0,0,1,0,1
72560,160,19546,21732,56575,0,0,1,0,1
72561,160,19547,21398,56575,0,0,0,1,1
72562,160,19548,21806,56575,0,0,1,0,1
72563,160,19549,21520,56575,0,0,0,1,1
72564,160,19550,21977,56575,0,0,1,0,1
72565,160,19551,21920,56575,0,0,1,0,1
72566,160,19552,21834,56575,0,0,1,0,1
72567,160,19553,21576,56575,0,0,0,1,1
72568,160,19557,22143,56575,0,0,1,0,1
72569,160,19558,22211;22412,56575,0,0,2,0,2
72570,160,19559,22233,56575,0,0,1,0,1
72571,160,19560,21809,56575,0,0,1,0,1
72572,160,19562,22145,56575,0,0,1,0,1
72573,160,19563,22428,56575,0,0,1,0,1
72574,160,19565,22408,56575,0,0,1,0,1
72575,160,19567,22318,56575,0,0,1,0,1
72576,160,19568,22991,56575,0,0,1,0,1
72577,160,19569,23141,56575,0,0,1,0,1
72578,160,19571,23195,56575,0,0,1,0,1
72579,160,19572,22855,56575,0,0,1,0,1
72580,160,19574,23317,56575,0,0,1,0,1
72581,160,19576,23684;24140,56575,0,0,2,0,2
72582,160,19577,23745,56575,0,0,1,0,1
72583,160,19578,23746;24073;27584,56575,0,1,2,0,3
72584,160,19579,23453;23767;27350,56575,0,1,2,0,3
72585,160,19580,23467;23728;26677;27566,56575,0,2,2,0,4
72586,160,19581,23873;24836;26615;28210,56575,1,0,3,0,4
72587,160,19583,23940;24035,56575,0,0,2,0,2
72588,160,19585,24238;24815,56575,0,0,2,0,2
72589,160,19586,24046,56575,0,0,1,0,1
72590,160,19587,24380,56575,0,0,1,0,1
72591,160,19588,24342,56575,0,0,1,0,1
72592,160,19590,24184;24538;27798;27995,56575,1,1,2,0,4
72593,160,19591,24744;25184,56575,0,0,2,0,2
72594,160,19592,24110,56575,0,0,1,0,1
72595,160,19593,24801,56575,0,0,1,0,1
72596,160,19594,24724,56575,0,0,1,0,1
72597,160,19595,24903;25353,56575,0,0,2,0,2
72598,160,19597,24932;25190;27639;28035,56575,1,1,2,0,4
72599,160,19598,24966;24976;27221;27820;27926,56575,1,2,2,0,5
72600,160,19599,25007;25217;27545,56575,0,1,2,0,3
72601,160,19600,25369;28242;28325,56575,2,0,1,0,3
72602,160,19601,24605,56575,0,0,1,0,1
72603,160,19602,25070;25087;27635,56575,0,1,2,0,3
72604,160,19603,24386;24654;27617;27897;28089,56575,2,1,2,0,5
72605,160,19604,25147;28031,56575,1,0,1,0,2
72606,160,19605,24941;25514,56575,0,0,2,0,2
72607,160,19606,24870;25185,56575,0,0,2,0,2
72608,160,19607,25227;25229,56575,0,0,2,0,2
72609,160,19608,25220,56575,0,0,1,0,1
72610,160,19609,25269;25646,56575,0,0,2,0,2
72611,160,19610,25270;25542,56575,0,0,2,0,2
72612,160,19611,25060;25407;28041,56575,1,0,2,0,3
72613,160,19612,25319;25714,56575,0,0,2,0,2
72614,160,19613,25014,56575,0,0,1,0,1
72615,160,19614,25351;25711,56575,0,0,2,0,2
72616,160,19615,25377;25413;27746;28144,56575,1,1,2,0,4
72617,160,19616,25380;25691;27757;28153,56575,1,1,2,0,4
72618,160,19617,25409,56575,0,0,1,0,1
72619,160,19618,25240;25411,56575,0,0,2,0,2
72620,160,19619,25231;25422,56575,0,0,2,0,2
72621,160,19620,25423;25492;27643,56575,0,1,2,0,3
72622,160,19621,25459;26073,56575,0,0,2,0,2
72623,160,19622,25502;25973;28163,56575,1,0,2,0,3
72624,160,19623,25547;25989,56575,0,0,2,0,2
72625,160,19624,25605;25933,56575,0,0,2,0,2
72626,160,19625,25350;25669,56575,0,0,2,0,2
72627,160,19626,25574;25684;27754,56575,0,1,2,0,3
72628,160,19627,25636;25998,56575,0,0,2,0,2
72629,160,19628,26170,56575,0,0,1,0,1
72630,160,19629,25734;26144,56575,0,0,2,0,2
72631,160,19630,25966,56575,0,0,1,0,1
72632,160,19631,25737;25876,56575,0,0,2,0,2
72633,160,19632,25775;25875,56575,0,0,2,0,2
72634,160,19633,25780;26124,56575,0,0,2,0,2
72635,160,19634,25825;26137,56575,0,0,2,0,2
72636,160,19635,25576,56575,0,0,1,0,1
72637,160,19636,25831;26182,56575,0,0,2,0,2
72638,160,19637,25834;25859,56575,0,0,2,0,2
72639,160,19638,25857;26165,56575,0,0,2,0,2
72640,160,19639,25908;26142,56575,0,0,2,0,2
72641,160,19640,21666,56940,0,0,1,0,1
72642,160,19641,21701,56940,0,0,1,0,1
72643,160,19642,21108,56940,0,0,0,1,1
72644,160,19643,21888,56940,0,0,1,0,1
72645,160,19644,22202,56940,0,0,1,0,1
72646,160,19646,21923,56940,0,0,1,0,1
72647,160,19647,22612,56940,0,0,1,0,1
72648,160,19648,22690,56940,0,0,1,0,1
72649,160,19649,22771,56940,0,0,1,0,1
72650,160,19650,22821,56940,0,0,1,0,1
72651,160,19651,23046,56940,0,0,1,0,1
72652,160,19652,22958,56940,0,0,1,0,1
72653,160,19659,23211,56940,0,0,1,0,1
72654,160,19660,23043,56940,0,0,1,0,1
72655,160,19661,23441,56940,0,0,1,0,1
72656,160,19663,23357,56940,0,0,1,0,1
72657,160,19664,23643,56940,0,0,1,0,1
72658,160,19666,24036;24488;26608;27696;27882;28278,56940,2,1,3,0,6
72659,160,19668,23848,56940,0,0,1,0,1
72660,160,19670,24196,56940,0,0,1,0,1
72661,160,19671,24233;24664;27521;27713;28091,56940,1,2,2,0,5
72662,160,19673,23984,56940,0,0,1,0,1
72663,160,19674,24347;24416;26426,56940,0,0,3,0,3
72664,160,19676,24262,56940,0,0,1,0,1
72665,160,19677,24593,56940,0,0,1,0,1
72666,160,19679,24726;25046;28024;28121,56940,2,0,2,0,4
72667,160,19680,24590,56940,0,0,1,0,1
72668,160,19681,24807;24856;27810;27912,56940,1,1,2,0,4
72669,160,19682,24816;25002,56940,0,0,2,0,2
72670,160,19683,24914,56940,0,0,1,0,1
72671,160,19684,24940;25510;28046;28338,56940,2,0,2,0,4
72672,160,19685,25053,56940,0,0,1,0,1
72673,160,19686,25082;25382;28243,56940,1,0,2,0,3
72674,160,19687,25123;25584,56940,0,0,2,0,2
72675,160,19688,25125;25326;27946,56940,1,0,2,0,3
72676,160,19689,25063;25237;27940,56940,1,0,2,0,3
72677,160,19690,25226;25454;28146,56940,1,0,2,0,3
72678,160,19691,25044;25344;27231;27742;27948;28241;28322,56940,3,2,2,0,7
72679,160,19692,25347,56940,0,0,1,0,1
72680,160,19693,25383;25600;28051;28340,56940,2,0,2,0,4
72681,160,19694,25403;25770,56940,0,0,2,0,2
72682,160,19695,25396;25426;27950,56940,1,0,2,0,3
72683,160,19696,25435;25496,56940,0,0,2,0,2
72684,160,19697,25179;25440;27644;28145,56940,1,1,2,0,4
72685,160,19698,25466;25915,56940,0,0,2,0,2
72686,160,19699,25501;25538;28048,56940,1,0,2,0,3
72687,160,19700,25419;25513;27957,56940,1,0,2,0,3
72688,160,19701,25453;25520;27751,56940,0,1,2,0,3
72689,160,19702,25604;25753;27438,56940,0,1,2,0,3
72690,160,19703,25626;25845,56940,0,0,2,0,2
72691,160,19704,25637;26082,56940,0,0,2,0,2
72692,160,19705,25485,56940,0,0,1,0,1
72693,160,19706,26151,56940,0,0,1,0,1
72694,160,19707,25732;26102,56940,0,0,2,0,2
72695,160,19708,25738,56940,0,0,1,0,1
72696,160,19709,25633;25788;28255,56940,1,0,2,0,3
72697,160,19710,25818;26278,56940,0,0,2,0,2
72698,160,19711,25819;26097,56940,0,0,2,0,2
72699,160,19712,25389;25826;28157,56940,1,0,2,0,3
72700,160,19713,25554,56940,0,0,1,0,1
72701,160,19714,25573,56940,0,0,1,0,1
72702,160,19715,25947;26306,56940,0,0,2,0,2
72703,160,19716,25696;25948;27967;28162,56940,2,0,2,0,4
72704,160,19717,26059;28166,56940,1,0,1,0,2
72705,160,19718,25958;26145,56940,0,0,2,0,2
72706,160,19719,25987;27852,56940,0,1,1,0,2
72707,160,19720,25796;26016,56940,0,0,2,0,2
72708,160,19721,21484,57305,0,0,0,1,1
72709,160,19722,21549,57305,0,0,0,1,1
72710,160,19723,21862,57305,0,0,1,0,1
72711,160,19725,22373,57305,0,0,1,0,1
72712,160,19726,22470,57305,0,0,1,0,1
72713,160,19727,22532,57305,0,0,1,0,1
72714,160,19728,22590,57305,0,0,1,0,1
72715,160,19729,22639,57305,0,0,1,0,1
72716,160,19730,23097,57305,0,0,1,0,1
72717,160,19732,23067,57305,0,0,1,0,1
72718,160,19733,23032,57305,0,0,1,0,1
72719,160,19734,23057,57305,0,0,1,0,1
72720,160,19735,23190,57305,0,0,1,0,1
72721,160,19736,23213,57305,0,0,1,0,1
72722,160,19737,23122,57305,0,0,1,0,1
72723,160,19738,22984;23081,57305,0,0,2,0,2
72724,160,19741,23463,57305,0,0,1,0,1
72725,160,19743,23580;23658,57305,0,0,2,0,2
72726,160,19744,23549;24229;26705,57305,0,1,2,0,3
72727,160,19745,23819,57305,0,0,1,0,1
72728,160,19746,23634,57305,0,0,1,0,1
72729,160,19747,23904;24150;26800;27185;27478,57305,0,3,2,0,5
72730,160,19748,23968,57305,0,0,1,0,1
72731,160,19749,24438,57305,0,0,1,0,1
72732,160,19750,25202;28316,57305,1,0,1,0,2
72733,160,19752,24527,57305,0,0,1,0,1
72734,160,19753,24592,57305,0,0,1,0,1
72735,160,19754,24666,57305,0,0,1,0,1
72736,160,19755,24882,57305,0,0,1,0,1
72737,160,19756,24616;24851;27530;27812,57305,0,2,2,0,4
72738,160,19758,25027,57305,0,0,1,0,1
72739,160,19759,24471;24516,57305,0,0,2,0,2
72740,160,19760,25049;25242,57305,0,0,2,0,2
72741,160,19761,25148,57305,0,0,1,0,1
72742,160,19762,25085;25234;27546,57305,0,1,2,0,3
72743,160,19763,25243;25294;27737,57305,0,1,2,0,3
72744,160,19764,24763;25257,57305,0,0,2,0,2
72745,160,19765,25273;25527,57305,0,0,2,0,2
72746,160,19766,25277;25336,57305,0,0,2,0,2
72747,160,19767,25281;25504;27750,57305,0,1,2,0,3
72748,160,19768,25331;25506,57305,0,0,2,0,2
72749,160,19769,24611;25012;28283,57305,1,0,2,0,3
72750,160,19770,25343;25741,57305,0,0,2,0,2
72751,160,19771,24953;25368;27549;27743;28040;28143,57305,2,2,2,0,6
72752,160,19772,25384;27949;28326,57305,2,0,1,0,3
72753,160,19773,25412;25420,57305,0,0,2,0,2
72754,160,19774,25264;25421;27234;28330,57305,1,1,2,0,4
72755,160,19775,25381;25473,57305,0,0,2,0,2
72756,160,19776,25558;25931,57305,0,0,2,0,2
72757,160,19777,25564;25639;28151,57305,1,0,2,0,3
72758,160,19778,25568;25695;27649,57305,0,1,2,0,3
72759,160,19779,25581;25721,57305,0,0,2,0,2
72760,160,19780,25588;25744,57305,0,0,2,0,2
72761,160,19781,25457;25790,57305,0,0,2,0,2
72762,160,19782,25618;25725,57305,0,0,2,0,2
72763,160,19783,25559;25619;28150,57305,1,0,2,0,3
72764,160,19784,25615;25640,57305,0,0,2,0,2
72765,160,19785,25662;26231;27969,57305,1,0,2,0,3
72766,160,19786,25763;25841;28158;28348,57305,2,0,2,0,4
72767,160,19787,25613,57305,0,0,1,0,1
72768,160,19788,25830;25982;28355,57305,1,0,2,0,3
72769,160,19789,25663;25835;27962,57305,1,0,2,0,3
72770,160,19790,25361;25836,57305,0,0,2,0,2
72771,160,19791,25843;26234,57305,0,0,2,0,2
72772,160,19792,25659;25848;27652;28059;28259,57305,2,1,2,0,5
72773,160,19793,25869;26355,57305,0,0,2,0,2
72774,160,19794,25884;26120,57305,0,0,2,0,2
72775,160,19795,25366;25896,57305,0,0,2,0,2
72776,160,19796,25907;26220,57305,0,0,2,0,2
72777,160,19797,26384,57305,0,0,1,0,1
72778,160,19798,25926;26071,57305,0,0,2,0,2
72779,160,19799,25769;25935,57305,0,0,2,0,2
72780,160,19800,25955;26077,57305,0,0,2,0,2
72781,160,19801,25794;25990,57305,0,0,2,0,2
72782,160,19802,25509;25991,57305,0,0,2,0,2
72783,160,19803,25865;25999,57305,0,0,2,0,2
72784,160,19804,26003;26332,57305,0,0,2,0,2
72785,160,19805,26022,57305,0,0,1,0,1
72786,160,19806,26029;26198,57305,0,0,2,0,2
72787,160,19807,26063;26272,57305,0,0,2,0,2
72788,160,19808,26072;26260,57305,0,0,2,0,2
72789,160,19809,26076;26167,57305,0,0,2,0,2
72790,160,19810,26107;26148,57305,0,0,2,0,2
72791,160,19811,25916;26134,57305,0,0,2,0,2
72792,160,19812,26136;26313,57305,0,0,2,0,2
72793,160,19813,21863,57670,0,0,1,0,1
72794,160,19814,22000,57670,0,0,1,0,1
72795,160,19815,21750,57670,0,0,1,0,1
72796,160,19816,21596,57670,0,0,0,1,1
72797,160,19817,22277,57670,0,0,1,0,1
72798,160,19818,22299,57670,0,0,1,0,1
72799,160,19819,22517,57670,0,0,1,0,1
72800,160,19820,22182,57670,0,0,1,0,1
72801,160,19821,22175;22462,57670,0,0,2,0,2
72802,160,19822,22600,57670,0,0,1,0,1
72803,160,19823,22755,57670,0,0,1,0,1
72804,160,19824,22863,57670,0,0,1,0,1
72805,160,19825,22877,57670,0,0,1,0,1
72806,160,19826,22843,57670,0,0,1,0,1
72807,160,19827,22580,57670,0,0,1,0,1
72808,160,19828,22960;23539,57670,0,0,2,0,2
72809,160,19830,23343,57670,0,0,1,0,1
72810,160,19831,23910,57670,0,0,1,0,1
72811,160,19832,24076,57670,0,0,1,0,1
72812,160,19833,23847;24077;25917;27574,57670,0,1,3,0,4
72813,160,19836,23705,57670,0,0,1,0,1
72814,160,19840,24374,57670,0,0,1,0,1
72815,160,19842,24543,57670,0,0,1,0,1
72816,160,19843,24610,57670,0,0,1,0,1
72817,160,19844,24635,57670,0,0,1,0,1
72818,160,19845,24644,57670,0,0,1,0,1
72819,160,19846,24566;24784;27115;27809;28293,57670,1,2,2,0,5
72820,160,19847,24772;25034;27631,57670,0,1,2,0,3
72821,160,19848,24899;24979;28114;28218,57670,2,0,2,0,4
72822,160,19849,24897,57670,0,0,1,0,1
72823,160,19850,24898,57670,0,0,1,0,1
72824,160,19851,25075,57670,0,0,1,0,1
72825,160,19852,24984;25124;27432;28030;28129;28311,57670,3,1,2,0,6
72826,160,19853,24987,57670,0,0,1,0,1
72827,160,19855,24779;25095;28025;28126,57670,2,0,2,0,4
72828,160,19856,25120;25267,57670,0,0,2,0,2
72829,160,19857,25167,57670,0,0,1,0,1
72830,160,19858,24716;25150;27836,57670,0,1,2,0,3
72831,160,19859,25357;25609;28341,57670,1,0,2,0,3
72832,160,19860,25322;25408,57670,0,0,2,0,2
72833,160,19861,24950;25557,57670,0,0,2,0,2
72834,160,19862,25335;25444,57670,0,0,2,0,2
72835,160,19863,25450;26101;28357,57670,1,0,2,0,3
72836,160,19865,25250,57670,0,0,1,0,1
72837,160,19866,25292;25546;28049,57670,1,0,2,0,3
72838,160,19867,25563;25740;28155,57670,1,0,2,0,3
72839,160,19868,25580;25812,57670,0,0,2,0,2
72840,160,19869,25587;25846,57670,0,0,2,0,2
72841,160,19870,25602;25863;28262,57670,1,0,2,0,3
72842,160,19871,25752,57670,0,0,1,0,1
72843,160,19872,25634;25813;27847,57670,0,1,2,0,3
72844,160,19873,25847;26489;28363,57670,1,0,2,0,3
72845,160,19874,25839;25871,57670,0,0,2,0,2
72846,160,19875,25694;25872,57670,0,0,2,0,2
72847,160,19876,25781;25887,57670,0,0,2,0,2
72848,160,19877,25853;25897,57670,0,0,2,0,2
72849,160,19878,25904;26422,57670,0,0,2,0,2
72850,160,19879,25495;25906,57670,0,0,2,0,2
72851,160,19880,25807;25912,57670,0,0,2,0,2
72852,160,19881,25936;25943,57670,0,0,2,0,2
72853,160,19882,25940;25977,57670,0,0,2,0,2
72854,160,19883,25786;25954;28062,57670,1,0,2,0,3
72855,160,19884,25957,57670,0,0,1,0,1
72856,160,19885,25890,57670,0,0,1,0,1
72857,160,19886,25436;25994,57670,0,0,2,0,2
72858,160,19887,26008;26287,57670,0,0,2,0,2
72859,160,19888,26177;26245,57670,0,0,2,0,2
72860,160,19889,25866;26066,57670,0,0,2,0,2
72861,160,19890,26140,57670,0,0,1,0,1
72862,160,19891,26092;26469,57670,0,0,2,0,2
72863,160,19892,26094;26326,57670,0,0,2,0,2
72864,160,19893,26099;26486,57670,0,0,2,0,2
72865,160,19894,26116;26158;27761,57670,0,1,2,0,3
72866,160,19895,26118,57670,0,0,1,0,1
72867,160,19896,26128;26249;28358,57670,1,0,2,0,3
72868,160,19897,26154;26505,57670,0,0,2,0,2
72869,160,19898,26045;26179;28167,57670,1,0,2,0,3
72870,160,19899,25829;25920;27848,57670,0,1,2,0,3
72871,160,19900,26218;26412,57670,0,0,2,0,2
72872,160,19901,26228;26318,57670,0,0,2,0,2
72873,160,19902,26230;26507,57670,0,0,2,0,2
72874,160,19903,26025;26239,57670,0,0,2,0,2
72875,160,19904,21845,58035,0,0,1,0,1
72876,160,19905,22316,58035,0,0,1,0,1
72877,160,19908,22804,58035,0,0,1,0,1
72878,160,19909,22095,58035,0,0,1,0,1
72879,160,19910,23058,58035,0,0,1,0,1
72880,160,19911,23090,58035,0,0,1,0,1
72881,160,19912,22585,58035,0,0,1,0,1
72882,160,19913,23241,58035,0,0,1,0,1
72883,160,19914,23245,58035,0,0,1,0,1
72884,160,19915,23344,58035,0,0,1,0,1
72885,160,19916,22854,58035,0,0,1,0,1
72886,160,19917,22744,58035,0,0,1,0,1
72887,160,19918,22789,58035,0,0,1,0,1
72888,160,19919,23315,58035,0,0,1,0,1
72889,160,19920,23471,58035,0,0,1,0,1
72890,160,19922,23829,58035,0,0,1,0,1
72891,160,19923,23451,58035,0,0,1,0,1
72892,160,19925,23855;24381,58035,0,0,2,0,2
72893,160,19926,23828,58035,0,0,1,0,1
72894,160,19927,23710,58035,0,0,1,0,1
72895,160,19928,24206;24834;27216;27419;27720,58035,0,3,2,0,5
72896,160,19929,24225,58035,0,0,1,0,1
72897,160,19930,24394,58035,0,0,1,0,1
72898,160,19931,24402,58035,0,0,1,0,1
72899,160,19932,24757,58035,0,0,1,0,1
72900,160,19933,24860,58035,0,0,1,0,1
72901,160,19934,24871,58035,0,0,1,0,1
72902,160,19935,24365,58035,0,0,1,0,1
72903,160,19936,24902,58035,0,0,1,0,1
72904,160,19937,25013,58035,0,0,1,0,1
72905,160,19938,25028;25173;27326;28227,58035,1,1,2,0,4
72906,160,19939,25052;27225,58035,0,1,1,0,2
72907,160,19940,24802;25196,58035,0,0,2,0,2
72908,160,19941,25214;25333,58035,0,0,2,0,2
72909,160,19942,25293;25463,58035,0,0,2,0,2
72910,160,19943,24995,58035,0,0,1,0,1
72911,160,19944,26121;28265,58035,1,0,1,0,2
72912,160,19945,25379;25642,58035,0,0,2,0,2
72913,160,19947,25704,58035,0,0,1,0,1
72914,160,19948,25631;25903;27966,58035,1,0,2,0,3
72915,160,19949,25648;25673,58035,0,0,2,0,2
72916,160,19950,25475,58035,0,0,1,0,1
72917,160,19951,25689;25785,58035,0,0,2,0,2
72918,160,19952,25716;26201,58035,0,0,2,0,2
72919,160,19953,25733,58035,0,0,1,0,1
72920,160,19954,25360;25764;28056,58035,1,0,2,0,3
72921,160,19955,25768;26163,58035,0,0,2,0,2
72922,160,19956,25726;25801;28154,58035,1,0,2,0,3
72923,160,19957,25401;25804;27651,58035,0,1,2,0,3
72924,160,19958,25975;28354,58035,1,0,1,0,2
72925,160,19959,25854;26015;28065,58035,1,0,2,0,3
72926,160,19960,25856;26046,58035,0,0,2,0,2
72927,160,19961,25742;25879,58035,0,0,2,0,2
72928,160,19962,25909,58035,0,0,1,0,1
72929,160,19963,25724;25910,58035,0,0,2,0,2
72930,160,19964,25913;26458,58035,0,0,2,0,2
72931,160,19965,25953;26367,58035,0,0,2,0,2
72932,160,19966,26030,58035,0,0,1,0,1
72933,160,19967,26041;26464,58035,0,0,2,0,2
72934,160,19968,26051;26290;28169;28267,58035,2,0,2,0,4
72935,160,19969,26052;26319,58035,0,0,2,0,2
72936,160,19970,26067;26560,58035,0,0,2,0,2
72937,160,19971,26075,58035,0,0,1,0,1
72938,160,19972,25838;26108,58035,0,0,2,0,2
72939,160,19973,26132;26349,58035,0,0,2,0,2
72940,160,19974,25814;26146;28359,58035,1,0,2,0,3
72941,160,19975,25730,58035,0,0,1,0,1
72942,160,19976,26017;26189,58035,0,0,2,0,2
72943,160,19977,26162;26193,58035,0,0,2,0,2
72944,160,19978,26194;26283,58035,0,0,2,0,2
72945,160,19979,26195;26200,58035,0,0,2,0,2
72946,160,19980,25279;26205,58035,0,0,2,0,2
72947,160,19981,26209;26446,58035,0,0,2,0,2
72948,160,19982,26156;26210,58035,0,0,2,0,2
72949,160,19983,26213,58035,0,0,1,0,1
72950,160,19984,26241;26548,58035,0,0,2,0,2
72951,160,19985,25992;26262,58035,0,0,2,0,2
72952,160,19986,22056,58400,0,0,1,0,1
72953,160,19987,22100,58400,0,0,1,0,1
72954,160,19988,21757,58400,0,0,1,0,1
72955,160,19989,22232,58400,0,0,1,0,1
72956,160,19990,22385,58400,0,0,1,0,1
72957,160,19991,22479,58400,0,0,1,0,1
72958,160,19992,22741,58400,0,0,1,0,1
72959,160,19993,22596,58400,0,0,1,0,1
72960,160,19994,22616,58400,0,0,1,0,1
72961,160,19995,22646,58400,0,0,1,0,1
72962,160,19996,22732,58400,0,0,1,0,1
72963,160,19997,22320,58400,0,0,1,0,1
72964,160,19998,22856,58400,0,0,1,0,1
72965,160,19999,22983,58400,0,0,1,0,1
72966,160,20000,22599,58400,0,0,1,0,1
72967,160,20001,22910,58400,0,0,1,0,1
72968,160,20002,23323,58400,0,0,1,0,1
72969,160,20003,22858,58400,0,0,1,0,1
72970,160,20004,23396,58400,0,0,1,0,1
72971,160,20005,23169,58400,0,0,1,0,1
72972,160,20006,23054,58400,0,0,1,0,1
72973,160,20007,22922,58400,0,0,1,0,1
72974,160,20008,23354,58400,0,0,1,0,1
72975,160,20009,23297,58400,0,0,1,0,1
72976,160,20010,23836,58400,0,0,1,0,1
72977,160,20011,24224,58400,0,0,1,0,1
72978,160,20012,24383,58400,0,0,1,0,1
72979,160,20013,24300,58400,0,0,1,0,1
72980,160,20014,24326,58400,0,0,1,0,1
72981,160,20016,24501;25079;26937;27827,58400,0,2,2,0,4
72982,160,20017,24223,58400,0,0,1,0,1
72983,160,20018,24570;24885;26725;27122,58400,0,2,2,0,4
72984,160,20019,24489,58400,0,0,1,0,1
72985,160,20020,24369;24645;27616,58400,0,1,2,0,3
72986,160,20021,24650,58400,0,0,1,0,1
72987,160,20022,24832,58400,0,0,1,0,1
72988,160,20023,24969,58400,0,0,1,0,1
72989,160,20024,25009,58400,0,0,1,0,1
72990,160,20025,25159,58400,0,0,1,0,1
72991,160,20026,25620;28251,58400,1,0,1,0,2
72992,160,20027,25308;25590;28339,58400,1,0,2,0,3
72993,160,20028,25126;25315,58400,0,0,2,0,2
72994,160,20029,25325,58400,0,0,1,0,1
72995,160,20030,25160;25390;28327,58400,1,0,2,0,3
72996,160,20031,25367;25465,58400,0,0,2,0,2
72997,160,20032,24841,58400,0,0,1,0,1
72998,160,20033,25238,58400,0,0,1,0,1
72999,160,20034,25481;25667;27756,58400,0,1,2,0,3
73000,160,20035,25363,58400,0,0,1,0,1
73001,160,20036,25531;25560,58400,0,0,2,0,2
73002,160,20037,25537;25840,58400,0,0,2,0,2
73003,160,20038,25562;26233,58400,0,0,2,0,2
73004,160,20039,25256;25598;27842;28050,58400,1,1,2,0,4
73005,160,20040,25507;25617,58400,0,0,2,0,2
73006,160,20041,25301,58400,0,0,1,0,1
73007,160,20042,25658;26080,58400,0,0,2,0,2
73008,160,20043,25583,58400,0,0,1,0,1
73009,160,20044,25745;25798,58400,0,0,2,0,2
73010,160,20045,25746;28254,58400,1,0,1,0,2
73011,160,20046,25586,58400,0,0,1,0,1
73012,160,20047,25832;25951,58400,0,0,2,0,2
73013,160,20048,25550,58400,0,0,1,0,1
73014,160,20049,25864;25901;28352,58400,1,0,2,0,3
73015,160,20050,25927;26061,58400,0,0,2,0,2
73016,160,20051,25803;25949,58400,0,0,2,0,2
73017,160,20052,25962;26433;28268,58400,1,0,2,0,3
73018,160,20053,25852,58400,0,0,1,0,1
73019,160,20054,25660;25981;27850;28263,58400,1,1,2,0,4
73020,160,20055,25971;26006,58400,0,0,2,0,2
73021,160,20056,25653;26007;28164;28356,58400,2,0,2,0,4
73022,160,20057,25860;26032,58400,0,0,2,0,2
73023,160,20058,26057;26328,58400,0,0,2,0,2
73024,160,20059,26261;27970,58400,1,0,1,0,2
73025,160,20060,26104;26420,58400,0,0,2,0,2
73026,160,20061,26109,58400,0,0,1,0,1
73027,160,20062,25905;26112,58400,0,0,2,0,2
73028,160,20063,26020;26117,58400,0,0,2,0,2
73029,160,20064,26122;26510;28068,58400,1,0,2,0,3
73030,160,20065,26130;26203,58400,0,0,2,0,2
73031,160,20066,25715,58400,0,0,1,0,1
73032,160,20067,25889;26152,58400,0,0,2,0,2
73033,160,20068,26208;26364;28360,58400,1,0,2,0,3
73034,160,20069,26216,58400,0,0,1,0,1
73035,160,20070,26062,58400,0,0,1,0,1
73036,160,20071,25993;26263,58400,0,0,2,0,2
73037,160,20072,26269;26521,58400,0,0,2,0,2
73038,160,20073,26275;26282,58400,0,0,2,0,2
73039,160,20074,26321;26524,58400,0,0,2,0,2
73040,160,20075,26385,58400,0,0,1,0,1
73041,160,20076,26298;26391,58400,0,0,2,0,2
73042,160,20077,26403;26532,58400,0,0,2,0,2
73043,160,20078,26410;26596,58400,0,0,2,0,2
73044,160,20079,26421;26694,58400,0,1,1,0,2
73045,160,20080,26414;26427,58400,0,0,2,0,2
73046,170,8491,21300,16790,0,0,0,1,1
73047,170,9443,18756,20440,0,0,0,1,1
73048,170,9576,19314,20805,0,0,0,1,1
73049,170,9754,19919,21535,0,0,0,1,1
73050,170,10109,19910,22630,0,0,0,1,1
73051,170,10497,19892,24090,0,0,0,1,1
73052,170,10845,20331,25185,0,0,0,1,1
73053,170,11158,19913,26280,0,0,0,1,1
73054,170,11234,20647,26280,0,0,0,1,1
73055,170,11468,20433,27010,0,0,0,1,1
73056,170,11558,23566;23962,27375,0,0,2,0,2
73057,170,12271,21772,29565,0,0,0,1,1
73058,170,12622,21205,30660,0,0,0,1,1
73059,170,13116,20885,32485,0,0,0,1,1
73060,170,13144,18867,32485,0,0,0,1,1
73061,170,13309,22887,33215,0,0,1,0,1
73062,170,13343,18897,33215,0,0,0,1,1
73063,170,13354,18678,33215,0,0,0,1,1
73064,170,13360,19183,33215,0,0,0,1,1
73065,170,13442,18520,33580,0,0,0,1,1
73066,170,13452,19291,33580,0,0,0,1,1
73067,170,13473,19210,33580,0,0,0,1,1
73068,170,13551,18672,33945,0,0,0,1,1
73069,170,13560,22921;26736,33945,0,0,2,0,2
73070,170,13567,18762,33945,0,0,0,1,1
73071,170,13569,19541,33945,0,0,0,1,1
73072,170,13591,21373;21445,33945,0,0,0,2,2
73073,170,13661,22524,34310,0,0,0,1,1
73074,170,13672,22310,34310,0,0,0,1,1
73075,170,13673,19256,34310,0,0,0,1,1
73076,170,13674,19319,34310,0,0,0,1,1
73077,170,13685,18992,34310,0,0,0,1,1
73078,170,13697,19199,34310,0,0,0,1,1
73079,170,13700,19504;19596,34310,0,0,0,2,2
73080,170,13701,19260,34310,0,0,0,1,1
73081,170,13708,19230,34310,0,0,0,1,1
73082,170,13712,23437;23631;26576;27447,34310,0,0,4,0,4
73083,170,13713,19282,34310,0,0,0,1,1
73084,170,13715,22818,34310,0,0,1,0,1
73085,170,13779,19104,34675,0,0,0,1,1
73086,170,13788,19130,34675,0,0,0,1,1
73087,170,13792,19166,34675,0,0,0,1,1
73088,170,13794,18903,34675,0,0,0,1,1
73089,170,13798,19222,34675,0,0,0,1,1
73090,170,13801,19633,34675,0,0,0,1,1
73091,170,13811,19079,34675,0,0,0,1,1
73092,170,13814,23633,34675,0,0,1,0,1
73093,170,13870,19266,35040,0,0,0,1,1
73094,170,13892,18934;19483,35040,0,0,0,2,2
73095,170,13896,19486,35040,0,0,0,1,1
73096,170,13905,19610,35040,0,0,0,1,1
73097,170,13910,18935,35040,0,0,0,1,1
73098,170,13917,19268,35040,0,0,0,1,1
73099,170,13979,23344;23401;26307,35405,0,0,3,0,3
73100,170,14002,25162;25327,35405,0,0,2,0,2
73101,170,14016,19358,35405,0,0,0,1,1
73102,170,14022,19329;19878,35405,0,0,0,2,2
73103,170,14026,19824,35405,0,0,0,1,1
73104,170,14027,19401,35405,0,0,0,1,1
73105,170,14035,24830;24917;27918;28110;28855,35405,1,2,2,0,5
73106,170,14039,19771,35405,0,0,0,1,1
73107,170,14042,19461,35405,0,0,0,1,1
73108,170,14044,19612,35405,0,0,0,1,1
73109,170,14046,19712,35405,0,0,0,1,1
73110,170,14051,19595,35405,0,0,0,1,1
73111,170,14110,19305,35770,0,0,0,1,1
73112,170,14112,19529,35770,0,0,0,1,1
73113,170,14115,19243,35770,0,0,0,1,1
73114,170,14116,19753,35770,0,0,0,1,1
73115,170,14117,19798,35770,0,0,0,1,1
73116,170,14119,19277,35770,0,0,0,1,1
73117,170,14122,19993,35770,0,0,0,1,1
73118,170,14126,19409,35770,0,0,0,1,1
73119,170,14128,19891,35770,0,0,0,1,1
73120,170,14131,19462;19657,35770,0,0,0,2,2
73121,170,14133,19554;19699,35770,0,0,0,2,2
73122,170,14134,19778,35770,0,0,0,1,1
73123,170,14141,19635,35770,0,0,0,1,1
73124,170,14142,19790,35770,0,0,0,1,1
73125,170,14145,19682,35770,0,0,0,1,1
73126,170,14146,19362,35770,0,0,0,1,1
73127,170,14149,19837,35770,0,0,0,1,1
73128,170,14150,19914,35770,0,0,0,1,1
73129,170,14232,19526,36135,0,0,0,1,1
73130,170,14234,19664,36135,0,0,0,1,1
73131,170,14238,19793,36135,0,0,0,1,1
73132,170,14239,19724,36135,0,0,0,1,1
73133,170,14241,19744,36135,0,0,0,1,1
73134,170,14246,20064,36135,0,0,0,1,1
73135,170,14250,20141,36135,0,0,0,1,1
73136,170,14255,19864,36135,0,0,0,1,1
73137,170,14257,19569,36135,0,0,0,1,1
73138,170,14293,18681,36500,0,0,0,1,1
73139,170,14300,19426,36500,0,0,0,1,1
73140,170,14302,18828,36500,0,0,0,1,1
73141,170,14305,19587,36500,0,0,0,1,1
73142,170,14308,19632,36500,0,0,0,1,1
73143,170,14316,19452,36500,0,0,0,1,1
73144,170,14317,19392,36500,0,0,0,1,1
73145,170,14318,19403,36500,0,0,0,1,1
73146,170,14320,20179,36500,0,0,0,1,1
73147,170,14321,19257,36500,0,0,0,1,1
73148,170,14322,19889,36500,0,0,0,1,1
73149,170,14323,19457,36500,0,0,0,1,1
73150,170,14325,19786,36500,0,0,0,1,1
73151,170,14327,19187,36500,0,0,0,1,1
73152,170,14331,20129,36500,0,0,0,1,1
73153,170,14332,19807,36500,0,0,0,1,1
73154,170,14333,19687,36500,0,0,0,1,1
73155,170,14334,20092,36500,0,0,0,1,1
73156,170,14338,20287,36500,0,0,0,1,1
73157,170,14339,20260,36500,0,0,0,1,1
73158,170,14340,19828;20177,36500,0,0,0,2,2
73159,170,14343,20174,36500,0,0,0,1,1
73160,170,14344,19855,36500,0,0,0,1,1
73161,170,14345,19857,36500,0,0,0,1,1
73162,170,14346,19876;19894,36500,0,0,0,2,2
73163,170,14349,19929,36500,0,0,0,1,1
73164,170,14350,19566,36500,0,0,0,1,1
73165,170,14353,19960;20000,36500,0,0,0,2,2
73166,170,14354,19816,36500,0,0,0,1,1
73167,170,14356,23769;27166,36500,0,0,2,0,2
73168,170,14414,18711,36865,0,0,0,1,1
73169,170,14430,19765,36865,0,0,0,1,1
73170,170,14432,20089,36865,0,0,0,1,1
73171,170,14433,19505,36865,0,0,0,1,1
73172,170,14436,19925,36865,0,0,0,1,1
73173,170,14446,19709,36865,0,0,0,1,1
73174,170,14449,20103,36865,0,0,0,1,1
73175,170,14453,20237,36865,0,0,0,1,1
73176,170,14454,19899,36865,0,0,0,1,1
73177,170,14456,20380,36865,0,0,0,1,1
73178,170,14458,20111,36865,0,0,0,1,1
73179,170,14459,19978,36865,0,0,0,1,1
73180,170,14462,19879;20006,36865,0,0,0,2,2
73181,170,14463,20022,36865,0,0,0,1,1
73182,170,14503,22707;22716;22985,37230,0,0,1,2,3
73183,170,14508,18928,37230,0,0,0,1,1
73184,170,14512,19151,37230,0,0,0,1,1
73185,170,14515,19415,37230,0,0,0,1,1
73186,170,14520,19887,37230,0,0,0,1,1
73187,170,14521,19538,37230,0,0,0,1,1
73188,170,14522,19583,37230,0,0,0,1,1
73189,170,14524,20148,37230,0,0,0,1,1
73190,170,14526,19591,37230,0,0,0,1,1
73191,170,14530,20059,37230,0,0,0,1,1
73192,170,14533,20042;20189,37230,0,0,0,2,2
73193,170,14534,20150,37230,0,0,0,1,1
73194,170,14540,20126;20185,37230,0,0,0,2,2
73195,170,14541,20479,37230,0,0,0,1,1
73196,170,14542,20213,37230,0,0,0,1,1
73197,170,14547,20222,37230,0,0,0,1,1
73198,170,14548,20018,37230,0,0,0,1,1
73199,170,14550,20097,37230,0,0,0,1,1
73200,170,14554,20261,37230,0,0,0,1,1
73201,170,14555,20154,37230,0,0,0,1,1
73202,170,14592,22380,37595,0,0,0,1,1
73203,170,14610,19332,37595,0,0,0,1,1
73204,170,14618,19684,37595,0,0,0,1,1
73205,170,14621,19700,37595,0,0,0,1,1
73206,170,14623,20194,37595,0,0,0,1,1
73207,170,14626,23895;27174,37595,0,0,2,0,2
73208,170,14627,20539,37595,0,0,0,1,1
73209,170,14630,19923;19984,37595,0,0,0,2,2
73210,170,14633,20049,37595,0,0,0,1,1
73211,170,14636,19951,37595,0,0,0,1,1
73212,170,14638,19833;20167,37595,0,0,0,2,2
73213,170,14639,20038;20628,37595,0,0,0,2,2
73214,170,14640,20557,37595,0,0,0,1,1
73215,170,14645,20288,37595,0,0,0,1,1
73216,170,14646,20255,37595,0,0,0,1,1
73217,170,14647,20432,37595,0,0,0,1,1
73218,170,14648,20191,37595,0,0,0,1,1
73219,170,14650,20227,37595,0,0,0,1,1
73220,170,14651,20352,37595,0,0,0,1,1
73221,170,14652,20168;20212,37595,0,0,0,2,2
73222,170,14654,20242,37595,0,0,0,1,1
73223,170,14655,19975;20017,37595,0,0,0,2,2
73224,170,14656,20272,37595,0,0,0,1,1
73225,170,14657,20279;20456,37595,0,0,0,2,2
73226,170,14725,19423,37960,0,0,0,1,1
73227,170,14730,19863,37960,0,0,0,1,1
73228,170,14734,19903,37960,0,0,0,1,1
73229,170,14737,19653,37960,0,0,0,1,1
73230,170,14738,19731,37960,0,0,0,1,1
73231,170,14742,19725,37960,0,0,0,1,1
73232,170,14743,19989,37960,0,0,0,1,1
73233,170,14745,19924,37960,0,0,0,1,1
73234,170,14746,19928,37960,0,0,0,1,1
73235,170,14748,20621,37960,0,0,0,1,1
73236,170,14752,20037,37960,0,0,0,1,1
73237,170,14755,20510,37960,0,0,0,1,1
73238,170,14756,20198,37960,0,0,0,1,1
73239,170,14757,20280,37960,0,0,0,1,1
73240,170,14760,20448,37960,0,0,0,1,1
73241,170,14761,22957;23680;27347,37960,0,0,3,0,3
73242,170,14762,20267,37960,0,0,0,1,1
73243,170,14763,20462,37960,0,0,0,1,1
73244,170,14764,20353;20431,37960,0,0,0,2,2
73245,170,14765,20664;21168,37960,0,0,0,2,2
73246,170,14766,20025,37960,0,0,0,1,1
73247,170,14819,19419;19620,38325,0,0,0,2,2
73248,170,14829,19410,38325,0,0,0,1,1
73249,170,14830,19900,38325,0,0,0,1,1
73250,170,14831,23570;27762,38325,0,1,1,0,2
73251,170,14834,20203,38325,0,0,0,1,1
73252,170,14836,20502,38325,0,0,0,1,1
73253,170,14837,20503,38325,0,0,0,1,1
73254,170,14838,19932,38325,0,0,0,1,1
73255,170,14843,20170,38325,0,0,0,1,1
73256,170,14844,20069,38325,0,0,0,1,1
73257,170,14847,23989;24346;27874,38325,0,1,2,0,3
73258,170,14849,20094,38325,0,0,0,1,1
73259,170,14851,20376,38325,0,0,0,1,1
73260,170,14854,20232,38325,0,0,0,1,1
73261,170,14855,20200,38325,0,0,0,1,1
73262,170,14857,23345;23679;23739;26679;26773;27449;27568;29019,38325,1,0,7,0,8
73263,170,14863,20384,38325,0,0,0,1,1
73264,170,14864,20393;20542,38325,0,0,0,2,2
73265,170,14865,20397,38325,0,0,0,1,1
73266,170,14867,20407;20668,38325,0,0,0,2,2
73267,170,14868,20718,38325,0,0,0,1,1
73268,170,14869,20484,38325,0,0,0,1,1
73269,170,14870,20909;21000,38325,0,0,0,2,2
73270,170,14871,20497,38325,0,0,0,1,1
73271,170,14872,20820,38325,0,0,0,1,1
73272,170,14873,20650,38325,0,0,0,1,1
73273,170,14876,20792,38325,0,0,0,1,1
73274,170,14877,20564;20640,38325,0,0,0,2,2
73275,170,14924,19372,38690,0,0,0,1,1
73276,170,14925,23009,38690,0,0,1,0,1
73277,170,14926,18719,38690,0,0,0,1,1
73278,170,14933,19670,38690,0,0,0,1,1
73279,170,14935,19742,38690,0,0,0,1,1
73280,170,14938,19425;19953,38690,0,0,0,2,2
73281,170,14942,19921,38690,0,0,0,1,1
73282,170,14943,20067,38690,0,0,0,1,1
73283,170,14945,19728;20199,38690,0,0,0,2,2
73284,170,14946,19628,38690,0,0,0,1,1
73285,170,14947,20055,38690,0,0,0,1,1
73286,170,14948,19788,38690,0,0,0,1,1
73287,170,14950,20106;20214,38690,0,0,0,2,2
73288,170,14951,20051,38690,0,0,0,1,1
73289,170,14954,20245,38690,0,0,0,1,1
73290,170,14957,20040,38690,0,0,0,1,1
73291,170,14958,20121,38690,0,0,0,1,1
73292,170,14959,19992;20413,38690,0,0,0,2,2
73293,170,14960,20394,38690,0,0,0,1,1
73294,170,14961,20134,38690,0,0,0,1,1
73295,170,14966,20290,38690,0,0,0,1,1
73296,170,14967,20536;20620,38690,0,0,0,2,2
73297,170,14969,20275,38690,0,0,0,1,1
73298,170,14973,20595,38690,0,0,0,1,1
73299,170,14974,20672;20723,38690,0,0,0,2,2
73300,170,14980,20940,38690,0,0,0,1,1
73301,170,14982,20488,38690,0,0,0,1,1
73302,170,14984,20378,38690,0,0,0,1,1
73303,170,14985,23557;23690;27450,38690,0,0,3,0,3
73304,170,14986,20527,38690,0,0,0,1,1
73305,170,14988,20559,38690,0,0,0,1,1
73306,170,14989,20511;20576,38690,0,0,0,2,2
73307,170,14990,20587;20863,38690,0,0,0,2,2
73308,170,14991,20627,38690,0,0,0,1,1
73309,170,15027,19061,39055,0,0,0,1,1
73310,170,15035,19463;24086,39055,0,0,1,1,2
73311,170,15043,19614,39055,0,0,0,1,1
73312,170,15044,19456,39055,0,0,0,1,1
73313,170,15051,19808;20144,39055,0,0,0,2,2
73314,170,15052,19846,39055,0,0,0,1,1
73315,170,15053,20087,39055,0,0,0,1,1
73316,170,15059,20088,39055,0,0,0,1,1
73317,170,15060,20011,39055,0,0,0,1,1
73318,170,15062,24444;24701;27906;28472,39055,0,2,2,0,4
73319,170,15063,20680;20708,39055,0,0,0,2,2
73320,170,15064,20344,39055,0,0,0,1,1
73321,170,15065,20113,39055,0,0,0,1,1
73322,170,15066,24237;24405;24697;24810;25078;25197;27226;27538;28137;28948,39055,1,1,8,0,10
73323,170,15067,20166;20766,39055,0,0,0,2,2
73324,170,15068,20535,39055,0,0,0,1,1
73325,170,15069,20606,39055,0,0,0,1,1
73326,170,15071,20440,39055,0,0,0,1,1
73327,170,15072,20281,39055,0,0,0,1,1
73328,170,15073,20180,39055,0,0,0,1,1
73329,170,15076,20862,39055,0,0,0,1,1
73330,170,15077,20435,39055,0,0,0,1,1
73331,170,15080,20538,39055,0,0,0,1,1
73332,170,15081,20463,39055,0,0,0,1,1
73333,170,15082,20329,39055,0,0,0,1,1
73334,170,15083,20172,39055,0,0,0,1,1
73335,170,15084,20932;21381,39055,0,0,0,2,2
73336,170,15085,20869,39055,0,0,0,1,1
73337,170,15086,20949,39055,0,0,0,1,1
73338,170,15089,20547,39055,0,0,0,1,1
73339,170,15090,20317;20552,39055,0,0,0,2,2
73340,170,15091,20574,39055,0,0,0,1,1
73341,170,15092,21048,39055,0,0,0,1,1
73342,170,15094,20626;24126,39055,0,0,1,1,2
73343,170,15095,20326,39055,0,0,0,1,1
73344,170,15096,20653,39055,0,0,0,1,1
73345,170,15098,20634,39055,0,0,0,1,1
73346,170,15099,20845;20924,39055,0,0,0,2,2
73347,170,15144,20193,39420,0,0,0,1,1
73348,170,15151,19713,39420,0,0,0,1,1
73349,170,15154,20250;20369,39420,0,0,0,2,2
73350,170,15155,20101,39420,0,0,0,1,1
73351,170,15156,19877,39420,0,0,0,1,1
73352,170,15158,19968,39420,0,0,0,1,1
73353,170,15160,20123,39420,0,0,0,1,1
73354,170,15161,20125,39420,0,0,0,1,1
73355,170,15164,20879,39420,0,0,0,1,1
73356,170,15169,20635,39420,0,0,0,1,1
73357,170,15170,20405;20472,39420,0,0,0,2,2
73358,170,15171,20438;20777,39420,0,0,0,2,2
73359,170,15172,20756,39420,0,0,0,1,1
73360,170,15173,20459,39420,0,0,0,1,1
73361,170,15175,20958;21163,39420,0,0,0,2,2
73362,170,15176,20592,39420,0,0,0,1,1
73363,170,15177,20216;20537,39420,0,0,0,2,2
73364,170,15178,24592;24633;27711;27895,39420,0,2,2,0,4
73365,170,15181,20583;20753,39420,0,0,0,2,2
73366,170,15182,20872;21100,39420,0,0,0,2,2
73367,170,15184,20599,39420,0,0,0,1,1
73368,170,15185,21143,39420,0,0,0,1,1
73369,170,15187,20659,39420,0,0,0,1,1
73370,170,15188,20660,39420,0,0,0,1,1
73371,170,15189,20182;20690,39420,0,0,0,2,2
73372,170,15191,20597;20956,39420,0,0,0,2,2
73373,170,15192,20382,39420,0,0,0,1,1
73374,170,15193,20769,39420,0,0,0,1,1
73375,170,15194,20785;20984;24826;27625;28104,39420,0,1,2,2,5
73376,170,15195,20971,39420,0,0,0,1,1
73377,170,15197,20827;20948,39420,0,0,0,2,2
73378,170,15198,24672;25025;27930,39420,0,1,2,0,3
73379,170,15199,20892,39420,0,0,0,1,1
73380,170,15235,19050,39785,0,0,0,1,1
73381,170,15247,23314,39785,0,0,1,0,1
73382,170,15251,20209,39785,0,0,0,1,1
73383,170,15252,20226,39785,0,0,0,1,1
73384,170,15253,19643,39785,0,0,0,1,1
73385,170,15255,20044,39785,0,0,0,1,1
73386,170,15257,20072,39785,0,0,0,1,1
73387,170,15259,20426,39785,0,0,0,1,1
73388,170,15260,20745,39785,0,0,0,1,1
73389,170,15261,20230,39785,0,0,0,1,1
73390,170,15262,20234,39785,0,0,0,1,1
73391,170,15263,20422,39785,0,0,0,1,1
73392,170,15264,20264,39785,0,0,0,1,1
73393,170,15266,20324,39785,0,0,0,1,1
73394,170,15268,20334,39785,0,0,0,1,1
73395,170,15274,20506,39785,0,0,0,1,1
73396,170,15275,20515,39785,0,0,0,1,1
73397,170,15276,20822,39785,0,0,0,1,1
73398,170,15278,20682;20899,39785,0,0,0,2,2
73399,170,15279,20963,39785,0,0,0,1,1
73400,170,15281,20866,39785,0,0,0,1,1
73401,170,15283,20677,39785,0,0,0,1,1
73402,170,15286,20689,39785,0,0,0,1,1
73403,170,15287,20529;20714,39785,0,0,0,2,2
73404,170,15288,21036;21138,39785,0,0,0,2,2
73405,170,15289,20725;20976,39785,0,0,0,2,2
73406,170,15290,20731,39785,0,0,0,1,1
73407,170,15292,20964,39785,0,0,0,1,1
73408,170,15294,20763,39785,0,0,0,1,1
73409,170,15295,20773;20945,39785,0,0,0,2,2
73410,170,15296,24415,39785,0,0,1,0,1
73411,170,15297,20844;21058,39785,0,0,0,2,2
73412,170,15298,20939,39785,0,0,0,1,1
73413,170,15299,20724;21072,39785,0,0,0,2,2
73414,170,15300,21171,39785,0,0,0,1,1
73415,170,15301,20871,39785,0,0,0,1,1
73416,170,15302,20893;21124,39785,0,0,0,2,2
73417,170,15303,21052,39785,0,0,0,1,1
73418,170,15304,20715;20923,39785,0,0,0,2,2
73419,170,15306,21096,39785,0,0,0,1,1
73420,170,15307,21038,39785,0,0,0,1,1
73421,170,15347,19458,40150,0,0,0,1,1
73422,170,15354,19890,40150,0,0,0,1,1
73423,170,15356,20600,40150,0,0,0,1,1
73424,170,15357,20175,40150,0,0,0,1,1
73425,170,15365,20922;20961,40150,0,0,0,2,2
73426,170,15367,20520,40150,0,0,0,1,1
73427,170,15369,20408,40150,0,0,0,1,1
73428,170,15370,20421;20696,40150,0,0,0,2,2
73429,170,15372,20439,40150,0,0,0,1,1
73430,170,15373,20613,40150,0,0,0,1,1
73431,170,15374,20409;20492,40150,0,0,0,2,2
73432,170,15376,20811,40150,0,0,0,1,1
73433,170,15381,20959,40150,0,0,0,1,1
73434,170,15382,20754,40150,0,0,0,1,1
73435,170,15383,21281,40150,0,0,0,1,1
73436,170,15385,20816,40150,0,0,0,1,1
73437,170,15386,21022;25138;28407,40150,0,1,1,1,3
73438,170,15388,20854;24822;27529;28103;28209,40150,0,2,2,1,5
73439,170,15390,21196;24622,40150,0,0,1,1,2
73440,170,15394,20926,40150,0,0,0,1,1
73441,170,15397,20874,40150,0,0,0,1,1
73442,170,15398,20977,40150,0,0,0,1,1
73443,170,15399,21238;21344,40150,0,0,0,2,2
73444,170,15400,21011,40150,0,0,0,1,1
73445,170,15401,21012,40150,0,0,0,1,1
73446,170,15436,20070,40515,0,0,0,1,1
73447,170,15445,19896,40515,0,0,0,1,1
73448,170,15448,20814;26031;26300,40515,0,0,2,1,3
73449,170,15449,20208,40515,0,0,0,1,1
73450,170,15454,20256;20795,40515,0,0,0,2,2
73451,170,15455,20303,40515,0,0,0,1,1
73452,170,15456,20684,40515,0,0,0,1,1
73453,170,15457,20607,40515,0,0,0,1,1
73454,170,15458,20437,40515,0,0,0,1,1
73455,170,15459,20457,40515,0,0,0,1,1
73456,170,15460,20450,40515,0,0,0,1,1
73457,170,15461,20480,40515,0,0,0,1,1
73458,170,15463,20930,40515,0,0,0,1,1
73459,170,15465,20541,40515,0,0,0,1,1
73460,170,15466,20995,40515,0,0,0,1,1
73461,170,15467,20780,40515,0,0,0,1,1
73462,170,15468,20826;21025,40515,0,0,0,2,2
73463,170,15470,20996,40515,0,0,0,1,1
73464,170,15472,20453,40515,0,0,0,1,1
73465,170,15473,20489,40515,0,0,0,1,1
73466,170,15474,20712,40515,0,0,0,1,1
73467,170,15476,20646;20791,40515,0,0,0,2,2
73468,170,15477,20823,40515,0,0,0,1,1
73469,170,15478,21015,40515,0,0,0,1,1
73470,170,15480,21114,40515,0,0,0,1,1
73471,170,15481,20912;20997,40515,0,0,0,2,2
73472,170,15482,20917,40515,0,0,0,1,1
73473,170,15484,20889,40515,0,0,0,1,1
73474,170,15485,20947;21066,40515,0,0,0,2,2
73475,170,15486,20732;20952,40515,0,0,0,2,2
73476,170,15487,20803;21201,40515,0,0,0,2,2
73477,170,15488,21487,40515,0,0,0,1,1
73478,170,15489,21037,40515,0,0,0,1,1
73479,170,15491,21028;21130,40515,0,0,0,2,2
73480,170,15492,21412,40515,0,0,0,1,1
73481,170,15493,21298,40515,0,0,0,1,1
73482,170,15494,21065,40515,0,0,0,1,1
73483,170,15496,21553;21814,40515,0,0,0,2,2
73484,170,15498,21121;21427,40515,0,0,0,2,2
73485,170,15499,21151;21308,40515,0,0,0,2,2
73486,170,15500,21486,40515,0,0,0,1,1
73487,170,15501,21200;21408,40515,0,0,0,2,2
73488,170,15502,21245,40515,0,0,0,1,1
73489,170,15529,19073,40880,0,0,0,1,1
73490,170,15543,20315,40880,0,0,0,1,1
73491,170,15544,20285,40880,0,0,0,1,1
73492,170,15545,20742,40880,0,0,0,1,1
73493,170,15546,20701,40880,0,0,0,1,1
73494,170,15547,20045;20138,40880,0,0,0,2,2
73495,170,15549,20522,40880,0,0,0,1,1
73496,170,15551,21031,40880,0,0,0,1,1
73497,170,15553,20604;20950,40880,0,0,0,2,2
73498,170,15555,20934;21004,40880,0,0,0,2,2
73499,170,15556,20544;23176,40880,0,0,1,1,2
73500,170,15557,20704;20994,40880,0,0,0,2,2
73501,170,15558,20978,40880,0,0,0,1,1
73502,170,15562,20722;21088,40880,0,0,0,2,2
73503,170,15563,20898;21464,40880,0,0,0,2,2
73504,170,15566,21420;21422,40880,0,0,0,2,2
73505,170,15568,21341,40880,0,0,0,1,1
73506,170,15569,20992,40880,0,0,0,1,1
73507,170,15571,20692;21010,40880,0,0,0,2,2
73508,170,15573,21416,40880,0,0,0,1,1
73509,170,15574,21315;21411,40880,0,0,0,2,2
73510,170,15575,21463,40880,0,0,0,1,1
73511,170,15576,21236,40880,0,0,0,1,1
73512,170,15577,21137,40880,0,0,0,1,1
73513,170,15578,21161,40880,0,0,0,1,1
73514,170,15580,21172,40880,0,0,0,1,1
73515,170,15583,20758,40880,0,0,0,1,1
73516,170,15584,20776;21211,40880,0,0,0,2,2
73517,170,15586,21249;21355,40880,0,0,0,2,2
73518,170,15587,20794;21256,40880,0,0,0,2,2
73519,170,15588,21262,40880,0,0,0,1,1
73520,170,15590,21313,40880,0,0,0,1,1
73521,170,15591,21283;21550,40880,0,0,0,2,2
73522,170,15592,21128;21286,40880,0,0,0,2,2
73523,170,15616,19167,41245,0,0,0,1,1
73524,170,15629,20593,41245,0,0,0,1,1
73525,170,15631,19977,41245,0,0,0,1,1
73526,170,15633,21039;21167,41245,0,0,0,2,2
73527,170,15636,20654,41245,0,0,0,1,1
73528,170,15638,20629;20678,41245,0,0,0,2,2
73529,170,15639,20470,41245,0,0,0,1,1
73530,170,15640,20768;20910,41245,0,0,0,2,2
73531,170,15641,20799,41245,0,0,0,1,1
73532,170,15644,21465,41245,0,0,0,1,1
73533,170,15646,20887,41245,0,0,0,1,1
73534,170,15647,20829;20888,41245,0,0,0,2,2
73535,170,15649,21002;21074,41245,0,0,0,2,2
73536,170,15650,21220,41245,0,0,0,1,1
73537,170,15651,20907;20989,41245,0,0,0,2,2
73538,170,15653,21110,41245,0,0,0,1,1
73539,170,15654,21415,41245,0,0,0,1,1
73540,170,15655,21115,41245,0,0,0,1,1
73541,170,15656,21428,41245,0,0,0,1,1
73542,170,15657,21482,41245,0,0,0,1,1
73543,170,15658,21145,41245,0,0,0,1,1
73544,170,15659,21162;21243,41245,0,0,0,2,2
73545,170,15660,20744;21217,41245,0,0,0,2,2
73546,170,15661,21418;21591,41245,0,0,0,2,2
73547,170,15663,21247,41245,0,0,0,1,1
73548,170,15665,21329;21683,41245,0,0,0,2,2
73549,170,15666,21259,41245,0,0,0,1,1
73550,170,15667,21253;21613,41245,0,0,0,2,2
73551,170,15668,21270;21662,41245,0,0,0,2,2
73552,170,15669,21278;21401,41245,0,0,0,2,2
73553,170,15670,21291;21534,41245,0,0,0,2,2
73554,170,15671,21304,41245,0,0,0,1,1
73555,170,15672,20986;21305,41245,0,0,0,2,2
73556,170,15673,25491;25630;28617,41245,0,1,2,0,3
73557,170,15674,21332,41245,0,0,0,1,1
73558,170,15675,21297;21310,41245,0,0,0,2,2
73559,170,15676,21326,41245,0,0,0,1,1
73560,170,15677,21394;21511,41245,0,0,0,2,2
73561,170,15678,21097;21600,41245,0,0,0,2,2
73562,170,15679,21393;24448;27690;28078,41245,0,2,1,1,4
73563,170,15680,21400,41245,0,0,0,1,1
73564,170,15681,21426,41245,0,0,0,1,1
73565,170,15720,19974,41610,0,0,0,1,1
73566,170,15726,20012,41610,0,0,0,1,1
73567,170,15727,20276,41610,0,0,0,1,1
73568,170,15728,20487,41610,0,0,0,1,1
73569,170,15733,20253,41610,0,0,0,1,1
73570,170,15734,20282,41610,0,0,0,1,1
73571,170,15736,20575,41610,0,0,0,1,1
73572,170,15737,21208,41610,0,0,0,1,1
73573,170,15742,20979,41610,0,0,0,1,1
73574,170,15743,20560;20721,41610,0,0,0,2,2
73575,170,15744,20757,41610,0,0,0,1,1
73576,170,15745,21060,41610,0,0,0,1,1
73577,170,15746,20665,41610,0,0,0,1,1
73578,170,15747,21271,41610,0,0,0,1,1
73579,170,15748,20779,41610,0,0,0,1,1
73580,170,15750,20441,41610,0,0,0,1,1
73581,170,15752,20884;21056,41610,0,0,0,2,2
73582,170,15754,20726,41610,0,0,0,1,1
73583,170,15755,20938;21112,41610,0,0,0,2,2
73584,170,15760,20897;21084,41610,0,0,0,2,2
73585,170,15762,21314,41610,0,0,0,1,1
73586,170,15766,21989;22140;24518;24621;27410;28200;28284,41610,0,2,3,2,7
73587,170,15767,20916,41610,0,0,0,1,1
73588,170,15768,21273;21433,41610,0,0,0,2,2
73589,170,15770,21290,41610,0,0,0,1,1
73590,170,15772,21608;21829,41610,0,0,0,2,2
73591,170,15775,21383,41610,0,0,0,1,1
73592,170,15776,21384,41610,0,0,0,1,1
73593,170,15777,21221;21621,41610,0,0,0,2,2
73594,170,15807,20178,41975,0,0,0,1,1
73595,170,15808,24750;24819;25114;27833;28029;28102,41975,0,3,3,0,6
73596,170,15811,20805,41975,0,0,0,1,1
73597,170,15812,20388,41975,0,0,0,1,1
73598,170,15814,20366;20477,41975,0,0,0,2,2
73599,170,15817,20657,41975,0,0,0,1,1
73600,170,15820,20882;21020,41975,0,0,0,2,2
73601,170,15821,21018,41975,0,0,0,1,1
73602,170,15822,24623;24828,41975,0,0,2,0,2
73603,170,15823,20411,41975,0,0,0,1,1
73604,170,15824,20840,41975,0,0,0,1,1
73605,170,15825,20974,41975,0,0,0,1,1
73606,170,15827,20755;21042,41975,0,0,0,2,2
73607,170,15829,20876;20937,41975,0,0,0,2,2
73608,170,15830,21040,41975,0,0,0,1,1
73609,170,15831,21184,41975,0,0,0,1,1
73610,170,15834,21593,41975,0,0,0,1,1
73611,170,15835,21347,41975,0,0,0,1,1
73612,170,15836,21318,41975,0,0,0,1,1
73613,170,15837,21475,41975,0,0,0,1,1
73614,170,15839,21078;21152,41975,0,0,0,2,2
73615,170,15841,21192;21532,41975,0,0,0,2,2
73616,170,15842,21365;21579,41975,0,0,0,2,2
73617,170,15843,21224;21288,41975,0,0,0,2,2
73618,170,15845,21231;24845;28011,41975,0,1,1,1,3
73619,170,15846,21763,41975,0,0,0,1,1
73620,170,15847,20797,41975,0,0,0,1,1
73621,170,15849,21374,41975,0,0,0,1,1
73622,170,15850,21043,41975,0,0,0,1,1
73623,170,15851,21316,41975,0,0,0,1,1
73624,170,15852,21719,41975,0,0,0,1,1
73625,170,15853,21531,41975,0,0,0,1,1
73626,170,15854,21369,41975,0,0,0,1,1
73627,170,15858,21109;21787,41975,0,0,0,2,2
73628,170,15859,21402;21494,41975,0,0,0,2,2
73629,170,15860,21623,41975,0,0,0,1,1
73630,170,15863,21589,41975,0,0,0,1,1
73631,170,15864,21595,41975,0,0,0,1,1
73632,170,15891,19759,42340,0,0,0,1,1
73633,170,15897,20079,42340,0,0,0,1,1
73634,170,15898,20578,42340,0,0,0,1,1
73635,170,15899,20060;20271,42340,0,0,0,2,2
73636,170,15907,20351;24576,42340,0,0,1,1,2
73637,170,15909,20670,42340,0,0,0,1,1
73638,170,15911,21093,42340,0,0,0,1,1
73639,170,15913,21107,42340,0,0,0,1,1
73640,170,15915,21003,42340,0,0,0,1,1
73641,170,15918,20836;20900,42340,0,0,0,2,2
73642,170,15919,21199,42340,0,0,0,1,1
73643,170,15921,25130;25229;25518;26238;28130;28741;29190,42340,1,2,4,0,7
73644,170,15922,20905;20914,42340,0,0,0,2,2
73645,170,15923,20953,42340,0,0,0,1,1
73646,170,15924,21675,42340,0,0,0,1,1
73647,170,15925,21481,42340,0,0,0,1,1
73648,170,15928,21523;21978,42340,0,0,0,2,2
73649,170,15929,21189;21292,42340,0,0,0,2,2
73650,170,15931,21141;21301,42340,0,0,0,2,2
73651,170,15933,21387,42340,0,0,0,1,1
73652,170,15934,21602;21909,42340,0,0,0,2,2
73653,170,15935,21828,42340,0,0,0,1,1
73654,170,15937,22017,42340,0,0,0,1,1
73655,170,15938,21434;21833,42340,0,0,0,2,2
73656,170,15939,21376;21436,42340,0,0,0,2,2
73657,170,15940,21466;21561,42340,0,0,0,2,2
73658,170,15941,21176;21483,42340,0,0,0,2,2
73659,170,15942,21515,42340,0,0,0,1,1
73660,170,15943,20962;21496,42340,0,0,0,2,2
73661,170,15945,21169;21562;25528,42340,0,0,1,2,3
73662,170,15946,21580,42340,0,0,0,1,1
73663,170,15947,21844;22050,42340,0,0,0,2,2
73664,170,15949,21212;21587,42340,0,0,0,2,2
73665,170,15950,21605;21913,42340,0,0,0,2,2
73666,170,15952,21614,42340,0,0,0,1,1
73667,170,15953,21616;21827,42340,0,0,0,2,2
73668,170,15954,21631,42340,0,0,0,1,1
73669,170,15955,21645,42340,0,0,0,1,1
73670,170,15958,21062;21294,42340,0,0,0,2,2
73671,170,15959,21703;21951,42340,0,0,0,2,2
73672,170,15960,21213;21704,42340,0,0,0,2,2
73673,170,15987,20608,42705,0,0,0,1,1
73674,170,15992,20702;24808;27417;27913,42705,0,1,2,1,4
73675,170,15995,20601;20957,42705,0,0,0,2,2
73676,170,15997,20710;20764,42705,0,0,0,2,2
73677,170,15998,21522,42705,0,0,0,1,1
73678,170,16001,20901;20987,42705,0,0,0,2,2
73679,170,16002,20254,42705,0,0,0,1,1
73680,170,16003,21222,42705,0,0,0,1,1
73681,170,16004,21261,42705,0,0,0,1,1
73682,170,16005,21191;25627,42705,0,0,1,1,2
73683,170,16006,21210;21533,42705,0,0,0,2,2
73684,170,16007,21263;25728;29147;29246,42705,2,0,1,1,4
73685,170,16009,21712,42705,0,0,0,1,1
73686,170,16010,20796;21336,42705,0,0,0,2,2
73687,170,16012,20856,42705,0,0,0,1,1
73688,170,16013,21241;21363,42705,0,0,0,2,2
73689,170,16014,21468,42705,0,0,0,1,1
73690,170,16015,21377,42705,0,0,0,1,1
73691,170,16016,21368;21670,42705,0,0,0,2,2
73692,170,16017,21636,42705,0,0,0,1,1
73693,170,16018,21429;21689,42705,0,0,0,2,2
73694,170,16019,21409;21461,42705,0,0,0,2,2
73695,170,16020,20858,42705,0,0,0,1,1
73696,170,16022,21439;21858,42705,0,0,0,2,2
73697,170,16023,21214;21503,42705,0,0,0,2,2
73698,170,16024,21618;21625,42705,0,0,0,2,2
73699,170,16025,22138,42705,0,0,0,1,1
73700,170,16027,21912,42705,0,0,0,1,1
73701,170,16028,22131,42705,0,0,0,1,1
73702,170,16029,21558;21566,42705,0,0,0,2,2
73703,170,16030,21469;21571,42705,0,0,0,2,2
73704,170,16031,21406;21895,42705,0,0,0,2,2
73705,170,16032,21728,42705,0,0,0,1,1
73706,170,16033,21671,42705,0,0,0,1,1
73707,170,16034,21274;21455,42705,0,0,0,2,2
73708,170,16035,22183;24889,42705,0,0,1,1,2
73709,170,16036,21715;22008,42705,0,0,0,2,2
73710,170,16037,21722,42705,0,0,0,1,1
73711,170,16038,21653,42705,0,0,0,1,1
73712,170,16039,21773,42705,0,0,0,1,1
73713,170,16040,21777,42705,0,0,0,1,1
73714,170,16041,21235;21780,42705,0,0,0,2,2
73715,170,16042,21458,42705,0,0,0,1,1
73716,170,16043,21525,42705,0,0,0,1,1
73717,170,16044,21781;21801,42705,0,0,0,2,2
73718,170,16045,21678;21893,42705,0,0,0,2,2
73719,170,16064,19479,43070,0,0,0,1,1
73720,170,16077,20158,43070,0,0,0,1,1
73721,170,16078,20119,43070,0,0,0,1,1
73722,170,16084,21155,43070,0,0,0,1,1
73723,170,16085,20738,43070,0,0,0,1,1
73724,170,16089,21174,43070,0,0,0,1,1
73725,170,16090,20972;21135,43070,0,0,0,2,2
73726,170,16091,21024,43070,0,0,0,1,1
73727,170,16092,21361,43070,0,0,0,1,1
73728,170,16096,21480,43070,0,0,0,1,1
73729,170,16097,20867;21129,43070,0,0,0,2,2
73730,170,16098,21544,43070,0,0,0,1,1
73731,170,16099,21574;21816,43070,0,0,0,2,2
73732,170,16100,23737;23937,43070,0,0,2,0,2
73733,170,16101,20975;21178,43070,0,0,0,2,2
73734,170,16102,20980;21267,43070,0,0,0,2,2
73735,170,16105,21333,43070,0,0,0,1,1
73736,170,16106,21144;21423,43070,0,0,0,2,2
73737,170,16107,21526,43070,0,0,0,1,1
73738,170,16108,21403,43070,0,0,0,1,1
73739,170,16109,21604,43070,0,0,0,1,1
73740,170,16110,21116;21746,43070,0,0,0,2,2
73741,170,16112,21460,43070,0,0,0,1,1
73742,170,16113,21448;22065,43070,0,0,0,2,2
73743,170,16114,21947,43070,0,0,0,1,1
73744,170,16115,21510;21876;24983;27821;28116;28303;28484;28763,43070,0,5,1,2,8
73745,170,16116,21495,43070,0,0,0,1,1
73746,170,16117,21069;21536,43070,0,0,0,2,2
73747,170,16118,21248;21734,43070,0,0,0,2,2
73748,170,16120,21489;21619,43070,0,0,0,2,2
73749,170,16121,21624,43070,0,0,0,1,1
73750,170,16124,21498;21795,43070,0,0,0,2,2
73751,170,16125,21652;21841,43070,0,0,0,2,2
73752,170,16126,21513;25925;28729;28989,43070,1,1,1,1,4
73753,170,16129,21694,43070,0,0,0,1,1
73754,170,16130,21476;21628,43070,0,0,0,2,2
73755,170,16131,21477;21744,43070,0,0,0,2,2
73756,170,16132,21967;22010;25842,43070,0,0,1,2,3
73757,170,16134,22230,43070,0,0,0,1,1
73758,170,16135,22042;22081,43070,0,0,0,2,2
73759,170,16136,21637;21811,43070,0,0,0,2,2
73760,170,16137,22153,43070,0,0,0,1,1
73761,170,16138,21835,43070,0,0,0,1,1
73762,170,16139,21836,43070,0,0,0,1,1
73763,170,16140,21847;22003;25937,43070,0,0,1,2,3
73764,170,16141,21736;21922,43070,0,0,0,2,2
73765,170,16142,21682;21850,43070,0,0,0,2,2
73766,170,16144,21864;22210,43070,0,0,0,2,2
73767,170,16145,21731;21884;25743;28884,43070,1,0,1,2,4
73768,170,16146,21770,43070,0,0,0,1,1
73769,170,16147,21552;21899,43070,0,0,0,2,2
73770,170,16148,22235,43070,0,0,0,1,1
73771,170,16149,21948;22195,43070,0,0,0,2,2
73772,170,16171,19380,43435,0,0,0,1,1
73773,170,16176,20318,43435,0,0,0,1,1
73774,170,16179,19939;20137,43435,0,0,0,2,2
73775,170,16180,20637,43435,0,0,0,1,1
73776,170,16185,20406,43435,0,0,0,1,1
73777,170,16187,20787,43435,0,0,0,1,1
73778,170,16188,21216,43435,0,0,0,1,1
73779,170,16189,20852,43435,0,0,0,1,1
73780,170,16192,21005,43435,0,0,0,1,1
73781,170,16194,21071,43435,0,0,0,1,1
73782,170,16196,21264;21657,43435,0,0,0,2,2
73783,170,16197,21139,43435,0,0,0,1,1
73784,170,16198,21080;21173,43435,0,0,0,2,2
73785,170,16200,21356,43435,0,0,0,1,1
73786,170,16201,21658,43435,0,0,0,1,1
73787,170,16202,21372;21441,43435,0,0,0,2,2
73788,170,16203,21673;21873,43435,0,0,0,2,2
73789,170,16205,21611;22078,43435,0,0,0,2,2
73790,170,16206,22194,43435,0,0,0,1,1
73791,170,16211,21695;21868,43435,0,0,0,2,2
73792,170,16212,21632,43435,0,0,0,1,1
73793,170,16214,21706;22241,43435,0,0,0,2,2
73794,170,16215,21708,43435,0,0,0,1,1
73795,170,16216,21677;21710,43435,0,0,0,2,2
73796,170,16217,22208;22526,43435,0,0,0,2,2
73797,170,16218,21535;21751,43435,0,0,0,2,2
73798,170,16219,22094,43435,0,0,0,1,1
73799,170,16220,21754;21937,43435,0,0,0,2,2
73800,170,16221,21755,43435,0,0,0,1,1
73801,170,16222,21667;21760,43435,0,0,0,2,2
73802,170,16223,21647,43435,0,0,0,1,1
73803,170,16224,21785,43435,0,0,0,1,1
73804,170,16225,21564;21786,43435,0,0,0,2,2
73805,170,16226,21820,43435,0,0,0,1,1
73806,170,16227,21823,43435,0,0,0,1,1
73807,170,16228,21832,43435,0,0,0,1,1
73808,170,16229,21941,43435,0,0,0,1,1
73809,170,16230,21849;21881,43435,0,0,0,2,2
73810,170,16231,21867,43435,0,0,0,1,1
73811,170,16232,21762,43435,0,0,0,1,1
73812,170,16233,21601;21897,43435,0,0,0,2,2
73813,170,16234,21933;22152,43435,0,0,0,2,2
73814,170,16235,21938;22309,43435,0,0,0,2,2
73815,170,16237,21392;21953;25749,43435,0,0,1,2,3
73816,170,16238,21956,43435,0,0,0,1,1
73817,170,16240,21964;21992,43435,0,0,0,2,2
73818,170,16241,21968;22301,43435,0,0,0,2,2
73819,170,16242,22139;22350,43435,0,0,0,2,2
73820,170,16243,21926;21998,43435,0,0,0,2,2
73821,170,16244,22014,43435,0,0,0,1,1
73822,170,16245,22016,43435,0,0,0,1,1
73823,170,16246,22307,43435,0,0,0,1,1
73824,170,16247,22031,43435,0,0,0,1,1
73825,170,16248,22123,43435,0,0,0,1,1
73826,170,16249,22013,43435,0,0,0,1,1
73827,170,16274,20031,43800,0,0,0,1,1
73828,170,16280,20602,43800,0,0,0,1,1
73829,170,16289,20519;20824,43800,0,0,0,2,2
73830,170,16290,20981,43800,0,0,0,1,1
73831,170,16294,21126,43800,0,0,0,1,1
73832,170,16296,21470,43800,0,0,0,1,1
73833,170,16297,21635;25535,43800,0,0,1,1,2
73834,170,16298,21239;21660,43800,0,0,0,2,2
73835,170,16299,21158;21430,43800,0,0,0,2,2
73836,170,16300,25338;28239,43800,0,1,1,0,2
73837,170,16301,21349,43800,0,0,0,1,1
73838,170,16303,20935;21507,43800,0,0,0,2,2
73839,170,16304,21765;26037,43800,0,0,1,1,2
73840,170,16305,21705;24970;27927;28301;28392,43800,0,3,1,1,5
73841,170,16306,21702,43800,0,0,0,1,1
73842,170,16307,21854,43800,0,0,0,1,1
73843,170,16308,21588,43800,0,0,0,1,1
73844,170,16309,21594,43800,0,0,0,1,1
73845,170,16311,21622;21804,43800,0,0,0,2,2
73846,170,16312,21784;21930,43800,0,0,0,2,2
73847,170,16313,21499;21597,43800,0,0,0,2,2
73848,170,16314,21869;25452;25548;28788;28872,43800,1,1,2,1,5
73849,170,16316,21890;21939,43800,0,0,0,2,2
73850,170,16317,22007,43800,0,0,0,1,1
73851,170,16318,21691;21957,43800,0,0,0,2,2
73852,170,16319,21697,43800,0,0,0,1,1
73853,170,16321,21629;22062,43800,0,0,0,2,2
73854,170,16322,21309;21560,43800,0,0,0,2,2
73855,170,16323,21961;22227,43800,0,0,0,2,2
73856,170,16325,21860;22364;26347,43800,0,0,1,2,3
73857,170,16327,21842;22141,43800,0,0,0,2,2
73858,170,16329,21910;22147,43800,0,0,0,2,2
73859,170,16331,21917;22286,43800,0,0,0,2,2
73860,170,16332,21936;22148,43800,0,0,0,2,2
73861,170,16333,22282,43800,0,0,0,1,1
73862,170,16336,22474,43800,0,0,0,1,1
73863,170,16337,21696;22267,43800,0,0,0,2,2
73864,170,16338,21644;22009,43800,0,0,0,2,2
73865,170,16340,22041;22133,43800,0,0,0,2,2
73866,170,16342,22030,43800,0,0,0,1,1
73867,170,16344,22260;22421,43800,0,0,0,2,2
73868,170,16345,22085;22215,43800,0,0,0,2,2
73869,170,16346,22317,43800,0,0,0,1,1
73870,170,16347,22136,43800,0,0,0,1,1
73871,170,16348,21803;22106;25941;28991,43800,1,0,1,2,4
73872,170,16349,21935;22190,43800,0,0,0,2,2
73873,170,16350,22411;22493,43800,0,0,0,2,2
73874,170,16351,21758;22149,43800,0,0,0,2,2
73875,170,16352,22157;22216,43800,0,0,0,2,2
73876,170,16367,19387,44165,0,0,0,1,1
73877,170,16379,19218,44165,0,0,0,1,1
73878,170,16390,21215,44165,0,0,0,1,1
73879,170,16391,21686,44165,0,0,0,1,1
73880,170,16393,20883;21150,44165,0,0,0,2,2
73881,170,16395,21089,44165,0,0,0,1,1
73882,170,16397,20850;21059,44165,0,0,0,2,2
73883,170,16398,21077;21546,44165,0,0,0,2,2
73884,170,16400,21424,44165,0,0,0,1,1
73885,170,16401,21194;21572,44165,0,0,0,2,2
73886,170,16402,21207;22004,44165,0,0,0,2,2
73887,170,16404,21179;21233,44165,0,0,0,2,2
73888,170,16406,21029;21390,44165,0,0,0,2,2
73889,170,16407,21165;21350,44165,0,0,0,2,2
73890,170,16408,21610,44165,0,0,0,1,1
73891,170,16409,21775;21887,44165,0,0,0,2,2
73892,170,16410,21655,44165,0,0,0,1,1
73893,170,16411,21756;21959,44165,0,0,0,2,2
73894,170,16412,21491;21569,44165,0,0,0,2,2
73895,170,16413,21639,44165,0,0,0,1,1
73896,170,16414,21606;21875,44165,0,0,0,2,2
73897,170,16415,22311;22390,44165,0,0,0,2,2
73898,170,16418,22113;22196,44165,0,0,0,2,2
73899,170,16419,22192;22332,44165,0,0,0,2,2
73900,170,16420,21505;21894;25455,44165,0,0,1,2,3
73901,170,16421,21900,44165,0,0,0,1,1
73902,170,16422,21901;22302,44165,0,0,0,2,2
73903,170,16423,21874,44165,0,0,0,1,1
73904,170,16424,21282;21444,44165,0,0,0,2,2
73905,170,16425,21987;22033,44165,0,0,0,2,2
73906,170,16427,21656;22250,44165,0,0,0,2,2
73907,170,16428,22029,44165,0,0,0,1,1
73908,170,16429,22549,44165,0,0,0,1,1
73909,170,16430,21843;22049,44165,0,0,0,2,2
73910,170,16431,22066;22114,44165,0,0,0,2,2
73911,170,16432,22025;22368,44165,0,0,0,2,2
73912,170,16433,22032,44165,0,0,0,1,1
73913,170,16435,21767;22176,44165,0,0,0,2,2
73914,170,16436,22298,44165,0,0,0,1,1
73915,170,16437,21932;22499;26622,44165,0,0,1,2,3
73916,170,16438,22455,44165,0,0,0,1,1
73917,170,16440,22555,44165,0,0,0,1,1
73918,170,16441,21906,44165,0,0,0,1,1
73919,170,16442,21617,44165,0,0,0,1,1
73920,170,16443,22395,44165,0,0,0,1,1
73921,170,16444,22238;22331,44165,0,0,0,2,2
73922,170,16468,19959,44530,0,0,0,1,1
73923,170,16469,20367,44530,0,0,0,1,1
73924,170,16477,20184,44530,0,0,0,1,1
73925,170,16478,20734,44530,0,0,0,1,1
73926,170,16480,20967,44530,0,0,0,1,1
73927,170,16486,21083,44530,0,0,0,1,1
73928,170,16487,21328;21450,44530,0,0,0,2,2
73929,170,16488,21817;22084,44530,0,0,0,2,2
73930,170,16489,21539;21740,44530,0,0,0,2,2
73931,170,16490,21570;22508,44530,0,0,0,2,2
73932,170,16491,21902;21980,44530,0,0,0,2,2
73933,170,16493,21590;21776,44530,0,0,0,2,2
73934,170,16494,22134,44530,0,0,0,1,1
73935,170,16495,21462;21665,44530,0,0,0,2,2
73936,170,16497,21714;21782,44530,0,0,0,2,2
73937,170,16498,21343,44530,0,0,0,1,1
73938,170,16499,21891;26618;26835,44530,0,0,2,1,3
73939,170,16501,21994;22296,44530,0,0,0,2,2
73940,170,16502,21555;21883,44530,0,0,0,2,2
73941,170,16503,21871;22137,44530,0,0,0,2,2
73942,170,16504,21886,44530,0,0,0,1,1
73943,170,16505,22012,44530,0,0,0,1,1
73944,170,16506,22006;24671,44530,0,0,1,1,2
73945,170,16507,21931;21981,44530,0,0,0,2,2
73946,170,16510,22128;22171,44530,0,0,0,2,2
73947,170,16511,21752;21889,44530,0,0,0,2,2
73948,170,16512,22090;22558,44530,0,0,0,2,2
73949,170,16514,22328;22489;25961,44530,0,0,1,2,3
73950,170,16515,21934;22104,44530,0,0,0,2,2
73951,170,16516,22614;22699;26445,44530,0,0,1,2,3
73952,170,16517,22156;22178,44530,0,0,0,2,2
73953,170,16518,22632,44530,0,0,0,1,1
73954,170,16519,21674;22034,44530,0,0,0,2,2
73955,170,16520,22170;22505,44530,0,0,0,2,2
73956,170,16521,22181;22347,44530,0,0,0,2,2
73957,170,16522,22242;22330;26159,44530,0,0,1,2,3
73958,170,16524,22292;22485,44530,0,0,0,2,2
73959,170,16525,22023;22297,44530,0,0,0,2,2
73960,170,16526,21975;22304,44530,0,0,0,2,2
73961,170,16527,22528;22634,44530,0,0,0,2,2
73962,170,16528,22378;22696,44530,0,0,0,2,2
73963,170,16529,22046;22355,44530,0,0,0,2,2
73964,170,16530,22168;22356,44530,0,0,0,2,2
73965,170,16531,22365,44530,0,0,0,1,1
73966,170,16543,19182,44895,0,0,0,1,1
73967,170,16553,20573,44895,0,0,0,1,1
73968,170,16555,20330;20496,44895,0,0,0,2,2
73969,170,16556,20336;20609,44895,0,0,0,2,2
73970,170,16558,20486;21122,44895,0,0,0,2,2
73971,170,16563,21380,44895,0,0,0,1,1
73972,170,16565,20894,44895,0,0,0,1,1
73973,170,16567,21148;21442,44895,0,0,0,2,2
73974,170,16570,21079;21330,44895,0,0,0,2,2
73975,170,16571,21378,44895,0,0,0,1,1
73976,170,16572,21396;21764,44895,0,0,0,2,2
73977,170,16573,21807;21838,44895,0,0,0,2,2
73978,170,16577,21388,44895,0,0,0,1,1
73979,170,16579,21337;22011,44895,0,0,0,2,2
73980,170,16580,21830;21919,44895,0,0,0,2,2
73981,170,16581,21578;21634,44895,0,0,0,2,2
73982,170,16582,21542;21882,44895,0,0,0,2,2
73983,170,16585,21453;21779,44895,0,0,0,2,2
73984,170,16586,21688,44895,0,0,0,1,1
73985,170,16588,22187;22254,44895,0,0,0,2,2
73986,170,16589,22035;22080,44895,0,0,0,2,2
73987,170,16590,22259,44895,0,0,0,1,1
73988,170,16591,21851;22127,44895,0,0,0,2,2
73989,170,16592,21852;22327,44895,0,0,0,2,2
73990,170,16593,21650;21997,44895,0,0,0,2,2
73991,170,16595,21916;22165,44895,0,0,0,2,2
73992,170,16596,21877,44895,0,0,0,1,1
73993,170,16597,22293;22295,44895,0,0,0,2,2
73994,170,16598,22222;22336,44895,0,0,0,2,2
73995,170,16599,22251,44895,0,0,0,1,1
73996,170,16600,21649;22075,44895,0,0,0,2,2
73997,170,16601,21800;22077;26431,44895,0,0,1,2,3
73998,170,16603,21859;22322,44895,0,0,0,2,2
73999,170,16604,22101;22757,44895,0,0,0,2,2
74000,170,16605,22273;22531,44895,0,0,0,2,2
74001,170,16606,21759,44895,0,0,0,1,1
74002,170,16607,22693;26838,44895,0,0,1,1,2
74003,170,16608,22564;22604,44895,0,0,0,2,2
74004,170,16609,22713;22740,44895,0,0,0,2,2
74005,170,16612,22496,44895,0,0,0,1,1
74006,170,16613,22051;22262,44895,0,0,0,2,2
74007,170,16614,22314;22335,44895,0,0,0,2,2
74008,170,16615,22257,44895,0,0,0,1,1
74009,170,16616,22379,44895,0,0,0,1,1
74010,170,16617,22353;22394,44895,0,0,0,2,2
74011,170,16618,22018;22396,44895,0,0,0,2,2
74012,170,16619,22401,44895,0,0,0,1,1
74013,170,16620,21969;22404,44895,0,0,0,2,2
74014,170,16621,22756,44895,0,0,0,1,1
74015,170,16622,22442;22695,44895,0,0,0,2,2
74016,170,16623,22452;22859,44895,0,0,1,1,2
74017,170,16624,22346;22542,44895,0,0,0,2,2
74018,170,16625,22484,44895,0,0,0,1,1
74019,170,16626,22582;22747,44895,0,0,0,2,2
74020,170,16647,19995,45260,0,0,0,1,1
74021,170,16663,20558,45260,0,0,0,1,1
74022,170,16664,21035;21219,45260,0,0,0,2,2
74023,170,16665,21379,45260,0,0,0,1,1
74024,170,16666,21183;21530,45260,0,0,0,2,2
74025,170,16668,21609,45260,0,0,0,1,1
74026,170,16669,21414;21641,45260,0,0,0,2,2
74027,170,16670,22359,45260,0,0,0,1,1
74028,170,16673,21654,45260,0,0,0,1,1
74029,170,16676,21646,45260,0,0,0,1,1
74030,170,16677,21960;22020,45260,0,0,0,2,2
74031,170,16678,21878,45260,0,0,0,1,1
74032,170,16679,21915;22203,45260,0,0,0,2,2
74033,170,16680,21504;22261,45260,0,0,0,2,2
74034,170,16681,21905,45260,0,0,0,1,1
74035,170,16682,21630,45260,0,0,0,1,1
74036,170,16684,22207,45260,0,0,0,1,1
74037,170,16685,22043,45260,0,0,0,1,1
74038,170,16686,22063;22158,45260,0,0,0,2,2
74039,170,16687,22097;22285,45260,0,0,0,2,2
74040,170,16688,22270,45260,0,0,0,1,1
74041,170,16689,21914,45260,0,0,0,1,1
74042,170,16690,22595;22651,45260,0,0,0,2,2
74043,170,16691,22807,45260,0,0,1,0,1
74044,170,16692,22252;22349,45260,0,0,0,2,2
74045,170,16693,22038;22400,45260,0,0,0,2,2
74046,170,16694,22741;22915;27132,45260,0,0,2,1,3
74047,170,16695,22326;22417,45260,0,0,0,2,2
74048,170,16696,22387;22398,45260,0,0,0,2,2
74049,170,16697,22686;22793,45260,0,0,1,1,2
74050,170,16698,22437,45260,0,0,0,1,1
74051,170,16700,22098;22478,45260,0,0,0,2,2
74052,170,16701,22492;22796,45260,0,0,1,1,2
74053,170,16703,22501;22619;26168,45260,0,0,1,2,3
74054,170,16704,22780;22814;26630,45260,0,0,3,0,3
74055,170,16705,22169;22529,45260,0,0,0,2,2
74056,170,16706,22201;22535,45260,0,0,0,2,2
74057,170,16707,22553;22580;25968,45260,0,0,1,2,3
74058,170,16708,22498;22556,45260,0,0,0,2,2
74059,170,16709,22560;22645,45260,0,0,0,2,2
74060,170,16710,22269;22577;26064,45260,0,0,1,2,3
74061,170,16712,22338;22623;26619,45260,0,0,1,2,3
74062,170,16713,22626,45260,0,0,0,1,1
74063,170,16729,19280,45625,0,0,0,1,1
74064,170,16736,19565,45625,0,0,0,1,1
74065,170,16737,20065;20299,45625,0,0,0,2,2
74066,170,16746,21034,45625,0,0,0,1,1
74067,170,16748,21519,45625,0,0,0,1,1
74068,170,16750,21451,45625,0,0,0,1,1
74069,170,16751,21325,45625,0,0,0,1,1
74070,170,16752,21352,45625,0,0,0,1,1
74071,170,16754,21885;21942,45625,0,0,0,2,2
74072,170,16755,21949;22015,45625,0,0,0,2,2
74073,170,16759,21638;22026,45625,0,0,0,2,2
74074,170,16761,21419;21774,45625,0,0,0,2,2
74075,170,16762,22768,45625,0,0,0,1,1
74076,170,16764,21958;21970,45625,0,0,0,2,2
74077,170,16765,21721;22093;25561;27753;28250;28522,45625,0,3,1,2,6
74078,170,16766,22362;22579,45625,0,0,0,2,2
74079,170,16767,22039;22245,45625,0,0,0,2,2
74080,170,16768,22048;22476,45625,0,0,0,2,2
74081,170,16769,21853;22073,45625,0,0,0,2,2
74082,170,16770,22124;22561;26623,45625,0,0,1,2,3
74083,170,16772,22122,45625,0,0,0,1,1
74084,170,16773,22878;22890;26841,45625,0,0,3,0,3
74085,170,16774,22126;22638,45625,0,0,0,2,2
74086,170,16775,22001,45625,0,0,0,1,1
74087,170,16777,22237;22403,45625,0,0,0,2,2
74088,170,16778,22422;22681,45625,0,0,0,2,2
74089,170,16779,22154;22808,45625,0,0,1,1,2
74090,170,16780,22021,45625,0,0,0,1,1
74091,170,16781,22504;22622,45625,0,0,0,2,2
74092,170,16782,22070;22540,45625,0,0,0,2,2
74093,170,16783,22418;22545,45625,0,0,0,2,2
74094,170,16784,22319;22374,45625,0,0,0,2,2
74095,170,16785,22584,45625,0,0,0,1,1
74096,170,16786,22891;23052;27135,45625,0,0,3,0,3
74097,170,16787,22912;23098,45625,0,0,2,0,2
74098,170,16788,22939;25698;28345;28442;28527;28631,45625,0,4,2,0,6
74099,170,16790,22679;22961,45625,0,0,1,1,2
74100,170,16791,22839;22862;25883,45625,0,0,3,0,3
74101,170,16792,22685,45625,0,0,0,1,1
74102,170,16793,22218,45625,0,0,0,1,1
74103,170,16794,22812;26943,45625,0,0,2,0,2
74104,170,16795,22708;22832,45625,0,0,1,1,2
74105,170,16796,22701;22714;25979,45625,0,0,1,2,3
74106,170,16798,22409;22742,45625,0,0,0,2,2
74107,170,16799,22572;22745,45625,0,0,0,2,2
74108,170,16800,22658;22822;25986;26730;27851;28064,45625,0,2,3,1,6
74109,170,16801,22610;22770,45625,0,0,0,2,2
74110,170,16832,20346,45990,0,0,0,1,1
74111,170,16836,20902,45990,0,0,0,1,1
74112,170,16837,20741;21032,45990,0,0,0,2,2
74113,170,16840,20929,45990,0,0,0,1,1
74114,170,16841,21134;21713,45990,0,0,0,2,2
74115,170,16842,21360,45990,0,0,0,1,1
74116,170,16843,21500,45990,0,0,0,1,1
74117,170,16845,22166,45990,0,0,0,1,1
74118,170,16847,22069,45990,0,0,0,1,1
74119,170,16848,21720;22054,45990,0,0,0,2,2
74120,170,16849,21733;22150,45990,0,0,0,2,2
74121,170,16851,21382;21846,45990,0,0,0,2,2
74122,170,16852,21813;22217;25104,45990,0,0,1,2,3
74123,170,16853,21837;22130,45990,0,0,0,2,2
74124,170,16854,21598;22231,45990,0,0,0,2,2
74125,170,16856,21794;21976,45990,0,0,0,2,2
74126,170,16857,22246,45990,0,0,0,1,1
74127,170,16860,22278,45990,0,0,0,1,1
74128,170,16861,22351,45990,0,0,0,1,1
74129,170,16862,22461;22734;25497,45990,0,0,1,2,3
74130,170,16863,22413;22743,45990,0,0,0,2,2
74131,170,16864,22784;26942,45990,0,0,2,0,2
74132,170,16865,22197;22450,45990,0,0,0,2,2
74133,170,16866,22917,45990,0,0,1,0,1
74134,170,16867,22465;22617,45990,0,0,0,2,2
74135,170,16868,22761;22936,45990,0,0,1,1,2
74136,170,16869,22538;22726,45990,0,0,0,2,2
74137,170,16870,22616;22659,45990,0,0,0,2,2
74138,170,16871,22471;22557;25969,45990,0,0,1,2,3
74139,170,16872,22715,45990,0,0,0,1,1
74140,170,16874,22255;22676;25782,45990,0,0,1,2,3
74141,170,16875,22683;22754,45990,0,0,0,2,2
74142,170,16876,22694;22852;26628;28838,45990,0,1,2,1,4
74143,170,16878,22534;23014,45990,0,0,1,1,2
74144,170,16879,22809;22941,45990,0,0,2,0,2
74145,170,16881,22340;22884,45990,0,0,1,1,2
74146,170,16900,20296,46355,0,0,0,1,1
74147,170,16902,19906,46355,0,0,0,1,1
74148,170,16916,21322;21438,46355,0,0,0,2,2
74149,170,16921,21391,46355,0,0,0,1,1
74150,170,16922,21699;21739,46355,0,0,0,2,2
74151,170,16925,21729,46355,0,0,0,1,1
74152,170,16928,22185,46355,0,0,0,1,1
74153,170,16929,21848;22229,46355,0,0,0,2,2
74154,170,16930,21929;22058,46355,0,0,0,2,2
74155,170,16932,22173,46355,0,0,0,1,1
74156,170,16934,22449,46355,0,0,0,1,1
74157,170,16936,22200;22249,46355,0,0,0,2,2
74158,170,16937,22306;22820,46355,0,0,1,1,2
74159,170,16938,22313;23166,46355,0,0,1,1,2
74160,170,16939,22320;22578;25777;28156,46355,0,1,1,2,4
74161,170,16940,22342;22598,46355,0,0,0,2,2
74162,170,16943,22371,46355,0,0,0,1,1
74163,170,16944,22376;22785,46355,0,0,1,1,2
74164,170,16946,22415;22948,46355,0,0,1,1,2
74165,170,16948,22163;22563;25867,46355,0,0,1,2,3
74166,170,16949,21966;22451,46355,0,0,0,2,2
74167,170,16950,22525;22792,46355,0,0,1,1,2
74168,170,16952,22290;22487,46355,0,0,0,2,2
74169,170,16953,22500;22687;25976;28993,46355,1,0,1,2,4
74170,170,16954,22629;22731;25687,46355,0,0,1,2,3
74171,170,16955,22102,46355,0,0,0,1,1
74172,170,16956,22225;22602,46355,0,0,0,2,2
74173,170,16957,22660;22864,46355,0,0,1,1,2
74174,170,16958,22624;23219;26854,46355,0,0,2,1,3
74175,170,16959,22637,46355,0,0,0,1,1
74176,170,16960,22607;22667,46355,0,0,0,2,2
74177,170,16962,22700;23008,46355,0,0,1,1,2
74178,170,16963,22965;25505,46355,0,0,2,0,2
74179,170,16964,22174;22750,46355,0,0,0,2,2
74180,170,16965,22762;27025,46355,0,0,1,1,2
74181,170,16966,22497;22775,46355,0,0,1,1,2
74182,170,16967,22835;23205,46355,0,0,2,0,2
74183,170,16969,22850,46355,0,0,1,0,1
74184,170,16971,22886;23250,46355,0,0,2,0,2
74185,170,16972,22763;22895,46355,0,0,1,1,2
74186,170,16973,22916;23178;26644,46355,0,0,3,0,3
74187,170,16974,22530;22937,46355,0,0,1,1,2
74188,170,16975,23080;23206,46355,0,0,2,0,2
74189,170,16977,22975;22987,46355,0,0,2,0,2
74190,170,16979,22585;23248;26381,46355,0,0,2,1,3
74191,170,16991,19760,46720,0,0,0,1,1
74192,170,16998,20379,46720,0,0,0,1,1
74193,170,17001,20325,46720,0,0,0,1,1
74194,170,17003,20429;20580,46720,0,0,0,2,2
74195,170,17007,21017,46720,0,0,0,1,1
74196,170,17011,21127;21509,46720,0,0,0,2,2
74197,170,17012,21351;21738,46720,0,0,0,2,2
74198,170,17018,21907;22142,46720,0,0,0,2,2
74199,170,17020,21979;22213,46720,0,0,0,2,2
74200,170,17021,22454,46720,0,0,0,1,1
74201,170,17022,22674;22922,46720,0,0,1,1,2
74202,170,17023,22205,46720,0,0,0,1,1
74203,170,17024,22565;22652,46720,0,0,0,2,2
74204,170,17026,22265,46720,0,0,0,1,1
74205,170,17027,22209;22279,46720,0,0,0,2,2
74206,170,17028,22283;22752,46720,0,0,0,2,2
74207,170,17029,22325,46720,0,0,0,1,1
74208,170,17030,22825,46720,0,0,1,0,1
74209,170,17031,22236,46720,0,0,0,1,1
74210,170,17032,22383;22871,46720,0,0,1,1,2
74211,170,17033,22047;22399,46720,0,0,0,2,2
74212,170,17034,21925;22407,46720,0,0,0,2,2
74213,170,17035,22429,46720,0,0,0,1,1
74214,170,17036,22457;22503,46720,0,0,0,2,2
74215,170,17038,22433;22521,46720,0,0,0,2,2
74216,170,17039,22344;22551,46720,0,0,0,2,2
74217,170,17040,22120;22606,46720,0,0,0,2,2
74218,170,17041,22799;23146,46720,0,0,2,0,2
74219,170,17042,22712;22956,46720,0,0,1,1,2
74220,170,17043,22786;23279,46720,0,0,2,0,2
74221,170,17044,22767;26074,46720,0,0,1,1,2
74222,170,17045,22444;22728,46720,0,0,0,2,2
74223,170,17046,22790;23101,46720,0,0,2,0,2
74224,170,17047,22643;26540,46720,0,0,1,1,2
74225,170,17048,22840,46720,0,0,1,0,1
74226,170,17049,22861;22918,46720,0,0,2,0,2
74227,170,17050,23136;23380,46720,0,0,2,0,2
74228,170,17051,22833;22919,46720,0,0,2,0,2
74229,170,17052,22718;23045,46720,0,0,1,1,2
74230,170,17053,22801,46720,0,0,1,0,1
74231,170,17055,22951;27134,46720,0,0,2,0,2
74232,170,17056,22976;23038,46720,0,0,2,0,2
74233,170,17057,23016;23243,46720,0,0,2,0,2
74234,170,17059,23022;23049;26538;28561,46720,0,1,3,0,4
74235,170,17060,23023;23230,46720,0,0,2,0,2
74236,170,17061,22559;23036,46720,0,0,1,1,2
74237,170,17062,22706;23026,46720,0,0,1,1,2
74238,170,17063,23194;23541;27335,46720,0,0,3,0,3
74239,170,17064,23216;23267,46720,0,0,2,0,2
74240,170,17065,23024;23056,46720,0,0,2,0,2
74241,170,17066,23074;23239;27031,46720,0,0,3,0,3
74242,170,17067,23027;23102,46720,0,0,2,0,2
74243,170,17069,18653,47085,0,0,0,1,1
74244,170,17098,20767,47085,0,0,0,1,1
74245,170,17100,20343;20706,47085,0,0,0,2,2
74246,170,17101,21258;21497,47085,0,0,0,2,2
74247,170,17105,21317,47085,0,0,0,1,1
74248,170,17109,21676;21928,47085,0,0,0,2,2
74249,170,17110,21753;22061,47085,0,0,0,2,2
74250,170,17112,22271;22480,47085,0,0,0,2,2
74251,170,17114,22513;22760,47085,0,0,0,2,2
74252,170,17116,22155;22445,47085,0,0,0,2,2
74253,170,17117,22172;22566,47085,0,0,0,2,2
74254,170,17119,22615;22869,47085,0,0,1,1,2
74255,170,17120,22730;22837;26731,47085,0,0,2,1,3
74256,170,17121,22778;22873;27236,47085,0,0,3,0,3
74257,170,17125,22448;22509,47085,0,0,0,2,2
74258,170,17127,22092;22486,47085,0,0,0,2,2
74259,170,17128,22516;25487,47085,0,0,1,1,2
74260,170,17129,23063;23094,47085,0,0,2,0,2
74261,170,17130,22576;22654,47085,0,0,0,2,2
74262,170,17132,22321;22608,47085,0,0,0,2,2
74263,170,17133,22853,47085,0,0,1,0,1
74264,170,17135,22072;22702,47085,0,0,0,2,2
74265,170,17136,22244;22711,47085,0,0,0,2,2
74266,170,17137,22352,47085,0,0,0,1,1
74267,170,17138,22357;22841;26274;26530;27027;29224,47085,1,0,4,1,6
74268,170,17139,22630;22717;25778;28720,47085,0,1,1,2,4
74269,170,17140,22908;23030;25700,47085,0,0,3,0,3
74270,170,17141,22375;22828,47085,0,0,1,1,2
74271,170,17142,22920,47085,0,0,1,0,1
74272,170,17143,22845;23322;26191,47085,0,0,3,0,3
74273,170,17145,23300;23379;26859,47085,0,0,3,0,3
74274,170,17146,23187;23301,47085,0,0,2,0,2
74275,170,17147,22929,47085,0,0,1,0,1
74276,170,17148,22848;23108,47085,0,0,2,0,2
74277,170,17150,22935;23269;27240,47085,0,0,3,0,3
74278,170,17151,23393,47085,0,0,1,0,1
74279,170,17152,22727;23010;25799,47085,0,0,2,1,3
74280,170,17153,22981;23053,47085,0,0,2,0,2
74281,170,17154,22547;23071,47085,0,0,1,1,2
74282,170,17155,23476;26390;26865,47085,0,0,3,0,3
74283,170,17158,23470;26315,47085,0,0,2,0,2
74284,170,17159,23087;23161;26849,47085,0,0,3,0,3
74285,170,17160,22860;23168,47085,0,0,2,0,2
74286,170,17161,23007;23177,47085,0,0,2,0,2
74287,170,17163,23183;23407;27242,47085,0,0,3,0,3
74288,170,17164,23218;23299;26752;26950;27336,47085,0,0,5,0,5
74289,170,17180,19859,47450,0,0,0,1,1
74290,170,17186,20530,47450,0,0,0,1,1
74291,170,17188,21456;21822,47450,0,0,0,2,2
74292,170,17191,20880,47450,0,0,0,1,1
74293,170,17195,21242;21543,47450,0,0,0,2,2
74294,170,17196,21557;21999,47450,0,0,0,2,2
74295,170,17197,22019,47450,0,0,0,1,1
74296,170,17201,22377;22548,47450,0,0,0,2,2
74297,170,17204,22287;22308;25950,47450,0,0,1,2,3
74298,170,17205,21825;22089,47450,0,0,0,2,2
74299,170,17208,21716;21808,47450,0,0,0,2,2
74300,170,17212,22844,47450,0,0,1,0,1
74301,170,17213,22339;22573,47450,0,0,0,2,2
74302,170,17214,23048,47450,0,0,1,0,1
74303,170,17216,22348;22416,47450,0,0,0,2,2
74304,170,17217,22704;22826,47450,0,0,1,1,2
74305,170,17218,22188;22443,47450,0,0,0,2,2
74306,170,17219,22511;22758;26525,47450,0,0,1,2,3
74307,170,17221,22382;22587;26258,47450,0,0,1,2,3
74308,170,17222,22967;26091;29271,47450,1,0,2,0,3
74309,170,17223,22605,47450,0,0,0,1,1
74310,170,17224,23155,47450,0,0,1,0,1
74311,170,17225,22748,47450,0,0,0,1,1
74312,170,17226,22753;23013,47450,0,0,1,1,2
74313,170,17227,22226;22776;27026,47450,0,0,2,1,3
74314,170,17228,22781,47450,0,0,1,0,1
74315,170,17229,22477;22783,47450,0,0,1,1,2
74316,170,17230,23018;23492,47450,0,0,2,0,2
74317,170,17231,22829;23095,47450,0,0,2,0,2
74318,170,17232,22435;23085,47450,0,0,1,1,2
74319,170,17234,22914;23318,47450,0,0,2,0,2
74320,170,17235,22923;23260;27763,47450,0,1,2,0,3
74321,170,17236,22947;23039,47450,0,0,2,0,2
74322,170,17237,22963;22992,47450,0,0,2,0,2
74323,170,17239,23112;23456,47450,0,0,2,0,2
74324,170,17241,22539;22994;26093,47450,0,0,2,1,3
74325,170,17242,22751;22996;26738,47450,0,0,2,1,3
74326,170,17243,22720;23005,47450,0,0,1,1,2
74327,170,17244,23154,47450,0,0,1,0,1
74328,170,17246,23028;23417,47450,0,0,2,0,2
74329,170,17248,23180;23185,47450,0,0,2,0,2
74330,170,17250,22903;23091,47450,0,0,2,0,2
74331,170,17251,23373;23479;27444,47450,0,0,3,0,3
74332,170,17252,23119,47450,0,0,1,0,1
74333,170,17253,23135;23435;27141,47450,0,0,3,0,3
74334,170,17254,23111;23339,47450,0,0,2,0,2
74335,170,17255,23179;23199,47450,0,0,2,0,2
74336,170,17256,23273;23324,47450,0,0,2,0,2
74337,170,17257,23058;23351;26302;27037;28747,47450,0,1,4,0,5
74338,170,17258,23223;23235,47450,0,0,2,0,2
74339,170,17260,23259;23360,47450,0,0,2,0,2
74340,170,17261,22986;23265,47450,0,0,2,0,2
74341,170,17262,23271;23340;26301;27441,47450,0,0,4,0,4
74342,170,17263,22803;23293;27033,47450,0,0,3,0,3
74343,170,17267,19228,47815,0,0,0,1,1
74344,170,17271,19516,47815,0,0,0,1,1
74345,170,17283,20853,47815,0,0,0,1,1
74346,170,17288,20982;21340,47815,0,0,0,2,2
74347,170,17290,21190,47815,0,0,0,1,1
74348,170,17291,21166,47815,0,0,0,1,1
74349,170,17292,21348;21521,47815,0,0,0,2,2
74350,170,17295,21640,47815,0,0,0,1,1
74351,170,17301,22088;22655,47815,0,0,0,2,2
74352,170,17303,22402;22810,47815,0,0,1,1,2
74353,170,17304,21879,47815,0,0,0,1,1
74354,170,17305,21991;22256,47815,0,0,0,2,2
74355,170,17307,22666,47815,0,0,0,1,1
74356,170,17308,22436;22705,47815,0,0,0,2,2
74357,170,17310,22482,47815,0,0,0,1,1
74358,170,17311,22491;22847,47815,0,0,1,1,2
74359,170,17312,22258;22568,47815,0,0,0,2,2
74360,170,17313,22562,47815,0,0,0,1,1
74361,170,17314,21952,47815,0,0,0,1,1
74362,170,17315,23015,47815,0,0,1,0,1
74363,170,17316,22931,47815,0,0,1,0,1
74364,170,17317,22099;22735,47815,0,0,0,2,2
74365,170,17318,22641;22737,47815,0,0,0,2,2
74366,170,17319,22363;22759,47815,0,0,0,2,2
74367,170,17321,22721;22872,47815,0,0,1,1,2
74368,170,17322,22927;23349;27036,47815,0,0,3,0,3
74369,170,17323,22883,47815,0,0,1,0,1
74370,170,17324,22782;26732,47815,0,0,2,0,2
74371,170,17325,22787;22906,47815,0,0,2,0,2
74372,170,17327,22603;23115,47815,0,0,1,1,2
74373,170,17328,23044;23134,47815,0,0,2,0,2
74374,170,17330,23554,47815,0,0,1,0,1
74375,170,17331,23132;23192,47815,0,0,2,0,2
74376,170,17333,22662;23001,47815,0,0,1,1,2
74377,170,17334,23184;23244,47815,0,0,2,0,2
74378,170,17336,23281;26857;27440,47815,0,0,3,0,3
74379,170,17337,23089;23581;27653,47815,0,1,2,0,3
74380,170,17338,22766;23153,47815,0,0,1,1,2
74381,170,17339,23120,47815,0,0,1,0,1
74382,170,17341,23681,47815,0,0,1,0,1
74383,170,17342,23145,47815,0,0,1,0,1
74384,170,17343,23160;23288,47815,0,0,2,0,2
74385,170,17344,22938;23200,47815,0,0,2,0,2
74386,170,17345,23079;23226,47815,0,0,2,0,2
74387,170,17346,23151;23498;27040,47815,0,0,3,0,3
74388,170,17347,23188;23263,47815,0,0,2,0,2
74389,170,17348,22928;23264;26650;27032,47815,0,0,4,0,4
74390,170,17349,23096;23274,47815,0,0,2,0,2
74391,170,17350,23488;23639,47815,0,0,2,0,2
74392,170,17351,22962;23503;26761,47815,0,0,3,0,3
74393,170,17352,23572;27343;27563,47815,0,0,3,0,3
74394,170,17353,23616,47815,0,0,1,0,1
74395,170,17354,23277;23366,47815,0,0,2,0,2
74396,170,17355,23384;23732;27264;27567,47815,0,0,4,0,4
74397,170,17357,22924;23400,47815,0,0,2,0,2
74398,170,17364,19518;19686,48180,0,0,0,2,2
74399,170,17366,19637,48180,0,0,0,1,1
74400,170,17367,20292,48180,0,0,0,1,1
74401,170,17378,20561,48180,0,0,0,1,1
74402,170,17380,20784,48180,0,0,0,1,1
74403,170,17385,21478,48180,0,0,0,1,1
74404,170,17387,21068;21404,48180,0,0,0,2,2
74405,170,17392,21620,48180,0,0,0,1,1
74406,170,17394,21567,48180,0,0,0,1,1
74407,170,17397,21821,48180,0,0,0,1,1
74408,170,17398,21990;22052;24670,48180,0,0,1,2,3
74409,170,17401,22581,48180,0,0,0,1,1
74410,170,17402,22280,48180,0,0,0,1,1
74411,170,17405,22045;22159,48180,0,0,0,2,2
74412,170,17407,21995;22167,48180,0,0,0,2,2
74413,170,17408,22067,48180,0,0,0,1,1
74414,170,17409,22354;22849,48180,0,0,1,1,2
74415,170,17410,22268;23099,48180,0,0,1,1,2
74416,170,17411,22468,48180,0,0,0,1,1
74417,170,17412,22361;22469,48180,0,0,0,2,2
74418,170,17413,22220;22483,48180,0,0,0,2,2
74419,170,17415,25591;25965,48180,0,0,2,0,2
74420,170,17416,22527;22846,48180,0,0,1,1,2
74421,170,17417,21963;22636,48180,0,0,0,2,2
74422,170,17419,22239;22571;26166;28911;29182,48180,2,0,1,2,5
74423,170,17420,22593;23104;25898,48180,0,0,2,1,3
74424,170,17421,22749;22893,48180,0,0,1,1,2
74425,170,17422,22802;22911;26734,48180,0,0,3,0,3
74426,170,17423,22341;22635,48180,0,0,0,2,2
74427,170,17424,23046;23143,48180,0,0,2,0,2
74428,170,17425,22710;22805,48180,0,0,1,1,2
74429,170,17426,22668;22882,48180,0,0,1,1,2
74430,170,17427,22601;22691,48180,0,0,0,2,2
74431,170,17428,22692,48180,0,0,0,1,1
74432,170,17429,22611;22719;24910;26617;28017;28109;28389;29304,48180,1,3,2,2,8
74433,170,17430,22111;22591,48180,0,0,0,2,2
74434,170,17431,22186;22199,48180,0,0,0,2,2
74435,170,17432,22406;22440,48180,0,0,0,2,2
74436,170,17434,22823;23064;26461,48180,0,0,3,0,3
74437,170,17435,22473;22870;25988,48180,0,0,2,1,3
74438,170,17436,22842;22876,48180,0,0,2,0,2
74439,170,17437,22933,48180,0,0,1,0,1
74440,170,17438,22467;23173;25312;27945;28698,48180,0,2,2,1,5
74441,170,17440,23237;23526,48180,0,0,2,0,2
74442,170,17441,22980;23002,48180,0,0,2,0,2
74443,170,17442,22795;23029;27558,48180,0,0,3,0,3
74444,170,17443,23060;23097,48180,0,0,2,0,2
74445,170,17444,23124;23382;28173,48180,0,1,2,0,3
74446,170,17445,23575;26870,48180,0,0,2,0,2
74447,170,17446,23086;23452,48180,0,0,2,0,2
74448,170,17447,22971;23189;26850;29218,48180,1,0,3,0,4
74449,170,17449,23726;23865,48180,0,0,2,0,2
74450,170,17452,23846;27273,48180,0,0,2,0,2
74451,170,17454,23286;23315,48180,0,0,2,0,2
74452,170,17456,23272;23510;27041,48180,0,0,3,0,3
74453,170,17457,23589;23601;26767,48180,0,0,3,0,3
74454,170,17460,22970;23370,48180,0,0,2,0,2
74455,170,17461,23621;23645;26488,48180,0,0,3,0,3
74456,170,17462,23442;23521;27042,48180,0,0,3,0,3
74457,170,17463,23292;23402;26863,48180,0,0,3,0,3
74458,170,17464,23418;23440;26387;26954;29198;29222,48180,2,0,4,0,6
74459,170,17465,23376;23472;26660,48180,0,0,3,0,3
74460,170,17466,23332;23432;27338,48180,0,0,3,0,3
74461,170,17467,23169;23627,48180,0,0,2,0,2
74462,170,17468,23424;23459,48180,0,0,2,0,2
74463,170,17469,22964;23465,48180,0,0,2,0,2
74464,170,17470,23316;23751,48180,0,0,2,0,2
74465,170,17471,23385;23606,48180,0,0,2,0,2
74466,170,17472,23490;23505;26021;27248,48180,0,0,4,0,4
74467,170,17473,23499;23938;27361;27579,48180,0,0,4,0,4
74468,170,17479,18605,48545,0,0,0,1,1
74469,170,17483,19646;19769,48545,0,0,0,2,2
74470,170,17484,20014,48545,0,0,0,1,1
74471,170,17487,20173,48545,0,0,0,1,1
74472,170,17489,20848,48545,0,0,0,1,1
74473,170,17498,21131,48545,0,0,0,1,1
74474,170,17512,22867;22881,48545,0,0,2,0,2
74475,170,17513,21540;21944,48545,0,0,0,2,2
74476,170,17515,22520;22621;27128,48545,0,0,1,2,3
74477,170,17516,22135;22248,48545,0,0,0,2,2
74478,170,17518,22189;22620,48545,0,0,0,2,2
74479,170,17519,22439;22518,48545,0,0,0,2,2
74480,170,17522,22266;22868,48545,0,0,1,1,2
74481,170,17524,21962;22392,48545,0,0,0,2,2
74482,170,17525,22323;22397,48545,0,0,0,2,2
74483,170,17526,23117;23209,48545,0,0,2,0,2
74484,170,17528,22284;22430,48545,0,0,0,2,2
74485,170,17529,22532;23158,48545,0,0,1,1,2
74486,170,17530,22567;22791,48545,0,0,1,1,2
74487,170,17532,22858;23003;26536,48545,0,0,3,0,3
74488,170,17533,23126;23162,48545,0,0,2,0,2
74489,170,17534,22736;22926,48545,0,0,1,1,2
74490,170,17536,22408;22633,48545,0,0,0,2,2
74491,170,17537,22889;23358;26476;26755,48545,0,0,4,0,4
74492,170,17538,22806,48545,0,0,1,0,1
74493,170,17540,22665;22824,48545,0,0,1,1,2
74494,170,17541,22541;23093,48545,0,0,1,1,2
74495,170,17542,22955,48545,0,0,1,0,1
74496,170,17543,22625;22907,48545,0,0,1,1,2
74497,170,17544,23116,48545,0,0,1,0,1
74498,170,17545,23070;23744;26776,48545,0,0,3,0,3
74499,170,17546,23011;23088,48545,0,0,2,0,2
74500,170,17547,23311;23361,48545,0,0,2,0,2
74501,170,17548,23084;23458;26480;27245,48545,0,0,4,0,4
74502,170,17549,23150;23257,48545,0,0,2,0,2
74503,170,17550,23745;23754;27768,48545,0,1,2,0,3
74504,170,17551,23942,48545,0,0,1,0,1
74505,170,17552,23217,48545,0,0,1,0,1
74506,170,17553,23050;23559;27445,48545,0,0,3,0,3
74507,170,17554,23337;23389,48545,0,0,2,0,2
74508,170,17555,22972;23304;27559,48545,0,0,3,0,3
74509,170,17556,23103;23319;25511,48545,0,0,3,0,3
74510,170,17557,23342,48545,0,0,1,0,1
74511,170,17558,23386;23405,48545,0,0,2,0,2
74512,170,17559,22942;23395,48545,0,0,2,0,2
74513,170,17560,23689;24032,48545,0,0,2,0,2
74514,170,17561,23428;23662;26397;26671;29200,48545,1,0,4,0,5
74515,170,17562,22294;23107;27136,48545,0,0,2,1,3
74516,170,17563,23415;23439;27243,48545,0,0,3,0,3
74517,170,17564,23283;23615;26769,48545,0,0,3,0,3
74518,170,17565,23388;23454;27442,48545,0,0,3,0,3
74519,170,17567,23493;23785,48545,0,0,2,0,2
74520,170,17568,23377;23515;27250,48545,0,0,3,0,3
74521,170,17569,23538,48545,0,0,1,0,1
74522,170,17570,23806;23821;26408;27353,48545,0,0,4,0,4
74523,170,17571,23308;23562,48545,0,0,2,0,2
74524,170,17572,23568;23918,48545,0,0,2,0,2
74525,170,17573,22739;23468,48545,0,0,1,1,2
74526,170,17580,20350,48910,0,0,0,1,1
74527,170,17589,20846;20988,48910,0,0,0,2,2
74528,170,17595,21421;21730,48910,0,0,0,2,2
74529,170,17599,22458,48910,0,0,0,1,1
74530,170,17603,21812;22393,48910,0,0,0,2,2
74531,170,17604,22369;22663,48910,0,0,0,2,2
74532,170,17606,21865;22472,48910,0,0,0,2,2
74533,170,17608,22423;22438,48910,0,0,0,2,2
74534,170,17609,22463;22554,48910,0,0,0,2,2
74535,170,17610,22464;23031;26096;26844;28940,48910,1,0,3,1,5
74536,170,17611,22453;23152,48910,0,0,1,1,2
74537,170,17614,22543;22653;24684;25779;28721,48910,0,1,2,2,5
74538,170,17615,22642;23078,48910,0,0,1,1,2
74539,170,17617,22797;23475,48910,0,0,2,0,2
74540,170,17618,22755;23394,48910,0,0,1,1,2
74541,170,17619,22815;22819,48910,0,0,2,0,2
74542,170,17621,22788;22978;26637,48910,0,0,3,0,3
74543,170,17623,22894;23113,48910,0,0,2,0,2
74544,170,17626,22729;22979;25996;29073,48910,1,0,2,1,4
74545,170,17627,22988;23076,48910,0,0,2,0,2
74546,170,17628,22999;23233,48910,0,0,2,0,2
74547,170,17629,22879;23017,48910,0,0,2,0,2
74548,170,17630,22431;23138;26098,48910,0,0,2,1,3
74549,170,17631,23042;23258;25701,48910,0,0,3,0,3
74550,170,17632,23167;23372;26386;29095;29197;29293,48910,3,0,3,0,6
74551,170,17633,23037;23607,48910,0,0,2,0,2
74552,170,17634,22950;23202,48910,0,0,2,0,2
74553,170,17635,23350;23709,48910,0,0,2,0,2
74554,170,17637,23242;23434,48910,0,0,2,0,2
74555,170,17638,23696;23710;26878;26961;27157,48910,0,0,5,0,5
74556,170,17639,23722;23735,48910,0,0,2,0,2
74557,170,17640,23252;23736,48910,0,0,2,0,2
74558,170,17641,23148;23149,48910,0,0,2,0,2
74559,170,17642,23313;23330,48910,0,0,2,0,2
74560,170,17643,23548;27342,48910,0,0,2,0,2
74561,170,17645,23647;23781;26889;29026,48910,1,0,3,0,4
74562,170,17646,23482;26866,48910,0,0,2,0,2
74563,170,17647,23341;23387,48910,0,0,2,0,2
74564,170,17648,23198;23410;26309,48910,0,0,3,0,3
74565,170,17649,23966;24075;26695;27365;27463;27581,48910,0,0,6,0,6
74566,170,17650,24015;27661,48910,0,1,1,0,2
74567,170,17651,23256;23449,48910,0,0,2,0,2
74568,170,17653,23577;23641;26668,48910,0,0,3,0,3
74569,170,17654,23489;23612,48910,0,0,2,0,2
74570,170,17655,23463;23525;26762,48910,0,0,3,0,3
74571,170,17656,23368;23506;27249,48910,0,0,3,0,3
74572,170,17657,23507;24067,48910,0,0,2,0,2
74573,170,17658,23511;23747;27570;27767,48910,0,1,3,0,4
74574,170,17659,23523;23835;27859,48910,0,1,2,0,3
74575,170,17660,23403;23780;27352,48910,0,0,3,0,3
74576,170,17661,23529;23537,48910,0,0,2,0,2
74577,170,17662,23579;23699;26879,48910,0,0,3,0,3
74578,170,17663,23451;23585;26394;27254;27654,48910,0,1,4,0,5
74579,170,17664,23502;24058;27471;28177,48910,0,1,3,0,4
74580,170,17665,23598;23642,48910,0,0,2,0,2
74581,170,17667,23688;23698,48910,0,0,2,0,2
74582,170,17668,23123;23703,48910,0,0,2,0,2
74583,170,17676,20030,49275,0,0,0,1,1
74584,170,17693,21452;21568,49275,0,0,0,2,2
74585,170,17699,21685;22228,49275,0,0,0,2,2
74586,170,17702,22002;22410,49275,0,0,0,2,2
74587,170,17705,23159;23215,49275,0,0,2,0,2
74588,170,17706,22506;22901;26842,49275,0,0,2,1,3
74589,170,17707,22857,49275,0,0,1,0,1
74590,170,17709,22523;22834,49275,0,0,1,1,2
74591,170,17710,22274;22649,49275,0,0,0,2,2
74592,170,17711,22600;23012;26740,49275,0,0,2,1,3
74593,170,17715,22289;22689,49275,0,0,0,2,2
74594,170,17716,22064;22723;25594;26359;27553;28791;28875,49275,1,1,3,2,7
74595,170,17717,22954,49275,0,0,1,0,1
74596,170,17720,22902,49275,0,0,1,0,1
74597,170,17723,23130;23353;26303;29092,49275,1,0,3,0,4
74598,170,17724,22488;23041;26000;26845,49275,0,0,3,1,4
74599,170,17726,23220,49275,0,0,1,0,1
74600,170,17727,23296;23708,49275,0,0,2,0,2
74601,170,17728,23033;23825,49275,0,0,2,0,2
74602,170,17729,23328;23678;26559,49275,0,0,3,0,3
74603,170,17730,23952;27462,49275,0,0,2,0,2
74604,170,17731,23383;23391,49275,0,0,2,0,2
74605,170,17732,23238;23411;27560,49275,0,0,3,0,3
74606,170,17733,23164;23491;27247,49275,0,0,3,0,3
74607,170,17734,24041;24224,49275,0,0,2,0,2
74608,170,17735,23516;23675,49275,0,0,2,0,2
74609,170,17736,23431;23916;26792;27578,49275,0,0,4,0,4
74610,170,17737,24100;24145;27376;27477;27778;27868,49275,0,2,4,0,6
74611,170,17738,23068;23542,49275,0,0,2,0,2
74612,170,17739,23587;23614;26484,49275,0,0,3,0,3
74613,170,17740,23590;23977;26982,49275,0,0,3,0,3
74614,170,17741,23963;27862,49275,0,1,1,0,2
74615,170,17742,23640;23771,49275,0,0,2,0,2
74616,170,17743,23310;23552,49275,0,0,2,0,2
74617,170,17744,23573;23630;26958;27346,49275,0,0,4,0,4
74618,170,17745,23653,49275,0,0,1,0,1
74619,170,17746,23670,49275,0,0,1,0,1
74620,170,17747,23849;24120;28181,49275,0,1,2,0,3
74621,170,17748,23593;24111;27082;27668;28180,49275,0,2,3,0,5
74622,170,17749,23309;23782,49275,0,0,2,0,2
74623,170,17750,23730;24018,49275,0,0,2,0,2
74624,170,17751,23326;23877;26790;26975;27576,49275,0,0,5,0,5
74625,170,17752,23495;23762,49275,0,0,2,0,2
74626,170,17753,23797;23965;27282;27364,49275,0,0,4,0,4
74627,170,17754,23768,49275,0,0,1,0,1
74628,170,17756,23422;23820;27271,49275,0,0,3,0,3
74629,170,17758,23789;23830,49275,0,0,2,0,2
74630,170,17759,23609;23795,49275,0,0,2,0,2
74631,170,17768,20252;20389,49640,0,0,0,2,2
74632,170,17772,20478,49640,0,0,0,1,1
74633,170,17777,20661;20686,49640,0,0,0,2,2
74634,170,17778,20857,49640,0,0,0,1,1
74635,170,17779,20790,49640,0,0,0,1,1
74636,170,17780,20915;21311,49640,0,0,0,2,2
74637,170,17788,21545,49640,0,0,0,1,1
74638,170,17791,21443;21651,49640,0,0,0,2,2
74639,170,17793,21921;21996,49640,0,0,0,2,2
74640,170,17794,21983;22110,49640,0,0,0,2,2
74641,170,17795,21855;22193,49640,0,0,0,2,2
74642,170,17801,22517;23139;27334,49640,0,0,2,1,3
74643,170,17802,22949;23040,49640,0,0,2,0,2
74644,170,17803,22697;22709,49640,0,0,0,2,2
74645,170,17806,22744;22934,49640,0,0,1,1,2
74646,170,17807,22247;22816;25881,49640,0,0,2,1,3
74647,170,17808,23055;23426;26657,49640,0,0,3,0,3
74648,170,17809,23457;23543;27443,49640,0,0,3,0,3
74649,170,17811,23196;23433;27137,49640,0,0,3,0,3
74650,170,17812,23125;26848,49640,0,0,2,0,2
74651,170,17813,23774;23947;26887,49640,0,0,3,0,3
74652,170,17816,22932;23280,49640,0,0,2,0,2
74653,170,17818,23335;23706;27261;29321,49640,1,0,3,0,4
74654,170,17819,23195;23346,49640,0,0,2,0,2
74655,170,17820,23371,49640,0,0,1,0,1
74656,170,17822,23129,49640,0,0,1,0,1
74657,170,17823,23683;26877,49640,0,0,2,0,2
74658,170,17825,23983,49640,0,0,1,0,1
74659,170,17826,23588;23673,49640,0,0,2,0,2
74660,170,17827,23664;23827,49640,0,0,2,0,2
74661,170,17829,23446;23870,49640,0,0,2,0,2
74662,170,17830,23655,49640,0,0,1,0,1
74663,170,17831,23677,49640,0,0,1,0,1
74664,170,17832,23348;23756;27452,49640,0,0,3,0,3
74665,170,17833,23798;24208,49640,0,0,2,0,2
74666,170,17834,23801;23885;26890,49640,0,0,3,0,3
74667,170,17835,24118;27777,49640,0,1,1,0,2
74668,170,17836,24188,49640,0,0,1,0,1
74669,170,17837,23409;23878,49640,0,0,2,0,2
74670,170,17838,23909;24179;26917;26996;27869;29312,49640,1,1,4,0,6
74671,170,17839,23816;23926,49640,0,0,2,0,2
74672,170,17840,23518;23932,49640,0,0,2,0,2
74673,170,17841,23901;24241;27980,49640,0,1,2,0,3
74674,170,17842,23297;24031;27180;29319,49640,1,0,3,0,4
74675,170,17846,19789;20483,50005,0,0,0,2,2
74676,170,17849,20071;20443,50005,0,0,0,2,2
74677,170,17858,20401,50005,0,0,0,1,1
74678,170,17865,21984;22074,50005,0,0,0,2,2
74679,170,17867,22366,50005,0,0,0,1,1
74680,170,17869,22144;22263,50005,0,0,0,2,2
74681,170,17874,22570;22953;26187,50005,0,0,2,1,3
74682,170,17875,22116;22389,50005,0,0,0,2,2
74683,170,17876,22079;22441,50005,0,0,0,2,2
74684,170,17878,21982;22191,50005,0,0,0,2,2
74685,170,17880,22574;22774,50005,0,0,1,1,2
74686,170,17884,22943;23306;27034,50005,0,0,3,0,3
74687,170,17886,23006;23197,50005,0,0,2,0,2
74688,170,17887,23347;23685;26674;27051,50005,0,0,4,0,4
74689,170,17889,23083,50005,0,0,1,0,1
74690,170,17890,22959;23092,50005,0,0,2,0,2
74691,170,17891,23221;23450;27142,50005,0,0,3,0,3
74692,170,17892,22905;27131,50005,0,0,2,0,2
74693,170,17893,23592,50005,0,0,1,0,1
74694,170,17894,23624;23626;27564,50005,0,0,3,0,3
74695,170,17895,23305;23750;27163,50005,0,0,3,0,3
74696,170,17896,23352;23880;26976,50005,0,0,3,0,3
74697,170,17897,23381,50005,0,0,1,0,1
74698,170,17899,23933;26692;26794,50005,0,0,3,0,3
74699,170,17900,23284;23427,50005,0,0,2,0,2
74700,170,17903,23824,50005,0,0,1,0,1
74701,170,17905,23362;23519;27341,50005,0,0,3,0,3
74702,170,17906,23528;23758;27267,50005,0,0,3,0,3
74703,170,17907,23535;23908,50005,0,0,2,0,2
74704,170,17908,23075;23547;27046,50005,0,0,3,0,3
74705,170,17909,23657;23705;27448,50005,0,0,3,0,3
74706,170,17910,23912;23964;27175,50005,0,0,3,0,3
74707,170,17911,23582;23702;27451,50005,0,0,3,0,3
74708,170,17912,23672;23799;26967,50005,0,0,3,0,3
74709,170,17913,23636;23960,50005,0,0,2,0,2
74710,170,17914,23287;23671;27259,50005,0,0,3,0,3
74711,170,17915,23701;23900;27357;27577,50005,0,0,4,0,4
74712,170,17916,24029;27368,50005,0,0,2,0,2
74713,170,17917,23986;24248,50005,0,0,2,0,2
74714,170,17918,23546;23773,50005,0,0,2,0,2
74715,170,17919,23777;23887,50005,0,0,2,0,2
74716,170,17920,23533;23783;26964;27656,50005,0,1,3,0,4
74717,170,17921,23717;23791;27455,50005,0,0,3,0,3
74718,170,17922,23471;23802,50005,0,0,2,0,2
74719,170,17923,24152;27479;27587,50005,0,0,3,0,3
74720,170,17924,23687;23826,50005,0,0,2,0,2
74721,170,17925,23832;23982;26501;28070,50005,0,1,3,0,4
74722,170,17926,23619;23851;27274,50005,0,0,3,0,3
74723,170,17927,24245;27783,50005,0,1,1,0,2
74724,170,17928,23978;24226;27594;27672,50005,0,1,3,0,4
74725,170,17929,23911,50005,0,0,1,0,1
74726,170,17930,24221;26999;27382;27671,50005,0,1,3,0,4
74727,170,17931,23931;24277;27983;28185,50005,0,2,2,0,4
74728,170,17932,23276;23954,50005,0,0,2,0,2
74729,170,17933,23957,50005,0,0,1,0,1
74730,170,17934,23654;23969,50005,0,0,2,0,2
74731,170,17935,23866;24001;27178;29124,50005,1,0,3,0,4
74732,170,17937,23990;24348;27389;27489;27986;28274,50005,0,2,4,0,6
74733,170,17938,23995;24099;26594;26796;28364,50005,0,1,4,0,5
74734,170,17939,23775;23917;26793,50005,0,0,3,0,3
74735,170,17940,23748;24016,50005,0,0,2,0,2
74736,170,17942,24030;24266,50005,0,0,2,0,2
74737,170,17944,23544;24008;26331;27865,50005,0,1,3,0,4
74738,170,17945,24280;27297,50005,0,0,2,0,2
74739,170,17946,24078;24108;26599;27079;27371;27867,50005,0,1,5,0,6
74740,170,17947,23981;24083;27863;28069,50005,0,2,2,0,4
74741,170,17953,19990,50370,0,0,0,1,1
74742,170,17957,20685,50370,0,0,0,1,1
74743,170,17959,20171,50370,0,0,0,1,1
74744,170,17962,20666,50370,0,0,0,1,1
74745,170,17968,21082,50370,0,0,0,1,1
74746,170,17976,21627,50370,0,0,0,1,1
74747,170,17982,22087,50370,0,0,0,1,1
74748,170,17984,21903;22425;26939,50370,0,0,1,2,3
74749,170,17991,22613;22968;27237,50370,0,0,2,1,3
74750,170,17995,22930;23224;26855,50370,0,0,3,0,3
74751,170,17998,23251;23483;27246,50370,0,0,3,0,3
74752,170,18001,23298;26106,50370,0,0,2,0,2
74753,170,18002,23246;23563;26665;27253,50370,0,0,4,0,4
74754,170,18004,23285;23406;27138,50370,0,0,3,0,3
74755,170,18007,23788;27657;27989,50370,0,2,1,0,3
74756,170,18008,23894;23988;27069;27864,50370,0,1,3,0,4
74757,170,18009,23864;27172;27275;28367,50370,0,1,3,0,4
74758,170,18011,23448;23574;27148,50370,0,0,3,0,3
74759,170,18013,23462;23464;26970;27561,50370,0,0,4,0,4
74760,170,18014,23416;23474,50370,0,0,2,0,2
74761,170,18015,23282;23531,50370,0,0,2,0,2
74762,170,18017,23760,50370,0,0,1,0,1
74763,170,18018,23532;23545;27854,50370,0,1,2,0,3
74764,170,18019,23182;23646,50370,0,0,2,0,2
74765,170,18020,23540;26764;27146;27856,50370,0,1,3,0,4
74766,170,18021,23268,50370,0,0,1,0,1
74767,170,18022,23534;23608;27855,50370,0,1,2,0,3
74768,170,18023,24003;24004;27285;27465,50370,0,0,4,0,4
74769,170,18024,24141;24178;27378;29322,50370,1,0,3,0,4
74770,170,18025,23564;23763,50370,0,0,2,0,2
74771,170,18026,23487;23715;26123;27053;27158,50370,0,0,5,0,5
74772,170,18027,23734;23920;27265,50370,0,0,3,0,3
74773,170,18029,23833;24228;27595,50370,0,0,3,0,3
74774,170,18030,23804;24084;27372;27473,50370,0,0,4,0,4
74775,170,18031,23599;23844;26685,50370,0,0,3,0,3
74776,170,18032,23420;23629;27764,50370,0,1,2,0,3
74777,170,18033,23425;23867,50370,0,0,2,0,2
74778,170,18034,23469;23868;26226;27063,50370,0,0,4,0,4
74779,170,18035,23746;24202;27670;27782,50370,0,2,2,0,4
74780,170,18038,24094;24146;27586,50370,0,0,3,0,3
74781,170,18039,23980;24285;26805,50370,0,0,3,0,3
74782,170,18040,23985;24214;27381;28183,50370,0,1,3,0,4
74783,170,18041,24010;24097;27073;27467,50370,0,0,4,0,4
74784,170,18042,24034;24289,50370,0,0,2,0,2
74785,170,18043,23971;24039;26986;27369;27774,50370,0,1,4,0,5
74786,170,18044,24040,50370,0,0,1,0,1
74787,170,18045,24047;27469;27583;29231,50370,1,0,3,0,4
74788,170,18046,24116;24460,50370,0,0,2,0,2
74789,170,18047,23860;24160,50370,0,0,2,0,2
74790,170,18048,24033;24172;27187,50370,0,0,3,0,3
74791,170,18049,24155;24181,50370,0,0,2,0,2
74792,170,18051,24368;28075,50370,0,1,1,0,2
74793,170,18061,19997,50735,0,0,0,1,1
74794,170,18062,20083,50735,0,0,0,1,1
74795,170,18063,20716;20878,50735,0,0,0,2,2
74796,170,18064,20508,50735,0,0,0,1,1
74797,170,18067,20859;20944,50735,0,0,0,2,2
74798,170,18072,21554,50735,0,0,0,1,1
74799,170,18075,21226;21687,50735,0,0,0,2,2
74800,170,18085,22678;23210,50735,0,0,1,1,2
74801,170,18087,23228;27971,50735,0,1,1,0,2
74802,170,18091,23004;23208,50735,0,0,2,0,2
74803,170,18094,23118;23861;27459;29035,50735,1,0,3,0,4
74804,170,18096,23204;23845;27170;27457,50735,0,0,4,0,4
74805,170,18098,23236;23766;26779,50735,0,0,3,0,3
74806,170,18099,23207;23261;27239,50735,0,0,3,0,3
74807,170,18101,23175;23392;27241;29126,50735,1,0,3,0,4
74808,170,18103,23862;23955,50735,0,0,2,0,2
74809,170,18104,23429;23692;27260,50735,0,0,3,0,3
74810,170,18105,23814;27167;27268;27354,50735,0,0,4,0,4
74811,170,18106,23082;23509;27562,50735,0,0,3,0,3
74812,170,18108,24169;24176,50735,0,0,2,0,2
74813,170,18109,23105;23800,50735,0,0,2,0,2
74814,170,18111,23610;23757;26574;27446;29301,50735,1,0,4,0,5
74815,170,18112,23500;23613,50735,0,0,2,0,2
74816,170,18113,23317;23714;27262,50735,0,0,3,0,3
74817,170,18114,23455;23765;27453,50735,0,0,3,0,3
74818,170,18115,23494;23776;26963;27351,50735,0,0,4,0,4
74819,170,18118,23886;24338;27488,50735,0,0,3,0,3
74820,170,18120,23945,50735,0,0,1,0,1
74821,170,18121,23727;23967;27582,50735,0,0,3,0,3
74822,170,18122,23635;24006;27466,50735,0,0,3,0,3
74823,170,18123,24026;24164;27377;27481;27779,50735,0,1,4,0,5
74824,170,18124,23883;24053;27076;27182,50735,0,0,4,0,4
74825,170,18125,23338;24074;26989;28270,50735,0,1,3,0,4
74826,170,18126,24098;27665;27974;28072,50735,0,3,1,0,4
74827,170,18127,24104;24458;27398;27499,50735,0,0,4,0,4
74828,170,18128,24130;24282;27193;28565,50735,0,1,3,0,4
74829,170,18129,23668;24072;27078;28178,50735,0,1,3,0,4
74830,170,18131,24070;24177;26802;27293,50735,0,0,4,0,4
74831,170,18132,23888;24191;27669,50735,0,1,2,0,3
74832,170,18134,24431,50735,0,0,1,0,1
74833,170,18135,19927,51100,0,0,0,1,1
74834,170,18141,20525,51100,0,0,0,1,1
74835,170,18148,21276,51100,0,0,0,1,1
74836,170,18150,21397;21485,51100,0,0,0,2,2
74837,170,18155,21663,51100,0,0,0,1,1
74838,170,18158,21113;21223,51100,0,0,0,2,2
74839,170,18161,22546;22765;26448,51100,0,0,1,2,3
74840,170,18163,22105,51100,0,0,0,1,1
74841,170,18172,22466;23061,51100,0,0,1,1,2
74842,170,18174,22575;22675,51100,0,0,0,2,2
74843,170,18175,23190;23367;27337,51100,0,0,3,0,3
74844,170,18183,23057;23201;26949,51100,0,0,3,0,3
74845,170,18188,23902,51100,0,0,1,0,1
74846,170,18189,23165;23436,51100,0,0,2,0,2
74847,170,18190,23477;23594,51100,0,0,2,0,2
74848,170,18191,22703;23497,51100,0,0,1,1,2
74849,170,18192,23527;27143,51100,0,0,2,0,2
74850,170,18193,23443;23530,51100,0,0,2,0,2
74851,170,18194,23504;23720,51100,0,0,2,0,2
74852,170,18195,23266;23602;26768;27150,51100,0,0,4,0,4
74853,170,18196,23622;26872,51100,0,0,2,0,2
74854,170,18198,23793;24013;26697;26904;28666,51100,0,1,4,0,5
74855,170,18199,24080;24162;27085;27291,51100,0,0,4,0,4
74856,170,18201,24352;24423;27788,51100,0,1,2,0,3
74857,170,18202,23853;26129,51100,0,0,2,0,2
74858,170,18203,23857;26786,51100,0,0,2,0,2
74859,170,18204,24217;24376,51100,0,0,2,0,2
74860,170,18205,23950;27362,51100,0,0,2,0,2
74861,170,18206,23514;23953;26980;27363,51100,0,0,4,0,4
74862,170,18207,23419;23972,51100,0,0,2,0,2
74863,170,18210,24336;28370,51100,0,1,1,0,2
74864,170,18211,24081;27080,51100,0,0,2,0,2
74865,170,18212,24484;27503;27695,51100,0,1,2,0,3
74866,170,18213,23643;24038,51100,0,0,2,0,2
74867,170,18214,24212;24291,51100,0,0,2,0,2
74868,170,18217,24123;24187,51100,0,0,2,0,2
74869,170,18218,24136;24283;27194,51100,0,0,3,0,3
74870,170,18219,23994;24218;27295,51100,0,0,3,0,3
74871,170,18220,24193;26506;27977;29099,51100,1,1,2,0,4
74872,170,18221,24195,51100,0,0,1,0,1
74873,170,18223,23725;24211,51100,0,0,2,0,2
74874,170,18224,24216;24577;27104,51100,0,0,3,0,3
74875,170,18225,24326;24327,51100,0,0,2,0,2
74876,170,18226,24278;24290;27677,51100,0,1,2,0,3
74877,170,18228,24598;27313,51100,0,0,2,0,2
74878,170,18229,24303;27599,51100,0,0,2,0,2
74879,170,18230,24324;24500,51100,0,0,2,0,2
74880,170,18231,24435;27200;27396,51100,0,0,3,0,3
74881,170,18232,24335,51100,0,0,1,0,1
74882,170,18233,24337;26921;27785;28273,51100,0,2,2,0,4
74883,170,18234,23991;24354;27199;27684,51100,0,1,3,0,4
74884,170,18235,24560,51100,0,0,1,0,1
74885,170,18236,23869;24363;27094;27685,51100,0,1,3,0,4
74886,170,18237,24589;27612;28087;28281,51100,0,2,2,0,4
74887,170,18240,20086,51465,0,0,0,1,1
74888,170,18241,20390,51465,0,0,0,1,1
74889,170,18246,20501,51465,0,0,0,1,1
74890,170,18247,20265,51465,0,0,0,1,1
74891,170,18250,21009;21147,51465,0,0,0,2,2
74892,170,18258,21819;21965,51465,0,0,0,2,2
74893,170,18261,22112;22184,51465,0,0,0,2,2
74894,170,18262,22057;22177,51465,0,0,0,2,2
74895,170,18264,22028,51465,0,0,0,1,1
74896,170,18266,23172;23321;27035;28847,51465,0,1,3,0,4
74897,170,18267,22650;22661;26941,51465,0,0,1,2,3
74898,170,18276,23163;23203;26852;29025,51465,1,0,3,0,4
74899,170,18279,23691;23834;27572,51465,0,0,3,0,3
74900,170,18280,23466;23817;27270;27857;28174,51465,0,2,3,0,5
74901,170,18281,23721;27159;27348,51465,0,0,3,0,3
74902,170,18282,23803;26407;26782,51465,0,0,3,0,3
74903,170,18283,23501;23837;27168;27769,51465,0,1,3,0,4
74904,170,18284,23327;23595,51465,0,0,2,0,2
74905,170,18286,23665,51465,0,0,1,0,1
74906,170,18287,23365;23669;26672,51465,0,0,3,0,3
74907,170,18288,23307;23414,51465,0,0,2,0,2
74908,170,18289,23815;26968,51465,0,0,2,0,2
74909,170,18290,23270;23481,51465,0,0,2,0,2
74910,170,18291,23761;27571;27655,51465,0,1,2,0,3
74911,170,18292,23676;23787,51465,0,0,2,0,2
74912,170,18293,23794;23899;27064;27356,51465,0,0,4,0,4
74913,170,18295,23876;26789;27276,51465,0,0,3,0,3
74914,170,18296,23949;24168;27976,51465,0,1,2,0,3
74915,170,18297,23790;24020;28071,51465,0,1,2,0,3
74916,170,18298,24023;24432,51465,0,0,2,0,2
74917,170,18299,24037;27074,51465,0,0,2,0,2
74918,170,18300,24048,51465,0,0,1,0,1
74919,170,18301,24057;24463;27005;27204,51465,0,0,4,0,4
74920,170,18302,23823;24068;27776,51465,0,1,2,0,3
74921,170,18304,24297;24398;27392;27496,51465,0,0,4,0,4
74922,170,18305,23693;23884,51465,0,0,2,0,2
74923,170,18306,24428;28077,51465,0,1,1,0,2
74924,170,18307,23731;24144,51465,0,0,2,0,2
74925,170,18308,24174,51465,0,0,1,0,1
74926,170,18309,24182;24213;26703;29213;29306,51465,2,0,3,0,5
74927,170,18310,24265;24574;26930;27705;28085;28198,51465,0,3,3,0,6
74928,170,18311,24322;28465,51465,0,1,1,0,2
74929,170,18312,23882;24293,51465,0,0,2,0,2
74930,170,18313,24295;24320;27871,51465,0,1,2,0,3
74931,170,18314,24319;24350;27490,51465,0,0,3,0,3
74932,170,18315,24321;24747;27387;27681,51465,0,1,3,0,4
74933,170,18316,24349;24614,51465,0,0,2,0,2
74934,170,18317,24090;26924;27877;28276,51465,0,2,2,0,4
74935,170,18318,24408;24649;27520;27896,51465,0,1,3,0,4
74936,170,18319,23996;24420;27393,51465,0,0,3,0,3
74937,170,18320,24436;24442;27304;27397,51465,0,0,4,0,4
74938,170,18321,24457;24477;27791;28372,51465,0,2,2,0,4
74939,170,18322,20294,51830,0,0,0,1,1
74940,170,18323,20054,51830,0,0,0,1,1
74941,170,18327,20231,51830,0,0,0,1,1
74942,170,18331,20801;20813,51830,0,0,0,2,2
74943,170,18338,21180;21541,51830,0,0,0,2,2
74944,170,18352,22391,51830,0,0,0,1,1
74945,170,18361,23278;26553,51830,0,0,2,0,2
74946,170,18362,23364;23444,51830,0,0,2,0,2
74947,170,18366,24103;26990;27474;27666,51830,0,1,3,0,4
74948,170,18367,23551;24159;27480,51830,0,0,3,0,3
74949,170,18368,23369;23660;27153;27565;29032,51830,1,0,4,0,5
74950,170,18369,23617;23656;27256,51830,0,0,3,0,3
74951,170,18370,24166;24173;26702;27292;27780;29327,51830,1,1,4,0,6
74952,170,18371,23713;24302;27487;27784;28186,51830,0,2,3,0,5
74953,170,18373,23240;23733;27766,51830,0,1,2,0,3
74954,170,18374,23805;24205,51830,0,0,2,0,2
74955,170,18375,23810;24227;28184,51830,0,1,2,0,3
74956,170,18376,23253;23738,51830,0,0,2,0,2
74957,170,18377,23447;23898;26791,51830,0,0,3,0,3
74958,170,18378,23998;27176;27284;27464;27772,51830,0,1,4,0,5
74959,170,18379,24012;24310;27600;27678,51830,0,1,3,0,4
74960,170,18380,24045;24356;27298;27491;28188;28466,51830,0,2,4,0,6
74961,170,18381,24539;27309;28084,51830,0,1,2,0,3
74962,170,18383,23560;24066;26597,51830,0,0,3,0,3
74963,170,18384,24307;24656;27898;28000;28287,51830,0,3,2,0,5
74964,170,18385,23719;24122;26910,51830,0,0,3,0,3
74965,170,18386,24125;24450;27604;28079;28849,51830,1,1,3,0,5
74966,170,18387,24180;24318;27680;28369,51830,0,2,2,0,4
74967,170,18388,24190;24192;27589,51830,0,0,3,0,3
74968,170,18389,24076;24200;27188;27379;27590,51830,0,0,5,0,5
74969,170,18390,24643;27519;27712,51830,0,1,2,0,3
74970,170,18392,24276;24620;27803,51830,0,1,2,0,3
74971,170,18394,24309;24629;27517,51830,0,0,3,0,3
74972,170,18395,24323;27873;28074,51830,0,2,1,0,3
74973,170,18396,24329;24788;27623;28206,51830,0,1,3,0,4
74974,170,18397,24396,51830,0,0,1,0,1
74975,170,18398,24406;24679;27988,51830,0,1,2,0,3
74976,170,18399,24439;24694;27413;28003,51830,0,1,3,0,4
74977,170,18400,24438;24854;27320;27420,51830,0,0,4,0,4
74978,170,18401,24452;24718;28096;28202,51830,0,2,2,0,4
74979,170,18402,24281,51830,0,0,1,0,1
74980,170,18403,24483;24850;28386,51830,0,1,2,0,3
74981,170,18404,24507;24632;27403;27507;27796;27884;28568,51830,0,3,4,0,7
74982,170,18405,24526;27308;27700,51830,0,1,2,0,3
74983,170,18406,24528;24646;27411,51830,0,0,3,0,3
74984,170,18407,24530;24626;27516;28757,51830,0,1,3,0,4
74985,170,18408,24142;24534;28083,51830,0,1,2,0,3
74986,170,18409,24485;24548;27010,51830,0,0,3,0,3
74987,170,18410,24549;24797,51830,0,0,2,0,2
74988,170,18411,24404;24553,51830,0,0,2,0,2
74989,170,18412,24128;24556;27405;27513;27888;28376,51830,0,2,4,0,6
74990,170,18414,20084,52195,0,0,0,1,1
74991,170,18417,20356;20842,52195,0,0,0,2,2
74992,170,18420,20671,52195,0,0,0,1,1
74993,170,18422,20649;20941,52195,0,0,0,2,2
74994,170,18423,20434;20749,52195,0,0,0,2,2
74995,170,18428,21198,52195,0,0,0,1,1
74996,170,18429,21149,52195,0,0,0,1,1
74997,170,18431,21225,52195,0,0,0,1,1
74998,170,18436,21927;22414;26253,52195,0,0,1,2,3
74999,170,18437,22091,52195,0,0,0,1,1
75000,170,18438,22107,52195,0,0,0,1,1
75001,170,18442,22447;22510,52195,0,0,0,2,2
75002,170,18446,22648;22657,52195,0,0,0,2,2
75003,170,18448,22897;23356;25614,52195,0,0,3,0,3
75004,170,18450,23021;23109,52195,0,0,2,0,2
75005,170,18452,23649;24073;27584,52195,0,0,3,0,3
75006,170,18453,23212;23743,52195,0,0,2,0,2
75007,170,18458,23704;23999;27070;27177,52195,0,0,4,0,4
75008,170,18459,23753;24153;26333;27290;27588,52195,0,0,5,0,5
75009,170,18460,23569;23843,52195,0,0,2,0,2
75010,170,18461,23979;24113;27475,52195,0,0,3,0,3
75011,170,18462,23325;23822;26893;27060;27456;27858;29114;29220,52195,2,1,5,0,8
75012,170,18463,24019;24087,52195,0,0,2,0,2
75013,170,18464,24024;24469;27006;27501,52195,0,0,4,0,4
75014,170,18465,24052;24361;27391;27789,52195,0,1,3,0,4
75015,170,18467,24127;24292;27386;27985,52195,0,1,3,0,4
75016,170,18468,24165,52195,0,0,1,0,1
75017,170,18469,24203;24253;27591;28563,52195,0,1,3,0,4
75018,170,18470,24156;24232;27088;27189,52195,0,0,4,0,4
75019,170,18471,24230;24234;27384,52195,0,0,3,0,3
75020,170,18473,24236;24246,52195,0,0,2,0,2
75021,170,18474,24255;24258;26804;27485;28464,52195,0,1,4,0,5
75022,170,18475,24317;24580;27408;27514,52195,0,0,4,0,4
75023,170,18476,24235;27089;27979;28272,52195,0,2,2,0,4
75024,170,18477,24334;24410,52195,0,0,2,0,2
75025,170,18479,23659;24370;27495,52195,0,0,3,0,3
75026,170,18481,24421;28277,52195,0,1,1,0,2
75027,170,18482,23915;24453,52195,0,0,2,0,2
75028,170,18484,24525;24774;27717,52195,0,1,2,0,3
75029,170,18485,24487;24793;27910;28476,52195,0,2,2,0,4
75030,170,18486,24497;24531;27401,52195,0,0,3,0,3
75031,170,18487,24372;24533;27607,52195,0,0,3,0,3
75032,170,18488,24540;27996,52195,0,1,1,0,2
75033,170,18489,24254;24550;27512;27608,52195,0,0,4,0,4
75034,170,18490,24284;24551;27011;27404,52195,0,0,4,0,4
75035,170,18492,24878;28014;28107;28680,52195,0,3,1,0,4
75036,170,18493,24739;24800,52195,0,0,2,0,2
75037,170,18494,24602;24608;27515,52195,0,0,3,0,3
75038,170,18495,24609;24680,52195,0,0,2,0,2
75039,170,18496,24849;28212;28852,52195,1,1,1,0,3
75040,170,18497,24613;25004;28119,52195,0,1,2,0,3
75041,170,18498,24760;24906,52195,0,0,2,0,2
75042,170,18499,24513;24637;28286,52195,0,1,2,0,3
75043,170,18500,24651;24712;27112;28095,52195,0,1,3,0,4
75044,170,18501,24652;28381,52195,0,1,1,0,2
75045,170,18502,24300;24669;27901;28002,52195,0,2,2,0,4
75046,170,18503,24683;24961;28300;28942,52195,1,1,2,0,4
75047,170,18504,20643,52560,0,0,0,1,1
75048,170,18505,20451,52560,0,0,0,1,1
75049,170,18506,20205,52560,0,0,0,1,1
75050,170,18507,20187,52560,0,0,0,1,1
75051,170,18509,20705,52560,0,0,0,1,1
75052,170,18516,21119;21342,52560,0,0,0,2,2
75053,170,18519,20851,52560,0,0,0,1,1
75054,170,18520,21339,52560,0,0,0,1,1
75055,170,18521,21277;21289,52560,0,0,0,2,2
75056,170,18523,21133;21285,52560,0,0,0,2,2
75057,170,18528,21766,52560,0,0,0,1,1
75058,170,18529,21768,52560,0,0,0,1,1
75059,170,18533,22129,52560,0,0,0,1,1
75060,170,18539,22432,52560,0,0,0,1,1
75061,170,18542,22628,52560,0,0,0,1,1
75062,170,18549,23225;23565,52560,0,0,2,0,2
75063,170,18550,23792;24260;27674;27870;27981,52560,0,3,2,0,5
75064,170,18551,23712;24131;27585;27975,52560,0,1,3,0,4
75065,170,18552,23567;23742;26024;28455;29170,52560,1,1,3,0,5
75066,170,18553,24065;27663;27775,52560,0,2,1,0,3
75067,170,18554,23842;24388,52560,0,0,2,0,2
75068,170,18555,23686;23856,52560,0,0,2,0,2
75069,170,18556,23778;23892,52560,0,0,2,0,2
75070,170,18557,23929;24440;27689;27990,52560,0,2,2,0,4
75071,170,18558,23632;23951;26592;27861,52560,0,1,3,0,4
75072,170,18560,24043;24105;26991;27667;28179,52560,0,2,3,0,5
75073,170,18561,24107;24133;27287;27375,52560,0,0,4,0,4
75074,170,18562,24607;28199,52560,0,1,1,0,2
75075,170,18563,24199;24502;27101;27505;28567,52560,0,1,4,0,5
75076,170,18564,24207;24389;27300;27987,52560,0,1,3,0,4
75077,170,18565,23928;24231;27596;27673,52560,0,1,3,0,4
75078,170,18566,24247;24803;27117,52560,0,0,3,0,3
75079,170,18567,24252;24340;26335;26922;27682,52560,0,1,4,0,5
75080,170,18569,24343;24400;27878,52560,0,1,2,0,3
75081,170,18571,24606;27708;28282,52560,0,2,1,0,3
75082,170,18572,24298;24417;28019,52560,0,1,2,0,3
75083,170,18573,24088;24418;27003,52560,0,0,3,0,3
75084,170,18574,24115;24480;27305;27693,52560,0,1,3,0,4
75085,170,18575,24498;27402;29323,52560,1,0,2,0,3
75086,170,18576,24499;27795;27992;28191,52560,0,3,1,0,4
75087,170,18577,24639;27106;27615;28470;28570,52560,0,2,3,0,5
75088,170,18578,24547;24600;27890,52560,0,1,2,0,3
75089,170,18579,24572;24700;27704;27800;27889,52560,0,3,2,0,5
75090,170,18580,24449;24586;27312;27611,52560,0,0,4,0,4
75091,170,18581,24642;26819;28844,52560,0,1,2,0,3
75092,170,18582,24554;24661;27997,52560,0,1,2,0,3
75093,170,18583,24617;24688;27902;28288,52560,0,2,2,0,4
75094,170,18584,24723;24897,52560,0,0,2,0,2
75095,170,18585,24392;24745;27620;28005;28289,52560,0,2,3,0,5
75096,170,18586,24838;24920;27627;27920;28762,52560,0,2,3,0,5
75097,170,18587,24615;24769;28007;28574;28678,52560,0,3,2,0,5
75098,170,18588,24818;27418;28208;28759,52560,0,2,2,0,4
75099,170,18589,20656,52925,0,0,0,1,1
75100,170,18591,20618,52925,0,0,0,1,1
75101,170,18596,21583,52925,0,0,0,1,1
75102,170,18597,21324;21474,52925,0,0,0,2,2
75103,170,18599,21154,52925,0,0,0,1,1
75104,170,18601,21711;21724,52925,0,0,0,2,2
75105,170,18604,22161,52925,0,0,0,1,1
75106,170,18605,22589,52925,0,0,0,1,1
75107,170,18606,22234;22746,52925,0,0,0,2,2
75108,170,18607,22831;23059,52925,0,0,2,0,2
75109,170,18609,23147;23445;26389;27339;29294,52925,1,0,4,0,5
75110,170,18611,23623,52925,0,0,1,0,1
75111,170,18614,23603,52925,0,0,1,0,1
75112,170,18615,23254;23628,52925,0,0,2,0,2
75113,170,18617,23597;23927;26956,52925,0,0,3,0,3
75114,170,18622,23638;24022;27662,52925,0,1,2,0,3
75115,170,18623,23644;24082;27664,52925,0,1,2,0,3
75116,170,18625,23707;24154;28182,52925,0,1,2,0,3
75117,170,18626,23992;24135,52925,0,0,2,0,2
75118,170,18627,23711;23859,52925,0,0,2,0,2
75119,170,18628,23723;23741;26495;26775;27569;29324,52925,1,0,5,0,6
75120,170,18631,23784;26225,52925,0,0,2,0,2
75121,170,18632,23831;23948;27659,52925,0,1,2,0,3
75122,170,18633,23611;23854;26972,52925,0,0,3,0,3
75123,170,18634,24102;24249,52925,0,0,2,0,2
75124,170,18635,23807;23891;27860,52925,0,1,2,0,3
75125,170,18636,23604;24250;27484,52925,0,0,3,0,3
75126,170,18637,24271;27982;28564,52925,0,2,1,0,3
75127,170,18639,23836;24028;27367,52925,0,0,3,0,3
75128,170,18640,23808;23939;26590;26899;27278,52925,0,0,5,0,5
75129,170,18641,24222;24259;27483;27593,52925,0,0,4,0,4
75130,170,18642,24007;24093;26600,52925,0,0,3,0,3
75131,170,18644,24464,52925,0,0,1,0,1
75132,170,18645,24151;24451;27097;27498,52925,0,0,4,0,4
75133,170,18647,23997;24175,52925,0,0,2,0,2
75134,170,18648,24263;24591;27706;27801;28088;28569,52925,0,4,2,0,6
75135,170,18649,24046;24279;27385,52925,0,0,3,0,3
75136,170,18650,24197;24366;27494,52925,0,0,3,0,3
75137,170,18651,24705;27907,52925,0,1,1,0,2
75138,170,18652,24313;24403,52925,0,0,2,0,2
75139,170,18653,24345;24563;27703;28196;28469,52925,0,3,2,0,5
75140,170,18654,24355;24409;26810;27879;28566,52925,0,2,3,0,5
75141,170,18655,24542;26337;28375;28657;29094,52925,1,2,2,0,5
75142,170,18656,24454;24521;27205;27699;27994,52925,0,2,3,0,5
75143,170,18657,24455;24565;27202,52925,0,0,3,0,3
75144,170,18658,24474;24730;27715,52925,0,1,2,0,3
75145,170,18659,24568;24693;28673,52925,0,1,2,0,3
75146,170,18660,24143;27288;27476,52925,0,0,3,0,3
75147,170,18661,24731;24949;27619,52925,0,0,3,0,3
75148,170,18662,24506;27506;27698;27881,52925,0,2,2,0,4
75149,170,18663,24393;24523;27206,52925,0,0,3,0,3
75150,170,18665,24535;24911;27817,52925,0,1,2,0,3
75151,170,18666,25047,52925,0,0,1,0,1
75152,170,18667,24625;25051;27824;28402,52925,0,2,2,0,4
75153,170,18668,24627;24945;27709;27893,52925,0,2,2,0,4
75154,170,18669,24630;25302;28320;28502;28774,52925,0,3,2,0,5
75155,170,18670,24640;24847;27626;28012;28211,52925,0,2,3,0,5
75156,170,18671,24306;24359;28467,52925,0,1,2,0,3
75157,170,18672,24653;24972;28302;28393;28581,52925,0,3,2,0,5
75158,170,18674,24727;25096,52925,0,0,2,0,2
75159,170,18675,24729;24749;28098,52925,0,1,2,0,3
75160,170,18676,24740;24759,52925,0,0,2,0,2
75161,170,18677,24662;24778;27317;27719,52925,0,1,3,0,4
75162,170,18678,24597;25151;28032;28692,52925,0,2,2,0,4
75163,170,18679,24395;24786;28205,52925,0,1,2,0,3
75164,170,18681,24754;24804;28008,52925,0,1,2,0,3
75165,170,18682,24837;25045;28222,52925,0,1,2,0,3
75166,170,18683,24852;24934;27630;28579,52925,0,1,3,0,4
75167,170,18684,24668;24928;27423;27628,52925,0,0,4,0,4
75168,170,18685,24562;24863;27421;28478,52925,0,1,3,0,4
75169,170,18686,24817;24978;27426,52925,0,0,3,0,3
75170,170,18687,24709;24879;27714;28383,52925,0,2,2,0,4
75171,170,18688,24880;25208,52925,0,0,2,0,2
75172,170,18689,24985;24995;27222;28117;28219;28394;28485;28683,52925,0,5,3,0,8
75173,170,18690,24720;24888;28108;28479,52925,0,2,2,0,4
75174,170,18691,24896;28388,52925,0,1,1,0,2
75175,170,18692,24296;24973;27425;29037,52925,1,0,3,0,4
75176,170,18693,24993;25098;27540;27830;28588;28689,52925,0,3,3,0,6
75177,170,18694,20116,53290,0,0,0,1,1
75178,170,18696,20743,53290,0,0,0,1,1
75179,170,18697,21120,53290,0,0,0,1,1
75180,170,18699,20698,53290,0,0,0,1,1
75181,170,18704,21193;21548,53290,0,0,0,2,2
75182,170,18707,21405,53290,0,0,0,1,1
75183,170,18709,21099,53290,0,0,0,1,1
75184,170,18710,21227;21385,53290,0,0,0,2,2
75185,170,18720,21778,53290,0,0,0,1,1
75186,170,18724,21988,53290,0,0,0,1,1
75187,170,18728,22684;23020,53290,0,0,1,1,2
75188,170,18734,23618;23858;26974;27458,53290,0,0,4,0,4
75189,170,18736,22896;23035,53290,0,0,2,0,2
75190,170,18737,23480;23666;27154,53290,0,0,3,0,3
75191,170,18743,24261;27597,53290,0,0,2,0,2
75192,170,18744,23811;23905;27359;29127,53290,1,0,3,0,4
75193,170,18745,23729;23925;27161,53290,0,0,3,0,3
75194,170,18747,23740;24005;27660,53290,0,1,2,0,3
75195,170,18748,24011;24287;27984,53290,0,1,2,0,3
75196,170,18749,24095;24243,53290,0,0,2,0,2
75197,170,18750,24426;27303;28076;28756,53290,0,2,2,0,4
75198,170,18751,23975;24089,53290,0,0,2,0,2
75199,170,18752,23872;26788,53290,0,0,2,0,2
75200,170,18753,23770;24051;27470,53290,0,0,3,0,3
75201,170,18754,23987;24189,53290,0,0,2,0,2
75202,170,18755,23922;24240,53290,0,0,2,0,2
75203,170,18756,24270;24636;27014,53290,0,0,3,0,3
75204,170,18757,24325;24584,53290,0,0,2,0,2
75205,170,18758,24353,53290,0,0,1,0,1
75206,170,18760,24367;24673,53290,0,0,2,0,2
75207,170,18761,24375;24737;27876;28275,53290,0,2,2,0,4
75208,170,18762,24385;24536;27510,53290,0,0,3,0,3
75209,170,18763,24391;27686;29326,53290,1,1,1,0,3
75210,170,18764,24401;24519;28194,53290,0,1,2,0,3
75211,170,18766,24443;24905;28297,53290,0,1,2,0,3
75212,170,18767,24894;25008;27019;27723,53290,0,1,3,0,4
75213,170,18768,24512;24702,53290,0,0,2,0,2
75214,170,18769,24515;24559;27606;28082,53290,0,1,3,0,4
75215,170,18770,24757;25040;27932;28400;28685,53290,0,3,2,0,5
75216,170,18771,24161;24569;28197,53290,0,1,2,0,3
75217,170,18772,24618;24835;27315;27892;27999,53290,0,2,3,0,5
75218,170,18773,24634;27518;27804,53290,0,1,2,0,3
75219,170,18774,24811;24840;28105,53290,0,1,2,0,3
75220,170,18775,24675;24714,53290,0,0,2,0,2
75221,170,18776,24682;25080;28125,53290,0,1,2,0,3
75222,170,18777,24573;24998;27428;27534,53290,0,0,4,0,4
75223,170,18778,24514;24699,53290,0,0,2,0,2
75224,170,18779,24677;24711;28094,53290,0,1,2,0,3
75225,170,18780,24698;24713;26720,53290,0,0,3,0,3
75226,170,18781,24595;24719;27523;28676,53290,0,1,3,0,4
75227,170,18782,24736;25005;27125;28021,53290,0,1,3,0,4
75228,170,18783,24685,53290,0,0,1,0,1
75229,170,18784,24761;24874;27526;28204,53290,0,1,3,0,4
75230,170,18785,24767;25043;27808;28758,53290,0,2,2,0,4
75231,170,18786,24855;24886;27815;27917;28681;28853,53290,1,3,2,0,6
75232,170,18787,24647;24764;27621,53290,0,0,3,0,3
75233,170,18788,24812;24827;28385,53290,0,1,2,0,3
75234,170,18789,24960;25121;27834,53290,0,1,2,0,3
75235,170,18790,24658;24833;28010,53290,0,1,2,0,3
75236,170,18791,25182;25216;28233;29130,53290,1,1,2,0,4
75237,170,18792,24876;25180;27638;27938;28034;28136,53290,0,3,3,0,6
75238,170,18793,24789;24890;27416;28207,53290,0,1,3,0,4
75239,170,18794,25159;25260;27941,53290,0,1,2,0,3
75240,170,18795,24486;24909,53290,0,0,2,0,2
75241,170,18796,24964;28391,53290,0,1,1,0,2
75242,170,18797,24858;24977,53290,0,0,2,0,2
75243,170,18798,24990;25199;28694;28949,53290,1,1,2,0,4
75244,170,18799,24958;25001;28304,53290,0,1,2,0,3
75245,170,18800,24899;24980;27427,53290,0,0,3,0,3
75246,170,18801,20740,53655,0,0,0,1,1
75247,170,18802,20931,53655,0,0,0,1,1
75248,170,18805,21081,53655,0,0,0,1,1
75249,170,18806,21159,53655,0,0,0,1,1
75250,170,18808,21563,53655,0,0,0,1,1
75251,170,18810,21030;21104,53655,0,0,0,2,2
75252,170,18811,21501,53655,0,0,0,1,1
75253,170,18817,21761,53655,0,0,0,1,1
75254,170,18827,22664,53655,0,0,0,1,1
75255,170,18830,23303;23438;27573,53655,0,0,3,0,3
75256,170,18831,23290;23663;26772;26960,53655,0,0,4,0,4
75257,170,18834,23508;23959,53655,0,0,2,0,2
75258,170,18835,23667;23764;27155;27765,53655,0,1,3,0,4
75259,170,18836,23700,53655,0,0,1,0,1
75260,170,18838,23652;23874;27077;27972,53655,0,1,3,0,4
75261,170,18841,23936,53655,0,0,1,0,1
75262,170,18842,24000;28176,53655,0,1,1,0,2
75263,170,18843,23772;24009;27056;27454,53655,0,0,4,0,4
75264,170,18844,23759;24147;26913;29311,53655,1,0,3,0,4
75265,170,18846,24505;27697;27883,53655,0,2,1,0,3
75266,170,18849,24305;24561;27407;27610;28377;29036,53655,1,1,4,0,6
75267,170,18850,25003;25171;27429;28396,53655,0,1,3,0,4
75268,170,18851,24419;24783;28292;28384,53655,0,2,2,0,4
75269,170,18852,24357;24390;27092;29120,53655,1,0,3,0,4
75270,170,18853,24429;24638;27395,53655,0,0,3,0,3
75271,170,18854,24472;24624;27614;28285,53655,0,1,3,0,4
75272,170,18855,24503;24770;27909,53655,0,1,2,0,3
75273,170,18856,24311;24601;27891;28379,53655,0,2,2,0,4
75274,170,18857,24446;24509;27307;27508;27993;28192;28280,53655,0,3,4,0,7
75275,170,18859,24741,53655,0,0,1,0,1
75276,170,18860,24780;25187,53655,0,0,2,0,2
75277,170,18861,24495;24717;28675,53655,0,1,2,0,3
75278,170,18862,24748;24796;27716,53655,0,1,2,0,3
75279,170,18863,24753;28006;28677,53655,0,2,1,0,3
75280,170,18864,25088;27323;27539;27828;28586;28946,53655,1,2,3,0,6
75281,170,18865,24383;25010;28305;28684,53655,0,2,2,0,4
75282,170,18866,24722;24829;27915,53655,0,1,2,0,3
75283,170,18867,24861;27916;28387,53655,0,2,1,0,3
75284,170,18868,24943;25166;27936;28315;28493;29038,53655,1,3,2,0,6
75285,170,18870,24877;24914,53655,0,0,2,0,2
75286,170,18871,24919;25156;27324,53655,0,0,3,0,3
75287,170,18872,24738;24931;27629;27725;28578,53655,0,2,3,0,5
75288,170,18873,24991,53655,0,0,1,0,1
75289,170,18874,24904;24946;28576,53655,0,1,2,0,3
75290,170,18875,25110;27636;27729;28028;28224;28690;29232,53655,1,4,2,0,7
75291,170,18876,24963;25168;27424;28390,53655,0,1,3,0,4
75292,170,18877,24989;27223,53655,0,0,2,0,2
75293,170,18878,25142;25221;28408;28947,53655,1,1,2,0,4
75294,170,18879,24820;25332,53655,0,0,2,0,2
75295,170,18880,25022;25200;28770,53655,0,1,2,0,3
75296,170,18881,25024;25137;27727;28022,53655,0,2,2,0,4
75297,170,18882,24724;25276;27943;28139;28234,53655,0,3,2,0,5
75298,170,18883,24751;25155;27228,53655,0,0,3,0,3
75299,170,18884,25136;27835;28312,53655,0,2,1,0,3
75300,170,18885,25071;27126;27826,53655,0,1,2,0,3
75301,170,18886,25283;28416;29132,53655,1,1,1,0,3
75302,170,18888,25091;25178;28309;28587;28688,53655,0,3,2,0,5
75303,170,18889,25280;28235,53655,0,1,1,0,2
75304,170,18892,20828,54020,0,0,0,1,1
75305,170,18895,20679,54020,0,0,0,1,1
75306,170,18896,21047;21395,54020,0,0,0,2,2
75307,170,18897,21346;21633,54020,0,0,0,2,2
75308,170,18898,20815,54020,0,0,0,1,1
75309,170,18899,21698,54020,0,0,0,1,1
75310,170,18904,21898,54020,0,0,0,1,1
75311,170,18908,22132,54020,0,0,0,1,1
75312,170,18909,21798,54020,0,0,0,1,1
75313,170,18912,22490,54020,0,0,0,1,1
75314,170,18915,22494,54020,0,0,0,1,1
75315,170,18919,22324,54020,0,0,0,1,1
75316,170,18922,23156;23586,54020,0,0,2,0,2
75317,170,18925,22779,54020,0,0,1,0,1
75318,170,18929,23390,54020,0,0,1,0,1
75319,170,18931,23674;23724;27263;27349,54020,0,0,4,0,4
75320,170,18932,23461;23695,54020,0,0,2,0,2
75321,170,18937,23924;24060,54020,0,0,2,0,2
75322,170,18940,24344;27683;27787,54020,0,2,1,0,3
75323,170,18941,24119;24124,54020,0,0,2,0,2
75324,170,18942,24158;24364;27493,54020,0,0,3,0,3
75325,170,18943,24194;24204;28271,54020,0,1,2,0,3
75326,170,18944,24908;27816;28480,54020,0,2,1,0,3
75327,170,18945,24456;27203;27691,54020,0,1,2,0,3
75328,170,18946,24059;24274;27091;28073,54020,0,1,3,0,4
75329,170,18947,24308;24342;27872,54020,0,1,2,0,3
75330,170,18948,24239;24382,54020,0,0,2,0,2
75331,170,18949,24387;24537;27511;27701;27797;27886,54020,0,3,3,0,6
75332,170,18950,24496;24545;27400;27794,54020,0,1,3,0,4
75333,170,18951,24479;24644;27399;27502;27692,54020,0,1,4,0,5
75334,170,18952,24599;25141;28132;28313,54020,0,2,2,0,4
75335,170,18953,25042;28120,54020,0,1,1,0,2
75336,170,18954,24407;24926;27724;28482;28577,54020,0,3,2,0,5
75337,170,18955,24490;24689;27903;28093,54020,0,2,2,0,4
75338,170,18956,24692;25055;27904,54020,0,1,2,0,3
75339,170,18957,24696;25089;27829,54020,0,1,2,0,3
75340,170,18958,24703;24860;28382;28473,54020,0,2,2,0,4
75341,170,18959,24575;24935;27922;28111;28217,54020,0,3,2,0,5
75342,170,18960,24708;24743;26724;27016;27524;28097;28573;29108,54020,1,2,5,0,8
75343,170,18961,24610;24887;28214,54020,0,1,2,0,3
75344,170,18962,24843;24844;28941,54020,1,0,2,0,3
75345,170,18963,24873;24947,54020,0,0,2,0,2
75346,170,18964,24952;25244;28318;28598,54020,0,2,2,0,4
75347,170,18965,24957,54020,0,0,1,0,1
75348,170,18966,24965;25081;28113,54020,0,1,2,0,3
75349,170,18967,24971;25157;28409,54020,0,1,2,0,3
75350,170,18968,24660;25284,54020,0,0,2,0,2
75351,170,18969,25210;27734,54020,0,1,1,0,2
75352,170,18970,24982;24994;27726;28020;28115,54020,0,3,2,0,5
75353,170,18971,24884;29128,54020,1,0,1,0,2
75354,170,18972,25324;25494;28504,54020,0,1,2,0,3
75355,170,18973,24787;25015;27224;27822;28306;28582;29230,54020,1,3,3,0,7
75356,170,18974,24781;25020;28398;28583;28943,54020,1,2,2,0,5
75357,170,18975,24831;25056;28944,54020,1,0,2,0,3
75358,170,18976,24567;25073,54020,0,0,2,0,2
75359,170,18977,24918;27919,54020,0,1,1,0,2
75360,170,18978,25090;25127;28225,54020,0,1,2,0,3
75361,170,18979,25128;25417;27637,54020,0,0,3,0,3
75362,170,18980,25461;25637,54020,0,0,2,0,2
75363,170,18981,25074;25144;28307;28766,54020,0,2,2,0,4
75364,170,18982,25181;25354;28508,54020,0,1,2,0,3
75365,170,18983,25027;25193;28036;28231;28596,54020,0,3,2,0,5
75366,170,18984,25203;25222;27838;28037,54020,0,2,2,0,4
75367,170,18985,25206;25225;27640;28038,54020,0,1,3,0,4
75368,170,18990,20819,54385,0,0,0,1,1
75369,170,18992,21061,54385,0,0,0,1,1
75370,170,18995,20886,54385,0,0,0,1,1
75371,170,18998,21275,54385,0,0,0,1,1
75372,170,18999,21727,54385,0,0,0,1,1
75373,170,19000,21826;21971,54385,0,0,0,2,2
75374,170,19001,21457,54385,0,0,0,1,1
75375,170,19004,22998,54385,0,0,1,0,1
75376,170,19008,22300,54385,0,0,0,1,1
75377,170,19016,23110;23214,54385,0,0,2,0,2
75378,170,19019,23234;23520,54385,0,0,2,0,2
75379,170,19022,23404;23718,54385,0,0,2,0,2
75380,170,19025,23536;23819;27144,54385,0,0,3,0,3
75381,170,19030,23907;27461,54385,0,0,2,0,2
75382,170,19031,23935;24096,54385,0,0,2,0,2
75383,170,19032,23946;24138;27973,54385,0,1,2,0,3
75384,170,19034,24106;24304,54385,0,0,2,0,2
75385,170,19035,24339;27786,54385,0,1,1,0,2
75386,170,19036,24063;24412;27301,54385,0,0,3,0,3
75387,170,19037,24441;24582,54385,0,0,2,0,2
75388,170,19038,24447;24867;28679,54385,0,1,2,0,3
75389,170,19039,24522;24676;28092,54385,0,1,2,0,3
75390,170,19042,24571;27209,54385,0,0,2,0,2
75391,170,19044,24541;25038;27632,54385,0,0,3,0,3
75392,170,19045,24925;25093;27533;27770;27818;28018;28298;28481,54385,0,5,3,0,8
75393,170,19046,24042,54385,0,0,1,0,1
75394,170,19047,24413;24678,54385,0,0,2,0,2
75395,170,19048,24758;25152;28033;28226,54385,0,2,2,0,4
75396,170,19049,24470;24823;27624;28009,54385,0,1,3,0,4
75397,170,19050,24824;27914;28575,54385,0,2,1,0,3
75398,170,19051,24777;24839;27121,54385,0,0,3,0,3
75399,170,19052,24262;24706;27805;27908;28004,54385,0,3,2,0,5
75400,170,19054,24875;25430;27747;28432,54385,0,2,2,0,4
75401,170,19055,24881;24942,54385,0,0,2,0,2
75402,170,19056,24922;27220;27532;27921,54385,0,1,3,0,4
75403,170,19057,25037;28023;28221;28488,54385,0,3,1,0,4
75404,170,19058,24936;24988;28395;28486,54385,0,2,2,0,4
75405,170,19059,25262,54385,0,0,1,0,1
75406,170,19060,24865;24929;27722,54385,0,1,2,0,3
75407,170,19061,25132;25201;28406,54385,0,1,2,0,3
75408,170,19062,25067;25158;28134;28314,54385,0,2,2,0,4
75409,170,19063,25163;25209;28693,54385,0,1,2,0,3
75410,170,19064,24921;25169;27837,54385,0,1,2,0,3
75411,170,19065,25521;25552;27752;28249,54385,0,2,2,0,4
75412,170,19066,25477;25556;28707;28865,54385,1,1,2,0,4
75413,170,19067,25207;25543;28870;28965,54385,2,0,2,0,4
75414,170,19069,24907;25183;27544,54385,0,0,3,0,3
75415,170,19070,25107;25265;28039,54385,0,1,2,0,3
75416,170,19071,25299;25478;28044;28963,54385,1,1,2,0,4
75417,170,19072,20719,54750,0,0,0,1,1
75418,170,19073,21086,54750,0,0,0,1,1
75419,170,19075,20913,54750,0,0,0,1,1
75420,170,19076,20925,54750,0,0,0,1,1
75421,170,19077,20918;21204,54750,0,0,0,2,2
75422,170,19078,21006,54750,0,0,0,1,1
75423,170,19081,21856,54750,0,0,0,1,1
75424,170,19084,21986;22121,54750,0,0,0,2,2
75425,170,19090,21742,54750,0,0,0,1,1
75426,170,19098,22865;23331,54750,0,0,2,0,2
75427,170,19099,22925;23025,54750,0,0,2,0,2
75428,170,19108,23550;23605,54750,0,0,2,0,2
75429,170,19110,23682;23841;27169,54750,0,0,3,0,3
75430,170,19111,23578;23749;26886,54750,0,0,3,0,3
75431,170,19112,23871;24264;27190;27675,54750,0,1,3,0,4
75432,170,19113,23961;24492;27504;27991;28374,54750,0,2,3,0,5
75433,170,19116,23852;24091,54750,0,0,2,0,2
75434,170,19118,23796;24219,54750,0,0,2,0,2
75435,170,19119,24061;24071;27472,54750,0,0,3,0,3
75436,170,19120,24594;27210;27613;27707;27802,54750,0,2,3,0,5
75437,170,19121,24588;24776;27622;27718,54750,0,1,3,0,4
75438,170,19123,24269;24578;27998,54750,0,1,2,0,3
75439,170,19126,24468;24872;27219;27814;28213,54750,0,2,3,0,5
75440,170,19127,24631;27894,54750,0,1,1,0,2
75441,170,19128,24273;24552;27609;27799;28195,54750,0,2,3,0,5
75442,170,19131,24657;27899;28001,54750,0,2,1,0,3
75443,170,19132,24746;24790;27525,54750,0,0,3,0,3
75444,170,19133,24272;24752;27114;27806;28099;28290;29031,54750,1,3,3,0,7
75445,170,19135,24771;24869;27218,54750,0,0,3,0,3
75446,170,19136,24775;25145;27732;28133,54750,0,2,2,0,4
75447,170,19137,25215;27735,54750,0,1,1,0,2
75448,170,19138,25220;25532;28710;28964,54750,1,1,2,0,4
75449,170,19139,24959;25032,54750,0,0,2,0,2
75450,170,19140,24962;28483,54750,0,1,1,0,2
75451,170,19141,25432;28515;29136,54750,1,1,1,0,3
75452,170,19142,25019;27536,54750,0,0,2,0,2
75453,170,19143,25239;25410;27550;27952;28244;28607;28703,54750,0,4,3,0,7
75454,170,19144,25035;25645;29142,54750,1,0,2,0,3
75455,170,19145,25041;25370;27744;28510,54750,0,2,2,0,4
75456,170,19146,25054;25569;28621;28714;28873,54750,1,2,2,0,5
75457,170,19147,25164;25282;28415;28600;28696,54750,0,3,2,0,5
75458,170,19148,25084;25099;27831;28310;28589,54750,0,3,2,0,5
75459,170,19149,24913;25086;27322;28308;28767,54750,0,2,3,0,5
75460,170,19150,24938;25117;27935;28128,54750,0,2,2,0,4
75461,170,19151,25131;27730,54750,0,1,1,0,2
75462,170,19152,25143;25448;27749;28246,54750,0,2,2,0,4
75463,170,19153,25146;27542;28593,54750,0,1,2,0,3
75464,170,19154,25149;25470;28335;28614;28782,54750,0,3,2,0,5
75465,170,19155,25059;25165;27933;28223;28490;28686,54750,0,4,2,0,6
75466,170,19156,25174;25271,54750,0,0,2,0,2
75467,170,19157,25172;25176;27543;27937,54750,0,1,3,0,4
75468,170,19158,24832;25189;28229,54750,0,1,2,0,3
75469,170,19159,25223;25682;29055;29243,54750,2,0,2,0,4
75470,170,19160,25230;25424;28514;28704,54750,0,2,2,0,4
75471,170,19161,25399;25434,54750,0,0,2,0,2
75472,170,19162,25236;25295;27939;28412;28952,54750,1,2,2,0,5
75473,170,19164,25247;25373,54750,0,0,2,0,2
75474,170,19165,25402;25652,54750,0,0,2,0,2
75475,170,19166,25303;27740;28697;28775,54750,0,3,1,0,4
75476,170,19167,25433;27551,54750,0,0,2,0,2
75477,170,19168,25313;25611,54750,0,0,2,0,2
75478,170,19169,25314;28237;28321;29133,54750,1,2,1,0,4
75479,170,19170,25328;25484;27956,54750,0,1,2,0,3
75480,170,19171,25329;25758;27759;28802,54750,0,2,2,0,4
75481,170,19172,25334;25387;27332,54750,0,0,3,0,3
75482,170,19173,25340;25719;28445;28632;28975;29244,54750,2,2,2,0,6
75483,170,19174,25551;28713;29138,54750,1,1,1,0,3
75484,170,19175,25365;25549,54750,0,0,2,0,2
75485,170,19176,25310;25376;27745;28778,54750,0,2,2,0,4
75486,170,19177,25394;25638,54750,0,0,2,0,2
75487,170,19178,25066;25397;28423,54750,0,1,2,0,3
75488,170,19179,25398;27951,54750,0,1,1,0,2
75489,170,19180,25395;25400,54750,0,0,2,0,2
75490,170,19181,21229,55115,0,0,0,1,1
75491,170,19182,21182,55115,0,0,0,1,1
75492,170,19184,21156,55115,0,0,0,1,1
75493,170,19187,21410;21680,55115,0,0,0,2,2
75494,170,19190,21681,55115,0,0,0,1,1
75495,170,19192,21892,55115,0,0,0,1,1
75496,170,19193,22083,55115,0,0,0,1,1
75497,170,19194,21943,55115,0,0,0,1,1
75498,170,19205,23191,55115,0,0,1,0,1
75499,170,19211,23556;23930,55115,0,0,2,0,2
75500,170,19213,23828;24101,55115,0,0,2,0,2
75501,170,19219,23958,55115,0,0,1,0,1
75502,170,19220,24054,55115,0,0,1,0,1
75503,170,19221,24782;27528,55115,0,0,2,0,2
75504,170,19222,24312;25064;28123;28687;28945,55115,1,2,2,0,5
75505,170,19223,24424;24425;27687,55115,0,1,2,0,3
75506,170,19224,24373;24430;27603;27790;28189,55115,0,2,3,0,5
75507,170,19226,24544;24564;26609;27208;27702;27887,55115,0,2,4,0,6
75508,170,19227,24733;27212;28572,55115,0,1,2,0,3
75509,170,19228,25092;25306;28140;28503;28776;28953,55115,1,3,2,0,6
75510,170,19232,24659;25286;28501;28601,55115,0,2,2,0,4
75511,170,19233,24504;24742;27113;28203,55115,0,1,3,0,4
75512,170,19234,24210;24663;27412;28090,55115,0,1,3,0,4
75513,170,19235,25266;27547;28414,55115,0,1,2,0,3
75514,170,19236,24667;27618;27900,55115,0,1,2,0,3
75515,170,19239,24791;25428;28331;28430,55115,0,2,2,0,4
75516,170,19240,24842;25050,55115,0,0,2,0,2
75517,170,19241,24848;24853;28013;28106;28296,55115,0,3,2,0,5
75518,170,19242,24892;24902;28015;28101;28682,55115,0,3,2,0,5
75519,170,19243,24937;25069;27819;27923,55115,0,2,2,0,4
75520,170,19245,24461;24951;28112,55115,0,1,2,0,3
75521,170,19246,24968;25445;28333,55115,0,1,2,0,3
75522,170,19247,24901;25118;29129,55115,1,0,2,0,3
75523,170,19248,25036;25213;28232;29040,55115,1,1,2,0,4
75524,170,19249,25062;25170;27325;28494,55115,0,1,3,0,4
75525,170,19250,24794;25108;27541;27832;28027;28405;28492,55115,0,4,3,0,7
75526,170,19251,24813;25490,55115,0,0,2,0,2
75527,170,19253,25102;25204;27431;28127;28404;28491,55115,0,3,3,0,6
75528,170,19254,25212;25651;27961;28052;28343,55115,0,3,2,0,5
75529,170,19255,25252;27738;29042,55115,1,1,1,0,3
75530,170,19256,25253;25665,55115,0,0,2,0,2
75531,170,19257,25316;25612;28342,55115,0,1,2,0,3
75532,170,19258,25388;25681;28439;28798;29144;29242,55115,2,2,2,0,6
75533,170,19259,25391;25817;29153,55115,1,0,2,0,3
75534,170,19260,25393;25656;28881,55115,1,0,2,0,3
75535,170,19261,25437;25671;29241,55115,1,0,2,0,3
75536,170,19262,25348;25597;27648;27960;28967,55115,1,1,3,0,5
75537,170,19263,21237;21479,55480,0,0,0,2,2
75538,170,19267,21707,55480,0,0,0,1,1
75539,170,19268,21524,55480,0,0,0,1,1
75540,170,19269,21581,55480,0,0,0,1,1
75541,170,19272,22024,55480,0,0,0,1,1
75542,170,19277,22773,55480,0,0,1,0,1
75543,170,19281,22240;22426,55480,0,0,0,2,2
75544,170,19283,23275;23374,55480,0,0,2,0,2
75545,170,19288,23302;23558,55480,0,0,2,0,2
75546,170,19291,23897;24315,55480,0,0,2,0,2
75547,170,19293,24186;24333;27197;27601,55480,0,0,4,0,4
75548,170,19295,23879;24148,55480,0,0,2,0,2
75549,170,19296,24149;24695;27211;27905;28201;28674,55480,0,3,3,0,6
75550,170,19297,24332;24465;27099,55480,0,0,3,0,3
75551,170,19298,23875;24201;26997;27781;27978;28368,55480,0,3,3,0,6
75552,170,19300,24267;24466;27500,55480,0,0,3,0,3
75553,170,19302,24798;28100;28294,55480,0,2,1,0,3
75554,170,19303,24411;24756;27807;28474,55480,0,2,2,0,4
75555,170,19304,24704;27111;28571;28850,55480,1,1,2,0,4
75556,170,19305,24027;24215;27773;27866,55480,0,2,2,0,4
75557,170,19306,24517;24665;27885;28193,55480,0,2,2,0,4
75558,170,19307,25263;25317;28773,55480,0,1,2,0,3
75559,170,19308,24655;24864;27813;28760,55480,0,2,2,0,4
75560,170,19309,24686;24805;27911,55480,0,1,2,0,3
75561,170,19310,24546;24821;27811;28295;28851,55480,1,2,2,0,5
75562,170,19311,24883;25297,55480,0,0,2,0,2
75563,170,19312,24891;25251;28138,55480,0,1,2,0,3
75564,170,19313,24478;25072;27934,55480,0,1,2,0,3
75565,170,19314,24710;24954;27924;28580,55480,0,2,2,0,4
75566,170,19315,24728;25000;27929,55480,0,1,2,0,3
75567,170,19316,24762;25018;28397,55480,0,1,2,0,3
75568,170,19317,25031;25290;27823;27931;28220;28487,55480,0,4,2,0,6
75569,170,19319,25555;28521,55480,0,1,1,0,2
75570,170,19321,25006;25177;27535,55480,0,0,3,0,3
75571,170,19322,25186;25188;27327;28228;28496,55480,0,2,3,0,5
75572,170,19323,25258;25362;28324,55480,0,1,2,0,3
75573,170,19324,25259;25330;28857,55480,1,0,2,0,3
75574,170,19325,25272;25443;27548;27739;28319;28500,55480,0,3,3,0,6
75575,170,19326,25296;25298;28602;28858,55480,1,1,2,0,4
75576,170,19327,25346;28418;28956,55480,1,1,1,0,3
75577,170,19328,25371;25922;28161,55480,0,1,2,0,3
75578,170,19329,25198;25275;27839,55480,0,1,2,0,3
75579,170,19330,25415;25641;28877,55480,1,0,2,0,3
75580,170,19331,25232;25476;27954,55480,0,1,2,0,3
75581,170,19332,25582;25707;27846;28346;28716,55480,0,3,2,0,5
75582,170,19333,25288;25488;28336;28516,55480,0,2,2,0,4
75583,170,19334,25489;25523;28147;29051,55480,1,1,2,0,4
75584,170,19335,25498;25873;28534;28808,55480,0,2,2,0,4
75585,170,19336,25427;25515;27958,55480,0,1,2,0,3
75586,170,19337,25784;28448;28638;28979,55480,1,2,1,0,4
75587,170,19338,25675;25849;27965;28260;28532;28725;29061,55480,1,4,2,0,7
75588,170,19339,25565;25693;28441,55480,0,1,2,0,3
75589,170,19340,25571;25643;28969,55480,1,0,2,0,3
75590,170,19341,25727;25862;28349;28987;29256,55480,2,1,2,0,5
75591,170,19342,25525;25579;28436,55480,0,1,2,0,3
75592,170,19343,25195;25670;28627;28796,55480,0,2,2,0,4
75593,170,19344,25686;25822;27963;28257;28985,55480,1,2,2,0,5
75594,170,19345,25878;28726,55480,0,1,1,0,2
75595,170,19346,25833,55480,0,0,1,0,1
75596,170,19347,25596;27435,55480,0,0,2,0,2
75597,170,19348,25621;25792;28641,55480,0,1,2,0,3
75598,170,19351,21302,55845,0,0,0,1,1
75599,170,19354,21783,55845,0,0,0,1,1
75600,170,19358,21745,55845,0,0,0,1,1
75601,170,19359,22119,55845,0,0,0,1,1
75602,170,19361,22146,55845,0,0,0,1,1
75603,170,19362,22096,55845,0,0,0,1,1
75604,170,19363,22315,55845,0,0,0,1,1
75605,170,19364,22337,55845,0,0,0,1,1
75606,170,19366,22164,55845,0,0,0,1,1
75607,170,19370,22481,55845,0,0,0,1,1
75608,170,19375,22874,55845,0,0,1,0,1
75609,170,19378,23423;24002;27072,55845,0,0,3,0,3
75610,170,19379,23648;23755;27266,55845,0,0,3,0,3
75611,170,19388,23919;24286,55845,0,0,2,0,2
75612,170,19389,23889;24316;26708;27679;28187,55845,0,2,3,0,5
75613,170,19391,23943;24079,55845,0,0,2,0,2
75614,170,19392,24117;24294;27598,55845,0,0,3,0,3
75615,170,19393,24604;28380,55845,0,1,1,0,2
75616,170,19395,24462;24482;27008;27100;27694;27793;28373;29314,55845,1,3,4,0,8
75617,170,19396,24511;24799;27509,55845,0,0,3,0,3
75618,170,19397,24648;25285,55845,0,0,2,0,2
75619,170,19398,24414;24687;27522;28471,55845,0,1,3,0,4
75620,170,19399,24690;24868;27018;28761,55845,0,1,3,0,4
75621,170,19400,24734;24956;26827;27925;28299,55845,0,2,3,0,5
75622,170,19404,24257;24862,55845,0,0,2,0,2
75623,170,19405,24371;24467,55845,0,0,2,0,2
75624,170,19406,25359;28859,55845,1,0,1,0,2
75625,170,19407,24725;25048;28765,55845,0,1,2,0,3
75626,170,19408,24915;25065,55845,0,0,2,0,2
75627,170,19409,25029;25068;27634;27825,55845,0,1,3,0,4
75628,170,19410,25076;25122;27321;28124,55845,0,1,3,0,4
75629,170,19411,25116;25134;27731,55845,0,1,2,0,3
75630,170,19412,25135;25140;27227;28591;28691;28755,55845,0,3,3,0,6
75631,170,19413,25161;25442;28042;28332;29047,55845,1,2,2,0,5
75632,170,19414,25250;25816;28058;28347;28984,55845,1,2,2,0,5
75633,170,19415,24491;25175;28135,55845,0,1,2,0,3
75634,170,19416,24866;25192;28230;28768,55845,0,2,2,0,4
75635,170,19417,25486;28248,55845,0,1,1,0,2
75636,170,19418,24871;25233,55845,0,0,2,0,2
75637,170,19419,25248;25720;28633,55845,0,1,2,0,3
75638,170,19420,25254;29131,55845,1,0,1,0,2
75639,170,19421,25261;26023;28995,55845,1,0,2,0,3
75640,170,19422,26027;28165;29074,55845,1,1,1,0,3
75641,170,19423,25425;25577;28149;28435;28622;29052,55845,1,3,2,0,6
75642,170,19424,25167;25650;28152;28625;28972,55845,1,2,2,0,5
75643,170,19426,25106;25358;27840;28323;28509,55845,0,3,2,0,5
75644,170,19427,25886;25930;28730;29066,55845,1,1,2,0,4
75645,170,19428,25374;25705;28443,55845,0,1,2,0,3
75646,170,19430,25456;25739,55845,0,0,2,0,2
75647,170,19431,25462;25469;28962,55845,1,0,2,0,3
75648,170,19432,25482;27955;28616;28866;29137,55845,2,2,1,0,5
75649,170,19433,25021;25512;28047;28619,55845,0,2,2,0,4
75650,170,19434,25129;25517;28785;29236,55845,1,1,2,0,4
75651,170,19435,25519;25756;28447,55845,0,1,2,0,3
75652,170,19436,25211;25500;27646;28045;28337;29235,55845,1,2,3,0,6
75653,170,19437,25533;25729;29148,55845,1,0,2,0,3
75654,170,19438,25405;27642;28328,55845,0,1,2,0,3
75655,170,19439,25323;25545,55845,0,0,2,0,2
75656,170,19440,25624;25861;28159,55845,0,1,2,0,3
75657,170,19441,25480;28708,55845,0,1,1,0,2
75658,170,19442,26005;28541;28733;28899,55845,1,2,1,0,4
75659,170,19444,25629;25900,55845,0,0,2,0,2
75660,170,19445,25635;25855;28807;29157;29254,55845,2,1,2,0,5
75661,170,19446,25154;25710;28053;28253;28528;28882;29146,55845,2,3,2,0,7
75662,170,19447,25655;25771;27555;27844;28526,55845,0,2,3,0,5
75663,170,19448,25503;25683;28252;29056,55845,1,1,2,0,4
75664,170,19449,25708;26018;29169,55845,1,0,2,0,3
75665,170,19450,25718;25945;29262,55845,1,0,2,0,3
75666,170,19451,21488,56210,0,0,0,1,1
75667,170,19452,21537,56210,0,0,0,1,1
75668,170,19453,21559,56210,0,0,0,1,1
75669,170,19454,21599;21668,56210,0,0,0,2,2
75670,170,19455,21528,56210,0,0,0,1,1
75671,170,19459,22037,56210,0,0,0,1,1
75672,170,19460,21648,56210,0,0,0,1,1
75673,170,19468,22677,56210,0,0,0,1,1
75674,170,19469,22427,56210,0,0,0,1,1
75675,170,19470,22680,56210,0,0,0,1,1
75676,170,19478,23903,56210,0,0,1,0,1
75677,170,19482,23941;24268;28175,56210,0,1,2,0,3
75678,170,19483,23944;27067;27580;27658;27771,56210,0,2,3,0,5
75679,170,19484,24347;24427;27880,56210,0,1,2,0,3
75680,170,19485,24050;24555,56210,0,0,2,0,2
75681,170,19487,24251;24766;27017;28291,56210,0,1,3,0,4
75682,170,19488,24351;24445;27201;27497,56210,0,0,4,0,4
75683,170,19489,24301;24481;27792;28080,56210,0,2,2,0,4
75684,170,19490,24587;24916;28854,56210,1,0,2,0,3
75685,170,19491,24557;25057;27633;27728,56210,0,1,3,0,4
75686,170,19493,24641;24974;27020;27928,56210,0,1,3,0,4
75687,170,19494,24524;24857;27531;27721,56210,0,1,3,0,4
75688,170,19498,24923,56210,0,0,1,0,1
75689,170,19499,24768;24999,56210,0,0,2,0,2
75690,170,19500,25339;25472;27645,56210,0,0,3,0,3
75691,170,19501,24596;24895;28215,56210,0,1,2,0,3
75692,170,19502,25033;25414;27841,56210,0,1,2,0,3
75693,170,19503,24997;25342;27741;27947;28240;28506,56210,0,4,2,0,6
75694,170,19504,25011;26936;29221,56210,1,0,2,0,3
75695,170,19505,25039;25644;27755;28878;28970;29141,56210,3,1,2,0,6
75696,170,19507,25103;25105,56210,0,0,2,0,2
75697,170,19511,25153;25572,56210,0,0,2,0,2
75698,170,19512,24846;25205,56210,0,0,2,0,2
75699,170,19513,25241;25268;27942;28599,56210,0,2,2,0,4
75700,170,19514,25447;25685,56210,0,0,2,0,2
75701,170,19515,25392;28422;28512;29044,56210,1,2,1,0,4
75702,170,19517,25375;27331;27434;28605;28700,56210,0,2,3,0,5
75703,170,19518,25386;25468;28043;28247;28863,56210,1,2,2,0,5
75704,170,19519,24927;25418;27333;28329;28513;29135,56210,1,2,3,0,6
75705,170,19520,25431;25679;28344;28797,56210,0,2,2,0,4
75706,170,19521,25307;25439;27748;28780,56210,0,2,2,0,4
75707,170,19522,24898;25446;28862,56210,1,0,2,0,3
75708,170,19523,25449;28334;28961,56210,1,1,1,0,3
75709,170,19524,25458,56210,0,0,1,0,1
75710,170,19525,25460;25827;28451;29155,56210,1,1,2,0,4
75711,170,19526,25526;25882;27557;28810;29062,56210,1,1,3,0,5
75712,170,19527,25585;26138;28548;28908,56210,1,1,2,0,4
75713,170,19529,25320;25625;27433;28141;28238,56210,0,2,3,0,5
75714,170,19530,25632;26054,56210,0,0,2,0,2
75715,170,19531,25647;25894,56210,0,0,2,0,2
75716,170,19532,25649;25891;28160;29063,56210,1,1,2,0,4
75717,170,19533,25985;28063;29167,56210,1,1,1,0,3
75718,170,19534,25672;25757,56210,0,0,2,0,2
75719,170,19535,25674;25946;28536;28992,56210,1,1,2,0,4
75720,170,19536,25712;25918;28535,56210,0,1,2,0,3
75721,170,19537,25760;28719;29059,56210,1,1,1,0,3
75722,170,19538,25795;26034;29266,56210,1,0,2,0,3
75723,170,19539,25797;25802;28722,56210,0,1,2,0,3
75724,170,19540,25774;25805;29150,56210,1,0,2,0,3
75725,170,19541,25806;26026;28647;28996,56210,1,1,2,0,4
75726,170,19542,25688;25810,56210,0,0,2,0,2
75727,170,19543,25318;25811,56210,0,0,2,0,2
75728,170,19544,21573,56575,0,0,0,1,1
75729,170,19545,21857,56575,0,0,0,1,1
75730,170,19546,21732,56575,0,0,0,1,1
75731,170,19547,21398,56575,0,0,0,1,1
75732,170,19548,21806,56575,0,0,0,1,1
75733,170,19550,21977,56575,0,0,0,1,1
75734,170,19551,21920,56575,0,0,0,1,1
75735,170,19552,21834,56575,0,0,0,1,1
75736,170,19553,21576,56575,0,0,0,1,1
75737,170,19557,22143,56575,0,0,0,1,1
75738,170,19558,22211;22412,56575,0,0,0,2,2
75739,170,19559,22233,56575,0,0,0,1,1
75740,170,19560,21809,56575,0,0,0,1,1
75741,170,19562,22145,56575,0,0,0,1,1
75742,170,19563,22428,56575,0,0,0,1,1
75743,170,19567,22318,56575,0,0,0,1,1
75744,170,19568,22991,56575,0,0,1,0,1
75745,170,19569,23141,56575,0,0,1,0,1
75746,170,19572,22855,56575,0,0,1,0,1
75747,170,19576,23684;24140,56575,0,0,2,0,2
75748,170,19579,23453;23767;27350,56575,0,0,3,0,3
75749,170,19580,23467;27566,56575,0,0,2,0,2
75750,170,19581,24836;26615;28210,56575,0,1,2,0,3
75751,170,19583,23940;24035,56575,0,0,2,0,2
75752,170,19587,24380,56575,0,0,1,0,1
75753,170,19590,24397;24538;27798;27995,56575,0,2,2,0,4
75754,170,19592,24110,56575,0,0,1,0,1
75755,170,19595,24903;25353,56575,0,0,2,0,2
75756,170,19597,24932;25190;27639;28035,56575,0,1,3,0,4
75757,170,19598,24966;27820;27926,56575,0,2,1,0,3
75758,170,19599,25007;25217;27545;28498;28950,56575,1,1,3,0,5
75759,170,19600,25369;28242;28325;28860,56575,1,2,1,0,4
75760,170,19601,24605,56575,0,0,1,0,1
75761,170,19602,25087;27635;28585,56575,0,1,2,0,3
75762,170,19603,24654;27617;27897;28089,56575,0,2,2,0,4
75763,170,19604,24981;25147;28031,56575,0,1,2,0,3
75764,170,19605,25235;25514;29050,56575,1,0,2,0,3
75765,170,19606,25185;28410;28594;29039,56575,1,2,1,0,4
75766,170,19609,25646;25723;28879;28971,56575,2,0,2,0,4
75767,170,19610,25542;25566;28620,56575,0,1,2,0,3
75768,170,19611,25407;28041;28424,56575,0,2,1,0,3
75769,170,19612,25501;25714,56575,0,0,2,0,2
75770,170,19613,25014,56575,0,0,1,0,1
75771,170,19614,25351;25711;28529,56575,0,1,2,0,3
75772,170,19615,25094;25377;27746;28144;28511;28606,56575,0,4,2,0,6
75773,170,19616,25380;25691;27757;28153,56575,0,2,2,0,4
75774,170,19617,25278;25409;28426;28702,56575,0,2,2,0,4
75775,170,19618,25240;25411;28427,56575,0,1,2,0,3
75776,170,19619,25231;25422;28429;28609;29046,56575,1,2,2,0,5
75777,170,19620,25423;25492;27643;28861,56575,1,0,3,0,4
75778,170,19621,25459;26073;28456,56575,0,1,2,0,3
75779,170,19622,25973;28163;29264,56575,1,1,1,0,3
75780,170,19623,25547;25989;28540,56575,0,1,2,0,3
75781,170,19624,25605;25933;28731;28990;29261,56575,2,1,2,0,5
75782,170,19625,25669;28795,56575,0,1,1,0,2
75783,170,19626,25574;25684;27754;28874,56575,1,1,2,0,4
75784,170,19627,25636;25998;28994,56575,1,0,2,0,3
75785,170,19628,25575;26170;29083;29276,56575,2,0,2,0,4
75786,170,19629,26047;26144;28821,56575,0,1,2,0,3
75787,170,19630,25713;25966;29164;29263,56575,2,0,2,0,4
75788,170,19631,25737;29247,56575,1,0,1,0,2
75789,170,19632,25775;25875;29257,56575,1,0,2,0,3
75790,170,19633,25780;26124;29180;29274,56575,2,0,2,0,4
75791,170,19634,25959;26137,56575,0,0,2,0,2
75792,170,19635,25576,56575,0,0,1,0,1
75793,170,19636,25831;26182,56575,0,0,2,0,2
75794,170,19637,25834;25859,56575,0,0,2,0,2
75795,170,19638,25857;26165;28823;29181,56575,1,1,2,0,4
75796,170,19639,25908;26142;28820,56575,0,1,2,0,3
75797,170,19640,21666,56940,0,0,0,1,1
75798,170,19641,21701,56940,0,0,0,1,1
75799,170,19642,21108,56940,0,0,0,1,1
75800,170,19643,21888;22343,56940,0,0,0,2,2
75801,170,19644,22202;22722,56940,0,0,0,2,2
75802,170,19646,21923,56940,0,0,0,1,1
75803,170,19647,22612,56940,0,0,0,1,1
75804,170,19648,22690,56940,0,0,0,1,1
75805,170,19649,22771,56940,0,0,0,1,1
75806,170,19650,22821,56940,0,0,1,0,1
75807,170,19652,22944;22958,56940,0,0,2,0,2
75808,170,19660,23043,56940,0,0,1,0,1
75809,170,19666,24036;24488;27696;27882;28278;28468,56940,0,4,2,0,6
75810,170,19670,24196;24362;27492;27602;27875,56940,0,1,4,0,5
75811,170,19671,24233;24664;27521;27713;28091,56940,0,2,3,0,5
75812,170,19673,23984;23993,56940,0,0,2,0,2
75813,170,19677,24593,56940,0,0,1,0,1
75814,170,19679,24726;25046;28024;28121;28401;28489;28764,56940,0,5,2,0,7
75815,170,19680,24475;24590;28371,56940,0,1,2,0,3
75816,170,19681,24807;24992;27810;27912,56940,0,2,2,0,4
75817,170,19682,24816;25002,56940,0,0,2,0,2
75818,170,19684,24940;25510;28046;28338,56940,0,2,2,0,4
75819,170,19686,25082;25382;28243,56940,0,1,2,0,3
75820,170,19687,25123;25584;28790,56940,0,1,2,0,3
75821,170,19688,25125;25326;27946;28777,56940,0,2,2,0,4
75822,170,19689,25237;27940;29041,56940,1,1,1,0,3
75823,170,19690,25226;25454;28146;28613,56940,0,2,2,0,4
75824,170,19691,25044;25344;27231;27742;27948;28241;28322;28507,56940,0,5,3,0,8
75825,170,19692,25347,56940,0,0,1,0,1
75826,170,19693,25383;25600;28051;28340;28623,56940,0,3,2,0,5
75827,170,19694,25403;25770,56940,0,0,2,0,2
75828,170,19695,25396;25426;27950,56940,0,1,2,0,3
75829,170,19696,25435;25496;28611;28706,56940,0,2,2,0,4
75830,170,19697,25179;25440;27644;28145;28612;28960,56940,1,2,3,0,6
75831,170,19698,25466;25915;28728;28892,56940,1,1,2,0,4
75832,170,19699,25538;28048;28869,56940,1,1,1,0,3
75833,170,19700,25419;25513;27957;28517;28784;29049,56940,1,3,2,0,6
75834,170,19701,25453;25520;27751;28709;29237,56940,1,2,2,0,5
75835,170,19702,25604;25753;28718;29149,56940,1,1,2,0,4
75836,170,19703,25626;25845,56940,0,0,2,0,2
75837,170,19705,25485,56940,0,0,1,0,1
75838,170,19706,26151,56940,0,0,1,0,1
75839,170,19707,26102;29178,56940,1,0,1,0,2
75840,170,19708,25616;25738;27688;28792,56940,0,2,2,0,4
75841,170,19709,25633;25788;28255,56940,0,1,2,0,3
75842,170,19710,25818;26278;29006,56940,1,0,2,0,3
75843,170,19711,25819;26097;28904;29177,56940,2,0,2,0,4
75844,170,19712,25826;26113;28157;28888;29154,56940,2,1,2,0,5
75845,170,19713,25880;25914;29160,56940,1,0,2,0,3
75846,170,19714,25573,56940,0,0,1,0,1
75847,170,19715,25947;28537;28894;29069,56940,2,1,1,0,4
75848,170,19716,25696;25948;27967;28162,56940,0,2,2,0,4
75849,170,19717,26059;26131;28166,56940,0,1,2,0,3
75850,170,19718,25958;26145;28822,56940,0,1,2,0,3
75851,170,19719,25578;25987;27852;28898,56940,1,1,2,0,4
75852,170,19720,25796;26016;29265,56940,1,0,2,0,3
75853,170,19723,21862,57305,0,0,0,1,1
75854,170,19726,22460,57305,0,0,0,1,1
75855,170,19728,22590,57305,0,0,0,1,1
75856,170,19729,22639,57305,0,0,0,1,1
75857,170,19733,23032,57305,0,0,1,0,1
75858,170,19736,23213,57305,0,0,1,0,1
75859,170,19737,23122,57305,0,0,1,0,1
75860,170,19738,23081,57305,0,0,1,0,1
75861,170,19743,23580;23658,57305,0,0,2,0,2
75862,170,19744,23549;24229,57305,0,0,2,0,2
75863,170,19747,23904;24150;26800;27478,57305,0,0,4,0,4
75864,170,19748,23968,57305,0,0,1,0,1
75865,170,19750,24969;25202;28316;28411,57305,0,2,2,0,4
75866,170,19752,24815,57305,0,0,1,0,1
75867,170,19754,24666,57305,0,0,1,0,1
75868,170,19756,24616;24851;27530;27812,57305,0,1,3,0,4
75869,170,19759,24471;24516,57305,0,0,2,0,2
75870,170,19760,25049;25242,57305,0,0,2,0,2
75871,170,19761,25148;25184,57305,0,0,2,0,2
75872,170,19762,25085;25234;27546,57305,0,0,3,0,3
75873,170,19763,25243;25294;27737;28499,57305,0,2,2,0,4
75874,170,19764,24763;25257;28413;28695,57305,0,2,2,0,4
75875,170,19765,25273;25527;28519,57305,0,1,2,0,3
75876,170,19766,25277;25336,57305,0,0,2,0,2
75877,170,19767,25504;27750;28618;28867,57305,1,2,1,0,4
75878,170,19768,25331;25506,57305,0,0,2,0,2
75879,170,19769,24611;25012;28283,57305,0,1,2,0,3
75880,170,19770,25493;25741;28883,57305,1,0,2,0,3
75881,170,19771,24953;25368;27549;27743;28040;28143;28604,57305,0,4,3,0,7
75882,170,19772,25245;25384;27949;28326;29043,57305,1,2,2,0,5
75883,170,19773,25412;25420;28428;28958,57305,1,1,2,0,4
75884,170,19774,25264;25421;28330;28608;29045,57305,1,2,2,0,5
75885,170,19775,25473,57305,0,0,1,0,1
75886,170,19776,25558;25931,57305,0,0,2,0,2
75887,170,19777,25564;25639;28151;28437;29140,57305,1,2,2,0,5
75888,170,19778,25695;25904;27649,57305,0,0,3,0,3
75889,170,19779,25581;25721,57305,0,0,2,0,2
75890,170,19780,25744;28717;29058,57305,1,1,1,0,3
75891,170,19781,25457;25790;28640;29151,57305,1,1,2,0,4
75892,170,19782,25536;25618;28715,57305,0,1,2,0,3
75893,170,19783,25559;25619;28150;29139;29240,57305,2,1,2,0,5
75894,170,19784,25615;25640;28793,57305,0,1,2,0,3
75895,170,19785,25662;26231;27969;28552,57305,0,2,2,0,4
75896,170,19786,25763;25841;28158;28348;29060;29253,57305,2,2,2,0,6
75897,170,19787,25613;25967;28453;28896,57305,1,1,2,0,4
75898,170,19788,25830;25982;28355;28897,57305,1,1,2,0,4
75899,170,19789,25663;25835;27962,57305,0,1,2,0,3
75900,170,19790,25361;25836;29251,57305,1,0,2,0,3
75901,170,19791,26234;29189,57305,1,0,1,0,2
75902,170,19792,25659;25848;27652;28059;28259;28644,57305,0,3,3,0,6
75903,170,19793,25869;26355,57305,0,0,2,0,2
75904,170,19794,25884;26120;28736;29179,57305,1,1,2,0,4
75905,170,19796,25907;26220,57305,0,0,2,0,2
75906,170,19797,26384;28660,57305,0,1,1,0,2
75907,170,19798,25926;26071,57305,0,0,2,0,2
75908,170,19799,25759;25935,57305,0,0,2,0,2
75909,170,19800,25955;26077;29076;29270,57305,2,0,2,0,4
75910,170,19801,25794;25990;29168,57305,1,0,2,0,3
75911,170,19802,25509;25991,57305,0,0,2,0,2
75912,170,19803,25865;25999,57305,0,0,2,0,2
75913,170,19804,26003;26332;28923,57305,1,0,2,0,3
75914,170,19805,25441;26022,57305,0,0,2,0,2
75915,170,19806,26029;26198,57305,0,0,2,0,2
75916,170,19807,26063;26272;28656;28745;29005,57305,1,2,2,0,5
75917,170,19808,26072;26260;28827;29283,57305,1,1,2,0,4
75918,170,19809,26076;26167,57305,0,0,2,0,2
75919,170,19810,26107;26148,57305,0,0,2,0,2
75920,170,19811,25916;26134;28819,57305,0,1,2,0,3
75921,170,19812,26136;26313;28555;28830,57305,0,2,2,0,4
75922,170,19813,21863,57670,0,0,0,1,1
75923,170,19814,22000,57670,0,0,0,1,1
75924,170,19815,21750,57670,0,0,0,1,1
75925,170,19817,22277,57670,0,0,0,1,1
75926,170,19818,22299,57670,0,0,0,1,1
75927,170,19820,22182,57670,0,0,0,1,1
75928,170,19821,22175;22462,57670,0,0,0,2,2
75929,170,19824,22863,57670,0,0,1,0,1
75930,170,19825,22789,57670,0,0,1,0,1
75931,170,19826,22843,57670,0,0,1,0,1
75932,170,19828,22960;23539,57670,0,0,2,0,2
75933,170,19830,23343,57670,0,0,1,0,1
75934,170,19833,23847;24077;25917;27574,57670,0,0,4,0,4
75935,170,19840,24256;24374,57670,0,0,2,0,2
75936,170,19842,24543,57670,0,0,1,0,1
75937,170,19843,24532;25058;28122,57670,0,1,2,0,3
75938,170,19844,24635,57670,0,0,1,0,1
75939,170,19846,24784;27115;27809;28293;28475,57670,0,3,2,0,5
75940,170,19847,24772;25034;27631;28399;28584,57670,0,2,3,0,5
75941,170,19848,24979;28114;28218,57670,0,2,1,0,3
75942,170,19852,24984;25124;27432;28030;28129;28311,57670,0,3,3,0,6
75943,170,19853,25224;25481;28771,57670,0,1,2,0,3
75944,170,19855,24779;25095;28025;28126,57670,0,2,2,0,4
75945,170,19856,25120;25267,57670,0,0,2,0,2
75946,170,19858,25053;25150;27836;29233,57670,1,1,2,0,4
75947,170,19859,25609;28341;28523,57670,0,2,1,0,3
75948,170,19860,25322;25408;28425;28701,57670,0,2,2,0,4
75949,170,19861,24950;25557,57670,0,0,2,0,2
75950,170,19862,25335;25451;29134,57670,1,0,2,0,3
75951,170,19863,25450;26101;28357;28457;28543;28905;29272,57670,2,3,2,0,7
75952,170,19866,25292;25546;28049;28712;28871,57670,1,2,2,0,5
75953,170,19867,25563;25740;28155;28800,57670,0,2,2,0,4
75954,170,19868,25580;25812,57670,0,0,2,0,2
75955,170,19869,25587;25846;28986,57670,1,0,2,0,3
75956,170,19870,25863;28262,57670,0,1,1,0,2
75957,170,19872,25634;25813;27847;28805;28887;29250,57670,2,2,2,0,6
75958,170,19873,25928;26489;28363;28559,57670,0,2,2,0,4
75959,170,19874,25839;28643;29252,57670,1,1,1,0,3
75960,170,19875,25694;25872,57670,0,0,2,0,2
75961,170,19876,25781;25887;28811;28891,57670,1,1,2,0,4
75962,170,19877,25853;28806;28890,57670,1,1,1,0,3
75963,170,19878,26422;26475,57670,0,0,2,0,2
75964,170,19879,25495;25906;28988;29065;29259,57670,3,0,2,0,5
75965,170,19880,25807;25912;28727,57670,0,1,2,0,3
75966,170,19881,25943,57670,0,0,1,0,1
75967,170,19882,25940;25977,57670,0,0,2,0,2
75968,170,19883,25786;25954;28062;29070,57670,1,1,2,0,4
75969,170,19884,25957;26411;28832,57670,0,1,2,0,3
75970,170,19885,25890;26267,57670,0,0,2,0,2
75971,170,19886,25436;25994,57670,0,0,2,0,2
75972,170,19887,25923;26287;29191,57670,1,0,2,0,3
75973,170,19888,26245;28743;29281,57670,1,1,1,0,3
75974,170,19889,25866;26066,57670,0,0,2,0,2
75975,170,19890,25773;26140;28549,57670,0,1,2,0,3
75976,170,19891,26092;26469,57670,0,0,2,0,2
75977,170,19892,26326,57670,0,0,1,0,1
75978,170,19893,26312;26486;28661,57670,0,1,2,0,3
75979,170,19894,26116;26158;27761;28545;29078;29273,57670,2,2,2,0,6
75980,170,19895,26118;26472;29013,57670,1,0,2,0,3
75981,170,19896,26128;26249;28358;29000,57670,1,1,2,0,4
75982,170,19897,26154;26505,57670,0,0,2,0,2
75983,170,19898,26045;26179;28167;28654,57670,0,2,2,0,4
75984,170,19899,25829;25920;27848,57670,0,1,2,0,3
75985,170,19900,26218,57670,0,0,1,0,1
75986,170,19901,26228;26318;28826,57670,0,1,2,0,3
75987,170,19902,26230;26507;28931,57670,1,0,2,0,3
75988,170,19903,26025;26239;28742;29089,57670,1,1,2,0,4
75989,170,19904,21845,58035,0,0,0,1,1
75990,170,19905,22316,58035,0,0,0,1,1
75991,170,19908,22804,58035,0,0,1,0,1
75992,170,19909,22095,58035,0,0,0,1,1
75993,170,19911,23090,58035,0,0,1,0,1
75994,170,19914,23245,58035,0,0,1,0,1
75995,170,19916,22854,58035,0,0,1,0,1
75996,170,19925,24381,58035,0,0,1,0,1
75997,170,19928,24206;24834;27216;27419;28477;29033,58035,1,1,4,0,6
75998,170,19929,24225;24493;28081;28279,58035,0,2,2,0,4
75999,170,19930,24394;24434;26814;28190,58035,0,1,3,0,4
76000,170,19931,24402;24628;27710,58035,0,1,2,0,3
76001,170,19937,25013;25304;28236;28417,58035,0,2,2,0,4
76002,170,19938,25028;25173;27326;28227;28495,58035,0,2,3,0,5
76003,170,19939,24765;25052;27225,58035,0,0,3,0,3
76004,170,19940,24802;25196;28769,58035,0,1,2,0,3
76005,170,19941,25214;25333;28497,58035,0,1,2,0,3
76006,170,19942,25463;25642;28781;29048,58035,1,1,2,0,4
76007,170,19944,26079;26121;28265,58035,0,1,2,0,3
76008,170,19945,25379;28421;28957,58035,1,1,1,0,3
76009,170,19947,25877,58035,0,0,1,0,1
76010,170,19948,25631;25903;27966;28452;29064;29159;29258,58035,3,2,2,0,7
76011,170,19949,25648;25673;28438;28973,58035,1,1,2,0,4
76012,170,19950,25475;25921,58035,0,0,2,0,2
76013,170,19951,25689;25785;29145,58035,1,0,2,0,3
76014,170,19952,25716;26201,58035,0,0,2,0,2
76015,170,19953,25733;25837,58035,0,0,2,0,2
76016,170,19954,25764;28056,58035,0,1,1,0,2
76017,170,19955,25768;26163;28738;28910,58035,1,1,2,0,4
76018,170,19956,25726;25801;28154;28446;28976;29245,58035,2,2,2,0,6
76019,170,19957,25401;25804;27651;28450;28983;29152,58035,2,1,3,0,6
76020,170,19958,25814;25975;28354;29165,58035,1,1,2,0,4
76021,170,19959,25854;26015;28065;28734,58035,0,2,2,0,4
76022,170,19960,25856;26046;28817,58035,0,1,2,0,3
76023,170,19961,25668;25879;28809,58035,0,1,2,0,3
76024,170,19962,25909;26316,58035,0,0,2,0,2
76025,170,19963,25724,58035,0,0,1,0,1
76026,170,19964,26458;28558,58035,0,1,1,0,2
76027,170,19965,25953;26367;29291,58035,1,0,2,0,3
76028,170,19966,26030;26086;28542,58035,0,1,2,0,3
76029,170,19967,26043;26464;28750,58035,0,1,2,0,3
76030,170,19968,26051;26290;28169;28267,58035,0,2,2,0,4
76031,170,19969,26105;26319;29093;29193;29285,58035,3,0,2,0,5
76032,170,19970,26067;26560,58035,0,0,2,0,2
76033,170,19971,26075,58035,0,0,1,0,1
76034,170,19972,25838;26108;28544;28906,58035,1,1,2,0,4
76035,170,19973,26132;26349;29289,58035,1,0,2,0,3
76036,170,19974,26146;28359;29080,58035,1,1,1,0,3
76037,170,19975,25730;25735;28054;28530;28635;28799,58035,0,4,2,0,6
76038,170,19976,26017;26189;28551;28913;29002;29279,58035,3,1,2,0,6
76039,170,19977,26193;28914;29003,58035,2,0,1,0,3
76040,170,19978,26194;26283;28746,58035,0,1,2,0,3
76041,170,19979,26195;26200;29085,58035,1,0,2,0,3
76042,170,19980,26205,58035,0,0,1,0,1
76043,170,19981,26209;26446,58035,0,0,2,0,2
76044,170,19982,26156;26210;29004,58035,1,0,2,0,3
76045,170,19984,26241;26548,58035,0,0,2,0,2
76046,170,19985,25992;26262;29284,58035,1,0,2,0,3
76047,170,19986,22056,58400,0,0,0,1,1
76048,170,19987,22100,58400,0,0,0,1,1
76049,170,19988,21757,58400,0,0,0,1,1
76050,170,19989,22232,58400,0,0,0,1,1
76051,170,19990,22385,58400,0,0,0,1,1
76052,170,19991,22479,58400,0,0,0,1,1
76053,170,19993,22596,58400,0,0,0,1,1
76054,170,19995,22646,58400,0,0,0,1,1
76055,170,19998,22856,58400,0,0,1,0,1
76056,170,20001,22910;22945,58400,0,0,2,0,2
76057,170,20002,23323,58400,0,0,1,0,1
76058,170,20006,23054,58400,0,0,1,0,1
76059,170,20008,23354;23398,58400,0,0,2,0,2
76060,170,20016,24501;25079;26937;27827;28403;29116,58400,1,2,3,0,6
76061,170,20017,24223;24358,58400,0,0,2,0,2
76062,170,20018,24570;24885;27122,58400,0,0,3,0,3
76063,170,20019,24489,58400,0,0,1,0,1
76064,170,20020,24369;24645;28672,58400,0,1,2,0,3
76065,170,20021,24650,58400,0,0,1,0,1
76066,170,20024,25009;25416;27953;28779,58400,0,2,2,0,4
76067,170,20026,25586;25620;28251;28524,58400,0,2,2,0,4
76068,170,20027,25308;25590;28339;28966,58400,1,1,2,0,4
76069,170,20028,25126;25315;28699,58400,0,1,2,0,3
76070,170,20029,25325,58400,0,0,1,0,1
76071,170,20030,25160;25390;28327,58400,0,1,2,0,3
76072,170,20031,25367;25465,58400,0,0,2,0,2
76073,170,20032,24841;25191;28595,58400,0,1,2,0,3
76074,170,20033,25238,58400,0,0,1,0,1
76075,170,20034,25667;27756;28626,58400,0,2,1,0,3
76076,170,20035,25363;25570;27552,58400,0,0,3,0,3
76077,170,20036,25560;28434,58400,0,1,1,0,2
76078,170,20037,25537;25840;28724;28889;29156,58400,2,1,2,0,5
76079,170,20038,25562;26233,58400,0,0,2,0,2
76080,170,20039,25256;25598;27842;28050,58400,0,2,2,0,4
76081,170,20040,25507;25617,58400,0,0,2,0,2
76082,170,20041,25301;25355;28142;28419,58400,0,2,2,0,4
76083,170,20042,25658;26080;28649,58400,0,1,2,0,3
76084,170,20043,25583;25697;28630,58400,0,1,2,0,3
76085,170,20044,25745;25798;28801,58400,0,1,2,0,3
76086,170,20045,25530;25746;28254;28636;28885,58400,1,2,2,0,5
76087,170,20047,25832;28538,58400,0,1,1,0,2
76088,170,20048,26011;26213;27968,58400,0,1,2,0,3
76089,170,20049,25864;25901;28352,58400,0,1,2,0,3
76090,170,20050,25927;26061;28997;29173;29269,58400,3,0,2,0,5
76091,170,20051,25803;25949;28645,58400,0,1,2,0,3
76092,170,20052,26433;28268,58400,0,1,1,0,2
76093,170,20053,25852;26396,58400,0,0,2,0,2
76094,170,20054,25660;25981;27850;28263;28646;28732;29166,58400,1,4,2,0,7
76095,170,20055,26006,58400,0,0,1,0,1
76096,170,20056,25653;26007;28164;28356;28814,58400,0,3,2,0,5
76097,170,20057,25860;26032;28648,58400,0,1,2,0,3
76098,170,20058,26057;26328,58400,0,0,2,0,2
76099,170,20059,26221;26261;27970;28554,58400,0,2,2,0,4
76100,170,20060,26420;28557,58400,0,1,1,0,2
76101,170,20061,26109;26372,58400,0,0,2,0,2
76102,170,20062,25893;26112,58400,0,0,2,0,2
76103,170,20063,26020;26117,58400,0,0,2,0,2
76104,170,20064,26122;26510;28068,58400,0,1,2,0,3
76105,170,20065,26203;28916,58400,1,0,1,0,2
76106,170,20066,25539;25715;28520;28711;28787;29238,58400,1,3,2,0,6
76107,170,20067,25889;26152;28550;29081,58400,1,1,2,0,4
76108,170,20068,26208;26364;28360;28458;29186,58400,1,2,2,0,5
76109,170,20069,26216;26582,58400,0,0,2,0,2
76110,170,20070,26062;26821;29308,58400,1,0,2,0,3
76111,170,20071,25993;26263,58400,0,0,2,0,2
76112,170,20072,26521,58400,0,0,1,0,1
76113,170,20073,26275;26282;29090,58400,1,0,2,0,3
76114,170,20074,26321;26524;28836;29297,58400,1,1,2,0,4
76115,170,20075,26385,58400,0,0,1,0,1
76116,170,20076,26298;26391,58400,0,0,2,0,2
76117,170,20077,26353;26532;29298,58400,1,0,2,0,3
76118,170,20078,26410;26596;28936,58400,1,0,2,0,3
76119,170,20079,26273;26694;28839,58400,0,1,2,0,3
76120,170,20080,26414;26427;29201,58400,1,0,2,0,3
76121,170,20081,21802,58765,0,0,0,1,1
76122,170,20082,21946,58765,0,0,0,1,1
76123,170,20087,22522,58765,0,0,0,1,1
76124,170,20088,22544,58765,0,0,0,1,1
76125,170,20090,22769,58765,0,0,0,1,1
76126,170,20093,22725,58765,0,0,0,1,1
76127,170,20095,22866;22952,58765,0,0,2,0,2
76128,170,20096,22984,58765,0,0,1,0,1
76129,170,20097,22388,58765,0,0,0,1,1
76130,170,20101,23786;23921;26498,58765,0,0,3,0,3
76131,170,20102,24378;27095,58765,0,0,2,0,2
76132,170,20107,24603;25139;28131;28592,58765,0,2,2,0,4
76133,170,20108,24132;24585,58765,0,0,2,0,2
76134,170,20109,24416;24681,58765,0,0,2,0,2
76135,170,20110,24581,58765,0,0,1,0,1
76136,170,20113,24930,58765,0,0,1,0,1
76137,170,20114,25026;25112,58765,0,0,2,0,2
76138,170,20115,25133;25717;27758;28444,58765,0,2,2,0,4
76139,170,20118,25321;25522;27959;28518;28786,58765,0,3,2,0,5
76140,170,20120,25858;28261;28533;29255,58765,1,2,1,0,4
76141,170,20121,25471;28864,58765,1,0,1,0,2
76142,170,20122,25524;25592;28148;28868,58765,1,1,2,0,4
76143,170,20123,25603;25899;28351,58765,0,1,2,0,3
76144,170,20124,25664;25870,58765,0,0,2,0,2
76145,170,20126,25568;25692;28440;28629;29057,58765,1,2,2,0,5
76146,170,20127,25876;26084;27853;28903;29175,58765,2,1,2,0,5
76147,170,20128,25438;25748;28055,58765,0,1,2,0,3
76148,170,20129,25761;25809;27556,58765,0,0,3,0,3
76149,170,20131,26001;26266;28919,58765,1,0,2,0,3
76150,170,20132,26038;26119;28546;28652,58765,0,2,2,0,4
76151,170,20133,26048;26398,58765,0,0,2,0,2
76152,170,20134,26052;26125;28547;28737;28907;28998,58765,2,2,2,0,6
76153,170,20135,25844;26060;29268,58765,1,0,2,0,3
76154,170,20136,25776;26103,58765,0,0,2,0,2
76155,170,20137,26169;26754;29216,58765,1,0,2,0,3
76156,170,20138,25752;25895,58765,0,0,2,0,2
76157,170,20139,26192;26537,58765,0,0,2,0,2
76158,170,20140,26237;26310;28168;29088,58765,1,1,2,0,4
76159,170,20141,26164;26246,58765,0,0,2,0,2
76160,170,20142,26516,58765,0,0,1,0,1
76161,170,20143,26160;26255;28744,58765,0,1,2,0,3
76162,170,20144,26774;28366;28668;28843,58765,0,3,1,0,4
76163,170,20145,26296;26545,58765,0,0,2,0,2
76164,170,20146,26707;28667,58765,0,1,1,0,2
76165,170,20147,26028;26314,58765,0,0,2,0,2
76166,170,20148,25534;26322;29008;29287,58765,2,0,2,0,4
76167,170,20149,26334;26508,58765,0,0,2,0,2
76168,170,20150,26363;26603;28665;29102,58765,1,1,2,0,4
76169,170,20151,25593;26375,58765,0,0,2,0,2
76170,170,20152,26377;26493;28925,58765,1,0,2,0,3
76171,170,20153,26409;26601;29302,58765,1,0,2,0,3
76172,170,20154,26421;26723;28841,58765,0,1,2,0,3
76173,170,20155,26243;26450;28362,58765,0,1,2,0,3
76174,170,20156,26454;26555;29097,58765,1,0,2,0,3
76175,170,20157,26460,58765,0,0,1,0,1
76176,170,20158,26090,58765,0,0,1,0,1
76177,170,20159,26468;26741,58765,0,0,2,0,2
76178,170,20160,26473,58765,0,0,1,0,1
76179,170,20161,26244;26490;29203,58765,1,0,2,0,3
76180,170,20162,26492;26504;28662,58765,0,1,2,0,3
76181,170,20163,26512;26602,58765,0,0,2,0,2
76182,170,20164,22329,59130,0,0,0,1,1
76183,170,20165,22345,59130,0,0,0,1,1
76184,170,20167,22405,59130,0,0,0,1,1
76185,170,20168,22456;22990,59130,0,0,1,1,2
76186,170,20169,22597,59130,0,0,0,1,1
76187,170,20170,22794,59130,0,0,1,0,1
76188,170,20171,22888,59130,0,0,1,0,1
76189,170,20173,22682,59130,0,0,0,1,1
76190,170,20174,22644,59130,0,0,0,1,1
76191,170,20175,23170,59130,0,0,1,0,1
76192,170,20176,23077;23363,59130,0,0,2,0,2
76193,170,20178,23073,59130,0,0,1,0,1
76194,170,20180,22836;23066,59130,0,0,2,0,2
76195,170,20182,23524;23591,59130,0,0,2,0,2
76196,170,20186,24114,59130,0,0,1,0,1
76197,170,20189,24183;24275,59130,0,0,2,0,2
76198,170,20195,24744,59130,0,0,1,0,1
76199,170,20197,24856,59130,0,0,1,0,1
76200,170,20198,24941,59130,0,0,1,0,1
76201,170,20205,24870;25219;27736;28597,59130,0,2,2,0,4
76202,170,20206,25249;25289;28856,59130,1,0,2,0,3
76203,170,20207,25389,59130,0,0,1,0,1
76204,170,20208,25406;25553;28789;29239,59130,1,1,2,0,4
76205,170,20210,25599;25678;28628;28974;29143,59130,2,1,2,0,5
76206,170,20211,25706;26085;29176,59130,1,0,2,0,3
76207,170,20212,25588;25828;28642,59130,0,1,2,0,3
76208,170,20213,25610;25755;28637;28978,59130,1,1,2,0,4
76209,170,20214,25762;29248,59130,1,0,1,0,2
76210,170,20215,25847;25956;28353;28539;29162,59130,1,2,2,0,5
76211,170,20216,26286;26368,59130,0,0,2,0,2
76212,170,20217,25747;25952;27849;28895,59130,1,1,2,0,4
76213,170,20218,25964;29163,59130,1,0,1,0,2
76214,170,20219,25850;25978;27439,59130,0,0,3,0,3
76215,170,20221,26013;26438;28834,59130,0,1,2,0,3
76216,170,20222,26070;26081;28650;28735;28902;29174,59130,2,2,2,0,6
76217,170,20223,26041;26279;28828,59130,0,1,2,0,3
76218,170,20224,26100;26211;29187,59130,1,0,2,0,3
76219,170,20225,25820;26183;28066;29278,59130,1,1,2,0,4
76220,170,20226,26204;26502,59130,0,0,2,0,2
76221,170,20227,25997;26206;29086;29185,59130,2,0,2,0,4
76222,170,20228,26207;26763,59130,0,0,2,0,2
76223,170,20229,26232;26654,59130,0,0,2,0,2
76224,170,20230,25924;26235,59130,0,0,2,0,2
76225,170,20231,26248;26539;29299,59130,1,0,2,0,3
76226,170,20232,26350;26463,59130,0,0,2,0,2
76227,170,20233,26219;26401;29295,59130,1,0,2,0,3
76228,170,20234,26569;26680,59130,0,0,2,0,2
76229,170,20235,26426;29096,59130,1,0,1,0,2
76230,170,20236,26399;26429,59130,0,0,2,0,2
76231,170,20237,26444;26485,59130,0,0,2,0,2
76232,170,20238,26467;28171,59130,0,1,1,0,2
76233,170,20239,26437,59130,0,0,1,0,1
76234,170,20240,26561;26715,59130,0,0,2,0,2
76235,170,20241,26434;26579;29205,59130,1,0,2,0,3
76236,170,20242,26572;28664,59130,0,1,1,0,2
76237,170,20243,22470,59495,0,0,0,1,1
76238,170,20244,22370,59495,0,0,0,1,1
76239,170,20245,22384,59495,0,0,0,1,1
76240,170,20246,21945,59495,0,0,0,1,1
76241,170,20247,22811,59495,0,0,1,0,1
76242,170,20248,22586,59495,0,0,0,1,1
76243,170,20249,22877,59495,0,0,1,0,1
76244,170,20250,23396,59495,0,0,1,0,1
76245,170,20251,23255,59495,0,0,1,0,1
76246,170,20255,23812,59495,0,0,1,0,1
76247,170,20257,23378,59495,0,0,1,0,1
76248,170,20260,23596,59495,0,0,1,0,1
76249,170,20262,24049;24157,59495,0,0,2,0,2
76250,170,20266,24583,59495,0,0,1,0,1
76251,170,20267,24900;28016;28216,59495,0,2,1,0,3
76252,170,20269,25016;25429;28245;28431;28610;28705;28959,59495,1,4,2,0,7
76253,170,20270,25246;25311;28954,59495,1,0,2,0,3
76254,170,20271,25083;25309;28603,59495,0,1,2,0,3
76255,170,20272,25467;25690;27845,59495,0,1,2,0,3
76256,170,20273,25345;25767;28803,59495,0,1,2,0,3
76257,170,20274,25540;25654;28794;28880;29054,59495,2,1,2,0,5
76258,170,20275,25554;25765,59495,0,0,2,0,2
76259,170,20276,26082,59495,0,0,1,0,1
76260,170,20277,25666;25754,59495,0,0,2,0,2
76261,170,20278,25742,59495,0,0,1,0,1
76262,170,20279,25769;25932;28813;29260,59495,1,1,2,0,4
76263,170,20280,25772;26172;29183,59495,1,0,2,0,3
76264,170,20281,25897;26500;28663;28930,59495,1,1,2,0,4
76265,170,20282,26452,59495,0,0,1,0,1
76266,170,20283,25984,59495,0,0,1,0,1
76267,170,20284,26083;26229,59495,0,0,2,0,2
76268,170,20285,25934;26089;28651;28818,59495,0,2,2,0,4
76269,170,20286,26095;26114,59495,0,0,2,0,2
76270,170,20287,25821;26111;29077,59495,1,0,2,0,3
76271,170,20288,25905,59495,0,0,1,0,1
76272,170,20289,25888;26133;29001,59495,1,0,2,0,3
76273,170,20290,25825;26199;28740;28915,59495,1,1,2,0,4
76274,170,20291,26139;26365,59495,0,0,2,0,2
76275,170,20292,26153;26932;28562,59495,0,1,2,0,3
76276,170,20293,25919;26173;28653,59495,0,1,2,0,3
76277,170,20294,26126;26176;28999,59495,1,0,2,0,3
76278,170,20295,26197;26585;29101,59495,1,0,2,0,3
76279,170,20297,26257;26289;28460;28655,59495,0,2,2,0,4
76280,170,20298,26268;26927,59495,0,0,2,0,2
76281,170,20299,26270;26577,59495,0,0,2,0,2
76282,170,20300,26324;26481,59495,0,0,2,0,2
76283,170,20301,26710,59495,0,0,1,0,1
76284,170,20302,26250;26470;29012,59495,1,0,2,0,3
76285,170,20303,26357;26862,59495,0,0,2,0,2
76286,170,20304,26366;26833,59495,0,0,2,0,2
76287,170,20305,26035;26380;28659;29196,59495,1,1,2,0,4
76288,170,20306,26254;26441;28918,59495,1,0,2,0,3
76289,170,20307,26442;28749,59495,0,1,1,0,2
76290,170,20308,26227;26453;28835,59495,0,1,2,0,3
76291,170,20309,26483;26969,59495,0,0,2,0,2
76292,170,20310,26325;26526;28932,59495,1,0,2,0,3
76293,170,20311,26529;26648;29017,59495,1,0,2,0,3
76294,170,20312,26533;26901,59495,0,0,2,0,2
76295,170,20313,26534;29100,59495,1,0,1,0,2
76296,170,20314,26535;26948,59495,0,0,2,0,2
76297,170,20315,26415;26573,59495,0,0,2,0,2
76298,170,20316,26613;29303,59495,1,0,1,0,2
76299,170,20317,26610;26652,59495,0,0,2,0,2
76300,170,20318,26658,59495,0,0,1,0,1
76301,170,20319,26404;26669,59495,0,0,2,0,2
76302,170,20320,26683,59495,0,0,1,0,1
76303,170,20321,26509;26686,59495,0,0,2,0,2
76304,170,20322,26247;26687,59495,0,0,2,0,2
76305,170,20323,26706,59495,0,0,1,0,1
76306,170,20324,26711;26903;29027,59495,1,0,2,0,3
76307,170,20325,22446,59860,0,0,0,1,1
76308,170,20326,22115,59860,0,0,0,1,1
76309,170,20328,22875,59860,0,0,1,0,1
76310,170,20329,22373,59860,0,0,0,1,1
76311,170,20330,22899;22969,59860,0,0,2,0,2
76312,170,20331,22982,59860,0,0,1,0,1
76313,170,20332,22459,59860,0,0,0,1,1
76314,170,20333,22838,59860,0,0,1,0,1
76315,170,20336,22946,59860,0,0,1,0,1
76316,170,20337,22514,59860,0,0,0,1,1
76317,170,20340,23555,59860,0,0,1,0,1
76318,170,20342,23600,59860,0,0,1,0,1
76319,170,20347,24121;24288,59860,0,0,2,0,2
76320,170,20349,24062,59860,0,0,1,0,1
76321,170,20350,24433;24715,59860,0,0,2,0,2
76322,170,20351,24825;25023;27430,59860,0,0,3,0,3
76323,170,20353,24976;25227,59860,0,0,2,0,2
76324,170,20354,25061;25378;27641;28420;29234,59860,1,1,3,0,5
76325,170,20355,25218,59860,0,0,1,0,1
76326,170,20357,25060,59860,0,0,1,0,1
76327,170,20358,25474;25789;28980,59860,1,0,2,0,3
76328,170,20359,25483;25824;27964;28258,59860,0,2,2,0,4
76329,170,20360,25606;29053,59860,1,0,1,0,2
76330,170,20362,25508;25516;27647;28783,59860,0,1,3,0,4
76331,170,20363,25356;25622;27843;28525;28876;28968,59860,2,2,2,0,6
76332,170,20364,25100;25350;28026;28590,59860,0,2,2,0,4
76333,170,20365,25541,59860,0,0,1,0,1
76334,170,20366,25703;26185;28739,59860,0,1,2,0,3
76335,170,20367,25766,59860,0,0,1,0,1
76336,170,20368,25709;25793;28981,59860,1,0,2,0,3
76337,170,20369,25404;26340,59860,0,0,2,0,2
76338,170,20370,25589,59860,0,0,1,0,1
76339,170,20371,25942;26342;28831,59860,0,1,2,0,3
76340,170,20372,26306;26888,59860,0,0,2,0,2
76341,170,20373,25970;26196;29071,59860,1,0,2,0,3
76342,170,20374,26008;26115,59860,0,0,2,0,2
76343,170,20375,26012;26352;28924,59860,1,0,2,0,3
76344,170,20376,25983;26049;29267,59860,1,0,2,0,3
76345,170,20377,26056;26149,59860,0,0,2,0,2
76346,170,20378,26087,59860,0,0,1,0,1
76347,170,20379,26099;26217;28825,59860,0,1,2,0,3
76348,170,20380,26130,59860,0,0,1,0,1
76349,170,20381,26141;26812;29217,59860,1,0,2,0,3
76350,170,20382,26150;26360;29011;29290,59860,2,0,2,0,4
76351,170,20383,26494,59860,0,0,1,0,1
76352,170,20384,26162,59860,0,0,1,0,1
76353,170,20385,26690,59860,0,0,1,0,1
76354,170,20386,26223;26392,59860,0,0,2,0,2
76355,170,20388,26338;26633;28937,59860,1,0,2,0,3
76356,170,20389,26345;26783;28669,59860,0,1,2,0,3
76357,170,20390,26361;26362,59860,0,0,2,0,2
76358,170,20391,26383;26511,59860,0,0,2,0,2
76359,170,20392,26395;26556,59860,0,0,2,0,2
76360,170,20393,26400;26655,59860,0,0,2,0,2
76361,170,20394,26186;26403;29084,59860,1,0,2,0,3
76362,170,20395,26419,59860,0,0,1,0,1
76363,170,20396,25962;26004;28454,59860,0,1,2,0,3
76364,170,20397,26402;26435,59860,0,0,2,0,2
76365,170,20398,26439;26675;29018,59860,1,0,2,0,3
76366,170,20399,26456;26828;29024,59860,1,0,2,0,3
76367,170,20400,26474;26728,59860,0,0,2,0,2
76368,170,20401,26482;26795;28939,59860,1,0,2,0,3
76369,170,20402,26369;26662;28269;29105,59860,1,1,2,0,4
76370,170,20403,26565;26983;28754;29223,59860,1,1,2,0,4
76371,170,20404,26604;26898,59860,0,0,2,0,2
76372,170,20405,26616;27059;29225,59860,1,0,2,0,3
76373,170,20406,27086,59860,0,0,1,0,1
76374,170,20407,26242;26634;29211,59860,1,0,2,0,3
76375,170,20408,26896;27062,59860,0,0,2,0,2
76376,170,20409,26667;26753,59860,0,0,2,0,2
76377,170,20410,26678;26869,59860,0,0,2,0,2
76378,170,20411,26527;26688;29106;29305,59860,2,0,2,0,4
76379,170,20412,26689;26843,59860,0,0,2,0,2
76380,170,20413,26554;26714,59860,0,0,2,0,2
76381,170,20414,26727;26981,59860,0,0,2,0,2
76382,170,20415,26747;26868,59860,0,0,2,0,2
76383,170,20416,26750;26837,59860,0,0,2,0,2
76384,170,20417,26808,59860,0,0,1,0,1
76385,170,20418,22672,60225,0,0,0,1,1
76386,170,20419,22738,60225,0,0,0,1,1
76387,170,20420,22519,60225,0,0,0,1,1
76388,170,20422,22977,60225,0,0,1,0,1
76389,170,20423,22813,60225,0,0,1,0,1
76390,170,20424,22798,60225,0,0,1,0,1
76391,170,20425,23355,60225,0,0,1,0,1
76392,170,20428,23637;23694,60225,0,0,2,0,2
76393,170,20432,23829,60225,0,0,1,0,1
76394,170,20436,24209;24558;27311;27406,60225,0,0,4,0,4
76395,170,20439,24814,60225,0,0,1,0,1
76396,170,20440,24773;25228;28317;28772;28951,60225,1,2,2,0,5
76397,170,20441,24859;24986,60225,0,0,2,0,2
76398,170,20443,24933,60225,0,0,1,0,1
76399,170,20444,25119,60225,0,0,1,0,1
76400,170,20445,25337;25341;28505;28955,60225,1,1,2,0,4
76401,170,20446,25499;25607;28624,60225,0,1,2,0,3
76402,170,20447,25677;25731;28634;28977,60225,1,1,2,0,4
76403,170,20448,25750;25972;29072,60225,1,0,2,0,3
76404,170,20449,25751,60225,0,0,1,0,1
76405,170,20450,26178,60225,0,0,1,0,1
76406,170,20451,25787;28057;28639;28804;29249,60225,1,3,1,0,5
76407,170,20452,25444;25892;28350;29158,60225,1,1,2,0,4
76408,170,20453,25896,60225,0,0,1,0,1
76409,170,20454,25936;25939;29067;29161,60225,2,0,2,0,4
76410,170,20455,25963;26284,60225,0,0,2,0,2
76411,170,20456,25980;26175,60225,0,0,2,0,2
76412,170,20457,25995;26382;28926,60225,1,0,2,0,3
76413,170,20458,26002,60225,0,0,1,0,1
76414,170,20459,26053;26174;28824;28912;29277,60225,2,1,2,0,5
76415,170,20460,26088;26374;28461;28658;29194;29292,60225,2,2,2,0,6
76416,170,20461,26127;26330;28170;28361,60225,0,2,2,0,4
76417,170,20462,25868;26143;29079,60225,1,0,2,0,3
76418,170,20463,26040,60225,0,0,1,0,1
76419,170,20464,26161;26430;28927;29202,60225,2,0,2,0,4
76420,170,20465,26251,60225,0,0,1,0,1
76421,170,20466,26277;26376,60225,0,0,2,0,2
76422,170,20467,26094;26926,60225,0,0,2,0,2
76423,170,20468,25680;26329;28556;28748;29288,60225,1,2,2,0,5
76424,170,20469,26358;26432;28833,60225,0,1,2,0,3
76425,170,20470,26378;26542;29300,60225,1,0,2,0,3
76426,170,20472,26252;26424,60225,0,0,2,0,2
76427,170,20473,26447;26771;29110,60225,1,0,2,0,3
76428,170,20474,26449;26591,60225,0,0,2,0,2
76429,170,20475,26459;26575,60225,0,0,2,0,2
76430,170,20476,26477,60225,0,0,1,0,1
76431,170,20477,26462;26491;28560;28751,60225,0,2,2,0,4
76432,170,20478,26269;26656,60225,0,0,2,0,2
76433,170,20479,26522;26813;29023,60225,1,0,2,0,3
76434,170,20480,26528;27196,60225,0,0,2,0,2
76435,170,20481,27007,60225,0,0,1,0,1
76436,170,20482,26513;29014;29296,60225,2,0,1,0,3
76437,170,20483,26503;26607,60225,0,0,2,0,2
76438,170,20484,26065;26612;29208,60225,1,0,2,0,3
76439,170,20485,26627;29210,60225,1,0,1,0,2
76440,170,20486,26629;26785;28670,60225,0,1,2,0,3
76441,170,20487,26624;26636;29103,60225,1,0,2,0,3
76442,170,20488,26514;26659,60225,0,0,2,0,2
76443,170,20489,26451;26663,60225,0,0,2,0,2
76444,170,20490,26718;27217,60225,0,0,2,0,2
76445,170,20491,26749;27002;29118,60225,1,0,2,0,3
76446,170,20492,26417;26777,60225,0,0,2,0,2
76447,170,20493,26520;26780;29015,60225,1,0,2,0,3
76448,170,20494,26765;26799,60225,0,0,2,0,2
76449,170,20495,26743;26809;29022,60225,1,0,2,0,3
76450,170,20496,26811;26994,60225,0,0,2,0,2
76451,170,20497,26817;26909,60225,0,0,2,0,2
76452,170,20498,26681;28462,60225,0,1,1,0,2
76453,170,20499,26829;26873;29310,60225,1,0,2,0,3
76454,170,20500,26861;26875;29112,60225,1,0,2,0,3
76455,170,20501,26880;26897,60225,0,0,2,0,2
76456,170,20502,26916;26979,60225,0,0,2,0,2
76457,170,20503,22989,60590,0,0,1,0,1
76458,170,20506,23034,60590,0,0,1,0,1
76459,170,20507,23174,60590,0,0,1,0,1
76460,170,20508,22909,60590,0,0,1,0,1
76461,170,20511,23142;23227,60590,0,0,2,0,2
76462,170,20512,23140,60590,0,0,1,0,1
76463,170,20514,23661;24137,60590,0,0,2,0,2
76464,170,20516,23893;24021,60590,0,0,2,0,2
76465,170,20522,24184,60590,0,0,1,0,1
76466,170,20525,24330,60590,0,0,1,0,1
76467,170,20526,23973,60590,0,0,1,0,1
76468,170,20530,24365,60590,0,0,1,0,1
76469,170,20531,24674;24996;28118,60590,0,1,2,0,3
76470,170,20532,24735,60590,0,0,1,0,1
76471,170,20533,24755,60590,0,0,1,0,1
76472,170,20536,25017;25479;27235;28433;28615,60590,0,2,3,0,5
76473,170,20537,25115,60590,0,0,1,0,1
76474,170,20539,24967;25366,60590,0,0,2,0,2
76475,170,20541,25349,60590,0,0,1,0,1
76476,170,20543,25111,60590,0,0,1,0,1
76477,170,20544,25464,60590,0,0,1,0,1
76478,170,20545,25381,60590,0,0,1,0,1
76479,170,20546,26014;28815,60590,0,1,1,0,2
76480,170,20548,25270,60590,0,0,1,0,1
76481,170,20549,25274;25601,60590,0,0,2,0,2
76482,170,20550,25725,60590,0,0,1,0,1
76483,170,20551,25623,60590,0,0,1,0,1
76484,170,20552,25661;25944;28061;28893;29068,60590,2,1,2,0,5
76485,170,20553,25352;26009,60590,0,0,2,0,2
76486,170,20554,25902;26155;28266;28909;29082,60590,2,1,2,0,5
76487,170,20555,25960;26499,60590,0,0,2,0,2
76488,170,20556,26042,60590,0,0,1,0,1
76489,170,20557,26055;26236;28459;28917,60590,1,1,2,0,4
76490,170,20558,26039;26078,60590,0,0,2,0,2
76491,170,20559,26177;26214;28067;29087;29188,60590,2,1,2,0,5
76492,170,20560,26202;26373,60590,0,0,2,0,2
76493,170,20561,26215,60590,0,0,1,0,1
76494,170,20562,26256;26824,60590,0,0,2,0,2
76495,170,20563,26019;26259;28553;29282,60590,1,1,2,0,4
76496,170,20564,26291;26344;29009,60590,1,0,2,0,3
76497,170,20565,26292;26346,60590,0,0,2,0,2
76498,170,20566,26297;26563;28934,60590,1,0,2,0,3
76499,170,20567,26311;26778,60590,0,0,2,0,2
76500,170,20568,26320;26323;28922;29286,60590,2,0,2,0,4
76501,170,20569,26147;26371,60590,0,0,2,0,2
76502,170,20570,26428;26440,60590,0,0,2,0,2
76503,170,20571,26443;26595;29207,60590,1,0,2,0,3
76504,170,20572,26370;26558,60590,0,0,2,0,2
76505,170,20573,26593;26760,60590,0,0,2,0,2
76506,170,20574,26621;26935;29115,60590,1,0,2,0,3
76507,170,20575,26478;26626;29104;29209,60590,2,0,2,0,4
76508,170,20576,26631,60590,0,0,1,0,1
76509,170,20577,26640;26748,60590,0,0,2,0,2
76510,170,20578,26647;27028,60590,0,0,2,0,2
76511,170,20579,26642;26664,60590,0,0,2,0,2
76512,170,20580,26666,60590,0,0,1,0,1
76513,170,20581,26691;27214,60590,0,0,2,0,2
76514,170,20582,26698;27118,60590,0,0,2,0,2
76515,170,20583,26635;26700,60590,0,0,2,0,2
76516,170,20584,26705;26818,60590,0,0,2,0,2
76517,170,20585,26735;26894,60590,0,0,2,0,2
76518,170,20586,26646;26758,60590,0,0,2,0,2
76519,170,20587,26807;26951;29117,60590,1,0,2,0,3
76520,170,20588,26696;26820;28845;29307,60590,1,1,2,0,4
76521,170,20589,26823,60590,0,0,1,0,1
76522,170,20590,26661;26826,60590,0,0,2,0,2
76523,170,20591,26519;26853;29219,60590,1,0,2,0,3
76524,170,20592,27084;29316,60590,1,0,1,0,2
76525,170,20593,26716;26891,60590,0,0,2,0,2
76526,170,20594,26907,60590,0,0,1,0,1
76527,170,20595,26944;26947,60590,0,0,2,0,2
76528,170,20596,26611;27001;29029,60590,1,0,2,0,3
76529,170,20597,27004;27127;29227,60590,1,0,2,0,3
76530,170,20598,27009;27314,60590,0,0,2,0,2
76531,170,20599,22900,60955,0,0,1,0,1
76532,170,20600,22993,60955,0,0,1,0,1
76533,170,20601,23000,60955,0,0,1,0,1
76534,170,20602,22732,60955,0,0,0,1,1
76535,170,20603,23241;23247,60955,0,0,2,0,2
76536,170,20606,23334,60955,0,0,1,0,1
76537,170,20609,23421,60955,0,0,1,0,1
76538,170,20610,23561,60955,0,0,1,0,1
76539,170,20611,23651;23716,60955,0,0,2,0,2
76540,170,20612,23818;24025,60955,0,0,2,0,2
76541,170,20614,23484,60955,0,0,1,0,1
76542,170,20615,23850,60955,0,0,1,0,1
76543,170,20616,23522,60955,0,0,1,0,1
76544,170,20617,24109,60955,0,0,1,0,1
76545,170,20618,24163,60955,0,0,1,0,1
76546,170,20619,23517;23650,60955,0,0,2,0,2
76547,170,20620,24360,60955,0,0,1,0,1
76548,170,20621,24476,60955,0,0,1,0,1
76549,170,20623,24691,60955,0,0,1,0,1
76550,170,20624,25063,60955,0,0,1,0,1
76551,170,20625,25101,60955,0,0,1,0,1
76552,170,20626,25343,60955,0,0,1,0,1
76553,170,20627,25030,60955,0,0,1,0,1
76554,170,20628,25413,60955,0,0,1,0,1
76555,170,20632,25269,60955,0,0,1,0,1
76556,170,20633,25319,60955,0,0,1,0,1
76557,170,20634,25567,60955,0,0,1,0,1
76558,170,20635,25529,60955,0,0,1,0,1
76559,170,20637,25871,60955,0,0,1,0,1
76560,170,20638,25913;26379;29195,60955,1,0,2,0,3
76561,170,20639,26104,60955,0,0,1,0,1
76562,170,20640,25734,60955,0,0,1,0,1
76563,170,20641,26188;26317,60955,0,0,2,0,2
76564,170,20642,26212;26393;29199,60955,1,0,2,0,3
76565,170,20643,25843,60955,0,0,1,0,1
76566,170,20645,26264;26465,60955,0,0,2,0,2
76567,170,20646,26240;29280,60955,1,0,1,0,2
76568,170,20647,26281;26304;28921;29192,60955,2,0,2,0,4
76569,170,20648,26294;26388,60955,0,0,2,0,2
76570,170,20649,26336,60955,0,0,1,0,1
76571,170,20650,26348;26867,60955,0,0,2,0,2
76572,170,20651,26518;26639;29212,60955,1,0,2,0,3
76573,170,20652,26552;26684;28933,60955,1,0,2,0,3
76574,170,20653,26580;27047,60955,0,0,2,0,2
76575,170,20654,26632,60955,0,0,1,0,1
76576,170,20655,26682;27071,60955,0,0,2,0,2
76577,170,20656,26405;26693,60955,0,0,2,0,2
76578,170,20657,26547;26699,60955,0,0,2,0,2
76579,170,20658,26719;29020;29107,60955,2,0,1,0,3
76580,170,20659,26722,60955,0,0,1,0,1
76581,170,20660,26742;28842,60955,0,1,1,0,2
76582,170,20661,26739;27048,60955,0,0,2,0,2
76583,170,20662,26546;26766;29109,60955,1,0,2,0,3
76584,170,20663,26645;26770;28365;28753,60955,0,2,2,0,4
76585,170,20664,26797;26985,60955,0,0,2,0,2
76586,170,20665,26801;26966,60955,0,0,2,0,2
76587,170,20666,26643;26825,60955,0,0,2,0,2
76588,170,20667,26704;26860;29309,60955,1,0,2,0,3
76589,170,20668,26876,60955,0,0,1,0,1
76590,170,20669,26884;27147,60955,0,0,2,0,2
76591,170,20670,26902;26928,60955,0,0,2,0,2
76592,170,20671,26912;27316,60955,0,0,2,0,2
76593,170,20672,26834;26914,60955,0,0,2,0,2
76594,170,20673,26471;26919,60955,0,0,2,0,2
76595,170,20674,26638;26920;28463,60955,0,1,2,0,3
76596,170,20675,26929;26957,60955,0,0,2,0,2
76597,170,20676,26571;26945,60955,0,0,2,0,2
76598,170,20677,26583;26952,60955,0,0,2,0,2
76599,170,20678,26965;27198,60955,0,0,2,0,2
76600,170,20679,26973;27185,60955,0,0,2,0,2
76601,170,20680,26977;27021;29315,60955,1,0,2,0,3
76602,170,20681,26987;27068,60955,0,0,2,0,2
76603,170,20682,26851;26871,60955,0,0,2,0,2
76604,170,20683,26605;26993,60955,0,0,2,0,2
76605,170,20684,27000;27140;29122,60955,1,0,2,0,3
76606,170,20685,27024;27181,60955,0,0,2,0,2
76607,170,20686,26923;27029,60955,0,0,2,0,2
76608,170,20687,27050;27075,60955,0,0,2,0,2
76609,170,20688,27054;27213,60955,0,0,2,0,2
76610,170,20689,27281,60955,0,0,1,0,1
76611,170,20690,26712;26858,60955,0,0,2,0,2
76612,170,20691,26864;27090,60955,0,0,2,0,2
76613,170,20692,26649;27103,60955,0,0,2,0,2
76614,170,20693,27318;27422,60955,0,0,2,0,2
76615,170,20694,23127,61320,0,0,1,0,1
76616,170,20695,23181,61320,0,0,1,0,1
76617,170,20696,23289,61320,0,0,1,0,1
76618,170,20697,23222;23291,61320,0,0,2,0,2
76619,170,20698,23144,61320,0,0,1,0,1
76620,170,20700,23157,61320,0,0,1,0,1
76621,170,20702,23485,61320,0,0,1,0,1
76622,170,20703,23974,61320,0,0,1,0,1
76623,170,20705,24014,61320,0,0,1,0,1
76624,170,20706,24170,61320,0,0,1,0,1
76625,170,20708,24459,61320,0,0,1,0,1
76626,170,20709,24129,61320,0,0,1,0,1
76627,170,20710,23855,61320,0,0,1,0,1
76628,170,20712,24139,61320,0,0,1,0,1
76629,170,20713,24134,61320,0,0,1,0,1
76630,170,20715,24566,61320,0,0,1,0,1
76631,170,20716,24882,61320,0,0,1,0,1
76632,170,20719,24792,61320,0,0,1,0,1
76633,170,20720,24527,61320,0,0,1,0,1
76634,170,20721,25113,61320,0,0,1,0,1
76635,170,20722,24806,61320,0,0,1,0,1
76636,170,20723,25097,61320,0,0,1,0,1
76637,170,20725,25194;25385,61320,0,0,2,0,2
76638,170,20726,24987,61320,0,0,1,0,1
76639,170,20727,25300,61320,0,0,1,0,1
76640,170,20728,25305,61320,0,0,1,0,1
76641,170,20729,25364,61320,0,0,1,0,1
76642,170,20730,25595;25791,61320,0,0,2,0,2
76643,170,20731,25608;25800;28256;28449;28723;28886;28982,61320,2,3,2,0,7
76644,170,20732,25732,61320,0,0,1,0,1
76645,170,20733,25808;26033;28816;28900;29171,61320,2,1,2,0,5
76646,170,20734,25851;26356,61320,0,0,2,0,2
76647,170,20735,25929;26110;27760;28060;28812,61320,0,3,2,0,5
76648,170,20736,25502,61320,0,0,1,0,1
76649,170,20737,25628;26036,61320,0,0,2,0,2
76650,170,20738,25702,61320,0,0,1,0,1
76651,170,20739,25938,61320,0,0,1,0,1
76652,170,20740,26157;29275,61320,1,0,1,0,2
76653,170,20741,26295,61320,0,0,1,0,1
76654,170,20742,26305;26978,61320,0,0,2,0,2
76655,170,20743,26570;26822,61320,0,0,2,0,2
76656,170,20744,26299;26455,61320,0,0,2,0,2
76657,170,20745,26171;26479;28928,61320,1,0,2,0,3
76658,170,20746,26190,61320,0,0,1,0,1
76659,170,20747,26423;26620,61320,0,0,2,0,2
76660,170,20748,26523,61320,0,0,1,0,1
76661,170,20749,26531;27109,61320,0,0,2,0,2
76662,170,20750,26416,61320,0,0,1,0,1
76663,170,20751,26544;26746;28938,61320,1,0,2,0,3
76664,170,20752,27319,61320,0,0,1,0,1
76665,170,20753,26557;26803,61320,0,0,2,0,2
76666,170,20754,26517;26584,61320,0,0,2,0,2
76667,170,20755,26614;26725,61320,0,0,2,0,2
76668,170,20756,26625,61320,0,0,1,0,1
76669,170,20757,26285,61320,0,0,1,0,1
76670,170,20758,26578;26673,61320,0,0,2,0,2
76671,170,20759,26726;26933,61320,0,0,2,0,2
76672,170,20760,26737;26885;29113,61320,1,0,2,0,3
76673,170,20761,26759;27066;29021,61320,1,0,2,0,3
76674,170,20762,26756;26784,61320,0,0,2,0,2
76675,170,20763,26906;27255;29034,61320,1,0,2,0,3
76676,170,20764,26733;26931;29028,61320,1,0,2,0,3
76677,170,20765,26959;27272,61320,0,0,2,0,2
76678,170,20766,26908;26988;28671;29313,61320,1,1,2,0,4
76679,170,20767,27015;27310,61320,0,0,2,0,2
76680,170,20768,26676;27039,61320,0,0,2,0,2
76681,170,20769,27044;27374,61320,0,0,2,0,2
76682,170,20770,27049;27139,61320,0,0,2,0,2
76683,170,20771,27081;27415,61320,0,0,2,0,2
76684,170,20772,26413;27098;29030,61320,1,0,2,0,3
76685,170,20773,27105;27468,61320,0,0,2,0,2
76686,170,20774,27102;27119;29317,61320,1,0,2,0,3
76687,170,20775,27013;27129,61320,0,0,2,0,2
76688,170,20776,27133;27328,61320,0,0,2,0,2
76689,170,20777,27145;27207,61320,0,0,2,0,2
76690,170,20778,27160,61320,0,0,1,0,1
76691,170,20779,27149;27162,61320,0,0,2,0,2
76692,170,20780,27171;27486,61320,0,0,2,0,2
76693,170,20781,27173,61320,0,0,1,0,1
76694,170,20782,26905;27191,61320,0,0,2,0,2
76695,170,20783,26787;27192;29125,61320,1,0,2,0,3
76696,170,20784,27233;27370,61320,0,0,2,0,2
76697,170,20785,27234;27438,61320,0,0,2,0,2
76698,170,20786,23295,61685,0,0,1,0,1
76699,170,20787,23336,61685,0,0,1,0,1
76700,170,20788,23430;23460,61685,0,0,2,0,2
76701,170,20789,23512,61685,0,0,1,0,1
76702,170,20790,23211,61685,0,0,1,0,1
76703,170,20791,23890,61685,0,0,1,0,1
76704,170,20794,23873,61685,0,0,1,0,1
76705,170,20795,23357,61685,0,0,1,0,1
76706,170,20796,23848,61685,0,0,1,0,1
76707,170,20797,23956,61685,0,0,1,0,1
76708,170,20798,23634,61685,0,0,1,0,1
76709,170,20799,24055,61685,0,0,1,0,1
76710,170,20801,24331,61685,0,0,1,0,1
76711,170,20802,24341,61685,0,0,1,0,1
76712,170,20803,24238;24619,61685,0,0,2,0,2
76713,170,20804,24422,61685,0,0,1,0,1
76714,170,20805,24056;24579;28086;28378,61685,0,2,2,0,4
76715,170,20807,24529,61685,0,0,1,0,1
76716,170,20808,24510,61685,0,0,1,0,1
76717,170,20809,24707,61685,0,0,1,0,1
76718,170,20810,24801,61685,0,0,1,0,1
76719,170,20811,24944,61685,0,0,1,0,1
76720,170,20812,24716,61685,0,0,1,0,1
76721,170,20814,25075,61685,0,0,1,0,1
76722,170,20815,25077,61685,0,0,1,0,1
76723,170,20816,25291,61685,0,0,1,0,1
76724,170,20817,25293,61685,0,0,1,0,1
76725,170,20819,25357,61685,0,0,1,0,1
76726,170,20820,25544,61685,0,0,1,0,1
76727,170,20821,24975,61685,0,0,1,0,1
76728,170,20823,25281,61685,0,0,1,0,1
76729,170,20824,25602,61685,0,0,1,0,1
76730,170,20825,25676;26058;29172,61685,1,0,2,0,3
76731,170,20826,25699,61685,0,0,1,0,1
76732,170,20827,25783;25815;27650;28531,61685,0,1,3,0,4
76733,170,20828,25971,61685,0,0,1,0,1
76734,170,20829,25657,61685,0,0,1,0,1
76735,170,20830,26010,61685,0,0,1,0,1
76736,170,20831,26184;26354;29010,61685,1,0,2,0,3
76737,170,20832,26222,61685,0,0,1,0,1
76738,170,20833,26276,61685,0,0,1,0,1
76739,170,20834,26280;26587;29016,61685,1,0,2,0,3
76740,170,20835,26224;26293;28829;28920;29007;29091,61685,3,1,2,0,6
76741,170,20836,26351;26717;28840;29215,61685,1,1,2,0,4
76742,170,20837,26457;26721,61685,0,0,2,0,2
76743,170,20838,26550;27257,61685,0,0,2,0,2
76744,170,20839,26564;26798,61685,0,0,2,0,2
76745,170,20840,26566;26831,61685,0,0,2,0,2
76746,170,20841,26466;26567,61685,0,0,2,0,2
76747,170,20842,26327;26588;28172,61685,0,1,2,0,3
76748,170,20843,26541;26653,61685,0,0,2,0,2
76749,170,20844,26832,61685,0,0,1,0,1
76750,170,20845,26308,61685,0,0,1,0,1
76751,170,20846,26713;26729,61685,0,0,2,0,2
76752,170,20847,26701;26745,61685,0,0,2,0,2
76753,170,20848,26751;26900,61685,0,0,2,0,2
76754,170,20849,26806;27186,61685,0,0,2,0,2
76755,170,20850,26816;26984,61685,0,0,2,0,2
76756,170,20851,26836;27023,61685,0,0,2,0,2
76757,170,20852,26839;27280,61685,0,0,2,0,2
76758,170,20853,26840;27156,61685,0,0,2,0,2
76759,170,20854,26992,61685,0,0,1,0,1
76760,170,20855,26589;26677,61685,0,0,2,0,2
76761,170,20856,26915;27269,61685,0,0,2,0,2
76762,170,20857,26925;27289,61685,0,0,2,0,2
76763,170,20858,26946;27030,61685,0,0,2,0,2
76764,170,20859,26953;27195;29320,61685,1,0,2,0,3
76765,170,20860,26998;27330,61685,0,0,2,0,2
76766,170,20861,26543;27022;28846;29119,61685,1,1,2,0,4
76767,170,20862,26918;27038,61685,0,0,2,0,2
76768,170,20863,27045;27215;29229,61685,1,0,2,0,3
76769,170,20864,27052;27179;29228,61685,1,0,2,0,3
76770,170,20865,27055,61685,0,0,1,0,1
76771,170,20866,26757;27061,61685,0,0,2,0,2
76772,170,20867,27083;27120;28848,61685,0,1,2,0,3
76773,170,20868,26940;27087,61685,0,0,2,0,2
76774,170,20869,27093,61685,0,0,1,0,1
76775,170,20870,26895;27108,61685,0,0,2,0,2
76776,170,20871,26882;27165,61685,0,0,2,0,2
76777,170,20872,27183;27296,61685,0,0,2,0,2
76778,170,20873,27221,61685,0,0,1,0,1
76779,170,20874,27229;27616;29325,61685,1,0,2,0,3
76780,170,20875,27279;27286,61685,0,0,2,0,2
76781,170,20876,27283;27436,61685,0,0,2,0,2
76782,170,20877,27012;27294,61685,0,0,2,0,2
76783,170,20878,27299;27340,61685,0,0,2,0,2
76784,170,20879,27302;27482,61685,0,0,2,0,2
76785,170,20880,27123,61685,0,0,1,0,1
76786,170,20881,26551,61685,0,0,1,0,1
76787,170,20882,23229,62050,0,0,1,0,1
76788,170,20884,23399,62050,0,0,1,0,1
76789,170,20885,23513,62050,0,0,1,0,1
76790,170,20886,23397,62050,0,0,1,0,1
76791,170,20889,23620;23906;27460,62050,0,0,3,0,3
76792,170,20890,23809,62050,0,0,1,0,1
76793,170,20891,23913,62050,0,0,1,0,1
76794,170,20892,23896,62050,0,0,1,0,1
76795,170,20893,23976,62050,0,0,1,0,1
76796,170,20894,24044,62050,0,0,1,0,1
76797,170,20895,23838,62050,0,0,1,0,1
76798,170,20896,24328,62050,0,0,1,0,1
76799,170,20897,24384,62050,0,0,1,0,1
76800,170,20898,24386,62050,0,0,1,0,1
76801,170,20899,24473,62050,0,0,1,0,1
76802,170,20900,24520,62050,0,0,1,0,1
76803,170,20901,24299,62050,0,0,1,0,1
76804,170,20902,24508,62050,0,0,1,0,1
76805,170,20904,24732,62050,0,0,1,0,1
76806,170,20905,24399,62050,0,0,1,0,1
76807,170,20906,24612,62050,0,0,1,0,1
76808,170,20907,24939,62050,0,0,1,0,1
76809,170,20908,24912,62050,0,0,1,0,1
76810,170,20909,24924,62050,0,0,1,0,1
76811,170,20910,25070,62050,0,0,1,0,1
76812,170,20911,25109,62050,0,0,1,0,1
76813,170,20912,24955,62050,0,0,1,0,1
76814,170,20913,25279,62050,0,0,1,0,1
76815,170,20914,25287,62050,0,0,1,0,1
76816,170,20915,25360,62050,0,0,1,0,1
76817,170,20916,25874;26050;28264;28901;29075,62050,2,1,2,0,5
76818,170,20917,25704,62050,0,0,1,0,1
76819,170,20918,25911,62050,0,0,1,0,1
76820,170,20919,25974,62050,0,0,1,0,1
76821,170,20920,26044;26181;29184,62050,1,0,2,0,3
76822,170,20921,26069,62050,0,0,1,0,1
76823,170,20922,26135;26425,62050,0,0,2,0,2
76824,170,20923,26271;26515,62050,0,0,2,0,2
76825,170,20924,26288,62050,0,0,1,0,1
76826,170,20926,26343;26487;28929;29098,62050,2,0,2,0,4
76827,170,20927,26406;26598,62050,0,0,2,0,2
76828,170,20928,26549,62050,0,0,1,0,1
76829,170,20929,26562;26911,62050,0,0,2,0,2
76830,170,20930,26265;26568;28752;28837;28935;29204,62050,2,2,2,0,6
76831,170,20931,26581;29206,62050,1,0,1,0,2
76832,170,20932,26341;26586,62050,0,0,2,0,2
76833,170,20933,26606,62050,0,0,1,0,1
76834,170,20934,26608,62050,0,0,1,0,1
76835,170,20935,26641;26874;29111,62050,1,0,2,0,3
76836,170,20936,26651;26847,62050,0,0,2,0,2
76837,170,20937,26339;26709;29214,62050,1,0,2,0,3
76838,170,20938,26744,62050,0,0,1,0,1
76839,170,20939,26781;27152,62050,0,0,2,0,2
76840,170,20940,26815;27124;29226;29318,62050,2,0,2,0,4
76841,170,20941,26830,62050,0,0,1,0,1
76842,170,20942,26846,62050,0,0,1,0,1
76843,170,20943,26856,62050,0,0,1,0,1
76844,170,20944,26496;26881,62050,0,0,2,0,2
76845,170,20945,26883,62050,0,0,1,0,1
76846,170,20946,26934;27107,62050,0,0,2,0,2
76847,170,20947,26938;27164;29123,62050,1,0,2,0,3
76848,170,20948,26955;27230,62050,0,0,2,0,2
76849,170,20949,26995;27232,62050,0,0,2,0,2
76850,170,20950,26971;27043,62050,0,0,2,0,2
76851,170,20951,27057;27537,62050,0,0,2,0,2
76852,170,20952,27065;27252,62050,0,0,2,0,2
76853,170,20953,27096;27184,62050,0,0,2,0,2
76854,170,20954,26892;27130,62050,0,0,2,0,2
76855,170,20955,27151,62050,0,0,1,0,1
76856,170,20956,27238;27437,62050,0,0,2,0,2
76857,170,20957,27244;27605,62050,0,0,2,0,2
76858,170,20958,27251;27409,62050,0,0,2,0,2
76859,170,20959,27258;27306,62050,0,0,2,0,2
76860,170,20960,27277;27592,62050,0,0,2,0,2
76861,170,20961,27058,62050,0,0,1,0,1
76862,170,20962,26962;27329,62050,0,0,2,0,2
76863,170,20963,27344;27527,62050,0,0,2,0,2
76864,170,20964,27116;27345;29121,62050,1,0,2,0,3
76865,170,20965,27355,62050,0,0,1,0,1
76866,170,20966,27358,62050,0,0,1,0,1
76867,170,20967,27360;27366,62050,0,0,2,0,2
76868,170,20968,27373;27720,62050,0,1,1,0,2
76869,170,20969,27380;27676,62050,0,1,1,0,2
76870,170,20970,27383,62050,0,0,1,0,1
76871,170,20971,27110;27388,62050,0,0,2,0,2
76872,170,20972,27390;27733,62050,0,1,1,0,2
76873,170,20973,27394;27554,62050,0,0,2,0,2
76874,170,20974,27414;27575,62050,0,0,2,0,2
76875,180,8491,21300,16790,0,0,0,1,1
76876,180,10497,19892,24090,0,0,0,1,1
76877,180,11234,20647,26280,0,0,0,1,1
76878,180,11558,23566;23962,27375,0,0,1,1,2
76879,180,13116,20885,32485,0,0,0,1,1
76880,180,13309,22887,33215,0,0,0,1,1
76881,180,13560,22921,33945,0,0,0,1,1
76882,180,13591,21373;21445,33945,0,0,0,2,2
76883,180,13661,22524,34310,0,0,0,1,1
76884,180,13672,22310,34310,0,0,0,1,1
76885,180,13712,23631,34310,0,0,0,1,1
76886,180,13715,22818,34310,0,0,0,1,1
76887,180,13979,23344;23401,35405,0,0,0,2,2
76888,180,14002,25162,35405,0,0,1,0,1
76889,180,14035,24830;24917;28855,35405,0,1,2,0,3
76890,180,14325,19786,36500,0,0,0,1,1
76891,180,14334,20092,36500,0,0,0,1,1
76892,180,14338,20287,36500,0,0,0,1,1
76893,180,14346,19876,36500,0,0,0,1,1
76894,180,14356,23769,36500,0,0,0,1,1
76895,180,14459,19978,36865,0,0,0,1,1
76896,180,14503,22707;22985,37230,0,0,0,2,2
76897,180,14541,20479,37230,0,0,0,1,1
76898,180,14542,20213,37230,0,0,0,1,1
76899,180,14547,20222,37230,0,0,0,1,1
76900,180,14548,20018,37230,0,0,0,1,1
76901,180,14592,22380,37595,0,0,0,1,1
76902,180,14626,23895,37595,0,0,1,0,1
76903,180,14630,19984,37595,0,0,0,1,1
76904,180,14633,20049,37595,0,0,0,1,1
76905,180,14639,20038,37595,0,0,0,1,1
76906,180,14647,20432,37595,0,0,0,1,1
76907,180,14748,20621,37960,0,0,0,1,1
76908,180,14755,20510,37960,0,0,0,1,1
76909,180,14761,23680,37960,0,0,0,1,1
76910,180,14831,23570,38325,0,0,0,1,1
76911,180,14834,20203,38325,0,0,0,1,1
76912,180,14838,19932,38325,0,0,0,1,1
76913,180,14847,23989;24346,38325,0,0,2,0,2
76914,180,14854,20232,38325,0,0,0,1,1
76915,180,14855,20200,38325,0,0,0,1,1
76916,180,14857,23679;23739;26679;29019,38325,0,1,1,2,4
76917,180,14868,20718,38325,0,0,0,1,1
76918,180,14869,20484,38325,0,0,0,1,1
76919,180,14876,20792,38325,0,0,0,1,1
76920,180,14925,23009,38690,0,0,0,1,1
76921,180,14954,20245,38690,0,0,0,1,1
76922,180,14959,20413,38690,0,0,0,1,1
76923,180,14982,20488,38690,0,0,0,1,1
76924,180,14984,20378,38690,0,0,0,1,1
76925,180,14985,23690;27450;30140;30231,38690,2,0,1,1,4
76926,180,14986,20527,38690,0,0,0,1,1
76927,180,14988,20559,38690,0,0,0,1,1
76928,180,14989,20576,38690,0,0,0,1,1
76929,180,15062,24701;27906;28472,39055,0,0,3,0,3
76930,180,15064,20344,39055,0,0,0,1,1
76931,180,15066,24405;24810;25078;25179;25197;27226;28137;28948,39055,0,1,7,0,8
76932,180,15067,20766,39055,0,0,0,1,1
76933,180,15068,20535,39055,0,0,0,1,1
76934,180,15069,20606,39055,0,0,0,1,1
76935,180,15072,20281,39055,0,0,0,1,1
76936,180,15085,20869,39055,0,0,0,1,1
76937,180,15089,20547,39055,0,0,0,1,1
76938,180,15090,20552,39055,0,0,0,1,1
76939,180,15094,20626,39055,0,0,0,1,1
76940,180,15172,20756,39420,0,0,0,1,1
76941,180,15173,20459,39420,0,0,0,1,1
76942,180,15175,21163,39420,0,0,0,1,1
76943,180,15176,20592,39420,0,0,0,1,1
76944,180,15177,20216,39420,0,0,0,1,1
76945,180,15178,24633;24670;27711,39420,0,0,3,0,3
76946,180,15185,21143,39420,0,0,0,1,1
76947,180,15187,20659,39420,0,0,0,1,1
76948,180,15191,20956,39420,0,0,0,1,1
76949,180,15193,20769,39420,0,0,0,1,1
76950,180,15194,20785;20984;24826;27625;28104,39420,0,0,3,2,5
76951,180,15197,20827;20948,39420,0,0,0,2,2
76952,180,15198,24672;25025,39420,0,0,2,0,2
76953,180,15199,20892,39420,0,0,0,1,1
76954,180,15247,23314,39785,0,0,0,1,1
76955,180,15260,20745,39785,0,0,0,1,1
76956,180,15268,20334,39785,0,0,0,1,1
76957,180,15274,20506,39785,0,0,0,1,1
76958,180,15278,20682,39785,0,0,0,1,1
76959,180,15279,20963,39785,0,0,0,1,1
76960,180,15281,20866,39785,0,0,0,1,1
76961,180,15287,20714,39785,0,0,0,1,1
76962,180,15288,21138,39785,0,0,0,1,1
76963,180,15289,20976,39785,0,0,0,1,1
76964,180,15298,20939,39785,0,0,0,1,1
76965,180,15301,20871,39785,0,0,0,1,1
76966,180,15302,20893;21124,39785,0,0,0,2,2
76967,180,15306,21096,39785,0,0,0,1,1
76968,180,15365,20922,40150,0,0,0,1,1
76969,180,15367,20520,40150,0,0,0,1,1
76970,180,15369,20408,40150,0,0,0,1,1
76971,180,15372,20439,40150,0,0,0,1,1
76972,180,15376,20811,40150,0,0,0,1,1
76973,180,15382,20754,40150,0,0,0,1,1
76974,180,15383,21281,40150,0,0,0,1,1
76975,180,15386,21022,40150,0,0,0,1,1
76976,180,15390,24622,40150,0,0,1,0,1
76977,180,15397,20874,40150,0,0,0,1,1
76978,180,15399,21238,40150,0,0,0,1,1
76979,180,15448,26031;26300;29631,40515,0,1,2,0,3
76980,180,15454,20795,40515,0,0,0,1,1
76981,180,15455,20303,40515,0,0,0,1,1
76982,180,15457,20607,40515,0,0,0,1,1
76983,180,15459,20457,40515,0,0,0,1,1
76984,180,15466,20995,40515,0,0,0,1,1
76985,180,15468,21025,40515,0,0,0,1,1
76986,180,15481,20912;20997,40515,0,0,0,2,2
76987,180,15486,20732,40515,0,0,0,1,1
76988,180,15487,20803,40515,0,0,0,1,1
76989,180,15488,21487,40515,0,0,0,1,1
76990,180,15491,21130,40515,0,0,0,1,1
76991,180,15493,21298,40515,0,0,0,1,1
76992,180,15496,21553;21814,40515,0,0,0,2,2
76993,180,15498,21121;21427,40515,0,0,0,2,2
76994,180,15499,21151,40515,0,0,0,1,1
76995,180,15500,21486,40515,0,0,0,1,1
76996,180,15501,21200;21408,40515,0,0,0,2,2
76997,180,15502,21245,40515,0,0,0,1,1
76998,180,15546,20701,40880,0,0,0,1,1
76999,180,15551,21031,40880,0,0,0,1,1
77000,180,15555,21004,40880,0,0,0,1,1
77001,180,15556,23176,40880,0,0,0,1,1
77002,180,15557,20704,40880,0,0,0,1,1
77003,180,15558,20978,40880,0,0,0,1,1
77004,180,15562,20722;21088,40880,0,0,0,2,2
77005,180,15563,20898,40880,0,0,0,1,1
77006,180,15566,21420,40880,0,0,0,1,1
77007,180,15568,21341,40880,0,0,0,1,1
77008,180,15569,20992,40880,0,0,0,1,1
77009,180,15571,20692;21010,40880,0,0,0,2,2
77010,180,15574,21411,40880,0,0,0,1,1
77011,180,15575,21463,40880,0,0,0,1,1
77012,180,15576,21236,40880,0,0,0,1,1
77013,180,15577,21137,40880,0,0,0,1,1
77014,180,15580,21172,40880,0,0,0,1,1
77015,180,15586,21249,40880,0,0,0,1,1
77016,180,15587,21256,40880,0,0,0,1,1
77017,180,15588,21262,40880,0,0,0,1,1
77018,180,15591,21283;21550,40880,0,0,0,2,2
77019,180,15592,21128,40880,0,0,0,1,1
77020,180,15629,20593,41245,0,0,0,1,1
77021,180,15633,21167,41245,0,0,0,1,1
77022,180,15640,20768,41245,0,0,0,1,1
77023,180,15647,20829,41245,0,0,0,1,1
77024,180,15651,20907;20989,41245,0,0,0,2,2
77025,180,15653,21110,41245,0,0,0,1,1
77026,180,15654,21415,41245,0,0,0,1,1
77027,180,15658,21145,41245,0,0,0,1,1
77028,180,15659,21162;21243,41245,0,0,0,2,2
77029,180,15660,20744,41245,0,0,0,1,1
77030,180,15661,21591,41245,0,0,0,1,1
77031,180,15665,21329;21683,41245,0,0,0,2,2
77032,180,15666,21259,41245,0,0,0,1,1
77033,180,15667,21613,41245,0,0,0,1,1
77034,180,15668,21270,41245,0,0,0,1,1
77035,180,15669,21278,41245,0,0,0,1,1
77036,180,15670,21534,41245,0,0,0,1,1
77037,180,15672,20986;21305,41245,0,0,0,2,2
77038,180,15673,25491;25630;28617,41245,0,0,3,0,3
77039,180,15674,21332,41245,0,0,0,1,1
77040,180,15676,21326,41245,0,0,0,1,1
77041,180,15677,21394;21511,41245,0,0,0,2,2
77042,180,15678,21097;21600,41245,0,0,0,2,2
77043,180,15679,21393;24448;28078;30162,41245,1,0,2,1,4
77044,180,15726,20012,41610,0,0,0,1,1
77045,180,15742,20979,41610,0,0,0,1,1
77046,180,15744,20757,41610,0,0,0,1,1
77047,180,15745,21060,41610,0,0,0,1,1
77048,180,15747,21271,41610,0,0,0,1,1
77049,180,15752,21056,41610,0,0,0,1,1
77050,180,15755,20938;21112,41610,0,0,0,2,2
77051,180,15766,21989,41610,0,0,0,1,1
77052,180,15770,21290,41610,0,0,0,1,1
77053,180,15772,21829,41610,0,0,0,1,1
77054,180,15775,21383,41610,0,0,0,1,1
77055,180,15776,21384,41610,0,0,0,1,1
77056,180,15777,21621,41610,0,0,0,1,1
77057,180,15808,24819;25114;27833;28029;28102,41975,0,0,5,0,5
77058,180,15811,20805,41975,0,0,0,1,1
77059,180,15829,20937,41975,0,0,0,1,1
77060,180,15830,21040,41975,0,0,0,1,1
77061,180,15835,21347,41975,0,0,0,1,1
77062,180,15836,21318,41975,0,0,0,1,1
77063,180,15837,21475,41975,0,0,0,1,1
77064,180,15839,21152,41975,0,0,0,1,1
77065,180,15842,21579,41975,0,0,0,1,1
77066,180,15843,21224,41975,0,0,0,1,1
77067,180,15845,21231,41975,0,0,0,1,1
77068,180,15846,21763,41975,0,0,0,1,1
77069,180,15852,21719,41975,0,0,0,1,1
77070,180,15858,21109;21787,41975,0,0,0,2,2
77071,180,15859,21402;21494,41975,0,0,0,2,2
77072,180,15860,21623,41975,0,0,0,1,1
77073,180,15863,21589,41975,0,0,0,1,1
77074,180,15913,21107,42340,0,0,0,1,1
77075,180,15915,21003,42340,0,0,0,1,1
77076,180,15918,20900,42340,0,0,0,1,1
77077,180,15921,24944;25130;26130;26238;28130;28741;29190,42340,0,2,5,0,7
77078,180,15922,20905,42340,0,0,0,1,1
77079,180,15924,21675,42340,0,0,0,1,1
77080,180,15925,21481,42340,0,0,0,1,1
77081,180,15928,21978,42340,0,0,0,1,1
77082,180,15929,21189;21292,42340,0,0,0,2,2
77083,180,15931,21301,42340,0,0,0,1,1
77084,180,15934,21602;21909,42340,0,0,0,2,2
77085,180,15935,21828,42340,0,0,0,1,1
77086,180,15937,22017,42340,0,0,0,1,1
77087,180,15938,21434,42340,0,0,0,1,1
77088,180,15939,21436,42340,0,0,0,1,1
77089,180,15940,21466;21561,42340,0,0,0,2,2
77090,180,15941,21176,42340,0,0,0,1,1
77091,180,15943,21496,42340,0,0,0,1,1
77092,180,15945,21169,42340,0,0,0,1,1
77093,180,15946,21580,42340,0,0,0,1,1
77094,180,15947,22050,42340,0,0,0,1,1
77095,180,15949,21212;21587,42340,0,0,0,2,2
77096,180,15950,21605;21913,42340,0,0,0,2,2
77097,180,15952,21614,42340,0,0,0,1,1
77098,180,15953,21827,42340,0,0,0,1,1
77099,180,15959,21951,42340,0,0,0,1,1
77100,180,15960,21213;21704,42340,0,0,0,2,2
77101,180,15987,20608,42705,0,0,0,1,1
77102,180,15995,20957,42705,0,0,0,1,1
77103,180,15998,21522,42705,0,0,0,1,1
77104,180,16003,21222,42705,0,0,0,1,1
77105,180,16005,21191,42705,0,0,0,1,1
77106,180,16006,21533,42705,0,0,0,1,1
77107,180,16007,21263;25728;29147;29246,42705,0,2,1,1,4
77108,180,16010,20796;21336,42705,0,0,0,2,2
77109,180,16012,20856,42705,0,0,0,1,1
77110,180,16013,21241;21363,42705,0,0,0,2,2
77111,180,16014,21468,42705,0,0,0,1,1
77112,180,16015,21377,42705,0,0,0,1,1
77113,180,16016,21368,42705,0,0,0,1,1
77114,180,16017,21636,42705,0,0,0,1,1
77115,180,16018,21429,42705,0,0,0,1,1
77116,180,16022,21439;21858,42705,0,0,0,2,2
77117,180,16023,21214;21503,42705,0,0,0,2,2
77118,180,16024,21625,42705,0,0,0,1,1
77119,180,16025,22138,42705,0,0,0,1,1
77120,180,16027,21912,42705,0,0,0,1,1
77121,180,16028,22131,42705,0,0,0,1,1
77122,180,16029,21558;21566,42705,0,0,0,2,2
77123,180,16030,21469;21571,42705,0,0,0,2,2
77124,180,16031,21406;21895,42705,0,0,0,2,2
77125,180,16032,21728,42705,0,0,0,1,1
77126,180,16033,21671,42705,0,0,0,1,1
77127,180,16034,21455,42705,0,0,0,1,1
77128,180,16035,22183,42705,0,0,0,1,1
77129,180,16037,21722,42705,0,0,0,1,1
77130,180,16038,21653,42705,0,0,0,1,1
77131,180,16039,21773,42705,0,0,0,1,1
77132,180,16040,21777,42705,0,0,0,1,1
77133,180,16041,21780,42705,0,0,0,1,1
77134,180,16042,21458,42705,0,0,0,1,1
77135,180,16043,21525,42705,0,0,0,1,1
77136,180,16044,21781;21801,42705,0,0,0,2,2
77137,180,16045,21678;21893,42705,0,0,0,2,2
77138,180,16084,21155,43070,0,0,0,1,1
77139,180,16085,20738,43070,0,0,0,1,1
77140,180,16089,21174,43070,0,0,0,1,1
77141,180,16090,20972,43070,0,0,0,1,1
77142,180,16096,21480,43070,0,0,0,1,1
77143,180,16098,21544,43070,0,0,0,1,1
77144,180,16100,23737;23937,43070,0,0,1,1,2
77145,180,16101,20975,43070,0,0,0,1,1
77146,180,16105,21333,43070,0,0,0,1,1
77147,180,16106,21423,43070,0,0,0,1,1
77148,180,16108,21403,43070,0,0,0,1,1
77149,180,16109,21604,43070,0,0,0,1,1
77150,180,16110,21116;21746,43070,0,0,0,2,2
77151,180,16113,22065,43070,0,0,0,1,1
77152,180,16114,21947,43070,0,0,0,1,1
77153,180,16115,21510;21876,43070,0,0,0,2,2
77154,180,16116,21495,43070,0,0,0,1,1
77155,180,16117,21536,43070,0,0,0,1,1
77156,180,16120,21619,43070,0,0,0,1,1
77157,180,16121,21624,43070,0,0,0,1,1
77158,180,16124,21498,43070,0,0,0,1,1
77159,180,16125,21841,43070,0,0,0,1,1
77160,180,16126,21513,43070,0,0,0,1,1
77161,180,16130,21476;21628,43070,0,0,0,2,2
77162,180,16131,21477;21744,43070,0,0,0,2,2
77163,180,16132,21967,43070,0,0,0,1,1
77164,180,16134,22230,43070,0,0,0,1,1
77165,180,16135,22081,43070,0,0,0,1,1
77166,180,16136,21637;21811,43070,0,0,0,2,2
77167,180,16137,22153,43070,0,0,0,1,1
77168,180,16139,21836,43070,0,0,0,1,1
77169,180,16140,21847;22003,43070,0,0,0,2,2
77170,180,16141,21736,43070,0,0,0,1,1
77171,180,16142,21850,43070,0,0,0,1,1
77172,180,16144,21864;22210,43070,0,0,0,2,2
77173,180,16145,21731,43070,0,0,0,1,1
77174,180,16146,21770,43070,0,0,0,1,1
77175,180,16147,21899,43070,0,0,0,1,1
77176,180,16148,22235,43070,0,0,0,1,1
77177,180,16149,21948;22195,43070,0,0,0,2,2
77178,180,16176,20318,43435,0,0,0,1,1
77179,180,16179,19939,43435,0,0,0,1,1
77180,180,16180,20637,43435,0,0,0,1,1
77181,180,16192,21005,43435,0,0,0,1,1
77182,180,16196,21264;21657,43435,0,0,0,2,2
77183,180,16197,21139,43435,0,0,0,1,1
77184,180,16198,21173,43435,0,0,0,1,1
77185,180,16201,21658,43435,0,0,0,1,1
77186,180,16203,21673,43435,0,0,0,1,1
77187,180,16205,21611,43435,0,0,0,1,1
77188,180,16211,21695,43435,0,0,0,1,1
77189,180,16214,21706;22241,43435,0,0,0,2,2
77190,180,16215,21708,43435,0,0,0,1,1
77191,180,16217,22208;22526,43435,0,0,0,2,2
77192,180,16218,21535;21751,43435,0,0,0,2,2
77193,180,16219,22094,43435,0,0,0,1,1
77194,180,16220,21937,43435,0,0,0,1,1
77195,180,16222,21760,43435,0,0,0,1,1
77196,180,16224,21785,43435,0,0,0,1,1
77197,180,16225,21564;21786,43435,0,0,0,2,2
77198,180,16226,21820,43435,0,0,0,1,1
77199,180,16227,21823,43435,0,0,0,1,1
77200,180,16228,21832,43435,0,0,0,1,1
77201,180,16229,21941,43435,0,0,0,1,1
77202,180,16230,21849;21881,43435,0,0,0,2,2
77203,180,16232,21762,43435,0,0,0,1,1
77204,180,16233,21601,43435,0,0,0,1,1
77205,180,16234,22152,43435,0,0,0,1,1
77206,180,16237,21953,43435,0,0,0,1,1
77207,180,16238,21956,43435,0,0,0,1,1
77208,180,16240,21964;21992,43435,0,0,0,2,2
77209,180,16243,21926;21998,43435,0,0,0,2,2
77210,180,16244,22014,43435,0,0,0,1,1
77211,180,16245,22016,43435,0,0,0,1,1
77212,180,16246,22307,43435,0,0,0,1,1
77213,180,16247,22031,43435,0,0,0,1,1
77214,180,16248,22123,43435,0,0,0,1,1
77215,180,16290,20981,43800,0,0,0,1,1
77216,180,16294,21126,43800,0,0,0,1,1
77217,180,16297,21635,43800,0,0,0,1,1
77218,180,16298,21239,43800,0,0,0,1,1
77219,180,16299,21430,43800,0,0,0,1,1
77220,180,16300,25338;28239,43800,0,0,2,0,2
77221,180,16301,21349,43800,0,0,0,1,1
77222,180,16304,21765;26037,43800,0,0,1,1,2
77223,180,16305,21705;24970;28301;28392,43800,0,0,3,1,4
77224,180,16306,21702,43800,0,0,0,1,1
77225,180,16308,21588,43800,0,0,0,1,1
77226,180,16309,21594,43800,0,0,0,1,1
77227,180,16311,21622;21804,43800,0,0,0,2,2
77228,180,16312,21784;21930,43800,0,0,0,2,2
77229,180,16313,21499;21597,43800,0,0,0,2,2
77230,180,16314,21869,43800,0,0,0,1,1
77231,180,16316,21890;21939,43800,0,0,0,2,2
77232,180,16317,22007,43800,0,0,0,1,1
77233,180,16318,21691;21957,43800,0,0,0,2,2
77234,180,16319,21697,43800,0,0,0,1,1
77235,180,16321,21629;22062,43800,0,0,0,2,2
77236,180,16322,21309,43800,0,0,0,1,1
77237,180,16323,21961;22227,43800,0,0,0,2,2
77238,180,16325,21860;22364,43800,0,0,0,2,2
77239,180,16327,21842;22141,43800,0,0,0,2,2
77240,180,16329,21910;22147,43800,0,0,0,2,2
77241,180,16331,22286,43800,0,0,0,1,1
77242,180,16332,21936;22148,43800,0,0,0,2,2
77243,180,16336,22474,43800,0,0,0,1,1
77244,180,16337,22267,43800,0,0,0,1,1
77245,180,16338,21644;22009,43800,0,0,0,2,2
77246,180,16340,22041,43800,0,0,0,1,1
77247,180,16342,22030,43800,0,0,0,1,1
77248,180,16344,22260;22421,43800,0,0,0,2,2
77249,180,16345,22085;22215,43800,0,0,0,2,2
77250,180,16348,25941;26215;28991,43800,0,1,2,0,3
77251,180,16349,21935;22190,43800,0,0,0,2,2
77252,180,16350,22411;22493,43800,0,0,0,2,2
77253,180,16390,21215,44165,0,0,0,1,1
77254,180,16391,21686,44165,0,0,0,1,1
77255,180,16393,21150,44165,0,0,0,1,1
77256,180,16395,21089,44165,0,0,0,1,1
77257,180,16397,21059,44165,0,0,0,1,1
77258,180,16398,21077;21546,44165,0,0,0,2,2
77259,180,16400,21424,44165,0,0,0,1,1
77260,180,16401,21194,44165,0,0,0,1,1
77261,180,16402,21207;22004,44165,0,0,0,2,2
77262,180,16404,21179;21233,44165,0,0,0,2,2
77263,180,16406,21029;21390,44165,0,0,0,2,2
77264,180,16407,21165;21350,44165,0,0,0,2,2
77265,180,16408,21610,44165,0,0,0,1,1
77266,180,16409,21775,44165,0,0,0,1,1
77267,180,16410,21655,44165,0,0,0,1,1
77268,180,16411,21756;21959,44165,0,0,0,2,2
77269,180,16412,21491;21569,44165,0,0,0,2,2
77270,180,16413,21639,44165,0,0,0,1,1
77271,180,16414,21606,44165,0,0,0,1,1
77272,180,16415,22311;22390,44165,0,0,0,2,2
77273,180,16418,22196,44165,0,0,0,1,1
77274,180,16419,22192,44165,0,0,0,1,1
77275,180,16420,21894;25455,44165,0,0,1,1,2
77276,180,16422,22302,44165,0,0,0,1,1
77277,180,16423,21874,44165,0,0,0,1,1
77278,180,16425,21987,44165,0,0,0,1,1
77279,180,16427,21656,44165,0,0,0,1,1
77280,180,16428,22029,44165,0,0,0,1,1
77281,180,16429,22549,44165,0,0,0,1,1
77282,180,16431,22114,44165,0,0,0,1,1
77283,180,16432,22368,44165,0,0,0,1,1
77284,180,16433,22032,44165,0,0,0,1,1
77285,180,16435,21767;22176,44165,0,0,0,2,2
77286,180,16436,22298,44165,0,0,0,1,1
77287,180,16437,21932;22499;26622;29838,44165,1,0,1,2,4
77288,180,16438,22455,44165,0,0,0,1,1
77289,180,16440,22555,44165,0,0,0,1,1
77290,180,16441,21906,44165,0,0,0,1,1
77291,180,16442,21617,44165,0,0,0,1,1
77292,180,16443,22395,44165,0,0,0,1,1
77293,180,16444,22238;22331,44165,0,0,0,2,2
77294,180,16480,20967,44530,0,0,0,1,1
77295,180,16486,21083,44530,0,0,0,1,1
77296,180,16487,21328;21450,44530,0,0,0,2,2
77297,180,16488,22084,44530,0,0,0,1,1
77298,180,16489,21740,44530,0,0,0,1,1
77299,180,16490,21570;22508,44530,0,0,0,2,2
77300,180,16491,21980,44530,0,0,0,1,1
77301,180,16494,22134,44530,0,0,0,1,1
77302,180,16495,21665,44530,0,0,0,1,1
77303,180,16497,21782,44530,0,0,0,1,1
77304,180,16498,21343,44530,0,0,0,1,1
77305,180,16499,21891,44530,0,0,0,1,1
77306,180,16501,21994;22296,44530,0,0,0,2,2
77307,180,16502,21555;21883,44530,0,0,0,2,2
77308,180,16503,21871;22137,44530,0,0,0,2,2
77309,180,16504,21886,44530,0,0,0,1,1
77310,180,16505,22012,44530,0,0,0,1,1
77311,180,16506,22006;24671,44530,0,0,1,1,2
77312,180,16507,21931,44530,0,0,0,1,1
77313,180,16510,22128;22171,44530,0,0,0,2,2
77314,180,16511,21752;21889,44530,0,0,0,2,2
77315,180,16512,22090,44530,0,0,0,1,1
77316,180,16514,22328;22489,44530,0,0,0,2,2
77317,180,16515,22104,44530,0,0,0,1,1
77318,180,16516,22699,44530,0,0,0,1,1
77319,180,16517,22178,44530,0,0,0,1,1
77320,180,16518,22632,44530,0,0,0,1,1
77321,180,16519,21674;22034,44530,0,0,0,2,2
77322,180,16520,22170;22505,44530,0,0,0,2,2
77323,180,16521,22347,44530,0,0,0,1,1
77324,180,16522,22242;22330,44530,0,0,0,2,2
77325,180,16524,22292;22485,44530,0,0,0,2,2
77326,180,16525,22023;22297,44530,0,0,0,2,2
77327,180,16526,21975;22304,44530,0,0,0,2,2
77328,180,16527,22528;22634,44530,0,0,0,2,2
77329,180,16528,22378;22696,44530,0,0,0,2,2
77330,180,16529,22046;22355,44530,0,0,0,2,2
77331,180,16530,22168,44530,0,0,0,1,1
77332,180,16531,22365,44530,0,0,0,1,1
77333,180,16553,20573,44895,0,0,0,1,1
77334,180,16567,21442,44895,0,0,0,1,1
77335,180,16571,21378,44895,0,0,0,1,1
77336,180,16572,21396;21764,44895,0,0,0,2,2
77337,180,16573,21807;21838,44895,0,0,0,2,2
77338,180,16580,21830;21919,44895,0,0,0,2,2
77339,180,16581,21578;21634,44895,0,0,0,2,2
77340,180,16585,21779,44895,0,0,0,1,1
77341,180,16586,21688,44895,0,0,0,1,1
77342,180,16588,22187;22254,44895,0,0,0,2,2
77343,180,16589,22035;22080,44895,0,0,0,2,2
77344,180,16590,22259,44895,0,0,0,1,1
77345,180,16591,21851,44895,0,0,0,1,1
77346,180,16592,21852;22327,44895,0,0,0,2,2
77347,180,16593,21650;21997,44895,0,0,0,2,2
77348,180,16595,22165,44895,0,0,0,1,1
77349,180,16596,21877,44895,0,0,0,1,1
77350,180,16597,22293;22295,44895,0,0,0,2,2
77351,180,16598,22222;22336,44895,0,0,0,2,2
77352,180,16599,22251,44895,0,0,0,1,1
77353,180,16600,22075,44895,0,0,0,1,1
77354,180,16601,21800;22077,44895,0,0,0,2,2
77355,180,16603,22322,44895,0,0,0,1,1
77356,180,16604,22101;22757,44895,0,0,0,2,2
77357,180,16605,22273;22531,44895,0,0,0,2,2
77358,180,16606,21759,44895,0,0,0,1,1
77359,180,16607,22693,44895,0,0,0,1,1
77360,180,16608,22564;22604,44895,0,0,0,2,2
77361,180,16609,22713;22740,44895,0,0,0,2,2
77362,180,16612,22496,44895,0,0,0,1,1
77363,180,16613,22051,44895,0,0,0,1,1
77364,180,16614,22314;22335,44895,0,0,0,2,2
77365,180,16615,22257,44895,0,0,0,1,1
77366,180,16616,22379,44895,0,0,0,1,1
77367,180,16617,22353;22394,44895,0,0,0,2,2
77368,180,16618,22018;22396,44895,0,0,0,2,2
77369,180,16619,22401,44895,0,0,0,1,1
77370,180,16620,22404,44895,0,0,0,1,1
77371,180,16621,22756,44895,0,0,0,1,1
77372,180,16622,22442;22695,44895,0,0,0,2,2
77373,180,16623,22452;22859,44895,0,0,0,2,2
77374,180,16624,22346;22542,44895,0,0,0,2,2
77375,180,16626,22582;22747,44895,0,0,0,2,2
77376,180,16664,21219,45260,0,0,0,1,1
77377,180,16665,21379,45260,0,0,0,1,1
77378,180,16666,21183;21530,45260,0,0,0,2,2
77379,180,16668,21609,45260,0,0,0,1,1
77380,180,16670,22359,45260,0,0,0,1,1
77381,180,16673,21654,45260,0,0,0,1,1
77382,180,16677,21960;22020,45260,0,0,0,2,2
77383,180,16678,21878,45260,0,0,0,1,1
77384,180,16679,21915;22203,45260,0,0,0,2,2
77385,180,16680,21504;22261,45260,0,0,0,2,2
77386,180,16681,21905,45260,0,0,0,1,1
77387,180,16684,22207,45260,0,0,0,1,1
77388,180,16686,22063;22158,45260,0,0,0,2,2
77389,180,16687,22097,45260,0,0,0,1,1
77390,180,16688,22270,45260,0,0,0,1,1
77391,180,16690,22595;22651,45260,0,0,0,2,2
77392,180,16691,22807,45260,0,0,0,1,1
77393,180,16692,22252;22349,45260,0,0,0,2,2
77394,180,16693,22038;22400,45260,0,0,0,2,2
77395,180,16694,22915;27132,45260,0,0,1,1,2
77396,180,16695,22326;22417,45260,0,0,0,2,2
77397,180,16696,22387,45260,0,0,0,1,1
77398,180,16697,22686;22793,45260,0,0,0,2,2
77399,180,16698,22437,45260,0,0,0,1,1
77400,180,16700,22478,45260,0,0,0,1,1
77401,180,16701,22492;22796,45260,0,0,0,2,2
77402,180,16703,22501;22619,45260,0,0,0,2,2
77403,180,16704,22780;22814;26630;29576;29666,45260,0,2,1,2,5
77404,180,16705,22169;22529,45260,0,0,0,2,2
77405,180,16706,22201;22535,45260,0,0,0,2,2
77406,180,16707,22553;22580,45260,0,0,0,2,2
77407,180,16708,22498;22556,45260,0,0,0,2,2
77408,180,16709,22560;22645,45260,0,0,0,2,2
77409,180,16710,22577,45260,0,0,0,1,1
77410,180,16712,22338;22623,45260,0,0,0,2,2
77411,180,16713,22626,45260,0,0,0,1,1
77412,180,16746,21034,45625,0,0,0,1,1
77413,180,16748,21519,45625,0,0,0,1,1
77414,180,16752,21352,45625,0,0,0,1,1
77415,180,16754,21942,45625,0,0,0,1,1
77416,180,16755,21949;22015,45625,0,0,0,2,2
77417,180,16759,21638;22026,45625,0,0,0,2,2
77418,180,16761,21419;21774,45625,0,0,0,2,2
77419,180,16762,22768,45625,0,0,0,1,1
77420,180,16764,21958;21970,45625,0,0,0,2,2
77421,180,16765,21721,45625,0,0,0,1,1
77422,180,16766,22362,45625,0,0,0,1,1
77423,180,16767,22039;22245,45625,0,0,0,2,2
77424,180,16768,22048;22476,45625,0,0,0,2,2
77425,180,16769,21853;22073,45625,0,0,0,2,2
77426,180,16770,22561,45625,0,0,0,1,1
77427,180,16772,22122,45625,0,0,0,1,1
77428,180,16773,22878;22890;26841,45625,0,0,1,2,3
77429,180,16774,22126;22638,45625,0,0,0,2,2
77430,180,16775,22001,45625,0,0,0,1,1
77431,180,16777,22237;22403,45625,0,0,0,2,2
77432,180,16778,22422;22681,45625,0,0,0,2,2
77433,180,16779,22154;22808,45625,0,0,0,2,2
77434,180,16781,22622,45625,0,0,0,1,1
77435,180,16782,22070;22540,45625,0,0,0,2,2
77436,180,16783,22418;22545,45625,0,0,0,2,2
77437,180,16784,22319;22374,45625,0,0,0,2,2
77438,180,16785,22584,45625,0,0,0,1,1
77439,180,16786,23052;27135;29510;29685,45625,0,2,1,1,4
77440,180,16787,22912;23098,45625,0,0,0,2,2
77441,180,16788,22939,45625,0,0,0,1,1
77442,180,16790,22679;22961,45625,0,0,0,2,2
77443,180,16791,22839,45625,0,0,0,1,1
77444,180,16793,22218,45625,0,0,0,1,1
77445,180,16794,22812,45625,0,0,0,1,1
77446,180,16795,22708;22832,45625,0,0,0,2,2
77447,180,16796,22701;22714,45625,0,0,0,2,2
77448,180,16798,22742,45625,0,0,0,1,1
77449,180,16799,22572;22745,45625,0,0,0,2,2
77450,180,16800,22658;22822,45625,0,0,0,2,2
77451,180,16801,22610;22770,45625,0,0,0,2,2
77452,180,16832,20346,45990,0,0,0,1,1
77453,180,16836,20902,45990,0,0,0,1,1
77454,180,16837,21032,45990,0,0,0,1,1
77455,180,16841,21134;21713,45990,0,0,0,2,2
77456,180,16843,21500,45990,0,0,0,1,1
77457,180,16845,22166,45990,0,0,0,1,1
77458,180,16847,22069,45990,0,0,0,1,1
77459,180,16848,21720,45990,0,0,0,1,1
77460,180,16849,21733;22150,45990,0,0,0,2,2
77461,180,16851,21846,45990,0,0,0,1,1
77462,180,16852,22217,45990,0,0,0,1,1
77463,180,16853,22130,45990,0,0,0,1,1
77464,180,16854,21598;22231,45990,0,0,0,2,2
77465,180,16856,21976,45990,0,0,0,1,1
77466,180,16857,22246,45990,0,0,0,1,1
77467,180,16860,22278,45990,0,0,0,1,1
77468,180,16861,22351,45990,0,0,0,1,1
77469,180,16862,22461,45990,0,0,0,1,1
77470,180,16863,22413;22743,45990,0,0,0,2,2
77471,180,16864,22784,45990,0,0,0,1,1
77472,180,16865,22197;22450,45990,0,0,0,2,2
77473,180,16866,22917,45990,0,0,0,1,1
77474,180,16867,22465;22617,45990,0,0,0,2,2
77475,180,16868,22761;22936,45990,0,0,0,2,2
77476,180,16869,22538;22726,45990,0,0,0,2,2
77477,180,16870,22616,45990,0,0,0,1,1
77478,180,16871,22471;22557,45990,0,0,0,2,2
77479,180,16872,22715,45990,0,0,0,1,1
77480,180,16874,22255;22676;25782,45990,0,0,1,2,3
77481,180,16875,22683,45990,0,0,0,1,1
77482,180,16876,22694;22852,45990,0,0,0,2,2
77483,180,16878,23014,45990,0,0,0,1,1
77484,180,16879,22809;22941,45990,0,0,0,2,2
77485,180,16881,22884,45990,0,0,0,1,1
77486,180,16916,21322,46355,0,0,0,1,1
77487,180,16922,21699;21739,46355,0,0,0,2,2
77488,180,16925,21729,46355,0,0,0,1,1
77489,180,16928,22185,46355,0,0,0,1,1
77490,180,16929,21848;22229,46355,0,0,0,2,2
77491,180,16932,22173,46355,0,0,0,1,1
77492,180,16934,22449,46355,0,0,0,1,1
77493,180,16936,22249,46355,0,0,0,1,1
77494,180,16937,22306;22820,46355,0,0,0,2,2
77495,180,16938,23166,46355,0,0,0,1,1
77496,180,16939,22578,46355,0,0,0,1,1
77497,180,16940,22342;22598,46355,0,0,0,2,2
77498,180,16943,22371,46355,0,0,0,1,1
77499,180,16944,22785,46355,0,0,0,1,1
77500,180,16946,22415;22948,46355,0,0,0,2,2
77501,180,16948,22163;22563,46355,0,0,0,2,2
77502,180,16949,21966;22451,46355,0,0,0,2,2
77503,180,16950,22525;22792,46355,0,0,0,2,2
77504,180,16952,22290;22487,46355,0,0,0,2,2
77505,180,16953,22687,46355,0,0,0,1,1
77506,180,16954,22629;22731,46355,0,0,0,2,2
77507,180,16955,22102,46355,0,0,0,1,1
77508,180,16956,22225;22602,46355,0,0,0,2,2
77509,180,16957,22660;22864,46355,0,0,0,2,2
77510,180,16958,22624;23219;26854,46355,0,0,1,2,3
77511,180,16959,22637,46355,0,0,0,1,1
77512,180,16960,22607,46355,0,0,0,1,1
77513,180,16962,22700;23008,46355,0,0,0,2,2
77514,180,16963,22965,46355,0,0,0,1,1
77515,180,16964,22174;22750,46355,0,0,0,2,2
77516,180,16965,22762,46355,0,0,0,1,1
77517,180,16966,22497;22775,46355,0,0,0,2,2
77518,180,16967,22835;23205,46355,0,0,0,2,2
77519,180,16969,22850,46355,0,0,0,1,1
77520,180,16971,22886;23250,46355,0,0,0,2,2
77521,180,16972,22763;22895,46355,0,0,0,2,2
77522,180,16973,22916;23178;26644,46355,0,0,1,2,3
77523,180,16974,22530;22937,46355,0,0,0,2,2
77524,180,16975,23080;23206,46355,0,0,0,2,2
77525,180,16977,22987,46355,0,0,0,1,1
77526,180,16979,22585;23248,46355,0,0,0,2,2
77527,180,17007,21017,46720,0,0,0,1,1
77528,180,17011,21509,46720,0,0,0,1,1
77529,180,17018,21907;22142,46720,0,0,0,2,2
77530,180,17020,21979;22213,46720,0,0,0,2,2
77531,180,17021,22454,46720,0,0,0,1,1
77532,180,17022,22674;22922,46720,0,0,0,2,2
77533,180,17023,22205,46720,0,0,0,1,1
77534,180,17024,22565;22652,46720,0,0,0,2,2
77535,180,17026,22265,46720,0,0,0,1,1
77536,180,17027,22209;22279,46720,0,0,0,2,2
77537,180,17028,22283;22752,46720,0,0,0,2,2
77538,180,17029,22325,46720,0,0,0,1,1
77539,180,17030,22825,46720,0,0,0,1,1
77540,180,17031,22236,46720,0,0,0,1,1
77541,180,17032,22383;22871,46720,0,0,0,2,2
77542,180,17034,21925;22407,46720,0,0,0,2,2
77543,180,17035,22429,46720,0,0,0,1,1
77544,180,17036,22503,46720,0,0,0,1,1
77545,180,17038,22433;22521,46720,0,0,0,2,2
77546,180,17039,22344;22551,46720,0,0,0,2,2
77547,180,17040,22606,46720,0,0,0,1,1
77548,180,17041,22799;23146,46720,0,0,0,2,2
77549,180,17042,22712;22956,46720,0,0,0,2,2
77550,180,17043,22786;23279,46720,0,0,0,2,2
77551,180,17045,22444;22728,46720,0,0,0,2,2
77552,180,17046,22790;23101,46720,0,0,0,2,2
77553,180,17047,22643,46720,0,0,0,1,1
77554,180,17049,22861;22918,46720,0,0,0,2,2
77555,180,17050,23136;23380,46720,0,0,0,2,2
77556,180,17051,22919,46720,0,0,0,1,1
77557,180,17052,22718;23045,46720,0,0,0,2,2
77558,180,17053,22801,46720,0,0,0,1,1
77559,180,17055,22951,46720,0,0,0,1,1
77560,180,17056,23038,46720,0,0,0,1,1
77561,180,17057,23016;23243,46720,0,0,0,2,2
77562,180,17059,23022;23049,46720,0,0,0,2,2
77563,180,17060,23023;23230,46720,0,0,0,2,2
77564,180,17061,22559;23036,46720,0,0,0,2,2
77565,180,17062,22706;23026,46720,0,0,0,2,2
77566,180,17063,23194;23541,46720,0,0,0,2,2
77567,180,17064,23216;23267,46720,0,0,0,2,2
77568,180,17065,23024;23056,46720,0,0,0,2,2
77569,180,17066,23239,46720,0,0,0,1,1
77570,180,17067,23027;23102,46720,0,0,0,2,2
77571,180,17100,20706,47085,0,0,0,1,1
77572,180,17101,21258;21497,47085,0,0,0,2,2
77573,180,17105,21317,47085,0,0,0,1,1
77574,180,17109,21928,47085,0,0,0,1,1
77575,180,17110,21753;22061,47085,0,0,0,2,2
77576,180,17112,22271;22480,47085,0,0,0,2,2
77577,180,17114,22513;22760,47085,0,0,0,2,2
77578,180,17116,22155;22445,47085,0,0,0,2,2
77579,180,17117,22566,47085,0,0,0,1,1
77580,180,17119,22615;22869,47085,0,0,0,2,2
77581,180,17120,22730;22837,47085,0,0,0,2,2
77582,180,17121,22778;22873;27236,47085,0,0,1,2,3
77583,180,17125,22448,47085,0,0,0,1,1
77584,180,17127,22486,47085,0,0,0,1,1
77585,180,17128,22516,47085,0,0,0,1,1
77586,180,17129,23094,47085,0,0,0,1,1
77587,180,17132,22608,47085,0,0,0,1,1
77588,180,17133,22853,47085,0,0,0,1,1
77589,180,17135,22072;22702,47085,0,0,0,2,2
77590,180,17136,22711,47085,0,0,0,1,1
77591,180,17137,22352,47085,0,0,0,1,1
77592,180,17138,22357;22841,47085,0,0,0,2,2
77593,180,17139,22630;22717,47085,0,0,0,2,2
77594,180,17140,23030;25700,47085,0,0,1,1,2
77595,180,17141,22375;22828,47085,0,0,0,2,2
77596,180,17142,22920,47085,0,0,0,1,1
77597,180,17143,22845;23322;26191,47085,0,0,1,2,3
77598,180,17145,23300;23379,47085,0,0,0,2,2
77599,180,17146,23187;23301,47085,0,0,0,2,2
77600,180,17148,22848;23108,47085,0,0,0,2,2
77601,180,17150,22935;23269,47085,0,0,0,2,2
77602,180,17151,23393,47085,0,0,0,1,1
77603,180,17152,22727,47085,0,0,0,1,1
77604,180,17153,22981;23053,47085,0,0,0,2,2
77605,180,17154,22547;23071,47085,0,0,0,2,2
77606,180,17155,23476,47085,0,0,0,1,1
77607,180,17158,23470,47085,0,0,0,1,1
77608,180,17159,23087;23161,47085,0,0,0,2,2
77609,180,17160,23168,47085,0,0,0,1,1
77610,180,17161,23007;23177,47085,0,0,0,2,2
77611,180,17163,23183;23407;27242,47085,0,0,1,2,3
77612,180,17164,23218;23299;27336,47085,0,0,1,2,3
77613,180,17188,21456;21822,47450,0,0,0,2,2
77614,180,17196,21557;21999,47450,0,0,0,2,2
77615,180,17197,22019,47450,0,0,0,1,1
77616,180,17201,22377;22548,47450,0,0,0,2,2
77617,180,17204,22287;22308;25950,47450,0,0,1,2,3
77618,180,17205,21825;22089,47450,0,0,0,2,2
77619,180,17213,22339;22573,47450,0,0,0,2,2
77620,180,17214,23048,47450,0,0,0,1,1
77621,180,17216,22348;22416,47450,0,0,0,2,2
77622,180,17217,22704;22826,47450,0,0,0,2,2
77623,180,17218,22188;22443,47450,0,0,0,2,2
77624,180,17219,22511;22758,47450,0,0,0,2,2
77625,180,17221,22382;22587,47450,0,0,0,2,2
77626,180,17222,22967,47450,0,0,0,1,1
77627,180,17223,22605,47450,0,0,0,1,1
77628,180,17224,23155,47450,0,0,0,1,1
77629,180,17225,22748,47450,0,0,0,1,1
77630,180,17226,22753;23013,47450,0,0,0,2,2
77631,180,17227,22226;22776,47450,0,0,0,2,2
77632,180,17228,22781,47450,0,0,0,1,1
77633,180,17229,22783,47450,0,0,0,1,1
77634,180,17230,23018;23492,47450,0,0,0,2,2
77635,180,17231,22829;23095,47450,0,0,0,2,2
77636,180,17232,22435;23085,47450,0,0,0,2,2
77637,180,17234,22914;23318,47450,0,0,0,2,2
77638,180,17235,22923;23260;27763,47450,0,0,1,2,3
77639,180,17236,22947;23039,47450,0,0,0,2,2
77640,180,17237,22963;22992,47450,0,0,0,2,2
77641,180,17239,23112,47450,0,0,0,1,1
77642,180,17241,22539;22994,47450,0,0,0,2,2
77643,180,17242,22751;22996,47450,0,0,0,2,2
77644,180,17243,22720;23005,47450,0,0,0,2,2
77645,180,17244,23154,47450,0,0,0,1,1
77646,180,17246,23028;23417,47450,0,0,0,2,2
77647,180,17248,23180;23185,47450,0,0,0,2,2
77648,180,17250,22903;23091,47450,0,0,0,2,2
77649,180,17251,23373;23479,47450,0,0,0,2,2
77650,180,17252,23119,47450,0,0,0,1,1
77651,180,17253,23435,47450,0,0,0,1,1
77652,180,17254,23111;23339,47450,0,0,0,2,2
77653,180,17255,23179;23199,47450,0,0,0,2,2
77654,180,17256,23273;23324,47450,0,0,0,2,2
77655,180,17257,23058,47450,0,0,0,1,1
77656,180,17258,23223;23235,47450,0,0,0,2,2
77657,180,17260,23259;23360,47450,0,0,0,2,2
77658,180,17261,22986;23265,47450,0,0,0,2,2
77659,180,17262,23271;23340,47450,0,0,0,2,2
77660,180,17263,22803;23293,47450,0,0,0,2,2
77661,180,17283,20853,47815,0,0,0,1,1
77662,180,17288,21340,47815,0,0,0,1,1
77663,180,17290,21190,47815,0,0,0,1,1
77664,180,17291,21166,47815,0,0,0,1,1
77665,180,17292,21348,47815,0,0,0,1,1
77666,180,17295,21640,47815,0,0,0,1,1
77667,180,17301,22088;22655,47815,0,0,0,2,2
77668,180,17303,22402;22810,47815,0,0,0,2,2
77669,180,17304,21879,47815,0,0,0,1,1
77670,180,17305,21991;22256,47815,0,0,0,2,2
77671,180,17307,22666,47815,0,0,0,1,1
77672,180,17308,22436;22705,47815,0,0,0,2,2
77673,180,17310,22482,47815,0,0,0,1,1
77674,180,17311,22491;22847,47815,0,0,0,2,2
77675,180,17312,22258;22568,47815,0,0,0,2,2
77676,180,17315,23015,47815,0,0,0,1,1
77677,180,17316,22931,47815,0,0,0,1,1
77678,180,17317,22735,47815,0,0,0,1,1
77679,180,17318,22641;22737,47815,0,0,0,2,2
77680,180,17319,22363;22759,47815,0,0,0,2,2
77681,180,17321,22721,47815,0,0,0,1,1
77682,180,17322,22927;23349;27036,47815,0,0,1,2,3
77683,180,17323,22883,47815,0,0,0,1,1
77684,180,17324,22782;26732;29583,47815,0,1,1,1,3
77685,180,17325,22906,47815,0,0,0,1,1
77686,180,17327,22603;23115,47815,0,0,0,2,2
77687,180,17328,23044;23134,47815,0,0,0,2,2
77688,180,17330,23554,47815,0,0,0,1,1
77689,180,17331,23132;23192,47815,0,0,0,2,2
77690,180,17333,22662;23001,47815,0,0,0,2,2
77691,180,17334,23184;23244,47815,0,0,0,2,2
77692,180,17336,23281;26857;27440,47815,0,0,2,1,3
77693,180,17337,23089;23581;27653;29706,47815,0,1,1,2,4
77694,180,17338,22766;23153,47815,0,0,0,2,2
77695,180,17339,23120,47815,0,0,0,1,1
77696,180,17341,23681,47815,0,0,0,1,1
77697,180,17342,23145,47815,0,0,0,1,1
77698,180,17343,23160;23288,47815,0,0,0,2,2
77699,180,17344,22938;23200,47815,0,0,0,2,2
77700,180,17345,23226,47815,0,0,0,1,1
77701,180,17346,23151;23498;27040,47815,0,0,1,2,3
77702,180,17347,23188;23263,47815,0,0,0,2,2
77703,180,17348,22928;23264;27032,47815,0,0,1,2,3
77704,180,17349,23096;23274,47815,0,0,0,2,2
77705,180,17350,23488;23639,47815,0,0,0,2,2
77706,180,17351,22962;23503,47815,0,0,0,2,2
77707,180,17352,23572,47815,0,0,0,1,1
77708,180,17353,23616,47815,0,0,0,1,1
77709,180,17354,23277;23366,47815,0,0,0,2,2
77710,180,17355,23384;23732;27264;27567,47815,0,0,2,2,4
77711,180,17357,22924;23400,47815,0,0,0,2,2
77712,180,17385,21478,48180,0,0,0,1,1
77713,180,17387,21068;21404,48180,0,0,0,2,2
77714,180,17392,21620,48180,0,0,0,1,1
77715,180,17397,21821,48180,0,0,0,1,1
77716,180,17398,21990,48180,0,0,0,1,1
77717,180,17401,22581,48180,0,0,0,1,1
77718,180,17402,22280,48180,0,0,0,1,1
77719,180,17405,22045;22159,48180,0,0,0,2,2
77720,180,17407,22167,48180,0,0,0,1,1
77721,180,17408,22067,48180,0,0,0,1,1
77722,180,17409,22354;22849,48180,0,0,0,2,2
77723,180,17410,22268,48180,0,0,0,1,1
77724,180,17411,22468,48180,0,0,0,1,1
77725,180,17412,22469,48180,0,0,0,1,1
77726,180,17413,22220;22483,48180,0,0,0,2,2
77727,180,17415,25591;25965,48180,0,0,2,0,2
77728,180,17416,22527;22846,48180,0,0,0,2,2
77729,180,17417,21963,48180,0,0,0,1,1
77730,180,17419,22239;22571;26166;28911;29182,48180,0,2,1,2,5
77731,180,17420,22593;23104,48180,0,0,0,2,2
77732,180,17421,22749;22893,48180,0,0,0,2,2
77733,180,17422,22802;22911,48180,0,0,0,2,2
77734,180,17423,22635,48180,0,0,0,1,1
77735,180,17424,23046;23143,48180,0,0,0,2,2
77736,180,17425,22710;22805,48180,0,0,0,2,2
77737,180,17426,22668;22882,48180,0,0,0,2,2
77738,180,17427,22601;22691,48180,0,0,0,2,2
77739,180,17428,22692,48180,0,0,0,1,1
77740,180,17429,22719,48180,0,0,0,1,1
77741,180,17430,22111;22591,48180,0,0,0,2,2
77742,180,17431,22186,48180,0,0,0,1,1
77743,180,17432,22440,48180,0,0,0,1,1
77744,180,17434,22823;23064,48180,0,0,0,2,2
77745,180,17435,22473;22870,48180,0,0,0,2,2
77746,180,17436,22842;22876,48180,0,0,0,2,2
77747,180,17437,22933,48180,0,0,0,1,1
77748,180,17438,22467;23173;25312;27945;28698;29331,48180,0,2,2,2,6
77749,180,17440,23237;23526,48180,0,0,0,2,2
77750,180,17441,22980,48180,0,0,0,1,1
77751,180,17442,22795,48180,0,0,0,1,1
77752,180,17443,23060,48180,0,0,0,1,1
77753,180,17444,28173,48180,0,0,1,0,1
77754,180,17445,23575,48180,0,0,0,1,1
77755,180,17446,23086;23452,48180,0,0,0,2,2
77756,180,17447,22971;23189;26850;29218;29936,48180,1,1,1,2,5
77757,180,17449,23726;23865,48180,0,0,1,1,2
77758,180,17452,23846;24110,48180,0,0,1,1,2
77759,180,17454,23286;23315,48180,0,0,0,2,2
77760,180,17456,23510,48180,0,0,0,1,1
77761,180,17457,23589;23601;26767,48180,0,0,1,2,3
77762,180,17460,22970;23370,48180,0,0,0,2,2
77763,180,17461,23621;23645,48180,0,0,0,2,2
77764,180,17462,23442;23521;27042,48180,0,0,1,2,3
77765,180,17463,23292,48180,0,0,0,1,1
77766,180,17464,23418;23440,48180,0,0,0,2,2
77767,180,17465,23376;23472,48180,0,0,0,2,2
77768,180,17466,23332;23432,48180,0,0,0,2,2
77769,180,17467,23169;23627,48180,0,0,0,2,2
77770,180,17468,23424;23459,48180,0,0,0,2,2
77771,180,17469,22964,48180,0,0,0,1,1
77772,180,17470,23316;23751,48180,0,0,0,2,2
77773,180,17471,23385;23606,48180,0,0,0,2,2
77774,180,17472,23490;23505,48180,0,0,0,2,2
77775,180,17473,23499;23938,48180,0,0,1,1,2
77776,180,17487,20173,48545,0,0,0,1,1
77777,180,17489,20848,48545,0,0,0,1,1
77778,180,17498,21131,48545,0,0,0,1,1
77779,180,17512,22867,48545,0,0,0,1,1
77780,180,17513,21540;21944,48545,0,0,0,2,2
77781,180,17515,22520,48545,0,0,0,1,1
77782,180,17516,22135;22248,48545,0,0,0,2,2
77783,180,17518,22189;22620,48545,0,0,0,2,2
77784,180,17519,22439;22518,48545,0,0,0,2,2
77785,180,17522,22868,48545,0,0,0,1,1
77786,180,17524,21962;22392,48545,0,0,0,2,2
77787,180,17525,22323;22397,48545,0,0,0,2,2
77788,180,17526,23117;23209,48545,0,0,0,2,2
77789,180,17528,22284;22430,48545,0,0,0,2,2
77790,180,17529,22532;23158,48545,0,0,0,2,2
77791,180,17530,22791,48545,0,0,0,1,1
77792,180,17532,22858;23003,48545,0,0,0,2,2
77793,180,17533,23126;23162,48545,0,0,0,2,2
77794,180,17534,22736;22926,48545,0,0,0,2,2
77795,180,17536,22408;22633,48545,0,0,0,2,2
77796,180,17537,22889;23358;26755,48545,0,0,1,2,3
77797,180,17540,22665;22824,48545,0,0,0,2,2
77798,180,17541,22541,48545,0,0,0,1,1
77799,180,17542,22955,48545,0,0,0,1,1
77800,180,17543,22907,48545,0,0,0,1,1
77801,180,17544,23116,48545,0,0,0,1,1
77802,180,17545,23070;23744,48545,0,0,0,2,2
77803,180,17546,23011,48545,0,0,0,1,1
77804,180,17547,23311;23361,48545,0,0,0,2,2
77805,180,17548,23084;23458;26480,48545,0,0,1,2,3
77806,180,17549,23150;23257,48545,0,0,0,2,2
77807,180,17550,23555;23754,48545,0,0,0,2,2
77808,180,17552,23217,48545,0,0,0,1,1
77809,180,17553,23050;23559;27445,48545,0,0,1,2,3
77810,180,17554,23337;23389,48545,0,0,0,2,2
77811,180,17555,22972;23304,48545,0,0,0,2,2
77812,180,17556,23319,48545,0,0,0,1,1
77813,180,17557,23342,48545,0,0,0,1,1
77814,180,17558,23386;23405,48545,0,0,0,2,2
77815,180,17559,22942;23395,48545,0,0,0,2,2
77816,180,17560,23689;24032,48545,0,0,1,1,2
77817,180,17561,23428;23662,48545,0,0,0,2,2
77818,180,17562,23107,48545,0,0,0,1,1
77819,180,17563,23415;23439,48545,0,0,0,2,2
77820,180,17564,23283;23615,48545,0,0,0,2,2
77821,180,17565,23388;23454;27442,48545,0,0,1,2,3
77822,180,17567,23493;23785,48545,0,0,0,2,2
77823,180,17568,23377;23515;27250,48545,0,0,1,2,3
77824,180,17569,23538,48545,0,0,0,1,1
77825,180,17570,23821,48545,0,0,0,1,1
77826,180,17571,23308;23562,48545,0,0,0,2,2
77827,180,17572,23568;23918,48545,0,0,1,1,2
77828,180,17573,23468,48545,0,0,0,1,1
77829,180,17580,20350,48910,0,0,0,1,1
77830,180,17599,22458,48910,0,0,0,1,1
77831,180,17603,21812;22393,48910,0,0,0,2,2
77832,180,17604,22369;22663,48910,0,0,0,2,2
77833,180,17606,22472,48910,0,0,0,1,1
77834,180,17608,22423;22438,48910,0,0,0,2,2
77835,180,17609,22463;22554,48910,0,0,0,2,2
77836,180,17610,22464,48910,0,0,0,1,1
77837,180,17611,22453;23152,48910,0,0,0,2,2
77838,180,17614,22543;22653,48910,0,0,0,2,2
77839,180,17615,22642;23078,48910,0,0,0,2,2
77840,180,17617,23475,48910,0,0,0,1,1
77841,180,17618,22755;23394,48910,0,0,0,2,2
77842,180,17619,22819,48910,0,0,0,1,1
77843,180,17621,22788;22978;26637;29839;30002,48910,2,0,1,2,5
77844,180,17623,22894;23113,48910,0,0,0,2,2
77845,180,17626,22729;22979,48910,0,0,0,2,2
77846,180,17627,22988;23076,48910,0,0,0,2,2
77847,180,17628,23233,48910,0,0,0,1,1
77848,180,17629,22879;23017,48910,0,0,0,2,2
77849,180,17630,22431;23138,48910,0,0,0,2,2
77850,180,17631,23042;25701,48910,0,0,1,1,2
77851,180,17632,23167;23372;26386;29095;29197;29293,48910,0,3,1,2,6
77852,180,17633,23037;23607,48910,0,0,0,2,2
77853,180,17634,22950;23202,48910,0,0,0,2,2
77854,180,17635,23350;23709,48910,0,0,0,2,2
77855,180,17637,23242;23434,48910,0,0,0,2,2
77856,180,17638,23696;23710;26878;27157;29419,48910,0,1,2,2,5
77857,180,17639,23722;23735,48910,0,0,0,2,2
77858,180,17640,23252;23736,48910,0,0,0,2,2
77859,180,17641,23148;23149,48910,0,0,0,2,2
77860,180,17642,23313;23330,48910,0,0,0,2,2
77861,180,17643,23548,48910,0,0,0,1,1
77862,180,17645,23647;23781,48910,0,0,0,2,2
77863,180,17646,23482,48910,0,0,0,1,1
77864,180,17647,23341;23387,48910,0,0,0,2,2
77865,180,17648,23198;23410,48910,0,0,0,2,2
77866,180,17649,23966;24075;27365;27463,48910,0,0,4,0,4
77867,180,17650,23513;24015;27661,48910,0,0,2,1,3
77868,180,17651,23256;23449,48910,0,0,0,2,2
77869,180,17653,23577;23641,48910,0,0,0,2,2
77870,180,17654,23489;23612,48910,0,0,0,2,2
77871,180,17655,23525;26762,48910,0,0,1,1,2
77872,180,17656,23368;23506,48910,0,0,0,2,2
77873,180,17657,24067,48910,0,0,1,0,1
77874,180,17658,27570,48910,0,0,1,0,1
77875,180,17659,23523;23835;27859,48910,0,0,1,2,3
77876,180,17660,23403;23780;27352,48910,0,0,1,2,3
77877,180,17661,23529;23537,48910,0,0,0,2,2
77878,180,17662,23579;23699,48910,0,0,0,2,2
77879,180,17663,23451;23585;27254;27654;30040,48910,1,0,2,2,5
77880,180,17664,23502;24058;27471;28177,48910,0,0,3,1,4
77881,180,17665,23642,48910,0,0,0,1,1
77882,180,17667,23688;23698,48910,0,0,0,2,2
77883,180,17668,23123;23703,48910,0,0,0,2,2
77884,180,17693,21452;21568,49275,0,0,0,2,2
77885,180,17699,21685;22228,49275,0,0,0,2,2
77886,180,17702,22410,49275,0,0,0,1,1
77887,180,17705,23159;23215,49275,0,0,0,2,2
77888,180,17706,22506;22901,49275,0,0,0,2,2
77889,180,17707,22857,49275,0,0,0,1,1
77890,180,17709,22523;22834,49275,0,0,0,2,2
77891,180,17710,22649,49275,0,0,0,1,1
77892,180,17711,22600;23012,49275,0,0,0,2,2
77893,180,17715,22689,49275,0,0,0,1,1
77894,180,17716,22723;25594;28791;28875,49275,0,2,1,1,4
77895,180,17717,22954,49275,0,0,0,1,1
77896,180,17720,22902,49275,0,0,0,1,1
77897,180,17723,23130;23353,49275,0,0,0,2,2
77898,180,17724,22488;23041;26000;26845,49275,0,0,2,2,4
77899,180,17726,23220,49275,0,0,0,1,1
77900,180,17727,23708,49275,0,0,0,1,1
77901,180,17728,23033;23825,49275,0,0,0,2,2
77902,180,17729,23328;23678,49275,0,0,0,2,2
77903,180,17730,23809;23952,49275,0,0,1,1,2
77904,180,17731,23383;23391,49275,0,0,0,2,2
77905,180,17732,23238;23411,49275,0,0,0,2,2
77906,180,17733,23164;23491,49275,0,0,0,2,2
77907,180,17734,24224,49275,0,0,1,0,1
77908,180,17735,23516;23675,49275,0,0,0,2,2
77909,180,17736,23916,49275,0,0,1,0,1
77910,180,17737,24145;27778,49275,0,0,2,0,2
77911,180,17738,23542,49275,0,0,0,1,1
77912,180,17739,23587;23614,49275,0,0,0,2,2
77913,180,17740,23590;23977,49275,0,0,1,1,2
77914,180,17741,23963;27862;29976,49275,1,0,2,0,3
77915,180,17742,23640;23771,49275,0,0,0,2,2
77916,180,17743,23310;23552,49275,0,0,0,2,2
77917,180,17744,23573;23630;26958;27346,49275,0,0,2,2,4
77918,180,17745,23653,49275,0,0,0,1,1
77919,180,17746,23670,49275,0,0,0,1,1
77920,180,17748,23593;24111;28180,49275,0,0,2,1,3
77921,180,17749,23309;23782,49275,0,0,0,2,2
77922,180,17751,23326;23877;26790;26975;27576,49275,0,0,4,1,5
77923,180,17752,23495;23762,49275,0,0,0,2,2
77924,180,17753,23797;23965;27364;29517;29962,49275,1,1,2,1,5
77925,180,17756,23422;23820,49275,0,0,0,2,2
77926,180,17759,23609;23795,49275,0,0,0,2,2
77927,180,17777,20661;20686,49640,0,0,0,2,2
77928,180,17778,20857,49640,0,0,0,1,1
77929,180,17780,21311,49640,0,0,0,1,1
77930,180,17788,21545,49640,0,0,0,1,1
77931,180,17793,21996,49640,0,0,0,1,1
77932,180,17794,21983;22110,49640,0,0,0,2,2
77933,180,17795,21855;22193,49640,0,0,0,2,2
77934,180,17801,22517;23139;27334,49640,0,0,1,2,3
77935,180,17802,22949,49640,0,0,0,1,1
77936,180,17803,22709,49640,0,0,0,1,1
77937,180,17806,22744;22934,49640,0,0,0,2,2
77938,180,17807,22247;22816,49640,0,0,0,2,2
77939,180,17808,23055;23426,49640,0,0,0,2,2
77940,180,17809,23543;27443,49640,0,0,1,1,2
77941,180,17811,23196;23433;27137;29599,49640,0,1,1,2,4
77942,180,17812,23125,49640,0,0,0,1,1
77943,180,17813,23774;23947,49640,0,0,1,1,2
77944,180,17816,22932,49640,0,0,0,1,1
77945,180,17818,23335;23706,49640,0,0,0,2,2
77946,180,17819,23195;23346,49640,0,0,0,2,2
77947,180,17822,23129,49640,0,0,0,1,1
77948,180,17823,23683,49640,0,0,0,1,1
77949,180,17825,23983,49640,0,0,1,0,1
77950,180,17826,23588;23673,49640,0,0,0,2,2
77951,180,17827,23664;23827,49640,0,0,0,2,2
77952,180,17829,23446;23870,49640,0,0,1,1,2
77953,180,17831,23677,49640,0,0,0,1,1
77954,180,17832,23756,49640,0,0,0,1,1
77955,180,17833,23798;24208,49640,0,0,1,1,2
77956,180,17834,23801;23885,49640,0,0,1,1,2
77957,180,17835,23913;24118,49640,0,0,2,0,2
77958,180,17837,23409;23878,49640,0,0,1,1,2
77959,180,17838,23909;24179;26917;27869;29312;29766,49640,0,2,4,0,6
77960,180,17839,23816;23926,49640,0,0,1,1,2
77961,180,17840,23518;23932,49640,0,0,1,1,2
77962,180,17841,23901;24241,49640,0,0,2,0,2
77963,180,17842,23297;24031,49640,0,0,1,1,2
77964,180,17846,20483,50005,0,0,0,1,1
77965,180,17865,22074,50005,0,0,0,1,1
77966,180,17867,22366,50005,0,0,0,1,1
77967,180,17869,22144;22263,50005,0,0,0,2,2
77968,180,17874,22570;22953,50005,0,0,0,2,2
77969,180,17875,22116;22389,50005,0,0,0,2,2
77970,180,17876,22441,50005,0,0,0,1,1
77971,180,17878,21982;22191,50005,0,0,0,2,2
77972,180,17880,22574;22774,50005,0,0,0,2,2
77973,180,17884,22943;23306,50005,0,0,0,2,2
77974,180,17886,23006;23197,50005,0,0,0,2,2
77975,180,17887,23347;23685;27051,50005,0,0,1,2,3
77976,180,17889,23083,50005,0,0,0,1,1
77977,180,17890,22959;23092,50005,0,0,0,2,2
77978,180,17891,23221;23450,50005,0,0,0,2,2
77979,180,17892,22905;27131,50005,0,0,1,1,2
77980,180,17893,23592,50005,0,0,0,1,1
77981,180,17894,23624;23626;27564,50005,0,0,1,2,3
77982,180,17895,23750,50005,0,0,0,1,1
77983,180,17896,23352;23880,50005,0,0,1,1,2
77984,180,17897,23381,50005,0,0,0,1,1
77985,180,17899,23933,50005,0,0,1,0,1
77986,180,17900,23284;23427,50005,0,0,0,2,2
77987,180,17903,23824,50005,0,0,0,1,1
77988,180,17905,23519,50005,0,0,0,1,1
77989,180,17906,23528;23758,50005,0,0,0,2,2
77990,180,17907,23535;23908,50005,0,0,1,1,2
77991,180,17908,23075;23547;27046,50005,0,0,1,2,3
77992,180,17909,23657,50005,0,0,0,1,1
77993,180,17910,23912;23964,50005,0,0,2,0,2
77994,180,17911,23582;23702,50005,0,0,0,2,2
77995,180,17912,23799,50005,0,0,0,1,1
77996,180,17913,23636;23960,50005,0,0,1,1,2
77997,180,17914,23287;23671,50005,0,0,0,2,2
77998,180,17915,23431;23900,50005,0,0,1,1,2
77999,180,17916,23719;24029,50005,0,0,1,1,2
78000,180,17917,24248,50005,0,0,1,0,1
78001,180,17918,23546;23773,50005,0,0,0,2,2
78002,180,17919,23777;23887,50005,0,0,1,1,2
78003,180,17920,23533;23783,50005,0,0,0,2,2
78004,180,17922,23471;23802,50005,0,0,0,2,2
78005,180,17923,24152,50005,0,0,1,0,1
78006,180,17924,23687;23826,50005,0,0,0,2,2
78007,180,17925,23832;23982,50005,0,0,1,1,2
78008,180,17926,23619;23851,50005,0,0,1,1,2
78009,180,17927,24044;24245,50005,0,0,2,0,2
78010,180,17928,23978;24226,50005,0,0,2,0,2
78011,180,17930,24221,50005,0,0,1,0,1
78012,180,17931,24100;24277,50005,0,0,2,0,2
78013,180,17932,23276;23954,50005,0,0,1,1,2
78014,180,17934,23654;23969,50005,0,0,1,1,2
78015,180,17935,23866;24001,50005,0,0,2,0,2
78016,180,17937,23990;24348,50005,0,0,2,0,2
78017,180,17938,23796;23995;26594;28364;29835,50005,1,0,3,1,5
78018,180,17939,23775;23917,50005,0,0,1,1,2
78019,180,17940,23748;24016,50005,0,0,1,1,2
78020,180,17942,24030;24266,50005,0,0,2,0,2
78021,180,17944,23544;24008,50005,0,0,1,1,2
78022,180,17945,23976;24280,50005,0,0,2,0,2
78023,180,17946,24078;24108,50005,0,0,2,0,2
78024,180,17947,23981;24083;28069,50005,0,0,3,0,3
78025,180,17976,21627,50370,0,0,0,1,1
78026,180,17982,22087,50370,0,0,0,1,1
78027,180,17984,21903;22425,50370,0,0,0,2,2
78028,180,17991,22613;22968,50370,0,0,0,2,2
78029,180,17995,22930;23224,50370,0,0,0,2,2
78030,180,17998,23251;23483,50370,0,0,0,2,2
78031,180,18001,23298;26106,50370,0,0,1,1,2
78032,180,18002,23246;23563,50370,0,0,0,2,2
78033,180,18004,23285;23406,50370,0,0,0,2,2
78034,180,18007,23788;27989,50370,0,0,1,1,2
78035,180,18008,23894,50370,0,0,1,0,1
78036,180,18009,23850;23864;28367,50370,0,0,2,1,3
78037,180,18011,23448;27148;29418;29949,50370,1,1,1,1,4
78038,180,18013,23462;23464;27561,50370,0,0,1,2,3
78039,180,18014,23416,50370,0,0,0,1,1
78040,180,18015,23531,50370,0,0,0,1,1
78041,180,18017,23760,50370,0,0,0,1,1
78042,180,18018,23532;27854,50370,0,0,1,1,2
78043,180,18019,23182;23646,50370,0,0,0,2,2
78044,180,18020,23540;27856,50370,0,0,1,1,2
78045,180,18021,23268,50370,0,0,0,1,1
78046,180,18022,23534;23608,50370,0,0,0,2,2
78047,180,18023,24003,50370,0,0,1,0,1
78048,180,18025,23564;23763,50370,0,0,0,2,2
78049,180,18026,23487;23715;26123,50370,0,0,1,2,3
78050,180,18027,23734;23920,50370,0,0,1,1,2
78051,180,18029,23833;24228,50370,0,0,1,1,2
78052,180,18030,23804;24084,50370,0,0,1,1,2
78053,180,18031,23599;23844,50370,0,0,0,2,2
78054,180,18032,23629,50370,0,0,0,1,1
78055,180,18033,23425;23867,50370,0,0,1,1,2
78056,180,18034,23469;23868,50370,0,0,1,1,2
78057,180,18035,23746;24202;27670,50370,0,0,2,1,3
78058,180,18038,24094;24146,50370,0,0,2,0,2
78059,180,18039,23980;24285,50370,0,0,2,0,2
78060,180,18040,24214;27381,50370,0,0,2,0,2
78061,180,18041,24010;24097;27467,50370,0,0,3,0,3
78062,180,18042,24289,50370,0,0,1,0,1
78063,180,18043,23971;24039;26986,50370,0,0,3,0,3
78064,180,18044,24040,50370,0,0,1,0,1
78065,180,18045,24047;27469;27583;29231;29879,50370,1,1,3,0,5
78066,180,18046,24116;24460,50370,0,0,2,0,2
78067,180,18047,23860;24160,50370,0,0,2,0,2
78068,180,18048,24033;24172,50370,0,0,2,0,2
78069,180,18049,24155;24181,50370,0,0,2,0,2
78070,180,18051,24360;24368,50370,0,0,2,0,2
78071,180,18072,21554,50735,0,0,0,1,1
78072,180,18075,21226;21687,50735,0,0,0,2,2
78073,180,18085,22678;23210,50735,0,0,0,2,2
78074,180,18087,23228,50735,0,0,0,1,1
78075,180,18091,23004;23208,50735,0,0,0,2,2
78076,180,18094,23118,50735,0,0,0,1,1
78077,180,18096,23204;23845;27170,50735,0,0,1,2,3
78078,180,18098,23236;23766,50735,0,0,0,2,2
78079,180,18099,23207;23261,50735,0,0,0,2,2
78080,180,18101,23175;23392,50735,0,0,0,2,2
78081,180,18103,23862;23955,50735,0,0,2,0,2
78082,180,18105,23560;23814;27167;29867;30206,50735,2,0,1,2,5
78083,180,18108,24169,50735,0,0,1,0,1
78084,180,18109,23105;23800,50735,0,0,0,2,2
78085,180,18111,23610;23757;26574;27446;29301;30051,50735,1,1,2,2,6
78086,180,18112,23500;23613,50735,0,0,0,2,2
78087,180,18113,23317;23714,50735,0,0,0,2,2
78088,180,18114,23455;23765;27453;29609,50735,0,1,1,2,4
78089,180,18115,23494;23776,50735,0,0,0,2,2
78090,180,18118,23886;24338;27488,50735,0,0,3,0,3
78091,180,18120,23945,50735,0,0,1,0,1
78092,180,18121,23727;23967,50735,0,0,1,1,2
78093,180,18122,24006;27466;29878;30141,50735,2,0,2,0,4
78094,180,18123,24026;24164;27481;27779,50735,0,0,4,0,4
78095,180,18124,23883;24053,50735,0,0,2,0,2
78096,180,18125,23338;26989,50735,0,0,1,1,2
78097,180,18126,23935;24098,50735,0,0,2,0,2
78098,180,18127,24104;24458,50735,0,0,2,0,2
78099,180,18128,24130;24282;27193;28565,50735,0,0,4,0,4
78100,180,18129,23668;24072,50735,0,0,1,1,2
78101,180,18131,27293;29694;30216,50735,1,1,1,0,3
78102,180,18132,23888;24191;27669,50735,0,0,3,0,3
78103,180,18148,21276,51100,0,0,0,1,1
78104,180,18158,21113;21223,51100,0,0,0,2,2
78105,180,18161,22546;22765,51100,0,0,0,2,2
78106,180,18163,22105,51100,0,0,0,1,1
78107,180,18172,22466;23061,51100,0,0,0,2,2
78108,180,18174,22575;22675,51100,0,0,0,2,2
78109,180,18175,23190;23367,51100,0,0,0,2,2
78110,180,18183,23057;23201,51100,0,0,0,2,2
78111,180,18188,23902,51100,0,0,1,0,1
78112,180,18189,23165;23436,51100,0,0,0,2,2
78113,180,18190,23477;23594,51100,0,0,0,2,2
78114,180,18191,22703;23497,51100,0,0,0,2,2
78115,180,18192,23334;23527,51100,0,0,0,2,2
78116,180,18193,23443;23530,51100,0,0,0,2,2
78117,180,18194,23504;23720,51100,0,0,0,2,2
78118,180,18195,23266;23602;26768;30092,51100,1,0,1,2,4
78119,180,18196,23622,51100,0,0,0,1,1
78120,180,18198,23793,51100,0,0,0,1,1
78121,180,18199,24080;24162,51100,0,0,2,0,2
78122,180,18201,24352;27788,51100,0,0,2,0,2
78123,180,18202,23600;23853,51100,0,0,1,1,2
78124,180,18203,23857,51100,0,0,1,0,1
78125,180,18204,24217;24376,51100,0,0,2,0,2
78126,180,18205,23950,51100,0,0,1,0,1
78127,180,18206,23514;23953,51100,0,0,1,1,2
78128,180,18207,23419;23972,51100,0,0,1,1,2
78129,180,18210,24332;24336;28370,51100,0,0,3,0,3
78130,180,18211,24081;27080,51100,0,0,2,0,2
78131,180,18213,23643;24038,51100,0,0,1,1,2
78132,180,18214,24212;24291,51100,0,0,2,0,2
78133,180,18217,24123;24187,51100,0,0,2,0,2
78134,180,18218,24136;24283;27194,51100,0,0,3,0,3
78135,180,18219,23994;24218,51100,0,0,2,0,2
78136,180,18220,24193,51100,0,0,1,0,1
78137,180,18223,23725;24211,51100,0,0,1,1,2
78138,180,18224,24216;24577,51100,0,0,2,0,2
78139,180,18225,24327,51100,0,0,1,0,1
78140,180,18226,24278;24290,51100,0,0,2,0,2
78141,180,18229,24303,51100,0,0,1,0,1
78142,180,18230,24324;24500,51100,0,0,2,0,2
78143,180,18233,24337;27785,51100,0,0,2,0,2
78144,180,18234,23991,51100,0,0,1,0,1
78145,180,18236,23869;24363,51100,0,0,2,0,2
78146,180,18237,24589;28087;28281,51100,0,0,3,0,3
78147,180,18250,21009,51465,0,0,0,1,1
78148,180,18258,21819;21965,51465,0,0,0,2,2
78149,180,18261,22112;22184,51465,0,0,0,2,2
78150,180,18262,22057,51465,0,0,0,1,1
78151,180,18264,22028,51465,0,0,0,1,1
78152,180,18266,23172;23321,51465,0,0,0,2,2
78153,180,18267,22650;22661,51465,0,0,0,2,2
78154,180,18276,23163;23203;26852;29025;29585;30098,51465,1,2,1,2,6
78155,180,18279,23691;23834;27572;29800,51465,0,1,1,2,4
78156,180,18280,23466;23817;28174,51465,0,0,1,2,3
78157,180,18281,23721;27348;29697,51465,0,1,1,1,3
78158,180,18282,23634;23803,51465,0,0,0,2,2
78159,180,18283,23501;23837,51465,0,0,0,2,2
78160,180,18284,23327;23595,51465,0,0,0,2,2
78161,180,18286,23665,51465,0,0,0,1,1
78162,180,18287,23365;23669,51465,0,0,0,2,2
78163,180,18288,23307,51465,0,0,0,1,1
78164,180,18289,23815,51465,0,0,0,1,1
78165,180,18290,23270;23481,51465,0,0,0,2,2
78166,180,18291,23761,51465,0,0,0,1,1
78167,180,18292,23676;23787,51465,0,0,0,2,2
78168,180,18293,23794;23899,51465,0,0,1,1,2
78169,180,18295,23876,51465,0,0,1,0,1
78170,180,18296,23949;24168,51465,0,0,2,0,2
78171,180,18297,23790;24020;28071,51465,0,0,2,1,3
78172,180,18298,24023;24432,51465,0,0,2,0,2
78173,180,18299,24037,51465,0,0,1,0,1
78174,180,18301,24463,51465,0,0,1,0,1
78175,180,18302,23823;24068,51465,0,0,1,1,2
78176,180,18304,24297;24398,51465,0,0,2,0,2
78177,180,18305,23693;23884,51465,0,0,1,1,2
78178,180,18306,24428;28077,51465,0,0,2,0,2
78179,180,18307,24144,51465,0,0,1,0,1
78180,180,18308,24174,51465,0,0,1,0,1
78181,180,18309,24182;24213,51465,0,0,2,0,2
78182,180,18310,24265;24574;28085;28198,51465,0,0,4,0,4
78183,180,18311,24129;24322;28465,51465,0,0,3,0,3
78184,180,18312,23882;24293,51465,0,0,2,0,2
78185,180,18313,24295;24320,51465,0,0,2,0,2
78186,180,18314,24319;24350;27490,51465,0,0,3,0,3
78187,180,18317,24090;24533;28276,51465,0,0,3,0,3
78188,180,18318,24408;24649,51465,0,0,2,0,2
78189,180,18319,23996;24420;27393,51465,0,0,3,0,3
78190,180,18320,24436;24442;27397;30137,51465,1,0,3,0,4
78191,180,18321,24457;24477;28372,51465,0,0,3,0,3
78192,180,18331,20801,51830,0,0,0,1,1
78193,180,18338,21541,51830,0,0,0,1,1
78194,180,18352,22391,51830,0,0,0,1,1
78195,180,18361,23278;26553,51830,0,0,1,1,2
78196,180,18362,23364;23444,51830,0,0,0,2,2
78197,180,18366,24103;26990,51830,0,0,2,0,2
78198,180,18367,24159;27480,51830,0,0,2,0,2
78199,180,18368,27565,51830,0,0,1,0,1
78200,180,18369,23617;23656,51830,0,0,0,2,2
78201,180,18370,24166;24173,51830,0,0,2,0,2
78202,180,18371,23713;24302,51830,0,0,1,1,2
78203,180,18373,23240;23733,51830,0,0,0,2,2
78204,180,18374,23805;24205,51830,0,0,1,1,2
78205,180,18375,24227;28184,51830,0,0,2,0,2
78206,180,18376,23738,51830,0,0,0,1,1
78207,180,18377,23447;23898;26791,51830,0,0,2,1,3
78208,180,18378,23998;24299;27464,51830,0,0,3,0,3
78209,180,18379,24012;24310;27600,51830,0,0,3,0,3
78210,180,18380,24356;28466,51830,0,0,2,0,2
78211,180,18381,24394;24539;27309;28084;30131,51830,1,0,4,0,5
78212,180,18383,24066;26597,51830,0,0,2,0,2
78213,180,18384,24307;24656;27898;28000;28287;29977,51830,1,0,5,0,6
78214,180,18385,24086;24122;26910,51830,0,0,3,0,3
78215,180,18386,24125;24450;28079;28849,51830,0,1,3,0,4
78216,180,18387,24180;24318;28369,51830,0,0,3,0,3
78217,180,18388,24190;24192;27589;30148,51830,1,0,3,0,4
78218,180,18389,24076;24200,51830,0,0,2,0,2
78219,180,18390,24328;24643;27519,51830,0,0,3,0,3
78220,180,18392,24276;24620,51830,0,0,2,0,2
78221,180,18394,24309;24629;27517,51830,0,0,3,0,3
78222,180,18395,24306;24323;27873;28074,51830,0,0,4,0,4
78223,180,18396,24329;24788;27623,51830,0,0,3,0,3
78224,180,18397,24341;24396,51830,0,0,2,0,2
78225,180,18398,24406;24679,51830,0,0,2,0,2
78226,180,18399,24439;24694,51830,0,0,2,0,2
78227,180,18400,24854;27420,51830,0,0,2,0,2
78228,180,18401,24452;24718;28096;28202;30163,51830,1,0,4,0,5
78229,180,18402,24088;24281,51830,0,0,2,0,2
78230,180,18403,24850;24960;28386;30171,51830,1,0,3,0,4
78231,180,18404,24507;24632;27403;28568,51830,0,0,4,0,4
78232,180,18405,24526,51830,0,0,1,0,1
78233,180,18406,24313;24646;27411,51830,0,0,3,0,3
78234,180,18407,24530;24626;28757,51830,0,1,2,0,3
78235,180,18408,24142;24534,51830,0,0,2,0,2
78236,180,18409,24485;24548,51830,0,0,2,0,2
78237,180,18410,24549;24797,51830,0,0,2,0,2
78238,180,18411,24404;24553,51830,0,0,2,0,2
78239,180,18436,21927,52195,0,0,0,1,1
78240,180,18437,22091,52195,0,0,0,1,1
78241,180,18442,22447;22510,52195,0,0,0,2,2
78242,180,18446,22648;22657,52195,0,0,0,2,2
78243,180,18448,22897;23356,52195,0,0,0,2,2
78244,180,18450,23021;23109,52195,0,0,0,2,2
78245,180,18452,23649;24073,52195,0,0,1,1,2
78246,180,18453,23212;23743,52195,0,0,0,2,2
78247,180,18458,23704;23999,52195,0,0,1,1,2
78248,180,18459,23753;24153;27588;29429,52195,0,1,2,1,4
78249,180,18460,23569,52195,0,0,0,1,1
78250,180,18461,23979;24113,52195,0,0,2,0,2
78251,180,18462,23325;23822,52195,0,0,0,2,2
78252,180,18463,24019;24087,52195,0,0,2,0,2
78253,180,18464,24469,52195,0,0,1,0,1
78254,180,18465,24361;27391;27789,52195,0,0,3,0,3
78255,180,18467,24127;24292,52195,0,0,2,0,2
78256,180,18468,24165,52195,0,0,1,0,1
78257,180,18469,24203;28563,52195,0,0,2,0,2
78258,180,18470,24232;27088,52195,0,0,2,0,2
78259,180,18471,24234;27384,52195,0,0,2,0,2
78260,180,18473,24246,52195,0,0,1,0,1
78261,180,18474,24255;27485;28464,52195,0,0,3,0,3
78262,180,18475,24317;24580;27408,52195,0,0,3,0,3
78263,180,18476,24235;24301;28272;30065,52195,1,0,3,0,4
78264,180,18477,24334;24410,52195,0,0,2,0,2
78265,180,18479,23659;24370;27495,52195,0,0,2,1,3
78266,180,18481,24126;24421;28277,52195,0,0,3,0,3
78267,180,18482,23915;24453,52195,0,0,2,0,2
78268,180,18484,24525;24774;27717,52195,0,0,3,0,3
78269,180,18485,24674;24793;28476,52195,0,0,3,0,3
78270,180,18486,24497,52195,0,0,1,0,1
78271,180,18488,24386;24540;27996,52195,0,0,3,0,3
78272,180,18489,24254;24550,52195,0,0,2,0,2
78273,180,18490,24284;24551;27011,52195,0,0,3,0,3
78274,180,18492,24878;28680,52195,0,1,1,0,2
78275,180,18493,24739;24800,52195,0,0,2,0,2
78276,180,18494,24602;24608;27515,52195,0,0,3,0,3
78277,180,18495,24609;24680,52195,0,0,2,0,2
78278,180,18496,24849;28852,52195,0,1,1,0,2
78279,180,18497,24613;25004;28119,52195,0,0,3,0,3
78280,180,18498,24760;24906,52195,0,0,2,0,2
78281,180,18499,24513;24637;28286,52195,0,0,3,0,3
78282,180,18500,24651;24712;27112,52195,0,0,3,0,3
78283,180,18501,24576;24652;28381,52195,0,0,3,0,3
78284,180,18502,24300;24669,52195,0,0,2,0,2
78285,180,18503,24683;24961;28300;28942,52195,0,1,3,0,4
78286,180,18516,21342,52560,0,0,0,1,1
78287,180,18519,20851,52560,0,0,0,1,1
78288,180,18521,21289,52560,0,0,0,1,1
78289,180,18523,21133;21285,52560,0,0,0,2,2
78290,180,18529,21768,52560,0,0,0,1,1
78291,180,18539,22432,52560,0,0,0,1,1
78292,180,18549,23225;23565,52560,0,0,0,2,2
78293,180,18550,23792;24260;27981;30159,52560,1,0,2,1,4
78294,180,18551,23712;24131;27585,52560,0,0,2,1,3
78295,180,18552,23567;23742,52560,0,0,0,2,2
78296,180,18553,24065,52560,0,0,1,0,1
78297,180,18554,23842;24388,52560,0,0,1,1,2
78298,180,18555,23686;23856,52560,0,0,1,1,2
78299,180,18557,23929;24440,52560,0,0,2,0,2
78300,180,18558,23811;23951;27861,52560,0,0,2,1,3
78301,180,18560,24105;24156;28179,52560,0,0,3,0,3
78302,180,18561,24107;24133,52560,0,0,2,0,2
78303,180,18562,24459;24607,52560,0,0,2,0,2
78304,180,18563,24502;28567,52560,0,0,2,0,2
78305,180,18564,24389,52560,0,0,1,0,1
78306,180,18565,23928;24231;27673;29526,52560,0,1,3,0,4
78307,180,18566,24803,52560,0,0,1,0,1
78308,180,18567,24340,52560,0,0,1,0,1
78309,180,18569,24400,52560,0,0,1,0,1
78310,180,18571,24510;24606;28282,52560,0,0,3,0,3
78311,180,18572,24298;24417;28019,52560,0,0,3,0,3
78312,180,18573,24418,52560,0,0,1,0,1
78313,180,18574,24115;24480;27693,52560,0,0,3,0,3
78314,180,18575,24498,52560,0,0,1,0,1
78315,180,18576,24114;24499,52560,0,0,2,0,2
78316,180,18577,24330;24639;28470;28570,52560,0,0,4,0,4
78317,180,18578,24547;24600;27890;29432;30063,52560,1,1,3,0,5
78318,180,18579,24572;24700;27704,52560,0,0,3,0,3
78319,180,18580,24449;24586,52560,0,0,2,0,2
78320,180,18581,24128;24642;26819;27405;27888;28376;28844;29933;30186;30224,52560,3,1,6,0,10
78321,180,18582,24554;24661;27997;30246,52560,1,0,3,0,4
78322,180,18583,24617;24688;27902;28288,52560,0,0,4,0,4
78323,180,18584,24723;24897,52560,0,0,2,0,2
78324,180,18585,24392;24745;28289,52560,0,0,3,0,3
78325,180,18586,24920;28762,52560,0,1,1,0,2
78326,180,18587,24615;28574;28678,52560,0,1,2,0,3
78327,180,18588,24818;28208;28759,52560,0,1,2,0,3
78328,180,18589,20656,52925,0,0,0,1,1
78329,180,18596,21583,52925,0,0,0,1,1
78330,180,18597,21474,52925,0,0,0,1,1
78331,180,18599,21154,52925,0,0,0,1,1
78332,180,18601,21711;21724,52925,0,0,0,2,2
78333,180,18604,22161,52925,0,0,0,1,1
78334,180,18605,22589,52925,0,0,0,1,1
78335,180,18606,22234;22746,52925,0,0,0,2,2
78336,180,18607,22831;23059,52925,0,0,0,2,2
78337,180,18609,23147;23445,52925,0,0,0,2,2
78338,180,18611,23623,52925,0,0,0,1,1
78339,180,18614,23603,52925,0,0,0,1,1
78340,180,18615,23254;23628,52925,0,0,0,2,2
78341,180,18617,23597;23927,52925,0,0,1,1,2
78342,180,18622,23638;24022;27662,52925,0,0,2,1,3
78343,180,18623,23644;24082,52925,0,0,1,1,2
78344,180,18625,23707,52925,0,0,0,1,1
78345,180,18626,23992;24135,52925,0,0,2,0,2
78346,180,18627,23711;23859,52925,0,0,1,1,2
78347,180,18628,23723,52925,0,0,0,1,1
78348,180,18631,23784,52925,0,0,0,1,1
78349,180,18632,23831;23948,52925,0,0,1,1,2
78350,180,18633,23611;23854;26972,52925,0,0,2,1,3
78351,180,18634,24102;24249,52925,0,0,2,0,2
78352,180,18635,23807;23891,52925,0,0,1,1,2
78353,180,18636,23604;24250;27484,52925,0,0,2,1,3
78354,180,18637,27982,52925,0,0,1,0,1
78355,180,18639,23836;24028;27367,52925,0,0,2,1,3
78356,180,18640,23808;23939,52925,0,0,1,1,2
78357,180,18641,24222,52925,0,0,1,0,1
78358,180,18642,24007;24093,52925,0,0,2,0,2
78359,180,18644,24464,52925,0,0,1,0,1
78360,180,18645,24451,52925,0,0,1,0,1
78361,180,18647,23997;24175,52925,0,0,2,0,2
78362,180,18648,24591;27706;28569,52925,0,0,3,0,3
78363,180,18649,24046;24279,52925,0,0,2,0,2
78364,180,18650,24184;24366,52925,0,0,2,0,2
78365,180,18651,24705;27907,52925,0,0,2,0,2
78366,180,18653,24345;24563;28469,52925,0,0,3,0,3
78367,180,18654,24409;26810;27879;28566,52925,0,0,4,0,4
78368,180,18655,24542;26337;28657;29094;29652,52925,0,2,3,0,5
78369,180,18656,24454;24521,52925,0,0,2,0,2
78370,180,18657,24399;24455,52925,0,0,2,0,2
78371,180,18658,24730;24747;27387;27715;29887,52925,1,0,4,0,5
78372,180,18659,24568;24693;28673;29529,52925,0,2,2,0,4
78373,180,18660,23855;24143,52925,0,0,2,0,2
78374,180,18661,24731;24949,52925,0,0,2,0,2
78375,180,18662,24506;27881;29806,52925,0,1,2,0,3
78376,180,18663,24393;24523;27206;29788,52925,0,1,3,0,4
78377,180,18665,24535;24911;27817,52925,0,0,3,0,3
78378,180,18666,25047,52925,0,0,1,0,1
78379,180,18667,24625;25051;28402,52925,0,0,3,0,3
78380,180,18668,24627;24945;27893,52925,0,0,3,0,3
78381,180,18669,24630;25302;28320;28502;28774,52925,0,1,4,0,5
78382,180,18670,24640;24847,52925,0,0,2,0,2
78383,180,18671,23890;24359;28467,52925,0,0,3,0,3
78384,180,18672,24653;24972;28302;28393;28581,52925,0,0,5,0,5
78385,180,18674,24727;25096,52925,0,0,2,0,2
78386,180,18676,24520;24740,52925,0,0,2,0,2
78387,180,18677,24662;24778;27719,52925,0,0,3,0,3
78388,180,18678,25151;28692,52925,0,1,1,0,2
78389,180,18679,24395;24786,52925,0,0,2,0,2
78390,180,18681,24754;24804,52925,0,0,2,0,2
78391,180,18682,25045;28222,52925,0,0,2,0,2
78392,180,18683,24934;28579,52925,0,0,2,0,2
78393,180,18684,24668;24928;27423;27628,52925,0,0,4,0,4
78394,180,18685,24863;28478,52925,0,0,2,0,2
78395,180,18686,24528;24978,52925,0,0,2,0,2
78396,180,18687,24709;24879;28383,52925,0,0,3,0,3
78397,180,18688,24880;25208,52925,0,0,2,0,2
78398,180,18689,24985;24995;28219;28394;28485;28683;30253,52925,1,1,5,0,7
78399,180,18690,24858;24888;28479,52925,0,0,3,0,3
78400,180,18691,24650;24896;28388,52925,0,0,3,0,3
78401,180,18692,24296;24973;27425;29037,52925,0,1,3,0,4
78402,180,18693,24993;25098;27540;28588;28689,52925,0,1,4,0,5
78403,180,18697,21120,53290,0,0,0,1,1
78404,180,18710,21227;21385,53290,0,0,0,2,2
78405,180,18724,21988,53290,0,0,0,1,1
78406,180,18728,23020,53290,0,0,0,1,1
78407,180,18734,23618;23858,53290,0,0,1,1,2
78408,180,18736,22896;23035,53290,0,0,0,2,2
78409,180,18737,23666,53290,0,0,0,1,1
78410,180,18743,24261;27597,53290,0,0,2,0,2
78411,180,18744,23905;27359;29127,53290,0,1,2,0,3
78412,180,18745,23925;27161;29784,53290,0,1,2,0,3
78413,180,18747,23740;24005;27660,53290,0,0,2,1,3
78414,180,18748,24011;24287;27984,53290,0,0,3,0,3
78415,180,18749,24095,53290,0,0,1,0,1
78416,180,18750,23911;24426;28076;28756,53290,0,1,3,0,4
78417,180,18751,24089,53290,0,0,1,0,1
78418,180,18752,23872,53290,0,0,1,0,1
78419,180,18753,24051,53290,0,0,1,0,1
78420,180,18754,23987;24189,53290,0,0,2,0,2
78421,180,18755,23922;24240,53290,0,0,2,0,2
78422,180,18756,24270;24636,53290,0,0,2,0,2
78423,180,18757,24325;24584,53290,0,0,2,0,2
78424,180,18760,24367;24673,53290,0,0,2,0,2
78425,180,18761,24375;27876,53290,0,0,2,0,2
78426,180,18762,24385;24536;27510,53290,0,0,3,0,3
78427,180,18763,24391,53290,0,0,1,0,1
78428,180,18766,24335;24443,53290,0,0,2,0,2
78429,180,18767,24894;25008;27723,53290,0,0,3,0,3
78430,180,18768,24702,53290,0,0,1,0,1
78431,180,18769,24515;24559;28082,53290,0,0,3,0,3
78432,180,18770,24757;25040,53290,0,0,2,0,2
78433,180,18771,24161;24569;28197,53290,0,0,3,0,3
78434,180,18772,24618;24835;27892,53290,0,0,3,0,3
78435,180,18773,24634,53290,0,0,1,0,1
78436,180,18774,24665;24840,53290,0,0,2,0,2
78437,180,18776,24682;25080,53290,0,0,2,0,2
78438,180,18777,24573;24998,53290,0,0,2,0,2
78439,180,18778,24514;24699,53290,0,0,2,0,2
78440,180,18779,24677;24711;28094,53290,0,0,3,0,3
78441,180,18780,24698;24713,53290,0,0,2,0,2
78442,180,18781,24567;24719;28676,53290,0,1,2,0,3
78443,180,18782,24736;25005,53290,0,0,2,0,2
78444,180,18783,24207;24685,53290,0,0,2,0,2
78445,180,18784,24761;24874;28204,53290,0,0,3,0,3
78446,180,18785,25043;27808;28758,53290,0,1,2,0,3
78447,180,18786,24886;27917;28681;28853,53290,0,2,2,0,4
78448,180,18787,24647;24764,53290,0,0,2,0,2
78449,180,18788,24812;28385,53290,0,0,2,0,2
78450,180,18789,25121;27834,53290,0,0,2,0,2
78451,180,18790,24658;24833,53290,0,0,2,0,2
78452,180,18791,25182;25216;28233;29130,53290,0,1,3,0,4
78453,180,18792,25180;27638,53290,0,0,2,0,2
78454,180,18793,24789;28207,53290,0,0,2,0,2
78455,180,18794,25159;25260,53290,0,0,2,0,2
78456,180,18795,24486;24909,53290,0,0,2,0,2
78457,180,18796,24964;28391,53290,0,0,2,0,2
78458,180,18797,24977,53290,0,0,1,0,1
78459,180,18798,24990;25199;28694;28949,53290,0,2,2,0,4
78460,180,18799,24958;25001;28304,53290,0,0,3,0,3
78461,180,18800,24899;24980,53290,0,0,2,0,2
78462,180,18801,20740,53655,0,0,0,1,1
78463,180,18802,20931,53655,0,0,0,1,1
78464,180,18808,21563,53655,0,0,0,1,1
78465,180,18810,21104,53655,0,0,0,1,1
78466,180,18811,21501,53655,0,0,0,1,1
78467,180,18827,22664,53655,0,0,0,1,1
78468,180,18830,23303;23438;27573,53655,0,0,1,2,3
78469,180,18831,23290;23663;26772,53655,0,0,1,2,3
78470,180,18834,23508;23959,53655,0,0,1,1,2
78471,180,18835,23667;27155;29689;30119,53655,1,1,1,1,4
78472,180,18836,23512;23700,53655,0,0,0,2,2
78473,180,18838,23874,53655,0,0,1,0,1
78474,180,18841,23936,53655,0,0,1,0,1
78475,180,18842,23437;24000;28176,53655,0,0,2,1,3
78476,180,18843,23772;24009,53655,0,0,1,1,2
78477,180,18844,24147;26913;29311,53655,0,1,2,0,3
78478,180,18846,23974;24505;27697;30238,53655,1,0,3,0,4
78479,180,18849,24305;24561;28377;29036,53655,0,1,3,0,4
78480,180,18850,24635;25003;28396,53655,0,0,3,0,3
78481,180,18851,24419;24783;28292,53655,0,0,3,0,3
78482,180,18853,24429;24638,53655,0,0,2,0,2
78483,180,18854,24472;24624;28285,53655,0,0,3,0,3
78484,180,18855,24508;24770,53655,0,0,2,0,2
78485,180,18856,24601;28379,53655,0,0,2,0,2
78486,180,18857,24446;24509;27508;27993,53655,0,0,4,0,4
78487,180,18859,24365;24741,53655,0,0,2,0,2
78488,180,18860,24780;25187,53655,0,0,2,0,2
78489,180,18861,24495;24717;28675,53655,0,1,2,0,3
78490,180,18862,24748;24796;27716,53655,0,0,3,0,3
78491,180,18863,23812;24753;28677,53655,0,1,1,1,3
78492,180,18864,25088;28586;28946,53655,0,1,2,0,3
78493,180,18865,24383;25010;28684,53655,0,1,2,0,3
78494,180,18866,24722;24829,53655,0,0,2,0,2
78495,180,18867,24861;27916,53655,0,0,2,0,2
78496,180,18868,24648;25166;28315;28493;29038,53655,0,1,4,0,5
78497,180,18870,24877;24914,53655,0,0,2,0,2
78498,180,18871,24919;25156,53655,0,0,2,0,2
78499,180,18872,24684;24931;28578,53655,0,0,3,0,3
78500,180,18874,24904;24946;28576,53655,0,0,3,0,3
78501,180,18875,25110;28028;28224;28690,53655,0,1,3,0,4
78502,180,18876,24963;25168;28390,53655,0,0,3,0,3
78503,180,18877,24989,53655,0,0,1,0,1
78504,180,18878,25142;25221;28947,53655,0,1,2,0,3
78505,180,18879,24820;25332,53655,0,0,2,0,2
78506,180,18880,25022;25200;28770;29328,53655,0,2,2,0,4
78507,180,18881,25024;25137;27727,53655,0,0,3,0,3
78508,180,18882,25276;28139;28234;30165,53655,1,0,3,0,4
78509,180,18883,24751;25155,53655,0,0,2,0,2
78510,180,18884,25136;27835;28312,53655,0,0,3,0,3
78511,180,18885,25071;27826,53655,0,0,2,0,2
78512,180,18886,25283;28416;29132,53655,0,1,2,0,3
78513,180,18888,25091;25178;28587;28688,53655,0,1,3,0,4
78514,180,18889,25104;25280;28235;29986;30254,53655,2,0,3,0,5
78515,180,18892,20828,54020,0,0,0,1,1
78516,180,18896,21047;21395,54020,0,0,0,2,2
78517,180,18897,21346;21633,54020,0,0,0,2,2
78518,180,18898,20815,54020,0,0,0,1,1
78519,180,18899,21698,54020,0,0,0,1,1
78520,180,18909,21798,54020,0,0,0,1,1
78521,180,18912,22490,54020,0,0,0,1,1
78522,180,18922,23156;23586,54020,0,0,0,2,2
78523,180,18925,22779,54020,0,0,0,1,1
78524,180,18929,23390,54020,0,0,0,1,1
78525,180,18931,23724;27349;30134;30221,54020,2,0,1,1,4
78526,180,18932,23461;23695,54020,0,0,0,2,2
78527,180,18937,23924;24060,54020,0,0,2,0,2
78528,180,18940,24344;27787,54020,0,0,2,0,2
78529,180,18941,24119;24124,54020,0,0,2,0,2
78530,180,18942,24343;24364,54020,0,0,2,0,2
78531,180,18943,24204,54020,0,0,1,0,1
78532,180,18945,24197;24456;27203;27691;29870,54020,1,0,4,0,5
78533,180,18946,24059;24274,54020,0,0,2,0,2
78534,180,18947,24308,54020,0,0,1,0,1
78535,180,18948,24239,54020,0,0,1,0,1
78536,180,18949,24387;24537,54020,0,0,2,0,2
78537,180,18950,24496;24545,54020,0,0,2,0,2
78538,180,18951,24479;24644;27692,54020,0,0,3,0,3
78539,180,18952,24599;25141;28313,54020,0,0,3,0,3
78540,180,18953,25042;28120,54020,0,0,2,0,2
78541,180,18954,24926;28482;28577,54020,0,0,3,0,3
78542,180,18955,24490;24689,54020,0,0,2,0,2
78543,180,18956,24692;25055;27904,54020,0,0,3,0,3
78544,180,18957,24696;25089;27829,54020,0,0,3,0,3
78545,180,18958,24401;24703;28382;28473,54020,0,0,4,0,4
78546,180,18959,24575;24935,54020,0,0,2,0,2
78547,180,18960,24708;24743;28097;28573,54020,0,0,4,0,4
78548,180,18961,24610;24887;28214,54020,0,0,3,0,3
78549,180,18962,24844;28941,54020,0,1,1,0,2
78550,180,18963,24873;24947,54020,0,0,2,0,2
78551,180,18964,24952;25244;28598,54020,0,0,3,0,3
78552,180,18965,24583;24957,54020,0,0,2,0,2
78553,180,18966,24965,54020,0,0,1,0,1
78554,180,18967,24971;25157;28409,54020,0,0,3,0,3
78555,180,18968,24660;25284,54020,0,0,2,0,2
78556,180,18969,25210,54020,0,0,1,0,1
78557,180,18970,24982;24994;28020;28115,54020,0,0,4,0,4
78558,180,18971,24566;24884;29128,54020,0,1,2,0,3
78559,180,18972,25324;25494;28504,54020,0,0,3,0,3
78560,180,18973,24787;25015;27822;28306;28582,54020,0,0,5,0,5
78561,180,18974,24781;25020;28398;28583;28943,54020,0,1,4,0,5
78562,180,18975,24831;25056;28944,54020,0,1,2,0,3
78563,180,18976,24735;25073,54020,0,0,2,0,2
78564,180,18977,24587;24918,54020,0,0,2,0,2
78565,180,18978,25090;25127;28225,54020,0,0,3,0,3
78566,180,18979,25128;25417,54020,0,0,2,0,2
78567,180,18980,25461;25637,54020,0,0,2,0,2
78568,180,18981,24817;25074;28766,54020,0,1,2,0,3
78569,180,18982,25054;25354;28508,54020,0,0,3,0,3
78570,180,18983,25027;25193;28036;28231;28596,54020,0,0,5,0,5
78571,180,18984,25203;25222;28037,54020,0,0,3,0,3
78572,180,18985,25206;28038,54020,0,0,2,0,2
78573,180,18990,20819,54385,0,0,0,1,1
78574,180,18992,21061,54385,0,0,0,1,1
78575,180,18998,21275,54385,0,0,0,1,1
78576,180,18999,21727,54385,0,0,0,1,1
78577,180,19000,21971,54385,0,0,0,1,1
78578,180,19001,21457,54385,0,0,0,1,1
78579,180,19004,22998,54385,0,0,0,1,1
78580,180,19008,22300,54385,0,0,0,1,1
78581,180,19016,23110;23214,54385,0,0,0,2,2
78582,180,19019,23520,54385,0,0,0,1,1
78583,180,19022,23404;23718,54385,0,0,0,2,2
78584,180,19025,23536;23819,54385,0,0,0,2,2
78585,180,19030,23907,54385,0,0,1,0,1
78586,180,19032,23946;24138;27973,54385,0,0,3,0,3
78587,180,19034,24106;24304,54385,0,0,2,0,2
78588,180,19036,24063;24412,54385,0,0,2,0,2
78589,180,19037,24441;24582,54385,0,0,2,0,2
78590,180,19038,24447;24867;28679,54385,0,1,2,0,3
78591,180,19039,24676;28092,54385,0,0,2,0,2
78592,180,19042,24571,54385,0,0,1,0,1
78593,180,19044,25038;27632,54385,0,0,2,0,2
78594,180,19045,24925;25093;27770;28298;28481,54385,0,0,5,0,5
78595,180,19046,24042,54385,0,0,1,0,1
78596,180,19048,24758;25152,54385,0,0,2,0,2
78597,180,19049,24765;24823;28009,54385,0,0,3,0,3
78598,180,19050,24824;24882;27914;28575,54385,0,0,4,0,4
78599,180,19051,24777;24839,54385,0,0,2,0,2
78600,180,19052,24262;24706,54385,0,0,2,0,2
78601,180,19054,24875;25430;28432,54385,0,0,3,0,3
78602,180,19056,24605;24922;27220;27921,54385,0,0,4,0,4
78603,180,19057,25037;28221;28488,54385,0,0,3,0,3
78604,180,19058,24936;24988;28395;28486,54385,0,0,4,0,4
78605,180,19059,24969;25262,54385,0,0,2,0,2
78606,180,19060,24865;24929,54385,0,0,2,0,2
78607,180,19061,25132;25201;28406,54385,0,0,3,0,3
78608,180,19062,25067;25158,54385,0,0,2,0,2
78609,180,19063,25163;25209;28693,54385,0,1,2,0,3
78610,180,19064,24921;25169,54385,0,0,2,0,2
78611,180,19065,25521;25552,54385,0,0,2,0,2
78612,180,19066,25477;25556;28707;28865,54385,0,2,2,0,4
78613,180,19067,25207;25543;28870;28965;29435,54385,0,3,2,0,5
78614,180,19069,25183,54385,0,0,1,0,1
78615,180,19070,25265,54385,0,0,1,0,1
78616,180,19071,25299;25478;28963,54385,0,1,2,0,3
78617,180,19072,20719,54750,0,0,0,1,1
78618,180,19073,21086,54750,0,0,0,1,1
78619,180,19075,20913,54750,0,0,0,1,1
78620,180,19076,20925,54750,0,0,0,1,1
78621,180,19077,20918,54750,0,0,0,1,1
78622,180,19078,21006,54750,0,0,0,1,1
78623,180,19084,21986;22121,54750,0,0,0,2,2
78624,180,19098,23331,54750,0,0,0,1,1
78625,180,19099,22925;23025,54750,0,0,0,2,2
78626,180,19108,23550;23605,54750,0,0,0,2,2
78627,180,19110,23682;23841,54750,0,0,0,2,2
78628,180,19111,23578;23749;26886,54750,0,0,1,2,3
78629,180,19112,24264;27190;29785,54750,0,1,2,0,3
78630,180,19113,23961;24492,54750,0,0,2,0,2
78631,180,19116,23852;24091,54750,0,0,2,0,2
78632,180,19118,24219,54750,0,0,1,0,1
78633,180,19119,24061;24071,54750,0,0,2,0,2
78634,180,19120,24407;24594;27210;27707;27802;29707;30154,54750,1,1,5,0,7
78635,180,19121,24776,54750,0,0,1,0,1
78636,180,19123,24269;24578;27998,54750,0,0,3,0,3
78637,180,19126,24468;24872,54750,0,0,2,0,2
78638,180,19127,24631,54750,0,0,1,0,1
78639,180,19128,24273;24552;27609;28195,54750,0,0,4,0,4
78640,180,19132,24746;24790,54750,0,0,2,0,2
78641,180,19133,24272;24752;28099;28290,54750,0,0,4,0,4
78642,180,19135,24869;27218,54750,0,0,2,0,2
78643,180,19136,24939;25145;27732;28133,54750,0,0,4,0,4
78644,180,19137,25215;27735,54750,0,0,2,0,2
78645,180,19138,25220;25532;28710;28964,54750,0,2,2,0,4
78646,180,19140,24744;24962;28483,54750,0,0,3,0,3
78647,180,19141,25349;25432;28515;29136;29334,54750,0,2,3,0,5
78648,180,19142,25019;27536,54750,0,0,2,0,2
78649,180,19143,25410;27952;28244;28607;28703,54750,0,1,4,0,5
78650,180,19144,25035;25645;29142;29714,54750,0,2,2,0,4
78651,180,19145,25041;25370;28510,54750,0,0,3,0,3
78652,180,19146,25389;25569;28621;28714;28873,54750,0,2,3,0,5
78653,180,19147,25282;28600;28696,54750,0,1,2,0,3
78654,180,19148,25084;25099;28589,54750,0,0,3,0,3
78655,180,19149,24913;25086;28308;28767,54750,0,1,3,0,4
78656,180,19150,24938;25117;28128,54750,0,0,3,0,3
78657,180,19151,24876;25131,54750,0,0,2,0,2
78658,180,19152,25143;25448;28246,54750,0,0,3,0,3
78659,180,19153,24806;25146;27542;28593;29522;29798,54750,0,2,4,0,6
78660,180,19154,25149;25470;28335;28614;28782,54750,0,1,4,0,5
78661,180,19155,25059;25165;27933;28223;28686,54750,0,1,4,0,5
78662,180,19156,25174;25271,54750,0,0,2,0,2
78663,180,19157,25172,54750,0,0,1,0,1
78664,180,19158,24832;25189;28229,54750,0,0,3,0,3
78665,180,19159,25223;25682;29055;29243,54750,0,2,2,0,4
78666,180,19160,25230;25424;28514;28704,54750,0,1,3,0,4
78667,180,19161,25434,54750,0,0,1,0,1
78668,180,19162,25295;28412;28952,54750,0,1,2,0,3
78669,180,19164,25247;25373,54750,0,0,2,0,2
78670,180,19165,25402;25652;29532,54750,0,1,2,0,3
78671,180,19166,25164;25303;27740;28697;28775,54750,0,2,3,0,5
78672,180,19167,25413;25433,54750,0,0,2,0,2
78673,180,19168,25313;25611,54750,0,0,2,0,2
78674,180,19169,25119;25314;28321;29133,54750,0,1,3,0,4
78675,180,19170,25328;25484;29336,54750,0,1,2,0,3
78676,180,19171,25758;28802;29715,54750,0,2,1,0,3
78677,180,19172,25334;25387;27332,54750,0,0,3,0,3
78678,180,19173,25340;25719;28445;28632;28975;29244,54750,0,2,4,0,6
78679,180,19174,25551;25623;28713;29138,54750,0,2,2,0,4
78680,180,19175,25365;25549,54750,0,0,2,0,2
78681,180,19176,25376;25505;28778,54750,0,1,2,0,3
78682,180,19177,25573;25638,54750,0,0,2,0,2
78683,180,19178,25066;25397;28423,54750,0,0,3,0,3
78684,180,19179,25398;27951,54750,0,0,2,0,2
78685,180,19180,25395;25400,54750,0,0,2,0,2
78686,180,19181,21229,55115,0,0,0,1,1
78687,180,19182,21182,55115,0,0,0,1,1
78688,180,19187,21680,55115,0,0,0,1,1
78689,180,19192,21892,55115,0,0,0,1,1
78690,180,19193,22083,55115,0,0,0,1,1
78691,180,19194,21943,55115,0,0,0,1,1
78692,180,19205,23191,55115,0,0,0,1,1
78693,180,19211,23556;23930,55115,0,0,1,1,2
78694,180,19213,23828;24101,55115,0,0,1,1,2
78695,180,19219,23958,55115,0,0,1,0,1
78696,180,19220,24054,55115,0,0,1,0,1
78697,180,19221,24593;24782,55115,0,0,2,0,2
78698,180,19222,24950;25064;28123;28687;28945,55115,0,2,3,0,5
78699,180,19223,24424;24425,55115,0,0,2,0,2
78700,180,19224,24373;24430;27790;28189,55115,0,0,4,0,4
78701,180,19226,24544;24564;27208,55115,0,0,3,0,3
78702,180,19227,24592;24733;27212;28572;29512;29692,55115,0,2,4,0,6
78703,180,19228,25306;28503;28776;28953;29619,55115,0,3,2,0,5
78704,180,19232,24659;25286;28501;28601,55115,0,0,4,0,4
78705,180,19233,24504;24742;28203,55115,0,0,3,0,3
78706,180,19234,28090,55115,0,0,1,0,1
78707,180,19235,25266;28414,55115,0,0,2,0,2
78708,180,19236,24667,55115,0,0,1,0,1
78709,180,19239,24791;25428;28331;28430,55115,0,0,4,0,4
78710,180,19240,24842;25050,55115,0,0,2,0,2
78711,180,19241,24848;24853;28106;28296,55115,0,0,4,0,4
78712,180,19242,24892;28015;28682,55115,0,1,2,0,3
78713,180,19243,24937;27819;27923;29618;29891;30156,55115,2,1,3,0,6
78714,180,19245,24461;24951;28112,55115,0,0,3,0,3
78715,180,19246,24968;25445,55115,0,0,2,0,2
78716,180,19247,24901;25118;29129,55115,0,1,2,0,3
78717,180,19248,25036;25213;29040,55115,0,1,2,0,3
78718,180,19249,25062;25170;28494,55115,0,0,3,0,3
78719,180,19250,24794;25108;28027;28405;28492;29982,55115,1,0,5,0,6
78720,180,19251,24813;25490,55115,0,0,2,0,2
78721,180,19253,25102;25204;28404;28491,55115,0,0,4,0,4
78722,180,19254,25212;25651,55115,0,0,2,0,2
78723,180,19255,25252;25631;29042,55115,0,1,2,0,3
78724,180,19256,25665,55115,0,0,1,0,1
78725,180,19257,25316;25612;28342,55115,0,0,3,0,3
78726,180,19258,25681;28439;28798;29144;29242,55115,0,3,2,0,5
78727,180,19259,25391;25817;29153,55115,0,1,2,0,3
78728,180,19260,25393;25656;28881,55115,0,1,2,0,3
78729,180,19261,25437;25671;29241,55115,0,1,2,0,3
78730,180,19262,25348;25597;28967,55115,0,1,2,0,3
78731,180,19263,21237,55480,0,0,0,1,1
78732,180,19272,22024,55480,0,0,0,1,1
78733,180,19277,22773,55480,0,0,0,1,1
78734,180,19281,22240;22426,55480,0,0,0,2,2
78735,180,19283,23275;23374,55480,0,0,0,2,2
78736,180,19288,23302;23558,55480,0,0,0,2,2
78737,180,19291,23897;24315,55480,0,0,2,0,2
78738,180,19293,24186;24333,55480,0,0,2,0,2
78739,180,19295,23875;24148,55480,0,0,2,0,2
78740,180,19296,24149;24695;27905;28674;30244,55480,1,1,3,0,5
78741,180,19297,24465,55480,0,0,1,0,1
78742,180,19298,24201,55480,0,0,1,0,1
78743,180,19300,24466,55480,0,0,1,0,1
78744,180,19302,24691;24798;28100;28294,55480,0,0,4,0,4
78745,180,19303,24411;24756;27807;28474,55480,0,0,4,0,4
78746,180,19304,24704;24707;28571;28850,55480,0,1,3,0,4
78747,180,19305,24027;24215;27773;27866,55480,0,0,4,0,4
78748,180,19306,24517;24527;27885,55480,0,0,3,0,3
78749,180,19307,25263;25317;28773,55480,0,1,2,0,3
78750,180,19308,24619;24655;28760,55480,0,1,2,0,3
78751,180,19309,24686;24805;27911,55480,0,0,3,0,3
78752,180,19310,24546;24821;28851,55480,0,1,2,0,3
78753,180,19311,24883;25297,55480,0,0,2,0,2
78754,180,19312,24891;25251;28138,55480,0,0,3,0,3
78755,180,19313,24478;25072;27934,55480,0,0,3,0,3
78756,180,19314,24710;24954;28580,55480,0,0,3,0,3
78757,180,19315,24728;25000,55480,0,0,2,0,2
78758,180,19316,24762;25018;28397,55480,0,0,3,0,3
78759,180,19317,25031;25290;28487,55480,0,0,3,0,3
78760,180,19319,25555;28521,55480,0,0,2,0,2
78761,180,19321,25006;25177;27535;29881;30145,55480,2,0,3,0,5
78762,180,19322,25186;25188;28496,55480,0,0,3,0,3
78763,180,19323,25258;25362;28324,55480,0,0,3,0,3
78764,180,19324,25259;25330;28857,55480,0,1,2,0,3
78765,180,19325,25272;25443;27548;28319;28500,55480,0,0,5,0,5
78766,180,19326,25296;25298;28602;28858,55480,0,1,3,0,4
78767,180,19327,25346;28418;28956,55480,0,1,2,0,3
78768,180,19328,25888;25922;28161,55480,0,0,3,0,3
78769,180,19329,25198;25275,55480,0,0,2,0,2
78770,180,19330,25415;25641;28877,55480,0,1,2,0,3
78771,180,19331,25253;25476;27954,55480,0,0,3,0,3
78772,180,19332,25582;25707;28346;28716,55480,0,1,3,0,4
78773,180,19333,25288;25488;28336;28516,55480,0,0,4,0,4
78774,180,19334,25489;25523;29051,55480,0,1,2,0,3
78775,180,19335,25544;25873;28534;28808,55480,0,1,3,0,4
78776,180,19336,25427;25515,55480,0,0,2,0,2
78777,180,19337,25751;25784;28448;28638;28979,55480,0,1,4,0,5
78778,180,19338,25675;25849;28532;28725;29061;29443,55480,0,3,3,0,6
78779,180,19339,25565;25693;28441,55480,0,0,3,0,3
78780,180,19340,25643;28969,55480,0,1,1,0,2
78781,180,19341,25727;25862;28349;28987;29256,55480,0,2,3,0,5
78782,180,19342,25525;25579;28436,55480,0,0,3,0,3
78783,180,19343,25195;25670;28796,55480,0,1,2,0,3
78784,180,19344,25686;25822;28985;29343,55480,0,2,2,0,4
78785,180,19345,25878;28726,55480,0,1,1,0,2
78786,180,19346,25833;26093,55480,0,0,2,0,2
78787,180,19347,25596,55480,0,0,1,0,1
78788,180,19348,25621;25792;28641,55480,0,0,3,0,3
78789,180,19351,21302,55845,0,0,0,1,1
78790,180,19354,21783,55845,0,0,0,1,1
78791,180,19358,21745,55845,0,0,0,1,1
78792,180,19359,22119,55845,0,0,0,1,1
78793,180,19361,22146,55845,0,0,0,1,1
78794,180,19363,22315,55845,0,0,0,1,1
78795,180,19364,22337,55845,0,0,0,1,1
78796,180,19366,22164,55845,0,0,0,1,1
78797,180,19370,22481,55845,0,0,0,1,1
78798,180,19375,22874,55845,0,0,0,1,1
78799,180,19378,23423;24002,55845,0,0,1,1,2
78800,180,19379,23648;23755,55845,0,0,0,2,2
78801,180,19388,23919;24286,55845,0,0,2,0,2
78802,180,19389,23889;24316;27679;28187,55845,0,0,4,0,4
78803,180,19391,23943;24079,55845,0,0,2,0,2
78804,180,19392,24117;24294,55845,0,0,2,0,2
78805,180,19393,24474;24604,55845,0,0,2,0,2
78806,180,19395,24462;24482;27793;28373,55845,0,0,4,0,4
78807,180,19396,24511;24799,55845,0,0,2,0,2
78808,180,19398,24414;24687;28471,55845,0,0,3,0,3
78809,180,19399,24690;24868;27018;28761,55845,0,1,3,0,4
78810,180,19400,24943;24956;28299,55845,0,0,3,0,3
78811,180,19404,24862,55845,0,0,1,0,1
78812,180,19405,24467,55845,0,0,1,0,1
78813,180,19406,25359;28859,55845,0,1,1,0,2
78814,180,19407,24725;25048;28765,55845,0,1,2,0,3
78815,180,19408,25065,55845,0,0,1,0,1
78816,180,19409,25029;25068;27634,55845,0,0,3,0,3
78817,180,19410,25076;25077,55845,0,0,2,0,2
78818,180,19411,24855;25134,55845,0,0,2,0,2
78819,180,19412,25135;25140;28591;28691,55845,0,1,3,0,4
78820,180,19413,25161;25442;28042;28332;29047;29434,55845,0,2,4,0,6
78821,180,19414,25250;25816;28347;28984;29537;29716,55845,0,3,3,0,6
78822,180,19415,24491;25175;28135,55845,0,0,3,0,3
78823,180,19416,24866;25192;28768,55845,0,1,2,0,3
78824,180,19417,25361;25486;28248;29530,55845,0,1,3,0,4
78825,180,19418,24941;25233,55845,0,0,2,0,2
78826,180,19419,25248;25720;28633,55845,0,0,3,0,3
78827,180,19420,24816;25254;29131,55845,0,1,2,0,3
78828,180,19421,25261;26023;28995,55845,0,1,2,0,3
78829,180,19422,26027;28165;29074,55845,0,1,2,0,3
78830,180,19423,25425;25577;28149;28435;28622;29052,55845,0,1,5,0,6
78831,180,19424,25167;25650;28152;28625;28972,55845,0,1,4,0,5
78832,180,19426,25106;25358,55845,0,0,2,0,2
78833,180,19427,25930;28730;29066;29348;29813;29988;30069,55845,3,3,1,0,7
78834,180,19428,25374;25705;28443;29340,55845,0,1,3,0,4
78835,180,19430,25456;25739,55845,0,0,2,0,2
78836,180,19431,25462;25469;28962,55845,0,1,2,0,3
78837,180,19432,25133;25482;28616;28866;29137,55845,0,2,3,0,5
78838,180,19433,25021;25512;28047;28619,55845,0,0,4,0,4
78839,180,19434,25129;25517;28785;29236,55845,0,2,2,0,4
78840,180,19435,25519;25756;28447,55845,0,0,3,0,3
78841,180,19436,25211;25500;28337;29235,55845,0,1,3,0,4
78842,180,19437,25533;25729;29148,55845,0,1,2,0,3
78843,180,19438,25405;27642;28328,55845,0,0,3,0,3
78844,180,19439,24975;25545;29337,55845,0,1,2,0,3
78845,180,19440,25624;25861;28159,55845,0,0,3,0,3
78846,180,19441,25371;25480;28708,55845,0,1,2,0,3
78847,180,19442,25458;26005;28541;28733;28899;29352;29628,55845,0,4,3,0,7
78848,180,19444,25629;25900;30068,55845,1,0,2,0,3
78849,180,19445,25855;25881;28807;29157;29254,55845,0,3,2,0,5
78850,180,19446,25154;25710;28253;28882;29146,55845,0,2,3,0,5
78851,180,19447,25075;25655;28526,55845,0,0,3,0,3
78852,180,19448,25503;25683;29056,55845,0,1,2,0,3
78853,180,19449,25708;26018;29169;29816,55845,1,1,2,0,4
78854,180,19450,25718;25945;29262;29896,55845,1,1,2,0,4
78855,180,19452,21537,56210,0,0,0,1,1
78856,180,19453,21559,56210,0,0,0,1,1
78857,180,19454,21599,56210,0,0,0,1,1
78858,180,19455,21528,56210,0,0,0,1,1
78859,180,19459,22037,56210,0,0,0,1,1
78860,180,19460,21648,56210,0,0,0,1,1
78861,180,19468,22677,56210,0,0,0,1,1
78862,180,19469,22427,56210,0,0,0,1,1
78863,180,19470,22680,56210,0,0,0,1,1
78864,180,19482,23941;24268;28175,56210,0,0,3,0,3
78865,180,19483,23944;24062;27067,56210,0,0,3,0,3
78866,180,19484,24347;24427,56210,0,0,2,0,2
78867,180,19485,24050;24555,56210,0,0,2,0,2
78868,180,19487,24251;24766,56210,0,0,2,0,2
78869,180,19488,24351;24445;27201,56210,0,0,3,0,3
78870,180,19489,24194;24481;28080,56210,0,0,3,0,3
78871,180,19490,24916;28854,56210,0,1,1,0,2
78872,180,19491,24557;25057,56210,0,0,2,0,2
78873,180,19493,24974,56210,0,0,1,0,1
78874,180,19494,24524;27531,56210,0,0,2,0,2
78875,180,19498,24923,56210,0,0,1,0,1
78876,180,19499,24999,56210,0,0,1,0,1
78877,180,19500,25339;25472,56210,0,0,2,0,2
78878,180,19501,24596;24895,56210,0,0,2,0,2
78879,180,19502,25033;25414,56210,0,0,2,0,2
78880,180,19503,24997;25342;27741;27947;28506;30155;30240;30262,56210,3,0,5,0,8
78881,180,19504,24870;25011;26936;29221,56210,0,1,3,0,4
78882,180,19505,25644;27755;28878;28970;29141;29438,56210,0,4,2,0,6
78883,180,19507,25103;25105,56210,0,0,2,0,2
78884,180,19511,25153;25572;29437,56210,0,1,2,0,3
78885,180,19512,25205,56210,0,0,1,0,1
78886,180,19513,25241;25268;28599,56210,0,0,3,0,3
78887,180,19514,25447;25685,56210,0,0,2,0,2
78888,180,19515,25392;29044,56210,0,1,1,0,2
78889,180,19517,24811;25375;28605;28700,56210,0,1,3,0,4
78890,180,19518,25386;25468;28863,56210,0,1,2,0,3
78891,180,19519,24927;25418;28329;28513;29135,56210,0,1,4,0,5
78892,180,19520,25571;25679;28344;28797,56210,0,1,3,0,4
78893,180,19522,24898;25446;28862,56210,0,1,2,0,3
78894,180,19523,25449;28334;28961,56210,0,1,2,0,3
78895,180,19525,25827;25867;29155,56210,0,1,2,0,3
78896,180,19526,25882;28810;29062,56210,0,2,1,0,3
78897,180,19527,25585;26138;28548;28908;29459;29821,56210,1,2,3,0,6
78898,180,19529,25320;25625;27433;28141;28238,56210,0,0,5,0,5
78899,180,19530,25632;26054;29632,56210,0,1,2,0,3
78900,180,19531,25647;25894;29347,56210,0,1,2,0,3
78901,180,19532,25649;25891;28160;29063;29346,56210,0,2,3,0,5
78902,180,19533,25886;25985;29167;29719,56210,0,2,2,0,4
78903,180,19534,25672;25757,56210,0,0,2,0,2
78904,180,19535,25674;25946;28536;28992,56210,0,1,3,0,4
78905,180,19536,25712;25918;28535;29540;29624,56210,0,2,3,0,5
78906,180,19537,25431;25760;28719;29059,56210,0,2,2,0,4
78907,180,19538,26002;26034;29266,56210,0,1,2,0,3
78908,180,19539,25797;25802;28722,56210,0,1,2,0,3
78909,180,19540,25774;25805;29150;29535,56210,0,2,2,0,4
78910,180,19541,25806;26026;28647;28996;29354,56210,0,2,3,0,5
78911,180,19542,25688;25810,56210,0,0,2,0,2
78912,180,19543,25811,56210,0,0,1,0,1
78913,180,19545,21857,56575,0,0,0,1,1
78914,180,19550,21977,56575,0,0,0,1,1
78915,180,19552,21834,56575,0,0,0,1,1
78916,180,19553,21576,56575,0,0,0,1,1
78917,180,19557,22143,56575,0,0,0,1,1
78918,180,19558,22211,56575,0,0,0,1,1
78919,180,19559,22233,56575,0,0,0,1,1
78920,180,19560,21809,56575,0,0,0,1,1
78921,180,19562,22145,56575,0,0,0,1,1
78922,180,19563,22428,56575,0,0,0,1,1
78923,180,19567,22318,56575,0,0,0,1,1
78924,180,19568,22991,56575,0,0,0,1,1
78925,180,19569,23141,56575,0,0,0,1,1
78926,180,19572,22855,56575,0,0,0,1,1
78927,180,19576,23684;24140,56575,0,0,1,1,2
78928,180,19579,23453;23767,56575,0,0,0,2,2
78929,180,19580,23467;24178,56575,0,0,1,1,2
78930,180,19581,24732;24836;28210,56575,0,0,3,0,3
78931,180,19583,23940;24035,56575,0,0,2,0,2
78932,180,19590,24397;24538,56575,0,0,2,0,2
78933,180,19595,24903;25353,56575,0,0,2,0,2
78934,180,19597,24932;25190;27639;28035;29430;29705,56575,0,2,4,0,6
78935,180,19598,24476;24966;27926,56575,0,0,3,0,3
78936,180,19599,25063;25217;28498;28950,56575,0,1,3,0,4
78937,180,19600,25176;25369;28325;28860,56575,0,1,3,0,4
78938,180,19602,25087;28585,56575,0,0,2,0,2
78939,180,19603,24654,56575,0,0,1,0,1
78940,180,19604,24981;25147;28031,56575,0,0,3,0,3
78941,180,19605,25235;25514;29050;29531,56575,0,2,2,0,4
78942,180,19606,25060;25185;28410;28594;29039,56575,0,1,4,0,5
78943,180,19609,25646;25723;28879;28971,56575,0,2,2,0,4
78944,180,19610,25542;25566;28620;29620,56575,0,1,3,0,4
78945,180,19611,25407;28041;28424,56575,0,0,3,0,3
78946,180,19612,25501;25714,56575,0,0,2,0,2
78947,180,19614,25351;25711;28529;29341,56575,0,1,3,0,4
78948,180,19615,25094;25377;28144;28511;28606,56575,0,0,5,0,5
78949,180,19616,25380;25691;28153,56575,0,0,3,0,3
78950,180,19617,25278;25409;28426;28702,56575,0,1,3,0,4
78951,180,19618,25240;25411;28427,56575,0,0,3,0,3
78952,180,19619,25231;25422;28429;28609;29046;29333,56575,0,2,4,0,6
78953,180,19620,25423;25492;28861,56575,0,1,2,0,3
78954,180,19621,25459;26073;28456;29992,56575,1,0,3,0,4
78955,180,19622,25694;25973;28163;29264,56575,0,1,3,0,4
78956,180,19623,25989;28540,56575,0,0,2,0,2
78957,180,19624,25605;25933;28731;28990;29261;29814,56575,1,3,2,0,6
78958,180,19625,25287;25669;28795,56575,0,1,2,0,3
78959,180,19626,25574;25684;28874,56575,0,1,2,0,3
78960,180,19627,25636;25998;28994;29544,56575,0,2,2,0,4
78961,180,19628,25575;26170;29083;29276,56575,0,2,2,0,4
78962,180,19629,26144;28821,56575,0,1,1,0,2
78963,180,19630,25795;25966;29164;29263;29448;29990,56575,1,3,2,0,6
78964,180,19631,25536;25737;29247,56575,0,1,2,0,3
78965,180,19632,25775;25875;29257,56575,0,1,2,0,3
78966,180,19633,25780;26124;29180;29274,56575,0,2,2,0,4
78967,180,19634,25959;26137;29820,56575,1,0,2,0,3
78968,180,19635,25576,56575,0,0,1,0,1
78969,180,19636,25831;26182,56575,0,0,2,0,2
78970,180,19637,25859;29345,56575,0,1,1,0,2
78971,180,19638,25857;26165;28823;29181,56575,0,2,2,0,4
78972,180,19639,25908;26142,56575,0,0,2,0,2
78973,180,19644,22202;22722,56940,0,0,0,2,2
78974,180,19647,22612,56940,0,0,0,1,1
78975,180,19648,22690,56940,0,0,0,1,1
78976,180,19649,22771,56940,0,0,0,1,1
78977,180,19650,22821,56940,0,0,0,1,1
78978,180,19652,22944;22958,56940,0,0,0,2,2
78979,180,19660,23043,56940,0,0,0,1,1
78980,180,19666,24036;24488;28278;28468,56940,0,0,4,0,4
78981,180,19670,24196;24362;27875,56940,0,0,3,0,3
78982,180,19671,24390;24664;27521,56940,0,0,3,0,3
78983,180,19673,23984;23993,56940,0,0,2,0,2
78984,180,19679,24726;25046;28401;28489;28764,56940,0,1,4,0,5
78985,180,19680,24475;24590;28371,56940,0,0,3,0,3
78986,180,19681,24807;27912,56940,0,0,2,0,2
78987,180,19682,24856;25002,56940,0,0,2,0,2
78988,180,19684,24940;25510;28338,56940,0,0,3,0,3
78989,180,19686,25382,56940,0,0,1,0,1
78990,180,19687,25123;25584;28790,56940,0,1,2,0,3
78991,180,19688,25125;25326;27946;28777,56940,0,1,3,0,4
78992,180,19689,24955;25237;27940;29041,56940,0,1,3,0,4
78993,180,19690,25226;25454;28146;28613;29335;30066,56940,1,1,4,0,6
78994,180,19691,25044;25344;27231;27742;27948;28241;28322;28507,56940,0,0,8,0,8
78995,180,19692,25111;25347,56940,0,0,2,0,2
78996,180,19693,25383;25600;28051;28340;28623,56940,0,0,5,0,5
78997,180,19694,25360;25770,56940,0,0,2,0,2
78998,180,19695,25396;25438;29332,56940,0,1,2,0,3
78999,180,19696,25435;25496;28611;28706,56940,0,1,3,0,4
79000,180,19697,25440;25460;28612;28960,56940,0,1,3,0,4
79001,180,19698,25466;25915;28728;28892;29445,56940,0,3,2,0,5
79002,180,19699,25113;25538;28869,56940,0,1,2,0,3
79003,180,19700,25419;25513;27957;28517;28784;29049,56940,0,2,4,0,6
79004,180,19701,25453;25520;28709;29237,56940,0,2,2,0,4
79005,180,19702,25753;28718;29149;29440,56940,0,3,1,0,4
79006,180,19703,25626;25845,56940,0,0,2,0,2
79007,180,19705,25485;25777,56940,0,0,2,0,2
79008,180,19706,26064;26151,56940,0,0,2,0,2
79009,180,19707,26102;29178;29356,56940,0,2,1,0,3
79010,180,19708,25616;25738;28792,56940,0,1,2,0,3
79011,180,19709,25788;28255,56940,0,0,2,0,2
79012,180,19710,26278;29006,56940,0,1,1,0,2
79013,180,19711,25819;26097;28904;29177,56940,0,2,2,0,4
79014,180,19712,25826;28157;28888;29154,56940,0,2,2,0,4
79015,180,19713,25880;25914;29160,56940,0,1,2,0,3
79016,180,19715,25818;25947;28537;28894;29069,56940,0,2,3,0,5
79017,180,19716,25696;25948;29446;29627,56940,0,2,2,0,4
79018,180,19717,26059;26131;29454;29634,56940,0,2,2,0,4
79019,180,19718,25958;26145;28822;29822,56940,1,1,2,0,4
79020,180,19719,25987;28898;29349;29451,56940,0,3,1,0,4
79021,180,19720,25796;26016;29265;29353;29629,56940,0,3,2,0,5
79022,180,19723,21862,57305,0,0,0,1,1
79023,180,19726,22460,57305,0,0,0,1,1
79024,180,19728,22590,57305,0,0,0,1,1
79025,180,19729,22639,57305,0,0,0,1,1
79026,180,19733,23032,57305,0,0,0,1,1
79027,180,19736,23213,57305,0,0,0,1,1
79028,180,19737,23122,57305,0,0,0,1,1
79029,180,19738,23081,57305,0,0,0,1,1
79030,180,19744,23549;24229,57305,0,0,1,1,2
79031,180,19747,23904;24150,57305,0,0,2,0,2
79032,180,19748,23968,57305,0,0,1,0,1
79033,180,19750,25014;25202;28316;28411,57305,0,0,4,0,4
79034,180,19752,24815,57305,0,0,1,0,1
79035,180,19754,24666;24808;27913,57305,0,0,3,0,3
79036,180,19756,24616;24851,57305,0,0,2,0,2
79037,180,19759,24471;24516,57305,0,0,2,0,2
79038,180,19760,25049;25242,57305,0,0,2,0,2
79039,180,19761,25148;25184,57305,0,0,2,0,2
79040,180,19762,25085;25234;27546,57305,0,0,3,0,3
79041,180,19763,25243;25294;28499;29329,57305,0,1,3,0,4
79042,180,19764,24763;25257;28413;28695,57305,0,1,3,0,4
79043,180,19765,25273;25527,57305,0,0,2,0,2
79044,180,19766,25277;25336,57305,0,0,2,0,2
79045,180,19767,25305;25504;28618;28867;30067,57305,1,1,3,0,5
79046,180,19768,25331;25506,57305,0,0,2,0,2
79047,180,19769,24611;28283,57305,0,0,2,0,2
79048,180,19770,25493;25741;28883,57305,0,1,2,0,3
79049,180,19771,24953;25368;28143;28604,57305,0,0,4,0,4
79050,180,19772,25384;27949;28326;29043;29893;29895,57305,2,1,3,0,6
79051,180,19773,25412;25420;28958,57305,0,1,2,0,3
79052,180,19774,25421;25511;28330;28608;29045,57305,0,1,4,0,5
79053,180,19775,25343;25473,57305,0,0,2,0,2
79054,180,19777,25439;25498;28151;28437;28780;29140,57305,0,2,4,0,6
79055,180,19778,25695;25904;27649;29339,57305,0,1,3,0,4
79056,180,19779,25581;25721,57305,0,0,2,0,2
79057,180,19780,25744;25864;28717;29058,57305,0,2,2,0,4
79058,180,19781,25457;25790;28640;29151;29342;29811,57305,1,2,3,0,6
79059,180,19782,25618;28715,57305,0,1,1,0,2
79060,180,19783,25559;25619;29139;29240,57305,0,2,2,0,4
79061,180,19784,25615;25640;28793,57305,0,1,2,0,3
79062,180,19785,25662;26231;28552,57305,0,0,3,0,3
79063,180,19786,25763;25841;28158;29060;29253,57305,0,2,3,0,5
79064,180,19787,25613;25967;28896,57305,0,1,2,0,3
79065,180,19788,25830;25982;28355;28897;29450;30259,57305,1,2,3,0,6
79066,180,19789,25663;25835;27962,57305,0,0,3,0,3
79067,180,19790,25836;29251;29538;29623,57305,0,3,1,0,4
79068,180,19791,25732;26234;29189,57305,0,1,2,0,3
79069,180,19792,25848;28644,57305,0,0,2,0,2
79070,180,19793,25869;26355;29735,57305,0,1,2,0,3
79071,180,19794,25884;26120;28736;29179;29457;29638;29899,57305,1,4,2,0,7
79072,180,19796,25907;26220,57305,0,0,2,0,2
79073,180,19797,26384;28660,57305,0,0,2,0,2
79074,180,19798,25926;26071;29817,57305,1,0,2,0,3
79075,180,19799,25759;25935,57305,0,0,2,0,2
79076,180,19800,25955;26077;29076;29270,57305,0,2,2,0,4
79077,180,19801,25614;25990;29168;29350;29897,57305,1,2,2,0,5
79078,180,19802,25509;25991,57305,0,0,2,0,2
79079,180,19803,25999,57305,0,0,1,0,1
79080,180,19804,26003;26332;28923,57305,0,1,2,0,3
79081,180,19805,25441;26022,57305,0,0,2,0,2
79082,180,19806,26104;26198;29463,57305,0,1,2,0,3
79083,180,19807,26063;26272;28656;28745;29005;29371;29731,57305,0,4,3,0,7
79084,180,19808,26192;26260;28827;29283;29467,57305,0,3,2,0,5
79085,180,19809,25750;26167;29460;29552;29823;29900;29993,57305,3,2,2,0,7
79086,180,19810,26107;26148,57305,0,0,2,0,2
79087,180,19811,25916;26134;28819,57305,0,1,2,0,3
79088,180,19812,26136;26313;28555;28830;29649;29828,57305,1,2,3,0,6
79089,180,19813,21863,57670,0,0,0,1,1
79090,180,19815,21750,57670,0,0,0,1,1
79091,180,19817,22277,57670,0,0,0,1,1
79092,180,19820,22182,57670,0,0,0,1,1
79093,180,19821,22175;22462,57670,0,0,0,2,2
79094,180,19824,22863,57670,0,0,0,1,1
79095,180,19825,22789,57670,0,0,0,1,1
79096,180,19826,22843,57670,0,0,0,1,1
79097,180,19828,22960;23539,57670,0,0,0,2,2
79098,180,19830,23343,57670,0,0,0,1,1
79099,180,19833,23847;24077,57670,0,0,1,1,2
79100,180,19840,24256;24374,57670,0,0,2,0,2
79101,180,19842,24543,57670,0,0,1,0,1
79102,180,19843,24532;25058;28122,57670,0,0,3,0,3
79103,180,19846,24380;24784;27809;28293;28475,57670,0,0,5,0,5
79104,180,19847,24772;25034;27631;28399;28584,57670,0,0,5,0,5
79105,180,19848,24907;24979;28114,57670,0,0,3,0,3
79106,180,19852,25124;27432;28030;28129;28311;30229,57670,1,0,5,0,6
79107,180,19853,25224;25481;28771,57670,0,1,2,0,3
79108,180,19855,25095;28025,57670,0,0,2,0,2
79109,180,19856,25120;25267,57670,0,0,2,0,2
79110,180,19858,25150;27836;29233,57670,0,1,2,0,3
79111,180,19859,25310;25609;28341;28523,57670,0,0,4,0,4
79112,180,19860,25322;28425;28701,57670,0,1,2,0,3
79113,180,19861,25557;29621,57670,0,1,1,0,2
79114,180,19862,25335;25451;29134,57670,0,1,2,0,3
79115,180,19863,26101;26218;28357;28457;28543;28905;29272,57670,0,2,5,0,7
79116,180,19866,25292;25546;28712;28871,57670,0,2,2,0,4
79117,180,19867,25563;25740;28155;28800,57670,0,1,3,0,4
79118,180,19868,25812;29442,57670,0,1,1,0,2
79119,180,19869,25587;25846;28986,57670,0,1,2,0,3
79120,180,19870,25863;25913;28262,57670,0,0,3,0,3
79121,180,19872,25634;25813;28805;28887;29250,57670,0,3,2,0,5
79122,180,19873,25928;26489;28559,57670,0,0,3,0,3
79123,180,19874,25664;25839;28643;29252,57670,0,1,3,0,4
79124,180,19876,25781;25887;28811;28891;29444,57670,0,3,2,0,5
79125,180,19877,25853;28806;28890,57670,0,2,1,0,3
79126,180,19878,26394;26422;29909,57670,1,0,2,0,3
79127,180,19879,25495;25906;28988;29065;29259;29539,57670,0,4,2,0,6
79128,180,19880,25807;25912;28727,57670,0,1,2,0,3
79129,180,19881,25943;29626,57670,0,1,1,0,2
79130,180,19882,25940;25977,57670,0,0,2,0,2
79131,180,19883,25786;25954;29070,57670,0,1,2,0,3
79132,180,19884,25957;26411;28832;29739,57670,0,2,2,0,4
79133,180,19885,25890;26267;29370;29469;29557,57670,0,3,2,0,5
79134,180,19886,25436;25994,57670,0,0,2,0,2
79135,180,19887,25974;26287;29191;29471;29826,57670,1,2,2,0,5
79136,180,19888,26162;26245;28743;29281;29995,57670,1,2,2,0,5
79137,180,19889,25866;26066;29548,57670,0,1,2,0,3
79138,180,19890,25773;26140;28549,57670,0,0,3,0,3
79139,180,19891,26092;26469;29658;30078,57670,1,1,2,0,4
79140,180,19892,26226;26326,57670,0,0,2,0,2
79141,180,19893,26312;26486;28661;29566,57670,0,1,3,0,4
79142,180,19894,26116;26158;27761;28545;29078;29273;29975,57670,1,2,4,0,7
79143,180,19895,26118;26472;29013,57670,0,1,2,0,3
79144,180,19896,26128;26249;28358;29000;29550;29640,57670,0,3,3,0,6
79145,180,19898,26045;26179;28167;28654;29553,57670,0,1,4,0,5
79146,180,19899,25829;25920;29718,57670,0,1,2,0,3
79147,180,19901,26228;26318;28826;29366,57670,0,2,2,0,4
79148,180,19902,26230;26507;28931;29911,57670,1,1,2,0,4
79149,180,19903,26025;26239;28742;29089,57670,0,2,2,0,4
79150,180,19904,21845,58035,0,0,0,1,1
79151,180,19905,22316,58035,0,0,0,1,1
79152,180,19908,22804,58035,0,0,0,1,1
79153,180,19909,22095,58035,0,0,0,1,1
79154,180,19911,23090,58035,0,0,0,1,1
79155,180,19914,23245,58035,0,0,0,1,1
79156,180,19916,22854,58035,0,0,0,1,1
79157,180,19925,23838;24381,58035,0,0,1,1,2
79158,180,19928,24834;28477,58035,0,0,2,0,2
79159,180,19929,24225;24493;28081;28279,58035,0,0,4,0,4
79160,180,19930,24422;24434;28190,58035,0,0,3,0,3
79161,180,19931,24628;24716,58035,0,0,2,0,2
79162,180,19937,25013;25304;28236;28417;30255,58035,1,0,4,0,5
79163,180,19938,25028;25173;28227;28495,58035,0,0,4,0,4
79164,180,19939,25052,58035,0,0,1,0,1
79165,180,19940,24802;25196;28769,58035,0,1,2,0,3
79166,180,19941,25214;28497,58035,0,0,2,0,2
79167,180,19942,25463;25642;28781;29048,58035,0,2,2,0,4
79168,180,19944,26079;26121;29639;29722,58035,0,2,2,0,4
79169,180,19945,25379;28421;28957,58035,0,1,2,0,3
79170,180,19947,25877,58035,0,0,1,0,1
79171,180,19948,25567;25903;29064;29159;29258;29812,58035,1,3,2,0,6
79172,180,19949,25648;25673;28438;28973,58035,0,1,3,0,4
79173,180,19950,25475;25921,58035,0,0,2,0,2
79174,180,19951,25689;25785;29145,58035,0,1,2,0,3
79175,180,19952,25716;26201,58035,0,0,2,0,2
79176,180,19953,25733;25837,58035,0,0,2,0,2
79177,180,19954,25528;25764;28056;29534,58035,0,1,3,0,4
79178,180,19955,25768;26163;28738;28910;29644;30073,58035,1,3,2,0,6
79179,180,19956,25726;25801;28446;28976;29245,58035,0,2,3,0,5
79180,180,19957,25401;25804;28450;28983;29152,58035,0,2,3,0,5
79181,180,19958,25814;25975;29165;29449;29815,58035,1,2,2,0,5
79182,180,19959,25854;26015;29452,58035,0,1,2,0,3
79183,180,19960,25856;26046;28817;29991,58035,1,1,2,0,4
79184,180,19961,25668;25879;28809,58035,0,1,2,0,3
79185,180,19962,25909;26316;29472;29907,58035,1,1,2,0,4
79186,180,19964,26458;28558,58035,0,0,2,0,2
79187,180,19965,26367;26535;29291;29477,58035,0,2,2,0,4
79188,180,19966,26030;26086,58035,0,0,2,0,2
79189,180,19967,26043;26464;28750;29481;29657,58035,0,3,2,0,5
79190,180,19968,26051;26290;29374,58035,0,1,2,0,3
79191,180,19969,26105;26319;29093;29193;29285;29375;29650,58035,0,5,2,0,7
79192,180,19970,26560,58035,0,0,1,0,1
79193,180,19971,25931;26075,58035,0,0,2,0,2
79194,180,19972,25838;26108;28544;28906,58035,0,1,3,0,4
79195,180,19973,26132;26349;29289;29475;29997,58035,1,2,2,0,5
79196,180,19974,25971;26146;28359;29080;29642;30260,58035,1,2,3,0,6
79197,180,19975,25735;28054;28530;28635;28799,58035,0,1,4,0,5
79198,180,19976,26017;26189;28551;28913;29002;29279;29994,58035,1,3,3,0,7
79199,180,19977,26193;28914;29003;29726,58035,0,3,1,0,4
79200,180,19978,26194;26283;28746;29372,58035,0,2,2,0,4
79201,180,19979,26195;29085;29462,58035,0,2,1,0,3
79202,180,19980,25911;26205;29901,58035,1,0,2,0,3
79203,180,19981,26446,58035,0,0,1,0,1
79204,180,19982,26156;26210;29004;29464;29645,58035,0,3,2,0,5
79205,180,19984,26241;26548;29571;29747;30000,58035,1,2,2,0,5
79206,180,19985,25992;26262;29284;29905,58035,1,1,2,0,4
79207,180,19988,21757,58400,0,0,0,1,1
79208,180,19989,22232,58400,0,0,0,1,1
79209,180,19990,22385,58400,0,0,0,1,1
79210,180,19991,22479,58400,0,0,0,1,1
79211,180,19993,22596,58400,0,0,0,1,1
79212,180,19995,22646,58400,0,0,0,1,1
79213,180,19998,22856,58400,0,0,0,1,1
79214,180,20001,22910;22945,58400,0,0,0,2,2
79215,180,20002,23323,58400,0,0,0,1,1
79216,180,20006,23054,58400,0,0,0,1,1
79217,180,20008,23354;23398,58400,0,0,0,2,2
79218,180,20016,24889;25079,58400,0,0,2,0,2
79219,180,20017,24223;24358,58400,0,0,2,0,2
79220,180,20018,24570;24885,58400,0,0,2,0,2
79221,180,20019,24983;27821;28116;28303;28484;28763,58400,0,1,5,0,6
79222,180,20020,24369;24645;28672,58400,0,1,2,0,3
79223,180,20024,25009;25416;27953;28779,58400,0,1,3,0,4
79224,180,20026,25586;25620,58400,0,0,2,0,2
79225,180,20027,25308;25590;28339;28966;30169,58400,1,1,3,0,5
79226,180,20028,25126;25315;28699,58400,0,1,2,0,3
79227,180,20029,25325;25561;28250;28522;30256,58400,1,0,4,0,5
79228,180,20030,25160;25390;28327,58400,0,0,3,0,3
79229,180,20031,25367;25465,58400,0,0,2,0,2
79230,180,20032,24841;25191;28595,58400,0,0,3,0,3
79231,180,20034,25364;25667;28626,58400,0,0,3,0,3
79232,180,20035,25363;25570;27552;29611,58400,0,1,3,0,4
79233,180,20036,25560;28434;29436;30261,58400,1,1,2,0,4
79234,180,20037,25537;25840;28724;28889;29156,58400,0,3,2,0,5
79235,180,20038,25562;26233;29367;29556;29729,58400,0,3,2,0,5
79236,180,20039,25452;25598;28050;29713,58400,0,1,3,0,4
79237,180,20040,25507;25617,58400,0,0,2,0,2
79238,180,20041,25301;25355;28419,58400,0,0,3,0,3
79239,180,20042,25658;26080;28649;29549;29635,58400,0,2,3,0,5
79240,180,20043,25583;25697;28630,58400,0,0,3,0,3
79241,180,20044,25745;25798;28801,58400,0,1,2,0,3
79242,180,20045,25746;28636;28885,58400,0,1,2,0,3
79243,180,20047,25832;26407;28538,58400,0,0,3,0,3
79244,180,20048,25635;26011,58400,0,0,2,0,2
79245,180,20049,25901;28352,58400,0,0,2,0,2
79246,180,20050,26061;26074;28997;29173;29269,58400,0,3,2,0,5
79247,180,20051,25905;25949;28645;29447;29542;29989,58400,1,2,3,0,6
79248,180,20052,26285;26433;28268;29987;30076,58400,2,0,3,0,5
79249,180,20053,26396;29831,58400,1,0,1,0,2
79250,180,20054,25660;25981;27850;28646;28732;29166;29805;30061;30071,58400,2,3,4,0,9
79251,180,20055,26006;26113;29720,58400,0,1,2,0,3
79252,180,20056,26007;26139;28814,58400,0,1,2,0,3
79253,180,20057,25860;26032;28648,58400,0,0,3,0,3
79254,180,20058,26057;26328,58400,0,0,2,0,2
79255,180,20059,26221;26261;28554,58400,0,0,3,0,3
79256,180,20060,26420;26528;28557;30176,58400,1,0,3,0,4
79257,180,20061,26109;26372;29380;29830;29908;29999,58400,3,1,2,0,6
79258,180,20062,25893;26112,58400,0,0,2,0,2
79259,180,20063,26020;26117;29637;29721,58400,0,2,2,0,4
79260,180,20064,26122;26510;28068,58400,0,0,3,0,3
79261,180,20065,25953;26203;28916;29363,58400,0,2,2,0,4
79262,180,20066,25539;28520;28711;28787;29238,58400,0,3,2,0,5
79263,180,20067,26152;28550;29081;29551,58400,0,2,2,0,4
79264,180,20068,26208;26364;28360;28458;29186;29364;29902,58400,1,2,4,0,7
79265,180,20070,26062;26821;29308;29934;30008,58400,2,1,2,0,5
79266,180,20071,25993;26263,58400,0,0,2,0,2
79267,180,20073,26275;26282;29090;29733,58400,0,2,2,0,4
79268,180,20074,26321;26524;28836;29297,58400,0,2,2,0,4
79269,180,20075,26385;26590;29562,58400,0,1,2,0,3
79270,180,20076,25969;26391;29738,58400,0,1,2,0,3
79271,180,20077,26353;26532;29298;29484;29834,58400,1,2,2,0,5
79272,180,20078,26410;26596;28936;29573,58400,0,2,2,0,4
79273,180,20079,26593;26694;28839;29581;29669;29671,58400,0,4,2,0,6
79274,180,20080,26414;26427;29201;30175,58400,1,1,2,0,4
79275,180,20081,21802,58765,0,0,0,1,1
79276,180,20088,22544,58765,0,0,0,1,1
79277,180,20090,22769,58765,0,0,0,1,1
79278,180,20093,22725,58765,0,0,0,1,1
79279,180,20096,22984,58765,0,0,0,1,1
79280,180,20097,22388,58765,0,0,0,1,1
79281,180,20101,23921;26498,58765,0,0,2,0,2
79282,180,20102,24378,58765,0,0,1,0,1
79283,180,20107,24603;25139;28592,58765,0,0,3,0,3
79284,180,20108,24132;24585,58765,0,0,2,0,2
79285,180,20109,24416;24681,58765,0,0,2,0,2
79286,180,20113,24930,58765,0,0,1,0,1
79287,180,20114,25026;25112,58765,0,0,2,0,2
79288,180,20115,25404;25717;28444;30173,58765,1,0,3,0,4
79289,180,20118,25522;28518;28786,58765,0,1,2,0,3
79290,180,20120,25858;25979;28261;28533;29255;29344;29810,58765,0,3,4,0,7
79291,180,20121,25471;25535;28864,58765,0,1,2,0,3
79292,180,20122,25524;25592;28148;28868;30166,58765,1,1,3,0,5
79293,180,20123,25603;25899;28351,58765,0,0,3,0,3
79294,180,20124,25497;25870,58765,0,0,2,0,2
79295,180,20126,25568;25692;28440;28629;29057;29338;29439,58765,0,3,4,0,7
79296,180,20127,25876;26084;27853;28903;29175;29636;29818,58765,1,3,3,0,7
79297,180,20129,25761;25809,58765,0,0,2,0,2
79298,180,20131,26001;26266;28919;29468;29906,58765,1,2,2,0,5
79299,180,20132,26119;28546;28652;29357,58765,0,1,3,0,4
79300,180,20133,26048;26398,58765,0,0,2,0,2
79301,180,20134,26052;26125;28547;28737;28907;28998,58765,0,3,3,0,6
79302,180,20135,25844;26060;29268,58765,0,1,2,0,3
79303,180,20136,25776;26103,58765,0,0,2,0,2
79304,180,20137,26169;26754;29216,58765,0,1,2,0,3
79305,180,20138,25752,58765,0,0,1,0,1
79306,180,20139,26222;26537,58765,0,0,2,0,2
79307,180,20140,26237;26310;29088,58765,0,1,2,0,3
79308,180,20143,26160;26255;28744;29466,58765,0,2,2,0,4
79309,180,20144,26749;26774;28366;28668;28843;29931,58765,1,1,4,0,6
79310,180,20145,26296;26545;29485,58765,0,1,2,0,3
79311,180,20146,26530;26707;28667,58765,0,0,3,0,3
79312,180,20147,26028;26314,58765,0,0,2,0,2
79313,180,20148,25534;26322;29008;29287,58765,0,2,2,0,4
79314,180,20149,26334;26708;29398,58765,0,1,2,0,3
79315,180,20150,26363;26603;28665;29102;29488;29664,58765,0,3,3,0,6
79316,180,20151,25593;26375,58765,0,0,2,0,2
79317,180,20152,26377;26493;28925,58765,0,1,2,0,3
79318,180,20153,26409;26601;29302,58765,0,1,2,0,3
79319,180,20154,26421;26723;28841;29497,58765,0,2,2,0,4
79320,180,20155,26243;26450;28362,58765,0,0,3,0,3
79321,180,20156,26454;29097;29656,58765,0,2,1,0,3
79322,180,20157,26274;26460,58765,0,0,2,0,2
79323,180,20158,26090;26301;29898,58765,1,0,2,0,3
79324,180,20159,26741,58765,0,0,1,0,1
79325,180,20160,26473;29743,58765,0,1,1,0,2
79326,180,20161,26244;26490;29203;29386;29567;29660,58765,0,4,2,0,6
79327,180,20162,26492;26504;28662,58765,0,0,3,0,3
79328,180,20163,26512;26602;29745;29912,58765,1,1,2,0,4
79329,180,20164,22329,59130,0,0,0,1,1
79330,180,20165,22345,59130,0,0,0,1,1
79331,180,20167,22405,59130,0,0,0,1,1
79332,180,20168,22456;22990,59130,0,0,0,2,2
79333,180,20169,22597,59130,0,0,0,1,1
79334,180,20170,22794,59130,0,0,0,1,1
79335,180,20171,22888,59130,0,0,0,1,1
79336,180,20173,22682,59130,0,0,0,1,1
79337,180,20174,22644,59130,0,0,0,1,1
79338,180,20175,23170,59130,0,0,0,1,1
79339,180,20176,23363,59130,0,0,0,1,1
79340,180,20178,23073,59130,0,0,0,1,1
79341,180,20180,22836;23066,59130,0,0,0,2,2
79342,180,20182,23524;23591,59130,0,0,0,2,2
79343,180,20189,24183;24275,59130,0,0,2,0,2
79344,180,20205,25219;27736;28597,59130,0,0,3,0,3
79345,180,20206,25249;25289;28856,59130,0,1,2,0,3
79346,180,20208,25406;25553;28789;29239,59130,0,2,2,0,4
79347,180,20210,25599;25678;28628;28974;29143,59130,0,2,3,0,5
79348,180,20211,25706;26085;29176;29819,59130,1,1,2,0,4
79349,180,20212,25588;25828;28642;29717,59130,0,1,3,0,4
79350,180,20213,25666;25755;28637;28978,59130,0,1,3,0,4
79351,180,20214,25762;29248,59130,0,1,1,0,2
79352,180,20215,25847;25956;28539;29162,59130,0,1,3,0,4
79353,180,20216,26286;26368;29378;29561,59130,0,2,2,0,4
79354,180,20217,25952;28895,59130,0,1,1,0,2
79355,180,20218,25687;25964;29163,59130,0,1,2,0,3
79356,180,20219,25794;25850,59130,0,0,2,0,2
79357,180,20221,26013;26438;28834,59130,0,1,2,0,3
79358,180,20222,26076;26081;28650;28735;28902;29174,59130,0,3,3,0,6
79359,180,20223,26279;28828;29732;30074,59130,1,2,1,0,4
79360,180,20224,26100;26211;29187;29554,59130,0,2,2,0,4
79361,180,20225,25820;26183;28066;29278;29362;29461,59130,0,3,3,0,6
79362,180,20226,26204;26502,59130,0,0,2,0,2
79363,180,20227,25997;26206;29086;29185;29727,59130,0,3,2,0,5
79364,180,20228,26207;26763;30006,59130,1,0,2,0,3
79365,180,20230,25924;26235;29730,59130,0,1,2,0,3
79366,180,20231,26248;26539;29299,59130,0,1,2,0,3
79367,180,20232,26463;29382;29480,59130,0,2,1,0,3
79368,180,20233,26401;29295,59130,0,1,1,0,2
79369,180,20234,26569;26680,59130,0,0,2,0,2
79370,180,20235,26069;26426;29096,59130,0,1,2,0,3
79371,180,20236,26429;29655;29740,59130,0,2,1,0,3
79372,180,20237,26444;26485;29384;29744,59130,0,2,2,0,4
79373,180,20238,26467,59130,0,0,1,0,1
79374,180,20240,26561,59130,0,0,1,0,1
79375,180,20241,26434;26579;29205;29487,59130,0,2,2,0,4
79376,180,20242,26476;26572;28664,59130,0,0,3,0,3
79377,180,20243,22470,59495,0,0,0,1,1
79378,180,20244,22370,59495,0,0,0,1,1
79379,180,20247,22811,59495,0,0,0,1,1
79380,180,20248,22586,59495,0,0,0,1,1
79381,180,20249,22877,59495,0,0,0,1,1
79382,180,20250,23396,59495,0,0,0,1,1
79383,180,20251,23255,59495,0,0,0,1,1
79384,180,20257,23378,59495,0,0,0,1,1
79385,180,20260,23596,59495,0,0,0,1,1
79386,180,20262,24049;24157,59495,0,0,2,0,2
79387,180,20267,24595;24900;28016;28216;28480,59495,0,0,5,0,5
79388,180,20269,25016;25429;28245;28431;28610;28705;28959,59495,0,2,5,0,7
79389,180,20270,25246;25311;28954;29330,59495,0,2,2,0,4
79390,180,20271,25083;25309;28603,59495,0,0,3,0,3
79391,180,20272,25547;25690,59495,0,0,2,0,2
79392,180,20273,25767;28803,59495,0,1,1,0,2
79393,180,20274,25540;25654;28794;28880;29054,59495,0,3,2,0,5
79394,180,20275,25554;25765,59495,0,0,2,0,2
79395,180,20277,25749;25754;29533,59495,0,1,2,0,3
79396,180,20278,25742;26389;29294;29737;30075,59495,1,2,2,0,5
79397,180,20279,25769;25932;28813;29260;30070,59495,1,2,2,0,5
79398,180,20280,25772;26172;29183,59495,0,1,2,0,3
79399,180,20281,25897;26500;28663;28930;29568,59495,0,2,3,0,5
79400,180,20282,26452;29564,59495,0,1,1,0,2
79401,180,20284,26083;26229;29903,59495,1,0,2,0,3
79402,180,20285,25934;26089;28651;28818,59495,0,1,3,0,4
79403,180,20286,26095;26114;29355,59495,0,1,2,0,3
79404,180,20287,25962;26111;29077,59495,0,1,2,0,3
79405,180,20289,25734;26133;29001,59495,0,1,2,0,3
79406,180,20290,25825;26199;28740;28915,59495,0,2,2,0,4
79407,180,20291,26159;26365,59495,0,0,2,0,2
79408,180,20292,26153;26932;28562;29591,59495,0,1,3,0,4
79409,180,20293,25529;26173;28653;29360;29723,59495,0,2,3,0,5
79410,180,20294,26126;26176;28999;29358;29458,59495,0,3,2,0,5
79411,180,20295,26197;26585;29101,59495,0,1,2,0,3
79412,180,20297,26257;26289;28655;29369,59495,0,1,3,0,4
79413,180,20298,26268;26927,59495,0,0,2,0,2
79414,180,20299,26270;26577;30082,59495,1,0,2,0,3
79415,180,20300,26324;26481,59495,0,0,2,0,2
79416,180,20301,26710;29925,59495,1,0,1,0,2
79417,180,20302,26250;26470;29012,59495,0,1,2,0,3
79418,180,20303,26357;26862,59495,0,0,2,0,2
79419,180,20304,26366;26833,59495,0,0,2,0,2
79420,180,20305,26035;26380;28659;29196,59495,0,1,3,0,4
79421,180,20306,26254;26441;28918,59495,0,1,2,0,3
79422,180,20307,26442;28749;29742;30178,59495,1,2,1,0,4
79423,180,20308,26227;26453;28835,59495,0,1,2,0,3
79424,180,20309,26483;26969;29681,59495,0,1,2,0,3
79425,180,20310,26325;26526;28932;29483,59495,0,2,2,0,4
79426,180,20311,26529;26648;29017,59495,0,1,2,0,3
79427,180,20312,26842;26901;29589;29942;30104,59495,2,1,2,0,5
79428,180,20313,26534;26615;29100;29569,59495,0,2,2,0,4
79429,180,20314,26948;29770;30191,59495,1,1,1,0,3
79430,180,20315,26415;26573;29478,59495,0,1,2,0,3
79431,180,20316,26475;26613;29303;29836,59495,1,1,2,0,4
79432,180,20317,26610;26652;29578;30183,59495,1,1,2,0,4
79433,180,20318,26658;29840,59495,1,0,1,0,2
79434,180,20319,26404;26669,59495,0,0,2,0,2
79435,180,20320,26683;29843;30089,59495,2,0,1,0,3
79436,180,20321,26509;26686,59495,0,0,2,0,2
79437,180,20322,26247;26687;29579,59495,0,1,2,0,3
79438,180,20323,26350;26706;29845,59495,1,0,2,0,3
79439,180,20324,26711;26903;29027;30105,59495,1,1,2,0,4
79440,180,20325,22446,59860,0,0,0,1,1
79441,180,20326,22115,59860,0,0,0,1,1
79442,180,20328,22875,59860,0,0,0,1,1
79443,180,20329,22373,59860,0,0,0,1,1
79444,180,20330,22899,59860,0,0,0,1,1
79445,180,20331,22982,59860,0,0,0,1,1
79446,180,20332,22459,59860,0,0,0,1,1
79447,180,20333,22838,59860,0,0,0,1,1
79448,180,20336,22946,59860,0,0,0,1,1
79449,180,20337,22514,59860,0,0,0,1,1
79450,180,20347,24121;24288,59860,0,0,2,0,2
79451,180,20350,24433;24715,59860,0,0,2,0,2
79452,180,20351,24825;25023;27430,59860,0,0,3,0,3
79453,180,20353,24976;25227,59860,0,0,2,0,2
79454,180,20354,25061;25378;27641;28420;29234,59860,0,1,4,0,5
79455,180,20355,25218,59860,0,0,1,0,1
79456,180,20358,25474;25789;28980;29536,59860,0,2,2,0,4
79457,180,20359,25483;25824;27964;28258;29979,59860,1,0,4,0,5
79458,180,20360,25381;25606;29053,59860,0,1,2,0,3
79459,180,20362,25318;25508;28783,59860,0,1,2,0,3
79460,180,20363,25356;25622;28525;28876;28968,59860,0,2,3,0,5
79461,180,20364,25100;25350;28026;28590,59860,0,0,4,0,4
79462,180,20365,25541;25748,59860,0,0,2,0,2
79463,180,20366,25703;26185;28739;29725,59860,0,2,2,0,4
79464,180,20367,25766;25937,59860,0,0,2,0,2
79465,180,20368,25709;25793;28981;29622,59860,0,2,2,0,4
79466,180,20369,26340,59860,0,0,1,0,1
79467,180,20370,25589,59860,0,0,1,0,1
79468,180,20371,25942;26342;28831;29474;29560,59860,0,3,2,0,5
79469,180,20372,26306;26888;29502;30102,59860,1,1,2,0,4
79470,180,20373,25724;25970;29071,59860,0,1,2,0,3
79471,180,20374,26008;26115;29456;30072,59860,1,1,2,0,4
79472,180,20375,26012;26352;28924,59860,0,1,2,0,3
79473,180,20376,25699;26049;29267;29546,59860,0,2,2,0,4
79474,180,20377,26149,59860,0,0,1,0,1
79475,180,20378,25602;26087;29455,59860,0,1,2,0,3
79476,180,20379,26099;26217;28825;29365;29555,59860,0,3,2,0,5
79477,180,20381,26141;26812;29217;29584,59860,0,2,2,0,4
79478,180,20382,26360;29011;29290;29998,59860,1,2,1,0,4
79479,180,20385,26495;26690;29580;29668;29758;29922,59860,1,3,2,0,6
79480,180,20386,26392,59860,0,0,1,0,1
79481,180,20388,26633;28937,59860,0,1,1,0,2
79482,180,20389,26727;26783;28669,59860,0,0,3,0,3
79483,180,20390,26361;26362;29829,59860,1,0,2,0,3
79484,180,20391,26383;26511;29736,59860,0,1,2,0,3
79485,180,20392,26395;26556;29749,59860,0,1,2,0,3
79486,180,20393,26400;26655,59860,0,0,2,0,2
79487,180,20394,26186;26403;29084,59860,0,1,2,0,3
79488,180,20396,26004;26010;28454;29351,59860,0,1,3,0,4
79489,180,20397,26402;26435;29832,59860,1,0,2,0,3
79490,180,20398,26439;26675;29018;29493;29920;30088,59860,2,2,2,0,6
79491,180,20399,26456;26828;29024;29673;29762;29935,59860,1,3,2,0,6
79492,180,20400,26474;26728;29401,59860,0,1,2,0,3
79493,180,20401,26482;26795;28939;29405,59860,0,2,2,0,4
79494,180,20402,26369;26662;29105;29667;29841;29919,59860,2,2,2,0,6
79495,180,20403,26565;26983;28754;29223;29597,59860,0,3,2,0,5
79496,180,20404,26604;26898;29588,59860,0,1,2,0,3
79497,180,20405,26750;27059;29225;30112,59860,1,1,2,0,4
79498,180,20407,26242;26634;29211;29394;29490,59860,0,3,2,0,5
79499,180,20408,26896;27062;29947;30198,59860,2,0,2,0,4
79500,180,20409,26667;26753,59860,0,0,2,0,2
79501,180,20410,26678;26869;30100,59860,1,0,2,0,3
79502,180,20411,26527;26688;29106;29305;29397;29494;29757;29921,59860,1,5,2,0,8
79503,180,20412,26689;26843,59860,0,0,2,0,2
79504,180,20413,26554;26714;29389;29486;29748,59860,0,3,2,0,5
79505,180,20414,26963;26981;29775;30020,59860,1,1,2,0,4
79506,180,20415,26747;26868;28564;29939,59860,1,0,3,0,4
79507,180,20417,26390;26808;29406;29846,59860,1,1,2,0,4
79508,180,20418,22672,60225,0,0,0,1,1
79509,180,20419,22738,60225,0,0,0,1,1
79510,180,20420,22519,60225,0,0,0,1,1
79511,180,20422,22977,60225,0,0,0,1,1
79512,180,20423,22813,60225,0,0,0,1,1
79513,180,20424,22798,60225,0,0,0,1,1
79514,180,20428,23637;23694,60225,0,0,0,2,2
79515,180,20436,24109;24558;27311,60225,0,0,3,0,3
79516,180,20439,24814;24828,60225,0,0,2,0,2
79517,180,20440,24773;25228;28772;28951,60225,0,2,2,0,4
79518,180,20441,24859;24986,60225,0,0,2,0,2
79519,180,20443,24749;24933,60225,0,0,2,0,2
79520,180,20445,25337;25341;28505;28955,60225,0,1,3,0,4
79521,180,20446,25499;25607;28624,60225,0,0,3,0,3
79522,180,20447,25677;25731;28634;28977,60225,0,1,3,0,4
79523,180,20448,25883;25972;29072,60225,0,1,2,0,3
79524,180,20451,25291;25787;28057;28639;28804;29249;29441,60225,0,3,4,0,7
79525,180,20452,25444;25892;28350;29158,60225,0,1,3,0,4
79526,180,20453,25896;25986;29543,60225,0,1,2,0,3
79527,180,20454,25936;25939;29067;29161;29625,60225,0,3,2,0,5
79528,180,20455,25963;26284;29373;29470,60225,0,2,2,0,4
79529,180,20456,25980,60225,0,0,1,0,1
79530,180,20457,25995;26382;28926;29654,60225,0,2,2,0,4
79531,180,20459,26154;26174;28824;28912;29277;29724,60225,0,4,2,0,6
79532,180,20460,26088;26374;28461;28658;29194;29292;29653,60225,0,3,4,0,7
79533,180,20461,26127;26330,60225,0,0,2,0,2
79534,180,20462,26143;29079;29641,60225,0,2,1,0,3
79535,180,20463,26040,60225,0,0,1,0,1
79536,180,20464,26161;26430;28927;29202,60225,0,2,2,0,4
79537,180,20465,26251;26521;29746;29914,60225,1,1,2,0,4
79538,180,20466,26376,60225,0,0,1,0,1
79539,180,20467,26094;26926;29853;30018;30107,60225,3,0,2,0,5
79540,180,20468,25680;26329;28556;28748;29288,60225,0,2,3,0,5
79541,180,20469,26358;26432;28833;29381,60225,0,2,2,0,4
79542,180,20470,26378;26542;29300,60225,0,1,2,0,3
79543,180,20472,25968;26252;29825,60225,1,0,2,0,3
79544,180,20473,26650;26771;29110;29500,60225,0,2,2,0,4
79545,180,20474,26449;26591,60225,0,0,2,0,2
79546,180,20475,26213;26575,60225,0,0,2,0,2
79547,180,20477,26462;26491;28560;28751;29482,60225,0,2,3,0,5
79548,180,20478,26269;26656;29396,60225,0,1,2,0,3
79549,180,20479,26522;26813;29023;29847,60225,1,1,2,0,4
79550,180,20481,26887;27007,60225,0,0,2,0,2
79551,180,20482,26513;29014;29296;29388;30079,60225,1,3,1,0,5
79552,180,20483,26607;29752,60225,0,1,1,0,2
79553,180,20484,26065;26612;29208;29392;29489,60225,0,3,2,0,5
79554,180,20485,26544;26627;29210;30084,60225,1,1,2,0,4
79555,180,20486,26785;26792;28670;29404;30093,60225,1,1,3,0,5
79556,180,20487,26624;26636;29103,60225,0,1,2,0,3
79557,180,20488,26514;26659,60225,0,0,2,0,2
79558,180,20489,26451;26663;30087,60225,1,0,2,0,3
79559,180,20490,26718;27217,60225,0,0,2,0,2
79560,180,20491,27002;27204;29118;30192,60225,1,1,2,0,4
79561,180,20492,26417;26777,60225,0,0,2,0,2
79562,180,20493,26520;26780;29015;29913,60225,1,1,2,0,4
79563,180,20494,26765;26799;29499,60225,0,1,2,0,3
79564,180,20495,26743;26809;29022;29407;30095,60225,1,2,2,0,5
79565,180,20496,26811;26994,60225,0,0,2,0,2
79566,180,20497,26817;26909,60225,0,0,2,0,2
79567,180,20498,26681;28462;29842,60225,1,0,2,0,3
79568,180,20499,26829;26873;29310;29675,60225,0,2,2,0,4
79569,180,20500,26861;26875;29112;29940,60225,1,1,2,0,4
79570,180,20501,26880;26897,60225,0,0,2,0,2
79571,180,20502,26916;26979,60225,0,0,2,0,2
79572,180,20503,22989,60590,0,0,0,1,1
79573,180,20506,23034,60590,0,0,0,1,1
79574,180,20508,22909,60590,0,0,0,1,1
79575,180,20511,23142;23227,60590,0,0,0,2,2
79576,180,20514,23661;24137,60590,0,0,1,1,2
79577,180,20516,24021,60590,0,0,1,0,1
79578,180,20526,23973;24560,60590,0,0,2,0,2
79579,180,20531,24996,60590,0,0,1,0,1
79580,180,20536,25017;25479;28433;28615,60590,0,0,4,0,4
79581,180,20537,25115,60590,0,0,1,0,1
79582,180,20539,24967;25366,60590,0,0,2,0,2
79583,180,20544,25464,60590,0,0,1,0,1
79584,180,20546,25898;26014;28815,60590,0,1,2,0,3
79585,180,20549,25274;25601,60590,0,0,2,0,2
79586,180,20550,25725,60590,0,0,1,0,1
79587,180,20552,25661;25944;28893;29068,60590,0,2,2,0,4
79588,180,20553,25352;26009,60590,0,0,2,0,2
79589,180,20554,25902;26155;28909;29082;29359;29643,60590,0,4,2,0,6
79590,180,20555,25960;26499,60590,0,0,2,0,2
79591,180,20556,26042,60590,0,0,1,0,1
79592,180,20557,26055;26236;28459;28917;29824;29904,60590,2,1,3,0,6
79593,180,20558,26039;26078,60590,0,0,2,0,2
79594,180,20559,26177;26214;29087;29188,60590,0,2,2,0,4
79595,180,20560,26202;26373,60590,0,0,2,0,2
79596,180,20562,26256;26824,60590,0,0,2,0,2
79597,180,20563,26019;26259;28553;29282,60590,0,1,3,0,4
79598,180,20564,26291;26344;29009;29377;29996,60590,1,2,2,0,5
79599,180,20565,26292;26346,60590,0,0,2,0,2
79600,180,20566,26297;26563;28934;29751;29916,60590,1,2,2,0,5
79601,180,20567,26311;26778;29403,60590,0,1,2,0,3
79602,180,20568,26320;26323;28922;29286;29376;29473,60590,0,4,2,0,6
79603,180,20569,26147;26371;29379,60590,0,1,2,0,3
79604,180,20570,26428;26440;29910,60590,1,0,2,0,3
79605,180,20571,26595;26625;29207,60590,0,1,2,0,3
79606,180,20572,26370;26558;29661;29750;30081,60590,1,2,2,0,5
79607,180,20574,26621;26935;29115;29592;29678,60590,0,3,2,0,5
79608,180,20575,26478;26626;29104;29209;30181,60590,1,2,2,0,5
79609,180,20576,26600;26631;29574,60590,0,1,2,0,3
79610,180,20577,26640;26748;29754;30085,60590,1,1,2,0,4
79611,180,20578,26647;27028,60590,0,0,2,0,2
79612,180,20579,26664;26870;29755,60590,0,1,2,0,3
79613,180,20580,26666;26967;29857,60590,1,0,2,0,3
79614,180,20581,26691;27214;29601;29953;30124;30208,60590,3,1,2,0,6
79615,180,20582,26698;27118,60590,0,0,2,0,2
79616,180,20583,26635;26700;29496,60590,0,1,2,0,3
79617,180,20584,26705;26818;29760;29848,60590,1,1,2,0,4
79618,180,20585,26894;30103,60590,1,0,1,0,2
79619,180,20586,26646;26758;30005;30091,60590,2,0,2,0,4
79620,180,20587,26800;26951;29117;30109,60590,1,1,2,0,4
79621,180,20588,26696;26820;28845;29307;29761;30187,60590,1,3,2,0,6
79622,180,20589,26720;26823;30096,60590,1,0,2,0,3
79623,180,20590,26661;26826,60590,0,0,2,0,2
79624,180,20591,26519;26853;29219;29501;29765;29937,60590,1,3,2,0,6
79625,180,20592,27084;29316;29780,60590,0,2,1,0,3
79626,180,20593,26716;26891;30014,60590,1,0,2,0,3
79627,180,20594,26657;26907;29410,60590,0,1,2,0,3
79628,180,20595,26947;27284;29595;29769,60590,0,2,2,0,4
79629,180,20596,26611;27001;29029;29860,60590,1,1,2,0,4
79630,180,20597,27004;27127;29227,60590,0,1,2,0,3
79631,180,20598,27009;27314,60590,0,0,2,0,2
79632,180,20599,22900,60955,0,0,0,1,1
79633,180,20600,22993,60955,0,0,0,1,1
79634,180,20601,23000,60955,0,0,0,1,1
79635,180,20602,22732,60955,0,0,0,1,1
79636,180,20603,23241;23247,60955,0,0,0,2,2
79637,180,20609,23421,60955,0,0,0,1,1
79638,180,20611,23651;23716,60955,0,0,0,2,2
79639,180,20612,23818;24025,60955,0,0,1,1,2
79640,180,20614,23484,60955,0,0,0,1,1
79641,180,20616,23522,60955,0,0,0,1,1
79642,180,20618,24163;24357,60955,0,0,2,0,2
79643,180,20619,23517;23650,60955,0,0,0,2,2
79644,180,20625,25101,60955,0,0,1,0,1
79645,180,20627,25030,60955,0,0,1,0,1
79646,180,20633,25138;25319;28407,60955,0,0,3,0,3
79647,180,20638,26379;29195,60955,0,1,1,0,2
79648,180,20641,26188;26317;29559,60955,0,1,2,0,3
79649,180,20642,26212;26393;29199,60955,0,1,2,0,3
79650,180,20643,25843,60955,0,0,1,0,1
79651,180,20645,26264;26465;30179,60955,1,0,2,0,3
79652,180,20646,26240;26336;29280;29465;29647,60955,0,3,2,0,5
79653,180,20647,26281;26304;28921;29192;29827,60955,1,2,2,0,5
79654,180,20648,26294;26388;29734,60955,0,1,2,0,3
79655,180,20650,26867;29408;29586,60955,0,2,1,0,3
79656,180,20651,26639;26914;29212;30182,60955,1,1,2,0,4
79657,180,20652,26552;26684;28933,60955,0,1,2,0,3
79658,180,20653,26580;27047,60955,0,0,2,0,2
79659,180,20654,26632;27027;29224,60955,0,1,2,0,3
79660,180,20655,26682;27071,60955,0,0,2,0,2
79661,180,20656,26693;26779,60955,0,0,2,0,2
79662,180,20657,26547;26699;29495;29844;29923;30003,60955,3,1,2,0,6
79663,180,20658,26419;26719;29020;29107;30090,60955,1,2,2,0,5
79664,180,20659,26273;26722;29400,60955,0,1,2,0,3
79665,180,20660,26742;28842;29928,60955,1,1,1,0,3
79666,180,20661,26739;27048,60955,0,0,2,0,2
79667,180,20662,26546;26766;29109,60955,0,1,2,0,3
79668,180,20663,26645;26770;28365;28753;29577;30086,60955,1,2,3,0,6
79669,180,20664,26797;26985,60955,0,0,2,0,2
79670,180,20665,26801;26966;29672,60955,0,1,2,0,3
79671,180,20666,26825;29849,60955,1,0,1,0,2
79672,180,20667,26704;26860;29309;29938;30099,60955,2,1,2,0,5
79673,180,20668,26876;29409;29941;30101;30188,60955,3,1,1,0,5
79674,180,20669,26884;27147,60955,0,0,2,0,2
79675,180,20670,26902;26928;29768,60955,0,1,2,0,3
79676,180,20671,26912;27316,60955,0,0,2,0,2
79677,180,20672,26381;26834;30097,60955,1,0,2,0,3
79678,180,20673,26471;26919;29590,60955,0,1,2,0,3
79679,180,20674,26638;26920;28463;29767,60955,0,1,3,0,4
79680,180,20675,26929;26957;30110,60955,1,0,2,0,3
79681,180,20676,26571;26945;30108;30190,60955,2,0,2,0,4
79682,180,20677,26583;26952;29413;29771;29856;29943,60955,2,2,2,0,6
79683,180,20678,27198;27435;29787,60955,0,1,2,0,3
79684,180,20679,26973;27185,60955,0,0,2,0,2
79685,180,20680,26977;27021;29315;29506;29946;30022,60955,2,2,2,0,6
79686,180,20681,26872;27068;29598,60955,0,1,2,0,3
79687,180,20682,26851;26871;29764;30013,60955,1,1,2,0,4
79688,180,20683,26605;26993;29945,60955,1,0,2,0,3
79689,180,20684,27000;27140;29122,60955,0,1,2,0,3
79690,180,20685,27024;27181,60955,0,0,2,0,2
79691,180,20686,26923;27029,60955,0,0,2,0,2
79692,180,20687,26879;27075,60955,0,0,2,0,2
79693,180,20688,27054;27213;30123,60955,1,0,2,0,3
79694,180,20689,27281;29421;29958,60955,1,1,1,0,3
79695,180,20690,26712;26858;29399,60955,0,1,2,0,3
79696,180,20691,26864;27090;29781;30114,60955,1,1,2,0,4
79697,180,20692,26649;27103;30115,60955,1,0,2,0,3
79698,180,20693,27318,60955,0,0,1,0,1
79699,180,20694,23127,61320,0,0,0,1,1
79700,180,20695,23181,61320,0,0,0,1,1
79701,180,20696,23289,61320,0,0,0,1,1
79702,180,20697,23222;23291,61320,0,0,0,2,2
79703,180,20698,23144,61320,0,0,0,1,1
79704,180,20700,23157,61320,0,0,0,1,1
79705,180,20702,23485;23768,61320,0,0,0,2,2
79706,180,20705,24014,61320,0,0,1,0,1
79707,180,20713,24134,61320,0,0,1,0,1
79708,180,20719,24792;24822;28103,61320,0,0,3,0,3
79709,180,20725,25194;25385,61320,0,0,2,0,2
79710,180,20726,24942;24987,61320,0,0,2,0,2
79711,180,20727,25300;25743;28884,61320,0,1,2,0,3
79712,180,20730,25595;25791,61320,0,0,2,0,2
79713,180,20731,25608;25800;28449;28723;28886;28982,61320,0,3,3,0,6
79714,180,20733,25919;26033;28816;28900;29171,61320,0,3,2,0,5
79715,180,20734,25851;26356;29476,61320,0,1,2,0,3
79716,180,20735,25929;26110;28812;29541,61320,0,2,2,0,4
79717,180,20736,25502,61320,0,0,1,0,1
79718,180,20737,25628;26036;29545,61320,0,1,2,0,3
79719,180,20740,25871;26157;29275,61320,0,1,2,0,3
79720,180,20741,26582,61320,0,0,1,0,1
79721,180,20742,26305;26978,61320,0,0,2,0,2
79722,180,20743,26822;30009,61320,1,0,1,0,2
79723,180,20744,26299,61320,0,0,1,0,1
79724,180,20745,26171;26479;28928;29565,61320,0,2,2,0,4
79725,180,20746,26190;26536;29570;29915;30080,61320,2,1,2,0,5
79726,180,20747,26423;26620;29575;29837;30083,61320,2,1,2,0,5
79727,180,20748,26523,61320,0,0,1,0,1
79728,180,20749,27109;29862;30116,61320,2,0,1,0,3
79729,180,20751,26416;26746;28938;29929,61320,1,1,2,0,4
79730,180,20752,27122;27319;29422;30043,61320,1,1,2,0,4
79731,180,20753,26557;26803,61320,0,0,2,0,2
79732,180,20754,26517;26584,61320,0,0,2,0,2
79733,180,20755,26614;26725;29582,61320,0,1,2,0,3
79734,180,20758,26578;26673;29492;29756,61320,0,2,2,0,4
79735,180,20759,26726;26933;29854,61320,1,0,2,0,3
79736,180,20760,26737;26885;29113,61320,0,1,2,0,3
79737,180,20761,26759;27066;29021;29670,61320,0,2,2,0,4
79738,180,20762,26756,61320,0,0,1,0,1
79739,180,20763,26906;27255;29034;29603,61320,0,2,2,0,4
79740,180,20764,26931;29028;29503;29677,61320,0,3,1,0,4
79741,180,20765,26959;27272;29871,61320,1,0,2,0,3
79742,180,20766,26908;26988;28671;29313;29859,61320,1,1,3,0,5
79743,180,20767,27015;27310;29695,61320,0,1,2,0,3
79744,180,20768,26676;27039;29507;30111;30197,61320,2,1,2,0,5
79745,180,20769,27142;27374,61320,0,0,2,0,2
79746,180,20770,27139;30026,61320,1,0,1,0,2
79747,180,20771,27081;27415,61320,0,0,2,0,2
79748,180,20772,26413;27098;29030;29416,61320,0,2,2,0,4
79749,180,20773,27105;27468,61320,0,0,2,0,2
79750,180,20774,27102;27119;29317,61320,0,1,2,0,3
79751,180,20775,27129;29417,61320,0,1,1,0,2
79752,180,20776,27074;27328;30219,61320,1,0,2,0,3
79753,180,20777,27145,61320,0,0,1,0,1
79754,180,20778,27160;27729;30059,61320,1,0,2,0,3
79755,180,20779,27149;29865;30118;30203,61320,3,0,1,0,4
79756,180,20781,27173;27580;29524,61320,0,1,2,0,3
79757,180,20782,26905;27191;29868,61320,1,0,2,0,3
79758,180,20783,27192;29125;29786;29869;29951,61320,2,2,1,0,5
79759,180,20784,27233;29789;30210,61320,1,1,1,0,3
79760,180,20785,27234;27438;29426;29968,61320,1,1,2,0,4
79761,180,20786,23295,61685,0,0,0,1,1
79762,180,20787,23336,61685,0,0,0,1,1
79763,180,20788,23430;23460,61685,0,0,0,2,2
79764,180,20790,23211;23371,61685,0,0,0,2,2
79765,180,20794,23873;24188,61685,0,0,2,0,2
79766,180,20795,23357,61685,0,0,0,1,1
79767,180,20796,23848;23957,61685,0,0,1,1,2
79768,180,20797,23956;24018,61685,0,0,2,0,2
79769,180,20799,24055,61685,0,0,1,0,1
79770,180,20801,24331;24678,61685,0,0,2,0,2
79771,180,20805,24579;28378,61685,0,0,2,0,2
79772,180,20807,24529,61685,0,0,1,0,1
79773,180,20810,24801,61685,0,0,1,0,1
79774,180,20817,25171;25548;28788;28872,61685,0,2,2,0,4
79775,180,20819,25357,61685,0,0,1,0,1
79776,180,20823,25281;25698;28345;28442;28527;28631,61685,0,0,6,0,6
79777,180,20825,25676;26058;29172;29547;29633,61685,0,3,2,0,5
79778,180,20826,25976;28993,61685,0,1,1,0,2
79779,180,20827,25783;25815;28531,61685,0,0,3,0,3
79780,180,20829,25657,61685,0,0,1,0,1
79781,180,20831,26184;26354;29010,61685,0,1,2,0,3
79782,180,20833,26538;28561,61685,0,0,2,0,2
79783,180,20834,26280;26587;29016;29662;30001,61685,1,2,2,0,5
79784,180,20835,26224;26293;28829;28920;29007;29091;29648,61685,0,5,2,0,7
79785,180,20836,26717;28840;29215,61685,0,2,1,0,3
79786,180,20837,26457;26721,61685,0,0,2,0,2
79787,180,20838,27257;27444,61685,0,0,2,0,2
79788,180,20839,26564;26798,61685,0,0,2,0,2
79789,180,20840,26566;26831;29674;30010,61685,1,1,2,0,4
79790,180,20841,26466;26567;30180,61685,1,0,2,0,3
79791,180,20842,26327;26588;28172;29391,61685,0,1,3,0,4
79792,180,20843,26541;26653,61685,0,0,2,0,2
79793,180,20844,26832,61685,0,0,1,0,1
79794,180,20845,26308,61685,0,0,1,0,1
79795,180,20846,26729,61685,0,0,1,0,1
79796,180,20847,26701;26745;29924,61685,1,0,2,0,3
79797,180,20848,26751;26900;29852,61685,1,0,2,0,3
79798,180,20849,26806;27186;30207,61685,1,0,2,0,3
79799,180,20850,26816;26984;29858,61685,1,0,2,0,3
79800,180,20851,26836;27023;30011,61685,1,0,2,0,3
79801,180,20852,26839;27280;30042,61685,1,0,2,0,3
79802,180,20853,26840;27156;29690,61685,0,1,2,0,3
79803,180,20855,26589;26677,61685,0,0,2,0,2
79804,180,20856,27169;27269,61685,0,0,2,0,2
79805,180,20857,26925;27289,61685,0,0,2,0,2
79806,180,20858,26946;27030;29415,61685,0,1,2,0,3
79807,180,20859,26953;27195;29320;29952;30033;30122,61685,3,1,2,0,6
79808,180,20860,26998;27330,61685,0,0,2,0,2
79809,180,20861,26543;27022;28846;29119;29776;30195,61685,1,3,2,0,6
79810,180,20862,26918;27038,61685,0,0,2,0,2
79811,180,20863,27045;27215;29229;30035;30209,61685,2,1,2,0,5
79812,180,20864,26974;27179;29228;30031,61685,1,1,2,0,4
79813,180,20865,27055;27082;29508;29861,61685,1,1,2,0,4
79814,180,20866,26757;27061,61685,0,0,2,0,2
79815,180,20867,27083;27120;28848;29779;30024;30113;30199,61685,3,2,2,0,7
79816,180,20868,26940;27087;30200,61685,1,0,2,0,3
79817,180,20869,27093,61685,0,0,1,0,1
79818,180,20870,26895;27108;29782,61685,0,1,2,0,3
79819,180,20871,26882;27165;29950;30121,61685,2,0,2,0,4
79820,180,20872,27183;27296;29511,61685,0,1,2,0,3
79821,180,20873,26956;27221;29513;30037,61685,1,1,2,0,4
79822,180,20874,27616;29325;29703,61685,0,2,1,0,3
79823,180,20875,27279;27286;29957,61685,1,0,2,0,3
79824,180,20876,27436,61685,0,0,1,0,1
79825,180,20877,27012;27294,61685,0,0,2,0,2
79826,180,20878,27299;27340;29606,61685,0,1,2,0,3
79827,180,20879,27302;27482,61685,0,0,2,0,2
79828,180,20880,27123;27562;29799;29882;30234,61685,2,1,2,0,5
79829,180,20881,26551,61685,0,0,1,0,1
79830,180,20882,23229,62050,0,0,0,1,1
79831,180,20884,23399,62050,0,0,0,1,1
79832,180,20886,23397,62050,0,0,0,1,1
79833,180,20889,23620;23906,62050,0,0,1,1,2
79834,180,20892,23655;23896,62050,0,0,1,1,2
79835,180,20897,24403,62050,0,0,1,0,1
79836,180,20899,24415;24473,62050,0,0,2,0,2
79837,180,20908,24845;24912,62050,0,0,2,0,2
79838,180,20911,24991,62050,0,0,1,0,1
79839,180,20913,25279,62050,0,0,1,0,1
79840,180,20916,25874;26050;28264;28901;29075,62050,0,2,3,0,5
79841,180,20917,25704,62050,0,0,1,0,1
79842,180,20920,26181;29184;29361,62050,0,2,1,0,3
79843,180,20922,26135;26425,62050,0,0,2,0,2
79844,180,20923,26271;26515,62050,0,0,2,0,2
79845,180,20924,26288;26618;29393;29918,62050,1,1,2,0,4
79846,180,20926,26343;26487;28929;29098;29659,62050,0,3,2,0,5
79847,180,20927,26406;26598;29663,62050,0,1,2,0,3
79848,180,20929,26562;26911,62050,0,0,2,0,2
79849,180,20930,25988;26568;28752;28837;28935;29204;29390,62050,0,5,2,0,7
79850,180,20931,26501;26581;29206;29572,62050,0,2,2,0,4
79851,180,20933,26606;26671;29491,62050,0,1,2,0,3
79852,180,20934,26586;26608,62050,0,0,2,0,2
79853,180,20935,26550;26874;29111,62050,0,1,2,0,3
79854,180,20936,26651;26847;29395,62050,0,1,2,0,3
79855,180,20937,26339;26709;29214,62050,0,1,2,0,3
79856,180,20938,26744,62050,0,0,1,0,1
79857,180,20939,26781;27152,62050,0,0,2,0,2
79858,180,20940,27124;29226;29318;29863,62050,1,2,1,0,4
79859,180,20941,26830,62050,0,0,1,0,1
79860,180,20942,26846,62050,0,0,1,0,1
79861,180,20943,26856,62050,0,0,1,0,1
79862,180,20944,26496;26881;29587,62050,0,1,2,0,3
79863,180,20945,26883,62050,0,0,1,0,1
79864,180,20946,27107,62050,0,0,1,0,1
79865,180,20947,26938;27164;29123;30028;30120,62050,2,1,2,0,5
79866,180,20948,26955;27230;30038,62050,1,0,2,0,3
79867,180,20949,27232;30039,62050,1,0,1,0,2
79868,180,20950,26971;27043;29682;30023,62050,1,1,2,0,4
79869,180,20951,27057;27537;29521,62050,0,1,2,0,3
79870,180,20952,27065;27252;30128;30213,62050,2,0,2,0,4
79871,180,20953,27096;27184;30032,62050,1,0,2,0,3
79872,180,20954,26892;27130,62050,0,0,2,0,2
79873,180,20955,26964;27151,62050,0,0,2,0,2
79874,180,20956,27238;27437;30230,62050,1,0,2,0,3
79875,180,20957,27244;27605,62050,0,0,2,0,2
79876,180,20958,27251;27409;29519,62050,0,1,2,0,3
79877,180,20959,27258;27306,62050,0,0,2,0,2
79878,180,20960,27592,62050,0,0,1,0,1
79879,180,20961,27058;27652,62050,0,0,2,0,2
79880,180,20962,26962;27329,62050,0,0,2,0,2
79881,180,20963,27344;27527,62050,0,0,2,0,2
79882,180,20964,27116;27345;29121,62050,0,1,2,0,3
79883,180,20965,27355;27872,62050,0,0,2,0,2
79884,180,20966,27358,62050,0,0,1,0,1
79885,180,20967,27360;27366;30044,62050,1,0,2,0,3
79886,180,20968,27373;27720;30239,62050,1,0,2,0,3
79887,180,20969,27380;27676,62050,0,0,2,0,2
79888,180,20970,27383,62050,0,0,1,0,1
79889,180,20971,27110;27388;29518;30136,62050,1,1,2,0,4
79890,180,20972,27494;27733,62050,0,0,2,0,2
79891,180,20973,27394;27554;29523,62050,0,1,2,0,3
79892,180,20974,27414;27575;30147,62050,1,0,2,0,3
79893,180,20976,23463,62415,0,0,0,1,1
79894,180,20977,23903,62415,0,0,1,0,1
79895,180,20978,23429,62415,0,0,0,1,1
79896,180,20979,23658;23730,62415,0,0,0,2,2
79897,180,20982,24176,62415,0,0,1,0,1
79898,180,20983,24070,62415,0,0,1,0,1
79899,180,20984,24141;24484,62415,0,0,2,0,2
79900,180,20986,23633;24253,62415,0,0,1,1,2
79901,180,20987,24024,62415,0,0,1,0,1
79902,180,20988,24372,62415,0,0,1,0,1
79903,180,20989,24565,62415,0,0,1,0,1
79904,180,20993,25122,62415,0,0,1,0,1
79905,180,20994,24779,62415,0,0,1,0,1
79906,180,20997,24871;25285,62415,0,0,2,0,2
79907,180,21000,25426,62415,0,0,1,0,1
79908,180,21001,25659;25799,62415,0,0,2,0,2
79909,180,21005,26175;26516,62415,0,0,2,0,2
79910,180,21008,26021;26302;28747;30174,62415,1,1,2,0,4
79911,180,21009,25927;26397;29200;29563,62415,0,2,2,0,4
79912,180,21010,26072;26494;29387,62415,0,1,2,0,3
79913,180,21011,26129;26609;29665,62415,0,1,2,0,3
79914,180,21012,26187;26431;29479;29741;30177,62415,1,2,2,0,5
79915,180,21013,26341;26437;29833,62415,1,0,2,0,3
79916,180,21014,26351;26738;29927;30185,62415,2,0,2,0,4
79917,180,21015,26387;29198,62415,0,1,1,0,2
79918,180,21017,26216;26505,62415,0,0,2,0,2
79919,180,21018,26629;26855,62415,0,0,2,0,2
79920,180,21019,26740;27168,62415,0,0,2,0,2
79921,180,21020,26408;26752;29498;29930,62415,1,1,2,0,4
79922,180,21021,26764;27003,62415,0,0,2,0,2
79923,180,21022,27114;29031;29509;29683;30202,62415,1,3,1,0,5
79924,180,21023,26730;29402;30184,62415,1,1,1,0,3
79925,180,21024,26660;26859,62415,0,0,2,0,2
79926,180,21025,26692;26939;29593,62415,0,1,2,0,3
79927,180,21026,26995;27180;29319,62415,0,1,2,0,3
79928,180,21028,26592;27006;29414;30193,62415,1,1,2,0,4
79929,180,21029,27378;29322;29608;29874;29966,62415,2,2,1,0,5
79930,180,21030,27020;27274;29605;29791,62415,0,2,2,0,4
79931,180,21031,26616,62415,0,0,1,0,1
79932,180,21032,27073;27428,62415,0,0,2,0,2
79933,180,21033,26992;27295;30217,62415,1,0,2,0,3
79934,180,21034,27035;27171;28847,62415,0,1,2,0,3
79935,180,21035,27291;30130,62415,1,0,1,0,2
79936,180,21036,27209;27612;30055;30151,62415,2,0,2,0,4
79937,180,21037,26991;27224;29230;29955,62415,1,1,2,0,4
79938,180,21038,27189;27241;29126;29420,62415,0,2,2,0,4
79939,180,21039,27263;27449,62415,0,0,2,0,2
79940,180,21040,27273;27524;29700,62415,0,1,2,0,3
79941,180,21041,27262;27287;29604;29956,62415,1,1,2,0,4
79942,180,21042,27076;27202;30034,62415,1,0,2,0,3
79943,180,21043,27307;27361;29607,62415,0,1,2,0,3
79944,180,21044,27354;27417;30227,62415,1,0,2,0,3
79945,180,21045,27422;27777;29889,62415,1,0,2,0,3
79946,180,21046,27313;27434;29425,62415,0,1,2,0,3
79947,180,21047,27503;29520,62415,0,1,1,0,2
79948,180,21048,27016;27532,62415,0,0,2,0,2
79949,180,21049,27553;27618,62415,0,0,2,0,2
79950,180,21050,27072;27555,62415,0,0,2,0,2
79951,180,21051,27556;27599;29702;29884;30150,62415,2,1,2,0,5
79952,180,21054,23272,62780,0,0,0,1,1
79953,180,21056,23674,62780,0,0,0,1,1
79954,180,21057,23557,62780,0,0,0,1,1
79955,180,21058,23849;23892,62780,0,0,1,1,2
79956,180,21060,24056,62780,0,0,1,0,1
79957,180,21061,23879;24048,62780,0,0,2,0,2
79958,180,21066,24267,62780,0,0,1,0,1
79959,180,21068,24734,62780,0,0,1,0,1
79960,180,21072,25069,62780,0,0,1,0,1
79961,180,21080,25245,62780,0,0,1,0,1
79962,180,21081,25394;25778;28720,62780,0,1,2,0,3
79963,180,21082,25307,62780,0,0,1,0,1
79964,180,21084,25872,62780,0,0,1,0,1
79965,180,21086,25604,62780,0,0,1,0,1
79966,180,21087,25702,62780,0,0,1,0,1
79967,180,21090,25487;25925;28729;28989,62780,0,2,2,0,4
79968,180,21091,25842;26091;29271,62780,0,1,2,0,3
79969,180,21092,26196;26484;29383,62780,0,1,2,0,3
79970,180,21093,26098;26448;30077,62780,1,0,2,0,3
79971,180,21094,25821,62780,0,0,1,0,1
79972,180,21095,26258;26303;29092;29558,62780,0,2,2,0,4
79973,180,21096,26307;27008;29314;30194,62780,1,1,2,0,4
79974,180,21097,26315;26331;29651,62780,0,1,2,0,3
79975,180,21100,26643;26922;29412;30017,62780,1,1,2,0,4
79976,180,21101,26559;26695,62780,0,0,2,0,2
79977,180,21102,26736;26844;28940,62780,0,1,2,0,3
79978,180,21103,26773;27182,62780,0,0,2,0,2
79979,180,21104,26782;27079,62780,0,0,2,0,2
79980,180,21105,26815,62780,0,0,1,0,1
79981,180,21106,26827;27188,62780,0,0,2,0,2
79982,180,21107,26549;26950;29855,62780,1,0,2,0,3
79983,180,21108,26890;29851,62780,1,0,1,0,2
79984,180,21109,26674;26921;29411;30106,62780,1,1,2,0,4
79985,180,21111,27034,62780,0,0,1,0,1
79986,180,21112,26961;27271,62780,0,0,2,0,2
79987,180,21113,27457,62780,0,0,1,0,1
79988,180,21114,26802;27178;29124;29691;30030,62780,1,2,2,0,5
79989,180,21115,26965;27486,62780,0,0,2,0,2
79990,180,21116,27246;27924,62780,0,0,2,0,2
79991,180,21117,27253;27404;29602,62780,0,1,2,0,3
79992,180,21118,27687;27701;29802,62780,0,1,2,0,3
79993,180,21120,27113;27268,62780,0,0,2,0,2
79994,180,21121,27270;27738,62780,0,0,2,0,2
79995,180,21122,27290;27400;30223,62780,1,0,2,0,3
79996,180,21123,27292;27640;29886,62780,1,0,2,0,3
79997,180,21124,27010;27301;29872,62780,1,0,2,0,3
79998,180,21125,27304;27633,62780,0,0,2,0,2
79999,180,21126,27305;27664,62780,0,0,2,0,2
80000,180,21127,27249;27324;29960,62780,1,0,2,0,3
80001,180,21128,27326;27845,62780,0,0,2,0,2
80002,180,21129,27327;27500;29970,62780,1,0,2,0,3
80003,180,21130,27331;27927,62780,0,0,2,0,2
80004,180,21131,27138;27339;30220,62780,1,0,2,0,3
80005,180,21132,27337;27347;29516,62780,0,1,2,0,3
80006,180,21134,27385,62780,0,0,1,0,1
80007,180,21135,27115;27386;29875,62780,1,0,2,0,3
80008,180,21136,27056;27427;29796,62780,0,1,2,0,3
80009,180,21137,27431;27520;30139;30228,62780,2,0,2,0,4
80010,180,21138,27447;27499;29427;29876,62780,1,1,2,0,4
80011,180,21140,27350;27458,62780,0,0,2,0,2
80012,180,21141,27419;27462;29428;30052;30232,62780,2,1,2,0,5
80013,180,21142,27478;27765,62780,0,0,2,0,2
80014,180,21143,27389;27459;29035,62780,0,1,2,0,3
80015,180,21144,27551;27695,62780,0,0,2,0,2
80016,180,21145,27559;27749,62780,0,0,2,0,2
80017,180,21146,27317;27563;29971;30146,62780,2,0,2,0,4
80018,180,21147,27587;27764,62780,0,0,2,0,2
80019,180,21148,27815;27864,62780,0,0,2,0,2
80020,180,21149,27712,62780,0,0,1,0,1
80021,180,21150,27111;27647;30152,62780,1,0,2,0,3
80022,180,21151,27651;27686;29326;30056,62780,1,1,2,0,4
80023,180,21152,23362,63145,0,0,0,1,1
80024,180,21153,23545,63145,0,0,0,1,1
80025,180,21154,23692;23717,63145,0,0,0,2,2
80026,180,21156,23652,63145,0,0,0,1,1
80027,180,21157,23778,63145,0,0,0,1,1
80028,180,21159,24326;24714,63145,0,0,2,0,2
80029,180,21160,24402;24518,63145,0,0,2,0,2
80030,180,21168,24846,63145,0,0,1,0,1
80031,180,21169,25081,63145,0,0,1,0,1
80032,180,21171,25321,63145,0,0,1,0,1
80033,180,21172,25097,63145,0,0,1,0,1
80034,180,21176,25238,63145,0,0,1,0,1
80035,180,21179,25771,63145,0,0,1,0,1
80036,180,21185,25961,63145,0,0,1,0,1
80037,180,21187,25530;25996;29073,63145,0,1,2,0,3
80038,180,21188,26038,63145,0,0,1,0,1
80039,180,21190,26164,63145,0,0,1,0,1
80040,180,21191,26223;26488;29385,63145,0,1,2,0,3
80041,180,21193,26246;26461,63145,0,0,2,0,2
80042,180,21195,26619;26668,63145,0,0,2,0,2
80043,180,21197,26769;26943;29594;29680,63145,0,2,2,0,4
80044,180,21198,26734;26976;29774;29944;30019,63145,2,1,2,0,5
80045,180,21199,26893;29114;29220;30015;30189,63145,2,2,1,0,5
80046,180,21200,26904;27153;29032;29688;29866,63145,1,2,2,0,5
80047,180,21201,26775;26937;29116;29504;29679,63145,0,3,2,0,5
80048,180,21202,26941;27150,63145,0,0,2,0,2
80049,180,21203,27026;27031,63145,0,0,2,0,2
80050,180,21204,27033;27041;29777,63145,0,1,2,0,3
80051,180,21205,27092;29120;30025,63145,1,1,1,0,3
80052,180,21206,27097,63145,0,0,1,0,1
80053,180,21207,27104;27239;30126,63145,1,0,2,0,3
80054,180,21208,27126;27476,63145,0,0,2,0,2
80055,180,21209,27128;29684,63145,0,1,1,0,2
80056,180,21210,27141,63145,0,0,1,0,1
80057,180,21211,27225,63145,0,0,1,0,1
80058,180,21212,27237;27593;29801,63145,0,1,2,0,3
80059,180,21213,27260;27602,63145,0,0,2,0,2
80060,180,21214,27172;27285,63145,0,0,2,0,2
80061,180,21215,27320;27889;30062,63145,1,0,2,0,3
80062,180,21216,27197;27322;29792,63145,0,1,2,0,3
80063,180,21217,27357;27694;29614,63145,0,1,2,0,3
80064,180,21218,27044;27492,63145,0,0,2,0,2
80065,180,21219,27416;27734,63145,0,0,2,0,2
80066,180,21220,27418;27584;30235,63145,1,0,2,0,3
80067,180,21221,27441;27547,63145,0,0,2,0,2
80068,180,21222,27479;27549,63145,0,0,2,0,2
80069,180,21223,27487;27690,63145,0,0,2,0,2
80070,180,21224,27497,63145,0,0,1,0,1
80071,180,21225,27797;27880;30060,63145,1,0,2,0,3
80072,180,21226,27199;27502;29699;30233,63145,1,1,2,0,4
80073,180,21227,27053;27377;29965,63145,1,0,2,0,3
80074,180,21228,27025;27511,63145,0,0,2,0,2
80075,180,21229,27831,63145,0,0,1,0,1
80076,180,21230,27578;27985,63145,0,0,2,0,2
80077,180,21231,27582,63145,0,0,1,0,1
80078,180,21232,27590;27958;30158,63145,1,0,2,0,3
80079,180,21233,27603,63145,0,0,1,0,1
80080,180,21234,27606;27766,63145,0,0,2,0,2
80081,180,21235,27644;27799,63145,0,0,2,0,2
80082,180,21236,27656;28010,63145,0,0,2,0,2
80083,180,21237,27698;27837;30057,63145,1,0,2,0,3
80084,180,21238,27543;27700,63145,0,0,2,0,2
80085,180,21239,27702;29973,63145,1,0,1,0,2
80086,180,21240,27714,63145,0,0,1,0,1
80087,180,21241,27288;27724,63145,0,0,2,0,2
80088,180,21242,27645;27739,63145,0,0,2,0,2
80089,180,21243,27650;27747,63145,0,0,2,0,2
80090,180,21244,27560;27748;29616,63145,0,1,2,0,3
80091,180,21245,27752;27805,63145,0,0,2,0,2
80092,180,21246,27678;27758,63145,0,0,2,0,2
80093,180,21247,23420;23942,63510,0,0,1,1,2
80094,180,21248,23507,63510,0,0,0,1,1
80095,180,21252,24139,63510,0,0,1,0,1
80096,180,21253,24355,63510,0,0,1,0,1
80097,180,21257,24413;24621;28200;28284,63510,0,0,4,0,4
80098,180,21258,24675,63510,0,0,1,0,1
80099,180,21259,24588,63510,0,0,1,0,1
80100,180,21260,24247,63510,0,0,1,0,1
80101,180,21262,24353;24438,63510,0,0,2,0,2
80102,180,21264,24720,63510,0,0,1,0,1
80103,180,21265,24915,63510,0,0,1,0,1
80104,180,21266,24881,63510,0,0,1,0,1
80105,180,21268,25053,63510,0,0,1,0,1
80106,180,21270,25256,63510,0,0,1,0,1
80107,180,21272,25293,63510,0,0,1,0,1
80108,180,21273,25564,63510,0,0,1,0,1
80109,180,21274,25715,63510,0,0,1,0,1
80110,180,21276,25345,63510,0,0,1,0,1
80111,180,21277,26053;26335,63510,0,0,2,0,2
80112,180,21279,26044,63510,0,0,1,0,1
80113,180,21281,26232,63510,0,0,1,0,1
80114,180,21282,26477,63510,0,0,1,0,1
80115,180,21285,26424;26889;29026;29676,63510,0,2,2,0,4
80116,180,21287,26576;26617;29304;29917,63510,1,1,2,0,4
80117,180,21288,26447;26794;30094,63510,1,0,2,0,3
80118,180,21290,26934;27078,63510,0,0,2,0,2
80119,180,21291,26807,63510,0,0,1,0,1
80120,180,21292,26997;27259;30041;30214,63510,2,0,2,0,4
80121,180,21293,26999;27335,63510,0,0,2,0,2
80122,180,21294,27052;27315;29696;29959;30218,63510,2,1,2,0,5
80123,180,21295,27060;27550,63510,0,0,2,0,2
80124,180,21296,26987,63510,0,0,1,0,1
80125,180,21297,27371;27472;29797,63510,0,1,2,0,3
80126,180,21298,27117;27245;29514;30212,63510,1,1,2,0,4
80127,180,21299,27013,63510,0,0,1,0,1
80128,180,21300,27158;27655;29431,63510,0,1,2,0,3
80129,180,21301,27680,63510,0,0,1,0,1
80130,180,21303,26970;27338,63510,0,0,2,0,2
80131,180,21304,27382;27614;29613,63510,0,1,2,0,3
80132,180,21305,27406;27621,63510,0,0,2,0,2
80133,180,21306,27424,63510,0,0,1,0,1
80134,180,21307,27452;28003;30247,63510,1,0,2,0,3
80135,180,21308,27261;27470;29321;30129,63510,1,1,2,0,4
80136,180,21309,27398;27483;29424;29967,63510,1,1,2,0,4
80137,180,21310,27493;27772;29888,63510,1,0,2,0,3
80138,180,21311,27496,63510,0,0,1,0,1
80139,180,21312,27121;27523,63510,0,0,2,0,2
80140,180,21313,27526;28022;30160,63510,1,0,2,0,3
80141,180,21314,27591;27667,63510,0,0,2,0,2
80142,180,21315,27297;27594;30149,63510,1,0,2,0,3
80143,180,21316,27895;29711,63510,0,1,1,0,2
80144,180,21317,27607;27838,63510,0,0,2,0,2
80145,180,21318,27696,63510,0,0,1,0,1
80146,180,21319,27671;27867,63510,0,0,2,0,2
80147,180,21320,28061,63510,0,0,1,0,1
80148,180,21321,27699;27978,63510,0,0,2,0,2
80149,180,21322,27718;27762,63510,0,0,2,0,2
80150,180,21323,27619;27721;29803,63510,0,1,2,0,3
80151,180,21324,27728;27839,63510,0,0,2,0,2
80152,180,21325,27794;27841,63510,0,0,2,0,2
80153,180,21326,27842;28134,63510,0,0,2,0,2
80154,180,21327,27276;27812,63510,0,0,2,0,2
80155,180,21328,27791;27824,63510,0,0,2,0,2
80156,180,21329,27392;27832;30242,63510,1,0,2,0,3
80157,180,21330,27795;27840;29528,63510,0,1,2,0,3
80158,180,21331,23253,63875,0,0,0,1,1
80159,180,21333,23786;24195,63875,0,0,1,1,2
80160,180,21334,23830,63875,0,0,0,1,1
80161,180,21335,23829,63875,0,0,0,1,1
80162,180,21336,23871,63875,0,0,1,0,1
80163,180,21337,24233,63875,0,0,1,0,1
80164,180,21338,24236,63875,0,0,1,0,1
80165,180,21339,24259,63875,0,0,1,0,1
80166,180,21341,24483,63875,0,0,1,0,1
80167,180,21345,24992,63875,0,0,1,0,1
80168,180,21346,24838,63875,0,0,1,0,1
80169,180,21347,24738,63875,0,0,1,0,1
80170,180,21348,25109,63875,0,0,1,0,1
80171,180,21350,24959,63875,0,0,1,0,1
80172,180,21352,24750,63875,0,0,1,0,1
80173,180,21353,25116,63875,0,0,1,0,1
80174,180,21354,25107,63875,0,0,1,0,1
80175,180,21355,25264,63875,0,0,1,0,1
80176,180,21360,25627,63875,0,0,1,0,1
80177,180,21361,25578,63875,0,0,1,0,1
80178,180,21362,26029,63875,0,0,1,0,1
80179,180,21364,26168;26623;29753,63875,0,1,2,0,3
80180,180,21365,26333;26899;30016,63875,1,0,2,0,3
80181,180,21366,26445;26506;29099,63875,0,1,2,0,3
80182,180,21367,26540,63875,0,0,1,0,1
80183,180,21368,26265;26724;29108;29759,63875,0,2,2,0,4
80184,180,21369,26642;26954;29222;29505;29772,63875,0,3,2,0,5
80185,180,21370,26405;26703;29213;29306,63875,0,2,2,0,4
80186,180,21371,26784,63875,0,0,1,0,1
80187,180,21373,26863;27200,63875,0,0,2,0,2
80188,180,21374,26733;26786;29932,63875,1,0,2,0,3
80189,180,21375,26877,63875,0,0,1,0,1
80190,180,21376,26525;26960;29773,63875,0,1,2,0,3
80191,180,21377,26968;27227;28755,63875,0,1,2,0,3
80192,180,21379,27049,63875,0,0,1,0,1
80193,180,21380,27063;29778,63875,0,1,1,0,2
80194,180,21381,27089;27248;29515;29693;30127,63875,1,2,2,0,5
80195,180,21382,27133,63875,0,0,1,0,1
80196,180,21383,27146;27518;29600;29948;30117,63875,2,1,2,0,5
80197,180,21384,27205;27275;30215,63875,1,0,2,0,3
80198,180,21385,27094;27216;29033;29954;30036;30125,63875,3,1,2,0,6
80199,180,21386,27228;27333;29423;29793;30133,63875,1,2,2,0,5
80200,180,21387,27353;27746,63875,0,0,2,0,2
80201,180,21388,27375;27448;29877,63875,1,0,2,0,3
80202,180,21389,27401;27429;30047,63875,1,0,2,0,3
80203,180,21390,27410;27558;30054,63875,1,0,2,0,3
80204,180,21391,27426;27937;30157,63875,1,0,2,0,3
80205,180,21392,27454;27683,63875,0,0,2,0,2
80206,180,21393,27222;27455,63875,0,0,2,0,2
80207,180,21394,27460;27636;29232;29704,63875,0,2,2,0,4
80208,180,21395,27461;27803,63875,0,0,2,0,2
80209,180,21396,27465;27608,63875,0,0,2,0,2
80210,180,21397,27569;29324,63875,0,1,1,0,2
80211,180,21398,27504;27901;29978,63875,1,0,2,0,3
80212,180,21399,27413;27507;29795;30226,63875,1,1,2,0,4
80213,180,21400,27509;29610,63875,0,1,1,0,2
80214,180,21401,27533;27689,63875,0,0,2,0,2
80215,180,21402,27534,63875,0,0,1,0,1
80216,180,21403,27574;28006;30248,63875,1,0,2,0,3
80217,180,21404,27596,63875,0,0,1,0,1
80218,180,21405,27624;28001,63875,0,0,2,0,2
80219,180,21406,27539;27627,63875,0,0,2,0,2
80220,180,21407,27643;28002,63875,0,0,2,0,2
80221,180,21408,27505,63875,0,0,1,0,1
80222,180,21409,27541;27648,63875,0,0,2,0,2
80223,180,21410,27963,63875,0,0,1,0,1
80224,180,21411,27710;29615;30058,63875,1,1,1,0,3
80225,180,21412,27451;27665;30153,63875,1,0,2,0,3
80226,180,21413,27737;28098;29712,63875,0,1,2,0,3
80227,180,21414,27757;28072;30250,63875,1,0,2,0,3
80228,180,21415,27759;27814,63875,0,0,2,0,2
80229,180,21416,27846;28256,63875,0,0,2,0,2
80230,180,21417,27798;27847,63875,0,0,2,0,2
80231,180,21418,27682;27848,63875,0,0,2,0,2
80232,180,21419,27855;28199;29985,63875,1,0,2,0,3
80233,180,21420,27882;28249,63875,0,0,2,0,2
80234,180,21421,27899;28232,63875,0,0,2,0,2
80235,180,21422,27884;27908,63875,0,0,2,0,2
80236,180,21423,27571;27918,63875,0,0,2,0,2
80237,180,21424,27930;28040,63875,0,0,2,0,2
80238,180,21425,27936;28260,63875,0,0,2,0,2
80239,180,21426,27938;28052,63875,0,0,2,0,2
80240,180,21427,27955;28400;30172,63875,1,0,2,0,3
80241,180,21428,27956;28105,63875,0,0,2,0,2
80242,180,21429,27961;28188,63875,0,0,2,0,2
80243,180,21431,24238,64240,0,0,1,0,1
80244,180,21433,24312,64240,0,0,1,0,1
80245,180,21434,24487,64240,0,0,1,0,1
80246,180,21435,24431,64240,0,0,1,0,1
80247,180,21436,24860,64240,0,0,1,0,1
80248,180,21437,24729,64240,0,0,1,0,1
80249,180,21438,24759,64240,0,0,1,0,1
80250,180,21439,24827,64240,0,0,1,0,1
80251,180,21441,24489,64240,0,0,1,0,1
80252,180,21442,25092,64240,0,0,1,0,1
80253,180,21445,25323,64240,0,0,1,0,1
80254,180,21448,25984,64240,0,0,1,0,1
80255,180,21449,26056,64240,0,0,1,0,1
80256,180,21450,26455,64240,0,0,1,0,1
80257,180,21451,26518,64240,0,0,1,0,1
80258,180,21453,26761;27125;29864,64240,1,0,2,0,3
80259,180,21454,26788;26789;30007,64240,1,0,2,0,3
80260,180,21455,26796;27174,64240,0,0,2,0,2
80261,180,21456,26804;26848;29763;29850;30012,64240,2,1,2,0,5
80262,180,21458,26944,64240,0,0,1,0,1
80263,180,21459,26672;26949,64240,0,0,2,0,2
80264,180,21460,27069;27407;30049,64240,1,0,2,0,3
80265,180,21461,27298,64240,0,0,1,0,1
80266,180,21462,27100;27372;29964;30045;30222,64240,3,0,2,0,5
80267,180,21463,27163;27709,64240,0,0,2,0,2
80268,180,21464,27219;27611,64240,0,0,2,0,2
80269,180,21465,26980;27235;29790,64240,0,1,2,0,3
80270,180,21466,26835;27351;29873,64240,1,0,2,0,3
80271,180,21467,27070;27395,64240,0,0,2,0,2
80272,180,21468,27439;27622;29885;29972,64240,2,0,2,0,4
80273,180,21470,27501;27760;29804,64240,0,1,2,0,3
80274,180,21471,27529;27970,64240,0,0,2,0,2
80275,180,21472,27544;27613,64240,0,0,2,0,2
80276,180,21473,27557;27810,64240,0,0,2,0,2
80277,180,21474,27595;28023;29981,64240,1,0,2,0,3
80278,180,21475,27598;27851,64240,0,0,2,0,2
80279,180,21476,27134;27604,64240,0,0,2,0,2
80280,180,21477,27229,64240,0,0,1,0,1
80281,180,21478,27256;27379;30046,64240,1,0,2,0,3
80282,180,21479,27703;28348;30170,64240,1,0,2,0,3
80283,180,21480,27713,64240,0,0,1,0,1
80284,180,21481,27243;27745,64240,0,0,2,0,2
80285,180,21482,27753;28191,64240,0,0,2,0,2
80286,180,21483,27767;28317,64240,0,0,2,0,2
80287,180,21484,27771;27868;29710,64240,0,1,2,0,3
80288,180,21485,27775;27979;30245,64240,1,0,2,0,3
80289,180,21486,28295,64240,0,0,1,0,1
80290,180,21487,27187;27796,64240,0,0,2,0,2
80291,180,21488,27811;27976,64240,0,0,2,0,2
80292,180,21489,27825;27863,64240,0,0,2,0,2
80293,180,21490,27615,64240,0,0,1,0,1
80294,180,21491,27754;27865,64240,0,0,2,0,2
80295,180,21492,27891;28110,64240,0,0,2,0,2
80296,180,21493,27919,64240,0,0,1,0,1
80297,180,21494,27823;27922,64240,0,0,2,0,2
80298,180,21495,27363;27931;29808;29892,64240,1,1,2,0,4
80299,180,21496,27935;28212,64240,0,0,2,0,2
80300,180,21497,27681;27941,64240,0,0,2,0,2
80301,180,21498,27959;28215,64240,0,0,2,0,2
80302,180,21499,27966;28291,64240,0,0,2,0,2
80303,180,21500,27900;27969;29433,64240,0,1,2,0,3
80304,180,21501,27988;28333,64240,0,0,2,0,2
80305,180,21502,28220,64240,0,0,1,0,1
80306,180,21503,28024;28164,64240,0,0,2,0,2
80307,180,21504,28033;28318,64240,0,0,2,0,2
80308,180,21505,28044;28178,64240,0,0,2,0,2
80309,180,21506,27672;27991,64240,0,0,2,0,2
80310,180,21507,24057,64605,0,0,1,0,1
80311,180,21509,23731,64605,0,0,0,1,1
80312,180,21511,24382,64605,0,0,1,0,1
80313,180,21512,24252,64605,0,0,1,0,1
80314,180,21514,24541,64605,0,0,1,0,1
80315,180,21515,24170,64605,0,0,1,0,1
80316,180,21517,24311,64605,0,0,1,0,1
80317,180,21519,24843,64605,0,0,1,0,1
80318,180,21520,24771,64605,0,0,1,0,1
80319,180,21521,25039,64605,0,0,1,0,1
80320,180,21522,24984,64605,0,0,1,0,1
80321,180,21523,25229,64605,0,0,1,0,1
80322,180,21524,24724,64605,0,0,1,0,1
80323,180,21526,25032;25144,64605,0,0,2,0,2
80324,180,21527,25713,64605,0,0,1,0,1
80325,180,21529,25923,64605,0,0,1,0,1
80326,180,21533,26253;29368,64605,0,1,1,0,2
80327,180,21534,26348,64605,0,0,1,0,1
80328,180,21535,26024;26359;28455;29170;29453;29630,64605,0,3,3,0,6
80329,180,21536,25917,64605,0,0,1,0,1
80330,180,21537,26298,64605,0,0,1,0,1
80331,180,21539,26277;26685,64605,0,0,2,0,2
80332,180,21540,26276;26654,64605,0,0,2,0,2
80333,180,21541,26555,64605,0,0,1,0,1
80334,180,21542,26599;26776,64605,0,0,2,0,2
80335,180,21543,26503,64605,0,0,1,0,1
80336,180,21544,26838,64605,0,0,1,0,1
80337,180,21545,26865;27106,64605,0,0,2,0,2
80338,180,21546,26533,64605,0,0,1,0,1
80339,180,21547,26915,64605,0,0,1,0,1
80340,180,21548,26930;27211,64605,0,0,2,0,2
80341,180,21549,26866;26982;29596;30021,64605,1,1,2,0,4
80342,180,21551,27144;29687,64605,0,1,1,0,2
80343,180,21552,27162,64605,0,0,1,0,1
80344,180,21553,27166;27247;30029;30205,64605,2,0,2,0,4
80345,180,21554,27175;27871;30243,64605,1,0,2,0,3
80346,180,21555,27177,64605,0,0,1,0,1
80347,180,21556,27207,64605,0,0,1,0,1
80348,180,21557,27266;27781;29890,64605,1,0,2,0,3
80349,180,21558,27267;27312;30132,64605,1,0,2,0,3
80350,180,21559,27283,64605,0,0,1,0,1
80351,180,21560,27321;27522;30143,64605,1,0,2,0,3
80352,180,21561,27646;27780;29327,64605,0,1,2,0,3
80353,180,21562,27343;27376,64605,0,0,2,0,2
80354,180,21563,27356;30135,64605,1,0,1,0,2
80355,180,21564,27077;27341,64605,0,0,2,0,2
80356,180,21565,27154;27412;30050;30138;30225,64605,3,0,2,0,5
80357,180,21566,27095,64605,0,0,1,0,1
80358,180,21567,27308;27473;30053,64605,1,0,2,0,3
80359,180,21568,27474,64605,0,0,1,0,1
80360,180,21569,27513,64605,0,0,1,0,1
80361,180,21570,27626,64605,0,0,1,0,1
80362,180,21571,27637,64605,0,0,1,0,1
80363,180,21572,27674;27929,64605,0,0,2,0,2
80364,180,21574,27579;27685;29612;29701;29883,64605,1,2,2,0,5
80365,180,21575,27390,64605,0,0,1,0,1
80366,180,21576,27743;28095,64605,0,0,2,0,2
80367,180,21577,27784;28086,64605,0,0,2,0,2
80368,180,21578,27792;28088,64605,0,0,2,0,2
80369,180,21579,27800;27820;29617,64605,0,1,2,0,3
80370,180,21580,27804;27967,64605,0,0,2,0,2
80371,180,21581,27844;28007;29980,64605,1,0,2,0,3
80372,180,21582,27883;28147,64605,0,0,2,0,2
80373,180,21583,27887;27909;29807,64605,0,1,2,0,3
80374,180,21584,27910;28211;30167,64605,1,0,2,0,3
80375,180,21585,27915,64605,0,0,1,0,1
80376,180,21586,27282;27925,64605,0,0,2,0,2
80377,180,21587,27950;28169,64605,0,0,2,0,2
80378,180,21588,27990;28070,64605,0,0,2,0,2
80379,180,21589,27894;28013,64605,0,0,2,0,2
80380,180,21590,28018;28240,64605,0,0,2,0,2
80381,180,21591,28021;28384,64605,0,0,2,0,2
80382,180,21592,28049,64605,0,0,1,0,1
80383,180,21593,28062;28252,64605,0,0,2,0,2
80384,180,21594,28083;28117,64605,0,0,2,0,2
80385,180,21595,27852;28121,64605,0,0,2,0,2
80386,180,21596,28131;28305,64605,0,0,2,0,2
80387,180,21597,28142;28422,64605,0,0,2,0,2
80388,180,21598,28154;28323,64605,0,0,2,0,2
80389,180,21599,28171;28452,64605,0,0,2,0,2
80390,180,21600,23975,64970,0,0,1,0,1
80391,180,21601,23759;24339,64970,0,0,1,1,2
80392,180,21602,24199,64970,0,0,1,0,1
80393,180,21603,24206,64970,0,0,1,0,1
80394,180,21604,24052,64970,0,0,1,0,1
80395,180,21605,24209,64970,0,0,1,0,1
80396,180,21606,24768,64970,0,0,1,0,1
80397,180,21607,24597,64970,0,0,1,0,1
80398,180,21611,24775,64970,0,0,1,0,1
80399,180,21612,25333,64970,0,0,1,0,1
80400,180,21613,25399,64970,0,0,1,0,1
80401,180,21614,25403,64970,0,0,1,0,1
80402,180,21615,25467,64970,0,0,1,0,1
80403,180,21618,25633,64970,0,0,1,0,1
80404,180,21619,25653,64970,0,0,1,0,1
80405,180,21620,25730,64970,0,0,1,0,1
80406,180,21621,25747,64970,0,0,1,0,1
80407,180,21622,25270,64970,0,0,1,0,1
80408,180,21623,25808,64970,0,0,1,0,1
80409,180,21624,25895,64970,0,0,1,0,1
80410,180,21626,25983,64970,0,0,1,0,1
80411,180,21627,26067,64970,0,0,1,0,1
80412,180,21628,26096,64970,0,0,1,0,1
80413,180,21631,26443;26697;28666,64970,0,0,3,0,3
80414,180,21632,26225;26338;29646;29728,64970,0,2,2,0,4
80415,180,21633,26345,64970,0,0,1,0,1
80416,180,21634,26849,64970,0,0,1,0,1
80417,180,21636,26924;27064,64970,0,0,2,0,2
80418,180,21637,26942,64970,0,0,1,0,1
80419,180,21638,27005;27475;29969;30142,64970,2,0,2,0,4
80420,180,21639,27014;27708;29708;29974,64970,1,1,2,0,4
80421,180,21640,26805;27037;30196,64970,1,0,2,0,3
80422,180,21641,27050;27086,64970,0,0,2,0,2
80423,180,21642,26531,64970,0,0,1,0,1
80424,180,21643,27159;27265;30027;30204,64970,2,0,2,0,4
80425,180,21644,27323;27362;29961,64970,1,0,2,0,3
80426,180,21645,27085;27369,64970,0,0,2,0,2
80427,180,21646,27610;29525;30236,64970,1,1,1,0,3
80428,180,21647,27399;27828,64970,0,0,2,0,2
80429,180,21648,27489;27903,64970,0,0,2,0,2
80430,180,21649,27506;27943,64970,0,0,2,0,2
80431,180,21650,27512;28073,64970,0,0,2,0,2
80432,180,21651,27325;27525,64970,0,0,2,0,2
80433,180,21652,27456;27668,64970,0,0,2,0,2
80434,180,21653,27629;27677,64970,0,0,2,0,2
80435,180,21654,27658,64970,0,0,1,0,1
80436,180,21655,27666;27744,64970,0,0,2,0,2
80437,180,21656,27722;27813,64970,0,0,2,0,2
80438,180,21657,27725;28186,64970,0,0,2,0,2
80439,180,21658,27731;28380,64970,0,0,2,0,2
80440,180,21659,27751;28124,64970,0,0,2,0,2
80441,180,21660,27769;28194,64970,0,0,2,0,2
80442,180,21661,27342;28205,64970,0,0,2,0,2
80443,180,21662,27783,64970,0,0,1,0,1
80444,180,21663,27782;27818;30241,64970,1,0,2,0,3
80445,180,21664,27827;27992,64970,0,0,2,0,2
80446,180,21665,27830;27932,64970,0,0,2,0,2
80447,180,21666,27843;28032,64970,0,0,2,0,2
80448,180,21667,27886,64970,0,0,1,0,1
80449,180,21668,27896;28297,64970,0,0,2,0,2
80450,180,21669,27965;29894,64970,1,0,1,0,2
80451,180,21670,27877;27994,64970,0,0,2,0,2
80452,180,21671,28011,64970,0,0,1,0,1
80453,180,21672,28034,64970,0,0,1,0,1
80454,180,21673,28039;28127;29983,64970,1,0,2,0,3
80455,180,21674,28055;28125;29809,64970,0,1,2,0,3
80456,180,21675,27849;28060;30249,64970,1,0,2,0,3
80457,180,21676,27730;28063;30064,64970,1,0,2,0,3
80458,180,21677,28132;28309;30168,64970,1,0,2,0,3
80459,180,21678,27801;28111;30164,64970,1,0,2,0,3
80460,180,21679,28150;28182,64970,0,0,2,0,2
80461,180,21680,28108;28162;30251,64970,1,0,2,0,3
80462,180,21681,28014;28166,64970,0,0,2,0,2
80463,180,21682,28193;28209;30252,64970,1,0,2,0,3
80464,180,21683,28201,64970,0,0,1,0,1
80465,180,21684,28206,64970,0,0,1,0,1
80466,180,21685,28228;28415,64970,0,0,2,0,2
80467,180,21686,27974;28237,64970,0,0,2,0,2
80468,180,21687,28242;28451,64970,0,0,2,0,2
80469,180,21688,28101;28259,64970,0,0,2,0,2
80470,180,21689,28247;28266,64970,0,0,2,0,2
80471,180,21690,24034,65335,0,0,1,0,1
80472,180,21691,24342;24657,65335,0,0,2,0,2
80473,180,21692,24384,65335,0,0,1,0,1
80474,180,21693,24522,65335,0,0,1,0,1
80475,180,21694,24924,65335,0,0,1,0,1
80476,180,21695,24852,65335,0,0,1,0,1
80477,180,21696,25082,65335,0,0,1,0,1
80478,180,21697,25239,65335,0,0,1,0,1
80479,180,21699,25327,65335,0,0,1,0,1
80480,180,21700,25329,65335,0,0,1,0,1
80481,180,21701,25450,65335,0,0,1,0,1
80482,180,21702,25518,65335,0,0,1,0,1
80483,180,21703,25269,65335,0,0,1,0,1
80484,180,21705,25388,65335,0,0,1,0,1
80485,180,21706,25803,65335,0,0,1,0,1
80486,180,21707,25580,65335,0,0,1,0,1
80487,180,21708,26082,65335,0,0,1,0,1
80488,180,21709,25868,65335,0,0,1,0,1
80489,180,21710,25889,65335,0,0,1,0,1
80490,180,21712,26309,65335,0,0,1,0,1
80491,180,21713,26347;26628;28838,65335,0,1,2,0,3
80492,180,21715,26399,65335,0,0,1,0,1
80493,180,21716,26468;26702;30004,65335,1,0,2,0,3
80494,180,21718,26570,65335,0,0,1,0,1
80495,180,21719,26715,65335,0,0,1,0,1
80496,180,21720,26731;26814;29926,65335,1,0,2,0,3
80497,180,21721,26735,65335,0,0,1,0,1
80498,180,21722,27099;27368;29698;29963,65335,1,1,2,0,4
80499,180,21723,27017;27101;30201,65335,1,0,2,0,3
80500,180,21724,27091;27136;29686;29783,65335,0,2,2,0,4
80501,180,21725,27370,65335,0,0,1,0,1
80502,180,21726,27176,65335,0,0,1,0,1
80503,180,21727,27396;27726;29709,65335,0,1,2,0,3
80504,180,21728,27303;27402;29323;29794;30048,65335,1,2,2,0,5
80505,180,21729,27528;29880;30144,65335,2,0,1,0,3
80506,180,21730,27530;27870,65335,0,0,2,0,2
80507,180,21731,27538;27768;29527,65335,0,1,2,0,3
80508,180,21732,27545;27635,65335,0,0,2,0,2
80509,180,21733,27577;28043;30161,65335,1,0,2,0,3
80510,180,21734,27277,65335,0,0,1,0,1
80511,180,21735,27601,65335,0,0,1,0,1
80512,180,21736,27750;27874,65335,0,0,2,0,2
80513,180,21737,27786;28196,65335,0,0,2,0,2
80514,180,21738,27878;28273,65335,0,0,2,0,2
80515,180,21739,27928;28065,65335,0,0,2,0,2
80516,180,21740,27939;27960,65335,0,0,2,0,2
80517,180,21741,27897;27968,65335,0,0,2,0,2
80518,180,21742,27756;27971,65335,0,0,2,0,2
80519,180,21743,27972;28314,65335,0,0,2,0,2
80520,180,21744,27999;28343,65335,0,0,2,0,2
80521,180,21745,28045,65335,0,0,1,0,1
80522,180,21746,28046;28053,65335,0,0,2,0,2
80523,180,21747,28059;28168,65335,0,0,2,0,2
80524,180,21748,28064;28528,65335,0,0,2,0,2
80525,180,21749,28075,65335,0,0,1,0,1
80526,180,21750,28107;28270,65335,0,0,2,0,2
80527,180,21751,28113;28192,65335,0,0,2,0,2
80528,180,21752,28387,65335,0,0,1,0,1
80529,180,21753,28145;28490,65335,0,0,2,0,2
80530,180,21754,28067;28183,65335,0,0,2,0,2
80531,180,21755,27774;28185,65335,0,0,2,0,2
80532,180,21756,28213;28354,65335,0,0,2,0,2
80533,180,21757,28004;28230,65335,0,0,2,0,2
80534,180,21758,28251;28408,65335,0,0,2,0,2
80535,180,21759,28254;28627,65335,0,0,2,0,2
80536,180,21760,27980;28263;30257,65335,1,0,2,0,3
80537,180,21761,28048;28353,65335,0,0,2,0,2
80538,180,21762,27675;28356,65335,0,0,2,0,2
80539,180,21763,28361;28524,65335,0,0,2,0,2
80540,180,21765,24349,65700,0,0,1,0,1
80541,180,21766,24371,65700,0,0,1,0,1
80542,180,21767,24237,65700,0,0,1,0,1
80543,180,21768,24435;24444,65700,0,0,2,0,2
80544,180,21769,24151,65700,0,0,1,0,1
80545,180,21770,24501,65700,0,0,1,0,1
80546,180,21771,24531,65700,0,0,1,0,1
80547,180,21772,24263,65700,0,0,1,0,1
80548,180,21773,24258,65700,0,0,1,0,1
80549,180,21774,24512,65700,0,0,1,0,1
80550,180,21775,24910;28109;28389,65700,0,0,3,0,3
80551,180,21776,24581,65700,0,0,1,0,1
80552,180,21777,25012,65700,0,0,1,0,1
80553,180,21778,24837,65700,0,0,1,0,1
80554,180,21779,25070,65700,0,0,1,0,1
80555,180,21780,25516,65700,0,0,1,0,1
80556,180,21781,25779;28721,65700,0,1,1,0,2
80557,180,21782,25865,65700,0,0,1,0,1
80558,180,21783,25526,65700,0,0,1,0,1
80559,180,21784,25978,65700,0,0,1,0,1
80560,180,21785,26041,65700,0,0,1,0,1
80561,180,21786,26150,65700,0,0,1,0,1
80562,180,21787,25938,65700,0,0,1,0,1
80563,180,21788,26219,65700,0,0,1,0,1
80564,180,21789,26295,65700,0,0,1,0,1
80565,180,21790,26641,65700,0,0,1,0,1
80566,180,21791,26713,65700,0,0,1,0,1
80567,180,21792,26793,65700,0,0,1,0,1
80568,180,21793,26996;27240;30211,65700,1,0,2,0,3
80569,180,21794,26665,65700,0,0,1,0,1
80570,180,21795,27019,65700,0,0,1,0,1
80571,180,21796,27300,65700,0,0,1,0,1
80572,180,21797,27477;27684,65700,0,0,2,0,2
80573,180,21798,27516;27986,65700,0,0,2,0,2
80574,180,21799,27566;27857,65700,0,0,2,0,2
80575,180,21800,27491,65700,0,0,1,0,1
80576,180,21801,27581;28267,65700,0,0,2,0,2
80577,180,21802,27617,65700,0,0,1,0,1
80578,180,21803,27278;27657,65700,0,0,2,0,2
80579,180,21804,27663,65700,0,0,1,0,1
80580,180,21805,27143;27688;30237,65700,1,0,2,0,3
80581,180,21806,27659,65700,0,0,1,0,1
80582,180,21807,27620,65700,0,0,1,0,1
80583,180,21808,27705,65700,0,0,1,0,1
80584,180,21809,27568,65700,0,0,1,0,1
80585,180,21810,27860,65700,0,0,1,0,1
80586,180,21811,27776;27920,65700,0,0,2,0,2
80587,180,21812,27977;28275,65700,0,0,2,0,2
80588,180,21813,27983;28512,65700,0,0,2,0,2
80589,180,21814,27858;27987,65700,0,0,2,0,2
80590,180,21815,27942;27995,65700,0,0,2,0,2
80591,180,21816,28008;28542,65700,0,0,2,0,2
80592,180,21817,28089;28363,65700,0,0,2,0,2
80593,180,21818,28058;28091,65700,0,0,2,0,2
80594,180,21819,28017;28093,65700,0,0,2,0,2
80595,180,21820,28118;28307;30258,65700,1,0,2,0,3
80596,180,21821,28126,65700,0,0,1,0,1
80597,180,21822,28005;28136,65700,0,0,2,0,2
80598,180,21823,27806;28140;29984,65700,1,0,2,0,3
80599,180,21824,28156;28218,65700,0,0,2,0,2
80600,180,21825,28170;28217,65700,0,0,2,0,2
80601,180,21826,28181;28685,65700,0,1,1,0,2
80602,180,21827,28226;28257,65700,0,0,2,0,2
80603,180,21828,27975;28271,65700,0,0,2,0,2
80604,180,21829,28265;28280,65700,0,0,2,0,2
80605,180,21830,28310,65700,0,0,1,0,1
80606,180,21831,28374;28734,65700,0,1,1,0,2
80607,180,21832,28274;28375,65700,0,0,2,0,2
80608,180,21833,28403;28519,65700,0,0,2,0,2
80609,180,21834,28243;28428,65700,0,0,2,0,2
80610,180,21835,28453;28509,65700,0,0,2,0,2
80611,180,21836,28368;28460,65700,0,0,2,0,2
80612,190,11558,23566;23962,27375,0,0,0,2,2
80613,190,13309,22887,33215,0,0,0,1,1
80614,190,13591,21373,33945,0,0,0,1,1
80615,190,13661,22524,34310,0,0,0,1,1
80616,190,13672,22310,34310,0,0,0,1,1
80617,190,13712,23631,34310,0,0,0,1,1
80618,190,13715,22818,34310,0,0,0,1,1
80619,190,13979,23344;23401,35405,0,0,0,2,2
80620,190,14002,24759;25162,35405,0,0,1,1,2
80621,190,14035,24917,35405,0,0,1,0,1
80622,190,14356,23769,36500,0,0,0,1,1
80623,190,14503,22707;22985,37230,0,0,0,2,2
80624,190,14592,22380,37595,0,0,0,1,1
80625,190,14626,23895,37595,0,0,0,1,1
80626,190,14761,23680,37960,0,0,0,1,1
80627,190,14831,23570,38325,0,0,0,1,1
80628,190,14847,23989;24346,38325,0,0,0,2,2
80629,190,14857,23679;23739,38325,0,0,0,2,2
80630,190,14985,23690,38690,0,0,0,1,1
80631,190,15062,24701,39055,0,0,0,1,1
80632,190,15066,24405;25078;25179;25197,39055,0,0,3,1,4
80633,190,15178,24633;24670,39420,0,0,0,2,2
80634,190,15194,24622;24826,39420,0,0,0,2,2
80635,190,15198,24672;25025,39420,0,0,1,1,2
80636,190,15448,26031;26300;29631,40515,0,1,2,0,3
80637,190,15498,21427,40515,0,0,0,1,1
80638,190,15501,21200,40515,0,0,0,1,1
80639,190,15556,23176,40880,0,0,0,1,1
80640,190,15566,21420,40880,0,0,0,1,1
80641,190,15568,21341,40880,0,0,0,1,1
80642,190,15575,21463,40880,0,0,0,1,1
80643,190,15651,20907;20989,41245,0,0,0,2,2
80644,190,15654,21415,41245,0,0,0,1,1
80645,190,15665,21683,41245,0,0,0,1,1
80646,190,15666,21259,41245,0,0,0,1,1
80647,190,15673,25491;25630,41245,0,0,2,0,2
80648,190,15676,21326,41245,0,0,0,1,1
80649,190,15677,21394,41245,0,0,0,1,1
80650,190,15679,21393,41245,0,0,0,1,1
80651,190,15742,20979,41610,0,0,0,1,1
80652,190,15772,21829,41610,0,0,0,1,1
80653,190,15777,21621,41610,0,0,0,1,1
80654,190,15808,24524;24819;25114;27531,41975,0,0,2,2,4
80655,190,15839,21152,41975,0,0,0,1,1
80656,190,15845,21231,41975,0,0,0,1,1
80657,190,15859,21494,41975,0,0,0,1,1
80658,190,15918,20900,42340,0,0,0,1,1
80659,190,15921,24944;25130;26130;26238;29190,42340,0,0,5,0,5
80660,190,15928,21978,42340,0,0,0,1,1
80661,190,15934,21909,42340,0,0,0,1,1
80662,190,15935,21828,42340,0,0,0,1,1
80663,190,15937,22017,42340,0,0,0,1,1
80664,190,15941,21176,42340,0,0,0,1,1
80665,190,15946,21580,42340,0,0,0,1,1
80666,190,15947,22050,42340,0,0,0,1,1
80667,190,15950,21605,42340,0,0,0,1,1
80668,190,15953,21827,42340,0,0,0,1,1
80669,190,15959,21951,42340,0,0,0,1,1
80670,190,15960,21704,42340,0,0,0,1,1
80671,190,16007,25728,42705,0,0,1,0,1
80672,190,16022,21439,42705,0,0,0,1,1
80673,190,16025,22138,42705,0,0,0,1,1
80674,190,16027,21912,42705,0,0,0,1,1
80675,190,16028,22131,42705,0,0,0,1,1
80676,190,16031,21895,42705,0,0,0,1,1
80677,190,16033,21671,42705,0,0,0,1,1
80678,190,16038,21653,42705,0,0,0,1,1
80679,190,16039,21773,42705,0,0,0,1,1
80680,190,16042,21458,42705,0,0,0,1,1
80681,190,16044,21801,42705,0,0,0,1,1
80682,190,16045,21893,42705,0,0,0,1,1
80683,190,16100,23737;23937,43070,0,0,0,2,2
80684,190,16108,21403,43070,0,0,0,1,1
80685,190,16113,22065,43070,0,0,0,1,1
80686,190,16114,21947,43070,0,0,0,1,1
80687,190,16121,21624,43070,0,0,0,1,1
80688,190,16125,21841,43070,0,0,0,1,1
80689,190,16126,21513,43070,0,0,0,1,1
80690,190,16130,21476,43070,0,0,0,1,1
80691,190,16132,21967,43070,0,0,0,1,1
80692,190,16136,21637;21811,43070,0,0,0,2,2
80693,190,16137,22153,43070,0,0,0,1,1
80694,190,16139,21836,43070,0,0,0,1,1
80695,190,16140,21847,43070,0,0,0,1,1
80696,190,16142,21850,43070,0,0,0,1,1
80697,190,16144,21864,43070,0,0,0,1,1
80698,190,16147,21899,43070,0,0,0,1,1
80699,190,16148,22235,43070,0,0,0,1,1
80700,190,16149,22195,43070,0,0,0,1,1
80701,190,16196,21657,43435,0,0,0,1,1
80702,190,16201,21658,43435,0,0,0,1,1
80703,190,16205,21611,43435,0,0,0,1,1
80704,190,16217,22526,43435,0,0,0,1,1
80705,190,16218,21751,43435,0,0,0,1,1
80706,190,16219,22094,43435,0,0,0,1,1
80707,190,16222,21760,43435,0,0,0,1,1
80708,190,16224,21785,43435,0,0,0,1,1
80709,190,16228,21832,43435,0,0,0,1,1
80710,190,16243,21998,43435,0,0,0,1,1
80711,190,16244,22014,43435,0,0,0,1,1
80712,190,16246,22307,43435,0,0,0,1,1
80713,190,16247,22031,43435,0,0,0,1,1
80714,190,16248,22123,43435,0,0,0,1,1
80715,190,16305,21705;24970;28301,43800,0,0,2,1,3
80716,190,16309,21594,43800,0,0,0,1,1
80717,190,16311,21622,43800,0,0,0,1,1
80718,190,16312,21930,43800,0,0,0,1,1
80719,190,16313,21499,43800,0,0,0,1,1
80720,190,16316,21890,43800,0,0,0,1,1
80721,190,16319,21697,43800,0,0,0,1,1
80722,190,16321,21629;22062,43800,0,0,0,2,2
80723,190,16322,21309,43800,0,0,0,1,1
80724,190,16323,22227,43800,0,0,0,1,1
80725,190,16325,22364,43800,0,0,0,1,1
80726,190,16327,21842;22141,43800,0,0,0,2,2
80727,190,16329,21910,43800,0,0,0,1,1
80728,190,16332,21936;22148,43800,0,0,0,2,2
80729,190,16337,22267,43800,0,0,0,1,1
80730,190,16338,22009,43800,0,0,0,1,1
80731,190,16340,22041,43800,0,0,0,1,1
80732,190,16344,22260,43800,0,0,0,1,1
80733,190,16345,22085;22215,43800,0,0,0,2,2
80734,190,16348,25723;25941,43800,0,0,2,0,2
80735,190,16397,21059,44165,0,0,0,1,1
80736,190,16398,21077;21546,44165,0,0,0,2,2
80737,190,16406,21029,44165,0,0,0,1,1
80738,190,16408,21610,44165,0,0,0,1,1
80739,190,16409,21775,44165,0,0,0,1,1
80740,190,16411,21959,44165,0,0,0,1,1
80741,190,16412,21491,44165,0,0,0,1,1
80742,190,16413,21639,44165,0,0,0,1,1
80743,190,16415,22390,44165,0,0,0,1,1
80744,190,16418,22196,44165,0,0,0,1,1
80745,190,16419,22192,44165,0,0,0,1,1
80746,190,16422,22302,44165,0,0,0,1,1
80747,190,16428,22029,44165,0,0,0,1,1
80748,190,16429,22549,44165,0,0,0,1,1
80749,190,16431,22114,44165,0,0,0,1,1
80750,190,16432,22368,44165,0,0,0,1,1
80751,190,16433,22032,44165,0,0,0,1,1
80752,190,16435,21767;22176,44165,0,0,0,2,2
80753,190,16436,22298,44165,0,0,0,1,1
80754,190,16438,22455,44165,0,0,0,1,1
80755,190,16440,22555,44165,0,0,0,1,1
80756,190,16441,21906,44165,0,0,0,1,1
80757,190,16443,22395,44165,0,0,0,1,1
80758,190,16444,22238;22331,44165,0,0,0,2,2
80759,190,16488,22084,44530,0,0,0,1,1
80760,190,16490,22508,44530,0,0,0,1,1
80761,190,16491,21980,44530,0,0,0,1,1
80762,190,16495,21665,44530,0,0,0,1,1
80763,190,16501,21994;22296,44530,0,0,0,2,2
80764,190,16502,21883,44530,0,0,0,1,1
80765,190,16504,21886,44530,0,0,0,1,1
80766,190,16505,22012,44530,0,0,0,1,1
80767,190,16506,22006;24671,44530,0,0,0,2,2
80768,190,16510,22171,44530,0,0,0,1,1
80769,190,16511,21752,44530,0,0,0,1,1
80770,190,16512,22090,44530,0,0,0,1,1
80771,190,16514,22489,44530,0,0,0,1,1
80772,190,16515,22104,44530,0,0,0,1,1
80773,190,16516,22699,44530,0,0,0,1,1
80774,190,16517,22178,44530,0,0,0,1,1
80775,190,16518,22632,44530,0,0,0,1,1
80776,190,16519,21674;22034,44530,0,0,0,2,2
80777,190,16520,22505,44530,0,0,0,1,1
80778,190,16521,22347,44530,0,0,0,1,1
80779,190,16522,22330,44530,0,0,0,1,1
80780,190,16524,22292;22485,44530,0,0,0,2,2
80781,190,16527,22634,44530,0,0,0,1,1
80782,190,16529,22046,44530,0,0,0,1,1
80783,190,16530,22168,44530,0,0,0,1,1
80784,190,16572,21764,44895,0,0,0,1,1
80785,190,16581,21634,44895,0,0,0,1,1
80786,190,16586,21688,44895,0,0,0,1,1
80787,190,16588,22254,44895,0,0,0,1,1
80788,190,16592,22327,44895,0,0,0,1,1
80789,190,16598,22336,44895,0,0,0,1,1
80790,190,16599,22251,44895,0,0,0,1,1
80791,190,16600,22075,44895,0,0,0,1,1
80792,190,16604,22101,44895,0,0,0,1,1
80793,190,16605,22273,44895,0,0,0,1,1
80794,190,16606,21759,44895,0,0,0,1,1
80795,190,16607,22693,44895,0,0,0,1,1
80796,190,16608,22564;22604,44895,0,0,0,2,2
80797,190,16609,22713,44895,0,0,0,1,1
80798,190,16612,22496,44895,0,0,0,1,1
80799,190,16614,22314,44895,0,0,0,1,1
80800,190,16616,22379,44895,0,0,0,1,1
80801,190,16617,22394,44895,0,0,0,1,1
80802,190,16618,22018,44895,0,0,0,1,1
80803,190,16619,22401,44895,0,0,0,1,1
80804,190,16622,22442;22695,44895,0,0,0,2,2
80805,190,16623,22452;22859,44895,0,0,0,2,2
80806,190,16626,22582;22747,44895,0,0,0,2,2
80807,190,16666,21530,45260,0,0,0,1,1
80808,190,16678,21878,45260,0,0,0,1,1
80809,190,16679,21915,45260,0,0,0,1,1
80810,190,16680,22261,45260,0,0,0,1,1
80811,190,16684,22207,45260,0,0,0,1,1
80812,190,16686,22158,45260,0,0,0,1,1
80813,190,16688,22270,45260,0,0,0,1,1
80814,190,16690,22595;22651,45260,0,0,0,2,2
80815,190,16691,22807,45260,0,0,0,1,1
80816,190,16692,22252,45260,0,0,0,1,1
80817,190,16693,22038;22400,45260,0,0,0,2,2
80818,190,16694,22915;27132,45260,0,0,1,1,2
80819,190,16695,22326;22417,45260,0,0,0,2,2
80820,190,16696,22387,45260,0,0,0,1,1
80821,190,16697,22793,45260,0,0,0,1,1
80822,190,16698,22437,45260,0,0,0,1,1
80823,190,16700,22478,45260,0,0,0,1,1
80824,190,16701,22796,45260,0,0,0,1,1
80825,190,16703,22501,45260,0,0,0,1,1
80826,190,16704,22780;22814;26630;29576,45260,0,0,2,2,4
80827,190,16705,22169,45260,0,0,0,1,1
80828,190,16706,22535,45260,0,0,0,1,1
80829,190,16707,22553;22580,45260,0,0,0,2,2
80830,190,16708,22556,45260,0,0,0,1,1
80831,190,16709,22560;22645,45260,0,0,0,2,2
80832,190,16712,22338;22623,45260,0,0,0,2,2
80833,190,16713,22626,45260,0,0,0,1,1
80834,190,16759,21638,45625,0,0,0,1,1
80835,190,16762,22768,45625,0,0,0,1,1
80836,190,16767,22245,45625,0,0,0,1,1
80837,190,16768,22476,45625,0,0,0,1,1
80838,190,16769,21853;22073,45625,0,0,0,2,2
80839,190,16770,22561,45625,0,0,0,1,1
80840,190,16773,22890,45625,0,0,0,1,1
80841,190,16774,22638,45625,0,0,0,1,1
80842,190,16775,22001,45625,0,0,0,1,1
80843,190,16777,22237;22403,45625,0,0,0,2,2
80844,190,16778,22422;22681,45625,0,0,0,2,2
80845,190,16779,22154;22808,45625,0,0,0,2,2
80846,190,16781,22622,45625,0,0,0,1,1
80847,190,16783,22418,45625,0,0,0,1,1
80848,190,16784,22319,45625,0,0,0,1,1
80849,190,16785,22584,45625,0,0,0,1,1
80850,190,16786,23052,45625,0,0,0,1,1
80851,190,16787,23098,45625,0,0,0,1,1
80852,190,16788,22939,45625,0,0,0,1,1
80853,190,16790,22961,45625,0,0,0,1,1
80854,190,16794,22812,45625,0,0,0,1,1
80855,190,16795,22832,45625,0,0,0,1,1
80856,190,16796,22714,45625,0,0,0,1,1
80857,190,16798,22742,45625,0,0,0,1,1
80858,190,16799,22572,45625,0,0,0,1,1
80859,190,16800,22658;22822,45625,0,0,0,2,2
80860,190,16801,22610;22770,45625,0,0,0,2,2
80861,190,16843,21500,45990,0,0,0,1,1
80862,190,16848,21720,45990,0,0,0,1,1
80863,190,16849,22150,45990,0,0,0,1,1
80864,190,16856,21976,45990,0,0,0,1,1
80865,190,16862,22461,45990,0,0,0,1,1
80866,190,16863,22413;22743,45990,0,0,0,2,2
80867,190,16864,22784,45990,0,0,0,1,1
80868,190,16865,22197,45990,0,0,0,1,1
80869,190,16867,22465;22617,45990,0,0,0,2,2
80870,190,16868,22761;22936,45990,0,0,0,2,2
80871,190,16869,22538,45990,0,0,0,1,1
80872,190,16870,22616,45990,0,0,0,1,1
80873,190,16871,22557,45990,0,0,0,1,1
80874,190,16874,22255;22676,45990,0,0,0,2,2
80875,190,16875,22683,45990,0,0,0,1,1
80876,190,16876,22852,45990,0,0,0,1,1
80877,190,16878,23014,45990,0,0,0,1,1
80878,190,16879,22809;22941,45990,0,0,0,2,2
80879,190,16922,21739,46355,0,0,0,1,1
80880,190,16925,21729,46355,0,0,0,1,1
80881,190,16928,22185,46355,0,0,0,1,1
80882,190,16929,21848,46355,0,0,0,1,1
80883,190,16934,22449,46355,0,0,0,1,1
80884,190,16937,22306;22820,46355,0,0,0,2,2
80885,190,16938,23166,46355,0,0,0,1,1
80886,190,16939,22578,46355,0,0,0,1,1
80887,190,16940,22342,46355,0,0,0,1,1
80888,190,16944,22785,46355,0,0,0,1,1
80889,190,16948,22563,46355,0,0,0,1,1
80890,190,16949,22451,46355,0,0,0,1,1
80891,190,16950,22525;22792,46355,0,0,0,2,2
80892,190,16952,22290;22487,46355,0,0,0,2,2
80893,190,16954,22629;22731,46355,0,0,0,2,2
80894,190,16955,22102,46355,0,0,0,1,1
80895,190,16956,22602,46355,0,0,0,1,1
80896,190,16957,22864,46355,0,0,0,1,1
80897,190,16958,22624,46355,0,0,0,1,1
80898,190,16959,22637,46355,0,0,0,1,1
80899,190,16962,22700,46355,0,0,0,1,1
80900,190,16963,22965,46355,0,0,0,1,1
80901,190,16964,22174,46355,0,0,0,1,1
80902,190,16965,22762,46355,0,0,0,1,1
80903,190,16966,22775,46355,0,0,0,1,1
80904,190,16967,23205,46355,0,0,0,1,1
80905,190,16969,22850,46355,0,0,0,1,1
80906,190,16971,23250,46355,0,0,0,1,1
80907,190,16972,22895,46355,0,0,0,1,1
80908,190,16973,22916,46355,0,0,0,1,1
80909,190,16974,22530;22937,46355,0,0,0,2,2
80910,190,16975,23206,46355,0,0,0,1,1
80911,190,16977,22987,46355,0,0,0,1,1
80912,190,16979,22585;23248,46355,0,0,0,2,2
80913,190,17018,21907,46720,0,0,0,1,1
80914,190,17021,22454,46720,0,0,0,1,1
80915,190,17023,22205,46720,0,0,0,1,1
80916,190,17024,22652,46720,0,0,0,1,1
80917,190,17028,22283;22752,46720,0,0,0,2,2
80918,190,17029,22325,46720,0,0,0,1,1
80919,190,17032,22383;22871,46720,0,0,0,2,2
80920,190,17035,22429,46720,0,0,0,1,1
80921,190,17036,22503,46720,0,0,0,1,1
80922,190,17038,22433;22521,46720,0,0,0,2,2
80923,190,17039,22551,46720,0,0,0,1,1
80924,190,17042,22712;22956,46720,0,0,0,2,2
80925,190,17043,22786;23279,46720,0,0,0,2,2
80926,190,17045,22728,46720,0,0,0,1,1
80927,190,17046,23101,46720,0,0,0,1,1
80928,190,17049,22918,46720,0,0,0,1,1
80929,190,17050,23136;23380,46720,0,0,0,2,2
80930,190,17055,22951,46720,0,0,0,1,1
80931,190,17056,23038,46720,0,0,0,1,1
80932,190,17057,23243,46720,0,0,0,1,1
80933,190,17059,23022;23049,46720,0,0,0,2,2
80934,190,17060,23023;23230,46720,0,0,0,2,2
80935,190,17061,23036,46720,0,0,0,1,1
80936,190,17062,22706;23026,46720,0,0,0,2,2
80937,190,17063,23194;23541,46720,0,0,0,2,2
80938,190,17066,23239,46720,0,0,0,1,1
80939,190,17067,23027;23102,46720,0,0,0,2,2
80940,190,17101,21497,47085,0,0,0,1,1
80941,190,17109,21928,47085,0,0,0,1,1
80942,190,17112,22271;22480,47085,0,0,0,2,2
80943,190,17114,22513;22760,47085,0,0,0,2,2
80944,190,17117,22566,47085,0,0,0,1,1
80945,190,17119,22869,47085,0,0,0,1,1
80946,190,17120,22730,47085,0,0,0,1,1
80947,190,17121,22778;22873,47085,0,0,0,2,2
80948,190,17128,22516,47085,0,0,0,1,1
80949,190,17129,23094,47085,0,0,0,1,1
80950,190,17132,22608,47085,0,0,0,1,1
80951,190,17135,22702,47085,0,0,0,1,1
80952,190,17138,22841,47085,0,0,0,1,1
80953,190,17139,22717,47085,0,0,0,1,1
80954,190,17140,23030;25700,47085,0,0,1,1,2
80955,190,17141,22828,47085,0,0,0,1,1
80956,190,17142,22920,47085,0,0,0,1,1
80957,190,17143,23322,47085,0,0,0,1,1
80958,190,17145,23300;23379,47085,0,0,0,2,2
80959,190,17146,23301,47085,0,0,0,1,1
80960,190,17148,22848;23108,47085,0,0,0,2,2
80961,190,17150,22935;23269,47085,0,0,0,2,2
80962,190,17151,23393,47085,0,0,0,1,1
80963,190,17152,22727,47085,0,0,0,1,1
80964,190,17154,23071,47085,0,0,0,1,1
80965,190,17158,23470,47085,0,0,0,1,1
80966,190,17159,23087;23161,47085,0,0,0,2,2
80967,190,17161,23177,47085,0,0,0,1,1
80968,190,17163,23183;23407,47085,0,0,0,2,2
80969,190,17164,23218;23299,47085,0,0,0,2,2
80970,190,17188,21822,47450,0,0,0,1,1
80971,190,17196,21999,47450,0,0,0,1,1
80972,190,17204,22287,47450,0,0,0,1,1
80973,190,17213,22339;22573,47450,0,0,0,2,2
80974,190,17216,22348,47450,0,0,0,1,1
80975,190,17217,22704;22826,47450,0,0,0,2,2
80976,190,17221,22382;22587,47450,0,0,0,2,2
80977,190,17222,22967,47450,0,0,0,1,1
80978,190,17225,22748,47450,0,0,0,1,1
80979,190,17226,22753;23013,47450,0,0,0,2,2
80980,190,17227,22226;22776,47450,0,0,0,2,2
80981,190,17228,22781,47450,0,0,0,1,1
80982,190,17229,22783,47450,0,0,0,1,1
80983,190,17230,23018;23492,47450,0,0,0,2,2
80984,190,17231,23095,47450,0,0,0,1,1
80985,190,17232,22435;23085,47450,0,0,0,2,2
80986,190,17234,22914;23318,47450,0,0,0,2,2
80987,190,17235,22923;23260;27763,47450,0,0,1,2,3
80988,190,17236,22947,47450,0,0,0,1,1
80989,190,17237,22963;22992,47450,0,0,0,2,2
80990,190,17239,23112,47450,0,0,0,1,1
80991,190,17242,22751;22996,47450,0,0,0,2,2
80992,190,17243,22720;23005,47450,0,0,0,2,2
80993,190,17244,23154,47450,0,0,0,1,1
80994,190,17246,23417,47450,0,0,0,1,1
80995,190,17248,23180,47450,0,0,0,1,1
80996,190,17250,22903;23091,47450,0,0,0,2,2
80997,190,17251,23373;23479,47450,0,0,0,2,2
80998,190,17252,23119,47450,0,0,0,1,1
80999,190,17253,23435,47450,0,0,0,1,1
81000,190,17254,23111;23339,47450,0,0,0,2,2
81001,190,17255,23199,47450,0,0,0,1,1
81002,190,17256,23273;23324,47450,0,0,0,2,2
81003,190,17257,23058,47450,0,0,0,1,1
81004,190,17260,23360,47450,0,0,0,1,1
81005,190,17261,22986,47450,0,0,0,1,1
81006,190,17262,23340,47450,0,0,0,1,1
81007,190,17263,22803;23293,47450,0,0,0,2,2
81008,190,17288,21340,47815,0,0,0,1,1
81009,190,17301,22088;22655,47815,0,0,0,2,2
81010,190,17303,22810,47815,0,0,0,1,1
81011,190,17304,21879,47815,0,0,0,1,1
81012,190,17307,22666,47815,0,0,0,1,1
81013,190,17310,22482,47815,0,0,0,1,1
81014,190,17311,22491;22847,47815,0,0,0,2,2
81015,190,17312,22568,47815,0,0,0,1,1
81016,190,17317,22735,47815,0,0,0,1,1
81017,190,17318,22641,47815,0,0,0,1,1
81018,190,17319,22363,47815,0,0,0,1,1
81019,190,17321,22721,47815,0,0,0,1,1
81020,190,17322,22927;23349,47815,0,0,0,2,2
81021,190,17323,22883,47815,0,0,0,1,1
81022,190,17324,22782,47815,0,0,0,1,1
81023,190,17325,22906,47815,0,0,0,1,1
81024,190,17327,23115,47815,0,0,0,1,1
81025,190,17328,23044;23134,47815,0,0,0,2,2
81026,190,17331,23132;23192,47815,0,0,0,2,2
81027,190,17333,23001,47815,0,0,0,1,1
81028,190,17334,23244,47815,0,0,0,1,1
81029,190,17336,23281,47815,0,0,0,1,1
81030,190,17337,23581,47815,0,0,0,1,1
81031,190,17338,22766;23153,47815,0,0,0,2,2
81032,190,17339,23120,47815,0,0,0,1,1
81033,190,17341,23681,47815,0,0,0,1,1
81034,190,17343,23160;23288,47815,0,0,0,2,2
81035,190,17344,22938;23200,47815,0,0,0,2,2
81036,190,17346,23498;27040,47815,0,0,1,1,2
81037,190,17347,23188;23263,47815,0,0,0,2,2
81038,190,17348,22928;23264,47815,0,0,0,2,2
81039,190,17349,23274,47815,0,0,0,1,1
81040,190,17350,23488;23639,47815,0,0,0,2,2
81041,190,17351,22962,47815,0,0,0,1,1
81042,190,17352,23572,47815,0,0,0,1,1
81043,190,17354,23277,47815,0,0,0,1,1
81044,190,17355,23384;23732,47815,0,0,0,2,2
81045,190,17357,23400,47815,0,0,0,1,1
81046,190,17385,21478,48180,0,0,0,1,1
81047,190,17397,21821,48180,0,0,0,1,1
81048,190,17401,22581,48180,0,0,0,1,1
81049,190,17402,22280,48180,0,0,0,1,1
81050,190,17407,22167,48180,0,0,0,1,1
81051,190,17409,22354,48180,0,0,0,1,1
81052,190,17410,22268,48180,0,0,0,1,1
81053,190,17411,22468,48180,0,0,0,1,1
81054,190,17412,22469,48180,0,0,0,1,1
81055,190,17415,25591;25965,48180,0,0,2,0,2
81056,190,17416,22527;22846,48180,0,0,0,2,2
81057,190,17419,22571,48180,0,0,0,1,1
81058,190,17420,22593;23104,48180,0,0,0,2,2
81059,190,17421,22893,48180,0,0,0,1,1
81060,190,17422,22802,48180,0,0,0,1,1
81061,190,17423,22635,48180,0,0,0,1,1
81062,190,17425,22710;22805,48180,0,0,0,2,2
81063,190,17426,22668,48180,0,0,0,1,1
81064,190,17427,22601,48180,0,0,0,1,1
81065,190,17429,22719,48180,0,0,0,1,1
81066,190,17430,22591,48180,0,0,0,1,1
81067,190,17432,22440,48180,0,0,0,1,1
81068,190,17434,22823;23064,48180,0,0,0,2,2
81069,190,17435,22473;22870,48180,0,0,0,2,2
81070,190,17436,22842;22876,48180,0,0,0,2,2
81071,190,17438,23173;25312;27945;29331,48180,0,0,3,1,4
81072,190,17440,23526,48180,0,0,0,1,1
81073,190,17441,22980,48180,0,0,0,1,1
81074,190,17442,22795,48180,0,0,0,1,1
81075,190,17443,23060,48180,0,0,0,1,1
81076,190,17444,28173,48180,0,0,1,0,1
81077,190,17445,23575,48180,0,0,0,1,1
81078,190,17446,23086;23452,48180,0,0,0,2,2
81079,190,17447,23189,48180,0,0,0,1,1
81080,190,17449,23726;23865,48180,0,0,0,2,2
81081,190,17452,23846;24110,48180,0,0,0,2,2
81082,190,17454,23286,48180,0,0,0,1,1
81083,190,17456,23510,48180,0,0,0,1,1
81084,190,17457,23589;23601,48180,0,0,0,2,2
81085,190,17460,22970,48180,0,0,0,1,1
81086,190,17461,23645,48180,0,0,0,1,1
81087,190,17462,23442;23521;27042,48180,0,0,1,2,3
81088,190,17463,23292,48180,0,0,0,1,1
81089,190,17464,23418;23440,48180,0,0,0,2,2
81090,190,17465,23376;23472,48180,0,0,0,2,2
81091,190,17466,23432,48180,0,0,0,1,1
81092,190,17467,23169;23627,48180,0,0,0,2,2
81093,190,17468,23459,48180,0,0,0,1,1
81094,190,17469,22964,48180,0,0,0,1,1
81095,190,17470,23316;23751,48180,0,0,0,2,2
81096,190,17471,23385;23606,48180,0,0,0,2,2
81097,190,17472,23505,48180,0,0,0,1,1
81098,190,17473,23499;23938,48180,0,0,0,2,2
81099,190,17512,22867,48545,0,0,0,1,1
81100,190,17515,22520,48545,0,0,0,1,1
81101,190,17516,22135;22248,48545,0,0,0,2,2
81102,190,17518,22620,48545,0,0,0,1,1
81103,190,17519,22439;22518,48545,0,0,0,2,2
81104,190,17524,21962,48545,0,0,0,1,1
81105,190,17525,22323;22397,48545,0,0,0,2,2
81106,190,17526,23117;23209,48545,0,0,0,2,2
81107,190,17528,22284;22430,48545,0,0,0,2,2
81108,190,17529,23158,48545,0,0,0,1,1
81109,190,17530,22791,48545,0,0,0,1,1
81110,190,17532,22858;23003,48545,0,0,0,2,2
81111,190,17533,23126;23162,48545,0,0,0,2,2
81112,190,17534,22926,48545,0,0,0,1,1
81113,190,17536,22408,48545,0,0,0,1,1
81114,190,17537,22889;23358,48545,0,0,0,2,2
81115,190,17540,22665;22824,48545,0,0,0,2,2
81116,190,17543,22907,48545,0,0,0,1,1
81117,190,17544,23116,48545,0,0,0,1,1
81118,190,17545,23070;23744,48545,0,0,0,2,2
81119,190,17546,23011,48545,0,0,0,1,1
81120,190,17547,23311,48545,0,0,0,1,1
81121,190,17548,23084;23458;26480,48545,0,0,1,2,3
81122,190,17549,23257,48545,0,0,0,1,1
81123,190,17550,23555;23754,48545,0,0,0,2,2
81124,190,17552,23217,48545,0,0,0,1,1
81125,190,17553,23050,48545,0,0,0,1,1
81126,190,17554,23337;23389,48545,0,0,0,2,2
81127,190,17555,23304,48545,0,0,0,1,1
81128,190,17556,23319,48545,0,0,0,1,1
81129,190,17557,23342,48545,0,0,0,1,1
81130,190,17558,23386;23405,48545,0,0,0,2,2
81131,190,17559,23395,48545,0,0,0,1,1
81132,190,17560,23689,48545,0,0,0,1,1
81133,190,17561,23428;23662,48545,0,0,0,2,2
81134,190,17562,23107,48545,0,0,0,1,1
81135,190,17563,23415,48545,0,0,0,1,1
81136,190,17564,23283;23615,48545,0,0,0,2,2
81137,190,17565,23388;23454,48545,0,0,0,2,2
81138,190,17567,23493;23785,48545,0,0,0,2,2
81139,190,17568,23515,48545,0,0,0,1,1
81140,190,17569,23538,48545,0,0,0,1,1
81141,190,17570,23821,48545,0,0,0,1,1
81142,190,17571,23308;23562,48545,0,0,0,2,2
81143,190,17572,23568;23918,48545,0,0,0,2,2
81144,190,17573,23468,48545,0,0,0,1,1
81145,190,17599,22458,48910,0,0,0,1,1
81146,190,17603,21812;22393,48910,0,0,0,2,2
81147,190,17604,22369,48910,0,0,0,1,1
81148,190,17606,22472,48910,0,0,0,1,1
81149,190,17608,22423;22438,48910,0,0,0,2,2
81150,190,17609,22463,48910,0,0,0,1,1
81151,190,17611,22453;23152,48910,0,0,0,2,2
81152,190,17615,23078,48910,0,0,0,1,1
81153,190,17617,23475,48910,0,0,0,1,1
81154,190,17618,22755;23394,48910,0,0,0,2,2
81155,190,17619,22819,48910,0,0,0,1,1
81156,190,17621,22788;22978,48910,0,0,0,2,2
81157,190,17623,22894;23113,48910,0,0,0,2,2
81158,190,17626,22979,48910,0,0,0,1,1
81159,190,17627,22988;23076,48910,0,0,0,2,2
81160,190,17628,23233,48910,0,0,0,1,1
81161,190,17629,23017,48910,0,0,0,1,1
81162,190,17630,22431;23138,48910,0,0,0,2,2
81163,190,17631,23042;25701,48910,0,0,1,1,2
81164,190,17632,23372,48910,0,0,0,1,1
81165,190,17633,23607,48910,0,0,0,1,1
81166,190,17634,22950,48910,0,0,0,1,1
81167,190,17635,23350;23709,48910,0,0,0,2,2
81168,190,17637,23242;23434,48910,0,0,0,2,2
81169,190,17638,23696;23710,48910,0,0,0,2,2
81170,190,17639,23722;23735,48910,0,0,0,2,2
81171,190,17640,23252;23736,48910,0,0,0,2,2
81172,190,17641,23149,48910,0,0,0,1,1
81173,190,17642,23313;23330,48910,0,0,0,2,2
81174,190,17643,23548,48910,0,0,0,1,1
81175,190,17645,23647;23781,48910,0,0,0,2,2
81176,190,17647,23341,48910,0,0,0,1,1
81177,190,17648,23198;23410,48910,0,0,0,2,2
81178,190,17649,23966;24075,48910,0,0,0,2,2
81179,190,17650,23513;24015,48910,0,0,0,2,2
81180,190,17651,23256;23449,48910,0,0,0,2,2
81181,190,17653,23641,48910,0,0,0,1,1
81182,190,17654,23489;23612,48910,0,0,0,2,2
81183,190,17655,23525,48910,0,0,0,1,1
81184,190,17656,23506,48910,0,0,0,1,1
81185,190,17658,27570,48910,0,0,1,0,1
81186,190,17659,23523;23835,48910,0,0,0,2,2
81187,190,17660,23403;23780,48910,0,0,0,2,2
81188,190,17661,23529;23537,48910,0,0,0,2,2
81189,190,17662,23579;23699,48910,0,0,0,2,2
81190,190,17663,23451;23585,48910,0,0,0,2,2
81191,190,17664,23502;24058,48910,0,0,0,2,2
81192,190,17665,23642,48910,0,0,0,1,1
81193,190,17667,23688;23698,48910,0,0,0,2,2
81194,190,17668,23123;23703,48910,0,0,0,2,2
81195,190,17702,22410,49275,0,0,0,1,1
81196,190,17705,23159;23215,49275,0,0,0,2,2
81197,190,17706,22506;22901,49275,0,0,0,2,2
81198,190,17707,22857,49275,0,0,0,1,1
81199,190,17709,22834,49275,0,0,0,1,1
81200,190,17710,22649,49275,0,0,0,1,1
81201,190,17711,22600;23012,49275,0,0,0,2,2
81202,190,17715,22689,49275,0,0,0,1,1
81203,190,17716,22723,49275,0,0,0,1,1
81204,190,17717,22954,49275,0,0,0,1,1
81205,190,17720,22902,49275,0,0,0,1,1
81206,190,17723,23353,49275,0,0,0,1,1
81207,190,17724,22488;23041,49275,0,0,0,2,2
81208,190,17726,23220,49275,0,0,0,1,1
81209,190,17727,23708,49275,0,0,0,1,1
81210,190,17728,23033;23825,49275,0,0,0,2,2
81211,190,17729,23328;23678,49275,0,0,0,2,2
81212,190,17730,23809;23952,49275,0,0,0,2,2
81213,190,17731,23383;23391,49275,0,0,0,2,2
81214,190,17732,23238,49275,0,0,0,1,1
81215,190,17733,23164;23491,49275,0,0,0,2,2
81216,190,17734,24224,49275,0,0,0,1,1
81217,190,17735,23516;23675,49275,0,0,0,2,2
81218,190,17736,23916,49275,0,0,0,1,1
81219,190,17737,27670;27778;30329;30509,49275,0,2,2,0,4
81220,190,17738,23542,49275,0,0,0,1,1
81221,190,17739,23587;23614,49275,0,0,0,2,2
81222,190,17740,23590;23977,49275,0,0,0,2,2
81223,190,17741,23963,49275,0,0,0,1,1
81224,190,17742,23640;23771,49275,0,0,0,2,2
81225,190,17743,23310;23552,49275,0,0,0,2,2
81226,190,17744,23573;23630;26958,49275,0,0,1,2,3
81227,190,17745,23653,49275,0,0,0,1,1
81228,190,17746,23670,49275,0,0,0,1,1
81229,190,17748,23593;24111,49275,0,0,0,2,2
81230,190,17749,23309;23782,49275,0,0,0,2,2
81231,190,17751,23326;27576,49275,0,0,1,1,2
81232,190,17752,23762,49275,0,0,0,1,1
81233,190,17753,23797;23965;27364;29962;30484;30925,49275,1,2,1,2,6
81234,190,17756,23422;23820,49275,0,0,0,2,2
81235,190,17759,23609,49275,0,0,0,1,1
81236,190,17793,21996,49640,0,0,0,1,1
81237,190,17794,22110,49640,0,0,0,1,1
81238,190,17795,22193,49640,0,0,0,1,1
81239,190,17801,22517;23139,49640,0,0,0,2,2
81240,190,17802,22949,49640,0,0,0,1,1
81241,190,17803,22709,49640,0,0,0,1,1
81242,190,17806,22934,49640,0,0,0,1,1
81243,190,17807,22247;22816,49640,0,0,0,2,2
81244,190,17808,23055;23426,49640,0,0,0,2,2
81245,190,17809,23543;27443,49640,0,0,1,1,2
81246,190,17811,23196;23433,49640,0,0,0,2,2
81247,190,17812,23125,49640,0,0,0,1,1
81248,190,17813,23774;23947,49640,0,0,0,2,2
81249,190,17816,22932,49640,0,0,0,1,1
81250,190,17818,23335;23706,49640,0,0,0,2,2
81251,190,17819,23346,49640,0,0,0,1,1
81252,190,17822,23129,49640,0,0,0,1,1
81253,190,17823,23683,49640,0,0,0,1,1
81254,190,17825,23983,49640,0,0,0,1,1
81255,190,17826,23588;23673,49640,0,0,0,2,2
81256,190,17827,23664;23827,49640,0,0,0,2,2
81257,190,17829,23446;23870,49640,0,0,0,2,2
81258,190,17831,23677,49640,0,0,0,1,1
81259,190,17832,23756,49640,0,0,0,1,1
81260,190,17833,23798;24208,49640,0,0,0,2,2
81261,190,17834,23801;23885,49640,0,0,0,2,2
81262,190,17835,23913;24118,49640,0,0,0,2,2
81263,190,17837,23878,49640,0,0,0,1,1
81264,190,17838,23909;24179,49640,0,0,0,2,2
81265,190,17839,23816;23926,49640,0,0,0,2,2
81266,190,17840,23518;23932,49640,0,0,0,2,2
81267,190,17841,23901;24241,49640,0,0,0,2,2
81268,190,17842,24031,49640,0,0,0,1,1
81269,190,17874,22570,50005,0,0,0,1,1
81270,190,17875,22116,50005,0,0,0,1,1
81271,190,17880,22774,50005,0,0,0,1,1
81272,190,17884,22943;23306,50005,0,0,0,2,2
81273,190,17886,23006;23197,50005,0,0,0,2,2
81274,190,17887,23685,50005,0,0,0,1,1
81275,190,17890,22959;23092,50005,0,0,0,2,2
81276,190,17891,23221;23450,50005,0,0,0,2,2
81277,190,17892,22905,50005,0,0,0,1,1
81278,190,17894,23624;23626,50005,0,0,0,2,2
81279,190,17895,23750,50005,0,0,0,1,1
81280,190,17896,23880,50005,0,0,0,1,1
81281,190,17897,23381,50005,0,0,0,1,1
81282,190,17899,23933,50005,0,0,0,1,1
81283,190,17900,23284,50005,0,0,0,1,1
81284,190,17903,23824,50005,0,0,0,1,1
81285,190,17905,23519,50005,0,0,0,1,1
81286,190,17906,23758,50005,0,0,0,1,1
81287,190,17907,23535;23908,50005,0,0,0,2,2
81288,190,17908,23547;27046,50005,0,0,1,1,2
81289,190,17909,23657,50005,0,0,0,1,1
81290,190,17910,23964,50005,0,0,0,1,1
81291,190,17911,23582;23702,50005,0,0,0,2,2
81292,190,17912,23799,50005,0,0,0,1,1
81293,190,17913,23636;23960,50005,0,0,0,2,2
81294,190,17914,23287;23671,50005,0,0,0,2,2
81295,190,17915,23431;23900,50005,0,0,0,2,2
81296,190,17916,24029,50005,0,0,0,1,1
81297,190,17917,24248,50005,0,0,0,1,1
81298,190,17918,23773,50005,0,0,0,1,1
81299,190,17919,23777;23887,50005,0,0,0,2,2
81300,190,17920,23783,50005,0,0,0,1,1
81301,190,17922,23802,50005,0,0,0,1,1
81302,190,17923,24152,50005,0,0,0,1,1
81303,190,17924,23687;23826,50005,0,0,0,2,2
81304,190,17925,23832;23982,50005,0,0,0,2,2
81305,190,17926,23619;23851,50005,0,0,0,2,2
81306,190,17927,24044,50005,0,0,0,1,1
81307,190,17928,23978;24226,50005,0,0,0,2,2
81308,190,17930,24221,50005,0,0,0,1,1
81309,190,17931,24100;24277,50005,0,0,0,2,2
81310,190,17932,23276;23954,50005,0,0,0,2,2
81311,190,17934,23654;23969,50005,0,0,0,2,2
81312,190,17935,23866,50005,0,0,0,1,1
81313,190,17937,23990;24348,50005,0,0,0,2,2
81314,190,17938,23995,50005,0,0,0,1,1
81315,190,17939,23917,50005,0,0,0,1,1
81316,190,17940,23748;24016,50005,0,0,0,2,2
81317,190,17942,24030;24266,50005,0,0,0,2,2
81318,190,17944,23544;24008,50005,0,0,0,2,2
81319,190,17945,23976;24280,50005,0,0,0,2,2
81320,190,17946,24078;24108,50005,0,0,0,2,2
81321,190,17947,23981;24083,50005,0,0,0,2,2
81322,190,17991,22613;22968,50370,0,0,0,2,2
81323,190,17995,22930;23224,50370,0,0,0,2,2
81324,190,17998,23251;23483,50370,0,0,0,2,2
81325,190,18001,23298,50370,0,0,0,1,1
81326,190,18002,23246;23563,50370,0,0,0,2,2
81327,190,18004,23285,50370,0,0,0,1,1
81328,190,18007,23788,50370,0,0,0,1,1
81329,190,18009,23864,50370,0,0,0,1,1
81330,190,18011,23448,50370,0,0,0,1,1
81331,190,18013,23462,50370,0,0,0,1,1
81332,190,18014,23416,50370,0,0,0,1,1
81333,190,18017,23760,50370,0,0,0,1,1
81334,190,18018,23532,50370,0,0,0,1,1
81335,190,18019,23182;23646,50370,0,0,0,2,2
81336,190,18020,23540,50370,0,0,0,1,1
81337,190,18022,23534;23608,50370,0,0,0,2,2
81338,190,18023,24003,50370,0,0,0,1,1
81339,190,18025,23763,50370,0,0,0,1,1
81340,190,18026,23487;23715,50370,0,0,0,2,2
81341,190,18027,23920,50370,0,0,0,1,1
81342,190,18029,23833;24228,50370,0,0,0,2,2
81343,190,18030,24084,50370,0,0,0,1,1
81344,190,18031,23844,50370,0,0,0,1,1
81345,190,18033,23425;23867,50370,0,0,0,2,2
81346,190,18034,23469;23868,50370,0,0,0,2,2
81347,190,18035,24202,50370,0,0,0,1,1
81348,190,18039,23980;24285,50370,0,0,0,2,2
81349,190,18040,24214,50370,0,0,0,1,1
81350,190,18041,24010;24097,50370,0,0,0,2,2
81351,190,18042,24289,50370,0,0,0,1,1
81352,190,18043,23971;24039,50370,0,0,0,2,2
81353,190,18045,24047;27583,50370,0,0,1,1,2
81354,190,18046,24116;24460,50370,0,0,0,2,2
81355,190,18047,23860;24160,50370,0,0,0,2,2
81356,190,18048,24033;24172,50370,0,0,0,2,2
81357,190,18049,24155;24181,50370,0,0,0,2,2
81358,190,18051,24360;24368,50370,0,0,0,2,2
81359,190,18085,23210,50735,0,0,0,1,1
81360,190,18091,23004;23208,50735,0,0,0,2,2
81361,190,18094,23118,50735,0,0,0,1,1
81362,190,18096,23204;23845,50735,0,0,0,2,2
81363,190,18098,23236,50735,0,0,0,1,1
81364,190,18099,23207,50735,0,0,0,1,1
81365,190,18101,23392,50735,0,0,0,1,1
81366,190,18103,23862;23955,50735,0,0,0,2,2
81367,190,18105,23560;23814,50735,0,0,0,2,2
81368,190,18108,24169,50735,0,0,0,1,1
81369,190,18109,23105;23800,50735,0,0,0,2,2
81370,190,18111,23610;23757;26574;29301,50735,0,0,2,2,4
81371,190,18112,23500,50735,0,0,0,1,1
81372,190,18113,23317;23714,50735,0,0,0,2,2
81373,190,18114,23765,50735,0,0,0,1,1
81374,190,18115,23494,50735,0,0,0,1,1
81375,190,18118,24338,50735,0,0,0,1,1
81376,190,18120,23945,50735,0,0,0,1,1
81377,190,18121,23727;23967,50735,0,0,0,2,2
81378,190,18122,24006,50735,0,0,0,1,1
81379,190,18123,24026;24164;27779;30330;30590,50735,0,2,1,2,5
81380,190,18124,23883,50735,0,0,0,1,1
81381,190,18125,23338,50735,0,0,0,1,1
81382,190,18126,23935;24098,50735,0,0,0,2,2
81383,190,18127,24104;24458,50735,0,0,0,2,2
81384,190,18128,24130;24282;28565,50735,0,0,1,2,3
81385,190,18129,23668;24072,50735,0,0,0,2,2
81386,190,18131,26877;27293;29694;30216;30734,50735,1,2,2,0,5
81387,190,18132,23888;24191,50735,0,0,0,2,2
81388,190,18158,21113;21223,51100,0,0,0,2,2
81389,190,18161,22765,51100,0,0,0,1,1
81390,190,18163,22105,51100,0,0,0,1,1
81391,190,18172,22466,51100,0,0,0,1,1
81392,190,18174,22575;22675,51100,0,0,0,2,2
81393,190,18175,23190;23367,51100,0,0,0,2,2
81394,190,18183,23057;23201,51100,0,0,0,2,2
81395,190,18188,23902,51100,0,0,0,1,1
81396,190,18189,23436,51100,0,0,0,1,1
81397,190,18190,23477;23594,51100,0,0,0,2,2
81398,190,18191,23497,51100,0,0,0,1,1
81399,190,18192,23334;23527,51100,0,0,0,2,2
81400,190,18193,23443;23530,51100,0,0,0,2,2
81401,190,18194,23720,51100,0,0,0,1,1
81402,190,18196,23622,51100,0,0,0,1,1
81403,190,18198,23793,51100,0,0,0,1,1
81404,190,18199,24080;24162,51100,0,0,0,2,2
81405,190,18201,24352;27788,51100,0,0,1,1,2
81406,190,18202,23600;23853,51100,0,0,0,2,2
81407,190,18203,23857,51100,0,0,0,1,1
81408,190,18204,24376,51100,0,0,0,1,1
81409,190,18205,23950,51100,0,0,0,1,1
81410,190,18206,23514;23953,51100,0,0,0,2,2
81411,190,18207,23972,51100,0,0,0,1,1
81412,190,18210,24332;24336;28370,51100,0,0,1,2,3
81413,190,18211,24081,51100,0,0,0,1,1
81414,190,18213,24038,51100,0,0,0,1,1
81415,190,18214,24212;24291,51100,0,0,0,2,2
81416,190,18217,24187,51100,0,0,0,1,1
81417,190,18218,24283,51100,0,0,0,1,1
81418,190,18219,23994;24218,51100,0,0,0,2,2
81419,190,18220,24193,51100,0,0,0,1,1
81420,190,18223,23725;24211,51100,0,0,0,2,2
81421,190,18224,24216;24577,51100,0,0,0,2,2
81422,190,18225,24327,51100,0,0,0,1,1
81423,190,18226,24278;24290,51100,0,0,0,2,2
81424,190,18229,24303,51100,0,0,0,1,1
81425,190,18230,24324;24500,51100,0,0,0,2,2
81426,190,18233,24337,51100,0,0,0,1,1
81427,190,18234,23991,51100,0,0,0,1,1
81428,190,18236,23869;24363,51100,0,0,0,2,2
81429,190,18258,21819;21965,51465,0,0,0,2,2
81430,190,18261,22184,51465,0,0,0,1,1
81431,190,18262,22057,51465,0,0,0,1,1
81432,190,18264,22028,51465,0,0,0,1,1
81433,190,18266,23172,51465,0,0,0,1,1
81434,190,18276,23203,51465,0,0,0,1,1
81435,190,18279,23691;23834,51465,0,0,0,2,2
81436,190,18280,23466;23817;28174,51465,0,0,1,2,3
81437,190,18281,23721,51465,0,0,0,1,1
81438,190,18282,23634;23803,51465,0,0,0,2,2
81439,190,18283,23837,51465,0,0,0,1,1
81440,190,18284,23327;23595,51465,0,0,0,2,2
81441,190,18286,23665,51465,0,0,0,1,1
81442,190,18287,23365;23669,51465,0,0,0,2,2
81443,190,18288,23307,51465,0,0,0,1,1
81444,190,18289,23815,51465,0,0,0,1,1
81445,190,18290,23270;23481,51465,0,0,0,2,2
81446,190,18291,23761,51465,0,0,0,1,1
81447,190,18292,23787,51465,0,0,0,1,1
81448,190,18293,23794;23899,51465,0,0,0,2,2
81449,190,18295,23876,51465,0,0,0,1,1
81450,190,18296,24168,51465,0,0,0,1,1
81451,190,18297,23790;24020,51465,0,0,0,2,2
81452,190,18298,24023;24432,51465,0,0,0,2,2
81453,190,18301,24463,51465,0,0,0,1,1
81454,190,18302,24068,51465,0,0,0,1,1
81455,190,18304,24297;24398,51465,0,0,0,2,2
81456,190,18305,23693;23884,51465,0,0,0,2,2
81457,190,18306,24428,51465,0,0,0,1,1
81458,190,18307,24144,51465,0,0,0,1,1
81459,190,18308,24174,51465,0,0,0,1,1
81460,190,18309,24182;24213,51465,0,0,0,2,2
81461,190,18310,24574;28085;28198;30439;31134,51465,1,1,2,1,5
81462,190,18311,24129;24322,51465,0,0,0,2,2
81463,190,18312,24293,51465,0,0,0,1,1
81464,190,18313,24295;24320,51465,0,0,0,2,2
81465,190,18314,24350,51465,0,0,0,1,1
81466,190,18317,24090;24533,51465,0,0,0,2,2
81467,190,18318,24408,51465,0,0,0,1,1
81468,190,18319,23996;24420,51465,0,0,0,2,2
81469,190,18320,24436,51465,0,0,0,1,1
81470,190,18321,24457;24477,51465,0,0,0,2,2
81471,190,18352,22391,51830,0,0,0,1,1
81472,190,18361,23278,51830,0,0,0,1,1
81473,190,18362,23364;23444,51830,0,0,0,2,2
81474,190,18366,24103,51830,0,0,0,1,1
81475,190,18367,24159;27480,51830,0,0,1,1,2
81476,190,18368,27565,51830,0,0,1,0,1
81477,190,18369,23617;23656,51830,0,0,0,2,2
81478,190,18370,24166;24173,51830,0,0,0,2,2
81479,190,18371,23713;24302,51830,0,0,0,2,2
81480,190,18373,23240;23733,51830,0,0,0,2,2
81481,190,18374,23805;24205,51830,0,0,0,2,2
81482,190,18375,24227,51830,0,0,0,1,1
81483,190,18376,23738,51830,0,0,0,1,1
81484,190,18377,23447;23898,51830,0,0,0,2,2
81485,190,18378,23998;24299;27464,51830,0,0,1,2,3
81486,190,18379,24310,51830,0,0,0,1,1
81487,190,18380,24356,51830,0,0,0,1,1
81488,190,18381,24394;24539;28084,51830,0,0,1,2,3
81489,190,18383,24066;26597,51830,0,0,1,1,2
81490,190,18384,24307;24656;27898;29977;30954,51830,1,1,1,2,5
81491,190,18385,24086;24122,51830,0,0,0,2,2
81492,190,18386,24125;24450;28849,51830,0,0,1,2,3
81493,190,18387,24180;24318;28369,51830,0,0,1,2,3
81494,190,18388,24190;24192,51830,0,0,0,2,2
81495,190,18389,24076;24200,51830,0,0,0,2,2
81496,190,18390,24328;24643,51830,0,0,0,2,2
81497,190,18392,24276;24620,51830,0,0,0,2,2
81498,190,18394,24629,51830,0,0,0,1,1
81499,190,18395,24306;24323,51830,0,0,0,2,2
81500,190,18396,24788,51830,0,0,0,1,1
81501,190,18397,24341;24396,51830,0,0,0,2,2
81502,190,18398,24406,51830,0,0,0,1,1
81503,190,18399,24439,51830,0,0,0,1,1
81504,190,18400,24854,51830,0,0,0,1,1
81505,190,18401,24452;24718;28202,51830,0,0,1,2,3
81506,190,18402,24281,51830,0,0,0,1,1
81507,190,18403,24850;24960,51830,0,0,1,1,2
81508,190,18404,24507;24632,51830,0,0,0,2,2
81509,190,18405,24526,51830,0,0,0,1,1
81510,190,18406,24313;24646,51830,0,0,0,2,2
81511,190,18407,24530;24626,51830,0,0,0,2,2
81512,190,18408,24142;24534,51830,0,0,0,2,2
81513,190,18409,24485;24548,51830,0,0,0,2,2
81514,190,18410,24549;24797,51830,0,0,0,2,2
81515,190,18411,24404;24553,51830,0,0,0,2,2
81516,190,18436,21927,52195,0,0,0,1,1
81517,190,18448,22897;23356,52195,0,0,0,2,2
81518,190,18450,23021;23109,52195,0,0,0,2,2
81519,190,18452,23649;24073,52195,0,0,0,2,2
81520,190,18453,23212;23743,52195,0,0,0,2,2
81521,190,18458,23704;23999,52195,0,0,0,2,2
81522,190,18459,24153,52195,0,0,0,1,1
81523,190,18460,23569,52195,0,0,0,1,1
81524,190,18461,23979,52195,0,0,0,1,1
81525,190,18462,23325;23822,52195,0,0,0,2,2
81526,190,18463,24019;24087,52195,0,0,0,2,2
81527,190,18464,24469,52195,0,0,0,1,1
81528,190,18465,24361;27391,52195,0,0,1,1,2
81529,190,18467,24127;24292,52195,0,0,0,2,2
81530,190,18468,24165,52195,0,0,0,1,1
81531,190,18469,24203;28563,52195,0,0,1,1,2
81532,190,18470,24232;27088,52195,0,0,1,1,2
81533,190,18471,24234,52195,0,0,0,1,1
81534,190,18473,24246,52195,0,0,0,1,1
81535,190,18474,24255;28464,52195,0,0,1,1,2
81536,190,18475,24317;24580,52195,0,0,0,2,2
81537,190,18476,24235;24301,52195,0,0,0,2,2
81538,190,18477,24334;24410,52195,0,0,0,2,2
81539,190,18479,24370,52195,0,0,0,1,1
81540,190,18481,24126;24421,52195,0,0,0,2,2
81541,190,18482,24453,52195,0,0,0,1,1
81542,190,18484,24525,52195,0,0,0,1,1
81543,190,18485,24674;24793;28476,52195,0,0,1,2,3
81544,190,18486,24497,52195,0,0,0,1,1
81545,190,18488,24540,52195,0,0,0,1,1
81546,190,18489,24254,52195,0,0,0,1,1
81547,190,18490,24284;24551,52195,0,0,0,2,2
81548,190,18492,24660;24878;28680,52195,0,0,1,2,3
81549,190,18493,24739;24800,52195,0,0,0,2,2
81550,190,18494,24602;24608,52195,0,0,0,2,2
81551,190,18495,24609;24680,52195,0,0,0,2,2
81552,190,18496,24644;24849,52195,0,0,0,2,2
81553,190,18497,24613;25004,52195,0,0,1,1,2
81554,190,18498,24760;24906,52195,0,0,0,2,2
81555,190,18499,24513,52195,0,0,0,1,1
81556,190,18500,24651;24712,52195,0,0,0,2,2
81557,190,18501,24576;24652,52195,0,0,0,2,2
81558,190,18502,24300;24669,52195,0,0,0,2,2
81559,190,18503,24683;24961,52195,0,0,1,1,2
81560,190,18529,21768,52560,0,0,0,1,1
81561,190,18539,22432,52560,0,0,0,1,1
81562,190,18549,23565,52560,0,0,0,1,1
81563,190,18550,24260,52560,0,0,0,1,1
81564,190,18551,24131,52560,0,0,0,1,1
81565,190,18552,23567;23742,52560,0,0,0,2,2
81566,190,18554,23842;24388,52560,0,0,0,2,2
81567,190,18555,23686;23856,52560,0,0,0,2,2
81568,190,18557,23929;24440,52560,0,0,0,2,2
81569,190,18558,23811;23951,52560,0,0,0,2,2
81570,190,18560,24105;24156,52560,0,0,0,2,2
81571,190,18561,24107;24133,52560,0,0,0,2,2
81572,190,18562,24459;24607,52560,0,0,0,2,2
81573,190,18563,24502;28567,52560,0,0,1,1,2
81574,190,18564,24389,52560,0,0,0,1,1
81575,190,18565,23928;24231,52560,0,0,0,2,2
81576,190,18566,24803,52560,0,0,0,1,1
81577,190,18567,24340,52560,0,0,0,1,1
81578,190,18569,24400,52560,0,0,0,1,1
81579,190,18571,24510;24606,52560,0,0,0,2,2
81580,190,18572,24298;24417,52560,0,0,0,2,2
81581,190,18574,24115;24480,52560,0,0,0,2,2
81582,190,18575,24498,52560,0,0,0,1,1
81583,190,18576,24114;24499,52560,0,0,0,2,2
81584,190,18577,24330;24639,52560,0,0,0,2,2
81585,190,18578,24547;24600;27890;29432;30063;30428;30598,52560,0,3,2,2,7
81586,190,18579,24572,52560,0,0,0,1,1
81587,190,18580,24449;24586,52560,0,0,0,2,2
81588,190,18581,24128;24642;26819;29933;30186;30276,52560,0,3,1,2,6
81589,190,18582,24554;24661,52560,0,0,0,2,2
81590,190,18583,24617;24688,52560,0,0,0,2,2
81591,190,18584,24723;24897,52560,0,0,0,2,2
81592,190,18585,24392;24745;28289,52560,0,0,1,2,3
81593,190,18586,24801;24920;28762;31078,52560,1,0,2,1,4
81594,190,18587,24615,52560,0,0,0,1,1
81595,190,18588,24487;24818;28208;28759,52560,0,0,2,2,4
81596,190,18597,21474,52925,0,0,0,1,1
81597,190,18601,21711;21724,52925,0,0,0,2,2
81598,190,18605,22589,52925,0,0,0,1,1
81599,190,18606,22234,52925,0,0,0,1,1
81600,190,18607,22831;23059,52925,0,0,0,2,2
81601,190,18609,23147;23445,52925,0,0,0,2,2
81602,190,18611,23623,52925,0,0,0,1,1
81603,190,18615,23254;23628,52925,0,0,0,2,2
81604,190,18617,23597,52925,0,0,0,1,1
81605,190,18622,23638;24022,52925,0,0,0,2,2
81606,190,18623,24082,52925,0,0,0,1,1
81607,190,18626,24135,52925,0,0,0,1,1
81608,190,18627,23859,52925,0,0,0,1,1
81609,190,18631,23784,52925,0,0,0,1,1
81610,190,18632,23831;23948,52925,0,0,0,2,2
81611,190,18633,23611;23854,52925,0,0,0,2,2
81612,190,18634,24102;24249,52925,0,0,0,2,2
81613,190,18635,23807;23891,52925,0,0,0,2,2
81614,190,18636,23604;24250,52925,0,0,0,2,2
81615,190,18637,27982;28841,52925,0,0,2,0,2
81616,190,18639,23836;24028,52925,0,0,0,2,2
81617,190,18640,23808,52925,0,0,0,1,1
81618,190,18642,24007;24093,52925,0,0,0,2,2
81619,190,18645,24451,52925,0,0,0,1,1
81620,190,18647,23997;24175,52925,0,0,0,2,2
81621,190,18648,24591,52925,0,0,0,1,1
81622,190,18649,24046,52925,0,0,0,1,1
81623,190,18650,24184;24366,52925,0,0,0,2,2
81624,190,18651,24705;24830;27907,52925,0,0,1,2,3
81625,190,18653,24563,52925,0,0,0,1,1
81626,190,18654,24409,52925,0,0,0,1,1
81627,190,18655,24542,52925,0,0,0,1,1
81628,190,18656,24454;24521,52925,0,0,0,2,2
81629,190,18657,24455,52925,0,0,0,1,1
81630,190,18658,24730;24747,52925,0,0,0,2,2
81631,190,18659,24568;24693;28673;29529,52925,0,0,2,2,4
81632,190,18660,24143,52925,0,0,0,1,1
81633,190,18661,24731;24949,52925,0,0,1,1,2
81634,190,18662,24506,52925,0,0,0,1,1
81635,190,18663,24393;24523,52925,0,0,0,2,2
81636,190,18665,24535;24911,52925,0,0,0,2,2
81637,190,18667,24625;25051,52925,0,0,1,1,2
81638,190,18668,24627;24945,52925,0,0,1,1,2
81639,190,18669,25302;28774,52925,0,0,2,0,2
81640,190,18671,23890;24359,52925,0,0,0,2,2
81641,190,18672,24653;24972,52925,0,0,1,1,2
81642,190,18674,24727;25096,52925,0,0,1,1,2
81643,190,18676,24740,52925,0,0,0,1,1
81644,190,18677,24662;24778;27719,52925,0,0,1,2,3
81645,190,18678,24984;25151,52925,0,0,2,0,2
81646,190,18679,24395;24786,52925,0,0,0,2,2
81647,190,18681,24754;24804,52925,0,0,0,2,2
81648,190,18682,25045,52925,0,0,1,0,1
81649,190,18684,24668;24928,52925,0,0,1,1,2
81650,190,18685,24863,52925,0,0,0,1,1
81651,190,18686,24528;24978,52925,0,0,1,1,2
81652,190,18687,24709;24879,52925,0,0,0,2,2
81653,190,18688,24880;25208,52925,0,0,1,1,2
81654,190,18689,24985;24995,52925,0,0,2,0,2
81655,190,18690,24858;24888,52925,0,0,0,2,2
81656,190,18691,24650;24896,52925,0,0,0,2,2
81657,190,18692,24973,52925,0,0,1,0,1
81658,190,18693,24953;25098;28689,52925,0,0,3,0,3
81659,190,18728,23020,53290,0,0,0,1,1
81660,190,18734,23618;23858,53290,0,0,0,2,2
81661,190,18736,22896;23035,53290,0,0,0,2,2
81662,190,18737,23666,53290,0,0,0,1,1
81663,190,18743,24261,53290,0,0,0,1,1
81664,190,18744,23905;27359;29127,53290,0,0,2,1,3
81665,190,18745,23925,53290,0,0,0,1,1
81666,190,18747,23740;24005,53290,0,0,0,2,2
81667,190,18748,24011;24287,53290,0,0,0,2,2
81668,190,18749,24095,53290,0,0,0,1,1
81669,190,18750,23911;24426;28756,53290,0,0,1,2,3
81670,190,18751,24089,53290,0,0,0,1,1
81671,190,18752,23872,53290,0,0,0,1,1
81672,190,18753,24051,53290,0,0,0,1,1
81673,190,18754,23987;24189,53290,0,0,0,2,2
81674,190,18755,23922;24240,53290,0,0,0,2,2
81675,190,18756,24270;24636,53290,0,0,0,2,2
81676,190,18757,24325;24584,53290,0,0,0,2,2
81677,190,18760,24673,53290,0,0,0,1,1
81678,190,18761,24375,53290,0,0,0,1,1
81679,190,18762,24385;24536,53290,0,0,0,2,2
81680,190,18763,24391,53290,0,0,0,1,1
81681,190,18766,24335;24443,53290,0,0,0,2,2
81682,190,18767,24894;25008,53290,0,0,1,1,2
81683,190,18768,24702,53290,0,0,0,1,1
81684,190,18769,24515;24559,53290,0,0,0,2,2
81685,190,18770,24757;25040,53290,0,0,1,1,2
81686,190,18771,24161,53290,0,0,0,1,1
81687,190,18772,24618;24835,53290,0,0,0,2,2
81688,190,18773,24634,53290,0,0,0,1,1
81689,190,18774,24665;24840,53290,0,0,0,2,2
81690,190,18776,24682;25080,53290,0,0,1,1,2
81691,190,18777,24573;24998,53290,0,0,1,1,2
81692,190,18778,24514;24699,53290,0,0,0,2,2
81693,190,18779,24677;24711,53290,0,0,0,2,2
81694,190,18780,24698;24713,53290,0,0,0,2,2
81695,190,18781,24567;24719,53290,0,0,0,2,2
81696,190,18782,24736;25005,53290,0,0,1,1,2
81697,190,18783,24207;24685,53290,0,0,0,2,2
81698,190,18784,24761;24874,53290,0,0,0,2,2
81699,190,18785,25043;25779;27808,53290,0,0,3,0,3
81700,190,18786,24886,53290,0,0,0,1,1
81701,190,18787,24647;24764,53290,0,0,0,2,2
81702,190,18788,24812;28385,53290,0,0,1,1,2
81703,190,18789,24992;25121,53290,0,0,2,0,2
81704,190,18790,24658;24833,53290,0,0,0,2,2
81705,190,18791,25182;25216;29130,53290,0,0,3,0,3
81706,190,18792,25180,53290,0,0,1,0,1
81707,190,18793,24541;24789,53290,0,0,0,2,2
81708,190,18794,25260,53290,0,0,1,0,1
81709,190,18795,24486;24909,53290,0,0,0,2,2
81710,190,18796,24964,53290,0,0,1,0,1
81711,190,18797,24977,53290,0,0,1,0,1
81712,190,18798,24990;25199,53290,0,0,2,0,2
81713,190,18799,24958;25001,53290,0,0,2,0,2
81714,190,18800,24980,53290,0,0,1,0,1
81715,190,18811,21501,53655,0,0,0,1,1
81716,190,18827,22664,53655,0,0,0,1,1
81717,190,18830,23303;23438,53655,0,0,0,2,2
81718,190,18831,23290;23663,53655,0,0,0,2,2
81719,190,18834,23508;23959,53655,0,0,0,2,2
81720,190,18835,23667,53655,0,0,0,1,1
81721,190,18836,23700,53655,0,0,0,1,1
81722,190,18841,23936,53655,0,0,0,1,1
81723,190,18842,23437;24000,53655,0,0,0,2,2
81724,190,18843,23772;24009,53655,0,0,0,2,2
81725,190,18844,24147,53655,0,0,0,1,1
81726,190,18846,23974;24505,53655,0,0,0,2,2
81727,190,18849,24305;24561;29036,53655,0,0,1,2,3
81728,190,18850,24635;25003,53655,0,0,1,1,2
81729,190,18851,24419;24783;28292,53655,0,0,1,2,3
81730,190,18853,24429;24638,53655,0,0,0,2,2
81731,190,18854,24472;24624,53655,0,0,0,2,2
81732,190,18855,24508;24770,53655,0,0,0,2,2
81733,190,18856,24483;24601,53655,0,0,0,2,2
81734,190,18857,24446;24589,53655,0,0,0,2,2
81735,190,18859,24365;24741,53655,0,0,0,2,2
81736,190,18860,25187,53655,0,0,1,0,1
81737,190,18861,24495;24717,53655,0,0,0,2,2
81738,190,18862,24748;24796,53655,0,0,0,2,2
81739,190,18863,23812;24753,53655,0,0,0,2,2
81740,190,18864,25088;25153,53655,0,0,2,0,2
81741,190,18865,24383;25010;28684,53655,0,0,2,1,3
81742,190,18866,24722;24829,53655,0,0,0,2,2
81743,190,18867,24861;27916,53655,0,0,1,1,2
81744,190,18868,24648;25166,53655,0,0,1,1,2
81745,190,18870,24877;24914,53655,0,0,0,2,2
81746,190,18871,25156,53655,0,0,1,0,1
81747,190,18872,24684;24931,53655,0,0,1,1,2
81748,190,18874,24904;24946,53655,0,0,1,1,2
81749,190,18875,25110,53655,0,0,1,0,1
81750,190,18876,24963;25168,53655,0,0,2,0,2
81751,190,18877,24989,53655,0,0,1,0,1
81752,190,18878,25142;25221;28947,53655,0,0,3,0,3
81753,190,18879,24820;25332,53655,0,0,1,1,2
81754,190,18880,25022;25200;29328,53655,0,0,3,0,3
81755,190,18881,25024;27727,53655,0,0,2,0,2
81756,190,18882,25276,53655,0,0,1,0,1
81757,190,18883,25155,53655,0,0,1,0,1
81758,190,18884,27835;28312;29031,53655,0,0,3,0,3
81759,190,18885,24852;25071,53655,0,0,1,1,2
81760,190,18886,25283,53655,0,0,1,0,1
81761,190,18888,25091;25178;28587,53655,0,0,3,0,3
81762,190,18889,25104;25280,53655,0,0,2,0,2
81763,190,18897,21346;21633,54020,0,0,0,2,2
81764,190,18909,21798,54020,0,0,0,1,1
81765,190,18912,22490,54020,0,0,0,1,1
81766,190,18922,23156;23586,54020,0,0,0,2,2
81767,190,18925,22779,54020,0,0,0,1,1
81768,190,18931,23724,54020,0,0,0,1,1
81769,190,18932,23461;23695,54020,0,0,0,2,2
81770,190,18937,23924;24060,54020,0,0,0,2,2
81771,190,18940,24344,54020,0,0,0,1,1
81772,190,18941,24119;24124,54020,0,0,0,2,2
81773,190,18942,24343;24364,54020,0,0,0,2,2
81774,190,18943,24204,54020,0,0,0,1,1
81775,190,18945,24197;24456,54020,0,0,0,2,2
81776,190,18946,24059;24274,54020,0,0,0,2,2
81777,190,18947,24308,54020,0,0,0,1,1
81778,190,18948,24239,54020,0,0,0,1,1
81779,190,18949,24387;24537,54020,0,0,0,2,2
81780,190,18950,24496;24545,54020,0,0,0,2,2
81781,190,18951,24479;27692,54020,0,0,1,1,2
81782,190,18952,24599;25141,54020,0,0,1,1,2
81783,190,18953,24881;25042,54020,0,0,1,1,2
81784,190,18954,24926;25122;28577,54020,0,0,3,0,3
81785,190,18955,24689,54020,0,0,0,1,1
81786,190,18956,24692;25055,54020,0,0,1,1,2
81787,190,18957,25030;25089,54020,0,0,2,0,2
81788,190,18958,24401;24703;28382,54020,0,0,1,2,3
81789,190,18959,24575;24935,54020,0,0,1,1,2
81790,190,18960,24708;24743;28097;28573,54020,0,0,2,2,4
81791,190,18961,24610;24887,54020,0,0,0,2,2
81792,190,18962,24844;28941;30909,54020,1,0,1,1,3
81793,190,18963,24873;24947,54020,0,0,1,1,2
81794,190,18964,24952;25244,54020,0,0,2,0,2
81795,190,18967,24971;25157,54020,0,0,2,0,2
81796,190,18969,25210,54020,0,0,1,0,1
81797,190,18970,24982;24994,54020,0,0,2,0,2
81798,190,18971,24566;24884;29128,54020,0,0,1,2,3
81799,190,18972,25324;25494;28504,54020,0,0,3,0,3
81800,190,18973,24787;25015,54020,0,0,1,1,2
81801,190,18974,24781;25020;28943,54020,0,0,2,1,3
81802,190,18975,24831;25056,54020,0,0,1,1,2
81803,190,18976,24735;25073,54020,0,0,1,1,2
81804,190,18977,24587;24918,54020,0,0,1,1,2
81805,190,18978,25090;25127,54020,0,0,2,0,2
81806,190,18979,25128,54020,0,0,1,0,1
81807,190,18980,25461;25637,54020,0,0,2,0,2
81808,190,18981,24817;25074,54020,0,0,1,1,2
81809,190,18982,25354,54020,0,0,1,0,1
81810,190,18983,25027;25193;28231,54020,0,0,3,0,3
81811,190,18984,25203;25222,54020,0,0,2,0,2
81812,190,18985,25206,54020,0,0,1,0,1
81813,190,18999,21727,54385,0,0,0,1,1
81814,190,19000,21971,54385,0,0,0,1,1
81815,190,19004,22998,54385,0,0,0,1,1
81816,190,19016,23214,54385,0,0,0,1,1
81817,190,19019,23520,54385,0,0,0,1,1
81818,190,19022,23404;23718,54385,0,0,0,2,2
81819,190,19025,23536;23819,54385,0,0,0,2,2
81820,190,19034,24106;24304,54385,0,0,0,2,2
81821,190,19036,24063;24412,54385,0,0,0,2,2
81822,190,19037,24441;24582,54385,0,0,0,2,2
81823,190,19038,24447;24867,54385,0,0,0,2,2
81824,190,19039,24676,54385,0,0,0,1,1
81825,190,19042,24571,54385,0,0,0,1,1
81826,190,19044,25038,54385,0,0,1,0,1
81827,190,19045,24925;25093;28481,54385,0,0,3,0,3
81828,190,19046,24042,54385,0,0,0,1,1
81829,190,19048,25152,54385,0,0,1,0,1
81830,190,19049,24765;24823,54385,0,0,0,2,2
81831,190,19050,24824;24882,54385,0,0,0,2,2
81832,190,19051,24777;24839,54385,0,0,0,2,2
81833,190,19052,24262;24706,54385,0,0,0,2,2
81834,190,19054,24875;25430,54385,0,0,1,1,2
81835,190,19056,24922,54385,0,0,1,0,1
81836,190,19057,25037,54385,0,0,1,0,1
81837,190,19058,24988;28486;30895,54385,1,0,2,0,3
81838,190,19059,24969;25262,54385,0,0,2,0,2
81839,190,19060,24865,54385,0,0,0,1,1
81840,190,19061,25132;25201,54385,0,0,2,0,2
81841,190,19062,25067;25158,54385,0,0,2,0,2
81842,190,19063,25119;25163,54385,0,0,2,0,2
81843,190,19064,24921;25169,54385,0,0,2,0,2
81844,190,19065,25521;25552,54385,0,0,2,0,2
81845,190,19066,25477;25556;28865,54385,0,0,3,0,3
81846,190,19067,25069;25543;29435,54385,0,0,3,0,3
81847,190,19069,25097;25183,54385,0,0,2,0,2
81848,190,19071,25299;25478;28963;30910,54385,1,0,3,0,4
81849,190,19084,21986,54750,0,0,0,1,1
81850,190,19098,23331,54750,0,0,0,1,1
81851,190,19108,23550,54750,0,0,0,1,1
81852,190,19110,23841,54750,0,0,0,1,1
81853,190,19111,23578;23749,54750,0,0,0,2,2
81854,190,19112,24264,54750,0,0,0,1,1
81855,190,19113,23961;24492,54750,0,0,0,2,2
81856,190,19116,23852;24091,54750,0,0,0,2,2
81857,190,19118,24219,54750,0,0,0,1,1
81858,190,19119,24061;24071,54750,0,0,0,2,2
81859,190,19120,24407;24594,54750,0,0,0,2,2
81860,190,19121,24776,54750,0,0,0,1,1
81861,190,19123,24269;24578,54750,0,0,0,2,2
81862,190,19126,24468;24872,54750,0,0,0,2,2
81863,190,19128,24273;24552;28195,54750,0,0,1,2,3
81864,190,19132,24790,54750,0,0,0,1,1
81865,190,19133,24272;24752,54750,0,0,0,2,2
81866,190,19135,24597;24869,54750,0,0,0,2,2
81867,190,19137,25215;25229,54750,0,0,2,0,2
81868,190,19138,25220;25532;28964,54750,0,0,3,0,3
81869,190,19140,24744;24962,54750,0,0,1,1,2
81870,190,19141,25349;25432;29136;29334,54750,0,0,4,0,4
81871,190,19142,24827;25019,54750,0,0,1,1,2
81872,190,19143,25410;28607,54750,0,0,2,0,2
81873,190,19144,25245;25645;29142;29714;31088,54750,1,1,3,0,5
81874,190,19145,25370,54750,0,0,1,0,1
81875,190,19146,25569;25599,54750,0,0,2,0,2
81876,190,19147,24915;25282,54750,0,0,1,1,2
81877,190,19148,25084;25099,54750,0,0,2,0,2
81878,190,19149,25086,54750,0,0,1,0,1
81879,190,19150,24938;25117,54750,0,0,2,0,2
81880,190,19151,24876;25131,54750,0,0,1,1,2
81881,190,19152,25448;25516,54750,0,0,2,0,2
81882,190,19153,24806;25146,54750,0,0,1,1,2
81883,190,19154,25149;25470;28335,54750,0,0,3,0,3
81884,190,19155,25059;25165;28686,54750,0,0,3,0,3
81885,190,19156,25174;25271,54750,0,0,2,0,2
81886,190,19157,25039;25172,54750,0,0,2,0,2
81887,190,19158,24832;25189;28229,54750,0,0,2,1,3
81888,190,19159,25321;25682;29055;29243,54750,0,0,4,0,4
81889,190,19160,25230;25424;28704,54750,0,0,3,0,3
81890,190,19161,25256;25434,54750,0,0,2,0,2
81891,190,19162,25295;25717;28952,54750,0,0,3,0,3
81892,190,19164,25247;25373,54750,0,0,2,0,2
81893,190,19165,25402;25652;29532,54750,0,0,3,0,3
81894,190,19166,25164;25303,54750,0,0,2,0,2
81895,190,19167,25413,54750,0,0,1,0,1
81896,190,19168,25313;25611,54750,0,0,2,0,2
81897,190,19169,25314,54750,0,0,1,0,1
81898,190,19170,25484;29336,54750,0,0,2,0,2
81899,190,19171,28802;29168,54750,0,0,2,0,2
81900,190,19172,25334;25387,54750,0,0,2,0,2
81901,190,19173,25340;25719;29244,54750,0,0,3,0,3
81902,190,19174,25551;25623;29138,54750,0,0,3,0,3
81903,190,19175,25365;25549,54750,0,0,2,0,2
81904,190,19176,25376;28778,54750,0,0,2,0,2
81905,190,19177,25573;25638,54750,0,0,2,0,2
81906,190,19179,25398,54750,0,0,1,0,1
81907,190,19180,25395,54750,0,0,1,0,1
81908,190,19187,21680,55115,0,0,0,1,1
81909,190,19205,23191,55115,0,0,0,1,1
81910,190,19211,23930,55115,0,0,0,1,1
81911,190,19213,24101,55115,0,0,0,1,1
81912,190,19219,23958,55115,0,0,0,1,1
81913,190,19220,24054,55115,0,0,0,1,1
81914,190,19221,24593;24782,55115,0,0,0,2,2
81915,190,19222,24950;25064,55115,0,0,2,0,2
81916,190,19223,24424;24425,55115,0,0,0,2,2
81917,190,19224,24373;24430;27790,55115,0,0,1,2,3
81918,190,19226,24544;24564,55115,0,0,0,2,2
81919,190,19227,24592;24733,55115,0,0,0,2,2
81920,190,19228,25306;28776;29619,55115,0,1,2,0,3
81921,190,19232,24659;25286;28501;28601;30794;30985,55115,2,0,3,1,6
81922,190,19233,24504;24742,55115,0,0,0,2,2
81923,190,19234,28090;28478,55115,0,0,2,0,2
81924,190,19235,25266,55115,0,0,1,0,1
81925,190,19236,24667,55115,0,0,0,1,1
81926,190,19239,25143;25428;28331,55115,0,0,3,0,3
81927,190,19240,24842;25050,55115,0,0,1,1,2
81928,190,19241,24848;24853,55115,0,0,0,2,2
81929,190,19242,24892,55115,0,0,0,1,1
81930,190,19243,24937,55115,0,0,1,0,1
81931,190,19245,24461;24951,55115,0,0,1,1,2
81932,190,19246,24968;25445,55115,0,0,2,0,2
81933,190,19247,24901;25118;29129,55115,0,0,2,1,3
81934,190,19248,25036;25213;29040,55115,0,0,3,0,3
81935,190,19249,25062;25170,55115,0,0,2,0,2
81936,190,19250,24794;25108,55115,0,0,1,1,2
81937,190,19251,25490,55115,0,0,1,0,1
81938,190,19253,25102;25204,55115,0,0,2,0,2
81939,190,19254,25212;25651,55115,0,0,2,0,2
81940,190,19255,25252;25631,55115,0,0,2,0,2
81941,190,19256,25264;25665,55115,0,0,2,0,2
81942,190,19257,25612,55115,0,0,1,0,1
81943,190,19258,25502;25681;28798;29242;31008,55115,1,0,4,0,5
81944,190,19259,25632;25817,55115,0,0,2,0,2
81945,190,19260,25393;25656;28881,55115,0,0,3,0,3
81946,190,19261,25437;25671,55115,0,0,2,0,2
81947,190,19262,25348;28967;31001,55115,1,0,2,0,3
81948,190,19263,21237,55480,0,0,0,1,1
81949,190,19277,22773,55480,0,0,0,1,1
81950,190,19283,23275;23374,55480,0,0,0,2,2
81951,190,19288,23302;23558,55480,0,0,0,2,2
81952,190,19291,23897;24315,55480,0,0,0,2,2
81953,190,19293,24186;24333,55480,0,0,0,2,2
81954,190,19295,23875;24148,55480,0,0,0,2,2
81955,190,19296,24149;24695,55480,0,0,0,2,2
81956,190,19297,24465,55480,0,0,0,1,1
81957,190,19298,24201,55480,0,0,0,1,1
81958,190,19302,24691;24798,55480,0,0,0,2,2
81959,190,19303,24411;24756;28474,55480,0,0,1,2,3
81960,190,19304,24704;24707;28850,55480,0,0,1,2,3
81961,190,19305,24027;24215;27866;30335;30758;30850,55480,2,1,1,2,6
81962,190,19306,24517;24527,55480,0,0,0,2,2
81963,190,19307,24924;25263,55480,0,0,2,0,2
81964,190,19308,24619;24655;28760,55480,0,0,1,2,3
81965,190,19309,24805;27911;30854,55480,1,0,1,1,3
81966,190,19310,24546;24821,55480,0,0,0,2,2
81967,190,19311,24883,55480,0,0,0,1,1
81968,190,19312,24891;25251,55480,0,0,1,1,2
81969,190,19313,25072,55480,0,0,1,0,1
81970,190,19314,24710;24954,55480,0,0,1,1,2
81971,190,19315,24728;25000,55480,0,0,1,1,2
81972,190,19316,24762;25018;28397;30788;30890,55480,2,0,2,1,5
81973,190,19317,25031,55480,0,0,1,0,1
81974,190,19321,25006;25177;27535;29881;30145;30496;30831,55480,1,3,3,0,7
81975,190,19322,25186;25188,55480,0,0,2,0,2
81976,190,19323,25258;25362,55480,0,0,2,0,2
81977,190,19324,25259;25330,55480,0,0,2,0,2
81978,190,19325,25272;25443,55480,0,0,2,0,2
81979,190,19326,25296;25298,55480,0,0,2,0,2
81980,190,19327,25209;25346;28418,55480,0,0,3,0,3
81981,190,19328,25888;25922,55480,0,0,2,0,2
81982,190,19329,25198;25275,55480,0,0,2,0,2
81983,190,19330,25415;25641;28877;30999,55480,1,0,3,0,4
81984,190,19331,25253;25476,55480,0,0,2,0,2
81985,190,19332,25707;25715,55480,0,0,2,0,2
81986,190,19333,25288;25488,55480,0,0,2,0,2
81987,190,19334,25489;25523;29051,55480,0,0,3,0,3
81988,190,19335,25544;25873;28808,55480,0,0,3,0,3
81989,190,19336,25427;25515,55480,0,0,2,0,2
81990,190,19337,25751;25784,55480,0,0,2,0,2
81991,190,19338,25675;25849;29443,55480,0,0,3,0,3
81992,190,19339,25693,55480,0,0,1,0,1
81993,190,19340,25643;25713,55480,0,0,2,0,2
81994,190,19341,25526;25862;28987;29256,55480,0,0,4,0,4
81995,190,19342,25525;25579,55480,0,0,2,0,2
81996,190,19343,25195;25670,55480,0,0,2,0,2
81997,190,19344,25686;25822;28985,55480,0,0,3,0,3
81998,190,19345,25391;25878;28726,55480,0,0,3,0,3
81999,190,19346,25833;26093,55480,0,0,2,0,2
82000,190,19348,25621;25792,55480,0,0,2,0,2
82001,190,19361,22146,55845,0,0,0,1,1
82002,190,19363,22315,55845,0,0,0,1,1
82003,190,19366,22164,55845,0,0,0,1,1
82004,190,19370,22481,55845,0,0,0,1,1
82005,190,19375,22874,55845,0,0,0,1,1
82006,190,19379,23648;23755,55845,0,0,0,2,2
82007,190,19388,23919;24286,55845,0,0,0,2,2
82008,190,19389,23889;24316,55845,0,0,0,2,2
82009,190,19391,23943;24079,55845,0,0,0,2,2
82010,190,19392,24117;24294,55845,0,0,0,2,2
82011,190,19393,24474,55845,0,0,0,1,1
82012,190,19395,24462;24482;27793,55845,0,0,1,2,3
82013,190,19396,24511;24799,55845,0,0,0,2,2
82014,190,19398,24414;24687,55845,0,0,0,2,2
82015,190,19399,24690;24868;27018;28761,55845,0,0,2,2,4
82016,190,19400,24943;24956,55845,0,0,2,0,2
82017,190,19404,24862,55845,0,0,0,1,1
82018,190,19405,24467,55845,0,0,0,1,1
82019,190,19406,28859;29009,55845,0,0,2,0,2
82020,190,19407,24725;25048;28765,55845,0,0,2,1,3
82021,190,19408,25065,55845,0,0,1,0,1
82022,190,19409,25029;25068,55845,0,0,2,0,2
82023,190,19410,25076;25077,55845,0,0,2,0,2
82024,190,19411,24855;25047,55845,0,0,1,1,2
82025,190,19412,25135,55845,0,0,1,0,1
82026,190,19413,25161;25442,55845,0,0,2,0,2
82027,190,19414,25816;29537;29716,55845,0,1,2,0,3
82028,190,19415,25175,55845,0,0,1,0,1
82029,190,19416,25192,55845,0,0,1,0,1
82030,190,19417,25361;25486;29530,55845,0,0,3,0,3
82031,190,19418,24941;25233,55845,0,0,2,0,2
82032,190,19419,25248;25720;28633,55845,0,0,3,0,3
82033,190,19420,24816;25254,55845,0,0,1,1,2
82034,190,19421,25261;26023;28995,55845,0,0,3,0,3
82035,190,19422,25821;26027,55845,0,0,2,0,2
82036,190,19424,25167;25650;28625;30796;31157,55845,2,0,3,0,5
82037,190,19426,25106;25358,55845,0,0,2,0,2
82038,190,19427,25930;25995;29348;29813;29988;30069,55845,0,3,3,0,6
82039,190,19428,25374;25705;29340,55845,0,0,3,0,3
82040,190,19431,25462;25469,55845,0,0,2,0,2
82041,190,19432,25133;25482;28866;29137,55845,0,0,4,0,4
82042,190,19433,25316;25512,55845,0,0,2,0,2
82043,190,19434,25129;25517;29236,55845,0,0,3,0,3
82044,190,19435,25519;25756,55845,0,0,2,0,2
82045,190,19436,25211;25500,55845,0,0,2,0,2
82046,190,19437,25533;25729;29148,55845,0,0,3,0,3
82047,190,19438,25405,55845,0,0,1,0,1
82048,190,19439,24975;25545,55845,0,0,2,0,2
82049,190,19440,25861,55845,0,0,1,0,1
82050,190,19441,25371;25480;28708,55845,0,0,3,0,3
82051,190,19442,25458;26005;28899;29352;29628,55845,0,1,4,0,5
82052,190,19444,25629;25900;30068,55845,0,1,2,0,3
82053,190,19445,25855;25881;29157;29254;30725,55845,0,1,4,0,5
82054,190,19446,25154;25710;28253;29146,55845,0,0,4,0,4
82055,190,19447,25357;25655,55845,0,0,2,0,2
82056,190,19448,25503;25683,55845,0,0,2,0,2
82057,190,19449,26018;29169;29816,55845,0,1,2,0,3
82058,190,19450,25718;25945;29262;29896,55845,0,1,3,0,4
82059,190,19452,21537,56210,0,0,0,1,1
82060,190,19468,22677,56210,0,0,0,1,1
82061,190,19482,23941;24268,56210,0,0,0,2,2
82062,190,19483,23944;24062,56210,0,0,0,2,2
82063,190,19484,24347;24427,56210,0,0,0,2,2
82064,190,19485,24050;24555,56210,0,0,0,2,2
82065,190,19487,24766,56210,0,0,0,1,1
82066,190,19488,24351;24445,56210,0,0,0,2,2
82067,190,19489,24194;24481,56210,0,0,0,2,2
82068,190,19490,24734;24916;28854,56210,0,0,1,2,3
82069,190,19491,24557;25057,56210,0,0,1,1,2
82070,190,19493,24974,56210,0,0,1,0,1
82071,190,19499,24999,56210,0,0,1,0,1
82072,190,19500,25339;25472,56210,0,0,2,0,2
82073,190,19501,24596;24895,56210,0,0,0,2,2
82074,190,19502,25033;25414,56210,0,0,2,0,2
82075,190,19503,24997;27947;28506;30262,56210,0,1,3,0,4
82076,190,19504,24870;25011,56210,0,0,1,1,2
82077,190,19505,25329;25644;28878;29141;29438,56210,0,0,5,0,5
82078,190,19507,25103;25105,56210,0,0,2,0,2
82079,190,19511,25572;29437,56210,0,0,2,0,2
82080,190,19512,25066;25205,56210,0,0,2,0,2
82081,190,19513,25268;28599,56210,0,0,2,0,2
82082,190,19514,25447;25685,56210,0,0,2,0,2
82083,190,19515,25392,56210,0,0,1,0,1
82084,190,19517,24811;25375,56210,0,0,1,1,2
82085,190,19518,25386;25468,56210,0,0,2,0,2
82086,190,19519,24927;25418,56210,0,0,2,0,2
82087,190,19520,25571;25679,56210,0,0,2,0,2
82088,190,19522,24898;25446,56210,0,0,1,1,2
82089,190,19523,25449;25467,56210,0,0,2,0,2
82090,190,19525,25827;25867;29155,56210,0,0,3,0,3
82091,190,19526,25768;25882;29062,56210,0,0,3,0,3
82092,190,19527,26138;28908;29459;29821;31180,56210,1,1,3,0,5
82093,190,19529,25320;28238,56210,0,0,2,0,2
82094,190,19530,25896;26054;29632,56210,0,1,2,0,3
82095,190,19531,25894,56210,0,0,1,0,1
82096,190,19532,25649;25891;29346,56210,0,0,3,0,3
82097,190,19533,25985;26000;29719,56210,0,1,2,0,3
82098,190,19534,25672,56210,0,0,1,0,1
82099,190,19535,25674;25946;28992;31002,56210,1,0,3,0,4
82100,190,19536,25712;25918;29540;29624,56210,0,1,3,0,4
82101,190,19537,25431;25760,56210,0,0,2,0,2
82102,190,19538,26002;26034;29266,56210,0,0,3,0,3
82103,190,19539,25797;25802;28722,56210,0,0,3,0,3
82104,190,19540,25774;25805;29150;29535,56210,0,0,4,0,4
82105,190,19541,26026,56210,0,0,1,0,1
82106,190,19545,21857,56575,0,0,0,1,1
82107,190,19550,21977,56575,0,0,0,1,1
82108,190,19552,21834,56575,0,0,0,1,1
82109,190,19559,22233,56575,0,0,0,1,1
82110,190,19567,22318,56575,0,0,0,1,1
82111,190,19568,22991,56575,0,0,0,1,1
82112,190,19569,23141,56575,0,0,0,1,1
82113,190,19572,22855,56575,0,0,0,1,1
82114,190,19576,23684;24140,56575,0,0,0,2,2
82115,190,19579,23453;23767,56575,0,0,0,2,2
82116,190,19580,24178,56575,0,0,0,1,1
82117,190,19581,24836;28210,56575,0,0,1,1,2
82118,190,19583,24035,56575,0,0,0,1,1
82119,190,19590,24397;24538,56575,0,0,0,2,2
82120,190,19595,24903;25353,56575,0,0,1,1,2
82121,190,19597,24932;25190,56575,0,0,2,0,2
82122,190,19598,24476;24966,56575,0,0,1,1,2
82123,190,19599,25063;25217;28498;28950,56575,0,0,4,0,4
82124,190,19600,25176;25369,56575,0,0,2,0,2
82125,190,19602,24913;25087,56575,0,0,1,1,2
82126,190,19603,24654,56575,0,0,0,1,1
82127,190,19604,24981;25147,56575,0,0,2,0,2
82128,190,19605,25235;25514;29050;29531,56575,0,0,4,0,4
82129,190,19606,25060;25185;28410;28594;30892;31068,56575,2,0,4,0,6
82130,190,19609,25403;25646;28971,56575,0,0,3,0,3
82131,190,19610,25542;25566;29620,56575,0,1,2,0,3
82132,190,19611,25238;25407,56575,0,0,2,0,2
82133,190,19612,25501;25714,56575,0,0,2,0,2
82134,190,19614,25351;25711;29341,56575,0,0,3,0,3
82135,190,19615,25094;25377;28606,56575,0,0,3,0,3
82136,190,19616,25380;25691,56575,0,0,2,0,2
82137,190,19617,25278;25409;28702,56575,0,0,3,0,3
82138,190,19618,25054;25411,56575,0,0,2,0,2
82139,190,19619,25422;28609;29046;29333,56575,0,0,4,0,4
82140,190,19620,25423,56575,0,0,1,0,1
82141,190,19621,25459;29992,56575,0,1,1,0,2
82142,190,19622,25694;25973;28163;29264,56575,0,0,4,0,4
82143,190,19623,25984;25989,56575,0,0,2,0,2
82144,190,19624,25605;25933;28990;29261;29814,56575,0,1,4,0,5
82145,190,19625,25287;25669,56575,0,0,2,0,2
82146,190,19626,25574;25684,56575,0,0,2,0,2
82147,190,19627,25636;25998;29544,56575,0,0,3,0,3
82148,190,19628,25575;26170;29276,56575,0,0,3,0,3
82149,190,19629,25950;26144,56575,0,0,2,0,2
82150,190,19630,25795;25966;29164;29263;29448;29990,56575,0,1,5,0,6
82151,190,19631,25536;25737;29247,56575,0,0,3,0,3
82152,190,19632,25775;25875,56575,0,0,2,0,2
82153,190,19633,25780;26124;29274,56575,0,0,3,0,3
82154,190,19634,25959;26137;29820,56575,0,1,2,0,3
82155,190,19636,25831;26182,56575,0,0,2,0,2
82156,190,19637,25859;29345,56575,0,0,2,0,2
82157,190,19638,26165;28823;29181;31004,56575,1,0,3,0,4
82158,190,19639,26025;26142,56575,0,0,2,0,2
82159,190,19649,22771,56940,0,0,0,1,1
82160,190,19652,22944;22958,56940,0,0,0,2,2
82161,190,19666,24036;24488;28468;30980,56940,1,0,1,2,4
82162,190,19670,24196;24362,56940,0,0,0,2,2
82163,190,19671,24664;27521,56940,0,0,1,1,2
82164,190,19673,23984;23993,56940,0,0,0,2,2
82165,190,19679,25046,56940,0,0,1,0,1
82166,190,19680,24475;24590,56940,0,0,0,2,2
82167,190,19681,24807;27912,56940,0,0,1,1,2
82168,190,19682,24856;25002,56940,0,0,1,1,2
82169,190,19684,24940,56940,0,0,1,0,1
82170,190,19686,25382,56940,0,0,1,0,1
82171,190,19687,25123;25584,56940,0,0,2,0,2
82172,190,19688,25125;25326;27946;28777;29715,56940,0,1,4,0,5
82173,190,19689,24955;25237;29041,56940,0,0,3,0,3
82174,190,19690,25226;25454,56940,0,0,2,0,2
82175,190,19691,25044;25344;27948;28322,56940,0,0,4,0,4
82176,190,19692,25111;25347,56940,0,0,2,0,2
82177,190,19693,25383;25600,56940,0,0,2,0,2
82178,190,19694,25218;25770,56940,0,0,2,0,2
82179,190,19695,25396;25438,56940,0,0,2,0,2
82180,190,19696,25435;28611;30986,56940,1,0,2,0,3
82181,190,19697,25440;25460,56940,0,0,2,0,2
82182,190,19698,25466;25915;28892;29445,56940,0,0,4,0,4
82183,190,19699,25113;25538,56940,0,0,2,0,2
82184,190,19700,25419;25513,56940,0,0,2,0,2
82185,190,19701,25453;25520;29237,56940,0,0,3,0,3
82186,190,19702,25753;25908;29149;29440,56940,0,0,4,0,4
82187,190,19703,25845,56940,0,0,1,0,1
82188,190,19705,25240;25777,56940,0,0,2,0,2
82189,190,19706,26064;26151,56940,0,0,2,0,2
82190,190,19707,25647;26102;29178;29356,56940,0,0,4,0,4
82191,190,19708,25616;25738;28792,56940,0,0,3,0,3
82192,190,19710,26192;26278;29006,56940,0,0,3,0,3
82193,190,19711,25819;26097;28904,56940,0,0,3,0,3
82194,190,19712,25564;25826;28888;31165,56940,1,0,3,0,4
82195,190,19713,25880;25914;29160,56940,0,0,3,0,3
82196,190,19715,25818;25947;28537,56940,0,0,3,0,3
82197,190,19716,25902;25948;29446;29627,56940,0,1,3,0,4
82198,190,19717,25958;26059;29454;29634,56940,0,1,3,0,4
82199,190,19718,26072;26145;29822,56940,0,1,2,0,3
82200,190,19719,25987;26096;29349,56940,0,0,3,0,3
82201,190,19720,25727;26016;29265;29629,56940,0,1,3,0,4
82202,190,19728,22590,57305,0,0,0,1,1
82203,190,19733,23032,57305,0,0,0,1,1
82204,190,19737,23122,57305,0,0,0,1,1
82205,190,19738,23081,57305,0,0,0,1,1
82206,190,19744,24229,57305,0,0,0,1,1
82207,190,19747,24150,57305,0,0,0,1,1
82208,190,19748,23968,57305,0,0,0,1,1
82209,190,19750,25202,57305,0,0,1,0,1
82210,190,19754,24808,57305,0,0,0,1,1
82211,190,19756,24616;24851,57305,0,0,0,2,2
82212,190,19759,24471;24516,57305,0,0,0,2,2
82213,190,19760,25049;25242,57305,0,0,2,0,2
82214,190,19761,25148;25184,57305,0,0,2,0,2
82215,190,19762,25085;25234;27546,57305,0,0,3,0,3
82216,190,19763,25243;25294;29329,57305,0,0,3,0,3
82217,190,19764,24763;25257;28413;28695,57305,0,0,3,1,4
82218,190,19765,25273;25527,57305,0,0,2,0,2
82219,190,19766,25277;25336,57305,0,0,2,0,2
82220,190,19767,25305;25504;30067,57305,0,1,2,0,3
82221,190,19768,25331;25506,57305,0,0,2,0,2
82222,190,19769,24611,57305,0,0,0,1,1
82223,190,19770,25493;25741,57305,0,0,2,0,2
82224,190,19772,25092;25384;28326;29043;29895;30786,57305,1,1,4,0,6
82225,190,19773,25412;25420,57305,0,0,2,0,2
82226,190,19774,25421;25511;28608;29045,57305,0,0,4,0,4
82227,190,19775,25343;25473,57305,0,0,2,0,2
82228,190,19777,25439;25498;28780,57305,0,0,3,0,3
82229,190,19778,25695;25904;29339,57305,0,0,3,0,3
82230,190,19779,25581;25721,57305,0,0,2,0,2
82231,190,19780,25744;25864;29058,57305,0,0,3,0,3
82232,190,19781,25457;25790;28640;29151;29811,57305,0,1,4,0,5
82233,190,19782,25618,57305,0,0,1,0,1
82234,190,19783,25559;25619;29240,57305,0,0,3,0,3
82235,190,19784,25615;25640,57305,0,0,2,0,2
82236,190,19785,25662;26231;28552,57305,0,0,3,0,3
82237,190,19786,25841,57305,0,0,1,0,1
82238,190,19787,25613;25967,57305,0,0,2,0,2
82239,190,19788,25830;25982;29450,57305,0,0,3,0,3
82240,190,19789,25663;25835,57305,0,0,2,0,2
82241,190,19790,25481;25836;29251;29538;29623,57305,0,1,4,0,5
82242,190,19791,26234;29189,57305,0,0,2,0,2
82243,190,19792,25589;25848;30452,57305,0,1,2,0,3
82244,190,19793,26355;29735,57305,0,1,1,0,2
82245,190,19794,25884;26120;29179;29457;29638;29899,57305,0,2,4,0,6
82246,190,19796,25907;26220,57305,0,0,2,0,2
82247,190,19797,26215;26384,57305,0,0,2,0,2
82248,190,19798,25926;26071;29817,57305,0,1,2,0,3
82249,190,19799,25759;25935,57305,0,0,2,0,2
82250,190,19800,26077;29076,57305,0,0,2,0,2
82251,190,19801,25990;29350;29897;31178,57305,1,1,2,0,4
82252,190,19802,25991,57305,0,0,1,0,1
82253,190,19804,26003;26332,57305,0,0,2,0,2
82254,190,19805,25441;26022,57305,0,0,2,0,2
82255,190,19806,26104;26198;29463,57305,0,0,3,0,3
82256,190,19807,26063;26272;29731,57305,0,1,2,0,3
82257,190,19808,26052;26260;29467,57305,0,0,3,0,3
82258,190,19809,25750;26167;29460;29823;29900;29993,57305,0,3,3,0,6
82259,190,19810,26107;26148,57305,0,0,2,0,2
82260,190,19811,25961;26134,57305,0,0,2,0,2
82261,190,19812,26136;26313;29649;29828,57305,0,2,2,0,4
82262,190,19821,22462,57670,0,0,0,1,1
82263,190,19825,22789,57670,0,0,0,1,1
82264,190,19828,23539,57670,0,0,0,1,1
82265,190,19833,24077,57670,0,0,0,1,1
82266,190,19840,24256;24374,57670,0,0,0,2,2
82267,190,19842,24543,57670,0,0,0,1,1
82268,190,19843,24532;25058;28122,57670,0,0,2,1,3
82269,190,19846,24380,57670,0,0,0,1,1
82270,190,19847,25034,57670,0,0,1,0,1
82271,190,19848,24907;24979,57670,0,0,1,1,2
82272,190,19852,24750;25124;27432;30229;30741,57670,1,1,2,1,5
82273,190,19853,25224,57670,0,0,1,0,1
82274,190,19855,25095,57670,0,0,1,0,1
82275,190,19856,25120;25267,57670,0,0,2,0,2
82276,190,19858,25107;25150;29233,57670,0,0,3,0,3
82277,190,19859,25310;25609,57670,0,0,2,0,2
82278,190,19860,25269,57670,0,0,1,0,1
82279,190,19862,25335;25451;29134,57670,0,0,3,0,3
82280,190,19863,26101;26218;28357,57670,0,0,3,0,3
82281,190,19866,25239;25546,57670,0,0,2,0,2
82282,190,19867,25563;25740,57670,0,0,2,0,2
82283,190,19868,25388;25812;29442,57670,0,0,3,0,3
82284,190,19869,25587;25846,57670,0,0,2,0,2
82285,190,19870,25863,57670,0,0,1,0,1
82286,190,19872,25333;25813;28805;28887;30721,57670,0,1,4,0,5
82287,190,19873,26489,57670,0,0,1,0,1
82288,190,19874,25664;25839;29252,57670,0,0,3,0,3
82289,190,19876,25887;29444,57670,0,0,2,0,2
82290,190,19877,25853;28806;28890,57670,0,0,3,0,3
82291,190,19878,26394;26422;29909,57670,0,1,2,0,3
82292,190,19879,25495;25906;29259;29539,57670,0,0,4,0,4
82293,190,19880,25807;25912,57670,0,0,2,0,2
82294,190,19881,25455;25943;29626,57670,0,1,2,0,3
82295,190,19882,25940,57670,0,0,1,0,1
82296,190,19883,25954;29070,57670,0,0,2,0,2
82297,190,19884,25957;26411;29739,57670,0,1,2,0,3
82298,190,19885,25890;26267;29370;29469;29557,57670,0,0,5,0,5
82299,190,19886,25436;25994,57670,0,0,2,0,2
82300,190,19887,25974;26287;29471;29826,57670,0,1,3,0,4
82301,190,19888,26162;26245;28743;29995,57670,0,1,3,0,4
82302,190,19889,25658;26066;29548,57670,0,0,3,0,3
82303,190,19890,25773;26140;28549,57670,0,0,3,0,3
82304,190,19891,26092;26469;29658;30078,57670,0,2,2,0,4
82305,190,19892,26326,57670,0,0,1,0,1
82306,190,19893,26312;26486;28661;31072,57670,1,0,3,0,4
82307,190,19894,26116;26158,57670,0,0,2,0,2
82308,190,19895,26118;26472;29013,57670,0,0,3,0,3
82309,190,19896,26128;26249;29550;29640,57670,0,1,3,0,4
82310,190,19898,26179;26347;29553,57670,0,0,3,0,3
82311,190,19899,25829;25920;29718,57670,0,1,2,0,3
82312,190,19901,26228;26318;28826;29366,57670,0,0,4,0,4
82313,190,19902,26230;26507;29911,57670,0,1,2,0,3
82314,190,19903,26239;28742,57670,0,0,2,0,2
82315,190,19911,23090,58035,0,0,0,1,1
82316,190,19914,23245,58035,0,0,0,1,1
82317,190,19925,23838;24381,58035,0,0,0,2,2
82318,190,19928,24834,58035,0,0,0,1,1
82319,190,19929,24493,58035,0,0,0,1,1
82320,190,19930,24422;24434,58035,0,0,0,2,2
82321,190,19931,24628;24716,58035,0,0,0,2,2
82322,190,19937,25013;25304;28417,58035,0,0,3,0,3
82323,190,19938,25028;25173;28495,58035,0,0,3,0,3
82324,190,19940,25196;28769,58035,0,0,2,0,2
82325,190,19941,25214,58035,0,0,1,0,1
82326,190,19942,25463;25642;28781,58035,0,0,3,0,3
82327,190,19944,26079;26121;29639;29722,58035,0,2,2,0,4
82328,190,19945,25379;28421;28957,58035,0,0,3,0,3
82329,190,19947,25724;25877,58035,0,0,2,0,2
82330,190,19948,25567;25903;29064;29159;29812,58035,0,1,4,0,5
82331,190,19949,25648;25673;28438;28973;30538,58035,0,1,4,0,5
82332,190,19950,25475;25921,58035,0,0,2,0,2
82333,190,19951,25689;25785,58035,0,0,2,0,2
82334,190,19952,25716;26201,58035,0,0,2,0,2
82335,190,19953,25837,58035,0,0,1,0,1
82336,190,19954,25528;29534,58035,0,0,2,0,2
82337,190,19955,26163;29644;30073,58035,0,2,1,0,3
82338,190,19956,25726;25801,58035,0,0,2,0,2
82339,190,19957,25401;25804;28983,58035,0,0,3,0,3
82340,190,19958,25814;25975;29165;29449;29815,58035,0,1,4,0,5
82341,190,19959,25854;26015;29452,58035,0,0,3,0,3
82342,190,19960,25856;26046;29991,58035,0,1,2,0,3
82343,190,19961,25668;25879,58035,0,0,2,0,2
82344,190,19962,25909;26316;29472;29907,58035,0,1,3,0,4
82345,190,19964,26458;26776;28558;30363;30545,58035,0,2,3,0,5
82346,190,19965,26367;26535;29477,58035,0,0,3,0,3
82347,190,19966,25782;26086,58035,0,0,2,0,2
82348,190,19967,26043;26464;29481;29657,58035,0,1,3,0,4
82349,190,19968,26051;26290;29374;30266,58035,0,1,3,0,4
82350,190,19969,26105;26319;29093;29375;29650,58035,0,1,4,0,5
82351,190,19971,25931;26075,58035,0,0,2,0,2
82352,190,19972,25838;26108;28906,58035,0,0,3,0,3
82353,190,19973,26349;29475;29997,58035,0,1,2,0,3
82354,190,19974,25971;26146;29080;29642,58035,0,1,3,0,4
82355,190,19975,25109;25735,58035,0,0,2,0,2
82356,190,19976,26017;26189;29002;29279;29994,58035,0,1,4,0,5
82357,190,19977,26193;28914;29003;29726,58035,0,1,3,0,4
82358,190,19978,26283,58035,0,0,1,0,1
82359,190,19979,25865;26195;29085;29462,58035,0,0,4,0,4
82360,190,19980,25911;26205;29901,58035,0,1,2,0,3
82361,190,19981,26446,58035,0,0,1,0,1
82362,190,19982,26156;26210;29004;29464;29645,58035,0,1,4,0,5
82363,190,19984,26241;26548;29571;29747;30000,58035,0,2,3,0,5
82364,190,19985,25992;26262;29284;29905,58035,0,1,3,0,4
82365,190,19990,22385,58400,0,0,0,1,1
82366,190,19991,22479,58400,0,0,0,1,1
82367,190,19993,22596,58400,0,0,0,1,1
82368,190,19995,22646,58400,0,0,0,1,1
82369,190,20001,22945,58400,0,0,0,1,1
82370,190,20016,24889;25079,58400,0,0,1,1,2
82371,190,20017,24223;24358,58400,0,0,0,2,2
82372,190,20018,24570;24885,58400,0,0,0,2,2
82373,190,20019,24768;24983,58400,0,0,1,1,2
82374,190,20020,24369;28672,58400,0,0,1,1,2
82375,190,20024,25009;25416;27953,58400,0,0,3,0,3
82376,190,20026,25620,58400,0,0,1,0,1
82377,190,20027,25308;25590;28339;28966;30169;31144,58400,1,1,4,0,6
82378,190,20028,25126;25315,58400,0,0,2,0,2
82379,190,20029,25561;28522;30442,58400,0,1,2,0,3
82380,190,20030,25160;25390;28327,58400,0,0,3,0,3
82381,190,20031,25367;25465,58400,0,0,2,0,2
82382,190,20032,24841;25191,58400,0,0,1,1,2
82383,190,20034,25364;25667,58400,0,0,2,0,2
82384,190,20035,25363;25570,58400,0,0,2,0,2
82385,190,20036,25560;29436,58400,0,0,2,0,2
82386,190,20037,25537;25840;28724;29156,58400,0,0,4,0,4
82387,190,20038,26233;29367;29556;29729,58400,0,1,3,0,4
82388,190,20039,25307;25598;29713,58400,0,1,2,0,3
82389,190,20041,25021;25355;28419,58400,0,0,3,0,3
82390,190,20042,26080;29549;29635,58400,0,1,2,0,3
82391,190,20043,25583;25697,58400,0,0,2,0,2
82392,190,20044,25745;25798;28801;30719;30997,58400,1,1,3,0,5
82393,190,20045,25496;25746,58400,0,0,2,0,2
82394,190,20047,25832;26407,58400,0,0,2,0,2
82395,190,20048,26011,58400,0,0,1,0,1
82396,190,20049,25901,58400,0,0,1,0,1
82397,190,20050,26061;26074;28997;29173,58400,0,0,4,0,4
82398,190,20051,25905;25949;29447;29542;29989,58400,0,1,4,0,5
82399,190,20052,26285;26433;30076,58400,0,1,2,0,3
82400,190,20053,25876;26396;29831,58400,0,1,2,0,3
82401,190,20054,25660;25981;29166;30071,58400,0,1,3,0,4
82402,190,20055,26006;29720;30453,58400,0,2,1,0,3
82403,190,20056,26007;26139,58400,0,0,2,0,2
82404,190,20057,25860;26032,58400,0,0,2,0,2
82405,190,20058,26057;26328,58400,0,0,2,0,2
82406,190,20059,26221;26261,58400,0,0,2,0,2
82407,190,20060,26420;26528;30176;30267,58400,0,2,2,0,4
82408,190,20061,26372;29380;29830;29908;29999,58400,0,3,2,0,5
82409,190,20062,25893;26112,58400,0,0,2,0,2
82410,190,20063,26020;26117;29637;29721,58400,0,2,2,0,4
82411,190,20064,26122;26510,58400,0,0,2,0,2
82412,190,20065,25953;26203;29363;30360,58400,0,1,3,0,4
82413,190,20066,25250;25539;28520;28787,58400,0,0,4,0,4
82414,190,20067,26152;29551;31181,58400,1,0,2,0,3
82415,190,20068,26208;26364;29186;29364;29902,58400,0,1,4,0,5
82416,190,20070,26647;26821;29934;30008;30460,58400,0,3,2,0,5
82417,190,20071,25993;26263,58400,0,0,2,0,2
82418,190,20073,26275;26282;29090;29733,58400,0,1,3,0,4
82419,190,20074,26321;26524;29297,58400,0,0,3,0,3
82420,190,20075,26385;26590;29562,58400,0,0,3,0,3
82421,190,20076,25969;26391;29738,58400,0,1,2,0,3
82422,190,20077,26227;26532;29298;29484;29834,58400,0,1,4,0,5
82423,190,20078,26381;26596;28936;29573,58400,0,0,4,0,4
82424,190,20079,26694;29581;29669;29671,58400,0,2,2,0,4
82425,190,20080,26414;26427;29201;30175,58400,0,1,3,0,4
82426,190,20090,22769,58765,0,0,0,1,1
82427,190,20096,22984,58765,0,0,0,1,1
82428,190,20101,23921;26498,58765,0,0,1,1,2
82429,190,20102,24378,58765,0,0,0,1,1
82430,190,20107,24603;25139,58765,0,0,1,1,2
82431,190,20108,24585,58765,0,0,0,1,1
82432,190,20109,24416,58765,0,0,0,1,1
82433,190,20113,24930,58765,0,0,1,0,1
82434,190,20114,25112,58765,0,0,1,0,1
82435,190,20118,25522;25582;28518,58765,0,0,3,0,3
82436,190,20120,25858;29344,58765,0,0,2,0,2
82437,190,20121,25471;25535,58765,0,0,2,0,2
82438,190,20122,25524;25592,58765,0,0,2,0,2
82439,190,20123,25899,58765,0,0,1,0,1
82440,190,20124,25497;25870,58765,0,0,2,0,2
82441,190,20126,25568;25692;29439,58765,0,0,3,0,3
82442,190,20127,25576;26084;28903;29636;29818,58765,0,2,3,0,5
82443,190,20129,25761;25809,58765,0,0,2,0,2
82444,190,20131,26001;26266;29468;29906,58765,0,1,3,0,4
82445,190,20132,26119;29357,58765,0,0,2,0,2
82446,190,20133,26398,58765,0,0,1,0,1
82447,190,20134,26125;28547;28998;30792,58765,1,0,3,0,4
82448,190,20135,25844;26060,58765,0,0,2,0,2
82449,190,20136,25776;26103,58765,0,0,2,0,2
82450,190,20137,26244;26754;30274,58765,0,1,2,0,3
82451,190,20139,26222;26537,58765,0,0,2,0,2
82452,190,20140,26237;26310;29088,58765,0,0,3,0,3
82453,190,20143,26160;26255;29466,58765,0,0,3,0,3
82454,190,20144,26749;26774;28843;29931,58765,0,1,3,0,4
82455,190,20145,26419;26545;29485,58765,0,0,3,0,3
82456,190,20146,26530;26707,58765,0,0,2,0,2
82457,190,20147,26028;26314,58765,0,0,2,0,2
82458,190,20148,25534;26322;29008;29287,58765,0,0,4,0,4
82459,190,20149,26708;29398,58765,0,0,2,0,2
82460,190,20150,26350;26603;29102;29488;29664,58765,0,1,4,0,5
82461,190,20151,25593;26375,58765,0,0,2,0,2
82462,190,20152,26377;26493;28925,58765,0,0,3,0,3
82463,190,20153,26601;29302,58765,0,0,2,0,2
82464,190,20154,26421;26723;29497,58765,0,0,3,0,3
82465,190,20155,26243;26450,58765,0,0,2,0,2
82466,190,20156,26454;29656,58765,0,1,1,0,2
82467,190,20157,26274;26460,58765,0,0,2,0,2
82468,190,20158,26056;26090;29898,58765,0,1,2,0,3
82469,190,20159,26741;30370,58765,0,1,1,0,2
82470,190,20160,26413;26473;29743,58765,0,1,2,0,3
82471,190,20161,26276;26490;29203;29567;29660,58765,0,1,4,0,5
82472,190,20162,26492,58765,0,0,1,0,1
82473,190,20163,26512;26602;29745;29912,58765,0,2,2,0,4
82474,190,20167,22405,59130,0,0,0,1,1
82475,190,20168,22456;22990,59130,0,0,0,2,2
82476,190,20171,22888,59130,0,0,0,1,1
82477,190,20176,23363,59130,0,0,0,1,1
82478,190,20178,23073,59130,0,0,0,1,1
82479,190,20182,23524,59130,0,0,0,1,1
82480,190,20189,24275,59130,0,0,0,1,1
82481,190,20205,24866;25219;27736,59130,0,0,2,1,3
82482,190,20206,25249;28856,59130,0,0,2,0,2
82483,190,20208,25406;25553;28789;30906,59130,1,0,3,0,4
82484,190,20210,25485;25678;28974;29143;30913,59130,1,0,4,0,5
82485,190,20211,25706;26085;29819,59130,0,1,2,0,3
82486,190,20212,25828;29717,59130,0,1,1,0,2
82487,190,20213,25666;25755;28978,59130,0,0,3,0,3
82488,190,20214,25762;25978;29248,59130,0,0,3,0,3
82489,190,20215,25847;25956;29162,59130,0,0,3,0,3
82490,190,20216,26286;26368;29378;29561;31092,59130,1,0,4,0,5
82491,190,20217,25952,59130,0,0,1,0,1
82492,190,20218,25687;25964;29163;31089,59130,1,0,3,0,4
82493,190,20219,25794;25850,59130,0,0,2,0,2
82494,190,20221,26013;26438;30629,59130,0,1,2,0,3
82495,190,20222,26076;26081;28650;28902,59130,0,0,4,0,4
82496,190,20223,25843;26279;28828;29732;30074;30265,59130,0,3,3,0,6
82497,190,20224,26100;26211;29187,59130,0,0,3,0,3
82498,190,20225,26183;29278;29362;29461,59130,0,0,4,0,4
82499,190,20226,26204;26502;30546,59130,0,1,2,0,3
82500,190,20227,25997;26206;29086;29185;29727,59130,0,1,4,0,5
82501,190,20228,26207;26763;30006,59130,0,1,2,0,3
82502,190,20230,25924;26235;29730,59130,0,1,2,0,3
82503,190,20231,26248;26539;29299,59130,0,0,3,0,3
82504,190,20232,26463;29382,59130,0,0,2,0,2
82505,190,20233,26042;26401;29295,59130,0,0,3,0,3
82506,190,20234,26569,59130,0,0,1,0,1
82507,190,20235,26069;26426;29096;31174,59130,1,0,3,0,4
82508,190,20236,26348;26429;29655;29740,59130,0,2,2,0,4
82509,190,20237,26444;26485;29384;29744,59130,0,1,3,0,4
82510,190,20240,26561,59130,0,0,1,0,1
82511,190,20241,26434;26579;29205;29487;30454,59130,0,1,4,0,5
82512,190,20242,26476;26572;28664,59130,0,0,3,0,3
82513,190,20244,22370,59495,0,0,0,1,1
82514,190,20248,22586,59495,0,0,0,1,1
82515,190,20250,23396,59495,0,0,0,1,1
82516,190,20257,23378,59495,0,0,0,1,1
82517,190,20262,24049;24157,59495,0,0,0,2,2
82518,190,20267,24595;24900;28216,59495,0,0,1,2,3
82519,190,20269,25016;25429;28610;28705,59495,0,0,4,0,4
82520,190,20270,25311;29330,59495,0,0,2,0,2
82521,190,20271,25083;25309,59495,0,0,2,0,2
82522,190,20272,25547;25690,59495,0,0,2,0,2
82523,190,20273,25767;28803,59495,0,0,2,0,2
82524,190,20274,25654;25739;28794;28880;29054,59495,0,0,5,0,5
82525,190,20275,25554;25765,59495,0,0,2,0,2
82526,190,20277,25749;25754;29533,59495,0,0,3,0,3
82527,190,20278,25742;26389;29737;30075,59495,0,2,2,0,4
82528,190,20279,25932;29260;30070,59495,0,1,2,0,3
82529,190,20280,26062;26172,59495,0,0,2,0,2
82530,190,20281,25897;26500;28930;29568,59495,0,0,4,0,4
82531,190,20282,26258;26452,59495,0,0,2,0,2
82532,190,20284,26083;26229;29903,59495,0,1,2,0,3
82533,190,20285,25934;26089;28651;28818;30544,59495,0,1,4,0,5
82534,190,20286,26095;26114;29355,59495,0,0,3,0,3
82535,190,20287,26111;29077;31003,59495,1,0,2,0,3
82536,190,20289,25734;26133,59495,0,0,2,0,2
82537,190,20290,25825;26199;28915,59495,0,0,3,0,3
82538,190,20292,26153;26932;29591,59495,0,0,3,0,3
82539,190,20293,26173;29723,59495,0,1,1,0,2
82540,190,20294,26126;26176;28999;29358;29458;30911,59495,1,0,5,0,6
82541,190,20295,26197;26585,59495,0,0,2,0,2
82542,190,20297,26257;26289;28655;29369,59495,0,0,4,0,4
82543,190,20298,26268;26927,59495,0,0,2,0,2
82544,190,20299,26270;26577;30082;30727,59495,1,1,2,0,4
82545,190,20301,26710;29925,59495,0,1,1,0,2
82546,190,20302,26470;30268,59495,0,1,1,0,2
82547,190,20303,26357;26862;30279,59495,0,1,2,0,3
82548,190,20304,26366;26833,59495,0,0,2,0,2
82549,190,20306,26254;26441,59495,0,0,2,0,2
82550,190,20307,26336;26442;29742;30178,59495,0,2,2,0,4
82551,190,20308,26453;26772,59495,0,0,2,0,2
82552,190,20309,26483;26969;29681,59495,0,1,2,0,3
82553,190,20310,26325;26526;29483,59495,0,0,3,0,3
82554,190,20311,26529;26648,59495,0,0,2,0,2
82555,190,20312,26842;26901;29589;29942;30104,59495,0,2,3,0,5
82556,190,20313,26534;26615;29569,59495,0,0,3,0,3
82557,190,20314,26767;26948;29770;30191,59495,0,2,2,0,4
82558,190,20315,26415;26573;29478,59495,0,0,3,0,3
82559,190,20316,26250;26613;29836,59495,0,1,2,0,3
82560,190,20317,26610;26652;29578;30183;30456,59495,0,2,3,0,5
82561,190,20318,26658;29840;30630,59495,0,2,1,0,3
82562,190,20319,26404;26669,59495,0,0,2,0,2
82563,190,20320,26683;29843;30089,59495,0,2,1,0,3
82564,190,20321,26509;26686;30368,59495,0,1,2,0,3
82565,190,20322,26641;26687;29579,59495,0,0,3,0,3
82566,190,20323,26706;29845,59495,0,1,1,0,2
82567,190,20324,26830;26903;30105,59495,0,1,2,0,3
82568,190,20326,22115,59860,0,0,0,1,1
82569,190,20329,22373,59860,0,0,0,1,1
82570,190,20330,22899,59860,0,0,0,1,1
82571,190,20332,22459,59860,0,0,0,1,1
82572,190,20333,22838,59860,0,0,0,1,1
82573,190,20347,24121;24288,59860,0,0,0,2,2
82574,190,20350,24433;24715,59860,0,0,0,2,2
82575,190,20351,24825;25023;27430;30740,59860,1,0,2,1,4
82576,190,20353,25227,59860,0,0,1,0,1
82577,190,20354,25061;25378;29234,59860,0,0,3,0,3
82578,190,20358,25789;25803;29536,59860,0,0,3,0,3
82579,190,20359,25483;25824,59860,0,0,2,0,2
82580,190,20360,25381;25606,59860,0,0,2,0,2
82581,190,20362,25318;25508,59860,0,0,2,0,2
82582,190,20363,25356;25622;28876,59860,0,0,3,0,3
82583,190,20364,25100;25350,59860,0,0,2,0,2
82584,190,20365,25541;25748,59860,0,0,2,0,2
82585,190,20366,26185;29725,59860,0,1,1,0,2
82586,190,20367,25766;25937,59860,0,0,2,0,2
82587,190,20368,25709;25793;28981;29622,59860,0,1,3,0,4
82588,190,20371,25942;26342;29474;29560,59860,0,0,4,0,4
82589,190,20372,26306;26888;30102;30464,59860,0,2,2,0,4
82590,190,20374,25815;26115;29456;30072,59860,0,1,3,0,4
82591,190,20375,26012;26352;30362,59860,0,1,2,0,3
82592,190,20376,25699;26049;29546,59860,0,0,3,0,3
82593,190,20378,25602;26087;29455,59860,0,0,3,0,3
82594,190,20379,26217;29555,59860,0,0,2,0,2
82595,190,20381,26141;26812;29217;29584;31007,59860,1,0,4,0,5
82596,190,20382,26360;29998,59860,0,1,1,0,2
82597,190,20385,26495;26690;29668;29758;29922,59860,0,3,2,0,5
82598,190,20386,26392,59860,0,0,1,0,1
82599,190,20388,26633,59860,0,0,1,0,1
82600,190,20390,26361;26362;29829,59860,0,1,2,0,3
82601,190,20391,26383;26511;29736,59860,0,1,2,0,3
82602,190,20392,26395;26556;29749,59860,0,1,2,0,3
82603,190,20393,26400;26655,59860,0,0,2,0,2
82604,190,20394,26186;26403;29084;31086,59860,1,0,3,0,4
82605,190,20396,26004;26010;28454;29351,59860,0,0,4,0,4
82606,190,20397,26402;26435;29832,59860,0,1,2,0,3
82607,190,20398,26675;29920;30088,59860,0,2,1,0,3
82608,190,20399,26456;26828;29024;29673;29762;29935,59860,0,3,3,0,6
82609,190,20400,26728,59860,0,0,1,0,1
82610,190,20401,26795,59860,0,0,1,0,1
82611,190,20402,26369;26662;29105;29667;29841;29919;30457;30728,59860,1,4,3,0,8
82612,190,20403,26665;26983,59860,0,0,2,0,2
82613,190,20404,26898;29588,59860,0,0,2,0,2
82614,190,20405,27059;29225;30112;30470,59860,0,2,2,0,4
82615,190,20407,26242;26634;29490,59860,0,0,3,0,3
82616,190,20408,26896;27062;29947;30198;30549,59860,0,3,2,0,5
82617,190,20409,26525;26753,59860,0,0,2,0,2
82618,190,20410,26678;26869;30100;30280,59860,0,2,2,0,4
82619,190,20411,26527;26688;29305;29397;29757;29921;30272,59860,0,3,4,0,7
82620,190,20412,26843;27049,59860,0,0,2,0,2
82621,190,20413,26554;26714;29389;29486;29748,59860,0,1,4,0,5
82622,190,20414,26963;26981;29775;30020;30814,59860,1,2,2,0,5
82623,190,20415,26747;26868;29939,59860,0,1,2,0,3
82624,190,20417,26390;26808;29406;29846;30459,59860,0,2,3,0,5
82625,190,20418,22672,60225,0,0,0,1,1
82626,190,20419,22738,60225,0,0,0,1,1
82627,190,20422,22977,60225,0,0,0,1,1
82628,190,20423,22813,60225,0,0,0,1,1
82629,190,20424,22798,60225,0,0,0,1,1
82630,190,20428,23637;23694,60225,0,0,0,2,2
82631,190,20436,24109;24558,60225,0,0,0,2,2
82632,190,20439,24814;24828,60225,0,0,0,2,2
82633,190,20440,24773;25228;28951,60225,0,0,2,1,3
82634,190,20441,24859;24986,60225,0,0,1,1,2
82635,190,20443,24749;24933,60225,0,0,1,1,2
82636,190,20445,25337;25341,60225,0,0,2,0,2
82637,190,20446,25499;25607;28624,60225,0,0,3,0,3
82638,190,20447,25677;25731,60225,0,0,2,0,2
82639,190,20448,25883;25972;29072,60225,0,0,3,0,3
82640,190,20451,25291;25787;28057;28639;29441,60225,0,0,5,0,5
82641,190,20452,25444;25892,60225,0,0,2,0,2
82642,190,20453,25986;29543,60225,0,0,2,0,2
82643,190,20454,25936;25939;29161;29625,60225,0,1,3,0,4
82644,190,20455,25963;26284;29373;29470,60225,0,0,4,0,4
82645,190,20457,26382;26475;29654,60225,0,1,2,0,3
82646,190,20459,26154;26174;28912;29277;29724,60225,0,1,4,0,5
82647,190,20460,26374;29653,60225,0,1,1,0,2
82648,190,20461,26127;26330,60225,0,0,2,0,2
82649,190,20462,25886;26143;29079;29641,60225,0,1,3,0,4
82650,190,20464,26161;26430,60225,0,0,2,0,2
82651,190,20465,26251;26521;29746;29914,60225,0,2,2,0,4
82652,190,20466,26345;26376,60225,0,0,2,0,2
82653,190,20467,26094;26926;29853;30018;30107,60225,0,3,2,0,5
82654,190,20468,25680;26329;29288,60225,0,0,3,0,3
82655,190,20469,26358;26432;29381,60225,0,0,3,0,3
82656,190,20470,26324;26542;30726,60225,1,0,2,0,3
82657,190,20472,25968;26252;29825;30264,60225,0,2,2,0,4
82658,190,20473,26650;26771;29500,60225,0,0,3,0,3
82659,190,20474,26449;26591,60225,0,0,2,0,2
82660,190,20475,26213;26575,60225,0,0,2,0,2
82661,190,20477,26491;29482,60225,0,0,2,0,2
82662,190,20478,26656;26807;29396,60225,0,0,3,0,3
82663,190,20479,26813;29847,60225,0,1,1,0,2
82664,190,20481,26887;27007,60225,0,0,2,0,2
82665,190,20482,26513;29014;29296;29388;30079;30270,60225,0,2,4,0,6
82666,190,20483,26607;29752,60225,0,1,1,0,2
82667,190,20484,26065;26612;29208;29392;29489,60225,0,0,5,0,5
82668,190,20485,26544;26627;29210;30084,60225,0,1,3,0,4
82669,190,20486,26785;26792;29404;30093,60225,0,1,3,0,4
82670,190,20487,26624;29103,60225,0,0,2,0,2
82671,190,20488,26514;26659;30365,60225,0,1,2,0,3
82672,190,20489,26451;26663;30087;30915,60225,1,1,2,0,4
82673,190,20490,26986;27217,60225,0,0,2,0,2
82674,190,20491,27002;27204;30192,60225,0,1,2,0,3
82675,190,20492,26417;26777,60225,0,0,2,0,2
82676,190,20493,26520;26780;29015;29913;30271,60225,0,2,3,0,5
82677,190,20494,26765;26799;29499,60225,0,0,3,0,3
82678,190,20495,26743;26809;29022;29407;30095;30275,60225,0,2,4,0,6
82679,190,20496,26811;26994,60225,0,0,2,0,2
82680,190,20497,26817;26909;30372,60225,0,1,2,0,3
82681,190,20498,26409;26681;29842;30367,60225,0,2,2,0,4
82682,190,20499,26829;26873;29310;29675;30462,60225,0,2,3,0,5
82683,190,20500,26861;26875;29940,60225,0,1,2,0,3
82684,190,20501,26880,60225,0,0,1,0,1
82685,190,20502,26916;26979,60225,0,0,2,0,2
82686,190,20503,22989,60590,0,0,0,1,1
82687,190,20506,23034,60590,0,0,0,1,1
82688,190,20511,23142,60590,0,0,0,1,1
82689,190,20514,23661,60590,0,0,0,1,1
82690,190,20516,24021,60590,0,0,0,1,1
82691,190,20526,23973;24560,60590,0,0,0,2,2
82692,190,20531,24802;24996,60590,0,0,1,1,2
82693,190,20536,25017;25479,60590,0,0,2,0,2
82694,190,20537,25115,60590,0,0,1,0,1
82695,190,20539,24967;25366,60590,0,0,2,0,2
82696,190,20546,25898;26014,60590,0,0,2,0,2
82697,190,20549,25601,60590,0,0,1,0,1
82698,190,20550,25725,60590,0,0,1,0,1
82699,190,20552,25661;25944;29068;30808;31085,60590,2,0,3,0,5
82700,190,20553,25352;26009,60590,0,0,2,0,2
82701,190,20554,26155;29082;29359;29643,60590,0,1,3,0,4
82702,190,20555,25960;26499,60590,0,0,2,0,2
82703,190,20557,26055;26236;29824;29904,60590,0,2,2,0,4
82704,190,20558,26039;26078,60590,0,0,2,0,2
82705,190,20559,26177;26214;29087,60590,0,0,3,0,3
82706,190,20560,26202;26373,60590,0,0,2,0,2
82707,190,20562,26256;26824,60590,0,0,2,0,2
82708,190,20563,26164;26259,60590,0,0,2,0,2
82709,190,20564,26291;26344;29377;29996,60590,0,1,3,0,4
82710,190,20565,26292;26346,60590,0,0,2,0,2
82711,190,20566,26297;26563;28934;29751;29916,60590,0,2,3,0,5
82712,190,20567,26311;26778;29403,60590,0,0,3,0,3
82713,190,20568,26320;26323;28922;29286;29376;29473,60590,0,0,6,0,6
82714,190,20569,26147;26371;29379,60590,0,0,3,0,3
82715,190,20570,26428;26440;29910,60590,0,1,2,0,3
82716,190,20571,26518;26595;29207,60590,0,0,3,0,3
82717,190,20572,26370;26558;29661;29750;30081,60590,0,3,2,0,5
82718,190,20574,26621;26935;29115;29592;29678,60590,0,1,4,0,5
82719,190,20575,26478;26626;29209;30181,60590,0,1,3,0,4
82720,190,20576,26600;29574,60590,0,0,2,0,2
82721,190,20577,26640;29754;30085,60590,0,2,1,0,3
82722,190,20578,27028;30287,60590,0,1,1,0,2
82723,190,20579,26664;26870;29755;30729,60590,1,1,2,0,4
82724,190,20580,26666;26967;29857;30284,60590,0,2,2,0,4
82725,190,20581,27011;27214;29601;29953;30124;30208,60590,0,3,3,0,6
82726,190,20582,26698;27118;30637,60590,0,1,2,0,3
82727,190,20583,26635;26700;29496,60590,0,0,3,0,3
82728,190,20584,26705;26818;29760;29848,60590,0,2,2,0,4
82729,190,20585,26773;26894;30103;30917,60590,1,1,2,0,4
82730,190,20586,26646;26758;30005;30091,60590,0,2,2,0,4
82731,190,20587,26800;26951;30109,60590,0,1,2,0,3
82732,190,20588,26696;26820;29307;29761;30187,60590,0,2,3,0,5
82733,190,20589,26755;26823;30096,60590,0,1,2,0,3
82734,190,20590,26661;26826,60590,0,0,2,0,2
82735,190,20591,26519;26853;29219;29501;29765;29937,60590,0,2,4,0,6
82736,190,20592,27084;29316;29780;30471,60590,0,2,2,0,4
82737,190,20593,26716;26891;30014,60590,0,1,2,0,3
82738,190,20594,26657;26907;29410;30465,60590,0,1,3,0,4
82739,190,20595,26947;27284;29595;29769,60590,0,1,3,0,4
82740,190,20596,26353;27001;29860,60590,0,1,2,0,3
82741,190,20597,26997;27127;30638,60590,0,1,2,0,3
82742,190,20598,27009;27314,60590,0,0,2,0,2
82743,190,20599,22900,60955,0,0,0,1,1
82744,190,20600,22993,60955,0,0,0,1,1
82745,190,20602,22732,60955,0,0,0,1,1
82746,190,20603,23241;23247,60955,0,0,0,2,2
82747,190,20609,23421,60955,0,0,0,1,1
82748,190,20611,23651;23716,60955,0,0,0,2,2
82749,190,20612,23818;24025,60955,0,0,0,2,2
82750,190,20614,23484,60955,0,0,0,1,1
82751,190,20616,23522,60955,0,0,0,1,1
82752,190,20618,24357,60955,0,0,0,1,1
82753,190,20619,23650,60955,0,0,0,1,1
82754,190,20625,25101,60955,0,0,1,0,1
82755,190,20633,25138;25319,60955,0,0,2,0,2
82756,190,20638,26135;26379,60955,0,0,2,0,2
82757,190,20641,26188;26317;29559,60955,0,0,3,0,3
82758,190,20642,26212;26393;29199;31175,60955,1,0,3,0,4
82759,190,20645,26264;26465;30179,60955,0,1,2,0,3
82760,190,20646,25627;26240;29280;29465;29647,60955,0,1,4,0,5
82761,190,20647,26067;26304;28921;29192;29827,60955,0,1,4,0,5
82762,190,20648,26294;26388;29734,60955,0,1,2,0,3
82763,190,20650,26840;26867;29408;29586;30633,60955,0,1,4,0,5
82764,190,20651,26639;26914;29212;30182,60955,0,1,3,0,4
82765,190,20652,26552;26684;29520,60955,0,0,3,0,3
82766,190,20653,26727;27047;30290,60955,0,1,2,0,3
82767,190,20654,26632;27027;29224,60955,0,0,3,0,3
82768,190,20655,26682;27071;30379,60955,0,1,2,0,3
82769,190,20656,26693;26779;30916,60955,1,0,2,0,3
82770,190,20657,26547;26699;29495;29844;29923;30003,60955,0,3,3,0,6
82771,190,20658,26719;30090,60955,0,1,1,0,2
82772,190,20659,26273;26722,60955,0,0,2,0,2
82773,190,20660,26742;29928;30631,60955,0,2,1,0,3
82774,190,20661,26739;27048;30291,60955,0,1,2,0,3
82775,190,20662,26546;26766,60955,0,0,2,0,2
82776,190,20663,26645;26770;29577;30086,60955,0,1,3,0,4
82777,190,20664,26797;26985;30375,60955,0,1,2,0,3
82778,190,20665,26801;26966;29672,60955,0,1,2,0,3
82779,190,20666,26825;29849,60955,0,1,1,0,2
82780,190,20667,26704;26860;29309;29938;30099,60955,0,2,3,0,5
82781,190,20668,26305;26876;29409;29941;30101;30188;30463,60955,0,4,3,0,7
82782,190,20669,26884;27147,60955,0,0,2,0,2
82783,190,20670,26902;26928;29768,60955,0,1,2,0,3
82784,190,20671,26912;27316;30650,60955,0,1,2,0,3
82785,190,20672,26834;30097;30278;30461,60955,0,3,1,0,4
82786,190,20673,26471;26919;29590,60955,0,0,3,0,3
82787,190,20674,26638;26920;28463;29767,60955,0,1,3,0,4
82788,190,20675,26929;26957;30110;30282;30812,60955,1,2,2,0,5
82789,190,20676,26571;26945;30108;30190,60955,0,2,2,0,4
82790,190,20677,26583;26952;29413;29771;29856;29943;30811,60955,1,3,3,0,7
82791,190,20678,27198;27435;29787;30477;30644,60955,0,3,2,0,5
82792,190,20679,26973;27185;30300,60955,0,1,2,0,3
82793,190,20680,26474;27021;29315;29506;29946;30022;31011,60955,1,2,4,0,7
82794,190,20681,27068;29598;30378;30636,60955,0,2,2,0,4
82795,190,20682,26851;26871;29764;30013,60955,0,2,2,0,4
82796,190,20683,26605;26993;29945,60955,0,1,2,0,3
82797,190,20684,27140;27226;29122,60955,0,0,3,0,3
82798,190,20686,26923;27029;30377,60955,0,1,2,0,3
82799,190,20687,26879;27075,60955,0,0,2,0,2
82800,190,20688,27054;27213;30123,60955,0,1,2,0,3
82801,190,20689,26883;27281;29421;29958;30306;30822,60955,1,2,3,0,6
82802,190,20690,26247;26712;30369;31010,60955,1,1,2,0,4
82803,190,20691,26864;27090;29781;30114;30293,60955,0,3,2,0,5
82804,190,20692,26649;27103;30115,60955,0,1,2,0,3
82805,190,20693,27242;27318,60955,0,0,2,0,2
82806,190,20694,23127,61320,0,0,0,1,1
82807,190,20695,23181,61320,0,0,0,1,1
82808,190,20696,23289,61320,0,0,0,1,1
82809,190,20697,23222,61320,0,0,0,1,1
82810,190,20698,23144,61320,0,0,0,1,1
82811,190,20702,23485;23768,61320,0,0,0,2,2
82812,190,20705,24014,61320,0,0,0,1,1
82813,190,20719,24792;24822,61320,0,0,0,2,2
82814,190,20725,25194;25385,61320,0,0,2,0,2
82815,190,20726,24987,61320,0,0,1,0,1
82816,190,20727,25300;25743,61320,0,0,2,0,2
82817,190,20730,25578;25791,61320,0,0,2,0,2
82818,190,20731,25608;25800;28723;28982,61320,0,0,4,0,4
82819,190,20733,26033;29171,61320,0,0,2,0,2
82820,190,20734,25851;26356,61320,0,0,2,0,2
82821,190,20735,25929,61320,0,0,1,0,1
82822,190,20737,25628;26036;29545,61320,0,0,3,0,3
82823,190,20740,26157,61320,0,0,1,0,1
82824,190,20742,26689;26978;30374;30466,61320,0,2,2,0,4
82825,190,20743,26307;26822;30009;30277;30632,61320,0,3,2,0,5
82826,190,20745,26171;26479;29565,61320,0,0,3,0,3
82827,190,20746,26190;26536;29570;29915;30080,61320,0,2,3,0,5
82828,190,20747,26423;26620;29575;29837;30083;31182,61320,1,2,3,0,6
82829,190,20748,26523,61320,0,0,1,0,1
82830,190,20749,26782;27109;29862;30116,61320,0,2,2,0,4
82831,190,20751,26416;26746;29929,61320,0,1,2,0,3
82832,190,20752,27122;27319;30043;30922,61320,1,1,2,0,4
82833,190,20753,26557;26803,61320,0,0,2,0,2
82834,190,20754,26517;26584,61320,0,0,2,0,2
82835,190,20755,26725;29582,61320,0,0,2,0,2
82836,190,20758,26578;26673;29492;29756,61320,0,1,3,0,4
82837,190,20759,26726;26933;29854;30810,61320,1,1,2,0,4
82838,190,20760,26737;26885,61320,0,0,2,0,2
82839,190,20761,26759;27066;29670;30458,61320,0,2,2,0,4
82840,190,20763,26906;27255;29603,61320,0,0,3,0,3
82841,190,20764,26931;27070;29503;29677;30281,61320,0,2,3,0,5
82842,190,20765,26975;27272;29871,61320,0,1,2,0,3
82843,190,20766,26988;26992;28671;29859,61320,0,1,3,0,4
82844,190,20767,27015;27310;29695,61320,0,1,2,0,3
82845,190,20768,26676;27039;29507;30111;30197;30289,61320,0,3,3,0,6
82846,190,20769,27142;27374;30736,61320,1,0,2,0,3
82847,190,20770,27139;30026,61320,0,1,1,0,2
82848,190,20771,27415,61320,0,0,1,0,1
82849,190,20772,26832;27098;29416,61320,0,0,3,0,3
82850,190,20773,27105;27468;30930,61320,1,0,2,0,3
82851,190,20774,27067;27102;29317,61320,0,0,3,0,3
82852,190,20775,26915;27129;30296,61320,0,1,2,0,3
82853,190,20776,27074;27328;30219;30309,61320,0,2,2,0,4
82854,190,20777,27145;30385,61320,0,1,1,0,2
82855,190,20778,27160;27729;30059;30667,61320,0,2,2,0,4
82856,190,20779,27149;27229;29865;30118;30203;30919,61320,1,3,2,0,6
82857,190,20781,27173;27580;29524;30743,61320,1,0,3,0,4
82858,190,20782,26905;27191;29868,61320,0,1,2,0,3
82859,190,20783,26711;27192;29786;29869;29951,61320,0,3,2,0,5
82860,190,20784,26845;27233;29789;30210;30392;30557,61320,0,4,2,0,6
82861,190,20785,27234;27438;29426;29968;30400,61320,0,2,3,0,5
82862,190,20788,23430;23460,61685,0,0,0,2,2
82863,190,20790,23211,61685,0,0,0,1,1
82864,190,20794,23873;24188,61685,0,0,0,2,2
82865,190,20796,23848;23957,61685,0,0,0,2,2
82866,190,20797,23956;24018,61685,0,0,0,2,2
82867,190,20799,24055,61685,0,0,0,1,1
82868,190,20801,24331,61685,0,0,0,1,1
82869,190,20805,24489;24579;28378,61685,0,0,1,2,3
82870,190,20807,24466;24529,61685,0,0,0,2,2
82871,190,20817,25529;25548,61685,0,0,2,0,2
82872,190,20823,25281;25698;28631,61685,0,0,3,0,3
82873,190,20825,25676;26058;29547;29633,61685,0,1,3,0,4
82874,190,20826,25917;25976;28993,61685,0,0,3,0,3
82875,190,20827,25426;25783;28531,61685,0,0,3,0,3
82876,190,20829,25657,61685,0,0,1,0,1
82877,190,20833,26191;26538,61685,0,0,2,0,2
82878,190,20834,26280;26587;29016;30001;30806,61685,1,1,3,0,5
82879,190,20835,26224;26293;28920;29007;29091;29648;31087,61685,1,1,5,0,7
82880,190,20836,26717;26720,61685,0,0,2,0,2
82881,190,20837,26457;26721;30273,61685,0,1,2,0,3
82882,190,20838,27257;27444,61685,0,0,2,0,2
82883,190,20839,26564,61685,0,0,1,0,1
82884,190,20840,26566;26831;29674;30010,61685,0,2,2,0,4
82885,190,20841,26466;30180,61685,0,1,1,0,2
82886,190,20842,26327;26588;29391,61685,0,0,3,0,3
82887,190,20843,26541;26653,61685,0,0,2,0,2
82888,190,20845,26308,61685,0,0,1,0,1
82889,190,20846,26729,61685,0,0,1,0,1
82890,190,20847,26701;26745;29924,61685,0,1,2,0,3
82891,190,20848,26751;26900;29852,61685,0,1,2,0,3
82892,190,20849,26806;27186;30207;30732,61685,1,1,2,0,4
82893,190,20850,26816;26984;29858,61685,0,1,2,0,3
82894,190,20851,26836;27023;30011,61685,0,1,2,0,3
82895,190,20852,26839;27280;30042,61685,0,1,2,0,3
82896,190,20853,27095;29690,61685,0,1,1,0,2
82897,190,20855,26589;26677,61685,0,0,2,0,2
82898,190,20856,26886;27269,61685,0,0,2,0,2
82899,190,20857,26925,61685,0,0,1,0,1
82900,190,20858,26946;27030;29415,61685,0,0,3,0,3
82901,190,20859,26953;27195;29952;30033;30122,61685,0,3,2,0,5
82902,190,20860,27330;30564,61685,0,1,1,0,2
82903,190,20861,26543;27022;29119;29776;30195,61685,0,2,3,0,5
82904,190,20862,26918;27038,61685,0,0,2,0,2
82905,190,20863,27215;29229;30035;30209,61685,0,2,2,0,4
82906,190,20864,27179;27210;29228;30031;30389,61685,0,2,3,0,5
82907,190,20865,27055;27082;29508;29861;30469,61685,0,2,3,0,5
82908,190,20866,26757;27061,61685,0,0,2,0,2
82909,190,20867,27083;27120;29779;30024;30113;30199;30380;30918,61685,1,5,2,0,8
82910,190,20868,26940;27087;30200;30381,61685,0,2,2,0,4
82911,190,20869,27093,61685,0,0,1,0,1
82912,190,20870,26895;27108;29782;30382,61685,0,2,2,0,4
82913,190,20871,27165;29950;30121;30554,61685,0,3,1,0,4
82914,190,20872,27183;27296;29511,61685,0,0,3,0,3
82915,190,20873,27024;27221;30037,61685,0,1,2,0,3
82916,190,20874,27358;27616;29325;29703;30410,61685,0,2,3,0,5
82917,190,20875,27279;27286;29957;30481,61685,0,2,2,0,4
82918,190,20876,27175;27436;30313;31014,61685,1,1,2,0,4
82919,190,20877,27012;27294;30482;30559,61685,0,2,2,0,4
82920,190,20878,27299;27340;29606;30560,61685,0,1,3,0,4
82921,190,20879,27302;27482;30492;30576,61685,0,2,2,0,4
82922,190,20880,27123;27562;29799;29882;30234;31102,61685,1,3,2,0,6
82923,190,20881,26810,61685,0,0,1,0,1
82924,190,20884,23399,62050,0,0,0,1,1
82925,190,20886,23397,62050,0,0,0,1,1
82926,190,20889,23906,62050,0,0,0,1,1
82927,190,20892,23655;23896,62050,0,0,0,2,2
82928,190,20897,24403,62050,0,0,0,1,1
82929,190,20899,24415;24473,62050,0,0,0,2,2
82930,190,20908,24912,62050,0,0,0,1,1
82931,190,20913,25145;25279,62050,0,0,2,0,2
82932,190,20916,26050;29075,62050,0,0,2,0,2
82933,190,20920,26181;29361,62050,0,0,2,0,2
82934,190,20923,26271;26515,62050,0,0,2,0,2
82935,190,20924,26288;26618;29393;29918;30455,62050,0,2,3,0,5
82936,190,20926,26343;26487;29659,62050,0,1,2,0,3
82937,190,20927,26406;26598;29663,62050,0,1,2,0,3
82938,190,20929,26562;26911,62050,0,0,2,0,2
82939,190,20930,25988;26568;28935;30804,62050,1,0,3,0,4
82940,190,20931,26501;26581;29206;29572,62050,0,0,4,0,4
82941,190,20933,26671;29491,62050,0,0,2,0,2
82942,190,20934,26586;26608,62050,0,0,2,0,2
82943,190,20935,26550;26874,62050,0,0,2,0,2
82944,190,20936,26651;26847,62050,0,0,2,0,2
82945,190,20937,26339;26709;29214,62050,0,0,3,0,3
82946,190,20939,26781;27152,62050,0,0,2,0,2
82947,190,20940,27124;29318;29863,62050,0,1,2,0,3
82948,190,20944,26881,62050,0,0,1,0,1
82949,190,20946,27107;27250,62050,0,0,2,0,2
82950,190,20947,26938;27164;30028;30120;30553,62050,0,3,2,0,5
82951,190,20948,26955;27230;30038,62050,0,1,2,0,3
82952,190,20949,27232;30039;30302;30646,62050,0,3,1,0,4
82953,190,20950,26971;29682;30023;30468,62050,0,3,1,0,4
82954,190,20951,27537;29521;30660,62050,0,1,2,0,3
82955,190,20952,27065;27252;30128;30213;30821,62050,1,2,2,0,5
82956,190,20953,27096;27184;30032,62050,0,1,2,0,3
82957,190,20954,26892;27130;30639,62050,0,1,2,0,3
82958,190,20955,26964;27151,62050,0,0,2,0,2
82959,190,20956,27238;27437;30230,62050,0,1,2,0,3
82960,190,20957,27244;27605;30500,62050,0,1,2,0,3
82961,190,20958,27251;27409;29519;30654,62050,0,1,3,0,4
82962,190,20959,27258;27306,62050,0,0,2,0,2
82963,190,20960,27236;27592,62050,0,0,2,0,2
82964,190,20961,27058;27652;30583,62050,0,1,2,0,3
82965,190,20962,26962;27329,62050,0,0,2,0,2
82966,190,20963,27527;30407;31016,62050,1,1,1,0,3
82967,190,20964,27116;27345,62050,0,0,2,0,2
82968,190,20965,27355;27872;30336;30852,62050,1,1,2,0,4
82969,190,20967,27360;27366;30044,62050,0,1,2,0,3
82970,190,20968,27373;27720;30239,62050,0,1,2,0,3
82971,190,20969,27380;27676;31021,62050,1,0,2,0,3
82972,190,20970,27383;30398;30486,62050,0,2,1,0,3
82973,190,20971,27110;27388;29518;30136;30568;30738,62050,1,2,3,0,6
82974,190,20972,27494;27733;30939,62050,1,0,2,0,3
82975,190,20973,27554;29523,62050,0,0,2,0,2
82976,190,20974,27414;27575;30147,62050,0,1,2,0,3
82977,190,20976,23463,62415,0,0,0,1,1
82978,190,20978,23429,62415,0,0,0,1,1
82979,190,20979,23658;23730,62415,0,0,0,2,2
82980,190,20983,24070,62415,0,0,0,1,1
82981,190,20984,24141;24484,62415,0,0,0,2,2
82982,190,20986,24253,62415,0,0,0,1,1
82983,190,20989,24448;24565,62415,0,0,0,2,2
82984,190,20994,24779,62415,0,0,0,1,1
82985,190,20997,24871;25285,62415,0,0,1,1,2
82986,190,21001,25659;25799,62415,0,0,2,0,2
82987,190,21005,26175;26516,62415,0,0,2,0,2
82988,190,21008,26021;26302;30174,62415,0,1,2,0,3
82989,190,21009,25955;26397;29563,62415,0,0,3,0,3
82990,190,21010,26494;26667;29387,62415,0,0,3,0,3
82991,190,21011,26609;29665,62415,0,1,1,0,2
82992,190,21012,26187;26431;29479;29741;30177,62415,0,2,3,0,5
82993,190,21013,26110;26437;29833,62415,0,1,2,0,3
82994,190,21014,26044;26738;29927;30185,62415,0,2,2,0,4
82995,190,21015,26387,62415,0,0,1,0,1
82996,190,21017,26216;26505,62415,0,0,2,0,2
82997,190,21018,26629;26855,62415,0,0,2,0,2
82998,190,21019,26740;27168;30387;30643,62415,0,2,2,0,4
82999,190,21020,26408;26752;29498;29930,62415,0,1,3,0,4
83000,190,21021,26567;27003;30376;30635,62415,0,2,2,0,4
83001,190,21022,27114;29509;29683;30202,62415,0,2,2,0,4
83002,190,21023,26730;30184,62415,0,1,1,0,2
83003,190,21024,26660;26859,62415,0,0,2,0,2
83004,190,21025,26692;26939;29593,62415,0,0,3,0,3
83005,190,21026,26995;27180;29319,62415,0,0,3,0,3
83006,190,21028,26592;27006;29414;30193,62415,0,1,3,0,4
83007,190,21029,27378;29322;29608;29874;29966;30397;30653;30737,62415,1,4,3,0,8
83008,190,21030,27020;27274;29791,62415,0,1,2,0,3
83009,190,21032,27073;27428,62415,0,0,2,0,2
83010,190,21033,26846;27295;30217;30483,62415,0,2,2,0,4
83011,190,21034,27035;27171;30288,62415,0,1,2,0,3
83012,190,21035,27291;27317;30130,62415,0,1,2,0,3
83013,190,21036,27209;27612;30055;30151,62415,0,2,2,0,4
83014,190,21037,26991;27224;29955,62415,0,1,2,0,3
83015,190,21038,27189;27241;29126;29420;30304;30809;31012,62415,2,1,4,0,7
83016,190,21039,27449,62415,0,0,1,0,1
83017,190,21040,27273;27524;29700;30577,62415,0,2,2,0,4
83018,190,21041,27262;27287;29604;29956,62415,0,1,3,0,4
83019,190,21042,27076;27202;30034;30820,62415,1,1,2,0,4
83020,190,21043,27361;29607,62415,0,0,2,0,2
83021,190,21044,27354;27417;30227,62415,0,1,2,0,3
83022,190,21045,27777;27837;29889;31109,62415,1,1,2,0,4
83023,190,21046,27434;30742;31099,62415,2,0,1,0,3
83024,190,21048,27016;27532;30495,62415,0,1,2,0,3
83025,190,21049,27553;27618;30411;30581;30663,62415,0,3,2,0,5
83026,190,21050,27555;30497;30661,62415,0,2,1,0,3
83027,190,21051,27556;27599;29702;29884;30150,62415,0,3,2,0,5
83028,190,21054,23272,62780,0,0,0,1,1
83029,190,21057,23557,62780,0,0,0,1,1
83030,190,21058,23849;23892,62780,0,0,0,2,2
83031,190,21060,24056,62780,0,0,0,1,1
83032,190,21061,23879;24048,62780,0,0,0,2,2
83033,190,21081,25425;25778;28720;30798,62780,1,0,3,0,4
83034,190,21086,25604;26166;29182,62780,0,0,3,0,3
83035,190,21087,25702,62780,0,0,1,0,1
83036,190,21090,25925;28989,62780,0,0,2,0,2
83037,190,21091,25842;26091;29271,62780,0,0,3,0,3
83038,190,21092,26196;26484;29383;30269;30364,62780,0,2,3,0,5
83039,190,21093,26448;30077,62780,0,1,1,0,2
83040,190,21095,26019;26303;29092;29558,62780,0,0,4,0,4
83041,190,21096,27008;27036;29314;30194,62780,0,1,3,0,4
83042,190,21097,26040;26331;29651,62780,0,1,2,0,3
83043,190,21100,26643;26922;30017,62780,0,1,2,0,3
83044,190,21102,26736;26844,62780,0,0,2,0,2
83045,190,21103,27182,62780,0,0,1,0,1
83046,190,21104,26540;27079;30292,62780,0,1,2,0,3
83047,190,21105,26815;27206;29788;30479,62780,0,2,2,0,4
83048,190,21106,26827;27188;30390,62780,0,1,2,0,3
83049,190,21107,26856;26950;29855,62780,0,1,2,0,3
83050,190,21108,26718;26890;29851,62780,0,1,2,0,3
83051,190,21109,26921;29411;30106,62780,0,1,2,0,3
83052,190,21111,26910;27034,62780,0,0,2,0,2
83053,190,21112,27271;30558;31013,62780,1,1,1,0,3
83054,190,21114,26802;27178;29691;30030,62780,0,2,2,0,4
83055,190,21115,26965;27486;30932,62780,1,0,2,0,3
83056,190,21116,27924,62780,0,0,1,0,1
83057,190,21117,27253;27404;29602;30305,62780,0,1,3,0,4
83058,190,21118,27687;27701;29802;30585;30666,62780,0,3,2,0,5
83059,190,21120,27113;27268,62780,0,0,2,0,2
83060,190,21121,27270;27738;30504;30837,62780,1,1,2,0,4
83061,190,21122,27290;27400;30223,62780,0,1,2,0,3
83062,190,21123,27292;27640;29886;30664,62780,0,2,2,0,4
83063,190,21124,27010;27301;29872;30395;30561,62780,0,3,2,0,5
83064,190,21125,27633;31020,62780,1,0,1,0,2
83065,190,21127,27249;27324;29960,62780,0,1,2,0,3
83066,190,21128,27326;27845;30334;30675;30756,62780,1,2,2,0,5
83067,190,21129,27327;27500;29970,62780,0,1,2,0,3
83068,190,21130,27331;27927;31037,62780,1,0,2,0,3
83069,190,21131,27339;30220;30924,62780,1,1,1,0,3
83070,190,21132,27337;27347;29516,62780,0,0,3,0,3
83071,190,21135,27115;27386;29875;31097,62780,1,1,2,0,4
83072,190,21136,27056;27427;29796;30312;30572;30655,62780,0,4,2,0,6
83073,190,21137,27431;27520;30139;30228;30488;30829,62780,1,3,2,0,6
83074,190,21138,27447;29427;29876;30656;31091,62780,1,2,2,0,5
83075,190,21140,27353;27458;30929,62780,1,0,2,0,3
83076,190,21141,27419;27462;29428;30052;30232,62780,0,2,3,0,5
83077,190,21142,27478;27765;30420;30671;31025;31106,62780,2,2,2,0,6
83078,190,21143,27389;27459;30574,62780,0,1,2,0,3
83079,190,21144,27551;27695;30414,62780,0,1,2,0,3
83080,190,21145,27559;27749,62780,0,0,2,0,2
83081,190,21146,26989;27563;29971;30146,62780,0,2,2,0,4
83082,190,21147,27587;27764,62780,0,0,2,0,2
83083,190,21148,27864;30596;30849,62780,1,1,1,0,3
83084,190,21149,27628;27712,62780,0,0,2,0,2
83085,190,21150,27111;27647;30152,62780,0,1,2,0,3
83086,190,21151,27651;27686;30056,62780,0,1,2,0,3
83087,190,21152,23362,63145,0,0,0,1,1
83088,190,21153,23545,63145,0,0,0,1,1
83089,190,21154,23692;23717,63145,0,0,0,2,2
83090,190,21156,23652,63145,0,0,0,1,1
83091,190,21157,23778,63145,0,0,0,1,1
83092,190,21159,24326;24714,63145,0,0,0,2,2
83093,190,21160,24518,63145,0,0,0,1,1
83094,190,21168,24846,63145,0,0,0,1,1
83095,190,21169,25081,63145,0,0,1,0,1
83096,190,21176,25404;25594;28791;28875;30996,63145,1,0,4,0,5
83097,190,21179,26299,63145,0,0,1,0,1
83098,190,21187,25530;25996;29073,63145,0,0,3,0,3
83099,190,21188,25999;26038,63145,0,0,2,0,2
83100,190,21191,26223;26488;29385,63145,0,0,3,0,3
83101,190,21193,26246;26461,63145,0,0,2,0,2
83102,190,21195,26619;26668,63145,0,0,2,0,2
83103,190,21197,26769;26943;29594;29680,63145,0,1,3,0,4
83104,190,21198,26734;26976;29774;29944;30019;30285,63145,0,4,2,0,6
83105,190,21199,26744;26893;29114;30015;30189;30634,63145,0,3,3,0,6
83106,190,21200,26904;27153;29688;29866,63145,0,2,2,0,4
83107,190,21201,26775;26937;29504;29679,63145,0,1,3,0,4
83108,190,21202,26941;27150,63145,0,0,2,0,2
83109,190,21203,26606;27031;30467,63145,0,1,2,0,3
83110,190,21204,27033;27041;29777,63145,0,1,2,0,3
83111,190,21205,26503;27092;29120;30025;30815,63145,1,1,3,0,5
83112,190,21206,27097;27542;29522;29798,63145,0,1,3,0,4
83113,190,21207,27057;27239;30126;30303;30647,63145,0,3,2,0,5
83114,190,21208,27126;27476;30490;31015;31100,63145,2,1,2,0,5
83115,190,21209,27225;30473,63145,0,1,1,0,2
83116,190,21210,27141,63145,0,0,1,0,1
83117,190,21212,27237;27593;29801,63145,0,1,2,0,3
83118,190,21213,27313;27602;31018,63145,1,0,2,0,3
83119,190,21214,27172;27285,63145,0,0,2,0,2
83120,190,21215,27320;27889;30062;31033,63145,1,1,2,0,4
83121,190,21216,26857;27322;29792;30308;30563,63145,0,3,2,0,5
83122,190,21217,27357;27694,63145,0,0,2,0,2
83123,190,21218,27044;27492,63145,0,0,2,0,2
83124,190,21219,27416;27734;30416;30940,63145,1,1,2,0,4
83125,190,21220,27584;30235,63145,0,1,1,0,2
83126,190,21221,27547;30409;31101,63145,1,1,1,0,3
83127,190,21222,27479;27549;30491;30931,63145,1,1,2,0,4
83128,190,21223,27487;27690,63145,0,0,2,0,2
83129,190,21224,27387;27497,63145,0,0,2,0,2
83130,190,21225,27797;27880;30060,63145,0,1,2,0,3
83131,190,21226,27199;27502;29699;30233;30493,63145,0,3,2,0,5
83132,190,21227,27169;27377;29965,63145,0,1,2,0,3
83133,190,21228,27025;27511;30830,63145,1,0,2,0,3
83134,190,21229,27831;30674;31112,63145,1,1,1,0,3
83135,190,21230,27785;27985;30342;30958,63145,1,1,2,0,4
83136,190,21231,27582,63145,0,0,1,0,1
83137,190,21232,27590;30158;30603;30680,63145,0,3,1,0,4
83138,190,21233,27603;27716;30832,63145,1,0,2,0,3
83139,190,21235,27644;27799;30513;30591;30672;31028,63145,1,3,2,0,6
83140,190,21236,27656;28010;30522;30861,63145,1,1,2,0,4
83141,190,21237,27433;27698;30057,63145,0,1,2,0,3
83142,190,21238,27543;27700;31104,63145,1,0,2,0,3
83143,190,21239,27623;27702;29973,63145,0,1,2,0,3
83144,190,21240,27714;30415,63145,0,1,1,0,2
83145,190,21241,27288;27724,63145,0,0,2,0,2
83146,190,21242,27645;27739,63145,0,0,2,0,2
83147,190,21243,27650;27747;30505,63145,0,1,2,0,3
83148,190,21244,27560;27748;29616;30327;30417;30588;30943,63145,1,3,3,0,7
83149,190,21245,27752;30506;30750,63145,1,1,1,0,3
83150,190,21246,27678;27758;30418,63145,0,1,2,0,3
83151,190,21247,23942,63510,0,0,0,1,1
83152,190,21248,23507,63510,0,0,0,1,1
83153,190,21252,24139,63510,0,0,0,1,1
83154,190,21257,24413;24621,63510,0,0,0,2,2
83155,190,21258,24675,63510,0,0,0,1,1
83156,190,21259,24588,63510,0,0,0,1,1
83157,190,21260,24247,63510,0,0,0,1,1
83158,190,21264,24720,63510,0,0,0,1,1
83159,190,21268,25053,63510,0,0,1,0,1
83160,190,21272,25265;25293,63510,0,0,2,0,2
83161,190,21277,26053;26335,63510,0,0,2,0,2
83162,190,21279,25889;26337;29652;30361,63510,0,2,2,0,4
83163,190,21281,26232;26340,63510,0,0,2,0,2
83164,190,21285,26424;26889;29676,63510,0,1,2,0,3
83165,190,21287,26576;26617;29304;29917,63510,0,1,3,0,4
83166,190,21288,26447;26794;30094,63510,0,1,2,0,3
83167,190,21290,26934;27078;30550,63510,0,1,2,0,3
83168,190,21292,27259;30041;30214;30393;30649,63510,0,4,1,0,5
83169,190,21293,27335;30396;30823,63510,1,1,1,0,3
83170,190,21294,27052;27315;29696;29959;30218;30562,63510,0,4,2,0,6
83171,190,21295,27060;27550;30315;30578;30934,63510,1,2,2,0,5
83172,190,21296,26987;27254;30040,63510,0,1,2,0,3
83173,190,21297,27371;27472;29797;30489,63510,0,2,2,0,4
83174,190,21298,27117;27245;29514;30212,63510,0,1,3,0,4
83175,190,21299,27013,63510,0,0,1,0,1
83176,190,21300,27158;29431;30584;30665,63510,0,2,2,0,4
83177,190,21301,27680,63510,0,0,1,0,1
83178,190,21303,26970;27338;30735;30923,63510,2,0,2,0,4
83179,190,21304,27382;27614;29613,63510,0,0,3,0,3
83180,190,21305,27621;30582;30834,63510,1,1,1,0,3
83181,190,21306,27424;27653;29706,63510,0,1,2,0,3
83182,190,21307,27452;28003;30247,63510,0,1,2,0,3
83183,190,21308,27261;27470;29321;30129;30394,63510,0,2,3,0,5
83184,190,21309,27398;29424;29967,63510,0,1,2,0,3
83185,190,21310,27772;29888,63510,0,1,1,0,2
83186,190,21311,27466;27496;29878;30141,63510,0,2,2,0,4
83187,190,21312,27495;27523,63510,0,0,2,0,2
83188,190,21313,27661;28022;30160;30686;30863,63510,1,2,2,0,5
83189,190,21314,27591;27667,63510,0,0,2,0,2
83190,190,21315,27297;27594;30149;30317,63510,0,2,2,0,4
83191,190,21316,27679;27895;29711;30338;30599,63510,0,3,2,0,5
83192,190,21317,27607;27838,63510,0,0,2,0,2
83193,190,21318,27696,63510,0,0,1,0,1
83194,190,21319,27671;27867;30597;30952,63510,1,1,2,0,4
83195,190,21320,27606;28061;30864;31044,63510,2,0,2,0,4
83196,190,21321,27699;27978,63510,0,0,2,0,2
83197,190,21322,27641;27762;30419;30508;30670;30945,63510,1,3,2,0,6
83198,190,21323,27619;27721;29803,63510,0,1,2,0,3
83199,190,21324,27728;27839,63510,0,0,2,0,2
83200,190,21325,27794;27841;30511,63510,0,1,2,0,3
83201,190,21326,27842;28134;31046,63510,1,0,2,0,3
83202,190,21327,27276;27812;30754;30842;31029,63510,3,0,2,0,5
83203,190,21328,27791;27824;30752;31027,63510,2,0,2,0,4
83204,190,21329,27392;27832;30242,63510,0,1,2,0,3
83205,190,21330,27795;27840;29528;30332;30947,63510,1,1,3,0,5
83206,190,21333,24195,63875,0,0,0,1,1
83207,190,21334,23830,63875,0,0,0,1,1
83208,190,21335,23829,63875,0,0,0,1,1
83209,190,21336,23871,63875,0,0,0,1,1
83210,190,21337,24233,63875,0,0,0,1,1
83211,190,21338,24236,63875,0,0,0,1,1
83212,190,21339,24259,63875,0,0,0,1,1
83213,190,21346,24838,63875,0,0,0,1,1
83214,190,21347,24738,63875,0,0,0,1,1
83215,190,21350,24959,63875,0,0,1,0,1
83216,190,21362,26029;26425,63875,0,0,2,0,2
83217,190,21364,26168;26623;29753,63875,0,1,2,0,3
83218,190,21365,26333;26899;30016,63875,0,1,2,0,3
83219,190,21366,26445;26506,63875,0,0,2,0,2
83220,190,21368,26265;26724;29759,63875,0,1,2,0,3
83221,190,21369,26642;26954;29222;29505;29772,63875,0,1,4,0,5
83222,190,21370,26405;26703;29213;29306,63875,0,0,4,0,4
83223,190,21373,27200;30478,63875,0,1,1,0,2
83224,190,21374,26733;26786;29932,63875,0,1,2,0,3
83225,190,21376,26872;26960;29773;30283;30813,63875,1,2,2,0,5
83226,190,21377,26790;27227,63875,0,0,2,0,2
83227,190,21380,27063;29778,63875,0,1,1,0,2
83228,190,21381,27089;27248;29515;29693;30127;30480,63875,0,3,3,0,6
83229,190,21382,27133;27161;29784;30642;30818,63875,1,2,2,0,5
83230,190,21383,27146;27518;29600;29948;30117,63875,0,2,3,0,5
83231,190,21384,27205;27275;30215,63875,0,1,2,0,3
83232,190,21385,27094;27216;29033;29954;30036;30125;30301,63875,0,4,3,0,7
83233,190,21386,27207;27333;29423;29793;30133;30565;30651,63875,0,4,3,0,7
83234,190,21387,27491;27746;30326;30669;30942,63875,1,2,2,0,5
83235,190,21388,27375;27448;29877;30402;30573,63875,0,3,2,0,5
83236,190,21389,27401;27429;30047;31098,63875,1,1,2,0,4
83237,190,21390,27410;27558;30054,63875,0,1,2,0,3
83238,190,21391,27426;27937;30157,63875,0,1,2,0,3
83239,190,21392,27454;27683;30748,63875,1,0,2,0,3
83240,190,21393,27222;27455,63875,0,0,2,0,2
83241,190,21394,27460;27636;29232;29704;30935,63875,1,1,3,0,5
83242,190,21395,27445;27803;30592,63875,0,1,2,0,3
83243,190,21396,27608;30833;31019,63875,2,0,1,0,3
83244,190,21397,27104;27569;29324;30498;30662,63875,0,2,3,0,5
83245,190,21398,27504;27901;29978;30601,63875,0,2,2,0,4
83246,190,21399,27413;27507;29795;30226,63875,0,2,2,0,4
83247,190,21400,27509;27742;29610;30494,63875,0,1,3,0,4
83248,190,21401,27533;27689,63875,0,0,2,0,2
83249,190,21402,27534;30408,63875,0,1,1,0,2
83250,190,21403,27515;28006;30248;30521,63875,0,2,2,0,4
83251,190,21404,27921;27981;30159;30764;31039,63875,2,1,2,0,5
83252,190,21406,27627,63875,0,0,1,0,1
83253,190,21407,27643;28002;30606,63875,0,1,2,0,3
83254,190,21408,27505,63875,0,0,1,0,1
83255,190,21409,27352;27541;30933,63875,1,0,2,0,3
83256,190,21410,27963;30681,63875,0,1,1,0,2
83257,190,21411,27710;27711;30058;31105,63875,1,1,2,0,4
83258,190,21412,27451;27665;30153;30322;30412;30746,63875,1,3,2,0,6
83259,190,21413,27737;28098;29712;30772,63875,1,1,2,0,4
83260,190,21414,28072;30250;31125,63875,1,1,1,0,3
83261,190,21415,27759;27814,63875,0,0,2,0,2
83262,190,21416,27846;28256,63875,0,0,2,0,2
83263,190,21417,27798;27847;30333;30422;30948,63875,1,2,2,0,5
83264,190,21418,27682;27848;30595,63875,0,1,2,0,3
83265,190,21419,28199;29985;30781,63875,1,1,1,0,3
83266,190,21420,27882;28249,63875,0,0,2,0,2
83267,190,21421,27899;28232,63875,0,0,2,0,2
83268,190,21422,27884;27908,63875,0,0,2,0,2
83269,190,21423,27571;27918;30761,63875,1,0,2,0,3
83270,190,21424,27930;28040,63875,0,0,2,0,2
83271,190,21425,27936;28260;30350;31138,63875,1,1,2,0,4
83272,190,21426,27938;28052;30689;31043;31124,63875,2,1,2,0,5
83273,190,21427,27955;28400;30172;30891,63875,1,1,2,0,4
83274,190,21428,28105;30527,63875,0,1,1,0,2
83275,190,21429,27961;28188;30877,63875,1,0,2,0,3
83276,190,21431,24238,64240,0,0,0,1,1
83277,190,21433,24312,64240,0,0,0,1,1
83278,190,21436,24965,64240,0,0,1,0,1
83279,190,21437,24729,64240,0,0,0,1,1
83280,190,21445,25323,64240,0,0,1,0,1
83281,190,21453,26761;27125;29864,64240,0,1,2,0,3
83282,190,21454,26788;26789;30007;30371,64240,0,2,2,0,4
83283,190,21455,26796;27174;30388;30475,64240,0,2,2,0,4
83284,190,21456,26804;26848;29763;29850;30012,64240,0,3,2,0,5
83285,190,21459,26672;26949,64240,0,0,2,0,2
83286,190,21460,27069;27407;30049;30827,64240,1,1,2,0,4
83287,190,21461,27131;27298;30474,64240,0,1,2,0,3
83288,190,21462,27100;27372;29964;30045;30222;30485;30567,64240,0,5,2,0,7
83289,190,21463,27163;27709;30324,64240,0,1,2,0,3
83290,190,21464,27219;27611;30319,64240,0,1,2,0,3
83291,190,21465,27235;29790,64240,0,1,1,0,2
83292,190,21466,26835;27351;29873;30824,64240,1,1,2,0,4
83293,190,21467,27365;27395,64240,0,0,2,0,2
83294,190,21468,27439;27622;29885;29972,64240,0,2,2,0,4
83295,190,21470,27501;27760;29804;30328;30589,64240,0,3,2,0,5
83296,190,21471,27529;27970,64240,0,0,2,0,2
83297,190,21472,27544;27613;30320;30502,64240,0,2,2,0,4
83298,190,21473,27557;27810;30423;30514,64240,0,2,2,0,4
83299,190,21474,27595;28023;29981;30435;30523,64240,0,3,2,0,5
83300,190,21475,27598;27851;30676,64240,0,1,2,0,3
83301,190,21476,27604;30580;30744,64240,1,1,1,0,3
83302,190,21478,27379;30046;30926,64240,1,1,1,0,3
83303,190,21479,27703;28348;30170;30977,64240,1,1,2,0,4
83304,190,21481,27243;27745,64240,0,0,2,0,2
83305,190,21482,27753;28191;30696;30779;31052;31132,64240,3,1,2,0,6
83306,190,21483,27767;28317,64240,0,0,2,0,2
83307,190,21484,27771;27868;29710;30851,64240,1,1,2,0,4
83308,190,21485,27775;27979;30245;30432;30763;30859;31120,64240,3,2,2,0,7
83309,190,21486,28295,64240,0,0,1,0,1
83310,190,21487,27187;27796;30512,64240,0,1,2,0,3
83311,190,21488,27811;27976,64240,0,0,2,0,2
83312,190,21489,27825;27863;30426;31113,64240,1,1,2,0,4
83313,190,21491,27754;27865;30757;31032,64240,2,0,2,0,4
83314,190,21492,27891;28110;30965,64240,1,0,2,0,3
83315,190,21493,27510;27919;30855;31035,64240,2,0,2,0,4
83316,190,21494,27823;27922;30340;30602;30856;31036,64240,2,2,2,0,6
83317,190,21495,27363;27931;29808;29892;30679,64240,0,3,2,0,5
83318,190,21496,27935;28212;30532;30697,64240,0,2,2,0,4
83319,190,21497,27681;27941;31118,64240,1,0,2,0,3
83320,190,21498,27959;28215;30972,64240,1,0,2,0,3
83321,190,21499,27966;28291,64240,0,0,2,0,2
83322,190,21500,27900;29433,64240,0,0,2,0,2
83323,190,21501,27988;28333;30535;30787;31143,64240,2,1,2,0,5
83324,190,21502,28100;28220;30440,64240,0,1,2,0,3
83325,190,21503,28024;28164;30611;31051,64240,1,1,2,0,4
83326,190,21504,28318;28361;31142,64240,1,0,2,0,3
83327,190,21505,28044;28178;30438;30777,64240,1,1,2,0,4
83328,190,21506,27672;27991;30684,64240,0,1,2,0,3
83329,190,21507,24057;24431,64605,0,0,0,2,2
83330,190,21509,23731,64605,0,0,0,1,1
83331,190,21511,24382,64605,0,0,0,1,1
83332,190,21512,24252,64605,0,0,0,1,1
83333,190,21515,24170,64605,0,0,0,1,1
83334,190,21520,24771,64605,0,0,0,1,1
83335,190,21524,24724,64605,0,0,0,1,1
83336,190,21526,25032;25144,64605,0,0,2,0,2
83337,190,21533,26082;26253;29368,64605,0,0,3,0,3
83338,190,21535,26024;26359;29170;29453;29630,64605,0,1,4,0,5
83339,190,21537,26298,64605,0,0,1,0,1
83340,190,21539,26277;26685,64605,0,0,2,0,2
83341,190,21540,26654,64605,0,0,1,0,1
83342,190,21541,26555;26936;29221,64605,0,0,3,0,3
83343,190,21542,26041;26599,64605,0,0,2,0,2
83344,190,21544,26838,64605,0,0,1,0,1
83345,190,21545,26865;27106;30295;30551;30817,64605,1,2,2,0,5
83346,190,21546,26533,64605,0,0,1,0,1
83347,190,21548,26930;27211,64605,0,0,2,0,2
83348,190,21549,26866;26982;29596;30021;30286;30548,64605,0,3,3,0,6
83349,190,21551,27144;29687;30384;30731,64605,1,2,1,0,4
83350,190,21552,27162,64605,0,0,1,0,1
83351,190,21553,27166;27247;30029;30205,64605,0,2,2,0,4
83352,190,21554,27871;30243;30953,64605,1,1,1,0,3
83353,190,21557,27266;27781;29890;30840,64605,1,1,2,0,4
83354,190,21558,27267;27312;30132;31095,64605,1,1,2,0,4
83355,190,21559,27283;27691;31023,64605,1,0,2,0,3
83356,190,21560,27321;27522;30143,64605,0,1,2,0,3
83357,190,21561,27646;29327,64605,0,0,2,0,2
83358,190,21562,27343;27376,64605,0,0,2,0,2
83359,190,21563,26784;27356;30135,64605,0,1,2,0,3
83360,190,21564,27077;27341,64605,0,0,2,0,2
83361,190,21565,27154;27412;30050;30138;30225,64605,0,3,2,0,5
83362,190,21567,27308;27473;30053,64605,0,1,2,0,3
83363,190,21568,27197;27474;30405;30659,64605,0,2,2,0,4
83364,190,21570,27634;27996;30766,64605,1,0,2,0,3
83365,190,21571,27637,64605,0,0,1,0,1
83366,190,21572,27674;27929,64605,0,0,2,0,2
83367,190,21574,27579;27685;29612;29701;29883;30499,64605,0,3,3,0,6
83368,190,21575,27390;27469;29231;29879;30404;30575,64605,0,3,3,0,6
83369,190,21576,27743;28095;30868,64605,1,0,2,0,3
83370,190,21577,27784;28086,64605,0,0,2,0,2
83371,190,21578,27792;28088;30331;30510;30841,64605,1,2,2,0,5
83372,190,21579,27800;27820;29617;30753,64605,1,0,3,0,4
83373,190,21580,27967,64605,0,0,1,0,1
83374,190,21581,27844;28007;29980,64605,0,1,2,0,3
83375,190,21582,27883;28147;31130,64605,1,0,2,0,3
83376,190,21583,27909;29807;30431,64605,0,2,1,0,3
83377,190,21584,27910;28211;30167,64605,0,1,2,0,3
83378,190,21585,27856;28114,64605,0,0,2,0,2
83379,190,21586,27282;27925;30956;31116,64605,2,0,2,0,4
83380,190,21587,27950;28169,64605,0,0,2,0,2
83381,190,21588,27990;28070;30690,64605,0,1,2,0,3
83382,190,21589,27894;28013;30343,64605,0,1,2,0,3
83383,190,21590,28018;28240,64605,0,0,2,0,2
83384,190,21591,28021;28384,64605,0,0,2,0,2
83385,190,21592,28049;28557,64605,0,0,2,0,2
83386,190,21593,28062;28252;30703,64605,0,1,2,0,3
83387,190,21594,28083;28117,64605,0,0,2,0,2
83388,190,21595,27852;28121;30608,64605,0,1,2,0,3
83389,190,21596,28131;28305,64605,0,0,2,0,2
83390,190,21597,28142;28422;30619;30893;31062,64605,2,1,2,0,5
83391,190,21598,28154;28323;30705,64605,0,1,2,0,3
83392,190,21599,28171;28452,64605,0,0,2,0,2
83393,190,21600,23975,64970,0,0,0,1,1
83394,190,21601,24339,64970,0,0,0,1,1
83395,190,21602,24418,64970,0,0,0,1,1
83396,190,21604,24052,64970,0,0,0,1,1
83397,190,21605,24209,64970,0,0,0,1,1
83398,190,21611,24775;24923,64970,0,0,1,1,2
83399,190,21613,25399;25617,64970,0,0,2,0,2
83400,190,21618,25633,64970,0,0,1,0,1
83401,190,21619,25653,64970,0,0,1,0,1
83402,190,21620,25730,64970,0,0,1,0,1
83403,190,21621,25747;25752,64970,0,0,2,0,2
83404,190,21622,25270;25338,64970,0,0,2,0,2
83405,190,21623,25808,64970,0,0,1,0,1
83406,190,21624,25895,64970,0,0,1,0,1
83407,190,21626,25983,64970,0,0,1,0,1
83408,190,21631,26697;30730,64970,1,0,1,0,2
83409,190,21632,26225;26338;29646;29728,64970,0,2,2,0,4
83410,190,21634,26849;27411;30571,64970,0,1,2,0,3
83411,190,21636,26924;27064,64970,0,0,2,0,2
83412,190,21638,27005;27475;29969;30142,64970,0,2,2,0,4
83413,190,21639,27014;27708;29708;29974;30749;30937,64970,2,2,2,0,6
83414,190,21640,26805;27037;30196,64970,0,1,2,0,3
83415,190,21641,27086;30472,64970,0,1,1,0,2
83416,190,21642,26531,64970,0,0,1,0,1
83417,190,21643,27159;27265;30027;30204,64970,0,2,2,0,4
83418,190,21644,27362;29961,64970,0,1,1,0,2
83419,190,21645,27085;27369;30566;30826;31096,64970,2,1,2,0,5
83420,190,21646,27610;29525;30236;30318;30501,64970,0,3,2,0,5
83421,190,21647,27828;27968;30424;31111,64970,1,1,2,0,4
83422,190,21648,27489;27903;30853,64970,1,0,2,0,3
83423,190,21649,27506;27943;31038,64970,1,0,2,0,3
83424,190,21650,27512;28073,64970,0,0,2,0,2
83425,190,21651,27325;27525,64970,0,0,2,0,2
83426,190,21652,27456;27668,64970,0,0,2,0,2
83427,190,21653,27677;30747,64970,1,0,1,0,2
83428,190,21655,27666;27744;30668;30941,64970,1,1,2,0,4
83429,190,21656,27813;30593;30843;30949;31030,64970,3,1,1,0,5
83430,190,21657,28153;28186,64970,0,0,2,0,2
83431,190,21658,27731;28380,64970,0,0,2,0,2
83432,190,21659,28124;31045,64970,1,0,1,0,2
83433,190,21660,27769;28194;30780;31133,64970,2,0,2,0,4
83434,190,21661,27342;28205,64970,0,0,2,0,2
83435,190,21662,27783;28222;30699,64970,0,1,2,0,3
83436,190,21663,27782;27818;30241;30515;30844,64970,1,2,2,0,5
83437,190,21664,27827;27992;30433;30520,64970,0,2,2,0,4
83438,190,21665,27830;27932;30594;31031,64970,1,1,2,0,4
83439,190,21666,27843;28032;30769,64970,1,0,2,0,3
83440,190,21667,27822;27886;30337;30677,64970,0,2,2,0,4
83441,190,21668,27896;28297;30600,64970,0,1,2,0,3
83442,190,21669,27578;27965;29894,64970,0,1,2,0,3
83443,190,21670,27877;27994;30860;30959;31121,64970,3,0,2,0,5
83444,190,21671,28011;28041,64970,0,0,2,0,2
83445,190,21673,28039;28127;29983,64970,0,1,2,0,3
83446,190,21674,28055;28125;29809;30770,64970,1,1,2,0,4
83447,190,21675,27849;28060;30249,64970,0,1,2,0,3
83448,190,21676,27730;28063;30064;30524;30865;30962,64970,2,2,2,0,6
83449,190,21677,28309;30168,64970,0,1,1,0,2
83450,190,21678,27801;28111;30164;30870,64970,1,1,2,0,4
83451,190,21679,28150;28182;30774,64970,1,0,2,0,3
83452,190,21680,28108;28162;30251;30529;30874;30968,64970,2,2,2,0,6
83453,190,21681,28035;28166;30530;30775;31131,64970,2,1,2,0,5
83454,190,21682,28193;28209;30252;30347,64970,0,2,2,0,4
83455,190,21683,28201;28444;30173,64970,0,1,2,0,3
83456,190,21684,28206,64970,0,0,1,0,1
83457,190,21685,28228;28415;30355;31061,64970,1,1,2,0,4
83458,190,21686,27974;28237;30784,64970,1,0,2,0,3
83459,190,21687,28451;30789,64970,1,0,1,0,2
83460,190,21688,27836;28101,64970,0,0,2,0,2
83461,190,21689,28247;28266;30704,64970,0,1,2,0,3
83462,190,21690,24034,65335,0,0,0,1,1
83463,190,21691,24342;24657,65335,0,0,0,2,2
83464,190,21692,24384,65335,0,0,0,1,1
83465,190,21693,24522;24847,65335,0,0,0,2,2
83466,190,21696,25082,65335,0,0,1,0,1
83467,190,21699,25327,65335,0,0,1,0,1
83468,190,21701,25368,65335,0,0,1,0,1
83469,190,21702,25518;25811,65335,0,0,2,0,2
83470,190,21707,25580,65335,0,0,1,0,1
83471,190,21709,25868;25872,65335,0,0,2,0,2
83472,190,21712,26309,65335,0,0,1,0,1
83473,190,21713,26628,65335,0,0,1,0,1
83474,190,21715,26399,65335,0,0,1,0,1
83475,190,21716,26468;26702;30004,65335,0,1,2,0,3
83476,190,21718,26570,65335,0,0,1,0,1
83477,190,21719,26637;26715;29839;30002,65335,0,2,2,0,4
83478,190,21720,26731;26814;29926,65335,0,1,2,0,3
83479,190,21722,27099;27368;29698;29963;30825,65335,1,2,2,0,5
83480,190,21723,27017;27101;30201;30294;30816,65335,1,2,2,0,5
83481,190,21724,27091;27136;29686;29783;30297;30640,65335,0,4,2,0,6
83482,190,21725,27370,65335,0,0,1,0,1
83483,190,21726,27201;31094,65335,1,0,1,0,2
83484,190,21727,27706;27726;29709;30938,65335,1,1,2,0,4
83485,190,21728,27303;27402;29323;29794;30048;30569;30927,65335,1,3,3,0,7
83486,190,21729,27218;27528;29880;30144,65335,0,2,2,0,4
83487,190,21730,27870;30759,65335,1,0,1,0,2
83488,190,21731,27538;27768;29527;30751;30839;31026;31108,65335,4,0,3,0,7
83489,190,21732,27545;27635,65335,0,0,2,0,2
83490,190,21733,27577;28043;30161;30688,65335,0,2,2,0,4
83491,190,21734,27277,65335,0,0,1,0,1
83492,190,21735,27349;27601;30134;30221;30652,65335,0,3,2,0,5
83493,190,21736,27750;27874;30427,65335,0,1,2,0,3
83494,190,21737,28196;28245,65335,0,0,2,0,2
83495,190,21738,27878;28273;30351;30883,65335,1,1,2,0,4
83496,190,21739,27928;28065,65335,0,0,2,0,2
83497,190,21740,27939;27960;30858;31117,65335,2,0,2,0,4
83498,190,21741,27897;30429;30678,65335,0,2,1,0,3
83499,190,21742,27756;27971,65335,0,0,2,0,2
83500,190,21743,28300;28314;30886;30975;31056,65335,3,0,2,0,5
83501,190,21744,28343,65335,0,0,1,0,1
83502,190,21745,28450;28572;30898;31066,65335,2,0,2,0,4
83503,190,21746,28046;28053,65335,0,0,2,0,2
83504,190,21747,28168;30969,65335,1,0,1,0,2
83505,190,21748,28064;28528,65335,0,0,2,0,2
83506,190,21749,27834;28177;30876,65335,1,0,2,0,3
83507,190,21750,28107;28270;30882,65335,1,0,2,0,3
83508,190,21751,28113;28192;30531,65335,0,1,2,0,3
83509,190,21752,28207;28387,65335,0,0,2,0,2
83510,190,21753,28145;28490,65335,0,0,2,0,2
83511,190,21754,28067;28183,65335,0,0,2,0,2
83512,190,21755,27774;28185,65335,0,0,2,0,2
83513,190,21756,28005;28213,65335,0,0,2,0,2
83514,190,21757,28187;28230;30700,65335,0,1,2,0,3
83515,190,21758,28408;28614,65335,0,0,2,0,2
83516,190,21759,28627,65335,0,0,1,0,1
83517,190,21760,27980;28263;30257,65335,0,1,2,0,3
83518,190,21761,28048;28353;31145,65335,1,0,2,0,3
83519,190,21762,27675;28356;30615,65335,0,1,2,0,3
83520,190,21763,28524;30443,65335,0,1,1,0,2
83521,190,21765,24349,65700,0,0,0,1,1
83522,190,21766,24371;24464,65700,0,0,0,2,2
83523,190,21767,24237,65700,0,0,0,1,1
83524,190,21768,24435;24444,65700,0,0,0,2,2
83525,190,21772,24263,65700,0,0,0,1,1
83526,190,21774,24512,65700,0,0,0,1,1
83527,190,21775,24531;24910;28109,65700,0,0,1,2,3
83528,190,21776,24581,65700,0,0,0,1,1
83529,190,21777,25012,65700,0,0,1,0,1
83530,190,21778,24837;25052,65700,0,0,1,1,2
83531,190,21779,25070,65700,0,0,1,0,1
83532,190,21787,25938,65700,0,0,1,0,1
83533,190,21788,26219;26380,65700,0,0,2,0,2
83534,190,21789,26295,65700,0,0,1,0,1
83535,190,21790,26150;26679;30366,65700,0,1,2,0,3
83536,190,21791,26756,65700,0,0,1,0,1
83537,190,21793,26996;27240;30211;30648,65700,0,2,2,0,4
83538,190,21795,27019;27508,65700,0,0,2,0,2
83539,190,21796,27300,65700,0,0,1,0,1
83540,190,21798,27519;27986;30604,65700,0,1,2,0,3
83541,190,21799,27857;30950,65700,1,0,1,0,2
83542,190,21801,27581;28267;30613,65700,0,1,2,0,3
83543,190,21802,27617,65700,0,0,1,0,1
83544,190,21803,27278;27657,65700,0,0,2,0,2
83545,190,21804,27663;27684;31022;31103,65700,2,0,2,0,4
83546,190,21805,27143;27688;30237;30323;30413,65700,0,3,2,0,5
83547,190,21806,27659;28116,65700,0,0,2,0,2
83548,190,21807,27620,65700,0,0,1,0,1
83549,190,21808,27705;27723;30325;30836,65700,1,1,2,0,4
83550,190,21809,28056;30771,65700,1,0,1,0,2
83551,190,21810,27860;30951,65700,1,0,1,0,2
83552,190,21811,27776;27920;30339;30517;30762;30955,65700,2,2,2,0,6
83553,190,21812,27977;28275;30352,65700,0,1,2,0,3
83554,190,21813,27983;28512,65700,0,0,2,0,2
83555,190,21814,27858;27987;30848,65700,1,0,2,0,3
83556,190,21815,27942;27995;30765,65700,1,0,2,0,3
83557,190,21816,28008;28542;30897,65700,1,0,2,0,3
83558,190,21817,28089;28363;30354,65700,0,1,2,0,3
83559,190,21818,28091;30525;30691,65700,0,2,1,0,3
83560,190,21819,28017,65700,0,0,1,0,1
83561,190,21820,28118;28307;30258,65700,0,1,2,0,3
83562,190,21821,28126;28250;30256;31054;31137,65700,2,1,2,0,5
83563,190,21822,28076;28136;30528;31047,65700,1,1,2,0,4
83564,190,21823,27806;28140;29984;30773;31048,65700,2,1,2,0,5
83565,190,21824,28156;28218,65700,0,0,2,0,2
83566,190,21825,28170;28217;30698;30783;30878;31135,65700,3,1,2,0,6
83567,190,21826,28685;30542,65700,0,1,1,0,2
83568,190,21827,28226;28540;30348;31053;31136,65700,2,1,2,0,5
83569,190,21828,27975;28271;31139,65700,1,0,2,0,3
83570,190,21829,28280,65700,0,0,1,0,1
83571,190,21830,28310,65700,0,0,1,0,1
83572,190,21831,28374;28734;30716,65700,0,1,2,0,3
83573,190,21833,28403;28519;30623;30710;30791;30982,65700,2,2,2,0,6
83574,190,21834,28243;28428,65700,0,0,2,0,2
83575,190,21835,28453;28509;30441,65700,0,1,2,0,3
83576,190,21836,28368;30706,65700,0,1,1,0,2
83577,190,21837,24478,66065,0,0,0,1,1
83578,190,21838,24772,66065,0,0,0,1,1
83579,190,21839,24976,66065,0,0,1,0,1
83580,190,21840,24899;24934,66065,0,0,1,1,2
83581,190,21841,24993,66065,0,0,1,0,1
83582,190,21845,25317,66065,0,0,1,0,1
83583,190,21849,25585,66065,0,0,1,0,1
83584,190,21853,25763;25980,66065,0,0,2,0,2
83585,190,21859,25970;26008,66065,0,0,2,0,2
83586,190,21861,26098;26386;29095;29197;29293,66065,0,0,5,0,5
83587,190,21866,26410;26477,66065,0,0,2,0,2
83588,190,21870,26791;26913;29311,66065,0,0,3,0,3
83589,190,21872,27004;27552;29611;30579,66065,0,1,3,0,4
83590,190,21873,26580;26850;29218;29936;30373,66065,0,2,3,0,5
83591,190,21874,27112;27463;30403;30658,66065,0,2,2,0,4
83592,190,21875,26990;27137;29599;30383,66065,0,1,3,0,4
83593,190,21876,27155;29689;30119;30641,66065,0,3,1,0,4
83594,190,21877,26974,66065,0,0,1,0,1
83595,190,21878,27208;27446;30051;30401,66065,0,2,2,0,4
83596,190,21879,27220;27905;30244;30430,66065,0,2,2,0,4
83597,190,21881,26959;27309;30131;30307,66065,0,2,2,0,4
83598,190,21883,27323,66065,0,0,1,0,1
83599,190,21884,27228;27385,66065,0,0,2,0,2
83600,190,21885,27348;27420;30310,66065,0,1,2,0,3
83601,190,21886,27264;27405;30224;30311;30570,66065,0,3,2,0,5
83602,190,21887,26942;27425,66065,0,0,2,0,2
83603,190,21888,27481;27850;29805;30061,66065,0,2,2,0,4
83604,190,21889,27951;28129,66065,0,0,2,0,2
83605,190,21890,27135;27177;29510;29685,66065,0,1,3,0,4
83606,190,21891,27923;30857,66065,1,0,1,0,2
83607,190,21892,27311;27649;30321,66065,0,1,2,0,3
83608,190,21893,27662;28026,66065,0,0,2,0,2
83609,190,21894,27305;27450;30140;30231;30657,66065,0,3,2,0,5
83610,190,21895,27548;27673;29526,66065,0,0,3,0,3
83611,190,21896,27403;27697;30238;30835,66065,1,1,2,0,4
83612,190,21897,27717;27998;30434;31040,66065,1,1,2,0,4
83613,190,21898,27773;30421;30946,66065,1,1,1,0,3
83614,190,21899,27422;27766;31107,66065,1,0,2,0,3
83615,190,21900,27804;27949;29893;30518;31119,66065,1,2,2,0,5
83616,190,21901,27384;27826;30673;30846;31110,66065,2,1,2,0,5
83617,190,21903,27564;27893,66065,0,0,2,0,2
83618,190,21904,28160,66065,0,0,1,0,1
83619,190,21905,27972;28001,66065,0,0,2,0,2
83620,190,21906,27755;27973;30341;30683;30957,66065,1,2,2,0,5
83621,190,21907,28123;30694;30871,66065,1,1,1,0,3
83622,190,21908,28009;28197,66065,0,0,2,0,2
83623,190,21909,27660;28019;30862,66065,1,0,2,0,3
83624,190,21910,28042;28189;30778;30971,66065,2,0,2,0,4
83625,190,21911,27807;28030;30345;31123,66065,1,1,2,0,4
83626,190,21912,28094;28152;31126,66065,1,0,2,0,3
83627,190,21913,28779,66065,0,0,1,0,1
83628,190,21914,28068;28139;30165;30695;31128,66065,1,2,2,0,5
83629,190,21915,28287;28579;30534;31055,66065,1,1,2,0,4
83630,190,21916,28304;30785,66065,1,0,1,0,2
83631,190,21917,28296;28320;30976,66065,1,0,2,0,3
83632,190,21918,28775;28796;30718;31163,66065,1,1,2,0,4
83633,190,21919,28337;28748;30717,66065,0,1,2,0,3
83634,190,21920,28347,66065,0,0,1,0,1
83635,190,21921,28358;31058,66065,1,0,1,0,2
83636,190,21922,28365;28480;30622;31064,66065,1,1,2,0,4
83637,190,21923,28120;28383;31146,66065,1,0,2,0,3
83638,190,21924,28394;28530,66065,0,0,2,0,2
83639,190,21925,28399;28412;30978,66065,1,0,2,0,3
83640,190,21926,28406;28471,66065,0,0,2,0,2
83641,190,21927,28376;28430;30356,66065,0,1,2,0,3
83642,190,21928,28439,66065,0,0,1,0,1
83643,190,21929,28306;28445,66065,0,0,2,0,2
83644,190,21930,28455;28848,66065,0,0,2,0,2
83645,190,21931,28746,66065,0,0,1,0,1
83646,190,21932,28282;28459;30974;31141,66065,2,0,2,0,4
83647,190,21933,28493,66065,0,0,1,0,1
83648,190,21934,28407;28521;30618,66065,0,1,2,0,3
83649,190,21935,28526;28583;30625,66065,0,1,2,0,3
83650,190,21936,28541;28674;30990,66065,1,0,2,0,3
83651,190,21937,28352;28543;30357,66065,0,1,2,0,3
83652,190,21939,24631;24681,66430,0,0,0,2,2
83653,190,21940,24251,66430,0,0,0,1,1
83654,190,21942,24815;24936,66430,0,0,1,1,2
83655,190,21944,24696,66430,0,0,0,1,1
83656,190,21948,25492,66430,0,0,1,0,1
83657,190,21950,25588,66430,0,0,1,0,1
83658,190,21953,25595,66430,0,0,1,0,1
83659,190,21954,25781,66430,0,0,1,0,1
83660,190,21956,26467,66430,0,0,1,0,1
83661,190,21960,26099,66430,0,0,1,0,1
83662,190,21961,26045,66430,0,0,1,0,1
83663,190,21964,26123,66430,0,0,1,0,1
83664,190,21966,26363;26644,66430,0,0,2,0,2
83665,190,21968,26443,66430,0,0,1,0,1
83666,190,21971,26482;26783;31093,66430,1,0,2,0,3
83667,190,21972,26897,66430,0,0,1,0,1
83668,190,21973,26908;27442,66430,0,0,2,0,2
83669,190,21975,26854;27080,66430,0,0,2,0,2
83670,190,21976,27119;27167;29867;30206;30299;30386;30555,66430,0,5,2,0,7
83671,190,21977,27121;27664,66430,0,0,2,0,2
83672,190,21978,27000,66430,0,0,1,0,1
83673,190,21979,26944;27148;29418;29949;30552,66430,0,2,3,0,5
83674,190,21980,27457;30928,66430,1,0,1,0,2
83675,190,21981,27170;27346,66430,0,0,2,0,2
83676,190,21982,27408;27761;29975;30838;30944,66430,2,1,2,0,5
83677,190,21983,27471;27892;30760;31034,66430,2,0,2,0,4
83678,190,21984,27336;27517;30314;30406,66430,0,2,2,0,4
83679,190,21985,27344,66430,0,0,1,0,1
83680,190,21986,27540;27993,66430,0,0,2,0,2
83681,190,21987,27561;27715;29887;30587,66430,0,2,2,0,4
83682,190,21988,27536;27600,66430,0,0,2,0,2
83683,190,21989,27477;27862;29976;30425,66430,0,2,2,0,4
83684,190,21990,27461,66430,0,0,1,0,1
83685,190,21991,27881;29806;31114,66430,1,1,1,0,3
83686,190,21992,27914;28138,66430,0,0,2,0,2
83687,190,21993,27954,66430,0,0,1,0,1
83688,190,21994,27964;29979;30519;30682,66430,0,3,1,0,4
83689,190,21995,28051;28137;30609,66430,0,1,2,0,3
83690,190,21996,27732;28074,66430,0,0,2,0,2
83691,190,21997,28080,66430,0,0,1,0,1
83692,190,21998,28259,66430,0,0,1,0,1
83693,190,21999,28104;28214;30692;30964,66430,1,1,2,0,4
83694,190,22000,28135;28233;30872;31127,66430,2,0,2,0,4
83695,190,22002,28141;28379,66430,0,0,2,0,2
83696,190,22003,27917;28143;31129,66430,1,0,2,0,3
83697,190,22004,28000;28155;30605;31041,66430,1,1,2,0,4
83698,190,22005,28200;28642,66430,0,0,2,0,2
83699,190,22006,28227;28299;30349;30879,66430,1,1,2,0,4
83700,190,22007,28302,66430,0,0,1,0,1
83701,190,22008,28047;28308,66430,0,0,2,0,2
83702,190,22009,28290;28332;30884,66430,1,0,2,0,3
83703,190,22010,28447,66430,0,0,1,0,1
83704,190,22011,28395;28440;30620;31147,66430,1,1,2,0,4
83705,190,22012,28436;28659;31159,66430,1,0,2,0,3
83706,190,22013,28449;28924,66430,0,0,2,0,2
83707,190,22014,28311;28473,66430,0,0,2,0,2
83708,190,22015,28483;28532;31151,66430,1,0,2,0,3
83709,190,22016,28500;28804,66430,0,0,2,0,2
83710,190,22017,28548;28940;30805;30908,66430,2,0,2,0,4
83711,190,22018,28556;28790,66430,0,0,2,0,2
83712,190,22019,28054;28578;31067,66430,1,0,2,0,3
83713,190,22021,28602;28766;31162,66430,1,0,2,0,3
83714,190,22022,28630;28719;30902,66430,1,0,2,0,3
83715,190,22023,28634;28745;30359,66430,0,1,2,0,3
83716,190,22024,28615;28657,66430,0,0,2,0,2
83717,190,22025,28258;28668;30901,66430,1,0,2,0,3
83718,190,22026,24605,66795,0,0,0,1,1
83719,190,22027,24311,66795,0,0,0,1,1
83720,190,22028,24726,66795,0,0,0,1,1
83721,190,22031,25555,66795,0,0,1,0,1
83722,190,22032,25301,66795,0,0,1,0,1
83723,190,22033,25417,66795,0,0,1,0,1
83724,190,22034,25207;25456,66795,0,0,2,0,2
83725,190,22036,25928;26481,66795,0,0,2,0,2
83726,190,22038,26037,66795,0,0,1,0,1
83727,190,22040,26132,66795,0,0,1,0,1
83728,190,22041,26194;26732;29583,66795,0,0,3,0,3
83729,190,22044,26301,66795,0,0,1,0,1
83730,190,22045,26281,66795,0,0,1,0,1
83731,190,22047,26226;26917;29312;29766;30547,66795,0,2,3,0,5
83732,190,22057,26968,66795,0,0,1,0,1
83733,190,22059,27026;27181;30819,66795,1,0,2,0,3
83734,190,22060,27134,66795,0,0,1,0,1
83735,190,22061,26793;27212;29512;29692;30645;30921,66795,1,2,3,0,6
83736,190,22062,26582;26691,66795,0,0,2,0,2
83737,190,22063,27246,66795,0,0,1,0,1
83738,190,22065,26998;27157;29419;30298,66795,0,1,3,0,4
83739,190,22066,27334;27639;29430;29705;31179,66795,1,1,3,0,5
83740,190,22068,27367;27397;30137,66795,0,1,2,0,3
83741,190,22069,27190;27263;29785;30476;30556,66795,0,3,2,0,5
83742,190,22070,27194;27453;29609,66795,0,0,3,0,3
83743,190,22071,27350;27589;30148;30316,66795,0,2,2,0,4
83744,190,22072,27484;27904,66795,0,0,2,0,2
83745,190,22074,27567;28027;29982;30961;31122,66795,2,1,2,0,5
83746,190,22075,27642;27819;29618;29891;30156,66795,0,2,3,0,5
83747,190,22076,27467;27632;30745,66795,1,0,2,0,3
83748,190,22078,27396,66795,0,0,1,0,1
83749,190,22079,27740;28016;30344;30768;30960,66795,2,1,2,0,5
83750,190,22080,27770;28560;30712,66795,0,1,2,0,3
83751,190,22081,28456,66795,0,0,1,0,1
83752,190,22082,27789;28448,66795,0,0,2,0,2
83753,190,22083,27859;28219;30253,66795,0,1,2,0,3
83754,190,22084,28014;28157;30610,66795,0,1,2,0,3
83755,190,22085,28241;28571;30984,66795,1,0,2,0,3
83756,190,22086,28071,66795,0,0,1,0,1
83757,190,22087,28036;28092;30436;30526,66795,0,2,2,0,4
83758,190,22088,27875;28099;30869,66795,1,0,2,0,3
83759,190,22089,27490;28158;30873;30967;31050,66795,3,0,2,0,5
83760,190,22090,28354,66795,0,0,1,0,1
83761,190,22091,28031;28236;30255;30701,66795,0,2,2,0,4
83762,190,22092,28255;28435,66795,0,0,2,0,2
83763,190,22093,28257,66795,0,0,1,0,1
83764,190,22094,28262;28313,66795,0,0,2,0,2
83765,190,22095,28204;28272;30065;31140,66795,1,1,2,0,4
83766,190,22096,28278;28527,66795,0,0,2,0,2
83767,190,22097,28279;28842,66795,0,0,2,0,2
83768,190,22098,28281;28325;30887,66795,1,0,2,0,3
83769,190,22099,28340;28663,66795,0,0,2,0,2
83770,190,22100,28079;28350,66795,0,0,2,0,2
83771,190,22101,28351;28683;31073,66795,1,0,2,0,3
83772,190,22102,28319;28367;30888,66795,1,0,2,0,3
83773,190,22104,28377;28488,66795,0,0,2,0,2
83774,190,22105,28388,66795,0,0,1,0,1
83775,190,22106,28393;28431,66795,0,0,2,0,2
83776,190,22107,28276;28423,66795,0,0,2,0,2
83777,190,22108,28465;30621;30894,66795,1,1,1,0,3
83778,190,22109,28472;28491;31149,66795,1,0,2,0,3
83779,190,22110,28489;28682,66795,0,0,2,0,2
83780,190,22111,28411;28494,66795,0,0,2,0,2
83781,190,22112,28457;28511,66795,0,0,2,0,2
83782,190,22113,28510;28525,66795,0,0,2,0,2
83783,190,22114,28533;28544;30624;30711,66795,0,2,2,0,4
83784,190,22115,28620;31069,66795,1,0,1,0,2
83785,190,22116,28545;28886,66795,0,0,2,0,2
83786,190,22117,28274;28551,66795,0,0,2,0,2
83787,190,22118,28432;28559,66795,0,0,2,0,2
83788,190,22119,28564;28679;30793,66795,1,0,2,0,3
83789,190,22120,28771;30994,66795,1,0,1,0,2
83790,190,22121,28605;30444;31156,66795,1,1,1,0,3
83791,190,22122,28613;28721;30066;30987,66795,1,1,2,0,4
83792,190,22123,28670;28965,66795,0,0,2,0,2
83793,190,22124,28621;28740,66795,0,0,2,0,2
83794,190,22125,28566;28622,66795,0,0,2,0,2
83795,190,22126,28328;28641,66795,0,0,2,0,2
83796,190,22127,28591;28654,66795,0,0,2,0,2
83797,190,22128,28660;29023,66795,0,0,2,0,2
83798,190,22129,28669;28824;30626,66795,0,1,2,0,3
83799,190,22130,28691;28744;30715,66795,0,1,2,0,3
83800,190,22131,28584;28707;31153,66795,1,0,2,0,3
83801,190,22132,28731;28933,66795,0,0,2,0,2
83802,190,22133,24686,67160,0,0,0,1,1
83803,190,22134,24860,67160,0,0,0,1,1
83804,190,22140,25635,67160,0,0,1,0,1
83805,190,22141,25696;25810,67160,0,0,2,0,2
83806,190,22142,25771;25788,67160,0,0,2,0,2
83807,190,22144,25708,67160,0,0,1,0,1
83808,190,22146,26088,67160,0,0,1,0,1
83809,190,22147,25820,67160,0,0,1,0,1
83810,190,22149,26334,67160,0,0,1,0,1
83811,190,22150,26341;26365,67160,0,0,2,0,2
83812,190,22151,26593;26762,67160,0,0,2,0,2
83813,190,22157,27050,67160,0,0,1,0,1
83814,190,22158,26961,67160,0,0,1,0,1
83815,190,22161,27441,67160,0,0,1,0,1
83816,190,22162,27669,67160,0,0,1,0,1
83817,190,22163,27887,67160,0,0,1,0,1
83818,190,22164,28172;30776,67160,1,0,1,0,2
83819,190,22165,27989;28409,67160,0,0,2,0,2
83820,190,22166,27574,67160,0,0,1,0,1
83821,190,22167,28029;28507;30708;30896,67160,1,1,2,0,4
83822,190,22169,28087;28180;30612;30970,67160,1,1,2,0,4
83823,190,22170,27984;28106;30607;30693,67160,0,2,2,0,4
83824,190,22171,28112;28484;30981,67160,1,0,2,0,3
83825,190,22172,28119;28747;30449,67160,0,1,2,0,3
83826,190,22173,28130;28316;30614,67160,0,1,2,0,3
83827,190,22174,28133;28149;30966,67160,1,0,2,0,3
83828,190,22175,28151;28466,67160,0,0,2,0,2
83829,190,22176,27787;28161,67160,0,0,2,0,2
83830,190,22177,27817;28261;29810,67160,0,1,2,0,3
83831,190,22178,28277,67160,0,0,1,0,1
83832,190,22179,28285;29030,67160,0,0,2,0,2
83833,190,22180,28298;28392;30885,67160,1,0,2,0,3
83834,190,22181,28336;28821;30800,67160,1,0,2,0,3
83835,190,22182,28069;28338;30353;30536;31057,67160,1,2,2,0,5
83836,190,22183,28221;28346;30533,67160,0,1,2,0,3
83837,190,22184,28349,67160,0,0,1,0,1
83838,190,22185,28360;28729,67160,0,0,2,0,2
83839,190,22186,28381,67160,0,0,1,0,1
83840,190,22187,28426;28434;30261,67160,0,1,2,0,3
83841,190,22188,27933;28429,67160,0,0,2,0,2
83842,190,22189,28128;28461,67160,0,0,2,0,2
83843,190,22190,28482;28600;30713;31155,67160,1,1,2,0,4
83844,190,22191,28485;28976,67160,0,0,2,0,2
83845,190,22192,28038;28515;30709,67160,0,1,2,0,3
83846,190,22194,28404;28580;30707,67160,0,1,2,0,3
83847,190,22195,28628;28861,67160,0,0,2,0,2
83848,190,22196,28575;28637;31158,67160,1,0,2,0,3
83849,190,22197,28644;28855;31083,67160,1,0,2,0,3
83850,190,22198,28715;28793;31164,67160,1,0,2,0,3
83851,190,22199,28750;30450;30904,67160,1,1,1,0,3
83852,190,22200,28676;28736;30714;30991,67160,1,1,2,0,4
83853,190,22201,28677;29017,67160,0,0,2,0,2
83854,190,22202,28568;28692,67160,0,0,2,0,2
83855,190,22203,28701;28954;31075,67160,1,0,2,0,3
83856,190,22204,28441;28710,67160,0,0,2,0,2
83857,190,22205,28696;28712;30447;31074,67160,1,1,2,0,4
83858,190,22206,28636;28730,67160,0,0,2,0,2
83859,190,22207,28767;28991;30722,67160,0,1,2,0,3
83860,190,22208,28782;28900,67160,0,0,2,0,2
83861,190,22209,28662;29005,67160,0,0,2,0,2
83862,190,22210,28812,67160,0,0,1,0,1
83863,190,22211,28709;28839,67160,0,0,2,0,2
83864,190,22212,28678;28847;30627;30720;30907,67160,1,2,2,0,5
83865,190,22215,25116,67525,0,0,1,0,1
83866,190,22216,25452,67525,0,0,1,0,1
83867,190,22217,25389,67525,0,0,1,0,1
83868,190,22218,25688,67525,0,0,1,0,1
83869,190,22221,26035,67525,0,0,1,0,1
83870,190,22223,26439;26594;29835,67525,0,1,2,0,3
83871,190,22224,26296,67525,0,0,1,0,1
83872,190,22225,26559,67525,0,0,1,0,1
83873,190,22226,26622;29838,67525,0,1,1,0,2
83874,190,22227,26798;27423;30399;30487;30739;30828,67525,2,2,2,0,6
83875,190,22228,26522;26852;30098,67525,0,1,2,0,3
83876,190,22231,27053,67525,0,0,1,0,1
83877,190,22234,26841;27193;30920,67525,1,0,2,0,3
83878,190,22235,27406,67525,0,0,1,0,1
83879,190,22236,27516,67525,0,0,1,0,1
83880,190,22237,27526;27625,67525,0,0,2,0,2
83881,190,22239,27573;28268;29987,67525,0,1,2,0,3
83882,190,22240,27609;27741;30155;30240,67525,0,2,2,0,4
83883,190,22241,27648,67525,0,0,1,0,1
83884,190,22242,27513;27707;29707;30154,67525,0,2,2,0,4
83885,190,22243,27718;28034,67525,0,0,2,0,2
83886,190,22247,27888;28739;30903,67525,1,0,2,0,3
83887,190,22249,28025,67525,0,0,1,0,1
83888,190,22250,27873;28028;31042,67525,1,0,2,0,3
83889,190,22251,28132;28469,67525,0,0,2,0,2
83890,190,22252,28146;28505;31152,67525,1,0,2,0,3
83891,190,22253,27853,67525,0,0,1,0,1
83892,190,22254,28175;28184,67525,0,0,2,0,2
83893,190,22255,28075,67525,0,0,1,0,1
83894,190,22256,28738,67525,0,0,1,0,1
83895,190,22257,28246;28442,67525,0,0,2,0,2
83896,190,22258,28264;28629;31070,67525,1,0,2,0,3
83897,190,22259,27885;28244;30702;30880,67525,1,1,2,0,4
83898,190,22260,28248;30881,67525,1,0,1,0,2
83899,190,22261,28334,67525,0,0,1,0,1
83900,190,22262,28364,67525,0,0,1,0,1
83901,190,22263,28294;28446,67525,0,0,2,0,2
83902,190,22264,28460;29104,67525,0,0,2,0,2
83903,190,22265,28362;28834,67525,0,0,2,0,2
83904,190,22266,28425;28470;31063;31148,67525,2,0,2,0,4
83905,190,22267,28342;28475,67525,0,0,2,0,2
83906,190,22268,28711,67525,0,0,1,0,1
83907,190,22269,28497;28508;30540;31065,67525,1,1,2,0,4
83908,190,22270,28714,67525,0,0,1,0,1
83909,190,22271,28427;28534,67525,0,0,2,0,2
83910,190,22272,28538;28687,67525,0,0,2,0,2
83911,190,22273,28402;28555,67525,0,0,2,0,2
83912,190,22274,28396;28582;30617;31060,67525,1,1,2,0,4
83913,190,22275,28590,67525,0,0,1,0,1
83914,190,22277,28618;28916;31167,67525,1,0,2,0,3
83915,190,22278,28283;28638;30445,67525,0,1,2,0,3
83916,190,22279,28643;28785,67525,0,0,2,0,2
83917,190,22280,28646,67525,0,0,1,0,1
83918,190,22281,28597;28665;30797;30989;31160,67525,3,0,2,0,5
83919,190,22282,28728;29176,67525,0,0,2,0,2
83920,190,22283,28758;28907,67525,0,0,2,0,2
83921,190,22284,28788,67525,0,0,1,0,1
83922,190,22285,28815;28961,67525,0,0,2,0,2
83923,190,22286,28819;29048,67525,0,0,2,0,2
83924,190,22287,28835;29061;31172,67525,1,0,2,0,3
83925,190,22288,28882;28942,67525,0,0,2,0,2
83926,190,22289,28901;28969;31171,67525,1,0,2,0,3
83927,190,22290,28918,67525,0,0,1,0,1
83928,190,22291,28857;28923,67525,0,0,2,0,2
83929,190,22292,25041,67890,0,0,1,0,1
83930,190,22297,24630,67890,0,0,0,1,1
83931,190,22298,25400,67890,0,0,1,0,1
83932,190,22300,25231,67890,0,0,1,0,1
83933,190,22301,25487,67890,0,0,1,0,1
83934,190,22302,25274,67890,0,0,1,0,1
83935,190,22303,25626,67890,0,0,1,0,1
83936,190,22306,25923,67890,0,0,1,0,1
83937,190,22307,25464,67890,0,0,1,0,1
83938,190,22308,25874,67890,0,0,1,0,1
83939,190,22309,26030,67890,0,0,1,0,1
83940,190,22310,25962;26149,67890,0,0,2,0,2
83941,190,22311,26378,67890,0,0,1,0,1
83942,190,22313,26611;26695,67890,0,0,2,0,2
83943,190,22315,26455;26768;30092,67890,0,1,2,0,3
83944,190,22319,26764,67890,0,0,1,0,1
83945,190,22322,27289;27588;29429,67890,0,0,3,0,3
83946,190,22324,27704;28096;30163;30346,67890,0,2,2,0,4
83947,190,22325,27631;27997;30246;30685;30767,67890,1,2,2,0,5
83948,190,22326,27854;30847,67890,1,0,1,0,2
83949,190,22327,27833;27913;31115,67890,1,0,2,0,3
83950,190,22328,28102;28341,67890,0,0,2,0,2
83951,190,22329,28103;28424,67890,0,0,2,0,2
83952,190,22330,28115;28167;30437;30875,67890,1,1,2,0,4
83953,190,22331,28223;28741,67890,0,0,2,0,2
83954,190,22332,28225,67890,0,0,1,0,1
83955,190,22333,28239;28667,67890,0,0,2,0,2
83956,190,22334,28288;28372,67890,0,0,2,0,2
83957,190,22335,28371,67890,0,0,1,0,1
83958,190,22336,28373,67890,0,0,1,0,1
83959,190,22337,28477;28737;30993,67890,1,0,2,0,3
83960,190,22338,28516,67890,0,0,1,0,1
83961,190,22339,28529,67890,0,0,1,0,1
83962,190,22340,28503;28554,67890,0,0,2,0,2
83963,190,22341,28570;28913,67890,0,0,2,0,2
83964,190,22342,28546;28589;31154,67890,1,0,2,0,3
83965,190,22343,28588;28649,67890,0,0,2,0,2
83966,190,22344,28586;28632;30899,67890,1,0,2,0,3
83967,190,22345,28617;28666;30795,67890,1,0,2,0,3
83968,190,22346,28437;28699;30448,67890,0,1,2,0,3
83969,190,22347,28717,67890,0,0,1,0,1
83970,190,22348,28732;28939;31169,67890,1,0,2,0,3
83971,190,22349,28234,67890,0,0,1,0,1
83972,190,22350,28458,67890,0,0,1,0,1
83973,190,22351,28786;28813,67890,0,0,2,0,2
83974,190,22352,28814;28846;31081,67890,1,0,2,0,3
83975,190,22353,28401;28822,67890,0,0,2,0,2
83976,190,22354,28829;29195;31006,67890,1,0,2,0,3
83977,190,22355,28694;28832;31079,67890,1,0,2,0,3
83978,190,22356,28833;29174,67890,0,0,2,0,2
83979,190,22357,28581;28867,67890,0,0,2,0,2
83980,190,22358,28647;28852;30998,67890,1,0,2,0,3
83981,190,22359,28863;28911,67890,0,0,2,0,2
83982,190,22360,28864;29144,67890,0,0,2,0,2
83983,190,22361,28809;28926;30802,67890,1,0,2,0,3
83984,190,22362,28945;29158,67890,0,0,2,0,2
83985,190,22363,28960,67890,0,0,1,0,1
83986,190,22364,29235,67890,0,0,1,0,1
83987,190,22365,28909;28968,67890,0,0,2,0,2
83988,190,22366,28972;29238,67890,0,0,2,0,2
83989,190,22367,28977;29172;30724;31090,67890,1,1,2,0,4
83990,190,22368,28984;29211;31176,67890,1,0,2,0,3
83991,190,22369,28994;29300,67890,0,0,2,0,2
83992,190,22370,28870;29010,67890,0,0,2,0,2
83993,190,22371,29018;29133,67890,0,0,2,0,2
83994,190,22372,29028;29257,67890,0,0,2,0,2
83995,190,22373,25035,68255,0,0,1,0,1
83996,190,22375,24780,68255,0,0,0,1,1
83997,190,22376,25292,68255,0,0,1,0,1
83998,190,22377,25562,68255,0,0,1,0,1
83999,190,22378,25625,68255,0,0,1,0,1
84000,190,22380,25769,68255,0,0,1,0,1
84001,190,22381,26106;26560,68255,0,0,2,0,2
84002,190,22383,25857,68255,0,0,1,0,1
84003,190,22384,25732,68255,0,0,1,0,1
84004,190,22388,26315,68255,0,0,1,0,1
84005,190,22391,26351,68255,0,0,1,0,1
84006,190,22392,26169;26354,68255,0,0,2,0,2
84007,190,22394,26977,68255,0,0,1,0,1
84008,190,22396,27399,68255,0,0,1,0,1
84009,190,22397,27260,68255,0,0,1,0,1
84010,190,22398,27485,68255,0,0,1,0,1
84011,190,22399,27394,68255,0,0,1,0,1
84012,190,22400,27539,68255,0,0,1,0,1
84013,190,22401,27654;28037;30687,68255,0,1,2,0,3
84014,190,22402,27735;27902,68255,0,0,2,0,2
84015,190,22403,28398,68255,0,0,1,0,1
84016,190,22404,27962;28355;30259,68255,0,1,2,0,3
84017,190,22405,27596,68255,0,0,1,0,1
84018,190,22406,27626,68255,0,0,1,0,1
84019,190,22407,27757,68255,0,0,1,0,1
84020,190,22408,28078;28467;30162;30867,68255,1,1,2,0,4
84021,190,22409,28159;28203;30782,68255,1,0,2,0,3
84022,190,22410,27879,68255,0,0,1,0,1
84023,190,22411,28190;28375,68255,0,0,2,0,2
84024,190,22412,28265;28539,68255,0,0,2,0,2
84025,190,22413,28286;28800,68255,0,0,2,0,2
84026,190,22414,27906;28293,68255,0,0,2,0,2
84027,190,22415,28315;28536,68255,0,0,2,0,2
84028,190,22416,28242,68255,0,0,1,0,1
84029,190,22417,28487;28681,68255,0,0,2,0,2
84030,190,22418,28562;28574,68255,0,0,2,0,2
84031,190,22419,28585,68255,0,0,1,0,1
84032,190,22420,28598;29065,68255,0,0,2,0,2
84033,190,22421,28604,68255,0,0,1,0,1
84034,190,22422,28626;28894;31000;31166,68255,2,0,2,0,4
84035,190,22423,29292,68255,0,0,1,0,1
84036,190,22424,28592;28653;30446;30541;31071,68255,1,2,2,0,5
84037,190,22425,28675;28927;30803;31168,68255,2,0,2,0,4
84038,190,22426,28700;29372,68255,0,0,2,0,2
84039,190,22427,28703;28897;31076,68255,1,0,2,0,3
84040,190,22428,28768;28838,68255,0,0,2,0,2
84041,190,22429,28844;29042,68255,0,0,2,0,2
84042,190,22430,28862;29037,68255,0,0,2,0,2
84043,190,22431,28896;29196,68255,0,0,2,0,2
84044,190,22432,28975;29204,68255,0,0,2,0,2
84045,190,22433,28986;29422,68255,0,0,2,0,2
84046,190,22434,28593;29000,68255,0,0,2,0,2
84047,190,22435,28612;29021,68255,0,0,2,0,2
84048,190,22436,29019;29026,68255,0,0,2,0,2
84049,190,22437,29053;29412,68255,0,0,2,0,2
84050,190,22438,28898;29057,68255,0,0,2,0,2
84051,190,22439,28755;29066;31173,68255,1,0,2,0,3
84052,190,22440,29083,68255,0,0,1,0,1
84053,190,22441,28996;29089,68255,0,0,2,0,2
84054,190,22442,29097;29100,68255,0,0,2,0,2
84055,190,22443,29099;29267,68255,0,0,2,0,2
84056,190,22444,28889;29109,68255,0,0,2,0,2
84057,190,22445,28949;29112,68255,0,0,2,0,2
84058,190,22446,29107;29117,68255,0,0,2,0,2
84059,190,22447,25159,68620,0,0,1,0,1
84060,190,22448,24810,68620,0,0,0,1,1
84061,190,22450,25246,68620,0,0,1,0,1
84062,190,22451,25140,68620,0,0,1,0,1
84063,190,22452,25394,68620,0,0,1,0,1
84064,190,22453,25325,68620,0,0,1,0,1
84065,190,22456,25806,68620,0,0,1,0,1
84066,190,22460,26604,68620,0,0,1,0,1
84067,190,22461,26129,68620,0,0,1,0,1
84068,190,22463,26748,68620,0,0,1,0,1
84069,190,22464,26551,68620,0,0,1,0,1
84070,190,22465,26549,68620,0,0,1,0,1
84071,190,22466,26750,68620,0,0,1,0,1
84072,190,22467,26863,68620,0,0,1,0,1
84073,190,22469,27231,68620,0,0,1,0,1
84074,190,22470,27256;27821;30516;30755;30845,68620,2,1,2,0,5
84075,190,22471,27440;27572;29800;31017,68620,1,1,2,0,4
84076,190,22472,27566,68620,0,0,1,0,1
84077,190,22473,27585,68620,0,0,1,0,1
84078,190,22474,27713,68620,0,0,1,0,1
84079,190,22475,27915,68620,0,0,1,0,1
84080,190,22476,27926;28148;30166;31049,68620,1,1,2,0,4
84081,190,22477,27952;28077;30866;30963,68620,2,0,2,0,4
84082,190,22479,28004,68620,0,0,1,0,1
84083,190,22480,28020,68620,0,0,1,0,1
84084,190,22481,27751,68620,0,0,1,0,1
84085,190,22482,28176;28179,68620,0,0,2,0,2
84086,190,22483,27786,68620,0,0,1,0,1
84087,190,22484,27855,68620,0,0,1,0,1
84088,190,22485,28224;28569,68620,0,0,2,0,2
84089,190,22486,27934,68620,0,0,1,0,1
84090,190,22487,28405;28753,68620,0,0,2,0,2
84091,190,22488,28284;28414;30979,68620,1,0,2,0,3
84092,190,22489,28416;28811,68620,0,0,2,0,2
84093,190,22491,28535,68620,0,0,1,0,1
84094,190,22492,28553;28561,68620,0,0,2,0,2
84095,190,22493,28330;28616;30988,68620,1,0,2,0,3
84096,190,22494,28645;29032,68620,0,0,2,0,2
84097,190,22495,27861,68620,0,0,1,0,1
84098,190,22496,28698;29132,68620,0,0,2,0,2
84099,190,22497,28706;28979,68620,0,0,2,0,2
84100,190,22498,28502,68620,0,0,1,0,1
84101,190,22499,28514,68620,0,0,1,0,1
84102,190,22500,28749;28868;31084,68620,1,0,2,0,3
84103,190,22501,28727;28763,68620,0,0,2,0,2
84104,190,22502,28784;28837,68620,0,0,2,0,2
84105,190,22503,28795,68620,0,0,1,0,1
84106,190,22504,29177,68620,0,0,1,0,1
84107,190,22505,28733;28988,68620,0,0,2,0,2
84108,190,22506,28845;29268,68620,0,0,2,0,2
84109,190,22507,28871;29272,68620,0,0,2,0,2
84110,190,22508,28874;29113,68620,0,0,2,0,2
84111,190,22509,28885;29047,68620,0,0,2,0,2
84112,190,22510,28772;28891;30905,68620,1,0,2,0,3
84113,190,22511,28895;29250,68620,0,0,2,0,2
84114,190,22512,28910;29038,68620,0,0,2,0,2
84115,190,22513,28716;28919,68620,0,0,2,0,2
84116,190,22514,28883;28928,68620,0,0,2,0,2
84117,190,22515,28929;29194,68620,0,0,2,0,2
84118,190,22516,28944;29121,68620,0,0,2,0,2
84119,190,22517,28783;28948,68620,0,0,2,0,2
84120,190,22518,28962,68620,0,0,1,0,1
84121,190,22519,29012,68620,0,0,1,0,1
84122,190,22520,29027;29365,68620,0,0,2,0,2
84123,190,22521,28937;29034,68620,0,0,2,0,2
84124,190,22522,29011;29044;30723,68620,0,1,2,0,3
84125,190,22523,29067;29074,68620,0,0,2,0,2
84126,190,22524,29094;29399,68620,0,0,2,0,2
84127,190,22525,29106;29258,68620,0,0,2,0,2
84128,190,22526,29069;29110,68620,0,0,2,0,2
84129,190,22527,28830;29125,68620,0,0,2,0,2
84130,190,22528,29152;29313,68620,0,0,2,0,2
84131,190,22529,29153;29167,68620,0,0,2,0,2
84132,190,22530,29183;29402,68620,0,0,2,0,2
84133,190,22531,29502,68620,0,0,1,0,1
84134,190,22532,29216;29281,68620,0,0,2,0,2
84135,190,22533,29223;29480,68620,0,0,2,0,2
84136,190,22534,28817;29230,68620,0,0,2,0,2
84137,190,22535,25223,68985,0,0,1,0,1
84138,190,22538,25733,68985,0,0,1,0,1
84139,190,22539,25866,68985,0,0,1,0,1
84140,190,22540,25786,68985,0,0,1,0,1
84141,190,22541,25977,68985,0,0,1,0,1
84142,190,22542,25919,68985,0,0,1,0,1
84143,190,22543,26113,68985,0,0,1,0,1
84144,190,22545,25869,68985,0,0,1,0,1
84145,190,22546,26109,68985,0,0,1,0,1
84146,190,22547,26462,68985,0,0,1,0,1
84147,190,22548,26713,68985,0,0,1,0,1
84148,190,22549,26972,68985,0,0,1,0,1
84149,190,22550,27051;27203;29870;30733,68985,1,1,2,0,4
84150,190,22551,27045,68985,0,0,1,0,1
84151,190,22552,26980,68985,0,0,1,0,1
84152,190,22553,27304,68985,0,0,1,0,1
84153,190,22554,27138,68985,0,0,1,0,1
84154,190,22555,27381,68985,0,0,1,0,1
84155,190,22556,27081,68985,0,0,1,0,1
84156,190,22557,27499,68985,0,0,1,0,1
84157,190,22558,27624,68985,0,0,1,0,1
84158,190,22559,27629;28165,68985,0,0,2,0,2
84159,190,22560,27725,68985,0,0,1,0,1
84160,190,22561,27493,68985,0,0,1,0,1
84161,190,22562,27809,68985,0,0,1,0,1
84162,190,22563,27805,68985,0,0,1,0,1
84163,190,22564,27829;28345,68985,0,0,2,0,2
84164,190,22565,27597,68985,0,0,1,0,1
84165,190,22566,27815,68985,0,0,1,0,1
84166,190,22567,27876;28235;29986;30254;30973,68985,1,2,2,0,5
84167,190,22568,27957,68985,0,0,1,0,1
84168,190,22569,28045,68985,0,0,1,0,1
84169,190,22570,28303;28324,68985,0,0,2,0,2
84170,190,22571,28321,68985,0,0,1,0,1
84171,190,22572,28359;28595;30260;30537;31059,68985,1,2,2,0,5
84172,190,22573,28066,68985,0,0,1,0,1
84173,190,22574,28389;28725;30543,68985,0,1,2,0,3
84174,190,22575,28386;28420;30171,68985,0,1,2,0,3
84175,190,22576,28081;28443;30539,68985,0,1,2,0,3
84176,190,22577,28462;28479;31150,68985,1,0,2,0,3
84177,190,22578,28517;28523;30790,68985,1,0,2,0,3
84178,190,22579,28496;28550;30358;30983,68985,1,1,2,0,4
84179,190,22580,28623,68985,0,0,1,0,1
84180,190,22581,28596,68985,0,0,1,0,1
84181,190,22582,28603;28773;30995,68985,1,0,2,0,3
84182,190,22583,28619;28635;30900,68985,1,0,2,0,3
84183,190,22584,28254,68985,0,0,1,0,1
84184,190,22585,28576,68985,0,0,1,0,1
84185,190,22586,28181,68985,0,0,1,0,1
84186,190,22587,28688;29191;31005,68985,1,0,2,0,3
84187,190,22588,28693;29188,68985,0,0,2,0,2
84188,190,22589,28735;28810,68985,0,0,2,0,2
84189,190,22590,28658,68985,0,0,1,0,1
84190,190,22591,28751;29291,68985,0,0,2,0,2
84191,190,22592,28799,68985,0,0,1,0,1
84192,190,22593,28754;28816;30799,68985,1,0,2,0,3
84193,190,22594,28827;28840;30801;31080,68985,2,0,2,0,4
84194,190,22595,28831,68985,0,0,1,0,1
84195,190,22596,28860,68985,0,0,1,0,1
84196,190,22597,28931;29123,68985,0,0,2,0,2
84197,190,22598,28905;29039,68985,0,0,2,0,2
84198,190,22599,29049;29193,68985,0,0,2,0,2
84199,190,22600,29052;29253,68985,0,0,2,0,2
84200,190,22601,29071;29566,68985,0,0,2,0,2
84201,190,22602,29116;29140,68985,0,0,2,0,2
84202,190,22603,29078;29118,68985,0,0,2,0,2
84203,190,22604,28938;29131,68985,0,0,2,0,2
84204,190,22605,28652;29145,68985,0,0,2,0,2
84205,190,22606,29063;29147,68985,0,0,2,0,2
84206,190,22607,28825;28893;30451,68985,0,1,2,0,3
84207,190,22608,29111;29180,68985,0,0,2,0,2
84208,190,22609,29184,68985,0,0,1,0,1
84209,190,22610,29226;29255;31177,68985,1,0,2,0,3
84210,190,22611,29227;29360,68985,0,0,2,0,2
84211,190,22612,29239;29246,68985,0,0,2,0,2
84212,190,22613,29241;29554,68985,0,0,2,0,2
84213,190,22614,29101;29249,68985,0,0,2,0,2
84214,190,22615,28851;29275,68985,0,0,2,0,2
84215,190,22616,29215;29289,68985,0,0,2,0,2
84216,190,22617,28648,68985,0,0,1,0,1
84217,190,22618,29303,68985,0,0,1,0,1
84218,190,22619,29308;29517,68985,0,0,2,0,2
84219,190,22620,25328,69350,0,0,1,0,1
84220,190,22621,25505,69350,0,0,1,0,1
84221,190,22622,25026,69350,0,0,1,0,1
84222,190,22623,25450,69350,0,0,1,0,1
84223,190,22624,24813,69350,0,0,0,1,1
84224,190,22625,25509,69350,0,0,1,0,1
84225,190,22627,25757,69350,0,0,1,0,1
84226,190,22628,25624,69350,0,0,1,0,1
84227,190,22629,25913,69350,0,0,1,0,1
84228,190,22630,25927,69350,0,0,1,0,1
84229,190,22631,25704,69350,0,0,1,0,1
84230,190,22632,25979,69350,0,0,1,0,1
84231,190,22633,25703,69350,0,0,1,0,1
84232,190,22635,26496,69350,0,0,1,0,1
84233,190,22636,26553,69350,0,0,1,0,1
84234,190,22637,26636,69350,0,0,1,0,1
84235,190,22638,26625,69350,0,0,1,0,1
84236,190,22640,26674,69350,0,0,1,0,1
84237,190,22641,26956,69350,0,0,1,0,1
84238,190,22642,27032,69350,0,0,1,0,1
84239,190,22643,26999,69350,0,0,1,0,1
84240,190,22644,26882,69350,0,0,1,0,1
84241,190,22645,27176,69350,0,0,1,0,1
84242,190,22646,26735,69350,0,0,1,0,1
84243,190,22647,27307,69350,0,0,1,0,1
84244,190,22648,27418,69350,0,0,1,0,1
84245,190,22649,27465,69350,0,0,1,0,1
84246,190,22650,27483,69350,0,0,1,0,1
84247,190,22651,27488,69350,0,0,1,0,1
84248,190,22652,27072,69350,0,0,1,0,1
84249,190,22653,27332,69350,0,0,1,0,1
84250,190,22654,27693;30503;30586;30936;31024,69350,2,2,1,0,5
84251,190,22655,27722,69350,0,0,1,0,1
84252,190,22656,27802,69350,0,0,1,0,1
84253,190,22657,27530,69350,0,0,1,0,1
84254,190,22658,28015,69350,0,0,1,0,1
84255,190,22659,27658,69350,0,0,1,0,1
84256,190,22660,27956,69350,0,0,1,0,1
84257,190,22661,27969,69350,0,0,1,0,1
84258,190,22662,27638,69350,0,0,1,0,1
84259,190,22663,27568,69350,0,0,1,0,1
84260,190,22664,28059,69350,0,0,1,0,1
84261,190,22665,28082;28390;30616;30889,69350,1,1,2,0,4
84262,190,22666,28058,69350,0,0,1,0,1
84263,190,22667,28251,69350,0,0,1,0,1
84264,190,22668,28050,69350,0,0,1,0,1
84265,190,22669,27869,69350,0,0,1,0,1
84266,190,22670,28329;28718;31161,69350,1,0,2,0,3
84267,190,22671,27999,69350,0,0,1,0,1
84268,190,22672,28344;28953,69350,0,0,2,0,2
84269,190,22673,28391,69350,0,0,1,0,1
84270,190,22674,28433,69350,0,0,1,0,1
84271,190,22675,27940,69350,0,0,1,0,1
84272,190,22676,28499,69350,0,0,1,0,1
84273,190,22677,28513;28970,69350,0,0,2,0,2
84274,190,22678,28656;29154,69350,0,0,2,0,2
84275,190,22679,28697;29020;30807,69350,1,0,2,0,3
84276,190,22680,28713;29035,69350,0,0,2,0,2
84277,190,22681,28752;28879;31077,69350,1,0,2,0,3
84278,190,22682,28690;28764;30992,69350,1,0,2,0,3
84279,190,22683,28797;29587,69350,0,0,2,0,2
84280,190,22684,28836,69350,0,0,1,0,1
84281,190,22685,28853;29025;30628;31082,69350,1,1,2,0,4
84282,190,22686,28869;28959;31170,69350,1,0,2,0,3
84283,190,22687,28872;28873,69350,0,0,2,0,2
84284,190,22688,28770;28884,69350,0,0,2,0,2
84285,190,22689,28958;29476,69350,0,0,2,0,2
84286,190,22690,28807;28980,69350,0,0,2,0,2
84287,190,22691,28858;29001,69350,0,0,2,0,2
84288,190,22692,28757;29029,69350,0,0,2,0,2
84289,190,22693,29059,69350,0,0,1,0,1
84290,190,22694,29081;30912,69350,1,0,1,0,2
84291,190,22695,29098;29200,69350,0,0,2,0,2
84292,190,22696,28932;29108,69350,0,0,2,0,2
84293,190,22697,29124,69350,0,0,1,0,1
84294,190,22698,28946;29139,69350,0,0,2,0,2
84295,190,22699,29175;29662,69350,0,1,1,0,2
84296,190,22700,29198,69350,0,0,1,0,1
84297,190,22701,29202;29494,69350,0,0,2,0,2
84298,190,22702,29220;29493,69350,0,0,2,0,2
84299,190,22703,29269;29585,69350,0,0,2,0,2
84300,190,22704,28956;29270,69350,0,0,2,0,2
84301,190,22705,29283;29564,69350,0,0,2,0,2
84302,190,22706,28955;29285,69350,0,0,2,0,2
84303,190,22707,29282;29290;30914,69350,1,0,2,0,3
84304,190,22708,29294;29541,69350,0,0,2,0,2
84305,190,22709,29434,69350,0,0,1,0,1
84306,190,22710,29320;29400,69350,0,0,2,0,2
84307,190,22711,29326;29597,69350,0,0,2,0,2
84308,190,22712,29332;29684,69350,0,1,1,0,2
84309,190,22713,29335;29425,69350,0,0,2,0,2
84310,190,22714,29337;29552,69350,0,0,2,0,2
84311,190,22715,29245;29338,69350,0,0,2,0,2
84312,190,22716,29342;29394;31009,69350,1,0,2,0,3
84313,190,22717,29343;29580,69350,0,0,2,0,2
84314,190,22718,28917;29347,69350,0,0,2,0,2
84315,190,22719,29353;29513,69350,0,0,2,0,2
84316,190,22720,29354,69350,0,0,1,0,1
84317,190,22721,29371;29605,69350,0,0,2,0,2
84318,190,22722,29386;29614,69350,0,0,2,0,2
84319,190,22723,29390;29621,69350,0,1,1,0,2
84320,190,22724,29395;29615,69350,0,0,2,0,2
84321,190,22725,29401;29697,69350,0,1,1,0,2
84322,190,22726,29405;29451,69350,0,0,2,0,2
84323,190,22727,29417;29666,69350,0,1,1,0,2
84324,200,11558,23566;23962,27375,0,0,0,2,2
84325,200,13309,22887,33215,0,0,0,1,1
84326,200,13979,23401,35405,0,0,0,1,1
84327,200,14002,24759;25162,35405,0,0,0,2,2
84328,200,14035,24917,35405,0,0,0,1,1
84329,200,14356,23769,36500,0,0,0,1,1
84330,200,14503,22985,37230,0,0,0,1,1
84331,200,14592,22380,37595,0,0,0,1,1
84332,200,14626,23895,37595,0,0,0,1,1
84333,200,14761,23680,37960,0,0,0,1,1
84334,200,14831,23570,38325,0,0,0,1,1
84335,200,14847,23989;24346,38325,0,0,0,2,2
84336,200,14857,23739,38325,0,0,0,1,1
84337,200,15066,24405;25078;25179;25197,39055,0,0,0,4,4
84338,200,15178,24633;24670,39420,0,0,0,2,2
84339,200,15194,24622;24826,39420,0,0,0,2,2
84340,200,15198,24672;25025,39420,0,0,0,2,2
84341,200,15448,26300;29631,40515,0,0,2,0,2
84342,200,15556,23176,40880,0,0,0,1,1
84343,200,15673,25491;25630,41245,0,0,0,2,2
84344,200,15808,24524;24819;25114,41975,0,0,0,3,3
84345,200,15921,24944;25130;26238,42340,0,0,1,2,3
84346,200,15947,22050,42340,0,0,0,1,1
84347,200,16007,25728,42705,0,0,0,1,1
84348,200,16100,23937,43070,0,0,0,1,1
84349,200,16114,21947,43070,0,0,0,1,1
84350,200,16132,21967,43070,0,0,0,1,1
84351,200,16148,22235,43070,0,0,0,1,1
84352,200,16305,24970,43800,0,0,0,1,1
84353,200,16312,21930,43800,0,0,0,1,1
84354,200,16323,22227,43800,0,0,0,1,1
84355,200,16327,22141,43800,0,0,0,1,1
84356,200,16337,22267,43800,0,0,0,1,1
84357,200,16345,22215,43800,0,0,0,1,1
84358,200,16348,25723;25941,43800,0,0,1,1,2
84359,200,16422,22302,44165,0,0,0,1,1
84360,200,16436,22298,44165,0,0,0,1,1
84361,200,16444,22331,44165,0,0,0,1,1
84362,200,16490,22508,44530,0,0,0,1,1
84363,200,16501,22296,44530,0,0,0,1,1
84364,200,16516,22699,44530,0,0,0,1,1
84365,200,16605,22273,44895,0,0,0,1,1
84366,200,16609,22713,44895,0,0,0,1,1
84367,200,16622,22442,44895,0,0,0,1,1
84368,200,16686,22158,45260,0,0,0,1,1
84369,200,16694,27132,45260,0,0,1,0,1
84370,200,16697,22793,45260,0,0,0,1,1
84371,200,16698,22437,45260,0,0,0,1,1
84372,200,16704,26630;29576,45260,0,0,2,0,2
84373,200,16706,22535,45260,0,0,0,1,1
84374,200,16713,22626,45260,0,0,0,1,1
84375,200,16777,22237,45625,0,0,0,1,1
84376,200,16778,22422;22681,45625,0,0,0,2,2
84377,200,16786,23052,45625,0,0,0,1,1
84378,200,16796,22714,45625,0,0,0,1,1
84379,200,16867,22617,45990,0,0,0,1,1
84380,200,16874,22255,45990,0,0,0,1,1
84381,200,16875,22683,45990,0,0,0,1,1
84382,200,16878,23014,45990,0,0,0,1,1
84383,200,16879,22809,45990,0,0,0,1,1
84384,200,16928,22185,46355,0,0,0,1,1
84385,200,16934,22449,46355,0,0,0,1,1
84386,200,16939,22578,46355,0,0,0,1,1
84387,200,16950,22792,46355,0,0,0,1,1
84388,200,16963,22965,46355,0,0,0,1,1
84389,200,16967,23205,46355,0,0,0,1,1
84390,200,16969,22850,46355,0,0,0,1,1
84391,200,16971,23250,46355,0,0,0,1,1
84392,200,16974,22530,46355,0,0,0,1,1
84393,200,16975,23206,46355,0,0,0,1,1
84394,200,16977,22987,46355,0,0,0,1,1
84395,200,16979,23248,46355,0,0,0,1,1
84396,200,17028,22283,46720,0,0,0,1,1
84397,200,17038,22521,46720,0,0,0,1,1
84398,200,17055,22951,46720,0,0,0,1,1
84399,200,17057,23243,46720,0,0,0,1,1
84400,200,17063,23194;23541,46720,0,0,0,2,2
84401,200,17066,23239,46720,0,0,0,1,1
84402,200,17135,22702,47085,0,0,0,1,1
84403,200,17140,25700,47085,0,0,0,1,1
84404,200,17142,22920,47085,0,0,0,1,1
84405,200,17145,23300,47085,0,0,0,1,1
84406,200,17148,22848;23108,47085,0,0,0,2,2
84407,200,17150,22935;23269,47085,0,0,0,2,2
84408,200,17151,23393,47085,0,0,0,1,1
84409,200,17159,23161,47085,0,0,0,1,1
84410,200,17161,23177,47085,0,0,0,1,1
84411,200,17163,23183;23407,47085,0,0,0,2,2
84412,200,17164,23299,47085,0,0,0,1,1
84413,200,17204,22287,47450,0,0,0,1,1
84414,200,17217,22826,47450,0,0,0,1,1
84415,200,17222,22967,47450,0,0,0,1,1
84416,200,17226,23013,47450,0,0,0,1,1
84417,200,17230,23018;23492,47450,0,0,0,2,2
84418,200,17232,23085,47450,0,0,0,1,1
84419,200,17234,22914;23318,47450,0,0,0,2,2
84420,200,17235,27763,47450,0,0,1,0,1
84421,200,17236,22947,47450,0,0,0,1,1
84422,200,17242,22996,47450,0,0,0,1,1
84423,200,17244,23154,47450,0,0,0,1,1
84424,200,17246,23417,47450,0,0,0,1,1
84425,200,17251,23479,47450,0,0,0,1,1
84426,200,17253,23435,47450,0,0,0,1,1
84427,200,17255,23199,47450,0,0,0,1,1
84428,200,17256,23273,47450,0,0,0,1,1
84429,200,17260,23360,47450,0,0,0,1,1
84430,200,17261,22986,47450,0,0,0,1,1
84431,200,17263,22803,47450,0,0,0,1,1
84432,200,17303,22810,47815,0,0,0,1,1
84433,200,17322,23349,47815,0,0,0,1,1
84434,200,17323,22883,47815,0,0,0,1,1
84435,200,17328,23134,47815,0,0,0,1,1
84436,200,17331,23192,47815,0,0,0,1,1
84437,200,17334,23244,47815,0,0,0,1,1
84438,200,17336,23281,47815,0,0,0,1,1
84439,200,17337,23581,47815,0,0,0,1,1
84440,200,17338,23153,47815,0,0,0,1,1
84441,200,17339,23120,47815,0,0,0,1,1
84442,200,17343,23288,47815,0,0,0,1,1
84443,200,17344,23200,47815,0,0,0,1,1
84444,200,17346,23498,47815,0,0,0,1,1
84445,200,17347,23188,47815,0,0,0,1,1
84446,200,17348,22928,47815,0,0,0,1,1
84447,200,17350,23639,47815,0,0,0,1,1
84448,200,17351,22962,47815,0,0,0,1,1
84449,200,17352,23572,47815,0,0,0,1,1
84450,200,17355,23384;23732,47815,0,0,0,2,2
84451,200,17415,25591;25965,48180,0,0,1,1,2
84452,200,17420,22593,48180,0,0,0,1,1
84453,200,17421,22893,48180,0,0,0,1,1
84454,200,17422,22802,48180,0,0,0,1,1
84455,200,17429,22719,48180,0,0,0,1,1
84456,200,17432,22440,48180,0,0,0,1,1
84457,200,17434,22823;23064,48180,0,0,0,2,2
84458,200,17438,23173;25312;29331,48180,0,0,1,2,3
84459,200,17445,23575,48180,0,0,0,1,1
84460,200,17446,23086;23452,48180,0,0,0,2,2
84461,200,17449,23726,48180,0,0,0,1,1
84462,200,17452,23846;24110,48180,0,0,0,2,2
84463,200,17456,23510,48180,0,0,0,1,1
84464,200,17457,23589;23601,48180,0,0,0,2,2
84465,200,17461,23645,48180,0,0,0,1,1
84466,200,17462,23442;23521,48180,0,0,0,2,2
84467,200,17463,23292,48180,0,0,0,1,1
84468,200,17465,23472,48180,0,0,0,1,1
84469,200,17466,23432,48180,0,0,0,1,1
84470,200,17468,23459,48180,0,0,0,1,1
84471,200,17512,22867,48545,0,0,0,1,1
84472,200,17518,22620,48545,0,0,0,1,1
84473,200,17526,23117,48545,0,0,0,1,1
84474,200,17529,23158,48545,0,0,0,1,1
84475,200,17532,22858,48545,0,0,0,1,1
84476,200,17533,23162,48545,0,0,0,1,1
84477,200,17534,22926,48545,0,0,0,1,1
84478,200,17547,23311,48545,0,0,0,1,1
84479,200,17548,23458,48545,0,0,0,1,1
84480,200,17550,23754,48545,0,0,0,1,1
84481,200,17552,23217,48545,0,0,0,1,1
84482,200,17554,23337;23389,48545,0,0,0,2,2
84483,200,17555,23304,48545,0,0,0,1,1
84484,200,17557,23342,48545,0,0,0,1,1
84485,200,17558,23405,48545,0,0,0,1,1
84486,200,17561,23428,48545,0,0,0,1,1
84487,200,17562,23107,48545,0,0,0,1,1
84488,200,17564,23615,48545,0,0,0,1,1
84489,200,17565,23388;23454,48545,0,0,0,2,2
84490,200,17567,23493;23785,48545,0,0,0,2,2
84491,200,17568,23515,48545,0,0,0,1,1
84492,200,17569,23538,48545,0,0,0,1,1
84493,200,17570,23821,48545,0,0,0,1,1
84494,200,17571,23562,48545,0,0,0,1,1
84495,200,17572,23568;23918,48545,0,0,0,2,2
84496,200,17573,23468,48545,0,0,0,1,1
84497,200,17609,22463,48910,0,0,0,1,1
84498,200,17611,23152,48910,0,0,0,1,1
84499,200,17615,23078,48910,0,0,0,1,1
84500,200,17618,22755,48910,0,0,0,1,1
84501,200,17619,22819,48910,0,0,0,1,1
84502,200,17623,23113,48910,0,0,0,1,1
84503,200,17629,23017,48910,0,0,0,1,1
84504,200,17630,23138,48910,0,0,0,1,1
84505,200,17631,23042;25701,48910,0,0,0,2,2
84506,200,17634,22950,48910,0,0,0,1,1
84507,200,17635,23350;23709,48910,0,0,0,2,2
84508,200,17637,23242,48910,0,0,0,1,1
84509,200,17638,23696;23710,48910,0,0,0,2,2
84510,200,17639,23735,48910,0,0,0,1,1
84511,200,17640,23252,48910,0,0,0,1,1
84512,200,17642,23313,48910,0,0,0,1,1
84513,200,17643,23548,48910,0,0,0,1,1
84514,200,17645,23647;23781,48910,0,0,0,2,2
84515,200,17647,23341,48910,0,0,0,1,1
84516,200,17648,23410,48910,0,0,0,1,1
84517,200,17649,23966;24075,48910,0,0,0,2,2
84518,200,17650,23513;24015,48910,0,0,0,2,2
84519,200,17651,23256,48910,0,0,0,1,1
84520,200,17653,23641,48910,0,0,0,1,1
84521,200,17654,23489,48910,0,0,0,1,1
84522,200,17655,23525,48910,0,0,0,1,1
84523,200,17656,23506,48910,0,0,0,1,1
84524,200,17659,23835,48910,0,0,0,1,1
84525,200,17660,23780,48910,0,0,0,1,1
84526,200,17661,23529;23537,48910,0,0,0,2,2
84527,200,17663,23585,48910,0,0,0,1,1
84528,200,17664,23502;24058,48910,0,0,0,2,2
84529,200,17665,23642,48910,0,0,0,1,1
84530,200,17667,23698,48910,0,0,0,1,1
84531,200,17702,22410,49275,0,0,0,1,1
84532,200,17705,23215,49275,0,0,0,1,1
84533,200,17709,22834,49275,0,0,0,1,1
84534,200,17716,22723,49275,0,0,0,1,1
84535,200,17724,23041,49275,0,0,0,1,1
84536,200,17727,23708,49275,0,0,0,1,1
84537,200,17728,23825,49275,0,0,0,1,1
84538,200,17729,23678,49275,0,0,0,1,1
84539,200,17730,23952,49275,0,0,0,1,1
84540,200,17731,23391,49275,0,0,0,1,1
84541,200,17733,23164,49275,0,0,0,1,1
84542,200,17734,24224,49275,0,0,0,1,1
84543,200,17735,23675,49275,0,0,0,1,1
84544,200,17736,23916,49275,0,0,0,1,1
84545,200,17737,27670;27778;30329;30509,49275,0,0,4,0,4
84546,200,17738,23542,49275,0,0,0,1,1
84547,200,17739,23614,49275,0,0,0,1,1
84548,200,17740,23590,49275,0,0,0,1,1
84549,200,17741,23963,49275,0,0,0,1,1
84550,200,17742,23640,49275,0,0,0,1,1
84551,200,17744,23630;26958,49275,0,0,1,1,2
84552,200,17746,23670,49275,0,0,0,1,1
84553,200,17748,23593;24111,49275,0,0,0,2,2
84554,200,17751,23326,49275,0,0,0,1,1
84555,200,17752,23762,49275,0,0,0,1,1
84556,200,17753,23797,49275,0,0,0,1,1
84557,200,17756,23820,49275,0,0,0,1,1
84558,200,17759,23609,49275,0,0,0,1,1
84559,200,17802,22949,49640,0,0,0,1,1
84560,200,17811,23433,49640,0,0,0,1,1
84561,200,17812,23125,49640,0,0,0,1,1
84562,200,17813,23774;23947,49640,0,0,0,2,2
84563,200,17816,22932,49640,0,0,0,1,1
84564,200,17818,23335;23706,49640,0,0,0,2,2
84565,200,17819,23346,49640,0,0,0,1,1
84566,200,17823,23683,49640,0,0,0,1,1
84567,200,17825,23983,49640,0,0,0,1,1
84568,200,17826,23588;23673,49640,0,0,0,2,2
84569,200,17827,23827,49640,0,0,0,1,1
84570,200,17829,23446;23870,49640,0,0,0,2,2
84571,200,17831,23677,49640,0,0,0,1,1
84572,200,17833,23798;24208,49640,0,0,0,2,2
84573,200,17834,23885,49640,0,0,0,1,1
84574,200,17835,24118,49640,0,0,0,1,1
84575,200,17837,23878,49640,0,0,0,1,1
84576,200,17838,23909;24179,49640,0,0,0,2,2
84577,200,17839,23926,49640,0,0,0,1,1
84578,200,17840,23932,49640,0,0,0,1,1
84579,200,17841,24241,49640,0,0,0,1,1
84580,200,17842,24031,49640,0,0,0,1,1
84581,200,17884,22943;23306,50005,0,0,0,2,2
84582,200,17886,23197,50005,0,0,0,1,1
84583,200,17887,23685,50005,0,0,0,1,1
84584,200,17891,23450,50005,0,0,0,1,1
84585,200,17894,23624,50005,0,0,0,1,1
84586,200,17895,23750,50005,0,0,0,1,1
84587,200,17896,23880,50005,0,0,0,1,1
84588,200,17897,23381,50005,0,0,0,1,1
84589,200,17899,23933,50005,0,0,0,1,1
84590,200,17900,23284,50005,0,0,0,1,1
84591,200,17903,23824,50005,0,0,0,1,1
84592,200,17906,23758,50005,0,0,0,1,1
84593,200,17907,23535,50005,0,0,0,1,1
84594,200,17909,23657,50005,0,0,0,1,1
84595,200,17910,23964,50005,0,0,0,1,1
84596,200,17911,23582,50005,0,0,0,1,1
84597,200,17913,23636,50005,0,0,0,1,1
84598,200,17914,23671,50005,0,0,0,1,1
84599,200,17915,23431;23900,50005,0,0,0,2,2
84600,200,17916,24029,50005,0,0,0,1,1
84601,200,17917,24248,50005,0,0,0,1,1
84602,200,17918,23773,50005,0,0,0,1,1
84603,200,17919,23887,50005,0,0,0,1,1
84604,200,17920,23783,50005,0,0,0,1,1
84605,200,17922,23802,50005,0,0,0,1,1
84606,200,17923,24152,50005,0,0,0,1,1
84607,200,17924,23826,50005,0,0,0,1,1
84608,200,17925,23832;23982,50005,0,0,0,2,2
84609,200,17926,23619;23851,50005,0,0,0,2,2
84610,200,17927,24044,50005,0,0,0,1,1
84611,200,17930,24221,50005,0,0,0,1,1
84612,200,17931,24100;24277,50005,0,0,0,2,2
84613,200,17932,23276;23954,50005,0,0,0,2,2
84614,200,17934,23654;23969,50005,0,0,0,2,2
84615,200,17935,23866,50005,0,0,0,1,1
84616,200,17937,24348,50005,0,0,0,1,1
84617,200,17939,23917,50005,0,0,0,1,1
84618,200,17940,23748,50005,0,0,0,1,1
84619,200,17942,24030;24266,50005,0,0,0,2,2
84620,200,17944,24008,50005,0,0,0,1,1
84621,200,17946,24078,50005,0,0,0,1,1
84622,200,17947,23981;24083,50005,0,0,0,2,2
84623,200,17991,22968,50370,0,0,0,1,1
84624,200,17995,22930,50370,0,0,0,1,1
84625,200,17998,23483,50370,0,0,0,1,1
84626,200,18002,23563,50370,0,0,0,1,1
84627,200,18009,23864,50370,0,0,0,1,1
84628,200,18013,23462,50370,0,0,0,1,1
84629,200,18014,23416,50370,0,0,0,1,1
84630,200,18017,23760,50370,0,0,0,1,1
84631,200,18018,23532,50370,0,0,0,1,1
84632,200,18019,23182;23646,50370,0,0,0,2,2
84633,200,18020,23540,50370,0,0,0,1,1
84634,200,18022,23534,50370,0,0,0,1,1
84635,200,18023,24003,50370,0,0,0,1,1
84636,200,18025,23763,50370,0,0,0,1,1
84637,200,18026,23715,50370,0,0,0,1,1
84638,200,18027,23920,50370,0,0,0,1,1
84639,200,18029,23833;24228,50370,0,0,0,2,2
84640,200,18030,24084,50370,0,0,0,1,1
84641,200,18034,23469;23868,50370,0,0,0,2,2
84642,200,18035,24202,50370,0,0,0,1,1
84643,200,18039,23980;24285,50370,0,0,0,2,2
84644,200,18040,24214,50370,0,0,0,1,1
84645,200,18042,24289,50370,0,0,0,1,1
84646,200,18043,24039,50370,0,0,0,1,1
84647,200,18045,24047,50370,0,0,0,1,1
84648,200,18046,24116;24460,50370,0,0,0,2,2
84649,200,18047,24160,50370,0,0,0,1,1
84650,200,18048,24033;24172,50370,0,0,0,2,2
84651,200,18049,24155;24181,50370,0,0,0,2,2
84652,200,18051,24368,50370,0,0,0,1,1
84653,200,18085,23210,50735,0,0,0,1,1
84654,200,18091,23208,50735,0,0,0,1,1
84655,200,18094,23118,50735,0,0,0,1,1
84656,200,18096,23204;23845,50735,0,0,0,2,2
84657,200,18103,23955,50735,0,0,0,1,1
84658,200,18105,23814,50735,0,0,0,1,1
84659,200,18108,24169,50735,0,0,0,1,1
84660,200,18109,23105;23800,50735,0,0,0,2,2
84661,200,18111,23610,50735,0,0,0,1,1
84662,200,18113,23714,50735,0,0,0,1,1
84663,200,18118,24338,50735,0,0,0,1,1
84664,200,18120,23945,50735,0,0,0,1,1
84665,200,18121,23727;23967,50735,0,0,0,2,2
84666,200,18122,24006,50735,0,0,0,1,1
84667,200,18123,24164,50735,0,0,0,1,1
84668,200,18126,23935;24098,50735,0,0,0,2,2
84669,200,18127,24104;24458,50735,0,0,0,2,2
84670,200,18128,24130;24282,50735,0,0,0,2,2
84671,200,18129,24072,50735,0,0,0,1,1
84672,200,18131,26877;27293;30734,50735,0,1,2,0,3
84673,200,18132,23888;24191,50735,0,0,0,2,2
84674,200,18172,22466,51100,0,0,0,1,1
84675,200,18174,22575;22675,51100,0,0,0,2,2
84676,200,18183,23057;23201,51100,0,0,0,2,2
84677,200,18188,23902,51100,0,0,0,1,1
84678,200,18189,23436,51100,0,0,0,1,1
84679,200,18190,23477,51100,0,0,0,1,1
84680,200,18191,23497,51100,0,0,0,1,1
84681,200,18192,23527,51100,0,0,0,1,1
84682,200,18193,23443;23530,51100,0,0,0,2,2
84683,200,18194,23720,51100,0,0,0,1,1
84684,200,18199,24162,51100,0,0,0,1,1
84685,200,18202,23600,51100,0,0,0,1,1
84686,200,18203,23857,51100,0,0,0,1,1
84687,200,18204,24376,51100,0,0,0,1,1
84688,200,18205,23950,51100,0,0,0,1,1
84689,200,18206,23953,51100,0,0,0,1,1
84690,200,18207,23972,51100,0,0,0,1,1
84691,200,18210,24332;24336,51100,0,0,0,2,2
84692,200,18211,24081,51100,0,0,0,1,1
84693,200,18213,24038,51100,0,0,0,1,1
84694,200,18214,24212;24291,51100,0,0,0,2,2
84695,200,18217,24187,51100,0,0,0,1,1
84696,200,18218,24283,51100,0,0,0,1,1
84697,200,18223,24211,51100,0,0,0,1,1
84698,200,18224,24216;24577,51100,0,0,0,2,2
84699,200,18225,24327,51100,0,0,0,1,1
84700,200,18226,24278;24290,51100,0,0,0,2,2
84701,200,18230,24324;24500,51100,0,0,0,2,2
84702,200,18234,23991,51100,0,0,0,1,1
84703,200,18236,23869;24363,51100,0,0,0,2,2
84704,200,18261,22184,51465,0,0,0,1,1
84705,200,18279,23834,51465,0,0,0,1,1
84706,200,18281,23721,51465,0,0,0,1,1
84707,200,18282,23634;23803,51465,0,0,0,2,2
84708,200,18283,23837,51465,0,0,0,1,1
84709,200,18284,23327;23595,51465,0,0,0,2,2
84710,200,18286,23665,51465,0,0,0,1,1
84711,200,18287,23365;23669,51465,0,0,0,2,2
84712,200,18288,23307,51465,0,0,0,1,1
84713,200,18289,23815,51465,0,0,0,1,1
84714,200,18291,23761,51465,0,0,0,1,1
84715,200,18292,23787,51465,0,0,0,1,1
84716,200,18293,23794;23899,51465,0,0,0,2,2
84717,200,18296,24168,51465,0,0,0,1,1
84718,200,18297,23790;24020,51465,0,0,0,2,2
84719,200,18298,24023;24432,51465,0,0,0,2,2
84720,200,18302,24068,51465,0,0,0,1,1
84721,200,18304,24398,51465,0,0,0,1,1
84722,200,18306,24428,51465,0,0,0,1,1
84723,200,18307,24144,51465,0,0,0,1,1
84724,200,18309,24182,51465,0,0,0,1,1
84725,200,18310,24574,51465,0,0,0,1,1
84726,200,18311,24129;24322,51465,0,0,0,2,2
84727,200,18312,24293,51465,0,0,0,1,1
84728,200,18313,24295;24320,51465,0,0,0,2,2
84729,200,18317,24090;24533,51465,0,0,0,2,2
84730,200,18318,24408,51465,0,0,0,1,1
84731,200,18319,23996;24420,51465,0,0,0,2,2
84732,200,18320,24436,51465,0,0,0,1,1
84733,200,18321,24457;24477,51465,0,0,0,2,2
84734,200,18366,24103,51830,0,0,0,1,1
84735,200,18367,27480,51830,0,0,1,0,1
84736,200,18369,23617;23656,51830,0,0,0,2,2
84737,200,18370,24166,51830,0,0,0,1,1
84738,200,18371,23713;24302,51830,0,0,0,2,2
84739,200,18373,23240,51830,0,0,0,1,1
84740,200,18374,23805;24205,51830,0,0,0,2,2
84741,200,18375,24227,51830,0,0,0,1,1
84742,200,18376,23738,51830,0,0,0,1,1
84743,200,18377,23898,51830,0,0,0,1,1
84744,200,18378,23998;24299,51830,0,0,0,2,2
84745,200,18379,24310,51830,0,0,0,1,1
84746,200,18381,24394;24539;28084,51830,0,0,1,2,3
84747,200,18383,24066,51830,0,0,0,1,1
84748,200,18384,24307;24656,51830,0,0,0,2,2
84749,200,18385,24122,51830,0,0,0,1,1
84750,200,18386,24450,51830,0,0,0,1,1
84751,200,18387,24180;24318,51830,0,0,0,2,2
84752,200,18388,24190,51830,0,0,0,1,1
84753,200,18389,24200,51830,0,0,0,1,1
84754,200,18392,24620,51830,0,0,0,1,1
84755,200,18394,24629,51830,0,0,0,1,1
84756,200,18395,24306;24323,51830,0,0,0,2,2
84757,200,18396,24788,51830,0,0,0,1,1
84758,200,18397,24396,51830,0,0,0,1,1
84759,200,18398,24406,51830,0,0,0,1,1
84760,200,18399,24439,51830,0,0,0,1,1
84761,200,18400,24854,51830,0,0,0,1,1
84762,200,18401,24452,51830,0,0,0,1,1
84763,200,18402,24281,51830,0,0,0,1,1
84764,200,18403,24850;24960,51830,0,0,0,2,2
84765,200,18404,24507,51830,0,0,0,1,1
84766,200,18405,24526,51830,0,0,0,1,1
84767,200,18406,24313;24646,51830,0,0,0,2,2
84768,200,18407,24530;24626,51830,0,0,0,2,2
84769,200,18408,24142;24534,51830,0,0,0,2,2
84770,200,18409,24485;24548,51830,0,0,0,2,2
84771,200,18410,24549;24797,51830,0,0,0,2,2
84772,200,18411,24404;24553,51830,0,0,0,2,2
84773,200,18436,21927,52195,0,0,0,1,1
84774,200,18448,23356,52195,0,0,0,1,1
84775,200,18452,24073,52195,0,0,0,1,1
84776,200,18453,23743,52195,0,0,0,1,1
84777,200,18459,24153,52195,0,0,0,1,1
84778,200,18461,23979,52195,0,0,0,1,1
84779,200,18462,23822,52195,0,0,0,1,1
84780,200,18463,24019;24087,52195,0,0,0,2,2
84781,200,18464,24469,52195,0,0,0,1,1
84782,200,18465,24361,52195,0,0,0,1,1
84783,200,18467,24127;24292,52195,0,0,0,2,2
84784,200,18468,24165,52195,0,0,0,1,1
84785,200,18471,24234,52195,0,0,0,1,1
84786,200,18473,24246,52195,0,0,0,1,1
84787,200,18475,24317;24580,52195,0,0,0,2,2
84788,200,18476,24235;24301,52195,0,0,0,2,2
84789,200,18477,24334;24410,52195,0,0,0,2,2
84790,200,18479,24370,52195,0,0,0,1,1
84791,200,18481,24126;24421,52195,0,0,0,2,2
84792,200,18482,24453,52195,0,0,0,1,1
84793,200,18484,24525,52195,0,0,0,1,1
84794,200,18485,24793,52195,0,0,0,1,1
84795,200,18486,24497,52195,0,0,0,1,1
84796,200,18490,24284;24551,52195,0,0,0,2,2
84797,200,18492,24878,52195,0,0,0,1,1
84798,200,18493,24739;24800,52195,0,0,0,2,2
84799,200,18495,24609,52195,0,0,0,1,1
84800,200,18496,24644;24849,52195,0,0,0,2,2
84801,200,18497,24613;25004,52195,0,0,0,2,2
84802,200,18498,24760;24906,52195,0,0,0,2,2
84803,200,18499,24513,52195,0,0,0,1,1
84804,200,18500,24651;24712,52195,0,0,0,2,2
84805,200,18501,24576;24652,52195,0,0,0,2,2
84806,200,18502,24669,52195,0,0,0,1,1
84807,200,18503,24683;24961,52195,0,0,0,2,2
84808,200,18550,24260,52560,0,0,0,1,1
84809,200,18551,24131,52560,0,0,0,1,1
84810,200,18552,23742,52560,0,0,0,1,1
84811,200,18554,24388,52560,0,0,0,1,1
84812,200,18555,23686;23856,52560,0,0,0,2,2
84813,200,18557,24440,52560,0,0,0,1,1
84814,200,18558,23811;23951,52560,0,0,0,2,2
84815,200,18560,24156,52560,0,0,0,1,1
84816,200,18561,24107,52560,0,0,0,1,1
84817,200,18562,24459;24607,52560,0,0,0,2,2
84818,200,18563,28567,52560,0,0,1,0,1
84819,200,18565,23928;24231,52560,0,0,0,2,2
84820,200,18566,24803,52560,0,0,0,1,1
84821,200,18567,24340,52560,0,0,0,1,1
84822,200,18569,24400,52560,0,0,0,1,1
84823,200,18571,24510;24606,52560,0,0,0,2,2
84824,200,18572,24298,52560,0,0,0,1,1
84825,200,18574,24480,52560,0,0,0,1,1
84826,200,18576,24114;24499,52560,0,0,0,2,2
84827,200,18577,24330;24639,52560,0,0,0,2,2
84828,200,18578,24547;24600;27890;29432;30063;30428;30598,52560,0,1,4,2,7
84829,200,18579,24572,52560,0,0,0,1,1
84830,200,18580,24449;24586,52560,0,0,0,2,2
84831,200,18581,24128;24642,52560,0,0,0,2,2
84832,200,18582,24661,52560,0,0,0,1,1
84833,200,18583,24617;24688,52560,0,0,0,2,2
84834,200,18584,24723;24897,52560,0,0,0,2,2
84835,200,18585,24745,52560,0,0,0,1,1
84836,200,18586,24801;24920;28762;31078;31335;31978,52560,1,2,1,2,6
84837,200,18587,24615,52560,0,0,0,1,1
84838,200,18588,24487;24818,52560,0,0,0,2,2
84839,200,18609,23147;23445,52925,0,0,0,2,2
84840,200,18611,23623,52925,0,0,0,1,1
84841,200,18615,23254;23628,52925,0,0,0,2,2
84842,200,18623,24082,52925,0,0,0,1,1
84843,200,18626,24135,52925,0,0,0,1,1
84844,200,18627,23859,52925,0,0,0,1,1
84845,200,18632,23948,52925,0,0,0,1,1
84846,200,18633,23854,52925,0,0,0,1,1
84847,200,18634,24102;24249,52925,0,0,0,2,2
84848,200,18635,23891,52925,0,0,0,1,1
84849,200,18636,24250,52925,0,0,0,1,1
84850,200,18637,28841;31418;31490,52925,0,2,1,0,3
84851,200,18640,23808,52925,0,0,0,1,1
84852,200,18642,24007;24093,52925,0,0,0,2,2
84853,200,18645,24451,52925,0,0,0,1,1
84854,200,18647,23997,52925,0,0,0,1,1
84855,200,18648,24591,52925,0,0,0,1,1
84856,200,18649,24046,52925,0,0,0,1,1
84857,200,18650,24184;24366,52925,0,0,0,2,2
84858,200,18651,24705;27907,52925,0,0,1,1,2
84859,200,18653,24563,52925,0,0,0,1,1
84860,200,18654,24409,52925,0,0,0,1,1
84861,200,18655,24542,52925,0,0,0,1,1
84862,200,18656,24521,52925,0,0,0,1,1
84863,200,18657,24455,52925,0,0,0,1,1
84864,200,18658,24730;24747,52925,0,0,0,2,2
84865,200,18659,24568,52925,0,0,0,1,1
84866,200,18660,24143,52925,0,0,0,1,1
84867,200,18661,24949,52925,0,0,0,1,1
84868,200,18662,24506,52925,0,0,0,1,1
84869,200,18663,24393,52925,0,0,0,1,1
84870,200,18665,24535;24911,52925,0,0,0,2,2
84871,200,18667,25051,52925,0,0,0,1,1
84872,200,18668,24627;24945,52925,0,0,0,2,2
84873,200,18669,25302,52925,0,0,0,1,1
84874,200,18671,23890,52925,0,0,0,1,1
84875,200,18672,24653;24972,52925,0,0,0,2,2
84876,200,18674,24727;25096,52925,0,0,0,2,2
84877,200,18676,24740,52925,0,0,0,1,1
84878,200,18677,24662;24778,52925,0,0,0,2,2
84879,200,18678,24984,52925,0,0,0,1,1
84880,200,18679,24395,52925,0,0,0,1,1
84881,200,18681,24754;24804,52925,0,0,0,2,2
84882,200,18682,25045,52925,0,0,0,1,1
84883,200,18684,24668;24928,52925,0,0,0,2,2
84884,200,18685,24863,52925,0,0,0,1,1
84885,200,18686,24528;24978,52925,0,0,0,2,2
84886,200,18687,24709;24879,52925,0,0,0,2,2
84887,200,18688,24880;25208,52925,0,0,0,2,2
84888,200,18689,24985;24995,52925,0,0,0,2,2
84889,200,18690,24888,52925,0,0,0,1,1
84890,200,18691,24650;24896,52925,0,0,0,2,2
84891,200,18692,24973,52925,0,0,0,1,1
84892,200,18693,24953;25098,52925,0,0,0,2,2
84893,200,18734,23618,53290,0,0,0,1,1
84894,200,18737,23666,53290,0,0,0,1,1
84895,200,18745,23925,53290,0,0,0,1,1
84896,200,18747,23740,53290,0,0,0,1,1
84897,200,18748,24287,53290,0,0,0,1,1
84898,200,18749,24095,53290,0,0,0,1,1
84899,200,18752,23872,53290,0,0,0,1,1
84900,200,18754,23987,53290,0,0,0,1,1
84901,200,18755,23922;24240,53290,0,0,0,2,2
84902,200,18756,24270;24636,53290,0,0,0,2,2
84903,200,18757,24325;24584,53290,0,0,0,2,2
84904,200,18760,24673,53290,0,0,0,1,1
84905,200,18761,24375,53290,0,0,0,1,1
84906,200,18762,24385;24536,53290,0,0,0,2,2
84907,200,18763,24391,53290,0,0,0,1,1
84908,200,18766,24335;24443,53290,0,0,0,2,2
84909,200,18767,24894,53290,0,0,0,1,1
84910,200,18768,24702,53290,0,0,0,1,1
84911,200,18769,24515;24559,53290,0,0,0,2,2
84912,200,18770,24757;25040,53290,0,0,0,2,2
84913,200,18771,24161,53290,0,0,0,1,1
84914,200,18772,24618;24835,53290,0,0,0,2,2
84915,200,18773,24634,53290,0,0,0,1,1
84916,200,18774,24840,53290,0,0,0,1,1
84917,200,18776,24682;25080,53290,0,0,0,2,2
84918,200,18777,24573;24998,53290,0,0,0,2,2
84919,200,18778,24699,53290,0,0,0,1,1
84920,200,18779,24677;24711,53290,0,0,0,2,2
84921,200,18780,24713,53290,0,0,0,1,1
84922,200,18781,24567;24719,53290,0,0,0,2,2
84923,200,18782,24736;25005,53290,0,0,0,2,2
84924,200,18783,24207;24685,53290,0,0,0,2,2
84925,200,18784,24761;24874,53290,0,0,0,2,2
84926,200,18785,25779,53290,0,0,0,1,1
84927,200,18786,24886,53290,0,0,0,1,1
84928,200,18787,24647;24764,53290,0,0,0,2,2
84929,200,18788,24812,53290,0,0,0,1,1
84930,200,18789,24992;25121,53290,0,0,0,2,2
84931,200,18790,24658;24833,53290,0,0,0,2,2
84932,200,18791,25182;25216,53290,0,0,0,2,2
84933,200,18792,25180,53290,0,0,0,1,1
84934,200,18793,24541;24789,53290,0,0,0,2,2
84935,200,18794,25260,53290,0,0,0,1,1
84936,200,18795,24486;24909,53290,0,0,0,2,2
84937,200,18796,24964,53290,0,0,0,1,1
84938,200,18797,24977,53290,0,0,0,1,1
84939,200,18798,24990;25199,53290,0,0,0,2,2
84940,200,18799,24958;25001,53290,0,0,0,2,2
84941,200,18800,24980,53290,0,0,0,1,1
84942,200,18827,22664,53655,0,0,0,1,1
84943,200,18830,23438,53655,0,0,0,1,1
84944,200,18831,23290,53655,0,0,0,1,1
84945,200,18834,23508;23959,53655,0,0,0,2,2
84946,200,18835,23667,53655,0,0,0,1,1
84947,200,18836,23700,53655,0,0,0,1,1
84948,200,18841,23936,53655,0,0,0,1,1
84949,200,18842,23437;24000,53655,0,0,0,2,2
84950,200,18843,23772,53655,0,0,0,1,1
84951,200,18844,24147,53655,0,0,0,1,1
84952,200,18846,23974;24505,53655,0,0,0,2,2
84953,200,18849,24305;24561;29036,53655,0,0,1,2,3
84954,200,18850,24635;25003,53655,0,0,0,2,2
84955,200,18851,24419;24783,53655,0,0,0,2,2
84956,200,18853,24429,53655,0,0,0,1,1
84957,200,18854,24472;24624,53655,0,0,0,2,2
84958,200,18855,24770,53655,0,0,0,1,1
84959,200,18856,24483;24601,53655,0,0,0,2,2
84960,200,18857,24446;24589,53655,0,0,0,2,2
84961,200,18859,24741,53655,0,0,0,1,1
84962,200,18860,25187,53655,0,0,0,1,1
84963,200,18861,24495;24717,53655,0,0,0,2,2
84964,200,18862,24748;24796,53655,0,0,0,2,2
84965,200,18863,23812;24753,53655,0,0,0,2,2
84966,200,18864,25088;25153,53655,0,0,0,2,2
84967,200,18865,24383,53655,0,0,0,1,1
84968,200,18866,24722;24829,53655,0,0,0,2,2
84969,200,18867,24861;27916,53655,0,0,1,1,2
84970,200,18868,24648;25166,53655,0,0,0,2,2
84971,200,18870,24877;24914,53655,0,0,0,2,2
84972,200,18871,25156,53655,0,0,0,1,1
84973,200,18872,24684,53655,0,0,0,1,1
84974,200,18874,24904;24946,53655,0,0,0,2,2
84975,200,18875,25110,53655,0,0,0,1,1
84976,200,18876,24963;25168,53655,0,0,0,2,2
84977,200,18877,24989,53655,0,0,0,1,1
84978,200,18878,25142;25221,53655,0,0,0,2,2
84979,200,18879,24820;25332,53655,0,0,0,2,2
84980,200,18880,25022;25200,53655,0,0,0,2,2
84981,200,18881,25024;27727,53655,0,0,1,1,2
84982,200,18882,25276,53655,0,0,0,1,1
84983,200,18883,25155,53655,0,0,0,1,1
84984,200,18884,27835;28312;29031;31259;31672;31844,53655,2,1,3,0,6
84985,200,18885,25071,53655,0,0,0,1,1
84986,200,18886,25283,53655,0,0,0,1,1
84987,200,18888,25178,53655,0,0,0,1,1
84988,200,18889,25104;25280,53655,0,0,0,2,2
84989,200,18922,23586,54020,0,0,0,1,1
84990,200,18925,22779,54020,0,0,0,1,1
84991,200,18932,23695,54020,0,0,0,1,1
84992,200,18937,23924;24060,54020,0,0,0,2,2
84993,200,18940,24344,54020,0,0,0,1,1
84994,200,18942,24343;24364,54020,0,0,0,2,2
84995,200,18945,24456,54020,0,0,0,1,1
84996,200,18946,24274,54020,0,0,0,1,1
84997,200,18947,24308,54020,0,0,0,1,1
84998,200,18948,24239,54020,0,0,0,1,1
84999,200,18949,24387;24537,54020,0,0,0,2,2
85000,200,18950,24496,54020,0,0,0,1,1
85001,200,18951,24479,54020,0,0,0,1,1
85002,200,18952,24599;25141,54020,0,0,0,2,2
85003,200,18953,24881;25042,54020,0,0,0,2,2
85004,200,18954,24926;25122,54020,0,0,0,2,2
85005,200,18955,24689,54020,0,0,0,1,1
85006,200,18956,24692;25055,54020,0,0,0,2,2
85007,200,18957,25030;25089,54020,0,0,0,2,2
85008,200,18958,24401;24703,54020,0,0,0,2,2
85009,200,18959,24575;24935,54020,0,0,0,2,2
85010,200,18960,24708;24743,54020,0,0,0,2,2
85011,200,18961,24610,54020,0,0,0,1,1
85012,200,18962,24844,54020,0,0,0,1,1
85013,200,18963,24947,54020,0,0,0,1,1
85014,200,18964,24952;25244,54020,0,0,0,2,2
85015,200,18967,24971;25157,54020,0,0,0,2,2
85016,200,18969,25210,54020,0,0,0,1,1
85017,200,18970,24982;24994,54020,0,0,0,2,2
85018,200,18971,24566;24884,54020,0,0,0,2,2
85019,200,18972,25324;25494,54020,0,0,0,2,2
85020,200,18973,24787;25015,54020,0,0,0,2,2
85021,200,18974,24781;25020,54020,0,0,0,2,2
85022,200,18975,24831;25056,54020,0,0,0,2,2
85023,200,18976,25073,54020,0,0,0,1,1
85024,200,18977,24587;24918,54020,0,0,0,2,2
85025,200,18978,25090;25127,54020,0,0,0,2,2
85026,200,18979,25128,54020,0,0,0,1,1
85027,200,18980,25461;25637,54020,0,0,0,2,2
85028,200,18981,24817;25074,54020,0,0,0,2,2
85029,200,18982,25354,54020,0,0,0,1,1
85030,200,18984,25203;25222,54020,0,0,0,2,2
85031,200,18985,25206,54020,0,0,0,1,1
85032,200,19016,23214,54385,0,0,0,1,1
85033,200,19019,23520,54385,0,0,0,1,1
85034,200,19022,23404;23718,54385,0,0,0,2,2
85035,200,19025,23536;23819,54385,0,0,0,2,2
85036,200,19034,24304,54385,0,0,0,1,1
85037,200,19037,24441;24582,54385,0,0,0,2,2
85038,200,19038,24447;24867,54385,0,0,0,2,2
85039,200,19039,24676,54385,0,0,0,1,1
85040,200,19042,24571,54385,0,0,0,1,1
85041,200,19044,25038,54385,0,0,0,1,1
85042,200,19045,24925;25093,54385,0,0,0,2,2
85043,200,19048,25152,54385,0,0,0,1,1
85044,200,19049,24823,54385,0,0,0,1,1
85045,200,19050,24824;24882,54385,0,0,0,2,2
85046,200,19051,24777;24839,54385,0,0,0,2,2
85047,200,19052,24262;24706,54385,0,0,0,2,2
85048,200,19054,24875;25430,54385,0,0,0,2,2
85049,200,19056,24922,54385,0,0,0,1,1
85050,200,19058,24988,54385,0,0,0,1,1
85051,200,19059,24969;25262,54385,0,0,0,2,2
85052,200,19060,24865,54385,0,0,0,1,1
85053,200,19061,25132;25201,54385,0,0,0,2,2
85054,200,19062,25067;25158,54385,0,0,0,2,2
85055,200,19063,25119;25163,54385,0,0,0,2,2
85056,200,19064,24921;25169,54385,0,0,0,2,2
85057,200,19065,25521;25552,54385,0,0,0,2,2
85058,200,19066,25477;25556,54385,0,0,0,2,2
85059,200,19067,25543,54385,0,0,0,1,1
85060,200,19069,25097;25183,54385,0,0,0,2,2
85061,200,19071,25299;25478,54385,0,0,0,2,2
85062,200,19108,23550,54750,0,0,0,1,1
85063,200,19110,23841,54750,0,0,0,1,1
85064,200,19111,23749,54750,0,0,0,1,1
85065,200,19112,24264,54750,0,0,0,1,1
85066,200,19113,23961;24492,54750,0,0,0,2,2
85067,200,19116,24091,54750,0,0,0,1,1
85068,200,19118,24219,54750,0,0,0,1,1
85069,200,19120,24594,54750,0,0,0,1,1
85070,200,19121,24776,54750,0,0,0,1,1
85071,200,19123,24578,54750,0,0,0,1,1
85072,200,19126,24468,54750,0,0,0,1,1
85073,200,19128,24273,54750,0,0,0,1,1
85074,200,19132,24790,54750,0,0,0,1,1
85075,200,19133,24272;24752,54750,0,0,0,2,2
85076,200,19135,24597;24869,54750,0,0,0,2,2
85077,200,19137,25215;25229,54750,0,0,0,2,2
85078,200,19138,25220;25532;28964,54750,0,0,1,2,3
85079,200,19140,24744;24962,54750,0,0,0,2,2
85080,200,19141,25349;25432,54750,0,0,0,2,2
85081,200,19142,24827;25019,54750,0,0,0,2,2
85082,200,19143,25410,54750,0,0,0,1,1
85083,200,19144,25245;25645;29714,54750,0,0,1,2,3
85084,200,19145,25370,54750,0,0,0,1,1
85085,200,19146,25569,54750,0,0,0,1,1
85086,200,19147,24915;25282,54750,0,0,0,2,2
85087,200,19148,25099,54750,0,0,0,1,1
85088,200,19149,25086,54750,0,0,0,1,1
85089,200,19150,24938;25117,54750,0,0,0,2,2
85090,200,19151,24876;25131,54750,0,0,0,2,2
85091,200,19152,25448;25516,54750,0,0,0,2,2
85092,200,19153,24806;25146,54750,0,0,0,2,2
85093,200,19154,25149;25470,54750,0,0,0,2,2
85094,200,19155,25059;25165,54750,0,0,0,2,2
85095,200,19156,25174;25271,54750,0,0,0,2,2
85096,200,19157,25039;25172,54750,0,0,0,2,2
85097,200,19158,24832;25189;28229,54750,0,0,1,2,3
85098,200,19159,25321;25682,54750,0,0,0,2,2
85099,200,19160,25230;25424,54750,0,0,0,2,2
85100,200,19161,25256;25434,54750,0,0,0,2,2
85101,200,19162,25295;25717;28952,54750,0,0,1,2,3
85102,200,19164,25247;25373,54750,0,0,0,2,2
85103,200,19165,25402;25652,54750,0,0,0,2,2
85104,200,19166,25164;25303,54750,0,0,0,2,2
85105,200,19168,25313;25611,54750,0,0,0,2,2
85106,200,19169,25314,54750,0,0,0,1,1
85107,200,19170,25484,54750,0,0,0,1,1
85108,200,19171,28802;29168;31927;32007,54750,2,0,2,0,4
85109,200,19172,25334;25387,54750,0,0,0,2,2
85110,200,19173,25340;25719,54750,0,0,0,2,2
85111,200,19174,25551;25623;29138,54750,0,0,1,2,3
85112,200,19175,25365;25549,54750,0,0,0,2,2
85113,200,19177,25573;25638,54750,0,0,0,2,2
85114,200,19179,25398,54750,0,0,0,1,1
85115,200,19180,25395,54750,0,0,0,1,1
85116,200,19205,23191,55115,0,0,0,1,1
85117,200,19211,23930,55115,0,0,0,1,1
85118,200,19213,24101,55115,0,0,0,1,1
85119,200,19221,24593;24782,55115,0,0,0,2,2
85120,200,19222,24950;25064,55115,0,0,0,2,2
85121,200,19223,24424;24425,55115,0,0,0,2,2
85122,200,19224,24373;24430,55115,0,0,0,2,2
85123,200,19226,24544;24564,55115,0,0,0,2,2
85124,200,19227,24733,55115,0,0,0,1,1
85125,200,19228,25306,55115,0,0,0,1,1
85126,200,19232,24659;25286,55115,0,0,0,2,2
85127,200,19233,24504;24742,55115,0,0,0,2,2
85128,200,19234,28090;28478;31477;31560,55115,0,2,2,0,4
85129,200,19235,25266,55115,0,0,0,1,1
85130,200,19236,24667,55115,0,0,0,1,1
85131,200,19239,25143;25428,55115,0,0,0,2,2
85132,200,19240,24842,55115,0,0,0,1,1
85133,200,19241,24848,55115,0,0,0,1,1
85134,200,19242,24892,55115,0,0,0,1,1
85135,200,19243,24937,55115,0,0,0,1,1
85136,200,19245,24951,55115,0,0,0,1,1
85137,200,19246,24968;25445,55115,0,0,0,2,2
85138,200,19247,24901,55115,0,0,0,1,1
85139,200,19248,25036;25213,55115,0,0,0,2,2
85140,200,19249,25062;25170,55115,0,0,0,2,2
85141,200,19250,24794;25108,55115,0,0,0,2,2
85142,200,19251,25490,55115,0,0,0,1,1
85143,200,19253,25102;25204,55115,0,0,0,2,2
85144,200,19254,25212;25651,55115,0,0,0,2,2
85145,200,19255,25631,55115,0,0,0,1,1
85146,200,19256,25665,55115,0,0,0,1,1
85147,200,19257,25612,55115,0,0,0,1,1
85148,200,19258,25502;25681;29242;31008,55115,0,1,1,2,4
85149,200,19259,25632;25817,55115,0,0,0,2,2
85150,200,19260,25393;25656,55115,0,0,0,2,2
85151,200,19261,25671,55115,0,0,0,1,1
85152,200,19262,28656;28967;31001,55115,0,1,2,0,3
85153,200,19288,23558,55480,0,0,0,1,1
85154,200,19291,23897;24315,55480,0,0,0,2,2
85155,200,19293,24333,55480,0,0,0,1,1
85156,200,19295,24148,55480,0,0,0,1,1
85157,200,19296,24149;24695,55480,0,0,0,2,2
85158,200,19297,24465,55480,0,0,0,1,1
85159,200,19298,24201,55480,0,0,0,1,1
85160,200,19303,24411;24756,55480,0,0,0,2,2
85161,200,19305,27866;30335;30758;30850,55480,0,2,2,0,4
85162,200,19306,24517;24527,55480,0,0,0,2,2
85163,200,19307,24924;25263,55480,0,0,0,2,2
85164,200,19308,28760,55480,0,0,1,0,1
85165,200,19309,24805;27911;30854,55480,0,1,1,1,3
85166,200,19310,24546;24821,55480,0,0,0,2,2
85167,200,19311,24883,55480,0,0,0,1,1
85168,200,19312,24891;25251,55480,0,0,0,2,2
85169,200,19313,25072,55480,0,0,0,1,1
85170,200,19314,24710;24954,55480,0,0,0,2,2
85171,200,19315,24728;25000,55480,0,0,0,2,2
85172,200,19316,24762;25018,55480,0,0,0,2,2
85173,200,19317,25031,55480,0,0,0,1,1
85174,200,19321,25006;25177,55480,0,0,0,2,2
85175,200,19322,25186;25188,55480,0,0,0,2,2
85176,200,19323,25258;25362,55480,0,0,0,2,2
85177,200,19324,25259;25330,55480,0,0,0,2,2
85178,200,19325,25272;25443,55480,0,0,0,2,2
85179,200,19326,25296,55480,0,0,0,1,1
85180,200,19327,25209;25346;28418,55480,0,0,1,2,3
85181,200,19328,25888;25922,55480,0,0,0,2,2
85182,200,19329,25275,55480,0,0,0,1,1
85183,200,19330,25415,55480,0,0,0,1,1
85184,200,19331,25253;25476,55480,0,0,0,2,2
85185,200,19332,25707;25715,55480,0,0,0,2,2
85186,200,19333,25288,55480,0,0,0,1,1
85187,200,19334,25489;25523,55480,0,0,0,2,2
85188,200,19335,25544;25873,55480,0,0,0,2,2
85189,200,19336,25515,55480,0,0,0,1,1
85190,200,19337,25751;25784,55480,0,0,0,2,2
85191,200,19338,25675;25849,55480,0,0,0,2,2
85192,200,19339,25693,55480,0,0,0,1,1
85193,200,19340,25643;25713,55480,0,0,0,2,2
85194,200,19341,28987;29256;31988,55480,1,0,2,0,3
85195,200,19342,25579,55480,0,0,0,1,1
85196,200,19343,25195;25670,55480,0,0,0,2,2
85197,200,19344,25686;25822,55480,0,0,0,2,2
85198,200,19345,25391;25878,55480,0,0,0,2,2
85199,200,19346,25833,55480,0,0,0,1,1
85200,200,19348,25792,55480,0,0,0,1,1
85201,200,19379,23648,55845,0,0,0,1,1
85202,200,19388,23919,55845,0,0,0,1,1
85203,200,19389,24316,55845,0,0,0,1,1
85204,200,19391,23943;24079,55845,0,0,0,2,2
85205,200,19392,24117;24294,55845,0,0,0,2,2
85206,200,19396,24511,55845,0,0,0,1,1
85207,200,19398,24414;24687,55845,0,0,0,2,2
85208,200,19399,24868,55845,0,0,0,1,1
85209,200,19400,24943;24956,55845,0,0,0,2,2
85210,200,19404,24862,55845,0,0,0,1,1
85211,200,19405,24467,55845,0,0,0,1,1
85212,200,19406,28859;29009,55845,0,0,2,0,2
85213,200,19407,24725;25048,55845,0,0,0,2,2
85214,200,19408,25065,55845,0,0,0,1,1
85215,200,19409,25029;25068,55845,0,0,0,2,2
85216,200,19410,25077,55845,0,0,0,1,1
85217,200,19411,24855;25047,55845,0,0,0,2,2
85218,200,19412,25135,55845,0,0,0,1,1
85219,200,19413,25442,55845,0,0,0,1,1
85220,200,19414,25816;25820;29716,55845,0,0,1,2,3
85221,200,19415,25175,55845,0,0,0,1,1
85222,200,19416,25192,55845,0,0,0,1,1
85223,200,19417,25361;25486,55845,0,0,0,2,2
85224,200,19418,24941;25233,55845,0,0,0,2,2
85225,200,19419,25248;25720,55845,0,0,0,2,2
85226,200,19420,24816;25254,55845,0,0,0,2,2
85227,200,19421,25261;26023,55845,0,0,1,1,2
85228,200,19422,25821;26027,55845,0,0,1,1,2
85229,200,19424,25167;25650,55845,0,0,0,2,2
85230,200,19426,25358,55845,0,0,0,1,1
85231,200,19427,25930;29348;29813;30069,55845,0,0,4,0,4
85232,200,19428,25374;25705,55845,0,0,0,2,2
85233,200,19431,25462;25469,55845,0,0,0,2,2
85234,200,19432,25133;25482,55845,0,0,0,2,2
85235,200,19433,25316;25512,55845,0,0,0,2,2
85236,200,19434,25129;25517,55845,0,0,0,2,2
85237,200,19435,25519;25756,55845,0,0,0,2,2
85238,200,19436,25211;25500,55845,0,0,0,2,2
85239,200,19437,25533;25729,55845,0,0,0,2,2
85240,200,19438,25405,55845,0,0,0,1,1
85241,200,19439,24975;25545,55845,0,0,0,2,2
85242,200,19440,25861,55845,0,0,0,1,1
85243,200,19441,25480,55845,0,0,0,1,1
85244,200,19442,25458;26005,55845,0,0,1,1,2
85245,200,19444,25629;25900,55845,0,0,0,2,2
85246,200,19445,25855;25881;29254;30725;31267;31511,55845,0,3,1,2,6
85247,200,19446,25154;25710;28253,55845,0,0,1,2,3
85248,200,19447,25357;25655,55845,0,0,0,2,2
85249,200,19448,25683,55845,0,0,0,1,1
85250,200,19449,26018,55845,0,0,1,0,1
85251,200,19450,25718;25945;29262,55845,0,0,2,1,3
85252,200,19482,23941,56210,0,0,0,1,1
85253,200,19483,23944,56210,0,0,0,1,1
85254,200,19484,24347,56210,0,0,0,1,1
85255,200,19485,24050;24555,56210,0,0,0,2,2
85256,200,19487,24766,56210,0,0,0,1,1
85257,200,19488,24351;24445,56210,0,0,0,2,2
85258,200,19489,24481,56210,0,0,0,1,1
85259,200,19490,24734;24916,56210,0,0,0,2,2
85260,200,19491,24557,56210,0,0,0,1,1
85261,200,19493,24974,56210,0,0,0,1,1
85262,200,19499,24999,56210,0,0,0,1,1
85263,200,19500,25339;25472,56210,0,0,0,2,2
85264,200,19501,24596,56210,0,0,0,1,1
85265,200,19502,25033;25414,56210,0,0,0,2,2
85266,200,19503,24997,56210,0,0,0,1,1
85267,200,19504,24870;25011,56210,0,0,0,2,2
85268,200,19505,25329;25644,56210,0,0,0,2,2
85269,200,19507,25103;25105,56210,0,0,0,2,2
85270,200,19511,25572,56210,0,0,0,1,1
85271,200,19512,25066;25205,56210,0,0,0,2,2
85272,200,19513,25268;28599,56210,0,0,1,1,2
85273,200,19514,25447;25685,56210,0,0,0,2,2
85274,200,19515,25392,56210,0,0,0,1,1
85275,200,19517,24811;25375,56210,0,0,0,2,2
85276,200,19518,25386;25468,56210,0,0,0,2,2
85277,200,19519,24927;25418,56210,0,0,0,2,2
85278,200,19520,25679,56210,0,0,0,1,1
85279,200,19522,24898;25446,56210,0,0,0,2,2
85280,200,19523,25449;25467,56210,0,0,0,2,2
85281,200,19525,25827;25867,56210,0,0,0,2,2
85282,200,19526,25768;25882,56210,0,0,0,2,2
85283,200,19527,25635;26138,56210,0,0,1,1,2
85284,200,19529,25320,56210,0,0,0,1,1
85285,200,19530,25896;26054;29632,56210,0,0,2,1,3
85286,200,19531,25894,56210,0,0,0,1,1
85287,200,19532,25649;25891,56210,0,0,0,2,2
85288,200,19533,25985;26000;29719,56210,0,0,3,0,3
85289,200,19534,25672,56210,0,0,0,1,1
85290,200,19535,25674;28992;31002;31256;31498;31591,56210,0,4,1,1,6
85291,200,19536,25712;25918;29624;31948;32033,56210,2,0,1,2,5
85292,200,19537,25760,56210,0,0,0,1,1
85293,200,19538,26002;26034;29266;31350,56210,0,1,3,0,4
85294,200,19539,25797;25802,56210,0,0,0,2,2
85295,200,19540,25774;25805,56210,0,0,0,2,2
85296,200,19541,26026,56210,0,0,1,0,1
85297,200,19572,22855,56575,0,0,0,1,1
85298,200,19576,23684,56575,0,0,0,1,1
85299,200,19579,23453;23767,56575,0,0,0,2,2
85300,200,19581,24836,56575,0,0,0,1,1
85301,200,19583,24035,56575,0,0,0,1,1
85302,200,19590,24397;24538,56575,0,0,0,2,2
85303,200,19595,25353,56575,0,0,0,1,1
85304,200,19597,24932,56575,0,0,0,1,1
85305,200,19598,24966,56575,0,0,0,1,1
85306,200,19599,25063;25217,56575,0,0,0,2,2
85307,200,19600,25176;25369,56575,0,0,0,2,2
85308,200,19602,25087,56575,0,0,0,1,1
85309,200,19603,24654,56575,0,0,0,1,1
85310,200,19604,24981;25147,56575,0,0,0,2,2
85311,200,19605,25514,56575,0,0,0,1,1
85312,200,19606,25185;28594;31068;31243;31482,56575,0,3,1,1,5
85313,200,19609,25403;25646,56575,0,0,0,2,2
85314,200,19610,25542;25566;29620,56575,0,0,1,2,3
85315,200,19611,25238;25407,56575,0,0,0,2,2
85316,200,19612,25501;25714,56575,0,0,0,2,2
85317,200,19614,25351;25711;29341,56575,0,0,1,2,3
85318,200,19615,25094;25377,56575,0,0,0,2,2
85319,200,19616,25691,56575,0,0,0,1,1
85320,200,19617,25278;25409,56575,0,0,0,2,2
85321,200,19618,25054;25411,56575,0,0,0,2,2
85322,200,19619,25422;28609;29333,56575,0,0,2,1,3
85323,200,19620,25423,56575,0,0,0,1,1
85324,200,19621,25459;29992,56575,0,0,1,1,2
85325,200,19622,25973,56575,0,0,1,0,1
85326,200,19623,25984;25989,56575,0,0,2,0,2
85327,200,19624,25605;25933;29261;32014,56575,1,0,2,1,4
85328,200,19625,25287;25669,56575,0,0,0,2,2
85329,200,19626,25574;25684,56575,0,0,0,2,2
85330,200,19627,25998;29544,56575,0,0,2,0,2
85331,200,19628,25575;26170,56575,0,0,1,1,2
85332,200,19629,25950;26144,56575,0,0,2,0,2
85333,200,19630,25795;25966;29990;31961,56575,1,0,2,1,4
85334,200,19631,25536;25737;30246,56575,0,0,1,2,3
85335,200,19633,26124,56575,0,0,1,0,1
85336,200,19634,25959;26137,56575,0,0,2,0,2
85337,200,19636,25831;26182,56575,0,0,1,1,2
85338,200,19637,25859,56575,0,0,0,1,1
85339,200,19638,26165,56575,0,0,1,0,1
85340,200,19639,26142,56575,0,0,1,0,1
85341,200,19652,22958,56940,0,0,0,1,1
85342,200,19666,24036;24488;28468;30980;31401,56940,0,2,1,2,5
85343,200,19670,24196;24362,56940,0,0,0,2,2
85344,200,19671,24664,56940,0,0,0,1,1
85345,200,19673,23993,56940,0,0,0,1,1
85346,200,19680,24475;24590,56940,0,0,0,2,2
85347,200,19681,24807;27912,56940,0,0,1,1,2
85348,200,19682,24856;25002,56940,0,0,0,2,2
85349,200,19684,24940,56940,0,0,0,1,1
85350,200,19686,25382,56940,0,0,0,1,1
85351,200,19687,25123;25584,56940,0,0,0,2,2
85352,200,19688,25125;25326,56940,0,0,0,2,2
85353,200,19689,24955;25237,56940,0,0,0,2,2
85354,200,19690,25454,56940,0,0,0,1,1
85355,200,19691,25044;25344,56940,0,0,0,2,2
85356,200,19692,25111;25347,56940,0,0,0,2,2
85357,200,19693,25383;25600,56940,0,0,0,2,2
85358,200,19694,25218;25770,56940,0,0,0,2,2
85359,200,19695,25396;25438,56940,0,0,0,2,2
85360,200,19696,25435;28611;30986;31245;31409;31820,56940,1,3,1,1,6
85361,200,19697,25440;25460,56940,0,0,0,2,2
85362,200,19698,25915,56940,0,0,0,1,1
85363,200,19699,25113;25538,56940,0,0,0,2,2
85364,200,19700,25513,56940,0,0,0,1,1
85365,200,19701,25453;25520,56940,0,0,0,2,2
85366,200,19702,25753;25908,56940,0,0,0,2,2
85367,200,19705,25240;25777,56940,0,0,0,2,2
85368,200,19706,26064;26151,56940,0,0,2,0,2
85369,200,19707,25647;26102;29178,56940,0,0,2,1,3
85370,200,19708,25616;25738,56940,0,0,0,2,2
85371,200,19710,26192;26278,56940,0,0,2,0,2
85372,200,19711,25819;26097;28904,56940,0,0,2,1,3
85373,200,19712,25826,56940,0,0,0,1,1
85374,200,19713,25880;25914;29160;32005,56940,1,0,1,2,4
85375,200,19715,25818;25947,56940,0,0,1,1,2
85376,200,19716,25948,56940,0,0,1,0,1
85377,200,19717,25958;26059;29454;29634,56940,0,0,4,0,4
85378,200,19718,26072;26145;31294,56940,0,1,2,0,3
85379,200,19719,25987;26096;29349;31517;31866,56940,1,1,3,0,5
85380,200,19720,25727;26016,56940,0,0,1,1,2
85381,200,19733,23032,57305,0,0,0,1,1
85382,200,19744,24229,57305,0,0,0,1,1
85383,200,19747,24150,57305,0,0,0,1,1
85384,200,19748,23968,57305,0,0,0,1,1
85385,200,19750,25202,57305,0,0,0,1,1
85386,200,19754,24808,57305,0,0,0,1,1
85387,200,19756,24616;24851,57305,0,0,0,2,2
85388,200,19759,24471;24516,57305,0,0,0,2,2
85389,200,19760,25049;25242,57305,0,0,0,2,2
85390,200,19761,25148;25184,57305,0,0,0,2,2
85391,200,19762,25085,57305,0,0,0,1,1
85392,200,19763,25243;25294,57305,0,0,0,2,2
85393,200,19764,24763;28413,57305,0,0,1,1,2
85394,200,19765,25273;25527,57305,0,0,0,2,2
85395,200,19766,25277;25336,57305,0,0,0,2,2
85396,200,19767,25305;25504;30067,57305,0,0,1,2,3
85397,200,19768,25331;25506,57305,0,0,0,2,2
85398,200,19769,24611,57305,0,0,0,1,1
85399,200,19770,25493;25741,57305,0,0,0,2,2
85400,200,19772,25092;25384,57305,0,0,0,2,2
85401,200,19773,25412;25420,57305,0,0,0,2,2
85402,200,19774,25421;25511,57305,0,0,0,2,2
85403,200,19775,25343;25473,57305,0,0,0,2,2
85404,200,19777,25439;25498,57305,0,0,0,2,2
85405,200,19778,25695;25904;29339,57305,0,0,1,2,3
85406,200,19779,25581;25721,57305,0,0,0,2,2
85407,200,19780,25744;25864,57305,0,0,0,2,2
85408,200,19781,25457;25790,57305,0,0,0,2,2
85409,200,19782,25618,57305,0,0,0,1,1
85410,200,19783,25559;25619,57305,0,0,0,2,2
85411,200,19784,25615;25640,57305,0,0,0,2,2
85412,200,19785,26231,57305,0,0,1,0,1
85413,200,19787,25967,57305,0,0,1,0,1
85414,200,19788,25830;25982;29450,57305,0,0,2,1,3
85415,200,19789,25663;25835,57305,0,0,0,2,2
85416,200,19790,25481;25836;29623;31527,57305,0,1,1,2,4
85417,200,19791,25869;26234;29189,57305,0,0,2,1,3
85418,200,19792,25589;25848;30452,57305,0,0,1,2,3
85419,200,19793,26355;26378,57305,0,0,2,0,2
85420,200,19794,25884;26120;29638,57305,0,0,2,1,3
85421,200,19796,26220,57305,0,0,1,0,1
85422,200,19797,26215;26384,57305,0,0,2,0,2
85423,200,19798,25926;26071,57305,0,0,2,0,2
85424,200,19799,25935,57305,0,0,1,0,1
85425,200,19800,25585;26077,57305,0,0,1,1,2
85426,200,19801,25327;25990;29897;31799,57305,1,0,2,1,4
85427,200,19802,25991,57305,0,0,1,0,1
85428,200,19804,26003;26332,57305,0,0,2,0,2
85429,200,19805,25441;26022,57305,0,0,1,1,2
85430,200,19806,26104;26198,57305,0,0,2,0,2
85431,200,19807,26113;26272;29731,57305,0,0,3,0,3
85432,200,19808,25927;26260,57305,0,0,2,0,2
85433,200,19809,25750;26167;29823;29900,57305,0,0,3,1,4
85434,200,19810,26107;26148,57305,0,0,2,0,2
85435,200,19811,25961;26134,57305,0,0,2,0,2
85436,200,19812,26136;26313;29828;31879,57305,1,0,3,0,4
85437,200,19828,23539,57670,0,0,0,1,1
85438,200,19833,24077,57670,0,0,0,1,1
85439,200,19842,24543,57670,0,0,0,1,1
85440,200,19843,24532;25058,57670,0,0,0,2,2
85441,200,19848,24907;24979,57670,0,0,0,2,2
85442,200,19852,24750;25124,57670,0,0,0,2,2
85443,200,19853,25224,57670,0,0,0,1,1
85444,200,19855,25095,57670,0,0,0,1,1
85445,200,19856,25120;25267,57670,0,0,0,2,2
85446,200,19858,25107;25150,57670,0,0,0,2,2
85447,200,19859,25609,57670,0,0,0,1,1
85448,200,19860,25269,57670,0,0,0,1,1
85449,200,19862,25335;29134,57670,0,0,1,1,2
85450,200,19863,26101;26218;28357,57670,0,0,3,0,3
85451,200,19866,25239;25546,57670,0,0,0,2,2
85452,200,19867,25563;25740,57670,0,0,0,2,2
85453,200,19868,25388;25812,57670,0,0,0,2,2
85454,200,19869,25587;25846,57670,0,0,0,2,2
85455,200,19872,25333;25813;28805,57670,0,0,1,2,3
85456,200,19873,26308;26489,57670,0,0,2,0,2
85457,200,19874,25839,57670,0,0,0,1,1
85458,200,19876,25887,57670,0,0,0,1,1
85459,200,19877,25853,57670,0,0,0,1,1
85460,200,19878,26394;26422,57670,0,0,2,0,2
85461,200,19879,25906,57670,0,0,0,1,1
85462,200,19880,25807;25912,57670,0,0,0,2,2
85463,200,19881,25943;29626,57670,0,0,2,0,2
85464,200,19882,25940,57670,0,0,1,0,1
85465,200,19883,25954,57670,0,0,1,0,1
85466,200,19884,25957;26411,57670,0,0,2,0,2
85467,200,19885,25890;26267;29557,57670,0,0,2,1,3
85468,200,19886,25436,57670,0,0,0,1,1
85469,200,19887,26287;29826,57670,0,0,2,0,2
85470,200,19889,25658;26066,57670,0,0,1,1,2
85471,200,19890,25773;26140;28549,57670,0,0,2,1,3
85472,200,19891,26092;26469;29658;30078,57670,0,0,4,0,4
85473,200,19892,26135;26326,57670,0,0,2,0,2
85474,200,19893,26486,57670,0,0,1,0,1
85475,200,19894,26116;26158,57670,0,0,2,0,2
85476,200,19895,26118;26472;29013,57670,0,0,3,0,3
85477,200,19896,26128,57670,0,0,1,0,1
85478,200,19898,26179,57670,0,0,1,0,1
85479,200,19899,25829;25920;29718,57670,0,0,1,2,3
85480,200,19901,26228;26318;29366;32020,57670,1,0,3,0,4
85481,200,19902,26507;29911;32049,57670,1,0,2,0,3
85482,200,19903,26075;26239;28742,57670,0,0,3,0,3
85483,200,19925,23838;24381,58035,0,0,0,2,2
85484,200,19928,24834,58035,0,0,0,1,1
85485,200,19929,24493,58035,0,0,0,1,1
85486,200,19930,24422,58035,0,0,0,1,1
85487,200,19931,24628;24716,58035,0,0,0,2,2
85488,200,19937,25013;25304;28417,58035,0,0,1,2,3
85489,200,19938,25028;25173,58035,0,0,0,2,2
85490,200,19940,25196,58035,0,0,0,1,1
85491,200,19941,25214,58035,0,0,0,1,1
85492,200,19942,28781;28784;31417;31659;31729,58035,2,1,2,0,5
85493,200,19944,26079;26121;29722,58035,0,0,3,0,3
85494,200,19945,25379,58035,0,0,0,1,1
85495,200,19947,25724;25877,58035,0,0,0,2,2
85496,200,19948,25903;29812,58035,0,0,1,1,2
85497,200,19949,25648;25673,58035,0,0,0,2,2
85498,200,19950,25921,58035,0,0,0,1,1
85499,200,19951,25689;25785,58035,0,0,0,2,2
85500,200,19952,25716;26201,58035,0,0,1,1,2
85501,200,19953,25837,58035,0,0,0,1,1
85502,200,19954,25528,58035,0,0,0,1,1
85503,200,19955,26163;30073,58035,0,0,2,0,2
85504,200,19956,25726;25801,58035,0,0,0,2,2
85505,200,19957,25401;25804,58035,0,0,0,2,2
85506,200,19958,25814;25975;29815,58035,0,0,2,1,3
85507,200,19959,26015,58035,0,0,1,0,1
85508,200,19960,25856;26046;29991,58035,0,0,2,1,3
85509,200,19961,25668;25879,58035,0,0,0,2,2
85510,200,19962,26316;29907;32047,58035,1,0,2,0,3
85511,200,19964,26403;26458;30363;30545,58035,0,1,3,0,4
85512,200,19965,26367,58035,0,0,1,0,1
85513,200,19966,25782;26086,58035,0,0,1,1,2
85514,200,19967,26043;26464;29657,58035,0,0,3,0,3
85515,200,19968,26051;26290;30266,58035,0,0,3,0,3
85516,200,19969,26105;26319;29650,58035,0,0,3,0,3
85517,200,19971,25931,58035,0,0,1,0,1
85518,200,19972,25838;26108,58035,0,0,1,1,2
85519,200,19973,26349;26351;29997,58035,0,0,3,0,3
85520,200,19974,25971;26146,58035,0,0,2,0,2
85521,200,19975,25735,58035,0,0,0,1,1
85522,200,19976,26017;26189;29002;29994,58035,0,0,4,0,4
85523,200,19977,25923;26193,58035,0,0,1,1,2
85524,200,19979,25865;26195,58035,0,0,1,1,2
85525,200,19980,25911;26205,58035,0,0,1,1,2
85526,200,19982,26210,58035,0,0,1,0,1
85527,200,19984,26531;26548;29571;29747;31524,58035,0,1,4,0,5
85528,200,19985,26248;26262,58035,0,0,2,0,2
85529,200,19990,22385,58400,0,0,0,1,1
85530,200,19991,22479,58400,0,0,0,1,1
85531,200,20016,24889;25079,58400,0,0,0,2,2
85532,200,20017,24223;24358,58400,0,0,0,2,2
85533,200,20018,24885,58400,0,0,0,1,1
85534,200,20019,24768;24983,58400,0,0,0,2,2
85535,200,20020,24369;28672,58400,0,0,1,1,2
85536,200,20024,25009;25416,58400,0,0,0,2,2
85537,200,20026,25620,58400,0,0,0,1,1
85538,200,20027,25308;25590;28339;30169;31144;31311,58400,0,2,2,2,6
85539,200,20028,25126;25315,58400,0,0,0,2,2
85540,200,20029,25561,58400,0,0,0,1,1
85541,200,20030,25160;25390;28327,58400,0,0,1,2,3
85542,200,20031,25367;25465,58400,0,0,0,2,2
85543,200,20032,24841;25191,58400,0,0,0,2,2
85544,200,20034,25364;25667,58400,0,0,0,2,2
85545,200,20035,25363;25570,58400,0,0,0,2,2
85546,200,20036,25509;25560,58400,0,0,0,2,2
85547,200,20037,25537;25840,58400,0,0,0,2,2
85548,200,20038,25866;26233,58400,0,0,1,1,2
85549,200,20039,25307;25598,58400,0,0,0,2,2
85550,200,20041,25021,58400,0,0,0,1,1
85551,200,20042,26080;29549,58400,0,0,2,0,2
85552,200,20043,25583,58400,0,0,0,1,1
85553,200,20044,25580;25745;28801;30719;30997;31337;31912,58400,1,3,1,2,7
85554,200,20045,25664;25746,58400,0,0,0,2,2
85555,200,20047,25832;26407,58400,0,0,1,1,2
85556,200,20048,26011,58400,0,0,1,0,1
85557,200,20050,26061;26074;28997,58400,0,0,3,0,3
85558,200,20051,25905;25949;29542,58400,0,0,2,1,3
85559,200,20052,26433,58400,0,0,1,0,1
85560,200,20053,25876;26396,58400,0,0,1,1,2
85561,200,20054,25902;25981,58400,0,0,1,1,2
85562,200,20055,25913;26006;30453,58400,0,0,2,1,3
85563,200,20056,26007;26139,58400,0,0,2,0,2
85564,200,20057,25860;26032,58400,0,0,1,1,2
85565,200,20058,26057;26328,58400,0,0,2,0,2
85566,200,20059,26221;26261,58400,0,0,2,0,2
85567,200,20060,26420;26528;30176;30267,58400,0,0,4,0,4
85568,200,20061,26298;26372;29908;29999,58400,0,0,4,0,4
85569,200,20062,25893;26112,58400,0,0,1,1,2
85570,200,20063,26020;26117,58400,0,0,2,0,2
85571,200,20064,26122;26510,58400,0,0,2,0,2
85572,200,20065,25953;26203;30360,58400,0,0,3,0,3
85573,200,20066,25250;25539,58400,0,0,0,2,2
85574,200,20067,26152,58400,0,0,1,0,1
85575,200,20068,26208;26364,58400,0,0,2,0,2
85576,200,20070,26647;26821;29934;30008;30460,58400,0,0,5,0,5
85577,200,20071,25993;26263,58400,0,0,2,0,2
85578,200,20073,26275;26282,58400,0,0,2,0,2
85579,200,20074,26498;26524,58400,0,0,2,0,2
85580,200,20075,26385;26590,58400,0,0,2,0,2
85581,200,20076,25969;26391,58400,0,0,2,0,2
85582,200,20077,26227;26532;29484;29834;32024,58400,1,0,4,0,5
85583,200,20078,26381;26596,58400,0,0,2,0,2
85584,200,20079,26519;26694;29669,58400,0,0,3,0,3
85585,200,20080,26414;26427;29201,58400,0,0,3,0,3
85586,200,20096,22984,58765,0,0,0,1,1
85587,200,20101,23921,58765,0,0,0,1,1
85588,200,20107,24603;25139,58765,0,0,0,2,2
85589,200,20109,24416,58765,0,0,0,1,1
85590,200,20113,24930,58765,0,0,0,1,1
85591,200,20114,25112,58765,0,0,0,1,1
85592,200,20118,25522;28518,58765,0,0,1,1,2
85593,200,20120,25858;29344,58765,0,0,1,1,2
85594,200,20121,25471;25535,58765,0,0,0,2,2
85595,200,20122,25524;25592,58765,0,0,0,2,2
85596,200,20123,25899,58765,0,0,0,1,1
85597,200,20124,25497;25870,58765,0,0,0,2,2
85598,200,20126,25568;25692,58765,0,0,0,2,2
85599,200,20127,26084;28903;31340;31986,58765,1,1,2,0,4
85600,200,20129,25761;25809,58765,0,0,0,2,2
85601,200,20131,26001;26266,58765,0,0,2,0,2
85602,200,20132,26119,58765,0,0,1,0,1
85603,200,20133,26398,58765,0,0,1,0,1
85604,200,20134,25725;26125,58765,0,0,1,1,2
85605,200,20135,25844;26060,58765,0,0,1,1,2
85606,200,20137,26754;30274,58765,0,0,2,0,2
85607,200,20139,26222;26537,58765,0,0,2,0,2
85608,200,20140,26237;26310,58765,0,0,2,0,2
85609,200,20143,26160;26255,58765,0,0,2,0,2
85610,200,20144,26749;26774,58765,0,0,2,0,2
85611,200,20145,26419;26545,58765,0,0,2,0,2
85612,200,20146,26530;26707,58765,0,0,2,0,2
85613,200,20147,26314,58765,0,0,1,0,1
85614,200,20148,25534;26322;29287;31609;31862,58765,1,1,2,1,5
85615,200,20149,26708;29398,58765,0,0,2,0,2
85616,200,20150,26350;26603;29664,58765,0,0,3,0,3
85617,200,20151,25593;26375,58765,0,0,1,1,2
85618,200,20152,26377;26493,58765,0,0,2,0,2
85619,200,20153,26443;26601;29302;31687,58765,1,0,3,0,4
85620,200,20154,26421;26723,58765,0,0,2,0,2
85621,200,20155,26243;26450,58765,0,0,2,0,2
85622,200,20156,26281;26454;29656,58765,0,0,3,0,3
85623,200,20157,26274;26460,58765,0,0,2,0,2
85624,200,20158,26056;26090,58765,0,0,2,0,2
85625,200,20159,26444;26741;30370,58765,0,0,3,0,3
85626,200,20160,26413;26473;29743,58765,0,0,3,0,3
85627,200,20161,26276;26490;29567;29660,58765,0,0,4,0,4
85628,200,20163,26512;29745,58765,0,0,2,0,2
85629,200,20168,22456;22990,59130,0,0,0,2,2
85630,200,20176,23363,59130,0,0,0,1,1
85631,200,20182,23524,59130,0,0,0,1,1
85632,200,20189,24275,59130,0,0,0,1,1
85633,200,20205,24866;25219,59130,0,0,0,2,2
85634,200,20206,25249,59130,0,0,0,1,1
85635,200,20208,25553;28789;30906;31731,59130,1,1,1,1,4
85636,200,20210,25485;25678,59130,0,0,0,2,2
85637,200,20211,25706;26085,59130,0,0,1,1,2
85638,200,20212,25450;25828;29717;31954,59130,1,0,1,2,4
85639,200,20213,25755,59130,0,0,0,1,1
85640,200,20214,25762;25978,59130,0,0,1,1,2
85641,200,20215,25847;25956,59130,0,0,1,1,2
85642,200,20216,26286;26368,59130,0,0,2,0,2
85643,200,20217,25952,59130,0,0,1,0,1
85644,200,20218,25687;25964,59130,0,0,1,1,2
85645,200,20219,25794;25850,59130,0,0,0,2,2
85646,200,20221,26013;30629,59130,0,1,1,0,2
85647,200,20222,26076;26081,59130,0,0,2,0,2
85648,200,20223,25843;26279;30074;30265,59130,0,0,3,1,4
85649,200,20224,26211,59130,0,0,1,0,1
85650,200,20225,26183;29278,59130,0,0,2,0,2
85651,200,20226,26410;26502;30546,59130,0,1,2,0,3
85652,200,20227,25997;26206,59130,0,0,2,0,2
85653,200,20228,26207;26763,59130,0,0,2,0,2
85654,200,20230,25924;26235,59130,0,0,2,0,2
85655,200,20231,26539;29299,59130,0,0,2,0,2
85656,200,20232,26463,59130,0,0,1,0,1
85657,200,20233,26042;26401,59130,0,0,2,0,2
85658,200,20234,26569,59130,0,0,1,0,1
85659,200,20235,26426,59130,0,0,1,0,1
85660,200,20236,26348;26429,59130,0,0,2,0,2
85661,200,20237,26485;29744,59130,0,0,2,0,2
85662,200,20240,26561,59130,0,0,1,0,1
85663,200,20241,26434;26579;29205;30454;31266;31436;31683,59130,1,2,4,0,7
85664,200,20242,26476;26572,59130,0,0,2,0,2
85665,200,20250,23396,59495,0,0,0,1,1
85666,200,20257,23378,59495,0,0,0,1,1
85667,200,20262,24049;24157,59495,0,0,0,2,2
85668,200,20267,24595;24900;28216,59495,0,0,1,2,3
85669,200,20269,25016;25429;28610,59495,0,0,1,2,3
85670,200,20270,25311,59495,0,0,0,1,1
85671,200,20271,25083;25309,59495,0,0,0,2,2
85672,200,20272,25547;25690,59495,0,0,0,2,2
85673,200,20273,25767,59495,0,0,0,1,1
85674,200,20274,25654;25739;28880,59495,0,0,1,2,3
85675,200,20275,25554;25765,59495,0,0,0,2,2
85676,200,20277,25754,59495,0,0,0,1,1
85677,200,20278,25742;26389;29737;30075,59495,0,0,3,1,4
85678,200,20279,25932;29260;30070,59495,0,0,3,0,3
85679,200,20280,26062;26172,59495,0,0,2,0,2
85680,200,20281,26500;29568,59495,0,0,2,0,2
85681,200,20282,26258;26452,59495,0,0,2,0,2
85682,200,20284,26083;26229,59495,0,0,2,0,2
85683,200,20285,25934;26089;28651,59495,0,0,3,0,3
85684,200,20286,26095;26114;29355,59495,0,0,3,0,3
85685,200,20287,26111,59495,0,0,1,0,1
85686,200,20289,25734;26133,59495,0,0,1,1,2
85687,200,20290,26199,59495,0,0,1,0,1
85688,200,20292,26153;26932,59495,0,0,2,0,2
85689,200,20293,26173;29723,59495,0,0,2,0,2
85690,200,20294,26126;26176,59495,0,0,2,0,2
85691,200,20295,26197;26585,59495,0,0,2,0,2
85692,200,20297,26257;26289,59495,0,0,2,0,2
85693,200,20298,26268;26927,59495,0,0,2,0,2
85694,200,20299,26577;26635;30082;30727,59495,0,1,3,0,4
85695,200,20301,26710,59495,0,0,1,0,1
85696,200,20302,25732;26470;30268,59495,0,0,2,1,3
85697,200,20303,26357;26862;30279;32057,59495,1,0,3,0,4
85698,200,20304,26366;26833,59495,0,0,2,0,2
85699,200,20306,26254;26295,59495,0,0,2,0,2
85700,200,20307,26336;26442,59495,0,0,2,0,2
85701,200,20308,26453;26772,59495,0,0,2,0,2
85702,200,20309,26483;26969;29681,59495,0,0,3,0,3
85703,200,20310,26325;26526,59495,0,0,2,0,2
85704,200,20311,26529;26648,59495,0,0,2,0,2
85705,200,20312,26842;26901;29942;30104,59495,0,0,4,0,4
85706,200,20313,26534;26615;29569,59495,0,0,3,0,3
85707,200,20314,26767;26948,59495,0,0,2,0,2
85708,200,20315,26415;26573,59495,0,0,2,0,2
85709,200,20316,26613,59495,0,0,1,0,1
85710,200,20317,26610;26652;30456,59495,0,0,3,0,3
85711,200,20318,26658;29840;30630,59495,0,1,2,0,3
85712,200,20319,26404;26669,59495,0,0,2,0,2
85713,200,20320,26683;30089,59495,0,0,2,0,2
85714,200,20321,26509;27227;30368,59495,0,0,3,0,3
85715,200,20322,26641;26687,59495,0,0,2,0,2
85716,200,20323,26285;26706;29845,59495,0,0,3,0,3
85717,200,20324,26830;26903,59495,0,0,2,0,2
85718,200,20347,24121;24288,59860,0,0,0,2,2
85719,200,20350,24433,59860,0,0,0,1,1
85720,200,20351,24825;25023;27430;30740,59860,0,1,1,2,4
85721,200,20353,25227,59860,0,0,0,1,1
85722,200,20354,25061;25378;29234,59860,0,0,1,2,3
85723,200,20358,25789;25803,59860,0,0,0,2,2
85724,200,20359,25824,59860,0,0,0,1,1
85725,200,20360,25381,59860,0,0,0,1,1
85726,200,20362,25508,59860,0,0,0,1,1
85727,200,20363,25356;25622,59860,0,0,0,2,2
85728,200,20364,25100;25350,59860,0,0,0,2,2
85729,200,20365,25541;25748,59860,0,0,0,2,2
85730,200,20366,26185;29725,59860,0,0,2,0,2
85731,200,20367,25937,59860,0,0,1,0,1
85732,200,20368,25709;25793;29622;31621,59860,0,1,1,2,4
85733,200,20371,25942;26342,59860,0,0,2,0,2
85734,200,20372,26306;26888;30464,59860,0,0,3,0,3
85735,200,20374,26115;30072,59860,0,0,2,0,2
85736,200,20375,26012;26352;30362,59860,0,0,3,0,3
85737,200,20376,25699;26049,59860,0,0,1,1,2
85738,200,20378,25602;26087,59860,0,0,1,1,2
85739,200,20379,25798;26217,59860,0,0,1,1,2
85740,200,20381,26141;26812;29217;31007;31931,59860,1,1,3,0,5
85741,200,20382,25704;26360;29998,59860,0,0,2,1,3
85742,200,20385,26495;26690,59860,0,0,2,0,2
85743,200,20388,26633,59860,0,0,1,0,1
85744,200,20390,26361;26362,59860,0,0,2,0,2
85745,200,20391,26383;26511,59860,0,0,2,0,2
85746,200,20392,26395;26556;29749,59860,0,0,3,0,3
85747,200,20393,26400;26655,59860,0,0,2,0,2
85748,200,20394,26186;29084;31086;31263,59860,0,2,2,0,4
85749,200,20396,26004;26010;28454,59860,0,0,3,0,3
85750,200,20397,26402;26435,59860,0,0,2,0,2
85751,200,20398,26675;27015,59860,0,0,2,0,2
85752,200,20399,26456;26828;29935,59860,0,0,3,0,3
85753,200,20400,26347;26728,59860,0,0,2,0,2
85754,200,20402,26369;26662;29841;29919;30457;30728,59860,0,1,5,0,6
85755,200,20403,26665;26983,59860,0,0,2,0,2
85756,200,20404,26898;29588,59860,0,0,2,0,2
85757,200,20405,26863;27059;30470,59860,0,0,3,0,3
85758,200,20407,26242;26634,59860,0,0,2,0,2
85759,200,20408,26896;27062;30549,59860,0,1,2,0,3
85760,200,20409,26525;26753,59860,0,0,2,0,2
85761,200,20410,26691;26869;30100;30280,59860,0,0,4,0,4
85762,200,20411,26688;29397;30272,59860,0,0,3,0,3
85763,200,20412,26843;27049,59860,0,0,2,0,2
85764,200,20413,26554;26714;29486;29748,59860,0,0,4,0,4
85765,200,20414,26963;26981;29775;30814;32041,59860,1,1,3,0,5
85766,200,20415,26747;26868;29939,59860,0,0,3,0,3
85767,200,20417,26390;26808;30459,59860,0,0,3,0,3
85768,200,20428,23637;23694,60225,0,0,0,2,2
85769,200,20436,24109;24558,60225,0,0,0,2,2
85770,200,20439,24814;24828,60225,0,0,0,2,2
85771,200,20440,24773;25228,60225,0,0,0,2,2
85772,200,20441,24986,60225,0,0,0,1,1
85773,200,20443,24749;24933,60225,0,0,0,2,2
85774,200,20445,25337;25341,60225,0,0,0,2,2
85775,200,20446,25499;25607;28624,60225,0,0,1,2,3
85776,200,20447,25677;25731,60225,0,0,0,2,2
85777,200,20448,25883;25972,60225,0,0,1,1,2
85778,200,20451,25291;25787,60225,0,0,0,2,2
85779,200,20452,25444;25892,60225,0,0,0,2,2
85780,200,20453,25986;29543,60225,0,0,2,0,2
85781,200,20454,25939,60225,0,0,1,0,1
85782,200,20455,25963;26284,60225,0,0,2,0,2
85783,200,20459,26154;26174;28912;29724,60225,0,0,4,0,4
85784,200,20460,26374,60225,0,0,1,0,1
85785,200,20461,26127;26330,60225,0,0,2,0,2
85786,200,20462,25886;26143;29641,60225,0,0,2,1,3
85787,200,20464,26161;26430,60225,0,0,2,0,2
85788,200,20465,26251;26521,60225,0,0,2,0,2
85789,200,20466,26345;26376,60225,0,0,2,0,2
85790,200,20467,26094;26926;30018;30107,60225,0,0,4,0,4
85791,200,20468,26329;26480,60225,0,0,2,0,2
85792,200,20469,26358;26432,60225,0,0,2,0,2
85793,200,20470,26324;26542;30726,60225,0,1,2,0,3
85794,200,20472,25968;26252;30264,60225,0,0,3,0,3
85795,200,20473,26650;26771,60225,0,0,2,0,2
85796,200,20474,26449;26591,60225,0,0,2,0,2
85797,200,20475,26213;26575,60225,0,0,2,0,2
85798,200,20477,26063;26491,60225,0,0,2,0,2
85799,200,20478,26656;26807;29396,60225,0,0,3,0,3
85800,200,20479,26813;29847;31957,60225,1,0,2,0,3
85801,200,20481,26887;27007,60225,0,0,2,0,2
85802,200,20482,26513;29014;29388;30079;30270;32056,60225,1,0,5,0,6
85803,200,20483,26607,60225,0,0,1,0,1
85804,200,20484,26065;26612;29392;29489,60225,0,0,4,0,4
85805,200,20485,26627;29210;30084,60225,0,0,3,0,3
85806,200,20486,26785,60225,0,0,1,0,1
85807,200,20487,26624,60225,0,0,1,0,1
85808,200,20488,26514;26659;30365,60225,0,0,3,0,3
85809,200,20489,26451;26663;30087;30915,60225,0,1,3,0,4
85810,200,20490,27217,60225,0,0,1,0,1
85811,200,20491,27002;30192,60225,0,0,2,0,2
85812,200,20492,26777;26870,60225,0,0,2,0,2
85813,200,20493,26520;29913;30271,60225,0,0,3,0,3
85814,200,20494,26765,60225,0,0,1,0,1
85815,200,20495,26743;26809;30095;30275,60225,0,0,4,0,4
85816,200,20496,26811;26994,60225,0,0,2,0,2
85817,200,20497,26817;30372,60225,0,0,2,0,2
85818,200,20498,26409;26681;29842;30367,60225,0,0,4,0,4
85819,200,20499,26829;26873;29675,60225,0,0,3,0,3
85820,200,20500,26861;26875,60225,0,0,2,0,2
85821,200,20502,26916;26979,60225,0,0,2,0,2
85822,200,20514,23661,60590,0,0,0,1,1
85823,200,20516,24021,60590,0,0,0,1,1
85824,200,20526,23973;24560,60590,0,0,0,2,2
85825,200,20531,24802,60590,0,0,0,1,1
85826,200,20536,25017;25479,60590,0,0,0,2,2
85827,200,20539,24967;25366,60590,0,0,0,2,2
85828,200,20546,25898;26014,60590,0,0,1,1,2
85829,200,20549,25601,60590,0,0,0,1,1
85830,200,20553,25352;26009,60590,0,0,1,1,2
85831,200,20554,26155;29643,60590,0,0,2,0,2
85832,200,20555,25960;26499,60590,0,0,2,0,2
85833,200,20557,26055;26236,60590,0,0,2,0,2
85834,200,20558,26039;26078,60590,0,0,2,0,2
85835,200,20559,26177;26214,60590,0,0,2,0,2
85836,200,20560,26202;26373,60590,0,0,2,0,2
85837,200,20562,26256;26824,60590,0,0,2,0,2
85838,200,20563,26164;26259,60590,0,0,2,0,2
85839,200,20564,26291;26344;29996,60590,0,0,3,0,3
85840,200,20565,26292;26346,60590,0,0,2,0,2
85841,200,20566,26297;26563;29916,60590,0,0,3,0,3
85842,200,20567,26311;26778,60590,0,0,2,0,2
85843,200,20568,26320;26323,60590,0,0,2,0,2
85844,200,20569,26147;26371,60590,0,0,2,0,2
85845,200,20570,26428;26440,60590,0,0,2,0,2
85846,200,20571,29207,60590,0,0,1,0,1
85847,200,20572,26370;26558;29661;29750,60590,0,0,4,0,4
85848,200,20574,26935,60590,0,0,1,0,1
85849,200,20575,26478;26626;30181,60590,0,0,3,0,3
85850,200,20576,26600;29574,60590,0,0,2,0,2
85851,200,20577,26640;30085,60590,0,0,2,0,2
85852,200,20578,26739;27028,60590,0,0,2,0,2
85853,200,20579,26664;30729,60590,0,1,1,0,2
85854,200,20580,26666;26967;30284,60590,0,0,3,0,3
85855,200,20581,27011;27214;30124;30208,60590,0,0,4,0,4
85856,200,20582,26698;27118;30637,60590,0,1,2,0,3
85857,200,20583,26700,60590,0,0,1,0,1
85858,200,20584,26705;26818;29760,60590,0,0,3,0,3
85859,200,20585,26773;26894;30103;30917,60590,0,1,3,0,4
85860,200,20586,26758;30091,60590,0,0,2,0,2
85861,200,20587,26800;26951;30109;31457,60590,0,1,3,0,4
85862,200,20588,26696;26820;29761;30187,60590,0,0,4,0,4
85863,200,20589,26755;26823;30096,60590,0,0,3,0,3
85864,200,20590,26661;26826,60590,0,0,2,0,2
85865,200,20591,26447;26853;29937,60590,0,0,3,0,3
85866,200,20592,26674;27084;30471,60590,0,0,3,0,3
85867,200,20593,26776;26891,60590,0,0,2,0,2
85868,200,20594,26657;26907;30465,60590,0,0,3,0,3
85869,200,20595,26947;27284;29769,60590,0,0,3,0,3
85870,200,20596,26353;27001,60590,0,0,2,0,2
85871,200,20597,26997;27127;30638,60590,0,1,2,0,3
85872,200,20598,27009;27314,60590,0,0,2,0,2
85873,200,20599,22900,60955,0,0,0,1,1
85874,200,20600,22993,60955,0,0,0,1,1
85875,200,20602,22732,60955,0,0,0,1,1
85876,200,20611,23651;23716,60955,0,0,0,2,2
85877,200,20612,23818,60955,0,0,0,1,1
85878,200,20614,23484,60955,0,0,0,1,1
85879,200,20616,23522,60955,0,0,0,1,1
85880,200,20625,25101,60955,0,0,0,1,1
85881,200,20633,25319,60955,0,0,0,1,1
85882,200,20638,26379,60955,0,0,1,0,1
85883,200,20641,26188;26317,60955,0,0,2,0,2
85884,200,20642,26393,60955,0,0,1,0,1
85885,200,20645,26264;26465;30179;31699;31802,60955,2,0,3,0,5
85886,200,20646,25627;26240;29280;29465,60955,0,0,3,1,4
85887,200,20647,26067;26304;29827,60955,0,0,3,0,3
85888,200,20648,26294;26388,60955,0,0,2,0,2
85889,200,20650,26867;26991;30633,60955,0,1,2,0,3
85890,200,20651,26639;26914;30182,60955,0,0,3,0,3
85891,200,20652,26552;26684,60955,0,0,2,0,2
85892,200,20653,27000,60955,0,0,1,0,1
85893,200,20654,26632;27027,60955,0,0,2,0,2
85894,200,20655,26682;27071;30379,60955,0,0,3,0,3
85895,200,20656,26417;26693;30916,60955,0,1,2,0,3
85896,200,20657,26547;26699;29923,60955,0,0,3,0,3
85897,200,20658,26719;27093;30090,60955,0,0,3,0,3
85898,200,20659,26273;26722,60955,0,0,2,0,2
85899,200,20660,26742;30631,60955,0,1,1,0,2
85900,200,20661,26764;27048,60955,0,0,2,0,2
85901,200,20662,26546;26766,60955,0,0,2,0,2
85902,200,20663,26645;26770,60955,0,0,2,0,2
85903,200,20664,26608;26985;30375,60955,0,0,3,0,3
85904,200,20665,26801;26966,60955,0,0,2,0,2
85905,200,20666,26462;26825;29849,60955,0,0,3,0,3
85906,200,20667,26704;26860;30099,60955,0,0,3,0,3
85907,200,20668,26676;27021;29941;29946;30022;30188;30463;31011;31959;32051,60955,2,1,7,0,10
85908,200,20669,26884;27147,60955,0,0,2,0,2
85909,200,20670,26902;26928,60955,0,0,2,0,2
85910,200,20671,27316;30650,60955,0,1,1,0,2
85911,200,20672,26474;26834;30278;30461,60955,0,0,4,0,4
85912,200,20673,26919,60955,0,0,1,0,1
85913,200,20674,26920,60955,0,0,1,0,1
85914,200,20675,26957;27025;30110;30282;30812,60955,0,1,4,0,5
85915,200,20676,26571;26945;30190,60955,0,0,3,0,3
85916,200,20677,26583;26952;30811,60955,0,1,2,0,3
85917,200,20678,27198;27435;29787;30477;30644,60955,0,1,4,0,5
85918,200,20679,26973;27185;30300,60955,0,0,3,0,3
85919,200,20681,27068;27162;29598;30378;30636,60955,0,1,4,0,5
85920,200,20682,26851,60955,0,0,1,0,1
85921,200,20683,26905;26993,60955,0,0,2,0,2
85922,200,20684,27140;27226,60955,0,0,2,0,2
85923,200,20686,26923;27029;30377,60955,0,0,3,0,3
85924,200,20687,26879;27075,60955,0,0,2,0,2
85925,200,20688,27054;27213;30123,60955,0,0,3,0,3
85926,200,20689,26883;27281;30306;30822,60955,0,1,3,0,4
85927,200,20690,26247;26712;30369;31010,60955,0,1,3,0,4
85928,200,20691,26864;27090;30114,60955,0,0,3,0,3
85929,200,20692,26649;27103;30115,60955,0,0,3,0,3
85930,200,20693,27318,60955,0,0,1,0,1
85931,200,20695,23181,61320,0,0,0,1,1
85932,200,20697,23222,61320,0,0,0,1,1
85933,200,20698,23144,61320,0,0,0,1,1
85934,200,20702,23485;23768,61320,0,0,0,2,2
85935,200,20705,24014,61320,0,0,0,1,1
85936,200,20719,24792;24822,61320,0,0,0,2,2
85937,200,20725,25194;25385,61320,0,0,0,2,2
85938,200,20726,24987,61320,0,0,0,1,1
85939,200,20730,25578;25791,61320,0,0,0,2,2
85940,200,20731,25800;28723,61320,0,0,1,1,2
85941,200,20733,26033,61320,0,0,1,0,1
85942,200,20734,26356,61320,0,0,1,0,1
85943,200,20737,25628;26036;29545,61320,0,0,2,1,3
85944,200,20740,26157,61320,0,0,1,0,1
85945,200,20742,26689;26978;30374;30466,61320,0,0,4,0,4
85946,200,20743,26822;30277;30632,61320,0,1,2,0,3
85947,200,20745,26479;29565,61320,0,0,2,0,2
85948,200,20746,26190;26536;30080,61320,0,0,3,0,3
85949,200,20747,26423;26620;30083,61320,0,0,3,0,3
85950,200,20748,26523;26810,61320,0,0,2,0,2
85951,200,20749,26782;27109;29862,61320,0,0,3,0,3
85952,200,20751,26746;29929,61320,0,0,2,0,2
85953,200,20752,27122;27319;30922,61320,0,1,2,0,3
85954,200,20753,26557;26803,61320,0,0,2,0,2
85955,200,20754,26517;26584,61320,0,0,2,0,2
85956,200,20755,26725;29582,61320,0,0,2,0,2
85957,200,20758,26578;26673,61320,0,0,2,0,2
85958,200,20759,26726;26933;30810,61320,0,1,2,0,3
85959,200,20760,26737;26885,61320,0,0,2,0,2
85960,200,20761,26759;27066;30458,61320,0,0,3,0,3
85961,200,20763,26906;27255,61320,0,0,2,0,2
85962,200,20764,26931;27070;29677;30281,61320,0,0,4,0,4
85963,200,20765,26975;27272;29871,61320,0,0,3,0,3
85964,200,20766,26988;29859,61320,0,0,2,0,2
85965,200,20768,26779;27039;30197,61320,0,0,3,0,3
85966,200,20769,27142;27374;30736;31184,61320,0,2,2,0,4
85967,200,20770,27139,61320,0,0,1,0,1
85968,200,20771,26839;27415,61320,0,0,2,0,2
85969,200,20772,26832;27098;29416,61320,0,0,3,0,3
85970,200,20774,27067;27102,61320,0,0,2,0,2
85971,200,20775,26915;27129,61320,0,0,2,0,2
85972,200,20776,27074;27328;30219;30309,61320,0,0,4,0,4
85973,200,20777,27073;27145;30385,61320,0,0,3,0,3
85974,200,20778,27160;30667,61320,0,1,1,0,2
85975,200,20779,27149;27229;29865;30118;30203;30919,61320,0,1,5,0,6
85976,200,20781,27173;27580;30743,61320,0,1,2,0,3
85977,200,20782,27191,61320,0,0,1,0,1
85978,200,20783,27192;29786;29951,61320,0,0,3,0,3
85979,200,20784,26845;27233;29789;30392;30557,61320,0,1,4,0,5
85980,200,20785,27438;29426;30400;31869,61320,1,0,3,0,4
85981,200,20788,23460,61685,0,0,0,1,1
85982,200,20794,23873,61685,0,0,0,1,1
85983,200,20796,23848;23957,61685,0,0,0,2,2
85984,200,20799,24055,61685,0,0,0,1,1
85985,200,20801,24331,61685,0,0,0,1,1
85986,200,20805,24579;28378,61685,0,0,1,1,2
85987,200,20807,24466;24529,61685,0,0,0,2,2
85988,200,20817,25529;25548,61685,0,0,0,2,2
85989,200,20823,25281;25698;28631,61685,0,0,1,2,3
85990,200,20825,26058;29547;29633;31790,61685,1,0,3,0,4
85991,200,20827,25426;25783,61685,0,0,0,2,2
85992,200,20829,25657,61685,0,0,0,1,1
85993,200,20833,25979;26538,61685,0,0,2,0,2
85994,200,20834,26587,61685,0,0,1,0,1
85995,200,20835,26224;26293;29007,61685,0,0,3,0,3
85996,200,20836,26717;26720,61685,0,0,2,0,2
85997,200,20837,26457;26721;30273,61685,0,0,3,0,3
85998,200,20838,27257;27444;31700,61685,1,0,2,0,3
85999,200,20840,26566;26831;30010,61685,0,0,3,0,3
86000,200,20841,26466;30180,61685,0,0,2,0,2
86001,200,20842,26327;26588;29391,61685,0,0,3,0,3
86002,200,20846,26729,61685,0,0,1,0,1
86003,200,20847,26701;26745;29924,61685,0,0,3,0,3
86004,200,20848,26751;26900;29852,61685,0,0,3,0,3
86005,200,20849,26806;27186;30732,61685,0,1,2,0,3
86006,200,20850,26816;26984,61685,0,0,2,0,2
86007,200,20851,26836;27023;30011,61685,0,0,3,0,3
86008,200,20852,27088;27280;31282,61685,0,1,2,0,3
86009,200,20853,27095,61685,0,0,1,0,1
86010,200,20855,26589;26677,61685,0,0,2,0,2
86011,200,20856,26886;27269,61685,0,0,2,0,2
86012,200,20858,26946;27030;29415,61685,0,0,3,0,3
86013,200,20859,27195,61685,0,0,1,0,1
86014,200,20860,27120;27330;30564,61685,0,1,2,0,3
86015,200,20861,26543;27022,61685,0,0,2,0,2
86016,200,20862,27038,61685,0,0,1,0,1
86017,200,20863,27065;27215;30209,61685,0,0,3,0,3
86018,200,20864,27179;27210;29228;30389,61685,0,0,4,0,4
86019,200,20865,27055;30469;32062,61685,1,0,2,0,3
86020,200,20866,26998;27061,61685,0,0,2,0,2
86021,200,20867,27083;29779;30024;30113;30199;30380;30918,61685,0,1,6,0,7
86022,200,20868,26940;27087;30381;32060,61685,1,0,3,0,4
86023,200,20870,26895;27108;29782;30382;31454,61685,0,1,4,0,5
86024,200,20871,27165;30121;30554,61685,0,1,2,0,3
86025,200,20872,27183;27296,61685,0,0,2,0,2
86026,200,20873,27024;27221;30037,61685,0,0,3,0,3
86027,200,20874,27616;30410,61685,0,0,2,0,2
86028,200,20875,27279;27286;29957;30481,61685,0,0,4,0,4
86029,200,20876,27175;27436;30313;31014,61685,0,1,3,0,4
86030,200,20878,27299;29606;30560,61685,0,1,2,0,3
86031,200,20879,27482;30492;30576,61685,0,1,2,0,3
86032,200,20880,27123;27562;29799;29882;30234;31102;31532;31795,61685,1,2,5,0,8
86033,200,20884,23399,62050,0,0,0,1,1
86034,200,20889,23906,62050,0,0,0,1,1
86035,200,20892,23655;23896,62050,0,0,0,2,2
86036,200,20897,24403,62050,0,0,0,1,1
86037,200,20899,24415;24473,62050,0,0,0,2,2
86038,200,20908,24912,62050,0,0,0,1,1
86039,200,20913,25145;25279,62050,0,0,0,2,2
86040,200,20916,25599;26050,62050,0,0,1,1,2
86041,200,20920,26181,62050,0,0,1,0,1
86042,200,20923,26271;26515,62050,0,0,2,0,2
86043,200,20924,26288;26618;29393;29918;30455;31958,62050,1,0,5,0,6
86044,200,20926,26343;26487;29659;31278;32037,62050,1,1,3,0,5
86045,200,20927,26406;26598,62050,0,0,2,0,2
86046,200,20929,26911;31280,62050,0,1,1,0,2
86047,200,20930,25988;26568;28935;30804;31588,62050,0,2,3,0,5
86048,200,20931,26501;26581,62050,0,0,2,0,2
86049,200,20933,26671;26672,62050,0,0,2,0,2
86050,200,20935,26550;26874,62050,0,0,2,0,2
86051,200,20936,26651;26847,62050,0,0,2,0,2
86052,200,20937,26709,62050,0,0,1,0,1
86053,200,20939,26781;27152,62050,0,0,2,0,2
86054,200,20940,27124,62050,0,0,1,0,1
86055,200,20944,26363;26881,62050,0,0,2,0,2
86056,200,20946,27107;27250,62050,0,0,2,0,2
86057,200,20947,27164;30028;30120;30553,62050,0,1,3,0,4
86058,200,20948,26955;27230,62050,0,0,2,0,2
86059,200,20949,27225;27232;30039;30302;30473;30646,62050,0,1,5,0,6
86060,200,20950,27099;27294;29682;30023;30468;30482;30559,62050,0,1,6,0,7
86061,200,20951,27537;27628;29521;30660,62050,0,1,3,0,4
86062,200,20952,27252;30128;30213;30821,62050,0,1,3,0,4
86063,200,20953,27184,62050,0,0,1,0,1
86064,200,20954,26892;27130;30639,62050,0,1,2,0,3
86065,200,20955,26964;27151,62050,0,0,2,0,2
86066,200,20956,27238;27437;30230,62050,0,0,3,0,3
86067,200,20957,27605;30500,62050,0,0,2,0,2
86068,200,20958,27251;27409;30654,62050,0,1,2,0,3
86069,200,20959,27258;27306,62050,0,0,2,0,2
86070,200,20960,27592;27705;31360,62050,0,1,2,0,3
86071,200,20961,27058;27652;30583,62050,0,1,2,0,3
86072,200,20962,26962;27329,62050,0,0,2,0,2
86073,200,20963,27527;30407;31016,62050,0,1,2,0,3
86074,200,20964,27116;27345,62050,0,0,2,0,2
86075,200,20965,27355;27872;30336;30852,62050,0,1,3,0,4
86076,200,20967,27360;27366;30044,62050,0,0,3,0,3
86077,200,20968,27373;27720,62050,0,0,2,0,2
86078,200,20969,27380;27676;31021,62050,0,1,2,0,3
86079,200,20970,27134;27383;30398;30486,62050,0,0,4,0,4
86080,200,20971,27110;27388;30568;30738;31359,62050,0,3,2,0,5
86081,200,20972,27733;30939,62050,0,1,1,0,2
86082,200,20973,27050;27554,62050,0,0,2,0,2
86083,200,20979,23658;23730,62415,0,0,0,2,2
86084,200,20984,24484,62415,0,0,0,1,1
86085,200,20986,24253,62415,0,0,0,1,1
86086,200,20989,24448;24565,62415,0,0,0,2,2
86087,200,20994,24779,62415,0,0,0,1,1
86088,200,20997,24871;25285,62415,0,0,0,2,2
86089,200,21001,25659;25799,62415,0,0,0,2,2
86090,200,21005,26516,62415,0,0,1,0,1
86091,200,21008,26021;26302,62415,0,0,2,0,2
86092,200,21009,25955;26397,62415,0,0,2,0,2
86093,200,21010,26494,62415,0,0,1,0,1
86094,200,21011,26609;26716;29665,62415,0,0,3,0,3
86095,200,21012,26187;30177,62415,0,0,2,0,2
86096,200,21013,26437;26475,62415,0,0,2,0,2
86097,200,21014,26544;26738;29927;30185,62415,0,0,4,0,4
86098,200,21015,26230;26387,62415,0,0,2,0,2
86099,200,21018,26629;26855,62415,0,0,2,0,2
86100,200,21019,26740;27168;30387;30643,62415,0,1,3,0,4
86101,200,21020,26408;26752;29498,62415,0,0,3,0,3
86102,200,21021,26567;27003;30376;30635,62415,0,1,3,0,4
86103,200,21022,27114,62415,0,0,1,0,1
86104,200,21023,26399;26730;30184,62415,0,0,3,0,3
86105,200,21024,26859,62415,0,0,1,0,1
86106,200,21025,26692;26939,62415,0,0,2,0,2
86107,200,21026,26995;27180,62415,0,0,2,0,2
86108,200,21028,26592;27006,62415,0,0,2,0,2
86109,200,21029,27302;27378;29322;29874;30397;30653;30737,62415,0,2,5,0,7
86110,200,21030,27020;27274,62415,0,0,2,0,2
86111,200,21032,27428,62415,0,0,1,0,1
86112,200,21033,26846;27295;30217;30483,62415,0,0,4,0,4
86113,200,21034,27035;27171,62415,0,0,2,0,2
86114,200,21035,27291;27317;30130,62415,0,0,3,0,3
86115,200,21036,27612;30055;30151,62415,0,0,3,0,3
86116,200,21037,27224,62415,0,0,1,0,1
86117,200,21038,27189;27241;31012,62415,0,1,2,0,3
86118,200,21040,27273;27524;29700;30577,62415,0,1,3,0,4
86119,200,21041,26974;27262,62415,0,0,2,0,2
86120,200,21042,27076;27202;30820,62415,0,1,2,0,3
86121,200,21044,27417;30227,62415,0,0,2,0,2
86122,200,21045,27777;27837;29889;31109,62415,0,1,3,0,4
86123,200,21046,26990;27434;30742;31099,62415,0,2,2,0,4
86124,200,21048,27532;30495,62415,0,0,2,0,2
86125,200,21049,27553;27618;30581;30663,62415,0,2,2,0,4
86126,200,21050,27389;27555;30497;30661,62415,0,1,3,0,4
86127,200,21051,27410;27599;31188,62415,0,1,2,0,3
86128,200,21058,23892,62780,0,0,0,1,1
86129,200,21060,24056,62780,0,0,0,1,1
86130,200,21081,25425;25778,62780,0,0,0,2,2
86131,200,21086,25604,62780,0,0,0,1,1
86132,200,21087,25702;25845,62780,0,0,0,2,2
86133,200,21090,25925,62780,0,0,1,0,1
86134,200,21092,26196;26484;30269;30364,62780,0,0,4,0,4
86135,200,21093,26448;30077,62780,0,0,2,0,2
86136,200,21095,26019;26303,62780,0,0,2,0,2
86137,200,21096,27008,62780,0,0,1,0,1
86138,200,21097,26040;26331,62780,0,0,2,0,2
86139,200,21100,26643;26922;30017,62780,0,0,3,0,3
86140,200,21102,26844,62780,0,0,1,0,1
86141,200,21103,27182,62780,0,0,1,0,1
86142,200,21104,26540;27079;30292,62780,0,0,3,0,3
86143,200,21105,26815;27206;29788;30479;32042,62780,1,0,4,0,5
86144,200,21106,26827;27188;30390,62780,0,0,3,0,3
86145,200,21107,26856;26950,62780,0,0,2,0,2
86146,200,21108,26718;26890;29851,62780,0,0,3,0,3
86147,200,21109,26559;26921;30106,62780,0,0,3,0,3
86148,200,21111,26910;27034,62780,0,0,2,0,2
86149,200,21112,26872;27271;30558;31013,62780,0,2,2,0,4
86150,200,21114,26802;27178;30030,62780,0,0,3,0,3
86151,200,21115,26965;27486;30932,62780,0,1,2,0,3
86152,200,21116,27924,62780,0,0,1,0,1
86153,200,21117,26909;27253;30305,62780,0,0,3,0,3
86154,200,21118,27687;30585;30666,62780,0,2,1,0,3
86155,200,21120,27113;27268,62780,0,0,2,0,2
86156,200,21121,27270;27738;30504;30837,62780,0,1,3,0,4
86157,200,21122,27290;27400,62780,0,0,2,0,2
86158,200,21123,27292;27640;29886;30664,62780,0,1,3,0,4
86159,200,21124,26638;27301;30395;30561,62780,0,1,3,0,4
86160,200,21125,27097;27633;31020;31285,62780,0,2,2,0,4
86161,200,21127,27249;27324,62780,0,0,2,0,2
86162,200,21128,27326;27845;30675;30756,62780,0,2,2,0,4
86163,200,21129,27327;27500;29970,62780,0,0,3,0,3
86164,200,21130,27331;27927;31037;31291,62780,0,2,2,0,4
86165,200,21131,27307;27339;30220;30924,62780,0,1,3,0,4
86166,200,21132,27337;27347,62780,0,0,2,0,2
86167,200,21135,27115;27386;31097;31185,62780,0,2,2,0,4
86168,200,21136,27427;30312;30572;30655,62780,0,2,2,0,4
86169,200,21137,27431;27520;30139;30228;30488;30829,62780,0,1,5,0,6
86170,200,21138,27447;29427;29876;30656;31091;31445;31780;31944,62780,2,3,3,0,8
86171,200,21140,27353;27458;30929,62780,0,1,2,0,3
86172,200,21141,27419;27462;29428;31870,62780,1,0,3,0,4
86173,200,21142,27478;27765;30420;30671;31025;31106;31364,62780,0,4,3,0,7
86174,200,21144,27551;27695;30414,62780,0,0,3,0,3
86175,200,21145,27559;27749,62780,0,0,2,0,2
86176,200,21146,26989;27563;29971,62780,0,0,3,0,3
86177,200,21147,27587;27764,62780,0,0,2,0,2
86178,200,21148,27864;27957;30596;30849;31197;31460,62780,0,4,2,0,6
86179,200,21150,27647;27719,62780,0,0,2,0,2
86180,200,21151,27651;27686,62780,0,0,2,0,2
86181,200,21153,23545,63145,0,0,0,1,1
86182,200,21154,23717,63145,0,0,0,1,1
86183,200,21156,23652,63145,0,0,0,1,1
86184,200,21159,24326;24714,63145,0,0,0,2,2
86185,200,21169,25081,63145,0,0,0,1,1
86186,200,21176,25404;25594,63145,0,0,0,2,2
86187,200,21179,26035;26299,63145,0,0,2,0,2
86188,200,21187,25530;25996,63145,0,0,1,1,2
86189,200,21188,25999,63145,0,0,1,0,1
86190,200,21191,26223;26488,63145,0,0,2,0,2
86191,200,21193,26246;26461,63145,0,0,2,0,2
86192,200,21195,26619;26668,63145,0,0,2,0,2
86193,200,21197,26604;26943,63145,0,0,2,0,2
86194,200,21198,26734;26976;29944;30019;30285,63145,0,0,5,0,5
86195,200,21199,26750;26893;30189;30634,63145,0,1,3,0,4
86196,200,21200,26904;27153;29866,63145,0,0,3,0,3
86197,200,21201,26775;26937,63145,0,0,2,0,2
86198,200,21202,26941;27150,63145,0,0,2,0,2
86199,200,21203,26606;27031;30467,63145,0,0,3,0,3
86200,200,21204,27033;27041;29777,63145,0,0,3,0,3
86201,200,21205,26503;27092;30025;30815,63145,0,1,3,0,4
86202,200,21206,27040;27542;29522;29798,63145,0,0,4,0,4
86203,200,21207,27239;27750;30126;30303;30647;31281,63145,0,2,4,0,6
86204,200,21208,27126;27476;30490;31015;31100,63145,0,2,3,0,5
86205,200,21210,27141,63145,0,0,1,0,1
86206,200,21212,27237;27593,63145,0,0,2,0,2
86207,200,21213,27313;27602;31018,63145,0,1,2,0,3
86208,200,21214,27172;27285,63145,0,0,2,0,2
86209,200,21215,27320;27889;31033,63145,0,1,2,0,3
86210,200,21216,27322;30563,63145,0,1,1,0,2
86211,200,21217,27357;27694,63145,0,0,2,0,2
86212,200,21218,27044;27492,63145,0,0,2,0,2
86213,200,21219,27305;27734;30416;30940;31290,63145,0,2,3,0,5
86214,200,21220,27584;27585;30235;31284,63145,0,1,3,0,4
86215,200,21221,27547;27568;30409;31101,63145,0,1,3,0,4
86216,200,21222,27479;27549;30491;30931,63145,0,1,3,0,4
86217,200,21224,27387;27497,63145,0,0,2,0,2
86218,200,21225,27638;27797;30060,63145,0,0,3,0,3
86219,200,21226,27199;29699;30493,63145,0,0,3,0,3
86220,200,21227,27169;27377,63145,0,0,2,0,2
86221,200,21228,27511;30830,63145,0,1,1,0,2
86222,200,21229,27404;27831;30674;31112,63145,0,2,2,0,4
86223,200,21230,27985;30342;30958,63145,0,1,2,0,3
86224,200,21231,27582,63145,0,0,1,0,1
86225,200,21232,27590;30603;30680,63145,0,2,1,0,3
86226,200,21233,27603;30832,63145,0,1,1,0,2
86227,200,21235,27644;27799;30513;30591;30672;31028,63145,0,3,3,0,6
86228,200,21236,28010;30522;30861,63145,0,1,2,0,3
86229,200,21237,27698;30057;31459;31962,63145,1,1,2,0,4
86230,200,21238,27460;27700;31104,63145,0,1,2,0,3
86231,200,21239,27623;27702,63145,0,0,2,0,2
86232,200,21240,27332;27714;30415,63145,0,0,3,0,3
86233,200,21241,27288;27724,63145,0,0,2,0,2
86234,200,21242,27645;27739,63145,0,0,2,0,2
86235,200,21243,27650;27747;30505,63145,0,0,3,0,3
86236,200,21244,27560;27748;29616;30327;30417;30588;30943,63145,0,2,5,0,7
86237,200,21245,27260;27752;30506;30750,63145,0,1,3,0,4
86238,200,21246,27678;27758;30418,63145,0,0,3,0,3
86239,200,21248,23507,63510,0,0,0,1,1
86240,200,21252,24139,63510,0,0,0,1,1
86241,200,21257,24621,63510,0,0,0,1,1
86242,200,21258,24675,63510,0,0,0,1,1
86243,200,21259,24588,63510,0,0,0,1,1
86244,200,21260,24247,63510,0,0,0,1,1
86245,200,21264,24720,63510,0,0,0,1,1
86246,200,21268,25053,63510,0,0,0,1,1
86247,200,21272,25265;25293,63510,0,0,0,2,2
86248,200,21277,26249;26335,63510,0,0,2,0,2
86249,200,21279,26109;26337;29652;30361,63510,0,0,4,0,4
86250,200,21281,26232;26340,63510,0,0,2,0,2
86251,200,21285,26424;26889;29676,63510,0,0,3,0,3
86252,200,21287,26576;26617;29917,63510,0,0,3,0,3
86253,200,21288,26794;30094,63510,0,0,2,0,2
86254,200,21290,26934;27078;30550,63510,0,1,2,0,3
86255,200,21292,27259;30041;30214;30393;30649,63510,0,1,4,0,5
86256,200,21293,27335;30396;30823,63510,0,1,2,0,3
86257,200,21294,27052;27315;29696;29959;30218;30562,63510,0,1,5,0,6
86258,200,21295,27060;27550;30315;30578;30934;31187,63510,0,3,3,0,6
86259,200,21296,26987;27254,63510,0,0,2,0,2
86260,200,21297,27371;27472;30489,63510,0,0,3,0,3
86261,200,21298,27117;27245;30212,63510,0,0,3,0,3
86262,200,21299,27013;27343,63510,0,0,2,0,2
86263,200,21300,27158;27448;29431;30402;30573;30584;30665,63510,0,3,4,0,7
86264,200,21301,27680;31287,63510,0,1,1,0,2
86265,200,21303,26970;27468;30735;30923;30930,63510,0,3,2,0,5
86266,200,21304,27382;29613,63510,0,0,2,0,2
86267,200,21305,27220;27621;30834,63510,0,1,2,0,3
86268,200,21306,27424;27653;29706;31190,63510,0,1,3,0,4
86269,200,21307,27452;28003;30247,63510,0,0,3,0,3
86270,200,21308,27261;27470;30394,63510,0,0,3,0,3
86271,200,21309,27176;27398;29967,63510,0,0,3,0,3
86272,200,21310,27725;27772;29888,63510,0,0,3,0,3
86273,200,21311,27466,63510,0,0,1,0,1
86274,200,21312,27495;27523,63510,0,0,2,0,2
86275,200,21313,28022;30160;30686;30863,63510,0,2,2,0,4
86276,200,21314,27591;27667,63510,0,0,2,0,2
86277,200,21315,27297;27594;30317,63510,0,0,3,0,3
86278,200,21316,27679;27895;29711;30338;30599,63510,0,1,4,0,5
86279,200,21317,27607;27838,63510,0,0,2,0,2
86280,200,21318,27464;27696,63510,0,0,2,0,2
86281,200,21319,27671;27867;30597;30952;31887,63510,1,2,2,0,5
86282,200,21320,27953;28061;30864;31044,63510,0,2,2,0,4
86283,200,21321,27699;27978,63510,0,0,2,0,2
86284,200,21322,27641;27762;30419;30508;30670;30945,63510,0,2,4,0,6
86285,200,21323,27619;27721,63510,0,0,2,0,2
86286,200,21324,27839,63510,0,0,1,0,1
86287,200,21325,27794;27841;30511,63510,0,0,3,0,3
86288,200,21326,27842;28134;31046;31542,63510,0,2,2,0,4
86289,200,21327,27812;30754;30842;31029,63510,0,3,1,0,4
86290,200,21328,27791;27824;30752;31027,63510,0,2,2,0,4
86291,200,21329,27392;27832;30242;31194,63510,0,1,3,0,4
86292,200,21330,27795;27840;30332;30947;31534,63510,0,2,3,0,5
86293,200,21333,24195,63875,0,0,0,1,1
86294,200,21337,24233,63875,0,0,0,1,1
86295,200,21339,24259,63875,0,0,0,1,1
86296,200,21346,24838,63875,0,0,0,1,1
86297,200,21347,24738,63875,0,0,0,1,1
86298,200,21350,24959,63875,0,0,0,1,1
86299,200,21362,26029;26425,63875,0,0,2,0,2
86300,200,21364,26168;26623;29753,63875,0,0,3,0,3
86301,200,21365,26333;26899;30016,63875,0,0,3,0,3
86302,200,21366,26445;26506,63875,0,0,2,0,2
86303,200,21368,26265;26724;29759,63875,0,0,3,0,3
86304,200,21369,26642;26954;29772,63875,0,0,3,0,3
86305,200,21370,26703,63875,0,0,1,0,1
86306,200,21373,27200;30478,63875,0,0,2,0,2
86307,200,21374,26733;26786;29932,63875,0,0,3,0,3
86308,200,21376,26960;26980;29773;30283;30813,63875,0,1,4,0,5
86309,200,21381,27089;27248;30127;30480,63875,0,0,4,0,4
86310,200,21382,27133;27161;30642;30818,63875,0,2,2,0,4
86311,200,21383,27146;27518;29600;29948,63875,0,0,4,0,4
86312,200,21384,27205;27275,63875,0,0,2,0,2
86313,200,21385,27094;27216;29954;30036;30125;30301,63875,0,0,6,0,6
86314,200,21386,27207;27333;29793;30133;30565;30651,63875,0,2,4,0,6
86315,200,21387,27491;27746;30326;30669;30942,63875,0,2,3,0,5
86316,200,21389,27401;27429;30047;31098,63875,0,1,3,0,4
86317,200,21390,27558,63875,0,0,1,0,1
86318,200,21391,27937,63875,0,0,1,0,1
86319,200,21392,26972;27683;30748,63875,0,1,2,0,3
86320,200,21393,27222;27455,63875,0,0,2,0,2
86321,200,21394,27344;27636;30935;31361,63875,0,2,2,0,4
86322,200,21395,27445;27803;30592,63875,0,1,2,0,3
86323,200,21396,27539;27608;30833;31019,63875,0,2,2,0,4
86324,200,21397,27104;27569;29324;30498;30662,63875,0,1,4,0,5
86325,200,21398,27504;27901;29978;30601,63875,0,1,3,0,4
86326,200,21399,27413;30226,63875,0,0,2,0,2
86327,200,21400,27509;27742;30494,63875,0,0,3,0,3
86328,200,21401,27533;27689;31191,63875,0,1,2,0,3
86329,200,21402,27534;30408,63875,0,0,2,0,2
86330,200,21403,27515;28006;30248;30521,63875,0,0,4,0,4
86331,200,21404,27981;30159;30764;31039;31886,63875,1,2,2,0,5
86332,200,21407,27643;28002;30606,63875,0,1,2,0,3
86333,200,21409,27352;27541;30933,63875,0,1,2,0,3
86334,200,21410,27692;27963;30681,63875,0,1,2,0,3
86335,200,21411,27710;27711;30058;31105;31289,63875,0,2,3,0,5
86336,200,21412,27451;27665;30153;30322;30412;30746;31803;31963,63875,2,1,5,0,8
86337,200,21413,28098;30772;31208,63875,0,2,1,0,3
86338,200,21414,27836;28072;30250;31125;31207,63875,0,2,3,0,5
86339,200,21415,27814;31365,63875,0,1,1,0,2
86340,200,21416,27846;28256,63875,0,0,2,0,2
86341,200,21417,27420;27798;30422;30948;31535,63875,0,2,3,0,5
86342,200,21418,27848;27948;30595,63875,0,1,2,0,3
86343,200,21419,28199;28476;30781;31220,63875,0,2,2,0,4
86344,200,21420,27882;28249;31807,63875,1,0,2,0,3
86345,200,21421,27899;28232;31222,63875,0,1,2,0,3
86346,200,21422,27884;27908,63875,0,0,2,0,2
86347,200,21423,27571;27918;30761,63875,0,1,2,0,3
86348,200,21424,27930;28040,63875,0,0,2,0,2
86349,200,21425,27936;28260;30350;31138,63875,0,1,3,0,4
86350,200,21426,27938;28052;30689;31043;31124;31370,63875,0,4,2,0,6
86351,200,21427,27955;28400;30172;30891,63875,0,1,3,0,4
86352,200,21428,28058;28105;30527;31210,63875,0,1,3,0,4
86353,200,21429,27961;28188;30877,63875,0,1,2,0,3
86354,200,21431,24238,64240,0,0,0,1,1
86355,200,21433,24312,64240,0,0,0,1,1
86356,200,21436,24965,64240,0,0,0,1,1
86357,200,21437,24729,64240,0,0,0,1,1
86358,200,21445,25323,64240,0,0,0,1,1
86359,200,21453,26761;27125;29864,64240,0,0,3,0,3
86360,200,21454,26788;26789;30007;30371,64240,0,0,4,0,4
86361,200,21455,26796;27174;30388;30475,64240,0,0,4,0,4
86362,200,21456,26804;26848,64240,0,0,2,0,2
86363,200,21459,26471;26949,64240,0,0,2,0,2
86364,200,21460,27069;27407;30049;30827,64240,0,1,3,0,4
86365,200,21461,27131;27298;30474,64240,0,0,3,0,3
86366,200,21462,27100;27372;29964;30485;30567,64240,0,1,4,0,5
86367,200,21463,27163;27709;30324;31192;31362,64240,0,2,3,0,5
86368,200,21464,27219;27611;30319,64240,0,0,3,0,3
86369,200,21465,27053;27235,64240,0,0,2,0,2
86370,200,21466,26835;27351;29873;30824,64240,0,1,3,0,4
86371,200,21468,27488;27622,64240,0,0,2,0,2
86372,200,21470,27501;27760;30328;30589,64240,0,1,3,0,4
86373,200,21471,27529;27970,64240,0,0,2,0,2
86374,200,21472,27544;27613;30502,64240,0,0,3,0,3
86375,200,21473,27557;27810;30514;31193,64240,0,1,3,0,4
86376,200,21474,28023;30435;31295;31367,64240,0,2,2,0,4
86377,200,21475,27598;27851;30676,64240,0,1,2,0,3
86378,200,21476,27441;27604;30580;30744,64240,0,2,2,0,4
86379,200,21478,27379;27483;30046;30926,64240,0,1,3,0,4
86380,200,21479,27703;28348;30977;31391,64240,0,2,2,0,4
86381,200,21481,27243;27745;31363,64240,0,1,2,0,3
86382,200,21482,28191;30696;30779;31052;31132,64240,0,4,1,0,5
86383,200,21483,27767;28317;31225;31310;31634,64240,1,2,2,0,5
86384,200,21484,27868;30851,64240,0,1,1,0,2
86385,200,21485,27399;27979;30245;30432;30763;30859;31120,64240,0,3,4,0,7
86386,200,21487,27505;27796;30512,64240,0,0,3,0,3
86387,200,21488,27811;27976;31204,64240,0,1,2,0,3
86388,200,21489,27863;30426;31113,64240,0,1,2,0,3
86389,200,21491,27865;30757;31032,64240,0,2,1,0,3
86390,200,21492,27891;28110;30965;31211,64240,0,2,2,0,4
86391,200,21493,27510;27919;30855;31035,64240,0,2,2,0,4
86392,200,21494,27823;27922;30602;30856;31036,64240,0,3,2,0,5
86393,200,21495,27363;27931;29892;30679,64240,0,1,3,0,4
86394,200,21496,27753;28212;30532;30697;31221,64240,0,2,3,0,5
86395,200,21497,27681;27941;31118;31202,64240,0,2,2,0,4
86396,200,21498,27959;28215;30972,64240,0,1,2,0,3
86397,200,21499,28112;28291;31223,64240,0,1,2,0,3
86398,200,21500,27900;29433;31271,64240,0,1,2,0,3
86399,200,21501,27988;28333;30535;30787;31143;31472,64240,0,3,3,0,6
86400,200,21502,28100;28220;30440;31546,64240,0,1,3,0,4
86401,200,21503,27736;28164;30611;31051;31376,64240,0,3,2,0,5
86402,200,21504,28085;28318;31142,64240,0,1,2,0,3
86403,200,21505,28044;28178;30438;30777;31543,64240,0,2,3,0,5
86404,200,21506,27672;27991;30684;31205,64240,0,2,2,0,4
86405,200,21507,24057;24431,64605,0,0,0,2,2
86406,200,21509,23731,64605,0,0,0,1,1
86407,200,21511,24382,64605,0,0,0,1,1
86408,200,21512,24252,64605,0,0,0,1,1
86409,200,21520,24771,64605,0,0,0,1,1
86410,200,21524,24724,64605,0,0,0,1,1
86411,200,21526,25032;25144,64605,0,0,0,2,2
86412,200,21533,26244;26253;29368,64605,0,0,3,0,3
86413,200,21535,26024;26359,64605,0,0,2,0,2
86414,200,21539,26685,64605,0,0,1,0,1
86415,200,21540,26654,64605,0,0,1,0,1
86416,200,21541,26678;26936,64605,0,0,2,0,2
86417,200,21542,26041;26599,64605,0,0,2,0,2
86418,200,21544,26838;26925,64605,0,0,2,0,2
86419,200,21545,26865;27106;30295;30551;30817,64605,0,2,3,0,5
86420,200,21546,26533,64605,0,0,1,0,1
86421,200,21549,26866;26982;30021;30286;30548,64605,0,1,4,0,5
86422,200,21551,27144;30384;30731,64605,0,1,2,0,3
86423,200,21553,27166;27247;30029;30205,64605,0,0,4,0,4
86424,200,21554,27624;27871;30243;30953,64605,0,1,3,0,4
86425,200,21557,27266;27781;30840;31629,64605,1,1,2,0,4
86426,200,21558,27277;27312;30132;31095,64605,0,1,3,0,4
86427,200,21559,27283;27691;31023,64605,0,1,2,0,3
86428,200,21560,27321;27522;30143;31283,64605,0,1,3,0,4
86429,200,21563,27046;27356;30135,64605,0,0,3,0,3
86430,200,21564,27077;27341,64605,0,0,2,0,2
86431,200,21565,27304;27412;30138;30225;31186,64605,0,1,4,0,5
86432,200,21567,27308;27473,64605,0,0,2,0,2
86433,200,21568,27197;27474;30405;30659,64605,0,1,3,0,4
86434,200,21570,27634;27996;30766,64605,0,1,2,0,3
86435,200,21572,27674;27929;31536,64605,0,1,2,0,3
86436,200,21574,27579;27685;29612;30499,64605,0,0,4,0,4
86437,200,21575,27390;27469;30404;30575,64605,0,1,3,0,4
86438,200,21576,27743;28095;30868,64605,0,1,2,0,3
86439,200,21578,27566;27792;30331;30510;30841,64605,0,1,4,0,5
86440,200,21579,27800;30753,64605,0,1,1,0,2
86441,200,21580,27576;27967,64605,0,0,2,0,2
86442,200,21581,27807;28007,64605,0,0,2,0,2
86443,200,21582,28147;31130;31374,64605,0,2,1,0,3
86444,200,21583,27909;28057;30431;31200,64605,0,1,3,0,4
86445,200,21584,27910;28211;31383,64605,0,1,2,0,3
86446,200,21585,27856;28114,64605,0,0,2,0,2
86447,200,21586,27925;30956;31116,64605,0,2,1,0,3
86448,200,21587,27950;28169;31377,64605,0,1,2,0,3
86449,200,21588,27990;28070;30690,64605,0,1,2,0,3
86450,200,21589,27894;28013;30343,64605,0,0,3,0,3
86451,200,21590,28018;28240;31385;31469,64605,0,2,2,0,4
86452,200,21591,28384,64605,0,0,1,0,1
86453,200,21592,28049;28557;31240;31643,64605,1,1,2,0,4
86454,200,21593,28062;28252;30703;31705,64605,1,1,2,0,4
86455,200,21594,28083;28117;31804,64605,1,0,2,0,3
86456,200,21595,27852;28121;30608;31465,64605,0,2,2,0,4
86457,200,21596,28131;28305;31224,64605,0,1,2,0,3
86458,200,21597,28142;28422;30619;30893;31062;31399,64605,0,4,2,0,6
86459,200,21598,28154;28323;30705;31966,64605,1,1,2,0,4
86460,200,21599,28171;28452,64605,0,0,2,0,2
86461,200,21600,23975,64970,0,0,0,1,1
86462,200,21601,24339,64970,0,0,0,1,1
86463,200,21611,24775;24923,64970,0,0,0,2,2
86464,200,21613,25399;25617,64970,0,0,0,2,2
86465,200,21618,25633,64970,0,0,0,1,1
86466,200,21619,25653,64970,0,0,0,1,1
86467,200,21620,25730;26283,64970,0,0,1,1,2
86468,200,21621,25747;25752,64970,0,0,0,2,2
86469,200,21622,25270;25338,64970,0,0,0,2,2
86470,200,21623,25808,64970,0,0,0,1,1
86471,200,21626,25983,64970,0,0,1,0,1
86472,200,21631,26280;26697;30730,64970,0,1,2,0,3
86473,200,21632,26225;26338;29728,64970,0,0,3,0,3
86474,200,21634,26849;27411;30571,64970,0,1,2,0,3
86475,200,21636,26924;27064,64970,0,0,2,0,2
86476,200,21638,27005;27475;29969;30142,64970,0,0,4,0,4
86477,200,21639,27014;27708;30937,64970,0,1,2,0,3
86478,200,21640,26713;27037;30196,64970,0,0,3,0,3
86479,200,21641,27018;27086;30472,64970,0,0,3,0,3
86480,200,21643,27159;27265;30204,64970,0,0,3,0,3
86481,200,21644,26986;27362,64970,0,0,2,0,2
86482,200,21645,27085;27369;30566;30826;31096,64970,0,3,2,0,5
86483,200,21646,27610;30236;30318;30501,64970,0,0,4,0,4
86484,200,21647,27828;27968;30424;31111,64970,0,1,3,0,4
86485,200,21648,27489;27903;30853,64970,0,1,2,0,3
86486,200,21649,27506;27943;31038,64970,0,1,2,0,3
86487,200,21650,27966;28073;31463;31538,64970,0,2,2,0,4
86488,200,21652,27456;27668,64970,0,0,2,0,2
86489,200,21653,27323;27677;30747,64970,0,1,2,0,3
86490,200,21655,27666;27744;30668;30941,64970,0,2,2,0,4
86491,200,21656,27282;27813;30593;30843;30949;31030,64970,0,4,2,0,6
86492,200,21657,28186;31219;31381,64970,0,2,1,0,3
86493,200,21658,27731;28380;31555,64970,0,1,2,0,3
86494,200,21659,27757;28124;31045,64970,0,1,2,0,3
86495,200,21660,27769;28194;30780;31133,64970,0,2,2,0,4
86496,200,21661,27342;28205;31382,64970,0,1,2,0,3
86497,200,21662,27783;28222;30699,64970,0,1,2,0,3
86498,200,21663,27782;27818;30241;30844;32054,64970,1,1,3,0,5
86499,200,21664,27962;27992;30433;30520;31703,64970,1,0,4,0,5
86500,200,21665,27830;27932;30594;31031,64970,0,2,2,0,4
86501,200,21666,27843;28032;30769,64970,0,1,2,0,3
86502,200,21667,27822;27886;30337;30677,64970,0,1,3,0,4
86503,200,21668,27896;28297;30600;30685;31461,64970,0,3,2,0,5
86504,200,21669,27578;27965,64970,0,0,2,0,2
86505,200,21670,27945;27994;30860;30959;31121,64970,0,3,2,0,5
86506,200,21671,28041;31296;31369,64970,0,2,1,0,3
86507,200,21673,28127;29983;31299,64970,0,1,2,0,3
86508,200,21674,28055;30770,64970,0,1,1,0,2
86509,200,21675,27849;28060,64970,0,0,2,0,2
86510,200,21676,27770;28063;30064;30524;30865;30962,64970,0,2,4,0,6
86511,200,21677,28254;28309;30168,64970,0,0,3,0,3
86512,200,21678,27801;28111;30164;30870;31212;31541;31890,64970,1,3,3,0,7
86513,200,21679,28150;28182;30774,64970,0,1,2,0,3
86514,200,21680,28108;28162;30529;30874;30968;31302;31632,64970,1,3,3,0,7
86515,200,21681,28035;28166;30530;30775;31131,64970,0,2,3,0,5
86516,200,21682,28193;28209;31468;31545,64970,0,2,2,0,4
86517,200,21683,28201;28444;30173;31639;31898,64970,2,0,3,0,5
86518,200,21684,28206,64970,0,0,1,0,1
86519,200,21685,28228;28415;30355;31061;31318;31398,64970,0,3,3,0,6
86520,200,21686,27974;28237;30784,64970,0,1,2,0,3
86521,200,21687,28451;30789;31559,64970,0,2,1,0,3
86522,200,21688,27521;28101;31209;31372,64970,0,2,2,0,4
86523,200,21689,28247;28266;30704,64970,0,1,2,0,3
86524,200,21690,24034,65335,0,0,0,1,1
86525,200,21691,24342;24657,65335,0,0,0,2,2
86526,200,21692,24384,65335,0,0,0,1,1
86527,200,21693,24522,65335,0,0,0,1,1
86528,200,21696,25082,65335,0,0,0,1,1
86529,200,21701,25368,65335,0,0,0,1,1
86530,200,21702,25518;25811,65335,0,0,0,2,2
86531,200,21709,25868;25872,65335,0,0,0,2,2
86532,200,21712,26309;26819;30276,65335,0,0,3,0,3
86533,200,21716,26702,65335,0,0,1,0,1
86534,200,21719,26637;29839;30002,65335,0,0,3,0,3
86535,200,21720,26731;26814;29926,65335,0,0,3,0,3
86536,200,21722,26968;27368;29963;30825,65335,0,1,3,0,4
86537,200,21723,27017;27101;30201;30294;30816;32053,65335,1,1,4,0,6
86538,200,21724,27091;27136;30297;30640,65335,0,1,3,0,4
86539,200,21725,27370,65335,0,0,1,0,1
86540,200,21726,27201;31094,65335,0,1,1,0,2
86541,200,21727,27706;27726;30938,65335,0,1,2,0,3
86542,200,21728,27303;27402;30048;30569;30927,65335,0,2,3,0,5
86543,200,21729,27218;27528;29880;30144;31798,65335,1,0,4,0,5
86544,200,21730,27870;27935;30759,65335,0,1,2,0,3
86545,200,21731,27376;27768;30751;30839;31026;31108,65335,0,4,2,0,6
86546,200,21732,27545;27635,65335,0,0,2,0,2
86547,200,21733,27577;28043;30161;30688,65335,0,1,3,0,4
86548,200,21735,27349;27601;30221;30652,65335,0,1,3,0,4
86549,200,21736,27187;27874;30427;31198,65335,0,1,3,0,4
86550,200,21737,28196;28245,65335,0,0,2,0,2
86551,200,21738,27878;28273;30351;30883,65335,0,1,3,0,4
86552,200,21739,27928;28065;31297;31371,65335,0,2,2,0,4
86553,200,21740,27939;27960;30858;31117;31462,65335,0,3,2,0,5
86554,200,21741,27897;27969;30429;30678,65335,0,1,3,0,4
86555,200,21742,27756;27971;31203;31537,65335,0,2,2,0,4
86556,200,21743,28300;28314;30886;30975;31056;31390;31471,65335,0,5,2,0,7
86557,200,21744,28343,65335,0,0,1,0,1
86558,200,21745,28572;30898;31066;31972,65335,1,2,1,0,4
86559,200,21746,28046;28053,65335,0,0,2,0,2
86560,200,21747,28042;28168;30969,65335,0,1,2,0,3
86561,200,21748,28064;28528;31815,65335,1,0,2,0,3
86562,200,21749,27834;28177;30876,65335,0,1,2,0,3
86563,200,21750,28107;28270;30882;31706,65335,1,1,2,0,4
86564,200,21751,28113;28192;30531,65335,0,0,3,0,3
86565,200,21752,28207;28387;31314;31810,65335,1,1,2,0,4
86566,200,21753,28145;28490;31236;31641,65335,1,1,2,0,4
86567,200,21754,28067;28183,65335,0,0,2,0,2
86568,200,21755,27774;28185;31380;31544,65335,0,2,2,0,4
86569,200,21756,28005;28213,65335,0,0,2,0,2
86570,200,21757,28230;30700,65335,0,1,1,0,2
86571,200,21758,28408;28614;31475,65335,0,1,2,0,3
86572,200,21759,28499;28627;31647,65335,1,0,2,0,3
86573,200,21760,27980;28263,65335,0,0,2,0,2
86574,200,21761,27771;28353;31145,65335,0,1,2,0,3
86575,200,21762,27675;28356;30615;31393,65335,0,2,2,0,4
86576,200,21763,28342;28524;30443,65335,0,0,3,0,3
86577,200,21765,24349,65700,0,0,0,1,1
86578,200,21766,24371;24464,65700,0,0,0,2,2
86579,200,21767,24237,65700,0,0,0,1,1
86580,200,21768,24435;24444,65700,0,0,0,2,2
86581,200,21772,24263,65700,0,0,0,1,1
86582,200,21775,24531;24910,65700,0,0,0,2,2
86583,200,21776,24581,65700,0,0,0,1,1
86584,200,21778,24837;25052,65700,0,0,0,2,2
86585,200,21779,25070,65700,0,0,0,1,1
86586,200,21787,25938,65700,0,0,1,0,1
86587,200,21788,26219;26380,65700,0,0,2,0,2
86588,200,21790,26150;26679;30366,65700,0,0,3,0,3
86589,200,21791,26756,65700,0,0,1,0,1
86590,200,21793,27240;30648,65700,0,1,1,0,2
86591,200,21795,27019;27508,65700,0,0,2,0,2
86592,200,21798,27986;30604,65700,0,1,1,0,2
86593,200,21799,27857;30950,65700,0,1,1,0,2
86594,200,21801,27581;28267;30613;31547,65700,0,2,2,0,4
86595,200,21802,27531;27617,65700,0,0,2,0,2
86596,200,21803,27278;27657,65700,0,0,2,0,2
86597,200,21804,27663;27684;31022;31103,65700,0,2,2,0,4
86598,200,21805,27143;27688;30237;30323;30413;31701,65700,1,0,5,0,6
86599,200,21806,27543;28116;31464,65700,0,1,2,0,3
86600,200,21808,27723;30325;30836,65700,0,1,2,0,3
86601,200,21809,28056;28141;30771,65700,0,1,2,0,3
86602,200,21810,27775;27860;30951,65700,0,1,2,0,3
86603,200,21811,27776;27920;30339;30517;30762;30955;31702,65700,1,2,4,0,7
86604,200,21812,27977;28275;30352;31305;31548,65700,0,2,3,0,5
86605,200,21813,27983;28512;31563,65700,0,1,2,0,3
86606,200,21814,27858;27987;30848,65700,0,1,2,0,3
86607,200,21815,27942;27995;30765,65700,0,1,2,0,3
86608,200,21816,28542;30897,65700,0,1,1,0,2
86609,200,21817,28089;28363;30354,65700,0,0,3,0,3
86610,200,21818,28075;28091;30525;30691,65700,0,1,3,0,4
86611,200,21819,28017,65700,0,0,1,0,1
86612,200,21820,28118;28307;30258;31553;32055,65700,1,1,3,0,5
86613,200,21821,28126;28250;31054;31137,65700,0,2,2,0,4
86614,200,21822,28076;28136;30528;31047,65700,0,1,3,0,4
86615,200,21823,27806;28140;30773;31048,65700,0,2,2,0,4
86616,200,21824,28156;28218;31216,65700,0,1,2,0,3
86617,200,21825,28217;30698;30783;30878;31135;31704,65700,1,4,1,0,6
86618,200,21826,28685;28702;30542,65700,0,0,3,0,3
86619,200,21827,28226;28540;31053;31136,65700,0,2,2,0,4
86620,200,21828,28048;28271;31139;31387,65700,0,2,2,0,4
86621,200,21829,28071;28280;31388,65700,0,1,2,0,3
86622,200,21830,28310;28438;30538,65700,0,0,3,0,3
86623,200,21831,28195;28734;30716,65700,0,1,2,0,3
86624,200,21833,28403;28519;30623;30710;30791;30982,65700,0,4,2,0,6
86625,200,21834,28243;28428;31897,65700,1,0,2,0,3
86626,200,21835,28453;28509;30441;31562;31712,65700,1,1,3,0,5
86627,200,21836,28335;28368;30706;31227;31396;31554;31967,65700,1,4,2,0,7
86628,200,21837,24478,66065,0,0,0,1,1
86629,200,21838,24772,66065,0,0,0,1,1
86630,200,21839,24976,66065,0,0,0,1,1
86631,200,21840,24899;24934,66065,0,0,0,2,2
86632,200,21845,25317,66065,0,0,0,1,1
86633,200,21859,25970;26008,66065,0,0,2,0,2
86634,200,21861,26098;26386;29293,66065,0,0,3,0,3
86635,200,21870,26791;26913,66065,0,0,2,0,2
86636,200,21872,27004;27552;30579,66065,0,1,2,0,3
86637,200,21873,26580;26850;30373,66065,0,0,3,0,3
86638,200,21874,27112;27463;30403;30658,66065,0,1,3,0,4
86639,200,21875,26961;27137,66065,0,0,2,0,2
86640,200,21876,27155;30641,66065,0,1,1,0,2
86641,200,21878,27433;27446;30401,66065,0,0,3,0,3
86642,200,21879,27905;30244;30430;31199,66065,0,1,3,0,4
86643,200,21881,26959;27309;30131,66065,0,0,3,0,3
86644,200,21884,27228;27385,66065,0,0,2,0,2
86645,200,21885,27236;27348;30310,66065,0,0,3,0,3
86646,200,21886,27264;27405;30224;30311;30570,66065,0,1,4,0,5
86647,200,21887,26942;27425,66065,0,0,2,0,2
86648,200,21888,27850;27853;29805;31530;31796;32043,66065,2,1,3,0,6
86649,200,21889,27951;28129,66065,0,0,2,0,2
86650,200,21890,27135;27177;29685,66065,0,0,3,0,3
86651,200,21891,27784;27923;30857;31201,66065,0,2,2,0,4
86652,200,21892,27311;27649;30321,66065,0,0,3,0,3
86653,200,21893,27662;28026,66065,0,0,2,0,2
86654,200,21894,27394;27450;30657,66065,0,1,2,0,3
86655,200,21895,27548;27673,66065,0,0,2,0,2
86656,200,21896,27403;27697;30238;30835,66065,0,1,3,0,4
86657,200,21897,27717;27998;30434;31040;32061,66065,1,1,3,0,5
86658,200,21898,27564;27773;30421;30946,66065,0,1,3,0,4
86659,200,21899,27422;27766;31107,66065,0,1,2,0,3
86660,200,21900,27804;27949;29893;30518;31119;31292;31630,66065,1,2,4,0,7
86661,200,21901,27384;27826;30673;30846;31110,66065,0,3,2,0,5
86662,200,21903,27893,66065,0,0,1,0,1
86663,200,21905,27972;28001,66065,0,0,2,0,2
86664,200,21906,27381;27973;30683;30957,66065,0,2,2,0,4
86665,200,21907,28123;28322;30694;30871;31373,66065,0,3,2,0,5
86666,200,21908,28009,66065,0,0,1,0,1
86667,200,21909,27660;28019;30862,66065,0,1,2,0,3
86668,200,21910,28045;28189;30778;30971,66065,0,2,2,0,4
86669,200,21911,27620;28030;30345;31123,66065,0,1,3,0,4
86670,200,21912,28094;28152;31126,66065,0,1,2,0,3
86671,200,21913,28779;28792;31249;31911,66065,1,1,2,0,4
86672,200,21914,28068;28139;30165;30695;31128,66065,0,2,3,0,5
86673,200,21915,28287;28579;30534;31055;31306,66065,0,2,3,0,5
86674,200,21916,27954;28304;30785,66065,0,1,2,0,3
86675,200,21917,28296;28320;30976,66065,0,1,2,0,3
86676,200,21918,28775;30718;31163;31572,66065,0,3,1,0,4
86677,200,21919,28337;28748;30717;31824,66065,1,1,2,0,4
86678,200,21920,28039;28347,66065,0,0,2,0,2
86679,200,21921,28358;31058;31394,66065,0,2,1,0,3
86680,200,21922,28365;28480;30622;31064;31403,66065,0,3,2,0,5
86681,200,21923,28120;28383;31146,66065,0,1,2,0,3
86682,200,21924,28394;28530;31316,66065,0,1,2,0,3
86683,200,21925,28399;28412;30978;31474,66065,0,2,2,0,4
86684,200,21926,28406;28471;31230;31557,66065,0,2,2,0,4
86685,200,21927,28376;28430;31638,66065,1,0,2,0,3
86686,200,21929,28306;28445,66065,0,0,2,0,2
86687,200,21930,28455;28848;31662,66065,1,0,2,0,3
86688,200,21931,28481;28746;31726,66065,1,0,2,0,3
86689,200,21932,28282;28459;30974;31141;31550,66065,0,3,2,0,5
86690,200,21933,28173;28493;31642,66065,1,0,2,0,3
86691,200,21934,28225;28407;31812,66065,1,0,2,0,3
86692,200,21935,28526;28583;30625;31644;31716,66065,2,1,2,0,5
86693,200,21936,28633;28674;30990,66065,0,1,2,0,3
86694,200,21937,28352;28543;30357,66065,0,0,3,0,3
86695,200,21939,24631;24681,66430,0,0,0,2,2
86696,200,21940,24251,66430,0,0,0,1,1
86697,200,21942,24815;24936,66430,0,0,0,2,2
86698,200,21944,24696,66430,0,0,0,1,1
86699,200,21948,25492,66430,0,0,0,1,1
86700,200,21950,25588,66430,0,0,0,1,1
86701,200,21953,25595,66430,0,0,0,1,1
86702,200,21954,25781;25841,66430,0,0,0,2,2
86703,200,21960,26099,66430,0,0,1,0,1
86704,200,21961,26045,66430,0,0,1,0,1
86705,200,21964,26123,66430,0,0,1,0,1
86706,200,21966,26644,66430,0,0,1,0,1
86707,200,21971,26482;26783;31093,66430,0,1,2,0,3
86708,200,21973,26908;27442,66430,0,0,2,0,2
86709,200,21975,27080,66430,0,0,1,0,1
86710,200,21976,27119;27167;30299;30386;30555,66430,0,1,4,0,5
86711,200,21977,27121;27664,66430,0,0,2,0,2
86712,200,21979,26944;27148;30552,66430,0,1,2,0,3
86713,200,21980,27300;27457;30928,66430,0,1,2,0,3
86714,200,21981,27170;27346,66430,0,0,2,0,2
86715,200,21982,27408;27761;30838;30944;31628,66430,1,2,2,0,5
86716,200,21983,27471;27892;30760;31034;31366,66430,0,3,2,0,5
86717,200,21984,27336;27517;30314;30406;31458,66430,0,1,4,0,5
86718,200,21986,27540;27993;31293,66430,0,1,2,0,3
86719,200,21987,27561;27715;29887;30587,66430,0,1,3,0,4
86720,200,21988,27536;27600,66430,0,0,2,0,2
86721,200,21989,27477;27862;30425,66430,0,0,3,0,3
86722,200,21990,27461,66430,0,0,1,0,1
86723,200,21991,27530;27881;31114,66430,0,1,2,0,3
86724,200,21992,28138;28259;31214;31805,66430,1,1,2,0,4
86725,200,21994,27788;27964;29979;30519;30682;31889,66430,1,1,4,0,6
86726,200,21995,28051;28137;30609,66430,0,1,2,0,3
86727,200,21996,28074,66430,0,0,1,0,1
86728,200,21997,28080,66430,0,0,1,0,1
86729,200,21999,28104;28214;30692;30964,66430,0,2,2,0,4
86730,200,22000,28135;28233;30872;31127,66430,0,2,2,0,4
86731,200,22002,27946;28379;31312,66430,0,1,2,0,3
86732,200,22003,27917;28143;31129;31466,66430,0,2,2,0,4
86733,200,22004,28000;30605;31041;31631,66430,1,2,1,0,4
86734,200,22005,28200;28642;31329,66430,0,1,2,0,3
86735,200,22006,28227;28299;30349;30879,66430,0,1,3,0,4
86736,200,22007,28302,66430,0,0,1,0,1
86737,200,22008,28047;28308;31308,66430,0,1,2,0,3
86738,200,22009,28290;28332;30884;31633,66430,1,1,2,0,4
86739,200,22011,28395;28440;30620;31147;31233,66430,0,3,2,0,5
86740,200,22012,28436;28659;31159,66430,0,1,2,0,3
86741,200,22013,28449;28924;31917,66430,1,0,2,0,3
86742,200,22015,28483;28532;31151,66430,0,1,2,0,3
86743,200,22016,28500;28804;31251;31733,66430,1,1,2,0,4
86744,200,22017,28940;30805;30908,66430,0,2,1,0,3
86745,200,22018,28556;28790;31336;31573,66430,0,2,2,0,4
86746,200,22019,28054;28578;31067,66430,0,1,2,0,3
86747,200,22021,28602;28766;31162,66430,0,1,2,0,3
86748,200,22022,28630;28719;30902;31724,66430,1,1,2,0,4
86749,200,22023,28693;28745;30359;31725;31964,66430,2,0,3,0,5
86750,200,22024,28615;28657;31721,66430,1,0,2,0,3
86751,200,22025,28668;28680;30901,66430,0,1,2,0,3
86752,200,22026,24605,66795,0,0,0,1,1
86753,200,22027,24311,66795,0,0,0,1,1
86754,200,22028,24726,66795,0,0,0,1,1
86755,200,22032,25301,66795,0,0,0,1,1
86756,200,22033,25417,66795,0,0,0,1,1
86757,200,22034,25207;25456,66795,0,0,0,2,2
86758,200,22036,25928,66795,0,0,1,0,1
86759,200,22038,26037,66795,0,0,1,0,1
86760,200,22041,26194;26732,66795,0,0,2,0,2
86761,200,22044,26301;26574,66795,0,0,2,0,2
86762,200,22047,26226;26917;29312;29766;30547,66795,0,1,4,0,5
86763,200,22059,27026;27181;30819,66795,0,1,2,0,3
86764,200,22061,26793;27212;29692;30645;30921;31358,66795,0,3,3,0,6
86765,200,22062,26582,66795,0,0,1,0,1
86766,200,22063,27246;27395,66795,0,0,2,0,2
86767,200,22065,27157,66795,0,0,1,0,1
86768,200,22066,27443;27639;29705,66795,0,0,3,0,3
86769,200,22068,27367;27397,66795,0,0,2,0,2
86770,200,22069,27190;27263;30476;30556,66795,0,1,3,0,4
86771,200,22070,27194,66795,0,0,1,0,1
86772,200,22071,27589;27637;30148,66795,0,0,3,0,3
86773,200,22072,27484;27904,66795,0,0,2,0,2
86774,200,22074,27567;28027;30961;31122,66795,0,2,2,0,4
86775,200,22075,27642;27819;29891;30156,66795,0,0,4,0,4
86776,200,22076,27632;30745,66795,0,1,1,0,2
86777,200,22079,28016;30768;30960,66795,0,2,1,0,3
86778,200,22080,28301;28560;30712;31407,66795,0,2,2,0,4
86779,200,22081,28456;31321;31709,66795,1,1,1,0,3
86780,200,22082,27789;28448;31320;31813,66795,1,1,2,0,4
86781,200,22083,27859;28219;30253,66795,0,0,3,0,3
86782,200,22084,28014;28157;30610;31217;31300,66795,0,3,2,0,5
86783,200,22085,28241;28571;30984;31324,66795,0,2,2,0,4
86784,200,22087,27661;28092;30526,66795,0,0,3,0,3
86785,200,22088,27875;28099;30869,66795,0,1,2,0,3
86786,200,22089,28158;30873;30967;31050;31375,66795,0,4,1,0,5
86787,200,22091,28031;28236;30255;30701,66795,0,1,3,0,4
86788,200,22092,28255;28435,66795,0,0,2,0,2
86789,200,22094,28262;28313;31707,66795,1,0,2,0,3
86790,200,22095,28204;28272;31140;31304,66795,0,2,2,0,4
86791,200,22096,28278;28527;31478,66795,0,1,2,0,3
86792,200,22097,28842;31419;31580,66795,0,2,1,0,3
86793,200,22098,28281;28325;30887;31226,66795,0,2,2,0,4
86794,200,22099,28663;31246,66795,0,1,1,0,2
86795,200,22100,28079;28410;30892;31637,66795,1,1,2,0,4
86796,200,22101,28683;31073;31907,66795,1,1,1,0,3
86797,200,22102,28004;28367;30888;31395,66795,0,2,2,0,4
86798,200,22104,28377;28488,66795,0,0,2,0,2
86799,200,22105,28011;28388,66795,0,0,2,0,2
86800,200,22106,28393;31228;31315,66795,0,2,1,0,3
86801,200,22107,28276;28423,66795,0,0,2,0,2
86802,200,22108,28465;28843;30621;30894,66795,0,2,2,0,4
86803,200,22109,28472;28491;31149;31235,66795,0,2,2,0,4
86804,200,22110,28489;28682;31906,66795,1,0,2,0,3
86805,200,22111,28411;28494,66795,0,0,2,0,2
86806,200,22112,28231;28511;31238;31406;31713;31899;31970,66795,3,2,2,0,7
86807,200,22113,28510;28525,66795,0,0,2,0,2
86808,200,22114,28097;28544;30624;30711,66795,0,2,2,0,4
86809,200,22115,28620;28759;31069,66795,0,1,2,0,3
86810,200,22116,28545;28886;31666;31741,66795,2,0,2,0,4
86811,200,22117,28274;28551;31903,66795,1,0,2,0,3
86812,200,22118,28109;28559;31971,66795,1,0,2,0,3
86813,200,22119,28564;28679;30793;31480,66795,0,2,2,0,4
86814,200,22120,28623;28771;30994;31826,66795,1,1,2,0,4
86815,200,22121,28432;28605;30444;31156;31327;31718,66795,1,2,3,0,6
86816,200,22122,28613;28721;30987;31410,66795,0,2,2,0,4
86817,200,22123,28881;28965;31838,66795,1,0,2,0,3
86818,200,22124,28621;28740,66795,0,0,2,0,2
86819,200,22125,28566;28622;31411,66795,0,1,2,0,3
86820,200,22126,28328;28641;31650,66795,1,0,2,0,3
86821,200,22127,28591;28654;31568,66795,0,1,2,0,3
86822,200,22128,28660;29023,66795,0,0,2,0,2
86823,200,22129,28673;28824;30626;31577,66795,0,2,2,0,4
86824,200,22130,28691;28744;30715;31413;31653,66795,1,2,2,0,5
86825,200,22131,28584;28707;31153,66795,0,1,2,0,3
86826,200,22132,28731;28933;31247;31334;31415;31823,66795,1,3,2,0,6
86827,200,22133,24686,67160,0,0,0,1,1
86828,200,22134,24860,67160,0,0,0,1,1
86829,200,22141,25810,67160,0,0,0,1,1
86830,200,22142,25771;25788,67160,0,0,0,2,2
86831,200,22144,25708;25976,67160,0,0,1,1,2
86832,200,22146,26088;26446,67160,0,0,2,0,2
86833,200,22149,26564,67160,0,0,1,0,1
86834,200,22150,26341;26365,67160,0,0,2,0,2
86835,200,22151,26593;26762,67160,0,0,2,0,2
86836,200,22162,27042;27669;31286,67160,0,1,2,0,3
86837,200,22163,27887,67160,0,0,1,0,1
86838,200,22164,27565;28172;30776;31303,67160,0,2,2,0,4
86839,200,22165,27989;28409,67160,0,0,2,0,2
86840,200,22166,27574,67160,0,0,1,0,1
86841,200,22167,28029;28507;30708;30896;31322,67160,0,3,2,0,5
86842,200,22169,28087;28180;30612;30970;31892,67160,1,2,2,0,5
86843,200,22170,28106;30607;30693,67160,0,2,1,0,3
86844,200,22171,28202;28484;30981;31404;31561;31969,67160,1,3,2,0,6
86845,200,22172,28119;28747;30449;31910,67160,1,0,3,0,4
86846,200,22173,28130;28316;30614;31309,67160,0,2,2,0,4
86847,200,22174,28133;28149;30966;31213,67160,0,2,2,0,4
86848,200,22175,28151;28466;31710,67160,1,0,2,0,3
86849,200,22176,28161;31301,67160,0,1,1,0,2
86850,200,22177,28261;29810,67160,0,0,2,0,2
86851,200,22178,28277;31549,67160,0,1,1,0,2
86852,200,22179,28285;29030,67160,0,0,2,0,2
86853,200,22180,28153;28298;30885;31389;31894,67160,1,2,2,0,5
86854,200,22181,28336;28821;30800;31576,67160,0,2,2,0,4
86855,200,22182,28069;28338;30536;31057,67160,0,1,3,0,4
86856,200,22183,28221;28346;30533,67160,0,0,3,0,3
86857,200,22184,28397;30788;30890;31229;31556;31636;31708;31811,67160,3,4,1,0,8
86858,200,22185,28729;31414;31487;31977,67160,1,2,1,0,4
86859,200,22186,28381;31313;31635,67160,1,1,1,0,3
86860,200,22187,28426;28434;30261,67160,0,0,3,0,3
86861,200,22188,27933;28429;31232,67160,0,1,2,0,3
86862,200,22189,28128;28461,67160,0,0,2,0,2
86863,200,22190,28174;28600;30713;31155;31565,67160,0,3,2,0,5
86864,200,22191,28485;28976;31840,67160,1,0,2,0,3
86865,200,22192,28038;28515;30709;31900,67160,1,1,2,0,4
86866,200,22194,28404;28580;30707,67160,0,1,2,0,3
86867,200,22195,28628;28861;31491;31829,67160,1,1,2,0,4
86868,200,22196,28555;28575;31158;31323,67160,0,2,2,0,4
86869,200,22197,28644;28855;31083;31915;31980,67160,2,1,2,0,5
86870,200,22198,28715;28793;31164,67160,0,1,2,0,3
86871,200,22199,28447;28750;30450;30904;31248;31488;31571,67160,0,4,3,0,7
86872,200,22200,28676;28689;30714;30991,67160,0,2,2,0,4
86873,200,22201,28777;29017;31750,67160,1,0,2,0,3
86874,200,22202,28568;28692;31722,67160,1,0,2,0,3
86875,200,22203,28701;28815;31075;31331;31723,67160,1,2,2,0,5
86876,200,22204,28441;28710;31655,67160,1,0,2,0,3
86877,200,22205,28696;28712;30447;31074;31654,67160,1,1,3,0,5
86878,200,22206,28636;28849;31905,67160,1,0,2,0,3
86879,200,22207,28955;28991;30722;31989,67160,1,1,2,0,4
86880,200,22208,28782;28900;31985,67160,1,0,2,0,3
86881,200,22209,28776;29005;31669,67160,1,0,2,0,3
86882,200,22210,28812,67160,0,0,1,0,1
86883,200,22211,28709;28839,67160,0,0,2,0,2
86884,200,22212,28678;28847;30627;30720;30907;31914,67160,1,3,2,0,6
86885,200,22215,25116,67525,0,0,0,1,1
86886,200,22217,25389,67525,0,0,0,1,1
86887,200,22218,25688,67525,0,0,0,1,1
86888,200,22223,26439;26594;29835,67525,0,0,3,0,3
86889,200,22224,25944;26296,67525,0,0,2,0,2
86890,200,22226,26622;26636,67525,0,0,2,0,2
86891,200,22227,26798;27423;30399;30487;30739;30828,67525,0,2,4,0,6
86892,200,22228,26522;26852;30098,67525,0,0,3,0,3
86893,200,22234,27138;27193;30920,67525,0,1,2,0,3
86894,200,22235,27406;28086,67525,0,0,2,0,2
86895,200,22236,27516,67525,0,0,1,0,1
86896,200,22237,27625;31189,67525,0,1,1,0,2
86897,200,22239,27573;28268;29987,67525,0,0,3,0,3
86898,200,22240,27741;30240,67525,0,0,2,0,2
86899,200,22241,27648,67525,0,0,1,0,1
86900,200,22242,27513;27707;31288,67525,0,1,2,0,3
86901,200,22243,27718;28034,67525,0,0,2,0,2
86902,200,22247,27888;28739;30903,67525,0,1,2,0,3
86903,200,22250,27467;28028;31042,67525,0,1,2,0,3
86904,200,22251,28132;28469,67525,0,0,2,0,2
86905,200,22252,28392;28505;31152;31237,67525,0,2,2,0,4
86906,200,22254,28175;28184;31218;31378,67525,0,2,2,0,4
86907,200,22256,28122;28738,67525,0,0,2,0,2
86908,200,22257,28155;28442;31400;31476,67525,0,2,2,0,4
86909,200,22258,28629;31070;31412;31648;31975,67525,2,2,1,0,5
86910,200,22259,28244;28464;30702;30880,67525,0,2,2,0,4
86911,200,22260,28248;30881;31386,67525,0,2,1,0,3
86912,200,22261,28334;28720;30798;31822,67525,1,1,2,0,4
86913,200,22262,28295;31470;31552,67525,0,2,1,0,3
86914,200,22264,29104;31429;31756;31998,67525,2,1,1,0,4
86915,200,22265,28362;28834;31252;31578;31735,67525,1,2,2,0,5
86916,200,22266,28470;31063;31148;31402,67525,0,3,1,0,4
86917,200,22267,28475;28537,67525,0,0,2,0,2
86918,200,22268,28711;31332,67525,0,1,1,0,2
86919,200,22269,28497;28508;30540;31065;31405;31711,67525,1,2,3,0,6
86920,200,22270,28714;28798,67525,0,0,2,0,2
86921,200,22271,28534;31901,67525,1,0,1,0,2
86922,200,22272,28538;28687,67525,0,0,2,0,2
86923,200,22274,28396;28582;30617;31060,67525,0,2,2,0,4
86924,200,22277,28618;28916;31167,67525,0,1,2,0,3
86925,200,22278,28210;28638;30445;31649;31720,67525,2,0,3,0,5
86926,200,22279,28643;28785;31730;31827,67525,2,0,2,0,4
86927,200,22280,28439;28646,67525,0,0,2,0,2
86928,200,22281,28597;28665;30797;30989;31160,67525,0,3,2,0,5
86929,200,22282,28728;29176,67525,0,0,2,0,2
86930,200,22283,28907;28995,67525,0,0,2,0,2
86931,200,22284,28788;29289;31863,67525,1,0,2,0,3
86932,200,22285,28354;28961;31918,67525,1,0,2,0,3
86933,200,22286,28819;31979,67525,1,0,1,0,2
86934,200,22287,28835;29061;31172,67525,0,1,2,0,3
86935,200,22288,28882;28942;31422,67525,0,1,2,0,3
86936,200,22289,28901;28969;31171;31987,67525,1,1,2,0,4
86937,200,22290,28918;31253;31833,67525,1,1,1,0,3
86938,200,22291,28857;28923;31737,67525,1,0,2,0,3
86939,200,22292,25041,67890,0,0,0,1,1
86940,200,22297,24630,67890,0,0,0,1,1
86941,200,22300,25231,67890,0,0,0,1,1
86942,200,22301,25487,67890,0,0,0,1,1
86943,200,22302,25274,67890,0,0,0,1,1
86944,200,22303,25626;25901,67890,0,0,0,2,2
86945,200,22307,25464,67890,0,0,0,1,1
86946,200,22309,25980;26030,67890,0,0,2,0,2
86947,200,22310,25962;26149,67890,0,0,2,0,2
86948,200,22313,26611;26695,67890,0,0,2,0,2
86949,200,22315,26455;26768;30092;31884,67890,1,0,3,0,4
86950,200,22322,27289;27588;29429,67890,0,0,3,0,3
86951,200,22324,27934;28096;30346;32059,67890,1,0,3,0,4
86952,200,22326,27854;30847;31196,67890,0,2,1,0,3
86953,200,22327,27833;27913;31115;31888,67890,1,1,2,0,4
86954,200,22328,28102;28341,67890,0,0,2,0,2
86955,200,22329,28103;28424;31968,67890,1,0,2,0,3
86956,200,22330,28115;28167;30437;30875,67890,0,1,3,0,4
86957,200,22331,28223;28741;31909,67890,1,0,2,0,3
86958,200,22333,28239;28667;31485,67890,0,1,2,0,3
86959,200,22334,28288;28372;31307,67890,0,1,2,0,3
86960,200,22335,28371,67890,0,0,1,0,1
86961,200,22336,27786;28373,67890,0,0,2,0,2
86962,200,22337,28477;28737;30993,67890,0,1,2,0,3
86963,200,22339,28529;28671,67890,0,0,2,0,2
86964,200,22340,28554;31714;31817,67890,2,0,1,0,3
86965,200,22341,28570;28913,67890,0,0,2,0,2
86966,200,22342,28546;28589;31154;31408;31904,67890,1,2,2,0,5
86967,200,22343,28588;28649,67890,0,0,2,0,2
86968,200,22344,28632;30899;31567,67890,0,2,1,0,3
86969,200,22345,28617;30795;31566,67890,0,2,1,0,3
86970,200,22346,28552;28699;30448,67890,0,0,3,0,3
86971,200,22347,28717;28838;31579;31660,67890,1,1,2,0,4
86972,200,22348,28732;28939;31169;31589;31835,67890,1,2,2,0,5
86973,200,22349,28234,67890,0,0,1,0,1
86974,200,22350,28458,67890,0,0,1,0,1
86975,200,22351,28786;28813,67890,0,0,2,0,2
86976,200,22352,28814;28846;31081,67890,0,1,2,0,3
86977,200,22353,28401;28822;31734,67890,1,0,2,0,3
86978,200,22354,28829;29195;31006;31858;31929,67890,2,1,2,0,5
86979,200,22355,28694;28832;31079,67890,0,1,2,0,3
86980,200,22356,28833;29174;31432,67890,0,1,2,0,3
86981,200,22357,28581;28867;31493;31739;31916,67890,2,1,2,0,5
86982,200,22358,28647;28852;30998,67890,0,1,2,0,3
86983,200,22359,28863;31492;31738,67890,1,1,1,0,3
86984,200,22360,28864;29144,67890,0,0,2,0,2
86985,200,22361,28809;28926;30802;31744,67890,1,1,2,0,4
86986,200,22362,28945;29158,67890,0,0,2,0,2
86987,200,22363,28831;28960;31748,67890,1,0,2,0,3
86988,200,22364,29235;31437,67890,0,1,1,0,2
86989,200,22365,28909;28968;31839,67890,1,0,2,0,3
86990,200,22366,28972;29238;31508,67890,0,1,2,0,3
86991,200,22367,29172;30724;31090;31856;31928,67890,2,2,1,0,5
86992,200,22368,29015;29211;31176,67890,0,1,2,0,3
86993,200,22369,29231;29300;31686,67890,1,0,2,0,3
86994,200,22370,28870;29010;31593;31921,67890,1,1,2,0,4
86995,200,22371,29018;29133,67890,0,0,2,0,2
86996,200,22372,29028;29257,67890,0,0,2,0,2
86997,200,22373,25035,68255,0,0,0,1,1
86998,200,22375,24780,68255,0,0,0,1,1
86999,200,22376,25292,68255,0,0,0,1,1
87000,200,22378,25625,68255,0,0,0,1,1
87001,200,22380,25769,68255,0,0,0,1,1
87002,200,22381,26106;26560,68255,0,0,2,0,2
87003,200,22383,25857,68255,0,0,0,1,1
87004,200,22392,26169;26354,68255,0,0,2,0,2
87005,200,22394,26977,68255,0,0,1,0,1
87006,200,22398,27485,68255,0,0,1,0,1
87007,200,22401,28037;30687;31206;31368,68255,0,3,1,0,4
87008,200,22402,27735;27902,68255,0,0,2,0,2
87009,200,22403,28398,68255,0,0,1,0,1
87010,200,22404,28355;30259;31392,68255,0,1,2,0,3
87011,200,22405,27596;27779;30330;30590,68255,0,1,3,0,4
87012,200,22406,27626,68255,0,0,1,0,1
87013,200,22408,28078;28467;30867;31298;31540,68255,0,3,2,0,5
87014,200,22409,28203;30782;31806;31893,68255,2,1,1,0,4
87015,200,22410,27879,68255,0,0,1,0,1
87016,200,22411,28190;28375,68255,0,0,2,0,2
87017,200,22412,28265;28539,68255,0,0,2,0,2
87018,200,22413,28286;28800;31732,68255,1,0,2,0,3
87019,200,22414,27906;28293;31551,68255,0,1,2,0,3
87020,200,22415,28536;31479;31902,68255,1,1,1,0,3
87021,200,22416,28446,68255,0,0,1,0,1
87022,200,22417,28487;28681,68255,0,0,2,0,2
87023,200,22418,28574,68255,0,0,1,0,1
87024,200,22419,28504;28585;31325;31481,68255,0,2,2,0,4
87025,200,22420,28598;29065;31499,68255,0,1,2,0,3
87026,200,22421,28604;28892;31585,68255,0,1,2,0,3
87027,200,22422,28626;28894;31000;31166;31742,68255,1,2,2,0,5
87028,200,22423,29292;29298,68255,0,0,2,0,2
87029,200,22424,28653;30446;30541;31071,68255,0,1,3,0,4
87030,200,22425,28927;28983;30803;31168;31745,68255,1,2,2,0,5
87031,200,22426,28700;29372,68255,0,0,2,0,2
87032,200,22427,28607;28703;31076,68255,0,1,2,0,3
87033,200,22429,28844;29042,68255,0,0,2,0,2
87034,200,22430,28862;29037,68255,0,0,2,0,2
87035,200,22431,28896;29196;31435;31859,68255,1,1,2,0,4
87036,200,22432,28975;29204;31603;31769;31930,68255,2,1,2,0,5
87037,200,22433,28986;29422;31352;31444;31779,68255,1,2,2,0,5
87038,200,22434,28593;29000;31342,68255,0,1,2,0,3
87039,200,22435,28612;29021;31258;31671;31992,68255,2,1,2,0,5
87040,200,22436,29026;31751,68255,1,0,1,0,2
87041,200,22437,29412,68255,0,0,1,0,1
87042,200,22438,28898;29057;31425;31594,68255,0,2,2,0,4
87043,200,22439,28755;29066;31173,68255,0,1,2,0,3
87044,200,22440,29083,68255,0,0,1,0,1
87045,200,22441,28996;29089;31678;31848,68255,2,0,2,0,4
87046,200,22442,29097;29100;31345;31428;31500;31996,68255,1,3,2,0,6
87047,200,22443,29099;29267;31513,68255,0,1,2,0,3
87048,200,22444,28889;29109;31757,68255,1,0,2,0,3
87049,200,22445,28949;29112;31346;31758,68255,1,1,2,0,4
87050,200,22446,29107;29117;31999,68255,1,0,2,0,3
87051,200,22447,25159,68620,0,0,0,1,1
87052,200,22448,24810,68620,0,0,0,1,1
87053,200,22451,25140,68620,0,0,0,1,1
87054,200,22452,25394,68620,0,0,0,1,1
87055,200,22453,25325,68620,0,0,0,1,1
87056,200,22456,25806,68620,0,0,0,1,1
87057,200,22461,26129,68620,0,0,1,0,1
87058,200,22463,26748,68620,0,0,1,0,1
87059,200,22464,26551,68620,0,0,1,0,1
87060,200,22465,26549,68620,0,0,1,0,1
87061,200,22467,26795,68620,0,0,1,0,1
87062,200,22470,27256;27821;30516;30755;30845,68620,0,2,3,0,5
87063,200,22471,27572;29800;31017,68620,0,1,2,0,3
87064,200,22474,27713,68620,0,0,1,0,1
87065,200,22475,27915,68620,0,0,1,0,1
87066,200,22476,27926;28148;30166;31049;31215,68620,0,2,3,0,5
87067,200,22477,28077;28319;30866;30963;31539,68620,0,3,2,0,5
87068,200,22480,28020,68620,0,0,1,0,1
87069,200,22481,27751,68620,0,0,1,0,1
87070,200,22482,28176;28179;31379;31891,68620,1,1,2,0,4
87071,200,22484,27855,68620,0,0,1,0,1
87072,200,22487,28405;28753;31317;31397,68620,0,2,2,0,4
87073,200,22488,28414;30979;31231;31558,68620,0,3,1,0,4
87074,200,22489,28416;28811;31489;31575,68620,0,2,2,0,4
87075,200,22491,28535,68620,0,0,1,0,1
87076,200,22492,28553;28561;31241,68620,0,1,2,0,3
87077,200,22493,28330;28616;30988;31646;31973,68620,2,1,2,0,5
87078,200,22494,28645;29032,68620,0,0,2,0,2
87079,200,22495,27861;28025,68620,0,0,2,0,2
87080,200,22496,29132;29413;31347;31763;31854,68620,2,1,2,0,5
87081,200,22497,28698;28979;31919,68620,1,0,2,0,3
87082,200,22498,28502;29022;31843,68620,1,0,2,0,3
87083,200,22499,28514,68620,0,0,1,0,1
87084,200,22500,28749;28868;31084;31582;31664;31740,68620,2,2,2,0,6
87085,200,22501,28391;28763;31416;31825,68620,1,1,2,0,4
87086,200,22502,28837;31736,68620,1,0,1,0,2
87087,200,22503,28639;28795;31250,68620,0,1,2,0,3
87088,200,22504,28743;29177,68620,0,0,2,0,2
87089,200,22505,28733;28988,68620,0,0,2,0,2
87090,200,22506,28845;29268;31514;31861,68620,1,1,2,0,4
87091,200,22507,28871;29272,68620,0,0,2,0,2
87092,200,22508,28874;29113;31982,68620,1,0,2,0,3
87093,200,22509,28885;29047;31831,68620,1,0,2,0,3
87094,200,22510,28634;28772;30905,68620,0,1,2,0,3
87095,200,22511,28895;29250,68620,0,0,2,0,2
87096,200,22512,28910;31586;31743,68620,1,1,1,0,3
87097,200,22513,28716;28919,68620,0,0,2,0,2
87098,200,22515,28929;31746;31834,68620,2,0,1,0,3
87099,200,22516,28944;29121;31600;31923,68620,1,1,2,0,4
87100,200,22517,28783;28948;31747,68620,1,0,2,0,3
87101,200,22518,28962;29068;30808;31085;31261,68620,0,3,2,0,5
87102,200,22519,28865;31420;31981,68620,1,1,1,0,3
87103,200,22520,29027;29365,68620,0,0,2,0,2
87104,200,22521,28937;29034;31673;31845,68620,2,0,2,0,4
87105,200,22522,29011;29044;30723,68620,0,1,2,0,3
87106,200,22523,29067;29074;31675,68620,1,0,2,0,3
87107,200,22524,29243;29399,68620,0,0,2,0,2
87108,200,22525,29106;29258;31268,68620,0,1,2,0,3
87109,200,22526,29069;29110;31502;31850,68620,1,1,2,0,4
87110,200,22527,28830;29125;31761;32001,68620,2,0,2,0,4
87111,200,22528,29152;29313;31351;31612;31864,68620,1,2,2,0,5
87112,200,22529,29153;29167;31766,68620,1,0,2,0,3
87113,200,22530,28915;29402;31442;31520;31614,68620,0,3,2,0,5
87114,200,22531,29502;29516;32027,68620,1,0,2,0,3
87115,200,22532,29216;29281;32017,68620,1,0,2,0,3
87116,200,22533,29223;29480;31872,68620,1,0,2,0,3
87117,200,22534,28817;29230;31604,68620,0,1,2,0,3
87118,200,22535,25223,68985,0,0,0,1,1
87119,200,22538,25733,68985,0,0,0,1,1
87120,200,22540,25786;25875,68985,0,0,0,2,2
87121,200,22541,25977;26103,68985,0,0,2,0,2
87122,200,22542,25919,68985,0,0,0,1,1
87123,200,22550,27051;27203;29870;30733,68985,0,1,3,0,4
87124,200,22554,27358;27364;30484;30925,68985,0,1,3,0,4
87125,200,22556,27081,68985,0,0,1,0,1
87126,200,22557,27499,68985,0,0,1,0,1
87127,200,22559,28165;31965,68985,1,0,1,0,2
87128,200,22561,27493;27690,68985,0,0,2,0,2
87129,200,22562,27809,68985,0,0,1,0,1
87130,200,22563,27805;28163,68985,0,0,2,0,2
87131,200,22564,27829;28345;31808,68985,1,0,2,0,3
87132,200,22565,27597,68985,0,0,1,0,1
87133,200,22567,27876;28235;30254;30973;31384,68985,0,2,3,0,5
87134,200,22570,28303;28324;31895,68985,1,0,2,0,3
87135,200,22571,28321,68985,0,0,1,0,1
87136,200,22572,28359;28595;30260;30537;31059;31473,68985,0,2,4,0,6
87137,200,22573,28066;28506;30262,68985,0,0,3,0,3
87138,200,22574,28389;28725;30543;31570,68985,0,1,3,0,4
87139,200,22575,28386;28420;31809,68985,1,0,2,0,3
87140,200,22576,28081;28443;30539;31234;31319,68985,0,2,3,0,5
87141,200,22577,28462;28479;31150,68985,0,1,2,0,3
87142,200,22578,28517;28523;30790;31239;31814,68985,1,2,2,0,5
87143,200,22579,28496;28550;30983;31816,68985,1,1,2,0,4
87144,200,22581,28516;28596,68985,0,0,2,0,2
87145,200,22582,28603;28773;30995;31728,68985,1,1,2,0,4
87146,200,22583,28370;28635;30900;31719,68985,1,1,2,0,4
87147,200,22585,28576;28590,68985,0,0,2,0,2
87148,200,22586,28181,68985,0,0,1,0,1
87149,200,22587,28688;29191;31005;31682,68985,1,1,2,0,4
87150,200,22588,29188;29295,68985,0,0,2,0,2
87151,200,22589,28735;28810;31828,68985,1,0,2,0,3
87152,200,22590,28658;28774;31658,68985,1,0,2,0,3
87153,200,22591,28751;29291;31773,68985,1,0,2,0,3
87154,200,22592,28799;28947,68985,0,0,2,0,2
87155,200,22593,28284;28754;30799;31727,68985,1,1,2,0,4
87156,200,22594,28827;28840;30801;31080;31661;31913,68985,2,2,2,0,6
87157,200,22595,28816;29055;31752,68985,1,0,2,0,3
87158,200,22596,28860;29237;31932;32012,68985,2,0,2,0,4
87159,200,22597,29053;29123;31760;31852,68985,2,0,2,0,4
87160,200,22598,29039;31922,68985,1,0,1,0,2
87161,200,22599,29049;29193;31505,68985,0,1,2,0,3
87162,200,22600,29052;29253;31510,68985,0,1,2,0,3
87163,200,22601,29071;29566;31946;32031,68985,2,0,2,0,4
87164,200,22602,28921;29116;31599,68985,0,1,2,0,3
87165,200,22603,29078;29118;31851,68985,1,0,2,0,3
87166,200,22604,28938;29131;31853;32002,68985,2,0,2,0,4
87167,200,22605,28652;29145;31431;31680;31764,68985,2,1,2,0,5
87168,200,22606,29063;29147;31765,68985,1,0,2,0,3
87169,200,22607,28825;28893;30451;31984,68985,1,0,3,0,4
87170,200,22608,29111;29180;31433;32009,68985,1,1,2,0,4
87171,200,22609,29184;29419,68985,0,0,2,0,2
87172,200,22610,29226;29255;31177;31507,68985,0,2,2,0,4
87173,200,22611,29227;29360;31690;31940,68985,2,0,2,0,4
87174,200,22612,29239;29246;31605,68985,0,1,2,0,3
87175,200,22613,29458;29554;31354,68985,0,1,2,0,3
87176,200,22614,29101;29249;31349;31607,68985,0,2,2,0,4
87177,200,22615,28851;29275,68985,0,0,2,0,2
87178,200,22617,28648,68985,0,0,1,0,1
87179,200,22618,28931;29303;31610,68985,0,1,2,0,3
87180,200,22619,29308;29517;31785,68985,1,0,2,0,3
87181,200,22620,25328,69350,0,0,0,1,1
87182,200,22621,25505,69350,0,0,0,1,1
87183,200,22622,25026,69350,0,0,0,1,1
87184,200,22627,25757,69350,0,0,0,1,1
87185,200,22628,25624,69350,0,0,0,1,1
87186,200,22633,25703,69350,0,0,0,1,1
87187,200,22636,26553,69350,0,0,1,0,1
87188,200,22641,26956,69350,0,0,1,0,1
87189,200,22642,27032,69350,0,0,1,0,1
87190,200,22643,26999;27432;30229;30741,69350,0,1,3,0,4
87191,200,22644,26882,69350,0,0,1,0,1
87192,200,22646,26735,69350,0,0,1,0,1
87193,200,22649,27465,69350,0,0,1,0,1
87194,200,22652,27072,69350,0,0,1,0,1
87195,200,22654,27519;27693;30503;30586;30936;31024,69350,0,3,3,0,6
87196,200,22655,27722,69350,0,0,1,0,1
87197,200,22659,27658,69350,0,0,1,0,1
87198,200,22660,27956,69350,0,0,1,0,1
87199,200,22664,28059;28160;31467,69350,0,1,2,0,3
87200,200,22665,28082;28390;30616;30889,69350,0,2,2,0,4
87201,200,22667,28251;28522;30442,69350,0,0,3,0,3
87202,200,22668,28050,69350,0,0,1,0,1
87203,200,22669,27869;28486;30895,69350,0,1,2,0,3
87204,200,22670,28329;28718;31161;31976,69350,1,1,2,0,4
87205,200,22671,27999,69350,0,0,1,0,1
87206,200,22672,28953;30767;31254;31341;31423,69350,0,4,1,0,5
87207,200,22677,28513;28970,69350,0,0,2,0,2
87208,200,22678,29154;32003,69350,1,0,1,0,2
87209,200,22679,28697;29020;30807;31670;31991,69350,2,1,2,0,5
87210,200,22680,28713;29035;31486;31821,69350,1,1,2,0,4
87211,200,22681,28752;28879;31077,69350,0,1,2,0,3
87212,200,22682,28558;28690;30992;31652;31908,69350,2,1,2,0,5
87213,200,22683,28797;29587,69350,0,0,2,0,2
87214,200,22684,28836,69350,0,0,1,0,1
87215,200,22685,28853;29025;30628;31082,69350,0,2,2,0,4
87216,200,22686,28959;29058;31170;31495,69350,0,2,2,0,4
87217,200,22687,28872;28873;31665,69350,1,0,2,0,3
87218,200,22688,28884;31339;31584,69350,0,2,1,0,3
87219,200,22689,29476,69350,0,0,1,0,1
87220,200,22690,28807;28980;31255;31590,69350,0,2,2,0,4
87221,200,22691,28858;29001;31990,69350,1,0,2,0,3
87222,200,22692,28757;29029,69350,0,0,2,0,2
87223,200,22693,28501;29059;31260;31753,69350,1,1,2,0,4
87224,200,22694,28828;29081;30912;31344;31677,69350,1,2,2,0,5
87225,200,22695,29098;29200;31755;31997,69350,2,0,2,0,4
87226,200,22696,28932;29108,69350,0,0,2,0,2
87227,200,22697,29124;29518,69350,0,0,2,0,2
87228,200,22698,28946;29139;31924,69350,1,0,2,0,3
87229,200,22699,29175;29662,69350,0,0,2,0,2
87230,200,22700,29198;29252,69350,0,0,2,0,2
87231,200,22701,29494,69350,0,0,1,0,1
87232,200,22702,29220;29493,69350,0,0,2,0,2
87233,200,22703,29269;29585;31620;31877,69350,1,1,2,0,4
87234,200,22704,28956;29270;31608;31772;32016,69350,2,1,2,0,5
87235,200,22705,29283;29564,69350,0,0,2,0,2
87236,200,22707,29282;29290;30914;31935,69350,1,1,2,0,4
87237,200,22708,29294;29541,69350,0,0,2,0,2
87238,200,22709,29434;29464,69350,0,0,2,0,2
87239,200,22710,29320;29400;31778,69350,1,0,2,0,3
87240,200,22711,29597,69350,0,0,1,0,1
87241,200,22712,29332;29684;31950,69350,1,0,2,0,3
87242,200,22713,29335;29425;31943,69350,1,0,2,0,3
87243,200,22714,29552;31523,69350,0,1,1,0,2
87244,200,22715,29338,69350,0,0,1,0,1
87245,200,22716,29342;29394;31009;31777;31868,69350,2,1,2,0,5
87246,200,22717,29507;29580;31619;31788,69350,1,1,2,0,4
87247,200,22719,29513,69350,0,0,1,0,1
87248,200,22720,29170;29354;31867,69350,1,0,2,0,3
87249,200,22721,29371;29605;31277,69350,0,1,2,0,3
87250,200,22722,29386;29614;32032,69350,1,0,2,0,3
87251,200,22723,29390;29621,69350,0,0,2,0,2
87252,200,22724,29395;29615;31947,69350,1,0,2,0,3
87253,200,22725,29556;29697,69350,0,0,2,0,2
87254,200,22726,29451,69350,0,0,1,0,1
87255,200,22727,29666;29688;31949,69350,1,0,2,0,3
87256,200,22728,25431,69715,0,0,0,1,1
87257,200,22731,25661,69715,0,0,0,1,1
87258,200,22732,25676,69715,0,0,0,1,1
87259,200,22734,25936,69715,0,0,1,0,1
87260,200,22737,26270,69715,0,0,1,0,1
87261,200,22738,26053,69715,0,0,1,0,1
87262,200,22740,26250,69715,0,0,1,0,1
87263,200,22742,26805,69715,0,0,1,0,1
87264,200,22747,27082,69715,0,0,1,0,1
87265,200,22750,27111,69715,0,0,1,0,1
87266,200,22751,26628;26938,69715,0,0,2,0,2
87267,200,22752,26930,69715,0,0,1,0,1
87268,200,22753,27359;27391;29127;31183,69715,0,1,3,0,4
87269,200,22755,27730,69715,0,0,1,0,1
87270,200,22757,27790;27898;30954,69715,0,1,2,0,3
87271,200,22759,27877,69715,0,0,1,0,1
87272,200,22764,28294,69715,0,0,1,0,1
87273,200,22768,28283;28906;31832,69715,1,0,2,0,3
87274,200,22769,28640;28974;31749,69715,1,0,2,0,3
87275,200,22770,28661;28705;31072;31330;31569;31651,69715,1,3,2,0,6
87276,200,22771,28258;28326;29895;30786;31896,69715,1,1,3,0,5
87277,200,22772,28670,69715,0,0,1,0,1
87278,200,22773,28437,69715,0,0,1,0,1
87279,200,22774,28954,69715,0,0,1,0,1
87280,200,22775,28724;29181;31004;31504,69715,0,2,2,0,4
87281,200,22776,28823;29142;31088;31430;31601;31679,69715,1,3,2,0,6
87282,200,22778,28768;29006;31920,69715,1,0,2,0,3
87283,200,22779,28876;29306;31338;31583,69715,0,2,2,0,4
87284,200,22780,28951;31837,69715,1,0,1,0,2
87285,200,22781,29080,69715,0,0,1,0,1
87286,200,22782,29008;31257;31592;31841,69715,1,2,1,0,4
87287,200,22784,28930;29082;31596;31754,69715,1,1,2,0,4
87288,200,22785,29137;29163;31089;31265,69715,0,2,2,0,4
87289,200,22786,29141,69715,0,0,1,0,1
87290,200,22787,29149;29297,69715,0,0,2,0,2
87291,200,22788,29151;29483,69715,0,0,2,0,2
87292,200,22789,29159;29296;31767,69715,1,0,2,0,3
87293,200,22790,28941;29203;30909,69715,0,1,2,0,3
87294,200,22791,29215;29482;31274,69715,0,1,2,0,3
87295,200,22792,29219;29420,69715,0,0,2,0,2
87296,200,22793,29024;29229;31860,69715,1,0,2,0,3
87297,200,22794,28922;29251;31685;31770;32013,69715,3,0,2,0,5
87298,200,22795,29190;29264;31681,69715,1,0,2,0,3
87299,200,22796,29265;29277;31512;32015,69715,1,1,2,0,4
87300,200,22797,28957;29310;31439;31611;32019,69715,1,2,2,0,5
87301,200,22798,29314;29519;31786;32029,69715,2,0,2,0,4
87302,200,22799,29092;29319;31440;31938,69715,1,1,2,0,4
87303,200,22800,28878;29327;31774,69715,1,0,2,0,3
87304,200,22801,29305;29350;31178,69715,0,1,2,0,3
87305,200,22802,29351;29474;31781,69715,1,0,2,0,3
87306,200,22803,29356;29639,69715,0,0,2,0,2
87307,200,22804,29776,69715,0,0,1,0,1
87308,200,22805,29051;29406,69715,0,0,2,0,2
87309,200,22806,29301;29410;31516;31936,69715,1,1,2,0,4
87310,200,22807,29411;29637,69715,0,0,2,0,2
87311,200,22808,29206;29421,69715,0,0,2,0,2
87312,200,22809,29435;31521,69715,0,1,1,0,2
87313,200,22810,29561;31092;31355;31875,69715,1,2,1,0,4
87314,200,22811,29459;29526;31180,69715,0,1,2,0,3
87315,200,22812,29466;31871,69715,1,0,1,0,2
87316,200,22813,29475;29528,69715,0,0,2,0,2
87317,200,22814,29701;29790,69715,0,0,2,0,2
87318,200,22815,29488;29578;31356;31787,69715,1,1,2,0,4
87319,200,22816,29456;29497;31273,69715,0,1,2,0,3
87320,200,22817,29503;29551;31181;31451,69715,0,2,2,0,4
87321,200,22818,29505;29607;31447,69715,0,1,2,0,3
87322,200,22819,29500;29511;31693,69715,1,0,2,0,3
87323,200,22820,25069,70080,0,0,0,1,1
87324,200,22821,25564,70080,0,0,0,1,1
87325,200,22822,25576,70080,0,0,0,1,1
87326,200,22823,25642,70080,0,0,0,1,1
87327,200,22826,26093,70080,0,0,1,0,1
87328,200,22827,26052,70080,0,0,1,0,1
87329,200,22828,26307,70080,0,0,1,0,1
87330,200,22833,26492;26496,70080,0,0,2,0,2
87331,200,22834,26605,70080,0,0,1,0,1
87332,200,22836,26790,70080,0,0,1,0,1
87333,200,22838,26918;27525,70080,0,0,2,0,2
87334,200,22840,26996,70080,0,0,1,0,1
87335,200,22841,27012;27211,70080,0,0,2,0,2
87336,200,22842,27334,70080,0,0,1,0,1
87337,200,22844,27365,70080,0,0,1,0,1
87338,200,22845,27439,70080,0,0,1,0,1
87339,200,22847,27704,70080,0,0,1,0,1
87340,200,22849,27416,70080,0,0,1,0,1
87341,200,22850,28088;28473,70080,0,0,2,0,2
87342,200,22851,27808,70080,0,0,1,0,1
87343,200,22857,28340,70080,0,0,1,0,1
87344,200,22859,28463;31640,70080,1,0,1,0,2
87345,200,22861,28520;28999;30911,70080,0,1,2,0,3
87346,200,22862,28521;28587;31242;31564;31645;31717,70080,2,2,2,0,6
87347,200,22864,28565;28708;31715,70080,1,0,2,0,3
87348,200,22865,28224,70080,0,0,1,0,1
87349,200,22866,28541;28569,70080,0,0,2,0,2
87350,200,22867,28736;29248,70080,0,0,2,0,2
87351,200,22868,28704;29156;31855,70080,1,0,2,0,3
87352,200,22869,28722;29016;30806;31424;31842,70080,1,2,2,0,5
87353,200,22870,28369;28756,70080,0,0,2,0,2
87354,200,22871,28349;28791;30996,70080,0,1,2,0,3
87355,200,22872,28531;28818;30544,70080,0,0,3,0,3
87356,200,22874,29194;29209;32011,70080,1,0,2,0,3
87357,200,22875,28985;29501;31784,70080,1,0,2,0,3
87358,200,22876,28677;28854;31581;31663,70080,1,1,2,0,4
87359,200,22877,29064;29185;31674;31993,70080,2,0,2,0,4
87360,200,22878,28826;29070;31262;31676,70080,1,1,2,0,4
87361,200,22879,28769;29086,70080,0,0,2,0,2
87362,200,22880,28662;29088;31597,70080,0,1,2,0,3
87363,200,22881,29119;29120,70080,0,0,2,0,2
87364,200,22882,28686;29126;30809;31762,70080,1,1,2,0,4
87365,200,22883,29418,70080,0,0,1,0,1
87366,200,22884,29146;29423;31942,70080,1,0,2,0,3
87367,200,22885,29157;29213,70080,0,0,2,0,2
87368,200,22886,29214;29244;31606;31684,70080,1,1,2,0,4
87369,200,22887,29241;29563;31452,70080,0,1,2,0,3
87370,200,22888,29325;29538;31449,70080,0,1,2,0,3
87371,200,22889,29367;29447;31519,70080,0,1,2,0,3
87372,200,22890,29376;29572;32021,70080,1,0,2,0,3
87373,200,22891,29377;29584,70080,0,0,2,0,2
87374,200,22892,29382;29481;32023,70080,1,0,2,0,3
87375,200,22893,29409;29694;31952,70080,1,0,2,0,3
87376,200,22894,29430;31179,70080,0,1,1,0,2
87377,200,22895,29618,70080,0,0,1,0,1
87378,200,22896,29442;29573;31876,70080,1,0,2,0,3
87379,200,22897,29457,70080,0,0,1,0,1
87380,200,22898,29380,70080,0,0,1,0,1
87381,200,22899,29712,70080,0,0,1,0,1
87382,200,22900,29533;29795,70080,0,0,2,0,2
87383,200,22901,29586;29645;32035,70080,1,0,2,0,3
87384,200,22902,29506;29591,70080,0,0,2,0,2
87385,200,22903,29316;29596,70080,0,0,2,0,2
87386,200,22904,29843,70080,0,0,1,0,1
87387,200,22905,29593;29608,70080,0,0,2,0,2
87388,200,22906,29414;29617,70080,0,0,2,0,2
87389,200,22907,25571,70445,0,0,0,1,1
87390,200,22908,25842,70445,0,0,0,1,1
87391,200,22909,25775,70445,0,0,0,1,1
87392,200,22911,25466,70445,0,0,0,1,1
87393,200,22913,25995,70445,0,0,1,0,1
87394,200,22914,25815,70445,0,0,0,1,1
87395,200,22916,25907,70445,0,0,0,1,1
87396,200,22917,26241;26467,70445,0,0,2,0,2
87397,200,22920,25909,70445,0,0,0,1,1
87398,200,22921,26518,70445,0,0,1,0,1
87399,200,22923,26527,70445,0,0,1,0,1
87400,200,22926,26392;26555,70445,0,0,2,0,2
87401,200,22932,27414,70445,0,0,1,0,1
87402,200,22933,27375,70445,0,0,1,0,1
87403,200,22935,27535;27546;29881;30496;30831;31533,70445,0,2,4,0,6
87404,200,22941,27825,70445,0,0,1,0,1
87405,200,22944,27755,70445,0,0,1,0,1
87406,200,22946,27827;28198;30439;31134,70445,0,1,3,0,4
87407,200,22949,28238;28577;31818,70445,1,0,2,0,3
87408,200,22950,27793,70445,0,0,1,0,1
87409,200,22953,28419;28655;31484,70445,0,1,2,0,3
87410,200,22955,28402,70445,0,0,1,0,1
87411,200,22956,28433,70445,0,0,1,0,1
87412,200,22958,29318;29328,70445,0,0,2,0,2
87413,200,22959,28726;28727;31333;31656,70445,1,1,2,0,4
87414,200,22960,28730;29369,70445,0,0,2,0,2
87415,200,22961,28770,70445,0,0,1,0,1
87416,200,22962,28778;28943;31836,70445,1,0,2,0,3
87417,200,22963,28794,70445,0,0,1,0,1
87418,200,22964,28856;28877;30999;31830;31983,70445,2,1,2,0,5
87419,200,22966,28625;28899;30796;31157;31974,70445,1,2,2,0,5
87420,200,22967,28914;29340,70445,0,0,2,0,2
87421,200,22968,28989;29304,70445,0,0,2,0,2
87422,200,22969,29373;29558,70445,0,0,2,0,2
87423,200,22970,29076;31846,70445,1,0,1,0,2
87424,200,22972,28963;29090;30910;31496,70445,0,2,2,0,4
87425,200,22973,29114;29440;31272,70445,0,1,2,0,3
87426,200,22974,29128,70445,0,0,1,0,1
87427,200,22975,28908;29143;30913,70445,0,1,2,0,3
87428,200,22976,29173;29424;31270;32022,70445,1,1,2,0,4
87429,200,22977,29012;29179;31857,70445,1,0,2,0,3
87430,200,22978,29186;29720;32039,70445,1,0,2,0,3
87431,200,22979,28984,70445,0,0,1,0,1
87432,200,22980,29276;29284;31515;31934,70445,1,1,2,0,4
87433,200,22981,29033;29309;31688;32018,70445,2,0,2,0,4
87434,200,22982,29263;29358;31771,70445,1,0,2,0,3
87435,200,22983,29379;31269,70445,0,1,1,0,2
87436,200,22984,29471,70445,0,0,1,0,1
87437,200,22985,29385;29875;31881;32046,70445,2,0,2,0,4
87438,200,22986,29183,70445,0,0,1,0,1
87439,200,22987,29403;29452;31692,70445,1,0,2,0,3
87440,200,22988,29095;29408;31443,70445,0,1,2,0,3
87441,200,22989,29271;29443;31691,70445,1,0,2,0,3
87442,200,22990,29467;29627,70445,0,0,2,0,2
87443,200,22991,29473;29611,70445,0,0,2,0,2
87444,200,22992,29478;29602,70445,0,0,2,0,2
87445,200,22993,29468;29520;31275,70445,0,1,2,0,3
87446,200,22994,29531;31873,70445,1,0,1,0,2
87447,200,22995,29537,70445,0,0,1,0,1
87448,200,22996,29444;29575;31182,70445,0,1,2,0,3
87449,200,22997,29485;29589;31526,70445,0,1,2,0,3
87450,200,22998,29654;29710,70445,0,0,2,0,2
87451,200,22999,29628;29982;31960,70445,1,0,2,0,3
87452,200,23000,29938,70445,0,0,1,0,1
87453,200,23001,29630;29636,70445,0,0,2,0,2
87454,200,23002,29604;29640;31528;32034,70445,1,1,2,0,4
87455,200,23003,29644;29856,70445,0,0,2,0,2
87456,200,23004,29671,70445,0,0,1,0,1
87457,200,23005,29690;31622,70445,0,1,1,0,2
87458,200,23006,29540;29693;31951,70445,1,0,2,0,3
87459,200,23007,29698;29879,70445,0,0,2,0,2
87460,200,23008,29487;29783,70445,0,0,2,0,2
87461,200,23009,29523;29707,70445,0,0,2,0,2
87462,200,23010,29736,70445,0,0,1,0,1
87463,200,23011,25526,70810,0,0,0,1,1
87464,200,23012,25567,70810,0,0,0,1,1
87465,200,23014,25854,70810,0,0,0,1,1
87466,200,23015,26082,70810,0,0,1,0,1
87467,200,23016,26025;26091,70810,0,0,2,0,2
87468,200,23018,26305;26477,70810,0,0,2,0,2
87469,200,23019,26441,70810,0,0,1,0,1
87470,200,23021,26132,70810,0,0,1,0,1
87471,200,23022,26175,70810,0,0,1,0,1
87472,200,23023,26382;26541,70810,0,0,2,0,2
87473,200,23025,26797,70810,0,0,1,0,1
87474,200,23026,27204,70810,0,0,1,0,1
87475,200,23029,27105,70810,0,0,1,0,1
87476,200,23030,26971;27361,70810,0,0,2,0,2
87477,200,23031,27606,70810,0,0,1,0,1
87478,200,23033,27716,70810,0,0,1,0,1
87479,200,23035,27880,70810,0,0,1,0,1
87480,200,23037,27627;28008,70810,0,0,2,0,2
87481,200,23040,28361,70810,0,0,1,0,1
87482,200,23041,28374,70810,0,0,1,0,1
87483,200,23043,28457,70810,0,0,1,0,1
87484,200,23044,28563;28887;30721,70810,0,1,2,0,3
87485,200,23046,28450;28664,70810,0,0,2,0,2
87486,200,23048,28758;28928,70810,0,0,2,0,2
87487,200,23049,28891;29347,70810,0,0,2,0,2
87488,200,23050,28619;28803;31574,70810,0,1,2,0,3
87489,200,23051,28669;28866;31421,70810,0,1,2,0,3
87490,200,23053,28936;28981;31667,70810,1,0,2,0,3
87491,200,23054,28998,70810,0,0,1,0,1
87492,200,23055,29043;29546;31450,70810,0,1,2,0,3
87493,200,23056,29046;29525;31276;31617,70810,0,2,2,0,4
87494,200,23057,29077;29102;31003,70810,0,1,2,0,3
87495,200,23058,29093;29164;31427;31598;31995,70810,1,2,2,0,5
87496,200,23059,29148;29668,70810,0,0,2,0,2
87497,200,23060,29182,70810,0,0,1,0,1
87498,200,23061,28573;28764,70810,0,0,2,0,2
87499,200,23062,28993;29329,70810,0,0,2,0,2
87500,200,23063,29375,70810,0,0,1,0,1
87501,200,23064,29437;29539,70810,0,0,2,0,2
87502,200,23065,29448;29495;31353;31522,70810,0,2,2,0,4
87503,200,23066,29496;32026,70810,1,0,1,0,2
87504,200,23067,29477;29530;31782,70810,1,0,2,0,3
87505,200,23068,29532,70810,0,0,1,0,1
87506,200,23069,29559;29680;31874,70810,1,0,2,0,3
87507,200,23070,29579;29595;31618,70810,0,1,2,0,3
87508,200,23071,29384;29635,70810,0,0,2,0,2
87509,200,23072,29085;29649;31453,70810,0,1,2,0,3
87510,200,23073,29653;29678,70810,0,0,2,0,2
87511,200,23074,29364;29695;31953,70810,1,0,2,0,3
87512,200,23075,29655;29709;31623,70810,0,1,2,0,3
87513,200,23076,29378;29995,70810,0,0,2,0,2
87514,200,23077,29732;30027,70810,0,0,2,0,2
87515,200,23078,29733,70810,0,0,1,0,1
87516,200,23079,29755;29756;31696;31793,70810,2,0,2,0,4
87517,200,23080,25483,71175,0,0,0,1,1
87518,200,23081,25889,71175,0,0,0,1,1
87519,200,23082,25917,71175,0,0,0,1,1
87520,200,23083,25455,71175,0,0,0,1,1
87521,200,23086,25825,71175,0,0,0,1,1
87522,200,23087,26156,71175,0,0,1,0,1
87523,200,23088,26315,71175,0,0,1,0,1
87524,200,23089,26468,71175,0,0,1,0,1
87525,200,23091,26334;26586,71175,0,0,2,0,2
87526,200,23094,26727,71175,0,0,1,0,1
87527,200,23098,27010,71175,0,0,1,0,1
87528,200,23103,27325,71175,0,0,1,0,1
87529,200,23104,27454,71175,0,0,1,0,1
87530,200,23105,27487,71175,0,0,1,0,1
87531,200,23108,27712;27740,71175,0,0,2,0,2
87532,200,23111,28431,71175,0,0,1,0,1
87533,200,23112,28311,71175,0,0,1,0,1
87534,200,23113,28482,71175,0,0,1,0,1
87535,200,23114,28586,71175,0,0,1,0,1
87536,200,23115,28695,71175,0,0,1,0,1
87537,200,23116,28875;28978;31497;31668,71175,1,1,2,0,4
87538,200,23117,28925;29155;31503;31925;32004,71175,2,1,2,0,5
87539,200,23118,29072;29115,71175,0,0,2,0,2
87540,200,23119,29136;29218,71175,0,0,2,0,2
87541,200,23120,29171;29286,71175,0,0,2,0,2
87542,200,23121,29192;29221,71175,0,0,2,0,2
87543,200,23122,29199;29453;31175,71175,0,1,2,0,3
87544,200,23123,29222;29389;31613,71175,0,1,2,0,3
87545,200,23124,29232;29446,71175,0,0,2,0,2
87546,200,23125,29240;31509;31933,71175,1,1,1,0,3
87547,200,23126,29259;29647,71175,0,0,2,0,2
87548,200,23127,29387;29536,71175,0,0,2,0,2
87549,200,23128,29330;31865;31939,71175,2,0,1,0,3
87550,200,23129,29343;29679,71175,0,0,2,0,2
87551,200,23130,29791,71175,0,0,1,0,1
87552,200,23131,29401,71175,0,0,1,0,1
87553,200,23132,29404;29910;32048,71175,1,0,2,0,3
87554,200,23133,29407;29491;32025,71175,1,0,2,0,3
87555,200,23134,29529;32030,71175,1,0,1,0,2
87556,200,23135,29512;29846;31880,71175,1,0,2,0,3
87557,200,23136,29515;29691,71175,0,0,2,0,2
87558,200,23137,29570;30000,71175,0,0,2,0,2
87559,200,23138,29610;29646;31791,71175,1,0,2,0,3
87560,200,23139,29663;30061,71175,0,0,2,0,2
87561,200,23140,29462;29670,71175,0,0,2,0,2
87562,200,23141,29726;29912;32050,71175,1,0,2,0,3
87563,200,23142,29555;29740;31792,71175,1,0,2,0,3
87564,200,23143,29625;29757;31789,71175,1,0,2,0,3
87565,200,23144,29359,71175,0,0,1,0,1
87566,200,23145,29811;29968,71175,0,0,2,0,2
87567,200,23146,29817;29966,71175,0,0,2,0,2
87568,200,23147,29832;29950,71175,0,0,2,0,2
87569,200,23148,29833;29906,71175,0,0,2,0,2
87570,200,23149,29470;29855,71175,0,0,2,0,2
87571,200,23150,29860;30122,71175,0,0,2,0,2
87572,200,23151,25776,71540,0,0,0,1,1
87573,200,23152,26100,71540,0,0,1,0,1
87574,200,23159,26757;26880,71540,0,0,2,0,2
87575,200,23161,26562,71540,0,0,1,0,1
87576,200,23164,27244,71540,0,0,1,0,1
87577,200,23166,27267,71540,0,0,1,0,1
87578,200,23167,27056,71540,0,0,1,0,1
87579,200,23169,27350,71540,0,0,1,0,1
87580,200,23170,27609,71540,0,0,1,0,1
87581,200,23171,27538,71540,0,0,1,0,1
87582,200,23173,27914,71540,0,0,1,0,1
87583,200,23174,27815,71540,0,0,1,0,1
87584,200,23175,28187,71540,0,0,1,0,1
87585,200,23176,28170,71540,0,0,1,0,1
87586,200,23177,27940,71540,0,0,1,0,1
87587,200,23178,28331;28547;30792,71540,0,1,2,0,3
87588,200,23179,28351,71540,0,0,1,0,1
87589,200,23180,28360,71540,0,0,1,0,1
87590,200,23181,28666,71540,0,0,1,0,1
87591,200,23182,28650,71540,0,0,1,0,1
87592,200,23185,28706,71540,0,0,1,0,1
87593,200,23186,28474;28787,71540,0,0,2,0,2
87594,200,23188,28279,71540,0,0,1,0,1
87595,200,23189,28869,71540,0,0,1,0,1
87596,200,23190,28883;28934;31587,71540,0,1,2,0,3
87597,200,23191,28897,71540,0,0,1,0,1
87598,200,23192,28902;29103,71540,0,0,2,0,2
87599,200,23194,29004;29122;31759;32000,71540,2,0,2,0,4
87600,200,23195,28780;29087;31994,71540,1,0,2,0,3
87601,200,23196,29073;29096;31174,71540,0,1,2,0,3
87602,200,23197,29105;31501;31849,71540,1,1,1,0,3
87603,200,23198,29363;31775;31941,71540,2,0,1,0,3
87604,200,23199,29778,71540,0,0,1,0,1
87605,200,23200,28850;29279;31438,71540,0,1,2,0,3
87606,200,23201,29288,71540,0,0,1,0,1
87607,200,23202,29187;29345,71540,0,0,2,0,2
87608,200,23203,28917;29323,71540,0,0,2,0,2
87609,200,23204,29352;29362;31518,71540,0,1,2,0,3
87610,200,23205,29436;29648;32036,71540,1,0,2,0,3
87611,200,23206,29463;29581,71540,0,0,2,0,2
87612,200,23207,28994,71540,0,0,1,0,1
87613,200,23208,29560;29735,71540,0,0,2,0,2
87614,200,23209,29374;29592,71540,0,0,2,0,2
87615,200,23210,29003;29594,71540,0,0,2,0,2
87616,200,23211,29619;30052,71540,0,0,2,0,2
87617,200,23212,29599,71540,0,0,1,0,1
87618,200,23213,29673;30157,71540,0,0,2,0,2
87619,200,23214,29687,71540,0,0,1,0,1
87620,200,23215,29161;29689,71540,0,0,2,0,2
87621,200,23216,29130,71540,0,0,1,0,1
87622,200,23217,29702;30155,71540,0,0,2,0,2
87623,200,23218,29703;29863;31797,71540,1,0,2,0,3
87624,200,23219,29370;31441;31776,71540,1,1,1,0,3
87625,200,23220,29729;30053,71540,0,0,2,0,2
87626,200,23221,29763,71540,0,0,1,0,1
87627,200,23222,29762,71540,0,0,1,0,1
87628,200,23223,29767;29980,71540,0,0,2,0,2
87629,200,23224,29774;29988,71540,0,0,2,0,2
87630,200,23225,29780;29986,71540,0,0,2,0,2
87631,200,23226,29455;29792,71540,0,0,2,0,2
87632,200,23227,29801;30149,71540,0,0,2,0,2
87633,200,23228,29804,71540,0,0,1,0,1
87634,200,23229,29806,71540,0,0,1,0,1
87635,200,23230,29819,71540,0,0,1,0,1
87636,200,23231,29797;29825,71540,0,0,2,0,2
87637,200,23232,29829;29854;31531,71540,0,1,2,0,3
87638,200,23233,29836;30006,71540,0,0,2,0,2
87639,200,23234,29853;30051;31883,71540,1,0,2,0,3
87640,200,23235,29553;29857;32044,71540,1,0,2,0,3
87641,200,23236,29858;29989,71540,0,0,2,0,2
87642,200,23237,29830;29861,71540,0,0,2,0,2
87643,200,23238,29894;30013,71540,0,0,2,0,2
87644,200,23239,29903;30040,71540,0,0,2,0,2
87645,200,23240,29904;30251,71540,0,0,2,0,2
87646,200,23241,29933;30045,71540,0,0,2,0,2
87647,200,23242,29816;29985,71540,0,0,2,0,2
87648,200,23244,26171,71905,0,0,1,0,1
87649,200,23245,25895,71905,0,0,0,1,1
87650,200,23246,25992,71905,0,0,1,0,1
87651,200,23249,25897,71905,0,0,0,1,1
87652,200,23251,26038,71905,0,0,1,0,1
87653,200,23255,27036,71905,0,0,1,0,1
87654,200,23256,27057,71905,0,0,1,0,1
87655,200,23258,27154,71905,0,0,1,0,1
87656,200,23259,27310,71905,0,0,1,0,1
87657,200,23260,27354,71905,0,0,1,0,1
87658,200,23261,27526,71905,0,0,1,0,1
87659,200,23262,27631,71905,0,0,1,0,1
87660,200,23263,27570,71905,0,0,1,0,1
87661,200,23265,28015,71905,0,0,1,0,1
87662,200,23266,27490,71905,0,0,1,0,1
87663,200,23267,28208,71905,0,0,1,0,1
87664,200,23268,27885,71905,0,0,1,0,1
87665,200,23271,28460,71905,0,0,1,0,1
87666,200,23272,28592,71905,0,0,1,0,1
87667,200,23273,28806;28888;31494,71905,0,1,2,0,3
87668,200,23274,28675,71905,0,0,1,0,1
87669,200,23275,29050;29315;31937,71905,1,0,2,0,3
87670,200,23276,28808;29062;31595,71905,0,1,2,0,3
87671,200,23277,28973;29079;31343;31426;31847,71905,1,2,2,0,5
87672,200,23278,29326;29472;31615,71905,0,1,2,0,3
87673,200,23279,29094,71905,0,0,1,0,1
87674,200,23280,29417;29785,71905,0,0,2,0,2
87675,200,23281,29449,71905,0,0,1,0,1
87676,200,23283,29381;29510;32028,71905,1,0,2,0,3
87677,200,23284,29508;29514;31448,71905,0,1,2,0,3
87678,200,23285,29383,71905,0,0,1,0,1
87679,200,23286,29548;29754;32040,71905,1,0,2,0,3
87680,200,23287,29439,71905,0,0,1,0,1
87681,200,23288,29651;30102,71905,0,0,2,0,2
87682,200,23289,29708;29915,71905,0,0,2,0,2
87683,200,23290,29727,71905,0,0,1,0,1
87684,200,23291,29741;29809;31624,71905,0,1,2,0,3
87685,200,23292,29758;30026,71905,0,0,2,0,2
87686,200,23293,29764;29784,71905,0,0,2,0,2
87687,200,23294,29802;30035,71905,0,0,2,0,2
87688,200,23295,29509;29820;31625,71905,0,1,2,0,3
87689,200,23296,29831;30066,71905,0,0,2,0,2
87690,200,23297,29667;29872;32038,71905,1,0,2,0,3
87691,200,23298,29902;29956;31697,71905,1,0,2,0,3
87692,200,23299,29961;30341,71905,0,0,2,0,2
87693,200,23300,30014,71905,0,0,1,0,1
87694,200,23301,30005;30170,71905,0,0,2,0,2
87695,200,23302,30012;30257,71905,0,0,2,0,2
87696,200,23303,30020;30038;31456,71905,0,1,2,0,3
87697,200,23304,29738;30043,71905,0,0,2,0,2
87698,200,23305,30056;30206,71905,0,0,2,0,2
87699,200,23306,26212,72270,0,0,1,0,1
87700,200,23307,26312,72270,0,0,1,0,1
87701,200,23308,26602;26653,72270,0,0,2,0,2
87702,200,23309,26625,72270,0,0,1,0,1
87703,200,23310,26405;26505,72270,0,0,2,0,2
87704,200,23311,26570,72270,0,0,1,0,1
87705,200,23313,26799,72270,0,0,1,0,1
87706,200,23314,26769,72270,0,0,1,0,1
87707,200,23315,26784,72270,0,0,1,0,1
87708,200,23316,26897,72270,0,0,1,0,1
87709,200,23317,27096,72270,0,0,1,0,1
87710,200,23318,26953;27063,72270,0,0,2,0,2
87711,200,23319,27440,72270,0,0,1,0,1
87712,200,23320,27556,72270,0,0,1,0,1
87713,200,23321,27583,72270,0,0,1,0,1
87714,200,23323,27701,72270,0,0,1,0,1
87715,200,23324,27732,72270,0,0,1,0,1
87716,200,23325,27817,72270,0,0,1,0,1
87717,200,23326,27682,72270,0,0,1,0,1
87718,200,23330,27737,72270,0,0,1,0,1
87719,200,23331,27646,72270,0,0,1,0,1
87720,200,23333,28159,72270,0,0,1,0,1
87721,200,23334,28024,72270,0,0,1,0,1
87722,200,23335,27883,72270,0,0,1,0,1
87723,200,23336,28257,72270,0,0,1,0,1
87724,200,23337,28242,72270,0,0,1,0,1
87725,200,23338,28421;28601;30794;30985;31244;31326;31483,72270,0,5,2,0,7
87726,200,23339,28495;28761;31657,72270,1,0,2,0,3
87727,200,23340,28498;29091;31087,72270,0,1,2,0,3
87728,200,23341,28533,72270,0,0,1,0,1
87729,200,23342,28684,72270,0,0,1,0,1
87730,200,23343,28765;29583;31525,72270,0,1,2,0,3
87731,200,23344,28890;29336,72270,0,0,2,0,2
87732,200,23346,29150;29550,72270,0,0,2,0,2
87733,200,23347,29166;29317,72270,0,0,2,0,2
87734,200,23348,29245;29721,72270,0,0,2,0,2
87735,200,23349,29162;29274;31264;31602;32006,72270,1,2,2,0,5
87736,200,23350,29321;29808;31878,72270,1,0,2,0,3
87737,200,23351,29357,72270,0,0,1,0,1
87738,200,23353,29704,72270,0,0,1,0,1
87739,200,23354,29054,72270,0,0,1,0,1
87740,200,23355,29438;29490,72270,0,0,2,0,2
87741,200,23356,29814,72270,0,0,1,0,1
87742,200,23357,29247;29469,72270,0,0,2,0,2
87743,200,23358,28958,72270,0,0,1,0,1
87744,200,23359,29197;29590;31695,72270,1,0,2,0,3
87745,200,23360,29479,72270,0,0,1,0,1
87746,200,23361,29504;29746,72270,0,0,2,0,2
87747,200,23362,29751;30042,72270,0,0,2,0,2
87748,200,23363,29752;30086,72270,0,0,2,0,2
87749,200,23364,29535;29765,72270,0,0,2,0,2
87750,200,23365,29686;29768;31794,72270,1,0,2,0,3
87751,200,23366,29781;30015;31955,72270,1,0,2,0,3
87752,200,23367,29742,72270,0,0,1,0,1
87753,200,23368,29877;30344,72270,0,0,2,0,2
87754,200,23369,29885;30081,72270,0,0,2,0,2
87755,200,23370,29896;29940,72270,0,0,2,0,2
87756,200,23371,29901;29976,72270,0,0,2,0,2
87757,200,23372,29914;30183,72270,0,0,2,0,2
87758,200,23374,29921;29974,72270,0,0,2,0,2
87759,200,23375,29629,72270,0,0,1,0,1
87760,200,23376,29945;29947,72270,0,0,2,0,2
87761,200,23377,29770;29949,72270,0,0,2,0,2
87762,200,23378,29803;29973,72270,0,0,2,0,2
87763,200,23379,29975,72270,0,0,1,0,1
87764,200,23380,29822;30004,72270,0,0,2,0,2
87765,200,23381,29898;30032,72270,0,0,2,0,2
87766,200,23382,30033;30222,72270,0,0,2,0,2
87767,200,23383,30034,72270,0,0,1,0,1
87768,200,23384,30050;30171,72270,0,0,2,0,2
87769,200,23385,30068;30383,72270,0,0,2,0,2
87770,200,23386,30088;30186,72270,0,0,2,0,2
87771,200,23387,30097,72270,0,0,1,0,1
87772,200,23388,30108;30334,72270,0,0,2,0,2
87773,200,23389,30136,72270,0,0,1,0,1
87774,200,23390,30116,72270,0,0,1,0,1
87775,200,23391,29953;30119;31885,72270,1,0,2,0,3
87776,200,23392,30105;30111,72270,0,0,2,0,2
87777,200,23393,30117;30137;32052,72270,1,0,2,0,3
87778,200,23394,30340,72270,0,0,1,0,1
87779,200,23395,30163;30304,72270,0,0,2,0,2
87780,200,23396,26277,72635,0,0,1,0,1
87781,200,23398,26854,72635,0,0,1,0,1
87782,200,23400,27242,72635,0,0,1,0,1
87783,200,23401,27231,72635,0,0,1,0,1
87784,200,23403,27512,72635,0,0,1,0,1
87785,200,23404,27654,72635,0,0,1,0,1
87786,200,23405,27754,72635,0,0,1,0,1
87787,200,23406,27847,72635,0,0,1,0,1
87788,200,23407,27873,72635,0,0,1,0,1
87789,200,23408,27426,72635,0,0,1,0,1
87790,200,23409,27952,72635,0,0,1,0,1
87791,200,23410,27984;28606;31328;31819,72635,1,1,2,0,4
87792,200,23411,28125,72635,0,0,1,0,1
87793,200,23412,27787,72635,0,0,1,0,1
87794,200,23413,28264,72635,0,0,1,0,1
87795,200,23414,28503,72635,0,0,1,0,1
87796,200,23415,28289;28385,72635,0,0,2,0,2
87797,200,23416,28246,72635,0,0,1,0,1
87798,200,23417,28425,72635,0,0,1,0,1
87799,200,23419,28292,72635,0,0,1,0,1
87800,200,23420,29048,72635,0,0,1,0,1
87801,200,23421,27982,72635,0,0,1,0,1
87802,200,23422,28911,72635,0,0,1,0,1
87803,200,23423,28344,72635,0,0,1,0,1
87804,200,23424,29041,72635,0,0,1,0,1
87805,200,23425,28990;29208;31348;31506;32010,72635,1,2,2,0,5
87806,200,23426,29224;29683;31529,72635,0,1,2,0,3
87807,200,23427,29225;29672;31357,72635,0,1,2,0,3
87808,200,23428,29236;29445;31446;31945,72635,1,1,2,0,4
87809,200,23429,29311;29524;31616;31694,72635,1,1,2,0,4
87810,200,23430,29045;29334;31689,72635,1,0,2,0,3
87811,200,23431,29361,72635,0,0,1,0,1
87812,200,23432,29140,72635,0,0,1,0,1
87813,200,23433,29441,72635,0,0,1,0,1
87814,200,23434,29405,72635,0,0,1,0,1
87815,200,23435,29492,72635,0,0,1,0,1
87816,200,23436,29577;29796,72635,0,0,2,0,2
87817,200,23437,29713;29925,72635,0,0,2,0,2
87818,200,23438,29734;29794;31956,72635,1,0,2,0,3
87819,200,23439,29562;29739,72635,0,0,2,0,2
87820,200,23440,29674;29771;31279,72635,0,1,2,0,3
87821,200,23441,29233,72635,0,0,1,0,1
87822,200,23442,29807;31455,72635,0,1,1,0,2
87823,200,23443,29838;30150,72635,0,0,2,0,2
87824,200,23444,29868;29922;32045,72635,1,0,2,0,3
87825,200,23445,29869;30198,72635,0,0,2,0,2
87826,200,23446,29850;29899,72635,0,0,2,0,2
87827,200,23447,29936,72635,0,0,1,0,1
87828,200,23448,29460;29930,72635,0,0,2,0,2
87829,200,23449,29952;30147,72635,0,0,2,0,2
87830,200,23450,29977;30062,72635,0,0,2,0,2
87831,200,23451,29878;29984,72635,0,0,2,0,2
87832,200,23452,30031;30515,72635,0,0,2,0,2
87833,200,23453,29642;30065;31801,72635,1,0,2,0,3
87834,200,23454,29962;30071;31698,72635,1,0,2,0,3
87835,200,23455,30003;30076,72635,0,0,2,0,2
87836,200,23456,29931;30134,72635,0,0,2,0,2
87837,200,23457,30054;30140,72635,0,0,2,0,2
87838,200,23458,30158;30411,72635,0,0,2,0,2
87839,200,23459,30162,72635,0,0,1,0,1
87840,200,23460,30174;30207,72635,0,0,2,0,2
87841,200,23461,30101;30178,72635,0,0,2,0,2
87842,200,23462,30194;30358,72635,0,0,2,0,2
87843,200,23463,29905;30211,72635,0,0,2,0,2
87844,200,23464,29824;30216,72635,0,0,2,0,2
87845,200,23465,29848;30233,72635,0,0,2,0,2
87846,200,23466,30001;30249,72635,0,0,2,0,2
87847,200,23467,26780,73000,0,0,1,0,1
87848,200,23468,26597,73000,0,0,1,0,1
87849,200,23469,26621,73000,0,0,1,0,1
87850,200,23470,26646,73000,0,0,1,0,1
87851,200,23471,26660,73000,0,0,1,0,1
87852,200,23472,26711,73000,0,0,1,0,1
87853,200,23473,26736,73000,0,0,1,0,1
87854,200,23475,26841,73000,0,0,1,0,1
87855,200,23476,26871,73000,0,0,1,0,1
87856,200,23477,27234,73000,0,0,1,0,1
87857,200,23478,27276,73000,0,0,1,0,1
87858,200,23479,26912,73000,0,0,1,0,1
87859,200,23480,27507,73000,0,0,1,0,1
87860,200,23481,27496,73000,0,0,1,0,1
87861,200,23482,27494,73000,0,0,1,0,1
87862,200,23483,27418,73000,0,0,1,0,1
87863,200,23484,27016,73000,0,0,1,0,1
87864,200,23485,27481,73000,0,0,1,0,1
87865,200,23486,27595,73000,0,0,1,0,1
87866,200,23487,27728,73000,0,0,1,0,1
87867,200,23488,27785,73000,0,0,1,0,1
87868,200,23489,27802,73000,0,0,1,0,1
87869,200,23490,27759,73000,0,0,1,0,1
87870,200,23491,28364,73000,0,0,1,0,1
87871,200,23492,27921,73000,0,0,1,0,1
87872,200,23493,28197,73000,0,0,1,0,1
87873,200,23494,28382,73000,0,0,1,0,1
87874,200,23496,28146,73000,0,0,1,0,1
87875,200,23497,28315,73000,0,0,1,0,1
87876,200,23498,28036,73000,0,0,1,0,1
87877,200,23499,28608,73000,0,0,1,0,1
87878,200,23500,28905,73000,0,0,1,0,1
87879,200,23501,29038,73000,0,0,1,0,1
87880,200,23502,28920;29165;31768;31926,73000,2,0,2,0,4
87881,200,23503,28950,73000,0,0,1,0,1
87882,200,23504,28982,73000,0,0,1,0,1
87883,200,23505,28966;29075,73000,0,0,2,0,2
87884,200,23506,29129;29169;32008,73000,1,0,2,0,3
87885,200,23507,28977,73000,0,0,1,0,1
87886,200,23508,29353,73000,0,0,1,0,1
87887,200,23509,29212,73000,0,0,1,0,1
87888,200,23510,29307;29499;31783,73000,1,0,2,0,3
87889,200,23511,29527,73000,0,0,1,0,1
87890,200,23512,29534;29837;31626,73000,0,1,2,0,3
87891,200,23513,29337,73000,0,0,1,0,1
87892,200,23514,29609;29960,73000,0,0,2,0,2
87893,200,23515,29715;29958,73000,0,0,2,0,2
87894,200,23516,29730;30141;31627,73000,0,1,2,0,3
87895,200,23517,29603,73000,0,0,1,0,1
87896,200,23518,29844;30145,73000,0,0,2,0,2
87897,200,23519,29883;30307,73000,0,0,2,0,2
87898,200,23520,29346;29890;31882,73000,1,0,2,0,3
87899,200,23521,29909;30152,73000,0,0,2,0,2
87900,200,23522,29928;30195,73000,0,0,2,0,2
87901,200,23523,29601;29955,73000,0,0,2,0,2
87902,200,23524,29884;29972,73000,0,0,2,0,2
87903,200,23525,29981,73000,0,0,1,0,1
87904,200,23526,29867;29993,73000,0,0,2,0,2
87905,200,23527,29965;30093;31800,73000,1,0,2,0,3
87906,200,23528,30009;30112,73000,0,0,2,0,2
87907,200,23529,30129;30232,73000,0,0,2,0,2
87908,200,23530,30146;30298,73000,0,0,2,0,2
87909,200,23531,30154;30618,73000,0,1,1,0,2
87910,200,23532,29920;30167,73000,0,0,2,0,2
87911,200,23533,30175,73000,0,0,1,0,1
87912,200,23534,30193;30200,73000,0,0,2,0,2
87913,200,23535,30202;30523,73000,0,0,2,0,2
87914,200,23536,29818;30210,73000,0,0,2,0,2
87915,200,23537,30191;30215,73000,0,0,2,0,2
87916,200,23538,30223,73000,0,0,1,0,1
87917,200,23539,30231;30582,73000,0,1,1,0,2
87918,200,23540,30252;30289,73000,0,0,2,0,2
87919,200,23541,30288;30316,73000,0,0,2,0,2
87920,200,23542,30239;30290;32058,73000,1,0,2,0,3
87921,200,23543,30256;30291,73000,0,0,2,0,2
87922,200,23544,30293;30574,73000,0,1,1,0,2
87923,200,23545,30059;30296,73000,0,0,2,0,2
87924,200,23546,30308;30436,73000,0,0,2,0,2
87925,200,23547,29943;30320,73000,0,0,2,0,2
87926,200,23548,30333;30353,73000,0,0,2,0,2
87927,200,23549,30287;30347,73000,0,0,2,0,2
87928,200,23550,30348;30462,73000,0,0,2,0,2
87929,200,23551,30356;30423,73000,0,0,2,0,2
