ind,time,household_id,member,household_founded,infant,school_age,adult,retired,household_size
0,0,0,1;2;3,0,0,1,1,1,3
1,0,1,4;5;6;7,0,0,2,1,1,4
2,0,2,8;9;10;11;12;13,0,0,2,2,2,6
3,0,3,14;15,0,0,0,2,0,2
4,0,4,16;17;18,0,1,0,1,1,3
5,0,5,19,0,0,0,0,1,1
6,0,6,20;21;22,0,0,0,3,0,3
7,0,7,23;24,0,0,0,1,1,2
8,0,8,25;26,0,0,0,2,0,2
9,0,9,27;28;29,0,1,0,2,0,3
10,0,10,30,0,0,0,1,0,1
11,0,11,31;32,0,0,0,1,1,2
12,0,12,33;34;35;36;37;38,0,0,3,2,1,6
13,0,13,39;2497,0,0,0,2,0,2
14,0,14,40;41;42;43;44,0,1,0,4,0,5
15,0,15,45;46;47;48;49;50,0,0,1,5,0,6
16,0,16,51;52;10032,0,1,0,1,1,3
17,0,17,53;54;55;56;57,0,2,2,1,0,5
18,0,18,58,0,0,0,1,0,1
19,0,19,59;60;61,0,1,0,1,1,3
20,0,20,62;63;64;65;10076,0,1,2,2,0,5
21,0,21,66;67,0,0,0,1,1,2
22,0,22,68;70;71,0,0,0,3,0,3
23,0,23,72;73;74;75,0,0,2,2,0,4
24,0,24,76;77,0,0,0,0,2,2
25,0,25,78;79;80;81,0,1,1,2,0,4
26,0,26,82;83;84,0,0,1,0,2,3
27,0,27,85;86;87,0,1,0,2,0,3
28,0,28,88;89;90,0,0,2,0,1,3
29,0,29,91;92;93;94,0,2,0,2,0,4
30,0,30,95,0,0,0,1,0,1
31,0,31,96;97,0,0,0,2,0,2
32,0,32,98,0,0,0,1,0,1
33,0,33,99;100,0,0,0,2,0,2
34,0,34,101;102;103,0,0,0,1,2,3
35,0,35,104;105;106;107,0,0,1,2,1,4
36,0,36,108;109;110;111;112;113,0,1,2,3,0,6
37,0,37,114;115;116,0,0,1,2,0,3
38,0,38,117;118;119;120,0,1,1,2,0,4
39,0,39,121;122;123,0,0,0,1,2,3
40,0,40,124;125,0,0,0,2,0,2
41,0,41,126;127,0,0,0,0,2,2
42,0,42,128;129;130,0,0,0,2,1,3
43,0,43,131;132,0,0,0,2,0,2
44,0,44,133;134;135;136,0,2,0,2,0,4
45,0,45,137,0,0,0,1,0,1
46,0,46,138,0,0,0,1,0,1
47,0,47,139;140,0,0,0,1,1,2
48,0,48,141,0,0,0,1,0,1
49,0,49,142;143;144;145;146;147,0,0,1,4,1,6
50,0,50,148;149,0,0,0,1,1,2
51,0,51,150,0,0,0,1,0,1
52,0,52,151;153,0,0,1,1,0,2
53,0,53,154;155,0,0,0,2,0,2
54,0,54,156;157;158;159;160,0,1,1,2,1,5
55,0,55,162;163,0,0,1,1,0,2
56,0,56,164,0,0,0,1,0,1
57,0,57,165;166,0,0,0,2,0,2
58,0,58,167;168;169;170,0,2,0,1,1,4
59,0,59,171;172,0,0,0,2,0,2
60,0,60,173;174;175,0,0,1,1,1,3
61,0,61,176;177;178;179;180;181;182;183,0,0,4,4,0,8
62,0,62,185;186,0,0,0,1,1,2
63,0,63,187;188;189,0,0,1,1,1,3
64,0,64,190;191;192,0,0,0,3,0,3
65,0,65,193;194,0,0,0,2,0,2
66,0,66,195;196,0,0,0,1,1,2
67,0,67,197;198;199,0,0,1,1,1,3
68,0,68,200;201;202;203;204;205,0,0,1,5,0,6
69,0,69,206;207,0,0,0,2,0,2
70,0,70,208,0,0,0,0,1,1
71,0,71,209;210,0,0,0,2,0,2
72,0,72,211;212;213,0,0,2,0,1,3
73,0,73,214;215;216;217;218;219,0,2,2,2,0,6
74,0,74,221,0,0,0,1,0,1
75,0,75,222,0,0,0,0,1,1
76,0,76,223;224;225,0,0,0,1,2,3
77,0,77,226;227;228,0,1,0,2,0,3
78,0,78,229;230;231;232,0,0,0,4,0,4
79,0,79,233;234;235,0,0,0,3,0,3
80,0,80,236;237;238;239;240,0,0,1,3,1,5
81,0,81,241;242,0,0,0,2,0,2
82,0,82,243;244,0,0,0,2,0,2
83,0,83,245;246;247,0,0,1,1,1,3
84,0,84,248;249;250;10054,0,1,1,2,0,4
85,0,85,251;252,0,0,0,2,0,2
86,0,86,253;254,0,0,0,2,0,2
87,0,87,255,0,0,0,1,0,1
88,0,88,256;257,0,0,0,0,2,2
89,0,90,259;260;261;262,0,0,0,4,0,4
90,0,91,263,0,0,0,0,1,1
91,0,92,264,0,0,0,1,0,1
92,0,93,265;266;267;268,0,1,0,2,1,4
93,0,94,269;270;271;272,0,0,1,3,0,4
94,0,95,273;274,0,0,0,0,2,2
95,0,96,275;276;277;278,0,0,2,2,0,4
96,0,97,279,0,0,0,1,0,1
97,0,98,280,0,0,0,1,0,1
98,0,99,281;283,0,0,0,2,0,2
99,0,100,284;285,0,0,0,2,0,2
100,0,101,286;287,0,0,0,2,0,2
101,0,102,288;289,0,0,0,2,0,2
102,0,103,290;291;292;293;294,0,0,2,1,2,5
103,0,104,295;296,0,0,0,2,0,2
104,0,105,297,0,0,0,1,0,1
105,0,106,298;300,0,0,0,1,1,2
106,0,107,301;302,0,0,0,2,0,2
107,0,108,303,0,0,0,1,0,1
108,0,109,304;305;306,0,0,0,3,0,3
109,0,110,308;309;310;311,0,0,0,3,1,4
110,0,111,312;313;314;315;316,0,0,1,3,1,5
111,0,112,317;318;319;320,0,2,0,2,0,4
112,0,113,321;322,0,0,0,2,0,2
113,0,114,323;324,0,0,0,1,1,2
114,0,115,325;326,0,0,0,2,0,2
115,0,116,327,0,0,0,1,0,1
116,0,117,328,0,0,0,0,1,1
117,0,118,329;330;331;332;333;334,0,1,1,4,0,6
118,0,119,335;336;337,0,0,0,3,0,3
119,0,120,338,0,0,0,0,1,1
120,0,121,339;340,0,0,0,1,1,2
121,0,122,341;342,0,0,0,1,1,2
122,0,123,343,0,0,0,1,0,1
123,0,124,344;345,0,0,0,2,0,2
124,0,125,346;347;348;349;350,0,0,3,2,0,5
125,0,126,351,0,0,0,0,1,1
126,0,127,352,0,0,0,1,0,1
127,0,128,353;354;355;356;357,0,0,3,1,1,5
128,0,129,358;359;360;361,0,0,1,3,0,4
129,0,130,362,0,0,0,1,0,1
130,0,131,363;364,0,0,0,2,0,2
131,0,132,365;366;367,0,1,0,1,1,3
132,0,133,368;369;370;371,0,0,0,3,1,4
133,0,134,372;10110,0,1,0,1,0,2
134,0,135,373,0,0,0,0,1,1
135,0,136,374;375;376;377;378;379,0,1,1,2,2,6
136,0,137,380,0,0,0,1,0,1
137,0,138,381;382;383,0,1,0,2,0,3
138,0,139,384;385;386,0,1,0,2,0,3
139,0,140,387,0,0,0,1,0,1
140,0,141,388;389;390,0,0,1,2,0,3
141,0,142,391;392;393,0,0,0,2,1,3
142,0,143,394,0,0,0,1,0,1
143,0,144,395;396;397,0,0,0,2,1,3
144,0,145,398;399,0,0,0,1,1,2
145,0,146,400,0,0,0,1,0,1
146,0,148,402;403;404;405,0,1,1,2,0,4
147,0,149,406,0,0,0,1,0,1
148,0,150,407;408;409;410,0,0,0,2,2,4
149,0,151,411,0,0,0,1,0,1
150,0,152,412;413;414;8202,0,0,1,3,0,4
151,0,153,415,0,0,0,0,1,1
152,0,154,416,0,0,0,1,0,1
153,0,155,417,0,0,0,1,0,1
154,0,156,418;419;420;421,0,0,1,3,0,4
155,0,157,422;424,0,0,0,2,0,2
156,0,158,425;426,0,0,0,2,0,2
157,0,159,427;428,0,0,0,2,0,2
158,0,160,429;430;431,0,1,1,0,1,3
159,0,161,432;433;434,0,0,0,2,1,3
160,0,162,435;436,0,0,0,2,0,2
161,0,163,437;438;439;440,0,0,1,3,0,4
162,0,164,441;443;444,0,0,1,1,1,3
163,0,165,445;446;447;448,0,2,0,2,0,4
164,0,166,449;450,0,0,0,1,1,2
165,0,167,451;452,0,0,0,1,1,2
166,0,168,453;454,0,0,0,2,0,2
167,0,169,455;456;457;458;459;460;461,0,1,0,4,2,7
168,0,170,462;463,0,0,0,1,1,2
169,0,171,464;465;466;467,0,0,0,4,0,4
170,0,172,468;469,0,0,0,0,2,2
171,0,173,470,0,0,1,0,0,1
172,0,174,471;472,0,0,0,1,1,2
173,0,175,473;474;475;476;477,0,2,1,1,1,5
174,0,176,478;479;480;1390,0,0,2,2,0,4
175,0,177,481;482,0,0,0,2,0,2
176,0,178,483;484;485;486;487;488;489;490,0,0,2,5,1,8
177,0,179,491;493;494,0,2,0,1,0,3
178,0,180,495,0,0,0,1,0,1
179,0,181,496;497,0,0,0,2,0,2
180,0,182,498;499,0,0,0,2,0,2
181,0,183,500,0,0,0,1,0,1
182,0,184,501;502;503,0,0,1,1,1,3
183,0,185,504;505,0,0,0,1,1,2
184,0,186,506,0,0,0,1,0,1
185,0,187,507;508,0,0,0,1,1,2
186,0,188,509;510;511;512;513,0,0,2,3,0,5
187,0,189,514;515;516;517,0,0,1,2,1,4
188,0,190,518;519;520,0,0,0,3,0,3
189,0,191,521;522;523;524,0,0,0,3,1,4
190,0,192,526;527;528,0,0,0,1,2,3
191,0,193,529;530,0,0,0,1,1,2
192,0,194,531,0,0,0,1,0,1
193,0,195,532,0,0,0,1,0,1
194,0,196,533,0,0,0,0,1,1
195,0,197,534;535;536;537;10065,0,1,2,2,0,5
196,0,198,538;539,0,0,0,2,0,2
197,0,199,540;541;542,0,0,0,3,0,3
198,0,200,543;544;545;546,0,2,0,2,0,4
199,0,201,547;548;550,0,0,0,2,1,3
200,0,202,551,0,0,0,1,0,1
201,0,203,553;554,0,0,0,1,1,2
202,0,204,555;556;557;558,0,0,0,1,3,4
203,0,205,559;560;561;562,0,1,1,0,2,4
204,0,206,563;564,0,0,0,1,1,2
205,0,207,566;567;568,0,0,1,2,0,3
206,0,208,569,0,0,0,1,0,1
207,0,209,570;571,0,0,0,2,0,2
208,0,210,572;573;574,0,1,0,2,0,3
209,0,211,575;8570,0,0,0,2,0,2
210,0,212,576,0,0,0,1,0,1
211,0,213,577;578,0,0,1,0,1,2
212,0,214,579,0,0,0,1,0,1
213,0,215,580,0,0,0,0,1,1
214,0,216,581;583;584;10031,0,1,1,2,0,4
215,0,217,585;586;587,0,0,0,2,1,3
216,0,218,588;589;590,0,0,0,3,0,3
217,0,219,591;592;593;594,0,0,0,3,1,4
218,0,220,595;596,0,0,0,2,0,2
219,0,221,597,0,0,0,1,0,1
220,0,222,599;600,0,0,0,1,1,2
221,0,223,601;602;603;604,0,1,1,2,0,4
222,0,224,605,0,0,0,1,0,1
223,0,225,606;607,0,0,0,0,2,2
224,0,226,609,0,0,0,1,0,1
225,0,227,610;611;612;613,0,2,0,2,0,4
226,0,228,614;615;616;617,0,0,1,3,0,4
227,0,229,618;619,0,0,0,1,1,2
228,0,230,620,0,0,0,1,0,1
229,0,231,621;622;10113,0,1,0,1,1,3
230,0,232,623,0,0,0,1,0,1
231,0,233,624;625;626,0,0,0,3,0,3
232,0,234,627,0,0,0,0,1,1
233,0,235,628;629;630;631;632,0,2,1,2,0,5
234,0,236,633;634,0,0,0,1,1,2
235,0,237,635;636,0,0,0,2,0,2
236,0,238,637;638;639,0,0,1,1,1,3
237,0,239,640;641;642;643,0,0,1,2,1,4
238,0,240,644;645,0,0,0,1,1,2
239,0,241,646;647;648,0,0,1,2,0,3
240,0,242,649,0,0,0,0,1,1
241,0,243,650;651;652;653,0,2,0,2,0,4
242,0,244,654,0,0,0,0,1,1
243,0,245,655;656;657,0,0,0,3,0,3
244,0,246,658,0,0,0,1,0,1
245,0,247,659;660,0,0,0,2,0,2
246,0,248,661;662,0,0,0,1,1,2
247,0,249,663;664;665,0,1,0,0,2,3
248,0,250,666;667,0,0,0,2,0,2
249,0,251,668;669,0,0,0,2,0,2
250,0,252,670,0,0,0,1,0,1
251,0,253,671;672;673;674,0,0,1,2,1,4
252,0,254,675;676;10075,0,1,0,2,0,3
253,0,255,677;678;679;680,0,0,1,2,1,4
254,0,256,681;682;683;684;685;686,0,0,2,4,0,6
255,0,257,687;688;10062,0,1,0,2,0,3
256,0,258,689,0,0,0,1,0,1
257,0,259,690,0,0,0,0,1,1
258,0,260,691;692,0,0,0,1,1,2
259,0,261,693,0,0,0,0,1,1
260,0,262,694;695,0,0,0,2,0,2
261,0,263,696,0,0,0,0,1,1
262,0,264,697;698,0,0,0,2,0,2
263,0,265,699;700;701;702,0,0,0,3,1,4
264,0,266,703;704;705;706,0,0,1,1,2,4
265,0,267,707,0,0,0,1,0,1
266,0,268,708,0,0,0,1,0,1
267,0,269,709;710,0,0,0,2,0,2
268,0,270,711;712;713;714,0,0,1,2,1,4
269,0,271,715,0,0,0,1,0,1
270,0,272,716;717,0,0,0,1,1,2
271,0,273,718;719;720;721,0,0,2,1,1,4
272,0,274,722;723,0,0,0,2,0,2
273,0,275,725;726;727;728,0,0,0,3,1,4
274,0,276,729;730;731;732,0,0,0,3,1,4
275,0,277,733;734;735;736,0,0,0,2,2,4
276,0,278,737,0,0,0,1,0,1
277,0,279,738,0,0,0,1,0,1
278,0,280,739;740,0,1,0,0,1,2
279,0,281,741;742,0,0,0,2,0,2
280,0,282,743,0,0,0,0,1,1
281,0,283,744;745;10071,0,1,0,1,1,3
282,0,284,746;747,0,0,0,2,0,2
283,0,285,748,0,0,0,1,0,1
284,0,286,749;750;751;752;753,0,0,3,1,1,5
285,0,287,754,0,0,0,0,1,1
286,0,288,755;756,0,0,0,1,1,2
287,0,289,757;758,0,0,0,2,0,2
288,0,290,759,0,0,0,1,0,1
289,0,291,760,0,0,0,1,0,1
290,0,292,761;762,0,0,0,2,0,2
291,0,293,763;8159,0,0,0,2,0,2
292,0,294,764;765,0,0,1,1,0,2
293,0,295,767,0,0,0,1,0,1
294,0,296,768;769;770;771,0,0,1,1,2,4
295,0,297,772;773;774,0,0,2,1,0,3
296,0,298,775;776;777;778,0,0,0,3,1,4
297,0,299,779;780;781,0,0,0,3,0,3
298,0,300,782;783,0,0,0,2,0,2
299,0,301,784;785;786;787,0,0,1,1,2,4
300,0,302,788,0,0,0,1,0,1
301,0,303,789,0,0,0,1,0,1
302,0,304,790;791;792;793;794;795,0,0,3,2,1,6
303,0,305,796;797;798,0,0,0,3,0,3
304,0,306,799;800;801;802;803;804;10048,0,3,2,2,0,7
305,0,307,805,0,0,0,1,0,1
306,0,308,806;807,0,0,0,2,0,2
307,0,309,808;809;810;811,0,0,1,2,1,4
308,0,310,812;813,0,0,0,2,0,2
309,0,311,814;815,0,0,0,2,0,2
310,0,312,816,0,0,0,1,0,1
311,0,313,817;818;819,0,0,0,2,1,3
312,0,314,820,0,0,0,1,0,1
313,0,315,821;822,0,0,0,2,0,2
314,0,316,823,0,0,0,1,0,1
315,0,317,824;826;827;828;829,0,0,1,1,3,5
316,0,318,830;831,0,0,0,2,0,2
317,0,319,832;833,0,0,0,2,0,2
318,0,320,834,0,0,0,1,0,1
319,0,321,835;836;837;838;839,0,1,2,2,0,5
320,0,322,840;841,0,0,0,1,1,2
321,0,323,842;843;844,0,0,0,2,1,3
322,0,324,845;846;847;848,0,0,0,2,2,4
323,0,325,849,0,0,0,0,1,1
324,0,326,851;852;853,0,0,1,2,0,3
325,0,327,854;855,0,0,0,2,0,2
326,0,328,856,0,0,0,0,1,1
327,0,329,857;858;859;860,0,0,0,2,2,4
328,0,330,861;862;863;864;865,0,1,1,3,0,5
329,0,331,866;867,0,0,0,2,0,2
330,0,332,868;869;870;871,0,0,1,3,0,4
331,0,333,872;873;874,0,0,0,2,1,3
332,0,334,875;876;877;878,0,1,1,2,0,4
333,0,335,879;880,0,0,0,2,0,2
334,0,336,881;882,0,0,0,2,0,2
335,0,337,883;884,0,0,0,2,0,2
336,0,338,885;886,0,0,0,2,0,2
337,0,339,887;888;889;890;891;892,0,0,3,2,1,6
338,0,340,893;894;895;896,0,0,1,3,0,4
339,0,341,897;898,0,0,1,0,1,2
340,0,342,899;900;901;902;903,0,0,1,2,2,5
341,0,343,904;905,0,0,0,1,1,2
342,0,344,906;907;908;909,0,1,0,3,0,4
343,0,345,910,0,0,0,0,1,1
344,0,346,911,0,0,0,1,0,1
345,0,347,912;913,0,0,0,1,1,2
346,0,348,914;915,0,0,0,1,1,2
347,0,349,916,0,0,0,1,0,1
348,0,350,917;918;919;920;921,0,0,2,1,2,5
349,0,351,922;923,0,0,0,1,1,2
350,0,352,924;925,0,0,0,2,0,2
351,0,353,926;927;928;929,0,0,1,2,1,4
352,0,354,930;931;932;933;7734,0,0,2,3,0,5
353,0,355,934;935;936,0,0,0,1,2,3
354,0,356,937;938,0,0,0,1,1,2
355,0,357,939;940,0,0,0,2,0,2
356,0,358,941;942;943;944;945,0,0,2,2,1,5
357,0,359,946,0,0,0,1,0,1
358,0,360,947,0,0,0,1,0,1
359,0,361,948;949;950;951;952;953;10109,0,2,0,5,0,7
360,0,362,954;955,0,0,0,2,0,2
361,0,363,956;957;958;959;960,0,1,1,1,2,5
362,0,364,961;962;963;964,0,0,0,3,1,4
363,0,365,965;966,0,0,0,1,1,2
364,0,366,967;968,0,0,0,2,0,2
365,0,367,969;970;971;972;973;975;976;977;978,0,0,0,6,3,9
366,0,368,980;981;982,0,0,1,0,2,3
367,0,369,983;984;985;986;987;988,0,1,2,3,0,6
368,0,370,989;990,0,0,0,2,0,2
369,0,371,991,0,0,0,1,0,1
370,0,372,992;993,0,0,0,1,1,2
371,0,373,994;995,0,0,0,2,0,2
372,0,374,996,0,0,0,1,0,1
373,0,375,997;998,0,0,0,1,1,2
374,0,376,999;1000;1001,0,0,1,2,0,3
375,0,377,1002;1003,0,0,0,1,1,2
376,0,378,1004;1005,0,0,0,2,0,2
377,0,379,1007;1008;1009;1010,0,0,1,2,1,4
378,0,380,1011,0,0,0,0,1,1
379,0,381,1012;1013,0,0,0,2,0,2
380,0,382,1014;1015;1016,0,0,1,1,1,3
381,0,383,1017;1018,0,0,0,0,2,2
382,0,384,1019,0,0,0,1,0,1
383,0,385,1020;1021,0,0,0,2,0,2
384,0,386,1022,0,0,0,0,1,1
385,0,387,1023;1024;1025;1026;1027,0,1,1,2,1,5
386,0,388,1028;1029;1030;1031;1032,0,0,1,4,0,5
387,0,389,1033;1034;1035,0,1,0,1,1,3
388,0,390,1036,0,0,0,1,0,1
389,0,391,1037;1038,0,0,0,0,2,2
390,0,392,1039;6796,0,0,0,2,0,2
391,0,393,1040;1041;1042;1043;1044;1045,0,2,0,2,2,6
392,0,394,1046,0,0,0,1,0,1
393,0,395,1047;1048;1049;1050;1051,0,3,0,1,1,5
394,0,396,1052;1054;1055;1056,0,0,1,3,0,4
395,0,397,1057,0,0,0,1,0,1
396,0,398,1058,0,0,0,1,0,1
397,0,399,1059;1060;1061,0,0,0,3,0,3
398,0,400,1062;1063;1064;1065,0,0,1,3,0,4
399,0,401,1066,0,0,0,0,1,1
400,0,402,1067;1068,0,0,0,1,1,2
401,0,403,1069;1070;1071,0,0,0,2,1,3
402,0,404,1072;1073;1074,0,0,0,2,1,3
403,0,405,1075,0,0,0,1,0,1
404,0,406,1076;1077,0,0,0,2,0,2
405,0,407,1078,0,0,0,1,0,1
406,0,408,1079,0,0,0,0,1,1
407,0,409,1080;1081,0,0,0,2,0,2
408,0,410,1082;5953;10015,0,1,0,2,0,3
409,0,411,1083;1084,0,0,1,1,0,2
410,0,412,1085;1086,0,0,0,2,0,2
411,0,413,1087;6231,0,0,0,2,0,2
412,0,414,1088;1089,0,0,0,2,0,2
413,0,415,1090;1091;1092;1093,0,2,0,1,1,4
414,0,416,1094;1095;1096,0,0,1,2,0,3
415,0,417,1097;1098;1099;1100,0,0,2,1,1,4
416,0,418,1101;1102,0,0,0,2,0,2
417,0,419,1103;1104,0,0,1,0,1,2
418,0,420,1105;1106;1107,0,1,0,2,0,3
419,0,421,1108,0,0,0,1,0,1
420,0,422,1109;1110,0,0,0,1,1,2
421,0,423,1111;1112,0,0,0,2,0,2
422,0,424,1113;1114;1115;1116,0,0,1,3,0,4
423,0,425,1117,0,0,0,1,0,1
424,0,426,1118,0,0,0,1,0,1
425,0,427,1119;1120;1121;1122;1123,0,0,2,1,2,5
426,0,428,1124;1125,0,0,0,2,0,2
427,0,429,1126;1127;1128,0,0,0,0,3,3
428,0,430,1129;1130,0,0,0,2,0,2
429,0,431,258;1131,0,0,0,2,0,2
430,0,432,1132;1133;1134,0,0,1,1,1,3
431,0,433,1135;1136,0,0,1,1,0,2
432,0,434,1137;1138;1139;1140;1141,0,0,3,2,0,5
433,0,435,1142;1143;1144,0,1,0,1,1,3
434,0,436,1145;1146;1147;1148,0,0,2,1,1,4
435,0,437,1149;1150;1151;1152,0,1,1,0,2,4
436,0,438,1153;1154,0,0,0,1,1,2
437,0,439,1155;1156;1157;1158,0,1,1,1,1,4
438,0,440,1159;1160;1161;1162;1163;1164,0,1,2,2,1,6
439,0,441,1165;1166;1167;1168;1169,0,0,1,3,1,5
440,0,442,1170,0,0,0,0,1,1
441,0,443,1171,0,0,0,0,1,1
442,0,444,1173;1174,0,0,0,1,1,2
443,0,445,1175;1176,0,0,0,2,0,2
444,0,446,1177,0,0,0,0,1,1
445,0,447,1178;1179,0,0,0,2,0,2
446,0,448,1180;1181,0,0,0,2,0,2
447,0,449,1182,0,0,0,1,0,1
448,0,450,1183;1184,0,0,0,1,1,2
449,0,451,1185;1186,0,0,0,2,0,2
450,0,452,1187;1188,0,0,0,1,1,2
451,0,453,1189;1190;1191;1192,0,2,0,2,0,4
452,0,454,1193,0,0,0,1,0,1
453,0,455,1194;1195;1196;1197,0,0,0,3,1,4
454,0,456,1198;5210,0,0,0,2,0,2
455,0,457,1199;1200;1201,0,0,0,2,1,3
456,0,458,1202;1203,0,0,0,1,1,2
457,0,459,1204,0,0,0,1,0,1
458,0,460,1205;1206;1207;1208;1209,0,0,0,4,1,5
459,0,461,1210;1211;1212;1213,0,0,2,2,0,4
460,0,462,1214;1215;1216;1217;1218,0,0,3,2,0,5
461,0,463,1219,0,0,0,1,0,1
462,0,464,1220;1221,0,0,0,2,0,2
463,0,465,1222,0,0,0,1,0,1
464,0,466,1223;1224,0,0,0,2,0,2
465,0,467,1225;1226;1227,0,0,0,3,0,3
466,0,468,1228;1229;1230;1231,0,1,0,2,1,4
467,0,469,1232,0,0,0,0,1,1
468,0,470,1233;1234;1235;1236,0,0,2,1,1,4
469,0,471,1237;1238;1239,0,0,2,0,1,3
470,0,472,1240;1241;1242,0,1,0,1,1,3
471,0,473,1243;1244;1245;1246;1247,0,0,0,3,2,5
472,0,474,1248;1249;1250;1251;1252,0,0,2,2,1,5
473,0,475,1253,0,0,0,0,1,1
474,0,476,1255;1256,0,0,0,2,0,2
475,0,477,1257;1258;1259,0,0,0,2,1,3
476,0,478,1260,0,1,0,0,0,1
477,0,479,1261;1262;1263,0,0,1,1,1,3
478,0,480,1264;1265;1266;1267,0,2,0,2,0,4
479,0,481,1268;1269;1270,0,0,1,1,1,3
480,0,482,1271;1273;1274,0,0,0,1,2,3
481,0,483,1275;1276,0,0,0,2,0,2
482,0,484,1277;1278,0,0,0,2,0,2
483,0,485,1279;1280,0,0,0,1,1,2
484,0,486,1281,0,0,0,0,1,1
485,0,487,1282;1283;1284,0,1,0,1,1,3
486,0,488,1285;1287;1288,0,0,2,1,0,3
487,0,489,1289,0,0,0,0,1,1
488,0,490,1290;1291,0,0,0,2,0,2
489,0,491,1292;1293;1294;1295;1296,0,0,1,2,2,5
490,0,492,1298;1299;1300;1301,0,0,1,2,1,4
491,0,493,1302;1303;1304;1305,0,1,1,1,1,4
492,0,494,1306;1307;1308,0,2,0,1,0,3
493,0,495,1309;1310,0,0,0,2,0,2
494,0,496,1311;1312;1313;1314,0,0,2,1,1,4
495,0,497,1315;1316;1317;1318,0,0,1,3,0,4
496,0,498,1319;1320;1321,0,0,1,1,1,3
497,0,499,1322,0,0,0,0,1,1
498,0,500,1323;1324,0,0,0,2,0,2
499,0,501,1325;1326,0,0,0,0,2,2
500,0,502,1327;1328,0,0,1,1,0,2
501,0,503,1329,0,0,0,1,0,1
502,0,504,1330;1332;1333;1334,0,1,1,2,0,4
503,0,505,1335;1336,0,0,0,1,1,2
504,0,506,1337,0,0,0,0,1,1
505,0,507,1338;1339,0,0,1,1,0,2
506,0,508,1340;1341,0,0,0,2,0,2
507,0,509,1342;1343;1344;1345,0,1,1,1,1,4
508,0,510,1346;1347;1348,0,0,0,2,1,3
509,0,511,1349;1350;1351;1352,0,0,2,0,2,4
510,0,512,1353;1354;1355,0,0,0,2,1,3
511,0,513,1356;1357;1358;1359;1360,0,2,0,1,2,5
512,0,514,1361;1362;1363;1364,0,0,1,2,1,4
513,0,515,1365,0,0,0,1,0,1
514,0,516,1366;1367;1368,0,0,0,3,0,3
515,0,517,1369;1370;1371;1372,0,0,1,3,0,4
516,0,518,1373;1374;10081,0,1,0,2,0,3
517,0,519,1375;1376,0,0,2,0,0,2
518,0,520,1377,0,0,0,0,1,1
519,0,521,1378;1379,0,0,0,0,2,2
520,0,522,1380;1381;1382,0,1,0,1,1,3
521,0,523,1383,0,0,0,1,0,1
522,0,524,1384;1385;1386;1387;1388,0,1,2,2,0,5
523,0,525,1389,0,0,0,0,1,1
524,0,527,1391,0,0,0,1,0,1
525,0,528,1392;1393,0,0,0,2,0,2
526,0,529,1394;1395;1396,0,0,0,1,2,3
527,0,530,1397;1398;1399,0,0,1,2,0,3
528,0,531,1400;1401,0,0,0,2,0,2
529,0,532,1402;1403,0,0,0,1,1,2
530,0,533,1404,0,0,0,0,1,1
531,0,534,1405;1406;10086,0,1,0,1,1,3
532,0,535,1407;1408,0,0,0,2,0,2
533,0,536,1409;1410,0,0,0,2,0,2
534,0,537,1411;1412,0,0,0,1,1,2
535,0,538,1413;1414;1415;1416,0,0,1,1,2,4
536,0,539,1417;1418;1419;1420;1421,0,0,0,3,2,5
537,0,540,1422;1423;1424,0,0,0,3,0,3
538,0,541,1425;1426;1427;1428,0,1,1,0,2,4
539,0,542,1429;1430;1432,0,1,0,0,2,3
540,0,543,1433,0,0,0,1,0,1
541,0,544,1434,0,0,0,0,1,1
542,0,545,1435;1436,0,0,0,2,0,2
543,0,546,1437;1438,0,0,0,2,0,2
544,0,547,1439;1440,0,0,0,2,0,2
545,0,548,1441,0,0,0,1,0,1
546,0,549,1442;1443,0,0,0,2,0,2
547,0,550,1444,0,0,0,1,0,1
548,0,551,1445;1446;1447,0,0,0,2,1,3
549,0,552,1448;1450;1451;1452,0,1,2,1,0,4
550,0,553,1453;7690,0,0,0,2,0,2
551,0,554,1454;1455,0,0,0,1,1,2
552,0,555,1456;1457;1458,0,0,0,2,1,3
553,0,556,1459;1460;1461,0,1,0,2,0,3
554,0,557,1462;1463,0,0,0,1,1,2
555,0,558,1464;10111,0,1,0,1,0,2
556,0,559,1465;1466;1467;1468,0,2,0,2,0,4
557,0,560,1469;1470;1471;1472,0,1,1,2,0,4
558,0,561,1473;1474,0,0,0,1,1,2
559,0,562,1475;1476;1477;1478,0,0,2,1,1,4
560,0,563,1480,0,0,0,1,0,1
561,0,564,1481;1482,0,0,0,2,0,2
562,0,565,1483;1484;1485;1486;10058,0,1,2,1,1,5
563,0,566,1487;1488;1489,0,0,0,2,1,3
564,0,567,1491;1492;1493,0,1,0,1,1,3
565,0,568,1494;1495;1496,0,0,0,3,0,3
566,0,569,1497;1498;1499;1500,0,0,1,2,1,4
567,0,570,1501,0,0,0,0,1,1
568,0,571,1502,0,0,0,1,0,1
569,0,572,1503;1504;1505,0,0,0,1,2,3
570,0,573,1506,0,0,0,1,0,1
571,0,574,1507;1508;1509,0,0,0,2,1,3
572,0,575,1510;1511,0,0,0,1,1,2
573,0,576,1513;1514;1515,0,0,1,2,0,3
574,0,577,1516;1517,0,0,0,2,0,2
575,0,578,1518;1519,0,0,0,1,1,2
576,0,579,1520;1521;1522,0,0,1,2,0,3
577,0,580,1523;1524;1525;1526,0,0,2,2,0,4
578,0,581,1527;1528,0,0,0,1,1,2
579,0,582,1529,0,0,0,1,0,1
580,0,583,1530;1531;1532,0,0,0,2,1,3
581,0,584,1533;1534;1535;1536;1537;1538,0,1,3,2,0,6
582,0,585,1539;1540;1541;1542,0,0,0,4,0,4
583,0,586,1543;1544;1545,0,1,1,0,1,3
584,0,587,1546;1547;1548,0,0,1,2,0,3
585,0,588,1549,0,0,0,1,0,1
586,0,589,1550;1551,0,0,0,2,0,2
587,0,590,1552;1553;10064,0,1,0,1,1,3
588,0,591,1554;1555;1556;1670,0,1,0,3,0,4
589,0,592,1557;1558,0,0,0,2,0,2
590,0,593,1559;1560,0,0,0,2,0,2
591,0,594,1561;1562;1563;1564;1565,0,2,0,3,0,5
592,0,595,1566;1567,0,0,0,2,0,2
593,0,596,1568;1570;1571;1572,0,0,2,0,2,4
594,0,597,1573;1574;1575,0,0,1,1,1,3
595,0,598,1576;1577,0,1,0,0,1,2
596,0,599,1578,0,0,0,0,1,1
597,0,600,1579;1580,0,0,0,1,1,2
598,0,601,1581,0,0,0,1,0,1
599,0,602,1582;1583;1584,0,0,1,1,1,3
600,0,603,1585;1586;1587,0,0,0,2,1,3
601,0,604,1588;1590;1591;1592,0,0,1,2,1,4
602,0,605,1593;1594,0,0,0,2,0,2
603,0,606,1595,0,0,0,1,0,1
604,0,607,1596,0,0,0,1,0,1
605,0,608,1597;1598;1599,0,0,1,2,0,3
606,0,609,1600,0,0,0,0,1,1
607,0,610,1601;1602;1603;1604,0,1,1,1,1,4
608,0,611,1605;1606,0,0,0,2,0,2
609,0,612,1607;1608;1609,0,0,2,1,0,3
610,0,613,1610;1611;1612;1613,0,0,0,4,0,4
611,0,614,1614;1615;1616;1617;1618;1619,0,2,0,3,1,6
612,0,615,1620;1621;1622;1623,0,2,0,2,0,4
613,0,616,1624;1625,0,0,0,2,0,2
614,0,617,1626;1627,0,0,0,1,1,2
615,0,618,1628;1629;1630,0,0,1,2,0,3
616,0,619,1631;1632,0,0,0,2,0,2
617,0,620,1633;1634,0,0,0,2,0,2
618,0,621,1635;1636;1637,0,0,1,2,0,3
619,0,622,1638;1639;1640,0,0,1,1,1,3
620,0,623,1641;1642,0,0,0,1,1,2
621,0,624,1643;1644,0,0,0,1,1,2
622,0,625,1645;1646;1647;1648;1649,0,0,1,3,1,5
623,0,626,1650;1651;1652;1653;1654;1655,0,0,3,2,1,6
624,0,627,1656;1657,0,0,0,1,1,2
625,0,628,1658,0,0,0,1,0,1
626,0,629,1659,0,0,0,1,0,1
627,0,630,1660;1661,0,0,0,2,0,2
628,0,631,1662;1663,0,1,0,0,1,2
629,0,632,1664;1665;1666;1667;1668,0,2,1,1,1,5
630,0,634,1672;1673;1674,0,0,0,1,2,3
631,0,635,1675,0,0,0,1,0,1
632,0,636,1676,0,0,0,0,1,1
633,0,637,1677;1678,0,0,0,2,0,2
634,0,638,1679;1680;1681;1682,0,1,0,2,1,4
635,0,639,1684;1685,0,0,0,2,0,2
636,0,640,1686;1687;1688;1689,0,0,0,2,2,4
637,0,641,1690;1691;1692;1693;1694,0,0,2,2,1,5
638,0,642,1695;1696;1697;1698;1699;1700,0,1,1,3,1,6
639,0,643,1701;1702,0,0,1,0,1,2
640,0,644,1703;1704;1705;1706;1707,0,0,3,1,1,5
641,0,645,1708;1709,0,0,0,1,1,2
642,0,646,1710;1711,0,0,0,1,1,2
643,0,647,1712;1713;1714,0,0,1,1,1,3
644,0,648,1715,0,0,0,1,0,1
645,0,649,1716;1717;1718;1719;1720;1721,0,2,1,3,0,6
646,0,650,1722;1723,0,0,0,2,0,2
647,0,651,1724;1725;1726;1727,0,1,1,1,1,4
648,0,652,1728;1729;1730;1731;1732,0,0,0,2,3,5
649,0,653,1733;1734,0,0,0,2,0,2
650,0,654,1735;1736;2465,0,0,0,3,0,3
651,0,655,1738;1739;1741,0,0,1,2,0,3
652,0,656,1742;1743,0,0,0,2,0,2
653,0,657,1744;1745;1746;1747,0,1,1,2,0,4
654,0,658,1748;1749;1750;1751,0,0,1,3,0,4
655,0,660,1754,0,0,0,1,0,1
656,0,661,1755;1756,0,0,1,0,1,2
657,0,662,1757;1758,0,0,0,1,1,2
658,0,663,1759;1760,0,0,0,2,0,2
659,0,664,1761;1762,0,0,0,1,1,2
660,0,665,1763;1764,0,0,0,1,1,2
661,0,666,1765;1766,0,0,1,1,0,2
662,0,667,1767;1768;1769;1770;1771,0,0,2,1,2,5
663,0,668,1772;1773;1774;1775;1776,0,0,1,3,1,5
664,0,669,1777;1778,0,0,0,1,1,2
665,0,670,1779;1780,0,0,0,1,1,2
666,0,671,1781;1782;1783;1784,0,0,0,4,0,4
667,0,672,1785;1786;1787;1788;1789,0,0,3,2,0,5
668,0,673,1790,0,0,0,1,0,1
669,0,674,1791,0,0,0,1,0,1
670,0,675,1792;1793,0,0,0,1,1,2
671,0,676,1794,0,0,0,0,1,1
672,0,677,1795;1796;1797,0,1,0,2,0,3
673,0,678,1798;1799,0,0,0,0,2,2
674,0,679,1800;1801;1802;1803,0,1,0,1,2,4
675,0,680,1804;1805,0,0,0,2,0,2
676,0,681,1806;1807;1808,0,1,0,0,2,3
677,0,682,1809;1810,0,0,0,2,0,2
678,0,683,1811,0,0,0,0,1,1
679,0,684,1812;1813;1814,0,0,1,2,0,3
680,0,685,1815,0,0,0,1,0,1
681,0,686,1816,0,0,0,1,0,1
682,0,687,1817;1818;1819,0,0,0,2,1,3
683,0,688,1820;1821;1822;1823;1824,0,0,1,3,1,5
684,0,689,1825,0,0,0,0,1,1
685,0,690,1827,0,0,0,1,0,1
686,0,691,1828,0,0,0,1,0,1
687,0,692,1829;1830;10041,0,1,0,2,0,3
688,0,693,1831,0,0,0,1,0,1
689,0,694,1832;1833;1834,0,0,0,1,2,3
690,0,695,1835;1836;1837,0,1,0,1,1,3
691,0,696,1838;1839;1840,0,1,0,2,0,3
692,0,697,1841;1842,0,0,0,2,0,2
693,0,698,1843,0,0,0,1,0,1
694,0,699,1844;1845;1846;1847,0,0,1,2,1,4
695,0,700,1849;1850;1851,0,0,0,1,2,3
696,0,701,1852,0,0,0,1,0,1
697,0,702,1853;1854,0,0,0,2,0,2
698,0,703,1855,0,0,0,0,1,1
699,0,704,1856;1857,0,0,0,2,0,2
700,0,705,1858;1859,0,0,0,1,1,2
701,0,706,1860;1861,0,0,0,1,1,2
702,0,707,1862;1863,0,0,0,1,1,2
703,0,708,1864;1865;1866,0,0,0,2,1,3
704,0,709,1867;1868,0,0,0,1,1,2
705,0,710,1869,0,0,0,1,0,1
706,0,711,1870,0,0,0,1,0,1
707,0,712,1871;1872;1873,0,0,0,2,1,3
708,0,713,1874;1875,0,0,0,2,0,2
709,0,714,1876;1877,0,0,0,2,0,2
710,0,715,1878;1879,0,0,0,1,1,2
711,0,716,1880;1881;1882;1883,0,1,0,3,0,4
712,0,717,1884,0,0,0,0,1,1
713,0,718,1885,0,0,0,0,1,1
714,0,719,1886;1887;1888;1889;1890,0,0,1,3,1,5
715,0,720,1891;1892;10047,0,1,0,2,0,3
716,0,721,1893;1894;1895,0,0,0,3,0,3
717,0,722,1896;1897,0,0,0,1,1,2
718,0,723,1898;1899;1901,0,0,0,3,0,3
719,0,724,1902;1903;1904,0,0,0,1,2,3
720,0,725,1905;1906,0,0,0,1,1,2
721,0,726,1908;1909,0,0,0,1,1,2
722,0,727,1910;1911;1912,0,0,0,2,1,3
723,0,728,1914;1915,0,0,0,2,0,2
724,0,729,1916,0,0,0,1,0,1
725,0,730,1917,0,0,0,1,0,1
726,0,731,1918;1919,0,0,0,1,1,2
727,0,732,1920;1921;1922,0,0,0,3,0,3
728,0,733,1923;1924;1925,0,0,1,2,0,3
729,0,734,1926;1927,0,0,0,1,1,2
730,0,735,1928;1929;1930,0,1,1,0,1,3
731,0,736,1931;1932;1933,0,0,2,1,0,3
732,0,737,1934,0,0,0,1,0,1
733,0,738,1935;1936,0,0,1,1,0,2
734,0,739,1937,0,0,0,1,0,1
735,0,740,1938;1939;1940,0,1,0,2,0,3
736,0,741,1941;1942;1943;1944,0,2,0,2,0,4
737,0,742,1945;1946;1947;1948;1949;1950,0,0,0,6,0,6
738,0,743,1952;1953,0,0,0,1,1,2
739,0,744,1954;1955,0,0,0,1,1,2
740,0,745,1956,0,0,0,0,1,1
741,0,746,1957,0,0,0,1,0,1
742,0,747,1958,0,0,0,1,0,1
743,0,748,1959,0,0,0,0,1,1
744,0,749,1961;1962;1963,0,0,2,0,1,3
745,0,750,1964;1965;1966,0,1,0,2,0,3
746,0,751,1967;1968,0,0,0,2,0,2
747,0,752,1969;1970,0,0,0,2,0,2
748,0,753,1971;1972;1973;1974,0,0,1,3,0,4
749,0,754,1975;1976;1977;1978;1979,0,0,1,4,0,5
750,0,755,1980;1981,0,0,0,2,0,2
751,0,756,1982;1983;1984;1985;1986;1987,0,0,2,2,2,6
752,0,757,1988;1990,0,0,1,1,0,2
753,0,758,1991,0,0,0,1,0,1
754,0,759,1993,0,0,0,1,0,1
755,0,760,1994;1995,0,0,0,1,1,2
756,0,762,1997;1998,0,0,0,2,0,2
757,0,763,1999,0,0,0,0,1,1
758,0,764,2000;2002,0,0,0,0,2,2
759,0,765,2003,0,0,0,0,1,1
760,0,766,2004,0,0,0,0,1,1
761,0,767,552;2005;10025,0,1,0,2,0,3
762,0,768,2006;2007;2008;2009;2010,0,0,4,1,0,5
763,0,769,2011;2012;2013;2014;2015,0,1,2,1,1,5
764,0,770,2016;2017;2018,0,0,0,3,0,3
765,0,771,2019;2020;2021;2022,0,0,0,3,1,4
766,0,772,2023;2024,0,0,0,2,0,2
767,0,773,2025;2026;2027,0,0,1,2,0,3
768,0,774,2028;2029;2030;2031;2032;2033,0,0,3,3,0,6
769,0,775,2034;2035;2036;2037;2038;2039;2040;2041;2042;2043,0,0,0,6,4,10
770,0,776,2044;4802,0,0,0,2,0,2
771,0,777,2045,0,0,0,1,0,1
772,0,778,2046;2047,0,0,0,1,1,2
773,0,779,2048,0,0,0,0,1,1
774,0,780,2049;2050,0,0,0,1,1,2
775,0,782,2052;2053,0,0,0,2,0,2
776,0,783,2054;2055,0,0,0,2,0,2
777,0,784,2057;2058;2059;4395,0,0,2,2,0,4
778,0,785,2060,0,0,0,1,0,1
779,0,786,2061;2062;2063,0,2,0,0,1,3
780,0,787,2064,0,0,0,1,0,1
781,0,788,2065;2066;2067;2068;2069,0,1,2,2,0,5
782,0,789,2070;2071,0,0,0,2,0,2
783,0,790,2072,0,0,0,1,0,1
784,0,791,2073,0,0,0,1,0,1
785,0,792,2074;2075;2076;2077,0,0,0,3,1,4
786,0,793,2078;2079,0,0,0,1,1,2
787,0,794,2080,0,0,0,1,0,1
788,0,795,2081;2082,0,0,0,1,1,2
789,0,796,2083;2084;2085,0,1,0,2,0,3
790,0,797,2086;2087,0,0,0,1,1,2
791,0,798,2088;2089;2090;2091;2092;2093,0,0,3,3,0,6
792,0,799,2094;2095,0,0,0,2,0,2
793,0,800,2096,0,0,0,0,1,1
794,0,801,2097;2098;2100;2101,0,0,0,3,1,4
795,0,802,2102,0,0,0,0,1,1
796,0,803,2103;5322,0,0,0,2,0,2
797,0,804,2104,0,0,0,0,1,1
798,0,805,2105;2106;2107;2108,0,0,1,2,1,4
799,0,806,2109;2110,0,0,0,2,0,2
800,0,807,2111;2112,0,0,0,1,1,2
801,0,808,2113,0,0,0,1,0,1
802,0,809,2114;5370,0,0,0,2,0,2
803,0,810,2115;2116,0,0,0,1,1,2
804,0,811,2117;2118,0,0,0,2,0,2
805,0,812,2119;2120;2121,0,1,0,2,0,3
806,0,813,2122;2123,0,1,0,0,1,2
807,0,814,2124;2125;2126,0,0,0,3,0,3
808,0,815,2127,0,0,0,1,0,1
809,0,816,2128;2129;2130;2131,0,0,0,4,0,4
810,0,817,2132;2133;2134;2136;2137;2138,0,0,0,3,3,6
811,0,818,2139;2140;2141;2142,0,1,0,3,0,4
812,0,819,2143,0,0,0,1,0,1
813,0,820,2144;2145;2146,0,1,0,2,0,3
814,0,821,2147;2148;10068,0,1,0,2,0,3
815,0,822,2149;2150,0,0,0,1,1,2
816,0,823,2151,0,0,0,0,1,1
817,0,824,2152;2153,0,0,0,2,0,2
818,0,825,2154;2155;2156,0,0,1,1,1,3
819,0,826,2157;2158;2159,0,1,0,2,0,3
820,0,827,2160,0,0,0,1,0,1
821,0,828,2161;2162,0,0,0,2,0,2
822,0,829,2163;2164,0,0,0,2,0,2
823,0,830,2165;2166;2167;2168;2169,0,0,1,2,2,5
824,0,831,2170,0,0,0,0,1,1
825,0,832,2171;2172,0,0,0,1,1,2
826,0,833,2173;2174;2175;2176,0,1,1,2,0,4
827,0,834,2177;2178;2179;2180,0,0,1,2,1,4
828,0,835,2181,0,0,0,0,1,1
829,0,836,2183;2184,0,0,0,1,1,2
830,0,837,2185;2186,0,0,0,1,1,2
831,0,838,2187;2188;2189,0,0,1,0,2,3
832,0,839,2190,0,0,0,0,1,1
833,0,840,2191;2192,0,0,0,1,1,2
834,0,841,2193;2194,0,0,0,2,0,2
835,0,842,2195;2196,0,0,0,1,1,2
836,0,843,2197,0,0,0,0,1,1
837,0,844,2198,0,0,0,1,0,1
838,0,845,2199,0,0,0,0,1,1
839,0,846,2200;2201;2202;2203,0,0,0,1,3,4
840,0,847,2204;2205,0,0,0,2,0,2
841,0,848,2207;2209;2210,0,0,0,1,2,3
842,0,849,2211,0,0,0,1,0,1
843,0,850,2212;2213;2214;2215,0,0,1,3,0,4
844,0,851,2216;2217;2218,0,0,0,2,1,3
845,0,852,2220;2221;2222;2223;2224;2225,0,0,0,4,2,6
846,0,853,2226;2227,0,0,0,2,0,2
847,0,854,2228;2229,0,0,0,2,0,2
848,0,855,2230;2231;2232;2233;2234;9959,0,2,2,2,0,6
849,0,856,2235;2236,0,0,0,1,1,2
850,0,857,2237;2238;2239;2240,0,0,2,1,1,4
851,0,858,2241,0,0,0,1,0,1
852,0,859,2242;2243;2244;2245;2246;2247,0,1,2,3,0,6
853,0,860,2248;2249;2250,0,1,0,2,0,3
854,0,861,2251;2252;2253;2254;2255;2256,0,0,1,4,1,6
855,0,862,2257,0,0,0,1,0,1
856,0,863,2259;2260;2261,0,0,0,2,1,3
857,0,864,2262;2263;2264;2265,0,0,1,3,0,4
858,0,865,2266;2267;2268,0,1,0,2,0,3
859,0,866,2269;2270;2271,0,1,0,1,1,3
860,0,867,2272;2273,0,0,1,1,0,2
861,0,868,2274;2275,0,0,0,2,0,2
862,0,869,2276;2277;2278;2280;2281,0,0,0,5,0,5
863,0,870,2282;2283;2284,0,0,0,3,0,3
864,0,871,2285,0,0,0,1,0,1
865,0,872,2286,0,0,0,0,1,1
866,0,873,2287;2289;2290;2291;6339,0,0,3,2,0,5
867,0,874,2292;2293;2294;2295,0,0,2,1,1,4
868,0,875,2296,0,0,0,0,1,1
869,0,876,2297,0,0,0,1,0,1
870,0,877,2298;2299;2300;2301;10077,0,1,2,2,0,5
871,0,878,2302;2303,0,0,0,1,1,2
872,0,879,2304;2305,0,0,0,0,2,2
873,0,880,2306,0,0,0,1,0,1
874,0,881,2307,0,0,0,1,0,1
875,0,882,2308;2309;2310;2311,0,0,0,2,2,4
876,0,883,2312,0,0,0,1,0,1
877,0,884,2313;2314,0,0,0,1,1,2
878,0,885,2315;2317,0,0,0,2,0,2
879,0,886,2318;2319;2320;2321;2322;2323,0,1,2,1,2,6
880,0,887,2324;2325;2327,0,0,0,2,1,3
881,0,888,2328;2329;2330,0,1,0,2,0,3
882,0,889,2331,0,0,0,1,0,1
883,0,890,2332;5622,0,0,0,2,0,2
884,0,891,2333;2334,0,0,0,2,0,2
885,0,892,2335;2336,0,0,0,2,0,2
886,0,893,2337;2338;2339,0,1,0,2,0,3
887,0,894,2340;2341;2342,0,0,0,2,1,3
888,0,895,2343;2344,0,0,0,1,1,2
889,0,896,2345;2347,0,0,0,2,0,2
890,0,897,2348;2349;2350;2351,0,0,0,2,2,4
891,0,898,2352;2353;2354;2355;2356,0,0,2,1,2,5
892,0,899,2357,0,0,0,0,1,1
893,0,900,2358;2359;2360;2361,0,1,1,2,0,4
894,0,901,2362;2363;2364;2365;2366,0,0,3,2,0,5
895,0,902,2367;2368;2369;2370,0,2,0,2,0,4
896,0,903,2371;2372,0,0,1,1,0,2
897,0,904,2373;2374,0,0,0,2,0,2
898,0,905,2375;2376;2377,0,0,0,2,1,3
899,0,906,2378,0,0,0,1,0,1
900,0,907,2379,0,0,0,1,0,1
901,0,908,2380;2381;2382;2383;2384;2385,0,0,2,4,0,6
902,0,909,2386,0,0,0,1,0,1
903,0,910,2387;2388;2389,0,1,0,2,0,3
904,0,911,2390;2391,0,0,0,1,1,2
905,0,912,2392;2393;2394;2395;2396,0,1,2,1,1,5
906,0,913,2397,0,0,0,0,1,1
907,0,914,2398;2399,0,0,0,1,1,2
908,0,915,2400;2401;2402;2403;2404,0,0,1,2,2,5
909,0,916,2405;2406;2407;2408,0,0,0,2,2,4
910,0,917,2409;2410;2411,0,0,0,3,0,3
911,0,918,2412;2413;2414,0,0,0,2,1,3
912,0,919,2415;2416;2417;2418;10095,0,1,2,2,0,5
913,0,920,2419,0,0,0,0,1,1
914,0,921,2420;2421,0,0,0,1,1,2
915,0,922,2422;2423,0,0,0,2,0,2
916,0,923,2424;2425,0,0,0,0,2,2
917,0,924,2426,0,0,0,1,0,1
918,0,925,2427;2428,0,0,0,1,1,2
919,0,926,2429;2430;2431,0,0,0,3,0,3
920,0,927,2432;2433;2434,0,0,2,1,0,3
921,0,928,2435;2436,0,0,0,2,0,2
922,0,929,2437;2438,0,0,0,2,0,2
923,0,930,2439;2440;2441;2442,0,1,0,3,0,4
924,0,931,2443;2444;2445;2446,0,0,0,3,1,4
925,0,932,2447;2448;2449,0,0,1,0,2,3
926,0,933,2450,0,0,0,0,1,1
927,0,934,2451;2452,0,0,0,2,0,2
928,0,935,2453;2454;2455;2456,0,0,0,4,0,4
929,0,936,2457;2458;2459,0,0,0,2,1,3
930,0,937,2460;2461;2462,0,0,0,3,0,3
931,0,938,2464;2466;2467;2468,0,0,0,3,1,4
932,0,939,2469;2470,0,0,0,0,2,2
933,0,940,2471;2472,0,0,0,2,0,2
934,0,941,2473;2474;2475;2476,0,1,1,2,0,4
935,0,942,2477;2478;2479;2480;2481,0,0,1,4,0,5
936,0,943,2482;2483,0,0,0,0,2,2
937,0,944,2484;2485,0,0,0,2,0,2
938,0,945,2486,0,0,0,1,0,1
939,0,946,2487,0,0,0,1,0,1
940,0,947,2488;2489,0,0,0,2,0,2
941,0,948,2490;2491;2492;2493;2494,0,0,2,1,2,5
942,0,949,2495;2496;2498;2499;2500,0,0,2,2,1,5
943,0,950,2501;2503,0,0,0,1,1,2
944,0,951,2504;2505;2506;2507;2508,0,0,1,2,2,5
945,0,952,2509;2510;2511,0,0,0,3,0,3
946,0,953,2512;2513,0,0,0,1,1,2
947,0,954,2514;2515;2516;2517,0,0,1,1,2,4
948,0,955,2518,0,0,0,0,1,1
949,0,956,2519;2520,0,0,0,2,0,2
950,0,957,2521;2522;2523;2524,0,2,0,2,0,4
951,0,958,2525;2526;2528;2529,0,0,0,4,0,4
952,0,959,2530;2531,0,0,0,0,2,2
953,0,960,2532;2533;2534,0,1,0,1,1,3
954,0,961,2535;2536,0,0,0,1,1,2
955,0,962,2537;2538;2539,0,1,0,1,1,3
956,0,963,2540,0,0,0,0,1,1
957,0,964,2541;2542;2543;2544;2545,0,1,2,1,1,5
958,0,965,2546;2547,0,0,0,1,1,2
959,0,966,2548;2549,0,0,0,1,1,2
960,0,967,2550,0,0,0,1,0,1
961,0,968,2551;2552,0,0,0,2,0,2
962,0,969,2553;2554;2555;2556,0,0,2,2,0,4
963,0,970,2557;2558;2559,0,0,1,1,1,3
964,0,971,2560;2561,0,0,0,1,1,2
965,0,972,2563;2564;10101,0,1,0,2,0,3
966,0,973,2565;2566,0,0,0,2,0,2
967,0,974,2567;2568,0,0,0,2,0,2
968,0,975,2569;2570,0,0,0,2,0,2
969,0,976,2571;2572;2573,0,0,0,1,2,3
970,0,977,2574;2575,0,0,0,2,0,2
971,0,978,2576;2577,0,0,0,1,1,2
972,0,979,2578;2579;2580;2581,0,0,2,1,1,4
973,0,980,2582,0,0,0,1,0,1
974,0,981,2583;2584;2585;2586,0,0,0,3,1,4
975,0,982,2587,0,0,0,0,1,1
976,0,983,2588;2589,0,0,0,2,0,2
977,0,984,2590;2591,0,0,0,2,0,2
978,0,986,2595;2596,0,0,0,0,2,2
979,0,987,2597;2598,0,1,0,1,0,2
980,0,988,2599;2600,0,0,0,2,0,2
981,0,989,2601;2602,0,0,0,1,1,2
982,0,990,2603;2604;2605;2606,0,0,2,1,1,4
983,0,991,2607;2608;10037,0,1,0,1,1,3
984,0,992,2609,0,0,0,1,0,1
985,0,993,2611,0,0,0,0,1,1
986,0,994,2612;2613,0,0,0,2,0,2
987,0,995,2614;2615,0,0,0,1,1,2
988,0,996,2616,0,0,0,0,1,1
989,0,997,2617,0,0,0,1,0,1
990,0,998,2618;2619;2620;2621,0,0,2,1,1,4
991,0,999,2622;2623;2624;2625,0,0,1,2,1,4
992,0,1000,2626;2627;2628;2629,0,0,2,0,2,4
993,0,1001,2630,0,0,0,1,0,1
994,0,1002,2631;2632,0,0,0,2,0,2
995,0,1003,2634,0,0,0,1,0,1
996,0,1004,2635;2636,0,0,0,2,0,2
997,0,1005,2637,0,0,0,1,0,1
998,0,1006,2638;2639,0,0,0,2,0,2
999,0,1007,2640;2641,0,0,0,2,0,2
1000,0,1008,2642;2643,0,0,0,0,2,2
1001,0,1009,2644,0,0,0,0,1,1
1002,0,1010,2645;2646;2647;2648,0,0,0,2,2,4
1003,0,1011,2649;2650;2651,0,0,1,0,2,3
1004,0,1012,2652;2653;2654;2655;2656,0,0,2,3,0,5
1005,0,1013,2657;2658,0,0,0,1,1,2
1006,0,1014,2659,0,0,0,0,1,1
1007,0,1015,2660,0,0,0,0,1,1
1008,0,1016,2662;2663,0,0,0,2,0,2
1009,0,1017,2664;2665,0,0,0,1,1,2
1010,0,1018,2666;2668;2669;2670,0,0,2,2,0,4
1011,0,1019,2671;2672;2673,0,0,0,3,0,3
1012,0,1020,2674;2675,0,0,0,1,1,2
1013,0,1021,2676;2677,0,0,0,1,1,2
1014,0,1022,2678;2679;2680;2681,0,0,1,3,0,4
1015,0,1023,2682;2683;2684,0,0,0,3,0,3
1016,0,1024,2685;2686;2687;2688;2689,0,0,1,2,2,5
1017,0,1025,2690;2691;2692;2693;2694,0,0,3,2,0,5
1018,0,1026,2695,0,0,0,1,0,1
1019,0,1027,2696,0,0,0,1,0,1
1020,0,1028,2697,0,0,0,1,0,1
1021,0,1029,2698;2699;2700;2701,0,0,3,1,0,4
1022,0,1030,2702,0,0,0,1,0,1
1023,0,1031,2703,0,0,0,1,0,1
1024,0,1032,2704,0,0,0,0,1,1
1025,0,1033,2705;2706;2707,0,0,0,2,1,3
1026,0,1034,2708;2714,0,0,0,2,0,2
1027,0,1035,2709;2710,0,0,0,1,1,2
1028,0,1036,2711,0,0,0,1,0,1
1029,0,1037,2712,0,0,0,1,0,1
1030,0,1038,2713;2715,0,0,0,1,1,2
1031,0,1039,2716,0,0,0,1,0,1
1032,0,1040,2718;2719;2720;2721,0,0,0,2,2,4
1033,0,1041,2722;2723;2724,0,0,0,3,0,3
1034,0,1042,2725,0,0,0,1,0,1
1035,0,1043,2726;2727;2728;2729,0,2,0,2,0,4
1036,0,1044,2730;2731;2732;2733,0,0,0,2,2,4
1037,0,1045,2734;2736;2737;2738,0,1,0,1,2,4
1038,0,1046,2739;2740;2741;2742,0,0,1,2,1,4
1039,0,1047,2743;2745;2746;2747;2748,0,0,0,3,2,5
1040,0,1048,2749;2750;2751,0,1,1,1,0,3
1041,0,1049,2752,0,0,0,1,0,1
1042,0,1050,2753,0,0,0,1,0,1
1043,0,1051,2754;2755,0,0,0,1,1,2
1044,0,1052,2756;2757,0,0,0,2,0,2
1045,0,1053,2758;2759;2760,0,1,0,1,1,3
1046,0,1054,2761,0,0,0,1,0,1
1047,0,1055,2762;2763;2764;2765;2766,0,0,1,3,1,5
1048,0,1056,2767,0,0,0,1,0,1
1049,0,1057,2768,0,0,0,0,1,1
1050,0,1058,2769;2770,0,0,0,0,2,2
1051,0,1059,2772;2773;2774;2775,0,2,0,1,1,4
1052,0,1060,2777;2778,0,0,0,1,1,2
1053,0,1061,2779;2780,0,0,0,1,1,2
1054,0,1062,2781;2782;2783;2784,0,0,2,0,2,4
1055,0,1063,2785;2786;2787;2788;2789,0,0,3,1,1,5
1056,0,1064,2790;2791,0,0,0,2,0,2
1057,0,1065,2792;2793,0,0,0,2,0,2
1058,0,1066,2794;2795,0,0,1,1,0,2
1059,0,1067,2796;2797;2798;2799;2800,0,0,3,2,0,5
1060,0,1068,2801;2802;2803;2804;2805,0,0,0,5,0,5
1061,0,1069,2806;2807,0,0,0,2,0,2
1062,0,1070,2808;2809;2810;2811;2812,0,0,3,1,1,5
1063,0,1071,2813;2814;2815;2816;2817;2818,0,1,3,2,0,6
1064,0,1072,2819;2820,0,0,0,2,0,2
1065,0,1073,2821;2822,0,0,0,2,0,2
1066,0,1074,2823;2824;2825,0,0,0,2,1,3
1067,0,1075,2826;2827;2828,0,0,0,3,0,3
1068,0,1076,2829;2830,0,0,0,2,0,2
1069,0,1077,2831;2832;2833;2834,0,0,1,2,1,4
1070,0,1078,2835,0,0,0,1,0,1
1071,0,1079,2836;2837;2838;2839;2840,0,0,2,1,2,5
1072,0,1080,2841;2842;2843,0,0,1,1,1,3
1073,0,1081,2844;2845,0,0,0,1,1,2
1074,0,1082,2846;2847,0,0,0,1,1,2
1075,0,1083,2849;2850,0,0,0,1,1,2
1076,0,1084,2851;2852,0,0,0,2,0,2
1077,0,1085,2853;2854;2855,0,1,0,1,1,3
1078,0,1086,2856;2857,0,0,0,2,0,2
1079,0,1087,2858;2859;2860;2861,0,0,0,1,3,4
1080,0,1088,2862;2863;2865,0,0,1,1,1,3
1081,0,1089,2866;2867,0,0,0,1,1,2
1082,0,1090,2868;2869;2870;2871,0,2,0,2,0,4
1083,0,1091,2872;2873;2874;2875;2876,0,1,0,3,1,5
1084,0,1092,2877;2878,0,0,1,0,1,2
1085,0,1093,2879;2880;2881,0,0,2,1,0,3
1086,0,1094,2882,0,0,0,1,0,1
1087,0,1095,2883;2884,0,0,0,1,1,2
1088,0,1096,2885,0,0,0,1,0,1
1089,0,1097,2886,0,0,0,0,1,1
1090,0,1098,2887,0,0,0,1,0,1
1091,0,1099,2888;2889;2890;2891;2892;2893,0,1,2,2,1,6
1092,0,1100,2894;2895;2896,0,1,0,1,1,3
1093,0,1101,2897;5499,0,0,0,2,0,2
1094,0,1102,2898;2899,0,0,0,2,0,2
1095,0,1103,2900;2901,0,0,0,2,0,2
1096,0,1104,2902;2903,0,0,0,2,0,2
1097,0,1105,2904;2905,0,0,0,2,0,2
1098,0,1106,2906;2907,0,0,0,1,1,2
1099,0,1107,2908;5636,0,0,0,2,0,2
1100,0,1108,2909;2910,0,1,0,1,0,2
1101,0,1109,2911,0,0,0,1,0,1
1102,0,1110,2912;2913;2914,0,0,0,3,0,3
1103,0,1111,2915;2916,0,0,0,2,0,2
1104,0,1112,2917,0,0,0,1,0,1
1105,0,1113,2918;2919;2920,0,1,1,1,0,3
1106,0,1114,2921;2922,0,0,0,1,1,2
1107,0,1115,2923;2924,0,0,0,2,0,2
1108,0,1116,2925;2926,0,0,0,2,0,2
1109,0,1117,2927;2928;2929;2930,0,0,0,3,1,4
1110,0,1118,2931;2932,0,0,0,1,1,2
1111,0,1119,2933;2934,0,0,0,0,2,2
1112,0,1120,2936,0,0,0,0,1,1
1113,0,1121,2937;2938;10108,0,1,0,1,1,3
1114,0,1122,2939;2940,0,0,0,2,0,2
1115,0,1123,2941;2942,0,0,0,2,0,2
1116,0,1124,2943;2944,0,0,0,2,0,2
1117,0,1125,2945,0,0,0,1,0,1
1118,0,1126,2946;2947;2948;2949;2950,0,1,2,2,0,5
1119,0,1127,2951;2953;2954,0,0,0,2,1,3
1120,0,1128,2955;2956,0,0,0,2,0,2
1121,0,1129,2957;2958;2959;2960;10072,0,1,2,2,0,5
1122,0,1130,2961;2962;2963;2964;2965,0,3,0,1,1,5
1123,0,1131,2966;2967,0,0,0,2,0,2
1124,0,1132,2968,0,0,0,1,0,1
1125,0,1133,2969;2970;2971;2972,0,0,1,2,1,4
1126,0,1134,2973;2974;2975;2976,0,2,0,2,0,4
1127,0,1135,2977;2978;2979;2980,0,0,2,1,1,4
1128,0,1136,2981;2982,0,0,0,2,0,2
1129,0,1137,2983;2984;2985;2986,0,0,0,3,1,4
1130,0,1138,2987;10094,0,1,0,1,0,2
1131,0,1139,2988;2989,0,0,0,2,0,2
1132,0,1140,2991,0,0,0,1,0,1
1133,0,1141,2992,0,0,0,0,1,1
1134,0,1142,2993;2994;2995;2996,0,0,2,2,0,4
1135,0,1143,2997;2998,0,0,0,1,1,2
1136,0,1144,3000;3001;3002;3003;3004,0,0,2,2,1,5
1137,0,1145,3005;3006;3007,0,1,0,1,1,3
1138,0,1146,3008;3009;3010;3011;3012,0,0,2,3,0,5
1139,0,1147,3013;3014,0,0,0,1,1,2
1140,0,1148,3015;3016,0,0,0,0,2,2
1141,0,1149,3017;3018;3019,0,1,0,2,0,3
1142,0,1150,3020;3021,0,0,0,1,1,2
1143,0,1151,3022;3023,0,0,0,2,0,2
1144,0,1152,3024;10026,0,1,0,1,0,2
1145,0,1153,3025;3026;3027;3028;3029,0,1,1,3,0,5
1146,0,1154,3030;3031;3032;3033,0,0,0,1,3,4
1147,0,1155,3035,0,0,0,0,1,1
1148,0,1156,3036;3037;3038;3039;3040;3041,0,0,1,4,1,6
1149,0,1157,3042;3043;3044;3045;3046,0,1,1,3,0,5
1150,0,1158,3047;3048,0,0,0,2,0,2
1151,0,1159,3049;3050,0,0,0,0,2,2
1152,0,1160,3051;3052,0,0,0,0,2,2
1153,0,1161,3053;3054;3055,0,1,0,2,0,3
1154,0,1162,3056;3057;3058,0,1,0,0,2,3
1155,0,1163,3059;3060;3061;3062,0,0,0,2,2,4
1156,0,1164,3063;3064;3065,0,0,0,1,2,3
1157,0,1165,3066;3067;3068;3069;3070;3071,0,1,2,2,1,6
1158,0,1166,3072,0,0,0,1,0,1
1159,0,1167,3073;3074;3075,0,0,0,2,1,3
1160,0,1168,3076;3077;3078,0,0,1,2,0,3
1161,0,1169,3079,0,0,0,0,1,1
1162,0,1170,3080,0,0,0,1,0,1
1163,0,1171,3081;3082;3083,0,0,0,3,0,3
1164,0,1172,3084;3085;3086;3087,0,0,1,3,0,4
1165,0,1173,3088,0,0,0,0,1,1
1166,0,1174,3089;3090,0,0,0,1,1,2
1167,0,1175,3091;3092;3093;3094,0,0,0,4,0,4
1168,0,1176,3095;3096,0,0,0,1,1,2
1169,0,1177,3097;3098;3099,0,0,0,2,1,3
1170,0,1178,3101;3102;3103,0,0,1,0,2,3
1171,0,1179,3104,0,0,0,0,1,1
1172,0,1180,3105;3106;3107;3108,0,1,0,2,1,4
1173,0,1181,3109;3110;3111,0,1,0,2,0,3
1174,0,1182,3112,0,0,0,1,0,1
1175,0,1183,3113;3114,0,0,0,2,0,2
1176,0,1184,3115;3116;3117;3118,0,1,2,1,0,4
1177,0,1185,3119;3120;3121;3122,0,1,2,1,0,4
1178,0,1186,3123;3124;3125;3126;3127,0,2,1,1,1,5
1179,0,1187,3128,0,0,0,1,0,1
1180,0,1188,3129,0,0,0,0,1,1
1181,0,1189,3130;3131;3132;3133,0,0,2,1,1,4
1182,0,1190,3134;3135;3136;3137,0,1,1,2,0,4
1183,0,1191,3138;3139;3140;3141,0,1,1,2,0,4
1184,0,1192,3142,0,0,0,1,0,1
1185,0,1193,3143;3144;3145;3146,0,2,0,2,0,4
1186,0,1194,3147;3148,0,0,0,1,1,2
1187,0,1195,3149,0,0,0,0,1,1
1188,0,1196,3150;3151,0,0,0,2,0,2
1189,0,1197,3152,0,0,0,0,1,1
1190,0,1198,3153;3154;3155;3156,0,1,1,1,1,4
1191,0,1199,3157;3158;3159;3160;3161,0,0,1,3,1,5
1192,0,1200,3162;3163;3164;3165,0,0,1,3,0,4
1193,0,1201,3166;3167,0,0,0,2,0,2
1194,0,1202,3168;3169,0,0,0,2,0,2
1195,0,1203,3170,0,0,0,1,0,1
1196,0,1204,3171;3172;3173,0,0,1,1,1,3
1197,0,1205,3174;3175,0,0,0,2,0,2
1198,0,1206,3176;3177;3178,0,0,0,3,0,3
1199,0,1207,3179;3180,0,0,0,1,1,2
1200,0,1208,3181;3182,0,0,0,2,0,2
1201,0,1209,3183;3184;3185,0,1,0,1,1,3
1202,0,1210,3186;3187,0,0,0,1,1,2
1203,0,1211,3188;3189;3191;3193,0,0,1,2,1,4
1204,0,1212,3194;3195,0,0,0,1,1,2
1205,0,1213,3196;3197;3198,0,0,0,2,1,3
1206,0,1214,3199;3200;3201;3202,0,0,2,1,1,4
1207,0,1215,3203;3204,0,0,0,2,0,2
1208,0,1216,3205;3206;3207;3208;3209,0,1,2,2,0,5
1209,0,1217,3210;3211,0,0,0,2,0,2
1210,0,1218,3212;3213;3214;3215,0,0,1,2,1,4
1211,0,1219,3216;3217;3218;3219,0,0,2,1,1,4
1212,0,1220,3220;3221;3222;10016,0,1,1,2,0,4
1213,0,1221,3223,0,0,0,1,0,1
1214,0,1222,3224;3225;3226;3227,0,0,0,2,2,4
1215,0,1223,3228;3229,0,0,0,2,0,2
1216,0,1224,3230;3231;3232;3233;3234,0,0,2,1,2,5
1217,0,1225,3235;3236;3237;3238;3239;3240;3241,0,1,2,3,1,7
1218,0,1226,3242,0,0,0,1,0,1
1219,0,1227,3244;3245;3246;3247,0,2,0,1,1,4
1220,0,1228,3248,0,0,0,0,1,1
1221,0,1229,3249;7523;10057,0,1,0,2,0,3
1222,0,1231,3251;3252,0,0,0,1,1,2
1223,0,1232,3253;3254;3255;3256,0,1,0,3,0,4
1224,0,1233,3257;3258,0,0,0,2,0,2
1225,0,1234,3259;3260,0,0,0,2,0,2
1226,0,1235,3261;3262;10027,0,1,0,2,0,3
1227,0,1236,3263,0,0,0,1,0,1
1228,0,1237,3264;3265;3266;3267,0,2,0,2,0,4
1229,0,1238,3268;3269,0,0,0,1,1,2
1230,0,1239,3271,0,0,0,0,1,1
1231,0,1240,3273,0,0,0,0,1,1
1232,0,1241,3274;3275;3276;3277,0,0,2,2,0,4
1233,0,1242,3278,0,0,0,1,0,1
1234,0,1243,3279;3280;3281,0,0,0,3,0,3
1235,0,1244,3282;3283,0,0,0,2,0,2
1236,0,1245,3284;3285,0,0,0,2,0,2
1237,0,1246,3286,0,0,0,0,1,1
1238,0,1247,3287;3288;3289,0,0,1,2,0,3
1239,0,1248,3290;3292,0,0,0,2,0,2
1240,0,1249,3293,0,0,0,1,0,1
1241,0,1250,3294;3295;3296,0,0,0,2,1,3
1242,0,1251,3297;3298,0,0,1,0,1,2
1243,0,1252,3299,0,0,0,1,0,1
1244,0,1253,3300;3301,0,0,0,1,1,2
1245,0,1254,3302;3303;3304;3305,0,0,0,3,1,4
1246,0,1255,3306;3307;3308;3309,0,0,2,0,2,4
1247,0,1256,3310;3311;3312,0,0,0,3,0,3
1248,0,1257,3313;3314;3315,0,0,1,2,0,3
1249,0,1258,3316;3317;3318,0,1,0,2,0,3
1250,0,1259,3319;3320,0,0,0,2,0,2
1251,0,1260,3321;3322,0,0,0,1,1,2
1252,0,1261,3323;3324,0,0,0,2,0,2
1253,0,1262,3325,0,0,0,1,0,1
1254,0,1263,3326;3327,0,0,0,1,1,2
1255,0,1264,3329,0,0,0,0,1,1
1256,0,1265,3330,0,0,0,1,0,1
1257,0,1266,3331;3332,0,0,0,1,1,2
1258,0,1267,3334,0,0,0,0,1,1
1259,0,1268,3335;3336;3337;3338,0,0,1,3,0,4
1260,0,1269,3339;3340;3341,0,1,0,1,1,3
1261,0,1270,3342,0,0,0,1,0,1
1262,0,1271,3343,0,0,0,1,0,1
1263,0,1272,3344;3345;3346,0,0,1,2,0,3
1264,0,1273,3347;3348,0,0,0,1,1,2
1265,0,1274,3349;3350,0,0,0,2,0,2
1266,0,1275,3351;3352;3353;3354;3355;3356,0,1,0,3,2,6
1267,0,1276,3357;3358;3359,0,1,0,2,0,3
1268,0,1277,3360;3361;3362;3363,0,0,1,3,0,4
1269,0,1278,3364,0,0,0,1,0,1
1270,0,1279,3365;3366;3367,0,2,0,0,1,3
1271,0,1280,3368;3369,0,0,0,2,0,2
1272,0,1281,3370;3371,0,0,0,2,0,2
1273,0,1282,3372;3373;3374;3375;3376;3377,0,0,4,2,0,6
1274,0,1283,3378;3379;3380;3381,0,0,2,2,0,4
1275,0,1284,3382;3383,0,0,0,2,0,2
1276,0,1285,3384;3385;3386;3387;3388,0,1,1,3,0,5
1277,0,1286,3389;3390;3391;3392,0,0,0,4,0,4
1278,0,1287,3393;3394;3395;3396;3397,0,0,2,3,0,5
1279,0,1288,3398;3399;3400;3401;3402;3403,0,1,3,2,0,6
1280,0,1289,3404;3405;3406;3407,0,0,1,2,1,4
1281,0,1290,3408;3409,0,0,0,2,0,2
1282,0,1291,3410,0,0,0,1,0,1
1283,0,1292,3411,0,0,0,1,0,1
1284,0,1293,3412,0,0,0,1,0,1
1285,0,1294,3413;3414,0,0,0,1,1,2
1286,0,1295,1671;3415;3416;3417;3418;3419;3420,0,2,1,3,1,7
1287,0,1296,3421,0,0,0,1,0,1
1288,0,1297,3422;3423;3424,0,1,0,2,0,3
1289,0,1298,3425,0,0,0,1,0,1
1290,0,1299,3426;3427;3428;3429,0,0,2,2,0,4
1291,0,1300,3430;3431;3432,0,0,0,3,0,3
1292,0,1301,3433;3434;3435;3436;3437;3438,0,0,2,2,2,6
1293,0,1302,3439;3440,0,0,0,2,0,2
1294,0,1303,3441;3442,0,0,0,2,0,2
1295,0,1304,3443;3444;3445,0,0,0,2,1,3
1296,0,1305,3446,0,0,0,1,0,1
1297,0,1306,3447;3448;3449;3450,0,0,2,2,0,4
1298,0,1307,3451;3452;3453;3454,0,0,0,2,2,4
1299,0,1308,3455;3456;3457;3458,0,0,1,2,1,4
1300,0,1309,3459;8836,0,0,0,2,0,2
1301,0,1310,3460,0,0,0,1,0,1
1302,0,1311,3461;3462;3463,0,0,1,2,0,3
1303,0,1312,3464,0,0,0,0,1,1
1304,0,1313,3465;3466;3467;3468,0,0,2,1,1,4
1305,0,1314,3469;3470;3471;3472,0,1,1,2,0,4
1306,0,1315,3473;3474;3475;3476;3477;3478,0,1,3,1,1,6
1307,0,1316,3479;3480;3481,0,1,0,2,0,3
1308,0,1317,3482,0,0,0,0,1,1
1309,0,1318,3483;3484,0,0,0,0,2,2
1310,0,1319,3485,0,0,0,0,1,1
1311,0,1320,3486;3487,0,0,0,2,0,2
1312,0,1321,3488;3489,0,0,0,1,1,2
1313,0,1322,3490;3491;3492;3493,0,0,1,3,0,4
1314,0,1323,3494;3495;3496,0,0,0,3,0,3
1315,0,1324,3497,0,0,0,1,0,1
1316,0,1325,3498;3499,0,0,0,2,0,2
1317,0,1326,3500;3501;3502;3503;3504,0,2,1,1,1,5
1318,0,1327,3505;3506;3507,0,1,0,1,1,3
1319,0,1329,3509,0,0,0,1,0,1
1320,0,1330,3510,0,0,0,1,0,1
1321,0,1331,3511;3512,0,0,0,2,0,2
1322,0,1332,3513;3514,0,0,0,2,0,2
1323,0,1333,3515;3516;3517;3518,0,0,2,2,0,4
1324,0,1334,3519;3520,0,0,1,1,0,2
1325,0,1335,3521;3522;3523;3524,0,0,2,2,0,4
1326,0,1336,3525,0,0,0,1,0,1
1327,0,1337,3526;3527,0,0,0,2,0,2
1328,0,1338,3528;3529;3530;3531,0,0,2,2,0,4
1329,0,1339,3532;3533;3534,0,0,0,3,0,3
1330,0,1340,3535,0,0,0,1,0,1
1331,0,1341,3536;3537;3538;3539;3540,0,0,1,2,2,5
1332,0,1342,3541,0,0,0,1,0,1
1333,0,1343,3542;3543;3544;3545,0,0,0,2,2,4
1334,0,1344,3546;3547;3548;3549,0,0,0,4,0,4
1335,0,1345,3550,0,0,0,0,1,1
1336,0,1346,3551;3552;3553,0,0,0,1,2,3
1337,0,1347,3555,0,0,0,1,0,1
1338,0,1348,3556;3557,0,0,0,2,0,2
1339,0,1349,3558;3559;3560;3561,0,1,1,0,2,4
1340,0,1350,3562;3563;3564;3565;3566,0,0,1,2,2,5
1341,0,1351,3567;3568,0,0,0,1,1,2
1342,0,1352,3569;3570,0,0,0,2,0,2
1343,0,1353,3571;3572;3573;3574;3575,0,0,3,2,0,5
1344,0,1354,3576;3577;3578,0,1,0,2,0,3
1345,0,1355,3579,0,0,0,0,1,1
1346,0,1356,3580,0,0,0,1,0,1
1347,0,1357,3581;3582,0,0,0,1,1,2
1348,0,1358,3584;3585;3586,0,0,0,3,0,3
1349,0,1359,3587;3588;3589;3590;3591;3592,0,2,0,1,3,6
1350,0,1360,3593;3594;3595,0,0,1,2,0,3
1351,0,1361,3596;3597,0,0,0,2,0,2
1352,0,1362,3598;3599;3600;3601,0,2,0,1,1,4
1353,0,1363,3602;3603,0,0,0,2,0,2
1354,0,1364,3604;3605,0,0,0,0,2,2
1355,0,1365,3606;3607,0,0,0,1,1,2
1356,0,1366,3608,0,0,0,1,0,1
1357,0,1367,3609;3610;3611;3612,0,0,2,2,0,4
1358,0,1368,3613;3614;3615,0,0,1,2,0,3
1359,0,1369,3616;3617,0,0,0,1,1,2
1360,0,1370,3618,0,0,0,1,0,1
1361,0,1371,3619;3620;3621,0,0,1,2,0,3
1362,0,1372,3622,0,0,0,1,0,1
1363,0,1373,3623,0,0,0,1,0,1
1364,0,1374,3624;3625;3626,0,0,0,3,0,3
1365,0,1375,3627,0,0,0,1,0,1
1366,0,1376,3628;3629;3630,0,0,0,1,2,3
1367,0,1377,3631;3632;3633,0,0,0,2,1,3
1368,0,1378,3634;3635;3636,0,0,0,2,1,3
1369,0,1379,3637;3638;3639,0,0,0,3,0,3
1370,0,1380,3640;3641;3642;3643,0,0,0,3,1,4
1371,0,1381,3644;3645;3646,0,0,0,3,0,3
1372,0,1382,3647;3648;3649;3650,0,0,0,3,1,4
1373,0,1383,3651;3652,0,0,0,2,0,2
1374,0,1384,3653,0,0,0,0,1,1
1375,0,1385,3654;3655;3656,0,0,0,2,1,3
1376,0,1386,3657;3658,0,0,0,2,0,2
1377,0,1387,3659;3660,0,0,0,1,1,2
1378,0,1388,3661;3662,0,0,0,2,0,2
1379,0,1389,3663,0,0,0,0,1,1
1380,0,1390,3665;3666;3667,0,0,0,1,2,3
1381,0,1391,3668;3669;10010,0,1,0,1,1,3
1382,0,1392,3670;3671;3672;3673;3674;3675,0,0,3,3,0,6
1383,0,1393,3676;3677;3678;3679,0,1,1,2,0,4
1384,0,1394,3680,0,0,0,1,0,1
1385,0,1395,3681;3682;10105,0,1,0,1,1,3
1386,0,1396,3683;3684;3685,0,0,0,2,1,3
1387,0,1397,3686;3687,0,0,0,2,0,2
1388,0,1398,3688;3689;3690;3691,0,0,1,3,0,4
1389,0,1399,3692;3693,0,0,0,0,2,2
1390,0,1400,3694;3695;3696,0,0,2,1,0,3
1391,0,1401,3697;3698;3699;3700,0,0,2,2,0,4
1392,0,1402,3701;3702,0,0,0,0,2,2
1393,0,1403,3703;3704,0,0,1,1,0,2
1394,0,1404,3705,0,0,0,1,0,1
1395,0,1405,3706;3707;3708;3709;3710,0,0,1,4,0,5
1396,0,1406,3711;3712;3713,0,0,1,1,1,3
1397,0,1407,3714;3715;3716;3717,0,0,2,1,1,4
1398,0,1409,3719;3720,0,0,0,1,1,2
1399,0,1410,3721;3722,0,0,0,2,0,2
1400,0,1411,3723;3724;3725;3726;3727,0,0,2,3,0,5
1401,0,1412,3729;3730;3731,0,1,1,1,0,3
1402,0,1413,3732,0,0,0,1,0,1
1403,0,1414,3733;3734;3735,0,1,0,0,2,3
1404,0,1415,3736;3737;3738,0,0,1,1,1,3
1405,0,1416,3739;5117,0,0,0,2,0,2
1406,0,1417,3740;3741,0,0,1,1,0,2
1407,0,1418,3742;3743,0,0,0,2,0,2
1408,0,1419,3744;3745,0,0,0,2,0,2
1409,0,1420,3746;3747;3748;3749,0,0,2,2,0,4
1410,0,1421,3750;3751;3752;3753,0,0,1,3,0,4
1411,0,1422,3754;3755,0,0,0,2,0,2
1412,0,1423,3756;3757;3758;3759,0,0,2,1,1,4
1413,0,1424,3760,0,0,0,1,0,1
1414,0,1425,3761;3762,0,0,0,2,0,2
1415,0,1426,3763;10044,0,1,0,1,0,2
1416,0,1427,3764;3765;3766;3767;3768,0,0,1,2,2,5
1417,0,1428,3769;3770,0,0,0,1,1,2
1418,0,1429,3771,0,0,0,0,1,1
1419,0,1430,3772,0,0,0,1,0,1
1420,0,1431,3773,0,0,0,0,1,1
1421,0,1432,3774;3776,0,1,0,0,1,2
1422,0,1433,3777;3778;3779;3780,0,0,0,3,1,4
1423,0,1434,3781;3782,0,0,0,2,0,2
1424,0,1435,3783,0,0,0,1,0,1
1425,0,1436,3784;3785;3786;3787,0,0,0,4,0,4
1426,0,1437,2219;3788,0,0,0,2,0,2
1427,0,1438,3789;3790,0,0,0,2,0,2
1428,0,1439,3791;3792;3793;3794,0,0,1,3,0,4
1429,0,1440,3795;3797;3798,0,1,0,2,0,3
1430,0,1441,3799;3800;3801;3802,0,0,1,3,0,4
1431,0,1442,3804,0,0,0,1,0,1
1432,0,1443,3805;3806,0,0,0,2,0,2
1433,0,1444,3807;3808,0,0,0,2,0,2
1434,0,1445,3809;3810;3811;3812;3813,0,0,2,3,0,5
1435,0,1446,3814,0,0,0,1,0,1
1436,0,1447,3815;3816;3817,0,0,0,2,1,3
1437,0,1448,3818;3819;3820,0,1,0,1,1,3
1438,0,1450,3822;3823;3824,0,0,0,2,1,3
1439,0,1451,3825;3826,0,0,0,2,0,2
1440,0,1452,3827;3828,0,0,0,2,0,2
1441,0,1453,3830;3831;3832;3833;3834,0,0,2,3,0,5
1442,0,1454,3835;3836;3837,0,0,0,1,2,3
1443,0,1455,3838;3839;3840;3841;3842,0,3,0,1,1,5
1444,0,1456,3843;3844,0,0,0,1,1,2
1445,0,1457,3845;3846,0,0,0,1,1,2
1446,0,1458,3847;3848;3849;3850,0,0,2,2,0,4
1447,0,1459,2326;3851,0,0,0,2,0,2
1448,0,1460,3852;3853;3854,0,0,0,1,2,3
1449,0,1461,3855;3856,0,0,0,2,0,2
1450,0,1462,3857;3858;3859;3860,0,0,2,2,0,4
1451,0,1463,3861;3862;3863,0,1,0,2,0,3
1452,0,1464,3864,0,0,0,1,0,1
1453,0,1465,3866;3867;3868;3869,0,0,1,2,1,4
1454,0,1466,3870;3871;3872;3873;3874,0,1,2,1,1,5
1455,0,1467,3875;3876;3877;3878;3879,0,0,1,2,2,5
1456,0,1468,3880,0,0,0,1,0,1
1457,0,1469,3881,0,0,0,0,1,1
1458,0,1470,3882;3883,0,0,1,1,0,2
1459,0,1471,3884;3885;3886,0,0,1,2,0,3
1460,0,1472,3887,0,0,0,1,0,1
1461,0,1473,3888;3889,0,0,0,1,1,2
1462,0,1474,3890;3891;3892,0,0,0,3,0,3
1463,0,1475,3893;3894;3895,0,0,1,1,1,3
1464,0,1476,3896;3897,0,0,0,1,1,2
1465,0,1477,3898,0,0,0,1,0,1
1466,0,1478,3899;3900;3901,0,1,0,0,2,3
1467,0,1479,3902;3903;3904,0,0,0,3,0,3
1468,0,1480,3905,0,0,0,1,0,1
1469,0,1481,3907;3908,0,0,0,2,0,2
1470,0,1482,3909,0,0,0,0,1,1
1471,0,1483,3910;3911,0,0,0,1,1,2
1472,0,1484,3912;3913,0,0,0,2,0,2
1473,0,1485,3915;3916;3917,0,0,0,1,2,3
1474,0,1486,3918;3919;3920;3921;3922,0,0,2,2,1,5
1475,0,1487,3923;3924;3925;3926,0,0,0,3,1,4
1476,0,1488,3927,0,0,0,0,1,1
1477,0,1489,3928,0,0,0,0,1,1
1478,0,1490,3929;3930,0,0,1,0,1,2
1479,0,1491,3931;3932;3933;3934,0,0,0,4,0,4
1480,0,1492,3935;3936;3937,0,0,0,1,2,3
1481,0,1493,3938;3939;3940,0,0,0,3,0,3
1482,0,1494,3941;3942,0,0,0,1,1,2
1483,0,1495,3943;3944;3945,0,0,1,2,0,3
1484,0,1496,3946;3947;3948,0,0,0,2,1,3
1485,0,1497,3950;3951;3952,0,1,0,1,1,3
1486,0,1498,3953;3954;3955;3956,0,0,0,4,0,4
1487,0,1499,3957;3958;3959;3960;3961;3962;3963,0,0,4,2,1,7
1488,0,1500,3964;3965,0,0,0,2,0,2
1489,0,1501,3966;3967;3968;3969,0,1,1,2,0,4
1490,0,1502,3970;3971;3972,0,0,0,3,0,3
1491,0,1503,3973,0,0,0,1,0,1
1492,0,1504,3974;3975;3976;3977;3978,0,0,2,2,1,5
1493,0,1505,3980,0,0,0,1,0,1
1494,0,1506,3981,0,0,0,1,0,1
1495,0,1507,3982,0,0,0,1,0,1
1496,0,1508,3983;3984;3985;3986,0,0,1,3,0,4
1497,0,1509,3987;3988,0,0,0,2,0,2
1498,0,1510,3989;3990,0,0,0,1,1,2
1499,0,1511,3991;3992,0,0,0,2,0,2
1500,0,1512,2776;3993;3994;3995;3996,0,0,2,3,0,5
1501,0,1513,3997;3998,0,0,0,0,2,2
1502,0,1514,3999,0,0,0,1,0,1
1503,0,1515,4000;4001;4002;4003;4004;4005,0,0,0,5,1,6
1504,0,1516,4006,0,0,0,0,1,1
1505,0,1517,4007;4008,0,0,0,1,1,2
1506,0,1518,4009;4010,0,0,0,2,0,2
1507,0,1519,4011,0,0,0,1,0,1
1508,0,1520,4012;4013,0,0,0,2,0,2
1509,0,1521,4014;4015;4016,0,0,1,2,0,3
1510,0,1522,4017,0,0,0,1,0,1
1511,0,1523,4018,0,0,0,1,0,1
1512,0,1524,4019;4020;4021;4022;4023,0,1,1,3,0,5
1513,0,1525,4024;4025,0,0,0,1,1,2
1514,0,1526,4026;4027;4028,0,0,0,2,1,3
1515,0,1527,4029;4030,0,0,0,2,0,2
1516,0,1528,4031,0,0,0,1,0,1
1517,0,1529,4032;4034;4035,0,0,2,1,0,3
1518,0,1530,4036;4037,0,0,0,1,1,2
1519,0,1531,4038;4039,0,0,0,2,0,2
1520,0,1532,4040,0,0,0,0,1,1
1521,0,1533,4041;4042;4043;4044;4045;4046,0,0,4,2,0,6
1522,0,1534,4047;4049,0,0,0,0,2,2
1523,0,1535,4050;4052;4053,0,0,1,2,0,3
1524,0,1536,4054;4055;4056;4057,0,2,0,2,0,4
1525,0,1537,1589;4058,0,0,0,2,0,2
1526,0,1538,4059;4060;4061;4062,0,0,1,2,1,4
1527,0,1539,4063,0,0,0,1,0,1
1528,0,1540,4064;4065,0,0,0,2,0,2
1529,0,1541,4066;4067,0,0,0,1,1,2
1530,0,1542,4068;4069;4070,0,0,1,2,0,3
1531,0,1543,4071;4072;4073;4074;4075,0,2,1,1,1,5
1532,0,1544,4076;4077,0,0,0,2,0,2
1533,0,1545,4078;4079,0,0,0,1,1,2
1534,0,1546,4080;4081,0,0,0,1,1,2
1535,0,1547,4082,0,0,0,1,0,1
1536,0,1548,4083;4084;4085;4086,0,0,0,4,0,4
1537,0,1549,4087,0,0,0,0,1,1
1538,0,1550,4088,0,0,0,1,0,1
1539,0,1551,4089;4090;4091;4092;4093,0,3,0,2,0,5
1540,0,1552,4094,0,0,0,1,0,1
1541,0,1553,4095,0,0,0,1,0,1
1542,0,1554,4096;4097,0,0,0,0,2,2
1543,0,1555,4098,0,0,0,1,0,1
1544,0,1556,4099;4100;4101;4102;4103,0,0,2,3,0,5
1545,0,1557,4104;4106,0,1,0,1,0,2
1546,0,1558,4107;4108;4109,0,0,1,1,1,3
1547,0,1559,4110;4112,0,0,0,1,1,2
1548,0,1560,4113;4114;4115,0,0,0,2,1,3
1549,0,1561,4116,0,0,0,1,0,1
1550,0,1562,4117;4118,0,0,0,1,1,2
1551,0,1563,4119;4120,0,0,0,1,1,2
1552,0,1564,4121;4122,0,0,0,0,2,2
1553,0,1565,4123;4124,0,0,0,2,0,2
1554,0,1566,4125,0,0,0,1,0,1
1555,0,1567,4126;4127,0,0,0,2,0,2
1556,0,1568,4128;4129,0,0,1,1,0,2
1557,0,1569,4130;4131;4132,0,0,0,2,1,3
1558,0,1570,4133,0,0,0,1,0,1
1559,0,1571,4134,0,0,0,1,0,1
1560,0,1572,4135;4136;10074,0,1,0,2,0,3
1561,0,1573,4137;4138,0,0,0,1,1,2
1562,0,1574,4139;4140;4141;9594,0,0,2,2,0,4
1563,0,1575,4142;5939,0,0,0,2,0,2
1564,0,1576,4143;4144,0,0,0,2,0,2
1565,0,1577,4145;4146;4147;4148;4149;4150;4151,0,2,2,1,2,7
1566,0,1578,4152,0,0,0,1,0,1
1567,0,1579,4153;4154;10091,0,1,0,2,0,3
1568,0,1580,4155;4156,0,0,0,2,0,2
1569,0,1581,4157;4158,0,0,0,2,0,2
1570,0,1582,4159;4160,0,0,0,1,1,2
1571,0,1583,4161;4162,0,0,0,2,0,2
1572,0,1584,4163;4164;4165;4166,0,0,2,0,2,4
1573,0,1585,4167;4168;4169;4170,0,0,2,1,1,4
1574,0,1586,4171,0,0,0,1,0,1
1575,0,1587,4172;4173,0,0,0,2,0,2
1576,0,1588,4174;4175,0,0,0,1,1,2
1577,0,1589,4176;4177;4178,0,0,0,2,1,3
1578,0,1590,4179;4180,0,0,0,0,2,2
1579,0,1591,4181;4182,0,0,0,1,1,2
1580,0,1592,4183;4184,0,0,0,1,1,2
1581,0,1593,4185;4186;4187;4189,0,0,1,3,0,4
1582,0,1594,4190,0,0,0,1,0,1
1583,0,1595,4192;4193,0,0,0,2,0,2
1584,0,1596,4194,0,0,0,0,1,1
1585,0,1597,4195;4196;4197;4198,0,0,0,3,1,4
1586,0,1598,4199,0,0,0,1,0,1
1587,0,1599,4200;4201;8234,0,0,0,3,0,3
1588,0,1600,4203;4204,0,0,0,2,0,2
1589,0,1601,4205,0,0,0,1,0,1
1590,0,1602,4206;4207;4208;4209;4210,0,0,0,4,1,5
1591,0,1603,4211;9142,0,0,0,2,0,2
1592,0,1604,4213,0,0,0,0,1,1
1593,0,1605,4214;4215,0,0,0,1,1,2
1594,0,1606,4216;4217;4218;4219;4220;4221,0,1,3,0,2,6
1595,0,1607,4222;4223;4224,0,0,0,3,0,3
1596,0,1608,4225;4226,0,0,0,1,1,2
1597,0,1609,4227;4228;4229,0,1,0,1,1,3
1598,0,1610,4230,0,0,0,1,0,1
1599,0,1611,4231;4232,0,0,0,2,0,2
1600,0,1612,4233;4234;4235,0,1,0,1,1,3
1601,0,1613,4236,0,0,0,1,0,1
1602,0,1614,4237;4238,0,0,0,2,0,2
1603,0,1615,4239,0,0,0,1,0,1
1604,0,1616,4240;4241,0,0,0,2,0,2
1605,0,1617,4242;4244,0,0,0,0,2,2
1606,0,1618,4245;4246,0,0,0,1,1,2
1607,0,1619,4247;4249,0,0,0,2,0,2
1608,0,1620,4250;4251;4252,0,0,1,1,1,3
1609,0,1621,4253;4254,0,0,0,2,0,2
1610,0,1622,4255;4256;4257;4258;4259,0,0,2,3,0,5
1611,0,1623,2935;4260,0,0,0,2,0,2
1612,0,1624,4261,0,0,0,1,0,1
1613,0,1625,4262,0,0,0,1,0,1
1614,0,1626,4263;4264,0,0,0,2,0,2
1615,0,1627,4265;4266;4267;4268,0,0,2,1,1,4
1616,0,1628,4269;4270;4271;4272;4273;4274,0,0,3,3,0,6
1617,0,1629,4275;4276;4277;4278;4279;4280,0,0,2,3,1,6
1618,0,1630,4281;4282;4283;4284;4285,0,0,3,2,0,5
1619,0,1631,4286;4287;4288,0,0,0,3,0,3
1620,0,1632,4289;4290,0,0,1,1,0,2
1621,0,1633,401;4291,0,0,0,2,0,2
1622,0,1634,4292;4293;4294;4295,0,1,0,3,0,4
1623,0,1635,4296;4297,0,0,0,2,0,2
1624,0,1636,4298;4299;10012,0,1,0,2,0,3
1625,0,1637,4300,0,0,0,1,0,1
1626,0,1638,4302;4303;4304,0,1,0,2,0,3
1627,0,1639,4305;4306;4307;4308;10087,0,1,2,2,0,5
1628,0,1640,4309,0,0,0,1,0,1
1629,0,1641,4310;4311,0,0,0,2,0,2
1630,0,1642,4312;4313;4314;4315,0,0,1,1,2,4
1631,0,1643,4316;4317,0,0,0,2,0,2
1632,0,1644,4318,0,0,0,1,0,1
1633,0,1645,4319;4320;4321,0,0,0,2,1,3
1634,0,1646,4322,0,0,0,0,1,1
1635,0,1647,4323;4324,0,0,0,2,0,2
1636,0,1648,4325,0,0,0,1,0,1
1637,0,1649,4326;4327,0,0,0,0,2,2
1638,0,1650,4328;4329,0,0,0,2,0,2
1639,0,1651,4330;4331,0,0,0,2,0,2
1640,0,1652,4332,0,0,0,1,0,1
1641,0,1653,4333,0,0,0,1,0,1
1642,0,1654,4334;4335;4336;4337,0,1,1,2,0,4
1643,0,1655,4338;4339;4340,0,0,0,1,2,3
1644,0,1656,4341,0,0,0,1,0,1
1645,0,1657,4342;4343,0,0,0,0,2,2
1646,0,1658,4344;9412,0,0,0,2,0,2
1647,0,1659,4345;4346,0,0,0,2,0,2
1648,0,1660,4347,0,0,0,1,0,1
1649,0,1661,4348;4349;4350,0,0,0,2,1,3
1650,0,1662,4351;4352,0,0,0,2,0,2
1651,0,1663,4353;4354;4355;4356,0,0,0,2,2,4
1652,0,1664,4357;10090,0,1,0,1,0,2
1653,0,1665,4358,0,0,0,1,0,1
1654,0,1666,4359;4360,0,0,0,0,2,2
1655,0,1667,4361;4362;4363,0,0,0,1,2,3
1656,0,1668,4364,0,0,0,1,0,1
1657,0,1669,4365,0,0,0,1,0,1
1658,0,1670,4366;4367;4368;4369;4370,0,0,3,1,1,5
1659,0,1671,4371;4372;4373;4374;4375,0,0,2,2,1,5
1660,0,1672,4376;4377;4378;4379;10011,0,1,0,3,1,5
1661,0,1673,4380;4381,0,0,1,1,0,2
1662,0,1674,4382;4383;4384;4385,0,1,0,3,0,4
1663,0,1675,4386;4387,0,0,0,1,1,2
1664,0,1676,4388;4389;4390,0,0,0,1,2,3
1665,0,1677,4391;4392,0,0,0,1,1,2
1666,0,1679,4396;4397;4398;4399;4400;4401,0,0,3,2,1,6
1667,0,1680,4402;4403,0,0,0,2,0,2
1668,0,1681,4404;4405;4406,0,0,0,2,1,3
1669,0,1682,4407,0,0,0,1,0,1
1670,0,1683,4408;4409;4410;4411,0,0,1,2,1,4
1671,0,1684,4412;4413,0,0,0,2,0,2
1672,0,1685,4414,0,0,0,0,1,1
1673,0,1686,4415;4416;4417,0,0,0,2,1,3
1674,0,1687,4418;4419,0,0,0,2,0,2
1675,0,1688,4420;4421,0,0,0,1,1,2
1676,0,1689,4422;4423,0,0,0,1,1,2
1677,0,1690,4424;4425,0,0,0,1,1,2
1678,0,1691,4426;4427,0,0,0,1,1,2
1679,0,1692,4428,0,0,0,1,0,1
1680,0,1693,4429,0,0,0,1,0,1
1681,0,1694,4430;4431,0,0,0,2,0,2
1682,0,1695,4432,0,0,0,0,1,1
1683,0,1696,2593;4433;4434;4435;4436,0,0,2,3,0,5
1684,0,1697,4437;4438,0,0,0,2,0,2
1685,0,1698,4439,0,0,0,0,1,1
1686,0,1699,4440;4441,0,0,0,1,1,2
1687,0,1700,4442,0,0,0,1,0,1
1688,0,1701,4443;4444;4445,0,0,0,3,0,3
1689,0,1702,4446;4447;4448;4449,0,0,2,2,0,4
1690,0,1703,4450;4451,0,0,0,2,0,2
1691,0,1704,4452;4453,0,0,0,2,0,2
1692,0,1705,4454;4455;4456,0,1,0,2,0,3
1693,0,1706,4457;4458;4459;4460,0,0,0,1,3,4
1694,0,1707,4461,0,0,0,1,0,1
1695,0,1708,4462;4463,0,0,0,1,1,2
1696,0,1709,4464,0,0,0,1,0,1
1697,0,1710,4465;4466,0,0,0,1,1,2
1698,0,1711,4467,0,0,0,1,0,1
1699,0,1712,4468;4469;4470;4471,0,2,0,2,0,4
1700,0,1713,4472;4473;4474;4475;4476,0,1,1,2,1,5
1701,0,1714,4477;4478;4479,0,0,1,1,1,3
1702,0,1715,4480;4481;4482,0,0,2,0,1,3
1703,0,1716,4483;4484;4486;4487,0,0,1,3,0,4
1704,0,1717,4488;4489,0,0,0,1,1,2
1705,0,1718,4490;4491;4492;4493,0,0,0,3,1,4
1706,0,1719,4494,0,0,0,1,0,1
1707,0,1720,4495;4496,0,0,0,1,1,2
1708,0,1721,4497;4498;4499;4500,0,0,0,4,0,4
1709,0,1722,4501;4502,0,0,0,2,0,2
1710,0,1723,4503;4504;4505;4506,0,0,1,3,0,4
1711,0,1724,4507;4508;4509;4510;4511,0,0,3,2,0,5
1712,0,1725,4512;4513;4514;4515;4516,0,2,1,0,2,5
1713,0,1726,4517,0,0,0,1,0,1
1714,0,1727,4518;4519,0,0,0,1,1,2
1715,0,1728,4520;4521;4522;4523,0,1,0,3,0,4
1716,0,1729,4524,0,0,0,1,0,1
1717,0,1730,4525;4526;4527;4528,0,0,1,3,0,4
1718,0,1731,4529;4530,0,0,0,2,0,2
1719,0,1732,0;4531,0,0,0,2,0,2
1720,0,1733,4532;4533;4534;4535,0,1,0,2,1,4
1721,0,1734,4536,0,0,0,1,0,1
1722,0,1735,4537,0,0,0,0,1,1
1723,0,1736,4538;4539,0,0,0,2,0,2
1724,0,1737,4540;4541;4542;4543;4544,0,1,2,2,0,5
1725,0,1738,4545,0,0,0,1,0,1
1726,0,1739,4546;4547;4548,0,0,0,3,0,3
1727,0,1740,4549;4550;4551;4552;4553,0,0,1,2,2,5
1728,0,1741,4554;4555,0,0,0,1,1,2
1729,0,1742,4556,0,0,0,1,0,1
1730,0,1743,4557,0,0,0,0,1,1
1731,0,1744,4558;4559,0,0,0,2,0,2
1732,0,1745,4560;4561,0,0,0,2,0,2
1733,0,1746,4562,0,0,0,1,0,1
1734,0,1747,4564;4565,0,0,0,1,1,2
1735,0,1748,4566;4567,0,0,0,1,1,2
1736,0,1749,4568;4569;4570;4571,0,1,0,1,2,4
1737,0,1750,4572;4573;4574,0,0,0,0,3,3
1738,0,1751,4575;4576;4577,0,0,1,1,1,3
1739,0,1752,4578,0,0,0,1,0,1
1740,0,1753,4579;4580;4581;4582,0,0,1,2,1,4
1741,0,1754,4583,0,0,0,0,1,1
1742,0,1755,4584;4585;4586;4587,0,1,1,2,0,4
1743,0,1756,4588;4589;4590,0,0,0,2,1,3
1744,0,1757,4591;4592;4593;4594;4595,0,0,1,3,1,5
1745,0,1758,4596;4597,0,0,0,1,1,2
1746,0,1759,4598;4599;4600;4601,0,0,2,0,2,4
1747,0,1760,4602;4603,0,0,0,1,1,2
1748,0,1761,4604;4605;4606;4607;4608,0,0,0,5,0,5
1749,0,1762,4609;4610,0,0,0,1,1,2
1750,0,1763,4611;4612,0,0,0,2,0,2
1751,0,1764,4613;4614;4615;4616;4617,0,0,1,2,2,5
1752,0,1765,4618;4619,0,0,0,2,0,2
1753,0,1766,4620;4622;4623,0,0,0,2,1,3
1754,0,1767,4624;4625,0,0,0,1,1,2
1755,0,1768,4626;4627;4628;4629;4630,0,1,2,2,0,5
1756,0,1769,4631;4632;4633;4634,0,2,0,0,2,4
1757,0,1770,4635;4636;4637,0,0,1,2,0,3
1758,0,1771,4638,0,0,0,1,0,1
1759,0,1772,4639;4640;4641,0,0,0,2,1,3
1760,0,1773,4642;4643,0,0,0,1,1,2
1761,0,1774,4644;4645,0,0,0,1,1,2
1762,0,1775,4646;4647;4648;4649,0,0,1,3,0,4
1763,0,1776,4650;4651,0,0,0,2,0,2
1764,0,1777,4652;4653;4654;4655;4656,0,1,2,1,1,5
1765,0,1778,4657;4658,0,0,0,1,1,2
1766,0,1779,4659;4660,0,0,0,2,0,2
1767,0,1780,4661,0,0,0,1,0,1
1768,0,1781,4662,0,0,0,1,0,1
1769,0,1782,4663,0,0,0,0,1,1
1770,0,1783,4664;4665,0,0,0,0,2,2
1771,0,1784,4666;4667;4668;4669,0,1,0,3,0,4
1772,0,1785,4670,0,0,0,1,0,1
1773,0,1786,4671;4672,0,0,0,1,1,2
1774,0,1787,4673;4674;10008,0,1,0,2,0,3
1775,0,1788,4675;4676;4677,0,1,0,2,0,3
1776,0,1789,4678;4679;4680,0,0,1,2,0,3
1777,0,1790,4681;4682,0,0,0,1,1,2
1778,0,1791,4683;4684,0,0,0,1,1,2
1779,0,1792,4685;4686,0,0,0,2,0,2
1780,0,1793,4687;4688;4689;4690,0,0,2,2,0,4
1781,0,1794,4691;4692;4693;4694,0,0,2,2,0,4
1782,0,1795,4695;4696,0,0,0,0,2,2
1783,0,1796,4697;4698;4699;4700,0,2,0,0,2,4
1784,0,1797,4701,0,0,0,0,1,1
1785,0,1798,4702;4703;4704,0,1,0,2,0,3
1786,0,1799,4705;4706;4707,0,0,0,3,0,3
1787,0,1800,4708;4709,0,0,0,2,0,2
1788,0,1801,4710,0,0,0,0,1,1
1789,0,1802,4711;4712;4713;4714,0,0,2,2,0,4
1790,0,1803,4715;4716,0,0,0,0,2,2
1791,0,1804,4717;4718,0,0,0,2,0,2
1792,0,1805,4719;4720;4721;4722;4723,0,0,3,1,1,5
1793,0,1806,4724;4725,0,0,0,1,1,2
1794,0,1807,4726;4727,0,0,0,2,0,2
1795,0,1808,4728;4729,0,0,0,0,2,2
1796,0,1809,4730,0,0,0,1,0,1
1797,0,1810,4731;4732,0,0,0,1,1,2
1798,0,1811,4733;4734;4735;4736,0,0,1,3,0,4
1799,0,1812,4737;4738;4739;4740,0,0,0,4,0,4
1800,0,1813,4741;4742;4743,0,1,0,2,0,3
1801,0,1814,4744;4745,0,0,0,0,2,2
1802,0,1815,4746;4747;4748,0,1,0,1,1,3
1803,0,1816,4749;4750;4751;4752,0,1,0,2,1,4
1804,0,1817,4753;4754;4755;4756;4757,0,1,2,2,0,5
1805,0,1818,4758,0,0,0,1,0,1
1806,0,1819,4759;4760,0,0,0,1,1,2
1807,0,1820,4761;4762;4763;4764;4765,0,0,0,5,0,5
1808,0,1821,4766,0,0,0,1,0,1
1809,0,1822,4767;4768;4769;4770;4771,0,0,2,2,1,5
1810,0,1823,4772;4773,0,0,0,1,1,2
1811,0,1824,4774;4775,0,0,0,2,0,2
1812,0,1825,4776,0,0,0,1,0,1
1813,0,1826,4777;4778,0,0,0,2,0,2
1814,0,1827,4779;4780,0,0,0,2,0,2
1815,0,1828,4781,0,0,0,1,0,1
1816,0,1829,4782;4783;10029,0,1,0,2,0,3
1817,0,1830,4784,0,0,0,1,0,1
1818,0,1831,565;4785,0,0,0,2,0,2
1819,0,1832,4786,0,0,0,1,0,1
1820,0,1833,4787,0,0,0,1,0,1
1821,0,1834,4788,0,0,0,1,0,1
1822,0,1835,4789;4790;4791;4792;4793,0,0,1,2,2,5
1823,0,1836,4794;4795;4796;4797;4798;4799,0,0,1,3,2,6
1824,0,1837,4800,0,0,0,1,0,1
1825,0,1838,4801;4803;4804,0,0,0,2,1,3
1826,0,1839,4805;4806,0,0,0,2,0,2
1827,0,1840,4807;4808;4809,0,0,1,1,1,3
1828,0,1841,4810;4811,0,0,0,2,0,2
1829,0,1842,4812;4813,0,0,0,2,0,2
1830,0,1843,4814;4815,0,0,0,1,1,2
1831,0,1844,4816,0,0,0,1,0,1
1832,0,1845,4817,0,0,0,0,1,1
1833,0,1846,4818;4819;4820;4821,0,0,0,2,2,4
1834,0,1847,4822;4823,0,0,0,2,0,2
1835,0,1848,4824,0,0,0,1,0,1
1836,0,1849,4825;4826;4827;4828,0,0,2,1,1,4
1837,0,1850,4829,0,0,0,1,0,1
1838,0,1851,4830;4831;4832;4833,0,2,0,2,0,4
1839,0,1852,4834;4835,0,0,0,2,0,2
1840,0,1853,2594;4836;4837;4838,0,0,1,2,1,4
1841,0,1854,4839;4840,0,0,0,1,1,2
1842,0,1855,4841;4842,0,0,0,2,0,2
1843,0,1856,4843;4844;4845;4846,0,2,0,2,0,4
1844,0,1857,4847,0,0,0,0,1,1
1845,0,1858,4848;4849;4850;4851,0,1,1,2,0,4
1846,0,1859,4852;4853;4854;4855;4856,0,0,3,1,1,5
1847,0,1860,4857;4858;4859;4860;4861;4862,0,0,4,1,1,6
1848,0,1861,4863;4864;4866;4867;4868,0,2,0,2,1,5
1849,0,1862,4869;4870,0,0,0,2,0,2
1850,0,1863,4871;4872;4873;4874,0,0,2,2,0,4
1851,0,1864,4875;4876,0,0,0,1,1,2
1852,0,1865,4877;4878,0,0,0,1,1,2
1853,0,1866,4879,0,0,0,1,0,1
1854,0,1867,4881;4882;4883,0,1,0,1,1,3
1855,0,1868,4884;4885;4886;4887;4888;4889,0,0,1,4,1,6
1856,0,1869,4890;4891;4892,0,1,0,1,1,3
1857,0,1870,4893,0,0,0,1,0,1
1858,0,1871,4894;4897;4898,0,0,1,1,1,3
1859,0,1872,4899;4900,0,0,0,2,0,2
1860,0,1873,4901;4902,0,0,0,1,1,2
1861,0,1874,4903,0,0,0,0,1,1
1862,0,1875,4904;4905,0,0,0,1,1,2
1863,0,1876,4906,0,0,0,0,1,1
1864,0,1877,4907;4908;4909;8851,0,0,1,3,0,4
1865,0,1878,4910,0,0,0,1,0,1
1866,0,1879,4911;4912,0,0,0,1,1,2
1867,0,1880,4913;4914;4915;4916,0,0,0,3,1,4
1868,0,1881,4917;4918;4919;4920,0,0,0,4,0,4
1869,0,1882,4921;4922;4923;4924;4925,0,0,1,4,0,5
1870,0,1883,4926,0,0,0,1,0,1
1871,0,1884,4927;4928;4929;4930;4931,0,0,0,4,1,5
1872,0,1885,4932;4933,0,0,0,2,0,2
1873,0,1886,4934,0,0,0,1,0,1
1874,0,1887,4935;4936,0,0,0,2,0,2
1875,0,1888,4937;4938;4939;4940;4941,0,0,0,3,2,5
1876,0,1889,4942;4943;4944;4945;4946,0,2,0,3,0,5
1877,0,1890,4947;4948;4949;4950,0,0,2,2,0,4
1878,0,1891,4951;4952;4953;4954;4955;4956,0,1,2,3,0,6
1879,0,1892,4957;4958;4959;4960,0,2,0,2,0,4
1880,0,1893,4961;4962;4963,0,0,1,2,0,3
1881,0,1894,4964;4965,0,0,0,2,0,2
1882,0,1895,4966;4967;4968,0,0,0,2,1,3
1883,0,1896,4969;4970,0,0,0,1,1,2
1884,0,1897,4972;4973,0,0,0,1,1,2
1885,0,1898,4974;4975,0,0,0,1,1,2
1886,0,1899,4976;4977;4978;4979,0,0,1,2,1,4
1887,0,1900,4980;4981,0,0,0,1,1,2
1888,0,1901,4982;4983,0,0,0,1,1,2
1889,0,1902,4984,0,0,0,0,1,1
1890,0,1903,4985,0,0,0,1,0,1
1891,0,1904,4986,0,0,0,1,0,1
1892,0,1905,4987;4988;4989;4990,0,0,1,2,1,4
1893,0,1906,4991;4992,0,0,0,2,0,2
1894,0,1907,4993;4994,0,0,0,0,2,2
1895,0,1908,4995;4996,0,0,0,1,1,2
1896,0,1909,4997,0,0,0,1,0,1
1897,0,1910,4998;4999;5000;5001;5002,0,0,2,2,1,5
1898,0,1911,5003;5004;5005,0,0,0,1,2,3
1899,0,1912,5006;5007;5008,0,0,0,3,0,3
1900,0,1913,5009;5010,0,0,0,1,1,2
1901,0,1914,5011;5012;5013,0,0,1,2,0,3
1902,0,1915,5014;5015;5016;5017,0,0,1,2,1,4
1903,0,1916,5018;5019,0,0,0,2,0,2
1904,0,1917,5020;5021;5022,0,0,0,2,1,3
1905,0,1918,5023;5024;5025,0,0,2,0,1,3
1906,0,1919,5026;5027,0,1,0,1,0,2
1907,0,1920,5028,0,0,0,1,0,1
1908,0,1921,5029;5030;5031;5032,0,1,1,1,1,4
1909,0,1922,5033;5034,0,0,0,2,0,2
1910,0,1923,5035;5036,0,0,0,2,0,2
1911,0,1924,5037;5038,0,0,0,2,0,2
1912,0,1925,5039;5040,0,1,0,0,1,2
1913,0,1926,5041;5042;5043;5044,0,0,2,2,0,4
1914,0,1927,5045;5046;5047,0,1,0,2,0,3
1915,0,1928,5048;5049;5050,0,0,0,3,0,3
1916,0,1929,5051;5052;5053,0,0,0,3,0,3
1917,0,1930,5054;5055,0,0,0,1,1,2
1918,0,1931,5056;5057,0,0,0,0,2,2
1919,0,1932,5059;5060,0,0,0,1,1,2
1920,0,1933,5061;5062;5063;5064,0,1,1,1,1,4
1921,0,1934,5065;5066,0,0,0,2,0,2
1922,0,1935,5067;5068,0,0,0,2,0,2
1923,0,1936,5069;5070;5071;5072,0,0,1,2,1,4
1924,0,1937,5073;5074,0,0,0,2,0,2
1925,0,1938,5075;5076,0,0,0,1,1,2
1926,0,1939,5077,0,0,0,0,1,1
1927,0,1940,5079,0,0,0,0,1,1
1928,0,1941,5080;5081,0,0,0,1,1,2
1929,0,1942,5082;5083;5084;5085;5086;5087,0,0,2,3,1,6
1930,0,1943,5088;5089,0,0,0,1,1,2
1931,0,1944,5090;5091,0,0,0,1,1,2
1932,0,1945,5092;5093,0,0,0,1,1,2
1933,0,1946,5094;5095;5096;5097,0,1,0,2,1,4
1934,0,1947,5098;5099;5100,0,1,0,2,0,3
1935,0,1948,5101;5102;10104,0,1,0,1,1,3
1936,0,1949,5103;5104;5105,0,0,1,1,1,3
1937,0,1950,5106,0,0,0,0,1,1
1938,0,1951,5107,0,0,0,0,1,1
1939,0,1952,5108,0,0,0,1,0,1
1940,0,1953,5109;5111;5112;5114,0,0,1,2,1,4
1941,0,1954,5115;5116,0,0,0,2,0,2
1942,0,1955,5118;5119,0,0,0,2,0,2
1943,0,1956,5120,0,0,0,1,0,1
1944,0,1957,5121,0,0,0,0,1,1
1945,0,1958,5122,0,0,0,0,1,1
1946,0,1959,5123,0,0,0,1,0,1
1947,0,1960,5125,0,0,0,1,0,1
1948,0,1961,5126;5127;5128,0,1,0,1,1,3
1949,0,1962,5129;5130,0,0,0,1,1,2
1950,0,1963,5131;5132;5133;5134;5135,0,1,1,2,1,5
1951,0,1964,5136;5137,0,0,1,1,0,2
1952,0,1965,5138,0,0,0,1,0,1
1953,0,1966,5139;5140,0,0,0,2,0,2
1954,0,1967,5141;5142,0,0,0,1,1,2
1955,0,1968,5143;5144,0,0,0,2,0,2
1956,0,1969,5145;5146;5147;5148;5149,0,0,0,2,3,5
1957,0,1970,5150;5151,0,0,0,1,1,2
1958,0,1971,5152;5153,0,0,0,1,1,2
1959,0,1972,5154;5155;5156,0,1,0,1,1,3
1960,0,1973,5157;5158;5159;5160;5161,0,1,2,2,0,5
1961,0,1974,5162;5163,0,0,0,2,0,2
1962,0,1975,5164;5165;5166,0,0,1,2,0,3
1963,0,1976,5167;5168;5169;5170,0,0,1,3,0,4
1964,0,1977,5171,0,0,0,0,1,1
1965,0,1978,5172;5174;5175,0,1,1,1,0,3
1966,0,1979,5176;5177;5178,0,0,0,3,0,3
1967,0,1980,5179;5180;5181;10093,0,1,1,2,0,4
1968,0,1981,5182,0,0,0,0,1,1
1969,0,1982,5183,0,0,0,1,0,1
1970,0,1983,5184;5185;5186;5187,0,2,0,2,0,4
1971,0,1984,5188;5189;5190;5191;5192,0,0,3,1,1,5
1972,0,1985,5193;5194,0,0,0,1,1,2
1973,0,1986,5195;5196,0,0,1,1,0,2
1974,0,1987,5197;5198,0,0,0,2,0,2
1975,0,1988,5199;5201;5202,0,0,2,1,0,3
1976,0,1989,5203;5204,0,0,0,0,2,2
1977,0,1990,5205;5206,0,0,0,2,0,2
1978,0,1991,5207,0,0,0,1,0,1
1979,0,1992,5209;5211,0,0,0,2,0,2
1980,0,1993,5212;5213;5214;5215;5216,0,0,0,5,0,5
1981,0,1994,5217;5218,0,0,0,2,0,2
1982,0,1995,5219;5220;5221,0,0,0,3,0,3
1983,0,1996,5222;5223,0,0,0,2,0,2
1984,0,1997,5224,0,0,0,1,0,1
1985,0,1998,5226;5227;5228,0,1,0,2,0,3
1986,0,1999,5229;5230;5231;5232,0,0,1,2,1,4
1987,0,2000,5233;5234;5235;5236,0,0,0,3,1,4
1988,0,2001,5237;5238;10100,0,1,0,1,1,3
1989,0,2002,5239,0,0,0,1,0,1
1990,0,2003,5240;5241,0,0,1,1,0,2
1991,0,2004,5242;5243;5244;5245,0,0,1,2,1,4
1992,0,2005,5246;5247;5248;5249;10038,0,2,1,2,0,5
1993,0,2006,5250;5251,0,0,0,2,0,2
1994,0,2007,5252,0,0,0,0,1,1
1995,0,2008,5253;5254,0,0,0,0,2,2
1996,0,2009,5255;5256;5257;5258,0,1,0,2,1,4
1997,0,2010,5259;5260;5261,0,0,2,1,0,3
1998,0,2011,5262;5263,0,0,0,1,1,2
1999,0,2013,5265;5266;5267,0,0,0,2,1,3
2000,0,2014,5268;5269,0,0,0,1,1,2
2001,0,2015,5270,0,0,0,0,1,1
2002,0,2016,5271,0,0,0,1,0,1
2003,0,2017,5272;5273,0,0,0,2,0,2
2004,0,2018,5274,0,0,0,1,0,1
2005,0,2019,5275;5276;5277;5278,0,0,1,2,1,4
2006,0,2020,5279,0,0,0,1,0,1
2007,0,2021,5280;5281;5282;5283,0,0,0,4,0,4
2008,0,2022,5284;5285,0,0,0,2,0,2
2009,0,2023,5287;5288;5289,0,0,0,2,1,3
2010,0,2024,5290;5291,0,0,0,2,0,2
2011,0,2025,5292;5293,0,0,0,1,1,2
2012,0,2026,5294;5295;5296;5297,0,1,1,2,0,4
2013,0,2027,5298,0,0,0,1,0,1
2014,0,2028,5299;5300;5301;5302,0,0,2,1,1,4
2015,0,2029,5303;5304,0,0,0,1,1,2
2016,0,2030,5306;5307,0,0,0,0,2,2
2017,0,2031,5308;5309;5310;5311,0,2,0,2,0,4
2018,0,2032,5313,0,0,0,1,0,1
2019,0,2033,5314;5315,0,0,0,2,0,2
2020,0,2034,5316;5317;5318,0,0,1,1,1,3
2021,0,2035,5319;5320,0,0,0,2,0,2
2022,0,2036,5321,0,0,0,1,0,1
2023,0,2038,5323,0,0,0,1,0,1
2024,0,2039,5324;5325,0,0,0,1,1,2
2025,0,2040,5326;5327;5328;5329;5330;5331,0,1,3,2,0,6
2026,0,2041,5332;10007,0,1,0,1,0,2
2027,0,2042,5333,0,0,0,1,0,1
2028,0,2043,5334;5335,0,0,0,2,0,2
2029,0,2044,5336;5337,0,0,0,2,0,2
2030,0,2045,5338;10023,0,1,0,1,0,2
2031,0,2046,5339;5340,0,0,0,2,0,2
2032,0,2047,5341,0,0,0,1,0,1
2033,0,2048,5342;5343,0,0,0,2,0,2
2034,0,2049,5344;5345,0,0,0,0,2,2
2035,0,2050,5346;5347,0,0,0,1,1,2
2036,0,2051,5348;5349,0,0,0,1,1,2
2037,0,2052,5350;5351;5352;5353,0,0,1,2,1,4
2038,0,2053,5354;5355,0,0,0,1,1,2
2039,0,2054,5356;5357,0,0,0,2,0,2
2040,0,2055,5358;5359,0,0,0,1,1,2
2041,0,2056,5361;5362,0,0,0,2,0,2
2042,0,2057,5363;5364;5365;5366;5367,0,1,1,3,0,5
2043,0,2058,5369;5574,0,0,0,2,0,2
2044,0,2059,5371;5372,0,0,0,2,0,2
2045,0,2060,5373;5374,0,0,0,2,0,2
2046,0,2061,5375;5376;5377;5378;5379,0,0,1,4,0,5
2047,0,2062,5381;5382,0,0,1,0,1,2
2048,0,2063,5383;5384,0,0,0,2,0,2
2049,0,2064,5385;5386;5387,0,0,0,3,0,3
2050,0,2065,5388;5389;5390,0,1,0,1,1,3
2051,0,2066,5391;5392;10034,0,1,0,2,0,3
2052,0,2067,2316;5393,0,0,0,2,0,2
2053,0,2068,5394;5395;5396,0,0,3,0,0,3
2054,0,2069,5397;5398,0,0,0,2,0,2
2055,0,2070,5399;5400;5401;5402,0,1,0,2,1,4
2056,0,2071,5403;5404,0,0,0,2,0,2
2057,0,2072,5405;5406,0,0,0,2,0,2
2058,0,2073,5407;5408;5409;5410,0,0,1,2,1,4
2059,0,2074,5412;5413,0,0,0,1,1,2
2060,0,2075,5414;5415,0,0,0,1,1,2
2061,0,2076,5416,0,0,0,1,0,1
2062,0,2077,5417;5418;5419;5420;5421,0,1,1,2,1,5
2063,0,2078,5422;10004,0,1,0,1,0,2
2064,0,2079,5423;5424;5425,0,1,0,2,0,3
2065,0,2080,5426;5427;10046,0,1,0,2,0,3
2066,0,2081,5428;5429,0,0,0,1,1,2
2067,0,2082,5430;5431;5432;5433,0,1,0,3,0,4
2068,0,2083,5434;5435;5436;5437;10022,0,3,0,1,1,5
2069,0,2084,5438;5439;5440;5441;5442;5443,0,0,3,2,1,6
2070,0,2085,5444;5445,0,0,0,1,1,2
2071,0,2086,5446;5447;5448;5449,0,1,1,1,1,4
2072,0,2087,5450;5451;5452,0,0,0,2,1,3
2073,0,2088,5453,0,0,0,1,0,1
2074,0,2089,5454;5455,0,0,0,2,0,2
2075,0,2090,5456;5457;5458;5459;5460,0,2,1,2,0,5
2076,0,2091,5461,0,0,0,1,0,1
2077,0,2092,5462,0,0,0,1,0,1
2078,0,2093,5463;5464,0,0,0,2,0,2
2079,0,2094,5465;5466;10024,0,1,0,1,1,3
2080,0,2095,5467,0,0,0,0,1,1
2081,0,2096,5468;5469,0,0,0,1,1,2
2082,0,2097,5470;5471,0,0,0,0,2,2
2083,0,2098,5472;5473,0,0,0,1,1,2
2084,0,2099,5474,0,0,0,1,0,1
2085,0,2100,5475;5476,0,0,0,2,0,2
2086,0,2101,5477;5478;5479;5480,0,2,0,2,0,4
2087,0,2102,5481;5482,0,0,0,1,1,2
2088,0,2103,5484,0,0,0,1,0,1
2089,0,2104,5485;5486;5487,0,0,0,3,0,3
2090,0,2105,5488;5489;5490,0,0,1,2,0,3
2091,0,2106,5491;5492,0,0,0,2,0,2
2092,0,2107,5494;5495,0,0,0,0,2,2
2093,0,2108,5496;5497,0,0,0,1,1,2
2094,0,2109,5498;5500;5501,0,0,0,0,3,3
2095,0,2110,5502;5503,0,0,0,1,1,2
2096,0,2111,5504,0,0,0,1,0,1
2097,0,2112,5505,0,0,0,1,0,1
2098,0,2113,5506,0,0,0,1,0,1
2099,0,2114,5508,0,0,0,1,0,1
2100,0,2115,5509,0,0,0,1,0,1
2101,0,2116,5510;5511;5512,0,0,0,2,1,3
2102,0,2117,5513;5514;5515;5516,0,0,0,4,0,4
2103,0,2118,5517;5518,0,0,0,2,0,2
2104,0,2119,5519;5520;5521;5522,0,2,0,1,1,4
2105,0,2120,5523;5524;5525;5526,0,1,1,2,0,4
2106,0,2121,5527,0,0,0,1,0,1
2107,0,2122,5528,0,0,0,1,0,1
2108,0,2123,5529,0,0,0,1,0,1
2109,0,2124,5530;5531,0,0,0,1,1,2
2110,0,2125,5532;5533;10006,0,1,0,1,1,3
2111,0,2126,5534,0,0,0,1,0,1
2112,0,2127,5535;5536,0,0,0,2,0,2
2113,0,2128,5537,0,0,0,1,0,1
2114,0,2129,5538,0,0,0,0,1,1
2115,0,2130,5539;5541;5542,0,0,0,2,1,3
2116,0,2131,5543;5544;5545;5546;5547,0,0,2,2,1,5
2117,0,2132,5548;5549;5550;10061,0,1,0,3,0,4
2118,0,2133,5551;5552;5553;5554,0,0,2,1,1,4
2119,0,2134,5555;5556;5557,0,1,0,1,1,3
2120,0,2135,5558;5559,0,0,0,1,1,2
2121,0,2136,5560;5561,0,0,0,2,0,2
2122,0,2137,5562;5563;5564;5565,0,0,1,2,1,4
2123,0,2138,5566;5567;5568,0,0,0,1,2,3
2124,0,2139,5569;5570;5571;5572;5573,0,0,2,2,1,5
2125,0,2141,5575;5576;5577,0,0,0,2,1,3
2126,0,2142,5578,0,0,0,1,0,1
2127,0,2143,5579;5580,0,0,0,2,0,2
2128,0,2144,3508;5581,0,0,0,2,0,2
2129,0,2145,5582,0,0,0,1,0,1
2130,0,2146,5583,0,0,0,1,0,1
2131,0,2147,5584;5585,0,0,0,0,2,2
2132,0,2148,5586;5587;5588;5589;5590,0,0,1,2,2,5
2133,0,2149,5591,0,0,0,1,0,1
2134,0,2150,4048;5592,0,0,0,2,0,2
2135,0,2151,5593;5594,0,0,0,2,0,2
2136,0,2152,5595;5596,0,0,0,2,0,2
2137,0,2153,5597;5598,0,0,0,1,1,2
2138,0,2154,5599;5600;5601,0,0,0,3,0,3
2139,0,2155,5602;5603;5604;5605;5606,0,0,3,2,0,5
2140,0,2156,5607,0,0,0,1,0,1
2141,0,2157,5608;5609,0,0,0,2,0,2
2142,0,2158,5610;5611,0,0,0,1,1,2
2143,0,2159,5613,0,0,0,1,0,1
2144,0,2160,5614;5615;5616;5617,0,0,2,2,0,4
2145,0,2161,5618;5619,0,0,0,2,0,2
2146,0,2162,5620;5621,0,0,0,1,1,2
2147,0,2163,5623;5624,0,0,0,0,2,2
2148,0,2164,5625;5626,0,0,0,2,0,2
2149,0,2165,5627;5628;5629;5630,0,0,1,2,1,4
2150,0,2166,5631;5632,0,0,0,1,1,2
2151,0,2167,5633,0,0,0,1,0,1
2152,0,2168,5634;5635,0,0,0,2,0,2
2153,0,2169,5637;5638;5639,0,0,0,1,2,3
2154,0,2170,5640;5641;5642;5643,0,2,0,2,0,4
2155,0,2171,5644;6827,0,0,0,2,0,2
2156,0,2172,5645;5646;5647,0,0,0,0,3,3
2157,0,2173,5648;5649,0,0,0,2,0,2
2158,0,2174,5651,0,0,0,1,0,1
2159,0,2175,5652;5653;5654,0,0,0,3,0,3
2160,0,2176,5655;5656,0,0,0,2,0,2
2161,0,2177,5657;5658;5659,0,1,0,1,1,3
2162,0,2178,5660;5661;5662,0,0,1,2,0,3
2163,0,2179,5663;5664,0,0,0,2,0,2
2164,0,2180,5665,0,0,0,0,1,1
2165,0,2181,5666;5667;5668,0,0,0,3,0,3
2166,0,2182,5669,0,0,0,0,1,1
2167,0,2183,5670;5671,0,0,0,1,1,2
2168,0,2184,5672;5673;5674,0,0,1,1,1,3
2169,0,2185,307;5675,0,0,0,2,0,2
2170,0,2186,5676,0,0,0,1,0,1
2171,0,2187,5677;5678;5679,0,0,1,1,1,3
2172,0,2188,5680;5681,0,0,0,2,0,2
2173,0,2189,5682,0,0,0,1,0,1
2174,0,2190,5683;5684,0,0,0,1,1,2
2175,0,2191,5685;5686;5687;5688,0,0,1,2,1,4
2176,0,2192,5689;5690;5691;5692,0,0,1,3,0,4
2177,0,2193,5693,0,0,0,1,0,1
2178,0,2194,5694;5695,0,0,0,2,0,2
2179,0,2195,5696;5697;5698,0,1,0,2,0,3
2180,0,2196,5699;5700;5701;5702;5703;5704,0,0,2,4,0,6
2181,0,2197,5705;5706,0,0,0,1,1,2
2182,0,2198,5707;5708;5709;5710,0,1,1,2,0,4
2183,0,2199,5711;5712,0,0,0,2,0,2
2184,0,2200,5713,0,0,0,0,1,1
2185,0,2201,5714;5715;5716,0,0,0,3,0,3
2186,0,2202,5717,0,0,0,1,0,1
2187,0,2203,5718,0,0,0,1,0,1
2188,0,2204,5719;5720;5721;5722;5723,0,0,2,1,2,5
2189,0,2205,5724;5725;5726,0,0,1,2,0,3
2190,0,2206,5727,0,0,0,1,0,1
2191,0,2207,5728,0,0,0,0,1,1
2192,0,2208,5729;5730;5731,0,1,0,2,0,3
2193,0,2209,5732,0,0,0,1,0,1
2194,0,2210,5733;5734;5735;5736;5737;5738,0,1,2,2,1,6
2195,0,2211,5739;5740;5741;5742;5743,0,2,1,0,2,5
2196,0,2212,5744;5745;5746;5747;5748;5749,0,0,1,3,2,6
2197,0,2213,5750;5751;5753;5754,0,0,0,1,3,4
2198,0,2214,5755,0,0,0,1,0,1
2199,0,2215,5756;5757;5758,0,0,0,3,0,3
2200,0,2216,5759,0,0,0,0,1,1
2201,0,2217,5760,0,0,0,1,0,1
2202,0,2218,5761,0,0,0,1,0,1
2203,0,2219,5762;5763;5765;5766,0,1,0,1,2,4
2204,0,2220,5768;5769;5770;5771,0,0,0,4,0,4
2205,0,2221,5772;5773;5774;5775,0,1,0,1,2,4
2206,0,2222,5776;5777,0,0,0,1,1,2
2207,0,2223,5778;5779,0,0,1,0,1,2
2208,0,2224,5780;5781;5782,0,0,0,3,0,3
2209,0,2225,5783;5784,0,0,0,1,1,2
2210,0,2226,5785;5787;5788;5789,0,0,3,1,0,4
2211,0,2227,5790,0,0,0,1,0,1
2212,0,2228,5791;5792;5793,0,1,1,1,0,3
2213,0,2229,5794;5795,0,0,0,1,1,2
2214,0,2230,5796;5797;5798;5799,0,0,2,1,1,4
2215,0,2231,5800,0,0,0,1,0,1
2216,0,2232,5801,0,0,0,1,0,1
2217,0,2233,5802,0,0,0,0,1,1
2218,0,2234,5803,0,0,0,1,0,1
2219,0,2235,5804;5805;5806,0,0,2,1,0,3
2220,0,2236,5807;5808;5809;5810;5811,0,0,2,3,0,5
2221,0,2237,5812,0,0,0,1,0,1
2222,0,2238,5813;5814,0,1,0,1,0,2
2223,0,2239,5815,0,0,0,1,0,1
2224,0,2240,5816;5817,0,0,0,1,1,2
2225,0,2241,5818;5819,0,0,0,1,1,2
2226,0,2242,5820;5821,0,0,0,1,1,2
2227,0,2243,5822,0,0,0,1,0,1
2228,0,2244,5823;5824,0,0,0,2,0,2
2229,0,2245,5826;5827;5828,0,0,0,0,3,3
2230,0,2246,5829;5830,0,0,0,1,1,2
2231,0,2247,5831;5832,0,0,0,2,0,2
2232,0,2248,5833,0,0,0,1,0,1
2233,0,2249,5834;5835,0,0,0,2,0,2
2234,0,2250,5836;5837,0,0,0,1,1,2
2235,0,2251,5838,0,0,0,1,0,1
2236,0,2252,5839;5840;5841,0,0,0,2,1,3
2237,0,2253,5842,0,0,0,1,0,1
2238,0,2254,5843;5844,0,0,0,2,0,2
2239,0,2255,5845;5846,0,0,0,2,0,2
2240,0,2256,5847;5849;5850,0,1,1,1,0,3
2241,0,2257,5851,0,0,0,0,1,1
2242,0,2258,5852;5853,0,0,0,0,2,2
2243,0,2259,5855,0,0,0,1,0,1
2244,0,2260,5856;5857,0,0,0,2,0,2
2245,0,2261,5858;5859;5860,0,1,0,2,0,3
2246,0,2262,5861;5862;5863;5864,0,0,2,2,0,4
2247,0,2263,5865;5866,0,0,0,2,0,2
2248,0,2264,5867;5868;5869;5870;5871,0,0,2,3,0,5
2249,0,2265,5872;5873,0,0,0,1,1,2
2250,0,2266,5874;5875;5876,0,0,0,2,1,3
2251,0,2267,5877,0,0,0,1,0,1
2252,0,2268,5878,0,0,0,1,0,1
2253,0,2269,5879,0,0,0,1,0,1
2254,0,2270,5880,0,0,0,1,0,1
2255,0,2271,5881;5882,0,0,0,2,0,2
2256,0,2273,5885;5886,0,0,0,0,2,2
2257,0,2274,5887;5888;5889;5890;10045;10080,0,3,0,3,0,6
2258,0,2275,5891;5892;8181,0,0,1,2,0,3
2259,0,2276,5894;5895,0,0,0,2,0,2
2260,0,2277,5896,0,0,0,1,0,1
2261,0,2278,5897;5898;5899;5900;5901,0,1,1,2,1,5
2262,0,2279,5902,0,0,0,1,0,1
2263,0,2280,5903;5904;5905,0,0,1,0,2,3
2264,0,2281,5906;5907,0,0,0,2,0,2
2265,0,2282,5908;5909;10099,0,1,0,1,1,3
2266,0,2283,5910;5911,0,0,0,2,0,2
2267,0,2284,5912;5913;5914,0,0,0,2,1,3
2268,0,2285,5915;5916;5917,0,1,0,1,1,3
2269,0,2286,5918,0,0,0,1,0,1
2270,0,2287,5919;5920,0,0,0,2,0,2
2271,0,2288,5921;5922,0,0,0,1,1,2
2272,0,2289,5923;5924,0,0,0,2,0,2
2273,0,2290,5925;5926;10115,0,1,0,2,0,3
2274,0,2291,5927;5928;5929;5930,0,2,0,2,0,4
2275,0,2292,5931;5932,0,0,0,2,0,2
2276,0,2293,5933,0,0,0,0,1,1
2277,0,2294,5934;5935;5936;5937,0,1,1,2,0,4
2278,0,2295,5938;5940,0,0,0,1,1,2
2279,0,2296,5941;5942,0,0,0,2,0,2
2280,0,2297,5943,0,0,0,0,1,1
2281,0,2298,5944;5945,0,0,0,2,0,2
2282,0,2299,5946,0,0,0,1,0,1
2283,0,2300,5947;5948;5949;5950,0,0,2,1,1,4
2284,0,2301,5951;5952,0,0,0,1,1,2
2285,0,2302,5954;5955,0,0,0,2,0,2
2286,0,2303,5956;5957,0,0,0,1,1,2
2287,0,2304,5958;5959,0,0,0,2,0,2
2288,0,2305,5960;5961;5962;5963;5964,0,0,3,1,1,5
2289,0,2306,5965;5966;5967;5968;5969;5970,0,0,4,2,0,6
2290,0,2307,5971;5973,0,0,0,0,2,2
2291,0,2308,5975;5976,0,0,0,1,1,2
2292,0,2309,5977,0,0,0,1,0,1
2293,0,2310,5978,0,0,0,1,0,1
2294,0,2311,5979;5980;5981;5982,0,0,1,3,0,4
2295,0,2312,5983;5984;5985,0,0,1,2,0,3
2296,0,2313,5986;5987;5988,0,0,1,1,1,3
2297,0,2314,5989;5990;5991;5992,0,2,0,2,0,4
2298,0,2315,5993;5994,0,0,0,0,2,2
2299,0,2316,5996;5997;5998,0,0,0,1,2,3
2300,0,2317,5999;6000;6001;6002;6003,0,2,0,2,1,5
2301,0,2318,6004;6005,0,0,0,1,1,2
2302,0,2319,6006,0,0,0,1,0,1
2303,0,2320,6007,0,0,0,1,0,1
2304,0,2321,6008,0,0,0,1,0,1
2305,0,2322,6009;6010,0,0,0,0,2,2
2306,0,2323,6011;6012,0,0,0,1,1,2
2307,0,2324,6013;6014;6015,0,1,0,1,1,3
2308,0,2325,6016;6017,0,0,0,2,0,2
2309,0,2326,6018;6019;6020;6021;6022,0,0,0,4,1,5
2310,0,2327,6023;6024,0,0,0,1,1,2
2311,0,2328,6025,0,0,0,1,0,1
2312,0,2329,6026;6027;6028,0,0,0,3,0,3
2313,0,2330,6029,0,0,0,0,1,1
2314,0,2331,6030;6031;6032,0,0,0,3,0,3
2315,0,2332,6033;6034;6035;6036;6037,0,0,2,2,1,5
2316,0,2333,6038,0,0,0,1,0,1
2317,0,2334,6039;6040,0,0,0,1,1,2
2318,0,2335,6041;6042,0,0,0,2,0,2
2319,0,2336,6043;6044,0,0,0,2,0,2
2320,0,2337,6045,0,0,0,0,1,1
2321,0,2338,6046,0,0,0,1,0,1
2322,0,2340,6048,0,0,0,1,0,1
2323,0,2341,6049;6050,0,0,0,2,0,2
2324,0,2342,6052;6053;6054,0,0,2,1,0,3
2325,0,2343,6055;6056,0,2,0,0,0,2
2326,0,2344,6057,0,0,0,1,0,1
2327,0,2345,6058,0,0,0,0,1,1
2328,0,2346,6059,0,0,0,1,0,1
2329,0,2347,6060;6061;6062,0,0,0,2,1,3
2330,0,2348,6063,0,0,0,1,0,1
2331,0,2349,6064;6065,0,0,0,2,0,2
2332,0,2350,6068;6069;6070;6071,0,1,1,2,0,4
2333,0,2351,6072;6073;6074,0,0,0,1,2,3
2334,0,2352,6075;6076,0,0,0,1,1,2
2335,0,2353,6077;6078;10097,0,1,0,2,0,3
2336,0,2354,6079;6080;6081,0,0,0,2,1,3
2337,0,2355,6082;6083;6084;6085,0,1,0,1,2,4
2338,0,2356,6086;6087;6088,0,1,0,0,2,3
2339,0,2357,6089;6090,0,0,0,2,0,2
2340,0,2358,6091;10056,0,1,0,1,0,2
2341,0,2359,6092,0,0,0,1,0,1
2342,0,2360,6093;6094,0,0,0,1,1,2
2343,0,2361,6095;6096,0,0,0,2,0,2
2344,0,2362,6097;6098,0,0,0,2,0,2
2345,0,2363,6099;6100;6101;6102,0,0,2,2,0,4
2346,0,2364,6103;6104,0,0,0,1,1,2
2347,0,2365,6105;6106;6107;6108,0,0,1,3,0,4
2348,0,2366,6109;6110;6111;6112;7964,0,0,4,1,0,5
2349,0,2367,6113;6114,0,1,0,1,0,2
2350,0,2368,6115;6116;6117;6118,0,0,2,1,1,4
2351,0,2369,6119;6120;6121,0,0,0,3,0,3
2352,0,2370,6122;6123;6124,0,0,0,2,1,3
2353,0,2371,6126;6127,0,1,0,1,0,2
2354,0,2372,6128;6129,0,0,0,1,1,2
2355,0,2373,282;6130,0,0,0,2,0,2
2356,0,2374,6131;6132;6133,0,0,1,0,2,3
2357,0,2375,6134;6135,0,0,0,1,1,2
2358,0,2376,6136,0,0,0,0,1,1
2359,0,2377,6137,0,0,0,0,1,1
2360,0,2378,6138;6139,0,0,1,1,0,2
2361,0,2379,6140,0,0,0,1,0,1
2362,0,2380,6141;6142,0,0,0,2,0,2
2363,0,2381,6143;6144,0,0,0,1,1,2
2364,0,2382,6145;6146;6147,0,0,0,1,2,3
2365,0,2383,6148;6149,0,0,0,2,0,2
2366,0,2384,6150;6151,0,0,0,1,1,2
2367,0,2385,6152;6153;6154;6155;10084,0,2,1,2,0,5
2368,0,2386,6156;6157;6158;6159,0,1,1,2,0,4
2369,0,2387,6160;6161,0,0,0,2,0,2
2370,0,2388,6162;6163;6164,0,0,0,3,0,3
2371,0,2389,6165;6166,0,0,1,0,1,2
2372,0,2390,6167;6168;6169;6170,0,0,1,2,1,4
2373,0,2391,6171;6172,0,0,0,2,0,2
2374,0,2392,6173;6174,0,0,0,2,0,2
2375,0,2393,6175,0,0,0,1,0,1
2376,0,2394,6176;6177;6178,0,0,0,1,2,3
2377,0,2395,6179;6180,0,0,0,2,0,2
2378,0,2396,6181;6182;6183;6184,0,0,2,1,1,4
2379,0,2397,6185;6186;6187;6188,0,0,2,1,1,4
2380,0,2398,6189;6190;6191;6192,0,0,2,1,1,4
2381,0,2399,6193;6194;10040,0,1,0,2,0,3
2382,0,2400,6195;6196;6197,0,0,1,2,0,3
2383,0,2401,6198;6199;6200;6201;6202,0,1,1,2,1,5
2384,0,2402,6203,0,0,0,0,1,1
2385,0,2403,6204;6205;10051,0,1,0,2,0,3
2386,0,2404,6206;6207;6208,0,1,0,2,0,3
2387,0,2405,6209;6210;6211;6212,0,1,0,2,1,4
2388,0,2406,6213,0,0,0,1,0,1
2389,0,2407,6214;6215,0,0,0,2,0,2
2390,0,2408,6216;6217;10070;10083,0,2,0,2,0,4
2391,0,2409,6218;6219;6220;6222,0,0,1,2,1,4
2392,0,2410,6223;6224;6225,0,0,0,2,1,3
2393,0,2411,6226,0,0,0,1,0,1
2394,0,2412,6227,0,0,0,1,0,1
2395,0,2413,6228;6229,0,0,0,1,1,2
2396,0,2414,6230;6232;6233,0,1,0,2,0,3
2397,0,2415,6234,0,0,0,1,0,1
2398,0,2416,6235;6236,0,0,0,1,1,2
2399,0,2417,6237;6238;6239;6240,0,0,2,1,1,4
2400,0,2418,6241;6242,0,0,0,2,0,2
2401,0,2419,6243;6244;6246,0,0,0,1,2,3
2402,0,2420,6247;6248,0,0,0,1,1,2
2403,0,2421,6249,0,0,0,1,0,1
2404,0,2422,6250;6251;6252,0,1,0,1,1,3
2405,0,2423,6253;6254,0,0,0,1,1,2
2406,0,2424,6255;6256,0,0,0,2,0,2
2407,0,2425,6257;6258;6260;6261;6262,0,2,0,0,3,5
2408,0,2426,6263;6264,0,0,0,1,1,2
2409,0,2427,6266,0,0,0,1,0,1
2410,0,2428,6267;6268,0,0,0,1,1,2
2411,0,2429,6269;6270;6271;6272,0,1,0,0,3,4
2412,0,2430,6273;6274;6275,0,1,0,2,0,3
2413,0,2431,6276;6277;6278,0,0,1,1,1,3
2414,0,2432,6279;6280;6281,0,0,0,2,1,3
2415,0,2433,6282;6283;6284;6285,0,0,2,2,0,4
2416,0,2434,6286;6287;6288;6289;6290,0,0,1,3,1,5
2417,0,2435,6291,0,0,0,1,0,1
2418,0,2436,6292,0,0,0,1,0,1
2419,0,2437,6293;6294;6295;6296,0,0,2,0,2,4
2420,0,2438,6297;6298;6299,0,0,1,0,2,3
2421,0,2439,6300;6301,0,0,0,2,0,2
2422,0,2440,6302;6303;6304,0,0,0,2,1,3
2423,0,2441,6305,0,0,0,1,0,1
2424,0,2442,6306;6307;6308;6309,0,1,1,1,1,4
2425,0,2443,6310;6312;6313,0,0,0,1,2,3
2426,0,2444,6314;6315,0,0,0,1,1,2
2427,0,2445,6316;6317;6318;6319,0,0,1,2,1,4
2428,0,2446,6320;6321,0,0,0,2,0,2
2429,0,2447,6322;6323;6324;6325,0,0,0,4,0,4
2430,0,2448,6326;6327,0,0,0,2,0,2
2431,0,2449,6328;6329;6330;6331,0,0,2,2,0,4
2432,0,2450,6332,0,0,0,1,0,1
2433,0,2451,6333;6334;6335;6336,0,2,0,2,0,4
2434,0,2452,6337;6338,0,0,0,1,1,2
2435,0,2453,6340;6341;6342,0,1,0,2,0,3
2436,0,2454,6343;6344;6345,0,0,1,2,0,3
2437,0,2455,6346;6347;6348,0,1,1,0,1,3
2438,0,2456,6349;6350,0,0,0,2,0,2
2439,0,2457,6351;6352;6353;6354,0,0,2,2,0,4
2440,0,2458,6355,0,0,0,1,0,1
2441,0,2459,6356;6357;6358,0,0,0,2,1,3
2442,0,2460,6359;6360,0,0,0,1,1,2
2443,0,2461,6361;6362;6363,0,1,0,1,1,3
2444,0,2462,6364,0,0,0,0,1,1
2445,0,2463,6365;6366,0,0,0,2,0,2
2446,0,2464,6367;6368;6369;6370,0,2,0,1,1,4
2447,0,2465,6371;6372;6373,0,0,0,1,2,3
2448,0,2466,6374,0,0,0,1,0,1
2449,0,2467,6375;6376;6377,0,0,0,2,1,3
2450,0,2468,6378;6379,0,0,0,2,0,2
2451,0,2469,6380,0,0,0,1,0,1
2452,0,2470,6381;6382,0,1,0,1,0,2
2453,0,2471,6383,0,0,0,1,0,1
2454,0,2472,6384,0,0,0,1,0,1
2455,0,2473,6385,0,0,0,1,0,1
2456,0,2474,6386;6387;6388;6389;6390,0,0,1,4,0,5
2457,0,2475,6391;6392;6393,0,1,0,1,1,3
2458,0,2476,6394,0,0,0,1,0,1
2459,0,2477,6395,0,0,0,1,0,1
2460,0,2478,6396;6397;6398;6399;6400;6401,0,0,0,4,2,6
2461,0,2479,6402;6403;6404;6405;6406;6407;6408,0,0,3,4,0,7
2462,0,2480,6409;6410,0,0,0,2,0,2
2463,0,2481,6411,0,0,0,0,1,1
2464,0,2482,6412;6413;6414,0,0,0,2,1,3
2465,0,2483,6415;6416,0,0,0,1,1,2
2466,0,2484,6417,0,0,0,0,1,1
2467,0,2485,6418;6419;6420;6421,0,0,2,2,0,4
2468,0,2486,6422;6423,0,0,0,1,1,2
2469,0,2487,6424,0,0,0,1,0,1
2470,0,2488,6425;6426,0,0,0,2,0,2
2471,0,2489,6427;6428;6429,0,0,0,3,0,3
2472,0,2490,6430;6431;10116,0,1,0,1,1,3
2473,0,2491,6432;6433,0,0,0,2,0,2
2474,0,2492,6434;6435;6436,0,0,0,2,1,3
2475,0,2493,6437,0,0,0,1,0,1
2476,0,2494,6438;6439;6440,0,0,0,3,0,3
2477,0,2495,6441;6442;6443;6444,0,2,0,2,0,4
2478,0,2496,6445;6446;6447,0,0,0,2,1,3
2479,0,2497,6448;6449,0,0,0,2,0,2
2480,0,2498,6450;6451;6452;6453;6454,0,0,2,3,0,5
2481,0,2499,6455;6456;6457;6458,0,0,1,3,0,4
2482,0,2500,6459;6460;6461,0,1,0,2,0,3
2483,0,2501,6462;6463;6464;6465;6466,0,0,3,1,1,5
2484,0,2502,6467,0,0,0,0,1,1
2485,0,2503,6468;6469;6470,0,2,0,1,0,3
2486,0,2504,6471;6472,0,0,0,0,2,2
2487,0,2505,6473;6474,0,0,0,2,0,2
2488,0,2506,6475,0,0,0,1,0,1
2489,0,2507,6476,0,0,0,1,0,1
2490,0,2508,6477;6478,0,0,0,2,0,2
2491,0,2509,6479;6480;6481;8635,0,0,2,2,0,4
2492,0,2510,6482;6483,0,0,0,2,0,2
2493,0,2511,6484,0,0,0,1,0,1
2494,0,2512,6485;6486,0,0,0,2,0,2
2495,0,2513,6487;6488;6489;6490,0,1,1,1,1,4
2496,0,2514,6491;6492;6493;6494,0,0,1,3,0,4
2497,0,2515,6495;6496,0,0,0,2,0,2
2498,0,2516,6497;6498,0,0,0,1,1,2
2499,0,2517,6499;6500,0,0,0,2,0,2
2500,0,2518,6501;6502;6503,0,0,1,2,0,3
2501,0,2519,6504,0,0,0,1,0,1
2502,0,2520,6505,0,0,0,1,0,1
2503,0,2521,6506,0,0,0,1,0,1
2504,0,2522,6507;6508,0,0,0,0,2,2
2505,0,2523,6510,0,0,0,1,0,1
2506,0,2524,6511;6512,0,0,0,1,1,2
2507,0,2525,6513,0,0,0,1,0,1
2508,0,2526,6515;6516;6517;6518,0,0,0,2,2,4
2509,0,2527,6519;6520,0,0,0,2,0,2
2510,0,2528,6521;6522,0,0,0,2,0,2
2511,0,2529,6523;6524;6525;6526,0,0,2,2,0,4
2512,0,2530,6527;6528;6529;6530;6531,0,0,2,2,1,5
2513,0,2531,6532;6533,0,0,0,2,0,2
2514,0,2532,6534;6535;6536;6537,0,0,2,2,0,4
2515,0,2533,6538,0,0,0,1,0,1
2516,0,2534,6539;6540;6541;6542;6543;6544,0,0,1,5,0,6
2517,0,2535,6545,0,0,0,0,1,1
2518,0,2536,6546,0,0,0,0,1,1
2519,0,2537,6547,0,0,0,0,1,1
2520,0,2538,6549;6550;6551,0,0,0,3,0,3
2521,0,2539,6552;6553;6554;6555,0,0,2,1,1,4
2522,0,2540,6556;6557;6558;6559;6560;6561,0,2,1,1,2,6
2523,0,2541,6562;6563,0,0,0,1,1,2
2524,0,2542,6564,0,0,0,1,0,1
2525,0,2543,6565,0,0,0,1,0,1
2526,0,2544,6566;6567,0,0,1,1,0,2
2527,0,2545,6568;6569,0,0,0,0,2,2
2528,0,2546,6570;6571,0,1,0,1,0,2
2529,0,2547,6572,0,0,0,1,0,1
2530,0,2548,6573;6574,0,0,0,1,1,2
2531,0,2549,6575,0,0,0,1,0,1
2532,0,2550,6576,0,0,0,0,1,1
2533,0,2551,6577;6578,0,0,0,1,1,2
2534,0,2552,6579;6580;6581;6582,0,0,1,3,0,4
2535,0,2553,6583,0,0,0,1,0,1
2536,0,2554,6584;6585;6586;6587;10052,0,1,1,2,1,5
2537,0,2555,6588;6589;6590;6591,0,0,0,4,0,4
2538,0,2556,6592;6593;6594;6595,0,0,1,3,0,4
2539,0,2557,6596,0,0,0,0,1,1
2540,0,2558,6597;6598,0,0,0,1,1,2
2541,0,2559,6599,0,0,0,1,0,1
2542,0,2560,6600;6601;6602;6603;6604;6605,0,0,4,2,0,6
2543,0,2561,6606;6607,0,0,0,1,1,2
2544,0,2562,6608;6609,0,0,0,0,2,2
2545,0,2563,6610;6611;6612,0,0,1,2,0,3
2546,0,2564,6613,0,0,0,0,1,1
2547,0,2565,6614;6615;6616,0,0,1,1,1,3
2548,0,2566,6617,0,0,0,1,0,1
2549,0,2567,6618;6619,0,0,0,2,0,2
2550,0,2568,6620;6621;6622;6623;6624;6625,0,0,1,4,1,6
2551,0,2569,6627;6628;6629,0,0,2,0,1,3
2552,0,2570,6630;6631;6632,0,1,0,2,0,3
2553,0,2571,6633;6634,0,0,0,2,0,2
2554,0,2572,6635;6636;6637,0,0,2,0,1,3
2555,0,2573,6638;6639;6640;6641;6642,0,2,0,2,1,5
2556,0,2574,6643,0,0,0,1,0,1
2557,0,2575,6644;6645,0,0,0,1,1,2
2558,0,2576,6646;6647;6648;6649,0,0,1,3,0,4
2559,0,2577,6650;6651;6652;6653;6654,0,0,2,2,1,5
2560,0,2578,6655,0,0,0,1,0,1
2561,0,2579,6657;6658;6659;6660;6661,0,0,2,3,0,5
2562,0,2580,6662,0,0,0,1,0,1
2563,0,2581,6663;6664,0,0,0,1,1,2
2564,0,2582,6665,0,0,0,1,0,1
2565,0,2583,6666;6667;6668,0,0,0,3,0,3
2566,0,2584,6669;6670,0,0,0,2,0,2
2567,0,2585,6671;6672;6673;6674;6675,0,0,1,3,1,5
2568,0,2586,6676,0,0,0,1,0,1
2569,0,2587,6677;6678,0,0,0,1,1,2
2570,0,2588,6679,0,0,0,1,0,1
2571,0,2589,6680;6681,0,0,0,2,0,2
2572,0,2590,6682;6683,0,0,0,1,1,2
2573,0,2591,6684;6685,0,0,0,0,2,2
2574,0,2592,6686;6687;6688;6689,0,0,2,2,0,4
2575,0,2593,6690;6691;6692;6693,0,0,2,2,0,4
2576,0,2594,6694;6695;6696,0,0,0,3,0,3
2577,0,2595,6697;6698;6699;6700;6701;6702,0,1,3,1,1,6
2578,0,2596,6704;6705;6706;6707,0,0,1,2,1,4
2579,0,2597,6708;6709,0,0,0,0,2,2
2580,0,2598,6711;6712;6713,0,0,0,2,1,3
2581,0,2599,6714,0,0,0,1,0,1
2582,0,2600,6715,0,0,0,0,1,1
2583,0,2601,6716;6717;6718;6719;6720,0,0,2,2,1,5
2584,0,2602,6721;6722;6723;6724,0,0,0,2,2,4
2585,0,2603,6725;6726;6727;6728;6729,0,1,1,3,0,5
2586,0,2604,6730;6731;6732,0,0,0,3,0,3
2587,0,2605,6733;6734;6735;6736,0,0,1,1,2,4
2588,0,2606,6737;6738,0,0,0,2,0,2
2589,0,2607,6739;6740,0,0,0,2,0,2
2590,0,2608,6741;6742;6743;6744,0,1,1,1,1,4
2591,0,2609,6745,0,0,0,1,0,1
2592,0,2610,6746;6747,0,0,0,1,1,2
2593,0,2611,6749;6750;6751,0,0,2,1,0,3
2594,0,2612,6752;6753,0,0,0,2,0,2
2595,0,2613,6754,0,0,0,1,0,1
2596,0,2615,6756,0,0,0,1,0,1
2597,0,2616,6758;6759;6760;6761,0,0,0,3,1,4
2598,0,2617,6762;6763;6764;6765,0,0,1,3,0,4
2599,0,2618,6766;6767,0,0,0,2,0,2
2600,0,2619,6768;6769;6770,0,0,2,0,1,3
2601,0,2620,6771,0,0,0,0,1,1
2602,0,2621,6772;6773;6774,0,0,2,0,1,3
2603,0,2622,6775,0,0,0,1,0,1
2604,0,2623,6776;6777,0,0,0,2,0,2
2605,0,2624,6778;6779;6780;6781;6782,0,0,1,3,1,5
2606,0,2625,6783;6784;6785;6786,0,0,0,2,2,4
2607,0,2626,6787;6788;10020,0,1,0,1,1,3
2608,0,2627,6789;6790;6791;6792,0,0,2,1,1,4
2609,0,2628,6793,0,0,0,0,1,1
2610,0,2629,6794;6795;6797;6798,0,0,0,3,1,4
2611,0,2630,6799;6800,0,0,0,1,1,2
2612,0,2631,6801;6802,0,0,0,2,0,2
2613,0,2632,6803;6804;6805,0,0,1,2,0,3
2614,0,2633,6806,0,0,0,0,1,1
2615,0,2634,6807;6808;6809,0,1,0,2,0,3
2616,0,2635,6810;6811,0,0,0,2,0,2
2617,0,2636,6812,0,0,0,0,1,1
2618,0,2637,6813;6814,0,0,0,2,0,2
2619,0,2638,6815;6816,0,0,0,1,1,2
2620,0,2639,6817;6818;6819;6820,0,0,2,1,1,4
2621,0,2640,6821;6822;6823,0,1,0,2,0,3
2622,0,2641,6824,0,0,0,1,0,1
2623,0,2642,6825;6826,0,0,0,2,0,2
2624,0,2643,6828;6829,0,0,0,2,0,2
2625,0,2644,6830;6831,0,0,0,0,2,2
2626,0,2645,6832;6833,0,0,0,1,1,2
2627,0,2646,6834;6835;6836;6837;6838;6839,0,2,2,1,1,6
2628,0,2647,6840;6841,0,0,0,1,1,2
2629,0,2648,6842;6843;6844;6845;6846;6847;6848;6849,0,2,1,4,1,8
2630,0,2649,6850;6851;6852,0,0,0,2,1,3
2631,0,2650,6853;6854;6855;6856;6857,0,0,1,4,0,5
2632,0,2651,6858,0,0,0,1,0,1
2633,0,2652,6859;6860,0,0,0,1,1,2
2634,0,2653,6861;6862;6863;6864;6865;6866;6867,0,0,0,5,2,7
2635,0,2654,6868;6869,0,0,0,1,1,2
2636,0,2655,6870;6871,0,0,0,1,1,2
2637,0,2656,6872;6873;6874;6875,0,0,1,3,0,4
2638,0,2657,6876,0,0,0,1,0,1
2639,0,2658,6877;6878;6879;6880,0,0,2,1,1,4
2640,0,2659,6881;6882,0,0,0,1,1,2
2641,0,2660,6883;6884;6885,0,0,1,1,1,3
2642,0,2661,6886;6887;6888,0,0,0,1,2,3
2643,0,2662,6889;6890,0,0,0,1,1,2
2644,0,2663,6891,0,0,0,1,0,1
2645,0,2665,6893;6894,0,0,0,1,1,2
2646,0,2666,6895;6896,0,0,0,2,0,2
2647,0,2668,6898;6899,0,0,0,1,1,2
2648,0,2669,6900;6901,0,0,0,1,1,2
2649,0,2670,6902;8228,0,0,0,2,0,2
2650,0,2671,6903;6904;6905,0,0,2,0,1,3
2651,0,2672,6906;6907,0,0,0,2,0,2
2652,0,2673,6908;6909;6910;6911,0,1,0,2,1,4
2653,0,2674,6912;6913;6914,0,0,0,3,0,3
2654,0,2675,2667;6915;10009,0,1,0,2,0,3
2655,0,2676,6916;6917;6918,0,0,1,1,1,3
2656,0,2677,6919;6920;6921;6922,0,0,0,2,2,4
2657,0,2678,6923;6924,0,0,0,2,0,2
2658,0,2679,6925,0,0,0,0,1,1
2659,0,2680,6926,0,0,0,1,0,1
2660,0,2681,6927;6928,0,0,0,1,1,2
2661,0,2682,6929;6930,0,0,0,1,1,2
2662,0,2683,6931;6932;6933,0,0,0,3,0,3
2663,0,2684,6934;6935;6936;6937,0,0,0,3,1,4
2664,0,2685,6938;6939,0,0,0,2,0,2
2665,0,2686,6940;6941,0,0,0,1,1,2
2666,0,2687,6942;6943,0,0,0,1,1,2
2667,0,2688,6944,0,0,0,1,0,1
2668,0,2689,6945;6946;6947;6948;6949;6950,0,0,2,4,0,6
2669,0,2690,6951;6952;6953;6954;6955,0,1,1,3,0,5
2670,0,2691,6956;6957,0,0,0,1,1,2
2671,0,2692,6958,0,0,0,1,0,1
2672,0,2693,6959,0,0,0,1,0,1
2673,0,2694,6961,0,0,0,1,0,1
2674,0,2695,6962;6963,0,0,0,0,2,2
2675,0,2696,6964,0,0,0,1,0,1
2676,0,2697,6965,0,0,0,1,0,1
2677,0,2698,6966;6967,0,0,1,1,0,2
2678,0,2699,6968;6969;6970;6971,0,0,2,2,0,4
2679,0,2700,6972;6973;6974,0,0,1,2,0,3
2680,0,2701,6975;6976,0,0,0,2,0,2
2681,0,2702,6977;6978,0,0,0,2,0,2
2682,0,2703,6979;6980;6981;6982,0,0,2,1,1,4
2683,0,2704,6983;6984;6985;6986,0,0,1,3,0,4
2684,0,2705,6987;6988;6989;6990;6991,0,2,1,2,0,5
2685,0,2706,6992;6993;6994;6995,0,0,1,3,0,4
2686,0,2707,6996,0,0,0,0,1,1
2687,0,2708,6997;6998;6999;7000,0,0,0,3,1,4
2688,0,2709,7001;7002;7003,0,0,0,2,1,3
2689,0,2710,7004,0,0,0,0,1,1
2690,0,2711,7005,0,0,0,1,0,1
2691,0,2712,7006;7007;7008;7009,0,0,0,2,2,4
2692,0,2713,7010;7011;7012,0,0,0,3,0,3
2693,0,2714,7013;7014;7015;7016,0,1,0,1,2,4
2694,0,2715,7017;7018;7019;7020,0,0,2,2,0,4
2695,0,2716,7021;7022;7023;7024;7025,0,0,1,3,1,5
2696,0,2717,7026,0,0,0,1,0,1
2697,0,2718,7027;7028;7029;7030,0,0,2,2,0,4
2698,0,2719,7031;7032;7033;7034;7035;7036;7037,0,1,2,1,3,7
2699,0,2720,7038;7039;7040,0,1,1,1,0,3
2700,0,2721,7041;7042,0,0,0,0,2,2
2701,0,2722,7043;7044,0,0,0,2,0,2
2702,0,2723,7045,0,0,0,1,0,1
2703,0,2724,7046,0,0,0,1,0,1
2704,0,2725,7047;7048,0,0,0,2,0,2
2705,0,2726,7049;7050;7051;9190,0,0,1,3,0,4
2706,0,2727,7052;7053;7054,0,1,0,1,1,3
2707,0,2728,7055,0,0,0,1,0,1
2708,0,2729,7056;7057;7058,0,0,0,3,0,3
2709,0,2730,7059,0,0,0,1,0,1
2710,0,2731,7060;7061,0,0,0,1,1,2
2711,0,2732,7062;7063,0,0,0,2,0,2
2712,0,2733,7064,0,0,0,1,0,1
2713,0,2734,7065;7066;7067;7068,0,0,1,1,2,4
2714,0,2735,7069;7070;7071;7072;7073;7074,0,0,2,2,2,6
2715,0,2736,7075;7076;7077;7078,0,0,2,2,0,4
2716,0,2737,7079;7080;7081;7082,0,0,0,4,0,4
2717,0,2738,7083;7084,0,0,0,1,1,2
2718,0,2739,7085,0,0,0,1,0,1
2719,0,2740,7086;7087,0,0,0,1,1,2
2720,0,2741,7088;7089,0,0,0,1,1,2
2721,0,2742,7090;7091,0,0,0,1,1,2
2722,0,2743,7092;7093,0,0,0,2,0,2
2723,0,2744,7094;10082,0,1,0,1,0,2
2724,0,2745,7095;7096;7097;7098,0,2,0,1,1,4
2725,0,2746,7099;7100;7101;7102,0,0,1,2,1,4
2726,0,2747,7103,0,0,0,0,1,1
2727,0,2748,7104;7105,0,0,0,1,1,2
2728,0,2749,7106;7107;7108;7109;7110,0,0,1,3,1,5
2729,0,2750,7111;7112,0,0,0,2,0,2
2730,0,2751,7113;7114;7115,0,1,0,1,1,3
2731,0,2752,7116;7117;7118;7119,0,0,1,1,2,4
2732,0,2753,7120;7121,0,0,1,1,0,2
2733,0,2754,7122;7123;7124,0,0,0,2,1,3
2734,0,2755,7125;7126;7127;7128,0,0,2,0,2,4
2735,0,2756,7129;7130;7131,0,0,0,3,0,3
2736,0,2757,7132,0,0,0,1,0,1
2737,0,2758,7133;7134,0,0,0,2,0,2
2738,0,2759,7135,0,0,0,1,0,1
2739,0,2760,7136;7137;7138,0,0,1,2,0,3
2740,0,2761,7139;7140;7141;7142;7143,0,0,2,3,0,5
2741,0,2762,7145,0,0,0,1,0,1
2742,0,2763,7146;7147,0,0,0,2,0,2
2743,0,2764,7148;7149;7150;7151,0,0,2,1,1,4
2744,0,2765,7152;7153,0,0,0,1,1,2
2745,0,2766,7154;7155;7156;7157;7158,0,1,1,3,0,5
2746,0,2767,7159,0,0,0,1,0,1
2747,0,2768,7160,0,0,0,0,1,1
2748,0,2769,7162;7163,0,1,0,1,0,2
2749,0,2770,7164,0,0,0,1,0,1
2750,0,2771,7165,0,0,0,1,0,1
2751,0,2772,7166;7167;10035,0,1,0,1,1,3
2752,0,2773,7168;7169;7170;7171;7172,0,0,1,3,1,5
2753,0,2775,7174;7175;7176;7177,0,1,1,1,1,4
2754,0,2776,7178;7179;7180;7181,0,0,2,2,0,4
2755,0,2777,7182,0,0,0,1,0,1
2756,0,2778,7183;7184;7185,0,0,1,1,1,3
2757,0,2779,7186,0,0,0,0,1,1
2758,0,2780,7187,0,0,0,1,0,1
2759,0,2781,7188,0,0,0,1,0,1
2760,0,2782,7189;7191;7192;7193,0,0,2,2,0,4
2761,0,2783,7194,0,0,0,1,0,1
2762,0,2784,7195;7196;7197,0,0,1,1,1,3
2763,0,2785,7198;7199,0,0,0,2,0,2
2764,0,2787,7201;7202;7203,0,0,1,0,2,3
2765,0,2788,7204;7205,0,0,0,2,0,2
2766,0,2789,7206;7207;7208,0,0,0,2,1,3
2767,0,2790,7209,0,0,0,0,1,1
2768,0,2791,7210;7211;7212,0,0,2,1,0,3
2769,0,2792,7214;7215;7216,0,0,0,2,1,3
2770,0,2793,7217,0,0,0,0,1,1
2771,0,2794,7218;7219,0,0,0,1,1,2
2772,0,2795,7220;7222;7223,0,0,2,0,1,3
2773,0,2796,7224;7225;7226;7227,0,0,0,3,1,4
2774,0,2797,7228;7229,0,0,0,2,0,2
2775,0,2798,7230;7231,0,0,0,0,2,2
2776,0,2799,7232,0,0,0,1,0,1
2777,0,2800,7233;7234;7236;7237;7238,0,0,1,3,1,5
2778,0,2801,7239,0,0,0,1,0,1
2779,0,2802,7240;7241;10107,0,1,0,1,1,3
2780,0,2803,7242;7243,0,0,0,2,0,2
2781,0,2804,7244,0,0,0,1,0,1
2782,0,2805,7245;7246,0,0,0,1,1,2
2783,0,2806,7247;7248;7249,0,0,0,1,2,3
2784,0,2807,7250,0,0,0,1,0,1
2785,0,2808,7251,0,0,0,0,1,1
2786,0,2809,7252;7253,0,0,0,2,0,2
2787,0,2810,7254;7255;7256;7257,0,1,2,1,0,4
2788,0,2811,7258,0,0,0,1,0,1
2789,0,2812,7259;7260;7261,0,0,0,1,2,3
2790,0,2813,7262,0,0,0,0,1,1
2791,0,2814,7263;7264,0,0,0,2,0,2
2792,0,2815,7265;7266,0,0,0,2,0,2
2793,0,2816,7267;7268,0,0,0,1,1,2
2794,0,2817,7269,0,0,0,1,0,1
2795,0,2818,7270;7271,0,0,0,1,1,2
2796,0,2819,7272;7273;7274;7275;7276,0,0,2,3,0,5
2797,0,2820,7277,0,0,0,1,0,1
2798,0,2821,7278;7279;7280,0,0,0,2,1,3
2799,0,2822,7281,0,0,0,0,1,1
2800,0,2823,7282;7283;7284,0,0,0,2,1,3
2801,0,2824,7285;7286,0,0,1,0,1,2
2802,0,2825,7287;7288,0,0,0,2,0,2
2803,0,2826,7289;7290,0,0,0,0,2,2
2804,0,2827,7291;7292;7293;7294;7295,0,1,2,2,0,5
2805,0,2828,7296,0,0,0,1,0,1
2806,0,2829,7297,0,0,0,1,0,1
2807,0,2830,7299;7300,0,0,0,2,0,2
2808,0,2831,7301;7302;7303;7304,0,0,1,2,1,4
2809,0,2832,7305;7306;7307,0,0,2,1,0,3
2810,0,2833,7308;7309;7310;7311,0,2,0,1,1,4
2811,0,2834,7312,0,0,0,1,0,1
2812,0,2835,7313;7314;7315;7316,0,2,0,0,2,4
2813,0,2836,7317;7318,0,0,0,2,0,2
2814,0,2837,7319,0,0,0,0,1,1
2815,0,2838,7320;7321;7322;7323;7324,0,1,1,3,0,5
2816,0,2839,7325;7326;10005,0,1,0,2,0,3
2817,0,2840,7327,0,0,0,1,0,1
2818,0,2841,7328;7330;7331;7332,0,0,2,2,0,4
2819,0,2842,5752;7333,0,0,0,2,0,2
2820,0,2843,7334,0,0,0,1,0,1
2821,0,2844,7335;7336,0,0,0,0,2,2
2822,0,2845,7337,0,0,0,1,0,1
2823,0,2846,7338;7339;7340;7341;7342;7343;7344,0,1,3,3,0,7
2824,0,2847,7345;7346,0,1,0,0,1,2
2825,0,2848,7347;7348,0,0,0,2,0,2
2826,0,2849,7349,0,0,0,0,1,1
2827,0,2850,7350;7351;7352;7353,0,0,0,3,1,4
2828,0,2851,7354;7355,0,0,0,2,0,2
2829,0,2852,7356;7357,0,0,1,1,0,2
2830,0,2853,7358;7359;7360,0,0,0,3,0,3
2831,0,2854,7362;7363,0,0,0,2,0,2
2832,0,2855,7364;10073,0,1,0,1,0,2
2833,0,2856,7365;7366;7367,0,0,0,1,2,3
2834,0,2857,7368;7369,0,0,0,0,2,2
2835,0,2858,7370;7371;7372;7373,0,1,1,0,2,4
2836,0,2859,7374;7375,0,0,0,0,2,2
2837,0,2860,7376;7377;7378,0,0,0,2,1,3
2838,0,2861,7379,0,0,0,1,0,1
2839,0,2862,7380;7381;7382;7383,0,1,1,1,1,4
2840,0,2863,7384;7385,0,0,1,1,0,2
2841,0,2864,7386,0,0,0,1,0,1
2842,0,2865,7387;7388,0,0,0,2,0,2
2843,0,2866,7389;7390;7391,0,0,1,1,1,3
2844,0,2867,7392;7393;7394;7395;7396,0,2,1,2,0,5
2845,0,2868,7397;7398,0,0,1,0,1,2
2846,0,2869,7399,0,0,0,1,0,1
2847,0,2870,7400;7401;7402;7403;7404;7405,0,1,3,2,0,6
2848,0,2871,7406;10117,0,1,0,1,0,2
2849,0,2872,7407;7408;7409;7410,0,1,0,2,1,4
2850,0,2873,7411;7412,0,0,0,1,1,2
2851,0,2874,7413;7414;7415,0,0,0,3,0,3
2852,0,2875,7416;7417;7418;7419,0,0,1,3,0,4
2853,0,2876,7420;7421;7422,0,0,0,1,2,3
2854,0,2877,7423;7424,0,0,0,1,1,2
2855,0,2878,7425;7426;7427;7428,0,0,0,4,0,4
2856,0,2879,7429,0,0,0,1,0,1
2857,0,2880,7430;7432;7434;7435,0,0,0,2,2,4
2858,0,2881,7436,0,0,0,0,1,1
2859,0,2882,7437;7438;7439;7440,0,2,0,2,0,4
2860,0,2883,7441;7442;7443;7444;7445,0,3,0,2,0,5
2861,0,2884,7446,0,0,0,1,0,1
2862,0,2885,7447;7448;7449,0,0,0,1,2,3
2863,0,2886,7450;7451,0,0,0,1,1,2
2864,0,2887,7452;7453,0,0,0,1,1,2
2865,0,2888,7454;7455,0,0,0,1,1,2
2866,0,2889,7456,0,0,0,0,1,1
2867,0,2890,7457,0,0,0,1,0,1
2868,0,2891,7458;7459;7460;7461,0,0,2,2,0,4
2869,0,2892,7462;7464;7465;7466,0,0,1,2,1,4
2870,0,2893,7467;10043,0,1,0,1,0,2
2871,0,2894,7468;7469,0,0,0,2,0,2
2872,0,2895,7470,0,0,0,1,0,1
2873,0,2896,7471;7472;10053,0,1,0,2,0,3
2874,0,2897,7473;7474;7475;7476;7477,0,0,0,3,2,5
2875,0,2898,7478;7479,0,0,0,0,2,2
2876,0,2899,7480;7481,0,1,0,1,0,2
2877,0,2900,7482,0,0,0,1,0,1
2878,0,2901,7483;7484;7485,0,0,0,2,1,3
2879,0,2902,7486;7487;7488,0,0,1,1,1,3
2880,0,2903,7489;7490,0,0,0,2,0,2
2881,0,2904,7491;7492,0,0,0,0,2,2
2882,0,2905,7493;7494;7495;7496,0,0,2,2,0,4
2883,0,2906,7497;7498;7499;7500,0,0,2,2,0,4
2884,0,2907,7501;7502;7503;10049,0,1,1,1,1,4
2885,0,2908,7504,0,0,0,1,0,1
2886,0,2909,7505;7506;7507;7508;7509;7510,0,1,2,2,1,6
2887,0,2910,7511,0,0,0,0,1,1
2888,0,2911,7512;7513,0,0,0,0,2,2
2889,0,2912,7514;7515;7516;7517,0,0,0,3,1,4
2890,0,2913,7518;7519;7520;7521,0,0,2,0,2,4
2891,0,2914,7522;7525,0,0,1,0,1,2
2892,0,2915,7526;7527,0,0,0,1,1,2
2893,0,2916,7528;7529;7530,0,1,0,1,1,3
2894,0,2917,7531,0,0,0,0,1,1
2895,0,2918,7532;7533;7534,0,0,1,0,2,3
2896,0,2919,7535;7536;7537;7538;7539,0,0,0,3,2,5
2897,0,2920,7540,0,0,0,1,0,1
2898,0,2921,7541,0,0,0,1,0,1
2899,0,2922,7543;7544,0,0,0,1,1,2
2900,0,2923,7545,0,0,0,0,1,1
2901,0,2924,7548;7549;7550,0,1,0,0,2,3
2902,0,2925,7551;7552;7553;7554;7555,0,1,2,1,1,5
2903,0,2926,7556,0,0,0,1,0,1
2904,0,2927,7558;7559;7560;7561,0,0,1,3,0,4
2905,0,2928,7562,0,0,0,1,0,1
2906,0,2929,7564;7565,0,0,0,1,1,2
2907,0,2930,7566;7567;7568;7569;7570,0,0,1,3,1,5
2908,0,2931,7571,0,0,0,1,0,1
2909,0,2932,7573,0,0,0,1,0,1
2910,0,2933,7574;7575,0,0,0,2,0,2
2911,0,2934,7576,0,0,0,1,0,1
2912,0,2935,7577;7578;7579,0,0,0,2,1,3
2913,0,2936,7580,0,0,0,0,1,1
2914,0,2937,7581;7582;7584;7585,0,0,0,4,0,4
2915,0,2938,7586,0,0,0,1,0,1
2916,0,2939,7587;7588,0,0,0,1,1,2
2917,0,2940,7589,0,0,0,1,0,1
2918,0,2941,7590;7591;7592,0,0,0,2,1,3
2919,0,2942,7593;7594;7595;7596,0,0,1,2,1,4
2920,0,2943,7597;7598,0,0,0,1,1,2
2921,0,2944,7599;7601,0,0,1,1,0,2
2922,0,2945,7602;7603;7604,0,0,2,1,0,3
2923,0,2946,7605,0,0,0,1,0,1
2924,0,2947,7606;7607,0,0,0,2,0,2
2925,0,2948,7608;7609,0,0,0,1,1,2
2926,0,2949,7610;7611,0,0,0,2,0,2
2927,0,2950,7612;7613,0,0,0,1,1,2
2928,0,2951,7614;7615;7616,0,0,0,3,0,3
2929,0,2952,7617;7618;7619;7620;7621;7622,0,1,1,3,1,6
2930,0,2953,7623;7624;7625;7626,0,0,0,3,1,4
2931,0,2954,7627;7628,0,0,0,2,0,2
2932,0,2955,7630,0,0,0,0,1,1
2933,0,2956,7631;7632;7633;7634,0,1,0,0,3,4
2934,0,2957,7635;7636,0,0,0,1,1,2
2935,0,2958,7637;7638,0,0,0,1,1,2
2936,0,2959,7639,0,0,0,1,0,1
2937,0,2960,7640;7641;7642,0,0,0,2,1,3
2938,0,2961,7643,0,0,0,1,0,1
2939,0,2962,7644;7646,0,0,0,2,0,2
2940,0,2963,7647;7648,0,0,0,2,0,2
2941,0,2964,7649;7650,0,0,0,2,0,2
2942,0,2965,7651,0,0,0,1,0,1
2943,0,2966,7652;7653,0,0,0,2,0,2
2944,0,2967,7655;7656;7657,0,0,1,1,1,3
2945,0,2968,7658;7659;7660;7661;7662,0,0,0,4,1,5
2946,0,2969,7663;7664;7665,0,1,0,1,1,3
2947,0,2970,7666,0,0,0,1,0,1
2948,0,2971,7667,0,0,0,1,0,1
2949,0,2972,7668;7669;7670;7671;7672,0,0,1,4,0,5
2950,0,2973,7673;7674;7675,0,0,0,2,1,3
2951,0,2974,7676;7677;7678;7679,0,0,1,3,0,4
2952,0,2975,3821;7680;7681;7682;7683,0,0,2,3,0,5
2953,0,2976,7684;7685,0,0,0,2,0,2
2954,0,2977,7686,0,0,0,0,1,1
2955,0,2978,7687,0,0,0,1,0,1
2956,0,2979,7688;7689;7691;7692,0,0,1,2,1,4
2957,0,2980,7693,0,0,0,1,0,1
2958,0,2981,7694;7695;7696;7697;7698,0,0,3,2,0,5
2959,0,2982,7699;7700;7701,0,0,0,3,0,3
2960,0,2983,7702;7703;7704;7705,0,0,1,2,1,4
2961,0,2984,7706,0,0,0,1,0,1
2962,0,2985,7707;7708;7709,0,1,0,2,0,3
2963,0,2986,7710;7711;7712,0,0,2,0,1,3
2964,0,2987,7713,0,0,0,0,1,1
2965,0,2988,7714;7715,0,0,0,1,1,2
2966,0,2989,7716;7717,0,0,0,2,0,2
2967,0,2990,7718,0,0,0,1,0,1
2968,0,2991,7719,0,0,0,1,0,1
2969,0,2992,7720;7721;7722;7723;7724,0,1,1,3,0,5
2970,0,2993,7725;7726;7727;7728;7729,0,0,2,2,1,5
2971,0,2994,7730;7731;7732;7733,0,0,2,1,1,4
2972,0,2996,7735;7736,0,0,0,0,2,2
2973,0,2997,7737;7738;7739,0,0,1,2,0,3
2974,0,2998,7740;7741,0,0,0,1,1,2
2975,0,2999,7742;7743;7744,0,0,1,1,1,3
2976,0,3000,4248;7745;7746;7747,0,0,2,2,0,4
2977,0,3001,7748;7749,0,0,0,0,2,2
2978,0,3002,7750;7751;7752;7753,0,0,0,3,1,4
2979,0,3003,7754,0,0,0,0,1,1
2980,0,3004,7755,0,0,0,1,0,1
2981,0,3005,7756,0,0,0,1,0,1
2982,0,3006,7757,0,0,0,1,0,1
2983,0,3007,7758,0,0,0,1,0,1
2984,0,3008,7760;7761;7762,0,1,0,2,0,3
2985,0,3009,7763;7764;7765;7766,0,2,0,0,2,4
2986,0,3010,7767,0,0,0,1,0,1
2987,0,3011,7768;7769,0,0,0,2,0,2
2988,0,3012,7770,0,0,0,0,1,1
2989,0,3013,7771;7772,0,0,0,2,0,2
2990,0,3014,7773;7774,0,0,0,1,1,2
2991,0,3015,5264;7775;7776;7777,0,0,2,2,0,4
2992,0,3016,7778;7779;7780;7781,0,2,0,1,1,4
2993,0,3017,7782;7783;7784;7785,0,0,1,3,0,4
2994,0,3018,7786,0,0,0,0,1,1
2995,0,3019,7787;7788;7789,0,1,0,1,1,3
2996,0,3020,7790;7791,0,0,0,2,0,2
2997,0,3021,7792,0,0,0,1,0,1
2998,0,3022,7793;7794,0,2,0,0,0,2
2999,0,3023,7795;7796,0,0,0,2,0,2
3000,0,3024,7797,0,0,0,1,0,1
3001,0,3025,7798;10092,0,1,0,1,0,2
3002,0,3026,7800;7801;7802,0,0,1,2,0,3
3003,0,3027,7803;7805,0,0,0,2,0,2
3004,0,3028,7806;7807;7808;7809;10050,0,1,1,2,1,5
3005,0,3029,7810;7811,0,0,0,1,1,2
3006,0,3030,7813;7814;7815,0,0,0,3,0,3
3007,0,3031,7816;7817;7818;7819,0,0,1,2,1,4
3008,0,3032,7820;7821;7822,0,0,0,2,1,3
3009,0,3033,7823;7824;7825;7826,0,0,1,3,0,4
3010,0,3034,7827;7828;7829;7830,0,0,0,3,1,4
3011,0,3036,7832;7833,0,0,0,1,1,2
3012,0,3037,7834;7835,0,0,0,1,1,2
3013,0,3038,7836;7837;7838;7839,0,0,0,2,2,4
3014,0,3039,7840;7841,0,0,0,2,0,2
3015,0,3040,7844;7845;7846,0,0,0,3,0,3
3016,0,3041,7847;7848,0,0,0,1,1,2
3017,0,3042,7850;7851,0,0,0,1,1,2
3018,0,3043,7852,0,0,0,1,0,1
3019,0,3044,7853,0,0,0,0,1,1
3020,0,3045,7854;7855;7856,0,1,0,2,0,3
3021,0,3046,7857;7858,0,0,0,2,0,2
3022,0,3047,7859,0,0,0,1,0,1
3023,0,3048,7860;7861;7862;7863,0,0,0,2,2,4
3024,0,3049,7864;7865,0,0,0,0,2,2
3025,0,3050,4895;7866;7867;7868,0,0,2,2,0,4
3026,0,3051,7869;7870;7871;7872;7873;7874,0,0,2,4,0,6
3027,0,3052,7875,0,0,0,1,0,1
3028,0,3053,2001;7876,0,0,0,2,0,2
3029,0,3054,7877;7878,0,0,0,1,1,2
3030,0,3055,7879,0,0,0,1,0,1
3031,0,3056,7880;7881;7882,0,0,1,1,1,3
3032,0,3057,7883,0,0,0,1,0,1
3033,0,3058,7884,0,0,0,1,0,1
3034,0,3059,7885;7886,0,0,0,2,0,2
3035,0,3060,7887;7888;7889;7890,0,1,1,2,0,4
3036,0,3061,7891;7892;7893;7894,0,0,2,1,1,4
3037,0,3062,7895;7896,0,0,0,1,1,2
3038,0,3063,7897;7898;7899;7900,0,0,0,4,0,4
3039,0,3064,7901;7902,0,0,0,1,1,2
3040,0,3065,7903,0,0,0,1,0,1
3041,0,3066,7904;7905;7906,0,0,0,2,1,3
3042,0,3067,7907,0,0,0,1,0,1
3043,0,3068,7908,0,0,0,1,0,1
3044,0,3069,7910;7911;7912;7913;7914,0,0,3,2,0,5
3045,0,3070,7915,0,0,0,1,0,1
3046,0,3071,7916;7917;10013,0,1,0,2,0,3
3047,0,3072,7918;7919;7920;7921,0,0,1,2,1,4
3048,0,3073,7922,0,0,0,1,0,1
3049,0,3074,7923;7924;7925;7926;7927,0,0,3,1,1,5
3050,0,3075,7928;7929,0,0,0,2,0,2
3051,0,3076,7930;7931;7932;7933,0,0,0,4,0,4
3052,0,3077,7934;7935;7936,0,0,0,2,1,3
3053,0,3078,7937,0,0,0,1,0,1
3054,0,3079,7938;7939,0,0,1,1,0,2
3055,0,3080,7940;7941;7942;7943;7944,0,0,0,4,1,5
3056,0,3081,7945;7946;7947,0,1,0,1,1,3
3057,0,3082,7948;7949,0,0,0,2,0,2
3058,0,3083,7950;7951;10030,0,1,0,2,0,3
3059,0,3084,7952,0,0,0,0,1,1
3060,0,3085,7953;7954,0,0,0,2,0,2
3061,0,3086,7955,0,0,0,0,1,1
3062,0,3087,7956;7957,0,0,0,2,0,2
3063,0,3088,7958;7959,0,0,0,1,1,2
3064,0,3089,7962;7963,0,0,0,1,1,2
3065,0,3090,7965,0,0,0,0,1,1
3066,0,3091,7966;7967;7968;7969,0,0,1,2,1,4
3067,0,3092,7970;7971;7972,0,1,0,1,1,3
3068,0,3093,7973;7974;7975,0,0,0,3,0,3
3069,0,3094,7976,0,0,0,1,0,1
3070,0,3095,7977;7978,0,0,0,2,0,2
3071,0,3096,7979;7980,0,0,0,1,1,2
3072,0,3097,7981;7982;7983,0,0,0,1,2,3
3073,0,3098,7984,0,0,0,1,0,1
3074,0,3099,7986,0,0,0,1,0,1
3075,0,3100,7987;7988;7989;7990,0,0,2,1,1,4
3076,0,3101,7991;7992;7993;7994;7995;8659,0,0,4,2,0,6
3077,0,3102,7996;7997;7998,0,0,1,2,0,3
3078,0,3103,7999;8000,0,0,0,0,2,2
3079,0,3104,8001;8002,0,0,0,2,0,2
3080,0,3105,8003,0,0,0,0,1,1
3081,0,3106,8004;8005;8006,0,0,0,3,0,3
3082,0,3107,8007,0,0,0,1,0,1
3083,0,3108,8008;8009;8010,0,0,1,2,0,3
3084,0,3109,8011,0,0,0,1,0,1
3085,0,3110,8012;8013;8014,0,0,2,1,0,3
3086,0,3111,8015;8016,0,0,0,0,2,2
3087,0,3112,8017;8018;8019;8020,0,0,2,1,1,4
3088,0,3113,8021;8022;8023;8024;8025;8026;8027;8028,0,0,0,7,1,8
3089,0,3114,8029;8030,0,0,0,2,0,2
3090,0,3115,8031;8032;8033;8034,0,0,0,3,1,4
3091,0,3116,8035;8036;8037;8038;8039;8040,0,1,3,2,0,6
3092,0,3117,8041;8042;8043,0,0,0,3,0,3
3093,0,3118,8044,0,0,0,0,1,1
3094,0,3119,8045;8046;8047,0,1,0,2,0,3
3095,0,3120,8048;8049;8050;8051;8052,0,2,0,3,0,5
3096,0,3121,8053;8054,0,0,0,0,2,2
3097,0,3122,8055;8056;8057,0,1,0,2,0,3
3098,0,3123,8058,0,0,0,1,0,1
3099,0,3124,8059;8060,0,0,0,0,2,2
3100,0,3125,8061;8063,0,0,0,1,1,2
3101,0,3126,8064;8065,0,0,1,1,0,2
3102,0,3127,8066;8067,0,0,0,2,0,2
3103,0,3128,8068,0,0,0,1,0,1
3104,0,3129,8069,0,0,0,1,0,1
3105,0,3130,8070;8071;8072;8073,0,0,0,4,0,4
3106,0,3131,8074,0,0,0,0,1,1
3107,0,3132,8075;8076,0,1,0,0,1,2
3108,0,3133,8077;8078,0,0,0,0,2,2
3109,0,3134,8079;8081,0,0,0,1,1,2
3110,0,3135,7557;8082;8083,0,0,0,3,0,3
3111,0,3136,8084,0,0,0,1,0,1
3112,0,3137,8085;8086;8087,0,0,1,2,0,3
3113,0,3138,8088;8089,0,0,0,2,0,2
3114,0,3139,8090;8091;8092,0,0,0,3,0,3
3115,0,3140,8093,0,0,0,1,0,1
3116,0,3141,8094;8095;8096,0,0,0,3,0,3
3117,0,3142,8097;8098;8099;8100,0,0,2,1,1,4
3118,0,3143,8101;8102,0,0,0,0,2,2
3119,0,3144,8103,0,0,0,1,0,1
3120,0,3145,5612;8104,0,0,0,2,0,2
3121,0,3146,8105;8106,0,0,1,1,0,2
3122,0,3147,8107;8108;8109;8110;8111,0,1,2,2,0,5
3123,0,3148,8112;8113,0,0,0,1,1,2
3124,0,3149,8114;8116;8117,0,0,0,2,1,3
3125,0,3150,8118;8119;8120,0,0,0,2,1,3
3126,0,3151,8121;8122;8123;8124,0,0,3,1,0,4
3127,0,3152,8125;8126;8127,0,0,0,3,0,3
3128,0,3153,8128;8129;10078,0,1,0,2,0,3
3129,0,3154,8130;8131;8132;8133,0,0,1,3,0,4
3130,0,3155,7583;8134;8135,0,0,1,2,0,3
3131,0,3156,8136;8137,0,0,0,1,1,2
3132,0,3157,8138;8139,0,0,0,2,0,2
3133,0,3158,8140;8141;10003,0,1,0,1,1,3
3134,0,3159,8142;8143;8144;8145;8146,0,2,1,1,1,5
3135,0,3160,8147;8148;8149;8150,0,1,1,2,0,4
3136,0,3161,8151;8152,0,0,0,1,1,2
3137,0,3162,8153;8154;8155,0,0,0,3,0,3
3138,0,3163,6067;8156,0,0,0,2,0,2
3139,0,3164,8157;8158,0,0,0,2,0,2
3140,0,3165,8160,0,0,0,1,0,1
3141,0,3166,8161,0,0,0,0,1,1
3142,0,3167,8162;8163;8164,0,0,0,3,0,3
3143,0,3168,8165;8166;8167;8168;8169,0,0,3,1,1,5
3144,0,3169,8170,0,0,0,0,1,1
3145,0,3170,8171;8172;8173;8174;8175;8176;8177,0,0,2,4,1,7
3146,0,3171,8178,0,0,0,0,1,1
3147,0,3172,8179,0,0,0,1,0,1
3148,0,3173,8180;8182;8183,0,0,0,1,2,3
3149,0,3174,8184;8185;8186;8187,0,0,0,3,1,4
3150,0,3175,8188;8189,0,0,0,2,0,2
3151,0,3176,8190;8191,0,0,0,1,1,2
3152,0,3177,8192,0,0,0,1,0,1
3153,0,3178,8193;8194,0,0,0,2,0,2
3154,0,3179,8195;8196;8197;8198,0,0,1,2,1,4
3155,0,3180,8199;8200;8201,0,1,0,2,0,3
3156,0,3182,8203;8204,0,0,0,2,0,2
3157,0,3183,8205;8206,0,0,0,1,1,2
3158,0,3184,8207,0,0,0,1,0,1
3159,0,3185,8208,0,0,0,0,1,1
3160,0,3186,8209;8210,0,0,0,2,0,2
3161,0,3187,8211,0,0,0,1,0,1
3162,0,3188,8212;8213,0,0,0,2,0,2
3163,0,3189,3718;8214,0,0,0,2,0,2
3164,0,3190,8215;8216,0,0,0,2,0,2
3165,0,3191,8217;8218;8219;8220,0,0,1,0,3,4
3166,0,3192,8222;8223;8224,0,0,0,3,0,3
3167,0,3193,8225;8226,0,0,1,1,0,2
3168,0,3194,8227;8229;8230,0,0,0,3,0,3
3169,0,3195,8231;8232,0,0,0,1,1,2
3170,0,3196,8233,0,0,0,0,1,1
3171,0,3198,8235;8236;8237;8238,0,2,0,2,0,4
3172,0,3199,1431;8239;10063,0,1,0,2,0,3
3173,0,3200,8240,0,0,0,1,0,1
3174,0,3201,8241;8242,0,0,0,2,0,2
3175,0,3202,8243;10014,0,1,0,1,0,2
3176,0,3203,8244,0,0,0,0,1,1
3177,0,3204,8245;8246,0,0,0,1,1,2
3178,0,3205,8247;8248,0,0,0,2,0,2
3179,0,3206,8249;8250;8251;8252;8253,0,0,1,4,0,5
3180,0,3207,8254;8255,0,0,0,2,0,2
3181,0,3208,8256;8257,0,0,0,2,0,2
3182,0,3209,8258,0,0,0,0,1,1
3183,0,3210,8259,0,0,0,1,0,1
3184,0,3211,8260;8261,0,0,0,2,0,2
3185,0,3212,8263;8264;10021,0,1,0,2,0,3
3186,0,3213,8265,0,0,0,0,1,1
3187,0,3214,8266;8267;8268;8269;8270;8271;8272;8273,0,0,5,3,0,8
3188,0,3215,8274,0,0,0,1,0,1
3189,0,3216,8275;8276;8277;8278,0,1,0,3,0,4
3190,0,3217,8279;8280,0,0,0,2,0,2
3191,0,3218,8281;8282;8283;8284;8285,0,0,3,2,0,5
3192,0,3219,8286;8287;8288,0,1,0,1,1,3
3193,0,3220,8289;8290;8291;8292,0,0,3,1,0,4
3194,0,3221,8293;8294,0,0,0,1,1,2
3195,0,3222,8295;8296;8297,0,0,1,0,2,3
3196,0,3223,8298,0,0,0,1,0,1
3197,0,3224,8299,0,0,0,0,1,1
3198,0,3225,8300;8301;8302,0,1,0,2,0,3
3199,0,3226,8303,0,0,0,1,0,1
3200,0,3227,8304;8305;8306;8307,0,0,2,2,0,4
3201,0,3228,8308;8309;8310,0,0,0,3,0,3
3202,0,3229,8311;8312;8313;8314;8315,0,0,0,2,3,5
3203,0,3230,8316;8317;8318,0,0,2,1,0,3
3204,0,3231,8319,0,0,0,1,0,1
3205,0,3232,8321;8322;8323;8324,0,0,1,3,0,4
3206,0,3233,8325;8326,0,0,0,1,1,2
3207,0,3234,8327;8328,0,1,0,1,0,2
3208,0,3235,8329;8330;8331;8332,0,0,2,1,1,4
3209,0,3236,8333;8334,0,0,0,1,1,2
3210,0,3237,8335;8336;8337;8338,0,1,2,0,1,4
3211,0,3238,8339;8340,0,0,0,1,1,2
3212,0,3239,8341;8342;8343,0,0,0,2,1,3
3213,0,3240,8344;8345,0,0,0,2,0,2
3214,0,3241,8346;8347,0,0,0,0,2,2
3215,0,3242,8348;8349,0,0,0,1,1,2
3216,0,3243,8350;8351;10079,0,1,0,1,1,3
3217,0,3244,8352;8353,0,0,0,1,1,2
3218,0,3245,8354;8355,0,0,0,1,1,2
3219,0,3246,8356,0,0,0,1,0,1
3220,0,3247,8357;8358,0,0,0,2,0,2
3221,0,3248,8359;8360;8361,0,0,0,3,0,3
3222,0,3249,8362;8363;8364;8365,0,0,1,2,1,4
3223,0,3250,8366;8367,0,0,0,2,0,2
3224,0,3251,8368;8369;8370,0,0,0,3,0,3
3225,0,3252,8371;8372,0,1,0,1,0,2
3226,0,3253,8373;8374;8375;8376,0,0,2,2,0,4
3227,0,3254,8377,0,0,0,0,1,1
3228,0,3255,8378;8379;8380,0,0,0,3,0,3
3229,0,3256,8381;8382;8383;8384,0,0,0,4,0,4
3230,0,3257,8385,0,0,0,0,1,1
3231,0,3258,8386;8387;8388;8389,0,0,2,1,1,4
3232,0,3259,8390;8391;8392,0,0,0,2,1,3
3233,0,3260,8393,0,0,0,1,0,1
3234,0,3261,8395;8396,0,0,1,1,0,2
3235,0,3262,8397;8398,0,0,0,2,0,2
3236,0,3263,8399;8400;8401;8402;8403,0,0,0,4,1,5
3237,0,3264,8404;8405;8406;8407;8408;8409,0,1,3,2,0,6
3238,0,3265,8410,0,0,0,0,1,1
3239,0,3266,8411;8412,0,0,0,1,1,2
3240,0,3267,8413;8414,0,0,0,2,0,2
3241,0,3268,8415;8416;8417;8418,0,1,1,2,0,4
3242,0,3269,8419;8420;8421,0,1,0,1,1,3
3243,0,3270,8422;8423;8424;8425,0,0,1,3,0,4
3244,0,3271,8426;8427,0,0,0,2,0,2
3245,0,3272,8428;8429,0,0,0,1,1,2
3246,0,3273,8430;8431;8432,0,0,0,2,1,3
3247,0,3274,8433,0,0,0,1,0,1
3248,0,3275,1913;8434,0,0,0,2,0,2
3249,0,3276,8435,0,0,0,1,0,1
3250,0,3277,8436;8437;8438,0,0,0,2,1,3
3251,0,3278,8439;8440,0,0,0,1,1,2
3252,0,3279,8441;8442;8443,0,0,1,2,0,3
3253,0,3280,8444;8445,0,0,0,1,1,2
3254,0,3281,8446;8447;8448,0,0,0,3,0,3
3255,0,3282,8449;8450,0,0,0,2,0,2
3256,0,3283,8451;8452,0,0,0,2,0,2
3257,0,3284,8453;8454;8455;8456,0,0,1,1,2,4
3258,0,3285,8457;8458;8459,0,0,0,2,1,3
3259,0,3286,8460;8461,0,0,0,1,1,2
3260,0,3287,8462;8463,0,0,0,2,0,2
3261,0,3288,8464;8465;8466,0,0,1,2,0,3
3262,0,3289,8467;8468;8469;8470,0,0,2,2,0,4
3263,0,3290,8471;8472;8473;8474,0,1,1,2,0,4
3264,0,3291,8475;8476,0,0,0,1,1,2
3265,0,3292,8477;8478;8479,0,0,0,1,2,3
3266,0,3293,8480;8481;8482;8483,0,0,1,2,1,4
3267,0,3294,8484,0,0,0,0,1,1
3268,0,3295,8485;8486;8487;8488,0,0,0,4,0,4
3269,0,3296,8490;8491;8492;8493;8494,0,0,2,3,0,5
3270,0,3297,8495;8496;8497;8498,0,0,2,1,1,4
3271,0,3298,8499;8500;8501;8502,0,0,1,2,1,4
3272,0,3299,8503;8504,0,0,0,1,1,2
3273,0,3300,8505,0,0,0,1,0,1
3274,0,3301,8506,0,0,0,1,0,1
3275,0,3302,8507,0,0,0,0,1,1
3276,0,3303,8508;8509,0,0,0,2,0,2
3277,0,3304,8510;8511,0,0,0,2,0,2
3278,0,3305,8512;8513;8514;8515;8516,0,0,3,1,1,5
3279,0,3306,8517;8518;8519;8520,0,0,2,1,1,4
3280,0,3307,8521,0,0,0,0,1,1
3281,0,3308,8522;8523,0,0,0,1,1,2
3282,0,3309,8524;8525;8526;8527,0,0,1,2,1,4
3283,0,3310,8528,0,0,0,1,0,1
3284,0,3311,8529;8530,0,0,0,1,1,2
3285,0,3312,8531,0,0,0,1,0,1
3286,0,3313,8532,0,0,0,1,0,1
3287,0,3314,8533;8534;8535,0,0,0,1,2,3
3288,0,3315,8536;8537;8538;8539,0,0,2,1,1,4
3289,0,3316,8540;8541;8542,0,0,0,2,1,3
3290,0,3317,8544;8545;8546;8547;8548;8549,0,0,0,5,1,6
3291,0,3318,8550;8551;8552;8553,0,1,1,2,0,4
3292,0,3319,8554;8555;8556,0,1,0,1,1,3
3293,0,3320,8557,0,0,0,1,0,1
3294,0,3321,8558;8559;8560;8561,0,0,2,2,0,4
3295,0,3322,8562;8563,0,0,0,1,1,2
3296,0,3323,8564;8565;8566;8567;8568,0,0,2,3,0,5
3297,0,3324,7173;8569,0,0,0,2,0,2
3298,0,3326,8571;8572;8573,0,0,2,0,1,3
3299,0,3327,8574,0,0,0,0,1,1
3300,0,3328,8575,0,0,0,1,0,1
3301,0,3329,8576,0,0,0,0,1,1
3302,0,3330,8577;8578;8579,0,0,0,2,1,3
3303,0,3331,8580;8581,0,0,0,1,1,2
3304,0,3332,8582;8583;8584,0,0,1,2,0,3
3305,0,3333,8585,0,0,0,1,0,1
3306,0,3334,8586,0,0,0,1,0,1
3307,0,3335,8587;8588;8589;8590;8591;8592,0,0,3,3,0,6
3308,0,3336,8593;8594;8595;8596,0,0,0,3,1,4
3309,0,3337,8597;8598,0,0,0,1,1,2
3310,0,3338,8599;8600,0,0,0,2,0,2
3311,0,3339,8601;8602;8603;8604,0,0,0,3,1,4
3312,0,3340,8605,0,0,0,1,0,1
3313,0,3341,8606;8607,0,0,0,2,0,2
3314,0,3342,8608;8609,0,0,0,2,0,2
3315,0,3343,8610;8611;8612,0,1,0,1,1,3
3316,0,3344,8613,0,0,0,1,0,1
3317,0,3345,8614;8615;8616;8617;8618;8619,0,0,3,2,1,6
3318,0,3346,8620;8621;8622;8623;8624,0,0,2,2,1,5
3319,0,3347,8625;8626;8627;8628;8629,0,0,3,2,0,5
3320,0,3348,8630;8631,0,0,0,2,0,2
3321,0,3349,8632;8633;8634,0,0,0,3,0,3
3322,0,3351,8636;8637;8638,0,0,1,1,1,3
3323,0,3352,8639;8640;8641;8642;8643,0,0,3,1,1,5
3324,0,3353,8644;8645;8646,0,0,0,3,0,3
3325,0,3354,8647;8648;8649;8650,0,0,2,2,0,4
3326,0,3355,8651;8652,0,0,0,2,0,2
3327,0,3356,8653;8654,0,0,0,1,1,2
3328,0,3357,8655;8656,0,0,0,1,1,2
3329,0,3358,8657;8658,0,0,0,2,0,2
3330,0,3360,8660,0,0,0,1,0,1
3331,0,3361,8661;8662;8663;8664;8665,0,0,0,5,0,5
3332,0,3362,5493;8666,0,0,0,2,0,2
3333,0,3363,8667;8668,0,0,0,1,1,2
3334,0,3364,8669,0,0,0,1,0,1
3335,0,3365,8670;8671;8672,0,0,1,2,0,3
3336,0,3366,8673;8674;8675,0,0,2,1,0,3
3337,0,3367,8676;8677;8679;8680;8681,0,1,2,0,2,5
3338,0,3368,8682;8683,0,0,0,1,1,2
3339,0,3369,8684;8685,0,0,0,2,0,2
3340,0,3370,8686;8687;8688,0,0,1,2,0,3
3341,0,3371,8689,0,0,0,1,0,1
3342,0,3372,8690;8691;8692,0,0,0,3,0,3
3343,0,3373,8693;8694,0,0,0,2,0,2
3344,0,3374,8695;8696;8697;8698,0,2,0,1,1,4
3345,0,3375,8699;8700;8701,0,1,0,1,1,3
3346,0,3376,8702;8703,0,1,0,1,0,2
3347,0,3377,8704,0,0,0,0,1,1
3348,0,3378,8705,0,0,0,1,0,1
3349,0,3379,8706;8707,0,0,0,2,0,2
3350,0,3380,8708,0,0,0,1,0,1
3351,0,3381,8709;8710;8711;8712,0,0,1,1,2,4
3352,0,3382,8713;8714;8715;8716,0,0,0,4,0,4
3353,0,3383,8717;8718;8719;8720;8721,0,1,0,3,1,5
3354,0,3384,8722;8723;10103,0,1,0,2,0,3
3355,0,3385,8724,0,0,0,1,0,1
3356,0,3386,8725;8726,0,0,0,1,1,2
3357,0,3387,8727;8728;10019,0,1,0,2,0,3
3358,0,3388,8729;8730,0,0,0,2,0,2
3359,0,3389,8731,0,0,0,1,0,1
3360,0,3390,8732;8733,0,0,0,2,0,2
3361,0,3391,8734;8735,0,0,0,1,1,2
3362,0,3392,8736;8737,0,0,0,2,0,2
3363,0,3393,8738;8739;8740;8741,0,0,2,1,1,4
3364,0,3394,8742;8743,0,0,0,1,1,2
3365,0,3395,8744;8745;8746;8747,0,0,1,3,0,4
3366,0,3396,8748;8749,0,0,0,2,0,2
3367,0,3397,8750;8751;8752;8753,0,0,0,3,1,4
3368,0,3398,8754;8755;8756;8757,0,0,0,3,1,4
3369,0,3399,8758;8759;8760,0,0,1,1,1,3
3370,0,3400,8761;8762,0,0,0,2,0,2
3371,0,3401,8763;8764,0,0,0,2,0,2
3372,0,3402,8765,0,0,0,1,0,1
3373,0,3403,8767;8768;8769;8770;8771;8772,0,0,0,3,3,6
3374,0,3404,8773;8774,0,0,0,2,0,2
3375,0,3405,8775;8776,0,0,0,1,1,2
3376,0,3406,8777;8778;8779;8780;8781,0,0,2,1,2,5
3377,0,3407,8782;8783;8784;8785,0,0,2,1,1,4
3378,0,3408,8786;8787,0,0,0,1,1,2
3379,0,3409,8788,0,0,0,1,0,1
3380,0,3410,8789,0,0,0,0,1,1
3381,0,3411,8790;8791,0,0,0,1,1,2
3382,0,3412,8792;8793,0,0,0,1,1,2
3383,0,3413,8794;8795;8796;8797;8798;8799,0,0,4,1,1,6
3384,0,3414,8800,0,0,0,0,1,1
3385,0,3415,8801;8802;8803,0,0,0,3,0,3
3386,0,3416,8804;8805;8806;8807;8808,0,0,3,2,0,5
3387,0,3417,8810,0,0,0,0,1,1
3388,0,3418,8811;8812;8813;8814;8815,0,0,1,4,0,5
3389,0,3419,8816,0,0,0,0,1,1
3390,0,3420,8817;8818;8819;8820;8821;8822;8823,0,0,2,2,3,7
3391,0,3421,8824;8825;8826;8827,0,0,2,2,0,4
3392,0,3422,8828;8829;8830;8831,0,0,0,4,0,4
3393,0,3423,8832;8833,0,0,0,2,0,2
3394,0,3424,8834;10096,0,1,0,1,0,2
3395,0,3425,8835;8837;8838;8839;8840,0,2,0,3,0,5
3396,0,3426,8841;8842,0,0,0,2,0,2
3397,0,3427,8843;8844;8845,0,0,1,2,0,3
3398,0,3428,8846,0,0,0,0,1,1
3399,0,3429,8847;8848,0,0,0,1,1,2
3400,0,3430,8849,0,0,0,1,0,1
3401,0,3431,8850;8852;8853;8854,0,1,1,2,0,4
3402,0,3432,8855;8857;8858;8859,0,0,3,0,1,4
3403,0,3433,8860,0,0,0,1,0,1
3404,0,3434,5884;8861,0,0,0,2,0,2
3405,0,3435,8862,0,1,0,0,0,1
3406,0,3436,1996;8863;8864,0,0,0,3,0,3
3407,0,3437,8865;8866;8867,0,0,0,2,1,3
3408,0,3438,8868;8869,0,0,0,1,1,2
3409,0,3439,8870,0,0,0,1,0,1
3410,0,3440,8871;8872;8873,0,0,0,3,0,3
3411,0,3441,8874,0,0,0,1,0,1
3412,0,3442,8875;8876;8877;8878,0,2,0,1,1,4
3413,0,3443,8879,0,0,0,1,0,1
3414,0,3444,8880;8881,0,0,0,0,2,2
3415,0,3445,8882,0,0,0,1,0,1
3416,0,3446,8883;8884;8885;8886,0,2,0,2,0,4
3417,0,3447,8887;8888,0,0,0,1,1,2
3418,0,3448,8889;8890;8891;8892;8893;8894,0,0,3,2,1,6
3419,0,3449,8895,0,0,0,1,0,1
3420,0,3450,8896;8897;8898;8899,0,0,1,3,0,4
3421,0,3451,8900;8901;8902;8903;8904,0,0,2,2,1,5
3422,0,3452,8905;8906,0,0,0,1,1,2
3423,0,3453,8907;8908,0,0,0,1,1,2
3424,0,3454,8910;8911;8912,0,0,1,1,1,3
3425,0,3455,8913,0,0,0,0,1,1
3426,0,3456,8914;8915,0,0,0,2,0,2
3427,0,3457,8916;8917,0,0,0,1,1,2
3428,0,3458,8918;8919,0,0,0,2,0,2
3429,0,3459,8920;8921;8922,0,0,1,2,0,3
3430,0,3460,8923;8924,0,0,0,1,1,2
3431,0,3461,8925;8926;8927;8928,0,0,0,4,0,4
3432,0,3462,8929;8930;8931;8932,0,0,2,2,0,4
3433,0,3463,8933;8934;8935,0,0,0,2,1,3
3434,0,3464,8937,0,0,0,1,0,1
3435,0,3465,8938;8939,0,0,0,1,1,2
3436,0,3466,8940,0,0,0,0,1,1
3437,0,3467,8941;8942;10085,0,1,0,2,0,3
3438,0,3468,8943;8944,0,0,0,2,0,2
3439,0,3469,8945;8946;8947;8948;8949,0,1,0,3,1,5
3440,0,3470,8950;8951;8952;8953,0,0,0,2,2,4
3441,0,3471,8954;8955;8956;8957,0,0,0,3,1,4
3442,0,3472,8958;8959,0,0,0,1,1,2
3443,0,3473,8960;8961,0,0,0,1,1,2
3444,0,3474,8962;8963,0,0,0,1,1,2
3445,0,3475,8964;8965;8966;8967,0,1,0,3,0,4
3446,0,3476,8968;8969,0,0,0,2,0,2
3447,0,3477,8970;8971,0,0,0,1,1,2
3448,0,3478,8972;8973,0,0,0,1,1,2
3449,0,3479,8974;8975;8976;8977;8978,0,1,1,1,2,5
3450,0,3480,8979,0,0,0,1,0,1
3451,0,3482,8982;8983;8984;8985;8986;8987,0,0,2,4,0,6
3452,0,3483,8988;8989,0,0,0,2,0,2
3453,0,3484,8990,0,0,0,1,0,1
3454,0,3485,8991;8992;10036,0,1,0,2,0,3
3455,0,3486,8993,0,0,0,1,0,1
3456,0,3487,8994;8995;8996;8997;8998,0,1,1,2,1,5
3457,0,3488,9000,0,0,0,1,0,1
3458,0,3489,9001;9002;9003,0,0,1,1,1,3
3459,0,3490,9004;9005;9006;9007;9008;9009,0,0,3,2,1,6
3460,0,3491,9010;9011,0,0,0,2,0,2
3461,0,3492,9012;9013,0,0,0,1,1,2
3462,0,3493,3829;9014;9015;9016;9017;10114,0,1,1,4,0,6
3463,0,3494,9018,0,0,0,1,0,1
3464,0,3495,9019;9020;9021,0,0,0,3,0,3
3465,0,3496,9022;9023,0,0,0,2,0,2
3466,0,3497,9024;9025,0,0,0,2,0,2
3467,0,3498,9026,0,0,0,1,0,1
3468,0,3499,9027;9028,0,0,0,2,0,2
3469,0,3500,9029,0,0,0,1,0,1
3470,0,3501,9030;9031;9032;9033,0,0,2,2,0,4
3471,0,3502,4485;9034,0,0,0,2,0,2
3472,0,3503,9035;9036;9037,0,1,0,2,0,3
3473,0,3504,9038;9039;9040;9041;9042;9043,0,2,2,2,0,6
3474,0,3505,9044;9045;9046,0,1,1,1,0,3
3475,0,3506,9047;9048;9049,0,0,0,2,1,3
3476,0,3507,9050;10106,0,1,0,1,0,2
3477,0,3508,9051,0,0,0,0,1,1
3478,0,3509,9052;9053,0,0,0,2,0,2
3479,0,3510,9054;9055;9056;10069,0,2,0,1,1,4
3480,0,3511,9057;9058,0,0,0,0,2,2
3481,0,3512,9059;9060,0,0,0,1,1,2
3482,0,3513,9061;9062;9063,0,0,1,1,1,3
3483,0,3514,9064,0,0,0,1,0,1
3484,0,3515,9065,0,0,0,1,0,1
3485,0,3516,9066;9067;9068;9069,0,0,2,2,0,4
3486,0,3517,9070;10059,0,1,0,1,0,2
3487,0,3518,9071;9072;9073;9074,0,0,0,3,1,4
3488,0,3519,9075;9076;9077;9078,0,0,1,2,1,4
3489,0,3520,9079;9080;9081;9082,0,0,1,3,0,4
3490,0,3521,9083;9084,0,0,0,1,1,2
3491,0,3522,9085;9086;9087,0,0,0,1,2,3
3492,0,3523,9088,0,0,0,1,0,1
3493,0,3524,9089;9090,0,0,0,1,1,2
3494,0,3525,9091;9092,0,0,0,1,1,2
3495,0,3526,9093;9094,0,0,0,1,1,2
3496,0,3527,9095;9096;9097;9098;9099,0,2,1,2,0,5
3497,0,3528,9100;9101;9102;9103,0,0,1,2,1,4
3498,0,3529,9104;9105;9106;9107,0,0,0,3,1,4
3499,0,3530,9108;9109,0,0,0,0,2,2
3500,0,3531,9110;9111;9112;9113;9114,0,0,1,2,2,5
3501,0,3532,9115;9116;9117;9118,0,0,2,1,1,4
3502,0,3533,9119;9120;9121,0,0,0,2,1,3
3503,0,3534,9122,0,0,0,1,0,1
3504,0,3535,9123;9124;9125;9126;9127,0,0,0,4,1,5
3505,0,3536,9128;9129,0,0,0,2,0,2
3506,0,3537,9130;9131;10018,0,1,0,2,0,3
3507,0,3538,9132;9133;9134,0,0,1,1,1,3
3508,0,3539,9135;9137;9138;9139,0,0,2,0,2,4
3509,0,3540,9140;9141,0,0,0,2,0,2
3510,0,3542,9143;9144;9145,0,0,1,2,0,3
3511,0,3543,9146,0,0,0,1,0,1
3512,0,3544,9147,0,0,0,1,0,1
3513,0,3545,9148;9149;9150;9151,0,2,0,1,1,4
3514,0,3546,9152,0,0,0,1,0,1
3515,0,3547,9153;9154,0,0,0,1,1,2
3516,0,3548,9155;9156,0,0,0,1,1,2
3517,0,3549,9157;9158;9160;9161;9162,0,2,0,2,1,5
3518,0,3550,9163;9164;9165;9166;9167,0,0,2,2,1,5
3519,0,3551,9168,0,0,0,1,0,1
3520,0,3552,9170;9171,0,0,0,1,1,2
3521,0,3553,9172;9173,0,0,0,1,1,2
3522,0,3554,9174;9175,0,0,0,1,1,2
3523,0,3555,9176;9177,0,0,0,2,0,2
3524,0,3556,9178;9179,0,0,0,1,1,2
3525,0,3557,9180,0,0,0,1,0,1
3526,0,3558,9181;9182,0,0,0,2,0,2
3527,0,3559,9183;9184,0,0,0,2,0,2
3528,0,3560,9185;9186;9187;9188;9189,0,0,3,2,0,5
3529,0,3562,9191;9192,0,0,0,1,1,2
3530,0,3563,9193,0,0,0,1,0,1
3531,0,3564,9194;9195;9196;9197,0,1,0,1,2,4
3532,0,3565,9198;9199,0,0,0,1,1,2
3533,0,3566,9200;9201,0,0,0,2,0,2
3534,0,3567,9202;9203,0,0,0,2,0,2
3535,0,3568,9204;9205,0,0,0,1,1,2
3536,0,3569,9206;9207;9208;9209;9210;9211,0,1,1,4,0,6
3537,0,3570,9212;9213;9214;9215,0,0,1,2,1,4
3538,0,3571,9216,0,0,0,0,1,1
3539,0,3572,9218;9219;9220;9221,0,0,2,1,1,4
3540,0,3573,9222;9223;9224;9225;9226;9227,0,0,3,3,0,6
3541,0,3574,9228;9229;9230;9231;9232,0,0,2,3,0,5
3542,0,3575,9233;9234;9235,0,0,0,1,2,3
3543,0,3576,9236;9237;9238,0,0,0,3,0,3
3544,0,3577,9239;9240,0,0,0,1,1,2
3545,0,3578,9241,0,0,0,1,0,1
3546,0,3579,9242,0,0,0,1,0,1
3547,0,3580,9243;9244;9245;9246;9247,0,1,2,1,1,5
3548,0,3581,9248,0,0,0,1,0,1
3549,0,3582,9249;9250,0,0,0,2,0,2
3550,0,3583,9251;9252,0,0,0,1,1,2
3551,0,3584,9253,0,0,0,1,0,1
3552,0,3585,9254;9255;9256;9257,0,0,1,1,2,4
3553,0,3586,9258;9259;9260,0,0,0,2,1,3
3554,0,3587,9261;9262,0,0,0,2,0,2
3555,0,3588,9263;9264;9265;9266;9267,0,1,1,3,0,5
3556,0,3589,9268;9269;9270,0,0,0,3,0,3
3557,0,3590,7812;9271,0,0,0,2,0,2
3558,0,3591,9272;9273,0,0,0,1,1,2
3559,0,3592,9274;9275;10067,0,1,0,2,0,3
3560,0,3593,9276;9277,0,0,0,1,1,2
3561,0,3594,9278;9279;9280;9281,0,0,2,0,2,4
3562,0,3595,9282,0,0,0,1,0,1
3563,0,3596,9283;9285,0,0,1,1,0,2
3564,0,3597,9286,0,0,0,1,0,1
3565,0,3598,9287,0,0,0,1,0,1
3566,0,3599,9288;9289,0,0,0,2,0,2
3567,0,3600,9290,0,0,0,1,0,1
3568,0,3601,9291,0,0,0,1,0,1
3569,0,3602,9292;9293,0,0,0,1,1,2
3570,0,3603,9294;9295,0,0,0,2,0,2
3571,0,3604,9296;9297;9298;9299;9300,0,0,0,4,1,5
3572,0,3605,7804;9301;10033,0,1,0,2,0,3
3573,0,3606,9302;9304,0,0,0,2,0,2
3574,0,3607,9305,0,0,0,0,1,1
3575,0,3608,9306;9307,0,0,0,2,0,2
3576,0,3609,9308,0,0,0,0,1,1
3577,0,3610,9310;9311,0,0,0,0,2,2
3578,0,3611,9312;9313,0,0,0,2,0,2
3579,0,3612,9314;9315;9316;9317,0,2,0,1,1,4
3580,0,3613,9318;9319,0,0,0,2,0,2
3581,0,3614,9320,0,0,0,0,1,1
3582,0,3615,9321,0,0,0,1,0,1
3583,0,3617,9323;9324;9325;9326,0,0,0,2,2,4
3584,0,3618,9327;9328;9329;9330;9331;9332,0,0,1,3,2,6
3585,0,3619,9333;9335;9336,0,0,1,2,0,3
3586,0,3620,9337;9338;9339;9340,0,0,1,2,1,4
3587,0,3621,9341;9342,0,0,0,2,0,2
3588,0,3622,9343;9344,0,0,0,1,1,2
3589,0,3623,9345,0,0,0,1,0,1
3590,0,3624,9346;9347;9348,0,0,0,3,0,3
3591,0,3625,9349;9350;9351;9352,0,0,1,3,0,4
3592,0,3626,9353;9354;9355;9356;9357;9358,0,0,4,2,0,6
3593,0,3627,9359,0,0,0,1,0,1
3594,0,3628,9360;9361;10112,0,1,0,2,0,3
3595,0,3629,9362;9363;9364;9365,0,2,0,2,0,4
3596,0,3630,9366;9368;9369;9370;9371,0,0,2,3,0,5
3597,0,3631,9372;9373,0,0,0,2,0,2
3598,0,3632,9374;9375,0,0,0,2,0,2
3599,0,3633,9377,0,0,0,1,0,1
3600,0,3634,9378,0,0,0,1,0,1
3601,0,3635,9379;9380,0,0,0,0,2,2
3602,0,3636,9381;9382,0,0,0,2,0,2
3603,0,3637,9383;9384,0,0,0,2,0,2
3604,0,3638,9385,0,0,0,1,0,1
3605,0,3639,9386;9387;9388;9389,0,0,1,2,1,4
3606,0,3640,9390;9391;9392;9393;9394,0,0,2,3,0,5
3607,0,3641,9395;9396,0,0,0,1,1,2
3608,0,3642,9397,0,0,0,0,1,1
3609,0,3643,9399;9400;9401,0,0,2,1,0,3
3610,0,3644,9402;9403,0,0,0,0,2,2
3611,0,3645,9404;9405;9406,0,0,1,2,0,3
3612,0,3646,9407;9408,0,0,0,2,0,2
3613,0,3647,9409;9410;9411,0,0,0,2,1,3
3614,0,3648,9413;9414,0,0,0,2,0,2
3615,0,3649,9415;9416;9417;9418;9419;9420,0,0,4,1,1,6
3616,0,3650,9421;9422;9423;9424;9425,0,1,2,1,1,5
3617,0,3651,9426;9427;9428;9429,0,0,0,3,1,4
3618,0,3652,9430,0,0,0,0,1,1
3619,0,3653,9432;9433;9434,0,0,0,2,1,3
3620,0,3654,9435;9436,0,0,0,2,0,2
3621,0,3655,9437;9438,0,0,0,1,1,2
3622,0,3656,9439,0,0,0,1,0,1
3623,0,3657,9440;9441,0,0,0,2,0,2
3624,0,3658,9442,0,0,0,1,0,1
3625,0,3659,9444;9445,0,0,0,1,1,2
3626,0,3660,9446;9447;9450,0,0,1,0,2,3
3627,0,3661,9451,0,0,0,0,1,1
3628,0,3662,9452;9453;9454;9455,0,0,2,2,0,4
3629,0,3663,9456,0,0,0,0,1,1
3630,0,3664,9457;9458;9459;9460;9461,0,0,0,5,0,5
3631,0,3665,9462;9463,0,0,0,2,0,2
3632,0,3666,9464,0,0,0,1,0,1
3633,0,3667,9465;9466;9467,0,0,1,2,0,3
3634,0,3668,9468;9469;9470;9471,0,0,0,1,3,4
3635,0,3669,9472;9473,0,0,0,1,1,2
3636,0,3670,9474,0,0,0,1,0,1
3637,0,3671,9475;9476,0,0,0,1,1,2
3638,0,3672,9477,0,0,0,1,0,1
3639,0,3673,9478;9479,0,0,0,1,1,2
3640,0,3674,9480;9481;9482;9483;9484;9485,0,0,2,4,0,6
3641,0,3675,9486,0,0,0,1,0,1
3642,0,3676,9487;9488;9489;9490;9491;9492,0,0,0,4,2,6
3643,0,3677,9493;9494,0,0,0,2,0,2
3644,0,3678,9495,0,0,0,1,0,1
3645,0,3679,1006;9496;10017,0,1,0,2,0,3
3646,0,3680,9497;9498;9499;9500;9501,0,0,3,1,1,5
3647,0,3681,9502,0,0,0,0,1,1
3648,0,3682,9503,0,0,0,1,0,1
3649,0,3683,9504;9505;9506,0,1,0,1,1,3
3650,0,3684,9507;9508,0,0,0,2,0,2
3651,0,3685,9509;9510;9511,0,0,0,3,0,3
3652,0,3686,9512;9513;9514,0,1,1,1,0,3
3653,0,3687,9515;9516;9517;9518;9519;9520,0,3,1,0,2,6
3654,0,3688,9521,0,0,0,1,0,1
3655,0,3689,9523,0,0,0,0,1,1
3656,0,3690,9524;9525;9526;10088,0,1,1,2,0,4
3657,0,3691,9527;9528;9529;9530;9531,0,0,0,4,1,5
3658,0,3692,9532;9533;9534,0,0,0,0,3,3
3659,0,3693,9535,0,0,0,1,0,1
3660,0,3694,9536;9537;9538,0,0,0,3,0,3
3661,0,3695,9539;9540,0,0,0,1,1,2
3662,0,3696,9541;9542,0,0,0,2,0,2
3663,0,3697,9543;9544,0,0,0,1,1,2
3664,0,3698,9545;9546;9547,0,0,0,2,1,3
3665,0,3699,9548;9549,0,0,0,2,0,2
3666,0,3700,9550;9551,0,0,0,2,0,2
3667,0,3701,9552;9553,0,0,0,1,1,2
3668,0,3702,9554;10055,0,1,0,1,0,2
3669,0,3703,9555;9556;9557;9558;9559,0,0,0,5,0,5
3670,0,3704,9560;9561;9562;9563,0,1,2,1,0,4
3671,0,3705,9564;9565;9566,0,0,0,3,0,3
3672,0,3706,9567;9568,0,0,0,1,1,2
3673,0,3707,9569;9570;9571;9572;9573,0,0,2,3,0,5
3674,0,3708,9574;9575;9576,0,0,0,3,0,3
3675,0,3709,9577,0,0,0,1,0,1
3676,0,3710,9578;9579;9580,0,1,0,1,1,3
3677,0,3711,9581;9582,0,0,0,1,1,2
3678,0,3712,9583;9584;9585,0,0,1,2,0,3
3679,0,3713,9586;9587;9588;9589;10066,0,1,2,2,0,5
3680,0,3714,9590;9591,0,0,0,2,0,2
3681,0,3715,9592;9593;9595;9596,0,0,1,0,3,4
3682,0,3716,9597,0,0,0,1,0,1
3683,0,3717,9598;9599;9600,0,0,0,2,1,3
3684,0,3718,9601;9602;9603,0,0,0,2,1,3
3685,0,3719,9604;9605;9606;9607;9608;10039;10042,0,2,3,2,0,7
3686,0,3720,9609,0,0,0,1,0,1
3687,0,3721,9610;9611,0,0,0,2,0,2
3688,0,3722,9612;9613,0,0,0,2,0,2
3689,0,3723,9614;9615;9616,0,0,0,3,0,3
3690,0,3724,9617;9618,0,0,0,1,1,2
3691,0,3725,9619,0,0,0,1,0,1
3692,0,3726,9620;9621,0,0,0,2,0,2
3693,0,3727,9622;9623;9624;9625;9626,0,1,0,3,1,5
3694,0,3728,9627;9628;9629,0,0,0,1,2,3
3695,0,3729,9630,0,0,0,0,1,1
3696,0,3730,9631;9632,0,0,0,1,1,2
3697,0,3731,9633;9634,0,0,0,2,0,2
3698,0,3732,9635;9636;9637,0,0,1,2,0,3
3699,0,3733,9638;9639,0,0,1,0,1,2
3700,0,3734,9640;9641;9642;9643,0,0,2,2,0,4
3701,0,3735,9644,0,0,0,0,1,1
3702,0,3736,9645,0,0,0,1,0,1
3703,0,3737,9646;9647;9648;9649,0,0,2,2,0,4
3704,0,3738,9650;9651,0,0,1,1,0,2
3705,0,3739,9652;9653;9654;9655,0,1,1,2,0,4
3706,0,3740,9656;9657,0,0,0,2,0,2
3707,0,3741,9658,0,0,0,1,0,1
3708,0,3742,9659,0,0,0,1,0,1
3709,0,3743,9660;9661;9662,0,0,0,3,0,3
3710,0,3744,9663;9664;9665;9666;9667,0,1,3,1,0,5
3711,0,3745,9668,0,0,0,0,1,1
3712,0,3746,9669,0,0,0,0,1,1
3713,0,3747,9670;9671,0,0,0,2,0,2
3714,0,3748,9672;9673,0,0,0,1,1,2
3715,0,3749,9674;9675;9676;9677,0,0,1,2,1,4
3716,0,3750,9678;9679;9680;9681,0,0,2,1,1,4
3717,0,3751,9682;9683,0,0,0,2,0,2
3718,0,3752,9684;9685;9686;9687;9688;9689,0,2,1,3,0,6
3719,0,3753,9690;9691;9692;9693;9694,0,0,3,2,0,5
3720,0,3754,9695;9696,0,0,0,2,0,2
3721,0,3755,9697;9698;9699,0,0,0,3,0,3
3722,0,3756,9700;9701,0,0,0,2,0,2
3723,0,3757,9702;9703,0,0,0,2,0,2
3724,0,3758,9705;9706,0,0,0,2,0,2
3725,0,3759,9707;9708;9709;9710,0,1,1,2,0,4
3726,0,3760,9711;9712,0,0,0,2,0,2
3727,0,3761,9713;9714,0,0,0,2,0,2
3728,0,3762,9715;9716,0,0,0,1,1,2
3729,0,3763,9717;9718;9719;9720;9721;9722,0,0,3,2,1,6
3730,0,3765,9724;9725;9726;9727;9728;9729,0,2,1,2,1,6
3731,0,3766,9730,0,0,0,1,0,1
3732,0,3767,9731,0,0,0,0,1,1
3733,0,3768,9732,0,0,0,0,1,1
3734,0,3769,9733;9734;9735;9736,0,2,0,2,0,4
3735,0,3770,9737;9738;9739;9740;9741,0,2,1,1,1,5
3736,0,3771,9742,0,1,0,0,0,1
3737,0,3772,9743;9744,0,0,0,2,0,2
3738,0,3773,9745;9746,0,0,0,0,2,2
3739,0,3774,9747;9748;9749;9750;9751,0,3,0,1,1,5
3740,0,3775,9752;9753,0,0,0,1,1,2
3741,0,3776,9754;9755;9756,0,0,1,2,0,3
3742,0,3777,9757,0,0,0,1,0,1
3743,0,3778,9758;9759;9760;9761;9762,0,0,0,4,1,5
3744,0,3779,9763;9764;9765,0,2,0,1,0,3
3745,0,3780,9766;9767;9768;9769,0,0,1,3,0,4
3746,0,3781,9770;9771,0,0,0,2,0,2
3747,0,3782,9772;9773,0,0,0,2,0,2
3748,0,3783,9774;9775;9776;9777,0,0,2,2,0,4
3749,0,3784,9778;9779,0,0,0,1,1,2
3750,0,3785,9780;9781;9782;9783,0,0,2,1,1,4
3751,0,3786,9784;9785;9786;9787;9788,0,1,1,3,0,5
3752,0,3787,9789;9790;9791;9792,0,0,0,4,0,4
3753,0,3788,9793;9794,0,0,0,2,0,2
3754,0,3789,9795;9796;9797;9798;9799,0,0,2,2,1,5
3755,0,3790,9800,0,0,0,0,1,1
3756,0,3791,9801,0,0,0,1,0,1
3757,0,3792,9802;9803;9804,0,0,0,3,0,3
3758,0,3793,9805;9806;9807,0,0,0,2,1,3
3759,0,3794,9808;9809,0,0,0,2,0,2
3760,0,3795,9810,0,0,0,1,0,1
3761,0,3796,9811;9812;9813,0,0,0,2,1,3
3762,0,3797,9814;9815;9816;9817;9818;9819,0,0,4,1,1,6
3763,0,3798,9820;9821,0,0,0,1,1,2
3764,0,3799,9822,0,0,0,1,0,1
3765,0,3800,9823;9824;9825;9826;9827,0,1,1,2,1,5
3766,0,3801,9829;9830;9831;9832;9833;9834,0,0,0,5,1,6
3767,0,3802,9835;9836;9837;9838,0,0,2,1,1,4
3768,0,3803,9840,0,0,0,1,0,1
3769,0,3804,9841;9842;9843;9844,0,0,1,3,0,4
3770,0,3805,9845,0,0,0,1,0,1
3771,0,3806,7831;9846,0,0,0,2,0,2
3772,0,3807,9847;9848;9849,0,1,1,0,1,3
3773,0,3809,9851;9852;9853;9854,0,0,1,3,0,4
3774,0,3810,9855;9856,0,0,0,1,1,2
3775,0,3811,9857;9858,0,0,0,1,1,2
3776,0,3812,9859;9860;9861,0,0,0,2,1,3
3777,0,3813,9862;9863,0,0,0,2,0,2
3778,0,3814,9864,0,0,0,1,0,1
3779,0,3815,9865,0,0,0,0,1,1
3780,0,3816,9866;9867;9868,0,0,0,2,1,3
3781,0,3817,9869;9870,0,0,0,2,0,2
3782,0,3818,9872;9873;9874,0,0,1,0,2,3
3783,0,3819,9875,0,0,0,0,1,1
3784,0,3820,9876;9877;9878;9879,0,0,1,3,0,4
3785,0,3821,9880;9881;9882;9883,0,0,1,2,1,4
3786,0,3822,9885;9886;9887;9888,0,2,0,2,0,4
3787,0,3823,9889;9890;9891,0,1,0,1,1,3
3788,0,3824,9892;9893;9894;9895,0,0,0,3,1,4
3789,0,3825,9896;9897;9898,0,0,1,1,1,3
3790,0,3826,9899,0,0,0,1,0,1
3791,0,3827,9900;9901,0,0,0,2,0,2
3792,0,3828,6703;9902,0,0,0,2,0,2
3793,0,3829,9903;9904,0,0,0,2,0,2
3794,0,3830,9905;9906,0,0,0,1,1,2
3795,0,3831,9907,0,0,0,1,0,1
3796,0,3832,9908;9909;9910;9912,0,0,0,3,1,4
3797,0,3833,9913;9914;9915,0,0,0,2,1,3
3798,0,3834,9916,0,0,0,0,1,1
3799,0,3835,9917;9918,0,0,0,2,0,2
3800,0,3836,9920;9921;9922;9923,0,1,0,3,0,4
3801,0,3837,9924;9925;9926;9927,0,1,1,2,0,4
3802,0,3838,9928;9929;9930,0,0,0,2,1,3
3803,0,3839,9931;9932,0,0,0,1,1,2
3804,0,3840,9933,0,0,0,0,1,1
3805,0,3841,9934;9935,0,0,0,1,1,2
3806,0,3842,9936;9937;9938;9939;9940,0,0,1,2,2,5
3807,0,3843,9941;9942,0,0,0,0,2,2
3808,0,3844,9943;9944;9945;9946;9947,0,0,1,4,0,5
3809,0,3845,9948;9949;9950;9951,0,0,1,3,0,4
3810,0,3846,9952,0,0,0,1,0,1
3811,0,3847,1848;9953,0,0,0,2,0,2
3812,0,3848,9954;9955,0,0,0,2,0,2
3813,0,3849,9956;9957,0,0,0,2,0,2
3814,0,3850,9958,0,0,0,1,0,1
3815,0,3852,9960;9961;9962;9963,0,0,1,2,1,4
3816,0,3853,9964;9965,0,0,0,1,1,2
3817,0,3854,9966;9967,0,0,0,1,1,2
3818,0,3855,9968;9969;9971,0,0,0,2,1,3
3819,0,3856,9972;9973;9974;9975;9976,0,1,2,2,0,5
3820,0,3857,9977;9978,0,0,0,1,1,2
3821,0,3858,9979;9980,0,0,0,1,1,2
3822,0,3859,9981;9982,0,0,0,2,0,2
3823,0,3860,9983;9984;9985;9986;9987,0,2,1,2,0,5
3824,0,3861,9988,0,0,0,1,0,1
3825,0,3862,9989;9990;9991,0,0,0,3,0,3
3826,0,3863,9992;9993,0,0,0,2,0,2
3827,0,3864,9994;9995;9996;9997;9998,0,0,0,3,2,5
3828,0,3865,9999;10000;10001;10002,0,0,0,4,0,4
3829,0,3866,69,0,0,0,1,0,1
3830,0,3867,184,0,0,0,1,0,1
3831,0,3868,299;2502;10089,0,1,0,2,0,3
3832,0,3869,423;7849,0,0,0,2,0,2
3833,0,3870,442;7842,0,0,0,2,0,2
3834,0,3871,492;5974,0,0,0,2,0,2
3835,0,3872,549,0,0,0,1,0,1
3836,0,3874,582,0,0,0,1,0,1
3837,0,3875,724,0,0,0,1,0,1
3838,0,3876,766,0,0,0,1,0,1
3839,0,3877,979;2099;10028,0,1,0,2,0,3
3840,0,3878,1272;5825,0,0,0,2,0,2
3841,0,3879,1569;1683;10098,0,1,0,2,0,3
3842,0,3880,1737,0,0,0,1,0,1
3843,0,3881,1826,0,0,0,1,0,1
3844,0,3882,1900,0,0,0,1,0,1
3845,0,3883,1989,0,0,0,1,0,1
3846,0,3884,2135;9309,0,0,0,2,0,2
3847,0,3885,974;2208,0,0,0,2,0,2
3848,0,3886,2258,0,0,0,1,0,1
3849,0,3887,2279,0,0,0,1,0,1
3850,0,3888,2288,0,0,0,1,0,1
3851,0,3889,2346,0,0,0,1,0,1
3852,0,3890,2463;9970,0,0,0,2,0,2
3853,0,3891,1297;2527,0,0,0,2,0,2
3854,0,3892,2562;6259,0,0,0,2,0,2
3855,0,3893,2610,0,0,0,0,1,1
3856,0,3894,2661,0,0,0,1,0,1
3857,0,3895,2717,0,0,0,1,0,1
3858,0,3896,2771;5360,0,0,0,2,0,2
3859,0,3897,2990,0,0,0,1,0,1
3860,0,3898,3034,0,0,0,0,1,1
3861,0,3899,3100;3583,0,0,0,2,0,2
3862,0,3900,3190,0,0,0,1,0,1
3863,0,3901,1740;3192,0,0,0,2,0,2
3864,0,3902,3291;5883,0,0,0,2,0,2
3865,0,3903,3554,0,0,0,1,0,1
3866,0,3904,3865;9431,0,0,0,2,0,2
3867,0,3905,3979,0,0,0,1,0,1
3868,0,3906,2735;4111,0,0,0,2,0,2
3869,0,3907,4191,0,0,0,0,1,1
3870,0,3908,4202,0,0,0,0,1,1
3871,0,3909,4243;4971,0,0,0,2,0,2
3872,0,3910,1907;4563,0,0,0,2,0,2
3873,0,3911,4865;5110,0,0,0,2,0,2
3874,0,3912,4880;9919,0,0,0,2,0,2
3875,0,3913,2864;5058;10060,0,1,0,2,0,3
3876,0,3914,4051;5113,0,0,0,2,0,2
3877,0,3915,5124,0,0,0,1,0,1
3878,0,3916,5208,0,0,0,1,0,1
3879,0,3917,5286;8981,0,0,0,2,0,2
3880,0,3918,525;5305,0,0,0,2,0,2
3881,0,3919,5411;6509,0,0,0,2,0,2
3882,0,3920,3914;5767,0,0,0,2,0,2
3883,0,3921,5972;8543,0,0,0,2,0,2
3884,0,3922,6051,0,0,0,1,0,1
3885,0,3923,6125,0,0,0,1,0,1
3886,0,3924,6514,0,0,0,1,0,1
3887,0,3925,6626,0,0,0,1,0,1
3888,0,3926,6710;9303,0,0,0,2,0,2
3889,0,3927,6757,0,0,0,1,0,1
3890,0,3928,7213,0,0,0,1,0,1
3891,0,3929,7361;7431,0,0,0,2,0,2
3892,0,3930,7542;10102,0,1,0,1,0,2
3893,0,3931,4621;7547,0,0,0,2,0,2
3894,0,3932,7759,0,0,0,1,0,1
3895,0,3933,5764;7843,0,0,0,2,0,2
3896,0,3934,7909,0,0,0,0,1,1
3897,0,3935,7985,0,0,0,1,0,1
3898,0,3936,8062,0,0,0,1,0,1
3899,0,3937,8080,0,0,0,1,0,1
3900,0,3938,7645;8221,0,0,0,2,0,2
3901,0,3939,8262;9159,0,0,0,2,0,2
3902,0,3940,8394,0,0,0,1,0,1
3903,0,3941,6221;8489,0,0,0,2,0,2
3904,0,3942,8678,0,0,0,1,0,1
3905,0,3943,1490;8936,0,0,0,2,0,2
3906,0,3944,8999,0,0,0,1,0,1
3907,0,3945,9136,0,0,0,1,0,1
3908,0,3946,4188;9169,0,0,1,1,0,2
3909,0,3947,9367,0,0,0,1,0,1
3910,0,3948,9398,0,0,0,1,0,1
3911,0,3949,6311;9449,0,0,0,2,0,2
3912,0,3950,9522,0,0,0,1,0,1
3913,0,3951,9704,0,0,0,1,0,1
3914,0,3952,9828,0,0,0,1,0,1
3915,0,3953,2206;9871,0,0,0,2,0,2
3916,0,3954,9911,0,0,0,1,0,1
3917,10,0,1;2,0,0,0,1,1,2
3918,10,1,4,0,0,0,1,0,1
3919,10,2,9;11;13,0,0,0,2,1,3
3920,10,3,14;15,0,0,0,2,0,2
3921,10,4,16;18,0,0,1,0,1,2
3922,10,6,20;21,0,0,0,1,1,2
3923,10,7,23,0,0,0,0,1,1
3924,10,8,25;26,0,0,0,2,0,2
3925,10,9,27;29;6088,0,0,2,0,1,3
3926,10,10,30,0,0,0,0,1,1
3927,10,11,31,0,0,0,0,1,1
3928,10,12,33;34;36,0,0,0,1,2,3
3929,10,13,39;2497;10845,0,1,0,2,0,3
3930,10,14,41;43;44;4063,0,0,1,3,0,4
3931,10,15,46;47;48;49;50,0,0,1,3,1,5
3932,10,17,53;54;56;57;7425,0,0,2,3,0,5
3933,10,18,58;4413,0,0,0,2,0,2
3934,10,19,59;60;61,0,0,1,0,2,3
3935,10,20,62;63;431;10076;10129;10268;10809;11039,0,2,4,2,0,8
3936,10,21,66;67,0,0,0,1,1,2
3937,10,22,70;8079;10505,0,0,1,2,0,3
3938,10,23,72;73;74,0,0,0,3,0,3
3939,10,24,77,0,0,0,0,1,1
3940,10,25,78;79;80;81;9208,0,0,2,3,0,5
3941,10,26,82;83,0,0,0,0,2,2
3942,10,27,85;86;87,0,0,1,1,1,3
3943,10,28,88;89;90,0,0,1,1,1,3
3944,10,29,91;92;93;94;10197;10314,0,0,4,2,0,6
3945,10,31,96;97,0,0,0,2,0,2
3946,10,33,99;100,0,0,0,2,0,2
3947,10,34,101;103,0,0,0,0,2,2
3948,10,35,104;105;107;9940,0,0,1,1,2,4
3949,10,36,108;109;111;113,0,0,1,3,0,4
3950,10,37,114;115,0,0,0,1,1,2
3951,10,38,117;118;119;120,0,0,1,3,0,4
3952,10,39,121;122;123,0,0,0,1,2,3
3953,10,40,124;125,0,0,0,1,1,2
3954,10,42,129,0,0,0,0,1,1
3955,10,43,131;132,0,0,0,2,0,2
3956,10,44,133;134;135;136,0,0,2,2,0,4
3957,10,45,137;8867;10443,0,0,1,2,0,3
3958,10,46,138,0,0,0,0,1,1
3959,10,47,140,0,0,0,0,1,1
3960,10,49,142;144;145,0,0,0,0,3,3
3961,10,50,149,0,0,0,0,1,1
3962,10,51,150,0,0,0,1,0,1
3963,10,52,151;7297,0,0,0,2,0,2
3964,10,53,154;7900,0,0,0,2,0,2
3965,10,54,156;157;159;160,0,0,1,2,1,4
3966,10,55,162;163;2306;10388;10503,0,0,3,2,0,5
3967,10,56,164;10300;10931,0,1,1,1,0,3
3968,10,57,165;166,0,0,0,2,0,2
3969,10,58,167;168;169;170,0,0,2,0,2,4
3970,10,59,171;172,0,0,0,2,0,2
3971,10,60,173;174;175,0,0,1,1,1,3
3972,10,61,176;178;179;180;182;3003,0,0,2,4,0,6
3973,10,62,185;186,0,0,0,0,2,2
3974,10,63,187;189,0,0,0,1,1,2
3975,10,64,190;192,0,0,0,2,0,2
3976,10,65,193;194,0,0,0,2,0,2
3977,10,67,198;2635,0,0,0,2,0,2
3978,10,68,202;204;205;7484,0,0,0,4,0,4
3979,10,69,206;207,0,0,0,2,0,2
3980,10,70,208,0,0,0,0,1,1
3981,10,71,210;10207;10255,0,0,2,1,0,3
3982,10,73,214;215;216;217;218;219,0,0,2,4,0,6
3983,10,74,221;1463,0,0,0,2,0,2
3984,10,76,225,0,0,0,0,1,1
3985,10,77,226;227;228,0,0,1,2,0,3
3986,10,78,229;230,0,0,0,2,0,2
3987,10,79,234;235,0,0,0,1,1,2
3988,10,80,238;240,0,0,0,1,1,2
3989,10,81,241;242,0,0,0,1,1,2
3990,10,83,245;246;247,0,0,0,2,1,3
3991,10,84,248;249;250;10054;10194;10240,0,0,3,3,0,6
3992,10,85,251;252,0,0,0,0,2,2
3993,10,86,253;5298,0,0,0,2,0,2
3994,10,87,255;1816,0,0,0,2,0,2
3995,10,88,256;257,0,0,0,0,2,2
3996,10,90,260;261,0,0,0,2,0,2
3997,10,91,263,0,0,0,0,1,1
3998,10,92,264,0,0,0,1,0,1
3999,10,93,265;267;268,0,0,1,1,1,3
4000,10,94,269;270,0,0,0,1,1,2
4001,10,95,273;274,0,0,0,0,2,2
4002,10,96,275;276;277,0,0,1,1,1,3
4003,10,98,280,0,0,0,1,0,1
4004,10,99,281;283,0,0,0,0,2,2
4005,10,100,284;285,0,0,0,2,0,2
4006,10,101,287,0,0,0,0,1,1
4007,10,103,290;291;294,0,0,1,0,2,3
4008,10,104,295;8027,0,0,0,2,0,2
4009,10,105,297,0,0,0,0,1,1
4010,10,106,298;300,0,0,0,1,1,2
4011,10,107,301;302,0,0,0,2,0,2
4012,10,109,306;605,0,0,0,1,1,2
4013,10,110,311,0,0,0,0,1,1
4014,10,111,312;314;315,0,0,0,1,2,3
4015,10,112,317;318;319;320,0,0,2,1,1,4
4016,10,113,321;322;10745;10821,0,2,0,2,0,4
4017,10,114,323,0,0,0,0,1,1
4018,10,115,325,0,0,0,0,1,1
4019,10,116,327,0,0,0,1,0,1
4020,10,117,328,0,0,0,0,1,1
4021,10,118,331;332;333;334,0,0,1,3,0,4
4022,10,119,336;337,0,0,0,1,1,2
4023,10,120,338,0,0,0,0,1,1
4024,10,121,339;340,0,0,0,0,2,2
4025,10,122,341;342,0,0,0,0,2,2
4026,10,123,343;8818,0,0,0,0,2,2
4027,10,124,344,0,0,0,1,0,1
4028,10,125,346;347;349,0,0,0,2,1,3
4029,10,126,351,0,0,0,0,1,1
4030,10,127,352,0,0,0,1,0,1
4031,10,128,354;7852,0,0,0,2,0,2
4032,10,129,358;359,0,0,0,2,0,2
4033,10,130,362;582,0,0,0,2,0,2
4034,10,131,364;7435,0,0,0,2,0,2
4035,10,132,310;366;367,0,0,1,2,0,3
4036,10,133,369,0,0,0,0,1,1
4037,10,134,372;10110;10262,0,0,2,1,0,3
4038,10,135,373,0,0,0,0,1,1
4039,10,136,374;375;377;378;379,0,0,2,1,2,5
4040,10,138,382;383;2108;10440,0,0,2,2,0,4
4041,10,139,384;385;386;10251;10764,0,1,2,2,0,5
4042,10,141,388;389;390,0,0,0,2,1,3
4043,10,142,391;392,0,0,0,1,1,2
4044,10,143,394;4885,0,0,0,2,0,2
4045,10,144,396;10681,0,1,0,1,0,2
4046,10,145,398;399,0,0,0,1,1,2
4047,10,146,400,0,0,0,0,1,1
4048,10,148,402;403;405,0,0,1,0,2,3
4049,10,150,407;408,0,0,0,0,2,2
4050,10,151,411,0,0,0,1,0,1
4051,10,152,412;413;5926,0,0,0,3,0,3
4052,10,154,416;4608,0,0,0,2,0,2
4053,10,155,5583,0,0,0,0,1,1
4054,10,156,418;420;421,0,0,1,1,1,3
4055,10,157,422;424,0,0,0,0,2,2
4056,10,158,425;426,0,0,0,1,1,2
4057,10,159,427;428,0,0,0,2,0,2
4058,10,161,432;433,0,0,0,0,2,2
4059,10,162,435;8578;10527;10609,0,0,2,2,0,4
4060,10,163,438;440;1219,0,0,0,3,0,3
4061,10,164,441;443,0,0,0,0,2,2
4062,10,165,446;447;448;506,0,0,2,2,0,4
4063,10,166,449;450,0,0,0,1,1,2
4064,10,167,451;452;10384;10957,0,1,1,1,1,4
4065,10,168,453;454,0,0,0,2,0,2
4066,10,169,456;457;460;461,0,0,1,2,1,4
4067,10,170,462;463,0,0,0,1,1,2
4068,10,171,464;465;466,0,0,0,1,2,3
4069,10,172,468,0,0,0,0,1,1
4070,10,173,470,0,0,0,1,0,1
4071,10,174,471;472,0,0,0,0,2,2
4072,10,175,473;474;476;477,0,0,2,0,2,4
4073,10,176,478;479;480;1390,0,0,1,1,2,4
4074,10,177,481;482,0,0,0,0,2,2
4075,10,178,483;484;485;490,0,0,0,2,2,4
4076,10,179,491;493;494,0,0,2,1,0,3
4077,10,180,495,0,0,0,0,1,1
4078,10,181,496;497,0,0,0,2,0,2
4079,10,182,498;499,0,0,0,1,1,2
4080,10,183,500;10490;11116,0,1,1,1,0,3
4081,10,184,502;10408;10489,0,0,2,1,0,3
4082,10,185,505;3198,0,0,0,2,0,2
4083,10,187,508,0,0,0,0,1,1
4084,10,188,510;511;512;8871,0,0,1,3,0,4
4085,10,189,515,0,0,0,1,0,1
4086,10,190,518;519,0,0,0,1,1,2
4087,10,191,522;524,0,0,0,2,0,2
4088,10,193,529;530,0,0,0,0,2,2
4089,10,195,532;4638,0,0,0,2,0,2
4090,10,197,535;537;10065,0,0,1,2,0,3
4091,10,198,538;539,0,0,0,0,2,2
4092,10,199,540;541,0,0,0,2,0,2
4093,10,200,543;544;545;546,0,0,2,0,2,4
4094,10,201,548;550,0,0,0,2,0,2
4095,10,202,551,0,0,0,0,1,1
4096,10,203,554,0,0,0,1,0,1
4097,10,205,559;561;562,0,0,1,1,1,3
4098,10,206,564,0,0,0,0,1,1
4099,10,207,566;567,0,0,0,0,2,2
4100,10,208,1915,0,0,0,1,0,1
4101,10,209,570;571,0,0,0,1,1,2
4102,10,210,573;574,0,0,1,1,0,2
4103,10,211,575;8570,0,0,0,1,1,2
4104,10,212,576,0,0,0,1,0,1
4105,10,213,577,0,0,0,0,1,1
4106,10,216,581;584;10031;10365,0,0,2,2,0,4
4107,10,217,585,0,0,0,1,0,1
4108,10,218,589;590,0,0,0,2,0,2
4109,10,219,591;5590;6850;6852,0,0,0,3,1,4
4110,10,220,595;596,0,0,0,2,0,2
4111,10,222,600,0,0,0,0,1,1
4112,10,223,601;602;604,0,0,1,0,2,3
4113,10,226,609,0,0,0,1,0,1
4114,10,227,610;611;612;613,0,0,2,1,1,4
4115,10,228,614;615;616,0,0,0,2,1,3
4116,10,229,619,0,0,0,0,1,1
4117,10,230,620,0,0,0,1,0,1
4118,10,231,621;622;10113;10333,0,0,2,1,1,4
4119,10,233,624;625;626,0,0,0,2,1,3
4120,10,234,627,0,0,0,0,1,1
4121,10,235,629;631;632;5974;10947;11101,0,2,2,2,0,6
4122,10,237,635,0,0,0,0,1,1
4123,10,238,637;638;639,0,0,0,1,2,3
4124,10,239,387;641,0,0,0,2,0,2
4125,10,240,644;9790;10399;10515,0,0,2,2,0,4
4126,10,241,646;647;648,0,0,1,0,2,3
4127,10,242,649,0,0,0,0,1,1
4128,10,243,650;651;652;653;1239,0,0,2,2,1,5
4129,10,245,657,0,0,0,1,0,1
4130,10,246,658;8522,0,0,0,2,0,2
4131,10,247,659;660,0,0,0,1,1,2
4132,10,249,663;665,0,0,1,0,1,2
4133,10,250,666;667,0,0,0,2,0,2
4134,10,251,668,0,0,0,1,0,1
4135,10,252,9260,0,0,0,1,0,1
4136,10,253,671;673;674;10190,0,0,1,2,1,4
4137,10,254,542;676;10075,0,0,1,2,0,3
4138,10,255,678;679;680;3234,0,0,0,3,1,4
4139,10,256,682;683,0,0,0,2,0,2
4140,10,257,688;5671;10062,0,0,1,2,0,3
4141,10,258,689;2502;10907;11146,0,2,0,2,0,4
4142,10,261,693,0,0,0,0,1,1
4143,10,262,694;695,0,0,0,2,0,2
4144,10,264,697;698,0,0,0,2,0,2
4145,10,265,699,0,0,0,1,0,1
4146,10,266,703;705,0,0,0,1,1,2
4147,10,267,707,0,0,0,1,0,1
4148,10,269,709,0,0,0,1,0,1
4149,10,270,713,0,0,0,1,0,1
4150,10,271,715;9662,0,0,0,2,0,2
4151,10,272,717,0,0,0,0,1,1
4152,10,273,718;719,0,0,0,1,1,2
4153,10,274,722;723;10788,0,1,0,2,0,3
4154,10,275,725;727,0,0,0,0,2,2
4155,10,276,729;731,0,0,0,1,1,2
4156,10,277,733;734,0,0,0,1,1,2
4157,10,278,737,0,0,0,1,0,1
4158,10,279,738;6343;6344;10326;10659,0,1,1,3,0,5
4159,10,280,739;740,0,0,1,0,1,2
4160,10,281,742,0,0,0,0,1,1
4161,10,282,743,0,0,0,0,1,1
4162,10,283,744;745;10071;10145;10417,0,0,3,1,1,5
4163,10,284,746;747,0,0,0,1,1,2
4164,10,285,748,0,0,0,0,1,1
4165,10,286,750;753,0,0,0,2,0,2
4166,10,288,755;756;10447;10623,0,0,2,1,1,4
4167,10,289,757;758,0,0,0,1,1,2
4168,10,291,760;6147;10538;10978;11015,0,2,1,2,0,5
4169,10,292,761;762,0,0,0,2,0,2
4170,10,293,763;6539;11091;11134,0,2,0,2,0,4
4171,10,294,764;765,0,0,1,1,0,2
4172,10,297,772;774,0,0,1,0,1,2
4173,10,298,775;776,0,0,0,0,2,2
4174,10,299,780;781,0,0,0,0,2,2
4175,10,300,782;783,0,0,0,1,1,2
4176,10,301,784;786;787,0,0,1,1,1,3
4177,10,302,788,0,0,0,0,1,1
4178,10,303,789;1983,0,0,0,2,0,2
4179,10,304,791;792;793;9920;9922;9923,0,0,1,3,2,6
4180,10,305,796;798,0,0,0,2,0,2
4181,10,306,799;800;801;802;803;804;10048;10476;11001,0,1,4,4,0,9
4182,10,307,224;805;10289,0,0,1,2,0,3
4183,10,308,806;807,0,0,0,2,0,2
4184,10,309,808;809;810,0,0,0,2,1,3
4185,10,310,812;813,0,0,0,2,0,2
4186,10,311,814;815,0,0,0,2,0,2
4187,10,313,817;818;7086,0,0,0,3,0,3
4188,10,314,820;4275,0,0,0,2,0,2
4189,10,315,821;822,0,0,0,1,1,2
4190,10,316,823,0,0,0,0,1,1
4191,10,317,826;829,0,0,0,1,1,2
4192,10,318,830;831,0,0,0,1,1,2
4193,10,319,832;833,0,0,0,1,1,2
4194,10,321,835;836;837;838;839,0,0,1,3,1,5
4195,10,322,840;841,0,0,0,1,1,2
4196,10,323,842,0,0,0,0,1,1
4197,10,324,845;846;847,0,0,0,1,2,3
4198,10,325,849,0,0,0,0,1,1
4199,10,326,852;853,0,0,0,1,1,2
4200,10,327,854;855;10297;10499;10889,0,1,2,1,1,5
4201,10,328,856,0,0,0,0,1,1
4202,10,329,857,0,0,0,0,1,1
4203,10,330,861;862;865,0,0,1,1,1,3
4204,10,331,866;867,0,0,0,2,0,2
4205,10,332,868;869;10807,0,1,0,2,0,3
4206,10,333,872;874,0,0,0,1,1,2
4207,10,334,876;878,0,0,1,1,0,2
4208,10,335,879;880,0,0,0,1,1,2
4209,10,336,882;2802,0,0,0,2,0,2
4210,10,337,884,0,0,0,1,0,1
4211,10,338,885;886,0,0,0,1,1,2
4212,10,339,889;890;891,0,0,0,2,1,3
4213,10,340,893;894;896,0,0,0,3,0,3
4214,10,341,897;898,0,0,0,1,1,2
4215,10,342,899;900;901;902,0,0,0,1,3,4
4216,10,343,904;905,0,0,0,1,1,2
4217,10,344,906;907;909,0,0,1,1,1,3
4218,10,346,911,0,0,0,0,1,1
4219,10,347,912;913,0,0,0,0,2,2
4220,10,348,914,0,0,0,1,0,1
4221,10,349,916,0,0,0,1,0,1
4222,10,350,919;920;921,0,0,0,2,1,3
4223,10,351,922;923,0,0,0,1,1,2
4224,10,352,924;925,0,0,0,2,0,2
4225,10,353,927;928;929,0,0,0,1,2,3
4226,10,354,930;932;7734,0,0,0,3,0,3
4227,10,355,935,0,0,0,0,1,1
4228,10,357,939;940,0,0,0,2,0,2
4229,10,358,942;943;944;945;8812,0,0,0,5,0,5
4230,10,359,946,0,0,0,0,1,1
4231,10,360,947,0,0,0,0,1,1
4232,10,361,949;953;10109;11198,0,1,2,1,0,4
4233,10,362,955,0,0,0,1,0,1
4234,10,363,956;959;960,0,0,1,1,1,3
4235,10,364,961;962,0,0,0,1,1,2
4236,10,365,965;966;10517;10590,0,0,2,1,1,4
4237,10,366,968,0,0,0,0,1,1
4238,10,367,969;970;976;978,0,0,0,1,3,4
4239,10,368,981;982,0,0,1,0,1,2
4240,10,369,984;985;987;988;3974;3976;3977,0,0,1,6,0,7
4241,10,370,989;990,0,0,0,1,1,2
4242,10,372,992;993,0,0,0,1,1,2
4243,10,373,994;995,0,0,0,1,1,2
4244,10,374,996,0,0,0,0,1,1
4245,10,375,997;998,0,0,0,0,2,2
4246,10,376,1000;1001;5972;10209;10966;11103,0,2,1,3,0,6
4247,10,377,1002;1003,0,0,0,0,2,2
4248,10,378,1004;1005,0,0,0,1,1,2
4249,10,379,1007;1008;1010,0,0,0,2,1,3
4250,10,380,1011,0,0,0,0,1,1
4251,10,381,1012;1013,0,0,0,2,0,2
4252,10,382,1014;6783;10946,0,1,0,2,0,3
4253,10,383,1017,0,0,0,0,1,1
4254,10,384,1019;10169;10273,0,0,2,1,0,3
4255,10,385,1020;1021,0,0,0,2,0,2
4256,10,386,1022,0,0,0,0,1,1
4257,10,387,1023;1024;1025;1026;1027,0,0,1,3,1,5
4258,10,388,1028;1029,0,0,0,1,1,2
4259,10,389,1033;1035,0,0,1,1,0,2
4260,10,391,1037;1038,0,0,0,0,2,2
4261,10,392,1039;6796,0,0,0,2,0,2
4262,10,393,1041;1043;1044;1045,0,0,2,0,2,4
4263,10,394,1046;4536,0,0,0,2,0,2
4264,10,395,1047;1048;1049;1050;1051,0,0,3,1,1,5
4265,10,396,1052;1056,0,0,0,1,1,2
4266,10,397,1057,0,0,0,0,1,1
4267,10,398,963;1058,0,0,0,2,0,2
4268,10,399,1060,0,0,0,1,0,1
4269,10,400,1062;1063;1064;1065,0,0,0,4,0,4
4270,10,401,1066,0,0,0,0,1,1
4271,10,402,1068,0,0,0,1,0,1
4272,10,403,1069,0,0,0,1,0,1
4273,10,404,1072;1073,0,0,0,0,2,2
4274,10,405,1075;3452,0,0,0,2,0,2
4275,10,406,1076;1077,0,0,0,2,0,2
4276,10,407,1078,0,0,0,1,0,1
4277,10,409,1080;1081,0,0,0,0,2,2
4278,10,410,1082;10015;10339;11033,0,1,2,1,0,4
4279,10,411,1083;1084;8505;10325;10532,0,0,2,3,0,5
4280,10,412,1085;1086,0,0,0,2,0,2
4281,10,413,1087,0,0,0,0,1,1
4282,10,414,1088;1089,0,0,0,2,0,2
4283,10,415,1090;1092;1093,0,0,2,1,0,3
4284,10,416,1094;1096,0,0,0,2,0,2
4285,10,417,1098;1100,0,0,0,2,0,2
4286,10,418,1101;1102;10179;11069,0,1,1,2,0,4
4287,10,420,1105;1106;1107;10793,0,1,1,2,0,4
4288,10,421,1108;8308,0,0,0,2,0,2
4289,10,423,1111;1112,0,0,0,2,0,2
4290,10,424,1113;1114;1115,0,0,0,2,1,3
4291,10,425,1117,0,0,0,1,0,1
4292,10,426,1110;1118,0,0,0,2,0,2
4293,10,427,1119;1120;1121,0,0,0,0,3,3
4294,10,428,1124;1125,0,0,0,1,1,2
4295,10,429,1126;1127;1128,0,0,0,0,3,3
4296,10,430,243;1129;10530;10861,0,1,1,2,0,4
4297,10,431,1131;3646,0,0,0,2,0,2
4298,10,432,1132;1134;2526,0,0,0,3,0,3
4299,10,433,1135;1136;1865,0,0,0,3,0,3
4300,10,434,1137;1138;1139;1141,0,0,0,3,1,4
4301,10,435,1142;1144,0,0,1,1,0,2
4302,10,436,1145;1146;1147;1148,0,0,0,3,1,4
4303,10,437,1149;1152,0,0,1,0,1,2
4304,10,438,1153,0,0,0,1,0,1
4305,10,439,1155;1156;1157;1158,0,0,1,2,1,4
4306,10,440,1159;1160;1161;1162;1163;1164,0,0,1,3,2,6
4307,10,441,1165;1168;1169,0,0,0,2,1,3
4308,10,445,1175;1176,0,0,0,2,0,2
4309,10,446,1177,0,0,0,0,1,1
4310,10,447,1178,0,0,0,1,0,1
4311,10,448,1180;1181,0,0,0,1,1,2
4312,10,449,759;1182,0,0,0,2,0,2
4313,10,451,1185;1186,0,0,0,2,0,2
4314,10,453,1189;1190;1191;1192;10445;10792,0,1,3,1,1,6
4315,10,454,1193,0,0,0,0,1,1
4316,10,455,1194;1196,0,0,0,1,1,2
4317,10,456,1198;3831;10878;10903;11059,0,3,0,2,0,5
4318,10,457,1200;1201,0,0,0,1,1,2
4319,10,458,1202,0,0,0,1,0,1
4320,10,459,1204;6775,0,0,0,2,0,2
4321,10,460,1206;1208,0,0,0,0,2,2
4322,10,462,1214;1215,0,0,0,1,1,2
4323,10,464,1220;1221,0,0,0,1,1,2
4324,10,465,1222,0,0,0,0,1,1
4325,10,466,1223,0,0,0,1,0,1
4326,10,467,1225;1226,0,0,0,0,2,2
4327,10,468,1228;1231,0,0,1,1,0,2
4328,10,469,1232,0,0,0,0,1,1
4329,10,470,1233;1234;1236,0,0,0,2,1,3
4330,10,472,1240;1241;1242,0,0,1,1,1,3
4331,10,473,1244;1245,0,0,0,0,2,2
4332,10,474,1248;1250;1251;1252;9623;10797,0,1,0,5,0,6
4333,10,475,1253,0,0,0,0,1,1
4334,10,476,1255,0,0,0,1,0,1
4335,10,477,1257;1258;1259,0,0,0,1,2,3
4336,10,478,1260,0,0,1,0,0,1
4337,10,479,1261;1262;1263,0,0,0,2,1,3
4338,10,480,1264;1265;1266;1267,0,0,2,1,1,4
4339,10,481,1268;1270;5202,0,0,0,2,1,3
4340,10,482,1271;1273,0,0,0,1,1,2
4341,10,483,1275;1276,0,0,0,2,0,2
4342,10,484,1277;1278,0,0,0,2,0,2
4343,10,485,1279;1280,0,0,0,0,2,2
4344,10,486,1281,0,0,0,0,1,1
4345,10,487,1283;1284;8781,0,0,1,2,0,3
4346,10,488,1285;1288;9429;10986;11169,0,2,0,3,0,5
4347,10,489,1289,0,0,0,0,1,1
4348,10,490,1290;1291,0,0,0,1,1,2
4349,10,491,1294;1296,0,0,0,1,1,2
4350,10,492,1299;1300;1301,0,0,0,1,2,3
4351,10,493,1302;1303;1305,0,0,1,1,1,3
4352,10,494,528;1306;1307;1308;1584,0,0,2,3,0,5
4353,10,495,1309;1310,0,0,0,1,1,2
4354,10,496,1311;1313;1314,0,0,0,2,1,3
4355,10,497,1315;1316;6904,0,0,0,3,0,3
4356,10,498,1319;1320;1321,0,0,0,2,1,3
4357,10,499,1322,0,0,0,0,1,1
4358,10,500,1323;1324;10951,0,1,0,2,0,3
4359,10,501,1325;1326,0,0,0,0,2,2
4360,10,502,1327;1328,0,0,0,2,0,2
4361,10,503,1329;6543,0,0,0,2,0,2
4362,10,504,768;1330;1334,0,0,1,2,0,3
4363,10,505,1335;6079,0,0,0,1,1,2
4364,10,507,1338;1339,0,0,0,2,0,2
4365,10,508,1340;1341,0,0,0,1,1,2
4366,10,509,1342;1344;1345,0,0,1,1,1,3
4367,10,510,1347;1348,0,0,0,0,2,2
4368,10,512,1354;1355,0,0,0,0,2,2
4369,10,513,1357,0,0,0,1,0,1
4370,10,514,1361;1362;1364,0,0,1,1,1,3
4371,10,516,1366,0,0,0,1,0,1
4372,10,517,1369;1370;1371,0,0,0,2,1,3
4373,10,518,1373;9207;10081;10464,0,0,2,2,0,4
4374,10,519,1375;1376,0,0,0,2,0,2
4375,10,521,1378;1379,0,0,0,0,2,2
4376,10,522,1381;1382,0,0,1,0,1,2
4377,10,523,1383,0,0,0,1,0,1
4378,10,524,1384;1388,0,0,1,1,0,2
4379,10,525,1389,0,0,0,0,1,1
4380,10,528,1392;1393,0,0,0,1,1,2
4381,10,529,1396,0,0,0,0,1,1
4382,10,530,1397;1398,0,0,0,0,2,2
4383,10,531,1400,0,0,0,1,0,1
4384,10,534,1405;1406;10086;10308;10380,0,0,3,1,1,5
4385,10,535,1407;1408,0,0,0,2,0,2
4386,10,536,1409;1410,0,0,0,0,2,2
4387,10,537,1412,0,0,0,1,0,1
4388,10,538,1413,0,0,0,0,1,1
4389,10,539,1419;1421,0,0,0,0,2,2
4390,10,540,1422;1423,0,0,0,2,0,2
4391,10,541,1425;1427;1428,0,0,1,1,1,3
4392,10,542,1429;1430;1432,0,0,1,0,2,3
4393,10,543,1433,0,0,0,1,0,1
4394,10,544,1434,0,0,0,0,1,1
4395,10,545,1435;1436,0,0,0,2,0,2
4396,10,546,1437;1438,0,0,0,1,1,2
4397,10,547,1439;1440,0,0,0,2,0,2
4398,10,548,1441,0,0,0,1,0,1
4399,10,549,1442,0,0,0,1,0,1
4400,10,550,1444;7505,0,0,0,2,0,2
4401,10,551,1445;1446,0,0,0,1,1,2
4402,10,552,1448;1450;1451;1452,0,0,3,0,1,4
4403,10,553,1453;7690,0,0,0,2,0,2
4404,10,554,1454;1455,0,0,0,0,2,2
4405,10,555,1456;1457;10645,0,1,0,1,1,3
4406,10,556,1459;1460;1461;10343;11135,0,1,2,2,0,5
4407,10,559,1465;1466;1467;1468,0,0,2,1,1,4
4408,10,560,1469;1470;1471;1472;10185;10307;11092,0,1,3,2,1,7
4409,10,561,1473;5771;10918,0,1,0,2,0,3
4410,10,562,1475;1476;1477;1478;10593,0,0,1,3,1,5
4411,10,563,1480,0,0,0,1,0,1
4412,10,564,1481;1482,0,0,0,0,2,2
4413,10,565,1483;1485;1486;3685;10058;10313,0,0,2,4,0,6
4414,10,566,1487;1488,0,0,0,2,0,2
4415,10,567,1491;1492;1493,0,0,1,1,1,3
4416,10,568,1494;1495;1496,0,0,0,3,0,3
4417,10,569,1497;1498;1500,0,0,0,2,1,3
4418,10,570,1501,0,0,0,0,1,1
4419,10,571,1502;10258;10742,0,1,1,1,0,3
4420,10,572,1504,0,0,0,0,1,1
4421,10,573,1506;10302;10611,0,0,2,1,0,3
4422,10,574,1507;2743,0,0,0,2,0,2
4423,10,575,1510;1511,0,0,0,0,2,2
4424,10,576,1514;1515,0,0,0,2,0,2
4425,10,577,1516,0,0,0,1,0,1
4426,10,578,1518;1519,0,0,0,1,1,2
4427,10,579,1520;1521;1522,0,0,0,3,0,3
4428,10,580,1523,0,0,0,0,1,1
4429,10,581,1527,0,0,0,0,1,1
4430,10,582,517;1529,0,0,0,2,0,2
4431,10,583,1530;1531,0,0,0,1,1,2
4432,10,584,1533;1534;1537;1538,0,0,1,3,0,4
4433,10,585,1540;1541;1542,0,0,0,2,1,3
4434,10,587,1546;1547;10318,0,0,1,2,0,3
4435,10,588,1549;10909,0,1,0,1,0,2
4436,10,589,1550;1551,0,0,0,0,2,2
4437,10,590,1553;10064;10272;10522,0,0,3,1,0,4
4438,10,591,1555;1670,0,0,1,1,0,2
4439,10,592,1557;1558;10469;10836,0,1,1,1,1,4
4440,10,593,1559;1560,0,0,0,2,0,2
4441,10,594,1562;1564;1565,0,0,2,1,0,3
4442,10,595,1566;1567,0,0,0,1,1,2
4443,10,596,1570;1571,0,0,0,1,1,2
4444,10,597,1573;1575,0,0,0,2,0,2
4445,10,598,1576;1577,0,0,1,0,1,2
4446,10,600,1579,0,0,0,1,0,1
4447,10,601,1581,0,0,0,0,1,1
4448,10,603,1585;1586;1587,0,0,0,1,2,3
4449,10,604,1591;1592,0,0,0,1,1,2
4450,10,605,1593;1594,0,0,0,2,0,2
4451,10,606,1595,0,0,0,1,0,1
4452,10,607,8801;10467;10620;11118,0,1,2,1,0,4
4453,10,608,1597,0,0,0,1,0,1
4454,10,609,1600,0,0,0,0,1,1
4455,10,610,1602;1604,0,0,1,0,1,2
4456,10,611,1605;1606,0,0,0,2,0,2
4457,10,612,1607;1608;1609;7132,0,0,0,3,1,4
4458,10,614,1614;1616;1618;1619,0,0,2,1,1,4
4459,10,615,1620;1621;1622;1623,0,0,2,1,1,4
4460,10,617,1626,0,0,0,0,1,1
4461,10,618,1628;1629;1630;10234;10557,0,0,2,3,0,5
4462,10,619,1631;1632;10228;10654;11143,0,2,1,2,0,5
4463,10,620,1633,0,0,0,1,0,1
4464,10,621,1635;1636;1637,0,0,0,2,1,3
4465,10,622,1638;1639;1640,0,0,0,2,1,3
4466,10,623,1641;1642,0,0,0,1,1,2
4467,10,624,1643,0,0,0,1,0,1
4468,10,625,1646;1649,0,0,0,1,1,2
4469,10,626,1650;1651;1652;1653,0,0,0,2,2,4
4470,10,627,1656;1657,0,0,0,1,1,2
4471,10,628,3312;6256,0,0,0,2,0,2
4472,10,629,1659,0,0,0,1,0,1
4473,10,630,1660;1957,0,0,0,0,2,2
4474,10,632,1664;1666;1667;1668;9901,0,0,2,3,0,5
4475,10,635,1675,0,0,0,0,1,1
4476,10,637,1677,0,0,0,1,0,1
4477,10,638,1681;1682;2662,0,0,1,2,0,3
4478,10,639,1684,0,0,0,1,0,1
4479,10,640,1687;1689,0,0,0,1,1,2
4480,10,641,1690;1691;1693;1694,0,0,0,3,1,4
4481,10,642,1697;1698;1699;1700;5742,0,0,3,2,0,5
4482,10,643,1701;1702,0,0,0,1,1,2
4483,10,644,1704;1705;1706;1707,0,0,0,4,0,4
4484,10,645,1708,0,0,0,1,0,1
4485,10,646,1710,0,0,0,1,0,1
4486,10,647,1712;1714,0,0,0,1,1,2
4487,10,648,1715;1776,0,0,0,2,0,2
4488,10,649,1716;1717;1720;1721,0,0,2,1,1,4
4489,10,650,1722;1723,0,0,0,1,1,2
4490,10,651,1724;1726;1727,0,0,2,0,1,3
4491,10,653,1733;1734,0,0,0,1,1,2
4492,10,654,1735;2465,0,0,0,2,0,2
4493,10,655,1738;1739,0,0,0,1,1,2
4494,10,656,1742;1743,0,0,0,2,0,2
4495,10,657,292;1744;1746;1747,0,0,1,1,2,4
4496,10,658,1748;1749;1750;1751,0,0,0,4,0,4
4497,10,660,1754;9192;10121,0,0,1,2,0,3
4498,10,661,1755;1756,0,0,0,1,1,2
4499,10,662,1757;1758,0,0,0,1,1,2
4500,10,663,1760,0,0,0,1,0,1
4501,10,664,1761;1762,0,0,0,0,2,2
4502,10,665,1763;1764,0,0,0,1,1,2
4503,10,666,1765;1766,0,0,0,1,1,2
4504,10,667,1767;1768;1770;1771,0,0,0,2,2,4
4505,10,668,1772;1773;1775,0,0,0,1,2,3
4506,10,669,1778,0,0,0,0,1,1
4507,10,670,1779;1780,0,0,0,1,1,2
4508,10,671,1781;1782,0,0,0,2,0,2
4509,10,672,1785;1786;1787;1789,0,0,0,4,0,4
4510,10,674,1791,0,0,0,0,1,1
4511,10,675,1793,0,0,0,0,1,1
4512,10,676,1794,0,0,0,0,1,1
4513,10,677,1795;1796;1797,0,0,1,1,1,3
4514,10,678,1799,0,0,0,0,1,1
4515,10,679,1800;1802;1803,0,0,1,0,2,3
4516,10,680,1804;1805,0,0,0,2,0,2
4517,10,682,1809;1810,0,0,0,2,0,2
4518,10,683,1811,0,0,0,0,1,1
4519,10,684,1812;1813;10442;10556;11214,0,1,2,2,0,5
4520,10,685,1815,0,0,0,0,1,1
4521,10,687,1817;1818;1819,0,0,0,1,2,3
4522,10,688,1822;1823,0,0,0,0,2,2
4523,10,689,1825,0,0,0,0,1,1
4524,10,690,1827,0,0,0,1,0,1
4525,10,691,1828,0,0,0,1,0,1
4526,10,692,1829;1830;10041;10147,0,0,2,2,0,4
4527,10,693,1831,0,0,0,1,0,1
4528,10,695,1837;4352,0,0,1,1,0,2
4529,10,696,1838;1839;1840,0,0,1,1,1,3
4530,10,698,1843;4648,0,0,0,2,0,2
4531,10,699,1844;1845;1847,0,0,0,1,2,3
4532,10,700,1851,0,0,0,0,1,1
4533,10,701,1852,0,0,0,0,1,1
4534,10,702,1853;1854,0,0,0,1,1,2
4535,10,703,1855,0,0,0,0,1,1
4536,10,704,1856;1857;10280,0,0,1,1,1,3
4537,10,705,1858;1859,0,0,0,0,2,2
4538,10,706,1861,0,0,0,1,0,1
4539,10,707,1862;1863,0,0,0,0,2,2
4540,10,708,1864,0,0,0,0,1,1
4541,10,709,1867;1868;10605,0,0,1,1,1,3
4542,10,710,1869;2679,0,0,0,2,0,2
4543,10,713,1874;1875,0,0,0,2,0,2
4544,10,714,1876,0,0,0,1,0,1
4545,10,715,1879,0,0,0,0,1,1
4546,10,716,1880;1881;1883,0,0,1,1,1,3
4547,10,717,1884,0,0,0,0,1,1
4548,10,719,1886;1888;1889,0,0,0,2,1,3
4549,10,720,1545;1891;1892;10047;10667,0,1,2,1,1,5
4550,10,721,1893;1895,0,0,0,1,1,2
4551,10,722,1896,0,0,0,1,0,1
4552,10,723,1898,0,0,0,0,1,1
4553,10,724,1903,0,0,0,0,1,1
4554,10,725,1905;1906,0,0,0,1,1,2
4555,10,726,1908;1909,0,0,0,0,2,2
4556,10,727,1911;1912,0,0,0,1,1,2
4557,10,728,1424;1914;8336;10193;10475;11215,0,1,2,3,0,6
4558,10,729,1916,0,0,0,1,0,1
4559,10,730,1917;9761,0,0,0,2,0,2
4560,10,731,1919,0,0,0,1,0,1
4561,10,732,1920;1921,0,0,0,2,0,2
4562,10,733,1923;1924,0,0,0,2,0,2
4563,10,734,1926,0,0,0,1,0,1
4564,10,735,1928;1929;1930,0,0,2,0,1,3
4565,10,736,1931;8154;10844,0,1,0,2,0,3
4566,10,737,1934,0,0,0,0,1,1
4567,10,738,5001,0,0,0,1,0,1
4568,10,739,1937,0,0,0,0,1,1
4569,10,740,1938;1939;1940,0,0,1,2,0,3
4570,10,741,1941;1942;1943;1944,0,0,2,1,1,4
4571,10,742,1945;1946;1949,0,0,0,2,1,3
4572,10,744,1955,0,0,0,0,1,1
4573,10,747,1958,0,0,0,1,0,1
4574,10,748,1959,0,0,0,0,1,1
4575,10,749,1961;1962;1963,0,0,0,2,1,3
4576,10,750,1965;1966;10204;10398,0,0,3,1,0,4
4577,10,751,1968,0,0,0,1,0,1
4578,10,752,1969;1970;10125;10738,0,1,1,2,0,4
4579,10,753,1971;1972;1973,0,0,0,3,0,3
4580,10,754,1975;1979,0,0,0,2,0,2
4581,10,755,1980;1981,0,0,0,2,0,2
4582,10,756,1982;1986;1987,0,0,0,2,1,3
4583,10,757,1988,0,0,0,1,0,1
4584,10,758,1991,0,0,0,1,0,1
4585,10,759,1993;7937;11154,0,1,0,2,0,3
4586,10,760,1994;6424,0,0,0,2,0,2
4587,10,762,1997;1998,0,0,0,1,1,2
4588,10,763,1999,0,0,0,0,1,1
4589,10,764,2000;2002,0,0,0,0,2,2
4590,10,765,2003,0,0,0,0,1,1
4591,10,767,552;2005;10025;10419,0,0,2,2,0,4
4592,10,768,2006;2008;2009;2010;10583;10973;11156,0,2,2,3,0,7
4593,10,769,2012;2013;2014;2015,0,0,1,3,0,4
4594,10,770,2016,0,0,0,1,0,1
4595,10,771,2019;2020;2021,0,0,0,0,3,3
4596,10,772,2023;2024,0,0,0,2,0,2
4597,10,773,2025;2026;2027;10421;10695,0,1,1,2,1,5
4598,10,774,2028;2029;2031;2032,0,0,1,2,1,4
4599,10,775,2034;2035;2036;2037;2040;2041;2043,0,0,0,0,7,7
4600,10,776,2044;4802,0,0,0,2,0,2
4601,10,777,2045,0,0,0,0,1,1
4602,10,778,2046,0,0,0,1,0,1
4603,10,779,2048,0,0,0,0,1,1
4604,10,780,2049;2050,0,0,0,0,2,2
4605,10,782,2052;2053,0,0,0,2,0,2
4606,10,783,2054;2055,0,0,0,2,0,2
4607,10,784,1464;2057;2059;10111,0,0,1,3,0,4
4608,10,786,2061;2062;2063,0,0,2,0,1,3
4609,10,787,2064,0,0,0,1,0,1
4610,10,788,2065;2066;2068;2069,0,0,2,2,0,4
4611,10,789,2070;2071,0,0,0,1,1,2
4612,10,791,2073,0,0,0,1,0,1
4613,10,792,2074;2075;2077,0,0,0,2,1,3
4614,10,793,2078;2079,0,0,0,1,1,2
4615,10,796,2083;2084;2085;10356,0,0,2,2,0,4
4616,10,797,2086;2087,0,0,0,1,1,2
4617,10,798,2088;2090;2091;2092,0,0,0,3,1,4
4618,10,799,2094;2095,0,0,0,1,1,2
4619,10,801,2097;2100;2101,0,0,0,2,1,3
4620,10,802,2102,0,0,0,0,1,1
4621,10,803,2103;5322;10457;10881,0,1,1,2,0,4
4622,10,804,2104,0,0,0,0,1,1
4623,10,805,2107;5779;9998,0,0,0,2,1,3
4624,10,806,2109;2110,0,0,0,2,0,2
4625,10,807,2111,0,0,0,1,0,1
4626,10,809,2114;5370,0,0,0,2,0,2
4627,10,810,2115,0,0,0,0,1,1
4628,10,811,2118,0,0,0,0,1,1
4629,10,812,2119;2120;2121,0,0,1,1,1,3
4630,10,813,2122;2123,0,0,1,0,1,2
4631,10,814,2124;2125,0,0,0,1,1,2
4632,10,815,2127,0,0,0,1,0,1
4633,10,816,2128;2129,0,0,0,2,0,2
4634,10,817,2132,0,0,0,0,1,1
4635,10,818,2139;2140;2142,0,0,1,1,1,3
4636,10,819,2143;6721,0,0,0,2,0,2
4637,10,820,2144;2145;2146,0,0,1,1,1,3
4638,10,821,2148;10068;10278;10541,0,0,3,1,0,4
4639,10,822,2149;2150,0,0,0,1,1,2
4640,10,823,2151,0,0,0,0,1,1
4641,10,825,2155;6082,0,0,0,2,0,2
4642,10,826,2157;2158;2159,0,0,1,2,0,3
4643,10,827,4894,0,0,0,1,0,1
4644,10,828,2161;2162,0,0,0,1,1,2
4645,10,829,2163;2164,0,0,0,1,1,2
4646,10,830,2167;2168,0,0,0,1,1,2
4647,10,831,2170,0,0,0,0,1,1
4648,10,833,2173;2175;2176;4785;10956;11041,0,2,1,3,0,6
4649,10,834,2177;2178;2179;10422;10544;10991,0,1,2,2,1,6
4650,10,836,2183;2184,0,0,0,0,2,2
4651,10,837,2185,0,0,0,1,0,1
4652,10,838,2187;2188,0,0,0,0,2,2
4653,10,839,2190,0,0,0,0,1,1
4654,10,840,2191,0,0,0,1,0,1
4655,10,841,2193;2194,0,0,0,1,1,2
4656,10,842,2196,0,0,0,0,1,1
4657,10,843,2197,0,0,0,0,1,1
4658,10,844,2198;9200,0,0,0,2,0,2
4659,10,845,2199,0,0,0,0,1,1
4660,10,846,2200;2202,0,0,0,0,2,2
4661,10,847,2204,0,0,0,1,0,1
4662,10,848,2209,0,0,0,0,1,1
4663,10,849,2211,0,0,0,0,1,1
4664,10,850,2213;2214,0,0,0,0,2,2
4665,10,851,2216,0,0,0,1,0,1
4666,10,852,2221;2223;2225;8061,0,0,0,3,1,4
4667,10,853,2227,0,0,0,0,1,1
4668,10,854,2228;2229,0,0,0,1,1,2
4669,10,855,2230;2231;2233;2234;9838;9959,0,0,2,4,0,6
4670,10,857,2238;2239;2240;10484;10830;11184,0,2,1,3,0,6
4671,10,858,2241,0,0,0,0,1,1
4672,10,859,2242;2243;2244;2245;2247,0,0,1,4,0,5
4673,10,860,2248;2249;2250,0,0,1,0,2,3
4674,10,861,2252;2254;2256,0,0,0,2,1,3
4675,10,862,2257,0,0,0,1,0,1
4676,10,863,2261,0,0,0,0,1,1
4677,10,864,2262;2263;2264;2265,0,0,0,3,1,4
4678,10,865,2266;2267;2268,0,0,1,2,0,3
4679,10,866,2269;2271,0,0,1,1,0,2
4680,10,867,2113;2272;2273,0,0,0,3,0,3
4681,10,868,2274;2275,0,0,0,2,0,2
4682,10,869,2276;2277;2280,0,0,0,1,2,3
4683,10,870,2283;2284,0,0,0,1,1,2
4684,10,872,2286,0,0,0,0,1,1
4685,10,873,2287;6339;10184;10782;10997,0,2,1,2,0,5
4686,10,874,2293;2294;10872,0,1,0,2,0,3
4687,10,877,2298;2299;2300;10077;10348,0,0,3,1,1,5
4688,10,878,2302;2303;11180,0,1,0,1,1,3
4689,10,879,2304,0,0,0,0,1,1
4690,10,881,2307;3814,0,0,0,2,0,2
4691,10,882,2310;2311,0,0,0,1,1,2
4692,10,883,2312;3128,0,0,0,2,0,2
4693,10,884,2314,0,0,0,1,0,1
4694,10,885,2315;2317,0,0,0,1,1,2
4695,10,886,2318;2320;2321;2322;2323,0,0,2,2,1,5
4696,10,887,2325;2327,0,0,0,0,2,2
4697,10,888,2328;2329;2330,0,0,1,1,1,3
4698,10,889,2331;6398,0,0,0,2,0,2
4699,10,890,5622,0,0,0,1,0,1
4700,10,891,2333;2334,0,0,0,1,1,2
4701,10,892,2335;2336,0,0,0,2,0,2
4702,10,893,2338;2339;2409,0,0,1,2,0,3
4703,10,894,2340;2342,0,0,0,1,1,2
4704,10,895,2344;10534;10970;11115,0,2,1,1,0,4
4705,10,896,2347,0,0,0,0,1,1
4706,10,897,2348,0,0,0,0,1,1
4707,10,898,2353;2354;2355;2356,0,0,1,2,1,4
4708,10,900,2358;2359;2360;2361,0,0,2,1,1,4
4709,10,901,2363;2364;2365,0,0,0,3,0,3
4710,10,902,2367;2369;2370,0,0,2,1,0,3
4711,10,903,2371;2372,0,0,0,1,1,2
4712,10,904,2373;2374;10393;10835,0,1,1,2,0,4
4713,10,905,2375,0,0,0,0,1,1
4714,10,906,2378,0,0,0,0,1,1
4715,10,908,2381;2382,0,0,0,0,2,2
4716,10,909,2386;6387,0,0,0,2,0,2
4717,10,910,2387;2389,0,0,1,0,1,2
4718,10,911,2390;2391,0,0,0,1,1,2
4719,10,912,2393;2394;2395;2396,0,0,1,3,0,4
4720,10,913,2397,0,0,0,0,1,1
4721,10,915,2400;2402,0,0,0,0,2,2
4722,10,916,2407;2408,0,0,0,1,1,2
4723,10,917,2411,0,0,0,0,1,1
4724,10,918,2412;2413;2414,0,0,0,2,1,3
4725,10,919,983;2415;2418;10095;10331,0,0,2,3,0,5
4726,10,921,2421;5861,0,0,0,2,0,2
4727,10,922,2422;2423,0,0,0,2,0,2
4728,10,923,2424,0,0,0,0,1,1
4729,10,924,2426;7434,0,0,0,0,2,2
4730,10,926,2430;2431,0,0,0,0,2,2
4731,10,927,2432;2434,0,0,1,0,1,2
4732,10,928,2435;2436,0,0,0,2,0,2
4733,10,929,2437;2438,0,0,0,1,1,2
4734,10,930,2439;2440;2442,0,0,1,1,1,3
4735,10,931,2444;2446,0,0,0,0,2,2
4736,10,932,2448;2449,0,0,0,1,1,2
4737,10,933,2450,0,0,0,0,1,1
4738,10,934,2451;2452,0,0,0,1,1,2
4739,10,935,2453;2454,0,0,0,2,0,2
4740,10,936,2457;2459,0,0,0,1,1,2
4741,10,937,2460;2461;2462,0,0,0,3,0,3
4742,10,938,2466,0,0,0,0,1,1
4743,10,939,2469,0,0,0,0,1,1
4744,10,940,2471;2472,0,0,0,2,0,2
4745,10,941,2473;2474;2476,0,0,1,1,1,3
4746,10,942,2477;2479,0,0,0,2,0,2
4747,10,943,2482,0,0,0,0,1,1
4748,10,944,2484;2485,0,0,0,1,1,2
4749,10,946,2487,0,0,0,1,0,1
4750,10,947,2488;2489,0,0,0,1,1,2
4751,10,948,2491;2492;2493;2494,0,0,0,2,2,4
4752,10,949,2496;2498;2499,0,0,0,2,1,3
4753,10,951,2505;2508;9585,0,0,0,2,1,3
4754,10,952,2509;2511,0,0,0,0,2,2
4755,10,953,2513;8071;10225;10674,0,1,1,2,0,4
4756,10,954,2514,0,0,0,0,1,1
4757,10,955,2518,0,0,0,0,1,1
4758,10,956,2520,0,0,0,1,0,1
4759,10,957,2521;2522;2523;2524,0,0,2,1,1,4
4760,10,958,2528;2529,0,0,0,0,2,2
4761,10,959,2530,0,0,0,0,1,1
4762,10,960,2533;2534,0,0,1,1,0,2
4763,10,961,2536,0,0,0,1,0,1
4764,10,962,2538;2539,0,0,1,1,0,2
4765,10,964,2541;2542;2544;2545,0,0,1,2,1,4
4766,10,965,2547;8879,0,0,0,2,0,2
4767,10,966,2548;2549,0,0,0,1,1,2
4768,10,967,2550,0,0,0,1,0,1
4769,10,968,2551;2552,0,0,0,1,1,2
4770,10,969,2554;2555,0,0,0,2,0,2
4771,10,970,531;2558,0,0,0,2,0,2
4772,10,971,2560;2561,0,0,0,0,2,2
4773,10,972,2564;10101;10210;10790,0,1,2,1,0,4
4774,10,973,2565;2566,0,0,0,0,2,2
4775,10,974,2567;2568,0,0,0,2,0,2
4776,10,975,2569;2570,0,0,0,1,1,2
4777,10,976,2571;2573,0,0,0,0,2,2
4778,10,977,2574;2575;10208;10488,0,0,2,1,1,4
4779,10,978,2576,0,0,0,1,0,1
4780,10,979,2578;2579;2581,0,0,0,2,1,3
4781,10,980,2153;2582,0,0,0,1,1,2
4782,10,981,2583;2586,0,0,0,0,2,2
4783,10,982,2587,0,0,0,0,1,1
4784,10,983,2589,0,0,0,0,1,1
4785,10,984,2590;2591,0,0,0,1,1,2
4786,10,987,2597;2598;5539,0,0,1,2,0,3
4787,10,988,2599;2600,0,0,0,2,0,2
4788,10,989,2602;7787;7789;10281;10730,0,1,2,2,0,5
4789,10,990,2604;2606,0,0,0,1,1,2
4790,10,991,2608;10037;10256;10501,0,0,3,1,0,4
4791,10,993,2611,0,0,0,0,1,1
4792,10,995,1211;2614;10265,0,0,1,2,0,3
4793,10,996,2616,0,0,0,0,1,1
4794,10,997,2072,0,0,0,1,0,1
4795,10,998,2618;2620,0,0,0,2,0,2
4796,10,999,2623;2624;2625,0,0,0,2,1,3
4797,10,1000,2626;2627,0,0,0,0,2,2
4798,10,1001,2630;4452;10495,0,0,1,2,0,3
4799,10,1002,2631;2632,0,0,0,0,2,2
4800,10,1003,2634;9123,0,0,0,2,0,2
4801,10,1005,2637,0,0,0,1,0,1
4802,10,1006,2638;2639,0,0,0,1,1,2
4803,10,1007,2640;2641,0,0,0,2,0,2
4804,10,1010,2645;2646;2648,0,0,0,1,2,3
4805,10,1011,2649;2650;2651,0,0,0,1,2,3
4806,10,1012,2652,0,0,0,1,0,1
4807,10,1013,520;2658;10531;10586,0,0,2,2,0,4
4808,10,1014,2659,0,0,0,0,1,1
4809,10,1015,2660,0,0,0,0,1,1
4810,10,1017,2664;2665,0,0,0,0,2,2
4811,10,1018,2666;2668,0,0,0,2,0,2
4812,10,1019,2672;2673,0,0,0,1,1,2
4813,10,1022,2678;2680,0,0,0,1,1,2
4814,10,1023,2683;2684,0,0,0,0,2,2
4815,10,1024,2686;2689,0,0,0,1,1,2
4816,10,1025,2690;2691;2693;2694;5040,0,0,1,4,0,5
4817,10,1026,2695,0,0,0,0,1,1
4818,10,1027,2837,0,0,0,1,0,1
4819,10,1028,2697,0,0,0,1,0,1
4820,10,1029,2698;2699;2700;2701;9810,0,0,1,4,0,5
4821,10,1031,2703;9909,0,0,0,2,0,2
4822,10,1032,2704,0,0,0,0,1,1
4823,10,1033,2705;2707,0,0,0,1,1,2
4824,10,1035,2709;2710,0,0,0,1,1,2
4825,10,1036,2711;5758,0,0,0,2,0,2
4826,10,1037,233;2712,0,0,0,2,0,2
4827,10,1038,2713;2715,0,0,0,0,2,2
4828,10,1039,2716;5780,0,0,0,2,0,2
4829,10,1040,2719;2720;2721,0,0,0,0,3,3
4830,10,1043,2726;2727;2728;2729,0,0,2,1,1,4
4831,10,1044,2732,0,0,0,0,1,1
4832,10,1045,2734;2738,0,0,1,0,1,2
4833,10,1046,2739;2740;2741;2742,0,0,0,3,1,4
4834,10,1047,2745;2748,0,0,0,1,1,2
4835,10,1048,2749;2750;2751;5146;10535;10922,0,1,2,3,0,6
4836,10,1049,2752,0,0,0,0,1,1
4837,10,1050,2753,0,0,0,1,0,1
4838,10,1051,2754;4597,0,0,0,2,0,2
4839,10,1052,2756;2757,0,0,0,1,1,2
4840,10,1053,2758;2759;2760,0,0,1,1,1,3
4841,10,1054,2761,0,0,0,0,1,1
4842,10,1055,2763;2764;2765,0,0,0,1,2,3
4843,10,1056,2767,0,0,0,0,1,1
4844,10,1059,2773;2774;2775,0,0,2,1,0,3
4845,10,1060,2777;2778,0,0,0,0,2,2
4846,10,1061,2779,0,0,0,0,1,1
4847,10,1062,2782;2783;2784,0,0,1,1,1,3
4848,10,1063,2786;2787;2788;2789;7390;10254;10371,0,0,3,4,0,7
4849,10,1064,2790;2791,0,0,0,1,1,2
4850,10,1065,2792;8660,0,0,0,2,0,2
4851,10,1066,2794;2795,0,0,0,1,1,2
4852,10,1067,2796;2797;2798,0,0,0,3,0,3
4853,10,1068,2803;2805,0,0,0,1,1,2
4854,10,1069,2806;2807;10221;11080,0,1,1,2,0,4
4855,10,1070,2808;2809;2810;2812,0,0,0,3,1,4
4856,10,1071,2813;2814;2815;2817;2818,0,0,1,3,1,5
4857,10,1072,2819;2820,0,0,0,1,1,2
4858,10,1073,2822,0,0,0,1,0,1
4859,10,1074,2823;2824,0,0,0,1,1,2
4860,10,1075,2826;2828,0,0,0,0,2,2
4861,10,1076,2829;2830,0,0,0,2,0,2
4862,10,1077,2832;2833,0,0,0,2,0,2
4863,10,1078,2835;7145,0,0,0,2,0,2
4864,10,1079,2836,0,0,0,0,1,1
4865,10,1080,2841;2842,0,0,0,1,1,2
4866,10,1081,2844,0,0,0,1,0,1
4867,10,1082,2846;2847,0,0,0,1,1,2
4868,10,1084,2851;2852,0,0,0,2,0,2
4869,10,1085,2853;2854;2855,0,0,1,0,2,3
4870,10,1086,2856,0,0,0,1,0,1
4871,10,1087,2858;2859;2860,0,0,0,0,3,3
4872,10,1088,2862;2863,0,0,0,1,1,2
4873,10,1089,2866;2867,0,0,0,1,1,2
4874,10,1090,2868;2869;2870;2871,0,0,2,2,0,4
4875,10,1091,2874;2875;2876,0,0,1,1,1,3
4876,10,1093,2879;2880;3293;6905;10578;11003,0,1,2,3,0,6
4877,10,1094,2882;4803,0,0,0,2,0,2
4878,10,1095,2884,0,0,0,1,0,1
4879,10,1096,2885;8951,0,0,0,2,0,2
4880,10,1097,2886,0,0,0,0,1,1
4881,10,1098,1719,0,0,0,1,0,1
4882,10,1099,887;2888;2891;2893,0,0,1,3,0,4
4883,10,1100,2894;2896,0,0,1,0,1,2
4884,10,1101,2897,0,0,0,1,0,1
4885,10,1102,2398;2898,0,0,0,2,0,2
4886,10,1103,2900;2901;7283,0,0,0,3,0,3
4887,10,1104,2903;5169,0,0,0,2,0,2
4888,10,1105,2904;2905,0,0,0,1,1,2
4889,10,1106,2907,0,0,0,0,1,1
4890,10,1107,2908;5636,0,0,0,2,0,2
4891,10,1109,2911;10286;10358;10648,0,1,2,1,0,4
4892,10,1110,2914,0,0,0,1,0,1
4893,10,1111,2915;2916,0,0,0,2,0,2
4894,10,1113,1952;2918;2919;2920;10386;10487;11182,0,1,3,3,0,7
4895,10,1114,2922,0,0,0,1,0,1
4896,10,1115,2923;2924,0,0,0,0,2,2
4897,10,1116,2925;2926,0,0,0,1,1,2
4898,10,1117,2927;2928,0,0,0,0,2,2
4899,10,1118,2931;2932,0,0,0,1,1,2
4900,10,1119,2933;2934,0,0,0,0,2,2
4901,10,1120,2936,0,0,0,0,1,1
4902,10,1121,2937;2938;10108;10154;10865,0,1,2,1,1,5
4903,10,1122,2939;2940,0,0,0,0,2,2
4904,10,1123,2941;2942,0,0,0,2,0,2
4905,10,1124,2944,0,0,0,1,0,1
4906,10,1125,2945,0,0,0,0,1,1
4907,10,1126,2947;2948;2950,0,0,1,1,1,3
4908,10,1127,2953,0,0,0,1,0,1
4909,10,1128,2955;2956,0,0,0,1,1,2
4910,10,1129,2957;2958;2959;10072;10162;10350;10494;10768;11149,0,2,4,2,1,9
4911,10,1130,51;2962;2963;2964;2965;10032;10317,0,0,5,2,0,7
4912,10,1131,2966;2967,0,0,0,2,0,2
4913,10,1132,2968,0,0,0,0,1,1
4914,10,1133,2969;2970;2971;8338,0,0,1,1,2,4
4915,10,1134,2973;2974;2975;2976,0,0,2,2,0,4
4916,10,1135,2977;2978;2979;2980,0,0,0,3,1,4
4917,10,1136,2981;2982,0,0,0,1,1,2
4918,10,1137,2983;2984;2985,0,0,0,1,2,3
4919,10,1138,2987;10094;10152,0,0,2,1,0,3
4920,10,1139,2988;2989,0,0,0,2,0,2
4921,10,1140,2991,0,0,0,0,1,1
4922,10,1142,2994;2995;2996;10165,0,0,2,2,0,4
4923,10,1145,3005;3007,0,0,1,1,0,2
4924,10,1146,3008;3009;3012,0,0,0,2,1,3
4925,10,1147,3013,0,0,0,1,0,1
4926,10,1148,3015;3016,0,0,0,0,2,2
4927,10,1149,3017;3018;3019,0,0,1,1,1,3
4928,10,1150,3020;3021,0,0,0,0,2,2
4929,10,1152,3024;10026;10237;10451,0,0,3,1,0,4
4930,10,1153,3025;3026;3027;3028;3029,0,0,2,3,0,5
4931,10,1154,3031;3033,0,0,0,0,2,2
4932,10,1156,3038;3040;3041;6323,0,0,0,4,0,4
4933,10,1157,3042;3044;3045;3046,0,0,1,1,2,4
4934,10,1158,3047;3048,0,0,0,1,1,2
4935,10,1159,3049;3050,0,0,0,0,2,2
4936,10,1160,3051,0,0,0,0,1,1
4937,10,1161,3053;3054;3055,0,0,1,1,1,3
4938,10,1163,3060;3061,0,0,0,1,1,2
4939,10,1164,3065,0,0,0,1,0,1
4940,10,1165,3068;3069;3071;4389,0,0,1,3,0,4
4941,10,1166,3072,0,0,0,1,0,1
4942,10,1167,3074,0,0,0,0,1,1
4943,10,1168,3076;3077;3078;10553;10804;11050,0,2,1,3,0,6
4944,10,1169,3079,0,0,0,0,1,1
4945,10,1170,3080;8211;10382,0,0,1,2,0,3
4946,10,1171,3081;4005,0,0,0,1,1,2
4947,10,1172,3085;3086;3087;9026;10747,0,1,0,4,0,5
4948,10,1174,3089,0,0,0,0,1,1
4949,10,1175,3093;3094,0,0,0,0,2,2
4950,10,1176,3095;3096,0,0,0,1,1,2
4951,10,1177,3097;3098;3099,0,0,0,1,2,3
4952,10,1179,3104,0,0,0,0,1,1
4953,10,1180,3105;3106;3107;3108;10529;10833,0,1,2,2,1,6
4954,10,1181,3109;3110;3111,0,0,1,2,0,3
4955,10,1182,3112,0,0,0,1,0,1
4956,10,1183,3113;3114,0,0,0,1,1,2
4957,10,1184,3115;3116;3117;3118,0,0,1,2,1,4
4958,10,1185,3119;3121;3122,0,0,1,2,0,3
4959,10,1186,3124;3126;3127,0,0,2,1,0,3
4960,10,1189,3132;6291,0,0,0,2,0,2
4961,10,1190,3135;3136;3137;6125,0,0,1,3,0,4
4962,10,1191,3138;3141;4531,0,0,1,2,0,3
4963,10,1192,3142;6371,0,0,0,2,0,2
4964,10,1193,3143;3145;3146;8004,0,0,2,2,0,4
4965,10,1194,3147;3148,0,0,0,1,1,2
4966,10,1195,3149,0,0,0,0,1,1
4967,10,1196,3150;3151,0,0,0,2,0,2
4968,10,1198,3153;3156,0,0,1,1,0,2
4969,10,1199,3158;3159,0,0,0,1,1,2
4970,10,1200,3162;3163,0,0,0,1,1,2
4971,10,1201,3166;3167,0,0,0,2,0,2
4972,10,1202,3169;4818;10920;11017,0,2,0,2,0,4
4973,10,1203,3170;8716;10151;10542,0,0,2,2,0,4
4974,10,1204,3171;3173,0,0,0,2,0,2
4975,10,1205,3174;3175;10277;10596;11193,0,1,2,2,0,5
4976,10,1206,3176;3178,0,0,0,2,0,2
4977,10,1207,3179;3180,0,0,0,1,1,2
4978,10,1208,3181,0,0,0,1,0,1
4979,10,1209,357;3184,0,0,0,2,0,2
4980,10,1210,3187;10567,0,0,1,1,0,2
4981,10,1211,3188;3189;3191,0,0,0,1,2,3
4982,10,1212,3194,0,0,0,0,1,1
4983,10,1213,3197,0,0,0,1,0,1
4984,10,1214,3201;3202;6479;7249,0,0,0,4,0,4
4985,10,1215,3203,0,0,0,0,1,1
4986,10,1216,3205;3206;3209,0,0,1,2,0,3
4987,10,1217,3210;3211,0,0,0,1,1,2
4988,10,1218,3212;3213;3214;3215,0,0,0,3,1,4
4989,10,1219,3217,0,0,0,0,1,1
4990,10,1220,3220;3221;10016,0,0,1,2,0,3
4991,10,1221,3223,0,0,0,0,1,1
4992,10,1222,3225;3226,0,0,0,0,2,2
4993,10,1223,3228,0,0,0,0,1,1
4994,10,1224,3231;8159;10536;10723,0,1,1,2,0,4
4995,10,1225,3236;3237;3238;3240;3241,0,0,1,3,1,5
4996,10,1226,3242,0,0,0,1,0,1
4997,10,1227,3244;3246;3247;8714,0,0,2,2,0,4
4998,10,1229,2279;3249;10057;10135;11048,0,1,2,2,0,5
4999,10,1231,3251,0,0,0,1,0,1
5000,10,1232,3058;3253;3254;3256;10518;10890,0,1,3,2,0,6
5001,10,1233,1899;3258,0,0,0,2,0,2
5002,10,1234,1769;3259;11150,0,1,0,2,0,3
5003,10,1235,3261;3262;10027,0,0,1,1,1,3
5004,10,1236,3263,0,0,0,1,0,1
5005,10,1237,3264;3265;3266;3267,0,0,2,1,1,4
5006,10,1238,3269,0,0,0,0,1,1
5007,10,1240,3273,0,0,0,0,1,1
5008,10,1241,3274;3275,0,0,0,2,0,2
5009,10,1242,3278,0,0,0,1,0,1
5010,10,1243,3279;3280;3281,0,0,0,3,0,3
5011,10,1244,3282;3283,0,0,0,1,1,2
5012,10,1245,3284;3285,0,0,0,1,1,2
5013,10,1247,3287;3288;3289,0,0,0,1,2,3
5014,10,1248,3290;3292,0,0,0,2,0,2
5015,10,1250,3294;3296,0,0,0,1,1,2
5016,10,1252,3299,0,0,0,0,1,1
5017,10,1253,3300;3301,0,0,0,1,1,2
5018,10,1254,3303;3304,0,0,0,0,2,2
5019,10,1255,3307;3309,0,0,0,1,1,2
5020,10,1256,3310;3311,0,0,0,1,1,2
5021,10,1257,3313;3314,0,0,0,2,0,2
5022,10,1258,3316;3317;3318;3901,0,0,2,1,1,4
5023,10,1259,3319;3320,0,0,0,1,1,2
5024,10,1260,3322,0,0,0,1,0,1
5025,10,1261,3323,0,0,0,0,1,1
5026,10,1262,3325,0,0,0,0,1,1
5027,10,1263,3326;3327,0,0,0,0,2,2
5028,10,1264,3329,0,0,0,0,1,1
5029,10,1265,3330,0,0,0,0,1,1
5030,10,1266,3331;3332,0,0,0,0,2,2
5031,10,1267,3334,0,0,0,0,1,1
5032,10,1268,3335;3336;3337;10172;10511;10810,0,1,3,2,0,6
5033,10,1269,3339;3340;3341,0,0,1,1,1,3
5034,10,1271,634;3343,0,0,0,2,0,2
5035,10,1272,3344;3345;3346,0,0,0,2,1,3
5036,10,1273,3347;3348,0,0,0,0,2,2
5037,10,1274,3349;3350,0,0,0,1,1,2
5038,10,1275,3351;3353;3354;3355;3356,0,0,1,3,1,5
5039,10,1276,3357;3359;5452,0,0,1,2,0,3
5040,10,1277,3360;3361;3362;3363,0,0,0,3,1,4
5041,10,1278,3364,0,0,0,1,0,1
5042,10,1279,3365;3366;3367,0,0,2,0,1,3
5043,10,1280,3368;3369,0,0,0,2,0,2
5044,10,1281,3370;3371,0,0,0,2,0,2
5045,10,1282,3372;3373;3375;3377,0,0,1,2,1,4
5046,10,1283,3378;3379;3380;3381;10368;10690,0,1,1,3,1,6
5047,10,1284,3382;3383,0,0,0,1,1,2
5048,10,1285,3385;3386;3387;3388,0,0,1,3,0,4
5049,10,1286,3389;3390;8487,0,0,0,3,0,3
5050,10,1287,3393;3395;3397,0,0,0,2,1,3
5051,10,1288,3398;3399;3400;3401;3402;3403,0,0,1,3,2,6
5052,10,1289,883;3404,0,0,0,2,0,2
5053,10,1290,3408;3409;10199;10612,0,0,2,2,0,4
5054,10,1291,3410,0,0,0,1,0,1
5055,10,1292,672;3411;10472,0,0,1,2,0,3
5056,10,1294,3413;3414,0,0,0,1,1,2
5057,10,1295,1671;3415;3416;3420,0,0,2,1,1,4
5058,10,1296,3421,0,0,0,0,1,1
5059,10,1297,3422;3423;3424,0,0,1,2,0,3
5060,10,1298,3425,0,0,0,1,0,1
5061,10,1299,3426;3427;3428,0,0,0,3,0,3
5062,10,1300,3430;3431,0,0,0,1,1,2
5063,10,1301,3434;3435,0,0,0,1,1,2
5064,10,1302,3439;3440,0,0,0,0,2,2
5065,10,1303,3441;3442,0,0,0,2,0,2
5066,10,1304,3443;3445,0,0,0,0,2,2
5067,10,1305,3446,0,0,0,0,1,1
5068,10,1306,3447;3448;3450,0,0,0,2,1,3
5069,10,1307,3453;3454,0,0,0,0,2,2
5070,10,1308,3455;3458,0,0,1,1,0,2
5071,10,1309,3459;8836,0,0,0,2,0,2
5072,10,1310,3460,0,0,0,1,0,1
5073,10,1311,3462;3463,0,0,0,2,0,2
5074,10,1312,3464,0,0,0,0,1,1
5075,10,1313,3466;3467;3468,0,0,0,2,1,3
5076,10,1314,3469;3470;3472,0,0,1,2,0,3
5077,10,1315,3474;3475;3478;6732;10794,0,1,1,3,0,5
5078,10,1316,3479;3480;3481,0,0,1,2,0,3
5079,10,1317,3482,0,0,0,0,1,1
5080,10,1320,3486;3487,0,0,0,2,0,2
5081,10,1321,3489,0,0,0,0,1,1
5082,10,1322,3490;3491;3493,0,0,0,2,1,3
5083,10,1323,3494;3496,0,0,0,0,2,2
5084,10,1324,3497,0,0,0,1,0,1
5085,10,1325,3498;3499,0,0,0,0,2,2
5086,10,1326,3501;3502;3503;3504;10130;10672;10839,0,2,3,2,0,7
5087,10,1327,3505;3506;3507,0,0,1,1,1,3
5088,10,1329,3509;6516;11012,0,1,0,2,0,3
5089,10,1331,3511;3512;10665;10811,0,2,0,2,0,4
5090,10,1332,3513;3514;10390;10871,0,1,1,1,1,4
5091,10,1333,3515;3516;3517,0,0,1,1,1,3
5092,10,1334,3519,0,0,0,0,1,1
5093,10,1335,1663;3521;3522,0,0,1,2,0,3
5094,10,1336,3525;6538,0,0,0,2,0,2
5095,10,1337,3526;3527;10361;10547;10709,0,1,2,2,0,5
5096,10,1338,3528;3529;3530,0,0,0,2,1,3
5097,10,1339,3532;3534,0,0,0,2,0,2
5098,10,1340,3535,0,0,0,0,1,1
5099,10,1341,3537;3540,0,0,0,1,1,2
5100,10,1342,3541,0,0,0,1,0,1
5101,10,1344,3546;3547,0,0,0,1,1,2
5102,10,1345,3550,0,0,0,0,1,1
5103,10,1346,3552,0,0,0,0,1,1
5104,10,1348,3556,0,0,0,0,1,1
5105,10,1349,3560,0,0,0,1,0,1
5106,10,1350,3562;3563,0,0,0,1,1,2
5107,10,1351,3567;5762,0,0,0,2,0,2
5108,10,1352,3569;3570,0,0,0,1,1,2
5109,10,1353,3571;3572;3573,0,0,0,2,1,3
5110,10,1354,3576;3577;3578,0,0,1,2,0,3
5111,10,1355,3579,0,0,0,0,1,1
5112,10,1356,3580,0,0,0,1,0,1
5113,10,1357,3581;3582,0,0,0,1,1,2
5114,10,1358,3584;3585;3586,0,0,0,1,2,3
5115,10,1359,3587;3588;3590;3591;3592,0,0,2,0,3,5
5116,10,1360,3593;3594,0,0,0,2,0,2
5117,10,1361,3596;3597,0,0,0,1,1,2
5118,10,1362,3599;3600;3601;8399,0,0,2,2,0,4
5119,10,1363,3602;3603,0,0,0,1,1,2
5120,10,1364,3604;3605,0,0,0,0,2,2
5121,10,1365,3606,0,0,0,0,1,1
5122,10,1367,3609;3610;3611;3612;5743,0,0,1,3,1,5
5123,10,1368,3613;3614;3615,0,0,1,1,1,3
5124,10,1369,3616,0,0,0,1,0,1
5125,10,1370,3618,0,0,0,1,0,1
5126,10,1371,3619;3620;10759;10858;11111,0,3,0,1,1,5
5127,10,1373,3623;5267,0,0,0,2,0,2
5128,10,1374,3624;3625,0,0,0,1,1,2
5129,10,1375,3627;3829;10526;10685;11206,0,2,1,2,0,5
5130,10,1376,3628,0,0,0,0,1,1
5131,10,1377,3631,0,0,0,0,1,1
5132,10,1378,3635;3636,0,0,0,2,0,2
5133,10,1379,3637;3638,0,0,0,2,0,2
5134,10,1380,3640;3642,0,0,0,0,2,2
5135,10,1381,3644;3645,0,0,0,1,1,2
5136,10,1382,3648;3649,0,0,0,1,1,2
5137,10,1383,3651;3652,0,0,0,2,0,2
5138,10,1384,3653,0,0,0,0,1,1
5139,10,1385,3654;3655;3656,0,0,0,1,2,3
5140,10,1386,3657;3658,0,0,0,2,0,2
5141,10,1387,3659,0,0,0,0,1,1
5142,10,1388,3661;3662,0,0,0,1,1,2
5143,10,1389,3663,0,0,0,0,1,1
5144,10,1390,3665,0,0,0,0,1,1
5145,10,1391,3668;3669;10010;10319,0,0,2,1,1,4
5146,10,1392,3670;3671;3673;3674,0,0,0,2,2,4
5147,10,1393,3676;3678;3679,0,0,1,2,0,3
5148,10,1394,3680;8546,0,0,0,2,0,2
5149,10,1395,3681;3682;10105;10157;10717,0,1,2,1,1,5
5150,10,1396,3683;3684,0,0,0,1,1,2
5151,10,1397,3686;3687,0,0,0,2,0,2
5152,10,1398,3688;3690;3691,0,0,0,3,0,3
5153,10,1399,3692;3693,0,0,0,0,2,2
5154,10,1400,3694;3696,0,0,0,2,0,2
5155,10,1401,3697;3698;3699;3700;6638,0,0,0,5,0,5
5156,10,1402,3701;3702,0,0,0,0,2,2
5157,10,1403,12,0,0,0,1,0,1
5158,10,1404,1617;3705,0,0,0,2,0,2
5159,10,1405,3706;3707;3710,0,0,1,1,1,3
5160,10,1406,3712;3713,0,0,1,1,0,2
5161,10,1407,3714,0,0,0,1,0,1
5162,10,1409,4929,0,0,0,1,0,1
5163,10,1410,3721;3722,0,0,0,1,1,2
5164,10,1411,3724;3725,0,0,0,2,0,2
5165,10,1412,3729;3731,0,0,1,1,0,2
5166,10,1414,3734;3735,0,0,1,0,1,2
5167,10,1415,2131;3737;3738,0,0,0,3,0,3
5168,10,1416,5117;10669;10817,0,2,0,1,0,3
5169,10,1417,1365;3740;10196;10424,0,0,2,2,0,4
5170,10,1418,3743,0,0,0,1,0,1
5171,10,1419,3744;3745,0,0,0,1,1,2
5172,10,1420,1873;3747;3748;3749,0,0,0,4,0,4
5173,10,1421,3752;3753,0,0,0,1,1,2
5174,10,1422,3754;3755,0,0,0,2,0,2
5175,10,1423,3756;3757;3758,0,0,0,2,1,3
5176,10,1424,313;3760,0,0,0,0,2,2
5177,10,1425,3761;3762;10372;10551;11211,0,1,2,2,0,5
5178,10,1426,3763;6659;10044;10195;10233,0,0,3,2,0,5
5179,10,1427,3767,0,0,0,1,0,1
5180,10,1428,3769,0,0,0,0,1,1
5181,10,1429,3771,0,0,0,0,1,1
5182,10,1430,7129;8028,0,0,0,2,0,2
5183,10,1432,3774;3776,0,0,1,0,1,2
5184,10,1433,3777;3779,0,0,0,0,2,2
5185,10,1434,3782,0,0,0,0,1,1
5186,10,1435,3783,0,0,0,0,1,1
5187,10,1436,3784;3786,0,0,0,0,2,2
5188,10,1437,2219,0,0,0,1,0,1
5189,10,1438,2943;3790,0,0,0,2,0,2
5190,10,1439,3791;3793;3794,0,0,1,2,0,3
5191,10,1440,3555;3797;3798;10322;10769,0,1,2,2,0,5
5192,10,1441,3800;3801;3802,0,0,0,3,0,3
5193,10,1443,3805;3806,0,0,0,0,2,2
5194,10,1444,3807;3808,0,0,0,2,0,2
5195,10,1445,3809;3810;3813,0,0,0,2,1,3
5196,10,1447,3816,0,0,0,0,1,1
5197,10,1448,3818;3819;3820,0,0,1,1,1,3
5198,10,1450,3822,0,0,0,0,1,1
5199,10,1451,3825;3826,0,0,0,2,0,2
5200,10,1452,3827;3828;10296,0,0,1,1,1,3
5201,10,1454,3835;3836;3837,0,0,0,0,3,3
5202,10,1455,3838;3839;3840;3841;3842,0,0,3,0,2,5
5203,10,1456,3843;3844,0,0,0,1,1,2
5204,10,1457,3845;10181;10537,0,0,2,1,0,3
5205,10,1458,3847;3848,0,0,0,2,0,2
5206,10,1459,2326;3851,0,0,0,2,0,2
5207,10,1460,3852;3853;3854,0,0,0,0,3,3
5208,10,1461,3855;3856,0,0,0,2,0,2
5209,10,1462,3857;3858;3859,0,0,0,2,1,3
5210,10,1463,3861;3862;3863,0,0,1,1,1,3
5211,10,1465,3866;7578,0,0,0,1,1,2
5212,10,1466,3870;3871;3872;3873;3874,0,0,1,3,1,5
5213,10,1467,3877;3878;8691,0,0,0,2,1,3
5214,10,1468,3880;5506;10706;10992,0,2,0,2,0,4
5215,10,1469,3881,0,0,0,0,1,1
5216,10,1470,3882;3883,0,0,0,1,1,2
5217,10,1471,3884;3885;3886,0,0,1,2,0,3
5218,10,1472,3887,0,0,0,1,0,1
5219,10,1473,3888;3889,0,0,0,1,1,2
5220,10,1474,3890,0,0,0,0,1,1
5221,10,1475,3893;3895;10614,0,0,1,2,0,3
5222,10,1476,3896;3897,0,0,0,1,1,2
5223,10,1479,3902;3904,0,0,0,1,1,2
5224,10,1480,3905,0,0,0,0,1,1
5225,10,1482,3909,0,0,0,0,1,1
5226,10,1483,3910;3911,0,0,0,1,1,2
5227,10,1484,3912;3913,0,0,0,2,0,2
5228,10,1485,3915,0,0,0,0,1,1
5229,10,1486,3918;3919;3920;3921;3922,0,0,0,3,2,5
5230,10,1487,3925;7941,0,0,0,2,0,2
5231,10,1490,3929,0,0,0,0,1,1
5232,10,1491,3932,0,0,0,0,1,1
5233,10,1492,3936;3937,0,0,0,0,2,2
5234,10,1493,3938;3939,0,0,0,1,1,2
5235,10,1494,3942,0,0,0,0,1,1
5236,10,1495,3943;3944;3945,0,0,0,2,1,3
5237,10,1496,3947;3948,0,0,0,1,1,2
5238,10,1497,3950;3951;3952,0,0,1,1,1,3
5239,10,1498,3953;3954;3956,0,0,0,3,0,3
5240,10,1499,3957;3958;3963,0,0,0,1,2,3
5241,10,1501,3966;3967;3969;10160;10423,0,0,3,1,1,5
5242,10,1502,3971;3972,0,0,0,1,1,2
5243,10,1503,3973,0,0,0,0,1,1
5244,10,1505,3980,0,0,0,1,0,1
5245,10,1506,3981,0,0,0,1,0,1
5246,10,1507,3982,0,0,0,1,0,1
5247,10,1508,2138;3983;3986;11051,0,1,1,2,0,4
5248,10,1509,3987;3988,0,0,0,2,0,2
5249,10,1510,3989;3990,0,0,0,1,1,2
5250,10,1511,3991,0,0,0,1,0,1
5251,10,1512,2776;3993;3994;3995,0,0,0,4,0,4
5252,10,1513,3997,0,0,0,0,1,1
5253,10,1514,3999,0,0,0,1,0,1
5254,10,1515,4004,0,0,0,0,1,1
5255,10,1516,4006,0,0,0,0,1,1
5256,10,1517,4007;4008,0,0,0,1,1,2
5257,10,1518,4009;4010,0,0,0,2,0,2
5258,10,1519,8356,0,0,0,1,0,1
5259,10,1520,4013,0,0,0,1,0,1
5260,10,1521,4014;4016;8463,0,0,0,3,0,3
5261,10,1522,4017;4605;10226;11007,0,1,1,2,0,4
5262,10,1523,4018,0,0,0,0,1,1
5263,10,1524,4019;4020;4021;4023,0,0,1,3,0,4
5264,10,1525,4024;4025,0,0,0,0,2,2
5265,10,1526,4027;4028,0,0,0,1,1,2
5266,10,1527,4029;7302,0,0,0,2,0,2
5267,10,1528,4031;7464;11061,0,1,0,2,0,3
5268,10,1529,4032;4035;5631,0,0,0,3,0,3
5269,10,1530,4036,0,0,0,0,1,1
5270,10,1531,4038;4039;10621;10731;10894,0,2,1,2,0,5
5271,10,1532,4040,0,0,0,0,1,1
5272,10,1533,4041;4042;4043,0,0,0,3,0,3
5273,10,1534,4049,0,0,0,0,1,1
5274,10,1535,4050;4052,0,0,0,2,0,2
5275,10,1536,4054;4055;4056;4057,0,0,2,0,2,4
5276,10,1537,1589;4058,0,0,0,0,2,2
5277,10,1538,4059;4060,0,0,0,0,2,2
5278,10,1540,4064;4065,0,0,0,2,0,2
5279,10,1541,4066;10330;10573;11219,0,1,2,1,0,4
5280,10,1542,4068;4069;4070,0,0,0,1,2,3
5281,10,1543,4071;4072;4074;4075,0,0,2,1,1,4
5282,10,1545,4078,0,0,0,0,1,1
5283,10,1546,4080;4081,0,0,0,1,1,2
5284,10,1548,4083;4086,0,0,0,0,2,2
5285,10,1549,4087,0,0,0,0,1,1
5286,10,1550,4088;5790;10834;11075,0,2,0,2,0,4
5287,10,1551,4089;4090;4091;4092;4093,0,0,3,1,1,5
5288,10,1553,4095,0,0,0,1,0,1
5289,10,1554,4096;4097,0,0,0,0,2,2
5290,10,1555,2762;4098,0,0,0,2,0,2
5291,10,1556,4099;4100,0,0,0,2,0,2
5292,10,1557,305;4104;4106,0,0,1,2,0,3
5293,10,1558,4107,0,0,0,1,0,1
5294,10,1559,4110,0,0,0,0,1,1
5295,10,1560,4114,0,0,0,0,1,1
5296,10,1562,4117;4118,0,0,0,1,1,2
5297,10,1563,4119;4120,0,0,0,1,1,2
5298,10,1564,4121,0,0,0,0,1,1
5299,10,1565,4123;4124,0,0,0,1,1,2
5300,10,1566,4125,0,0,0,1,0,1
5301,10,1568,4128,0,0,0,0,1,1
5302,10,1569,4131,0,0,0,1,0,1
5303,10,1570,4133;6059,0,0,0,2,0,2
5304,10,1571,4134,0,0,0,1,0,1
5305,10,1572,4135;4136;10074;10474;10826,0,1,2,2,0,5
5306,10,1573,4137,0,0,0,0,1,1
5307,10,1574,4139;4140;9594,0,0,0,3,0,3
5308,10,1575,4142;8171,0,0,0,2,0,2
5309,10,1576,4143;4144,0,0,0,1,1,2
5310,10,1577,4146;4147;4149;4150;4151,0,0,2,2,1,5
5311,10,1578,2478;4152,0,0,0,2,0,2
5312,10,1579,4153;4154;10091;10949;11054,0,2,1,2,0,5
5313,10,1580,4155;4156,0,0,0,1,1,2
5314,10,1581,4157;4158,0,0,0,1,1,2
5315,10,1582,4159,0,0,0,1,0,1
5316,10,1583,4161;4162;10214;10486;10854,0,1,2,2,0,5
5317,10,1584,4166,0,0,0,1,0,1
5318,10,1585,4167;4168,0,0,0,1,1,2
5319,10,1587,4172;4173,0,0,0,1,1,2
5320,10,1588,4175;8043;10525;10737;10998,0,2,1,2,0,5
5321,10,1589,4177,0,0,0,0,1,1
5322,10,1590,4179,0,0,0,0,1,1
5323,10,1591,4182,0,0,0,0,1,1
5324,10,1592,4183;4184,0,0,0,0,2,2
5325,10,1593,4185;4186;4189,0,0,0,3,0,3
5326,10,1595,4192;4193,0,0,0,2,0,2
5327,10,1597,4195;4196;4197,0,0,0,2,1,3
5328,10,1599,4200;8234,0,0,0,0,2,2
5329,10,1600,4203;4204,0,0,0,1,1,2
5330,10,1601,4205;9103,0,0,0,2,0,2
5331,10,1602,4206;4208;4210,0,0,0,2,1,3
5332,10,1603,4211;9142,0,0,0,2,0,2
5333,10,1605,4214;4215,0,0,0,1,1,2
5334,10,1606,4217;4219;4221,0,0,1,1,1,3
5335,10,1607,4222;4223,0,0,0,1,1,2
5336,10,1608,4225;4226,0,0,0,1,1,2
5337,10,1610,3787;4230,0,0,0,2,0,2
5338,10,1611,4231;4232,0,0,0,2,0,2
5339,10,1613,4236,0,0,0,1,0,1
5340,10,1614,4237;4238,0,0,0,0,2,2
5341,10,1616,4240;4241,0,0,0,2,0,2
5342,10,1617,4244,0,0,0,0,1,1
5343,10,1618,4245;4246,0,0,0,1,1,2
5344,10,1619,4247;4249,0,0,0,0,2,2
5345,10,1620,4250;4251;4252;9339,0,0,0,2,2,4
5346,10,1621,4253;4254,0,0,0,2,0,2
5347,10,1622,4256;4257,0,0,0,2,0,2
5348,10,1623,2935,0,0,0,1,0,1
5349,10,1625,4262;5894,0,0,0,2,0,2
5350,10,1626,4263;4264,0,0,0,1,1,2
5351,10,1627,4267;4268;6845;11147;11208,0,2,0,3,0,5
5352,10,1628,4269;4270;4271,0,0,0,3,0,3
5353,10,1629,4278;4279;4280,0,0,0,3,0,3
5354,10,1630,4282;4283;4285,0,0,0,3,0,3
5355,10,1631,4286;4288,0,0,0,1,1,2
5356,10,1633,401;4291;10478;10993,0,1,1,2,0,4
5357,10,1634,4292;4294;4295,0,0,1,2,0,3
5358,10,1635,4296;4297,0,0,0,2,0,2
5359,10,1636,4298;4299;10012;10637;11100,0,1,2,2,0,5
5360,10,1638,4302;4303;4304,0,0,1,0,2,3
5361,10,1639,4305;4306;4307;10087;10212;10436,0,0,3,2,1,6
5362,10,1640,4309,0,0,0,0,1,1
5363,10,1641,4310,0,0,0,0,1,1
5364,10,1642,4313,0,0,0,0,1,1
5365,10,1643,4316;4317,0,0,0,2,0,2
5366,10,1644,4318;9995;10260;10409,0,0,2,2,0,4
5367,10,1645,4319;8423,0,0,0,2,0,2
5368,10,1647,4323;4324,0,0,0,1,1,2
5369,10,1648,4325;4942,0,0,0,2,0,2
5370,10,1649,4327,0,0,0,0,1,1
5371,10,1650,4328;4329,0,0,0,2,0,2
5372,10,1651,4330;4331,0,0,0,2,0,2
5373,10,1652,4332,0,0,0,1,0,1
5374,10,1654,4334;4337,0,0,1,1,0,2
5375,10,1655,4338;4339;4340,0,0,0,1,2,3
5376,10,1656,4341,0,0,0,0,1,1
5377,10,1657,4343,0,0,0,0,1,1
5378,10,1658,4344;9412;10582;11210,0,1,1,2,0,4
5379,10,1659,4345;4346,0,0,0,2,0,2
5380,10,1660,4347;9126,0,0,0,2,0,2
5381,10,1661,4349;4350,0,0,0,1,1,2
5382,10,1663,4353;4354,0,0,0,1,1,2
5383,10,1664,908;4357;10090;11117,0,1,1,2,0,4
5384,10,1665,3780;4358,0,0,0,2,0,2
5385,10,1666,4360,0,0,0,0,1,1
5386,10,1667,4361,0,0,0,0,1,1
5387,10,1668,4364,0,0,0,1,0,1
5388,10,1669,4365;10328;10763,0,1,1,1,0,3
5389,10,1670,4366;4368;4369,0,0,0,3,0,3
5390,10,1671,4371;4372;4374,0,0,0,1,2,3
5391,10,1672,4376;10011,0,0,1,1,0,2
5392,10,1673,4380;4381,0,0,0,2,0,2
5393,10,1674,4382;4385,0,0,1,1,0,2
5394,10,1675,4386;4387,0,0,0,1,1,2
5395,10,1676,4388;4390,0,0,0,0,2,2
5396,10,1677,4391,0,0,0,1,0,1
5397,10,1679,4396;4397,0,0,0,1,1,2
5398,10,1680,4403,0,0,0,1,0,1
5399,10,1681,4404,0,0,0,0,1,1
5400,10,1683,4408;4409;4410,0,0,0,2,1,3
5401,10,1685,4414,0,0,0,0,1,1
5402,10,1686,4417,0,0,0,1,0,1
5403,10,1687,4418;4419;10142;10968,0,1,1,2,0,4
5404,10,1688,4420;4421,0,0,0,1,1,2
5405,10,1689,4423,0,0,0,1,0,1
5406,10,1690,4424,0,0,0,0,1,1
5407,10,1691,4427,0,0,0,1,0,1
5408,10,1693,4429,0,0,0,0,1,1
5409,10,1694,4430;4431,0,0,0,1,1,2
5410,10,1696,4433;4434;4436,0,0,0,3,0,3
5411,10,1697,4437;4438,0,0,0,2,0,2
5412,10,1699,4440;4441,0,0,0,1,1,2
5413,10,1700,4442;7409,0,0,0,2,0,2
5414,10,1701,4443;4445,0,0,0,2,0,2
5415,10,1702,4446;4447;4448;4449,0,0,1,3,0,4
5416,10,1703,4450;4451,0,0,0,1,1,2
5417,10,1705,4454;4455;4456,0,0,1,2,0,3
5418,10,1706,4457;4460;8743,0,0,0,2,1,3
5419,10,1707,4461,0,0,0,1,0,1
5420,10,1708,2260;4463,0,0,0,2,0,2
5421,10,1709,4464,0,0,0,0,1,1
5422,10,1710,4465;4466,0,0,0,1,1,2
5423,10,1711,4467;8303,0,0,0,2,0,2
5424,10,1712,4468;4469;4470;4471,0,0,2,2,0,4
5425,10,1713,4472;4473;4476;10840;10952,0,2,1,1,1,5
5426,10,1714,4477;4478,0,0,0,1,1,2
5427,10,1715,4480;4481,0,0,0,1,1,2
5428,10,1716,4483;4484;4486,0,0,0,3,0,3
5429,10,1718,4491,0,0,0,1,0,1
5430,10,1719,2917;4494;10546;11000,0,1,1,2,0,4
5431,10,1721,4497;4498,0,0,0,1,1,2
5432,10,1722,4502,0,0,0,0,1,1
5433,10,1723,4503;4505;4506,0,0,0,2,1,3
5434,10,1724,4508;4510;4511;9122,0,0,0,4,0,4
5435,10,1725,4512;4513;4515;4516,0,0,2,0,2,4
5436,10,1727,4518;4519,0,0,0,0,2,2
5437,10,1728,4520;4521;4523,0,0,1,1,1,3
5438,10,1729,4524;5575;10982;11013,0,2,0,2,0,4
5439,10,1730,4525;4526;4527;10155;10439,0,0,2,3,0,5
5440,10,1731,4529;4530,0,0,0,1,1,2
5441,10,1733,4533;4534;4535,0,0,1,1,1,3
5442,10,1735,4537,0,0,0,0,1,1
5443,10,1736,4538;4539,0,0,0,2,0,2
5444,10,1737,4540;4541;4542;4544;10191;10354;10506;10684,0,1,4,2,1,8
5445,10,1738,4545;8685,0,0,0,2,0,2
5446,10,1739,4546;4547,0,0,0,2,0,2
5447,10,1740,4549;4552,0,0,0,0,2,2
5448,10,1741,4554;4555,0,0,0,1,1,2
5449,10,1742,4556;6964,0,0,0,2,0,2
5450,10,1743,4557,0,0,0,0,1,1
5451,10,1744,4558,0,0,0,1,0,1
5452,10,1745,4176;4561,0,0,0,2,0,2
5453,10,1746,4562;7863,0,0,0,2,0,2
5454,10,1747,4565,0,0,0,1,0,1
5455,10,1748,4566;4567,0,0,0,1,1,2
5456,10,1749,4568;4569;4570;4571,0,0,1,0,3,4
5457,10,1750,4573,0,0,0,0,1,1
5458,10,1751,4575,0,0,0,0,1,1
5459,10,1752,4578;9088,0,0,0,2,0,2
5460,10,1753,4579,0,0,0,1,0,1
5461,10,1754,4583,0,0,0,0,1,1
5462,10,1755,4584;4585;4586;4587,0,0,1,3,0,4
5463,10,1756,4588;4590,0,0,0,1,1,2
5464,10,1757,4592;4593;4595,0,0,0,2,1,3
5465,10,1759,4598;4599;4600;4601,0,0,0,2,2,4
5466,10,1761,4604;4606;4607,0,0,0,2,1,3
5467,10,1762,4609;9952,0,0,0,1,1,2
5468,10,1763,4612,0,0,0,1,0,1
5469,10,1764,4614;4617,0,0,1,0,1,2
5470,10,1765,4618;4619,0,0,0,2,0,2
5471,10,1766,4620,0,0,0,1,0,1
5472,10,1767,4624;4625,0,0,0,1,1,2
5473,10,1768,4626;4627;4629;4630;10309,0,0,2,3,0,5
5474,10,1769,4631;4632;4633;4634,0,0,2,0,2,4
5475,10,1770,4635;4636,0,0,0,1,1,2
5476,10,1772,4639;4641,0,0,0,0,2,2
5477,10,1773,4642;4643,0,0,0,1,1,2
5478,10,1774,4644;4645,0,0,0,1,1,2
5479,10,1775,4646;4647,0,0,0,2,0,2
5480,10,1776,3002;4650,0,0,0,2,0,2
5481,10,1777,4653;4655;4656;7720;7724;10781,0,1,2,3,0,6
5482,10,1778,4657;4658,0,0,0,1,1,2
5483,10,1779,991;4660,0,0,0,2,0,2
5484,10,1780,4661,0,0,0,0,1,1
5485,10,1781,4662,0,0,0,0,1,1
5486,10,1783,4665,0,0,0,0,1,1
5487,10,1784,4666;4667;4669,0,0,1,1,1,3
5488,10,1785,4670,0,0,0,0,1,1
5489,10,1786,4672,0,0,0,0,1,1
5490,10,1787,1359;4673;4674;10008;10416,0,0,3,2,0,5
5491,10,1788,4676;4677,0,0,1,1,0,2
5492,10,1789,4679;4680,0,0,0,2,0,2
5493,10,1790,4682,0,0,0,1,0,1
5494,10,1791,4683;4684;10168,0,0,1,1,1,3
5495,10,1792,4685;4686,0,0,0,1,1,2
5496,10,1793,4687;4688;4689;4690;10425;10677,0,1,1,3,1,6
5497,10,1794,4692;4693;4694;8353,0,0,0,4,0,4
5498,10,1795,4695,0,0,0,0,1,1
5499,10,1796,4697;4698;4699;4700,0,0,2,0,2,4
5500,10,1797,4701,0,0,0,0,1,1
5501,10,1798,4702;4703;4704;10248,0,0,2,1,1,4
5502,10,1799,4705;4706,0,0,0,1,1,2
5503,10,1800,4708;4709,0,0,0,1,1,2
5504,10,1801,4710,0,0,0,0,1,1
5505,10,1802,4712,0,0,0,1,0,1
5506,10,1803,4715,0,0,0,0,1,1
5507,10,1804,4717;4718,0,0,0,1,1,2
5508,10,1805,4719;4720;4722,0,0,0,1,2,3
5509,10,1806,4724;4725,0,0,0,1,1,2
5510,10,1807,1613;4727,0,0,0,2,0,2
5511,10,1810,4731;4732,0,0,0,0,2,2
5512,10,1811,4734;4735;4736;10430;10636,0,0,2,3,0,5
5513,10,1812,4738;4739,0,0,0,2,0,2
5514,10,1813,4741;4742;4743,0,0,1,2,0,3
5515,10,1814,4744,0,0,0,0,1,1
5516,10,1815,975;4746;4748,0,0,1,2,0,3
5517,10,1816,4749;4750;4752,0,0,1,0,2,3
5518,10,1817,4753;4754;4757,0,0,1,2,0,3
5519,10,1818,816,0,0,0,1,0,1
5520,10,1819,4760;8326,0,0,0,2,0,2
5521,10,1820,4762;4763;4764;4765,0,0,0,3,1,4
5522,10,1821,2827;4766,0,0,0,2,0,2
5523,10,1822,4769;4770;4771,0,0,0,2,1,3
5524,10,1823,4773,0,0,0,0,1,1
5525,10,1824,4774;4775,0,0,0,1,1,2
5526,10,1825,4776;9470;11067,0,1,0,2,0,3
5527,10,1826,4777;4778,0,0,0,2,0,2
5528,10,1827,4779;4780;10625;11174,0,1,1,2,0,4
5529,10,1828,4781,0,0,0,1,0,1
5530,10,1829,4782;10029;10213,0,0,2,0,1,3
5531,10,1830,4784,0,0,0,0,1,1
5532,10,1832,4786;7071,0,0,0,2,0,2
5533,10,1833,732;4787,0,0,0,2,0,2
5534,10,1834,2702;4788;10173;10433;10589;10739,0,1,3,2,0,6
5535,10,1835,4789;4792;4793,0,0,0,2,1,3
5536,10,1836,4798,0,0,0,0,1,1
5537,10,1838,4801;4804,0,0,0,0,2,2
5538,10,1839,4805;4806,0,0,0,1,1,2
5539,10,1840,4808;4809,0,0,0,2,0,2
5540,10,1841,4810;4811,0,0,0,1,1,2
5541,10,1842,4812,0,0,0,1,0,1
5542,10,1844,4816,0,0,0,1,0,1
5543,10,1847,4822,0,0,0,0,1,1
5544,10,1848,4824;8948,0,0,0,2,0,2
5545,10,1849,4826;4828,0,0,0,2,0,2
5546,10,1850,4829;8975,0,0,0,0,2,2
5547,10,1851,4830;4831;4832;4833;10215;10249;10502,0,0,5,2,0,7
5548,10,1852,4834;4835,0,0,0,2,0,2
5549,10,1853,2594;4836;4837,0,0,0,2,1,3
5550,10,1854,4839,0,0,0,0,1,1
5551,10,1855,4841;4842,0,0,0,1,1,2
5552,10,1856,4843;4844;4845;4846,0,0,2,1,1,4
5553,10,1857,4847,0,0,0,0,1,1
5554,10,1858,4848;4849;4851,0,0,1,2,0,3
5555,10,1859,4853;4855;4856,0,0,0,3,0,3
5556,10,1860,4858;4859;4860;4861;4862,0,0,0,5,0,5
5557,10,1861,4863;4867;4868,0,0,2,0,1,3
5558,10,1862,4869;4870,0,0,0,2,0,2
5559,10,1863,4871;4872;4874,0,0,0,3,0,3
5560,10,1864,4875,0,0,0,1,0,1
5561,10,1865,1295;4878,0,0,0,2,0,2
5562,10,1866,4879;7836;10369;10808;11133,0,2,1,2,0,5
5563,10,1867,4881;4883,0,0,1,0,1,2
5564,10,1868,4884;4886,0,0,0,1,1,2
5565,10,1869,2030;4891;4892;5382,0,0,1,3,0,4
5566,10,1870,5718,0,0,0,1,0,1
5567,10,1872,4899;4900,0,0,0,2,0,2
5568,10,1873,4901;4902,0,0,0,0,2,2
5569,10,1875,4416;4905,0,0,0,2,0,2
5570,10,1876,4906,0,0,0,0,1,1
5571,10,1877,3553;4908;8851,0,0,0,3,0,3
5572,10,1878,4910;10324;10479,0,0,2,1,0,3
5573,10,1879,4912,0,0,0,1,0,1
5574,10,1880,4913;4914;4915;4916,0,0,0,2,2,4
5575,10,1882,4922;4923;5177,0,0,0,3,0,3
5576,10,1883,4926,0,0,0,0,1,1
5577,10,1884,4928;4930;4931,0,0,0,2,1,3
5578,10,1885,4932;4933,0,0,0,2,0,2
5579,10,1886,4934,0,0,0,1,0,1
5580,10,1887,4935;4936,0,0,0,1,1,2
5581,10,1888,1544;4937,0,0,0,1,1,2
5582,10,1889,4943;4945;4946,0,0,2,0,1,3
5583,10,1890,4947;4948,0,0,0,1,1,2
5584,10,1891,4951;4952;4954;4955;4956,0,0,2,3,0,5
5585,10,1892,4957;4958;4959;4960,0,0,2,0,2,4
5586,10,1893,4961;4962;4963,0,0,0,2,1,3
5587,10,1894,4964;4965,0,0,0,2,0,2
5588,10,1895,4966,0,0,0,1,0,1
5589,10,1896,4970,0,0,0,1,0,1
5590,10,1897,4972,0,0,0,0,1,1
5591,10,1898,4974;4975,0,0,0,1,1,2
5592,10,1899,4976;4977,0,0,0,1,1,2
5593,10,1900,4981,0,0,0,1,0,1
5594,10,1901,4982;4983;10134;10285;10357,0,0,3,1,1,5
5595,10,1903,4985;6759,0,0,0,2,0,2
5596,10,1904,4986,0,0,0,0,1,1
5597,10,1905,4987;4988;4989;4990,0,0,1,1,2,4
5598,10,1906,4991;4992,0,0,0,2,0,2
5599,10,1907,4993;4994,0,0,0,0,2,2
5600,10,1908,4995;4996,0,0,0,0,2,2
5601,10,1909,308;4997,0,0,0,2,0,2
5602,10,1910,4998;4999;5002,0,0,0,1,2,3
5603,10,1911,5005,0,0,0,0,1,1
5604,10,1912,5007,0,0,0,0,1,1
5605,10,1913,5009,0,0,0,1,0,1
5606,10,1914,5011;5012;5013,0,0,0,3,0,3
5607,10,1915,5014;5015;5016,0,0,0,2,1,3
5608,10,1916,5018;5019,0,0,0,0,2,2
5609,10,1917,5020;5022,0,0,0,1,1,2
5610,10,1918,5023;5024;5025,0,0,0,2,1,3
5611,10,1919,797;5027;6181;6183;10493;10847,0,1,3,2,0,6
5612,10,1920,5028,0,0,0,0,1,1
5613,10,1921,5029;5030;5031;5032,0,0,1,2,1,4
5614,10,1922,5033;5034;10217;10579,0,0,2,2,0,4
5615,10,1923,5036;10238;10846;11044,0,2,1,1,0,4
5616,10,1926,5041;5042;5043;5044,0,0,0,3,1,4
5617,10,1927,5045;5047;7278,0,0,1,2,0,3
5618,10,1928,5048;5049,0,0,0,1,1,2
5619,10,1929,5051;5053,0,0,0,1,1,2
5620,10,1930,5054;5055,0,0,0,1,1,2
5621,10,1931,5056;5057,0,0,0,0,2,2
5622,10,1932,5059;5060,0,0,0,0,2,2
5623,10,1933,5061;5063;5064;8369,0,0,1,3,0,4
5624,10,1934,5065;5066,0,0,0,2,0,2
5625,10,1935,5067;5068;10818;11078,0,2,0,2,0,4
5626,10,1936,5069;5071;5072,0,0,0,2,1,3
5627,10,1937,5073;5074,0,0,0,2,0,2
5628,10,1938,5076,0,0,0,1,0,1
5629,10,1940,5079,0,0,0,0,1,1
5630,10,1941,5080;5081,0,0,0,1,1,2
5631,10,1942,191;5083;5084,0,0,0,3,0,3
5632,10,1943,5088;5089;10205;10244,0,0,2,1,1,4
5633,10,1944,5090;5091,0,0,0,1,1,2
5634,10,1945,5093,0,0,0,1,0,1
5635,10,1946,5095;5096;5097,0,0,1,1,1,3
5636,10,1947,5098;5099;5100,0,0,1,1,1,3
5637,10,1948,5101;5102;10104;10795;10965,0,2,1,1,1,5
5638,10,1949,5103;5104;5105,0,0,0,2,1,3
5639,10,1952,5108,0,0,0,1,0,1
5640,10,1953,5111,0,0,0,0,1,1
5641,10,1954,5115;5116,0,0,0,1,1,2
5642,10,1955,5118;5119,0,0,0,1,1,2
5643,10,1956,5120;5218,0,0,0,2,0,2
5644,10,1957,5121,0,0,0,0,1,1
5645,10,1958,5122,0,0,0,0,1,1
5646,10,1960,5289,0,0,0,1,0,1
5647,10,1961,5126;5127;5128,0,0,1,1,1,3
5648,10,1962,5129;5130,0,0,0,1,1,2
5649,10,1963,5131;5132;5134;5135,0,0,1,2,1,4
5650,10,1964,5136;5137,0,0,1,0,1,2
5651,10,1965,5138,0,0,0,1,0,1
5652,10,1966,5139;5140,0,0,0,1,1,2
5653,10,1967,5142,0,0,0,0,1,1
5654,10,1968,5143;5144,0,0,0,2,0,2
5655,10,1969,5145,0,0,0,0,1,1
5656,10,1970,5150;5151,0,0,0,1,1,2
5657,10,1971,5152;5153,0,0,0,0,2,2
5658,10,1972,5154;5155;5156,0,0,1,1,1,3
5659,10,1973,5158;5161,0,0,1,0,1,2
5660,10,1974,5162;5163,0,0,0,2,0,2
5661,10,1975,5164;5165,0,0,0,1,1,2
5662,10,1977,5171,0,0,0,0,1,1
5663,10,1978,5172;5174;5175,0,0,2,1,0,3
5664,10,1979,5176;5178,0,0,0,1,1,2
5665,10,1980,5179;5180;5181;10093;10271,0,0,2,2,1,5
5666,10,1981,5182,0,0,0,0,1,1
5667,10,1983,5185;5186;5187;10941;11114,0,2,2,1,0,5
5668,10,1984,5188;5189;5190;5191;5192,0,0,0,4,1,5
5669,10,1985,5194,0,0,0,0,1,1
5670,10,1986,1042;5196;10984;11128,0,2,0,2,0,4
5671,10,1987,5197;5198,0,0,0,1,1,2
5672,10,1989,5204,0,0,0,0,1,1
5673,10,1990,5205;5206,0,0,0,0,2,2
5674,10,1991,5207;8430;10349;10762;10985,0,2,1,2,0,5
5675,10,1992,5209;5211,0,0,0,1,1,2
5676,10,1993,5212;5213;5215,0,0,0,3,0,3
5677,10,1994,5217;7642,0,0,0,2,0,2
5678,10,1995,5219;5220;5221,0,0,0,3,0,3
5679,10,1996,5222;5223,0,0,0,1,1,2
5680,10,1998,5227;5228;10266,0,0,2,1,0,3
5681,10,1999,5229;5231;5232,0,0,0,2,1,3
5682,10,2000,5233,0,0,0,1,0,1
5683,10,2001,5237;5238;10100,0,0,1,1,1,3
5684,10,2003,5240;5241,0,0,1,0,1,2
5685,10,2004,5242;5243;5244,0,0,0,2,1,3
5686,10,2005,5246;5247;5248;5249;10038;10201;10519;10673,0,1,4,3,0,8
5687,10,2006,5250;5251;10454,0,0,1,1,1,3
5688,10,2007,5252,0,0,0,0,1,1
5689,10,2008,5253;5254,0,0,0,0,2,2
5690,10,2009,5256;5258,0,0,1,1,0,2
5691,10,2010,5259;5260;5261,0,0,1,1,1,3
5692,10,2011,5262;5263,0,0,0,1,1,2
5693,10,2013,5265,0,0,0,1,0,1
5694,10,2014,5269,0,0,0,1,0,1
5695,10,2015,5270,0,0,0,0,1,1
5696,10,2016,5271,0,0,0,0,1,1
5697,10,2017,5273;10353;10514;10754,0,1,2,1,0,4
5698,10,2018,5274;10346,0,0,1,1,0,2
5699,10,2019,5276;5277;5278,0,0,0,3,0,3
5700,10,2020,5279,0,0,0,0,1,1
5701,10,2021,5281;5283,0,0,0,1,1,2
5702,10,2022,5284,0,0,0,1,0,1
5703,10,2023,5287,0,0,0,0,1,1
5704,10,2024,5290;5291,0,0,0,2,0,2
5705,10,2025,5292;5293;10420;10455,0,0,2,1,1,4
5706,10,2026,5294;5296;5297,0,0,1,2,0,3
5707,10,2028,5299;5300;5301;5302,0,0,0,2,2,4
5708,10,2029,5303;5304,0,0,0,1,1,2
5709,10,2030,5306;5307,0,0,0,0,2,2
5710,10,2031,5308;5309;5310;5311;11204,0,1,2,2,0,5
5711,10,2032,5313;5516,0,0,0,2,0,2
5712,10,2033,5314;5315;10131;10560;10646,0,1,2,2,0,5
5713,10,2034,5316;5317;5318,0,0,0,1,2,3
5714,10,2035,5319;5320,0,0,0,2,0,2
5715,10,2036,368;5321;10902,0,1,0,2,0,3
5716,10,2038,5323,0,0,0,1,0,1
5717,10,2039,5324;5325,0,0,0,1,1,2
5718,10,2040,5326;5329;5330;5331,0,0,2,1,1,4
5719,10,2041,5332;5626;10007;10412,0,0,2,2,0,4
5720,10,2042,5333,0,0,0,1,0,1
5721,10,2043,5334;5335,0,0,0,1,1,2
5722,10,2044,5336;5337,0,0,0,1,1,2
5723,10,2045,184;5338;10023;10182;10298,0,0,3,2,0,5
5724,10,2046,5339;5340,0,0,0,1,1,2
5725,10,2047,4261;5341,0,0,0,2,0,2
5726,10,2049,5345,0,0,0,0,1,1
5727,10,2050,5346;5347,0,0,0,1,1,2
5728,10,2051,5348,0,0,0,0,1,1
5729,10,2053,5354;5355,0,0,0,1,1,2
5730,10,2054,5356;5357,0,0,0,2,0,2
5731,10,2055,5358;5359,0,0,0,0,2,2
5732,10,2056,5361;5362,0,0,0,2,0,2
5733,10,2057,5363;5367;10252;10429;10633,0,0,4,1,0,5
5734,10,2058,5369;5574,0,0,0,2,0,2
5735,10,2059,5371,0,0,0,0,1,1
5736,10,2060,5373;5374,0,0,0,1,1,2
5737,10,2061,5375;5376,0,0,0,0,2,2
5738,10,2063,5383;5384,0,0,0,1,1,2
5739,10,2064,5385;5386;5387,0,0,0,1,2,3
5740,10,2065,5388;5389;5390,0,0,1,1,1,3
5741,10,2066,5392;10034;10507,0,0,2,1,0,3
5742,10,2067,5393;11011,0,1,0,1,0,2
5743,10,2068,5394;5395;5396;7143,0,0,0,4,0,4
5744,10,2069,5397;5398,0,0,0,0,2,2
5745,10,2070,5399;5400;5402,0,0,1,0,2,3
5746,10,2071,5403,0,0,0,1,0,1
5747,10,2072,5405;5406,0,0,0,1,1,2
5748,10,2073,5407;5408;5409,0,0,0,2,1,3
5749,10,2074,5413,0,0,0,0,1,1
5750,10,2075,5414;5415,0,0,0,1,1,2
5751,10,2076,5416,0,0,0,1,0,1
5752,10,2077,708;5420;5421,0,0,1,1,1,3
5753,10,2078,4917;5422;10004;10192;10299,0,0,3,2,0,5
5754,10,2079,5423;5424;5425,0,0,1,2,0,3
5755,10,2080,4927;5427;10046;10323,0,0,2,2,0,4
5756,10,2081,5429,0,0,0,1,0,1
5757,10,2082,5431;5433;9864,0,0,1,2,0,3
5758,10,2083,5435;5436;5437;8189;10022;10143;10406,0,0,5,2,0,7
5759,10,2084,5439;5440;5442,0,0,0,1,2,3
5760,10,2085,5444;5445,0,0,0,0,2,2
5761,10,2086,5446;5449,0,0,1,0,1,2
5762,10,2088,5453;6647,0,0,0,2,0,2
5763,10,2089,5454;5455,0,0,0,1,1,2
5764,10,2090,5456;5458;5459;5460,0,0,2,2,0,4
5765,10,2092,5462,0,0,0,0,1,1
5766,10,2093,5463;5464;10618;10767,0,1,1,2,0,4
5767,10,2094,5465;5466;10024;10132;10253;10378;10491,0,0,5,1,1,7
5768,10,2096,5468;10859;10960;11066,0,3,0,1,0,4
5769,10,2097,5471,0,0,0,0,1,1
5770,10,2098,5473,0,0,0,1,0,1
5771,10,2099,5474;8095,0,0,0,2,0,2
5772,10,2100,5475;5476,0,0,0,2,0,2
5773,10,2101,5477;5478;5479;5480,0,0,2,1,1,4
5774,10,2102,5482,0,0,0,0,1,1
5775,10,2103,5484,0,0,0,1,0,1
5776,10,2104,5485;5486;5487,0,0,0,2,1,3
5777,10,2105,5488;8093,0,0,0,2,0,2
5778,10,2106,5491;5492,0,0,0,1,1,2
5779,10,2107,5494;5495,0,0,0,0,2,2
5780,10,2108,5496;5497,0,0,0,0,2,2
5781,10,2109,5500,0,0,0,0,1,1
5782,10,2110,5503,0,0,0,1,0,1
5783,10,2111,5504;6493;11040,0,1,0,2,0,3
5784,10,2112,5505,0,0,0,1,0,1
5785,10,2114,279;5508;10613;11162,0,1,1,2,0,4
5786,10,2115,5509,0,0,0,1,0,1
5787,10,2116,5510;5511;5512,0,0,0,1,2,3
5788,10,2117,5513;5514;5515,0,0,0,2,1,3
5789,10,2118,5518,0,0,0,1,0,1
5790,10,2119,5519;5520;5521;5522,0,0,2,0,2,4
5791,10,2120,5523;5524;5525;5526;10267;10627;11055,0,1,3,2,1,7
5792,10,2122,5528;10141;10460,0,0,2,1,0,3
5793,10,2123,4866;5529,0,0,0,2,0,2
5794,10,2124,5530;5531,0,0,0,1,1,2
5795,10,2125,5532;10006,0,0,1,1,0,2
5796,10,2127,5535;5536,0,0,0,2,0,2
5797,10,2129,5538,0,0,0,0,1,1
5798,10,2130,5541,0,0,0,0,1,1
5799,10,2131,5543;5544;5545,0,0,0,1,2,3
5800,10,2132,5549;5550;10061;10126;10397;10848,0,1,3,2,0,6
5801,10,2133,4229;5552;5553;5554,0,0,1,2,1,4
5802,10,2135,5558;5559,0,0,0,0,2,2
5803,10,2136,5560;5561,0,0,0,1,1,2
5804,10,2137,5563;5564;5565,0,0,0,1,2,3
5805,10,2138,5567;5568,0,0,0,0,2,2
5806,10,2139,5570;5573,0,0,0,2,0,2
5807,10,2141,5576,0,0,0,0,1,1
5808,10,2142,5578;5757;11218,0,1,0,2,0,3
5809,10,2143,5579;5580,0,0,0,1,1,2
5810,10,2144,3508;5581,0,0,0,0,2,2
5811,10,2147,5584;5585,0,0,0,0,2,2
5812,10,2148,5587;7684,0,0,0,2,0,2
5813,10,2149,5591,0,0,0,1,0,1
5814,10,2150,4048;5592,0,0,0,1,1,2
5815,10,2151,5593;5594,0,0,0,1,1,2
5816,10,2152,5595;5596,0,0,0,2,0,2
5817,10,2153,5597;5598,0,0,0,1,1,2
5818,10,2154,5599;5600;5601,0,0,0,2,1,3
5819,10,2155,4199;9948;10496;10700;11098,0,2,1,2,0,5
5820,10,2156,5607,0,0,0,1,0,1
5821,10,2157,5608;5609,0,0,0,1,1,2
5822,10,2158,5610;5611,0,0,0,0,2,2
5823,10,2159,1246;5613;10699,0,1,0,2,0,3
5824,10,2160,5614;5615;5616,0,0,0,2,1,3
5825,10,2161,2081;5618,0,0,0,2,0,2
5826,10,2162,7598,0,0,0,1,0,1
5827,10,2163,5623,0,0,0,0,1,1
5828,10,2165,5627;5630,0,0,1,1,0,2
5829,10,2168,5634,0,0,0,1,0,1
5830,10,2169,5637;5638;5639,0,0,0,0,3,3
5831,10,2170,5640;5641;5642;5643;10327;10555;10708,0,1,4,2,0,7
5832,10,2171,5644;6827;10218;10306,0,0,2,2,0,4
5833,10,2172,5646;5647,0,0,0,0,2,2
5834,10,2173,5648;5649;10660,0,1,0,2,0,3
5835,10,2174,5651,0,0,0,1,0,1
5836,10,2175,5654,0,0,0,1,0,1
5837,10,2176,5656,0,0,0,0,1,1
5838,10,2177,5657;5658;5659,0,0,1,1,1,3
5839,10,2178,5660,0,0,0,1,0,1
5840,10,2179,5663,0,0,0,1,0,1
5841,10,2181,5666;5667;5668,0,0,0,2,1,3
5842,10,2182,5669,0,0,0,0,1,1
5843,10,2184,5672;5673;5674,0,0,0,1,2,3
5844,10,2185,307;5675,0,0,0,2,0,2
5845,10,2186,5676;6141,0,0,0,2,0,2
5846,10,2187,5678,0,0,0,1,0,1
5847,10,2188,5680;5681,0,0,0,0,2,2
5848,10,2190,5683,0,0,0,0,1,1
5849,10,2191,5685;5686;5687;5688,0,0,0,3,1,4
5850,10,2192,1187,0,0,0,1,0,1
5851,10,2193,5693,0,0,0,0,1,1
5852,10,2194,5694;5695,0,0,0,2,0,2
5853,10,2195,5696;5697;5698,0,0,1,1,1,3
5854,10,2196,5702;5703;5704,0,0,0,3,0,3
5855,10,2197,5705;5706,0,0,0,1,1,2
5856,10,2198,5707;5708;5710,0,0,1,2,0,3
5857,10,2199,5711;5712,0,0,0,2,0,2
5858,10,2200,5713,0,0,0,0,1,1
5859,10,2201,3461;5714;5715,0,0,0,2,1,3
5860,10,2202,5717;10539;10662,0,1,1,1,0,3
5861,10,2204,5719;5720;5722;5723,0,0,1,1,2,4
5862,10,2205,5724;5725;5726,0,0,0,2,1,3
5863,10,2206,5727;5821,0,0,0,2,0,2
5864,10,2208,5729;5730;5731,0,0,1,0,2,3
5865,10,2209,5732,0,0,0,1,0,1
5866,10,2210,2501;5734;5735;5736;5738,0,0,2,3,0,5
5867,10,2212,5745;5746;5747;5749,0,0,0,3,1,4
5868,10,2213,2725;5750;5754,0,0,0,2,1,3
5869,10,2215,5756,0,0,0,1,0,1
5870,10,2216,5759,0,0,0,0,1,1
5871,10,2217,5760;7966,0,0,0,2,0,2
5872,10,2218,5761,0,0,0,0,1,1
5873,10,2219,5765;5766,0,0,1,0,1,2
5874,10,2220,5768;5770,0,0,0,1,1,2
5875,10,2221,5772;5774;5775,0,0,1,1,1,3
5876,10,2222,5777,0,0,0,1,0,1
5877,10,2224,5781;5782,0,0,0,1,1,2
5878,10,2225,5783;5784,0,0,0,1,1,2
5879,10,2226,5785;5787;5789,0,0,0,3,0,3
5880,10,2228,5791;5792;5793,0,0,1,2,0,3
5881,10,2229,5795,0,0,0,1,0,1
5882,10,2230,5796;5797;5798,0,0,0,2,1,3
5883,10,2231,5800;9805,0,0,0,2,0,2
5884,10,2234,5803,0,0,0,0,1,1
5885,10,2235,5804;5805;5806;7005,0,0,0,4,0,4
5886,10,2236,5807;5808;5809,0,0,0,2,1,3
5887,10,2237,3391;5812,0,0,0,2,0,2
5888,10,2238,5813;5814,0,0,1,0,1,2
5889,10,2239,5815;8279,0,0,0,0,2,2
5890,10,2240,5817,0,0,0,0,1,1
5891,10,2243,5822;10366,0,0,1,1,0,2
5892,10,2244,5823;5824,0,0,0,2,0,2
5893,10,2245,5826;5827;5828,0,0,0,0,3,3
5894,10,2246,5829,0,0,0,0,1,1
5895,10,2247,5831;5832,0,0,0,1,1,2
5896,10,2248,5833,0,0,0,1,0,1
5897,10,2249,2872;5835,0,0,0,2,0,2
5898,10,2250,5836,0,0,0,1,0,1
5899,10,2252,1894;5840;5841;10572;10657,0,1,1,3,0,5
5900,10,2254,5843;5844,0,0,0,2,0,2
5901,10,2255,5845;5846,0,0,0,1,1,2
5902,10,2256,5847;5849;5850,0,0,1,2,0,3
5903,10,2257,5851,0,0,0,0,1,1
5904,10,2258,5853,0,0,0,0,1,1
5905,10,2259,5855,0,0,0,0,1,1
5906,10,2260,5856,0,0,0,0,1,1
5907,10,2261,5858;5859;5860,0,0,1,2,0,3
5908,10,2262,5862,0,0,0,1,0,1
5909,10,2263,5865;5866,0,0,0,1,1,2
5910,10,2264,5867;5868;5869;5871;10453;10784,0,1,1,4,0,6
5911,10,2265,5872,0,0,0,1,0,1
5912,10,2266,5874;5875;5876,0,0,0,2,1,3
5913,10,2267,5877;6063,0,0,0,2,0,2
5914,10,2269,5879,0,0,0,0,1,1
5915,10,2270,5880,0,0,0,0,1,1
5916,10,2271,5881;5882,0,0,0,1,1,2
5917,10,2273,5885;5886,0,0,0,0,2,2
5918,10,2274,5887;5889;5890;10045;10080;10187;10198,0,0,5,2,0,7
5919,10,2275,5891;5892;8181,0,0,0,3,0,3
5920,10,2276,5895,0,0,0,1,0,1
5921,10,2278,5897;5898;5901,0,0,1,1,1,3
5922,10,2279,5280,0,0,0,1,0,1
5923,10,2280,5903,0,0,0,0,1,1
5924,10,2281,5906,0,0,0,1,0,1
5925,10,2282,5909;8684;9837;10099;10283;10756,0,1,2,3,0,6
5926,10,2283,5910;5911;10516;11165,0,1,1,2,0,4
5927,10,2284,5912;5914,0,0,0,0,2,2
5928,10,2285,5915;5916;5917,0,0,1,1,1,3
5929,10,2286,4528;5918;10395;10908,0,1,1,2,0,4
5930,10,2287,5919,0,0,0,1,0,1
5931,10,2288,5921,0,0,0,0,1,1
5932,10,2289,5923;5924,0,0,0,2,0,2
5933,10,2290,5925;9326;10115;10510;10733;10772,0,2,2,2,0,6
5934,10,2291,5927;5929;5930,0,0,2,0,1,3
5935,10,2292,5931;5932,0,0,0,1,1,2
5936,10,2294,5934;5935;5937,0,0,1,2,0,3
5937,10,2295,5938;5940,0,0,0,0,2,2
5938,10,2296,5942,0,0,0,1,0,1
5939,10,2298,5944;5945,0,0,0,2,0,2
5940,10,2299,5946;9269,0,0,0,2,0,2
5941,10,2300,5947;5948,0,0,0,0,2,2
5942,10,2301,2278;5951;10206;10351;10595,0,0,3,2,0,5
5943,10,2302,5633;5955;10617;10670,0,1,1,2,0,4
5944,10,2303,5956;5957,0,0,0,1,1,2
5945,10,2305,5960;5961;5962;10161;10641,0,1,1,2,1,5
5946,10,2306,5965;5966;5967;5968;5969;5970,0,0,0,6,0,6
5947,10,2307,5973,0,0,0,0,1,1
5948,10,2308,5975;5976,0,0,0,0,2,2
5949,10,2310,5562;5978,0,0,0,2,0,2
5950,10,2311,3185;5979;5980;5981,0,0,1,3,0,4
5951,10,2312,5983;5984;5985,0,0,1,2,0,3
5952,10,2313,5987,0,0,0,0,1,1
5953,10,2314,5989;5990;5991;5992;10434;10743;10950,0,2,3,1,1,7
5954,10,2315,5993;5994,0,0,0,0,2,2
5955,10,2316,5996;5997;5998,0,0,0,1,2,3
5956,10,2317,5999;6000;6001;6002;6003,0,0,2,2,1,5
5957,10,2318,6004;6005,0,0,0,1,1,2
5958,10,2319,6006;7676;10875;10995,0,2,0,2,0,4
5959,10,2320,4428;6007,0,0,0,2,0,2
5960,10,2321,6008,0,0,0,1,0,1
5961,10,2322,6009,0,0,0,0,1,1
5962,10,2323,6011;6012,0,0,0,1,1,2
5963,10,2324,6014;6015,0,0,1,1,0,2
5964,10,2325,6017,0,0,0,1,0,1
5965,10,2326,6019,0,0,0,1,0,1
5966,10,2327,6023;6024,0,0,0,0,2,2
5967,10,2329,6026;6027,0,0,0,1,1,2
5968,10,2330,6029,0,0,0,0,1,1
5969,10,2331,6030;6032,0,0,0,1,1,2
5970,10,2332,6033;6034;6036,0,0,0,1,2,3
5971,10,2333,6038,0,0,0,1,0,1
5972,10,2334,6039;10414;10577,0,0,2,1,0,3
5973,10,2335,40;6041,0,0,0,2,0,2
5974,10,2336,6043;6044;10284;10377;10921,0,1,2,2,0,5
5975,10,2338,6046,0,0,0,1,0,1
5976,10,2341,6049;6050,0,0,0,2,0,2
5977,10,2342,5555;5557;6052;6053;6054;10958;11018,0,2,1,4,0,7
5978,10,2343,6055;6056,0,0,2,0,0,2
5979,10,2344,2585;6057,0,0,0,2,0,2
5980,10,2345,6058,0,0,0,0,1,1
5981,10,2347,6061;6062,0,0,0,0,2,2
5982,10,2349,6065;8838,0,0,0,2,0,2
5983,10,2350,6069;6071,0,0,1,1,0,2
5984,10,2353,6077;6078;10097;10824,0,1,1,2,0,4
5985,10,2354,6080,0,0,0,0,1,1
5986,10,2355,6084;6085,0,0,1,0,1,2
5987,10,2357,6089;6090,0,0,0,0,2,2
5988,10,2358,406;6091;10056;10305,0,0,2,2,0,4
5989,10,2359,6092,0,0,0,0,1,1
5990,10,2360,6094,0,0,0,1,0,1
5991,10,2361,6095;6096,0,0,0,2,0,2
5992,10,2362,6097;6098,0,0,0,2,0,2
5993,10,2363,6099;6100,0,0,0,1,1,2
5994,10,2364,6103;6104,0,0,0,0,2,2
5995,10,2365,6105;6106;6108,0,0,0,1,2,3
5996,10,2366,6109;6111;6112;7964,0,0,0,3,1,4
5997,10,2367,6113;6114;7312,0,0,1,2,0,3
5998,10,2368,6115;6116;6117,0,0,0,2,1,3
5999,10,2369,6121,0,0,0,0,1,1
6000,10,2370,6123;6124,0,0,0,1,1,2
6001,10,2371,6126;6127,0,0,1,1,0,2
6002,10,2372,6129,0,0,0,0,1,1
6003,10,2373,282;6130,0,0,0,2,0,2
6004,10,2374,6131,0,0,0,0,1,1
6005,10,2375,6134;6135,0,0,0,1,1,2
6006,10,2376,6136,0,0,0,0,1,1
6007,10,2378,6138;6139,0,0,0,1,1,2
6008,10,2379,6140;6891,0,0,0,2,0,2
6009,10,2381,6143;6239,0,0,0,2,0,2
6010,10,2382,6145,0,0,0,0,1,1
6011,10,2383,6148;6149,0,0,0,2,0,2
6012,10,2384,6150,0,0,0,1,0,1
6013,10,2385,6152;6153;6154;6155;10084;10342,0,0,3,3,0,6
6014,10,2386,6156;6157;6158;6159,0,0,1,3,0,4
6015,10,2387,6160;6161,0,0,0,1,1,2
6016,10,2389,2559;6166;10857,0,1,0,2,0,3
6017,10,2390,6167;6168,0,0,0,1,1,2
6018,10,2391,6171;6172;10230,0,0,1,2,0,3
6019,10,2392,330;6174;10604,0,0,1,2,0,3
6020,10,2393,6175,0,0,0,1,0,1
6021,10,2395,6179;6180;10432;10450,0,0,2,1,1,4
6022,10,2397,6185;6186;6187,0,0,0,2,1,3
6023,10,2398,2850;6190,0,0,0,2,0,2
6024,10,2399,6194;6394;10040;10171;10304;10381;10713,0,1,4,2,0,7
6025,10,2400,6195;6197,0,0,0,2,0,2
6026,10,2401,6200;6201;6202;9529,0,0,1,3,0,4
6027,10,2403,6204;10051;10803,0,1,1,1,0,3
6028,10,2404,6206;6208;7288,0,0,1,2,0,3
6029,10,2405,266;6209;6212,0,0,1,2,0,3
6030,10,2406,5461;6213,0,0,0,2,0,2
6031,10,2407,6214;10211;10385;10418,0,0,3,1,0,4
6032,10,2408,6216;6217;10070;10083;10127;10257;10758,0,1,4,2,0,7
6033,10,2409,6218;6220,0,0,0,0,2,2
6034,10,2410,6223;6224;6225,0,0,0,1,2,3
6035,10,2412,6227,0,0,0,0,1,1
6036,10,2413,6229,0,0,0,1,0,1
6037,10,2414,6230;6232;6233,0,0,1,1,1,3
6038,10,2415,6234,0,0,0,1,0,1
6039,10,2416,6235,0,0,0,0,1,1
6040,10,2418,6241;6242;10294;10359;10411;10906;11158,0,2,3,2,0,7
6041,10,2419,361;6246,0,0,0,2,0,2
6042,10,2420,6248,0,0,0,0,1,1
6043,10,2421,6249,0,0,0,0,1,1
6044,10,2422,6251;6252;10934,0,1,1,1,0,3
6045,10,2425,6258;6260;6261;6262,0,0,2,0,2,4
6046,10,2426,6263;6264,0,0,0,0,2,2
6047,10,2427,6266;7188,0,0,0,2,0,2
6048,10,2428,6267;6268,0,0,0,0,2,2
6049,10,2429,6269;6270;6272,0,0,1,0,2,3
6050,10,2430,6273;6274;6275,0,0,1,2,0,3
6051,10,2431,4815;5603;6277;11019,0,1,0,3,0,4
6052,10,2432,6279;6280,0,0,0,1,1,2
6053,10,2433,6283,0,0,0,1,0,1
6054,10,2434,6286;6288;6289;6290,0,0,0,2,2,4
6055,10,2436,6292,0,0,0,1,0,1
6056,10,2437,6294;6295;6296,0,0,0,2,1,3
6057,10,2438,6298;6299,0,0,0,1,1,2
6058,10,2439,6300;6301,0,0,0,0,2,2
6059,10,2440,6303;6304,0,0,0,0,2,2
6060,10,2441,6305,0,0,0,1,0,1
6061,10,2442,6306;6308;6309,0,0,1,2,0,3
6062,10,2443,6310;6312,0,0,0,0,2,2
6063,10,2444,6314;6315,0,0,0,1,1,2
6064,10,2445,6317;6319,0,0,0,2,0,2
6065,10,2446,6320;6321,0,0,0,2,0,2
6066,10,2447,6322;6324;6325,0,0,0,2,1,3
6067,10,2448,6327,0,0,0,1,0,1
6068,10,2449,6328;6329;6331,0,0,0,2,1,3
6069,10,2451,3554;6333;6335;6336,0,0,2,2,0,4
6070,10,2452,6338,0,0,0,0,1,1
6071,10,2453,6340;6341;6342,0,0,1,2,0,3
6072,10,2455,6346;6348,0,0,1,0,1,2
6073,10,2456,6349;6350,0,0,0,0,2,2
6074,10,2457,6351;6352;6353;10239;10719,0,1,1,2,1,5
6075,10,2458,6355,0,0,0,0,1,1
6076,10,2459,6356;6357;6358,0,0,0,0,3,3
6077,10,2460,6359;6360,0,0,0,1,1,2
6078,10,2461,6361;6362;6363,0,0,1,1,1,3
6079,10,2462,6364,0,0,0,0,1,1
6080,10,2463,6366;10186;10603;10964,0,1,2,1,0,4
6081,10,2464,6367;6368;6369;6370;7712,0,0,2,1,2,5
6082,10,2465,6372,0,0,0,0,1,1
6083,10,2466,2718;6374,0,0,0,1,1,2
6084,10,2467,6376;6377,0,0,0,0,2,2
6085,10,2468,6378;6379;10167;10468,0,0,2,2,0,4
6086,10,2469,1394;9359,0,0,0,2,0,2
6087,10,2470,6381;6382,0,0,1,1,0,2
6088,10,2471,4613;6383,0,0,0,2,0,2
6089,10,2472,4333;6384,0,0,0,2,0,2
6090,10,2473,6385,0,0,0,0,1,1
6091,10,2474,3834;6386;6388;6389,0,0,1,1,2,4
6092,10,2475,6391;6392;6393,0,0,1,0,2,3
6093,10,2477,6395,0,0,0,1,0,1
6094,10,2478,6397;6399,0,0,0,0,2,2
6095,10,2479,6402;6403;6404;6406;6408,0,0,0,5,0,5
6096,10,2480,6410,0,0,0,1,0,1
6097,10,2481,6411,0,0,0,0,1,1
6098,10,2482,6412;6414,0,0,0,0,2,2
6099,10,2483,6415;6416,0,0,0,0,2,2
6100,10,2484,6417,0,0,0,0,1,1
6101,10,2485,937;6419;6420;6421,0,0,1,3,0,4
6102,10,2486,3043;6423;10598;10765,0,1,1,2,0,4
6103,10,2488,6425;6426,0,0,0,1,1,2
6104,10,2489,6427;6429,0,0,0,0,2,2
6105,10,2490,6430;6431;10116;10246;10725,0,1,2,1,1,5
6106,10,2491,6433,0,0,0,1,0,1
6107,10,2492,6434;6435;6436,0,0,0,2,1,3
6108,10,2493,6437,0,0,0,1,0,1
6109,10,2494,6439,0,0,0,1,0,1
6110,10,2495,6441;6443;6444;10570;11105,0,1,3,1,0,5
6111,10,2496,6446;6447;8367,0,0,0,3,0,3
6112,10,2497,6448;6449;10164,0,0,1,1,1,3
6113,10,2498,6450;6451;6453,0,0,0,3,0,3
6114,10,2499,6455;6457;6458,0,0,0,2,1,3
6115,10,2500,6459;6460;6461,0,0,1,2,0,3
6116,10,2501,4082;6463;6465,0,0,0,3,0,3
6117,10,2502,6467,0,0,0,0,1,1
6118,10,2503,6468;6469;6470,0,0,2,1,0,3
6119,10,2504,6471;6472,0,0,0,0,2,2
6120,10,2505,6474,0,0,0,1,0,1
6121,10,2506,6475,0,0,0,0,1,1
6122,10,2507,3908;6476,0,0,0,2,0,2
6123,10,2508,6477;6478,0,0,0,1,1,2
6124,10,2509,6480;6481;8635,0,0,1,2,0,3
6125,10,2510,6482;6483,0,0,0,2,0,2
6126,10,2511,6484,0,0,0,0,1,1
6127,10,2512,2889;6485,0,0,0,2,0,2
6128,10,2513,6488;6490,0,0,1,0,1,2
6129,10,2514,6491;6492;6494,0,0,0,3,0,3
6130,10,2515,6495;6496,0,0,0,2,0,2
6131,10,2516,1420;6497,0,0,0,2,0,2
6132,10,2517,6499;6500,0,0,0,0,2,2
6133,10,2518,6501;6502,0,0,0,2,0,2
6134,10,2519,5438;10513;10929,0,1,1,1,0,3
6135,10,2520,6505;6599,0,0,0,2,0,2
6136,10,2521,4668;6506,0,0,0,2,0,2
6137,10,2522,6508,0,0,0,0,1,1
6138,10,2523,6510,0,0,0,0,1,1
6139,10,2524,6511;6512,0,0,0,1,1,2
6140,10,2525,6513,0,0,0,1,0,1
6141,10,2526,6515;6517,0,0,0,1,1,2
6142,10,2527,6519;6520;10415;10448,0,0,2,2,0,4
6143,10,2528,6521;6522,0,0,0,2,0,2
6144,10,2529,6523;6524;6525;6526,0,0,0,4,0,4
6145,10,2530,6527;6529;6531,0,0,0,2,1,3
6146,10,2531,6532;6533,0,0,0,1,1,2
6147,10,2532,6534;6535;6536,0,0,0,3,0,3
6148,10,2534,6540;6541,0,0,0,1,1,2
6149,10,2537,6547,0,0,0,0,1,1
6150,10,2538,6549;6551,0,0,0,1,1,2
6151,10,2539,6552;6553;6554;6555,0,0,0,2,2,4
6152,10,2540,6556;6557;6560;6561,0,0,2,0,2,4
6153,10,2541,6563,0,0,0,1,0,1
6154,10,2542,2443;6564;10744,0,1,0,2,0,3
6155,10,2543,2737;6565,0,0,0,2,0,2
6156,10,2544,6566;6567,0,0,0,2,0,2
6157,10,2545,6569,0,0,0,0,1,1
6158,10,2546,6570;6571,0,0,1,0,1,2
6159,10,2547,767;6572,0,0,0,0,2,2
6160,10,2548,6573;6574,0,0,0,0,2,2
6161,10,2549,6575;8255,0,0,0,2,0,2
6162,10,2551,3732;6578,0,0,0,2,0,2
6163,10,2552,6579,0,0,0,0,1,1
6164,10,2553,6583,0,0,0,0,1,1
6165,10,2554,6584;6585;10052;10287,0,0,2,1,1,4
6166,10,2555,6590;6591,0,0,0,2,0,2
6167,10,2556,6592;6593;6595,0,0,0,3,0,3
6168,10,2557,6596,0,0,0,0,1,1
6169,10,2558,6597,0,0,0,1,0,1
6170,10,2560,6600;6601;6603;6604;6605,0,0,1,3,1,5
6171,10,2561,6606;6607,0,0,0,1,1,2
6172,10,2563,6610;6611;6612,0,0,0,2,1,3
6173,10,2564,6613,0,0,0,0,1,1
6174,10,2565,6614;6615;6616,0,0,0,2,1,3
6175,10,2567,6619,0,0,0,1,0,1
6176,10,2568,6621;6622;6623;6624,0,0,1,2,1,4
6177,10,2569,6627;6628,0,0,0,1,1,2
6178,10,2570,1071;6630;6631;6632,0,0,1,3,0,4
6179,10,2571,6634,0,0,0,1,0,1
6180,10,2572,6635,0,0,0,0,1,1
6181,10,2573,6639;6641;6642,0,0,2,1,0,3
6182,10,2574,6643;7701;10477;10786,0,1,1,2,0,4
6183,10,2575,6644;6645,0,0,0,0,2,2
6184,10,2577,6650;6651;6652;6654,0,0,0,3,1,4
6185,10,2579,6657;6658;6660,0,0,0,3,0,3
6186,10,2580,3510;6662,0,0,0,1,1,2
6187,10,2581,6663;6664;10175;10481;11025,0,1,2,1,1,5
6188,10,2582,6665;8192,0,0,0,1,1,2
6189,10,2583,6666;6667;6668,0,0,0,3,0,3
6190,10,2584,6669;6670,0,0,0,1,1,2
6191,10,2585,6671;6672;6673;6675,0,0,0,2,2,4
6192,10,2586,6676,0,0,0,0,1,1
6193,10,2587,6677;6678,0,0,0,0,2,2
6194,10,2589,6680;6681,0,0,0,2,0,2
6195,10,2590,6683,0,0,0,1,0,1
6196,10,2591,6684;6685,0,0,0,0,2,2
6197,10,2592,1104;6686;6687;6689,0,0,0,2,2,4
6198,10,2593,6690;6691;6692;6693,0,0,0,4,0,4
6199,10,2594,6695;6738,0,0,0,2,0,2
6200,10,2595,6697;6698;6702;10336;10668,0,1,2,1,1,5
6201,10,2596,6704;6705;6707,0,0,0,2,1,3
6202,10,2598,6712;6713,0,0,0,0,2,2
6203,10,2599,6714,0,0,0,0,1,1
6204,10,2601,6716;6717;6719;6720,0,0,0,2,2,4
6205,10,2602,6722;6723,0,0,0,0,2,2
6206,10,2603,6725;6726;6729,0,0,1,1,1,3
6207,10,2604,6730;6731,0,0,0,1,1,2
6208,10,2605,6733;6735,0,0,0,1,1,2
6209,10,2606,3992;6737;10282;10376,0,0,2,2,0,4
6210,10,2607,6739;6740,0,0,0,1,1,2
6211,10,2608,6741;6742;6743;6744,0,0,1,2,1,4
6212,10,2610,6746;6747,0,0,0,1,1,2
6213,10,2611,6749;6750;6751;7828,0,0,0,3,1,4
6214,10,2612,6752;6753,0,0,0,2,0,2
6215,10,2613,6754,0,0,0,1,0,1
6216,10,2615,4362;6756,0,0,0,2,0,2
6217,10,2616,6758;6760,0,0,0,0,2,2
6218,10,2617,6762;6763;6764;6765,0,0,0,3,1,4
6219,10,2618,6766;10405,0,0,1,1,0,2
6220,10,2619,6768,0,0,0,0,1,1
6221,10,2620,6771,0,0,0,0,1,1
6222,10,2621,6772;6773,0,0,0,1,1,2
6223,10,2623,6776;6777,0,0,0,1,1,2
6224,10,2624,6779;6780;6781,0,0,0,2,1,3
6225,10,2625,6784;6785;6786,0,0,0,0,3,3
6226,10,2626,6787;6788;10020;10819;11090,0,2,1,1,1,5
6227,10,2627,6790;6791;7639,0,0,0,1,2,3
6228,10,2628,6793,0,0,0,0,1,1
6229,10,2629,6795;6798,0,0,0,1,1,2
6230,10,2630,6800,0,0,0,0,1,1
6231,10,2631,6801;6802;10229;10919;11032,0,2,1,2,0,5
6232,10,2632,6803;6804;6805,0,0,0,3,0,3
6233,10,2633,6806,0,0,0,0,1,1
6234,10,2634,6807;6808;6809,0,0,1,1,1,3
6235,10,2635,6811,0,0,0,1,0,1
6236,10,2636,6812,0,0,0,0,1,1
6237,10,2637,6813;6814,0,0,0,2,0,2
6238,10,2638,6816;9224;11062,0,1,0,2,0,3
6239,10,2639,6818,0,0,0,1,0,1
6240,10,2640,6822;6823,0,0,1,0,1,2
6241,10,2641,6824,0,0,0,1,0,1
6242,10,2642,6825;6826,0,0,0,1,1,2
6243,10,2643,6828;6829;10332;10565,0,0,2,1,1,4
6244,10,2644,6831,0,0,0,0,1,1
6245,10,2645,6832;6833,0,0,0,0,2,2
6246,10,2646,6834;6836;6838;6839,0,0,2,2,0,4
6247,10,2647,6840;6841,0,0,0,1,1,2
6248,10,2648,6842;6843;6844;6848;6849;9849,0,0,3,0,3,6
6249,10,2650,6853;6855;6857,0,0,0,3,0,3
6250,10,2651,6858;9460,0,0,0,2,0,2
6251,10,2652,6860,0,0,0,1,0,1
6252,10,2653,6863;6864;6865;6866,0,0,0,1,3,4
6253,10,2654,6868;6869,0,0,0,1,1,2
6254,10,2655,6871,0,0,0,0,1,1
6255,10,2656,6872;6874;6875,0,0,0,1,2,3
6256,10,2657,5537;6876,0,0,0,2,0,2
6257,10,2658,6877;6878;6879,0,0,0,2,1,3
6258,10,2659,6881;7673,0,0,0,2,0,2
6259,10,2660,6883;6884;6885,0,0,0,1,2,3
6260,10,2661,6886;6887;6888,0,0,0,0,3,3
6261,10,2662,6889,0,0,0,0,1,1
6262,10,2666,6896,0,0,0,1,0,1
6263,10,2668,6898;6899,0,0,0,0,2,2
6264,10,2669,6900;6901,0,0,0,0,2,2
6265,10,2670,6902;8228,0,0,0,2,0,2
6266,10,2672,6906;6907,0,0,0,2,0,2
6267,10,2673,6909;6911,0,0,1,1,0,2
6268,10,2674,6912;6913;10311;10610,0,0,2,2,0,4
6269,10,2675,6915;10009;10394,0,0,2,1,0,3
6270,10,2676,6916;6917;6918,0,0,0,2,1,3
6271,10,2677,6921,0,0,0,0,1,1
6272,10,2678,6924,0,0,0,1,0,1
6273,10,2680,6926,0,0,0,0,1,1
6274,10,2681,6928,0,0,0,1,0,1
6275,10,2683,6931;6932;6933,0,0,0,3,0,3
6276,10,2684,6934;6935;6937,0,0,0,0,3,3
6277,10,2685,6938;9324,0,0,0,2,0,2
6278,10,2686,6940;6941,0,0,0,1,1,2
6279,10,2687,6942;6943,0,0,0,1,1,2
6280,10,2688,6944,0,0,0,1,0,1
6281,10,2689,6945;6946;6947;6948;6950,0,0,1,3,1,5
6282,10,2690,6923;6952;6955;10159;10363;10753,0,1,3,2,0,6
6283,10,2691,6956;6957,0,0,0,0,2,2
6284,10,2692,6958,0,0,0,1,0,1
6285,10,2693,6959,0,0,0,1,0,1
6286,10,2694,6961;9886,0,0,0,2,0,2
6287,10,2695,6962;6963,0,0,0,0,2,2
6288,10,2697,3495;6965,0,0,0,2,0,2
6289,10,2698,5534;6967,0,0,0,2,0,2
6290,10,2699,6968;6969;6971;10149;10943,0,1,1,3,0,5
6291,10,2700,6972;6973,0,0,0,2,0,2
6292,10,2701,6975;6976,0,0,0,1,1,2
6293,10,2702,6977;6978,0,0,0,1,1,2
6294,10,2703,6979;6980;6981,0,0,0,2,1,3
6295,10,2704,6985,0,0,0,1,0,1
6296,10,2705,6987;6988;6990;6991;10814,0,1,2,1,1,5
6297,10,2706,6992;6994;6995,0,0,0,2,1,3
6298,10,2708,6998;7000,0,0,0,1,1,2
6299,10,2709,7002;7003,0,0,0,1,1,2
6300,10,2710,7004,0,0,0,0,1,1
6301,10,2712,7006,0,0,0,0,1,1
6302,10,2713,7010;7011,0,0,0,1,1,2
6303,10,2714,7014;7016,0,0,1,0,1,2
6304,10,2715,7017;7018;7019;7020,0,0,0,4,0,4
6305,10,2716,7022;7023;7024,0,0,0,2,1,3
6306,10,2717,4178;7026,0,0,0,2,0,2
6307,10,2718,7027;7028;7029;10158,0,0,1,3,0,4
6308,10,2719,7033;7036,0,0,0,1,1,2
6309,10,2720,7038;7039;7040,0,0,1,1,1,3
6310,10,2721,7042,0,0,0,0,1,1
6311,10,2722,7043;7044,0,0,0,2,0,2
6312,10,2723,7045;10431;10524;10576,0,0,3,1,0,4
6313,10,2724,4887;9771,0,0,0,2,0,2
6314,10,2725,7047;7048;10379;10606,0,0,2,2,0,4
6315,10,2726,7049;7050;9190,0,0,0,1,2,3
6316,10,2727,7052;7053;7054,0,0,1,0,2,3
6317,10,2728,7055,0,0,0,0,1,1
6318,10,2729,7056;7057,0,0,0,1,1,2
6319,10,2730,7059,0,0,0,1,0,1
6320,10,2731,7061,0,0,0,0,1,1
6321,10,2732,7062;7063,0,0,0,1,1,2
6322,10,2733,7064,0,0,0,1,0,1
6323,10,2734,7065;7067;7068,0,0,0,1,2,3
6324,10,2735,7069;7070;7073,0,0,0,1,2,3
6325,10,2737,7080;7081;7082,0,0,0,3,0,3
6326,10,2738,7083;7084,0,0,0,0,2,2
6327,10,2739,7085,0,0,0,1,0,1
6328,10,2741,7089,0,0,0,1,0,1
6329,10,2742,7090;7091,0,0,0,1,1,2
6330,10,2743,5481;7092,0,0,0,2,0,2
6331,10,2744,7094;9321;10082;10774,0,1,1,2,0,4
6332,10,2745,7095;7096;7097;7098;10220;10310;10352;10751,0,1,5,1,1,8
6333,10,2746,7099;7100;7101,0,0,0,2,1,3
6334,10,2747,7103,0,0,0,0,1,1
6335,10,2748,7104,0,0,0,1,0,1
6336,10,2750,7111;7112,0,0,0,2,0,2
6337,10,2751,7113;7115,0,0,1,1,0,2
6338,10,2752,7117;7119,0,0,0,1,1,2
6339,10,2753,7120;7121,0,0,0,1,1,2
6340,10,2754,7122;7123;7124;8759,0,0,0,3,1,4
6341,10,2755,7125;7127;7128,0,0,0,2,1,3
6342,10,2756,7130;7131,0,0,0,1,1,2
6343,10,2758,7133,0,0,0,1,0,1
6344,10,2759,2913;7135;10163;10316;10867,0,1,2,2,0,5
6345,10,2761,7139;7140;7141;7142,0,0,1,3,0,4
6346,10,2763,7146;7147;10291,0,0,1,1,1,3
6347,10,2764,7148;7149;7150;7151,0,0,1,2,1,4
6348,10,2765,7153;8362,0,0,0,2,0,2
6349,10,2766,7154;7155;7156;7157;7158,0,0,1,4,0,5
6350,10,2769,1922;7162;7163;10459;10727,0,1,2,2,0,5
6351,10,2770,5582;10500,0,0,1,1,0,2
6352,10,2771,2687;7165,0,0,0,2,0,2
6353,10,2772,7167;7257;10035;10148,0,0,3,1,0,4
6354,10,2773,7169;7171;7172,0,0,0,1,2,3
6355,10,2775,7174;7176;7177,0,0,2,1,0,3
6356,10,2776,7178;7179,0,0,0,2,0,2
6357,10,2778,7183;7184,0,0,0,1,1,2
6358,10,2779,7186,0,0,0,0,1,1
6359,10,2780,4356,0,0,0,0,1,1
6360,10,2782,5123;7189;7191;7193,0,0,1,3,0,4
6361,10,2783,7194,0,0,0,0,1,1
6362,10,2784,7195;7196;7197,0,0,1,1,1,3
6363,10,2785,7198;7199;10574;11063,0,1,1,2,0,4
6364,10,2787,7202;7203,0,0,0,1,1,2
6365,10,2788,7204;7205,0,0,0,1,1,2
6366,10,2789,7208,0,0,0,0,1,1
6367,10,2790,7209,0,0,0,0,1,1
6368,10,2791,5183;6648;7211;7212,0,0,0,4,0,4
6369,10,2792,7214;7215;7216,0,0,0,2,1,3
6370,10,2793,7217,0,0,0,0,1,1
6371,10,2794,7218;7219,0,0,0,1,1,2
6372,10,2795,7220,0,0,0,0,1,1
6373,10,2796,7224;7225,0,0,0,1,1,2
6374,10,2797,7228;7229,0,0,0,2,0,2
6375,10,2798,7230;7231,0,0,0,0,2,2
6376,10,2799,6745;7232,0,0,0,1,1,2
6377,10,2800,7233;7238,0,0,0,1,1,2
6378,10,2801,7239,0,0,0,0,1,1
6379,10,2802,7241;9495;10107;10146;10873;11136,0,2,2,2,0,6
6380,10,2803,7242;7243,0,0,0,1,1,2
6381,10,2805,7245,0,0,0,1,0,1
6382,10,2806,7248,0,0,0,0,1,1
6383,10,2807,7250,0,0,0,0,1,1
6384,10,2808,7251,0,0,0,0,1,1
6385,10,2809,4235;7252;7253;10223;10338;10482;11177,0,1,4,2,0,7
6386,10,2811,2251;7258;10571,0,0,1,2,0,3
6387,10,2812,7260,0,0,0,0,1,1
6388,10,2813,7262,0,0,0,0,1,1
6389,10,2814,7263,0,0,0,1,0,1
6390,10,2815,7265;7266,0,0,0,2,0,2
6391,10,2816,7268,0,0,0,1,0,1
6392,10,2817,2663;7269,0,0,0,2,0,2
6393,10,2818,7270;7271,0,0,0,1,1,2
6394,10,2819,7273;7274;7276,0,0,0,3,0,3
6395,10,2820,7277;10770;11087,0,2,0,1,0,3
6396,10,2821,1808;7279;7280,0,0,1,1,1,3
6397,10,2822,7281,0,0,0,0,1,1
6398,10,2823,7282;7284,0,0,0,1,1,2
6399,10,2826,7289;7290,0,0,0,0,2,2
6400,10,2827,7291;7292;7295,0,0,1,0,2,3
6401,10,2828,7296,0,0,0,1,0,1
6402,10,2830,7299;7300,0,0,0,2,0,2
6403,10,2831,7301;7304,0,0,1,0,1,2
6404,10,2832,7305;7306;7307,0,0,0,2,1,3
6405,10,2833,7309;7310;7311,0,0,2,0,1,3
6406,10,2835,7314;7315;7316,0,0,2,0,1,3
6407,10,2836,7318;7706,0,0,0,2,0,2
6408,10,2838,7320;7322;7323;7324,0,0,2,1,1,4
6409,10,2839,7325;10005;10295;10607;11094,0,1,3,1,0,5
6410,10,2840,7327,0,0,0,0,1,1
6411,10,2841,7328;7332,0,0,0,1,1,2
6412,10,2842,5752;7333,0,0,0,1,1,2
6413,10,2843,7334,0,0,0,0,1,1
6414,10,2845,7337,0,0,0,0,1,1
6415,10,2846,7338;7339;7340;7342;7344,0,0,1,4,0,5
6416,10,2848,7347;7348,0,0,0,2,0,2
6417,10,2850,7350;7351;7352,0,0,0,1,2,3
6418,10,2851,7355;10400;10566,0,0,2,1,0,3
6419,10,2852,7356;7357,0,0,0,1,1,2
6420,10,2853,7358;7360,0,0,0,2,0,2
6421,10,2854,702;7362,0,0,0,2,0,2
6422,10,2855,597;7364;10073;10183,0,0,2,2,0,4
6423,10,2856,7365;7366,0,0,0,0,2,2
6424,10,2857,7369,0,0,0,0,1,1
6425,10,2858,7371;7373,0,0,1,0,1,2
6426,10,2859,7374;7375,0,0,0,0,2,2
6427,10,2860,7377,0,0,0,0,1,1
6428,10,2862,7380;7383,0,0,1,1,0,2
6429,10,2863,7384;7385;10580;11127,0,1,1,2,0,4
6430,10,2864,1353;7386,0,0,0,2,0,2
6431,10,2865,7387;7388,0,0,0,1,1,2
6432,10,2867,7392;7393;7395;7396,0,0,2,0,2,4
6433,10,2869,5170;7399;8890;10755;10927,0,2,0,3,0,5
6434,10,2870,7400;7401;7402;7404;7405,0,0,2,3,0,5
6435,10,2871,7406;10117;10235;10446,0,0,3,1,0,4
6436,10,2872,7407;7408;7410,0,0,1,0,2,3
6437,10,2873,7412,0,0,0,1,0,1
6438,10,2874,7413;7415,0,0,0,1,1,2
6439,10,2875,7416;7418,0,0,0,2,0,2
6440,10,2876,7422,0,0,0,0,1,1
6441,10,2878,7427,0,0,0,1,0,1
6442,10,2879,1948;7429;10987;11187,0,2,0,2,0,4
6443,10,2880,7432,0,0,0,0,1,1
6444,10,2882,7437;7438;7439;7440,0,0,2,1,1,4
6445,10,2883,7442;7443;7444;7445,0,0,3,1,0,4
6446,10,2884,7446,0,0,0,0,1,1
6447,10,2885,6238;7448;7449,0,0,1,0,2,3
6448,10,2886,7451,0,0,0,0,1,1
6449,10,2887,7453,0,0,0,1,0,1
6450,10,2888,7454;7455,0,0,0,1,1,2
6451,10,2891,7458;7459;7460,0,0,0,3,0,3
6452,10,2892,7462;7465;7466,0,0,0,2,1,3
6453,10,2893,7467;10043,0,0,1,1,0,2
6454,10,2894,7468;7469,0,0,0,1,1,2
6455,10,2895,2324;8772,0,0,0,2,0,2
6456,10,2896,7471;7472;10053;10128;10292;10549;10682,0,1,4,2,0,7
6457,10,2897,7476;7477,0,0,0,1,1,2
6458,10,2898,7478;7479,0,0,0,0,2,2
6459,10,2899,7457;7480;7481,0,0,1,2,0,3
6460,10,2900,7482;10345;10462;10650,0,1,2,1,0,4
6461,10,2902,7486;7487,0,0,0,0,2,2
6462,10,2903,7489;7490,0,0,0,2,0,2
6463,10,2904,7491,0,0,0,0,1,1
6464,10,2905,7493;7494;7496;8590,0,0,0,4,0,4
6465,10,2906,7497;7498;7499;7500,0,0,0,4,0,4
6466,10,2907,7501;7503;10049;10275;10912,0,1,2,2,0,5
6467,10,2908,7504;7809,0,0,0,2,0,2
6468,10,2909,7507;7509;7510,0,0,1,1,1,3
6469,10,2910,7511,0,0,0,0,1,1
6470,10,2911,7513,0,0,0,0,1,1
6471,10,2912,7514,0,0,0,1,0,1
6472,10,2913,7518;7519;7520;7521,0,0,0,2,2,4
6473,10,2914,7522,0,0,0,0,1,1
6474,10,2915,7526;10144;10341;11137,0,1,2,1,0,4
6475,10,2916,7529;7530,0,0,1,1,0,2
6476,10,2917,7531,0,0,0,0,1,1
6477,10,2918,7533;7534,0,0,0,1,1,2
6478,10,2919,7536;7537;7539,0,0,0,1,2,3
6479,10,2920,7540,0,0,0,1,0,1
6480,10,2921,7541;9835;10259;10562,0,0,2,2,0,4
6481,10,2922,7544,0,0,0,0,1,1
6482,10,2923,7545,0,0,0,0,1,1
6483,10,2924,7549;7550,0,0,1,0,1,2
6484,10,2925,7551;7552;7553;7555,0,0,1,1,2,4
6485,10,2926,7556,0,0,0,1,0,1
6486,10,2927,7558;7560;7561,0,0,0,1,2,3
6487,10,2929,7564;7565,0,0,0,0,2,2
6488,10,2930,7566;7568,0,0,0,1,1,2
6489,10,2931,7571,0,0,0,1,0,1
6490,10,2933,7574;7575,0,0,0,2,0,2
6491,10,2934,7576,0,0,0,0,1,1
6492,10,2935,7577,0,0,0,0,1,1
6493,10,2936,7580,0,0,0,0,1,1
6494,10,2937,7581;7584,0,0,0,0,2,2
6495,10,2938,7586,0,0,0,1,0,1
6496,10,2939,7587,0,0,0,1,0,1
6497,10,2940,1346;7589,0,0,0,2,0,2
6498,10,2941,7590;7591,0,0,0,1,1,2
6499,10,2942,7593;7594;7596,0,0,0,1,2,3
6500,10,2944,7599,0,0,0,1,0,1
6501,10,2945,7602,0,0,0,1,0,1
6502,10,2946,7605,0,0,0,1,0,1
6503,10,2947,7606;7607;10724;10948,0,2,0,2,0,4
6504,10,2948,7608,0,0,0,0,1,1
6505,10,2949,7610;7611,0,0,0,1,1,2
6506,10,2950,7613;10564,0,0,1,1,0,2
6507,10,2951,7614,0,0,0,0,1,1
6508,10,2952,7617;7619;7620;7621;7622,0,0,1,3,1,5
6509,10,2953,7626,0,0,0,0,1,1
6510,10,2954,7627;7628,0,0,0,2,0,2
6511,10,2956,7631;7632;7634,0,0,1,0,2,3
6512,10,2957,7635;7636,0,0,0,1,1,2
6513,10,2958,7637;7638,0,0,0,1,1,2
6514,10,2960,7640;7641,0,0,0,1,1,2
6515,10,2962,3168;7646,0,0,0,2,0,2
6516,10,2963,7647;7648,0,0,0,1,1,2
6517,10,2964,7649,0,0,0,0,1,1
6518,10,2965,2130;7651;10370;10704;10936,0,2,1,2,0,5
6519,10,2966,7562;7652;7653,0,0,0,1,2,3
6520,10,2967,7655;7656,0,0,0,1,1,2
6521,10,2968,7659;7660;7662,0,0,0,2,1,3
6522,10,2969,1615;7664;7665,0,0,1,2,0,3
6523,10,2970,7666,0,0,0,0,1,1
6524,10,2971,7667,0,0,0,1,0,1
6525,10,2972,7668,0,0,0,1,0,1
6526,10,2973,7674,0,0,0,0,1,1
6527,10,2974,7677;7678;7679,0,0,0,1,2,3
6528,10,2975,3821;7680;7681;7683,0,0,0,4,0,4
6529,10,2979,7688;7689,0,0,0,0,2,2
6530,10,2981,7694;7695;7696;7697;7698,0,0,1,4,0,5
6531,10,2982,7699;7700;10916,0,1,0,2,0,3
6532,10,2983,4171;7702;7704,0,0,0,3,0,3
6533,10,2985,7707;7708;7709,0,0,1,2,0,3
6534,10,2986,7711,0,0,0,1,0,1
6535,10,2988,7714;7715,0,0,0,1,1,2
6536,10,2989,7716;7717,0,0,0,1,1,2
6537,10,2990,7379;7718,0,0,0,2,0,2
6538,10,2991,7719,0,0,0,0,1,1
6539,10,2993,7725;7727;7728;7729,0,0,0,3,1,4
6540,10,2994,7730;7731;7732;7733,0,0,0,2,2,4
6541,10,2996,7735;7736,0,0,0,0,2,2
6542,10,2997,7737;7738;7739;10896,0,1,0,3,0,4
6543,10,2998,7740;7741,0,0,0,1,1,2
6544,10,2999,7743,0,0,0,1,0,1
6545,10,3000,4248;7745;7747,0,0,0,3,0,3
6546,10,3002,7750;7751,0,0,0,1,1,2
6547,10,3003,7754,0,0,0,0,1,1
6548,10,3004,3898;7755,0,0,0,2,0,2
6549,10,3005,7756,0,0,0,0,1,1
6550,10,3006,7757,0,0,0,0,1,1
6551,10,3007,7758,0,0,0,0,1,1
6552,10,3008,7760;7761;7762,0,0,1,1,1,3
6553,10,3009,7764;7765;7766,0,0,2,0,1,3
6554,10,3010,2089;7767,0,0,0,2,0,2
6555,10,3011,7768;7769,0,0,0,2,0,2
6556,10,3012,7770,0,0,0,0,1,1
6557,10,3013,7771;7772;10980,0,1,0,2,0,3
6558,10,3014,7773;7774,0,0,0,1,1,2
6559,10,3015,5264;7775;7776;7777,0,0,0,4,0,4
6560,10,3016,7778;7779;7780;7781,0,0,2,1,1,4
6561,10,3017,7782;7783;7784;7785,0,0,0,4,0,4
6562,10,3018,7786,0,0,0,0,1,1
6563,10,3020,7790;7791,0,0,0,1,1,2
6564,10,3021,1166;7792;10732,0,1,0,2,0,3
6565,10,3022,7793;7794,0,0,2,0,0,2
6566,10,3023,7795;7796,0,0,0,1,1,2
6567,10,3024,7797,0,0,0,1,0,1
6568,10,3025,6332;7798;10092;10166,0,0,2,2,0,4
6569,10,3026,7800;7802;9106,0,0,0,3,0,3
6570,10,3027,7803;7805,0,0,0,1,1,2
6571,10,3028,7806;7807;7808;10050;10270,0,0,2,2,1,5
6572,10,3029,7810,0,0,0,1,0,1
6573,10,3030,7813;7814,0,0,0,0,2,2
6574,10,3031,7816;7817,0,0,0,1,1,2
6575,10,3032,7821;7822,0,0,0,0,2,2
6576,10,3033,7823;7824;7826,0,0,0,3,0,3
6577,10,3034,7830,0,0,0,0,1,1
6578,10,3036,7832,0,0,0,0,1,1
6579,10,3037,7834;7835,0,0,0,1,1,2
6580,10,3038,7837;7839,0,0,0,0,2,2
6581,10,3039,7840,0,0,0,0,1,1
6582,10,3040,7846,0,0,0,1,0,1
6583,10,3041,2076;7847,0,0,0,2,0,2
6584,10,3042,7850;7851,0,0,0,1,1,2
6585,10,3045,5404;7854;7856;10119;10882,0,1,2,2,0,5
6586,10,3046,5527;7857,0,0,0,2,0,2
6587,10,3047,7859,0,0,0,0,1,1
6588,10,3048,7861;7862,0,0,0,0,2,2
6589,10,3050,4895;7866;7867,0,0,0,2,1,3
6590,10,3051,7869;7870;7872,0,0,0,1,2,3
6591,10,3052,523;7875,0,0,0,2,0,2
6592,10,3053,2001;7876,0,0,0,2,0,2
6593,10,3054,7878;10787;11201,0,2,0,1,0,3
6594,10,3055,7879,0,0,0,1,0,1
6595,10,3056,7880;7881,0,0,0,1,1,2
6596,10,3057,380;7883,0,0,0,2,0,2
6597,10,3058,7884,0,0,0,0,1,1
6598,10,3060,7887;7888;7890,0,0,1,2,0,3
6599,10,3061,7891;7892;7893;7894,0,0,0,3,1,4
6600,10,3062,7895,0,0,0,0,1,1
6601,10,3063,7897;7898,0,0,0,1,1,2
6602,10,3064,7901,0,0,0,1,0,1
6603,10,3065,3629;7903;10241;10509;10829,0,1,2,2,0,5
6604,10,3066,7905,0,0,0,1,0,1
6605,10,3067,7907;10569;11014,0,1,1,1,0,3
6606,10,3069,7910;7911;7912;7913;7914,0,0,1,4,0,5
6607,10,3070,7075;7915;10428;10608,0,0,2,2,0,4
6608,10,3071,7916;8751;10013;10122,0,0,2,2,0,4
6609,10,3072,2017;7919;7920;10989,0,1,0,3,0,4
6610,10,3073,7922,0,0,0,0,1,1
6611,10,3074,7924;7927,0,0,0,1,1,2
6612,10,3075,7928;7929,0,0,0,2,0,2
6613,10,3076,7931;7932,0,0,0,0,2,2
6614,10,3077,7934;7935,0,0,0,1,1,2
6615,10,3079,7938;7939,0,0,0,1,1,2
6616,10,3080,7940;7943,0,0,0,0,2,2
6617,10,3081,7945;7946;7947,0,0,1,1,1,3
6618,10,3082,7948;7949;10616;10812;11126,0,2,1,2,0,5
6619,10,3083,7950;7951;10030;10263,0,0,2,2,0,4
6620,10,3084,7952,0,0,0,0,1,1
6621,10,3085,7953;7954,0,0,0,1,1,2
6622,10,3086,7955,0,0,0,0,1,1
6623,10,3087,7956;7957,0,0,0,1,1,2
6624,10,3088,7958;7959,0,0,0,0,2,2
6625,10,3089,7962;7963,0,0,0,0,2,2
6626,10,3091,7967;7968,0,0,0,0,2,2
6627,10,3092,7970;7971;7972,0,0,1,1,1,3
6628,10,3093,7974;7975,0,0,0,1,1,2
6629,10,3094,7976,0,0,0,0,1,1
6630,10,3095,7977;7978,0,0,0,1,1,2
6631,10,3096,7980,0,0,0,0,1,1
6632,10,3097,7981;7983,0,0,0,0,2,2
6633,10,3098,7984,0,0,0,0,1,1
6634,10,3099,4395;7986,0,0,0,2,0,2
6635,10,3100,7987;7990,0,0,0,2,0,2
6636,10,3101,7991;7992;7993;7994;7995;8659,0,0,0,6,0,6
6637,10,3102,6326;7996;10247;10799,0,1,1,2,0,4
6638,10,3103,8000,0,0,0,0,1,1
6639,10,3105,8003,0,0,0,0,1,1
6640,10,3107,8007,0,0,0,1,0,1
6641,10,3108,8008;8009;8010,0,0,0,3,0,3
6642,10,3109,844;8011;10729;10981,0,2,0,2,0,4
6643,10,3110,8012;8013;8014,0,0,0,3,0,3
6644,10,3111,8016,0,0,0,0,1,1
6645,10,3112,8018;8019;8020,0,0,0,3,0,3
6646,10,3113,8023;8025;8026,0,0,0,1,2,3
6647,10,3114,8029,0,0,0,1,0,1
6648,10,3115,8031;8032,0,0,0,2,0,2
6649,10,3116,8035;8036;8037;8038;8040,0,0,1,4,0,5
6650,10,3117,8041;8042,0,0,0,2,0,2
6651,10,3118,8044,0,0,0,0,1,1
6652,10,3119,8045;8046;8047,0,0,1,1,1,3
6653,10,3120,8048;8049;8050;8051;8052,0,0,2,2,1,5
6654,10,3121,8053;8054,0,0,0,0,2,2
6655,10,3122,8056;8057,0,0,1,1,0,2
6656,10,3123,8058,0,0,0,1,0,1
6657,10,3124,8059,0,0,0,0,1,1
6658,10,3126,4116;8064;8065,0,0,0,3,0,3
6659,10,3127,8066,0,0,0,1,0,1
6660,10,3128,556;8068,0,0,0,2,0,2
6661,10,3129,8069,0,0,0,0,1,1
6662,10,3130,8072;8073,0,0,0,1,1,2
6663,10,3132,8075;8076,0,0,1,0,1,2
6664,10,3133,8078,0,0,0,0,1,1
6665,10,3135,7557,0,0,0,1,0,1
6666,10,3136,8084,0,0,0,1,0,1
6667,10,3137,8085;8086;10203;10404;10615;10691;11155,0,2,3,2,0,7
6668,10,3139,8090;8091;8092,0,0,0,1,2,3
6669,10,3141,8094;8096,0,0,0,1,1,2
6670,10,3142,8097;8098;8100;10629;10938,0,1,1,2,1,5
6671,10,3143,8101,0,0,0,0,1,1
6672,10,3144,8103,0,0,0,1,0,1
6673,10,3145,5612;8104,0,0,0,2,0,2
6674,10,3146,8105,0,0,0,1,0,1
6675,10,3147,8107;8108;8109;8110;8111;10224;10320;10391,0,0,5,2,1,8
6676,10,3148,8112,0,0,0,1,0,1
6677,10,3149,8116;8117,0,0,0,1,1,2
6678,10,3150,8118;8119;8120,0,0,0,2,1,3
6679,10,3151,5653;9996;10711;11131,0,2,0,2,0,4
6680,10,3152,8126;8127,0,0,0,1,1,2
6681,10,3153,8128;8129;10078;10156;10456;10689,0,1,3,2,0,6
6682,10,3154,8131;8132;8133;10360;10483,0,0,2,3,0,5
6683,10,3155,7583;8134,0,0,0,0,2,2
6684,10,3156,8137,0,0,0,0,1,1
6685,10,3157,8138;8139,0,0,0,2,0,2
6686,10,3158,2486;8141;10003;10174;10543;10683,0,1,3,2,0,6
6687,10,3159,8142;8143;8144;8145;8146;10591,0,0,3,2,1,6
6688,10,3160,8147;8149;8150;10153;10396,0,0,3,2,0,5
6689,10,3161,8151,0,0,0,0,1,1
6690,10,3162,8153;8155,0,0,0,2,0,2
6691,10,3163,8156;10628,0,0,1,1,0,2
6692,10,3164,8158,0,0,0,1,0,1
6693,10,3165,8160,0,0,0,1,0,1
6694,10,3166,8161,0,0,0,0,1,1
6695,10,3167,8162;8164,0,0,0,2,0,2
6696,10,3168,8165;8166;8168;10133;10410,0,0,2,2,1,5
6697,10,3169,8170,0,0,0,0,1,1
6698,10,3170,8174;8175;8177,0,0,0,2,1,3
6699,10,3171,8178,0,0,0,0,1,1
6700,10,3172,7658;8179,0,0,0,2,0,2
6701,10,3173,8180;8182,0,0,0,0,2,2
6702,10,3174,8185;8186,0,0,0,0,2,2
6703,10,3175,8188,0,0,0,1,0,1
6704,10,3176,7693;8190,0,0,0,2,0,2
6705,10,3178,8193;8194,0,0,0,2,0,2
6706,10,3179,8195;8196;8197;8198,0,0,1,1,2,4
6707,10,3180,8199;8200;8201,0,0,1,0,2,3
6708,10,3182,8203,0,0,0,1,0,1
6709,10,3183,8205;8206,0,0,0,0,2,2
6710,10,3184,8207,0,0,0,1,0,1
6711,10,3185,8208,0,0,0,0,1,1
6712,10,3186,8209;8210,0,0,0,1,1,2
6713,10,3188,8212;8213,0,0,0,1,1,2
6714,10,3189,3718;8214;10427;10676,0,1,1,2,0,4
6715,10,3190,8215;8216,0,0,0,0,2,2
6716,10,3191,8217;8219;8220,0,0,1,0,2,3
6717,10,3192,8222;8223;8224,0,0,0,2,1,3
6718,10,3193,6588;8225;8226;10901;11185,0,2,0,3,0,5
6719,10,3194,8227;8229;8230,0,0,0,3,0,3
6720,10,3195,8231,0,0,0,1,0,1
6721,10,3196,8233,0,0,0,0,1,1
6722,10,3198,8235;8236;8237;8238,0,0,2,2,0,4
6723,10,3199,8239;10063;10321;10470;10688,0,1,3,1,0,5
6724,10,3200,8240,0,0,0,1,0,1
6725,10,3201,8241;8242;10200;10653,0,1,1,1,1,4
6726,10,3202,5285;8243;10014;10180;11065,0,1,2,2,0,5
6727,10,3204,8245,0,0,0,1,0,1
6728,10,3205,8247;8248;10761,0,1,0,2,0,3
6729,10,3206,8249;8250;8251;8253,0,0,0,4,0,4
6730,10,3208,8257,0,0,0,0,1,1
6731,10,3209,8258,0,0,0,0,1,1
6732,10,3210,8259,0,0,0,0,1,1
6733,10,3211,8261,0,0,0,1,0,1
6734,10,3212,8263;10021;10124;10437,0,0,3,1,0,4
6735,10,3213,8265,0,0,0,0,1,1
6736,10,3214,8266;8267;8268;8269;8270;8272;8273,0,0,0,7,0,7
6737,10,3215,5700;8274,0,0,0,2,0,2
6738,10,3216,8275;8276;8278,0,0,1,2,0,3
6739,10,3218,2878;8281;8282;8283,0,0,0,3,1,4
6740,10,3219,2212;8286;8288,0,0,1,2,0,3
6741,10,3220,8289;8290,0,0,0,1,1,2
6742,10,3221,8293;8294,0,0,0,1,1,2
6743,10,3222,8295;8296,0,0,0,0,2,2
6744,10,3223,8298;9576,0,0,0,2,0,2
6745,10,3224,8299,0,0,0,0,1,1
6746,10,3225,8300;8301;8302,0,0,1,0,2,3
6747,10,3227,8304;8305;8306,0,0,0,3,0,3
6748,10,3228,8309;8310,0,0,0,1,1,2
6749,10,3229,8313,0,0,0,0,1,1
6750,10,3230,8316;8317,0,0,0,1,1,2
6751,10,3232,8321;8323;8324,0,0,0,2,1,3
6752,10,3234,8327;8328,0,0,1,1,0,2
6753,10,3235,8329;8332,0,0,0,1,1,2
6754,10,3236,8333;8334;11194,0,1,0,1,1,3
6755,10,3237,2189;8337;11060;11181,0,2,0,2,0,4
6756,10,3238,8339;8340;10118;10452,0,0,2,1,1,4
6757,10,3239,8342;8343,0,0,0,1,1,2
6758,10,3240,8344;8345,0,0,0,2,0,2
6759,10,3241,8347,0,0,0,0,1,1
6760,10,3243,8350;10079;10344;10675,0,1,2,1,0,4
6761,10,3245,8354;8355,0,0,0,0,2,2
6762,10,3247,8357;8358,0,0,0,2,0,2
6763,10,3248,8359;8360,0,0,0,1,1,2
6764,10,3249,8363;8364;8365,0,0,0,1,2,3
6765,10,3250,8366,0,0,0,1,0,1
6766,10,3251,4077;8370,0,0,0,2,0,2
6767,10,3252,8371;8372,0,0,1,1,0,2
6768,10,3253,8373;8374;8375;8376,0,0,0,3,1,4
6769,10,3254,8377,0,0,0,0,1,1
6770,10,3255,8379;8380,0,0,0,1,1,2
6771,10,3256,2379;8381;8384,0,0,0,3,0,3
6772,10,3258,5959;8387;8389;10771;10891,0,2,0,3,0,5
6773,10,3259,8390,0,0,0,1,0,1
6774,10,3260,2825;8393,0,0,0,2,0,2
6775,10,3261,2506;8395;8396,0,0,0,3,0,3
6776,10,3262,8397,0,0,0,1,0,1
6777,10,3263,8400;8401;8402,0,0,0,1,2,3
6778,10,3264,8404;8405;8407;8408;8409,0,0,1,4,0,5
6779,10,3265,8410,0,0,0,0,1,1
6780,10,3266,8411;8412,0,0,0,0,2,2
6781,10,3267,8413;8414,0,0,0,1,1,2
6782,10,3268,8415;8416;8418,0,0,1,2,0,3
6783,10,3269,8419;8420;8421,0,0,1,0,2,3
6784,10,3270,8422;8424,0,0,0,1,1,2
6785,10,3271,8426;8427;10734;11209,0,2,0,2,0,4
6786,10,3272,8429,0,0,0,0,1,1
6787,10,3273,8432,0,0,0,1,0,1
6788,10,3274,95;8433,0,0,0,2,0,2
6789,10,3275,8434,0,0,0,1,0,1
6790,10,3276,8435,0,0,0,1,0,1
6791,10,3277,8436;8438,0,0,0,1,1,2
6792,10,3278,8439,0,0,0,0,1,1
6793,10,3279,8441;8442,0,0,0,2,0,2
6794,10,3280,8444,0,0,0,0,1,1
6795,10,3281,8447;8448,0,0,0,2,0,2
6796,10,3282,7474;8450,0,0,0,2,0,2
6797,10,3283,8452,0,0,0,1,0,1
6798,10,3284,8453;8454,0,0,0,0,2,2
6799,10,3285,8457;8458;8459,0,0,0,1,2,3
6800,10,3286,8460,0,0,0,0,1,1
6801,10,3287,8462,0,0,0,1,0,1
6802,10,3288,8464;8465;10392;10876;11217,0,2,1,2,0,5
6803,10,3289,8467;8468;8469;8470,0,0,0,3,1,4
6804,10,3290,8471;8472;8474,0,0,1,0,2,3
6805,10,3291,8475;8476,0,0,0,1,1,2
6806,10,3292,8477,0,0,0,0,1,1
6807,10,3293,8482,0,0,0,0,1,1
6808,10,3295,8485;8486,0,0,0,0,2,2
6809,10,3296,8491;8493;8494,0,0,0,2,1,3
6810,10,3297,8495;8496;8497;8498,0,0,0,3,1,4
6811,10,3298,8499;8500,0,0,0,1,1,2
6812,10,3299,8503,0,0,0,1,0,1
6813,10,3301,8506;9080,0,0,0,2,0,2
6814,10,3302,8507,0,0,0,0,1,1
6815,10,3303,8508;8509,0,0,0,2,0,2
6816,10,3304,8510;8511,0,0,0,2,0,2
6817,10,3305,6162;8513;8514;8515;8516,0,0,0,5,0,5
6818,10,3306,8518;8520,0,0,0,1,1,2
6819,10,3309,8525;8527,0,0,0,2,0,2
6820,10,3310,8528,0,0,0,0,1,1
6821,10,3311,8529,0,0,0,0,1,1
6822,10,3312,8531,0,0,0,0,1,1
6823,10,3314,8533;8534;8535,0,0,0,1,2,3
6824,10,3315,8536;8537;8539,0,0,0,2,1,3
6825,10,3316,8540;8542;10550;10721;11083,0,2,1,2,0,5
6826,10,3317,8544;8548;8549,0,0,0,1,2,3
6827,10,3318,8550;8551;8553,0,0,1,2,0,3
6828,10,3319,8554;8555;8556,0,0,1,1,1,3
6829,10,3320,593;8557,0,0,0,2,0,2
6830,10,3321,8558;8559;8560,0,0,0,3,0,3
6831,10,3323,5353;8564;8565,0,0,0,3,0,3
6832,10,3324,7173;8569,0,0,0,2,0,2
6833,10,3326,8571;8572;8573,0,0,0,2,1,3
6834,10,3328,8575,0,0,0,0,1,1
6835,10,3330,8579,0,0,0,0,1,1
6836,10,3331,8580,0,0,0,1,0,1
6837,10,3332,8582,0,0,0,1,0,1
6838,10,3333,6048;8585,0,0,0,1,1,2
6839,10,3334,8586,0,0,0,0,1,1
6840,10,3335,8587;8588;8589;8591,0,0,0,3,1,4
6841,10,3336,8593;8594,0,0,0,1,1,2
6842,10,3337,8597,0,0,0,0,1,1
6843,10,3338,8599;8600,0,0,0,2,0,2
6844,10,3339,8601;8603;8604,0,0,0,1,2,3
6845,10,3340,8605,0,0,0,0,1,1
6846,10,3341,8607,0,0,0,1,0,1
6847,10,3342,8608;8609,0,0,0,1,1,2
6848,10,3343,195;7110;8611;8612;10563,0,0,3,2,0,5
6849,10,3344,8613,0,0,0,1,0,1
6850,10,3345,8614;8615;8616,0,0,0,2,1,3
6851,10,3346,8620;8621;8624,0,0,0,2,1,3
6852,10,3347,8625;8626;8629,0,0,0,3,0,3
6853,10,3348,8630;8631,0,0,0,1,1,2
6854,10,3349,8632;8634,0,0,0,0,2,2
6855,10,3351,2910;8636;8637;8638,0,0,1,2,1,4
6856,10,3352,8639;8640;8641;8642;8643,0,0,0,3,2,5
6857,10,3353,8645;8646,0,0,0,2,0,2
6858,10,3354,8647;8648;8649;8650,0,0,0,3,1,4
6859,10,3355,8651;8652,0,0,0,1,1,2
6860,10,3356,8653;8654,0,0,0,1,1,2
6861,10,3357,8655;8656,0,0,0,1,1,2
6862,10,3358,8658,0,0,0,1,0,1
6863,10,3361,8661;8663;8664;8665,0,0,0,1,3,4
6864,10,3362,5493;8666,0,0,0,1,1,2
6865,10,3363,8667,0,0,0,0,1,1
6866,10,3364,8669,0,0,0,0,1,1
6867,10,3365,8670;8671,0,0,0,1,1,2
6868,10,3366,8673;8674;8675,0,0,0,2,1,3
6869,10,3368,8682,0,0,0,1,0,1
6870,10,3370,8687;8688,0,0,0,1,1,2
6871,10,3371,8689,0,0,0,1,0,1
6872,10,3372,8690;8692,0,0,0,1,1,2
6873,10,3373,8693;8694,0,0,0,1,1,2
6874,10,3374,8695;8696;8697;8698,0,0,2,1,1,4
6875,10,3375,8699;8700;8701,0,0,1,0,2,3
6876,10,3376,8563;8702;8703,0,0,1,2,0,3
6877,10,3379,8706;8707,0,0,0,2,0,2
6878,10,3380,8708,0,0,0,1,0,1
6879,10,3381,8709;8711,0,0,0,1,1,2
6880,10,3382,8713;8715,0,0,0,0,2,2
6881,10,3383,4496;8717;8721,0,0,1,2,0,3
6882,10,3384,8722;8723;10103;10150;10170;10288,0,0,4,2,0,6
6883,10,3385,7170;8724,0,0,0,2,0,2
6884,10,3386,1292;8726,0,0,0,2,0,2
6885,10,3387,5224;8728;10019;10631,0,0,2,2,0,4
6886,10,3388,8729;8730,0,0,0,2,0,2
6887,10,3389,8731,0,0,0,1,0,1
6888,10,3390,8732;8733,0,0,0,1,1,2
6889,10,3391,8734,0,0,0,0,1,1
6890,10,3392,8736;8737,0,0,0,1,1,2
6891,10,3393,8739;8741,0,0,0,1,1,2
6892,10,3394,8742,0,0,0,0,1,1
6893,10,3395,7182;8745;8746,0,0,0,2,1,3
6894,10,3396,8748;8749;10293;10849,0,1,1,2,0,4
6895,10,3397,8750;8752,0,0,0,1,1,2
6896,10,3398,8754;8755;8756;11166,0,1,0,2,1,4
6897,10,3399,8760,0,0,0,1,0,1
6898,10,3400,8761;8762,0,0,0,2,0,2
6899,10,3401,8763;8764,0,0,0,2,0,2
6900,10,3402,8765,0,0,0,0,1,1
6901,10,3403,8769;8771;9659,0,0,0,2,1,3
6902,10,3404,8773;8774,0,0,0,2,0,2
6903,10,3405,8775;8776,0,0,0,1,1,2
6904,10,3406,8778;8779;8780,0,0,0,2,1,3
6905,10,3407,8782;8783;8785,0,0,0,2,1,3
6906,10,3408,8786;8787,0,0,0,0,2,2
6907,10,3409,8788,0,0,0,0,1,1
6908,10,3410,8789,0,0,0,0,1,1
6909,10,3411,8790;8791,0,0,0,1,1,2
6910,10,3412,8792,0,0,0,1,0,1
6911,10,3413,8794;8797;8799,0,0,0,2,1,3
6912,10,3415,8802;8803,0,0,0,2,0,2
6913,10,3416,8804;8805;8806;10245;10581;10838,0,1,2,3,0,6
6914,10,3417,8810,0,0,0,0,1,1
6915,10,3418,8811;8813;8815,0,0,0,2,1,3
6916,10,3420,8817;8819;8820;8823,0,0,0,2,2,4
6917,10,3421,8824;8825;8827,0,0,0,3,0,3
6918,10,3422,8828;8829,0,0,0,2,0,2
6919,10,3423,8832;8833,0,0,0,2,0,2
6920,10,3424,8121;8834;10096,0,0,1,2,0,3
6921,10,3425,8835;8837;8839;8840,0,0,2,0,2,4
6922,10,3426,8841;8842,0,0,0,2,0,2
6923,10,3427,8843;8844;8845;10189;10402,0,0,2,3,0,5
6924,10,3428,8846,0,0,0,0,1,1
6925,10,3429,8847,0,0,0,0,1,1
6926,10,3431,8852;8853;8854,0,0,1,2,0,3
6927,10,3432,3222;8857;8858,0,0,0,3,0,3
6928,10,3433,8437;8860,0,0,0,2,0,2
6929,10,3434,5884;8861,0,0,0,2,0,2
6930,10,3435,8862,0,0,1,0,0,1
6931,10,3436,1996;8863,0,0,0,2,0,2
6932,10,3437,8866,0,0,0,0,1,1
6933,10,3438,8868,0,0,0,1,0,1
6934,10,3439,6215;8870,0,0,0,2,0,2
6935,10,3440,8872;8873,0,0,0,0,2,2
6936,10,3441,5094;8874,0,0,0,2,0,2
6937,10,3442,8875;8877;8878;9792,0,0,2,2,0,4
6938,10,3445,8882,0,0,0,1,0,1
6939,10,3446,8883;8884;8885;8886,0,0,2,2,0,4
6940,10,3447,8888,0,0,0,1,0,1
6941,10,3448,8891;8892;8893;8894,0,0,0,4,0,4
6942,10,3449,8895;10816;11109,0,2,0,1,0,3
6943,10,3450,4918;8897;8899,0,0,0,3,0,3
6944,10,3451,8900;8901,0,0,0,1,1,2
6945,10,3452,8906,0,0,0,1,0,1
6946,10,3453,8907,0,0,0,1,0,1
6947,10,3454,8910;8912,0,0,0,1,1,2
6948,10,3456,8914;8915,0,0,0,2,0,2
6949,10,3457,8917,0,0,0,0,1,1
6950,10,3458,8918;8919,0,0,0,2,0,2
6951,10,3459,8920,0,0,0,1,0,1
6952,10,3460,8923,0,0,0,0,1,1
6953,10,3461,4190;8926,0,0,0,2,0,2
6954,10,3462,8929;8930;8931;8932,0,0,0,3,1,4
6955,10,3463,8933;8935,0,0,0,0,2,2
6956,10,3464,8937,0,0,0,1,0,1
6957,10,3465,8938;8939,0,0,0,1,1,2
6958,10,3467,8941;8942;10085;10176,0,0,2,2,0,4
6959,10,3468,8943,0,0,0,1,0,1
6960,10,3469,8945;8947;8949,0,0,1,0,2,3
6961,10,3470,8952;8979,0,0,0,2,0,2
6962,10,3471,8955;8956,0,0,0,0,2,2
6963,10,3472,8958,0,0,0,1,0,1
6964,10,3473,8961,0,0,0,0,1,1
6965,10,3474,8963,0,0,0,0,1,1
6966,10,3475,8341;8965;8967,0,0,1,2,0,3
6967,10,3476,8968;8969,0,0,0,2,0,2
6968,10,3477,8970,0,0,0,1,0,1
6969,10,3478,8972;8973,0,0,0,0,2,2
6970,10,3479,8974;8978,0,0,1,0,1,2
6971,10,3482,8982;8983;8984;8986,0,0,0,2,2,4
6972,10,3483,8988;8989,0,0,0,1,1,2
6973,10,3484,8990,0,0,0,0,1,1
6974,10,3485,5372;8991;10036,0,0,1,2,0,3
6975,10,3487,8995;8996;8998,0,0,1,1,1,3
6976,10,3488,7159;9000,0,0,0,2,0,2
6977,10,3489,9002;9003,0,0,0,2,0,2
6978,10,3490,9004;9005;9007;9008;9009,0,0,0,3,2,5
6979,10,3491,9010;9011,0,0,0,0,2,2
6980,10,3492,9012;9013,0,0,0,0,2,2
6981,10,3493,9014;9015;9016;10114,0,0,1,3,0,4
6982,10,3494,9018,0,0,0,0,1,1
6983,10,3495,9019;9020;9021,0,0,0,3,0,3
6984,10,3496,9022;9023,0,0,0,2,0,2
6985,10,3497,9024;9025,0,0,0,1,1,2
6986,10,3499,9027;9028,0,0,0,1,1,2
6987,10,3500,9029,0,0,0,0,1,1
6988,10,3501,9030;9031;9033,0,0,0,2,1,3
6989,10,3502,4485;9034,0,0,0,2,0,2
6990,10,3503,9035;9036;9037,0,0,1,2,0,3
6991,10,3504,9038;9039;9040;9042;9043,0,0,2,2,1,5
6992,10,3505,9044;9046,0,0,1,0,1,2
6993,10,3506,9048;9049,0,0,0,0,2,2
6994,10,3507,1673;9050;10106;10601;10658,0,1,2,2,0,5
6995,10,3508,9051,0,0,0,0,1,1
6996,10,3509,9052;9053,0,0,0,1,1,2
6997,10,3510,9054;9055;9056;10069;10301;10435;10632,0,0,5,1,1,7
6998,10,3511,9057,0,0,0,0,1,1
6999,10,3512,9060,0,0,0,1,0,1
7000,10,3514,9064;9704;10276;10340;10630,0,0,3,2,0,5
7001,10,3515,1850;9065,0,0,0,2,0,2
7002,10,3516,9067;9068;9069,0,0,0,3,0,3
7003,10,3517,423;9070;10059;10387;10584;11175,0,1,3,2,0,6
7004,10,3518,9071;9073;9074,0,0,0,0,3,3
7005,10,3519,9076;9078;10647;10940,0,2,0,2,0,4
7006,10,3520,9079;9081;9082,0,0,0,1,2,3
7007,10,3521,3970;9083,0,0,0,1,1,2
7008,10,3522,9085;9087,0,0,0,0,2,2
7009,10,3523,8114,0,0,0,1,0,1
7010,10,3525,9091;9092,0,0,0,1,1,2
7011,10,3526,9093;9094,0,0,0,1,1,2
7012,10,3527,9095;9096;9098;9099,0,0,2,0,2,4
7013,10,3528,9100;9101;9102,0,0,0,2,1,3
7014,10,3529,9104;9107,0,0,0,1,1,2
7015,10,3530,9109,0,0,0,0,1,1
7016,10,3531,9110;9111;9114,0,0,0,1,2,3
7017,10,3532,8022;9116;9117;9118,0,0,1,3,0,4
7018,10,3533,9120;9121,0,0,0,1,1,2
7019,10,3535,9124,0,0,0,0,1,1
7020,10,3536,9128;9129,0,0,0,2,0,2
7021,10,3537,9130;9131;10018;10587;10715,0,1,2,1,1,5
7022,10,3538,9132;9133;9134,0,0,0,1,2,3
7023,10,3539,9135;9137;9138,0,0,0,1,2,3
7024,10,3540,9140;9141,0,0,0,2,0,2
7025,10,3542,8080;9143,0,0,0,2,0,2
7026,10,3543,9146,0,0,0,1,0,1
7027,10,3544,9147,0,0,0,0,1,1
7028,10,3545,9149;9150;9151,0,0,2,0,1,3
7029,10,3547,9153;9154,0,0,0,1,1,2
7030,10,3548,9155;9156,0,0,0,0,2,2
7031,10,3549,9157;9158;9160;9161;9162,0,0,2,0,3,5
7032,10,3550,9163;9164;9167,0,0,0,2,1,3
7033,10,3552,9170;9171,0,0,0,1,1,2
7034,10,3553,2674;9173,0,0,0,2,0,2
7035,10,3554,9174,0,0,0,1,0,1
7036,10,3555,9176;9177,0,0,0,2,0,2
7037,10,3556,9179,0,0,0,1,0,1
7038,10,3557,9180,0,0,0,0,1,1
7039,10,3558,9181;9182,0,0,0,1,1,2
7040,10,3559,9183;9184;10374,0,0,1,2,0,3
7041,10,3560,1611;9185,0,0,0,2,0,2
7042,10,3562,9191,0,0,0,0,1,1
7043,10,3564,1360;9195;9197,0,0,2,0,1,3
7044,10,3566,9201,0,0,0,1,0,1
7045,10,3567,9202;9203,0,0,0,2,0,2
7046,10,3568,9204;9205,0,0,0,1,1,2
7047,10,3569,9206;9209;9210;9211,0,0,2,2,0,4
7048,10,3570,9212;9213;9215,0,0,0,2,1,3
7049,10,3572,9218;9220;9221,0,0,0,3,0,3
7050,10,3573,9222;9223;9225;9226;9227,0,0,0,5,0,5
7051,10,3574,9228;9229;9230;9231;9232,0,0,0,5,0,5
7052,10,3575,9233;9235,0,0,0,1,1,2
7053,10,3576,9237,0,0,0,0,1,1
7054,10,3577,9239;9240,0,0,0,1,1,2
7055,10,3578,1205;9241,0,0,0,2,0,2
7056,10,3579,9242,0,0,0,1,0,1
7057,10,3580,9243;9244;9246;9247,0,0,1,2,1,4
7058,10,3581,9248,0,0,0,1,0,1
7059,10,3582,9249;9250,0,0,0,2,0,2
7060,10,3583,9251,0,0,0,1,0,1
7061,10,3584,860,0,0,0,0,1,1
7062,10,3585,9254;9255,0,0,0,0,2,2
7063,10,3586,9258;9259,0,0,0,0,2,2
7064,10,3587,9261;9262,0,0,0,2,0,2
7065,10,3588,9263;9264;9266;9267,0,0,2,1,1,4
7066,10,3589,9268,0,0,0,1,0,1
7067,10,3590,7812;10202;10362;11006,0,1,2,1,0,4
7068,10,3591,9272;9273,0,0,0,1,1,2
7069,10,3592,9274;9275;10067;10274;10597,0,0,3,1,1,5
7070,10,3593,9276;9277,0,0,0,1,1,2
7071,10,3594,9278;9279;9280,0,0,0,1,2,3
7072,10,3595,3412;9282,0,0,0,2,0,2
7073,10,3597,9286,0,0,0,1,0,1
7074,10,3598,2733;9287,0,0,0,0,2,2
7075,10,3600,288;3824,0,0,0,2,0,2
7076,10,3601,4405;9291,0,0,0,2,0,2
7077,10,3602,9292;9293,0,0,0,1,1,2
7078,10,3603,9294;9295;10178;10355,0,0,2,2,0,4
7079,10,3604,9296;9297;9300,0,0,0,1,2,3
7080,10,3605,7804;9301;10033;10188;10693,0,1,2,2,0,5
7081,10,3606,9302;9304;10473,0,0,1,2,0,3
7082,10,3608,9306;9307,0,0,0,1,1,2
7083,10,3609,9308,0,0,0,0,1,1
7084,10,3610,9310;9311,0,0,0,0,2,2
7085,10,3611,9312;9313,0,0,0,2,0,2
7086,10,3612,303;9315;9316;9317,0,0,2,2,0,4
7087,10,3613,9318;9319;10136,0,0,1,2,0,3
7088,10,3614,9320,0,0,0,0,1,1
7089,10,3618,9327;9332,0,0,1,0,1,2
7090,10,3619,1036;9335;9336,0,0,1,2,0,3
7091,10,3620,75;9340,0,0,0,2,0,2
7092,10,3621,9341;9342,0,0,0,1,1,2
7093,10,3622,5954;9343,0,0,0,2,0,2
7094,10,3623,9345,0,0,0,1,0,1
7095,10,3624,9346,0,0,0,1,0,1
7096,10,3625,9349;9350;11009;11200,0,2,0,2,0,4
7097,10,3626,9353;9354;9357,0,0,0,1,2,3
7098,10,3628,9360;9361;10112;10236;10602;10967,0,1,3,2,0,6
7099,10,3629,9362;9363;9364;9365,0,0,2,2,0,4
7100,10,3630,9283;9285;9366;9371,0,0,0,4,0,4
7101,10,3631,9372;9373,0,0,0,2,0,2
7102,10,3632,9374;9375,0,0,0,1,1,2
7103,10,3633,9377,0,0,0,0,1,1
7104,10,3634,1732;9378,0,0,0,2,0,2
7105,10,3635,9379;9380,0,0,0,0,2,2
7106,10,3636,9381;9382,0,0,0,1,1,2
7107,10,3637,9383;9384,0,0,0,1,1,2
7108,10,3638,6226;9385,0,0,0,2,0,2
7109,10,3639,9386;9387;9388;9389;10367,0,0,1,3,1,5
7110,10,3640,3233;9390;9391;9393;9394,0,0,1,4,0,5
7111,10,3641,9395;9396,0,0,0,1,1,2
7112,10,3642,9397,0,0,0,0,1,1
7113,10,3643,9399;9400;9401,0,0,1,2,0,3
7114,10,3644,9402;9403,0,0,0,0,2,2
7115,10,3645,9404;9405;9406,0,0,0,3,0,3
7116,10,3646,9407;9408;10219;10820,0,1,1,2,0,4
7117,10,3647,4444;9409,0,0,0,2,0,2
7118,10,3648,9413;9414,0,0,0,2,0,2
7119,10,3649,8001;9416;9417;9418;9419;9420,0,0,0,6,0,6
7120,10,3650,1539;9422;9423;9424;9425,0,0,1,4,0,5
7121,10,3651,9426;9427;10315;10347;10485;10748,0,1,3,1,1,6
7122,10,3652,9430,0,0,0,0,1,1
7123,10,3653,9433,0,0,0,0,1,1
7124,10,3654,9435;9436,0,0,0,2,0,2
7125,10,3655,9437;9438,0,0,0,0,2,2
7126,10,3657,9440,0,0,0,1,0,1
7127,10,3658,9442,0,0,0,1,0,1
7128,10,3659,9444;9445,0,0,0,1,1,2
7129,10,3660,9446;9447;9450,0,0,1,0,2,3
7130,10,3662,9452;9453;9454,0,0,0,3,0,3
7131,10,3663,9456,0,0,0,0,1,1
7132,10,3664,9457;9458,0,0,0,0,2,2
7133,10,3666,9464,0,0,0,1,0,1
7134,10,3667,9465;9466,0,0,0,2,0,2
7135,10,3668,9468,0,0,0,0,1,1
7136,10,3669,9473,0,0,0,0,1,1
7137,10,3670,9474,0,0,0,1,0,1
7138,10,3671,9475;9476,0,0,0,1,1,2
7139,10,3672,7359;9477;10334;10777;10893;11212,0,3,1,2,0,6
7140,10,3673,9479,0,0,0,1,0,1
7141,10,3674,9481;9483;9485,0,0,0,2,1,3
7142,10,3675,9486,0,0,0,0,1,1
7143,10,3676,9492,0,0,0,0,1,1
7144,10,3677,9493;9494,0,0,0,1,1,2
7145,10,3679,9496;10017;10216,0,0,2,1,0,3
7146,10,3680,9497;9498,0,0,0,1,1,2
7147,10,3681,9502,0,0,0,0,1,1
7148,10,3682,9503,0,0,0,0,1,1
7149,10,3683,9505;9506,0,0,1,0,1,2
7150,10,3684,5628;9507;10883;11099,0,2,0,2,0,4
7151,10,3685,9509;9510;9511,0,0,0,3,0,3
7152,10,3686,2464;9512;9513;9514,0,0,1,3,0,4
7153,10,3687,9515;9518;9519;9520,0,0,3,0,1,4
7154,10,3688,419;9521;10554;10802,0,1,1,2,0,4
7155,10,3690,244;9525;10088,0,0,1,2,0,3
7156,10,3691,9530;9531,0,0,0,2,0,2
7157,10,3692,9532;9533,0,0,0,0,2,2
7158,10,3693,7936;9535,0,0,0,2,0,2
7159,10,3694,9537,0,0,0,0,1,1
7160,10,3695,9539;9540,0,0,0,0,2,2
7161,10,3696,9541;9542,0,0,0,2,0,2
7162,10,3697,9544,0,0,0,1,0,1
7163,10,3698,9545;9546,0,0,0,1,1,2
7164,10,3699,9548;9549;10303;10441;10703,0,1,2,2,0,5
7165,10,3700,9550;9551,0,0,0,2,0,2
7166,10,3701,9553,0,0,0,0,1,1
7167,10,3702,9554;10055,0,0,1,1,0,2
7168,10,3703,9555;9557,0,0,0,1,1,2
7169,10,3704,9560;9561;9562;9563;9939,0,0,1,4,0,5
7170,10,3705,9565;9566,0,0,0,2,0,2
7171,10,3706,9568,0,0,0,1,0,1
7172,10,3707,4726;9571;9573,0,0,0,3,0,3
7173,10,3708,9574;9575,0,0,0,1,1,2
7174,10,3709,9577,0,0,0,1,0,1
7175,10,3710,9578;9579;9580,0,0,1,0,2,3
7176,10,3711,9581;9582,0,0,0,1,1,2
7177,10,3712,9583;9584,0,0,0,1,1,2
7178,10,3713,9586;9587;9589;10066;10728,0,1,1,3,0,5
7179,10,3714,9591,0,0,0,0,1,1
7180,10,3715,9595;9596,0,0,0,1,1,2
7181,10,3716,9597,0,0,0,1,0,1
7182,10,3717,9599,0,0,0,1,0,1
7183,10,3718,9602;9603,0,0,0,1,1,2
7184,10,3719,9604;9605;9606;9608;10039;10042;10335;10568,0,0,5,3,0,8
7185,10,3720,9609,0,0,0,0,1,1
7186,10,3721,9610;9611,0,0,0,0,2,2
7187,10,3722,9612;9613,0,0,0,2,0,2
7188,10,3723,9614;9615,0,0,0,2,0,2
7189,10,3724,9617;9618,0,0,0,1,1,2
7190,10,3725,9619,0,0,0,1,0,1
7191,10,3726,9620;9621;10138;10523;10935,0,1,2,2,0,5
7192,10,3727,9624;9626,0,0,1,1,0,2
7193,10,3728,9627;9628,0,0,0,1,1,2
7194,10,3730,9632,0,0,0,1,0,1
7195,10,3731,9634,0,0,0,1,0,1
7196,10,3732,9635;9636,0,0,0,2,0,2
7197,10,3733,9638,0,0,0,0,1,1
7198,10,3734,9640;9641,0,0,0,1,1,2
7199,10,3735,9644,0,0,0,0,1,1
7200,10,3736,5008;9645;11139,0,1,0,2,0,3
7201,10,3737,9646;9647,0,0,0,2,0,2
7202,10,3738,9650,0,0,0,0,1,1
7203,10,3739,9653;9654;9655,0,0,2,1,0,3
7204,10,3740,9656;9657,0,0,0,2,0,2
7205,10,3741,9658,0,0,0,1,0,1
7206,10,3743,9661,0,0,0,0,1,1
7207,10,3744,3891;9663;9665;9667,0,0,1,3,0,4
7208,10,3745,9668,0,0,0,0,1,1
7209,10,3747,9670;9671,0,0,0,2,0,2
7210,10,3748,9672;9673,0,0,0,1,1,2
7211,10,3749,9674;9675;9676,0,0,0,2,1,3
7212,10,3750,9679;9680,0,0,0,1,1,2
7213,10,3751,9682;9683,0,0,0,1,1,2
7214,10,3752,9685;9686;9687;9688;9689,0,0,2,2,1,5
7215,10,3753,9690;9691;9692;9693;9694,0,0,0,4,1,5
7216,10,3754,9695;9696,0,0,0,1,1,2
7217,10,3755,9698;9699,0,0,0,0,2,2
7218,10,3756,9700;9701,0,0,0,2,0,2
7219,10,3757,9703,0,0,0,0,1,1
7220,10,3758,9705,0,0,0,1,0,1
7221,10,3759,7615;9708;9709;9710,0,0,2,2,0,4
7222,10,3760,9711;9712,0,0,0,1,1,2
7223,10,3761,9713,0,0,0,1,0,1
7224,10,3762,9715;9716,0,0,0,1,1,2
7225,10,3763,9717;9718;9719;9720;9722,0,0,1,1,3,5
7226,10,3765,9724;9726;9728;9729,0,0,2,2,0,4
7227,10,3766,9491;9730,0,0,0,2,0,2
7228,10,3767,9731,0,0,0,0,1,1
7229,10,3768,9732,0,0,0,0,1,1
7230,10,3769,9733;9734;9735;9736,0,0,2,0,2,4
7231,10,3770,9737;9738;9740;9741,0,0,2,1,1,4
7232,10,3771,9742,0,0,1,0,0,1
7233,10,3772,9743;9744,0,0,0,2,0,2
7234,10,3774,9747;9748;9749;9750;9751,0,0,3,1,1,5
7235,10,3775,9752;9753,0,0,0,0,2,2
7236,10,3776,3302;9755;9756,0,0,0,3,0,3
7237,10,3777,9757,0,0,0,0,1,1
7238,10,3778,9759;9760,0,0,0,0,2,2
7239,10,3779,9763;9764;9765,0,0,2,1,0,3
7240,10,3780,9766;9767;9768,0,0,0,2,1,3
7241,10,3782,9772;9773,0,0,0,2,0,2
7242,10,3783,9774;9775,0,0,0,2,0,2
7243,10,3784,9778;10463;10925,0,1,1,1,0,3
7244,10,3785,9780;9783,0,0,0,1,1,2
7245,10,3786,1985;9785;9787;9788,0,0,1,3,0,4
7246,10,3787,9789;9791,0,0,0,2,0,2
7247,10,3788,9793;9794,0,0,0,2,0,2
7248,10,3789,9795;9796;9798,0,0,0,1,2,3
7249,10,3791,2308;9801,0,0,0,2,0,2
7250,10,3792,6254;9803;9804;10312;10512;10864,0,1,2,3,0,6
7251,10,3793,9806;9807,0,0,0,0,2,2
7252,10,3794,8934;9808,0,0,0,2,0,2
7253,10,3796,9812,0,0,0,1,0,1
7254,10,3797,711;9815;9816;9818;9819,0,0,0,5,0,5
7255,10,3798,9820;9821,0,0,0,0,2,2
7256,10,3800,9823;9824;9826;9827,0,0,1,1,2,4
7257,10,3801,9832;9834,0,0,0,0,2,2
7258,10,3803,9840,0,0,0,1,0,1
7259,10,3804,9841;9842;9844,0,0,0,2,1,3
7260,10,3805,9845,0,0,0,0,1,1
7261,10,3806,7831;9846,0,0,0,0,2,2
7262,10,3809,9851;9852;9853,0,0,1,1,1,3
7263,10,3810,9855;9856,0,0,0,1,1,2
7264,10,3812,9859;9860;9861,0,0,0,2,1,3
7265,10,3813,9862;9863,0,0,0,2,0,2
7266,10,3815,9865,0,0,0,0,1,1
7267,10,3816,7414;9867;9868,0,0,0,3,0,3
7268,10,3817,9869;9870;10983;11168,0,2,0,1,1,4
7269,10,3818,9872;9873;9874,0,0,0,1,2,3
7270,10,3819,9875,0,0,0,0,1,1
7271,10,3820,9876;9877,0,0,0,2,0,2
7272,10,3821,9880;9881,0,0,0,0,2,2
7273,10,3822,213;9885;9887;9888,0,0,2,1,1,4
7274,10,3823,9889;9890;9891,0,0,1,0,2,3
7275,10,3824,9892;9893;9894,0,0,0,2,1,3
7276,10,3825,9896,0,0,0,0,1,1
7277,10,3826,7623;9899,0,0,0,2,0,2
7278,10,3827,7009;9900;11064,0,1,0,2,0,3
7279,10,3828,6703;9902,0,0,0,2,0,2
7280,10,3829,9903;9904,0,0,0,1,1,2
7281,10,3830,9905;9906,0,0,0,0,2,2
7282,10,3831,3548;9907;10389;11188,0,1,1,2,0,4
7283,10,3832,9912,0,0,0,1,0,1
7284,10,3833,9913;9914;9915,0,0,0,2,1,3
7285,10,3834,9916,0,0,0,0,1,1
7286,10,3835,9917;9918,0,0,0,1,1,2
7287,10,3837,9924;9925;9927,0,0,1,1,1,3
7288,10,3838,7346;9928;9929,0,0,1,1,1,3
7289,10,3839,9931;10977;11049,0,2,0,1,0,3
7290,10,3841,9152;9934;10222;10687,0,1,1,2,0,4
7291,10,3844,9943;9945,0,0,0,1,1,2
7292,10,3845,2060;9949;9951,0,0,0,3,0,3
7293,10,3848,9955,0,0,0,0,1,1
7294,10,3849,9956;9957,0,0,0,2,0,2
7295,10,3850,6255;9958,0,0,0,2,0,2
7296,10,3852,9960;9961,0,0,0,1,1,2
7297,10,3853,9964,0,0,0,1,0,1
7298,10,3854,9966;9967,0,0,0,0,2,2
7299,10,3855,9968;9969;9971,0,0,0,2,1,3
7300,10,3856,9972;9973;9974;9976,0,0,1,2,1,4
7301,10,3858,9979;9980,0,0,0,0,2,2
7302,10,3859,9981;9982,0,0,0,1,1,2
7303,10,3860,9983;9984;9986;9987;10498;10640,0,1,3,2,0,6
7304,10,3861,9988,0,0,0,1,0,1
7305,10,3862,9989;9991,0,0,0,1,1,2
7306,10,3863,9992;9993,0,0,0,1,1,2
7307,10,3864,9994;9997,0,0,0,0,2,2
7308,10,3865,9999;10000;10002,0,0,0,2,1,3
7309,10,3866,22;69;10962,0,1,0,2,0,3
7310,10,3868,299;10089;10722,0,1,1,1,0,3
7311,10,3869,7669;7849;10639,0,0,1,2,0,3
7312,10,3870,442,0,0,0,1,0,1
7313,10,3871,492;10924,0,1,0,1,0,2
7314,10,3872,487;549,0,0,0,2,0,2
7315,10,3875,724,0,0,0,1,0,1
7316,10,3876,766;10001,0,0,0,2,0,2
7317,10,3877,979;2099;10028;10375;10626,0,0,3,2,0,5
7318,10,3878,5825,0,0,0,0,1,1
7319,10,3879,1569;10098;10231,0,0,2,1,0,3
7320,10,3880,1737,0,0,0,1,0,1
7321,10,3881,1826;2380;10735;10885,0,2,0,2,0,4
7322,10,3882,1900,0,0,0,0,1,1
7323,10,3883,1989;7661,0,0,0,2,0,2
7324,10,3884,2135;9309,0,0,0,0,2,2
7325,10,3885,974;2208;10250;10634;10954,0,1,2,2,0,5
7326,10,3886,2258;9193,0,0,0,2,0,2
7327,10,3888,2288,0,0,0,1,0,1
7328,10,3889,2346;3864,0,0,0,1,1,2
7329,10,3890,2463;9970,0,0,0,2,0,2
7330,10,3891,1297;2527,0,0,0,2,0,2
7331,10,3892,2562;6259,0,0,0,1,1,2
7332,10,3893,2610,0,0,0,0,1,1
7333,10,3894,2661,0,0,0,1,0,1
7334,10,3895,2717;7573,0,0,0,2,0,2
7335,10,3896,2771;5360,0,0,0,1,1,2
7336,10,3897,2990,0,0,0,0,1,1
7337,10,3898,3034,0,0,0,0,1,1
7338,10,3899,3100;3583,0,0,0,2,0,2
7339,10,3900,3190,0,0,0,1,0,1
7340,10,3901,1740,0,0,0,1,0,1
7341,10,3902,3291;10652;11213,0,2,0,1,0,3
7342,10,3904,3865;10139;10269;10773,0,1,2,1,0,4
7343,10,3905,3979;9480;10714;11088,0,2,0,2,0,4
7344,10,3906,2735;4111,0,0,0,2,0,2
7345,10,3907,4191,0,0,0,0,1,1
7346,10,3909,4243;4971,0,0,0,2,0,2
7347,10,3910,4563,0,0,0,1,0,1
7348,10,3911,5110,0,0,0,1,0,1
7349,10,3912,4880;9919,0,0,0,2,0,2
7350,10,3913,2864;5058;10060;10137;10592;11159,0,1,3,2,0,6
7351,10,3914,4051;10828;10917,0,2,0,1,0,3
7352,10,3915,5124,0,0,0,0,1,1
7353,10,3916,5208;9878;10558,0,0,1,2,0,3
7354,10,3917,2588;8981,0,0,0,2,0,2
7355,10,3918,525;5305,0,0,0,2,0,2
7356,10,3919,5411;6509,0,0,0,2,0,2
7357,10,3920,3914;5767,0,0,0,2,0,2
7358,10,3921,8543;10678;11151,0,2,0,1,0,3
7359,10,3922,6051,0,0,0,0,1,1
7360,10,3924,6514,0,0,0,1,0,1
7361,10,3925,8622;10561,0,0,1,1,0,2
7362,10,3926,6710;9303,0,0,0,2,0,2
7363,10,3927,6757;10800;11045,0,2,0,1,0,3
7364,10,3928,7213,0,0,0,1,0,1
7365,10,3929,7361,0,0,0,1,0,1
7366,10,3930,7542;9977;10102;10123,0,0,2,2,0,4
7367,10,3931,4621;7547,0,0,0,2,0,2
7368,10,3932,7759,0,0,0,0,1,1
7369,10,3933,5764;7843;10140;10438;10466,0,0,3,2,0,5
7370,10,3935,2688;7985,0,0,0,2,0,2
7371,10,3936,4740;8062,0,0,0,2,0,2
7372,10,3938,7645;8221,0,0,0,2,0,2
7373,10,3939,9159;10692,0,1,0,1,0,2
7374,10,3940,8394,0,0,0,0,1,1
7375,10,3941,6221;8489,0,0,0,2,0,2
7376,10,3942,8678,0,0,0,0,1,1
7377,10,3943,8936,0,0,0,1,0,1
7378,10,3944,7137;8999,0,0,0,2,0,2
7379,10,3945,1947;9136,0,0,0,2,0,2
7380,10,3946,4188;9169;10120,0,0,1,2,0,3
7381,10,3947,9367,0,0,0,0,1,1
7382,10,3948,5977;9398,0,0,0,2,0,2
7383,10,3949,6311;9449;10243;11026,0,1,1,2,0,4
7384,10,3950,964;9522,0,0,0,2,0,2
7385,10,3952,9828,0,0,0,1,0,1
7386,10,3953,2206;9871,0,0,0,2,0,2
7387,10,3954,1561;9911;10923,0,1,0,2,0,3
7388,10,3957,397;752,365,0,0,2,0,2
7389,10,3959,509,365,0,0,0,1,1
7390,10,3960,586;5699;11093,365,1,0,2,0,3
7391,10,3961,669,365,0,0,0,1,1
7392,10,3962,728;1695;10933;11112,365,2,0,2,0,4
7393,10,3964,954;7643,365,0,0,2,0,2
7394,10,3965,1174;9331,365,0,0,2,0,2
7395,10,3966,1179;7838;10879,365,1,0,2,0,3
7396,10,3967,459;1363,365,0,0,2,0,2
7397,10,3969,1890;3140,365,0,0,2,0,2
7398,10,3970,1950;5351,365,0,0,2,0,2
7399,10,3972,2171;5721,365,0,0,2,0,2
7400,10,3973,2410;3092,365,0,0,2,0,2
7401,10,3974,2377;9439,365,0,0,2,0,2
7402,10,3975,2723;11004,365,1,0,1,0,2
7403,10,3976,258;2793,365,0,0,2,0,2
7404,10,3977,2804;6064;11142,365,1,0,2,0,3
7405,10,3978,2930;9990;10261,365,0,1,2,0,3
7406,10,3979,2647;2998,365,0,0,2,0,2
7407,10,3980,516;3066;10279,365,0,1,2,0,3
7408,10,3981,3227;8633,365,0,0,2,0,2
7409,10,3982,3224,365,0,0,1,0,1
7410,10,3983,3073,365,0,0,1,0,1
7411,10,3984,3392,365,0,0,1,0,1
7412,10,3985,1368;3394,365,0,0,2,0,2
7413,10,3986,3396;8378;10718,365,1,0,2,0,3
7414,10,3987,726;3432;11189,365,1,0,2,0,3
7415,10,3988,3444;8946,365,0,0,2,0,2
7416,10,3989,3544;8024,365,0,0,2,0,2
7417,10,3990,3781,365,0,0,1,0,1
7418,10,3991,3923;10177;10403,365,0,2,1,0,3
7419,10,3992,4560;10775;11191,365,2,0,1,0,3
7420,10,3993,4640,365,0,0,0,1,1
7421,10,3994,4675;6974;10955,365,1,0,2,0,3
7422,10,3995,259;4790,365,0,0,2,0,2
7423,10,3996,4944,365,0,0,1,0,1
7424,10,3997,4968;6396,365,0,0,2,0,2
7425,10,3998,3833;5000;10401;10694,365,1,1,2,0,4
7426,10,3999,5426,365,0,0,0,1,1
7427,10,4000,4827;5432,365,0,0,2,0,2
7428,10,4001,5457,365,0,0,1,0,1
7429,10,4003,681;5588,365,0,0,2,0,2
7430,10,4004,9572,365,0,0,1,0,1
7431,10,4005,5652;9811,365,0,0,2,0,2
7432,10,4006,4889;5900;10696,365,1,0,2,0,3
7433,10,4008,6020;6706,365,0,0,2,0,2
7434,10,4009,2210;6021;10976;11221,365,2,0,2,0,4
7435,10,4010,6031;7244,365,0,0,2,0,2
7436,10,4011,3133;6696;10227;10508;10720,365,1,2,2,0,5
7437,10,4012,6711;9556,365,0,0,2,0,2
7438,10,4014,828;6797,365,0,0,2,0,2
7439,10,4015,6799;8315;8681;10842,365,1,1,2,0,4
7440,10,4016,3062;10242;10528;11106,365,1,2,1,0,4
7441,10,4017,3868;10480;10664,365,1,1,1,0,3
7442,10,4018,6390;7237;10232;10458;10898,365,1,2,2,0,5
7443,10,4020,7644,365,0,0,0,1,1
7444,10,4021,3451;7753,365,0,0,1,1,2
7445,10,4022,6222;7819;10337;10806,365,1,1,2,0,4
7446,10,4024,1913;7858,365,0,0,2,0,2
7447,10,4025,7264;7886,365,0,0,2,0,2
7448,10,4026,7917,365,0,0,0,1,1
7449,10,4027,7997;10805;11145,365,2,0,1,0,3
7450,10,4028,3157;10757;11021,365,2,0,1,0,3
7451,10,4029,8021;9559,365,0,0,2,0,2
7452,10,4030,8152,365,0,0,1,0,1
7453,10,4033,6993,365,0,0,1,0,1
7454,10,4035,4907;6674,365,0,0,2,0,2
7455,10,4036,9144,365,0,0,0,1,1
7456,10,4039,9270,365,0,0,0,1,1
7457,10,4040,8446;9428;10264;10635,365,0,2,2,0,4
7458,10,4041,3667;9432,365,0,0,2,0,2
7459,10,4042,9461;9829,365,0,0,2,0,2
7460,10,4043,102;9482,365,0,0,2,0,2
7461,10,4044,5602,365,0,0,1,0,1
7462,10,4045,9950,365,0,0,1,0,1
7463,10,4046,143;8125,730,0,0,2,0,2
7464,10,4047,200;8849,730,0,0,2,0,2
7465,10,4048,239;6184,730,0,0,2,0,2
7466,10,4049,329;10364;10860;11113,730,2,1,1,0,4
7467,10,4051,437,730,0,0,1,0,1
7468,10,4052,489;3429;10897;11192,730,2,0,2,0,4
7469,10,4053,513;2949;10413;11095,730,1,1,2,0,4
7470,10,4055,5617,730,0,0,1,0,1
7471,10,4056,692,730,0,0,0,1,1
7472,10,4057,819,730,0,0,0,1,1
7473,10,4058,948;5619;10383;10701;10843,730,2,1,2,0,5
7474,10,4059,951;2291;10702;10979,730,2,0,2,0,4
7475,10,4061,1401;5239,730,0,0,2,0,2
7476,10,4062,903;9848,730,0,0,2,0,2
7477,10,4063,1678,730,0,0,0,1,1
7478,10,4064,1703,730,0,0,0,1,1
7479,10,4065,1745;6581;10290;10492;10666;10831,730,2,2,2,0,6
7480,10,4066,1783;10862;11178,730,2,0,1,0,3
7481,10,4067,1801;1846;10841,730,1,0,2,0,3
7482,10,4068,1904;7066;10545;11125,730,1,1,2,0,4
7483,10,4069,1907;7206,730,0,0,1,1,2
7484,10,4071,7261,730,0,0,1,0,1
7485,10,4072,2165;2403,730,0,0,2,0,2
7486,10,4074,2259,730,0,0,0,1,1
7487,10,4075,2337,730,0,0,0,1,1
7488,10,4076,917;2405,730,0,0,0,2,2
7489,10,4077,2455,730,0,0,1,0,1
7490,10,4078,2468,730,0,0,1,0,1
7491,10,4081,2607,730,0,0,0,1,1
7492,10,4083,2636,730,0,0,0,1,1
7493,10,4084,2676;9822,730,0,0,2,0,2
7494,10,4085,2785,730,0,0,0,1,1
7495,10,4086,2801;8992,730,0,0,2,0,2
7496,10,4087,2845,730,0,0,0,1,1
7497,10,4088,3082,730,0,0,1,0,1
7498,10,4089,3192,730,0,0,1,0,1
7499,10,4090,3257,730,0,0,1,0,1
7500,10,4092,4348;4761,730,0,0,2,0,2
7501,10,4093,3643;3815,730,0,0,2,0,2
7502,10,4094,3792;6999,730,0,0,2,0,2
7503,10,4095,1688;3892,730,0,0,2,0,2
7504,10,4096,3924;6119;10594,730,0,1,2,0,3
7505,10,4097,3965,730,0,0,1,0,1
7506,10,4098,3984,730,0,0,1,0,1
7507,10,4099,4030;5216;7037;10449;10642,730,1,2,2,0,5
7508,10,4101,7942,730,0,0,1,0,1
7509,10,4102,4209,730,0,0,1,0,1
7510,10,4103,4273,730,0,0,1,0,1
7511,10,4104,592;4287,730,0,0,2,0,2
7512,10,4105,4377;8830;11152,730,1,0,2,0,3
7513,10,4106,4384;8033,730,0,0,2,0,2
7514,10,4107,4412,730,0,0,0,1,1
7515,10,4108,4659;7904,730,0,0,2,0,2
7516,10,4109,4909;6856;10827,730,1,0,2,0,3
7517,10,4111,5085,730,0,0,1,0,1
7518,10,4112,5087;8382,730,0,0,2,0,2
7519,10,4114,262;5365,730,0,0,2,0,2
7520,10,4115,5418,730,0,0,0,1,1
7521,10,4116,7;5451,730,0,0,2,0,2
7522,10,4117,730;5542;10779,730,1,0,2,0,3
7523,10,4118,5684;6920;10783,730,1,0,2,0,3
7524,10,4119,5883,730,0,0,1,0,1
7525,10,4122,2203,730,0,0,1,0,1
7526,10,4124,4794,730,0,0,1,0,1
7527,10,4125,6418,730,0,0,1,0,1
7528,10,4126,6438,730,0,0,1,0,1
7529,10,4127,158;6694;10373;10521;10880,730,1,2,2,0,5
7530,10,4128,1887;6890,730,0,0,2,0,2
7531,10,4129,5571;6922;10776,730,1,0,2,0,3
7532,10,4130,6936;7021;10825;11183,730,2,0,2,0,4
7533,10,4131,7074;8662;10329,730,0,1,2,0,3
7534,10,4132,4207;7287,730,0,0,2,0,2
7535,10,4133,7441,730,0,0,1,0,1
7536,10,4134,3305;7473,730,0,0,2,0,2
7537,10,4135,7567;9702;11068,730,1,0,2,0,3
7538,10,4136,2253,730,0,0,1,0,1
7539,10,4137,5109;7582,730,0,0,2,0,2
7540,10,4138,7592;8619,730,0,0,2,0,2
7541,10,4139,7855,730,0,0,0,1,1
7542,10,4140,7871;8757,730,0,0,2,0,2
7543,10,4141,5419;7899,730,0,0,2,0,2
7544,10,4143,8173;9937,730,0,0,2,0,2
7545,10,4144,4482;8277;10801;11197,730,2,0,2,0,4
7546,10,4145,8322;9105;11028,730,1,0,2,0,3
7547,10,4147,8348,730,0,0,0,1,1
7548,10,4148,6060;8392,730,0,0,2,0,2
7549,10,4149,9168,730,0,0,1,0,1
7550,10,4152,8814,730,0,0,1,0,1
7551,10,4153,8957,730,0,0,1,0,1
7552,10,4154,8964,730,0,0,0,1,1
7553,10,4155,5286,730,0,0,1,0,1
7554,10,4156,1209;9086;10540;10656,730,1,1,2,0,4
7555,10,4157,9186,730,0,0,1,0,1
7556,10,4158,4218;11199,730,1,0,1,0,2
7557,10,4159,3750;9410;10559,730,0,1,2,0,3
7558,10,4160,4407;9490,730,0,0,2,0,2
7559,10,4161,6679;9508,730,0,0,2,0,2
7560,10,4162,9524,730,0,0,1,0,1
7561,10,4163,9536,730,0,0,0,1,1
7562,10,4164,5819;9754,730,0,0,2,0,2
7563,10,4165,1447;9762,730,0,0,2,0,2
7564,10,4166,9781,730,0,0,1,0,1
7565,10,4167,1736,730,0,0,1,0,1
7566,10,4168,9813,730,0,0,0,1,1
7567,10,4170,9857,730,0,0,1,0,1
7568,10,4171,10;4284;10887,1095,1,0,2,0,3
7569,10,4172,38;1509;10407;10851,1095,1,1,2,0,4
7570,10,4173,45;5748,1095,0,0,2,0,2
7571,10,4174,181;3103,1095,0,0,2,0,2
7572,10,4178,417;2297,1095,0,0,1,1,2
7573,10,4179,475;1212,1095,0,0,2,0,2
7574,10,4180,578;5810,1095,0,0,2,0,2
7575,10,4181,655;9895;10911,1095,1,0,2,0,3
7576,10,4182,675,1095,0,0,1,0,1
7577,10,4183,467;685;10548;10740,1095,1,1,2,0,4
7578,10,4185,741;6550,1095,0,0,2,0,2
7579,10,4186,858;9558,1095,0,0,2,0,2
7580,10,4187,7035,1095,0,0,1,0,1
7581,10,4188,1167,1095,0,0,0,1,1
7582,10,4189,7007,1095,0,0,1,0,1
7583,10,4190,1197;2133;10643,1095,1,0,2,0,3
7584,10,4191,1224,1095,0,0,1,0,1
7585,10,4192,1247;9721,1095,0,0,2,0,2
7586,10,4194,1458;10552;10895,1095,1,1,1,0,3
7587,10,4195,1490;1790,1095,0,0,2,0,2
7588,10,4196,1563,1095,0,0,1,0,1
7589,10,4197,1655;6761;10655;10900;11110,1095,3,0,2,0,5
7590,10,4198,1821;6302,1095,0,0,1,1,2
7591,10,4199,873;1974,1095,0,0,2,0,2
7592,10,4200,2152,1095,0,0,0,1,1
7593,10,4201,2343,1095,0,0,0,1,1
7594,10,4202,2351;4015,1095,0,0,2,0,2
7595,10,4203,2383,1095,0,0,1,0,1
7596,10,4205,2517;4170;10651,1095,1,0,2,0,3
7597,10,4206,1603;4925;10766,1095,1,0,2,0,3
7598,10,4209,4260;9622,1095,0,0,2,0,2
7599,10,4210,3134,1095,0,0,0,1,1
7600,10,4211,2986;3235,1095,0,0,2,0,2
7601,10,4212,3239;7998,1095,0,0,2,0,2
7602,10,4213,3471;5679,1095,0,0,2,0,2
7603,10,4214,7226,1095,0,0,1,0,1
7604,10,4215,3907,1095,0,0,1,0,1
7605,10,4216,3931;7079,1095,0,0,2,0,2
7606,10,4217,4001;7272;10520;10663;10959,1095,2,1,2,0,5
7607,10,4218,4002;5070;10471,1095,0,1,2,0,3
7608,10,4219,4233,1095,0,0,1,0,1
7609,10,4220,4281,1095,0,0,0,1,1
7610,10,4221,3549,1095,0,0,1,0,1
7611,10,4222,4367,1095,0,0,0,1,1
7612,10,4223,4490;4938;10679;10785,1095,2,0,2,0,4
7613,10,4224,4550;7973,1095,0,0,2,0,2
7614,10,4225,4559;6587,1095,0,0,2,0,2
7615,10,4226,4589;4797;10905,1095,1,0,2,0,3
7616,10,4228,3083;4767,1095,0,0,2,0,2
7617,10,4230,4577,1095,0,0,1,0,1
7618,10,4231,5037,1095,0,0,1,0,1
7619,10,4232,5257;6035,1095,0,0,2,0,2
7620,10,4234,3759;5379,1095,0,0,2,0,2
7621,10,4236,5430;5755,1095,0,0,2,0,2
7622,10,4237,5769;6176;10705;10822;11082,1095,3,0,2,0,5
7623,10,4238,3903;5816,1095,0,0,2,0,2
7624,10,4239,5547;5928,1095,0,0,2,0,2
7625,10,4240,5952,1095,0,0,0,1,1
7626,10,4241,6028,1095,0,0,1,0,1
7627,10,4243,6142,1095,0,0,1,0,1
7628,10,4245,4148;6334,1095,0,0,2,0,2
7629,10,4246,4821;6428,1095,0,0,2,0,2
7630,10,4247,6646,1095,0,0,1,0,1
7631,10,4248,4522;6837;10874;10994,1095,2,0,2,0,4
7632,10,4249,2556;6914,1095,0,0,2,0,2
7633,10,4250,5489;7030,1095,0,0,2,0,2
7634,10,4251,7136,1095,0,0,1,0,1
7635,10,4252,7294;9281,1095,0,0,2,0,2
7636,10,4253,7317,1095,0,0,1,0,1
7637,10,4254,926;7321;10426;10798,1095,1,1,2,0,4
7638,10,4255,7363;9298,1095,0,0,2,0,2
7639,10,4256,4370;7367,1095,0,0,2,0,2
7640,10,4257,3675;7372,1095,0,0,2,0,2
7641,10,4258,7420,1095,0,0,0,1,1
7642,10,4259,2612;7426,1095,0,0,2,0,2
7643,10,4260,324;7516;11122,1095,1,0,2,0,3
7644,10,4261,5490;7585;11102,1095,1,0,2,0,3
7645,10,4262,5052,1095,0,0,1,0,1
7646,10,4263,7603;7722;10533;10622,1095,0,2,2,0,4
7647,10,4264,2350;9526,1095,0,0,2,0,2
7648,10,4265,5201;7818;10741,1095,1,0,2,0,3
7649,10,4266,6122;7844;10750,1095,1,0,2,0,3
7650,10,4267,8088,1095,0,0,1,0,1
7651,10,4268,6544,1095,0,0,1,0,1
7652,10,4271,8312,1095,0,0,1,0,1
7653,10,4272,8455;9882;11005,1095,1,0,2,0,3
7654,10,4273,3708;8483,1095,0,0,2,0,2
7655,10,4274,5343;7470,1095,0,0,2,0,2
7656,10,4275,7138;8807,1095,0,0,2,0,2
7657,10,4276,794;8859,1095,0,0,2,0,2
7658,10,4277,5716;8904,1095,0,0,2,0,2
7659,10,4278,2682;8954,1095,0,0,2,0,2
7660,10,4281,5366;9165;11104,1095,1,0,2,0,3
7661,10,4282,8492;9166;10497;10752;10915,1095,2,1,2,0,5
7662,10,4283,4115;9236,1095,0,0,2,0,2
7663,10,4284,9288,1095,0,0,1,0,1
7664,10,4285,5605,1095,0,0,1,0,1
7665,10,4286,9601,1095,0,0,1,0,1
7666,10,4287,5443;9714,1095,0,0,2,0,2
7667,10,4288,9727;10444;10736,1095,1,1,1,0,3
7668,10,4289,9770,1095,0,0,1,0,1
7669,10,4291,9935,1095,0,0,0,1,1
7670,10,4292,4276;9944;10465;11002,1095,1,1,2,0,4
7671,10,4293,9600;9962,1095,0,0,2,0,2
7672,10,4295,5801,1460,0,0,1,0,1
7673,10,4296,436,1460,0,0,0,1,1
7674,10,4297,486;8925,1460,0,0,2,0,2
7675,10,4298,583;7485,1460,0,0,2,0,2
7676,10,4299,643;8252,1460,0,0,2,0,2
7677,10,4300,684;7286;11096,1460,1,0,2,0,3
7678,10,4301,710,1460,0,0,1,0,1
7679,10,4302,795;4888;10837;11222,1460,2,0,2,0,4
7680,10,4303,811;7604;10990;11190,1460,2,0,2,0,4
7681,10,4304,871;10832;11020,1460,2,0,1,0,3
7682,10,4305,881,1460,0,0,1,0,1
7683,10,4306,895;5737,1460,0,0,2,0,2
7684,10,4307,977;4602;10707,1460,1,0,2,0,3
7685,10,4308,999;4094,1460,0,0,2,0,2
7686,10,4309,1059;1842;11216,1460,1,0,2,0,3
7687,10,4311,1199;4492;10461;10937,1460,1,1,2,0,4
7688,10,4312,1213;3255;10600;10686,1460,1,1,2,0,4
7689,10,4313,1227,1460,0,0,1,0,1
7690,10,4314,973,1460,0,0,1,0,1
7691,10,4315,1333,1460,0,0,1,0,1
7692,10,4316,1499;5709;10760,1460,1,0,2,0,3
7693,10,4317,371;1590,1460,0,0,2,0,2
7694,10,4318,1878,1460,0,0,1,0,1
7695,10,4319,1954,1460,0,0,0,1,1
7696,10,4320,2180;4756;10815,1460,1,0,2,0,3
7697,10,4321,2246;6625,1460,0,0,2,0,2
7698,10,4322,2126;2281,1460,0,0,2,0,2
7699,10,4323,2392,1460,0,0,0,1,1
7700,10,4324,2416,1460,0,0,0,1,1
7701,10,4325,2553,1460,0,0,0,1,1
7702,10,4326,2724;3799,1460,0,0,2,0,2
7703,10,4327,106;2731,1460,0,0,1,1,2
7704,10,4328,1536;2834,1460,0,0,2,0,2
7705,10,4329,2843,1460,0,0,1,0,1
7706,10,4330,2887;9786;10796,1460,1,0,2,0,3
7707,10,4331,3022,1460,0,0,1,0,1
7708,10,4333,3260,1460,0,0,1,0,1
7709,10,4334,3358,1460,0,0,0,1,1
7710,10,4335,3621;9947,1460,0,0,2,0,2
7711,10,4337,2301;3709;11081,1460,1,0,2,0,3
7712,10,4338,8456,1460,0,0,1,0,1
7713,10,4339,3723,1460,0,0,0,1,1
7714,10,4340,5905,1460,0,0,1,0,1
7715,10,4341,3832;10504;10624;11072,1460,1,2,1,0,4
7716,10,4342,3946;7624,1460,0,0,2,0,2
7717,10,4344,4076,1460,0,0,0,1,1
7718,10,4345,2232;4169;10892,1460,1,0,2,0,3
7719,10,4346,4201,1460,0,0,0,1,1
7720,10,4347,4315;10996,1460,1,0,1,0,2
7721,10,4348,4335;5038,1460,0,0,2,0,2
7722,10,4349,4379;8135,1460,0,0,2,0,2
7723,10,4350,4707,1460,0,0,1,0,1
7724,10,4351,4733,1460,0,0,0,1,1
7725,10,4352,4795;8770,1460,0,0,2,0,2
7726,10,4353,1054;4920;10599;10671;10971,1460,2,1,2,0,5
7727,10,4354,2622;4939;10710;11077,1460,2,0,2,0,4
7728,10,4355,3295;5017;11205,1460,1,0,2,0,3
7729,10,4359,4126;5350,1460,0,0,1,1,2
7730,10,4360,5377;6586;11123,1460,1,0,2,0,3
7731,10,4361,6504,1460,0,0,1,0,1
7732,10,4362,5741;9063;11161,1460,1,0,2,0,3
7733,10,4364,1978;5857;10585,1460,0,1,2,0,3
7734,10,4366,5899,1460,0,0,1,0,1
7735,10,4367,5953,1460,0,0,1,0,1
7736,10,4368,5982;8526;10884,1460,1,0,2,0,3
7737,10,4369,6067,1460,0,0,1,0,1
7738,10,4370,1526;6107,1460,0,0,2,0,2
7739,10,4371,6163,1460,0,0,1,0,1
7740,10,4372,5114;6169;10945,1460,1,0,2,0,3
7741,10,4373,6205,1460,0,0,1,0,1
7742,10,4375,6345;7989,1460,0,0,2,0,2
7743,10,4376,6489;6728,1460,0,0,2,0,2
7744,10,4377,6810,1460,0,0,0,1,1
7745,10,4378,6819;9257,1460,0,0,2,0,2
7746,10,4380,3566;6953,1460,0,0,2,0,2
7747,10,4381,6452;6986,1460,0,0,2,0,2
7748,10,4382,1718,1460,0,0,1,0,1
7749,10,4383,7107,1460,0,0,1,0,1
7750,10,4384,2427;3772,1460,0,0,2,0,2
7751,10,4385,2516;7180,1460,0,0,2,0,2
7752,10,4387,6133,1460,0,0,1,0,1
7753,10,4389,7517;8602,1460,0,0,2,0,2
7754,10,4390,7868;7925,1460,0,0,2,0,2
7755,10,4391,6211;7921,1460,0,0,2,0,2
7756,10,4392,2525;8070,1460,0,0,2,0,2
7757,10,4393,8089;8644,1460,0,0,2,0,2
7758,10,4394,8130,1460,0,0,1,0,1
7759,10,4396,2722;8202,1460,0,0,2,0,2
7760,10,4397,8284;8538,1460,0,0,2,0,2
7761,10,4398,8383,1460,0,0,1,0,1
7762,10,4399,8386,1460,0,0,0,1,1
7763,10,4400,8449;8686,1460,0,0,2,0,2
7764,10,4402,1218;8488;10680,1460,1,0,2,0,3
7765,10,4403,7495;8502,1460,0,0,2,0,2
7766,10,4404,8966;9238;10746,1460,1,0,2,0,3
7767,10,4405,8568;8987;10869;11010,1460,2,0,2,0,4
7768,10,4406,4375;9113,1460,0,0,2,0,2
7769,10,4407,9271,1460,0,0,1,0,1
7770,10,4408,6198;9299,1460,0,0,2,0,2
7771,10,4409,6318;9500,1460,0,0,2,0,2
7772,10,4410,9660,1460,0,0,0,1,1
7773,10,4411,1833;9697,1460,0,0,2,0,2
7774,10,4412,6413;9769,1460,0,0,2,0,2
7775,10,4413,706;9777,1460,0,0,2,0,2
7776,10,4414,4085;9809;10856;11153,1460,2,0,2,0,4
7777,10,4415,1741,1460,0,0,1,0,1
7778,10,4416,4873;9946,1460,0,0,2,0,2
7779,10,4417,71;4336,1825,0,0,2,0,2
7780,10,4418,199;8519,1825,0,0,2,0,2
7781,10,4419,201,1825,0,0,1,0,1
7782,10,4420,141;4623,1825,0,0,2,0,2
7783,10,4421,296;7076;7077;10638;11034,1825,1,1,3,0,5
7784,10,4422,304,1825,0,0,1,0,1
7785,10,4423,439;10778,1825,1,0,1,0,2
7786,10,4424,636;10575,1825,0,1,1,0,2
7787,10,4426,720;6736,1825,0,0,2,0,2
7788,10,4427,967,1825,0,0,1,0,1
7789,10,4428,972,1825,0,0,0,1,1
7790,10,4429,1130,1825,0,0,1,0,1
7791,10,4430,642;1525,1825,0,0,2,0,2
7792,10,4431,1683,1825,0,0,1,0,1
7793,10,4433,1784;3160,1825,0,0,2,0,2
7794,10,4435,6196,1825,0,0,1,0,1
7795,10,4437,3219,1825,0,0,1,0,1
7796,10,4438,3165;4898;10619;10877;11120,1825,2,1,2,0,5
7797,10,4439,3196,1825,0,0,0,1,1
7798,10,4440,3208;7012,1825,0,0,2,0,2
7799,10,4441,3229,1825,0,0,0,1,1
7800,10,4442,7523,1825,0,0,1,0,1
7801,10,4443,3308;6407,1825,0,0,2,0,2
7802,10,4444,3384;10961;11141,1825,2,0,1,0,3
7803,10,4445,1122,1825,0,0,1,0,1
7804,10,4446,3419;8285;10697;11022,1825,2,0,2,0,4
7805,10,4448,3565;8480,1825,0,0,2,0,2
7806,10,4449,3785,1825,0,0,1,0,1
7807,10,4451,3595;3850;11140,1825,1,0,2,0,3
7808,10,4452,3934;5888,1825,0,0,2,0,2
7809,10,4453,488;3961;10661,1825,1,0,2,0,3
7810,10,4454,1151;3962;10588;10866;10913,1825,2,1,2,0,5
7811,10,4455,4046,1825,0,0,1,0,1
7812,10,4456,4112,1825,0,0,0,1,1
7813,10,4457,1387;4165,1825,0,0,2,0,2
7814,10,4458,4351,1825,0,0,0,1,1
7815,10,4459,4453,1825,0,0,0,1,1
7816,10,4460,4474;8718,1825,0,0,2,0,2
7817,10,4461,4487;8672,1825,0,0,2,0,2
7818,10,4462,4678;4838;11079,1825,1,0,2,0,3
7819,10,4463,4711;9089,1825,0,0,2,0,2
7820,10,4464,4751;5160,1825,0,0,2,0,2
7821,10,4465,5566,1825,0,0,1,0,1
7822,10,4467,4825,1825,0,0,0,1,1
7823,10,4468,4921,1825,0,0,0,1,1
7824,10,4470,8552;8747;10644,1825,1,0,2,0,3
7825,10,4471,2285;5046;10649;10930,1825,2,0,2,0,4
7826,10,4472,5234;9830;10698;10823,1825,2,0,2,0,4
7827,10,4473,458;5235;10712;10988;11029,1825,3,0,2,0,5
7828,10,4474,5295,1825,0,0,0,1,1
7829,10,4475,5364,1825,0,0,1,0,1
7830,10,4476,1417;5391,1825,0,0,2,0,2
7831,10,4477,2316;5546;10870;11144,1825,2,0,2,0,4
7832,10,4479,5838,1825,0,0,0,1,1
7833,10,4481,5941,1825,0,0,1,0,1
7834,10,4483,4314;6022,1825,0,0,2,0,2
7835,10,4484,6173,1825,0,0,1,0,1
7836,10,4485,5811;6207,1825,0,0,2,0,2
7837,10,4486,6313;8561;10791;11056,1825,2,0,2,0,4
7838,10,4487,6219;6400,1825,0,0,2,0,2
7839,10,4488,6456;7116,1825,0,0,2,0,2
7840,10,4489,6530,1825,0,0,1,0,1
7841,10,4490,356;6637;10789;11037;11148,1825,3,0,2,0,5
7842,10,4491,5441;6649,1825,0,0,2,0,2
7843,10,4492,6070;6653,1825,0,0,2,0,2
7844,10,4493,3539;6782;11052,1825,1,0,2,0,3
7845,10,4494,6929,1825,0,0,1,0,1
7846,10,4495,1195;7845,1825,0,0,2,0,2
7847,10,4496,7210,1825,0,0,1,0,1
7848,10,4498,7256;7508;11008,1825,1,0,2,0,3
7849,10,4500,7308,1825,0,0,1,0,1
7850,10,4501,7051;7382,1825,0,0,2,0,2
7851,10,4502,777;7559,1825,0,0,2,0,2
7852,10,4503,773;7570;11073;11138,1825,2,0,2,0,4
7853,10,4504,7650,1825,0,0,1,0,1
7854,10,4505,6582;7672;10910,1825,1,0,2,0,3
7855,10,4506,7685,1825,0,0,1,0,1
7856,10,4507,7721;9329,1825,0,0,2,0,2
7857,10,4508,5448;7815,1825,0,0,2,0,2
7858,10,4510,7882;8985;10928,1825,1,0,2,0,3
7859,10,4511,7933,1825,0,0,1,0,1
7860,10,4513,8030,1825,0,0,0,1,1
7861,10,4514,8082,1825,0,0,1,0,1
7862,10,4515,8264,1825,0,0,0,1,1
7863,10,4517,8545,1825,0,0,1,0,1
7864,10,4519,8617,1825,0,0,1,0,1
7865,10,4520,4103;8628,1825,0,0,2,0,2
7866,10,4521,8744;9352;11084,1825,1,0,2,0,3
7867,10,4522,8176;11097,1825,1,0,1,0,2
7868,10,4523,2580,1825,0,0,1,0,1
7869,10,4524,9032;9651;10852;10972;11024,1825,3,0,2,0,5
7870,10,4525,1055;9077,1825,0,0,2,0,2
7871,10,4526,7601;9097,1825,0,0,2,0,2
7872,10,4527,9119;9127,1825,0,0,2,0,2
7873,10,4528,9528,1825,0,0,1,0,1
7874,10,4530,568;9356;10942,1825,1,0,2,0,3
7875,10,4531,2156;9368;11157,1825,1,0,2,0,3
7876,10,4532,2345;9538,1825,0,0,2,0,2
7877,10,4533,3538;9648,1825,0,0,2,0,2
7878,10,4534,2366;9817,1825,0,0,2,0,2
7879,10,4535,1583,1825,0,0,1,0,1
7880,10,4536,1317;9963,1825,0,0,2,0,2
7881,10,4537,68,2190,0,0,0,1,1
7882,10,4538,110;4274,2190,0,0,2,0,2
7883,10,4539,112;2881;11058,2190,1,0,2,0,3
7884,10,4540,236,2190,0,0,1,0,1
7885,10,4541,623,2190,0,0,1,0,1
7886,10,4542,863;6330,2190,0,0,2,0,2
7887,10,4543,1009,2190,0,0,1,0,1
7888,10,4544,5210,2190,0,0,1,0,1
7889,10,4545,1229,2190,0,0,0,1,1
7890,10,4546,1367,2190,0,0,1,0,1
7891,10,4547,7829,2190,0,0,1,0,1
7892,10,4548,1556;4615;10899;11173,2190,2,0,2,0,4
7893,10,4549,1598,2190,0,0,1,0,1
7894,10,4550,1610,2190,0,0,0,1,1
7895,10,4551,1788;3004,2190,0,0,2,0,2
7896,10,4552,1925,2190,0,0,1,0,1
7897,10,4553,2136,2190,0,0,0,1,1
7898,10,4554,2141;5166;11186,2190,1,0,2,0,3
7899,10,4555,2441;8864,2190,0,0,2,0,2
7900,10,4556,950;2480;11035,2190,1,0,2,0,3
7901,10,4557,2563,2190,0,0,0,1,1
7902,10,4558,2621;9006;11053,2190,1,0,2,0,3
7903,10,4559,2655;8567,2190,0,0,2,0,2
7904,10,4560,2670;7671;11207,2190,1,0,2,0,3
7905,10,4561,64;2811;11121,2190,1,0,2,0,3
7906,10,4562,2821,2190,0,0,1,0,1
7907,10,4563,2865;3315;10974,2190,1,0,2,0,3
7908,10,4566,3010;6281;10749;10932,2190,2,0,2,0,4
7909,10,4568,3139,2190,0,0,0,1,1
7910,10,4569,3161;7343;10888,2190,1,0,2,0,3
7911,10,4570,1848;3199,2190,0,0,2,0,2
7912,10,4571,3204;9459,2190,0,0,2,0,2
7913,10,4572,3531;4654;10904,2190,1,0,2,0,3
7914,10,4574,2433;3726,2190,0,0,2,0,2
7915,10,4575,3746,2190,0,0,1,0,1
7916,10,4576,3768;9897;10953,2190,1,0,2,0,3
7917,10,4578,2295;3860,2190,0,0,2,0,2
7918,10,4579,3955,2190,0,0,1,0,1
7919,10,4580,2490;4000,2190,0,0,2,0,2
7920,10,4581,4012,2190,0,0,0,1,1
7921,10,4582,4073;10850,2190,1,0,1,0,2
7922,10,4583,4475;8679;11057,2190,1,0,2,0,3
7923,10,4584,4504,2190,0,0,1,0,1
7924,10,4585,8388,2190,0,0,1,0,1
7925,10,4586,9831,2190,0,0,1,0,1
7926,10,4587,4813,2190,0,0,1,0,1
7927,10,4588,3720,2190,0,0,1,0,1
7928,10,4589,4950,2190,0,0,1,0,1
7929,10,4591,1415;5113,2190,0,0,2,0,2
7930,10,4593,1824;5606;10716;11163,2190,2,0,2,0,4
7931,10,4595,4893,2190,0,0,0,1,1
7932,10,4596,971,2190,0,0,0,1,1
7933,10,4597,5896;8349,2190,0,0,2,0,2
7934,10,4598,5963;6170,2190,0,0,2,0,2
7935,10,4599,3985;6074;10726;10813,2190,2,0,2,0,4
7936,10,4600,6118;6503,2190,0,0,2,0,2
7937,10,4601,1116;6347,2190,0,0,2,0,2
7938,10,4602,6365,2190,0,0,1,0,1
7939,10,4603,6432,2190,0,0,0,1,1
7940,10,4605,6594,2190,0,0,1,0,1
7941,10,4606,4594;6602;10780;10944;11042,2190,3,0,2,0,5
7942,10,4607,3164;6774,2190,0,0,2,0,2
7943,10,4608,7001;7227,2190,0,0,2,0,2
7944,10,4609,7093;9347,2190,0,0,2,0,2
7945,10,4610,6854;7102,2190,0,0,2,0,2
7946,10,4611,6191;7222;11070,2190,1,0,2,0,3
7947,10,4612,7331;9854,2190,0,0,2,0,2
7948,10,4613,7353;7691,2190,0,0,2,0,2
7949,10,4614,6193;7609,2190,0,0,2,0,2
7950,10,4615,7705,2190,0,0,1,0,1
7951,10,4616,7801,2190,0,0,1,0,1
7952,10,4617,7811,2190,0,0,0,1,1
7953,10,4618,7841,2190,0,0,1,0,1
7954,10,4619,4141;7874,2190,0,0,2,0,2
7955,10,4620,7982,2190,0,0,1,0,1
7956,10,4621,8184;8479;10969,2190,1,0,2,0,3
7957,10,4623,8204,2190,0,0,0,1,1
7958,10,4624,4102;8318,2190,0,0,2,0,2
7959,10,4626,4011,2190,0,0,1,0,1
7960,10,4627,8398,2190,0,0,1,0,1
7961,10,4628,8606,2190,0,0,0,1,1
7962,10,4629,8584;8798,2190,0,0,2,0,2
7963,10,4630,8898,2190,0,0,1,0,1
7964,10,4631,1418;9047,2190,0,0,2,0,2
7965,10,4632,9199,2190,0,0,1,0,1
7966,10,4633,3438;9370,2190,0,0,2,0,2
7967,10,4634,9484,2190,0,0,1,0,1
7968,10,4635,2220,2190,0,0,1,0,1
7969,10,4636,7236;9552,2190,0,0,2,0,2
7970,10,4637,9590,2190,0,0,1,0,1
7971,10,4638,6240;9616,2190,0,0,2,0,2
7972,10,4639,9643,2190,0,0,1,0,1
7973,10,4640,2500;9677,2190,0,0,2,0,2
7974,10,4641,9825,2190,0,0,1,0,1
7975,10,4643,4053;9926,2190,0,0,2,0,2
7976,10,4645,232;7930,2555,0,0,2,0,2
7977,10,4646,271;2892,2555,0,0,2,0,2
7978,10,4647,278;6192,2555,0,0,2,0,2
7979,10,4648,289,2555,0,0,0,1,1
7980,10,4649,350;8039,2555,0,0,2,0,2
7981,10,4650,355;4220,2555,0,0,2,0,2
7982,10,4652,779;7168,2555,0,0,2,0,2
7983,10,4653,1031;9265,2555,0,0,2,0,2
7984,10,4654,1332;3338,2555,0,0,2,0,2
7985,10,4655,9358,2555,0,0,1,0,1
7986,10,4656,1372;5661,2555,0,0,2,0,2
7987,10,4657,1399;7692,2555,0,0,2,0,2
7988,10,4658,1535;6354,2555,0,0,2,0,2
7989,10,4659,1814;8331,2555,0,0,2,0,2
7990,10,4660,1901;7657,2555,0,0,2,0,2
7991,10,4661,1932,2555,0,0,1,0,1
7992,10,4662,1935;4543,2555,0,0,2,0,2
7993,10,4663,1967,2555,0,0,1,0,1
7994,10,4664,1230;2289,2555,0,0,2,0,2
7995,10,4665,2368,2555,0,0,1,0,1
7996,10,4666,603;2385;10926;11195,2555,2,0,2,0,4
7997,10,4668,1654;2605,2555,0,0,2,0,2
7998,10,4669,430;2681;10855;11043,2555,2,0,2,0,4
7999,10,4670,2766;4979;10863,2555,1,0,2,0,3
8000,10,4671,2800;9501,2555,0,0,2,0,2
8001,10,4672,2058;2839,2555,0,0,2,0,2
8002,10,4673,2857,2555,0,0,1,0,1
8003,10,4674,1207;3144,2555,0,0,2,0,2
8004,10,4675,3268,2555,0,0,1,0,1
8005,10,4676,3277;8826,2555,0,0,2,0,2
8006,10,4677,1505;3524,2555,0,0,2,0,2
8007,10,4678,3574;6102,2555,0,0,2,0,2
8008,10,4679,3703;6767,2555,0,0,2,0,2
8009,10,4680,3751,2555,0,0,1,0,1
8010,10,4681,686;3766;11074,2555,1,0,2,0,3
8011,10,4683,4101;7391,2555,0,0,2,0,2
8012,10,4684,3561;4224;6620;10886,2555,1,1,2,0,4
8013,10,4685,4239,2555,0,0,1,0,1
8014,10,4686,4258;7255,2555,0,0,2,0,2
8015,10,4687,4259;8712,2555,0,0,2,0,2
8016,10,4688,714;4272;10853,2555,1,0,2,0,3
8017,10,4689,1692;4398;11107,2555,1,0,2,0,3
8018,10,4690,4501;8583,2555,0,0,2,0,2
8019,10,4691,4507;7058;11172,2555,1,0,2,0,3
8020,10,4692,4714;9588;11016,2555,1,0,2,0,3
8021,10,4694,4737;9333,2555,0,0,2,0,2
8022,10,4695,4758,2555,0,0,1,0,1
8023,10,4696,2671,2555,0,0,1,0,1
8024,10,4697,8618,2555,0,0,1,0,1
8025,10,4698,4865,2555,0,0,1,0,1
8026,10,4699,5167,2555,0,0,1,0,1
8027,10,4700,5245;8680,2555,0,0,2,0,2
8028,10,4701,5327,2555,0,0,1,0,1
8029,10,4702,5342,2555,0,0,1,0,1
8030,10,4703,5499,2555,0,0,1,0,1
8031,10,4704,6966,2555,0,0,1,0,1
8032,10,4705,5548,2555,0,0,1,0,1
8033,10,4706,5604,2555,0,0,1,0,1
8034,10,4708,5691;6164,2555,0,0,2,0,2
8035,10,4709,65;5799,2555,0,0,2,0,2
8036,10,4710,2692;5988,2555,0,0,2,0,2
8037,10,4711,834,2555,0,0,1,0,1
8038,10,4714,3131,2555,0,0,1,0,1
8039,10,4715,1910;6409,2555,0,0,2,0,2
8040,10,4716,6440;9797;10975,2555,1,0,2,0,3
8041,10,4717,6473,2555,0,0,1,0,1
8042,10,4718,630;6701,2555,0,0,2,0,2
8043,10,4719,203;1140;10939,2555,1,0,2,0,3
8044,10,4720,404;6769;11176,2555,1,0,2,0,3
8045,10,4721,4198;6778,2555,0,0,2,0,2
8046,10,4723,2007;6867;10963,2555,1,0,2,0,3
8047,10,4724,6949;8822,2555,0,0,2,0,2
8048,10,4725,6951;8831,2555,0,0,2,0,2
8049,10,4726,7078;8122,2555,0,0,2,0,2
8050,10,4728,2022;7820,2555,0,0,2,0,2
8051,10,4729,1030;7569;11086,2555,1,0,2,0,3
8052,10,4730,4649;7682;10868;11030;11108,2555,3,0,2,0,5
8053,10,4731,316;6037,2555,0,0,2,0,2
8054,10,4732,326;7926,2555,0,0,2,0,2
8055,10,4733,8002;8006,2555,0,0,2,0,2
8056,10,4734,3436;8083,2555,0,0,2,0,2
8057,10,4735,8087;9843,2555,0,0,2,0,2
8058,10,4736,8157,2555,0,0,1,0,1
8059,10,4737,4062;8271,2555,0,0,2,0,2
8060,10,4738,986;8501,2555,0,0,2,0,2
8061,10,4739,6626;8596,2555,0,0,2,0,2
8062,10,4740,7072;8740,2555,0,0,2,0,2
8063,10,4741,8753,2555,0,0,1,0,1
8064,10,4742,8795,2555,0,0,1,0,1
8065,10,4743,8796,2555,0,0,1,0,1
8066,10,4744,8908,2555,0,0,0,1,1
8067,10,4745,9090,2555,0,0,0,1,1
8068,10,4746,3418;9214,2555,0,0,2,0,2
8069,10,4747,9328;11119,2555,1,0,1,0,2
8070,10,4748,1612;9348,2555,0,0,2,0,2
8071,10,4749,2510,2555,0,0,0,1,1
8072,10,4750,7341;9499,2555,0,0,2,0,2
8073,10,4751,7746,2555,0,0,1,0,1
8074,10,4752,9547,2555,0,0,1,0,1
8075,10,4753,2628;9607;11124,2555,1,0,2,0,3
8076,10,4754,2609;9652,2555,0,0,2,0,2
8077,10,4755,9883,2555,0,0,1,0,1
8078,10,4757,1061;9975,2555,0,0,2,0,2
8079,10,4758,42,2920,0,0,1,0,1
8080,10,4759,146;4129,2920,0,0,2,0,2
8081,10,4760,209,2920,0,0,1,0,1
8082,10,4761,3218;9145,2920,0,0,2,0,2
8083,10,4762,286,2920,0,0,1,0,1
8084,10,4763,414;1548,2920,0,0,2,0,2
8085,10,4764,445,2920,0,0,1,0,1
8086,10,4765,534,2920,0,0,1,0,1
8087,10,4766,628,2920,0,0,0,1,1
8088,10,4767,687;7109,2920,0,0,2,0,2
8089,10,4768,736;8547,2920,0,0,2,0,2
8090,10,4769,851,2920,0,0,1,0,1
8091,10,4770,864;1235,2920,0,0,2,0,2
8092,10,4771,1016;6861;10914;11202,2920,2,0,2,0,4
8093,10,4772,892;3406,2920,0,0,2,0,2
8094,10,4773,3023,2920,0,0,1,0,1
8095,10,4774,1099,2920,0,0,1,0,1
8096,10,4775,1634,2920,0,0,1,0,1
8097,10,4776,1123;1648,2920,0,0,2,0,2
8098,10,4777,1665,2920,0,0,0,1,1
8099,10,4778,931;1882,2920,0,0,2,0,2
8100,10,4779,1936,2920,0,0,1,0,1
8101,10,4780,933;2067,2920,0,0,2,0,2
8102,10,4781,2169;8292,2920,0,0,2,0,2
8103,10,4782,2290,2920,0,0,1,0,1
8104,10,4783,2543,2920,0,0,1,0,1
8105,10,4784,2840;8627,2920,0,0,2,0,2
8106,10,4785,2861,2920,0,0,1,0,1
8107,10,4787,2946,2920,0,0,1,0,1
8108,10,4788,55;2960,2920,0,0,2,0,2
8109,10,4789,3155;3704,2920,0,0,2,0,2
8110,10,4790,3182,2920,0,0,1,0,1
8111,10,4791,3193,2920,0,0,1,0,1
8112,10,4792,3207;4713;11130,2920,1,0,2,0,3
8113,10,4793,3374;7185,2920,0,0,2,0,2
8114,10,4794,3449;5870,2920,0,0,2,0,2
8115,10,4795,3457,2920,0,0,1,0,1
8116,10,4796,4500,2920,0,0,1,0,1
8117,10,4797,3477;3959,2920,0,0,2,0,2
8118,10,4798,3533;6375,2920,0,0,2,0,2
8119,10,4799,3607,2920,0,0,1,0,1
8120,10,4800,3626,2920,0,0,1,0,1
8121,10,4801,3695;9392,2920,0,0,2,0,2
8122,10,4802,3727;3812,2920,0,0,2,0,2
8123,10,4803,3811;8417,2920,0,0,2,0,2
8124,10,4804,3849;3879;11220,2920,1,0,2,0,3
8125,10,4805,3940;7403,2920,0,0,2,0,2
8126,10,4806,4022;8425,2920,0,0,2,0,2
8127,10,4807,2456;4044,2920,0,0,2,0,2
8128,10,4808,4109;4411,2920,0,0,2,0,2
8129,10,4809,4255,2920,0,0,1,0,1
8130,10,4810,4290,2920,0,0,1,0,1
8131,10,4811,3795;4399,2920,0,0,2,0,2
8132,10,4813,3518;4949;11179,2920,1,0,2,0,3
8133,10,4814,751;5086,2920,0,0,2,0,2
8134,10,4815,5125,2920,0,0,1,0,1
8135,10,4816,4924;5328,2920,0,0,2,0,2
8136,10,4817,4637;5378,2920,0,0,2,0,2
8137,10,4818,5401,2920,0,0,1,0,1
8138,10,4819,5620,2920,0,0,1,0,1
8139,10,4820,5689,2920,0,0,1,0,1
8140,10,4821,5788;6770,2920,0,0,2,0,2
8141,10,4822,5864;7034,2920,0,0,2,0,2
8142,10,4823,5913,2920,0,0,1,0,1
8143,10,4824,4582;7293,2920,0,0,2,0,2
8144,10,4825,6284;9189;11047,2920,1,0,2,0,3
8145,10,4826,6454;8443,2920,0,0,2,0,2
8146,10,4827,6464;11031,2920,1,0,1,0,2
8147,10,4828,565;6618,2920,0,0,2,0,2
8148,10,4829,6688;6700,2920,0,0,2,0,2
8149,10,4830,4799;6718,2920,0,0,2,0,2
8150,10,4831,293;6910;10999;11196,2920,2,0,2,0,4
8151,10,4833,3120;7223,2920,0,0,2,0,2
8152,10,4834,3039,2920,0,0,1,0,1
8153,10,4836,6636;7419,2920,0,0,2,0,2
8154,10,4837,7502,2920,0,0,0,1,1
8155,10,4838,3641;7618,2920,0,0,2,0,2
8156,10,4839,7723,2920,0,0,1,0,1
8157,10,4840,5878,2920,0,0,1,0,1
8158,10,4841,2816;7889,2920,0,0,2,0,2
8159,10,4842,7902,2920,0,0,0,1,1
8160,10,4844,7181;8167,2920,0,0,2,0,2
8161,10,4845,8254,2920,0,0,1,0,1
8162,10,4846,4509;6989,2920,0,0,2,0,2
8163,10,4847,4854;8406,2920,0,0,2,0,2
8164,10,4848,8451,2920,0,0,1,0,1
8165,10,4849,4978,2920,0,0,1,0,1
8166,10,4851,8169;8784,2920,0,0,2,0,2
8167,10,4852,8850,2920,0,0,1,0,1
8168,10,4853,7896;8902,2920,0,0,2,0,2
8169,10,4854,2093;8997;11023,2920,1,0,2,0,3
8170,10,4856,1647;9196,2920,0,0,2,0,2
8171,10,4857,8123;9355,2920,0,0,2,0,2
8172,10,4858,1343,2920,0,0,1,0,1
8173,10,4859,1352;9664,2920,0,0,2,0,2
8174,10,4860,9681,2920,0,0,1,0,1
8175,10,4861,9706,2920,0,0,1,0,1
8176,10,4862,7378;9833;11167,2920,1,0,2,0,3
8177,10,4863,848;9930,2920,0,0,2,0,2
8178,10,4864,3011;9985,2920,0,0,2,0,2
8179,10,4865,28,3285,0,0,1,0,1
8180,10,4866,35,3285,0,0,1,0,1
8181,10,4867,37;7398,3285,0,0,2,0,2
8182,10,4869,116;4373,3285,0,0,2,0,2
8183,10,4870,128;1728,3285,0,0,2,0,2
8184,10,4871,183;4628,3285,0,0,2,0,2
8185,10,4872,188;3177,3285,0,0,2,0,2
8186,10,4873,272;6820,3285,0,0,2,0,2
8187,10,4874,381,3285,0,0,1,0,1
8188,10,4875,503;6629,3285,0,0,2,0,2
8189,10,4876,536;4548,3285,0,0,2,0,2
8190,10,4877,572,3285,0,0,1,0,1
8191,10,4878,6699,3285,0,0,1,0,1
8192,10,4879,875,3285,0,0,0,1,1
8193,10,4880,877;9879;11038,3285,1,0,2,0,3
8194,10,4881,952;8928,3285,0,0,2,0,2
8195,10,4882,958;9799,3285,0,0,2,0,2
8196,10,4883,1238;3376;11071,3285,1,0,2,0,3
8197,10,4884,1287;8592,3285,0,0,2,0,2
8198,10,4885,7013,3285,0,0,1,0,1
8199,10,4886,1658,3285,0,0,1,0,1
8200,10,4887,1679;1976,3285,0,0,2,0,2
8201,10,4889,1759,3285,0,0,1,0,1
8202,10,4890,1820;4320;11089,3285,1,0,2,0,3
8203,10,4891,4435;9649,3285,0,0,2,0,2
8204,10,4892,1977,3285,0,0,1,0,1
8205,10,4893,1990;9245,3285,0,0,2,0,2
8206,10,4894,936;2117,3285,0,0,2,0,2
8207,10,4895,2205,3285,0,0,1,0,1
8208,10,4896,3788,3285,0,0,1,0,1
8209,10,4898,1386;2417,3285,0,0,2,0,2
8210,10,4899,2481;5159;11132,3285,1,0,2,0,3
8211,10,4900,4553;8903,3285,0,0,2,0,2
8212,10,4901,2706,3285,0,0,1,0,1
8213,10,4902,2747,3285,0,0,1,0,1
8214,10,4903,3091;3789,3285,0,0,2,0,2
8215,10,4904,3125,3285,0,0,1,0,1
8216,10,4905,3276;6405,3285,0,0,2,0,2
8217,10,4906,3342,3285,0,0,1,0,1
8218,10,4907,3437,3285,0,0,1,0,1
8219,10,4908,3476;9776,3285,0,0,2,0,2
8220,10,4909,3523;5949,3285,0,0,2,0,2
8221,10,4910,6559,3285,0,0,1,0,1
8222,10,4912,3632,3285,0,0,1,0,1
8223,10,4913,6;3633;11027,3285,1,0,2,0,3
8224,10,4914,3639;4401,3285,0,0,2,0,2
8225,10,4915,3672;6847,3285,0,0,2,0,2
8226,10,4916,3716;4576,3285,0,0,2,0,2
8227,10,4917,9431,3285,0,0,1,0,1
8228,10,4918,3869;9188;11085,3285,1,0,2,0,3
8229,10,4919,3070;3968;11036,3285,1,0,2,0,3
8230,10,4920,3996,3285,0,0,1,0,1
8231,10,4921,4067,3285,0,0,0,1,1
8232,10,4922,1318;9684,3285,0,0,2,0,2
8233,10,4923,4479;4499;11046,3285,1,0,2,0,3
8234,10,4924,4691,3285,0,0,1,0,1
8235,10,4925,4721,3285,0,0,1,0,1
8236,10,4926,9570,3285,0,0,1,0,1
8237,10,4927,2217,3285,0,0,1,0,1
8238,10,4928,5026,3285,0,0,1,0,1
8239,10,4929,5075,3285,0,0,0,1,1
8240,10,4930,5226,3285,0,0,1,0,1
8241,10,4931,5692;5936,3285,0,0,2,0,2
8242,10,4932,4517,3285,0,0,1,0,1
8243,10,4933,212;5863,3285,0,0,2,0,2
8244,10,4934,5939;8595,3285,0,0,2,0,2
8245,10,4935,3741;6101,3285,0,0,2,0,2
8246,10,4936,6120,3285,0,0,1,0,1
8247,10,4937,6188,3285,0,0,1,0,1
8248,10,4938,4514;6285,3285,0,0,2,0,2
8249,10,4939,2080;6486,3285,0,0,2,0,2
8250,10,4940,6537,3285,0,0,1,0,1
8251,10,4941,4850;6727,3285,0,0,2,0,2
8252,10,4942,6873,3285,0,0,1,0,1
8253,10,4943,6895,3285,0,0,1,0,1
8254,10,4944,6954;8808,3285,0,0,2,0,2
8255,10,4945,6792;6970;11164,3285,1,0,2,0,3
8256,10,4946,1074,3285,0,0,1,0,1
8257,10,4947,5410;7192,3285,0,0,2,0,2
8258,10,4948,7326,3285,0,0,0,1,1
8259,10,4949,2215;7394,3285,0,0,2,0,2
8260,10,4950,4293;7428;11076;11203,3285,2,0,2,0,4
8261,10,4951,3417;7461,3285,0,0,2,0,2
8262,10,4952,3575;7488;11160,3285,1,0,2,0,3
8263,10,4953,7752,3285,0,0,1,0,1
8264,10,4954,8067,3285,0,0,0,1,1
8265,10,4955,8124,3285,0,0,1,0,1
8266,10,4956,8148;9462,3285,0,0,2,0,2
8267,10,4957,1431,3285,0,0,1,0,1
8268,10,4958,8319,3285,0,0,1,0,1
8269,10,4959,6542;8368,3285,0,0,2,0,2
8270,10,4960,3978;8466,3285,0,0,2,0,2
8271,10,4961,8490,3285,0,0,1,0,1
8272,10,4962,5021;9351,3285,0,0,2,0,2
8273,10,4963,8911,3285,0,0,1,0,1
8274,10,4964,8623;8922,3285,0,0,2,0,2
8275,10,4965,2429,3285,0,0,1,0,1
8276,10,4966,7330;9017,3285,0,0,2,0,2
8277,10,4967,9066,3285,0,0,1,0,1
8278,10,4968,9256,3285,0,0,1,0,1
8279,10,4969,9369,3285,0,0,1,0,1
8280,10,4970,9463,3285,0,0,1,0,1
8281,10,4971,8262,3285,0,0,1,0,1
8282,10,4972,3960;7025,3285,0,0,2,0,2
8283,10,4973,2654;9639,3285,0,0,2,0,2
8284,10,4974,9666,3285,0,0,1,0,1
8285,10,4975,2972;9739,3285,0,0,2,0,2
8286,10,4976,9898,3285,0,0,1,0,1
8287,10,4977,153;7525,3650,0,0,2,0,2
8288,10,4978,348,3650,0,0,1,0,1
8289,10,4979,360;3298,3650,0,0,2,0,2
8290,10,4980,9488,3650,0,0,1,0,1
8291,10,4981,721,3650,0,0,1,0,1
8292,10,4982,771;2656,3650,0,0,2,0,2
8293,10,4983,1032;9455,3650,0,0,2,0,2
8294,10,4984,3407,3650,0,0,1,0,1
8295,10,4985,1183,3650,0,0,1,0,1
8296,10,4986,1256,3650,0,0,1,0,1
8297,10,4987,1304,3650,0,0,1,0,1
8298,10,4988,1312,3650,0,0,1,0,1
8299,10,4989,1351;8099,3650,0,0,2,0,2
8300,10,4990,1416;2799,3650,0,0,2,0,2
8301,10,4991,1532,3650,0,0,1,0,1
8302,10,4992,1572;1774,3650,0,0,2,0,2
8303,10,4993,7046,3650,0,0,1,0,1
8304,10,4994,1933;7554;11129,3650,1,0,2,0,3
8305,10,4995,2018,3650,0,0,1,0,1
8306,10,4996,2147,3650,0,0,1,0,1
8307,10,4997,2362,3650,0,0,1,0,1
8308,10,4998,2384,3650,0,0,1,0,1
8309,10,4999,1217;2404,3650,0,0,2,0,2
8310,10,5000,8361,3650,0,0,1,0,1
8311,10,5001,2593,3650,0,0,1,0,1
8312,10,5002,3520,3650,0,0,1,0,1
8313,10,5003,3717;7275,3650,0,0,2,0,2
8314,10,5004,1599;3730,3650,0,0,2,0,2
8315,10,5005,3846,3650,0,0,0,1,1
8316,10,5006,870;3930,3650,0,0,2,0,2
8317,10,5007,7825,3650,0,0,1,0,1
8318,10,5008,4034,3650,0,0,1,0,1
8319,10,5009,8187,3650,0,0,1,0,1
8320,10,5010,4061;6110,3650,0,0,2,0,2
8321,10,5011,4308;5662,3650,0,0,2,0,2
8322,10,5012,393,3650,0,0,1,0,1
8323,10,5013,6655,3650,0,0,1,0,1
8324,10,5014,4581;7873,3650,0,0,2,0,2
8325,10,5015,2669;4755;11170,3650,1,0,2,0,3
8326,10,5016,4823,3650,0,0,1,0,1
8327,10,5017,4953;8566,3650,0,0,2,0,2
8328,10,5018,5157,3650,0,0,1,0,1
8329,10,5019,5184,3650,0,0,1,0,1
8330,10,5020,5195,3650,0,0,1,0,1
8331,10,5021,5572;8297;11171,3650,1,1,1,0,3
8332,10,5022,7164,3650,0,0,1,0,1
8333,10,5023,6278,3650,0,0,1,0,1
8334,10,5024,617,3650,0,0,1,0,1
8335,10,5025,147,3650,0,0,1,0,1
8336,10,5026,5902,3650,0,0,1,0,1
8337,10,5027,5920,3650,0,0,1,0,1
8338,10,5028,3492;5950,3650,0,1,1,0,2
8339,10,5029,6068;6846,3650,0,0,2,0,2
8340,10,5030,444;6466,3650,0,1,1,0,2
8341,10,5031,2629;6661,3650,0,0,2,0,2
8342,10,5032,6862,3650,0,0,1,0,1
8343,10,5033,7450,3650,0,0,1,0,1
8344,10,5034,7527,3650,0,0,0,1,1
8345,10,5036,7744;9139,3650,0,1,1,0,2
8346,10,5037,7842,3650,0,0,1,0,1
8347,10,5038,8005,3650,0,0,1,0,1
8348,10,5039,2475;8106,3650,0,1,1,0,2
8349,10,5040,8719,3650,0,0,1,0,1
8350,10,5041,2033;8307,3650,0,0,2,0,2
8351,10,5042,8291;8473,3650,0,0,2,0,2
8352,10,5043,1596,3650,0,0,1,0,1
8353,10,5044,8921,3650,0,0,1,0,1
8354,10,5045,6982;8977,3650,0,0,2,0,2
8355,10,5046,4045;9041,3650,0,0,2,0,2
8356,10,5047,5964;9045,3650,0,0,2,0,2
8357,10,5048,9112,3650,0,0,1,0,1
8358,10,5049,3;9187,3650,0,0,2,0,2
8359,10,5050,9441,3650,0,0,1,0,1
8360,10,5051,9517,3650,0,0,1,0,1
8361,10,5052,4723;9637,3650,0,0,2,0,2
8362,10,5053,4187;9642,3650,0,0,2,0,2
8363,10,5054,7969;9782,3650,0,0,2,0,2
8364,20,0,1;2,0,0,0,0,2,2
8365,20,1,4;11651;12270,0,1,1,1,0,3
8366,20,2,11;13,0,0,0,2,0,2
8367,20,3,15,0,0,0,0,1,1
8368,20,4,16;18,0,0,0,1,1,2
8369,20,6,20;9603,0,0,0,2,0,2
8370,20,7,23,0,0,0,0,1,1
8371,20,8,26,0,0,0,1,0,1
8372,20,9,27;29;6088,0,0,0,2,1,3
8373,20,12,33,0,0,0,0,1,1
8374,20,13,39;2497;10845,0,0,1,2,0,3
8375,20,14,4063,0,0,0,0,1,1
8376,20,15,46;47,0,0,0,1,1,2
8377,20,17,53;57,0,0,0,2,0,2
8378,20,18,58;4413,0,0,0,2,0,2
8379,20,19,60,0,0,0,0,1,1
8380,20,20,62;63;10076;10129;10268;10809;11039;11814,0,1,2,4,1,8
8381,20,21,67,0,0,0,0,1,1
8382,20,22,70;10505;11462,0,0,2,1,0,3
8383,20,23,73,0,0,0,0,1,1
8384,20,24,77,0,0,0,0,1,1
8385,20,25,1931;9208;11809,0,1,0,2,0,3
8386,20,27,85;86,0,0,0,1,1,2
8387,20,28,50;89;90;11926,0,1,0,3,0,4
8388,20,29,91;92;93;10197;10314,0,0,0,4,1,5
8389,20,31,96;97,0,0,0,1,1,2
8390,20,33,99;100,0,0,0,2,0,2
8391,20,35,105,0,0,0,0,1,1
8392,20,36,108;109;113,0,0,0,2,1,3
8393,20,37,114,0,0,0,0,1,1
8394,20,38,117;120;11667;11854,0,1,1,2,0,4
8395,20,39,122,0,0,0,0,1,1
8396,20,40,124,0,0,0,0,1,1
8397,20,42,129,0,0,0,0,1,1
8398,20,43,131;9861,0,0,0,2,0,2
8399,20,44,133;134,0,0,0,1,1,2
8400,20,45,137;8867;10443;11522,0,0,2,2,0,4
8401,20,46,138,0,0,0,0,1,1
8402,20,49,142;145,0,0,0,0,2,2
8403,20,52,151;7297,0,0,0,2,0,2
8404,20,53,154,0,0,0,1,0,1
8405,20,54,157;159,0,0,0,2,0,2
8406,20,55,162;2306;10388;10503,0,0,1,3,0,4
8407,20,56,164;10300;10931;11471,0,0,2,2,0,4
8408,20,57,165;166,0,0,0,0,2,2
8409,20,58,167;170,0,0,0,1,1,2
8410,20,59,171;172,0,0,0,1,1,2
8411,20,60,173;174,0,0,0,0,2,2
8412,20,61,176;179;180,0,0,0,2,1,3
8413,20,62,185;186,0,0,0,0,2,2
8414,20,64,190;192,0,0,0,0,2,2
8415,20,65,193;194,0,0,0,1,1,2
8416,20,67,198;2635,0,0,0,0,2,2
8417,20,68,204;205;7484,0,0,0,1,2,3
8418,20,69,206;207,0,0,0,1,1,2
8419,20,70,208,0,0,0,0,1,1
8420,20,71,210;572;10207;10255,0,0,0,4,0,4
8421,20,73,214;215;217;218,0,0,0,2,2,4
8422,20,74,1463,0,0,0,0,1,1
8423,20,77,226;228,0,0,0,1,1,2
8424,20,78,229;230,0,0,0,1,1,2
8425,20,79,234;235,0,0,0,0,2,2
8426,20,80,238,0,0,0,0,1,1
8427,20,81,241;242,0,0,0,1,1,2
8428,20,83,245;246;247,0,0,0,1,2,3
8429,20,84,249;10194;10240,0,0,0,3,0,3
8430,20,85,251,0,0,0,0,1,1
8431,20,86,253;5298,0,0,0,2,0,2
8432,20,87,255;1816,0,0,0,0,2,2
8433,20,88,256;257,0,0,0,0,2,2
8434,20,90,261,0,0,0,0,1,1
8435,20,92,264;2637,0,0,0,2,0,2
8436,20,93,265;268,0,0,0,1,1,2
8437,20,94,269;270,0,0,0,0,2,2
8438,20,95,274,0,0,0,0,1,1
8439,20,96,275;276,0,0,0,0,2,2
8440,20,99,281;283,0,0,0,0,2,2
8441,20,100,284;285,0,0,0,0,2,2
8442,20,101,287,0,0,0,0,1,1
8443,20,104,295;8027,0,0,0,0,2,2
8444,20,105,297,0,0,0,0,1,1
8445,20,106,300,0,0,0,0,1,1
8446,20,107,301;302,0,0,0,1,1,2
8447,20,109,306;605,0,0,0,0,2,2
8448,20,110,311,0,0,0,0,1,1
8449,20,111,312;314;315,0,0,0,0,3,3
8450,20,112,317;318;320,0,0,0,1,2,3
8451,20,113,321;322;10745;10821,0,0,2,1,1,4
8452,20,114,323,0,0,0,0,1,1
8453,20,118,331;332;334,0,0,0,2,1,3
8454,20,119,337,0,0,0,0,1,1
8455,20,120,338,0,0,0,0,1,1
8456,20,121,339,0,0,0,0,1,1
8457,20,122,342,0,0,0,0,1,1
8458,20,123,343;8818,0,0,0,0,2,2
8459,20,125,346,0,0,0,0,1,1
8460,20,126,351,0,0,0,0,1,1
8461,20,127,9894,0,0,0,1,0,1
8462,20,128,354;7852,0,0,0,2,0,2
8463,20,129,358;359,0,0,0,2,0,2
8464,20,130,362;582,0,0,0,2,0,2
8465,20,131,364;7435,0,0,0,2,0,2
8466,20,132,310,0,0,0,1,0,1
8467,20,133,369,0,0,0,0,1,1
8468,20,134,372;1878;10110;10262,0,0,0,4,0,4
8469,20,135,373,0,0,0,0,1,1
8470,20,136,377;379,0,0,0,1,1,2
8471,20,138,382;383;10440,0,0,1,2,0,3
8472,20,139,384;385;386;10764,0,0,1,2,1,4
8473,20,141,388;389;390,0,0,0,1,2,3
8474,20,142,391,0,0,0,0,1,1
8475,20,143,394;4885,0,0,0,2,0,2
8476,20,144,396;10681;11276;11734,0,0,3,1,0,4
8477,20,145,398;1896,0,0,0,2,0,2
8478,20,148,402;403;405,0,0,0,1,2,3
8479,20,150,407;408,0,0,0,0,2,2
8480,20,152,412;5926,0,0,0,0,2,2
8481,20,154,416;4608,0,0,0,0,2,2
8482,20,155,5583,0,0,0,0,1,1
8483,20,156,418,0,0,0,0,1,1
8484,20,157,422;424,0,0,0,0,2,2
8485,20,158,425;426,0,0,0,0,2,2
8486,20,159,427;428,0,0,0,2,0,2
8487,20,161,432,0,0,0,0,1,1
8488,20,162,435;10527;10609,0,0,2,1,0,3
8489,20,163,438;1219,0,0,0,0,2,2
8490,20,164,441,0,0,0,0,1,1
8491,20,165,446;506,0,0,0,0,2,2
8492,20,167,451;452;10384;10957,0,0,1,2,1,4
8493,20,168,453;454,0,0,0,0,2,2
8494,20,169,344;457;460,0,0,0,3,0,3
8495,20,170,462;463,0,0,0,0,2,2
8496,20,171,464;465,0,0,0,0,2,2
8497,20,173,470;5615;12053,0,1,0,2,0,3
8498,20,174,471;472,0,0,0,0,2,2
8499,20,175,473;474,0,0,0,0,2,2
8500,20,176,478;1390,0,0,0,0,2,2
8501,20,177,481;482,0,0,0,0,2,2
8502,20,178,483;484,0,0,0,0,2,2
8503,20,179,491;493,0,0,0,1,1,2
8504,20,180,495,0,0,0,0,1,1
8505,20,181,496;497,0,0,0,1,1,2
8506,20,182,498;499,0,0,0,1,1,2
8507,20,183,500;7164;10490;11116;11726,0,0,3,2,0,5
8508,20,184,502;7667;10408;10489;11235,0,0,2,3,0,5
8509,20,185,505;3198;11858,0,1,0,2,0,3
8510,20,187,508,0,0,0,0,1,1
8511,20,188,510;512;8871,0,0,0,1,2,3
8512,20,189,515,0,0,0,0,1,1
8513,20,190,518;519,0,0,0,1,1,2
8514,20,191,522;524,0,0,0,1,1,2
8515,20,193,529;530,0,0,0,0,2,2
8516,20,195,532;4638,0,0,0,0,2,2
8517,20,197,535;10065,0,0,0,2,0,2
8518,20,198,539,0,0,0,0,1,1
8519,20,199,540;541,0,0,0,0,2,2
8520,20,200,543;544,0,0,0,0,2,2
8521,20,201,548,0,0,0,0,1,1
8522,20,202,551,0,0,0,0,1,1
8523,20,203,554;3813,0,0,0,2,0,2
8524,20,206,564,0,0,0,0,1,1
8525,20,207,566;567,0,0,0,0,2,2
8526,20,208,1915,0,0,0,0,1,1
8527,20,209,570,0,0,0,1,0,1
8528,20,210,573;5862,0,0,0,0,2,2
8529,20,211,575;8570,0,0,0,0,2,2
8530,20,216,581;10031;10365,0,0,0,3,0,3
8531,20,217,585,0,0,0,1,0,1
8532,20,218,35;589,0,0,0,2,0,2
8533,20,219,591,0,0,0,0,1,1
8534,20,220,595;596,0,0,0,0,2,2
8535,20,222,600,0,0,0,0,1,1
8536,20,223,601,0,0,0,0,1,1
8537,20,227,610;613,0,0,0,1,1,2
8538,20,228,614,0,0,0,0,1,1
8539,20,231,621;622;10333;11264,0,0,1,2,1,4
8540,20,233,624;625;626,0,0,0,2,1,3
8541,20,234,627,0,0,0,0,1,1
8542,20,235,629;5974;10947;11101;11352,0,0,3,2,0,5
8543,20,238,637,0,0,0,0,1,1
8544,20,239,641,0,0,0,1,0,1
8545,20,240,644;9790;10399;10515;11732;12314,0,1,2,3,0,6
8546,20,241,646;647,0,0,0,0,2,2
8547,20,243,650;651;1239,0,0,0,2,1,3
8548,20,246,658;8522,0,0,0,2,0,2
8549,20,247,660,0,0,0,0,1,1
8550,20,250,666;667,0,0,0,1,1,2
8551,20,252,9260,0,0,0,0,1,1
8552,20,253,671;3607;10190,0,0,0,3,0,3
8553,20,254,542;676;10075,0,0,0,3,0,3
8554,20,255,678,0,0,0,0,1,1
8555,20,256,683,0,0,0,1,0,1
8556,20,257,688;10062,0,0,0,2,0,2
8557,20,258,689;2502;10907;11146,0,0,2,2,0,4
8558,20,262,694;695,0,0,0,0,2,2
8559,20,264,697;698,0,0,0,1,1,2
8560,20,267,707,0,0,0,1,0,1
8561,20,269,709;1153,0,0,0,2,0,2
8562,20,270,713;2983,0,0,0,2,0,2
8563,20,271,715;9662,0,0,0,0,2,2
8564,20,272,717,0,0,0,0,1,1
8565,20,273,718;719,0,0,0,1,1,2
8566,20,274,722;723;10788;11311,0,0,2,1,1,4
8567,20,275,725,0,0,0,0,1,1
8568,20,276,729,0,0,0,0,1,1
8569,20,277,733;8898,0,0,0,2,0,2
8570,20,278,737,0,0,0,0,1,1
8571,20,279,738;6344;10326;10659;11643,0,0,2,3,0,5
8572,20,282,743,0,0,0,0,1,1
8573,20,283,745;2242;10071;10417;11393,0,0,1,4,0,5
8574,20,284,746;747,0,0,0,1,1,2
8575,20,286,750;753,0,0,0,1,1,2
8576,20,288,756;10447;10623,0,0,2,1,0,3
8577,20,289,757;758,0,0,0,1,1,2
8578,20,291,760;6147;10538;10978;11015,0,0,3,2,0,5
8579,20,292,761;762,0,0,0,1,1,2
8580,20,293,763;6539;11091;11134,0,0,2,2,0,4
8581,20,294,764;765;5094,0,0,0,3,0,3
8582,20,297,774;7780,0,0,0,2,0,2
8583,20,299,780;781,0,0,0,0,2,2
8584,20,301,787,0,0,0,1,0,1
8585,20,302,788,0,0,0,0,1,1
8586,20,303,789;1983,0,0,0,0,2,2
8587,20,304,791;792;9923,0,0,0,2,1,3
8588,20,305,796;798,0,0,0,2,0,2
8589,20,306,799;800;803;804;10048;10476;11001,0,0,2,4,1,7
8590,20,307,805;10289,0,0,0,2,0,2
8591,20,308,806;807,0,0,0,2,0,2
8592,20,309,808,0,0,0,0,1,1
8593,20,310,812;813,0,0,0,1,1,2
8594,20,311,814;815,0,0,0,0,2,2
8595,20,313,818,0,0,0,1,0,1
8596,20,315,821;822,0,0,0,0,2,2
8597,20,316,823,0,0,0,0,1,1
8598,20,318,830;831,0,0,0,1,1,2
8599,20,319,832;833,0,0,0,0,2,2
8600,20,321,835;836;837;838;839,0,0,0,3,2,5
8601,20,322,840;841,0,0,0,1,1,2
8602,20,323,842,0,0,0,0,1,1
8603,20,324,847,0,0,0,1,0,1
8604,20,325,849,0,0,0,0,1,1
8605,20,326,852,0,0,0,0,1,1
8606,20,327,854;855;10499;10889,0,0,2,1,1,4
8607,20,328,856,0,0,0,0,1,1
8608,20,330,861;862,0,0,0,0,2,2
8609,20,331,866;867,0,0,0,1,1,2
8610,20,332,869;10807;11361,0,0,2,1,0,3
8611,20,333,874,0,0,0,0,1,1
8612,20,334,876;878;5401,0,0,0,3,0,3
8613,20,335,880,0,0,0,0,1,1
8614,20,336,882,0,0,0,0,1,1
8615,20,337,884,0,0,0,1,0,1
8616,20,338,885;886,0,0,0,1,1,2
8617,20,339,889,0,0,0,0,1,1
8618,20,340,893;894,0,0,0,2,0,2
8619,20,341,898,0,0,0,1,0,1
8620,20,342,900,0,0,0,0,1,1
8621,20,343,905,0,0,0,0,1,1
8622,20,344,906;907;909,0,0,0,1,2,3
8623,20,346,911,0,0,0,0,1,1
8624,20,347,912;913,0,0,0,0,2,2
8625,20,350,920;921;4736;7150;12132,0,1,0,4,0,5
8626,20,352,924;925,0,0,0,2,0,2
8627,20,353,929;9246;12288,0,1,0,2,0,3
8628,20,354,930;932;7734;11698,0,0,1,3,0,4
8629,20,355,935,0,0,0,0,1,1
8630,20,357,939;940,0,0,0,1,1,2
8631,20,358,942;8812,0,0,0,1,1,2
8632,20,359,946,0,0,0,0,1,1
8633,20,360,947,0,0,0,0,1,1
8634,20,361,949;11198,0,0,1,1,0,2
8635,20,363,956,0,0,0,0,1,1
8636,20,364,962,0,0,0,0,1,1
8637,20,365,965;10517;10590,0,0,2,1,0,3
8638,20,367,969;970;976;978,0,0,0,0,4,4
8639,20,368,981,0,0,0,0,1,1
8640,20,369,984;988;3974;3976;3977,0,0,0,3,2,5
8641,20,370,989;990,0,0,0,1,1,2
8642,20,372,993,0,0,0,1,0,1
8643,20,373,994;995,0,0,0,0,2,2
8644,20,374,996,0,0,0,0,1,1
8645,20,375,998,0,0,0,0,1,1
8646,20,376,1000;10209;10966;11103,0,0,2,2,0,4
8647,20,377,1002;1003,0,0,0,0,2,2
8648,20,378,1004;1005,0,0,0,1,1,2
8649,20,379,1008,0,0,0,0,1,1
8650,20,380,1011,0,0,0,0,1,1
8651,20,381,1012;1013,0,0,0,1,1,2
8652,20,382,1014;6783;10946;11270,0,0,2,2,0,4
8653,20,383,1017,0,0,0,0,1,1
8654,20,384,1019;6142;10169;10273,0,0,0,4,0,4
8655,20,385,1020,0,0,0,1,0,1
8656,20,387,1024;1025;1026,0,0,0,2,1,3
8657,20,388,1028;1029,0,0,0,0,2,2
8658,20,391,1038,0,0,0,0,1,1
8659,20,392,1039;6796,0,0,0,0,2,2
8660,20,393,1043;1044;1045,0,0,0,2,1,3
8661,20,394,1046;4536,0,0,0,0,2,2
8662,20,395,1048;1050,0,0,0,1,1,2
8663,20,397,1057,0,0,0,0,1,1
8664,20,398,1058,0,0,0,1,0,1
8665,20,400,1062;1063;1065,0,0,0,1,2,3
8666,20,401,1066,0,0,0,0,1,1
8667,20,403,1069,0,0,0,0,1,1
8668,20,404,1073,0,0,0,0,1,1
8669,20,405,1075;3452,0,0,0,2,0,2
8670,20,406,1077,0,0,0,1,0,1
8671,20,407,1078,0,0,0,0,1,1
8672,20,409,1080;1081,0,0,0,0,2,2
8673,20,410,1082;10015;10339;11033,0,0,1,3,0,4
8674,20,411,1083;10325;10532,0,0,1,2,0,3
8675,20,412,1085;1086,0,0,0,0,2,2
8676,20,413,1087,0,0,0,0,1,1
8677,20,414,1088;1089,0,0,0,1,1,2
8678,20,415,1090;1092,0,0,0,2,0,2
8679,20,416,1094,0,0,0,0,1,1
8680,20,417,1098;1100;9218;9221,0,0,0,4,0,4
8681,20,418,1101;1102;10179;11069,0,0,1,2,1,4
8682,20,420,1106;1107;10793;11421;11720,0,0,3,2,0,5
8683,20,421,1108;8308,0,0,0,2,0,2
8684,20,423,1111;1112,0,0,0,2,0,2
8685,20,424,1113;1114,0,0,0,0,2,2
8686,20,425,1117;4255,0,0,0,2,0,2
8687,20,426,1110;1118,0,0,0,0,2,2
8688,20,427,1120,0,0,0,0,1,1
8689,20,428,1124,0,0,0,0,1,1
8690,20,429,1126,0,0,0,0,1,1
8691,20,430,243;1129;10530;10861,0,0,2,2,0,4
8692,20,431,1131;3646,0,0,0,0,2,2
8693,20,432,1132;2526,0,0,0,0,2,2
8694,20,433,1135;1136;1865,0,0,0,1,2,3
8695,20,434,1137;1138;1141,0,0,0,1,2,3
8696,20,435,1142;1144,0,0,0,1,1,2
8697,20,436,1146;1148,0,0,0,1,1,2
8698,20,439,1156;1158,0,0,0,1,1,2
8699,20,440,1159;1160;1163;1164;10202,0,0,0,3,2,5
8700,20,441,1165;1168,0,0,0,1,1,2
8701,20,445,1175,0,0,0,0,1,1
8702,20,446,1177,0,0,0,0,1,1
8703,20,448,1181;8904,0,0,0,2,0,2
8704,20,449,759;1182,0,0,0,0,2,2
8705,20,451,1185;1186,0,0,0,1,1,2
8706,20,453,1189;1190;1191;1192;10445;10792,0,0,2,3,1,6
8707,20,454,1193,0,0,0,0,1,1
8708,20,455,1196,0,0,0,0,1,1
8709,20,456,1198;3831;10878;10903;11059,0,0,3,2,0,5
8710,20,457,1201,0,0,0,0,1,1
8711,20,459,1204;6775,0,0,0,0,2,2
8712,20,460,1206;1208,0,0,0,0,2,2
8713,20,462,1214,0,0,0,0,1,1
8714,20,464,1220;1221,0,0,0,0,2,2
8715,20,465,1222,0,0,0,0,1,1
8716,20,466,1223;5804,0,0,0,2,0,2
8717,20,467,1226,0,0,0,0,1,1
8718,20,468,623;1228;1231,0,0,0,3,0,3
8719,20,469,1232,0,0,0,0,1,1
8720,20,470,1234,0,0,0,0,1,1
8721,20,472,1241,0,0,0,0,1,1
8722,20,473,1244;1245,0,0,0,0,2,2
8723,20,474,1248;9623;10797,0,0,1,2,0,3
8724,20,476,1255,0,0,0,0,1,1
8725,20,477,1258,0,0,0,0,1,1
8726,20,478,1260;3503,0,0,0,2,0,2
8727,20,479,1261;1262,0,0,0,0,2,2
8728,20,480,1265,0,0,0,0,1,1
8729,20,481,1268,0,0,0,0,1,1
8730,20,483,1275;1276,0,0,0,1,1,2
8731,20,485,1279;1280,0,0,0,0,2,2
8732,20,486,1281,0,0,0,0,1,1
8733,20,487,1283;8781;11677,0,0,1,2,0,3
8734,20,488,1285;3676;3678;3679;10986;11169;12189,0,1,2,4,0,7
8735,20,490,1290;1291,0,0,0,1,1,2
8736,20,491,1296;8317,0,0,0,2,0,2
8737,20,492,1300,0,0,0,0,1,1
8738,20,493,1303,0,0,0,0,1,1
8739,20,494,528;1307,0,0,0,2,0,2
8740,20,495,1309;1310,0,0,0,1,1,2
8741,20,497,1315;1316,0,0,0,2,0,2
8742,20,499,1322,0,0,0,0,1,1
8743,20,500,1324;10951,0,0,1,1,0,2
8744,20,501,1325,0,0,0,0,1,1
8745,20,502,1327,0,0,0,0,1,1
8746,20,503,1329;6543,0,0,0,2,0,2
8747,20,504,768;1330;1334,0,0,0,1,2,3
8748,20,505,1335;6079,0,0,0,0,2,2
8749,20,507,118;1338,0,0,0,2,0,2
8750,20,508,1340;1341,0,0,0,0,2,2
8751,20,509,421;1345,0,0,0,2,0,2
8752,20,510,1347,0,0,0,0,1,1
8753,20,512,1354,0,0,0,0,1,1
8754,20,513,1357,0,0,0,0,1,1
8755,20,514,1361;1362,0,0,0,0,2,2
8756,20,516,1366,0,0,0,0,1,1
8757,20,517,1369,0,0,0,1,0,1
8758,20,518,1373;9207;10081;10464,0,0,1,3,0,4
8759,20,519,1375;5704;11827;12365,0,2,0,2,0,4
8760,20,521,1378;1379,0,0,0,0,2,2
8761,20,522,1382,0,0,0,1,0,1
8762,20,523,327;1383,0,0,0,2,0,2
8763,20,524,1384,0,0,0,0,1,1
8764,20,528,1393,0,0,0,0,1,1
8765,20,530,1397,0,0,0,0,1,1
8766,20,531,1400,0,0,0,0,1,1
8767,20,534,1405;9204;10086;10308;10380,0,0,0,5,0,5
8768,20,535,1407;1408,0,0,0,1,1,2
8769,20,537,1412,0,0,0,0,1,1
8770,20,538,1413,0,0,0,0,1,1
8771,20,540,1422;1423,0,0,0,1,1,2
8772,20,542,1430,0,0,0,0,1,1
8773,20,543,1433,0,0,0,0,1,1
8774,20,544,1434,0,0,0,0,1,1
8775,20,545,1435;1436,0,0,0,2,0,2
8776,20,546,1438,0,0,0,0,1,1
8777,20,547,1439;1440,0,0,0,1,1,2
8778,20,548,1441,0,0,0,0,1,1
8779,20,549,1442,0,0,0,0,1,1
8780,20,550,1444,0,0,0,1,0,1
8781,20,552,1448,0,0,0,0,1,1
8782,20,553,1453;7690;11747,0,0,1,2,0,3
8783,20,554,1455,0,0,0,0,1,1
8784,20,555,1456;10645,0,0,1,1,0,2
8785,20,556,1459;1461;10343;11135,0,0,1,3,0,4
8786,20,559,1465;1466;1468,0,0,0,1,2,3
8787,20,560,1469;1471;1472;10185;10307;11092,0,0,1,5,0,6
8788,20,561,1473;5771;10918,0,0,1,2,0,3
8789,20,562,1475;1476;10593;11252,0,0,2,1,1,4
8790,20,563,1480,0,0,0,0,1,1
8791,20,564,1481;1482,0,0,0,0,2,2
8792,20,565,1483;1485;1486;3685;10058;10313,0,0,0,6,0,6
8793,20,566,1488,0,0,0,0,1,1
8794,20,567,1491;1492,0,0,0,1,1,2
8795,20,568,1495;1496,0,0,0,1,1,2
8796,20,569,1497,0,0,0,1,0,1
8797,20,571,1502;5602;10258;10742,0,0,1,3,0,4
8798,20,573,1506;10302;10611;11620,0,0,2,2,0,4
8799,20,574,1507;2743,0,0,0,0,2,2
8800,20,575,1510;1511,0,0,0,0,2,2
8801,20,576,1514,0,0,0,0,1,1
8802,20,578,1518;1519,0,0,0,0,2,2
8803,20,579,1520;1521,0,0,0,1,1,2
8804,20,580,1523,0,0,0,0,1,1
8805,20,581,1527,0,0,0,0,1,1
8806,20,582,517;1529;11629,0,0,1,2,0,3
8807,20,583,1530;1531,0,0,0,0,2,2
8808,20,584,461;1534,0,0,0,1,1,2
8809,20,585,1540;1542,0,0,0,1,1,2
8810,20,587,1546;1547;10318,0,0,0,3,0,3
8811,20,588,1549;6850;10909,0,0,1,2,0,3
8812,20,589,1550;1551,0,0,0,0,2,2
8813,20,590,1553;6560;6564;10064;10272;10522,0,0,1,5,0,6
8814,20,591,1555,0,0,0,0,1,1
8815,20,592,1557;1558;10469;10836,0,0,2,1,1,4
8816,20,593,1560;11578;11687,0,0,2,1,0,3
8817,20,595,1567,0,0,0,0,1,1
8818,20,596,1570,0,0,0,0,1,1
8819,20,597,1573,0,0,0,0,1,1
8820,20,598,1577,0,0,0,1,0,1
8821,20,600,1579,0,0,0,0,1,1
8822,20,603,1585;1587,0,0,0,0,2,2
8823,20,604,1591,0,0,0,0,1,1
8824,20,606,1595,0,0,0,0,1,1
8825,20,607,7390;8801;10467;10620;11118,0,0,3,2,0,5
8826,20,608,1597,0,0,0,1,0,1
8827,20,610,1602;1604,0,0,0,1,1,2
8828,20,611,1605;1606,0,0,0,1,1,2
8829,20,612,1607;7132,0,0,0,0,2,2
8830,20,614,1616;1618,0,0,0,1,1,2
8831,20,615,1620;1621;1623,0,0,0,2,1,3
8832,20,617,1626,0,0,0,0,1,1
8833,20,618,1628;1629;1630;10234;10557,0,0,1,4,0,5
8834,20,619,1631;1632;10228;10654;11143,0,0,2,2,1,5
8835,20,620,178;1633;11438;11701,0,0,2,2,0,4
8836,20,621,1635;1636,0,0,0,0,2,2
8837,20,622,1638,0,0,0,1,0,1
8838,20,623,1641,0,0,0,0,1,1
8839,20,624,1643;4764,0,0,0,2,0,2
8840,20,625,1646,0,0,0,0,1,1
8841,20,627,1656;1657,0,0,0,0,2,2
8842,20,628,3312;6256,0,0,0,0,2,2
8843,20,629,1659,0,0,0,0,1,1
8844,20,630,1660;1957,0,0,0,0,2,2
8845,20,632,1664;1668;9901,0,0,0,1,2,3
8846,20,637,1677,0,0,0,0,1,1
8847,20,638,1681;1682;2662,0,0,0,2,1,3
8848,20,639,1684,0,0,0,0,1,1
8849,20,640,1689,0,0,0,1,0,1
8850,20,641,1690;1693;1694,0,0,0,3,0,3
8851,20,642,4988;5742,0,0,0,2,0,2
8852,20,643,1701;1702,0,0,0,1,1,2
8853,20,644,1704;1706;1707;2073,0,0,0,2,2,4
8854,20,645,1708,0,0,0,0,1,1
8855,20,646,1710,0,0,0,0,1,1
8856,20,647,1712,0,0,0,0,1,1
8857,20,648,1715;1776,0,0,0,2,0,2
8858,20,649,1716;1717;1720,0,0,0,2,1,3
8859,20,650,1722,0,0,0,0,1,1
8860,20,651,1727,0,0,0,1,0,1
8861,20,653,1734,0,0,0,0,1,1
8862,20,654,1735;2465,0,0,0,2,0,2
8863,20,656,1742;1743,0,0,0,2,0,2
8864,20,657,292;1744;1747,0,0,0,1,2,3
8865,20,658,1748;1749,0,0,0,2,0,2
8866,20,660,1754;9192,0,0,0,2,0,2
8867,20,661,1756;3842,0,0,0,2,0,2
8868,20,662,1757;1758,0,0,0,0,2,2
8869,20,663,1487,0,0,0,1,0,1
8870,20,664,1761;1762,0,0,0,0,2,2
8871,20,665,1763;1764,0,0,0,1,1,2
8872,20,667,1770;1771;7499,0,0,0,3,0,3
8873,20,668,1773,0,0,0,0,1,1
8874,20,669,1778,0,0,0,0,1,1
8875,20,670,1779,0,0,0,0,1,1
8876,20,671,1781;1782,0,0,0,1,1,2
8877,20,672,1785,0,0,0,0,1,1
8878,20,677,1795;1797,0,0,0,1,1,2
8879,20,678,1799,0,0,0,0,1,1
8880,20,680,1804;1805,0,0,0,0,2,2
8881,20,682,1809;1810,0,0,0,2,0,2
8882,20,683,1811,0,0,0,0,1,1
8883,20,684,1812;1813;10442;10556;11214,0,0,3,1,1,5
8884,20,685,1815,0,0,0,0,1,1
8885,20,687,1817;1818;1819,0,0,0,0,3,3
8886,20,688,1823,0,0,0,0,1,1
8887,20,689,1825,0,0,0,0,1,1
8888,20,691,1828,0,0,0,0,1,1
8889,20,692,1830;7339;10041;10147,0,0,0,4,0,4
8890,20,695,2946;4352,0,0,0,0,2,2
8891,20,696,1839;1840,0,0,0,1,1,2
8892,20,698,1843;4648,0,0,0,2,0,2
8893,20,699,1844,0,0,0,0,1,1
8894,20,701,1852,0,0,0,0,1,1
8895,20,702,1853;1854,0,0,0,1,1,2
8896,20,703,1855,0,0,0,0,1,1
8897,20,704,1856;7441;10280,0,0,0,3,0,3
8898,20,705,1858;1859,0,0,0,0,2,2
8899,20,706,1861,0,0,0,0,1,1
8900,20,707,1863,0,0,0,0,1,1
8901,20,709,1760;1868;10605,0,0,1,2,0,3
8902,20,710,1869;2679,0,0,0,2,0,2
8903,20,713,1874;1875,0,0,0,0,2,2
8904,20,714,1876,0,0,0,1,0,1
8905,20,716,1880;1881;1883;11640,0,0,1,2,1,4
8906,20,719,1886;1888;1889,0,0,0,1,2,3
8907,20,720,1545;1891;1892;10047;10667,0,0,1,3,1,5
8908,20,721,1893,0,0,0,1,0,1
8909,20,723,1898,0,0,0,0,1,1
8910,20,724,1903,0,0,0,0,1,1
8911,20,726,1909,0,0,0,0,1,1
8912,20,727,1912,0,0,0,1,0,1
8913,20,728,1914;8043;10193;10475;11215;11242,0,0,3,3,0,6
8914,20,729,1916;6672,0,0,0,0,2,2
8915,20,730,1917;9761,0,0,0,2,0,2
8916,20,731,1919;9969,0,0,0,2,0,2
8917,20,732,1920;1921,0,0,0,1,1,2
8918,20,733,1923;1924,0,0,0,2,0,2
8919,20,735,1930,0,0,0,1,0,1
8920,20,736,8154;10844;11387,0,0,2,1,0,3
8921,20,737,1934,0,0,0,0,1,1
8922,20,738,5001;12122,0,1,0,1,0,2
8923,20,739,1937,0,0,0,0,1,1
8924,20,740,1938;1939,0,0,0,0,2,2
8925,20,741,1941;1942,0,0,0,0,2,2
8926,20,742,1946;1949,0,0,0,0,2,2
8927,20,744,1955,0,0,0,0,1,1
8928,20,747,1958,0,0,0,1,0,1
8929,20,750,1965;1966;10398,0,0,0,3,0,3
8930,20,751,1968;8451,0,0,0,2,0,2
8931,20,752,1969;1970;10125;10738,0,0,1,2,1,4
8932,20,753,1971;1972,0,0,0,1,1,2
8933,20,754,1975,0,0,0,0,1,1
8934,20,757,1988,0,0,0,1,0,1
8935,20,759,1993;7937;11154;11381;11746,0,0,3,2,0,5
8936,20,760,1994;6424,0,0,0,1,1,2
8937,20,762,1997,0,0,0,1,0,1
8938,20,767,2005;10025;10419;11388,0,0,1,3,0,4
8939,20,768,2006;2009;6085;7829;10583;10973;11156,0,0,3,4,0,7
8940,20,769,2015;2884,0,0,0,2,0,2
8941,20,771,2019;2020,0,0,0,0,2,2
8942,20,772,2023;2024,0,0,0,1,1,2
8943,20,773,2025;2026;10421;10695,0,0,1,2,1,4
8944,20,774,2028;2029,0,0,0,0,2,2
8945,20,775,2034;2036;2037;2040,0,0,0,0,4,4
8946,20,776,2044;4802,0,0,0,0,2,2
8947,20,777,2045,0,0,0,0,1,1
8948,20,778,2046,0,0,0,0,1,1
8949,20,779,2048,0,0,0,0,1,1
8950,20,780,2050,0,0,0,0,1,1
8951,20,782,2052,0,0,0,1,0,1
8952,20,783,2054;2055,0,0,0,1,1,2
8953,20,784,1464;2057;10111,0,0,0,3,0,3
8954,20,786,2061;2062,0,0,0,1,1,2
8955,20,787,2064,0,0,0,1,0,1
8956,20,788,2065;2069,0,0,0,2,0,2
8957,20,789,2070;2071,0,0,0,1,1,2
8958,20,792,2074;2075;2077,0,0,0,1,2,3
8959,20,793,2078;2079,0,0,0,0,2,2
8960,20,796,2084;2085;10356,0,0,0,2,1,3
8961,20,797,2086;2087,0,0,0,1,1,2
8962,20,798,2088;2090,0,0,0,1,1,2
8963,20,799,2094;2095,0,0,0,0,2,2
8964,20,801,2100;2101,0,0,0,0,2,2
8965,20,803,2103;5322;10457;10881,0,0,2,2,0,4
8966,20,805,2107;5779;9998;11866;12237,0,2,0,2,1,5
8967,20,806,2109;3354,0,0,0,1,1,2
8968,20,809,2114;5370,0,0,0,2,0,2
8969,20,810,2115,0,0,0,0,1,1
8970,20,811,2118,0,0,0,0,1,1
8971,20,812,2119;2120,0,0,0,1,1,2
8972,20,813,2122;2123,0,0,0,1,1,2
8973,20,814,2124;2125,0,0,0,0,2,2
8974,20,816,2128,0,0,0,1,0,1
8975,20,817,2132,0,0,0,0,1,1
8976,20,818,2139;2140;2142,0,0,0,1,2,3
8977,20,819,2143,0,0,0,1,0,1
8978,20,820,2144;2145,0,0,0,0,2,2
8979,20,821,2148;10068;10278;10541,0,0,1,3,0,4
8980,20,822,2149,0,0,0,1,0,1
8981,20,823,2151,0,0,0,0,1,1
8982,20,825,3694;6082,0,0,0,1,1,2
8983,20,826,2157;2158,0,0,0,1,1,2
8984,20,827,4894,0,0,0,0,1,1
8985,20,828,2162,0,0,0,0,1,1
8986,20,829,1023;2163,0,0,0,2,0,2
8987,20,830,2167;2168,0,0,0,1,1,2
8988,20,833,2173;2176;10956;11041;11539,0,0,3,2,0,5
8989,20,834,1598;2178;2179;10422;10544;10991;11828,0,1,2,4,0,7
8990,20,836,2183;2184,0,0,0,0,2,2
8991,20,838,2187;2188,0,0,0,0,2,2
8992,20,839,2190,0,0,0,0,1,1
8993,20,841,2193;2194,0,0,0,0,2,2
8994,20,842,2196,0,0,0,0,1,1
8995,20,843,2197,0,0,0,0,1,1
8996,20,844,2198;9200,0,0,0,1,1,2
8997,20,845,2199,0,0,0,0,1,1
8998,20,846,2200;2202,0,0,0,0,2,2
8999,20,847,2204,0,0,0,0,1,1
9000,20,848,2209,0,0,0,0,1,1
9001,20,849,2211,0,0,0,0,1,1
9002,20,850,2213;2214,0,0,0,0,2,2
9003,20,851,2216;7783,0,0,0,2,0,2
9004,20,852,2221;2223;2225;8061,0,0,0,3,1,4
9005,20,853,2227,0,0,0,0,1,1
9006,20,854,2228;2229,0,0,0,0,2,2
9007,20,855,9959,0,0,0,0,1,1
9008,20,857,2238;2239;2240;10484;10830;11184,0,0,3,3,0,6
9009,20,859,2243;2247,0,0,0,2,0,2
9010,20,860,2248;2249,0,0,0,0,2,2
9011,20,862,2257;3580,0,0,0,2,0,2
9012,20,863,2261,0,0,0,0,1,1
9013,20,864,2262;2263;2264,0,0,0,2,1,3
9014,20,865,2266;2267,0,0,0,1,1,2
9015,20,866,2271,0,0,0,1,0,1
9016,20,867,2113;2272,0,0,0,0,2,2
9017,20,868,2274;2275,0,0,0,2,0,2
9018,20,869,2276;2277;2280,0,0,0,0,3,3
9019,20,870,2284,0,0,0,0,1,1
9020,20,873,1202;2287;10184;10782;10997,0,0,2,3,0,5
9021,20,874,2293;2294;10872,0,0,1,2,0,3
9022,20,877,1565;2298;2299;10077;10348,0,0,0,4,1,5
9023,20,878,2303;2805;11180;11359;11801,0,1,2,2,0,5
9024,20,882,2311,0,0,0,0,1,1
9025,20,883,2312,0,0,0,0,1,1
9026,20,885,2315;2317,0,0,0,0,2,2
9027,20,886,652;2320;2321;2323;11949;12357,0,2,0,4,0,6
9028,20,887,2325;2327,0,0,0,0,2,2
9029,20,889,2331;6398,0,0,0,1,1,2
9030,20,890,5622,0,0,0,0,1,1
9031,20,891,2333;2334,0,0,0,1,1,2
9032,20,892,2335;2336,0,0,0,1,1,2
9033,20,893,2338;2409,0,0,0,2,0,2
9034,20,894,2342,0,0,0,1,0,1
9035,20,895,2344;3189;10534;10970;11115,0,0,3,2,0,5
9036,20,896,2347,0,0,0,0,1,1
9037,20,898,2353,0,0,0,0,1,1
9038,20,900,2358,0,0,0,0,1,1
9039,20,901,2363,0,0,0,0,1,1
9040,20,902,2367;2369;2370;3814,0,0,0,4,0,4
9041,20,903,2371,0,0,0,0,1,1
9042,20,904,2373;2374;10393;10835;11765,0,1,1,2,1,5
9043,20,905,2375,0,0,0,0,1,1
9044,20,906,2378,0,0,0,0,1,1
9045,20,908,2381;2382,0,0,0,0,2,2
9046,20,909,2386,0,0,0,0,1,1
9047,20,910,2387,0,0,0,0,1,1
9048,20,911,2390,0,0,0,1,0,1
9049,20,912,2393;2394;2395;2396;8152,0,0,0,4,1,5
9050,20,915,2400;2402,0,0,0,0,2,2
9051,20,917,2411,0,0,0,0,1,1
9052,20,918,2412;2413;2414,0,0,0,0,3,3
9053,20,919,2418;4793;11735;12223,0,1,1,2,0,4
9054,20,921,2421,0,0,0,0,1,1
9055,20,922,2422;2423,0,0,0,1,1,2
9056,20,923,2424,0,0,0,0,1,1
9057,20,924,7434,0,0,0,0,1,1
9058,20,927,2432,0,0,0,0,1,1
9059,20,928,2435;2436,0,0,0,0,2,2
9060,20,929,2437;2438,0,0,0,1,1,2
9061,20,930,2439;2440,0,0,0,0,2,2
9062,20,931,2444;2446,0,0,0,0,2,2
9063,20,932,2448,0,0,0,0,1,1
9064,20,934,2452,0,0,0,0,1,1
9065,20,935,2453;2454,0,0,0,0,2,2
9066,20,936,2457;2459,0,0,0,0,2,2
9067,20,937,2460,0,0,0,0,1,1
9068,20,940,2471;2472,0,0,0,1,1,2
9069,20,941,2473;2474;2476,0,0,0,1,2,3
9070,20,942,2477;2479,0,0,0,0,2,2
9071,20,944,2484;2485,0,0,0,1,1,2
9072,20,947,2488;2489,0,0,0,0,2,2
9073,20,948,2491;2493,0,0,0,1,1,2
9074,20,951,2505;2508;9585;11896;12361,0,2,0,2,1,5
9075,20,952,2509,0,0,0,0,1,1
9076,20,953,2513;8011;10225;10674,0,0,1,3,0,4
9077,20,954,2514,0,0,0,0,1,1
9078,20,956,2520,0,0,0,0,1,1
9079,20,957,2521,0,0,0,0,1,1
9080,20,958,2529,0,0,0,0,1,1
9081,20,960,2533;2534,0,0,0,1,1,2
9082,20,961,2536,0,0,0,0,1,1
9083,20,962,2538;5562,0,0,0,2,0,2
9084,20,964,2541;2542,0,0,0,1,1,2
9085,20,965,2547;8879,0,0,0,2,0,2
9086,20,966,2548;2549,0,0,0,1,1,2
9087,20,967,2550,0,0,0,1,0,1
9088,20,968,2551;2552,0,0,0,0,2,2
9089,20,969,2554,0,0,0,1,0,1
9090,20,970,531;2558,0,0,0,2,0,2
9091,20,971,2561,0,0,0,0,1,1
9092,20,972,2564;10101;10790,0,0,1,2,0,3
9093,20,973,2565;2566,0,0,0,0,2,2
9094,20,974,2567;2568,0,0,0,1,1,2
9095,20,975,2569;2570,0,0,0,0,2,2
9096,20,977,2574;2575;10208;10488,0,0,1,2,1,4
9097,20,978,80;2576,0,0,0,2,0,2
9098,20,979,2579;2581,0,0,0,1,1,2
9099,20,980,2153;2582,0,0,0,0,2,2
9100,20,983,2589,0,0,0,0,1,1
9101,20,984,2590;2591,0,0,0,1,1,2
9102,20,987,2597;2598;5539,0,0,0,3,0,3
9103,20,988,2600,0,0,0,0,1,1
9104,20,989,2602;7787;10281;10730,0,0,1,3,0,4
9105,20,990,2606,0,0,0,1,0,1
9106,20,991,2608;8882;10256;10501,0,0,1,3,0,4
9107,20,995,1211;2614;10265,0,0,0,3,0,3
9108,20,996,2616,0,0,0,0,1,1
9109,20,997,2072,0,0,0,0,1,1
9110,20,998,2618;2620;2706,0,0,0,3,0,3
9111,20,999,2624,0,0,0,0,1,1
9112,20,1000,2627,0,0,0,0,1,1
9113,20,1001,2630;4452;10495,0,0,1,2,0,3
9114,20,1002,2631;2632,0,0,0,0,2,2
9115,20,1006,2639,0,0,0,0,1,1
9116,20,1007,2640;2641,0,0,0,0,2,2
9117,20,1010,2648,0,0,0,1,0,1
9118,20,1011,2651,0,0,0,1,0,1
9119,20,1013,2658;8008;10531;10586,0,0,2,2,0,4
9120,20,1015,2660,0,0,0,0,1,1
9121,20,1017,2664;2665,0,0,0,0,2,2
9122,20,1018,2666;2668,0,0,0,1,1,2
9123,20,1019,2672;2673,0,0,0,0,2,2
9124,20,1022,2678;2680,0,0,0,0,2,2
9125,20,1023,2683;2684,0,0,0,0,2,2
9126,20,1024,2686,0,0,0,0,1,1
9127,20,1025,2690;2691;2693;5040,0,0,0,4,0,4
9128,20,1026,2695,0,0,0,0,1,1
9129,20,1027,2837,0,0,0,0,1,1
9130,20,1028,2697,0,0,0,0,1,1
9131,20,1029,2698;9810,0,0,0,2,0,2
9132,20,1031,2703,0,0,0,1,0,1
9133,20,1033,2707;9333,0,0,0,2,0,2
9134,20,1035,2710,0,0,0,0,1,1
9135,20,1036,2711;5758,0,0,0,0,2,2
9136,20,1037,233;2712,0,0,0,2,0,2
9137,20,1038,2713,0,0,0,0,1,1
9138,20,1039,2716;5780,0,0,0,2,0,2
9139,20,1040,2719,0,0,0,0,1,1
9140,20,1043,2726;2727;2728,0,0,0,2,1,3
9141,20,1045,2738;5433,0,0,0,2,0,2
9142,20,1048,2749;2751;5146;10535;10922,0,0,2,3,0,5
9143,20,1049,2752,0,0,0,0,1,1
9144,20,1050,2753,0,0,0,0,1,1
9145,20,1051,2754,0,0,0,0,1,1
9146,20,1052,2756;2757,0,0,0,0,2,2
9147,20,1053,2758;2759;2760,0,0,0,2,1,3
9148,20,1054,2761,0,0,0,0,1,1
9149,20,1055,2763,0,0,0,0,1,1
9150,20,1056,2767,0,0,0,0,1,1
9151,20,1059,2748;2773;2774;11486;11829,0,1,1,3,0,5
9152,20,1060,2777,0,0,0,0,1,1
9153,20,1062,7177,0,0,0,1,0,1
9154,20,1063,2786;2788;5333;10254;10371,0,0,0,5,0,5
9155,20,1064,2790,0,0,0,0,1,1
9156,20,1065,2792;8660,0,0,0,0,2,2
9157,20,1067,2796;2797,0,0,0,0,2,2
9158,20,1068,2803,0,0,0,0,1,1
9159,20,1069,2806;10221;11080,0,0,1,2,0,3
9160,20,1070,2809;2810,0,0,0,2,0,2
9161,20,1071,2813;2814,0,0,0,0,2,2
9162,20,1072,2819;2820,0,0,0,1,1,2
9163,20,1073,2822,0,0,0,0,1,1
9164,20,1074,2823;3099;11266;12305,0,1,1,2,0,4
9165,20,1075,2826;2828,0,0,0,0,2,2
9166,20,1076,2829;2830,0,0,0,1,1,2
9167,20,1077,2832;3781,0,0,0,2,0,2
9168,20,1078,7145,0,0,0,0,1,1
9169,20,1080,2841,0,0,0,0,1,1
9170,20,1081,2844,0,0,0,0,1,1
9171,20,1082,2846;2847,0,0,0,0,2,2
9172,20,1084,2851;2852,0,0,0,1,1,2
9173,20,1085,2853;2854;2855,0,0,0,1,2,3
9174,20,1086,2856,0,0,0,1,0,1
9175,20,1088,2862;2863,0,0,0,1,1,2
9176,20,1089,2866,0,0,0,0,1,1
9177,20,1090,2868;2869,0,0,0,1,1,2
9178,20,1093,2879;3293;10578;11003,0,0,2,2,0,4
9179,20,1094,2882;4803,0,0,0,1,1,2
9180,20,1096,2885;8951,0,0,0,2,0,2
9181,20,1098,1719;5939;11319;12309,0,1,1,2,0,4
9182,20,1099,887;2888;2893,0,0,0,1,2,3
9183,20,1100,2894,0,0,0,0,1,1
9184,20,1102,2398;2898,0,0,0,2,0,2
9185,20,1103,2900;2901;7283,0,0,0,1,2,3
9186,20,1104,2903,0,0,0,1,0,1
9187,20,1105,2904;2905,0,0,0,1,1,2
9188,20,1106,2907,0,0,0,0,1,1
9189,20,1107,2908;5636,0,0,0,0,2,2
9190,20,1109,2911;6261;10286;10358;10648;11825,0,1,1,4,0,6
9191,20,1111,2915;2916,0,0,0,1,1,2
9192,20,1113,1952;2918;2920;10386;10487;11182,0,0,2,4,0,6
9193,20,1114,2922,0,0,0,0,1,1
9194,20,1115,2923;2924,0,0,0,0,2,2
9195,20,1116,2925;2926,0,0,0,0,2,2
9196,20,1117,2927,0,0,0,0,1,1
9197,20,1119,2934,0,0,0,0,1,1
9198,20,1120,2936,0,0,0,0,1,1
9199,20,1121,2937;4841;10865,0,0,1,2,0,3
9200,20,1122,2939,0,0,0,0,1,1
9201,20,1123,2941;2942,0,0,0,1,1,2
9202,20,1124,2944;9658,0,0,0,2,0,2
9203,20,1125,2945,0,0,0,0,1,1
9204,20,1126,2947;2950,0,0,0,1,1,2
9205,20,1128,2955;2956,0,0,0,1,1,2
9206,20,1129,2957;2958;10072;10350;10494;10768;11149;11898,0,1,3,3,1,8
9207,20,1130,51;2962;10032;10317,0,0,0,4,0,4
9208,20,1131,2966,0,0,0,0,1,1
9209,20,1132,2968,0,0,0,0,1,1
9210,20,1133,2970;8338,0,0,0,1,1,2
9211,20,1134,2974,0,0,0,0,1,1
9212,20,1135,2977;2978,0,0,0,1,1,2
9213,20,1136,2981;2982,0,0,0,1,1,2
9214,20,1137,2984,0,0,0,0,1,1
9215,20,1138,2987;6514;10094;10152,0,0,0,4,0,4
9216,20,1139,2988;2989,0,0,0,0,2,2
9217,20,1140,2991,0,0,0,0,1,1
9218,20,1142,2994;2996;10165,0,0,0,3,0,3
9219,20,1145,3005;3007,0,0,0,2,0,2
9220,20,1146,3008;3009,0,0,0,0,2,2
9221,20,1147,3013,0,0,0,0,1,1
9222,20,1148,3015,0,0,0,0,1,1
9223,20,1149,3017;3018;3019,0,0,0,2,1,3
9224,20,1150,3020;3021,0,0,0,0,2,2
9225,20,1152,3024;7315;10237;10451,0,0,1,3,0,4
9226,20,1153,3026;3029;6818,0,0,0,2,1,3
9227,20,1154,3031,0,0,0,0,1,1
9228,20,1156,3040;3041;5088;6323;9819;10205;10244,0,0,0,7,0,7
9229,20,1157,3042;3044;3046,0,0,0,1,2,3
9230,20,1158,3047;3048,0,0,0,0,2,2
9231,20,1159,3049,0,0,0,0,1,1
9232,20,1161,3053;3054;3055,0,0,0,1,2,3
9233,20,1163,3060,0,0,0,0,1,1
9234,20,1164,3065,0,0,0,0,1,1
9235,20,1165,3068,0,0,0,0,1,1
9236,20,1167,3074,0,0,0,0,1,1
9237,20,1168,3077;3078;10553;10804;11050;11267,0,0,4,1,1,6
9238,20,1170,3080;8211;10382;11367,0,0,1,3,0,4
9239,20,1171,3081;4005,0,0,0,0,2,2
9240,20,1172,3085;3086;9026;10747,0,0,1,3,0,4
9241,20,1175,3093;3094,0,0,0,0,2,2
9242,20,1176,3096,0,0,0,0,1,1
9243,20,1177,3097;3098,0,0,0,0,2,2
9244,20,1180,3105;3108;10529;10833,0,0,2,2,0,4
9245,20,1181,3109;3110;3111,0,0,0,3,0,3
9246,20,1182,3112,0,0,0,0,1,1
9247,20,1183,3113;3114,0,0,0,0,2,2
9248,20,1184,3115;3118,0,0,0,1,1,2
9249,20,1185,3119;6447,0,0,0,2,0,2
9250,20,1186,3124;5485,0,0,0,1,1,2
9251,20,1189,6291,0,0,0,0,1,1
9252,20,1190,3135;3137;6125,0,0,0,1,2,3
9253,20,1191,3138;3141;4531,0,0,0,3,0,3
9254,20,1192,3142;6371,0,0,0,2,0,2
9255,20,1193,3143;8004,0,0,0,1,1,2
9256,20,1194,3147;3148,0,0,0,1,1,2
9257,20,1198,3153,0,0,0,0,1,1
9258,20,1199,3158,0,0,0,0,1,1
9259,20,1200,3162;3163,0,0,0,1,1,2
9260,20,1201,3166;3167,0,0,0,1,1,2
9261,20,1202,3169;4818;10920;11017,0,0,2,2,0,4
9262,20,1203,3170;3751;10151;10542,0,0,1,3,0,4
9263,20,1204,3171,0,0,0,0,1,1
9264,20,1205,3174;3175;10277;10596;11193,0,0,2,3,0,5
9265,20,1206,3176;3178,0,0,0,0,2,2
9266,20,1208,3181;5220,0,0,0,2,0,2
9267,20,1209,357,0,0,0,1,0,1
9268,20,1210,3187;3364;10567;11263,0,0,2,2,0,4
9269,20,1211,3188;3191,0,0,0,0,2,2
9270,20,1212,3194,0,0,0,0,1,1
9271,20,1214,6479;7249,0,0,0,0,2,2
9272,20,1215,3203,0,0,0,0,1,1
9273,20,1216,3205;3206;3209,0,0,0,2,1,3
9274,20,1218,3212;3213;3214,0,0,0,2,1,3
9275,20,1219,3217,0,0,0,0,1,1
9276,20,1220,3220;3221;10016;11250,0,0,1,2,1,4
9277,20,1221,3223,0,0,0,0,1,1
9278,20,1222,3226,0,0,0,0,1,1
9279,20,1223,3228,0,0,0,0,1,1
9280,20,1224,3231;8159;10536;10723,0,0,2,2,0,4
9281,20,1225,3236;3237,0,0,0,1,1,2
9282,20,1226,3242,0,0,0,0,1,1
9283,20,1227,8714,0,0,0,0,1,1
9284,20,1229,2279;3249;10135;11048,0,0,1,3,0,4
9285,20,1231,3251,0,0,0,0,1,1
9286,20,1232,3058;3253;6339;10518;10890;11601,0,0,3,3,0,6
9287,20,1233,3258;6811,0,0,0,2,0,2
9288,20,1234,1769;3259;11150,0,0,1,2,0,3
9289,20,1235,3262;8224;10027,0,0,0,3,0,3
9290,20,1236,3263,0,0,0,1,0,1
9291,20,1237,3264;3265;3266;3267,0,0,0,2,2,4
9292,20,1238,3269,0,0,0,0,1,1
9293,20,1241,3274;3275,0,0,0,1,1,2
9294,20,1242,3278,0,0,0,0,1,1
9295,20,1243,3279,0,0,0,0,1,1
9296,20,1244,3282;3283,0,0,0,0,2,2
9297,20,1245,3284;3285,0,0,0,1,1,2
9298,20,1247,3287;3288,0,0,0,0,2,2
9299,20,1248,3290;3292,0,0,0,0,2,2
9300,20,1250,3294,0,0,0,1,0,1
9301,20,1253,3300;3301,0,0,0,0,2,2
9302,20,1255,3307,0,0,0,0,1,1
9303,20,1256,3310;3311,0,0,0,0,2,2
9304,20,1257,3313;3314,0,0,0,1,1,2
9305,20,1258,3316;3317;3318;3901,0,0,0,2,2,4
9306,20,1260,3322,0,0,0,0,1,1
9307,20,1261,3323,0,0,0,0,1,1
9308,20,1262,3325,0,0,0,0,1,1
9309,20,1265,3330,0,0,0,0,1,1
9310,20,1266,3331,0,0,0,0,1,1
9311,20,1267,3334,0,0,0,0,1,1
9312,20,1268,3336;8792;10172;10511;10810,0,0,2,3,0,5
9313,20,1269,3341;5654,0,0,0,2,0,2
9314,20,1271,634;3343,0,0,0,0,2,2
9315,20,1272,3344,0,0,0,0,1,1
9316,20,1273,3347,0,0,0,0,1,1
9317,20,1274,3349;3350,0,0,0,1,1,2
9318,20,1275,3355;3356,0,0,0,2,0,2
9319,20,1276,3357;5452,0,0,0,0,2,2
9320,20,1277,3360;3361,0,0,0,0,2,2
9321,20,1280,3368;3369,0,0,0,2,0,2
9322,20,1281,3370;3371,0,0,0,2,0,2
9323,20,1282,3372;3373;3375,0,0,0,2,1,3
9324,20,1283,3378;3379;3381;10368;10690,0,0,1,3,1,5
9325,20,1284,3382;3383,0,0,0,1,1,2
9326,20,1285,3386;3388;12176,0,1,0,2,0,3
9327,20,1286,3390;7694,0,0,0,2,0,2
9328,20,1287,3393,0,0,0,0,1,1
9329,20,1288,3398;3399;3403,0,0,0,1,2,3
9330,20,1290,3408;3409;10199;10612,0,0,1,3,0,4
9331,20,1291,3410,0,0,0,1,0,1
9332,20,1292,672;3411;10472;11291;11669,0,0,3,2,0,5
9333,20,1295,1671;3415;3420,0,0,0,3,0,3
9334,20,1296,3421,0,0,0,0,1,1
9335,20,1297,3422;3423;3424,0,0,0,2,1,3
9336,20,1298,3425,0,0,0,0,1,1
9337,20,1299,3426;3427,0,0,0,1,1,2
9338,20,1300,3430;3431,0,0,0,1,1,2
9339,20,1301,3435,0,0,0,0,1,1
9340,20,1302,3439;3440,0,0,0,0,2,2
9341,20,1303,3441;3442,0,0,0,2,0,2
9342,20,1305,3446,0,0,0,0,1,1
9343,20,1306,3447;3448;11234;11472,0,0,2,1,1,4
9344,20,1307,3453,0,0,0,0,1,1
9345,20,1309,3459;8836,0,0,0,0,2,2
9346,20,1310,3460,0,0,0,0,1,1
9347,20,1311,3462,0,0,0,0,1,1
9348,20,1313,3466,0,0,0,0,1,1
9349,20,1314,3469;3470;3472,0,0,0,2,1,3
9350,20,1315,3474;6732;10794;12075,0,1,1,2,0,4
9351,20,1316,3479;3480,0,0,0,0,2,2
9352,20,1320,3486,0,0,0,1,0,1
9353,20,1321,3489,0,0,0,0,1,1
9354,20,1322,3490;3491,0,0,0,0,2,2
9355,20,1323,3496,0,0,0,0,1,1
9356,20,1324,3497,0,0,0,0,1,1
9357,20,1325,3499,0,0,0,0,1,1
9358,20,1326,3501;6163;10130;10672;10839,0,0,2,3,0,5
9359,20,1327,1991;3505;3507,0,0,0,3,0,3
9360,20,1329,3509;6516;11012,0,0,1,2,0,3
9361,20,1331,3511;3512;10665;10811,0,0,2,2,0,4
9362,20,1332,3514;5066;10390;10871;11575,0,0,2,3,0,5
9363,20,1333,3515;3516,0,0,0,0,2,2
9364,20,1334,3519,0,0,0,0,1,1
9365,20,1335,3521;3522,0,0,0,1,1,2
9366,20,1336,3525;6538,0,0,0,0,2,2
9367,20,1337,3526;7650;10361;10547;10709,0,0,2,3,0,5
9368,20,1338,3528;3529;3530,0,0,0,1,2,3
9369,20,1339,3532;3534,0,0,0,2,0,2
9370,20,1340,3535,0,0,0,0,1,1
9371,20,1341,3540,0,0,0,1,0,1
9372,20,1342,3541,0,0,0,1,0,1
9373,20,1344,3546;3547,0,0,0,0,2,2
9374,20,1349,3560,0,0,0,1,0,1
9375,20,1351,3567,0,0,0,0,1,1
9376,20,1352,3569;3570,0,0,0,0,2,2
9377,20,1353,3571,0,0,0,0,1,1
9378,20,1354,3576;3577,0,0,0,0,2,2
9379,20,1357,3581,0,0,0,0,1,1
9380,20,1358,3584,0,0,0,0,1,1
9381,20,1359,3587;3591;3592,0,0,0,2,1,3
9382,20,1360,3593;3594,0,0,0,1,1,2
9383,20,1361,3596;3597,0,0,0,0,2,2
9384,20,1362,3599;3600;8399,0,0,0,1,2,3
9385,20,1364,3604;3605,0,0,0,0,2,2
9386,20,1365,3606,0,0,0,0,1,1
9387,20,1367,3609;3610;3612,0,0,0,1,2,3
9388,20,1368,3613;3615,0,0,0,2,0,2
9389,20,1369,3616,0,0,0,0,1,1
9390,20,1370,3618,0,0,0,0,1,1
9391,20,1371,3619;3620;10759;10858;11111,0,0,3,1,1,5
9392,20,1373,3623;5267,0,0,0,1,1,2
9393,20,1374,3624,0,0,0,0,1,1
9394,20,1375,3627;3829;10526;10685;11206,0,0,3,2,0,5
9395,20,1376,3628,0,0,0,0,1,1
9396,20,1378,3635,0,0,0,1,0,1
9397,20,1379,3637;3638,0,0,0,1,1,2
9398,20,1380,3640,0,0,0,0,1,1
9399,20,1381,3644;3645,0,0,0,0,2,2
9400,20,1383,3651;3652,0,0,0,0,2,2
9401,20,1384,3653,0,0,0,0,1,1
9402,20,1385,3654;3655;3656,0,0,0,1,2,3
9403,20,1386,3657;3658,0,0,0,1,1,2
9404,20,1387,3659,0,0,0,0,1,1
9405,20,1388,3661;3662,0,0,0,1,1,2
9406,20,1391,3668;10010;10319,0,0,0,3,0,3
9407,20,1392,3671,0,0,0,0,1,1
9408,20,1394,3680;8546,0,0,0,1,1,2
9409,20,1395,3681;3682;10105;10157;10717,0,0,1,3,1,5
9410,20,1396,3683;3684,0,0,0,0,2,2
9411,20,1397,3686,0,0,0,0,1,1
9412,20,1401,3697;3700;6638,0,0,0,3,0,3
9413,20,1402,3702,0,0,0,0,1,1
9414,20,1403,12;11670;12019,0,1,1,1,0,3
9415,20,1404,1617;3705,0,0,0,2,0,2
9416,20,1405,3707,0,0,0,0,1,1
9417,20,1406,1068;3712,0,0,0,1,1,2
9418,20,1409,4929,0,0,0,0,1,1
9419,20,1410,3722,0,0,0,0,1,1
9420,20,1411,3724,0,0,0,0,1,1
9421,20,1412,3729,0,0,0,0,1,1
9422,20,1414,3734;3735,0,0,0,1,1,2
9423,20,1415,922;2131,0,0,0,2,0,2
9424,20,1416,5117;10669;10817,0,0,2,1,0,3
9425,20,1417,1365;10196;10424,0,0,0,3,0,3
9426,20,1418,3743,0,0,0,0,1,1
9427,20,1419,3744;3745,0,0,0,1,1,2
9428,20,1420,1873;3747,0,0,0,0,2,2
9429,20,1421,3753;7993;12332,0,1,0,2,0,3
9430,20,1422,3754;3755,0,0,0,1,1,2
9431,20,1423,3756,0,0,0,1,0,1
9432,20,1424,313;3760,0,0,0,0,2,2
9433,20,1425,3761;3762;10372;10551;11211,0,0,2,2,1,5
9434,20,1426,3763;6659;10195;10233,0,0,0,4,0,4
9435,20,1427,3767;9696;11457;11709,0,0,2,2,0,4
9436,20,1428,3769,0,0,0,0,1,1
9437,20,1430,7129;8028,0,0,0,2,0,2
9438,20,1433,3777,0,0,0,0,1,1
9439,20,1434,3782,0,0,0,0,1,1
9440,20,1436,3784;3786,0,0,0,0,2,2
9441,20,1437,2219,0,0,0,1,0,1
9442,20,1438,2943;3790,0,0,0,0,2,2
9443,20,1439,3791,0,0,0,0,1,1
9444,20,1440,3797;3798;10322;10769,0,0,1,3,0,4
9445,20,1441,3800;3801;3802,0,0,0,1,2,3
9446,20,1443,3805,0,0,0,0,1,1
9447,20,1444,3807,0,0,0,1,0,1
9448,20,1445,3809;3810,0,0,0,1,1,2
9449,20,1448,3819;3820,0,0,0,1,1,2
9450,20,1451,3825;3826,0,0,0,1,1,2
9451,20,1452,3827;3828;10296,0,0,0,2,1,3
9452,20,1454,3835;3836,0,0,0,0,2,2
9453,20,1455,3838;3839;3840,0,0,0,1,2,3
9454,20,1456,3843;3844,0,0,0,0,2,2
9455,20,1457,3845;10181;10537,0,0,1,2,0,3
9456,20,1458,3848;11929;12188,0,2,0,1,0,3
9457,20,1459,2326;3851,0,0,0,0,2,2
9458,20,1461,3855,0,0,0,0,1,1
9459,20,1462,3857;3858,0,0,0,0,2,2
9460,20,1463,3861;3862,0,0,0,0,2,2
9461,20,1465,3866;7578,0,0,0,0,2,2
9462,20,1466,3871,0,0,0,0,1,1
9463,20,1467,3877;3878;8691,0,0,0,0,3,3
9464,20,1468,3880;10706;10992;11977,0,1,2,1,0,4
9465,20,1470,3882;3883,0,0,0,1,1,2
9466,20,1471,3884;3885,0,0,0,1,1,2
9467,20,1473,3888,0,0,0,0,1,1
9468,20,1474,3890,0,0,0,0,1,1
9469,20,1475,2314;3893;10614,0,0,1,2,0,3
9470,20,1476,3896;3897,0,0,0,1,1,2
9471,20,1479,3902;3904,0,0,0,0,2,2
9472,20,1480,3905,0,0,0,0,1,1
9473,20,1483,3910;3911,0,0,0,1,1,2
9474,20,1484,3912;3913,0,0,0,0,2,2
9475,20,1486,3918,0,0,0,0,1,1
9476,20,1487,7941,0,0,0,0,1,1
9477,20,1491,3932,0,0,0,0,1,1
9478,20,1492,3936,0,0,0,0,1,1
9479,20,1493,3938;3939,0,0,0,0,2,2
9480,20,1494,3942,0,0,0,0,1,1
9481,20,1495,3943,0,0,0,0,1,1
9482,20,1496,3947;3948,0,0,0,0,2,2
9483,20,1497,3950;3952,0,0,0,1,1,2
9484,20,1498,3953;3954,0,0,0,1,1,2
9485,20,1499,3957,0,0,0,0,1,1
9486,20,1501,3966;9152;10160;10423,0,0,0,4,0,4
9487,20,1502,3971;3972,0,0,0,0,2,2
9488,20,1503,3973,0,0,0,0,1,1
9489,20,1505,3980,0,0,0,0,1,1
9490,20,1507,3982,0,0,0,0,1,1
9491,20,1508,2138;3983;11051,0,0,1,2,0,3
9492,20,1509,3988,0,0,0,0,1,1
9493,20,1510,3989,0,0,0,0,1,1
9494,20,1511,3991,0,0,0,0,1,1
9495,20,1512,2776;3993;3994,0,0,0,3,0,3
9496,20,1513,3997,0,0,0,0,1,1
9497,20,1515,4004,0,0,0,0,1,1
9498,20,1517,4008,0,0,0,0,1,1
9499,20,1518,4009;4010,0,0,0,1,1,2
9500,20,1519,8356,0,0,0,1,0,1
9501,20,1520,963;4013,0,0,0,2,0,2
9502,20,1521,4014;8463,0,0,0,1,1,2
9503,20,1522,4017;4605;10226;11007,0,0,1,3,0,4
9504,20,1523,4018,0,0,0,0,1,1
9505,20,1524,4019;4020,0,0,0,0,2,2
9506,20,1525,4025,0,0,0,0,1,1
9507,20,1526,4027;4028,0,0,0,1,1,2
9508,20,1527,4029,0,0,0,0,1,1
9509,20,1528,4031;11061;11552,0,0,2,1,0,3
9510,20,1529,4032;5631,0,0,0,2,0,2
9511,20,1530,4036,0,0,0,0,1,1
9512,20,1531,4038;4039;10095;10621;10731;10894,0,0,3,3,0,6
9513,20,1533,4041;4042,0,0,0,2,0,2
9514,20,1535,4050;4052,0,0,0,1,1,2
9515,20,1536,4055;4056,0,0,0,1,1,2
9516,20,1537,1589;4058,0,0,0,0,2,2
9517,20,1538,4059;4060,0,0,0,0,2,2
9518,20,1540,4064;4065,0,0,0,1,1,2
9519,20,1541,4066;10330;10573;11219,0,0,2,2,0,4
9520,20,1542,4069,0,0,0,0,1,1
9521,20,1543,4071;4072,0,0,0,1,1,2
9522,20,1545,4078,0,0,0,0,1,1
9523,20,1546,4080,0,0,0,0,1,1
9524,20,1548,4083;4086,0,0,0,0,2,2
9525,20,1550,1586;4088;10834;11075,0,0,2,2,0,4
9526,20,1551,4090;4091,0,0,0,1,1,2
9527,20,1555,2762;3414,0,0,0,2,0,2
9528,20,1556,4099;4100,0,0,0,0,2,2
9529,20,1557,305;4104,0,0,0,2,0,2
9530,20,1558,4107,0,0,0,0,1,1
9531,20,1559,4110,0,0,0,0,1,1
9532,20,1560,4114,0,0,0,0,1,1
9533,20,1562,4117,0,0,0,0,1,1
9534,20,1563,4119;4120,0,0,0,0,2,2
9535,20,1566,4125,0,0,0,0,1,1
9536,20,1568,4128,0,0,0,0,1,1
9537,20,1570,4133;6059,0,0,0,1,1,2
9538,20,1572,4135;4136;10474;10826,0,0,2,1,1,4
9539,20,1573,4137,0,0,0,0,1,1
9540,20,1574,4139;9594,0,0,0,0,2,2
9541,20,1575,4142;8171;11731;12079,0,1,1,2,0,4
9542,20,1576,4143;4144,0,0,0,0,2,2
9543,20,1577,4146;4147;4150;4151,0,0,0,3,1,4
9544,20,1578,2478;4152,0,0,0,1,1,2
9545,20,1579,4153;10091;10949;11054,0,0,2,2,0,4
9546,20,1580,4155,0,0,0,0,1,1
9547,20,1581,4157;4158,0,0,0,0,2,2
9548,20,1582,4159,0,0,0,0,1,1
9549,20,1583,4161;4162;10214;10486;10854,0,0,2,3,0,5
9550,20,1584,4166,0,0,0,1,0,1
9551,20,1585,4167;4168,0,0,0,1,1,2
9552,20,1587,4172;4173,0,0,0,1,1,2
9553,20,1588,4175;6607;10525;10737;10998;11528,0,0,4,2,0,6
9554,20,1589,4177,0,0,0,0,1,1
9555,20,1591,4182,0,0,0,0,1,1
9556,20,1592,4183,0,0,0,0,1,1
9557,20,1593,4185;4189,0,0,0,1,1,2
9558,20,1595,4192;4193,0,0,0,1,1,2
9559,20,1597,4195,0,0,0,0,1,1
9560,20,1599,4200,0,0,0,0,1,1
9561,20,1600,4203,0,0,0,0,1,1
9562,20,1601,4205;9103;11245;11618,0,0,2,2,0,4
9563,20,1602,4206;4210,0,0,0,2,0,2
9564,20,1603,4211;9142,0,0,0,0,2,2
9565,20,1606,4217,0,0,0,0,1,1
9566,20,1607,4222;4223,0,0,0,1,1,2
9567,20,1608,4225;4226,0,0,0,1,1,2
9568,20,1610,3787,0,0,0,0,1,1
9569,20,1611,4231;4232,0,0,0,1,1,2
9570,20,1614,4237;4238,0,0,0,0,2,2
9571,20,1616,4240;4241,0,0,0,2,0,2
9572,20,1619,4247;4249,0,0,0,0,2,2
9573,20,1620,4250,0,0,0,0,1,1
9574,20,1621,4253;4254,0,0,0,1,1,2
9575,20,1622,4256,0,0,0,0,1,1
9576,20,1623,2220;2935,0,0,0,0,2,2
9577,20,1625,4262;5894,0,0,0,0,2,2
9578,20,1627,4268;4693;5248;6845;11147;11208;11226;11536;12058;12152;12165,0,3,4,4,0,11
9579,20,1628,4269;4270;4271,0,0,0,1,2,3
9580,20,1629,4278;4280,0,0,0,1,1,2
9581,20,1630,4282,0,0,0,0,1,1
9582,20,1631,4288,0,0,0,0,1,1
9583,20,1633,401;4291;10478;10993;11358,0,0,3,2,0,5
9584,20,1634,4295,0,0,0,1,0,1
9585,20,1635,4296;4297,0,0,0,1,1,2
9586,20,1636,4298;10012;10637;11100,0,0,2,2,0,4
9587,20,1638,4303,0,0,0,0,1,1
9588,20,1639,4306;10087;10212;10436,0,0,0,4,0,4
9589,20,1640,4309,0,0,0,0,1,1
9590,20,1641,4310,0,0,0,0,1,1
9591,20,1642,4313,0,0,0,0,1,1
9592,20,1643,4316;4317,0,0,0,1,1,2
9593,20,1644,4318;9995;10260;10409,0,0,0,4,0,4
9594,20,1645,4319;8423,0,0,0,2,0,2
9595,20,1647,4323;7165,0,0,0,2,0,2
9596,20,1648,4942,0,0,0,0,1,1
9597,20,1650,4328;4329,0,0,0,0,2,2
9598,20,1651,4330;4331,0,0,0,1,1,2
9599,20,1652,1187;4332,0,0,0,0,2,2
9600,20,1655,4338,0,0,0,1,0,1
9601,20,1656,4341,0,0,0,0,1,1
9602,20,1658,4344;10582;11210,0,0,2,1,0,3
9603,20,1659,4345;4346,0,0,0,0,2,2
9604,20,1660,4347;9126,0,0,0,0,2,2
9605,20,1661,4349;4350,0,0,0,0,2,2
9606,20,1663,4353,0,0,0,0,1,1
9607,20,1664,908;4357;10090;11117,0,0,1,3,0,4
9608,20,1665,7064,0,0,0,0,1,1
9609,20,1666,4360,0,0,0,0,1,1
9610,20,1668,4364,0,0,0,0,1,1
9611,20,1669,4365;10328;10763,0,0,1,2,0,3
9612,20,1670,4366,0,0,0,0,1,1
9613,20,1671,4371;4374,0,0,0,1,1,2
9614,20,1672,3210;4376;10011,0,0,0,2,1,3
9615,20,1673,4380;7842,0,0,0,0,2,2
9616,20,1674,1736;4382,0,0,0,2,0,2
9617,20,1675,4386;4387,0,0,0,0,2,2
9618,20,1677,4391,0,0,0,1,0,1
9619,20,1679,4396;9867,0,0,0,2,0,2
9620,20,1680,4403,0,0,0,0,1,1
9621,20,1681,4404,0,0,0,0,1,1
9622,20,1683,4408;4409,0,0,0,0,2,2
9623,20,1686,4417,0,0,0,0,1,1
9624,20,1687,4418;4419;10968;11702,0,0,2,1,1,4
9625,20,1688,4420;4421,0,0,0,1,1,2
9626,20,1689,4423,0,0,0,1,0,1
9627,20,1690,4424,0,0,0,0,1,1
9628,20,1691,4427,0,0,0,0,1,1
9629,20,1693,4429,0,0,0,0,1,1
9630,20,1694,4430;4431,0,0,0,0,2,2
9631,20,1696,4433;4434;4436,0,0,0,2,1,3
9632,20,1697,4437;4438,0,0,0,1,1,2
9633,20,1699,4440,0,0,0,0,1,1
9634,20,1701,4443;4445,0,0,0,0,2,2
9635,20,1702,1178;4446,0,0,0,2,0,2
9636,20,1703,4450;4451,0,0,0,0,2,2
9637,20,1705,4454;4456,0,0,0,1,1,2
9638,20,1706,4457;4460,0,0,0,0,2,2
9639,20,1707,4461,0,0,0,1,0,1
9640,20,1708,2260;4463,0,0,0,2,0,2
9641,20,1709,4464,0,0,0,0,1,1
9642,20,1710,4465,0,0,0,1,0,1
9643,20,1711,4467,0,0,0,1,0,1
9644,20,1712,4468;4469,0,0,0,2,0,2
9645,20,1713,4472;4473;4476;10840;10952,0,0,2,2,1,5
9646,20,1714,4477;4478,0,0,0,1,1,2
9647,20,1715,4480,0,0,0,0,1,1
9648,20,1716,4483,0,0,0,1,0,1
9649,20,1719,2917;4494;10546;11000,0,0,2,2,0,4
9650,20,1721,4497;4498,0,0,0,0,2,2
9651,20,1722,4502,0,0,0,0,1,1
9652,20,1723,4506;11482,0,0,1,1,0,2
9653,20,1724,4508;4511;9122,0,0,0,3,0,3
9654,20,1725,4512;4516,0,0,0,1,1,2
9655,20,1727,4519,0,0,0,0,1,1
9656,20,1728,1446;4521;4523,0,0,0,3,0,3
9657,20,1729,4524;10982;11013,0,0,2,1,0,3
9658,20,1730,4526;10155;10439,0,0,0,3,0,3
9659,20,1731,4529;4530,0,0,0,1,1,2
9660,20,1733,4534;4535,0,0,0,1,1,2
9661,20,1736,4538;4539,0,0,0,0,2,2
9662,20,1737,4540;4541;10191;10354;10506;10684,0,0,2,3,1,6
9663,20,1738,8685,0,0,0,0,1,1
9664,20,1739,4546;4547,0,0,0,2,0,2
9665,20,1741,4554;4555,0,0,0,1,1,2
9666,20,1742,4556;6964,0,0,0,0,2,2
9667,20,1745,4176;4561,0,0,0,0,2,2
9668,20,1746,4562;7863,0,0,0,1,1,2
9669,20,1747,4565,0,0,0,0,1,1
9670,20,1748,4566;4567,0,0,0,0,2,2
9671,20,1750,4573,0,0,0,0,1,1
9672,20,1751,4575,0,0,0,0,1,1
9673,20,1752,4578,0,0,0,0,1,1
9674,20,1753,4579,0,0,0,1,0,1
9675,20,1755,4584;4586;4587,0,0,0,2,1,3
9676,20,1756,4590,0,0,0,0,1,1
9677,20,1757,4592;4595,0,0,0,1,1,2
9678,20,1759,4600,0,0,0,1,0,1
9679,20,1761,4604;4606,0,0,0,0,2,2
9680,20,1762,4609;9952,0,0,0,0,2,2
9681,20,1763,4612;5689,0,0,0,0,2,2
9682,20,1764,4614,0,0,0,0,1,1
9683,20,1765,4618,0,0,0,0,1,1
9684,20,1766,4620,0,0,0,0,1,1
9685,20,1767,4625,0,0,0,1,0,1
9686,20,1768,4626;4627;4629;10309,0,0,0,3,1,4
9687,20,1769,4632,0,0,0,0,1,1
9688,20,1770,4635;4636,0,0,0,0,2,2
9689,20,1772,4639,0,0,0,0,1,1
9690,20,1773,4642;4643,0,0,0,0,2,2
9691,20,1774,4644;4645,0,0,0,1,1,2
9692,20,1775,4646;4647,0,0,0,2,0,2
9693,20,1776,3002;4650,0,0,0,1,1,2
9694,20,1777,4653;4656;7720;7724;10781;11479,0,0,2,4,0,6
9695,20,1778,4657;6418,0,0,0,2,0,2
9696,20,1779,4660,0,0,0,0,1,1
9697,20,1780,4661,0,0,0,0,1,1
9698,20,1781,4662,0,0,0,0,1,1
9699,20,1783,4665,0,0,0,0,1,1
9700,20,1784,4667;4669;5844,0,0,0,3,0,3
9701,20,1786,4672,0,0,0,0,1,1
9702,20,1787,4673;10416,0,0,0,2,0,2
9703,20,1788,4676;4677,0,0,0,1,1,2
9704,20,1789,4679,0,0,0,0,1,1
9705,20,1790,1312,0,0,0,0,1,1
9706,20,1791,4683;4684;10168,0,0,0,2,1,3
9707,20,1792,4685;4686,0,0,0,0,2,2
9708,20,1793,4688;4689;4690;10425;10677,0,0,1,4,0,5
9709,20,1794,4692;6252;8353,0,0,0,1,2,3
9710,20,1795,4695,0,0,0,0,1,1
9711,20,1796,4697;4699;4700,0,0,0,2,1,3
9712,20,1797,4701,0,0,0,0,1,1
9713,20,1798,4702;4703;10248,0,0,0,2,1,3
9714,20,1799,4705;4706,0,0,0,1,1,2
9715,20,1800,4708;4709,0,0,0,0,2,2
9716,20,1802,4712,0,0,0,1,0,1
9717,20,1804,4717;4718,0,0,0,0,2,2
9718,20,1805,4722;12146,0,1,0,1,0,2
9719,20,1806,4725,0,0,0,0,1,1
9720,20,1807,1613;4727,0,0,0,0,2,2
9721,20,1810,4732,0,0,0,0,1,1
9722,20,1811,4734;9716;10430;10636,0,0,1,3,0,4
9723,20,1812,4738;4739,0,0,0,0,2,2
9724,20,1813,4741;4742,0,0,0,1,1,2
9725,20,1814,4744,0,0,0,0,1,1
9726,20,1815,4746;4748;4831,0,0,0,3,0,3
9727,20,1816,4749;4750;4752,0,0,0,1,2,3
9728,20,1817,4753;4754;4757,0,0,0,3,0,3
9729,20,1818,816,0,0,0,0,1,1
9730,20,1819,4760;8326,0,0,0,0,2,2
9731,20,1820,4763;4765,0,0,0,0,2,2
9732,20,1821,2827;4766,0,0,0,0,2,2
9733,20,1822,4769;4770;4771,0,0,0,2,1,3
9734,20,1824,4774;4775,0,0,0,1,1,2
9735,20,1825,4776;9470;11067;11740,0,0,2,2,0,4
9736,20,1826,4777;4778,0,0,0,1,1,2
9737,20,1827,4779;4780;10625;11174,0,0,2,1,1,4
9738,20,1829,4782;10213,0,0,0,1,1,2
9739,20,1830,4784,0,0,0,0,1,1
9740,20,1832,4786;7071,0,0,0,2,0,2
9741,20,1833,732;4787,0,0,0,1,1,2
9742,20,1834,2702;4788;10173;10433;10589;10739,0,0,2,4,0,6
9743,20,1835,4789;4792,0,0,0,0,2,2
9744,20,1836,4798,0,0,0,0,1,1
9745,20,1838,4801,0,0,0,0,1,1
9746,20,1839,4805;4806,0,0,0,1,1,2
9747,20,1840,4808,0,0,0,1,0,1
9748,20,1841,4810;4811,0,0,0,1,1,2
9749,20,1842,4812,0,0,0,1,0,1
9750,20,1847,4822,0,0,0,0,1,1
9751,20,1848,4824;8948,0,0,0,0,2,2
9752,20,1849,4826,0,0,0,0,1,1
9753,20,1850,4829,0,0,0,0,1,1
9754,20,1851,3072;4830;4832;10215;10249;10502,0,0,1,5,0,6
9755,20,1852,4834;4835,0,0,0,1,1,2
9756,20,1853,2594;4837,0,0,0,1,1,2
9757,20,1854,4839,0,0,0,0,1,1
9758,20,1856,4843;4844;4845;4846,0,0,0,2,2,4
9759,20,1858,4848;4849,0,0,0,0,2,2
9760,20,1859,4853;11663;11978,0,1,1,1,0,3
9761,20,1860,4858;4861;9544,0,0,0,3,0,3
9762,20,1861,4863;4867,0,0,0,1,1,2
9763,20,1862,4870,0,0,0,1,0,1
9764,20,1863,4871;4872,0,0,0,1,1,2
9765,20,1864,4875,0,0,0,0,1,1
9766,20,1865,1295;4878,0,0,0,0,2,2
9767,20,1866,4879;7836;10369;10808;11133,0,0,2,3,0,5
9768,20,1867,4881,0,0,0,0,1,1
9769,20,1869,2030;4891;5382,0,0,0,2,1,3
9770,20,1870,5718,0,0,0,0,1,1
9771,20,1872,4899;4900,0,0,0,1,1,2
9772,20,1873,4901,0,0,0,0,1,1
9773,20,1875,4416;4905,0,0,0,0,2,2
9774,20,1877,3553;8851,0,0,0,2,0,2
9775,20,1878,4910;10324;10479,0,0,1,2,0,3
9776,20,1879,4912,0,0,0,0,1,1
9777,20,1880,4913;4915,0,0,0,0,2,2
9778,20,1882,4922;5177,0,0,0,1,1,2
9779,20,1883,4926,0,0,0,0,1,1
9780,20,1884,4928;4931,0,0,0,1,1,2
9781,20,1885,4932;4933,0,0,0,1,1,2
9782,20,1886,4934,0,0,0,0,1,1
9783,20,1887,4935;4936,0,0,0,0,2,2
9784,20,1889,4943;4945;4946,0,0,0,2,1,3
9785,20,1890,4947;4948,0,0,0,0,2,2
9786,20,1891,4951;4952;4955;4956,0,0,0,3,1,4
9787,20,1892,4957;4958;4960,0,0,0,1,2,3
9788,20,1893,4962,0,0,0,0,1,1
9789,20,1894,4965,0,0,0,1,0,1
9790,20,1896,4970,0,0,0,1,0,1
9791,20,1897,4972,0,0,0,0,1,1
9792,20,1898,3795;4975;11389;11611,0,0,2,2,0,4
9793,20,1899,4976;4977,0,0,0,0,2,2
9794,20,1900,4981,0,0,0,0,1,1
9795,20,1901,4983;10285;10357,0,0,0,3,0,3
9796,20,1903,4985;6759,0,0,0,0,2,2
9797,20,1904,4986,0,0,0,0,1,1
9798,20,1905,4989,0,0,0,0,1,1
9799,20,1906,4991;4992,0,0,0,2,0,2
9800,20,1907,4993,0,0,0,0,1,1
9801,20,1908,4996,0,0,0,0,1,1
9802,20,1909,308,0,0,0,1,0,1
9803,20,1910,4998;4999,0,0,0,0,2,2
9804,20,1911,5005,0,0,0,0,1,1
9805,20,1912,5007,0,0,0,0,1,1
9806,20,1913,5009,0,0,0,1,0,1
9807,20,1914,5011;5012,0,0,0,0,2,2
9808,20,1915,5015;5016,0,0,0,1,1,2
9809,20,1916,5018;5019,0,0,0,0,2,2
9810,20,1917,5020;5022,0,0,0,0,2,2
9811,20,1918,5023;5024,0,0,0,1,1,2
9812,20,1919,797;5027;6181;10493;10847;11289;11494,0,0,4,3,0,7
9813,20,1920,5028,0,0,0,0,1,1
9814,20,1921,5029;5030;5032,0,0,0,2,1,3
9815,20,1922,5033;5034;10217;10579,0,0,1,3,0,4
9816,20,1923,5036;8071;10238;10846;11044;11278,0,0,3,3,0,6
9817,20,1926,5041;5042,0,0,0,1,1,2
9818,20,1927,5045;5047;7278,0,0,0,1,2,3
9819,20,1929,5051;5053,0,0,0,0,2,2
9820,20,1930,5055,0,0,0,1,0,1
9821,20,1931,5056,0,0,0,0,1,1
9822,20,1932,5060,0,0,0,0,1,1
9823,20,1933,5061;5064;8369,0,0,0,1,2,3
9824,20,1935,5067;5068;10818;11078,0,0,2,2,0,4
9825,20,1937,5073;5074,0,0,0,2,0,2
9826,20,1938,5076,0,0,0,0,1,1
9827,20,1941,5080;5081,0,0,0,0,2,2
9828,20,1942,191;5083;5084,0,0,0,3,0,3
9829,20,1944,5091,0,0,0,1,0,1
9830,20,1945,5093;6283,0,0,0,2,0,2
9831,20,1946,5095;9547,0,0,0,2,0,2
9832,20,1947,3366;5098;5099;5100,0,0,0,3,1,4
9833,20,1948,5102;9431;10104;10795;10965;11694,0,0,3,3,0,6
9834,20,1949,5103;5105,0,0,0,2,0,2
9835,20,1952,5108,0,0,0,0,1,1
9836,20,1953,5111,0,0,0,0,1,1
9837,20,1954,5115,0,0,0,0,1,1
9838,20,1955,5118;5119,0,0,0,0,2,2
9839,20,1956,5120,0,0,0,0,1,1
9840,20,1960,5289,0,0,0,0,1,1
9841,20,1961,5127,0,0,0,1,0,1
9842,20,1962,3887;5129,0,0,0,2,0,2
9843,20,1963,5131,0,0,0,0,1,1
9844,20,1964,5136,0,0,0,0,1,1
9845,20,1965,5138,0,0,0,0,1,1
9846,20,1966,5139;5140,0,0,0,1,1,2
9847,20,1967,5142,0,0,0,0,1,1
9848,20,1968,5143,0,0,0,0,1,1
9849,20,1970,5150;5513,0,0,0,0,2,2
9850,20,1971,5153,0,0,0,0,1,1
9851,20,1972,5155;5156,0,0,0,2,0,2
9852,20,1973,5158;5161,0,0,0,1,1,2
9853,20,1974,5162;5163,0,0,0,1,1,2
9854,20,1975,5165;8702,0,0,0,2,0,2
9855,20,1978,5172;5481,0,0,0,2,0,2
9856,20,1979,5176;5178,0,0,0,0,2,2
9857,20,1980,5179;5180;5181;10093;10271,0,0,0,4,1,5
9858,20,1981,5182,0,0,0,0,1,1
9859,20,1983,5185;5187;10941;11114;11254,0,0,3,2,0,5
9860,20,1984,5189;5190;5191;5192,0,0,0,3,1,4
9861,20,1985,5194,0,0,0,0,1,1
9862,20,1986,1042;10984;11128;11789;12387,0,2,2,1,0,5
9863,20,1987,5197;5198,0,0,0,0,2,2
9864,20,1990,5205;5206,0,0,0,0,2,2
9865,20,1991,5207;8430;10349;10762;10985,0,0,2,3,0,5
9866,20,1992,5209;5211,0,0,0,0,2,2
9867,20,1993,5213;5215,0,0,0,0,2,2
9868,20,1994,5217;7642,0,0,0,1,1,2
9869,20,1995,5219;5221,0,0,0,0,2,2
9870,20,1996,5222;5223,0,0,0,1,1,2
9871,20,1998,4334;5227;5228;10266,0,0,0,4,0,4
9872,20,1999,5229;5231,0,0,0,1,1,2
9873,20,2001,5237,0,0,0,1,0,1
9874,20,2004,5242;5243,0,0,0,0,2,2
9875,20,2005,5246;5247;5249;10673,0,0,1,3,0,4
9876,20,2006,5250;5251;10454,0,0,1,1,1,3
9877,20,2008,5254,0,0,0,0,1,1
9878,20,2009,5256,0,0,0,0,1,1
9879,20,2010,5259,0,0,0,0,1,1
9880,20,2011,5262;5263,0,0,0,0,2,2
9881,20,2013,5265,0,0,0,0,1,1
9882,20,2014,5269,0,0,0,0,1,1
9883,20,2016,5271,0,0,0,0,1,1
9884,20,2017,5273;10353;10514;10754,0,0,2,2,0,4
9885,20,2018,5274;10346;11407,0,0,1,2,0,3
9886,20,2019,5276;5278,0,0,0,1,1,2
9887,20,2020,5279,0,0,0,0,1,1
9888,20,2021,5281;5283,0,0,0,0,2,2
9889,20,2022,5284,0,0,0,0,1,1
9890,20,2023,5287,0,0,0,0,1,1
9891,20,2024,5290;5291,0,0,0,2,0,2
9892,20,2025,5292;5293;10420;10455,0,0,1,2,1,4
9893,20,2026,5294;5296,0,0,0,1,1,2
9894,20,2028,5299;5301;5302,0,0,0,2,1,3
9895,20,2029,5304,0,0,0,0,1,1
9896,20,2030,5306;5307,0,0,0,0,2,2
9897,20,2031,5308;5309;5310;5311;11204;11373,0,0,2,4,0,6
9898,20,2032,5313;6862,0,0,0,2,0,2
9899,20,2033,78;5315;10131;10560;10646;11447,0,0,3,3,0,6
9900,20,2034,5318,0,0,0,1,0,1
9901,20,2035,5319;5320,0,0,0,1,1,2
9902,20,2036,368;5321;10902,0,0,1,2,0,3
9903,20,2038,5323,0,0,0,0,1,1
9904,20,2039,5324;5325,0,0,0,1,1,2
9905,20,2040,5326;5331,0,0,0,1,1,2
9906,20,2041,5332;5626;10007;10412,0,0,0,4,0,4
9907,20,2044,5336,0,0,0,0,1,1
9908,20,2045,184;5338;10023;10182;10298,0,0,0,5,0,5
9909,20,2046,5339;5340,0,0,0,0,2,2
9910,20,2047,4261;5341,0,0,0,0,2,2
9911,20,2049,5345,0,0,0,0,1,1
9912,20,2050,3785;5346,0,0,0,2,0,2
9913,20,2051,5348,0,0,0,0,1,1
9914,20,2054,5356;5357,0,0,0,2,0,2
9915,20,2055,5358;5359,0,0,0,0,2,2
9916,20,2056,5361;5362,0,0,0,1,1,2
9917,20,2057,5363;9702;10252;10429;10633;11068;11256;11824,0,1,3,4,0,8
9918,20,2058,5369;5574,0,0,0,0,2,2
9919,20,2060,5373;5374,0,0,0,0,2,2
9920,20,2061,5375,0,0,0,0,1,1
9921,20,2063,5383;5384,0,0,0,1,1,2
9922,20,2064,5385;5386;5387,0,0,0,0,3,3
9923,20,2065,3254;5388,0,0,0,2,0,2
9924,20,2066,5392;8731;10034;10507,0,0,1,3,0,4
9925,20,2067,5393;5613;11011;11583,0,0,2,2,0,4
9926,20,2068,5394;7143;11668,0,0,1,2,0,3
9927,20,2069,5397;5398,0,0,0,0,2,2
9928,20,2070,5399;5400,0,0,0,0,2,2
9929,20,2071,7797,0,0,0,1,0,1
9930,20,2072,5405;5406,0,0,0,0,2,2
9931,20,2073,5407;5409,0,0,0,1,1,2
9932,20,2075,5415,0,0,0,1,0,1
9933,20,2076,5416,0,0,0,1,0,1
9934,20,2077,708;5420,0,0,0,1,1,2
9935,20,2078,4917;5422;10004;10192;10299,0,0,0,5,0,5
9936,20,2079,5423;5424,0,0,0,2,0,2
9937,20,2080,4927;5427;10323,0,0,0,3,0,3
9938,20,2081,5429;7673,0,0,0,1,1,2
9939,20,2082,5431,0,0,0,0,1,1
9940,20,2083,5435;5437;8189;10143;10406,0,0,0,5,0,5
9941,20,2086,5446;5449,0,0,0,1,1,2
9942,20,2088,5453;6647,0,0,0,0,2,2
9943,20,2089,5454;5455,0,0,0,1,1,2
9944,20,2090,5456;5459;5460,0,0,0,2,1,3
9945,20,2092,5462,0,0,0,0,1,1
9946,20,2093,5463;5464;10618;10767,0,0,2,1,1,4
9947,20,2094,5465;10024;10253;10378;10491,0,0,1,4,0,5
9948,20,2096,3022;5468;10859;10960;11066,0,0,3,2,0,5
9949,20,2098,5473,0,0,0,0,1,1
9950,20,2100,5475;5476,0,0,0,2,0,2
9951,20,2101,5478,0,0,0,1,0,1
9952,20,2103,2487;5484,0,0,0,0,2,2
9953,20,2104,5486;5487,0,0,0,0,2,2
9954,20,2105,5488;8093,0,0,0,0,2,2
9955,20,2106,5491,0,0,0,1,0,1
9956,20,2108,5496;5497,0,0,0,0,2,2
9957,20,2109,5500,0,0,0,0,1,1
9958,20,2111,5504;6493;11040,0,0,1,2,0,3
9959,20,2112,5505,0,0,0,0,1,1
9960,20,2114,279;5508;10613;11162;11340,0,0,3,2,0,5
9961,20,2115,5509,0,0,0,0,1,1
9962,20,2116,5510;5512,0,0,0,0,2,2
9963,20,2117,5514;5515,0,0,0,0,2,2
9964,20,2118,9393;11819,0,1,0,1,0,2
9965,20,2119,5519;5520;5522,0,0,0,1,2,3
9966,20,2120,5523;5524;10267;10627;11055,0,0,2,2,1,5
9967,20,2122,5528;10141;10460,0,0,1,2,0,3
9968,20,2123,4866;5529,0,0,0,0,2,2
9969,20,2124,5530,0,0,0,0,1,1
9970,20,2125,1594;5532,0,0,0,2,0,2
9971,20,2127,5535;5536,0,0,0,2,0,2
9972,20,2130,5541,0,0,0,0,1,1
9973,20,2131,5543;5544;5545,0,0,0,0,3,3
9974,20,2132,5549;5550;10061;10126;10397;10848,0,0,1,4,1,6
9975,20,2133,4229;5552,0,0,0,1,1,2
9976,20,2135,5559,0,0,0,0,1,1
9977,20,2136,5560;5561,0,0,0,1,1,2
9978,20,2137,5563,0,0,0,0,1,1
9979,20,2139,5570;5573,0,0,0,1,1,2
9980,20,2141,5576,0,0,0,0,1,1
9981,20,2142,5578;5757;11218;11624,0,0,2,2,0,4
9982,20,2143,5579;5580,0,0,0,1,1,2
9983,20,2144,3508;5581,0,0,0,0,2,2
9984,20,2148,5587;7684,0,0,0,1,1,2
9985,20,2149,5591,0,0,0,0,1,1
9986,20,2150,4048;5592,0,0,0,0,2,2
9987,20,2151,5593;5594,0,0,0,0,2,2
9988,20,2152,5595;5596,0,0,0,1,1,2
9989,20,2153,5597;5598,0,0,0,1,1,2
9990,20,2154,5599;5601,0,0,0,1,1,2
9991,20,2155,4199;9948;10496;10700;11098,0,0,3,2,0,5
9992,20,2156,5607,0,0,0,0,1,1
9993,20,2157,5609,0,0,0,0,1,1
9994,20,2158,5610,0,0,0,0,1,1
9995,20,2159,1246;10699;11374;11569;11738,0,0,4,1,0,5
9996,20,2160,5614,0,0,0,0,1,1
9997,20,2161,2081;5618,0,0,0,0,2,2
9998,20,2162,7598,0,0,0,0,1,1
9999,20,2165,5627;6205,0,0,0,2,0,2
10000,20,2168,5634,0,0,0,0,1,1
10001,20,2169,5638;5639,0,0,0,0,2,2
10002,20,2170,5640;5641;5643;10327;10555;10708,0,0,2,4,0,6
10003,20,2171,2451;6827;10218;10306,0,0,0,4,0,4
10004,20,2172,5646,0,0,0,0,1,1
10005,20,2173,5648;5649;10660;11317,0,0,2,2,0,4
10006,20,2174,5651,0,0,0,0,1,1
10007,20,2176,5656,0,0,0,0,1,1
10008,20,2177,5658;5659,0,0,0,1,1,2
10009,20,2178,5660,0,0,0,0,1,1
10010,20,2179,5503;5663,0,0,0,0,2,2
10011,20,2181,5667;5668,0,0,0,0,2,2
10012,20,2184,5672;5673,0,0,0,0,2,2
10013,20,2186,5676;6141,0,0,0,2,0,2
10014,20,2187,5678,0,0,0,0,1,1
10015,20,2188,5680;5681,0,0,0,0,2,2
10016,20,2191,5685;5687,0,0,0,0,2,2
10017,20,2193,5693,0,0,0,0,1,1
10018,20,2194,5694;5695,0,0,0,1,1,2
10019,20,2195,5697;5698,0,0,0,2,0,2
10020,20,2196,3603;5702,0,0,0,2,0,2
10021,20,2198,5707;5708;5710,0,0,0,3,0,3
10022,20,2199,5711;5712,0,0,0,2,0,2
10023,20,2200,5713,0,0,0,0,1,1
10024,20,2201,3461;5714;5715,0,0,0,1,2,3
10025,20,2202,1981;5717;10539;10662,0,0,2,2,0,4
10026,20,2204,5720,0,0,0,0,1,1
10027,20,2205,5724,0,0,0,0,1,1
10028,20,2206,5727;5821,0,0,0,0,2,2
10029,20,2208,5729;5730;5731,0,0,0,1,2,3
10030,20,2209,4762;5732,0,0,0,2,0,2
10031,20,2210,2501;5734,0,0,0,0,2,2
10032,20,2212,3151;5745;5747;5749,0,0,0,2,2,4
10033,20,2213,2725;5750;5754,0,0,0,0,3,3
10034,20,2215,5756;9093,0,0,0,2,0,2
10035,20,2216,5759,0,0,0,0,1,1
10036,20,2217,5760;7966,0,0,0,2,0,2
10037,20,2218,5761,0,0,0,0,1,1
10038,20,2220,5770,0,0,0,0,1,1
10039,20,2221,5774,0,0,0,1,0,1
10040,20,2224,5782,0,0,0,0,1,1
10041,20,2225,5783,0,0,0,0,1,1
10042,20,2226,5785;5787;5789,0,0,0,2,1,3
10043,20,2228,5791;5793;6439,0,0,0,3,0,3
10044,20,2229,5795,0,0,0,1,0,1
10045,20,2230,5796;5797,0,0,0,1,1,2
10046,20,2231,5800;9805,0,0,0,0,2,2
10047,20,2234,5803,0,0,0,0,1,1
10048,20,2235,7005,0,0,0,1,0,1
10049,20,2236,5807;5808,0,0,0,0,2,2
10050,20,2237,3391;5812,0,0,0,2,0,2
10051,20,2238,5813;5814,0,0,0,1,1,2
10052,20,2239,8279,0,0,0,0,1,1
10053,20,2243,1831;5822;10366,0,0,0,3,0,3
10054,20,2244,5823;5824,0,0,0,1,1,2
10055,20,2245,5827;5828,0,0,0,0,2,2
10056,20,2246,5829,0,0,0,0,1,1
10057,20,2247,5831;5832,0,0,0,1,1,2
10058,20,2248,5833,0,0,0,0,1,1
10059,20,2249,5835,0,0,0,1,0,1
10060,20,2250,5836,0,0,0,0,1,1
10061,20,2252,1894;5840;10572;10657;11619,0,0,3,2,0,5
10062,20,2255,5845;5846,0,0,0,1,1,2
10063,20,2256,5847;5849,0,0,0,1,1,2
10064,20,2260,5856,0,0,0,0,1,1
10065,20,2261,5858;5859;5860,0,0,0,3,0,3
10066,20,2263,5865;5866,0,0,0,1,1,2
10067,20,2264,5867;5868;5869;10453;10784;11294,0,0,3,2,1,6
10068,20,2265,5872,0,0,0,1,0,1
10069,20,2266,5876,0,0,0,0,1,1
10070,20,2267,5877;6063,0,0,0,1,1,2
10071,20,2269,5879,0,0,0,0,1,1
10072,20,2270,5880,0,0,0,0,1,1
10073,20,2271,5881;8230,0,0,0,2,0,2
10074,20,2273,5886,0,0,0,0,1,1
10075,20,2274,5887;5889;5890;10045;10198,0,0,0,5,0,5
10076,20,2275,5891;8181,0,0,0,0,2,2
10077,20,2276,5895,0,0,0,0,1,1
10078,20,2278,4011;5897,0,0,0,2,0,2
10079,20,2279,5280,0,0,0,1,0,1
10080,20,2282,5909;8684;10283;10756,0,0,1,3,0,4
10081,20,2283,5910;5911;10516;11165,0,0,2,1,1,4
10082,20,2284,5912;5914,0,0,0,0,2,2
10083,20,2285,5915;5916;5917,0,0,0,2,1,3
10084,20,2286,4528;5918;10395;10908;11682,0,0,2,3,0,5
10085,20,2288,5921,0,0,0,0,1,1
10086,20,2289,5923;6710,0,0,0,2,0,2
10087,20,2290,5925;10115;10510;10733;10772,0,0,3,2,0,5
10088,20,2291,5927;5929;5930,0,0,0,2,1,3
10089,20,2292,5931;5932,0,0,0,1,1,2
10090,20,2294,5935,0,0,0,0,1,1
10091,20,2295,5938;5940,0,0,0,0,2,2
10092,20,2296,5942,0,0,0,0,1,1
10093,20,2298,5944;5945,0,0,0,2,0,2
10094,20,2299,5946;9269,0,0,0,2,0,2
10095,20,2300,5947,0,0,0,0,1,1
10096,20,2301,2278;5951;10351;10595,0,0,1,3,0,4
10097,20,2302,5633;10617;10670,0,0,2,1,0,3
10098,20,2303,5957,0,0,0,1,0,1
10099,20,2305,28;5960;10161;10641,0,0,1,3,0,4
10100,20,2306,5965,0,0,0,0,1,1
10101,20,2307,5973,0,0,0,0,1,1
10102,20,2308,5975,0,0,0,0,1,1
10103,20,2311,5979;5980;5981,0,0,0,2,1,3
10104,20,2312,5983;5984;6348,0,0,0,3,0,3
10105,20,2313,5987,0,0,0,0,1,1
10106,20,2314,5989;5990;10434;10743;10950,0,0,2,2,1,5
10107,20,2315,5994,0,0,0,0,1,1
10108,20,2316,5997,0,0,0,0,1,1
10109,20,2317,6000;6002,0,0,0,1,1,2
10110,20,2319,6006;7676;10875;10995,0,0,2,2,0,4
10111,20,2320,4428,0,0,0,1,0,1
10112,20,2321,2252;6008,0,0,0,0,2,2
10113,20,2322,6009,0,0,0,0,1,1
10114,20,2323,1030;6012,0,0,0,2,0,2
10115,20,2324,6014;6015,0,0,0,1,1,2
10116,20,2327,6023,0,0,0,0,1,1
10117,20,2329,6026;6027,0,0,0,1,1,2
10118,20,2330,6029,0,0,0,0,1,1
10119,20,2331,6030;6032,0,0,0,0,2,2
10120,20,2332,6033;6034,0,0,0,0,2,2
10121,20,2333,2953;6038,0,0,0,2,0,2
10122,20,2334,2932;6039;10414;10577;11324,0,0,2,3,0,5
10123,20,2335,40;6041,0,0,0,2,0,2
10124,20,2336,6043;6044;10284;10377;10921,0,0,1,4,0,5
10125,20,2338,4215;6046,0,0,0,2,0,2
10126,20,2341,6049;6050,0,0,0,1,1,2
10127,20,2342,5555;5557;6052;6054;10958;11018,0,0,2,4,0,6
10128,20,2343,6055;6056;11344;11428;11984,0,1,2,2,0,5
10129,20,2344,2585;6057,0,0,0,0,2,2
10130,20,2347,6061;6062,0,0,0,0,2,2
10131,20,2349,6065;8838,0,0,0,2,0,2
10132,20,2350,3180;6069;6071,0,0,0,3,0,3
10133,20,2353,6077;9250;10824,0,0,1,2,0,3
10134,20,2354,6080,0,0,0,0,1,1
10135,20,2357,6089;6090,0,0,0,0,2,2
10136,20,2358,3280;6091;10305,0,0,0,3,0,3
10137,20,2359,6092,0,0,0,0,1,1
10138,20,2360,6094,0,0,0,0,1,1
10139,20,2361,6095;6096,0,0,0,0,2,2
10140,20,2362,6097;6098,0,0,0,2,0,2
10141,20,2363,6099;6100,0,0,0,1,1,2
10142,20,2364,6103;6104,0,0,0,0,2,2
10143,20,2365,6105;6106,0,0,0,0,2,2
10144,20,2366,1515;6111;7964;12161,0,1,0,3,0,4
10145,20,2367,6113;6114;7312,0,0,0,1,2,3
10146,20,2368,6115,0,0,0,1,0,1
10147,20,2369,6121,0,0,0,0,1,1
10148,20,2370,6123;6124,0,0,0,0,2,2
10149,20,2371,6126;6127,0,0,0,1,1,2
10150,20,2372,6129,0,0,0,0,1,1
10151,20,2373,282,0,0,0,1,0,1
10152,20,2375,6135;7973,0,0,0,2,0,2
10153,20,2378,6138,0,0,0,0,1,1
10154,20,2379,6140;6891,0,0,0,0,2,2
10155,20,2381,5716;6239;11306;12002,0,1,1,2,0,4
10156,20,2383,6148;6149,0,0,0,1,1,2
10157,20,2384,6150;11273;11642,0,0,2,1,0,3
10158,20,2385,6152;6153;6155;10342,0,0,0,3,1,4
10159,20,2386,6156,0,0,0,1,0,1
10160,20,2387,6160;6161,0,0,0,1,1,2
10161,20,2389,2559;6166;10857;11599;11972,0,1,2,2,0,5
10162,20,2390,6167;6168,0,0,0,1,1,2
10163,20,2391,6171;6172;10230,0,0,0,2,1,3
10164,20,2392,330;6174;10604;11434,0,0,2,2,0,4
10165,20,2393,6175,0,0,0,1,0,1
10166,20,2395,6179;6180;10432;10450,0,0,1,2,1,4
10167,20,2397,6185;6187,0,0,0,1,1,2
10168,20,2398,2850;6190,0,0,0,0,2,2
10169,20,2399,6194;6394;10040;10171;10304;10381;10713;11804,0,1,1,6,0,8
10170,20,2400,6195,0,0,0,0,1,1
10171,20,2401,6200;9529,0,0,0,2,0,2
10172,20,2403,6204;8231;10051;10803,0,0,1,3,0,4
10173,20,2404,6206;7288,0,0,0,0,2,2
10174,20,2405,266;6209,0,0,0,0,2,2
10175,20,2406,5461;6213,0,0,0,0,2,2
10176,20,2407,6214;7287;10211;10385;10418,0,0,0,5,0,5
10177,20,2408,6216;6217;10070;10083;10127;10257;10758,0,0,1,6,0,7
10178,20,2410,6223;6224,0,0,0,0,2,2
10179,20,2412,6227,0,0,0,0,1,1
10180,20,2413,6229;11490,0,0,1,1,0,2
10181,20,2414,6232;6233,0,0,0,1,1,2
10182,20,2415,6234,0,0,0,0,1,1
10183,20,2416,6235,0,0,0,0,1,1
10184,20,2418,6241;7587;10294;10359;10411;10906;11158,0,0,2,5,0,7
10185,20,2419,361;6246,0,0,0,2,0,2
10186,20,2420,6248,0,0,0,0,1,1
10187,20,2421,6249,0,0,0,0,1,1
10188,20,2426,6263,0,0,0,0,1,1
10189,20,2427,6266;7188,0,0,0,0,2,2
10190,20,2428,6267,0,0,0,0,1,1
10191,20,2429,6270;6272,0,0,0,1,1,2
10192,20,2430,6273;6274,0,0,0,1,1,2
10193,20,2431,4815;5603;6277;11019;11423;11571;11605;11693,0,0,5,3,0,8
10194,20,2432,6279;6280,0,0,0,0,2,2
10195,20,2434,6286;6288;6290,0,0,0,1,2,3
10196,20,2436,4966;6292,0,0,0,1,1,2
10197,20,2439,6300;6301,0,0,0,0,2,2
10198,20,2440,6303,0,0,0,0,1,1
10199,20,2441,4916;6305,0,0,0,0,2,2
10200,20,2442,6306;6309,0,0,0,2,0,2
10201,20,2444,6315,0,0,0,1,0,1
10202,20,2445,6317;6319,0,0,0,2,0,2
10203,20,2446,6320;6321,0,0,0,1,1,2
10204,20,2447,6322;6324;6325;7311,0,0,0,3,1,4
10205,20,2448,6327,0,0,0,0,1,1
10206,20,2449,6328,0,0,0,0,1,1
10207,20,2451,3554;6333;6335;6336,0,0,0,4,0,4
10208,20,2452,6338,0,0,0,0,1,1
10209,20,2453,6340;6341;6342,0,0,0,1,2,3
10210,20,2456,6349;6350,0,0,0,0,2,2
10211,20,2457,6351;6352;10239;10719,0,0,1,2,1,4
10212,20,2458,6355,0,0,0,0,1,1
10213,20,2459,6356;6357,0,0,0,0,2,2
10214,20,2460,6360,0,0,0,0,1,1
10215,20,2461,6362,0,0,0,0,1,1
10216,20,2463,5941;6366;10603;10964;11495,0,0,3,2,0,5
10217,20,2464,6367;6368;6369,0,0,0,1,2,3
10218,20,2465,6372,0,0,0,0,1,1
10219,20,2466,2718;6374,0,0,0,0,2,2
10220,20,2467,6376,0,0,0,0,1,1
10221,20,2468,6378;6379;10468,0,0,1,2,0,3
10222,20,2469,1394;9359,0,0,0,0,2,2
10223,20,2470,6381;7846,0,0,0,0,2,2
10224,20,2471,4613;6383,0,0,0,2,0,2
10225,20,2472,4333;6384,0,0,0,2,0,2
10226,20,2473,6385,0,0,0,0,1,1
10227,20,2474,6388,0,0,0,0,1,1
10228,20,2475,6391;6393,0,0,0,1,1,2
10229,20,2477,6395,0,0,0,0,1,1
10230,20,2478,6397;6399,0,0,0,0,2,2
10231,20,2479,6408,0,0,0,1,0,1
10232,20,2480,6410,0,0,0,1,0,1
10233,20,2483,6415;6416,0,0,0,0,2,2
10234,20,2484,6417,0,0,0,0,1,1
10235,20,2485,937;6419;6421,0,0,0,1,2,3
10236,20,2486,6423;10598;10765,0,0,2,1,0,3
10237,20,2488,6425;6426,0,0,0,0,2,2
10238,20,2489,6427;6429,0,0,0,0,2,2
10239,20,2490,6431;10116;10246;10725,0,0,1,3,0,4
10240,20,2491,6433,0,0,0,0,1,1
10241,20,2492,6436,0,0,0,0,1,1
10242,20,2493,6437,0,0,0,0,1,1
10243,20,2495,6067;6441;10570;11105,0,0,2,2,0,4
10244,20,2496,6446;8367,0,0,0,2,0,2
10245,20,2497,1176;6448,0,0,0,2,0,2
10246,20,2498,6450;6451;6453,0,0,0,2,1,3
10247,20,2499,6455;6457;6458,0,0,0,1,2,3
10248,20,2500,6459;6460;6461,0,0,0,2,1,3
10249,20,2501,4082;6463,0,0,0,0,2,2
10250,20,2503,6468;6470,0,0,0,1,1,2
10251,20,2505,6474,0,0,0,0,1,1
10252,20,2506,6475,0,0,0,0,1,1
10253,20,2507,3908;6476,0,0,0,0,2,2
10254,20,2508,6477;6478,0,0,0,1,1,2
10255,20,2509,6481;8635;8920,0,0,0,1,2,3
10256,20,2510,6482,0,0,0,1,0,1
10257,20,2511,6484,0,0,0,0,1,1
10258,20,2512,2889;6485,0,0,0,2,0,2
10259,20,2513,6488;6490,0,0,0,1,1,2
10260,20,2514,6491;6492;6494,0,0,0,2,1,3
10261,20,2515,6495;6496,0,0,0,0,2,2
10262,20,2516,1420;6497,0,0,0,1,1,2
10263,20,2517,6499;6500,0,0,0,0,2,2
10264,20,2518,6501,0,0,0,0,1,1
10265,20,2519,5438;9944;10465;10513;10929;11002,0,0,4,2,0,6
10266,20,2520,6505;6599,0,0,0,0,2,2
10267,20,2521,4668;6506,0,0,0,2,0,2
10268,20,2522,6508,0,0,0,0,1,1
10269,20,2523,6510,0,0,0,0,1,1
10270,20,2524,6512,0,0,0,0,1,1
10271,20,2525,6513,0,0,0,1,0,1
10272,20,2526,6515,0,0,0,0,1,1
10273,20,2527,6519;7638;10415;10448,0,0,1,3,0,4
10274,20,2528,6521,0,0,0,0,1,1
10275,20,2529,6523,0,0,0,0,1,1
10276,20,2530,6527,0,0,0,0,1,1
10277,20,2531,6532,0,0,0,0,1,1
10278,20,2532,6534;6535,0,0,0,2,0,2
10279,20,2534,6540;6541,0,0,0,0,2,2
10280,20,2538,6549;6551,0,0,0,0,2,2
10281,20,2539,6552;6554,0,0,0,1,1,2
10282,20,2541,6563,0,0,0,0,1,1
10283,20,2542,2443;5906;10744,0,0,1,2,0,3
10284,20,2543,2737;6565,0,0,0,1,1,2
10285,20,2545,6569,0,0,0,0,1,1
10286,20,2546,6570;6571,0,0,0,1,1,2
10287,20,2547,767,0,0,0,0,1,1
10288,20,2548,6574,0,0,0,0,1,1
10289,20,2549,6575;8255,0,0,0,2,0,2
10290,20,2551,3732;6578,0,0,0,0,2,2
10291,20,2552,6579,0,0,0,0,1,1
10292,20,2554,6585;7714;10052,0,0,0,3,0,3
10293,20,2555,6590;6591,0,0,0,0,2,2
10294,20,2556,6593,0,0,0,0,1,1
10295,20,2557,6596,0,0,0,0,1,1
10296,20,2558,6597,0,0,0,0,1,1
10297,20,2560,6600;6605,0,0,0,1,1,2
10298,20,2563,6610;6611,0,0,0,1,1,2
10299,20,2565,6614;6616,0,0,0,2,0,2
10300,20,2568,6621;6623,0,0,0,0,2,2
10301,20,2569,3699;6628;11945,0,1,0,2,0,3
10302,20,2570,1071;6630,0,0,0,1,1,2
10303,20,2571,366;6634,0,0,0,2,0,2
10304,20,2573,6639;6642;7412,0,0,0,3,0,3
10305,20,2574,6643;7701;10477;10786,0,0,2,2,0,4
10306,20,2575,6645,0,0,0,0,1,1
10307,20,2577,6650;6651;6652,0,0,0,1,2,3
10308,20,2579,6657;6658,0,0,0,1,1,2
10309,20,2580,3510,0,0,0,0,1,1
10310,20,2581,6663;10175;10481;11025,0,0,2,2,0,4
10311,20,2582,8192,0,0,0,0,1,1
10312,20,2583,6666;6667;6668,0,0,0,3,0,3
10313,20,2584,6669;9288,0,0,0,2,0,2
10314,20,2585,6671;6673;6675,0,0,0,1,2,3
10315,20,2586,6676,0,0,0,0,1,1
10316,20,2587,6677,0,0,0,0,1,1
10317,20,2589,6680;6681,0,0,0,2,0,2
10318,20,2590,3714;6683,0,0,0,2,0,2
10319,20,2591,6685,0,0,0,0,1,1
10320,20,2592,6686;6687,0,0,0,0,2,2
10321,20,2593,6690;6691,0,0,0,0,2,2
10322,20,2594,6695,0,0,0,1,0,1
10323,20,2595,324;6697;10336;10668,0,0,1,3,0,4
10324,20,2596,6704;6707,0,0,0,1,1,2
10325,20,2598,6713,0,0,0,0,1,1
10326,20,2599,6714,0,0,0,0,1,1
10327,20,2601,6716;6720,0,0,0,1,1,2
10328,20,2602,6722;6723,0,0,0,0,2,2
10329,20,2603,6725;6726,0,0,0,0,2,2
10330,20,2604,6730;6731,0,0,0,1,1,2
10331,20,2605,6733,0,0,0,0,1,1
10332,20,2606,3992;6737;10282;10376,0,0,0,4,0,4
10333,20,2607,6739;6740,0,0,0,0,2,2
10334,20,2608,3083;6741;6744,0,0,0,3,0,3
10335,20,2610,6746,0,0,0,1,0,1
10336,20,2611,6749;7828,0,0,0,0,2,2
10337,20,2612,6752;6753,0,0,0,1,1,2
10338,20,2613,3563;6754,0,0,0,2,0,2
10339,20,2615,4362,0,0,0,0,1,1
10340,20,2616,6758,0,0,0,0,1,1
10341,20,2617,6762;6765,0,0,0,1,1,2
10342,20,2618,2688;6766;10405,0,0,0,3,0,3
10343,20,2621,6772;6773,0,0,0,1,1,2
10344,20,2623,6776;6777,0,0,0,0,2,2
10345,20,2624,6779,0,0,0,0,1,1
10346,20,2625,6786,0,0,0,0,1,1
10347,20,2626,6788;10020;10819;11090,0,0,2,2,0,4
10348,20,2627,6790,0,0,0,0,1,1
10349,20,2628,6793,0,0,0,0,1,1
10350,20,2629,6795;6798,0,0,0,0,2,2
10351,20,2631,6801;6802;10919;11032,0,0,2,2,0,4
10352,20,2632,6803;6804;6805,0,0,0,1,2,3
10353,20,2634,6807,0,0,0,1,0,1
10354,20,2637,6813;6814,0,0,0,2,0,2
10355,20,2638,6816;11062;11847;12119;12333,0,3,1,1,0,5
10356,20,2640,6822,0,0,0,0,1,1
10357,20,2641,6824,0,0,0,0,1,1
10358,20,2642,6826,0,0,0,0,1,1
10359,20,2643,6828;6829;10332;10565,0,0,1,2,1,4
10360,20,2644,6831,0,0,0,0,1,1
10361,20,2645,6832,0,0,0,0,1,1
10362,20,2646,6834;6836;6838,0,0,0,2,1,3
10363,20,2647,6841,0,0,0,0,1,1
10364,20,2648,6844;6848;6849,0,0,0,2,1,3
10365,20,2650,6853;6855,0,0,0,2,0,2
10366,20,2651,6858;9460,0,0,0,0,2,2
10367,20,2652,943;6860,0,0,0,2,0,2
10368,20,2655,6871,0,0,0,0,1,1
10369,20,2656,6872;6874,0,0,0,0,2,2
10370,20,2658,6877,0,0,0,0,1,1
10371,20,2660,6883,0,0,0,0,1,1
10372,20,2666,6896,0,0,0,1,0,1
10373,20,2668,6898,0,0,0,0,1,1
10374,20,2670,8228,0,0,0,1,0,1
10375,20,2672,6907,0,0,0,0,1,1
10376,20,2673,6909;6911,0,0,0,1,1,2
10377,20,2674,6912;6913;10311;10610,0,0,1,2,1,4
10378,20,2675,1683;6915;10009;10394,0,0,0,4,0,4
10379,20,2676,6916;6917,0,0,0,0,2,2
10380,20,2678,3260;6924,0,0,0,2,0,2
10381,20,2680,6926,0,0,0,0,1,1
10382,20,2681,1541;6928,0,0,0,2,0,2
10383,20,2683,6931;6932,0,0,0,1,1,2
10384,20,2684,6934;6935,0,0,0,0,2,2
10385,20,2685,6938;9324,0,0,0,0,2,2
10386,20,2686,6940,0,0,0,0,1,1
10387,20,2687,6942;6943,0,0,0,0,2,2
10388,20,2689,6945;6946,0,0,0,0,2,2
10389,20,2690,6923;6952;6955;10159;10363;10753,0,0,1,5,0,6
10390,20,2691,6957,0,0,0,0,1,1
10391,20,2692,6958,0,0,0,0,1,1
10392,20,2693,4410;6959,0,0,0,2,0,2
10393,20,2694,6961;9886,0,0,0,1,1,2
10394,20,2697,3495;6965,0,0,0,2,0,2
10395,20,2698,834;5534,0,0,0,0,2,2
10396,20,2699,6968;6969;10149;10943;11499,0,0,2,3,0,5
10397,20,2700,6972,0,0,0,1,0,1
10398,20,2701,6976,0,0,0,0,1,1
10399,20,2702,6977;6978,0,0,0,1,1,2
10400,20,2703,6979;6980,0,0,0,0,2,2
10401,20,2704,6985;11576,0,0,1,1,0,2
10402,20,2705,6987;6988;6990;6991;10814,0,0,1,3,1,5
10403,20,2706,6992;6994,0,0,0,0,2,2
10404,20,2708,6998;7000,0,0,0,1,1,2
10405,20,2709,7002,0,0,0,1,0,1
10406,20,2712,7006,0,0,0,0,1,1
10407,20,2713,7010,0,0,0,0,1,1
10408,20,2715,7018,0,0,0,0,1,1
10409,20,2716,7023,0,0,0,0,1,1
10410,20,2717,4178;7026,0,0,0,2,0,2
10411,20,2718,7027;7028,0,0,0,2,0,2
10412,20,2719,7036,0,0,0,1,0,1
10413,20,2720,7038;7040,0,0,0,1,1,2
10414,20,2722,7043;7044,0,0,0,1,1,2
10415,20,2723,6007;7045;10431;10524;10576,0,0,2,3,0,5
10416,20,2724,4887;9771,0,0,0,2,0,2
10417,20,2725,7047;7048;10379;10606;11357,0,0,2,2,1,5
10418,20,2726,7049;7050;9190,0,0,0,1,2,3
10419,20,2727,7053,0,0,0,0,1,1
10420,20,2728,7055,0,0,0,0,1,1
10421,20,2729,7056;7057,0,0,0,0,2,2
10422,20,2730,7059,0,0,0,0,1,1
10423,20,2731,7061,0,0,0,0,1,1
10424,20,2732,7063,0,0,0,0,1,1
10425,20,2737,7080;7082,0,0,0,0,2,2
10426,20,2738,7084,0,0,0,0,1,1
10427,20,2739,7085,0,0,0,0,1,1
10428,20,2741,5801;7089,0,0,0,2,0,2
10429,20,2742,7090;7091,0,0,0,1,1,2
10430,20,2743,7092,0,0,0,1,0,1
10431,20,2744,7094;10082;10774;11988,0,1,1,2,0,4
10432,20,2745,7096;7098;8120;10310;10352;10751,0,0,1,5,0,6
10433,20,2746,2372;7101,0,0,0,2,0,2
10434,20,2748,1273;7104,0,0,0,0,2,2
10435,20,2750,7111;7112,0,0,0,1,1,2
10436,20,2751,7113;7115,0,0,0,2,0,2
10437,20,2752,7117,0,0,0,0,1,1
10438,20,2753,7120,0,0,0,0,1,1
10439,20,2754,7122;7124,0,0,0,1,1,2
10440,20,2755,7125,0,0,0,0,1,1
10441,20,2756,7131,0,0,0,0,1,1
10442,20,2758,914;7133,0,0,0,2,0,2
10443,20,2759,2913;7135;10163;10316;10867;11345,0,0,2,4,0,6
10444,20,2761,7139;7140,0,0,0,1,1,2
10445,20,2763,7146;7147;10291,0,0,0,2,1,3
10446,20,2764,7151;8592;12038,0,1,0,2,0,3
10447,20,2765,7153;8362,0,0,0,1,1,2
10448,20,2766,7154;7157;7158,0,0,0,2,1,3
10449,20,2769,1922;7162;10459;10727,0,0,2,2,0,4
10450,20,2770,5582;10500;11349;11956,0,1,2,1,0,4
10451,20,2772,3740;7167;10148,0,0,0,3,0,3
10452,20,2773,7169,0,0,0,0,1,1
10453,20,2776,7179,0,0,0,1,0,1
10454,20,2780,4356,0,0,0,0,1,1
10455,20,2782,5123,0,0,0,1,0,1
10456,20,2783,7194,0,0,0,0,1,1
10457,20,2784,7195;7196;7197,0,0,0,2,1,3
10458,20,2785,7198;7199;10574;11063,0,0,2,1,1,4
10459,20,2787,3502;7203;11649;11930;12294,0,2,1,2,0,5
10460,20,2788,7204;7205,0,0,0,0,2,2
10461,20,2789,7208,0,0,0,0,1,1
10462,20,2790,7209,0,0,0,0,1,1
10463,20,2791,5183;6648,0,0,0,1,1,2
10464,20,2792,7214;7216,0,0,0,1,1,2
10465,20,2793,7217,0,0,0,0,1,1
10466,20,2794,7219,0,0,0,0,1,1
10467,20,2796,7224;7225,0,0,0,0,2,2
10468,20,2797,7228;7229,0,0,0,1,1,2
10469,20,2798,7230,0,0,0,0,1,1
10470,20,2799,6745,0,0,0,0,1,1
10471,20,2800,7233,0,0,0,0,1,1
10472,20,2801,7239,0,0,0,0,1,1
10473,20,2802,7241;9495;10107;10873;11136,0,0,2,3,0,5
10474,20,2803,7242;7243,0,0,0,1,1,2
10475,20,2807,7250,0,0,0,0,1,1
10476,20,2808,7251,0,0,0,0,1,1
10477,20,2809,4235;7252;7253;10223;10338;10482;11586;12034,0,1,2,5,0,8
10478,20,2811,6622;7258;10571,0,0,1,2,0,3
10479,20,2812,7260,0,0,0,0,1,1
10480,20,2813,7262,0,0,0,0,1,1
10481,20,2814,7263;8207,0,0,0,2,0,2
10482,20,2815,7266,0,0,0,0,1,1
10483,20,2816,7268,0,0,0,0,1,1
10484,20,2817,2663;7269,0,0,0,2,0,2
10485,20,2818,7270;7271,0,0,0,1,1,2
10486,20,2819,7273;7274,0,0,0,2,0,2
10487,20,2820,6524;7277;10770;11087,0,0,2,2,0,4
10488,20,2821,7279;7280,0,0,0,0,2,2
10489,20,2822,7281,0,0,0,0,1,1
10490,20,2823,7284,0,0,0,0,1,1
10491,20,2827,7291;7292;7295,0,0,0,1,2,3
10492,20,2830,5037;7299,0,0,0,0,2,2
10493,20,2832,7305,0,0,0,0,1,1
10494,20,2836,7318,0,0,0,1,0,1
10495,20,2838,7320;7322,0,0,0,1,1,2
10496,20,2839,3342;7325;10005;10295;10607;11094,0,0,2,4,0,6
10497,20,2840,7327,0,0,0,0,1,1
10498,20,2842,5752;7333,0,0,0,0,2,2
10499,20,2845,7337,0,0,0,0,1,1
10500,20,2846,7338;7340,0,0,0,1,1,2
10501,20,2848,7347;7348,0,0,0,0,2,2
10502,20,2850,7351,0,0,0,0,1,1
10503,20,2851,7355;10400;10566;11840,0,1,1,2,0,4
10504,20,2853,7358;7360,0,0,0,0,2,2
10505,20,2854,7362,0,0,0,0,1,1
10506,20,2855,597;7364,0,0,0,2,0,2
10507,20,2856,7365;7366,0,0,0,0,2,2
10508,20,2862,7380,0,0,0,0,1,1
10509,20,2863,2455;7384;9520;10580;11127,0,0,2,3,0,5
10510,20,2864,1353;7386,0,0,0,0,2,2
10511,20,2865,7387;7388,0,0,0,0,2,2
10512,20,2867,7392;7393;7395,0,0,0,1,2,3
10513,20,2869,8828;8890;10755;10927,0,0,2,2,0,4
10514,20,2870,7400;7401;7404;7405;10331,0,0,0,5,0,5
10515,20,2871,7406;10117;10235;10446;12010,0,1,1,3,0,5
10516,20,2872,7407,0,0,0,0,1,1
10517,20,2874,7415,0,0,0,1,0,1
10518,20,2875,680;7416;10934,0,0,1,2,0,3
10519,20,2876,7422,0,0,0,0,1,1
10520,20,2878,7427,0,0,0,0,1,1
10521,20,2879,1948;7429;10987;11187;11510,0,0,3,2,0,5
10522,20,2882,7437;7438;7440,0,0,0,2,1,3
10523,20,2883,7442;7445,0,0,0,1,1,2
10524,20,2884,7446,0,0,0,0,1,1
10525,20,2885,1622;6238;7449,0,0,0,2,1,3
10526,20,2887,7453,0,0,0,1,0,1
10527,20,2888,7454,0,0,0,0,1,1
10528,20,2891,7458;7459,0,0,0,0,2,2
10529,20,2892,7462;7465,0,0,0,1,1,2
10530,20,2893,7467,0,0,0,1,0,1
10531,20,2894,7468;7469,0,0,0,1,1,2
10532,20,2895,2324;8772,0,0,0,0,2,2
10533,20,2896,7471;7472;10053;10128;10292;10549;10682;11232,0,0,3,4,1,8
10534,20,2897,7476,0,0,0,0,1,1
10535,20,2899,7457;7480,0,0,0,0,2,2
10536,20,2900,7482;8537;8539;10345;10462;10650;11484,0,0,3,4,0,7
10537,20,2902,7486;7487,0,0,0,0,2,2
10538,20,2903,7489;7490,0,0,0,2,0,2
10539,20,2905,7493;8590;11308;11545;12033,0,1,2,2,0,5
10540,20,2906,7497;7498,0,0,0,1,1,2
10541,20,2907,5919;7501;10049;10275;10912,0,0,1,4,0,5
10542,20,2908,7504;7809,0,0,0,2,0,2
10543,20,2909,7507,0,0,0,0,1,1
10544,20,2912,7514,0,0,0,0,1,1
10545,20,2913,7518;7519,0,0,0,0,2,2
10546,20,2915,2634;7526;10144;10341;11137,0,0,1,4,0,5
10547,20,2916,7529,0,0,0,1,0,1
10548,20,2917,7531,0,0,0,0,1,1
10549,20,2918,7534,0,0,0,1,0,1
10550,20,2919,7536;7537;7539;9666;12202,0,1,0,2,2,5
10551,20,2920,7540;8158,0,0,0,2,0,2
10552,20,2921,7541;9835;10259;10562,0,0,1,3,0,4
10553,20,2925,7551;7555,0,0,0,1,1,2
10554,20,2926,7556,0,0,0,0,1,1
10555,20,2927,7560;7561,0,0,0,1,1,2
10556,20,2929,7564;7565,0,0,0,0,2,2
10557,20,2930,7566,0,0,0,1,0,1
10558,20,2933,7574;7575,0,0,0,1,1,2
10559,20,2935,7577,0,0,0,0,1,1
10560,20,2936,7580,0,0,0,0,1,1
10561,20,2937,7584,0,0,0,0,1,1
10562,20,2938,7586,0,0,0,0,1,1
10563,20,2940,1346;7589,0,0,0,2,0,2
10564,20,2941,7590;7591,0,0,0,1,1,2
10565,20,2942,7594;7596,0,0,0,1,1,2
10566,20,2944,5875;7599,0,0,0,2,0,2
10567,20,2945,7602,0,0,0,0,1,1
10568,20,2946,7605,0,0,0,0,1,1
10569,20,2947,7606;7607;10724;10948,0,0,2,2,0,4
10570,20,2949,7610;7611,0,0,0,0,2,2
10571,20,2950,7613;10564,0,0,1,1,0,2
10572,20,2952,7619;7621;7622,0,0,0,2,1,3
10573,20,2953,7626,0,0,0,0,1,1
10574,20,2954,7627;7628,0,0,0,1,1,2
10575,20,2956,7631,0,0,0,0,1,1
10576,20,2957,7635;7636,0,0,0,1,1,2
10577,20,2960,6881;7641,0,0,0,1,1,2
10578,20,2962,7646,0,0,0,0,1,1
10579,20,2963,7647;7648,0,0,0,0,2,2
10580,20,2964,7649,0,0,0,0,1,1
10581,20,2965,2130;7651;10370;10704;10936,0,0,2,3,0,5
10582,20,2966,7562;7652;7653,0,0,0,0,3,3
10583,20,2967,7655,0,0,0,0,1,1
10584,20,2968,7660,0,0,0,0,1,1
10585,20,2969,7178;7664,0,0,0,2,0,2
10586,20,2970,7666,0,0,0,0,1,1
10587,20,2972,7668,0,0,0,0,1,1
10588,20,2973,7674,0,0,0,0,1,1
10589,20,2974,7677;7678,0,0,0,0,2,2
10590,20,2975,3821;7680,0,0,0,1,1,2
10591,20,2979,7688;7689,0,0,0,0,2,2
10592,20,2981,7695,0,0,0,1,0,1
10593,20,2982,7699;7700;10916,0,0,1,2,0,3
10594,20,2983,4171;7702,0,0,0,2,0,2
10595,20,2985,7707;7708;7709,0,0,0,2,1,3
10596,20,2986,4954;7711,0,0,0,2,0,2
10597,20,2988,7715,0,0,0,0,1,1
10598,20,2989,7716;7717,0,0,0,0,2,2
10599,20,2990,7379;7718,0,0,0,1,1,2
10600,20,2991,7719,0,0,0,0,1,1
10601,20,2993,7727;7728,0,0,0,1,1,2
10602,20,2994,7730;7731,0,0,0,0,2,2
10603,20,2997,7737;7738;10896,0,0,1,1,1,3
10604,20,2998,7741,0,0,0,0,1,1
10605,20,2999,7743,0,0,0,0,1,1
10606,20,3000,4248;7745,0,0,0,0,2,2
10607,20,3002,7751,0,0,0,0,1,1
10608,20,3004,3898;7755,0,0,0,0,2,2
10609,20,3005,7756,0,0,0,0,1,1
10610,20,3006,7757,0,0,0,0,1,1
10611,20,3008,7760,0,0,0,1,0,1
10612,20,3009,7766,0,0,0,1,0,1
10613,20,3010,2089;7767,0,0,0,2,0,2
10614,20,3011,7768;7769,0,0,0,1,1,2
10615,20,3013,7771;10980;11703,0,0,2,0,1,3
10616,20,3014,7773;7774,0,0,0,1,1,2
10617,20,3015,7775;7777,0,0,0,1,1,2
10618,20,3016,7779,0,0,0,0,1,1
10619,20,3017,7782;7784;7785,0,0,0,2,1,3
10620,20,3020,7790;7791,0,0,0,1,1,2
10621,20,3021,1166;7792;10732;11330,0,0,2,2,0,4
10622,20,3022,7793,0,0,0,1,0,1
10623,20,3023,7795;7796,0,0,0,0,2,2
10624,20,3025,6332;7798;10092;10166,0,0,0,4,0,4
10625,20,3026,7174;7176;9106,0,0,0,3,0,3
10626,20,3027,7805,0,0,0,0,1,1
10627,20,3028,4507;7807;7808;10050;10270,0,0,0,5,0,5
10628,20,3029,7810,0,0,0,0,1,1
10629,20,3030,7813;7814,0,0,0,0,2,2
10630,20,3031,7817,0,0,0,1,0,1
10631,20,3032,7821;7822,0,0,0,0,2,2
10632,20,3033,7823;7824,0,0,0,0,2,2
10633,20,3036,7832,0,0,0,0,1,1
10634,20,3037,7834;7835,0,0,0,1,1,2
10635,20,3038,7837,0,0,0,0,1,1
10636,20,3039,7840,0,0,0,0,1,1
10637,20,3041,2076;7847,0,0,0,2,0,2
10638,20,3042,7850;7851,0,0,0,0,2,2
10639,20,3045,5404;7854;10119;10882;11449,0,0,2,3,0,5
10640,20,3046,5527;7857,0,0,0,2,0,2
10641,20,3047,7859,0,0,0,0,1,1
10642,20,3048,7862,0,0,0,0,1,1
10643,20,3050,7866,0,0,0,0,1,1
10644,20,3051,7869,0,0,0,0,1,1
10645,20,3052,523;7875,0,0,0,2,0,2
10646,20,3053,2001;7876,0,0,0,2,0,2
10647,20,3054,7878;10787;11201,0,0,2,1,0,3
10648,20,3055,7879,0,0,0,0,1,1
10649,20,3056,7881,0,0,0,1,0,1
10650,20,3057,380;7883,0,0,0,0,2,2
10651,20,3058,7884,0,0,0,0,1,1
10652,20,3060,7887;7888;7890,0,0,0,3,0,3
10653,20,3061,7892;7893,0,0,0,1,1,2
10654,20,3063,7897;7898,0,0,0,0,2,2
10655,20,3064,2652;7901,0,0,0,2,0,2
10656,20,3065,3629;7903;10241;10509;10829,0,0,2,3,0,5
10657,20,3067,5314;7907;10569;11014;11236;11654,0,0,4,2,0,6
10658,20,3069,7910;7911,0,0,0,0,2,2
10659,20,3070,7075;7915;10428;10608;11307,0,0,2,3,0,5
10660,20,3071,7916;8751;10013;10122,0,0,0,4,0,4
10661,20,3072,2017;7919;7920;10989;11279,0,0,2,3,0,5
10662,20,3074,7924,0,0,0,0,1,1
10663,20,3075,7928;7929,0,0,0,1,1,2
10664,20,3076,7931;7932,0,0,0,0,2,2
10665,20,3079,7938,0,0,0,0,1,1
10666,20,3080,7940;7943,0,0,0,0,2,2
10667,20,3081,5113;7946;7947,0,0,0,3,0,3
10668,20,3082,7948;7949;10616;10812;11126,0,0,3,2,0,5
10669,20,3083,7950;7951;10263,0,0,0,2,1,3
10670,20,3084,7952,0,0,0,0,1,1
10671,20,3085,7954,0,0,0,0,1,1
10672,20,3088,7958;7959,0,0,0,0,2,2
10673,20,3089,7962,0,0,0,0,1,1
10674,20,3091,7967,0,0,0,0,1,1
10675,20,3092,7970;7971;7972,0,0,0,1,2,3
10676,20,3093,7974,0,0,0,0,1,1
10677,20,3095,7977;7978,0,0,0,1,1,2
10678,20,3096,7980,0,0,0,0,1,1
10679,20,3097,7981;7983,0,0,0,0,2,2
10680,20,3098,7984,0,0,0,0,1,1
10681,20,3099,4395;7986;11574,0,0,1,2,0,3
10682,20,3100,7987;11485;11753;12171,0,1,2,1,0,4
10683,20,3101,7991;8659,0,0,0,2,0,2
10684,20,3102,6326;7996;10247;10799,0,0,1,3,0,4
10685,20,3107,8007;9143,0,0,0,2,0,2
10686,20,3108,8009,0,0,0,0,1,1
10687,20,3109,844;8580;10729;10981;11994,0,1,2,2,0,5
10688,20,3112,8018;8019;9295;10178;10355,0,0,0,5,0,5
10689,20,3113,8023,0,0,0,0,1,1
10690,20,3114,8029,0,0,0,1,0,1
10691,20,3115,8032,0,0,0,0,1,1
10692,20,3116,8035;8036;8037;8040,0,0,0,2,2,4
10693,20,3117,8041,0,0,0,0,1,1
10694,20,3118,8044,0,0,0,0,1,1
10695,20,3120,8048;8049;8050,0,0,0,1,2,3
10696,20,3121,8053;8054,0,0,0,0,2,2
10697,20,3122,1105;8056;8057,0,0,0,3,0,3
10698,20,3123,8058,0,0,0,0,1,1
10699,20,3126,4116;8064;8065,0,0,0,1,2,3
10700,20,3127,8066,0,0,0,0,1,1
10701,20,3128,556;8068,0,0,0,0,2,2
10702,20,3129,8069,0,0,0,0,1,1
10703,20,3130,8072;8073,0,0,0,1,1,2
10704,20,3132,8076,0,0,0,1,0,1
10705,20,3133,8078,0,0,0,0,1,1
10706,20,3136,8084,0,0,0,0,1,1
10707,20,3137,8085;8086;10203;10404;10615;10691;11155;11566;11713,0,0,5,4,0,9
10708,20,3139,8090;8091,0,0,0,0,2,2
10709,20,3141,8094;8096,0,0,0,0,2,2
10710,20,3142,8098;10629;10938,0,0,2,1,0,3
10711,20,3143,8101,0,0,0,0,1,1
10712,20,3144,8103,0,0,0,0,1,1
10713,20,3145,5612;8104,0,0,0,0,2,2
10714,20,3146,8105,0,0,0,0,1,1
10715,20,3147,8107;8108;8111;10224;10391;11796,0,1,0,4,1,6
10716,20,3148,7213;8112,0,0,0,2,0,2
10717,20,3150,8118,0,0,0,0,1,1
10718,20,3151,5653;9996;10711;11131,0,0,2,2,0,4
10719,20,3152,8126;8127,0,0,0,0,2,2
10720,20,3153,8128;8129;10078;10156;10456;10689,0,0,2,3,1,6
10721,20,3154,4134;8131;10360;10483,0,0,1,3,0,4
10722,20,3155,7583;8134,0,0,0,0,2,2
10723,20,3157,8138;8139,0,0,0,1,1,2
10724,20,3158,2486;8141;10003;10543;10683,0,0,2,3,0,5
10725,20,3159,8143;8145;8146;10591;11247,0,0,2,3,0,5
10726,20,3160,1360;3688;3690;8147;8149;8150;10153;10396,0,0,0,8,0,8
10727,20,3162,8153;8155,0,0,0,0,2,2
10728,20,3163,69;8156;10628;11408;11748,0,0,3,2,0,5
10729,20,3165,8160,0,0,0,0,1,1
10730,20,3167,8162,0,0,0,1,0,1
10731,20,3168,8165;8166;10133;10410,0,0,0,3,1,4
10732,20,3170,8174;8177,0,0,0,1,1,2
10733,20,3172,7658;8179,0,0,0,2,0,2
10734,20,3176,7693;8190,0,0,0,0,2,2
10735,20,3178,8193;8194,0,0,0,1,1,2
10736,20,3179,8195;8196;8197,0,0,0,0,3,3
10737,20,3180,8199;8200;8201,0,0,0,1,2,3
10738,20,3182,8203;9528,0,0,0,2,0,2
10739,20,3183,8205,0,0,0,0,1,1
10740,20,3185,8208,0,0,0,0,1,1
10741,20,3186,8209;8210,0,0,0,0,2,2
10742,20,3188,8212,0,0,0,0,1,1
10743,20,3189,3718;10427;10676;11467,0,0,2,2,0,4
10744,20,3190,8215,0,0,0,0,1,1
10745,20,3191,8217,0,0,0,0,1,1
10746,20,3192,8223,0,0,0,0,1,1
10747,20,3193,6588;8226;10901;11185,0,0,2,2,0,4
10748,20,3194,8227;8229,0,0,0,0,2,2
10749,20,3198,8235;8236,0,0,0,1,1,2
10750,20,3199,8239;10321;10470;10688;11742,0,0,3,2,0,5
10751,20,3201,8241;8242;10200;10653,0,0,1,2,1,4
10752,20,3202,5285;8243;10014;11065,0,0,1,3,0,4
10753,20,3204,1945;8245,0,0,0,2,0,2
10754,20,3205,8247;8248;10761;11366,0,0,2,2,0,4
10755,20,3206,8249;8250;8251,0,0,0,3,0,3
10756,20,3208,8257,0,0,0,0,1,1
10757,20,3210,8259,0,0,0,0,1,1
10758,20,3211,8261,0,0,0,0,1,1
10759,20,3212,1596;8263;10021;10124;10437,0,0,0,5,0,5
10760,20,3214,8266;8267,0,0,0,2,0,2
10761,20,3215,5700;8274,0,0,0,2,0,2
10762,20,3216,8275;8276;8278,0,0,0,3,0,3
10763,20,3218,2878;8281;8282,0,0,0,1,2,3
10764,20,3219,2212;5902,0,0,0,2,0,2
10765,20,3220,8289,0,0,0,0,1,1
10766,20,3221,8294,0,0,0,0,1,1
10767,20,3222,8295;8296,0,0,0,0,2,2
10768,20,3223,8298;9576,0,0,0,1,1,2
10769,20,3224,8299,0,0,0,0,1,1
10770,20,3225,8300,0,0,0,0,1,1
10771,20,3227,8304;8305;8306,0,0,0,3,0,3
10772,20,3228,8309;8310,0,0,0,0,2,2
10773,20,3230,8316,0,0,0,0,1,1
10774,20,3232,8321;8323,0,0,0,1,1,2
10775,20,3234,8327,0,0,0,1,0,1
10776,20,3235,8329,0,0,0,0,1,1
10777,20,3236,8333;8334;11194;11424,0,0,2,1,1,4
10778,20,3237,2189;8337;11060;11181;12184,0,1,2,2,0,5
10779,20,3238,8340;9429;10452,0,0,1,2,0,3
10780,20,3239,8342,0,0,0,0,1,1
10781,20,3240,8344;8345,0,0,0,1,1,2
10782,20,3243,6078;8350;10344;10675;11430;11805,0,1,2,3,0,6
10783,20,3245,8355,0,0,0,0,1,1
10784,20,3247,8357;8358,0,0,0,2,0,2
10785,20,3248,8359,0,0,0,0,1,1
10786,20,3249,8364,0,0,0,0,1,1
10787,20,3250,8366,0,0,0,0,1,1
10788,20,3251,4077,0,0,0,1,0,1
10789,20,3252,8371,0,0,0,0,1,1
10790,20,3253,8373;8374,0,0,0,1,1,2
10791,20,3255,8379;8380,0,0,0,0,2,2
10792,20,3256,2379;8381,0,0,0,0,2,2
10793,20,3258,5959;8387;10771;10891;11314,0,0,3,2,0,5
10794,20,3259,8390,0,0,0,0,1,1
10795,20,3260,2825;8393;11313;11439;12307,0,1,2,2,0,5
10796,20,3261,858;2506,0,0,0,2,0,2
10797,20,3262,2687;8397,0,0,0,2,0,2
10798,20,3263,8402,0,0,0,0,1,1
10799,20,3264,150;8404;8409,0,0,0,1,2,3
10800,20,3265,8410,0,0,0,0,1,1
10801,20,3266,8411,0,0,0,0,1,1
10802,20,3267,8413;8414,0,0,0,1,1,2
10803,20,3268,8415;8416,0,0,0,2,0,2
10804,20,3269,8419;8420;8421,0,0,0,1,2,3
10805,20,3270,8422;8424,0,0,0,0,2,2
10806,20,3271,8426;8427;10734;11209,0,0,2,1,1,4
10807,20,3273,8432,0,0,0,1,0,1
10808,20,3274,95;8433,0,0,0,2,0,2
10809,20,3275,6944;8434,0,0,0,2,0,2
10810,20,3277,8438,0,0,0,0,1,1
10811,20,3279,8441;8442;8658,0,0,0,3,0,3
10812,20,3280,8444,0,0,0,0,1,1
10813,20,3281,8447;8448,0,0,0,1,1,2
10814,20,3282,7474;8450,0,0,0,2,0,2
10815,20,3283,8452,0,0,0,0,1,1
10816,20,3284,8453;8454,0,0,0,0,2,2
10817,20,3285,8457;8458;8459,0,0,0,0,3,3
10818,20,3286,8460,0,0,0,0,1,1
10819,20,3287,8462,0,0,0,1,0,1
10820,20,3288,2747;8464;10392;10876;11217;11274;11502,0,0,4,3,0,7
10821,20,3289,8467;8468,0,0,0,0,2,2
10822,20,3290,8471;8472;8474,0,0,0,1,2,3
10823,20,3291,8475;8476,0,0,0,0,2,2
10824,20,3293,8482,0,0,0,0,1,1
10825,20,3295,8485,0,0,0,0,1,1
10826,20,3296,8491;8493,0,0,0,1,1,2
10827,20,3297,8495;8496,0,0,0,1,1,2
10828,20,3298,8500,0,0,0,0,1,1
10829,20,3299,8503,0,0,0,0,1,1
10830,20,3301,8506;9080,0,0,0,2,0,2
10831,20,3302,8507,0,0,0,0,1,1
10832,20,3303,8508;8509,0,0,0,1,1,2
10833,20,3304,8510;8511,0,0,0,2,0,2
10834,20,3305,6162;8515,0,0,0,2,0,2
10835,20,3306,8518,0,0,0,0,1,1
10836,20,3310,8528,0,0,0,0,1,1
10837,20,3311,8529,0,0,0,0,1,1
10838,20,3312,8531,0,0,0,0,1,1
10839,20,3314,8533;8535,0,0,0,0,2,2
10840,20,3316,6504;8540;8542;10550;10721;11083,0,0,3,3,0,6
10841,20,3317,8544;8548,0,0,0,0,2,2
10842,20,3318,8550;8551,0,0,0,1,1,2
10843,20,3319,8554;11240;11610;11853,0,1,2,1,0,4
10844,20,3320,593;8557,0,0,0,1,1,2
10845,20,3321,8558;8559,0,0,0,0,2,2
10846,20,3323,5353;8564;8565,0,0,0,3,0,3
10847,20,3324,8569,0,0,0,1,0,1
10848,20,3326,8571;8573,0,0,0,1,1,2
10849,20,3328,8575,0,0,0,0,1,1
10850,20,3330,8579,0,0,0,0,1,1
10851,20,3332,449;8582,0,0,0,2,0,2
10852,20,3333,6048;8585,0,0,0,0,2,2
10853,20,3334,8586,0,0,0,0,1,1
10854,20,3335,8587;8588,0,0,0,0,2,2
10855,20,3336,8593,0,0,0,1,0,1
10856,20,3337,8597,0,0,0,0,1,1
10857,20,3338,8599;8600,0,0,0,2,0,2
10858,20,3339,8603,0,0,0,0,1,1
10859,20,3340,8605,0,0,0,0,1,1
10860,20,3341,8607,0,0,0,0,1,1
10861,20,3342,8608,0,0,0,0,1,1
10862,20,3343,195;8611;8612;10563;11516;11580,0,0,3,3,0,6
10863,20,3344,8613,0,0,0,0,1,1
10864,20,3345,8614;8615,0,0,0,0,2,2
10865,20,3346,8620;8621;8624,0,0,0,1,2,3
10866,20,3347,8625;8626,0,0,0,1,1,2
10867,20,3348,8630;8631,0,0,0,1,1,2
10868,20,3349,8634,0,0,0,0,1,1
10869,20,3351,8637;8638,0,0,0,1,1,2
10870,20,3352,8640;8641,0,0,0,1,1,2
10871,20,3353,8645;8646,0,0,0,1,1,2
10872,20,3354,8647;8649,0,0,0,1,1,2
10873,20,3355,8651;8652,0,0,0,0,2,2
10874,20,3356,8653;8654,0,0,0,0,2,2
10875,20,3357,8655;8656,0,0,0,0,2,2
10876,20,3361,8663;8664;8665,0,0,0,0,3,3
10877,20,3362,5493;8666,0,0,0,0,2,2
10878,20,3363,8667,0,0,0,0,1,1
10879,20,3365,8670;8671,0,0,0,0,2,2
10880,20,3366,8560;8674;8675;12344,0,1,0,3,0,4
10881,20,3368,8682,0,0,0,0,1,1
10882,20,3370,8687;8688,0,0,0,1,1,2
10883,20,3371,8689,0,0,0,0,1,1
10884,20,3372,8690;8692,0,0,0,0,2,2
10885,20,3373,8694,0,0,0,0,1,1
10886,20,3375,8699;8700;8701,0,0,0,1,2,3
10887,20,3376,8563,0,0,0,1,0,1
10888,20,3379,8706;8707,0,0,0,2,0,2
10889,20,3380,8708,0,0,0,1,0,1
10890,20,3382,8715,0,0,0,0,1,1
10891,20,3383,4496,0,0,0,0,1,1
10892,20,3384,8723;10103;10150;10170;10288,0,0,0,5,0,5
10893,20,3385,7170;8724,0,0,0,1,1,2
10894,20,3386,1292;8726,0,0,0,0,2,2
10895,20,3387,5224;8728;10019;10631,0,0,1,3,0,4
10896,20,3388,8729,0,0,0,0,1,1
10897,20,3390,8732;8733,0,0,0,1,1,2
10898,20,3391,8734,0,0,0,0,1,1
10899,20,3392,8736;8737,0,0,0,0,2,2
10900,20,3393,8739,0,0,0,0,1,1
10901,20,3394,8742,0,0,0,0,1,1
10902,20,3395,8745,0,0,0,0,1,1
10903,20,3396,4233;8749;10293;10849,0,0,1,3,0,4
10904,20,3397,8750;8752,0,0,0,0,2,2
10905,20,3398,8755;11166;11426;11679,0,0,3,1,0,4
10906,20,3400,8761;8762,0,0,0,1,1,2
10907,20,3401,8763;8764,0,0,0,2,0,2
10908,20,3402,8765,0,0,0,0,1,1
10909,20,3403,8771,0,0,0,1,0,1
10910,20,3404,8773;8774,0,0,0,1,1,2
10911,20,3405,8775,0,0,0,0,1,1
10912,20,3407,8783,0,0,0,1,0,1
10913,20,3408,8786;8787,0,0,0,0,2,2
10914,20,3410,8789,0,0,0,0,1,1
10915,20,3411,8790;8791,0,0,0,1,1,2
10916,20,3413,8794;8799,0,0,0,1,1,2
10917,20,3415,8802;8803,0,0,0,0,2,2
10918,20,3416,8804;8805;10245;10581;10838,0,0,2,2,1,5
10919,20,3418,8811;8813,0,0,0,0,2,2
10920,20,3420,2833;8817;8819;8823;11869;12014,0,2,0,2,2,6
10921,20,3421,8824;8825,0,0,0,1,1,2
10922,20,3422,8829,0,0,0,0,1,1
10923,20,3423,8832;8833,0,0,0,2,0,2
10924,20,3424,8121;8834;10096;11412,0,0,1,3,0,4
10925,20,3425,8835;8837;8840,0,0,0,1,2,3
10926,20,3426,8841,0,0,0,1,0,1
10927,20,3427,8843;8844;10189;10402,0,0,0,4,0,4
10928,20,3429,8847,0,0,0,0,1,1
10929,20,3431,8852;8854,0,0,0,1,1,2
10930,20,3432,3222;5458;8857;8858;12120;12248;12336,0,3,0,4,0,7
10931,20,3433,8437;8860,0,0,0,2,0,2
10932,20,3434,5884;8861,0,0,0,0,2,2
10933,20,3435,3256;8862,0,0,0,2,0,2
10934,20,3437,8866,0,0,0,0,1,1
10935,20,3438,8868,0,0,0,1,0,1
10936,20,3439,6215;8870,0,0,0,2,0,2
10937,20,3440,8872;8873,0,0,0,0,2,2
10938,20,3442,8875;8878;9792,0,0,0,3,0,3
10939,20,3446,8883;8884;8886,0,0,0,2,1,3
10940,20,3447,8888,0,0,0,0,1,1
10941,20,3448,8891;8893,0,0,0,1,1,2
10942,20,3449,5069;8895;10816;11109,0,0,2,2,0,4
10943,20,3450,4918;8897,0,0,0,0,2,2
10944,20,3451,8901,0,0,0,0,1,1
10945,20,3453,8907,0,0,0,0,1,1
10946,20,3456,8914;8915,0,0,0,1,1,2
10947,20,3457,8917,0,0,0,0,1,1
10948,20,3458,8918;8919,0,0,0,0,2,2
10949,20,3460,8923,0,0,0,0,1,1
10950,20,3461,4190;8926,0,0,0,2,0,2
10951,20,3462,8929;8930;8932,0,0,0,1,2,3
10952,20,3463,8935,0,0,0,0,1,1
10953,20,3464,8937,0,0,0,0,1,1
10954,20,3465,8383;8938,0,0,0,0,2,2
10955,20,3467,8941;8942;10085,0,0,0,2,1,3
10956,20,3468,8943,0,0,0,0,1,1
10957,20,3469,4990;8949,0,0,0,2,0,2
10958,20,3470,8952;8979,0,0,0,0,2,2
10959,20,3471,8955;8956,0,0,0,0,2,2
10960,20,3472,8958,0,0,0,0,1,1
10961,20,3474,8963,0,0,0,0,1,1
10962,20,3475,8341;8965;8967,0,0,0,1,2,3
10963,20,3476,8968;8969,0,0,0,2,0,2
10964,20,3477,8970,0,0,0,0,1,1
10965,20,3478,8972,0,0,0,0,1,1
10966,20,3479,8100;8978,0,0,0,2,0,2
10967,20,3482,8982;8983,0,0,0,0,2,2
10968,20,3483,8988;8989,0,0,0,1,1,2
10969,20,3485,8991;10036,0,0,0,2,0,2
10970,20,3487,8998,0,0,0,1,0,1
10971,20,3488,7159;9000,0,0,0,2,0,2
10972,20,3489,9002,0,0,0,0,1,1
10973,20,3490,9005,0,0,0,0,1,1
10974,20,3491,9010;9011,0,0,0,0,2,2
10975,20,3492,9012,0,0,0,0,1,1
10976,20,3493,1980;9014;9016;10114,0,0,0,4,0,4
10977,20,3495,9019;9020,0,0,0,2,0,2
10978,20,3496,9023,0,0,0,0,1,1
10979,20,3497,9024;9025,0,0,0,0,2,2
10980,20,3499,5169;9028,0,0,0,2,0,2
10981,20,3500,9029,0,0,0,0,1,1
10982,20,3501,9031,0,0,0,0,1,1
10983,20,3502,4485;9034,0,0,0,2,0,2
10984,20,3503,9035;9036;9037,0,0,0,1,2,3
10985,20,3504,9038;9043,0,0,0,1,1,2
10986,20,3505,9044;9046,0,0,0,1,1,2
10987,20,3506,9048,0,0,0,0,1,1
10988,20,3507,1673;9050;10601;10658,0,0,2,2,0,4
10989,20,3508,9051,0,0,0,0,1,1
10990,20,3509,9052,0,0,0,0,1,1
10991,20,3510,9055;9056;10301;10435;10632,0,0,1,4,0,5
10992,20,3514,9064;10276;10340;10630,0,0,1,3,0,4
10993,20,3515,1850;9065,0,0,0,2,0,2
10994,20,3516,9067;9069,0,0,0,1,1,2
10995,20,3517,423;9070;10059;10387;10584;11175,0,0,2,4,0,6
10996,20,3518,9073,0,0,0,0,1,1
10997,20,3519,9076;9078;10647;10940;11458,0,0,3,2,0,5
10998,20,3520,9079;9081,0,0,0,0,2,2
10999,20,3521,3970;9083,0,0,0,0,2,2
11000,20,3523,8114;8490,0,0,0,1,1,2
11001,20,3525,9091;9092,0,0,0,0,2,2
11002,20,3527,9095;9096;9098,0,0,0,1,2,3
11003,20,3528,9100,0,0,0,0,1,1
11004,20,3529,9104;9107,0,0,0,0,2,2
11005,20,3531,9111,0,0,0,0,1,1
11006,20,3532,8022;9116,0,0,0,0,2,2
11007,20,3533,9120;9121,0,0,0,0,2,2
11008,20,3535,9124,0,0,0,0,1,1
11009,20,3536,9128;9129,0,0,0,2,0,2
11010,20,3537,9131;10018;10587;10715,0,0,2,2,0,4
11011,20,3538,9133;9134,0,0,0,1,1,2
11012,20,3539,4542;9138,0,0,0,2,0,2
11013,20,3540,9140;9141,0,0,0,1,1,2
11014,20,3543,9146,0,0,0,0,1,1
11015,20,3544,9147,0,0,0,0,1,1
11016,20,3545,9149,0,0,0,0,1,1
11017,20,3547,9153;9154,0,0,0,1,1,2
11018,20,3549,1104;8238;9157;9161;9162;12087;12274;12282,0,3,0,4,1,8
11019,20,3550,9163,0,0,0,0,1,1
11020,20,3552,9170;9171,0,0,0,1,1,2
11021,20,3553,2674;9173,0,0,0,1,1,2
11022,20,3554,9174,0,0,0,0,1,1
11023,20,3555,9176;9177,0,0,0,1,1,2
11024,20,3556,9179,0,0,0,0,1,1
11025,20,3557,9180,0,0,0,0,1,1
11026,20,3558,9181;9182,0,0,0,1,1,2
11027,20,3559,9183;9184;10374;11318,0,0,1,2,1,4
11028,20,3560,1611;9185,0,0,0,2,0,2
11029,20,3566,9201,0,0,0,0,1,1
11030,20,3567,9202;9203,0,0,0,1,1,2
11031,20,3569,9206;9209,0,0,0,0,2,2
11032,20,3570,9212;9213,0,0,0,0,2,2
11033,20,3573,9222;9223;9227,0,0,0,2,1,3
11034,20,3574,9228;9229;9232,0,0,0,1,2,3
11035,20,3576,9237,0,0,0,0,1,1
11036,20,3577,9240,0,0,0,0,1,1
11037,20,3578,1205;9241,0,0,0,2,0,2
11038,20,3579,6863;9242;11633;11838,0,1,1,2,0,4
11039,20,3580,9243;9244,0,0,0,1,1,2
11040,20,3584,860,0,0,0,0,1,1
11041,20,3586,9259,0,0,0,0,1,1
11042,20,3587,9261;9262,0,0,0,1,1,2
11043,20,3588,2328;9263;9267;11378,0,0,1,3,0,4
11044,20,3589,7571;9268,0,0,0,0,2,2
11045,20,3591,9273,0,0,0,0,1,1
11046,20,3592,9274;9275;10067;10274;10597,0,0,1,3,1,5
11047,20,3593,9276,0,0,0,0,1,1
11048,20,3595,3412;9282,0,0,0,0,2,2
11049,20,3598,9287,0,0,0,0,1,1
11050,20,3600,288,0,0,0,0,1,1
11051,20,3601,4405;9291,0,0,0,0,2,2
11052,20,3604,9296;9297,0,0,0,0,2,2
11053,20,3605,7804;9301;10693;11249,0,0,2,2,0,4
11054,20,3606,9302;9304;10473,0,0,1,1,1,3
11055,20,3611,9312;9313,0,0,0,2,0,2
11056,20,3612,303;9315;9317,0,0,0,3,0,3
11057,20,3613,9318;9319;10136,0,0,0,3,0,3
11058,20,3618,9327,0,0,0,0,1,1
11059,20,3619,1036;9335,0,0,0,0,2,2
11060,20,3620,75;9340;11712,0,0,1,2,0,3
11061,20,3621,9341;9342,0,0,0,0,2,2
11062,20,3622,5954;9343,0,0,0,0,2,2
11063,20,3624,5233;9346,0,0,0,2,0,2
11064,20,3625,9349;9350;11009;11200,0,0,2,1,1,4
11065,20,3626,9354;9357,0,0,0,1,1,2
11066,20,3628,9360;9361;10236;10602;10967,0,0,2,2,1,5
11067,20,3629,9362;9363;9365,0,0,0,2,1,3
11068,20,3630,9283;9366;9371,0,0,0,1,2,3
11069,20,3631,9372,0,0,0,0,1,1
11070,20,3632,9374;9375,0,0,0,1,1,2
11071,20,3633,9377,0,0,0,0,1,1
11072,20,3634,1732;9378,0,0,0,2,0,2
11073,20,3636,9381;9382,0,0,0,0,2,2
11074,20,3637,9383;9384,0,0,0,1,1,2
11075,20,3638,6226;9385,0,0,0,0,2,2
11076,20,3639,9386;9388;10367,0,0,0,3,0,3
11077,20,3640,9390;9391,0,0,0,2,0,2
11078,20,3641,9395,0,0,0,1,0,1
11079,20,3643,4504;9399,0,0,0,2,0,2
11080,20,3644,9402,0,0,0,0,1,1
11081,20,3645,9404;9405;9406,0,0,0,2,1,3
11082,20,3646,9407;9408;10219;10820,0,0,1,2,1,4
11083,20,3647,4444;9409,0,0,0,0,2,2
11084,20,3648,9413;9414,0,0,0,2,0,2
11085,20,3649,8001;9416;9419,0,0,0,2,1,3
11086,20,3650,1539;9422,0,0,0,2,0,2
11087,20,3651,9426;9427;10315;10347;10485;10748,0,0,2,3,1,6
11088,20,3653,9433,0,0,0,0,1,1
11089,20,3654,8026;9435;12141,0,1,0,2,0,3
11090,20,3655,9438,0,0,0,0,1,1
11091,20,3658,9442,0,0,0,0,1,1
11092,20,3659,9445,0,0,0,0,1,1
11093,20,3662,9452;9453,0,0,0,2,0,2
11094,20,3663,9456,0,0,0,0,1,1
11095,20,3664,9458,0,0,0,0,1,1
11096,20,3667,9465;9466,0,0,0,1,1,2
11097,20,3668,9468,0,0,0,0,1,1
11098,20,3669,9473,0,0,0,0,1,1
11099,20,3670,9474,0,0,0,0,1,1
11100,20,3671,9476,0,0,0,0,1,1
11101,20,3672,7359;9477;10334;10777;10893;11212,0,0,3,3,0,6
11102,20,3673,286;9479,0,0,0,2,0,2
11103,20,3674,9481;9483,0,0,0,1,1,2
11104,20,3675,9486,0,0,0,0,1,1
11105,20,3677,9493;9494,0,0,0,0,2,2
11106,20,3679,9496;10216,0,0,0,2,0,2
11107,20,3680,9497,0,0,0,0,1,1
11108,20,3682,9503,0,0,0,0,1,1
11109,20,3683,9505,0,0,0,0,1,1
11110,20,3684,5628;9507;10883;11099;11582,0,0,3,2,0,5
11111,20,3685,9509;9510;9511,0,0,0,2,1,3
11112,20,3686,2464;9512;9513,0,0,0,3,0,3
11113,20,3687,9518;9519,0,0,0,2,0,2
11114,20,3688,419;9521;10554;10802,0,0,2,2,0,4
11115,20,3690,244;9525,0,0,0,2,0,2
11116,20,3691,9530,0,0,0,0,1,1
11117,20,3693,7936;9535,0,0,0,2,0,2
11118,20,3694,9537,0,0,0,0,1,1
11119,20,3695,9539;9540,0,0,0,0,2,2
11120,20,3696,9541;9542,0,0,0,1,1,2
11121,20,3698,9546,0,0,0,0,1,1
11122,20,3699,9548;9549;10303;10441;10703,0,0,2,2,1,5
11123,20,3700,9550;9551,0,0,0,1,1,2
11124,20,3701,9553,0,0,0,0,1,1
11125,20,3702,307;9554;11275,0,0,1,2,0,3
11126,20,3703,9555;9557,0,0,0,0,2,2
11127,20,3704,9560;9561;9563;9939,0,0,0,4,0,4
11128,20,3705,9565;9566,0,0,0,0,2,2
11129,20,3706,9568,0,0,0,1,0,1
11130,20,3708,9574;9575,0,0,0,0,2,2
11131,20,3709,8088;9577,0,0,0,2,0,2
11132,20,3710,9578;9580,0,0,0,1,1,2
11133,20,3711,9581,0,0,0,0,1,1
11134,20,3712,9583;9584,0,0,0,1,1,2
11135,20,3713,9587;10066;10728;11265,0,0,2,2,0,4
11136,20,3714,9591,0,0,0,0,1,1
11137,20,3715,9596,0,0,0,1,0,1
11138,20,3716,9597,0,0,0,1,0,1
11139,20,3717,9599,0,0,0,0,1,1
11140,20,3718,9602,0,0,0,0,1,1
11141,20,3719,9604;9605;10039;10335;10568,0,0,1,4,0,5
11142,20,3721,9610,0,0,0,0,1,1
11143,20,3722,9612;9613,0,0,0,0,2,2
11144,20,3723,9614;9615,0,0,0,1,1,2
11145,20,3724,2407;9618,0,0,0,2,0,2
11146,20,3725,9436;9619,0,0,0,2,0,2
11147,20,3726,9620;9621;10523;10935;11371;11433,0,0,4,2,0,6
11148,20,3727,9624,0,0,0,0,1,1
11149,20,3728,9628,0,0,0,0,1,1
11150,20,3730,9632,0,0,0,0,1,1
11151,20,3731,4491;9634,0,0,0,2,0,2
11152,20,3732,9635;9636,0,0,0,2,0,2
11153,20,3733,9638,0,0,0,0,1,1
11154,20,3734,9640;9641,0,0,0,1,1,2
11155,20,3736,5008;9645;11139;12207,0,1,1,2,0,4
11156,20,3737,9646;9647,0,0,0,1,1,2
11157,20,3738,9650,0,0,0,0,1,1
11158,20,3739,9653,0,0,0,0,1,1
11159,20,3740,9656;9657,0,0,0,1,1,2
11160,20,3743,9661,0,0,0,0,1,1
11161,20,3744,3891;9663,0,0,0,1,1,2
11162,20,3747,9670;9671,0,0,0,1,1,2
11163,20,3748,9673,0,0,0,0,1,1
11164,20,3749,5342;9675,0,0,0,2,0,2
11165,20,3750,3201;12343,0,1,0,1,0,2
11166,20,3751,9683,0,0,0,0,1,1
11167,20,3752,9685;9686;9688,0,0,0,2,1,3
11168,20,3753,9690;9691,0,0,0,0,2,2
11169,20,3755,9698,0,0,0,0,1,1
11170,20,3756,9700;9701,0,0,0,1,1,2
11171,20,3757,9703,0,0,0,0,1,1
11172,20,3759,7615;9708,0,0,0,2,0,2
11173,20,3760,9711;9712,0,0,0,0,2,2
11174,20,3761,9713,0,0,0,1,0,1
11175,20,3763,9717;9718,0,0,0,0,2,2
11176,20,3765,9724;9728,0,0,0,1,1,2
11177,20,3766,9730,0,0,0,0,1,1
11178,20,3769,9734;9735;9736,0,0,0,2,1,3
11179,20,3770,9737;9738;9740,0,0,0,2,1,3
11180,20,3771,9742,0,0,0,1,0,1
11181,20,3772,9743;9744,0,0,0,0,2,2
11182,20,3774,8984;9748;9750;11959,0,1,0,3,0,4
11183,20,3775,9752,0,0,0,0,1,1
11184,20,3776,3302;9755,0,0,0,0,2,2
11185,20,3777,9757,0,0,0,0,1,1
11186,20,3778,9759,0,0,0,0,1,1
11187,20,3779,9440;9763,0,0,0,0,2,2
11188,20,3780,9766,0,0,0,1,0,1
11189,20,3782,9772,0,0,0,1,0,1
11190,20,3783,9774;9775,0,0,0,0,2,2
11191,20,3784,9778;10463;10925;12013,0,1,2,1,0,4
11192,20,3785,9780,0,0,0,0,1,1
11193,20,3786,1985;9785;9788,0,0,0,2,1,3
11194,20,3787,9789;9791,0,0,0,1,1,2
11195,20,3788,9793;9794,0,0,0,1,1,2
11196,20,3789,9796,0,0,0,0,1,1
11197,20,3791,2308;9801,0,0,0,0,2,2
11198,20,3792,9803;10312;10512;10864,0,0,2,2,0,4
11199,20,3793,9807,0,0,0,0,1,1
11200,20,3794,8934;9808;11362;11836;12329,0,2,1,2,0,5
11201,20,3796,9812,0,0,0,0,1,1
11202,20,3797,711;9815;9818;11346,0,0,1,3,0,4
11203,20,3798,9820,0,0,0,0,1,1
11204,20,3800,9823;9824;9826,0,0,0,1,2,3
11205,20,3801,9832,0,0,0,0,1,1
11206,20,3803,9840,0,0,0,0,1,1
11207,20,3804,9841;9842,0,0,0,0,2,2
11208,20,3805,9845,0,0,0,0,1,1
11209,20,3806,9846,0,0,0,0,1,1
11210,20,3809,9851;9852,0,0,0,1,1,2
11211,20,3810,9855;9856,0,0,0,0,2,2
11212,20,3812,9859,0,0,0,0,1,1
11213,20,3813,9862;9863,0,0,0,0,2,2
11214,20,3815,9865,0,0,0,0,1,1
11215,20,3816,7414;9868,0,0,0,2,0,2
11216,20,3817,7009;9870;10983;11168,0,0,2,2,0,4
11217,20,3818,9873,0,0,0,0,1,1
11218,20,3819,9875,0,0,0,0,1,1
11219,20,3820,9876;9877,0,0,0,1,1,2
11220,20,3821,9881,0,0,0,0,1,1
11221,20,3822,213;9888,0,0,0,2,0,2
11222,20,3823,9890,0,0,0,0,1,1
11223,20,3824,9892;9893,0,0,0,0,2,2
11224,20,3825,9896,0,0,0,0,1,1
11225,20,3826,7623;9899,0,0,0,2,0,2
11226,20,3827,5026;9900;11064;11807;12016,0,2,1,2,0,5
11227,20,3828,6703;9902,0,0,0,0,2,2
11228,20,3830,9906,0,0,0,0,1,1
11229,20,3831,3548;9907;10389;11188,0,0,1,3,0,4
11230,20,3832,5226,0,0,0,1,0,1
11231,20,3833,9913;9914;9915,0,0,0,2,1,3
11232,20,3835,9917;9918,0,0,0,0,2,2
11233,20,3837,9924,0,0,0,0,1,1
11234,20,3838,9929,0,0,0,0,1,1
11235,20,3839,9931;10977;11049,0,0,2,1,0,3
11236,20,3841,782;9934;10222;10687;11300,0,0,2,3,0,5
11237,20,3844,9943;9945,0,0,0,1,1,2
11238,20,3845,2060;9949;9951,0,0,0,2,1,3
11239,20,3849,9956;9957,0,0,0,2,0,2
11240,20,3850,6255;9958,0,0,0,1,1,2
11241,20,3852,9960;9961,0,0,0,0,2,2
11242,20,3853,7800;9964,0,0,0,2,0,2
11243,20,3854,9966;9967,0,0,0,0,2,2
11244,20,3855,9968;9971,0,0,0,0,2,2
11245,20,3856,9972;9973;9974,0,0,0,1,2,3
11246,20,3858,9980,0,0,0,0,1,1
11247,20,3859,9981;9982,0,0,0,0,2,2
11248,20,3860,9983;9984;9986;9987;10640,0,0,1,4,0,5
11249,20,3861,9988,0,0,0,1,0,1
11250,20,3862,9989;9991,0,0,0,1,1,2
11251,20,3863,9992;9993,0,0,0,0,2,2
11252,20,3864,9997,0,0,0,0,1,1
11253,20,3865,10000;10002,0,0,0,0,2,2
11254,20,3866,22;1906;10962;11504,0,0,2,2,0,4
11255,20,3868,299;1516;10089;10722,0,0,1,3,0,4
11256,20,3869,7669;7849;10639;11573,0,0,2,2,0,4
11257,20,3870,442,0,0,0,0,1,1
11258,20,3871,492;10924;11312,0,0,2,1,0,3
11259,20,3872,487;549,0,0,0,2,0,2
11260,20,3876,657;10001,0,0,0,2,0,2
11261,20,3877,979;2099;10028;10375;10626,0,0,1,4,0,5
11262,20,3878,5825,0,0,0,0,1,1
11263,20,3879,1569;10098;10231,0,0,0,3,0,3
11264,20,3880,1737,0,0,0,0,1,1
11265,20,3881,1826;2380;10735;10885,0,0,2,2,0,4
11266,20,3882,1900,0,0,0,0,1,1
11267,20,3883,1989;7661,0,0,0,2,0,2
11268,20,3884,2135;9309,0,0,0,0,2,2
11269,20,3885,974;2208;10250;10634;10954;11331,0,0,3,3,0,6
11270,20,3886,2258;9193,0,0,0,0,2,2
11271,20,3888,2288,0,0,0,1,0,1
11272,20,3889,2346;3864,0,0,0,0,2,2
11273,20,3890,9970,0,0,0,0,1,1
11274,20,3891,1297;2527,0,0,0,0,2,2
11275,20,3892,2562;6259,0,0,0,0,2,2
11276,20,3895,2717;7573,0,0,0,1,1,2
11277,20,3896,2771;5360,0,0,0,0,2,2
11278,20,3897,2990,0,0,0,0,1,1
11279,20,3899,3100;3625,0,0,0,2,0,2
11280,20,3900,3190,0,0,0,1,0,1
11281,20,3901,1740,0,0,0,1,0,1
11282,20,3902,3291;10652;11213,0,0,2,1,0,3
11283,20,3904,3865;6873;10139;10269;10773;11523,0,0,2,4,0,6
11284,20,3905,3979;9480;10714;11088;12052,0,1,2,2,0,5
11285,20,3906,4111,0,0,0,1,0,1
11286,20,3909,4243;4971,0,0,0,2,0,2
11287,20,3910,4563,0,0,0,0,1,1
11288,20,3911,5110,0,0,0,0,1,1
11289,20,3912,4880;9919,0,0,0,2,0,2
11290,20,3913,2864;5058;10137;10592;11159,0,0,2,3,0,5
11291,20,3914,4051;6074;10828;10917;11646,0,0,3,2,0,5
11292,20,3915,5124,0,0,0,0,1,1
11293,20,3916,5208;9878;10558;11293,0,0,2,2,0,4
11294,20,3917,2588;8981,0,0,0,2,0,2
11295,20,3918,525,0,0,0,0,1,1
11296,20,3919,5411;6509,0,0,0,0,2,2
11297,20,3920,5767,0,0,0,0,1,1
11298,20,3921,8543;10678;11151,0,0,2,1,0,3
11299,20,3925,6626;8622;10561;11353,0,0,2,2,0,4
11300,20,3926,9303,0,0,0,1,0,1
11301,20,3927,6757;10800;11045;11752,0,0,3,1,0,4
11302,20,3929,5777;7361,0,0,0,2,0,2
11303,20,3930,7542;9977;10102;10123,0,0,0,4,0,4
11304,20,3931,4621;7547,0,0,0,0,2,2
11305,20,3932,7759,0,0,0,0,1,1
11306,20,3933,5764;7843;10140;10438;10466,0,0,1,4,0,5
11307,20,3935,7985,0,0,0,1,0,1
11308,20,3936,4740;8062,0,0,0,2,0,2
11309,20,3938,7645;8221,0,0,0,2,0,2
11310,20,3939,202;9159;10692,0,0,1,2,0,3
11311,20,3940,8394,0,0,0,0,1,1
11312,20,3941,6221;8489,0,0,0,2,0,2
11313,20,3942,8678,0,0,0,0,1,1
11314,20,3943,8936,0,0,0,1,0,1
11315,20,3944,7137;8999,0,0,0,2,0,2
11316,20,3945,1947;9136,0,0,0,1,1,2
11317,20,3946,3922;4188;10120;11282;12363,0,1,1,3,0,5
11318,20,3947,9367,0,0,0,0,1,1
11319,20,3948,5977,0,0,0,0,1,1
11320,20,3949,6311;9449;10243;11026,0,0,1,3,0,4
11321,20,3950,964;9522,0,0,0,0,2,2
11322,20,3952,9828,0,0,0,0,1,1
11323,20,3953,2206;9871,0,0,0,2,0,2
11324,20,3954,1561;9911;10923;11258,0,0,2,2,0,4
11325,20,3957,752;3061;12063,365,1,0,2,0,3
11326,20,3959,509,365,0,0,0,1,1
11327,20,3960,5699;11093;11303,365,0,2,1,0,3
11328,20,3961,669,365,0,0,0,1,1
11329,20,3962,728;1695;10933;11112,365,0,2,2,0,4
11330,20,3964,954;7643,365,0,0,0,2,2
11331,20,3965,1174;9331,365,0,0,2,0,2
11332,20,3966,1179;7838;10879;11491,365,0,2,2,0,4
11333,20,3967,459;1363,365,0,0,2,0,2
11334,20,3969,3140;11946;12259,365,2,0,1,0,3
11335,20,3970,1950;5351,365,0,0,2,0,2
11336,20,3972,2171;5721,365,0,0,1,1,2
11337,20,3973,2410;3092,365,0,0,1,1,2
11338,20,3974,2377;9439,365,0,0,0,2,2
11339,20,3975,2723;11004;11441,365,0,2,1,0,3
11340,20,3976,258;2793,365,0,0,0,2,2
11341,20,3977,2804;6064;11142;11986,365,1,1,2,0,4
11342,20,3978,2930;9990;10261;11304,365,0,1,3,0,4
11343,20,3979,2647;2998,365,0,0,0,2,2
11344,20,3980,516;3066;10279;11477,365,0,1,3,0,4
11345,20,3981,3227;6566,365,0,0,2,0,2
11346,20,3982,3224,365,0,0,0,1,1
11347,20,3983,3073,365,0,0,0,1,1
11348,20,3984,3392,365,0,0,1,0,1
11349,20,3985,1368;3394,365,0,0,1,1,2
11350,20,3986,3396;8378;10718;11299;11473;12296,365,1,3,2,0,6
11351,20,3987,726;3432;5766;11189,365,0,1,3,0,4
11352,20,3988,3444;8946,365,0,0,2,0,2
11353,20,3989,3544;8024,365,0,0,1,1,2
11354,20,3991,916;3923;10177;10403;11225,365,0,1,4,0,5
11355,20,3992,4560;6619;10775;11191,365,0,2,2,0,4
11356,20,3993,4640,365,0,0,0,1,1
11357,20,3994,4675;6974;10955,365,0,1,2,0,3
11358,20,3995,259;1277,365,0,0,2,0,2
11359,20,3996,4944,365,0,0,0,1,1
11360,20,3997,4968;6396,365,0,0,2,0,2
11361,20,3998,1640;3833;10694;11418,365,0,2,2,0,4
11362,20,4000,4827;5432,365,0,0,2,0,2
11363,20,4003,681,365,0,0,1,0,1
11364,20,4004,9572;11904;12094,365,2,0,1,0,3
11365,20,4005,5652;9811,365,0,0,1,1,2
11366,20,4006,4889;5900;10696;11405,365,0,2,2,0,4
11367,20,4008,6020;6706,365,0,0,2,0,2
11368,20,4009,2210;6021;10976;11221;11764,365,1,2,2,0,5
11369,20,4010,6031;7244,365,0,0,2,0,2
11370,20,4011,3133;6696;10227;10508;10720,365,0,2,3,0,5
11371,20,4012,9556,365,0,0,0,1,1
11372,20,4014,828;6797,365,0,0,2,0,2
11373,20,4015,6799;8315;8681;10842,365,0,1,3,0,4
11374,20,4016,3062;3397;10242;10528;11106;11632,365,0,3,3,0,6
11375,20,4017,3868;10480;10664;11596,365,0,3,1,0,4
11376,20,4018,6390;10232;10458;10898,365,0,2,2,0,4
11377,20,4020,7644,365,0,0,0,1,1
11378,20,4021,3451;7753,365,0,0,0,2,2
11379,20,4022,6222;7819;10337;10806;11406,365,0,2,3,0,5
11380,20,4024,1913;7858,365,0,0,2,0,2
11381,20,4025,7264;7886,365,0,0,1,1,2
11382,20,4026,7917,365,0,0,0,1,1
11383,20,4027,7997;8696;8697;8698;10805;11145;11328;11455,365,0,4,4,0,8
11384,20,4028,3157;5878;10757;11021,365,0,2,2,0,4
11385,20,4029,8021;9559,365,0,0,1,1,2
11386,20,4033,3632;6993,365,0,0,2,0,2
11387,20,4035,4907;6674,365,0,0,2,0,2
11388,20,4039,9270,365,0,0,0,1,1
11389,20,4040,8446;9428;10264;10635,365,0,1,3,0,4
11390,20,4041,3667;9432,365,0,0,1,1,2
11391,20,4042,9461;9829,365,0,0,2,0,2
11392,20,4043,8286;9482,365,0,0,2,0,2
11393,20,4045,9950,365,0,0,1,0,1
11394,20,4046,143;8125,730,0,0,0,2,2
11395,20,4047,200;8849,730,0,0,0,2,2
11396,20,4048,6184;6735;11364,730,0,1,2,0,3
11397,20,4049,329;10364;10860;11113,730,0,2,2,0,4
11398,20,4051,437,730,0,0,0,1,1
11399,20,4052,489;3429;10897;11192;11512;11862,730,1,3,2,0,6
11400,20,4053,2949;10413;11095,730,0,1,2,0,3
11401,20,4055,5617;11767,730,1,0,1,0,2
11402,20,4056,692,730,0,0,0,1,1
11403,20,4058,948;5619;10383;10701;10843,730,0,2,3,0,5
11404,20,4059,951;3996;10702;10979;11334;11416,730,0,4,2,0,6
11405,20,4061,1401;5239,730,0,0,0,2,2
11406,20,4062,903;9848,730,0,0,2,0,2
11407,20,4063,1678,730,0,0,0,1,1
11408,20,4065,1745;6581;10290;10492;10666;10831;11623,730,0,4,3,0,7
11409,20,4066,1783;4619;10862;11178,730,0,2,2,0,4
11410,20,4067,1801;1846;10841;11637;12285,730,1,2,2,0,5
11411,20,4068,1904;7066;10545;11125,730,0,2,2,0,4
11412,20,4069,1907;7206,730,0,0,0,2,2
11413,20,4071,1306;7261,730,0,0,2,0,2
11414,20,4072,2165;2403,730,0,0,0,2,2
11415,20,4075,2337,730,0,0,0,1,1
11416,20,4076,917,730,0,0,0,1,1
11417,20,4083,2636,730,0,0,0,1,1
11418,20,4084,2676;9822,730,0,0,0,2,2
11419,20,4086,2801;8992,730,0,0,0,2,2
11420,20,4088,3082,730,0,0,0,1,1
11421,20,4089,3192,730,0,0,1,0,1
11422,20,4090,3257,730,0,0,1,0,1
11423,20,4092,4348;4761,730,0,0,2,0,2
11424,20,4093,3643;3815,730,0,0,1,1,2
11425,20,4094,3792;6999;11739;11923,730,1,1,2,0,4
11426,20,4095,1688;3892,730,0,0,0,2,2
11427,20,4096,3924;10594,730,0,1,1,0,2
11428,20,4097,3965,730,0,0,0,1,1
11429,20,4098,3984,730,0,0,1,0,1
11430,20,4099,4030;5216;7037;10449;10642,730,0,2,3,0,5
11431,20,4101,7942,730,0,0,0,1,1
11432,20,4103,4273,730,0,0,1,0,1
11433,20,4104,592;4287,730,0,0,1,1,2
11434,20,4105,4377;8830;11152,730,0,1,2,0,3
11435,20,4106,4384;8033;11842;12177,730,2,0,2,0,4
11436,20,4108,4659;7904,730,0,0,1,1,2
11437,20,4109,4909;6856;10827,730,0,1,2,0,3
11438,20,4111,705;5085;11782,730,1,0,2,0,3
11439,20,4112,5087;8382,730,0,0,2,0,2
11440,20,4114,262,730,0,0,1,0,1
11441,20,4116,7;6345,730,0,0,2,0,2
11442,20,4117,730;5542;10779,730,0,1,2,0,3
11443,20,4118,5684;6920;10783,730,0,1,2,0,3
11444,20,4119,5883,730,0,0,1,0,1
11445,20,4122,2203;11305;12039,730,1,1,1,0,3
11446,20,4124,4794,730,0,0,0,1,1
11447,20,4126,6438,730,0,0,0,1,1
11448,20,4127,158;6694;10373;10521;10880,730,0,2,3,0,5
11449,20,4128,1887;6890,730,0,0,1,1,2
11450,20,4129,5571;6922;10776;11527;11664,730,0,3,2,0,5
11451,20,4130,6936;7021;10825;11183;11420,730,0,3,2,0,5
11452,20,4131,7074;8662;10329;11975,730,1,0,3,0,4
11453,20,4134,3305,730,0,0,0,1,1
11454,20,4137,5109;7582,730,0,0,2,0,2
11455,20,4138,7592;11350;11750;12173,730,1,2,1,0,4
11456,20,4140,7871;8757;11505,730,0,1,2,0,3
11457,20,4141,5419;7899;11297;12208,730,1,1,2,0,4
11458,20,4143,8173;9937,730,0,0,2,0,2
11459,20,4144,4482;8277;10801;11197;11325,730,0,3,2,0,5
11460,20,4145,8322;9105;11028;11287;11363;11617;12324,730,1,4,2,0,7
11461,20,4148,6060;8392,730,0,0,1,1,2
11462,20,4149,9168,730,0,0,0,1,1
11463,20,4152,8814,730,0,0,1,0,1
11464,20,4153,8957,730,0,0,0,1,1
11465,20,4154,8964,730,0,0,0,1,1
11466,20,4155,5286,730,0,0,0,1,1
11467,20,4156,1209;9086;10540;10656,730,0,2,2,0,4
11468,20,4157,9186,730,0,0,0,1,1
11469,20,4158,1074;4218;11199;11530;11657,730,0,3,2,0,5
11470,20,4159,3750;5972;10559;11384,730,0,2,2,0,4
11471,20,4160,4407;9490,730,0,0,0,2,2
11472,20,4161,6679;9508,730,0,0,2,0,2
11473,20,4162,9524,730,0,0,0,1,1
11474,20,4164,5819;9754,730,0,0,1,1,2
11475,20,4165,1447;9762;11398;11715,730,0,2,2,0,4
11476,20,4166,9781,730,0,0,1,0,1
11477,20,4168,9813,730,0,0,0,1,1
11478,20,4170,9857,730,0,0,0,1,1
11479,20,4171,10;4284;10887;11262;12334,1095,1,2,2,0,5
11480,20,4172,38;1509;10407;10851;11280;11648;12386,1095,1,3,3,0,7
11481,20,4173,45;5748;11567;11733,1095,0,2,2,0,4
11482,20,4174,181;3103;12216,1095,1,0,2,0,3
11483,20,4178,417;2297,1095,0,0,0,2,2
11484,20,4179,475;1212;11570;11921;12028,1095,2,1,2,0,5
11485,20,4180,578;5810;12069,1095,1,0,2,0,3
11486,20,4181,655;9895;10911,1095,0,1,2,0,3
11487,20,4182,675,1095,0,0,0,1,1
11488,20,4183,467;685;10548;10740;11277,1095,0,3,2,0,5
11489,20,4185,6550,1095,0,0,1,0,1
11490,20,4186,7505;9558,1095,0,0,2,0,2
11491,20,4187,5000;7035;11534;11893;12163,1095,2,1,2,0,5
11492,20,4189,7007,1095,0,0,0,1,1
11493,20,4190,1197;2133;10643,1095,0,1,2,0,3
11494,20,4191,1224,1095,0,0,0,1,1
11495,20,4192,1247;9721,1095,0,0,2,0,2
11496,20,4194,1458;10552;10895,1095,0,2,1,0,3
11497,20,4195,1490;1790,1095,0,0,2,0,2
11498,20,4196,1563,1095,0,0,0,1,1
11499,20,4197,1655;6761;10655;10900;11110,1095,0,3,2,0,5
11500,20,4198,1821;6302,1095,0,0,0,2,2
11501,20,4199,873;1974,1095,0,0,2,0,2
11502,20,4200,2152,1095,0,0,0,1,1
11503,20,4201,2343,1095,0,0,0,1,1
11504,20,4202,2351;4015;11817;12154,1095,2,0,2,0,4
11505,20,4205,4170;10651;12252,1095,1,1,1,0,3
11506,20,4206,1603;4925;10766;11376;11553,1095,0,3,2,0,5
11507,20,4209,4260;9622,1095,0,0,0,2,2
11508,20,4211,2986;3235,1095,0,0,2,0,2
11509,20,4212,3239;7998;11288;11915;12190,1095,2,1,2,0,5
11510,20,4213,3471;5679,1095,0,0,2,0,2
11511,20,4214,7226,1095,0,0,1,0,1
11512,20,4216,7079,1095,0,0,1,0,1
11513,20,4217,4001;7272;10520;10663;10959,1095,0,3,2,0,5
11514,20,4218,4002;5070;10471;11228;11390,1095,0,3,2,0,5
11515,20,4221,3549;4207,1095,0,0,2,0,2
11516,20,4222,4367,1095,0,0,0,1,1
11517,20,4223,4490;4923;10679;10785;11301,1095,0,3,2,0,5
11518,20,4225,4559;6587;11615;11716,1095,0,2,2,0,4
11519,20,4226,4589;4797;10905;11465,1095,0,2,2,0,4
11520,20,4230,4577;11321;11717;11885,1095,1,2,1,0,4
11521,20,4232,6035,1095,0,0,1,0,1
11522,20,4234,3759;5379,1095,0,0,2,0,2
11523,20,4236,5430;5755,1095,0,0,2,0,2
11524,20,4237,5769;10705;10822;11082,1095,0,3,1,0,4
11525,20,4238,3903;5816,1095,0,0,1,1,2
11526,20,4239,5547;5928;11544;12157,1095,1,1,2,0,4
11527,20,4241,6028,1095,0,0,1,0,1
11528,20,4245,4148;6334,1095,0,0,2,0,2
11529,20,4246,4821;6428,1095,0,0,2,0,2
11530,20,4247,6646,1095,0,0,0,1,1
11531,20,4248,4522;6837;10874;10994,1095,0,2,2,0,4
11532,20,4249,2556;6914;11251;11579,1095,0,2,2,0,4
11533,20,4250,5489;12222,1095,1,0,1,0,2
11534,20,4251,7136,1095,0,0,0,1,1
11535,20,4252,5871;7294;11348,1095,0,1,2,0,3
11536,20,4253,1183;7317,1095,0,0,1,1,2
11537,20,4254,926;7321;10426;10798,1095,0,1,3,0,4
11538,20,4255,7363;9298,1095,0,0,2,0,2
11539,20,4256,4370,1095,0,0,1,0,1
11540,20,4257,3675;7372,1095,0,0,2,0,2
11541,20,4258,7420,1095,0,0,0,1,1
11542,20,4259,2612;7426,1095,0,0,0,2,2
11543,20,4260,1967;7516;11122;11409,1095,0,2,2,0,4
11544,20,4261,5490;7585;11102,1095,0,1,2,0,3
11545,20,4262,1532;5052,1095,0,0,0,2,2
11546,20,4263,7603;7722;10533;10622;11396,1095,0,3,2,0,5
11547,20,4264,2350;9526;11451;11820;11974,1095,2,1,2,0,5
11548,20,4265,5201;10741;11872,1095,1,1,1,0,3
11549,20,4266,6122;7844;10750,1095,0,1,2,0,3
11550,20,4268,6544;8516;11810;12385,1095,2,0,2,0,4
11551,20,4272,8455;11005;11415,1095,0,2,1,0,3
11552,20,4273,3708;8483;11519,1095,0,1,2,0,3
11553,20,4274,5343;7470,1095,0,0,0,2,2
11554,20,4275,7138;12130,1095,1,0,1,0,2
11555,20,4276,794;8859;11786;12072,1095,2,0,2,0,4
11556,20,4278,2682;4533,1095,0,0,2,0,2
11557,20,4281,5366;9165;11104;11950,1095,1,1,2,0,4
11558,20,4282,4908;9166;10497;10752;10915,1095,0,3,2,0,5
11559,20,4285,3289;5605,1095,0,0,2,0,2
11560,20,4286,9601,1095,0,0,0,1,1
11561,20,4287,5443;9714;12083;12281,1095,2,0,2,0,4
11562,20,4288,8175;9727;10444;10736;11886,1095,1,2,2,0,5
11563,20,4293,9600,1095,0,0,1,0,1
11564,20,4296,436,1460,0,0,0,1,1
11565,20,4297,486;8925,1460,0,0,2,0,2
11566,20,4298,583;11826;11884;12133,1460,3,0,1,0,4
11567,20,4299,643;11475,1460,0,1,1,0,2
11568,20,4300,7286;11096,1460,0,1,1,0,2
11569,20,4301,710,1460,0,0,0,1,1
11570,20,4302,795;4888;10837;11222,1460,0,2,2,0,4
11571,20,4303,811;7604;10990;11190;11481;12026,1460,1,3,2,0,6
11572,20,4304,871;10832;11020,1460,0,2,1,0,3
11573,20,4305,881,1460,0,0,0,1,1
11574,20,4306,895;5737,1460,0,0,2,0,2
11575,20,4307,977;4602;10707;11511,1460,0,2,2,0,4
11576,20,4308,999;4094,1460,0,0,0,2,2
11577,20,4309,1059;1842;11216;11382,1460,0,2,2,0,4
11578,20,4311,1199;4492;10461;10937,1460,0,2,2,0,4
11579,20,4312,1213;3255;10600;10686;11342;11939;12353,1460,2,3,2,0,7
11580,20,4313,1227,1460,0,0,0,1,1
11581,20,4314,973,1460,0,0,1,0,1
11582,20,4315,1333;7692,1460,0,0,2,0,2
11583,20,4316,1499;5709;10760;11514;11993,1460,1,2,2,0,5
11584,20,4317,371;1590,1460,0,0,2,0,2
11585,20,4320,4756;10815;11459;11699,1460,0,3,1,0,4
11586,20,4321,2246,1460,0,0,1,0,1
11587,20,4322,2126;2281,1460,0,0,2,0,2
11588,20,4323,2392,1460,0,0,0,1,1
11589,20,4324,2416,1460,0,0,0,1,1
11590,20,4325,2553,1460,0,0,0,1,1
11591,20,4326,2724;3799,1460,0,0,2,0,2
11592,20,4327,106;2731,1460,0,0,0,2,2
11593,20,4328,1536;2834,1460,0,0,2,0,2
11594,20,4329,2843;4527;11521,1460,0,1,2,0,3
11595,20,4330,2887;9786;10796;11626,1460,0,2,2,0,4
11596,20,4334,3358,1460,0,0,0,1,1
11597,20,4335,3621;9947;11795;12169,1460,2,0,2,0,4
11598,20,4337,2301;3709;11081;11370;11526,1460,0,3,2,0,5
11599,20,4338,8456;8760;12008,1460,1,0,2,0,3
11600,20,4340,5905;9562;11797,1460,1,0,2,0,3
11601,20,4341,3832;7485;10504;10624;11072;12074,1460,1,3,2,0,6
11602,20,4342,3946;7624,1460,0,0,2,0,2
11603,20,4344,4076,1460,0,0,0,1,1
11604,20,4345,2232;4169;10892;11563,1460,0,2,2,0,4
11605,20,4346,4201,1460,0,0,0,1,1
11606,20,4347,4315;10996;11979,1460,1,1,1,0,3
11607,20,4348,4335;5038,1460,0,0,1,1,2
11608,20,4349,4379;8135;11683,1460,0,1,2,0,3
11609,20,4350,4707;11332;11638,1460,0,2,1,0,3
11610,20,4352,4795;8770,1460,0,0,0,2,2
11611,20,4353,1054;4920;10599;10671;10971,1460,0,3,2,0,5
11612,20,4354,2622;4939;10710;11077,1460,0,2,2,0,4
11613,20,4355,3295;5017;11205;11666,1460,0,2,2,0,4
11614,20,4359,4126;5350,1460,0,0,0,2,2
11615,20,4360,5377;6586;11123;11518;11724,1460,0,3,2,0,5
11616,20,4362,5741;11161;11489;11598,1460,0,3,1,0,4
11617,20,4364,1978;5857;10585;11223,1460,0,2,2,0,4
11618,20,4366,3184;5899,1460,0,0,2,0,2
11619,20,4368,8526;10884,1460,0,1,1,0,2
11620,20,4369,4197;11272;11337,1460,0,2,1,0,3
11621,20,4370,1526,1460,0,0,1,0,1
11622,20,4372,5114;6169;10945;11672;12263,1460,1,2,2,0,5
11623,20,4375,7989;11422;11625;11916;12241,1460,2,2,1,0,5
11624,20,4376,6489;6728;12134;12271,1460,2,0,2,0,4
11625,20,4377,6810,1460,0,0,0,1,1
11626,20,4378,6819;9257,1460,0,0,2,0,2
11627,20,4380,3566;12160,1460,1,0,1,0,2
11628,20,4381,6452;6986;11461,1460,0,1,2,0,3
11629,20,4382,1718,1460,0,0,1,0,1
11630,20,4383,7107,1460,0,0,0,1,1
11631,20,4384,2427,1460,0,0,1,0,1
11632,20,4385,2516;9424;11503;11948;12030;12182;12287,1460,4,1,2,0,7
11633,20,4387,6133,1460,0,0,1,0,1
11634,20,4389,7517;8602,1460,0,0,2,0,2
11635,20,4390,7868;7925;12117,1460,1,0,2,0,3
11636,20,4391,6211;7921,1460,0,0,2,0,2
11637,20,4392,2525;8070,1460,0,0,2,0,2
11638,20,4393,8644,1460,0,0,1,0,1
11639,20,4396,2722;8202,1460,0,0,1,1,2
11640,20,4397,8284;8538,1460,0,0,2,0,2
11641,20,4400,8686,1460,0,0,1,0,1
11642,20,4402,1218;8488;10680;11976,1460,1,1,2,0,4
11643,20,4403,7495;8502,1460,0,0,2,0,2
11644,20,4404,8966;9238;10746;11483,1460,0,2,2,0,4
11645,20,4405,8568;8987;10869;11010;11316;12143,1460,1,3,2,0,6
11646,20,4406,4375;9113,1460,0,0,2,0,2
11647,20,4407,9271,1460,0,0,1,0,1
11648,20,4408,6198;9299,1460,0,0,2,0,2
11649,20,4409,6318;9500,1460,0,0,2,0,2
11650,20,4410,9660,1460,0,0,0,1,1
11651,20,4411,1833;9697,1460,0,0,2,0,2
11652,20,4412,6413;9769,1460,0,0,2,0,2
11653,20,4413,706;9777,1460,0,0,2,0,2
11654,20,4414,4085;9809;10856;11153;11799;12085,1460,2,2,2,0,6
11655,20,4415,1741,1460,0,0,1,0,1
11656,20,4416,4873,1460,0,0,1,0,1
11657,20,4417,71;4336;11558,1825,0,1,2,0,3
11658,20,4418,199;8519;11380;11933,1825,1,1,2,0,4
11659,20,4419,201;8661,1825,0,0,2,0,2
11660,20,4420,141;4623,1825,0,0,0,2,2
11661,20,4421,296;7076;10638;11034,1825,0,2,2,0,4
11662,20,4422,304,1825,0,0,0,1,1
11663,20,4423,439;10778;11243;11613;11947,1825,1,3,1,0,5
11664,20,4424,636;6143;10575;11411;11432,1825,0,3,2,0,5
11665,20,4426,720;6736;12181;12376,1825,2,0,2,0,4
11666,20,4427,7557,1825,0,0,1,0,1
11667,20,4428,972,1825,0,0,0,1,1
11668,20,4429,1130,1825,0,0,0,1,1
11669,20,4430,642;1525;11369,1825,0,1,2,0,3
11670,20,4431,411;6655,1825,0,0,2,0,2
11671,20,4433,1784,1825,0,0,1,0,1
11672,20,4435,6196,1825,0,0,1,0,1
11673,20,4437,3219,1825,0,0,1,0,1
11674,20,4438,3165;4898;10619;10877;11120,1825,0,3,2,0,5
11675,20,4440,3208;7012,1825,0,0,2,0,2
11676,20,4441,3229,1825,0,0,0,1,1
11677,20,4442,3648;7523;11488,1825,0,1,2,0,3
11678,20,4443,3308;6407;11375,1825,0,1,2,0,3
11679,20,4444,3384;5457;10961;11141,1825,0,2,2,0,4
11680,20,4445,1122;3463,1825,0,0,2,0,2
11681,20,4446,8285;9009;10697;11022;11851;12328,1825,2,2,2,0,6
11682,20,4448,3565;8480,1825,0,0,0,2,2
11683,20,4451,3595;3850;11140;11402;11487,1825,0,3,2,0,5
11684,20,4452,3934;5888;12081,1825,1,0,2,0,3
11685,20,4453,488;3961;10661;11924,1825,1,1,2,0,4
11686,20,4454,1151;3962;10588;10866;10913,1825,0,3,2,0,5
11687,20,4455,4046;11241;11778,1825,1,1,1,0,3
11688,20,4457,1387;4165;11761,1825,1,0,2,0,3
11689,20,4459,4453,1825,0,0,0,1,1
11690,20,4460,4474;8718,1825,0,0,2,0,2
11691,20,4461,4487;8672;11771,1825,1,0,2,0,3
11692,20,4462,4678;4838;11079;11286,1825,0,2,2,0,4
11693,20,4463,4711;9089,1825,0,0,2,0,2
11694,20,4464,4751;5160;11710,1825,0,1,2,0,3
11695,20,4465,5566,1825,0,0,0,1,1
11696,20,4468,4921,1825,0,0,0,1,1
11697,20,4470,8552;10644,1825,0,1,1,0,2
11698,20,4471,740;2285;5046;10649;10930;11296;11572,1825,0,4,3,0,7
11699,20,4472,5234;9830;10698;10823,1825,0,2,2,0,4
11700,20,4473,458;5235;10712;10988;11029,1825,0,3,2,0,5
11701,20,4474,5295,1825,0,0,0,1,1
11702,20,4476,1417;5391,1825,0,0,0,2,2
11703,20,4477,2316;5546;10870;11144;11995,1825,1,2,2,0,5
11704,20,4479,5838,1825,0,0,0,1,1
11705,20,4483,4314;6022,1825,0,0,2,0,2
11706,20,4484,6173,1825,0,0,1,0,1
11707,20,4485,5811;6207;11326;11351;11549;12166,1825,1,3,2,0,6
11708,20,4486,6313;8561;10791;11006;11056;11323;11581;11718,1825,0,6,2,0,8
11709,20,4488,6456;7116,1825,0,0,0,2,2
11710,20,4489,6530;6625;11755;12111,1825,1,1,2,0,4
11711,20,4490,356;6637;10789;11037;11148,1825,0,3,2,0,5
11712,20,4491,5014;6649;11227;12108,1825,1,1,2,0,4
11713,20,4492,6070;6653;11515,1825,0,1,2,0,3
11714,20,4493,3539;6782;11052;12242;12374,1825,2,1,2,0,5
11715,20,4494,6929,1825,0,0,0,1,1
11716,20,4495,1195;7845,1825,0,0,0,2,2
11717,20,4496,7210,1825,0,0,0,1,1
11718,20,4498,7256;7508;11008;11284;11593,1825,0,3,2,0,5
11719,20,4501,7051;7382;12124;12140,1825,2,0,2,0,4
11720,20,4502,7559,1825,0,0,0,1,1
11721,20,4503,773;9256;11073;11138;11587,1825,0,3,2,0,5
11722,20,4505,6582;7672;10910;11255;11689;11887,1825,1,3,2,0,6
11723,20,4506,7685,1825,0,0,1,0,1
11724,20,4507,7721;9329;11327,1825,0,1,2,0,3
11725,20,4508,5448;7815;11859,1825,1,0,2,0,3
11726,20,4510,7882;8985;10928,1825,0,1,2,0,3
11727,20,4511,7933,1825,0,0,1,0,1
11728,20,4513,8030,1825,0,0,0,1,1
11729,20,4514,8082,1825,0,0,1,0,1
11730,20,4515,8264,1825,0,0,0,1,1
11731,20,4517,550;8545,1825,0,0,2,0,2
11732,20,4519,8132;8617,1825,0,0,2,0,2
11733,20,4520,4103;8628,1825,0,0,2,0,2
11734,20,4521,8744;9352;11084,1825,0,1,2,0,3
11735,20,4522,3362;8176;11097;11368,1825,0,2,2,0,4
11736,20,4523,2580;9225;11708;12116;12345,1825,2,1,2,0,5
11737,20,4524,9032;9651;10852;10972;11024;12178,1825,1,3,2,0,6
11738,20,4525,1055;9077;11295;11501;11540,1825,0,3,2,0,5
11739,20,4526,7601;9097;11492;11954;12350,1825,2,1,2,0,5
11740,20,4527,9119;9127,1825,0,0,2,0,2
11741,20,4530,568;9356;10942,1825,0,1,2,0,3
11742,20,4531,2156;9368;11157;11630,1825,0,2,2,0,4
11743,20,4533,3538;9648;11529;12092,1825,1,1,2,0,4
11744,20,4534,2366;9817;11691;12299,1825,1,1,2,0,4
11745,20,4536,1317;9963;11444;11551,1825,0,2,2,0,4
11746,20,4538,110;4274,2190,0,0,2,0,2
11747,20,4539,112;2881;11058;11498;11647,2190,0,3,2,0,5
11748,20,4542,863;6330,2190,0,0,2,0,2
11749,20,4543,1009,2190,0,0,1,0,1
11750,20,4544,209;5210,2190,0,0,2,0,2
11751,20,4545,1229,2190,0,0,0,1,1
11752,20,4546,1367,2190,0,0,0,1,1
11753,20,4548,1556;4615;10899;11173,2190,0,2,2,0,4
11754,20,4550,1610,2190,0,0,0,1,1
11755,20,4551,1788;3004;11427;11967,2190,1,1,2,0,4
11756,20,4553,2136,2190,0,0,0,1,1
11757,20,4554,2141;5166;11186;11329;11525,2190,0,3,2,0,5
11758,20,4555,2441;8864;11546;11793,2190,1,1,2,0,4
11759,20,4556,950;2480;11035,2190,0,1,2,0,3
11760,20,4557,2563,2190,0,0,0,1,1
11761,20,4558,2621;9006;11053;11354;11591;11849;11907,2190,2,3,2,0,7
11762,20,4559,2655,2190,0,0,1,0,1
11763,20,4560,2670;7671;11207;11404;11568;11706;12082;12250,2190,2,4,2,0,8
11764,20,4561,64;2811;11121;11779;11966,2190,2,1,2,0,5
11765,20,4562,2821;9464,2190,0,0,2,0,2
11766,20,4563,2865;3315;10974;11452;11808,2190,1,2,2,0,5
11767,20,4566,6281;10749;10932,2190,0,2,1,0,3
11768,20,4568,3139,2190,0,0,0,1,1
11769,20,4569,3161;7343;10888;11436,2190,0,2,2,0,4
11770,20,4570,1848;3199,2190,0,0,0,2,2
11771,20,4571,9459,2190,0,0,0,1,1
11772,20,4572,3531;4654;10904;11248,2190,0,2,2,0,4
11773,20,4574,2433;6947;11292;12301,2190,1,1,2,0,4
11774,20,4575,3746,2190,0,0,0,1,1
11775,20,4576,3768;9897;10953;12293,2190,1,1,2,0,4
11776,20,4578,2295;3860,2190,0,0,2,0,2
11777,20,4579,3955;11730,2190,0,1,1,0,2
11778,20,4580,2490;4000,2190,0,0,2,0,2
11779,20,4581,4012,2190,0,0,0,1,1
11780,20,4582,4073;8269;10850;11229;12331,2190,1,2,2,0,5
11781,20,4583,4475;8679;11057;11290;11414;11594,2190,0,4,2,0,6
11782,20,4585,8388;9573;12273,2190,1,0,2,0,3
11783,20,4586,9831,2190,0,0,1,0,1
11784,20,4587,4813,2190,0,0,1,0,1
11785,20,4588,3720,2190,0,0,0,1,1
11786,20,4589,4950,2190,0,0,1,0,1
11787,20,4591,817;1415;11339;11711;12115,2190,1,2,2,0,5
11788,20,4593,1824;10716;11163;11681,2190,0,3,1,0,4
11789,20,4595,4893,2190,0,0,0,1,1
11790,20,4596,971,2190,0,0,0,1,1
11791,20,4597,5896;8349,2190,0,0,2,0,2
11792,20,4598,5963;6170;11970;12236,2190,2,0,2,0,4
11793,20,4599,3387;3985;10726;10813;11507;11535,2190,0,4,2,0,6
11794,20,4600,6118;6503,2190,0,0,2,0,2
11795,20,4601,1116;6347,2190,0,0,2,0,2
11796,20,4602,6365,2190,0,0,0,1,1
11797,20,4603,6432,2190,0,0,0,1,1
11798,20,4605,6594,2190,0,0,0,1,1
11799,20,4606,4594;6602;10780;10944;11042,2190,0,3,2,0,5
11800,20,4607,3164;6774;11728;11990,2190,1,1,2,0,4
11801,20,4608,7001;7227,2190,0,0,2,0,2
11802,20,4609,2016;9347,2190,0,0,2,0,2
11803,20,4610,6854;7102,2190,0,0,2,0,2
11804,20,4611,6191;7222;11070,2190,0,1,2,0,3
11805,20,4612,7331;9854,2190,0,0,2,0,2
11806,20,4613,7353;7691;11816,2190,1,0,2,0,3
11807,20,4614,6193;7609,2190,0,0,2,0,2
11808,20,4615,7705;11918,2190,1,0,1,0,2
11809,20,4617,7811,2190,0,0,0,1,1
11810,20,4618,7841,2190,0,0,0,1,1
11811,20,4619,4141;6262;7874;11431;11844;11897,2190,2,1,3,0,6
11812,20,4620,7982,2190,0,0,0,1,1
11813,20,4621,8184;8479;10969;12105,2190,1,1,2,0,4
11814,20,4623,8204,2190,0,0,0,1,1
11815,20,4624,4102;8318;11343;11606;12368,2190,1,2,2,0,5
11816,20,4627,779;8398,2190,0,0,2,0,2
11817,20,4629,8798;11901,2190,1,0,1,0,2
11818,20,4631,9047,2190,0,0,1,0,1
11819,20,4632,7183,2190,0,0,1,0,1
11820,20,4633,3438;9370;11561;12009,2190,1,1,2,0,4
11821,20,4634,9484;9926;11614;11707;12035,2190,1,2,2,0,5
11822,20,4637,9590,2190,0,0,0,1,1
11823,20,4638,9616,2190,0,0,1,0,1
11824,20,4639,8408;9643,2190,0,0,2,0,2
11825,20,4640,2500;9677,2190,0,0,2,0,2
11826,20,4641,9825,2190,0,0,1,0,1
11827,20,4643,4053,2190,0,0,1,0,1
11828,20,4645,232;7930,2555,0,0,2,0,2
11829,20,4646,1583;2892;12201,2555,1,0,2,0,3
11830,20,4647,278;6192;11798,2555,1,0,2,0,3
11831,20,4648,289,2555,0,0,0,1,1
11832,20,4649,350;8039;12359,2555,1,0,2,0,3
11833,20,4650,355;4220,2555,0,0,2,0,2
11834,20,4653,1031;9265,2555,0,0,2,0,2
11835,20,4654,1332;3338,2555,0,0,2,0,2
11836,20,4655,9358;11781;12217,2555,2,0,1,0,3
11837,20,4656,1372;5661;11864,2555,1,0,2,0,3
11838,20,4657,1399;11837,2555,1,0,1,0,2
11839,20,4658,6354;9224;11631;11905,2555,1,1,2,0,4
11840,20,4659,1814;8331;11811,2555,1,0,2,0,3
11841,20,4660,1901;7657,2555,0,0,2,0,2
11842,20,4661,1653;1932;12089,2555,1,0,2,0,3
11843,20,4662,1935;4543;11356,2555,0,1,2,0,3
11844,20,4664,1230;2289;11700,2555,0,1,2,0,3
11845,20,4665,2368,2555,0,0,1,0,1
11846,20,4666,603;2385;10926;11195,2555,0,2,2,0,4
11847,20,4668,2383;2605;11791,2555,1,0,2,0,3
11848,20,4669,430;2681;10855;11043,2555,0,2,2,0,4
11849,20,4670,2766;4979;10863;11260;11754,2555,0,3,2,0,5
11850,20,4671,2800;9501,2555,0,0,2,0,2
11851,20,4672,2058;2839,2555,0,0,2,0,2
11852,20,4673,2857,2555,0,0,0,1,1
11853,20,4674,1207;3144;11537;11813,2555,1,1,2,0,4
11854,20,4675,1494;3268;11253;11440;11989,2555,1,2,2,0,5
11855,20,4676,3277;9114,2555,0,0,2,0,2
11856,20,4677,1505;3524;11595,2555,0,1,2,0,3
11857,20,4678,3574;6102;11652,2555,0,1,2,0,3
11858,20,4679,3703;6767,2555,0,0,2,0,2
11859,20,4681,3766;7342;11074,2555,0,1,2,0,3
11860,20,4683,4101;7391;11445;11655;12298,2555,1,2,2,0,5
11861,20,4684,4224;10886,2555,0,1,1,0,2
11862,20,4685,4239,2555,0,0,1,0,1
11863,20,4686,4258;7255;11531;11832;12210,2555,2,1,2,0,5
11864,20,4687,8712,2555,0,0,1,0,1
11865,20,4688,714;4272;10853;11453;11751;11932,2555,1,3,2,0,6
11866,20,4689,1692;4398;11107,2555,0,1,2,0,3
11867,20,4690,4501;8583,2555,0,0,2,0,2
11868,20,4691,7058;11172;11397;11639,2555,0,3,1,0,4
11869,20,4692,8272;9588;11016;11480,2555,0,2,2,0,4
11870,20,4695,4758,2555,0,0,0,1,1
11871,20,4697,686;8618;12370,2555,1,0,2,0,3
11872,20,4698,4865,2555,0,0,0,1,1
11873,20,4699,5167,2555,0,0,0,1,1
11874,20,4700,8680;11244;11834;12289,2555,2,1,1,0,4
11875,20,4701,5327,2555,0,0,1,0,1
11876,20,4703,2310;5499,2555,0,0,1,1,2
11877,20,4705,5548,2555,0,0,1,0,1
11878,20,4706,4978;5604;11383;11547,2555,0,2,2,0,4
11879,20,4708,5691;6164;11787;11962,2555,2,0,2,0,4
11880,20,4709,65;5799;11496,2555,0,1,2,0,3
11881,20,4710,2692;5988;11403,2555,0,1,2,0,3
11882,20,4714,3131,2555,0,0,0,1,1
11883,20,4715,1910;6409,2555,0,0,2,0,2
11884,20,4716,6440;9797;10975;11749,2555,0,2,2,0,4
11885,20,4717,6473,2555,0,0,0,1,1
11886,20,4718,6701;11520;11608;11690,2555,0,3,1,0,4
11887,20,4719,203;1140;10939;11464,2555,0,2,2,0,4
11888,20,4720,404;6769;11176;11729;12254,2555,1,2,2,0,5
11889,20,4721,4198;6778,2555,0,0,2,0,2
11890,20,4723,2007;6867;10963,2555,0,1,2,0,3
11891,20,4724,6949;8822;11940,2555,1,0,2,0,3
11892,20,4725,6951;8831;11634,2555,0,1,2,0,3
11893,20,4726,7078;8122;11821,2555,1,0,2,0,3
11894,20,4728,2022;7820,2555,0,0,2,0,2
11895,20,4729,397;7569;11086,2555,0,1,2,0,3
11896,20,4730,4649;10868;11030;11108,2555,0,3,1,0,4
11897,20,4731,316;6037,2555,0,0,2,0,2
11898,20,4732,7926,2555,0,0,1,0,1
11899,20,4733,8002;8006,2555,0,0,2,0,2
11900,20,4734,3436;11283;11758,2555,1,1,1,0,3
11901,20,4735,8087;9843;11320;11454,2555,0,2,2,0,4
11902,20,4736,8157,2555,0,0,1,0,1
11903,20,4737,4062;8271;11470;12257,2555,1,1,2,0,4
11904,20,4738,986;8501,2555,0,0,2,0,2
11905,20,4739,8596;12239,2555,1,0,1,0,2
11906,20,4740,7072;8740,2555,0,0,2,0,2
11907,20,4741,8753,2555,0,0,1,0,1
11908,20,4742,1060;8795,2555,0,0,2,0,2
11909,20,4746,3418;9214,2555,0,0,2,0,2
11910,20,4747,236;9328;11119;11400,2555,0,2,2,0,4
11911,20,4748,1612,2555,0,0,0,1,1
11912,20,4749,2510,2555,0,0,0,1,1
11913,20,4750,7341;9499;12255,2555,1,0,2,0,3
11914,20,4751,2765,2555,0,0,1,0,1
11915,20,4753,2628;9607;11124,2555,0,1,2,0,3
11916,20,4754,2609;9652,2555,0,0,0,2,2
11917,20,4755,7307;9883;11676;11938,2555,1,1,2,0,4
11918,20,4757,1061;9975;11554;11937;12159,2555,2,1,2,0,5
11919,20,4758,42,2920,0,0,0,1,1
11920,20,4759,146;4129,2920,0,0,2,0,2
11921,20,4761,3218;9145;11224;12186,2920,1,1,2,0,4
11922,20,4763,414;1548,2920,0,0,2,0,2
11923,20,4764,445,2920,0,0,1,0,1
11924,20,4765,534,2920,0,0,1,0,1
11925,20,4767,687;7109,2920,0,0,1,1,2
11926,20,4768,736;8547,2920,0,0,0,2,2
11927,20,4770,864;1235,2920,0,0,2,0,2
11928,20,4771,1016;10914;11202;11772,2920,1,2,1,0,4
11929,20,4772,892;3406;12137,2920,1,0,2,0,3
11930,20,4774,1099;7992;12051,2920,1,0,2,0,3
11931,20,4775,1634;2355;11951;12125,2920,2,0,2,0,4
11932,20,4776,1123;1648;12023;12371,2920,2,0,2,0,4
11933,20,4778,931;1882;12096,2920,1,0,2,0,3
11934,20,4779,1936;5013;11385,2920,0,1,2,0,3
11935,20,4780,933;11857;12253,2920,2,0,1,0,3
11936,20,4781,2169;8292,2920,0,0,2,0,2
11937,20,4782,1925,2920,0,0,1,0,1
11938,20,4783,2543,2920,0,0,1,0,1
11939,20,4784,2840;8627;11759;12003,2920,2,0,2,0,4
11940,20,4785,2861,2920,0,0,1,0,1
11941,20,4788,55;2960;11889;12319,2920,2,0,2,0,4
11942,20,4789,3155;3704;11322;11543;11909;12321,2920,2,2,2,0,6
11943,20,4790,3182,2920,0,0,1,0,1
11944,20,4791,2812;3193,2920,0,0,2,0,2
11945,20,4792,3207;4713;11130;11341,2920,0,2,2,0,4
11946,20,4793,3374;7185;11922,2920,1,0,2,0,3
11947,20,4794,3449;5870,2920,0,0,2,0,2
11948,20,4796,4209;4500;12191,2920,1,0,2,0,3
11949,20,4797,3959;11725;11794;12107,2920,2,1,1,0,4
11950,20,4798,3533;6375,2920,0,0,2,0,2
11951,20,4800,3626,2920,0,0,1,0,1
11952,20,4801,3695;9392;12251,2920,1,0,2,0,3
11953,20,4802,3812;7698,2920,0,0,2,0,2
11954,20,4803,8417,2920,0,0,1,0,1
11955,20,4804,3849;3879;11220;12245,2920,1,1,2,0,4
11956,20,4805,3940;7403,2920,0,0,2,0,2
11957,20,4806,4022;8425;11541;11935,2920,1,1,2,0,4
11958,20,4807,2456;4044,2920,0,0,2,0,2
11959,20,4808,4109;4411;11391;11912;12234,2920,2,1,2,0,5
11960,20,4810,4290,2920,0,0,1,0,1
11961,20,4811,2359;4399,2920,0,0,2,0,2
11962,20,4813,3518;4949;11179;11538;11777,2920,1,2,2,0,5
11963,20,4814,751;5086;12097,2920,1,0,2,0,3
11964,20,4815,5125,2920,0,0,0,1,1
11965,20,4816,4924;5328;12339,2920,1,0,2,0,3
11966,20,4817,4637;5378;12128;12149;12358,2920,3,0,2,0,5
11967,20,4819,5620,2920,0,0,0,1,1
11968,20,4821,5788;6770,2920,0,0,2,0,2
11969,20,4822,5864;7034;11741;12303,2920,1,1,2,0,4
11970,20,4823,5913,2920,0,0,1,0,1
11971,20,4824,4582;7293;11871,2920,1,0,2,0,3
11972,20,4825,6284;9189;11047;11902,2920,1,1,2,0,4
11973,20,4826,6454;8443;11671;12043,2920,1,1,2,0,4
11974,20,4827,6464;8013;11031;11463;11560;11870,2920,1,3,2,0,6
11975,20,4828,565;6618;11231;11468,2920,0,2,2,0,4
11976,20,4829,6688;6700;11466;11873,2920,1,1,2,0,4
11977,20,4830,4799;6718;11565;11845,2920,1,1,2,0,4
11978,20,4831,293;7180;10999;11196;12006,2920,1,2,2,0,5
11979,20,4833,3120;7223;12084,2920,1,0,2,0,3
11980,20,4834,3039,2920,0,0,0,1,1
11981,20,4836,6636;7419;11336;11555;12059,2920,1,2,2,0,5
11982,20,4837,7502,2920,0,0,0,1,1
11983,20,4838,3641,2920,0,0,0,1,1
11984,20,4839,6604;8144;11588;11878;12261,2920,2,1,2,0,5
11985,20,4841,2816;7889,2920,0,0,2,0,2
11986,20,4842,7902,2920,0,0,0,1,1
11987,20,4844,7181;8167,2920,0,0,2,0,2
11988,20,4845,8254,2920,0,0,0,1,1
11989,20,4846,6989;12148,2920,1,0,1,0,2
11990,20,4847,4854;8406;12147,2920,1,0,2,0,3
11991,20,4851,8169;8784;12040,2920,1,0,2,0,3
11992,20,4852,8850,2920,0,0,0,1,1
11993,20,4853,8902,2920,0,0,1,0,1
11994,20,4854,2093;8997;11023;11281;11450,2920,0,3,2,0,5
11995,20,4856,1647;9196;12044,2920,1,0,2,0,3
11996,20,4857,8123;9355;11964;12229;12272,2920,3,0,2,0,5
11997,20,4858,1343;3895,2920,0,0,2,0,2
11998,20,4859,513;9664;11500;11722;12220,2920,1,2,2,0,5
11999,20,4860,6036;9681;12277,2920,1,0,2,0,3
12000,20,4861,620;9706,2920,0,0,0,2,2
12001,20,4862,7378;9833;11167,2920,0,1,2,0,3
12002,20,4863,848;9930,2920,0,0,2,0,2
12003,20,4864,3011;6689;11239;12078,2920,1,1,2,0,4
12004,20,4867,37;7398;11564;11704;11775,3285,1,2,2,0,5
12005,20,4869,116;4373;12041,3285,1,0,2,0,3
12006,20,4870,128;1728,3285,0,0,0,2,2
12007,20,4871,4628;7729;11309,3285,0,1,2,0,3
12008,20,4872,188;3177,3285,0,0,2,0,2
12009,20,4873,6820;12265,3285,1,0,1,0,2
12010,20,4874,375;381,3285,0,0,0,2,2
12011,20,4875,503;6629;11532;11883,3285,1,1,2,0,4
12012,20,4876,536,3285,0,0,1,0,1
12013,20,4878,6699;9280;11302;11386,3285,0,2,2,0,4
12014,20,4879,875,3285,0,0,0,1,1
12015,20,4880,877;9879;11038,3285,0,1,2,0,3
12016,20,4881,952;11744,3285,0,1,1,0,2
12017,20,4882,958;9799,3285,0,0,2,0,2
12018,20,4883,3376;11071;11446;12131,3285,1,2,1,0,4
12019,20,4885,7013,3285,0,0,0,1,1
12020,20,4886,1658;7245,3285,0,0,0,2,2
12021,20,4887,1679,3285,0,0,1,0,1
12022,20,4890,1820;4320;11089,3285,0,1,2,0,3
12023,20,4891,4435;9649;11269,3285,0,1,2,0,3
12024,20,4892,1977,3285,0,0,0,1,1
12025,20,4893,1990;9245;11259;11372,3285,0,2,2,0,4
12026,20,4894,936,3285,0,0,1,0,1
12027,20,4895,2205,3285,0,0,0,1,1
12028,20,4896,3788,3285,0,0,1,0,1
12029,20,4898,1386;2417,3285,0,0,2,0,2
12030,20,4899,3698;5159;11132,3285,0,1,2,0,3
12031,20,4900,4553;8903;12205,3285,1,0,2,0,3
12032,20,4903,3789,3285,0,0,0,1,1
12033,20,4904,3125,3285,0,0,1,0,1
12034,20,4905,3276;6405;11815;12183,3285,2,0,2,0,4
12035,20,4907,3437;8650;12262,3285,1,0,2,0,3
12036,20,4909,3523;5949;11762;12073,3285,2,0,2,0,4
12037,20,4910,6559,3285,0,0,1,0,1
12038,20,4913,3633;8214;11027,3285,0,1,2,0,3
12039,20,4914,4401,3285,0,0,1,0,1
12040,20,4915,3672;6847,3285,0,0,2,0,2
12041,20,4916,3716;4576,3285,0,0,2,0,2
12042,20,4918,3869;9188;11085;12007,3285,1,1,2,0,4
12043,20,4919,3070;3968;11036;11476;12110,3285,1,2,2,0,5
12044,20,4921,4067,3285,0,0,0,1,1
12045,20,4922,1318;2013;11562;11763,3285,1,1,2,0,4
12046,20,4923,4479;4499;11046;11609,3285,0,2,2,0,4
12047,20,4925,793;4721;11888;12226,3285,2,0,2,0,4
12048,20,4926,9570,3285,0,0,0,1,1
12049,20,4927,2217;4131,3285,0,0,2,0,2
12050,20,4929,5075,3285,0,0,0,1,1
12051,20,4931,5692;5936;12024,3285,1,0,2,0,3
12052,20,4932,4517,3285,0,0,1,0,1
12053,20,4933,5863;11833;12362,3285,2,0,1,0,3
12054,20,4934,5257;8595;11658,3285,0,1,2,0,3
12055,20,4935,3741;9768;12304,3285,1,0,2,0,3
12056,20,4936,6120,3285,0,0,0,1,1
12057,20,4937,6188;6612;11268;11443;11622,3285,0,3,2,0,5
12058,20,4938,4514;6285;11770;12022,3285,2,0,2,0,4
12059,20,4939,2080;6486,3285,0,0,2,0,2
12060,20,4940,6537,3285,0,0,1,0,1
12061,20,4941,4850;6727;11460;12062,3285,1,1,2,0,4
12062,20,4943,6895,3285,0,0,1,0,1
12063,20,4944,6954;8808;12060,3285,1,0,2,0,3
12064,20,4945,6792;6970;11164;11899;12198,3285,2,1,2,0,5
12065,20,4947,7192;11285;11692;11903,3285,1,2,1,0,4
12066,20,4949,2215;7394;11882,3285,1,0,2,0,3
12067,20,4950,4293;7428;11076;11203,3285,0,2,2,0,4
12068,20,4951,3417;7461,3285,0,0,2,0,2
12069,20,4952,3575;7488;11160;12032,3285,1,1,2,0,4
12070,20,4953,7752,3285,0,0,0,1,1
12071,20,4955,8124,3285,0,0,1,0,1
12072,20,4956,9462,3285,0,0,0,1,1
12073,20,4957,1431,3285,0,0,1,0,1
12074,20,4958,8319,3285,0,0,1,0,1
12075,20,4959,6542;8368,3285,0,0,2,0,2
12076,20,4960,8466;11238,3285,0,1,1,0,2
12077,20,4962,5021;9351;11230;11592,3285,0,2,2,0,4
12078,20,4963,8911,3285,0,0,0,1,1
12079,20,4964,8623;11360,3285,0,1,1,0,2
12080,20,4965,2429,3285,0,0,0,1,1
12081,20,4966,7330;9017;11548;11661;12311,3285,1,2,2,0,5
12082,20,4967,8748;9066,3285,0,0,1,1,2
12083,20,4969,6420;9571;11875,3285,1,0,2,0,3
12084,20,4970,9463,3285,0,0,1,0,1
12085,20,4971,5675;8262,3285,0,0,2,0,2
12086,20,4972,7025,3285,0,0,1,0,1
12087,20,4973,2654;9639;11425;11585,3285,0,2,2,0,4
12088,20,4975,2972;9739;11478;12012,3285,1,1,2,0,4
12089,20,4976,9898,3285,0,0,1,0,1
12090,20,4977,153;7525;11335;11559,3650,0,2,2,0,4
12091,20,4978,348;7068,3650,0,0,2,0,2
12092,20,4979,360;3298;11237;11900,3650,1,1,2,0,4
12093,20,4980,336;4294,3650,0,0,2,0,2
12094,20,4981,721;1364;11271;12340,3650,1,1,2,0,4
12095,20,4982,771;2656;11656;11999,3650,1,1,2,0,4
12096,20,4983,1032;9455;11493,3650,0,1,2,0,3
12097,20,4984,3407;6878,3650,0,0,2,0,2
12098,20,4986,1256,3650,0,0,0,1,1
12099,20,4987,1304;8110,3650,0,0,2,0,2
12100,20,4989,1351;8099;11856;12029,3650,2,0,2,0,4
12101,20,4990,1416;2799;12379,3650,1,0,2,0,3
12102,20,4992,1572;1774;12225;12323,3650,2,0,2,0,4
12103,20,4993,7046,3650,0,0,1,0,1
12104,20,4994,1933;7554;11129;11377,3650,0,2,2,0,4
12105,20,4995,2018,3650,0,0,0,1,1
12106,20,4996,5600;11298;11506,3650,0,2,1,0,3
12107,20,4997,2362,3650,0,0,1,0,1
12108,20,4998,2384;9891,3650,0,0,2,0,2
12109,20,4999,1217;2404;12091;12258,3650,2,0,2,0,4
12110,20,5000,8361,3650,0,0,0,1,1
12111,20,5001,2593;6933;11556;11696;12260,3650,1,2,2,0,5
12112,20,5002,3520;8336;11448;11892,3650,1,1,2,0,4
12113,20,5003,4859;7275;12142;12349,3650,2,0,2,0,4
12114,20,5004,1599,3650,0,0,1,0,1
12115,20,5005,3846,3650,0,0,0,1,1
12116,20,5006,3930;8826;12068,3650,1,0,2,0,3
12117,20,5007,3240;7825,3650,0,0,2,0,2
12118,20,5008,333;11769;11931,3650,2,0,1,0,3
12119,20,5010,4061,3650,0,0,1,0,1
12120,20,5011,4308;5662,3650,0,0,2,0,2
12121,20,5012,393;1666;11876,3650,1,0,2,0,3
12122,20,5014,4581;7873;11355;11590;11776,3650,1,2,2,0,5
12123,20,5015,2669;4755;11170;11246;12373,3650,1,2,2,0,5
12124,20,5016,4823;8842,3650,0,0,2,0,2
12125,20,5017,4953;8796;11233;11417,3650,0,2,2,0,4
12126,20,5018,5157,3650,0,0,0,1,1
12127,20,5019,955,3650,0,0,1,0,1
12128,20,5020,111;5195,3650,0,0,2,0,2
12129,20,5021,5572;8297;11171;11557,3650,0,2,2,0,4
12130,20,5023,6278;8589;11848;12233,3650,2,0,2,0,4
12131,20,5024,617;6750;12341,3650,1,0,2,0,3
12132,20,5025,147;9021,3650,0,0,2,0,2
12133,20,5027,5996,3650,0,0,1,0,1
12134,20,5028,3492;5950;11982,3650,1,0,2,0,3
12135,20,5029,6068;6846,3650,0,0,2,0,2
12136,20,5030,444;11394,3650,0,1,1,0,2
12137,20,5031,2629;6661;11497;12076;12227,3650,2,1,2,0,5
12138,20,5033,4095;7450,3650,0,0,0,2,2
12139,20,5036,7744;9139;11513,3650,0,1,2,0,3
12140,20,5038,6592;8005,3650,0,0,2,0,2
12141,20,5039,2475;8106;11737;11927,3650,1,1,2,0,4
12142,20,5040,8719,3650,0,0,1,0,1
12143,20,5041,2033;8307,3650,0,0,2,0,2
12144,20,5042,8291;8473;11261;11524;11850;11991,3650,2,2,2,0,6
12145,20,5044,8921,3650,0,0,1,0,1
12146,20,5045,6982;8977;11310,3650,0,1,2,0,3
12147,20,5046,4045;11783,3650,1,0,1,0,2
12148,20,5047,5964;9045,3650,0,0,2,0,2
12149,20,5049,3;810;11419;11942,3650,1,1,2,0,4
12150,20,5051,9517,3650,0,0,1,0,1
12151,20,5052,4723;9637;12061,3650,1,0,2,0,3
12152,20,5053,4187;9642;11395,3650,0,1,2,0,3
12153,20,5054,7969;9782,3650,0,0,2,0,2
12154,20,5056,36;4860;11435;11675;12221,4015,1,2,2,0,5
12155,20,5057,48,4015,0,0,1,0,1
12156,20,5058,49;5525;11944,4015,1,0,2,0,3
12157,20,5059,102,4015,0,0,1,0,1
12158,20,5060,189;8324;11603;12230,4015,1,1,2,0,4
12159,20,5061,239;8389,4015,0,0,2,0,2
12160,20,5062,260,4015,0,0,0,1,1
12161,20,5063,298,4015,0,0,1,0,1
12162,20,5065,659,4015,0,0,0,1,1
12163,20,5066,679,4015,0,0,1,0,1
12164,20,5067,43;684,4015,0,0,2,0,2
12165,20,5068,182;829;11399;11719,4015,0,2,2,0,4
12166,20,5069,1064;1376,4015,0,0,2,0,2
12167,20,5070,2008;11257;11723;12290,4015,1,2,1,0,4
12168,20,5071,1593,4015,0,0,1,0,1
12169,20,5072,1608;7939,4015,0,0,2,0,2
12170,20,5073,1738,4015,0,0,0,1,1
12171,20,5074,1963;6531;11338;12001,4015,1,1,2,0,4
12172,20,5075,2010;9285,4015,0,0,2,0,2
12173,20,5076,2273;6971;11333;11600,4015,0,2,2,0,4
12174,20,5077,2291;9226,4015,0,0,2,0,2
12175,20,5078,983,4015,0,0,1,0,1
12176,20,5079,2498;6879;11392,4015,0,1,2,0,3
12177,20,5080,8395,4015,0,0,1,0,1
12178,20,5081,2625;5025,4015,0,0,2,0,2
12179,20,5085,2244;3012,4015,0,0,2,0,2
12180,20,5086,3027;11910,4015,1,0,1,0,2
12181,20,5087,1746;2979;11542;12123;12347,4015,2,1,2,0,5
12182,20,5088,1979;3173;3776;11347;11757,4015,1,1,3,0,5
12183,20,5090,3335,4015,0,0,1,0,1
12184,20,5091,1987;3400;12098,4015,1,0,2,0,3
12185,20,5092,8290;11841;12050,4015,2,0,1,0,3
12186,20,5093,3527,4015,0,0,1,0,1
12187,20,5094,1251;3636,4015,0,0,2,0,2
12188,20,5095,3673;4279;11413;12138,4015,1,1,2,0,4
12189,20,5096,6119,4015,0,0,1,0,1
12190,20,5097,4123,4015,0,0,0,1,1
12191,20,5098,3076;4186;12067,4015,1,0,2,0,3
12192,20,5099,4283;9401;11917,4015,1,0,2,0,3
12193,20,5101,4486;6157,4015,0,0,2,0,2
12194,20,5102,4510;8931;11589,4015,0,1,2,0,3
12195,20,5103,4607,4015,0,0,1,0,1
12196,20,5104,4767,4015,0,0,0,1,1
12197,20,5105,4874;8014;11727,4015,0,1,2,0,3
12198,20,5106,985;3309;12114,4015,1,0,2,0,3
12199,20,5107,5616,4015,0,0,1,0,1
12200,20,5108,5244;8498;11641;12231,4015,1,1,2,0,4
12201,20,5111,5554;7238;11743,4015,0,1,2,0,3
12202,20,5112,5590;9485;12266,4015,1,0,2,0,3
12203,20,5113,586,4015,0,0,1,0,1
12204,20,5116,6240;8469,4015,0,0,2,0,2
12205,20,5117,1751;5395;11315;12080,4015,1,1,2,0,4
12206,20,5118,2265;8815;11662;11952;12194,4015,2,1,2,0,5
12207,20,5120,5723;6536;11644,4015,0,1,2,0,3
12208,20,5121,5722;6595;11908,4015,1,0,2,0,3
12209,20,5122,630,4015,0,0,1,0,1
12210,20,5123,5537,4015,0,0,0,1,1
12211,20,5124,2175;6981,4015,0,0,2,0,2
12212,20,5125,1339;3960,4015,0,0,2,0,2
12213,20,5126,3215;7073,4015,0,0,2,0,2
12214,20,5127,7739;11550;11983,4015,1,1,1,0,3
12215,20,5129,3674;7494;11855,4015,1,0,2,0,3
12216,20,5130,3986;9231;11943,4015,1,0,2,0,3
12217,20,5131,7618,4015,0,0,0,1,1
12218,20,5134,8376;9844;11774,4015,1,0,2,0,3
12219,20,5137,8253;8756;11790;12174;12308,4015,3,0,2,0,5
12220,20,5140,4149;4655;11760;12218;12384,4015,3,0,2,0,5
12221,20,5141,9030,4015,0,0,0,1,1
12222,20,5142,5063;9117;11379;11818;11961,4015,2,1,2,0,5
12223,20,5144,479;9220;12335,4015,1,0,2,0,3
12224,20,5146,9118;9665;11635,4015,0,1,2,0,3
12225,20,5147,3696;9687;12286,4015,1,0,2,0,3
12226,20,5149,6751;9756;11429;11963,4015,1,1,2,0,4
12227,20,5150,9869,4015,0,0,0,1,1
12228,20,5153,74;3363;11684;11868;12017,4380,2,1,2,0,5
12229,20,5154,132,4380,0,0,1,0,1
12230,20,5155,183,4380,0,0,1,0,1
12231,20,5156,224,4380,0,0,1,0,1
12232,20,5157,347;11705,4380,0,1,1,0,2
12233,20,5158,616;4307,4380,0,0,2,0,2
12234,20,5159,5671,4380,0,0,1,0,1
12235,20,5160,766,4380,0,0,1,0,1
12236,20,5161,3758;5002;11509;11911,4380,1,1,2,0,4
12237,20,5163,1084;2783;11822;12102,4380,2,0,2,0,4
12238,20,5165,891;1270,4380,0,0,2,0,2
12239,20,5166,221,4380,0,0,0,1,1
12240,20,5167,1522;8198;11660;12215,4380,1,1,2,0,4
12241,20,5168,1592;2322;11604;12310,4380,1,1,2,0,4
12242,20,5170,1639,4380,0,0,0,1,1
12243,20,5172,1424,4380,0,0,1,0,1
12244,20,5173,1313;2027,4380,0,0,2,0,2
12245,20,5174,2083;9345,4380,0,0,2,0,2
12246,20,5175,584;2091;12291,4380,1,0,2,0,3
12247,20,5177,2231;7211;11736,4380,0,1,2,0,3
12248,20,5178,2251,4380,0,0,1,0,1
12249,20,5179,5970;6308,4380,0,0,2,0,2
12250,20,5183,2544;7024;11673;11919,4380,1,1,2,0,4
12251,20,5184,2798;11846,4380,1,0,1,0,2
12252,20,5186,4597,4380,0,0,0,1,1
12253,20,5187,561;2787;12090;12197,4380,2,0,2,0,4
12254,20,5188,2807,4380,0,0,1,0,1
12255,20,5189,1010;2891,4380,0,0,2,0,2
12256,20,5190,2959,4380,0,0,1,0,1
12257,20,5191,2995;5072;11645;12129;12369,4380,2,1,2,0,5
12258,20,5193,5335,4380,0,0,1,0,1
12259,20,5194,1001;3121;11474,4380,0,1,2,0,3
12260,20,5195,3204,4380,0,0,0,1,1
12261,20,5196,3351;11365;11456,4380,0,2,1,0,3
12262,20,5197,3202;3468;12380,4380,1,0,2,0,3
12263,20,5198,2742;3493;11597;11785,4380,1,1,2,0,4
12264,20,5199,1698;3730,4380,0,0,2,0,2
12265,20,5200,9410,4380,0,0,1,0,1
12266,20,5201,3727,4380,0,0,1,0,1
12267,20,5202,3856;4781,4380,0,0,0,2,2
12268,20,5203,3872;6158;11695;11768;12228,4380,2,1,2,0,5
12269,20,5204,4021;7914,4380,0,0,2,0,2
12270,20,5206,9236,4380,0,0,0,1,1
12271,20,5207,1427;9694,4380,0,0,2,0,2
12272,20,5208,4285;8497;12049,4380,1,0,2,0,3
12273,20,5210,4938,4380,0,0,1,0,1
12274,20,5211,4505;8853;11442;12351,4380,1,1,2,0,4
12275,20,5213,1705;4855;11607,4380,0,1,2,0,3
12276,20,5214,4964,4380,0,0,0,1,1
12277,20,5215,4816;8874,4380,0,0,2,0,2
12278,20,5216,5132,4380,0,0,1,0,1
12279,20,5217,5164,4380,0,0,0,1,1
12280,20,5218,5212;11401;11533;11860,4380,1,2,1,0,4
12281,20,5219,212,4380,0,0,1,0,1
12282,20,5220,5967;8899;12206,4380,1,0,2,0,3
12283,20,5222,7681;8779,4380,0,0,2,0,2
12284,20,5224,5644,4380,0,0,1,0,1
12285,20,5225,4267,4380,0,0,1,0,1
12286,20,5226,6861;7683,4380,0,0,2,0,2
12287,20,5227,6868,4380,0,0,0,1,1
12288,20,5230,6973;7867;11674,4380,0,1,2,0,3
12289,20,5231,7017,4380,0,0,0,1,1
12290,20,5232,2880;7029;11745;12100,4380,1,1,2,0,4
12291,20,5233,3931;4263,4380,0,0,2,0,2
12292,20,5234,413;7141,4380,0,0,2,0,2
12293,20,5236,7306;8283,4380,0,0,2,0,2
12294,20,5238,3116;7357;11830;12004;12246,4380,3,0,2,0,5
12295,20,5239,7385,4380,0,0,1,0,1
12296,20,5240,2108;7503;11678;11998;12077,4380,2,1,2,0,5
12297,20,5242,7077;7679;11437;11839;12071,4380,2,1,2,0,5
12298,20,5245,3402;7913;12101,4380,1,0,2,0,3
12299,20,5246,2555;7995;11773;12113,4380,2,0,2,0,4
12300,20,5248,8079,4380,0,0,1,0,1
12301,20,5251,7173,4380,0,0,0,1,1
12302,20,5252,4449;8741;11936;12232,4380,2,0,2,0,4
12303,20,5253,4862;8780;11469;12031;12135,4380,2,1,2,0,5
12304,20,5254,3710;8806;11410,4380,0,1,2,0,3
12305,20,5256,9022,4380,0,0,1,0,1
12306,20,5257,9040;12193,4380,1,0,1,0,2
12307,20,5259,9498,4380,0,0,0,1,1
12308,20,5260,3951;9552,4380,0,0,2,0,2
12309,20,5261,6053;9589,4380,0,0,2,0,2
12310,20,5263,6948;9787,4380,0,0,2,0,2
12311,20,5264,6,4745,0,0,1,0,1
12312,20,5265,4016;5451;11863;12153,4745,2,0,2,0,4
12313,20,5266,25;9925,4745,0,0,2,0,2
12314,20,5267,107;11602;11843,4745,1,1,1,0,3
12315,20,5268,240;7776,4745,0,0,2,0,2
12316,20,5269,406,4745,0,0,1,0,1
12317,20,5272,699,4745,0,0,1,0,1
12318,20,5274,786;6275;11766;12046,4745,2,0,2,0,4
12319,20,5277,1076,4745,0,0,0,1,1
12320,20,5279,1314;3028;11971,4745,1,0,2,0,3
12321,20,5281,1559,4745,0,0,0,1,1
12322,20,5282,1609;4481;12185;12326,4745,2,0,2,0,4
12323,20,5283,1759,4745,0,0,0,1,1
12324,20,5284,2117;7236,4745,0,0,2,0,2
12325,20,5285,3455;7019;12388,4745,1,0,2,0,3
12326,20,5286,2360;7142;11577;11992,4745,1,1,2,0,4
12327,20,5287,2462;3944,4745,0,0,2,0,2
12328,20,5288,2494;9976;11517;11584;12103,4745,1,2,2,0,5
12329,20,5290,2791,4745,0,0,1,0,1
12330,20,5291,1766;2842;11788;11920,4745,2,0,2,0,4
12331,20,5292,3117;8894,4745,0,0,2,0,2
12332,20,5293,3025,4745,0,0,1,0,1
12333,20,5295,3234;9033,4745,0,0,2,0,2
12334,20,5296,3320,4745,0,0,1,0,1
12335,20,5299,3395;3467,4745,0,0,2,0,2
12336,20,5300,1652;3401;12047,4745,1,0,2,0,3
12337,20,5302,1787;3749;12203;12306,4745,2,0,2,0,4
12338,20,5303,3793,4745,0,0,1,0,1
12339,20,5305,3873,4745,0,0,1,0,1
12340,20,5306,3945;8759,4745,0,0,2,0,2
12341,20,5308,1344;4252;11780,4745,1,0,2,0,3
12342,20,5309,4369;9015;12042,4745,1,0,2,0,3
12343,20,5310,8743,4745,0,0,0,1,1
12344,20,5311,4558,4745,0,0,0,1,1
12345,20,5312,4790,4745,0,0,1,0,1
12346,20,5315,5044;8566;11960,4745,1,0,2,0,3
12347,20,5316,7747;9423;11714;11852,4745,1,1,2,0,4
12348,20,5317,5516,4745,0,0,1,0,1
12349,20,5318,3458;5565;11508;11697,4745,0,2,2,0,4
12350,20,5319,3380;5805;12352,4745,1,0,2,0,3
12351,20,5320,4630;5962;11636;11861,4745,1,1,2,0,4
12352,20,5321,5982,4745,0,0,1,0,1
12353,20,5323,3069;12167,4745,1,0,1,0,2
12354,20,5324,6201;9400;11981,4745,1,0,2,0,3
12355,20,5326,7212;9454,4745,0,0,2,0,2
12356,20,5327,2434;11616;11685;12297,4745,1,2,1,0,4
12357,20,5328,6555;11627;12348,4745,1,1,1,0,3
12358,20,5330,6670,4745,0,0,0,1,1
12359,20,5331,3404;6738,4745,0,0,2,0,2
12360,20,5332,6517;7062,4745,0,0,0,2,2
12361,20,5333,7081,4745,0,0,0,1,1
12362,20,5335,7149,4745,0,0,1,0,1
12363,20,5336,1161;3717;12240,4745,1,0,2,0,3
12364,20,5337,7276;8892,4745,0,0,2,0,2
12365,20,5338,3238;7300;12249;12267,4745,2,0,2,0,4
12366,20,5339,7496;7704,4745,0,0,2,0,2
12367,20,5340,7500,4745,0,0,1,0,1
12368,20,5341,1789;7553;12021,4745,1,0,2,0,3
12369,20,5342,54;8083;12104,4745,1,0,2,0,3
12370,20,5343,3956;8505,4745,0,0,2,0,2
12371,20,5344,6918;8514;11688;12168,4745,1,1,2,0,4
12372,20,5345,5396;8520,4745,0,0,2,0,2
12373,20,5346,8527;9693,4745,0,0,2,0,2
12374,20,5347,5137;9082,4745,0,0,2,0,2
12375,20,5348,1750;3919;11621;11802,4745,1,1,2,0,4
12376,20,5349,8629;9003;11721,4745,0,1,2,0,3
12377,20,5350,2699;8643,4745,0,0,2,0,2
12378,20,5351,1500;8912,4745,0,0,2,0,2
12379,20,5352,953;11653;11800,4745,1,1,1,0,3
12380,20,5353,9417;9798;12377,4745,1,0,2,0,3
12381,20,5354,9488,4745,0,0,1,0,1
12382,20,5355,890;2449;11659;11881;12109,4745,2,1,2,0,5
12383,20,5356,8401;9682,4745,0,0,2,0,2
12384,20,5357,3457;9684;12151,4745,1,0,2,0,3
12385,20,5358,294;9418;11914,4745,1,0,2,0,3
12386,20,5359,6631;9726,4745,0,0,2,0,2
12387,20,5360,8797;9837,4745,0,0,2,0,2
12388,20,5362,144,5110,0,0,0,1,1
12389,20,5363,175;7696;11650;12127,5110,1,1,2,0,4
12390,20,5364,216;6719;12383,5110,1,0,2,0,3
12391,20,5365,6910;8711,5110,0,0,2,0,2
12392,20,5367,639;4828;11877;12292,5110,2,0,2,0,4
12393,20,5368,648;5969,5110,0,0,2,0,2
12394,20,5369,853;7460;12269,5110,1,0,2,0,3
12395,20,5370,883,5110,0,0,1,0,1
12396,20,5372,1477;1714,5110,0,0,2,0,2
12397,20,5373,1535,5110,0,0,1,0,1
12398,20,5374,1642,5110,0,0,1,0,1
12399,20,5377,2365;6905;11612,5110,0,1,2,0,3
12400,20,5378,2517;9112,5110,0,0,2,0,2
12401,20,5379,2623,5110,0,0,1,0,1
12402,20,5380,2300;2789;11958;12330,5110,2,0,2,0,4
12403,20,5381,2928,5110,0,0,0,1,1
12404,20,5382,8716,5110,0,0,1,0,1
12405,20,5384,1328;3428,5110,0,0,2,0,2
12406,20,5385,3611;8133;12112,5110,1,0,2,0,3
12407,20,5386,3691;9709,5110,0,0,2,0,2
12408,20,5387,3725,5110,0,0,1,0,1
12409,20,5388,1986;3477,5110,0,0,2,0,2
12410,20,5389,3978,5110,0,0,1,0,1
12411,20,5390,8312,5110,0,0,1,0,1
12412,20,5391,4035,5110,0,0,1,0,1
12413,20,5393,4070;7990,5110,0,0,2,0,2
12414,20,5394,4264,5110,0,0,0,1,1
12415,20,5395,8303,5110,0,0,0,1,1
12416,20,5396,3389;4691,5110,0,0,2,0,2
12417,20,5397,2364;4963,5110,0,0,2,0,2
12418,20,5398,5031;5688,5110,0,0,2,0,2
12419,20,5400,1996;5588,5110,0,0,1,1,2
12420,20,5401,5674;12280,5110,1,0,1,0,2
12421,20,5403,9531,5110,0,0,0,1,1
12422,20,5404,4043;6101;11941;12200,5110,2,0,2,0,4
12423,20,5406,6154;8268;11968,5110,1,0,2,0,3
12424,20,5408,480;6353;11792,5110,1,0,2,0,3
12425,20,5409,802;6406,5110,0,0,2,0,2
12426,20,5410,1973;6693;12025,5110,1,0,2,0,3
12427,20,5411,2750,5110,0,0,1,0,1
12428,20,5412,6791;6950;11628;12375,5110,1,1,2,0,4
12429,20,5413,6875;8845;12093,5110,1,0,2,0,3
12430,20,5414,7030,5110,0,0,1,0,1
12431,20,5415,2870;7039;11812;12037,5110,2,0,2,0,4
12432,20,5416,2014;7121;12320,5110,1,0,2,0,3
12433,20,5417,7367,5110,0,0,1,0,1
12434,20,5418,7409,5110,0,0,1,0,1
12435,20,5419,7418;8270;11865;12055,5110,2,0,2,0,4
12436,20,5420,967;9251,5110,0,0,2,0,2
12437,20,5421,7332;7697;12150,5110,1,0,2,0,3
12438,20,5422,7872;8746;12086;12366,5110,2,0,2,0,4
12439,20,5423,8168,5110,0,0,1,0,1
12440,20,5424,8252,5110,0,0,1,0,1
12441,20,5425,8370,5110,0,0,0,1,1
12442,20,5426,8827;12048;12264,5110,2,0,1,0,3
12443,20,5427,9027,5110,0,0,0,1,1
12444,20,5428,6526;9068;12322,5110,1,0,2,0,3
12445,20,5429,5806;9210;12244,5110,1,0,2,0,3
12446,20,5430,4737,5110,0,0,1,0,1
12447,20,5431,9586,5110,0,0,1,0,1
12448,20,5433,6404;6567,5110,0,0,2,0,2
12449,20,5434,5735;9853;11680,5110,0,1,2,0,3
12450,20,5435,352,5110,0,0,1,0,1
12451,20,5436,2963;12005,5475,1,0,1,0,2
12452,20,5437,87;631;11686,5475,0,1,2,0,3
12453,20,5438,6130,5475,0,0,0,1,1
12454,20,5440,378;5043;12199,5475,1,0,2,0,3
12455,20,5441,431;5792;12065,5475,1,0,2,0,3
12456,20,5442,2795,5475,0,0,1,0,1
12457,20,5443,674;9783,5475,0,0,2,0,2
12458,20,5444,896;7826;12145,5475,1,0,2,0,3
12459,20,5445,902;9940;11806;12219,5475,2,0,2,0,4
12460,20,5446,987,5475,0,0,1,0,1
12461,20,5447,1056;8288,5475,0,0,2,0,2
12462,20,5448,1093;5425;11665;11880,5475,1,1,2,0,4
12463,20,5449,1139;3045;11965;12247,5475,2,0,2,0,4
12464,20,5450,1145,5475,0,0,0,1,1
12465,20,5451,1584,5475,0,0,1,0,1
12466,20,5452,1252;6112,5475,0,0,2,0,2
12467,20,5453,1278,5475,0,0,0,1,1
12468,20,5456,1575;5232,5475,0,0,2,0,2
12469,20,5457,1699;2059,5475,0,0,2,0,2
12470,20,5458,1803;5850,5475,0,0,2,0,2
12471,20,5459,1838,5475,0,0,1,0,1
12472,20,5460,1962;6139;11823,5475,1,0,2,0,3
12473,20,5461,8863,5475,0,0,0,1,1
12474,20,5462,2146;2268,5475,0,0,2,0,2
12475,20,5463,574;2159;12256,5475,1,0,2,0,3
12476,20,5464,4714,5475,0,0,1,0,1
12477,20,5466,2499;6108,5475,0,0,2,0,2
12478,20,5467,520,5475,0,0,1,0,1
12479,20,5468,1451;2948,5475,0,0,2,0,2
12480,20,5469,8633,5475,0,0,1,0,1
12481,20,5471,3359,5475,0,0,1,0,1
12482,20,5472,3450;7119;11756;12045,5475,1,1,2,0,4
12483,20,5473,3504;5329,5475,0,0,2,0,2
12484,20,5474,3513,5475,0,0,0,1,1
12485,20,5475,3586;3639,5475,0,0,2,0,2
12486,20,5476,3794;5241,5475,0,0,2,0,2
12487,20,5478,3921;6117;11803;12027,5475,2,0,2,0,4
12488,20,5479,9248,5475,0,0,1,0,1
12489,20,5480,4154,5475,0,0,1,0,1
12490,20,5482,1147;4381;12056;12279,5475,2,0,2,0,4
12491,20,5483,5116,5475,0,0,1,0,1
12492,20,5484,7189,5475,0,0,1,0,1
12493,20,5485,5134,5475,0,0,1,0,1
12494,20,5486,8591,5475,0,0,1,0,1
12495,20,5487,5170;5196,5475,0,0,2,0,2
12496,20,5488,4140;5277,5475,0,0,2,0,2
12497,20,5489,5953,5475,0,0,1,0,1
12498,20,5490,865;5526,5475,0,0,2,0,2
12499,20,5491,5955,5475,0,0,1,0,1
12500,20,5492,5725,5475,0,0,1,0,1
12501,20,5493,5843;9123,5475,0,0,2,0,2
12502,20,5494,9765;9849,5475,0,0,2,0,2
12503,20,5495,6242,5475,0,0,1,0,1
12504,20,5496,6403,5475,0,0,1,0,1
12505,20,5497,8010;12243,5475,1,0,1,0,2
12506,20,5498,4124,5475,0,0,1,0,1
12507,20,5499,6641;9450,5475,0,0,2,0,2
12508,20,5500,1352;6743;11997;12155,5475,2,0,2,0,4
12509,20,5501,2964;6823,5475,0,0,2,0,2
12510,20,5502,4509;9776,5475,0,0,2,0,2
12511,20,5504,7086,5475,0,0,1,0,1
12512,20,5505,5985;7156;11784,5475,1,0,2,0,3
12513,20,5506,7168,5475,0,0,0,1,1
12514,20,5508,4074;7383;11835;11996;12316,5475,3,0,2,0,5
12515,20,5509,7413,5475,0,0,0,1,1
12516,20,5510,5174;7520;12156,5475,1,0,2,0,3
12517,20,5511,7659;7725,5475,0,0,1,1,2
12518,20,5512,7323;7894;12327,5475,1,0,2,0,3
12519,20,5514,8020,5475,0,0,1,0,1
12520,20,5515,2980,5475,0,0,1,0,1
12521,20,5516,8182,5475,0,0,0,1,1
12522,20,5517,1571;8273,5475,0,0,2,0,2
12523,20,5518,6299;8365,5475,0,0,2,0,2
12524,20,5519,8449,5475,0,0,1,0,1
12525,20,5520,724;8525,5475,0,0,2,0,2
12526,20,5521,3475;8556,5475,0,0,2,0,2
12527,20,5522,8572,5475,0,0,1,0,1
12528,20,5523,1027;1287;12162,5475,1,0,2,0,3
12529,20,5527,1169;8785,5475,0,0,2,0,2
12530,20,5530,5372,5475,0,0,1,0,1
12531,20,5532,6857;9007,5475,0,0,2,0,2
12532,20,5533,3573;9215;12283,5475,1,0,2,0,3
12533,20,5535,2976;7257,5475,0,0,2,0,2
12534,20,5536,7093,5475,0,0,1,0,1
12535,20,5539,9704,5475,0,0,1,0,1
12536,20,5540,1450;9720;11831;12338,5475,2,0,2,0,4
12537,20,5542,9985,5475,0,0,1,0,1
12538,20,5543,61;8703,5840,0,0,2,0,2
12539,20,5544,250;2815,5840,0,0,2,0,2
12540,20,5545,79;277;12066,5840,1,0,2,0,3
12541,20,5546,367;5553,5840,0,0,2,0,2
12542,20,5548,447;1467;12088;12214,5840,2,0,2,0,4
12543,20,5549,632,5840,0,0,1,0,1
12544,20,5550,2067,5840,0,0,1,0,1
12545,20,5551,477;1035,5840,0,0,2,0,2
12546,20,5552,1049;3713,5840,0,0,2,0,2
12547,20,5553,1266;6202,5840,0,0,2,0,2
12548,20,5554,1267;12364,5840,1,0,1,0,2
12549,20,5555,319;12172,5840,1,0,1,0,2
12550,20,5556,1493;4385,5840,0,0,2,0,2
12551,20,5557,1649,5840,0,0,1,0,1
12552,20,5558,1899,5840,0,0,1,0,1
12553,20,5559,2031;8038;12164;12315,5840,2,0,2,0,4
12554,20,5560,2032;5128;12284,5840,1,0,2,0,3
12555,20,5561,2389;6632,5840,0,0,2,0,2
12556,20,5563,2694;4856;11895;12106,5840,2,0,2,0,4
12557,20,5564,163;2701;11985,5840,1,0,2,0,3
12558,20,5565,4098,5840,0,0,1,0,1
12559,20,5567,4892;7712;11928;12018,5840,2,0,2,0,4
12560,20,5568,2910;7016,5840,0,0,2,0,2
12561,20,5569,2965;10100,5840,0,0,2,0,2
12562,20,5570,8470,5840,0,0,1,0,1
12563,20,5571,2975,5840,0,0,1,0,1
12564,20,5572,3145;12095;12209,5840,2,0,1,0,3
12565,20,5573,1388;3156,5840,0,0,2,0,2
12566,20,5574,3247;4337;12196,5840,1,0,2,0,3
12567,20,5576,3476,5840,0,0,1,0,1
12568,20,5578,1929;3561,5840,0,0,2,0,2
12569,20,5580,1157;3738;12057,5840,1,0,2,0,3
12570,20,5581,3841;9364,5840,0,0,2,0,2
12571,20,5582,3859;5521;11867;11874;12170,5840,3,0,2,0,5
12572,20,5583,3863;10073,5840,0,0,2,0,2
12573,20,5584,3963;4634,5840,0,0,2,0,2
12574,20,5585,3367;4023;12278,5840,1,0,2,0,3
12575,20,5586,7801;9169,5840,0,0,2,0,2
12576,20,5588,4869,5840,0,0,0,1,1
12577,20,5591,5666;7350;11879,5840,1,0,2,0,3
12578,20,5592,5245,5840,0,0,1,0,1
12579,20,5593,5355;6876,5840,0,0,2,0,2
12580,20,5594,5511,5840,0,0,0,1,1
12581,20,5595,9063,5840,0,0,1,0,1
12582,20,5596,5991,5840,0,0,1,0,1
12583,20,5599,8513,5840,0,0,1,0,1
12584,20,5600,6370;6809;11894,5840,1,0,2,0,3
12585,20,5601,6382;7054,5840,0,0,2,0,2
12586,20,5602,6444;9710,5840,0,0,2,0,2
12587,20,5603,6480;6839,5840,0,0,2,0,2
12588,20,5605,7324,5840,0,0,1,0,1
12589,20,5607,7396;9667,5840,0,0,2,0,2
12590,20,5608,5937;7443;11934,5840,1,0,2,0,3
12591,20,5609,5202,5840,0,0,1,0,1
12592,20,5610,2896;7789,5840,0,0,2,0,2
12593,20,5611,7193;7802;11955,5840,1,0,2,0,3
12594,20,5612,7818,5840,0,0,1,0,1
12595,20,5613,7896,5840,0,0,1,0,1
12596,20,5614,1544;7912,5840,0,0,2,0,2
12597,20,5615,4617;8047,5840,0,0,2,0,2
12598,20,5616,8080,5840,0,0,1,0,1
12599,20,5617,4057;8302;11890,5840,1,0,2,0,3
12600,20,5618,3132;8407;11891;12346,5840,2,0,2,0,4
12601,20,5619,2468;9882,5840,0,0,2,0,2
12602,20,5620,8747;9676,5840,0,0,2,0,2
12603,20,5622,9187,5840,0,0,1,0,1
12604,20,5624,7128;9230,5840,0,0,2,0,2
12605,20,5626,5809;9339;11980,5840,1,0,2,0,3
12606,20,5627,1667;9506,5840,0,0,2,0,2
12607,20,5628,9102;9608;12224;12372,5840,2,0,2,0,4
12608,20,5629,2330;9654,5840,0,0,2,0,2
12609,20,5630,1096;9838;11969,5840,1,0,2,0,3
12610,20,5631,44;9332;12317,6205,1,0,2,0,3
12611,20,5632,136;2063;11906,6205,1,0,2,0,3
12612,20,5633,219;8494;11913;12011;12342,6205,3,0,2,0,5
12613,20,5634,1478,6205,0,0,1,0,1
12614,20,5635,546;665,6205,0,0,2,0,2
12615,20,5636,801,6205,0,0,1,0,1
12616,20,5638,945;1263,6205,0,0,2,0,2
12617,20,5639,1284;6363,6205,0,0,2,0,2
12618,20,5640,1305;10038,6205,0,0,2,0,2
12619,20,5641,1432;10204;12070,6205,1,0,2,0,3
12620,20,5642,1428;1670;11953;12313,6205,2,0,2,0,4
12621,20,5643,1700;3337;12020;12295,6205,2,0,2,0,4
12622,20,5644,3087,6205,0,0,1,0,1
12623,20,5645,1837;10164,6205,0,0,2,0,2
12624,20,5646,1944,6205,0,0,1,0,1
12625,20,5647,1134,6205,0,0,1,0,1
12626,20,5648,2068;2539,6205,0,0,2,0,2
12627,20,5649,2092;8616;11925,6205,1,0,2,0,3
12628,20,5650,2250;10044;12036,6205,1,0,2,0,3
12629,20,5651,2339;10055;12179;12355,6205,2,0,2,0,4
12630,20,5652,1321;2356;12054,6205,1,0,2,0,3
12631,20,5653,2481,6205,0,0,1,0,1
12632,20,5654,2545;7020,6205,0,0,2,0,2
12633,20,5655,2700;6001,6205,0,0,2,0,2
12634,20,5656,2741;12000,6205,1,0,1,0,2
12635,20,5657,2784;3601,6205,0,0,2,0,2
12636,20,5659,2871;3874,6205,0,0,2,0,2
12637,20,5660,271;5261,6205,0,0,2,0,2
12638,20,5661,3010;7191,6205,0,0,2,0,2
12639,20,5662,3071;10060,6205,0,0,2,0,2
12640,20,5663,3107,6205,0,0,1,0,1
12641,20,5664,6017,6205,0,0,1,0,1
12642,20,5665,3241;10201,6205,0,0,2,0,2
12643,20,5666,590;3281;12212,6205,1,0,2,0,3
12644,20,5667,3737,6205,0,0,1,0,1
12645,20,5669,3772,6205,0,0,1,0,1
12646,20,5670,3969,6205,0,0,1,0,1
12647,20,5671,4075;7316,6205,0,0,2,0,2
12648,20,5672,4204,6205,0,0,1,0,1
12649,20,5673,440;4257;11957;12302,6205,2,0,2,0,4
12650,20,5674,4471;10180;11973,6205,1,0,2,0,3
12651,20,5675,4484,6205,0,0,0,1,1
12652,20,5676,2234;4515;12180,6205,1,0,2,0,3
12653,20,5677,4525,6205,0,0,1,0,1
12654,20,5679,975,6205,0,0,1,0,1
12655,20,5680,4833;6561;12300,6205,1,0,2,0,3
12656,20,5681,2876,6205,0,0,1,0,1
12657,20,5682,4997,6205,0,0,1,0,1
12658,20,5683,4106;5135,6205,0,0,2,0,2
12659,20,5684,5144,6205,0,0,1,0,1
12660,20,5685,2524;5297,6205,0,0,2,0,2
12661,20,5686,5480;7304,6205,0,0,2,0,2
12662,20,5687,2147,6205,0,0,1,0,1
12663,20,5688,5186;5642,6205,0,0,2,0,2
12664,20,5689,5706,6205,0,0,1,0,1
12665,20,5690,5775,6205,0,0,1,0,1
12666,20,5691,820,6205,0,0,1,0,1
12667,20,5692,5992;8052,6205,0,0,2,0,2
12668,20,5693,6183;6624;12192,6205,1,0,2,0,3
12669,20,5694,6296;6885,6205,0,0,2,0,2
12670,20,5695,7237,6205,0,0,1,0,1
12671,20,5696,6434,6205,0,0,1,0,1
12672,20,5697,6449,6205,0,0,0,1,1
12673,20,5698,6483,6205,0,0,0,1,1
12674,20,5699,6525,6205,0,0,1,0,1
12675,20,5700,6529,6205,0,0,1,0,1
12676,20,5701,741;6019,6205,0,0,2,0,2
12677,20,5702,4680;6692,6205,0,0,2,0,2
12678,20,5703,5330;6967,6205,0,0,2,0,2
12679,20,5705,7706,6205,0,0,1,0,1
12680,20,5706,7346;10054;11987;12238,6205,2,0,2,0,4
12681,20,5707,7466;12354,6205,1,0,1,0,2
12682,20,5708,6003;7510,6205,0,0,2,0,2
12683,20,5709,7634;9827,6205,0,0,2,0,2
12684,20,5710,7723,6205,0,0,1,0,1
12685,20,5711,8092,6205,0,0,1,0,1
12686,20,5712,1288,6205,0,0,1,0,1
12687,20,5713,466,6205,0,0,1,0,1
12688,20,5714,3811,6205,0,0,1,0,1
12689,20,5715,8465,6205,0,0,1,0,1
12690,20,5716,1115;8642,6205,0,0,2,0,2
12691,20,5717,4959;8885,6205,0,0,2,0,2
12692,20,5719,9150;9626,6205,0,0,2,0,2
12693,20,5720,6601;9266;12325,6205,1,0,2,0,3
12694,20,5722,9389;9729,6205,0,0,2,0,2
12695,20,5723,9394,6205,0,0,1,0,1
12696,20,5724,1847;9606;12015,6205,1,0,2,0,3
12697,20,5725,7794;9722,6205,0,0,2,0,2
12698,20,5726,9741,6205,0,0,1,0,1
12699,20,5727,160;9751;12378,6205,1,0,2,0,3
12700,20,5728,56,6570,0,0,1,0,1
12701,20,5729,135;5892,6570,0,0,2,0,2
12702,20,5730,7900,6570,0,0,1,0,1
12703,20,5731,5365,6570,0,0,1,0,1
12704,20,5732,494;10118,6570,0,0,2,0,2
12705,20,5733,604;10174,6570,0,0,2,0,2
12706,20,5734,612;5260,6570,0,0,2,0,2
12707,20,5735,653;3136,6570,0,0,2,0,2
12708,20,5737,851,6570,0,0,1,0,1
12709,20,5739,1152;10042;12064,6570,1,0,2,0,3
12710,20,5740,1242;3346,6570,0,0,2,0,2
12711,20,5741,1264,6570,0,0,1,0,1
12712,20,5742,1301;8332;12356,6570,1,0,2,0,3
12713,20,5743,1308;10006;12187,6570,1,0,2,0,3
12714,20,5744,1359;10146;12118;12195,6570,2,0,2,0,4
12715,20,5745,1460,6570,0,0,1,0,1
12716,20,5746,1538;7344;12126,6570,1,0,2,0,3
12717,20,5747,1564;7373,6570,0,0,2,0,2
12718,20,5748,1250,6570,0,0,1,0,1
12719,20,5749,1615,6570,0,0,1,0,1
12720,20,5750,1637,6570,0,0,1,0,1
12721,20,5751,1663;10080;12136,6570,1,0,2,0,3
12722,20,5752,1721;10251;12175,6570,1,0,2,0,3
12723,20,5753,1726;6389;12158,6570,1,0,2,0,3
12724,20,5754,1890,6570,0,0,1,0,1
12725,20,5755,2290,6570,0,0,1,0,1
12726,20,5757,1940,6570,0,0,1,0,1
12727,20,5760,2442;10088,6570,0,0,2,0,2
12728,20,5761,2671,6570,0,0,1,0,1
12729,20,5762,2919,6570,0,0,1,0,1
12730,20,5763,3003;3834;12121,6570,1,0,2,0,3
12731,20,5764,3038,6570,0,0,1,0,1
12732,20,5765,3246,6570,0,0,1,0,1
12733,20,5767,3377;6289,6570,0,0,2,0,2
12734,20,5768,2523;3578;12144;12367,6570,2,0,2,0,4
12735,20,5769,5506,6570,0,0,1,0,1
12736,20,5770,870,6570,0,0,1,0,1
12737,20,5771,1775;7464,6570,0,0,2,0,2
12738,20,5772,4455,6570,0,0,1,0,1
12739,20,5773,4633;5901,6570,0,0,2,0,2
12740,20,5774,4694;6660,6570,0,0,2,0,2
12741,20,5775,2180,6570,0,0,1,0,1
12742,20,5776,4883;10167,6570,0,0,2,0,2
12743,20,5777,5441,6570,0,0,1,0,1
12744,20,5778,5442;6603;12235,6570,1,0,2,0,3
12745,20,5781,4368;8375,6570,0,0,2,0,2
12746,20,5782,5920,6570,0,0,1,0,1
12747,20,5783,5966,6570,0,0,1,0,1
12748,20,5784,6176,6570,0,0,1,0,1
12749,20,5785,6197;9773,6570,0,0,2,0,2
12750,20,5786,6208;7665,6570,0,0,2,0,2
12751,20,5787,6212;9099;12099,6570,1,0,2,0,3
12752,20,5788,6295,6570,0,0,1,0,1
12753,20,5789,6343,6570,0,0,1,0,1
12754,20,5790,9369,6570,0,0,1,0,1
12755,20,5791,4093;6729,6570,0,0,2,0,2
12756,20,5792,6781,6570,0,0,1,0,1
12757,20,5793,1236;6904,6570,0,0,2,0,2
12758,20,5794,7011,6570,0,0,1,0,1
12759,20,5795,7110;7410,6570,0,0,2,0,2
12760,20,5796,7530;10112,6570,0,0,2,0,2
12761,20,5797,7746,6570,0,0,1,0,1
12762,20,5798,2354;7762,6570,0,0,2,0,2
12763,20,5799,7765;10229,6570,0,0,2,0,2
12764,20,5800,7856;10084,6570,0,0,2,0,2
12765,20,5801,326,6570,0,0,1,0,1
12766,20,5802,8051;9514,6570,0,0,2,0,2
12767,20,5803,8164,6570,0,0,1,0,1
12768,20,5805,5421;8237,6570,0,0,2,0,2
12769,20,5806,2256;8396;12204,6570,1,0,2,0,3
12770,20,5807,8721;10063,6570,0,0,2,0,2
12771,20,5808,8922,6570,0,0,1,0,1
12772,20,5809,9060,6570,0,0,1,0,1
12773,20,5810,9292,6570,0,0,1,0,1
12774,20,5811,9321,6570,0,0,1,0,1
12775,20,5812,8220;9336;12211,6570,1,0,2,0,3
12776,20,5813,9247;9425;12275,6570,1,0,2,0,3
12777,20,5814,5978,6570,0,0,1,0,1
12778,20,5815,4704;9655,6570,0,0,2,0,2
12779,20,5816,6254,6570,0,0,1,0,1
12780,20,5817,959;9874,6570,0,0,2,0,2
12781,20,5818,9912,6570,0,0,1,0,1
12782,20,5819,81;476,6935,0,0,2,0,2
12783,20,5820,94;10069,6935,0,0,2,0,2
12784,20,5821,119;7402;12139,6935,1,0,2,0,3
12785,20,5822,248,6935,0,0,0,1,1
12786,20,5823,272;2817,6935,0,0,2,0,2
12787,20,5824,349,6935,0,0,1,0,1
12788,20,5825,537;3748,6935,0,0,2,0,2
12789,20,5826,552,6935,0,0,1,0,1
12790,20,5827,9420,6935,0,0,1,0,1
12791,20,5828,387,6935,0,0,1,0,1
12792,20,5829,879,6935,0,0,1,0,1
12793,20,5831,1371,6935,0,0,1,0,1
12794,20,5832,1723,6935,0,0,1,0,1
12795,20,5833,1808;10138,6935,0,0,2,0,2
12796,20,5834,1943;4809;12213,6935,1,0,2,0,3
12797,20,5835,2121;8109,6935,0,0,2,0,2
12798,20,5836,2233,6935,0,0,1,0,1
12799,20,5837,2245,6935,0,0,1,0,1
12800,20,5838,1654,6935,0,0,1,0,1
12801,20,5839,2729;10145;12268,6935,1,0,2,0,3
12802,20,5840,2775;10030,6935,0,0,2,0,2
12803,20,5841,2914,6935,0,0,1,0,1
12804,20,5843,9316,6935,0,0,1,0,1
12805,20,5844,3043,6935,0,0,1,0,1
12806,20,5845,545;3126;12360,6935,1,0,2,0,3
12807,20,5846,4448;10037,6935,0,0,2,0,2
12808,20,5847,3419,6935,0,0,1,0,1
12809,20,5848,3555,6935,0,0,1,0,1
12810,20,5849,4156,6935,0,0,1,0,1
12811,20,5850,4221;10074,6935,0,0,2,0,2
12812,20,5851,4259,6935,0,0,1,0,1
12813,20,5852,4299,6935,0,0,0,1,1
12814,20,5853,8384,6935,0,0,1,0,1
12815,20,5854,3127;4571,6935,0,0,2,0,2
12816,20,5855,7682,6935,0,0,1,0,1
12817,20,5856,4674,6935,0,0,0,1,1
12818,20,5857,2875,6935,0,0,1,0,1
12819,20,5858,4743;8418,6935,0,0,2,0,2
12820,20,5859,4785,6935,0,0,1,0,1
12821,20,5860,4868;10287;12276,6935,1,0,2,0,3
12822,20,5861,9946,6935,0,0,1,0,1
12823,20,5862,5097;7994,6935,0,0,2,0,2
12824,20,5863,5258;10158,6935,0,0,2,0,2
12825,20,5864,3583,6935,0,0,1,0,1
12826,20,5865,960;5367,6935,0,0,2,0,2
12827,20,5866,4219;5402,6935,0,0,2,0,2
12828,20,5867,5630;7310,6935,0,0,2,0,2
12829,20,5869,9326,6935,0,0,1,0,1
12830,20,5870,6110,6935,0,0,1,0,1
12831,20,5871,6159;10132,6935,0,0,2,0,2
12832,20,5872,6331,6935,0,0,1,0,1
12833,20,5873,169;6443;12312,6935,1,0,2,0,3
12834,20,5874,6466,6935,0,0,1,0,1
12835,20,5875,5743;6469,6935,0,0,2,0,2
12836,20,5876,8225,6935,0,0,1,0,1
12837,20,5877,7444;8553,6935,0,0,2,0,2
12838,20,5878,7155,6935,0,0,1,0,1
12839,20,5880,9199,6935,0,0,1,0,1
12840,20,5881,6465,6935,0,0,1,0,1
12841,20,5882,9281,6935,0,0,1,0,1
12842,20,5883,7399,6935,0,0,1,0,1
12843,20,5884,4442;7425,6935,0,0,2,0,2
12844,20,5885,3886;7439,6935,0,0,2,0,2
12845,20,5887,7509,6935,0,0,1,0,1
12846,20,5888,3731;7550,6935,0,0,2,0,2
12847,20,5889,7570;7733,6935,0,0,2,0,2
12848,20,5890,7781;9197,6935,0,0,2,0,2
12849,20,5891,7927;9692,6935,0,0,2,0,2
12850,20,5892,3981,6935,0,0,1,0,1
12851,20,5893,8219,6935,0,0,0,1,1
12852,20,5894,2971,6935,0,0,1,0,1
12853,20,5895,7097,6935,0,0,1,0,1
12854,20,5896,8578,6935,0,0,1,0,1
12855,20,5897,8609,6935,0,0,1,0,1
12856,20,5898,9659,6935,0,0,0,1,1
12857,20,5899,8839;9689,6935,0,0,2,0,2
12858,20,5900,8877;10186,6935,0,0,2,0,2
12859,20,5901,982;9042;12381,6935,1,0,2,0,3
12860,20,5902,9151;10046,6935,0,0,2,0,2
12861,20,5903,9373,6935,0,0,1,0,1
12862,20,5904,9412,6935,0,0,1,0,1
12863,20,5905,9680,6935,0,0,1,0,1
12864,20,5906,9764;10206,6935,0,0,2,0,2
12865,20,5907,9816,6935,0,0,1,0,1
12866,20,5908,10022;10210,6935,0,0,2,0,2
12867,20,5909,1619;10029,6935,0,0,2,0,2
12868,20,5910,10033;10362,6935,0,0,2,0,2
12869,20,5911,10035;10188,6935,0,0,2,0,2
12870,20,5912,10056;10297;12318,6935,1,0,2,0,3
12871,20,5913,10079;10162,6935,0,0,2,0,2
12872,20,5914,10099;10109,6935,0,0,2,0,2
12873,20,5915,2818;10108,6935,0,0,2,0,2
12874,20,5916,10113,6935,0,0,1,0,1
12875,20,5917,4034,7300,0,0,1,0,1
12876,20,5918,448;10183,7300,0,0,2,0,2
12877,20,5919,511,7300,0,0,1,0,1
12878,20,5920,4548,7300,0,0,1,0,1
12879,20,5921,562;9927,7300,0,0,2,0,2
12880,20,5922,899,7300,0,0,0,1,1
12881,20,5923,944;3995;12337,7300,1,0,2,0,3
12882,20,5924,8928;9804,7300,0,0,2,0,2
12883,20,5925,1021,7300,0,0,1,0,1
12884,20,5926,1162,7300,0,0,1,0,1
12885,20,5927,1452;2689,7300,0,0,2,0,2
12886,20,5928,1537;5390,7300,0,0,2,0,2
12887,20,5929,3160,7300,0,0,1,0,1
12888,20,5930,2361;10401,7300,0,0,2,0,2
12889,20,5931,1827,7300,0,0,1,0,1
12890,20,5932,8567,7300,0,0,1,0,1
12891,20,5933,5703,7300,0,0,1,0,1
12892,20,5934,3146;5479,7300,0,0,2,0,2
12893,20,5935,3185;10008;12382,7300,1,0,2,0,3
12894,20,5936,1238,7300,0,0,1,0,1
12895,20,5937,3478;10121,7300,0,0,2,0,2
12896,20,5938,3572,7300,0,0,1,0,1
12897,20,5939,3687,7300,0,0,1,0,1
12898,20,5940,3808,7300,0,0,1,0,1
12899,20,5941,3847,7300,0,0,0,1,1
12900,20,5942,9041,7300,0,0,1,0,1
12901,20,5943,4092;7163,7300,0,0,2,0,2
12902,20,5944,3481;4304,7300,0,0,2,0,2
12903,20,5945,4305,7300,0,0,0,1,1
12904,20,5946,4544;9887,7300,0,0,2,0,2
12905,20,5947,4601,7300,0,0,1,0,1
12906,20,5948,4687,7300,0,0,0,1,1
12907,20,5949,4735;9167,7300,0,0,2,0,2
12908,20,5950,4851;10057,7300,0,0,2,0,2
12909,20,5951,5175,7300,0,0,1,0,1
12910,20,5952,5403,7300,0,0,1,0,1
12911,20,5953,5606,7300,0,0,1,0,1
12912,20,5954,3339,7300,0,0,1,0,1
12913,20,5955,5726,7300,0,0,1,0,1
12914,20,5956,5738,7300,0,0,1,0,1
12915,20,5957,5798;5968,7300,0,0,2,0,2
12916,20,5958,7732,7300,0,0,1,0,1
12917,20,5959,3517;6702,7300,0,0,2,0,2
12918,20,5960,6953,7300,0,0,1,0,1
12919,20,5961,6764;6995,7300,0,0,2,0,2
12920,20,5962,7127,7300,0,0,1,0,1
12921,20,5963,8807,7300,0,0,1,0,1
12922,20,5964,7172,7300,0,0,1,0,1
12923,20,5965,5410,7300,0,0,1,0,1
12924,20,5966,8187,7300,0,0,1,0,1
12925,20,5967,8996,7300,0,0,1,0,1
12926,20,5968,7481;10097,7300,0,0,2,0,2
12927,20,5969,8619,7300,0,0,1,0,1
12928,20,5970,8031,7300,0,0,1,0,1
12929,20,5971,5436;8328,7300,0,0,2,0,2
12930,20,5972,8372;9211,7300,0,0,2,0,2
12931,20,5973,8089,7300,0,0,1,0,1
12932,20,5974,8722,7300,0,0,1,0,1
12933,20,5975,5736,7300,0,0,1,0,1
12934,20,5976,8986,7300,0,0,1,0,1
12935,20,5977,7521;9008,7300,0,0,2,0,2
12936,20,5978,5518,7300,0,0,1,0,1
12937,20,5979,9962,7300,0,0,1,0,1
12938,20,5980,4470;9749,7300,0,0,2,0,2
12939,20,5981,9920,7300,0,0,1,0,1
12940,20,5982,576,7300,0,0,1,0,1
12941,20,5983,10017;10320,7300,0,0,2,0,2
12942,20,5984,10026,7300,0,0,1,0,1
12943,20,5985,10043;10519,7300,0,1,1,0,2
12944,20,5986,10106;10220,7300,0,0,2,0,2
12945,20,5987,10134;10142,7300,0,0,2,0,2
12946,20,5988,10154;10498,7300,0,1,1,0,2
12947,20,5989,10187,7300,0,0,1,0,1
12948,30,0,2,0,0,0,0,1,1
12949,30,1,4;2455;11651;12270,0,0,2,2,0,4
12950,30,2,11,0,0,0,1,0,1
12951,30,3,15,0,0,0,0,1,1
12952,30,4,18,0,0,0,1,0,1
12953,30,6,20;9603,0,0,0,0,2,2
12954,30,7,23,0,0,0,0,1,1
12955,30,9,27,0,0,0,0,1,1
12956,30,12,33,0,0,0,0,1,1
12957,30,13,39;10845,0,0,0,2,0,2
12958,30,14,4063,0,0,0,0,1,1
12959,30,15,46,0,0,0,0,1,1
12960,30,17,53;57,0,0,0,1,1,2
12961,30,20,62;11814,0,0,1,1,0,2
12962,30,21,67,0,0,0,0,1,1
12963,30,22,70;11462,0,0,0,2,0,2
12964,30,25,9128;9208;11809,0,0,1,2,0,3
12965,30,27,86,0,0,0,0,1,1
12966,30,28,90;1720;11926;12734;13751,0,1,2,2,0,5
12967,30,29,91;92,0,0,0,1,1,2
12968,30,31,97,0,0,0,0,1,1
12969,30,33,99;100,0,0,0,1,1,2
12970,30,36,108;113,0,0,0,1,1,2
12971,30,38,117;11667;11854,0,0,2,1,0,3
12972,30,39,122,0,0,0,0,1,1
12973,30,43,131;9861,0,0,0,0,2,2
12974,30,44,133;134,0,0,0,1,1,2
12975,30,45,8867;11522,0,0,0,2,0,2
12976,30,46,138,0,0,0,0,1,1
12977,30,52,151;7297,0,0,0,0,2,2
12978,30,53,7876,0,0,0,0,1,1
12979,30,54,159;9347,0,0,0,2,0,2
12980,30,55,162;2306,0,0,0,0,2,2
12981,30,56,164;10300;11471,0,0,0,3,0,3
12982,30,57,165;166,0,0,0,0,2,2
12983,30,58,167;170,0,0,0,1,1,2
12984,30,59,171;172,0,0,0,0,2,2
12985,30,60,173,0,0,0,0,1,1
12986,30,61,180;5192,0,0,0,2,0,2
12987,30,62,185;186,0,0,0,0,2,2
12988,30,64,190;192,0,0,0,0,2,2
12989,30,65,193,0,0,0,1,0,1
12990,30,67,198;2635,0,0,0,0,2,2
12991,30,68,204;7484,0,0,0,0,2,2
12992,30,69,207,0,0,0,0,1,1
12993,30,71,210;572;10207,0,0,0,2,1,3
12994,30,73,214;215,0,0,0,0,2,2
12995,30,74,1463,0,0,0,0,1,1
12996,30,77,226,0,0,0,0,1,1
12997,30,78,229;230,0,0,0,0,2,2
12998,30,79,234,0,0,0,0,1,1
12999,30,80,238,0,0,0,0,1,1
13000,30,81,241;242,0,0,0,1,1,2
13001,30,83,246;247,0,0,0,1,1,2
13002,30,84,249;10194;10240,0,0,0,2,1,3
13003,30,86,253;5298,0,0,0,0,2,2
13004,30,87,255,0,0,0,0,1,1
13005,30,90,261,0,0,0,0,1,1
13006,30,92,264;2637,0,0,0,1,1,2
13007,30,93,268;10284;13547,0,1,0,2,0,3
13008,30,94,269;270,0,0,0,0,2,2
13009,30,96,275;276,0,0,0,0,2,2
13010,30,99,281;283,0,0,0,0,2,2
13011,30,100,284,0,0,0,0,1,1
13012,30,104,295;8027,0,0,0,0,2,2
13013,30,105,297,0,0,0,0,1,1
13014,30,107,301;302,0,0,0,0,2,2
13015,30,111,314,0,0,0,0,1,1
13016,30,112,317;318,0,0,0,0,2,2
13017,30,113,321;10745,0,0,0,2,0,2
13018,30,118,331;332;334,0,0,0,1,2,3
13019,30,119,337,0,0,0,0,1,1
13020,30,123,343,0,0,0,0,1,1
13021,30,127,9894,0,0,0,1,0,1
13022,30,128,354,0,0,0,1,0,1
13023,30,129,358;359,0,0,0,0,2,2
13024,30,130,362,0,0,0,0,1,1
13025,30,131,364;7435,0,0,0,1,1,2
13026,30,132,310,0,0,0,0,1,1
13027,30,134,372;1878,0,0,0,2,0,2
13028,30,136,379,0,0,0,1,0,1
13029,30,138,382;383,0,0,0,1,1,2
13030,30,139,384;385;386,0,0,0,2,1,3
13031,30,141,388;389,0,0,0,0,2,2
13032,30,142,391,0,0,0,0,1,1
13033,30,143,394;4885,0,0,0,0,2,2
13034,30,144,396;3992;11734,0,0,1,2,0,3
13035,30,152,412,0,0,0,0,1,1
13036,30,155,5583,0,0,0,0,1,1
13037,30,156,418,0,0,0,0,1,1
13038,30,157,422;424,0,0,0,0,2,2
13039,30,158,425;426,0,0,0,0,2,2
13040,30,159,427;428,0,0,0,0,2,2
13041,30,162,435;3043;10609,0,0,0,3,0,3
13042,30,163,438,0,0,0,0,1,1
13043,30,164,441,0,0,0,0,1,1
13044,30,165,446;506,0,0,0,0,2,2
13045,30,167,452;5030,0,0,0,2,0,2
13046,30,168,453;454,0,0,0,0,2,2
13047,30,169,344;457;460;5506,0,0,0,2,2,4
13048,30,170,462,0,0,0,0,1,1
13049,30,171,464,0,0,0,0,1,1
13050,30,173,470;5615;12053;12759;12876,0,0,3,2,0,5
13051,30,174,472,0,0,0,0,1,1
13052,30,176,478;1390,0,0,0,0,2,2
13053,30,177,482,0,0,0,0,1,1
13054,30,178,484,0,0,0,0,1,1
13055,30,179,491;493,0,0,0,1,1,2
13056,30,180,495,0,0,0,0,1,1
13057,30,181,496;497,0,0,0,1,1,2
13058,30,182,498,0,0,0,0,1,1
13059,30,183,500;7164;10490;11726,0,0,1,3,0,4
13060,30,184,502;7667;11235,0,0,0,3,0,3
13061,30,185,505;3198;11858,0,0,1,2,0,3
13062,30,187,508,0,0,0,0,1,1
13063,30,188,510,0,0,0,0,1,1
13064,30,190,518;519,0,0,0,0,2,2
13065,30,191,522,0,0,0,0,1,1
13066,30,193,530,0,0,0,0,1,1
13067,30,195,532;4638,0,0,0,0,2,2
13068,30,197,535,0,0,0,0,1,1
13069,30,198,539,0,0,0,0,1,1
13070,30,200,543,0,0,0,0,1,1
13071,30,202,551,0,0,0,0,1,1
13072,30,203,554;3813;12668,0,0,1,2,0,3
13073,30,207,567,0,0,0,0,1,1
13074,30,208,1915,0,0,0,0,1,1
13075,30,209,570,0,0,0,0,1,1
13076,30,210,573;5862,0,0,0,0,2,2
13077,30,211,575;8570,0,0,0,0,2,2
13078,30,216,581;8358,0,0,0,1,1,2
13079,30,217,585,0,0,0,0,1,1
13080,30,218,35;589,0,0,0,2,0,2
13081,30,219,591,0,0,0,0,1,1
13082,30,220,595;596,0,0,0,0,2,2
13083,30,227,613,0,0,0,1,0,1
13084,30,228,614,0,0,0,0,1,1
13085,30,231,621;622,0,0,0,1,1,2
13086,30,233,624;626,0,0,0,1,1,2
13087,30,234,627,0,0,0,0,1,1
13088,30,235,629;10947;11101;11352,0,0,0,4,0,4
13089,30,239,641,0,0,0,1,0,1
13090,30,240,644;9790;10399;11732;12314,0,0,2,3,0,5
13091,30,241,646;647,0,0,0,0,2,2
13092,30,243,650;651,0,0,0,0,2,2
13093,30,246,658;8522,0,0,0,0,2,2
13094,30,247,660,0,0,0,0,1,1
13095,30,250,666;667,0,0,0,0,2,2
13096,30,253,671;3607,0,0,0,0,2,2
13097,30,255,678,0,0,0,0,1,1
13098,30,256,683,0,0,0,0,1,1
13099,30,257,688;4589;10062,0,0,0,3,0,3
13100,30,258,689,0,0,0,1,0,1
13101,30,262,695,0,0,0,0,1,1
13102,30,264,697;698,0,0,0,0,2,2
13103,30,267,707,0,0,0,0,1,1
13104,30,269,709,0,0,0,0,1,1
13105,30,270,713;2983,0,0,0,0,2,2
13106,30,271,715;9662,0,0,0,0,2,2
13107,30,272,717,0,0,0,0,1,1
13108,30,273,718,0,0,0,1,0,1
13109,30,274,722;723;11311,0,0,0,2,1,3
13110,30,275,725,0,0,0,0,1,1
13111,30,276,729,0,0,0,0,1,1
13112,30,277,8898,0,0,0,0,1,1
13113,30,278,737,0,0,0,0,1,1
13114,30,279,738;10326;11643,0,0,1,2,0,3
13115,30,283,745;2242;11393,0,0,0,2,1,3
13116,30,284,746;747,0,0,0,0,2,2
13117,30,286,750,0,0,0,0,1,1
13118,30,288,756;6575;10623,0,0,0,3,0,3
13119,30,291,6147;10538;10978;11015,0,0,0,4,0,4
13120,30,292,762,0,0,0,0,1,1
13121,30,293,763;6539;11091;11134,0,0,0,4,0,4
13122,30,294,764;765;5094,0,0,0,1,2,3
13123,30,297,7780;13114;13667,0,2,0,1,0,3
13124,30,299,780;781,0,0,0,0,2,2
13125,30,301,787,0,0,0,1,0,1
13126,30,303,789;1983,0,0,0,0,2,2
13127,30,304,9923;13480;13591,0,2,0,1,0,3
13128,30,305,796;798,0,0,0,0,2,2
13129,30,306,799;800;803;11001,0,0,0,3,1,4
13130,30,307,445;805;10289,0,0,0,1,2,3
13131,30,308,806;807,0,0,0,1,1,2
13132,30,309,808,0,0,0,0,1,1
13133,30,310,812;813,0,0,0,0,2,2
13134,30,311,814;815,0,0,0,0,2,2
13135,30,315,822,0,0,0,0,1,1
13136,30,316,823,0,0,0,0,1,1
13137,30,318,831,0,0,0,0,1,1
13138,30,319,832,0,0,0,0,1,1
13139,30,321,836,0,0,0,0,1,1
13140,30,322,840,0,0,0,0,1,1
13141,30,323,842,0,0,0,0,1,1
13142,30,324,847,0,0,0,1,0,1
13143,30,327,854,0,0,0,0,1,1
13144,30,330,861,0,0,0,0,1,1
13145,30,331,866,0,0,0,0,1,1
13146,30,332,869;3919;11361,0,0,0,3,0,3
13147,30,334,876;5401,0,0,0,0,2,2
13148,30,336,882,0,0,0,0,1,1
13149,30,337,884,0,0,0,0,1,1
13150,30,338,885,0,0,0,0,1,1
13151,30,340,893;894,0,0,0,1,1,2
13152,30,342,900,0,0,0,0,1,1
13153,30,343,905,0,0,0,0,1,1
13154,30,347,912;913,0,0,0,0,2,2
13155,30,350,921;4736;7020;7150;12132;12538;12951;13398,0,1,3,4,0,8
13156,30,352,924;925,0,0,0,0,2,2
13157,30,353,929;9246;12288;12701,0,0,2,2,0,4
13158,30,354,930;7734;11698,0,0,1,2,0,3
13159,30,357,939;940,0,0,0,1,1,2
13160,30,358,942,0,0,0,0,1,1
13161,30,361,949;11198,0,0,0,2,0,2
13162,30,365,542;965;10517,0,0,0,2,1,3
13163,30,367,969;970,0,0,0,0,2,2
13164,30,369,984;3974;3976;3977,0,0,0,2,2,4
13165,30,370,989;990,0,0,0,1,1,2
13166,30,373,995,0,0,0,0,1,1
13167,30,376,1000;10966,0,0,0,2,0,2
13168,30,377,1002,0,0,0,0,1,1
13169,30,378,1005,0,0,0,0,1,1
13170,30,379,1008,0,0,0,0,1,1
13171,30,381,1012;1013,0,0,0,0,2,2
13172,30,382,1014;6783;11270,0,0,0,3,0,3
13173,30,384,1019;6142;10273,0,0,0,3,0,3
13174,30,388,1028,0,0,0,0,1,1
13175,30,392,1039,0,0,0,0,1,1
13176,30,393,1043;1044;1045;7890,0,0,0,3,1,4
13177,30,394,1046;4536,0,0,0,0,2,2
13178,30,395,1048;1050,0,0,0,1,1,2
13179,30,398,1058,0,0,0,0,1,1
13180,30,400,1062,0,0,0,0,1,1
13181,30,403,1069,0,0,0,0,1,1
13182,30,404,1073,0,0,0,0,1,1
13183,30,405,1075;3452,0,0,0,0,2,2
13184,30,406,1077,0,0,0,0,1,1
13185,30,407,1078,0,0,0,0,1,1
13186,30,409,1081,0,0,0,0,1,1
13187,30,410,1082;9170;11033,0,0,0,3,0,3
13188,30,411,1083,0,0,0,1,0,1
13189,30,412,1085;1086,0,0,0,0,2,2
13190,30,413,1087,0,0,0,0,1,1
13191,30,414,1088;1089,0,0,0,0,2,2
13192,30,415,1090;1092,0,0,0,1,1,2
13193,30,417,1098;9218,0,0,0,0,2,2
13194,30,418,1101;1102;10179;11069,0,0,0,3,1,4
13195,30,420,1106;1107;11421;11720,0,0,1,3,0,4
13196,30,421,1108;8308,0,0,0,0,2,2
13197,30,423,1112,0,0,0,0,1,1
13198,30,424,1114,0,0,0,0,1,1
13199,30,425,1117;4255,0,0,0,0,2,2
13200,30,426,1110,0,0,0,0,1,1
13201,30,427,1120,0,0,0,0,1,1
13202,30,428,1124,0,0,0,0,1,1
13203,30,430,243;1129;10861,0,0,0,3,0,3
13204,30,431,1131;3646,0,0,0,0,2,2
13205,30,432,1132;2526,0,0,0,0,2,2
13206,30,433,1135;1136;1865,0,0,0,1,2,3
13207,30,434,1137;1138,0,0,0,0,2,2
13208,30,436,1146,0,0,0,0,1,1
13209,30,440,1164;10202,0,0,0,2,0,2
13210,30,441,1168,0,0,0,0,1,1
13211,30,445,1175,0,0,0,0,1,1
13212,30,448,1181;8904,0,0,0,2,0,2
13213,30,449,759;1182,0,0,0,0,2,2
13214,30,451,1185;1186,0,0,0,1,1,2
13215,30,453,1189;1190;1191,0,0,0,2,1,3
13216,30,455,1196,0,0,0,0,1,1
13217,30,456,1198;3831;10878,0,0,0,3,0,3
13218,30,457,1201,0,0,0,0,1,1
13219,30,459,1204;6775,0,0,0,0,2,2
13220,30,460,1208,0,0,0,0,1,1
13221,30,464,1221,0,0,0,0,1,1
13222,30,465,1222,0,0,0,0,1,1
13223,30,466,1223;5804,0,0,0,0,2,2
13224,30,467,1226,0,0,0,0,1,1
13225,30,468,623;1228,0,0,0,0,2,2
13226,30,470,1234,0,0,0,0,1,1
13227,30,472,1241,0,0,0,0,1,1
13228,30,473,1244;1245,0,0,0,0,2,2
13229,30,474,3655;9623;10797,0,0,0,3,0,3
13230,30,477,1258,0,0,0,0,1,1
13231,30,478,1260;3503;13143;13535,0,2,0,2,0,4
13232,30,479,1261,0,0,0,0,1,1
13233,30,480,1265,0,0,0,0,1,1
13234,30,483,1275;1276,0,0,0,1,1,2
13235,30,487,1283;8781;11677,0,0,1,2,0,3
13236,30,488,1285;3676;11169;12189,0,0,1,3,0,4
13237,30,490,1291,0,0,0,0,1,1
13238,30,491,1296;8317;12976,0,0,1,2,0,3
13239,30,492,1300,0,0,0,0,1,1
13240,30,493,1303,0,0,0,0,1,1
13241,30,494,528;1307,0,0,0,1,1,2
13242,30,495,1309;1310,0,0,0,0,2,2
13243,30,497,1315;1316,0,0,0,0,2,2
13244,30,500,1324;10951,0,0,0,1,1,2
13245,30,502,1327,0,0,0,0,1,1
13246,30,503,1329;6543,0,0,0,0,2,2
13247,30,504,768,0,0,0,0,1,1
13248,30,505,1335;6079,0,0,0,0,2,2
13249,30,507,118;1338,0,0,0,0,2,2
13250,30,508,1340;1341,0,0,0,0,2,2
13251,30,509,1345;13364;13522,0,2,0,1,0,3
13252,30,513,1357,0,0,0,0,1,1
13253,30,514,1361;1362,0,0,0,0,2,2
13254,30,516,1366,0,0,0,0,1,1
13255,30,518,1373;9207;10464,0,0,0,3,0,3
13256,30,519,1375;5704;11827;12365,0,0,2,2,0,4
13257,30,522,1382;10019;12989;13272,0,1,1,2,0,4
13258,30,523,327;1383,0,0,0,1,1,2
13259,30,524,1384,0,0,0,0,1,1
13260,30,528,1393,0,0,0,0,1,1
13261,30,530,1397,0,0,0,0,1,1
13262,30,534,1405;9204;10308,0,0,0,2,1,3
13263,30,535,1407;1408,0,0,0,0,2,2
13264,30,540,1422;1423,0,0,0,0,2,2
13265,30,543,1433,0,0,0,0,1,1
13266,30,545,1435;1436,0,0,0,2,0,2
13267,30,546,1438,0,0,0,0,1,1
13268,30,547,1439;1440,0,0,0,0,2,2
13269,30,548,1441,0,0,0,0,1,1
13270,30,549,1442,0,0,0,0,1,1
13271,30,552,1448,0,0,0,0,1,1
13272,30,553,1453;7690;11747,0,0,1,2,0,3
13273,30,555,1456;7226,0,0,0,2,0,2
13274,30,556,1461;10343;10817;12975;13370;13796,0,2,1,3,0,6
13275,30,559,1465;1466;1468,0,0,0,1,2,3
13276,30,560,1469;1472;11092,0,0,0,3,0,3
13277,30,561,1473;5771;12597,0,0,1,2,0,3
13278,30,562,1475,0,0,0,1,0,1
13279,30,563,1480,0,0,0,0,1,1
13280,30,564,1481,0,0,0,0,1,1
13281,30,565,1483;1485;3685,0,0,0,1,2,3
13282,30,566,1488,0,0,0,0,1,1
13283,30,567,1491,0,0,0,0,1,1
13284,30,569,1497,0,0,0,1,0,1
13285,30,571,1502;5602,0,0,0,2,0,2
13286,30,573,1506;10611;11620,0,0,1,2,0,3
13287,30,574,1507,0,0,0,0,1,1
13288,30,575,1510;1511,0,0,0,0,2,2
13289,30,578,1519,0,0,0,0,1,1
13290,30,579,1520;1521,0,0,0,1,1,2
13291,30,580,1523,0,0,0,0,1,1
13292,30,582,517;1529,0,0,0,2,0,2
13293,30,583,1531,0,0,0,0,1,1
13294,30,584,461,0,0,0,1,0,1
13295,30,585,1540,0,0,0,0,1,1
13296,30,587,1546;1547;10318,0,0,0,2,1,3
13297,30,588,1549;6850,0,0,0,2,0,2
13298,30,590,132;1553;6560;10064,0,0,0,4,0,4
13299,30,591,1555,0,0,0,0,1,1
13300,30,592,1558;10836,0,0,0,2,0,2
13301,30,593,1560;11578;11687,0,0,2,1,0,3
13302,30,595,1567,0,0,0,0,1,1
13303,30,597,1573,0,0,0,0,1,1
13304,30,598,1577;12983;13366,0,1,1,1,0,3
13305,30,600,1579,0,0,0,0,1,1
13306,30,604,1591,0,0,0,0,1,1
13307,30,606,1595,0,0,0,0,1,1
13308,30,607,7390;8801;10467;10620;11118,0,0,0,5,0,5
13309,30,608,1597,0,0,0,0,1,1
13310,30,610,1602,0,0,0,0,1,1
13311,30,611,1605;1606,0,0,0,1,1,2
13312,30,614,1616,0,0,0,0,1,1
13313,30,615,1620,0,0,0,1,0,1
13314,30,618,1628;1629,0,0,0,1,1,2
13315,30,619,1631;1632;11143,0,0,0,2,1,3
13316,30,620,178;1633;11438;11701,0,0,1,3,0,4
13317,30,621,1635,0,0,0,0,1,1
13318,30,622,1638,0,0,0,0,1,1
13319,30,624,1643;4764,0,0,0,1,1,2
13320,30,625,1646,0,0,0,0,1,1
13321,30,628,6256,0,0,0,0,1,1
13322,30,629,1659,0,0,0,0,1,1
13323,30,630,1660;1957,0,0,0,0,2,2
13324,30,632,1664;9901,0,0,0,0,2,2
13325,30,638,1681,0,0,0,0,1,1
13326,30,639,1684,0,0,0,0,1,1
13327,30,641,1690;1694,0,0,0,1,1,2
13328,30,642,4988;5742,0,0,0,1,1,2
13329,30,644,1704;2073,0,0,0,0,2,2
13330,30,645,1708,0,0,0,0,1,1
13331,30,646,1710,0,0,0,0,1,1
13332,30,648,1715;1776,0,0,0,2,0,2
13333,30,649,1716;1717,0,0,0,0,2,2
13334,30,651,1727,0,0,0,1,0,1
13335,30,654,2465,0,0,0,0,1,1
13336,30,656,1742;1743,0,0,0,1,1,2
13337,30,657,1747,0,0,0,1,0,1
13338,30,658,1748,0,0,0,1,0,1
13339,30,660,1754;9192,0,0,0,0,2,2
13340,30,661,1756;3842;12528;12954;13328;13721,0,2,2,2,0,6
13341,30,662,1758,0,0,0,0,1,1
13342,30,665,1763;1764,0,0,0,0,2,2
13343,30,667,1771;7499;12518,0,0,1,2,0,3
13344,30,669,1778,0,0,0,0,1,1
13345,30,671,1781;1782,0,0,0,0,2,2
13346,30,677,1795,0,0,0,0,1,1
13347,30,680,1805,0,0,0,0,1,1
13348,30,682,1809;1810,0,0,0,2,0,2
13349,30,684,1812;1813;10556,0,0,0,2,1,3
13350,30,687,1818,0,0,0,0,1,1
13351,30,692,1830;7339;10041,0,0,0,1,2,3
13352,30,695,2946;4352,0,0,0,0,2,2
13353,30,696,1840;13216;13384,0,2,0,1,0,3
13354,30,698,1843,0,0,0,1,0,1
13355,30,699,1844,0,0,0,0,1,1
13356,30,702,1853;1854,0,0,0,1,1,2
13357,30,704,1856;7441,0,0,0,2,0,2
13358,30,705,1859,0,0,0,0,1,1
13359,30,706,1861,0,0,0,0,1,1
13360,30,709,1760;1868;10605,0,0,0,3,0,3
13361,30,710,1869;2679,0,0,0,0,2,2
13362,30,713,1874;1875,0,0,0,0,2,2
13363,30,714,1876,0,0,0,0,1,1
13364,30,716,879;1881;1883;11640,0,0,1,3,0,4
13365,30,719,1888,0,0,0,0,1,1
13366,30,720,1545;1891;1892,0,0,0,2,1,3
13367,30,721,1893,0,0,0,1,0,1
13368,30,723,1898,0,0,0,0,1,1
13369,30,727,1912,0,0,0,0,1,1
13370,30,728,1914;8043;11242,0,0,0,3,0,3
13371,30,729,1916;6672,0,0,0,0,2,2
13372,30,730,1917;9761,0,0,0,0,2,2
13373,30,731,9969,0,0,0,0,1,1
13374,30,732,1920;1921,0,0,0,0,2,2
13375,30,733,1923;1924,0,0,0,2,0,2
13376,30,735,3137,0,0,0,1,0,1
13377,30,736,8154;9410;10844;11387,0,0,0,4,0,4
13378,30,738,5001;7509;12122,0,0,1,2,0,3
13379,30,739,1937,0,0,0,0,1,1
13380,30,740,1938;1939,0,0,0,0,2,2
13381,30,742,1946;1949,0,0,0,0,2,2
13382,30,747,1958,0,0,0,0,1,1
13383,30,750,1965;2149,0,0,0,2,0,2
13384,30,751,1968;8451,0,0,0,0,2,2
13385,30,752,1969;1970,0,0,0,1,1,2
13386,30,753,1971;1972,0,0,0,0,2,2
13387,30,754,1975,0,0,0,0,1,1
13388,30,757,1988,0,0,0,0,1,1
13389,30,759,1993;7937;11154;11381;11746,0,0,1,4,0,5
13390,30,760,1994;6424,0,0,0,0,2,2
13391,30,762,1997,0,0,0,0,1,1
13392,30,767,2005;5613;11388,0,0,0,3,0,3
13393,30,768,2006;6085;7829;10973,0,0,0,4,0,4
13394,30,769,2884,0,0,0,0,1,1
13395,30,771,2020,0,0,0,0,1,1
13396,30,772,2023;2024,0,0,0,1,1,2
13397,30,773,2026;10695,0,0,0,2,0,2
13398,30,774,2028,0,0,0,0,1,1
13399,30,775,2036;2037,0,0,0,0,2,2
13400,30,776,2044;4802,0,0,0,0,2,2
13401,30,777,2045,0,0,0,0,1,1
13402,30,778,2046,0,0,0,0,1,1
13403,30,782,2052;6895,0,0,0,1,1,2
13404,30,784,1464;2057,0,0,0,0,2,2
13405,30,786,2062;8886,0,0,0,2,0,2
13406,30,787,2064,0,0,0,0,1,1
13407,30,788,2065,0,0,0,0,1,1
13408,30,789,2070,0,0,0,1,0,1
13409,30,792,2074;2075,0,0,0,0,2,2
13410,30,793,2079,0,0,0,0,1,1
13411,30,796,2084,0,0,0,0,1,1
13412,30,797,2087,0,0,0,0,1,1
13413,30,798,2088;2090,0,0,0,0,2,2
13414,30,799,2094;2095,0,0,0,0,2,2
13415,30,801,2100,0,0,0,0,1,1
13416,30,803,2103;2809,0,0,0,2,0,2
13417,30,805,2107;5779;11866;12237,0,0,2,1,1,4
13418,30,806,2109;3354,0,0,0,0,2,2
13419,30,809,2114;5370,0,0,0,0,2,2
13420,30,810,2115,0,0,0,0,1,1
13421,30,811,2118,0,0,0,0,1,1
13422,30,812,2119;2120,0,0,0,0,2,2
13423,30,813,2123;4946;12526;13339,0,1,1,2,0,4
13424,30,814,2125,0,0,0,0,1,1
13425,30,816,2128,0,0,0,0,1,1
13426,30,817,2132,0,0,0,0,1,1
13427,30,818,2139;2142,0,0,0,1,1,2
13428,30,819,2143,0,0,0,0,1,1
13429,30,820,2145,0,0,0,0,1,1
13430,30,821,2148;6028;10068,0,0,0,3,0,3
13431,30,825,3694;6082,0,0,0,0,2,2
13432,30,826,2158,0,0,0,0,1,1
13433,30,827,4894,0,0,0,0,1,1
13434,30,828,2162,0,0,0,0,1,1
13435,30,829,1023,0,0,0,1,0,1
13436,30,833,1931;2173;11539,0,0,1,2,0,3
13437,30,834,2178;2179;11828,0,0,1,2,0,3
13438,30,836,2184,0,0,0,0,1,1
13439,30,841,2193,0,0,0,0,1,1
13440,30,842,2196,0,0,0,0,1,1
13441,30,844,2198,0,0,0,0,1,1
13442,30,846,2202,0,0,0,0,1,1
13443,30,847,2204,0,0,0,0,1,1
13444,30,850,2214,0,0,0,0,1,1
13445,30,851,2216;7783,0,0,0,1,1,2
13446,30,852,2221;2223;8061,0,0,0,2,1,3
13447,30,854,2229,0,0,0,0,1,1
13448,30,857,758;2238;2240;10830;11184,0,0,0,5,0,5
13449,30,859,2243,0,0,0,0,1,1
13450,30,860,2248,0,0,0,0,1,1
13451,30,862,2257;3580,0,0,0,2,0,2
13452,30,864,2263,0,0,0,1,0,1
13453,30,865,2266;2267,0,0,0,0,2,2
13454,30,866,2271,0,0,0,1,0,1
13455,30,867,2113;2272,0,0,0,0,2,2
13456,30,868,2274;2275,0,0,0,0,2,2
13457,30,869,2277;2280,0,0,0,0,2,2
13458,30,870,2284,0,0,0,0,1,1
13459,30,873,1202;2287,0,0,0,2,0,2
13460,30,874,2293;10872,0,0,0,2,0,2
13461,30,877,2299;10077,0,0,0,1,1,2
13462,30,878,2303;2805;11180;11359;11801,0,0,1,4,0,5
13463,30,883,2312,0,0,0,0,1,1
13464,30,885,2315,0,0,0,0,1,1
13465,30,886,2320;2321;2323;5365;11949;12357;12434;12663;12683;13023;13511,0,1,6,4,0,11
13466,30,889,2331;6398,0,0,0,0,2,2
13467,30,890,5622,0,0,0,0,1,1
13468,30,892,2336,0,0,0,0,1,1
13469,30,893,2338;2409,0,0,0,1,1,2
13470,30,894,2342,0,0,0,1,0,1
13471,30,895,3189,0,0,0,1,0,1
13472,30,896,2347,0,0,0,0,1,1
13473,30,901,2363,0,0,0,0,1,1
13474,30,902,2367;3814,0,0,0,0,2,2
13475,30,904,2374;11765,0,0,1,1,0,2
13476,30,906,2378,0,0,0,0,1,1
13477,30,909,2386,0,0,0,0,1,1
13478,30,910,2387,0,0,0,0,1,1
13479,30,912,2393,0,0,0,0,1,1
13480,30,917,2411,0,0,0,0,1,1
13481,30,918,2412;2413;2414,0,0,0,0,3,3
13482,30,919,2418;4793;11735;12223,0,0,2,2,0,4
13483,30,921,2421,0,0,0,0,1,1
13484,30,922,2422;2423,0,0,0,1,1,2
13485,30,924,7434,0,0,0,0,1,1
13486,30,927,2432,0,0,0,0,1,1
13487,30,928,2436,0,0,0,0,1,1
13488,30,930,2439;2440,0,0,0,0,2,2
13489,30,935,2453;2454,0,0,0,0,2,2
13490,30,936,2459,0,0,0,0,1,1
13491,30,937,2460,0,0,0,0,1,1
13492,30,940,2471;2472,0,0,0,1,1,2
13493,30,941,2473;2474,0,0,0,0,2,2
13494,30,942,2477,0,0,0,0,1,1
13495,30,944,2484;2485,0,0,0,0,2,2
13496,30,947,2488,0,0,0,0,1,1
13497,30,948,2491;2493,0,0,0,1,1,2
13498,30,951,2505;2508;9585;11896;12361,0,0,2,2,1,5
13499,30,952,2509,0,0,0,0,1,1
13500,30,953,2368;2513;10674,0,0,0,3,0,3
13501,30,956,2520,0,0,0,0,1,1
13502,30,957,2521,0,0,0,0,1,1
13503,30,960,2533,0,0,0,0,1,1
13504,30,961,2536,0,0,0,0,1,1
13505,30,962,2538;5562,0,0,0,2,0,2
13506,30,964,2541,0,0,0,0,1,1
13507,30,965,2547,0,0,0,1,0,1
13508,30,967,2550,0,0,0,0,1,1
13509,30,968,2551;2552,0,0,0,0,2,2
13510,30,969,2554,0,0,0,0,1,1
13511,30,970,531;2558,0,0,0,0,2,2
13512,30,971,2561,0,0,0,0,1,1
13513,30,972,520;2564,0,0,0,2,0,2
13514,30,973,2566,0,0,0,0,1,1
13515,30,974,2567;2568,0,0,0,1,1,2
13516,30,975,2569,0,0,0,0,1,1
13517,30,977,2574;2575,0,0,0,1,1,2
13518,30,978,80;2576,0,0,0,2,0,2
13519,30,979,2579,0,0,0,0,1,1
13520,30,980,2153,0,0,0,0,1,1
13521,30,984,2590;2591,0,0,0,1,1,2
13522,30,987,5539,0,0,0,0,1,1
13523,30,989,2602;7787,0,0,0,2,0,2
13524,30,990,5248;8649;12647;12845,0,0,2,2,0,4
13525,30,991,2608;8882;10501,0,0,0,1,2,3
13526,30,995,1211;2614,0,0,0,2,0,2
13527,30,997,2072,0,0,0,0,1,1
13528,30,998,2618;2706,0,0,0,1,1,2
13529,30,1000,2627,0,0,0,0,1,1
13530,30,1001,2630;4452,0,0,0,2,0,2
13531,30,1006,2639,0,0,0,0,1,1
13532,30,1007,2640,0,0,0,0,1,1
13533,30,1010,2648;12796,0,0,1,1,0,2
13534,30,1013,2658;3740;10531,0,0,0,3,0,3
13535,30,1017,2665,0,0,0,0,1,1
13536,30,1018,2666;2668,0,0,0,0,2,2
13537,30,1019,2672;2673,0,0,0,0,2,2
13538,30,1023,2683,0,0,0,0,1,1
13539,30,1025,2690;2691;5040,0,0,0,1,2,3
13540,30,1027,2837,0,0,0,0,1,1
13541,30,1028,2697,0,0,0,0,1,1
13542,30,1029,2698;9810,0,0,0,0,2,2
13543,30,1031,2703,0,0,0,0,1,1
13544,30,1033,9333,0,0,0,1,0,1
13545,30,1037,233;2712,0,0,0,0,2,2
13546,30,1039,2716;5780,0,0,0,1,1,2
13547,30,1045,2738;5433;12505;12548;12936;13327,0,1,3,2,0,6
13548,30,1048,2749;5146,0,0,0,2,0,2
13549,30,1051,2754,0,0,0,0,1,1
13550,30,1052,2756;2757,0,0,0,0,2,2
13551,30,1059,2748;2773;11486;11829,0,0,1,3,0,4
13552,30,1062,2950;7177;13560,0,1,0,2,0,3
13553,30,1063,2786;4625;10371,0,0,0,3,0,3
13554,30,1064,2790,0,0,0,0,1,1
13555,30,1065,2792,0,0,0,0,1,1
13556,30,1067,2796;2797,0,0,0,0,2,2
13557,30,1069,2806;6176;11080,0,0,0,3,0,3
13558,30,1071,2814,0,0,0,0,1,1
13559,30,1072,2819;2820,0,0,0,1,1,2
13560,30,1073,2822,0,0,0,0,1,1
13561,30,1074,2823;12305,0,0,1,1,0,2
13562,30,1075,2826,0,0,0,0,1,1
13563,30,1076,2829;2830,0,0,0,1,1,2
13564,30,1077,2832;3781,0,0,0,0,2,2
13565,30,1078,7145,0,0,0,0,1,1
13566,30,1082,2847,0,0,0,0,1,1
13567,30,1084,2851,0,0,0,1,0,1
13568,30,1086,2856,0,0,0,0,1,1
13569,30,1088,2862,0,0,0,0,1,1
13570,30,1089,2866,0,0,0,0,1,1
13571,30,1090,2868,0,0,0,0,1,1
13572,30,1093,3293;6343;11003,0,0,0,3,0,3
13573,30,1094,2882;4803,0,0,0,0,2,2
13574,30,1096,2885;8951,0,0,0,1,1,2
13575,30,1098,1719;11319;12309;12697;12847,0,0,3,2,0,5
13576,30,1099,2888,0,0,0,0,1,1
13577,30,1100,2894,0,0,0,0,1,1
13578,30,1102,2398;2898,0,0,0,0,2,2
13579,30,1103,2900;7283,0,0,0,0,2,2
13580,30,1104,2903,0,0,0,1,0,1
13581,30,1105,2905,0,0,0,0,1,1
13582,30,1106,2907,0,0,0,0,1,1
13583,30,1107,5636,0,0,0,0,1,1
13584,30,1109,2911;10648;11825,0,0,1,2,0,3
13585,30,1111,2915;2916,0,0,0,1,1,2
13586,30,1113,2918;11182,0,0,0,2,0,2
13587,30,1115,2923,0,0,0,0,1,1
13588,30,1116,2926,0,0,0,0,1,1
13589,30,1117,2927,0,0,0,0,1,1
13590,30,1121,2937;4841,0,0,0,2,0,2
13591,30,1123,2941,0,0,0,0,1,1
13592,30,1124,2944;9658,0,0,0,0,2,2
13593,30,1125,2945,0,0,0,0,1,1
13594,30,1126,2947,0,0,0,0,1,1
13595,30,1128,2956,0,0,0,0,1,1
13596,30,1129,2958;10072;10768;11149;11898,0,0,1,4,0,5
13597,30,1130,51;2962,0,0,0,2,0,2
13598,30,1131,2966,0,0,0,0,1,1
13599,30,1133,8338,0,0,0,1,0,1
13600,30,1134,2974,0,0,0,0,1,1
13601,30,1135,2978,0,0,0,1,0,1
13602,30,1136,2981;2982,0,0,0,0,2,2
13603,30,1137,2984,0,0,0,0,1,1
13604,30,1138,2987;6514;10094,0,0,0,3,0,3
13605,30,1139,2988,0,0,0,0,1,1
13606,30,1140,2991,0,0,0,0,1,1
13607,30,1142,2994,0,0,0,0,1,1
13608,30,1146,3009,0,0,0,0,1,1
13609,30,1149,3018,0,0,0,1,0,1
13610,30,1152,726;3024,0,0,0,2,0,2
13611,30,1153,3026;6818,0,0,0,0,2,2
13612,30,1156,3040;3041;5088;6323;6972;9819;10205;12549,0,0,1,4,3,8
13613,30,1157,3042;3044,0,0,0,0,2,2
13614,30,1158,3047;3048,0,0,0,0,2,2
13615,30,1161,3053,0,0,0,0,1,1
13616,30,1164,3065,0,0,0,0,1,1
13617,30,1165,3068,0,0,0,0,1,1
13618,30,1168,3077;10553;10804;11050;11267,0,0,0,4,1,5
13619,30,1170,3080;8211;10382;11367,0,0,0,4,0,4
13620,30,1171,4005,0,0,0,0,1,1
13621,30,1172,3086;9026,0,0,0,2,0,2
13622,30,1180,3105;9702;10529,0,0,0,3,0,3
13623,30,1181,3109;3110;3111,0,0,0,2,1,3
13624,30,1182,3112,0,0,0,0,1,1
13625,30,1183,3113,0,0,0,0,1,1
13626,30,1184,3115,0,0,0,0,1,1
13627,30,1185,3119;6447,0,0,0,1,1,2
13628,30,1186,3124;5485,0,0,0,0,2,2
13629,30,1189,6291,0,0,0,0,1,1
13630,30,1190,3135;6125,0,0,0,0,2,2
13631,30,1191,3141;4531,0,0,0,1,1,2
13632,30,1192,3142;6371,0,0,0,0,2,2
13633,30,1193,3143,0,0,0,0,1,1
13634,30,1194,3148,0,0,0,0,1,1
13635,30,1198,3153,0,0,0,0,1,1
13636,30,1200,3162;3163,0,0,0,0,2,2
13637,30,1201,3166;3167,0,0,0,0,2,2
13638,30,1202,3169;8225,0,0,0,2,0,2
13639,30,1203,3170;9781;10542,0,0,0,1,2,3
13640,30,1204,3171,0,0,0,0,1,1
13641,30,1205,3174;3175;10596;11193,0,0,0,3,1,4
13642,30,1206,3176;3178,0,0,0,0,2,2
13643,30,1208,3181;5220,0,0,0,0,2,2
13644,30,1209,357;6720;12928,0,0,1,2,0,3
13645,30,1210,3187;3364;11263,0,0,0,3,0,3
13646,30,1212,3194,0,0,0,0,1,1
13647,30,1214,6479;7249,0,0,0,0,2,2
13648,30,1216,3205;3206,0,0,0,0,2,2
13649,30,1219,3217,0,0,0,0,1,1
13650,30,1220,3220;3221,0,0,0,1,1,2
13651,30,1221,3223,0,0,0,0,1,1
13652,30,1224,3231;10536,0,0,0,2,0,2
13653,30,1227,8714,0,0,0,0,1,1
13654,30,1229,2279;3249;10135;11048,0,0,0,4,0,4
13655,30,1232,3253;6339;10890;11601,0,0,1,3,0,4
13656,30,1233,3258;6811,0,0,0,0,2,2
13657,30,1234,1769;3259;11150;12724,0,0,1,3,0,4
13658,30,1235,3262,0,0,0,1,0,1
13659,30,1237,3264;3265,0,0,0,0,2,2
13660,30,1241,3274;3275,0,0,0,0,2,2
13661,30,1242,3278,0,0,0,0,1,1
13662,30,1243,3279,0,0,0,0,1,1
13663,30,1244,3282;3283,0,0,0,0,2,2
13664,30,1245,3284;3285,0,0,0,0,2,2
13665,30,1247,3288,0,0,0,0,1,1
13666,30,1248,3290;3292,0,0,0,0,2,2
13667,30,1250,3294;8868,0,0,0,0,2,2
13668,30,1256,3310;3311,0,0,0,0,2,2
13669,30,1257,3313;3314,0,0,0,0,2,2
13670,30,1258,3316;3317;3901,0,0,0,1,2,3
13671,30,1260,3322,0,0,0,0,1,1
13672,30,1262,3325,0,0,0,0,1,1
13673,30,1267,3334,0,0,0,0,1,1
13674,30,1268,3336;8792,0,0,0,1,1,2
13675,30,1269,3807;5654,0,0,0,1,1,2
13676,30,1271,634;3343,0,0,0,0,2,2
13677,30,1272,3344,0,0,0,0,1,1
13678,30,1273,3347,0,0,0,0,1,1
13679,30,1275,3355;3356;8526,0,0,0,3,0,3
13680,30,1276,3357;5452,0,0,0,0,2,2
13681,30,1277,3360;3361,0,0,0,0,2,2
13682,30,1280,3368;3369,0,0,0,1,1,2
13683,30,1281,3370;3371,0,0,0,0,2,2
13684,30,1282,3373,0,0,0,1,0,1
13685,30,1283,3378;10368;10690,0,0,0,3,0,3
13686,30,1285,774;3386;3419;6955;12176;12776;13456;13713,0,2,2,4,0,8
13687,30,1286,7694,0,0,0,0,1,1
13688,30,1288,3399,0,0,0,0,1,1
13689,30,1290,3408,0,0,0,0,1,1
13690,30,1291,3410,0,0,0,0,1,1
13691,30,1292,672;3411;10472;11291;11669,0,0,1,4,0,5
13692,30,1295,1671;3415;3420,0,0,0,2,1,3
13693,30,1297,3422;3423;3424,0,0,0,2,1,3
13694,30,1298,3425,0,0,0,0,1,1
13695,30,1299,3426;3427,0,0,0,1,1,2
13696,30,1300,3430,0,0,0,0,1,1
13697,30,1301,3435,0,0,0,0,1,1
13698,30,1302,3439;3440,0,0,0,0,2,2
13699,30,1303,3441;3442,0,0,0,1,1,2
13700,30,1305,3446,0,0,0,0,1,1
13701,30,1306,3447;3448;11234;11472,0,0,0,3,1,4
13702,30,1310,3460,0,0,0,0,1,1
13703,30,1311,3462,0,0,0,0,1,1
13704,30,1314,3469;3472;7465,0,0,0,3,0,3
13705,30,1315,3474;12075,0,0,1,1,0,2
13706,30,1316,3479,0,0,0,0,1,1
13707,30,1320,3486,0,0,0,0,1,1
13708,30,1322,3490;3491,0,0,0,0,2,2
13709,30,1323,3496,0,0,0,0,1,1
13710,30,1326,3501;3687,0,0,0,2,0,2
13711,30,1327,1991;3505;3507,0,0,0,1,2,3
13712,30,1329,3509;6516,0,0,0,2,0,2
13713,30,1331,3511;3512;10665;10811,0,0,0,3,1,4
13714,30,1332,3514;10390;10871;11575,0,0,1,3,0,4
13715,30,1333,3515,0,0,0,0,1,1
13716,30,1334,3519,0,0,0,0,1,1
13717,30,1335,3521;3522,0,0,0,0,2,2
13718,30,1336,3525,0,0,0,0,1,1
13719,30,1337,3526;7650,0,0,0,1,1,2
13720,30,1338,3529,0,0,0,0,1,1
13721,30,1339,3532;3534,0,0,0,0,2,2
13722,30,1340,3535,0,0,0,0,1,1
13723,30,1341,3540,0,0,0,1,0,1
13724,30,1342,3541,0,0,0,1,0,1
13725,30,1344,3546;3547,0,0,0,0,2,2
13726,30,1349,3560;12761,0,0,1,1,0,2
13727,30,1351,3567,0,0,0,0,1,1
13728,30,1352,3569;3570,0,0,0,0,2,2
13729,30,1354,3577,0,0,0,0,1,1
13730,30,1357,3581,0,0,0,0,1,1
13731,30,1359,3592,0,0,0,1,0,1
13732,30,1360,3594,0,0,0,0,1,1
13733,30,1361,3597,0,0,0,0,1,1
13734,30,1362,3599;8399,0,0,0,0,2,2
13735,30,1367,3609,0,0,0,0,1,1
13736,30,1368,3613,0,0,0,0,1,1
13737,30,1370,3618,0,0,0,0,1,1
13738,30,1371,3619;6638;10858;11111,0,0,0,4,0,4
13739,30,1373,3623;5267,0,0,0,0,2,2
13740,30,1375,3627;3829;10685,0,0,0,3,0,3
13741,30,1378,3635,0,0,0,0,1,1
13742,30,1379,3637;3638,0,0,0,0,2,2
13743,30,1383,3651;3652,0,0,0,0,2,2
13744,30,1385,3656,0,0,0,0,1,1
13745,30,1386,3657;3658,0,0,0,0,2,2
13746,30,1388,3661,0,0,0,0,1,1
13747,30,1394,3680;8546,0,0,0,0,2,2
13748,30,1395,3682,0,0,0,1,0,1
13749,30,1396,3684,0,0,0,0,1,1
13750,30,1397,3686,0,0,0,0,1,1
13751,30,1401,3697;7834,0,0,0,1,1,2
13752,30,1403,12;11670;12019,0,0,2,1,0,3
13753,30,1404,1617;3705,0,0,0,0,2,2
13754,30,1406,1068;3712,0,0,0,0,2,2
13755,30,1409,4929,0,0,0,0,1,1
13756,30,1410,3722,0,0,0,0,1,1
13757,30,1411,3724,0,0,0,0,1,1
13758,30,1412,3729,0,0,0,0,1,1
13759,30,1415,922,0,0,0,0,1,1
13760,30,1416,5117,0,0,0,1,0,1
13761,30,1417,1365;4871;10424,0,0,0,3,0,3
13762,30,1419,3745;8644,0,0,0,2,0,2
13763,30,1420,1873;3747,0,0,0,0,2,2
13764,30,1421,3753;7993;12332;13032,0,0,2,2,0,4
13765,30,1422,3754;3755,0,0,0,0,2,2
13766,30,1424,313,0,0,0,0,1,1
13767,30,1425,3761;3762;11211,0,0,0,2,1,3
13768,30,1426,3763;6659,0,0,0,2,0,2
13769,30,1427,3767;11457;11709,0,0,1,2,0,3
13770,30,1428,3769,0,0,0,0,1,1
13771,30,1430,7129;8028,0,0,0,0,2,2
13772,30,1434,3782,0,0,0,0,1,1
13773,30,1438,2943;3790,0,0,0,0,2,2
13774,30,1439,3791,0,0,0,0,1,1
13775,30,1440,3797,0,0,0,1,0,1
13776,30,1441,3800;3801;3802,0,0,0,1,2,3
13777,30,1445,3809;3810,0,0,0,0,2,2
13778,30,1448,3820,0,0,0,1,0,1
13779,30,1451,3826,0,0,0,0,1,1
13780,30,1452,3828,0,0,0,0,1,1
13781,30,1454,3836,0,0,0,0,1,1
13782,30,1455,3840,0,0,0,1,0,1
13783,30,1456,3843,0,0,0,0,1,1
13784,30,1457,3845;10537,0,0,0,2,0,2
13785,30,1458,3848;11929;12188,0,0,2,1,0,3
13786,30,1459,2326;3851,0,0,0,0,2,2
13787,30,1461,3855,0,0,0,0,1,1
13788,30,1462,3858,0,0,0,0,1,1
13789,30,1463,3862,0,0,0,0,1,1
13790,30,1465,7578,0,0,0,0,1,1
13791,30,1466,3871,0,0,0,0,1,1
13792,30,1467,3878;8691,0,0,0,0,2,2
13793,30,1468,3880;10706;11977,0,0,1,2,0,3
13794,30,1470,3883,0,0,0,1,0,1
13795,30,1471,3884;3885,0,0,0,0,2,2
13796,30,1475,2314;3893,0,0,0,0,2,2
13797,30,1476,3897,0,0,0,0,1,1
13798,30,1479,3902,0,0,0,0,1,1
13799,30,1484,3913,0,0,0,0,1,1
13800,30,1486,3918,0,0,0,0,1,1
13801,30,1491,3932,0,0,0,0,1,1
13802,30,1493,3938,0,0,0,0,1,1
13803,30,1494,3942,0,0,0,0,1,1
13804,30,1498,3953;3954,0,0,0,0,2,2
13805,30,1499,3957,0,0,0,0,1,1
13806,30,1501,3966;9152;10423,0,0,0,3,0,3
13807,30,1502,3971;3972,0,0,0,0,2,2
13808,30,1507,3982,0,0,0,0,1,1
13809,30,1508,2138;3983,0,0,0,1,1,2
13810,30,1509,3988,0,0,0,0,1,1
13811,30,1510,3989,0,0,0,0,1,1
13812,30,1511,3991,0,0,0,0,1,1
13813,30,1512,2776;3993,0,0,0,0,2,2
13814,30,1518,4009;4010,0,0,0,0,2,2
13815,30,1520,963;4013,0,0,0,0,2,2
13816,30,1521,4014;8463,0,0,0,0,2,2
13817,30,1522,4017;4605;11007,0,0,0,3,0,3
13818,30,1524,4020,0,0,0,0,1,1
13819,30,1525,4025,0,0,0,0,1,1
13820,30,1526,4027;4028,0,0,0,0,2,2
13821,30,1527,4029,0,0,0,0,1,1
13822,30,1529,5631,0,0,0,0,1,1
13823,30,1530,4036,0,0,0,0,1,1
13824,30,1531,4038;4039;10894,0,0,0,3,0,3
13825,30,1533,4041;4042,0,0,0,0,2,2
13826,30,1535,4050,0,0,0,0,1,1
13827,30,1536,4056,0,0,0,1,0,1
13828,30,1537,4058,0,0,0,0,1,1
13829,30,1538,4059,0,0,0,0,1,1
13830,30,1540,4064;4065,0,0,0,1,1,2
13831,30,1541,552;4066;11219,0,0,0,3,0,3
13832,30,1543,4072,0,0,0,0,1,1
13833,30,1548,4083;4086,0,0,0,0,2,2
13834,30,1550,1586;4088;11075,0,0,0,3,0,3
13835,30,1551,4090;4091,0,0,0,1,1,2
13836,30,1555,2762;3414,0,0,0,0,2,2
13837,30,1556,4099;4100,0,0,0,0,2,2
13838,30,1557,305;4104,0,0,0,0,2,2
13839,30,1558,4107,0,0,0,0,1,1
13840,30,1559,4110,0,0,0,0,1,1
13841,30,1562,4117,0,0,0,0,1,1
13842,30,1563,4120,0,0,0,0,1,1
13843,30,1566,4125,0,0,0,0,1,1
13844,30,1568,4128,0,0,0,0,1,1
13845,30,1570,6059,0,0,0,0,1,1
13846,30,1572,4135;4136;10826,0,0,0,2,1,3
13847,30,1573,4137,0,0,0,0,1,1
13848,30,1574,4139,0,0,0,0,1,1
13849,30,1575,4142;11731;12079,0,0,2,1,0,3
13850,30,1576,4143;4144,0,0,0,0,2,2
13851,30,1577,3019;4147;4150;4151;13068;13344,0,1,1,4,0,6
13852,30,1578,2478;4152,0,0,0,0,2,2
13853,30,1579,4153;10949,0,0,0,2,0,2
13854,30,1580,4155,0,0,0,0,1,1
13855,30,1581,4157;4158,0,0,0,0,2,2
13856,30,1582,4159,0,0,0,0,1,1
13857,30,1583,4161;4162;10214;10854,0,0,0,3,1,4
13858,30,1584,1376;8893;13322,0,1,0,2,0,3
13859,30,1587,4172;4173,0,0,0,0,2,2
13860,30,1588,4175;6607;11528,0,0,0,3,0,3
13861,30,1595,4192;4193,0,0,0,0,2,2
13862,30,1597,4195,0,0,0,0,1,1
13863,30,1599,4200,0,0,0,0,1,1
13864,30,1600,4203,0,0,0,0,1,1
13865,30,1601,4205;9103;11245;11618;12757,0,0,2,3,0,5
13866,30,1602,4206;4210,0,0,0,1,1,2
13867,30,1603,4211,0,0,0,0,1,1
13868,30,1607,4222;4223,0,0,0,0,2,2
13869,30,1608,1679;4225,0,0,0,2,0,2
13870,30,1610,3787,0,0,0,0,1,1
13871,30,1611,4231,0,0,0,0,1,1
13872,30,1614,4237,0,0,0,0,1,1
13873,30,1616,4240;4241,0,0,0,1,1,2
13874,30,1619,4247,0,0,0,0,1,1
13875,30,1621,4253;4254,0,0,0,1,1,2
13876,30,1622,4256,0,0,0,0,1,1
13877,30,1623,2220;2935,0,0,0,0,2,2
13878,30,1625,4262;5894,0,0,0,0,2,2
13879,30,1627,4268;6845;7729;11208;11226;11536;12058;12152;12165;13448,0,1,4,5,0,10
13880,30,1628,4269;4270,0,0,0,0,2,2
13881,30,1629,4278,0,0,0,0,1,1
13882,30,1630,4282,0,0,0,0,1,1
13883,30,1631,4288,0,0,0,0,1,1
13884,30,1633,401;4291;10478;10993;11358,0,0,0,5,0,5
13885,30,1634,4295;9332;12676;12861,0,0,2,2,0,4
13886,30,1635,4296;4297,0,0,0,0,2,2
13887,30,1636,4298;9988;10637,0,0,0,3,0,3
13888,30,1639,4306;5883,0,0,0,2,0,2
13889,30,1641,4310,0,0,0,0,1,1
13890,30,1643,4316;4317,0,0,0,0,2,2
13891,30,1644,4318;9995;10260,0,0,0,3,0,3
13892,30,1645,4319;8423,0,0,0,0,2,2
13893,30,1647,4323;7165,0,0,0,0,2,2
13894,30,1648,4942,0,0,0,0,1,1
13895,30,1651,4330,0,0,0,0,1,1
13896,30,1652,1187;4332,0,0,0,0,2,2
13897,30,1655,4338,0,0,0,0,1,1
13898,30,1658,4344;11210,0,0,0,2,0,2
13899,30,1659,4345;4346,0,0,0,0,2,2
13900,30,1660,4347;9126,0,0,0,0,2,2
13901,30,1665,7064,0,0,0,0,1,1
13902,30,1669,4365,0,0,0,1,0,1
13903,30,1670,4366,0,0,0,0,1,1
13904,30,1672,3210;4376,0,0,0,0,2,2
13905,30,1673,4380,0,0,0,0,1,1
13906,30,1674,1736;4382,0,0,0,0,2,2
13907,30,1675,4387,0,0,0,0,1,1
13908,30,1677,4391,0,0,0,0,1,1
13909,30,1679,9867;13008,0,0,1,1,0,2
13910,30,1680,4403,0,0,0,0,1,1
13911,30,1681,4404,0,0,0,0,1,1
13912,30,1683,4408;4409,0,0,0,0,2,2
13913,30,1687,4419;11702,0,0,1,1,0,2
13914,30,1688,4420,0,0,0,0,1,1
13915,30,1689,818;4423,0,0,0,0,2,2
13916,30,1690,4424,0,0,0,0,1,1
13917,30,1691,4427,0,0,0,0,1,1
13918,30,1694,4430,0,0,0,0,1,1
13919,30,1696,4433;4434;4436,0,0,0,2,1,3
13920,30,1697,4437,0,0,0,0,1,1
13921,30,1699,4440,0,0,0,0,1,1
13922,30,1701,4443;4445,0,0,0,0,2,2
13923,30,1702,1178;4446,0,0,0,2,0,2
13924,30,1703,4450,0,0,0,0,1,1
13925,30,1705,4454,0,0,0,0,1,1
13926,30,1706,4457;4460,0,0,0,0,2,2
13927,30,1708,2260;4463,0,0,0,0,2,2
13928,30,1710,4465,0,0,0,0,1,1
13929,30,1711,4467,0,0,0,0,1,1
13930,30,1712,4468;4469,0,0,0,0,2,2
13931,30,1713,4472;4476;10840,0,0,0,3,0,3
13932,30,1716,4483,0,0,0,0,1,1
13933,30,1719,2917;4494;10546,0,0,0,3,0,3
13934,30,1721,4498,0,0,0,0,1,1
13935,30,1722,4502,0,0,0,0,1,1
13936,30,1723,4506;11482;12437;12666,0,0,2,2,0,4
13937,30,1724,4508;9122,0,0,0,0,2,2
13938,30,1725,4516,0,0,0,1,0,1
13939,30,1727,4519,0,0,0,0,1,1
13940,30,1728,1446;4521;4523,0,0,0,1,2,3
13941,30,1729,4524;5600;11298;11506,0,0,0,4,0,4
13942,30,1730,4526;10155,0,0,0,1,1,2
13943,30,1731,4529;4530,0,0,0,0,2,2
13944,30,1736,4539,0,0,0,0,1,1
13945,30,1737,4540;4541;10354;10684,0,0,0,3,1,4
13946,30,1738,8685,0,0,0,0,1,1
13947,30,1739,4546;4547,0,0,0,0,2,2
13948,30,1742,4556;6964,0,0,0,0,2,2
13949,30,1745,4176;4561,0,0,0,0,2,2
13950,30,1746,4562;7863,0,0,0,0,2,2
13951,30,1747,4565,0,0,0,0,1,1
13952,30,1752,4578,0,0,0,0,1,1
13953,30,1753,4579,0,0,0,0,1,1
13954,30,1755,4584;4586;4587,0,0,0,2,1,3
13955,30,1756,4590,0,0,0,0,1,1
13956,30,1757,4592,0,0,0,0,1,1
13957,30,1761,4606,0,0,0,0,1,1
13958,30,1762,4609,0,0,0,0,1,1
13959,30,1763,4612;5689,0,0,0,0,2,2
13960,30,1766,4620,0,0,0,0,1,1
13961,30,1768,4626;4629,0,0,0,1,1,2
13962,30,1770,4635;4636,0,0,0,0,2,2
13963,30,1774,4645,0,0,0,1,0,1
13964,30,1775,4646;4647,0,0,0,0,2,2
13965,30,1776,3002;4650,0,0,0,0,2,2
13966,30,1777,4653;4656;7720;11479,0,0,0,4,0,4
13967,30,1778,4657;6418,0,0,0,0,2,2
13968,30,1779,4660,0,0,0,0,1,1
13969,30,1780,4661,0,0,0,0,1,1
13970,30,1783,4665,0,0,0,0,1,1
13971,30,1784,4669,0,0,0,1,0,1
13972,30,1787,4673,0,0,0,1,0,1
13973,30,1788,4676,0,0,0,0,1,1
13974,30,1789,4679,0,0,0,0,1,1
13975,30,1791,4684,0,0,0,0,1,1
13976,30,1792,4686,0,0,0,0,1,1
13977,30,1793,3005;4688;4689;10425;10677,0,0,0,5,0,5
13978,30,1794,4692;6252;8353,0,0,0,1,2,3
13979,30,1796,1049;4699;13538,0,1,0,2,0,3
13980,30,1798,4702;10248,0,0,0,1,1,2
13981,30,1800,4708;4709,0,0,0,0,2,2
13982,30,1802,4712,0,0,0,0,1,1
13983,30,1804,4717,0,0,0,0,1,1
13984,30,1805,898;4722;12146;12523;13422,0,1,2,2,0,5
13985,30,1806,4725,0,0,0,0,1,1
13986,30,1807,1613;4727,0,0,0,0,2,2
13987,30,1811,4734;9716,0,0,0,1,1,2
13988,30,1812,4738;4739,0,0,0,0,2,2
13989,30,1813,4741;4742,0,0,0,0,2,2
13990,30,1815,4746;4748;4831,0,0,0,2,1,3
13991,30,1817,4753;4754;4757,0,0,0,2,1,3
13992,30,1818,816,0,0,0,0,1,1
13993,30,1819,4760,0,0,0,0,1,1
13994,30,1821,2827;4766,0,0,0,0,2,2
13995,30,1822,4771,0,0,0,1,0,1
13996,30,1824,4774;4775,0,0,0,1,1,2
13997,30,1825,4776;9470;11740,0,0,1,2,0,3
13998,30,1826,4777;4778,0,0,0,0,2,2
13999,30,1827,4780;7651,0,0,0,2,0,2
14000,30,1832,7071,0,0,0,0,1,1
14001,30,1833,732;4787,0,0,0,0,2,2
14002,30,1834,2702;4788;10173;10589,0,0,0,4,0,4
14003,30,1835,4789,0,0,0,0,1,1
14004,30,1840,4808,0,0,0,0,1,1
14005,30,1842,4812,0,0,0,1,0,1
14006,30,1848,4824;8948,0,0,0,0,2,2
14007,30,1849,4826,0,0,0,0,1,1
14008,30,1851,4830;4832,0,0,0,2,0,2
14009,30,1852,4834;4835,0,0,0,1,1,2
14010,30,1856,4844;4845,0,0,0,1,1,2
14011,30,1858,4848;4849,0,0,0,0,2,2
14012,30,1859,4853;5245;11663;11978,0,0,2,2,0,4
14013,30,1860,4858;9544,0,0,0,0,2,2
14014,30,1861,4863,0,0,0,0,1,1
14015,30,1862,4870,0,0,0,1,0,1
14016,30,1865,1295;4878,0,0,0,0,2,2
14017,30,1866,4879;7836;10369;11133,0,0,0,4,0,4
14018,30,1869,2030;4891;5382,0,0,0,1,2,3
14019,30,1872,4899;4900,0,0,0,1,1,2
14020,30,1875,4416;4905,0,0,0,0,2,2
14021,30,1877,3553;8851,0,0,0,0,2,2
14022,30,1878,4910,0,0,0,1,0,1
14023,30,1879,4912,0,0,0,0,1,1
14024,30,1880,4913,0,0,0,0,1,1
14025,30,1882,4922;5177,0,0,0,0,2,2
14026,30,1883,4926,0,0,0,0,1,1
14027,30,1884,4931,0,0,0,1,0,1
14028,30,1885,4932;4933,0,0,0,1,1,2
14029,30,1886,4934,0,0,0,0,1,1
14030,30,1887,4936,0,0,0,0,1,1
14031,30,1889,4943;4945,0,0,0,1,1,2
14032,30,1890,4948,0,0,0,0,1,1
14033,30,1891,4951;4952,0,0,0,0,2,2
14034,30,1892,4957;4958,0,0,0,0,2,2
14035,30,1894,4965,0,0,0,0,1,1
14036,30,1896,4970,0,0,0,0,1,1
14037,30,1898,3795;4975;11389;11611,0,0,1,3,0,4
14038,30,1899,4977,0,0,0,0,1,1
14039,30,1901,4983;6434,0,0,0,2,0,2
14040,30,1903,4985;6759,0,0,0,0,2,2
14041,30,1904,4986,0,0,0,0,1,1
14042,30,1906,4991;4992,0,0,0,0,2,2
14043,30,1908,4996,0,0,0,0,1,1
14044,30,1909,308,0,0,0,0,1,1
14045,30,1912,5007,0,0,0,0,1,1
14046,30,1914,5011;5012,0,0,0,0,2,2
14047,30,1915,2839;5016;13203,0,1,0,2,0,3
14048,30,1916,5019,0,0,0,0,1,1
14049,30,1917,5022,0,0,0,0,1,1
14050,30,1919,797;6181;10493;11289;11494,0,0,0,5,0,5
14051,30,1922,5033;5034;10579,0,0,0,3,0,3
14052,30,1923,5036;8071;10238;10846;11044;11278,0,0,0,6,0,6
14053,30,1926,5041,0,0,0,0,1,1
14054,30,1927,5045;7278,0,0,0,0,2,2
14055,30,1929,5053,0,0,0,0,1,1
14056,30,1930,5055,0,0,0,0,1,1
14057,30,1933,5061,0,0,0,0,1,1
14058,30,1935,5067;5068;10818,0,0,0,3,0,3
14059,30,1937,5074,0,0,0,0,1,1
14060,30,1938,5076,0,0,0,0,1,1
14061,30,1941,5081,0,0,0,0,1,1
14062,30,1942,191;5083,0,0,0,0,2,2
14063,30,1944,5091,0,0,0,0,1,1
14064,30,1945,5093;6283,0,0,0,0,2,2
14065,30,1946,5095;9547,0,0,0,0,2,2
14066,30,1947,5099,0,0,0,0,1,1
14067,30,1948,5102;10965;11694,0,0,1,2,0,3
14068,30,1952,5108,0,0,0,0,1,1
14069,30,1954,5115,0,0,0,0,1,1
14070,30,1956,5120,0,0,0,0,1,1
14071,30,1960,5289,0,0,0,0,1,1
14072,30,1961,5127,0,0,0,0,1,1
14073,30,1962,3887;5129,0,0,0,0,2,2
14074,30,1965,5138,0,0,0,0,1,1
14075,30,1966,5140,0,0,0,0,1,1
14076,30,1967,5142,0,0,0,0,1,1
14077,30,1970,5150;5513,0,0,0,0,2,2
14078,30,1972,5155;5156,0,0,0,1,1,2
14079,30,1974,5162;5163,0,0,0,0,2,2
14080,30,1975,8702,0,0,0,0,1,1
14081,30,1978,5172;5481,0,0,0,0,2,2
14082,30,1980,699;5179,0,0,0,2,0,2
14083,30,1983,5185;5187;8159;10941;11254,0,0,0,5,0,5
14084,30,1984,5189,0,0,0,0,1,1
14085,30,1985,5194,0,0,0,0,1,1
14086,30,1986,1042;10984;11128;11789;12387,0,0,2,3,0,5
14087,30,1987,5197,0,0,0,0,1,1
14088,30,1991,5207;8430;10349,0,0,0,3,0,3
14089,30,1992,5211,0,0,0,0,1,1
14090,30,1993,5213;5215,0,0,0,0,2,2
14091,30,1994,5217;7642,0,0,0,0,2,2
14092,30,1995,5219;5221,0,0,0,0,2,2
14093,30,1996,5222,0,0,0,0,1,1
14094,30,1998,4334;5227,0,0,0,1,1,2
14095,30,1999,5229,0,0,0,0,1,1
14096,30,2001,5237,0,0,0,0,1,1
14097,30,2004,5243,0,0,0,0,1,1
14098,30,2005,5247;5249,0,0,0,2,0,2
14099,30,2006,5250;5251,0,0,0,1,1,2
14100,30,2008,5254,0,0,0,0,1,1
14101,30,2009,5256,0,0,0,0,1,1
14102,30,2010,5259,0,0,0,0,1,1
14103,30,2013,5265,0,0,0,0,1,1
14104,30,2014,5269,0,0,0,0,1,1
14105,30,2016,5271,0,0,0,0,1,1
14106,30,2017,10754,0,0,0,1,0,1
14107,30,2018,5274;5478;10346;11407,0,0,0,4,0,4
14108,30,2019,5276;5278,0,0,0,1,1,2
14109,30,2020,5279,0,0,0,0,1,1
14110,30,2021,5283,0,0,0,0,1,1
14111,30,2022,5284,0,0,0,0,1,1
14112,30,2024,5290;5291,0,0,0,1,1,2
14113,30,2025,2622;5293;10420,0,0,0,3,0,3
14114,30,2026,5294,0,0,0,0,1,1
14115,30,2028,5299,0,0,0,0,1,1
14116,30,2031,5308;5309;5311;11373,0,0,0,3,1,4
14117,30,2032,5313;6862,0,0,0,0,2,2
14118,30,2033,5315;10131;10560;10646;11447,0,0,0,5,0,5
14119,30,2034,5318,0,0,0,1,0,1
14120,30,2035,5319,0,0,0,0,1,1
14121,30,2036,368;5321;10902,0,0,0,3,0,3
14122,30,2039,5325,0,0,0,0,1,1
14123,30,2040,5331,0,0,0,1,0,1
14124,30,2041,5332;5626,0,0,0,1,1,2
14125,30,2044,5336,0,0,0,0,1,1
14126,30,2045,184;5338;10023,0,0,0,1,2,3
14127,30,2046,5339,0,0,0,0,1,1
14128,30,2047,4261;5341,0,0,0,0,2,2
14129,30,2050,3785;5346,0,0,0,0,2,2
14130,30,2054,5356;5357,0,0,0,0,2,2
14131,30,2056,5361;5362,0,0,0,0,2,2
14132,30,2057,1904;5363;11068;11824,0,0,1,3,0,4
14133,30,2058,5574,0,0,0,0,1,1
14134,30,2060,5374,0,0,0,0,1,1
14135,30,2061,5375,0,0,0,0,1,1
14136,30,2063,5383,0,0,0,0,1,1
14137,30,2064,5385;5386,0,0,0,0,2,2
14138,30,2065,3254;5388,0,0,0,2,0,2
14139,30,2066,5392;8731;10507,0,0,0,3,0,3
14140,30,2067,4675;5393;11583,0,0,1,2,0,3
14141,30,2068,3477;7143;11668;13011,0,0,2,2,0,4
14142,30,2071,4333;7797,0,0,0,1,1,2
14143,30,2072,5405,0,0,0,0,1,1
14144,30,2073,5407,0,0,0,0,1,1
14145,30,2075,5415,0,0,0,0,1,1
14146,30,2076,5416,0,0,0,0,1,1
14147,30,2078,4031;4917;10004;11061;11552,0,0,1,4,0,5
14148,30,2079,5423;5424,0,0,0,2,0,2
14149,30,2080,4927;5427;10323,0,0,0,3,0,3
14150,30,2081,5429;7673,0,0,0,0,2,2
14151,30,2082,5431,0,0,0,0,1,1
14152,30,2083,5435;9463;10406,0,0,0,1,2,3
14153,30,2086,5449,0,0,0,1,0,1
14154,30,2088,5453;6647,0,0,0,0,2,2
14155,30,2089,5454;5455,0,0,0,0,2,2
14156,30,2090,5456;5460,0,0,0,1,1,2
14157,30,2093,5463;8611,0,0,0,2,0,2
14158,30,2094,820;5465,0,0,0,1,1,2
14159,30,2096,3022;5468;10859;10960;11066,0,0,0,5,0,5
14160,30,2098,5473,0,0,0,0,1,1
14161,30,2100,5475;5476,0,0,0,1,1,2
14162,30,2103,2487;5484,0,0,0,0,2,2
14163,30,2104,5486,0,0,0,0,1,1
14164,30,2105,5488,0,0,0,0,1,1
14165,30,2106,5491,0,0,0,1,0,1
14166,30,2109,5500,0,0,0,0,1,1
14167,30,2111,5504;6493;11040,0,0,0,3,0,3
14168,30,2112,5505,0,0,0,0,1,1
14169,30,2114,279;11162;11340,0,0,0,3,0,3
14170,30,2115,5509,0,0,0,0,1,1
14171,30,2117,5515,0,0,0,0,1,1
14172,30,2118,9393;11819;12621,0,0,2,1,0,3
14173,30,2119,5520;5522,0,0,0,1,1,2
14174,30,2120,5523;5524;11055,0,0,0,2,1,3
14175,30,2122,5528;8011;10460,0,0,0,3,0,3
14176,30,2123,4866,0,0,0,0,1,1
14177,30,2124,5530,0,0,0,0,1,1
14178,30,2125,1594;5532,0,0,0,0,2,2
14179,30,2127,5535,0,0,0,0,1,1
14180,30,2131,5545,0,0,0,0,1,1
14181,30,2132,5549;10848,0,0,0,2,0,2
14182,30,2136,5560;5561,0,0,0,1,1,2
14183,30,2137,5563,0,0,0,0,1,1
14184,30,2139,5570,0,0,0,0,1,1
14185,30,2142,5578;5757;11218;11624,0,0,1,3,0,4
14186,30,2144,3508,0,0,0,0,1,1
14187,30,2148,5587;7684,0,0,0,0,2,2
14188,30,2149,5591,0,0,0,0,1,1
14189,30,2150,5592,0,0,0,0,1,1
14190,30,2151,5593;5594,0,0,0,0,2,2
14191,30,2152,5595;5596,0,0,0,0,2,2
14192,30,2154,5601,0,0,0,1,0,1
14193,30,2155,4199;9948;10700;11098,0,0,0,4,0,4
14194,30,2156,5607,0,0,0,0,1,1
14195,30,2157,5609,0,0,0,0,1,1
14196,30,2159,1246;11374;11569;11738,0,0,2,2,0,4
14197,30,2161,5618,0,0,0,0,1,1
14198,30,2162,7598,0,0,0,0,1,1
14199,30,2168,5634,0,0,0,0,1,1
14200,30,2169,5639,0,0,0,0,1,1
14201,30,2170,5640;5641;10555,0,0,0,3,0,3
14202,30,2171,2451;6827,0,0,0,2,0,2
14203,30,2173,5648;5649;10660;11317,0,0,0,3,1,4
14204,30,2174,5651,0,0,0,0,1,1
14205,30,2177,5658,0,0,0,0,1,1
14206,30,2178,5660,0,0,0,0,1,1
14207,30,2179,5503,0,0,0,0,1,1
14208,30,2181,5667;5668,0,0,0,0,2,2
14209,30,2184,5672;5673,0,0,0,0,2,2
14210,30,2186,5676;6141,0,0,0,0,2,2
14211,30,2187,5678,0,0,0,0,1,1
14212,30,2188,5680;5681,0,0,0,0,2,2
14213,30,2191,5685,0,0,0,0,1,1
14214,30,2193,5693,0,0,0,0,1,1
14215,30,2194,5694;5695,0,0,0,1,1,2
14216,30,2195,5697,0,0,0,0,1,1
14217,30,2196,3603;5702,0,0,0,0,2,2
14218,30,2198,5707;5708,0,0,0,1,1,2
14219,30,2199,5711,0,0,0,1,0,1
14220,30,2200,5713,0,0,0,0,1,1
14221,30,2201,5714,0,0,0,0,1,1
14222,30,2202,1981;5717;10539,0,0,0,3,0,3
14223,30,2206,5821,0,0,0,0,1,1
14224,30,2208,5730,0,0,0,0,1,1
14225,30,2209,4762;5732,0,0,0,0,2,2
14226,30,2210,2501;5734,0,0,0,0,2,2
14227,30,2212,3151;5745;5747;5749,0,0,0,2,2,4
14228,30,2213,2725;5754,0,0,0,0,2,2
14229,30,2215,5756;9093,0,0,0,2,0,2
14230,30,2216,5759,0,0,0,0,1,1
14231,30,2217,7966,0,0,0,1,0,1
14232,30,2218,5761,0,0,0,0,1,1
14233,30,2220,5770,0,0,0,0,1,1
14234,30,2224,5782,0,0,0,0,1,1
14235,30,2226,5787;5789,0,0,0,2,0,2
14236,30,2228,5791;6439,0,0,0,0,2,2
14237,30,2229,5795,0,0,0,0,1,1
14238,30,2230,5796,0,0,0,0,1,1
14239,30,2231,5800,0,0,0,0,1,1
14240,30,2235,7005,0,0,0,0,1,1
14241,30,2236,5807;5808,0,0,0,0,2,2
14242,30,2237,3391,0,0,0,0,1,1
14243,30,2238,5813,0,0,0,0,1,1
14244,30,2239,8279,0,0,0,0,1,1
14245,30,2243,1831;5822;10366,0,0,0,2,1,3
14246,30,2244,5823;5824,0,0,0,1,1,2
14247,30,2247,5832,0,0,0,0,1,1
14248,30,2248,5833,0,0,0,0,1,1
14249,30,2249,5835,0,0,0,0,1,1
14250,30,2252,1894;5840;11619,0,0,1,2,0,3
14251,30,2255,5845;5846,0,0,0,0,2,2
14252,30,2256,5847,0,0,0,0,1,1
14253,30,2263,5865;5866,0,0,0,0,2,2
14254,30,2264,4810;5868;5869;10453;10784;11294,0,0,0,6,0,6
14255,30,2265,5872,0,0,0,0,1,1
14256,30,2267,5877;6063,0,0,0,0,2,2
14257,30,2269,5879,0,0,0,0,1,1
14258,30,2271,5881;8230,0,0,0,0,2,2
14259,30,2274,5887;5889,0,0,0,1,1,2
14260,30,2275,5891;8181,0,0,0,0,2,2
14261,30,2278,4011;5897,0,0,0,1,1,2
14262,30,2279,5280,0,0,0,0,1,1
14263,30,2282,5909;8684,0,0,0,1,1,2
14264,30,2283,5910;5911,0,0,0,1,1,2
14265,30,2284,5912,0,0,0,0,1,1
14266,30,2285,5916,0,0,0,0,1,1
14267,30,2286,4528;5918;10908;11682,0,0,1,3,0,4
14268,30,2289,5923;6710,0,0,0,1,1,2
14269,30,2290,5913;5925;10772,0,0,0,3,0,3
14270,30,2291,5929;5930;13733,0,1,0,2,0,3
14271,30,2294,5935,0,0,0,0,1,1
14272,30,2299,5946;9269,0,0,0,0,2,2
14273,30,2300,5947,0,0,0,0,1,1
14274,30,2301,2278;5951,0,0,0,0,2,2
14275,30,2302,5633;10670,0,0,0,2,0,2
14276,30,2303,5957,0,0,0,0,1,1
14277,30,2305,28;5960;10161,0,0,0,2,1,3
14278,30,2306,5965,0,0,0,0,1,1
14279,30,2308,5975,0,0,0,0,1,1
14280,30,2311,5979;5980,0,0,0,1,1,2
14281,30,2312,5983;5984;6348,0,0,0,1,2,3
14282,30,2314,5989;10743,0,0,0,2,0,2
14283,30,2317,10070;10315;13412,0,1,0,2,0,3
14284,30,2319,6006;7676;10875,0,0,0,3,0,3
14285,30,2320,4428,0,0,0,1,0,1
14286,30,2321,2252;6008,0,0,0,0,2,2
14287,30,2322,6009,0,0,0,0,1,1
14288,30,2324,6014;6015,0,0,0,1,1,2
14289,30,2327,6023,0,0,0,0,1,1
14290,30,2331,6030;6032,0,0,0,0,2,2
14291,30,2332,6033;6034,0,0,0,0,2,2
14292,30,2333,2953;6038,0,0,0,2,0,2
14293,30,2334,2932;6039;10414,0,0,0,3,0,3
14294,30,2335,40;6041,0,0,0,0,2,2
14295,30,2336,6043;6044,0,0,0,2,0,2
14296,30,2338,4215;6046,0,0,0,1,1,2
14297,30,2341,6049;6050,0,0,0,0,2,2
14298,30,2342,5557;6052;10958,0,0,0,3,0,3
14299,30,2343,1537;6055;6056;11428;11984,0,0,1,4,0,5
14300,30,2344,2585,0,0,0,0,1,1
14301,30,2347,6061,0,0,0,0,1,1
14302,30,2349,6065;8838,0,0,0,1,1,2
14303,30,2350,3180;6069,0,0,0,0,2,2
14304,30,2353,6077;9250;10824,0,0,0,1,2,3
14305,30,2354,6080,0,0,0,0,1,1
14306,30,2357,6090,0,0,0,0,1,1
14307,30,2358,3280;6091,0,0,0,0,2,2
14308,30,2359,6092,0,0,0,0,1,1
14309,30,2360,6094,0,0,0,0,1,1
14310,30,2361,6095;6096,0,0,0,0,2,2
14311,30,2362,6098,0,0,0,1,0,1
14312,30,2363,6100,0,0,0,0,1,1
14313,30,2365,6105,0,0,0,0,1,1
14314,30,2366,1515;6111;7964;12161,0,0,1,3,0,4
14315,30,2367,6113;7312,0,0,0,0,2,2
14316,30,2368,6115,0,0,0,0,1,1
14317,30,2369,6121,0,0,0,0,1,1
14318,30,2370,6123,0,0,0,0,1,1
14319,30,2371,6126,0,0,0,0,1,1
14320,30,2372,6129,0,0,0,0,1,1
14321,30,2373,282,0,0,0,0,1,1
14322,30,2375,7973,0,0,0,0,1,1
14323,30,2379,6891,0,0,0,0,1,1
14324,30,2381,6239;11306;12002;12442,0,0,2,2,0,4
14325,30,2383,6149,0,0,0,1,0,1
14326,30,2384,6150;11273;11642,0,0,1,2,0,3
14327,30,2385,6153,0,0,0,0,1,1
14328,30,2387,6160;6161,0,0,0,0,2,2
14329,30,2389,2559;6166;10857;11599;11972,0,0,2,3,0,5
14330,30,2390,6168,0,0,0,0,1,1
14331,30,2392,330;6174;11434,0,0,0,3,0,3
14332,30,2393,6175,0,0,0,0,1,1
14333,30,2395,6180,0,0,0,1,0,1
14334,30,2398,6190,0,0,0,0,1,1
14335,30,2399,6394;11804,0,0,1,1,0,2
14336,30,2401,9529,0,0,0,0,1,1
14337,30,2403,6204;8231,0,0,0,2,0,2
14338,30,2404,6206;7288,0,0,0,0,2,2
14339,30,2405,266;6209,0,0,0,0,2,2
14340,30,2406,5461;6213,0,0,0,0,2,2
14341,30,2407,6214;7287,0,0,0,0,2,2
14342,30,2408,6216;10758,0,0,0,2,0,2
14343,30,2410,6224,0,0,0,0,1,1
14344,30,2413,6229;8393;11490,0,0,0,3,0,3
14345,30,2414,6233,0,0,0,1,0,1
14346,30,2415,6234,0,0,0,0,1,1
14347,30,2418,7587;10906;11158,0,0,0,2,1,3
14348,30,2419,361,0,0,0,1,0,1
14349,30,2420,6248,0,0,0,0,1,1
14350,30,2427,6266;7188,0,0,0,0,2,2
14351,30,2429,6272,0,0,0,1,0,1
14352,30,2430,6273;6274,0,0,0,0,2,2
14353,30,2431,3700;5603;6277;11423;11571;11605;11693;12956,0,0,4,4,0,8
14354,30,2432,6279,0,0,0,0,1,1
14355,30,2434,120;6290;13286;13409,0,2,0,2,0,4
14356,30,2436,4966;6292,0,0,0,0,2,2
14357,30,2439,6300;6301,0,0,0,0,2,2
14358,30,2441,4916,0,0,0,0,1,1
14359,30,2444,6315,0,0,0,0,1,1
14360,30,2445,6317;6319,0,0,0,2,0,2
14361,30,2446,6320;6321,0,0,0,1,1,2
14362,30,2448,6327,0,0,0,0,1,1
14363,30,2449,6328,0,0,0,0,1,1
14364,30,2451,3554;6333;6335;6336,0,0,0,2,2,4
14365,30,2453,6340;6341;6342,0,0,0,1,2,3
14366,30,2456,6349;6350,0,0,0,0,2,2
14367,30,2457,6351,0,0,0,1,0,1
14368,30,2458,6355,0,0,0,0,1,1
14369,30,2459,6356,0,0,0,0,1,1
14370,30,2460,6360,0,0,0,0,1,1
14371,30,2461,6362,0,0,0,0,1,1
14372,30,2463,5941;6366;10964;11495,0,0,0,4,0,4
14373,30,2464,6368;6369,0,0,0,1,1,2
14374,30,2466,2718;6374,0,0,0,0,2,2
14375,30,2468,6378;6379,0,0,0,2,0,2
14376,30,2469,9359,0,0,0,0,1,1
14377,30,2470,6381;7846,0,0,0,0,2,2
14378,30,2471,4613;6383,0,0,0,2,0,2
14379,30,2472,6384,0,0,0,1,0,1
14380,30,2473,6385,0,0,0,0,1,1
14381,30,2475,6391,0,0,0,0,1,1
14382,30,2477,6395,0,0,0,0,1,1
14383,30,2479,5849;6408,0,0,0,2,0,2
14384,30,2480,6410,0,0,0,0,1,1
14385,30,2485,937;6419,0,0,0,0,2,2
14386,30,2486,3212;6423,0,0,0,2,0,2
14387,30,2489,6429,0,0,0,0,1,1
14388,30,2490,6431;10116,0,0,0,2,0,2
14389,30,2491,6433,0,0,0,0,1,1
14390,30,2495,6067;6441;11105,0,0,0,3,0,3
14391,30,2496,6446;8367,0,0,0,1,1,2
14392,30,2497,6448,0,0,0,1,0,1
14393,30,2498,6450,0,0,0,1,0,1
14394,30,2499,6457;6458,0,0,0,1,1,2
14395,30,2500,6459;6460,0,0,0,0,2,2
14396,30,2503,1026;6470;13102;13509,0,2,0,2,0,4
14397,30,2507,3908,0,0,0,0,1,1
14398,30,2508,6477;6478,0,0,0,0,2,2
14399,30,2509,6481;8635;8920,0,0,0,1,2,3
14400,30,2511,6484,0,0,0,0,1,1
14401,30,2512,6485,0,0,0,0,1,1
14402,30,2513,6488;6490,0,0,0,1,1,2
14403,30,2514,6492;6494,0,0,0,1,1,2
14404,30,2515,6496,0,0,0,0,1,1
14405,30,2516,1420;6497,0,0,0,0,2,2
14406,30,2517,6499,0,0,0,0,1,1
14407,30,2518,6501,0,0,0,0,1,1
14408,30,2519,5438;10929;11002,0,0,0,3,0,3
14409,30,2520,6505;6599,0,0,0,0,2,2
14410,30,2521,4668;6506,0,0,0,2,0,2
14411,30,2527,6519;7638,0,0,0,1,1,2
14412,30,2528,6521,0,0,0,0,1,1
14413,30,2529,6523,0,0,0,0,1,1
14414,30,2531,6532,0,0,0,0,1,1
14415,30,2532,6534,0,0,0,0,1,1
14416,30,2534,6540,0,0,0,0,1,1
14417,30,2539,6552;6554,0,0,0,1,1,2
14418,30,2541,6563,0,0,0,0,1,1
14419,30,2542,2443;5906,0,0,0,2,0,2
14420,30,2543,2737;6565,0,0,0,0,2,2
14421,30,2545,6569,0,0,0,0,1,1
14422,30,2546,6570,0,0,0,0,1,1
14423,30,2547,767,0,0,0,0,1,1
14424,30,2551,3732,0,0,0,0,1,1
14425,30,2554,6585,0,0,0,1,0,1
14426,30,2555,6590;6591,0,0,0,0,2,2
14427,30,2556,6593,0,0,0,0,1,1
14428,30,2558,6597,0,0,0,0,1,1
14429,30,2563,6610;6611,0,0,0,0,2,2
14430,30,2565,6614;6746,0,0,0,0,2,2
14431,30,2569,3699;6628;11945;12645;12909,0,0,3,2,0,5
14432,30,2570,1071;6630,0,0,0,0,2,2
14433,30,2574,6643;7701,0,0,0,2,0,2
14434,30,2577,6650,0,0,0,0,1,1
14435,30,2579,6657;6658,0,0,0,0,2,2
14436,30,2580,3510,0,0,0,0,1,1
14437,30,2581,6663;7416;11025,0,0,0,3,0,3
14438,30,2583,6666;6667;6668,0,0,0,0,3,3
14439,30,2584,6669,0,0,0,0,1,1
14440,30,2589,6680;6681,0,0,0,1,1,2
14441,30,2590,3714,0,0,0,0,1,1
14442,30,2591,6685,0,0,0,0,1,1
14443,30,2592,6686;6687,0,0,0,0,2,2
14444,30,2593,6690;6691,0,0,0,0,2,2
14445,30,2595,324;6697;10336,0,0,0,3,0,3
14446,30,2596,6707,0,0,0,1,0,1
14447,30,2601,6716,0,0,0,0,1,1
14448,30,2603,6725;6726,0,0,0,0,2,2
14449,30,2604,6730,0,0,0,1,0,1
14450,30,2606,6737,0,0,0,1,0,1
14451,30,2607,6739,0,0,0,0,1,1
14452,30,2608,3083;6741,0,0,0,0,2,2
14453,30,2611,6749,0,0,0,0,1,1
14454,30,2612,6752;6753,0,0,0,0,2,2
14455,30,2613,3563;6754,0,0,0,0,2,2
14456,30,2615,4362,0,0,0,0,1,1
14457,30,2617,6762,0,0,0,0,1,1
14458,30,2618,2688;6766,0,0,0,1,1,2
14459,30,2623,6776;6777,0,0,0,0,2,2
14460,30,2624,6779,0,0,0,0,1,1
14461,30,2626,6788;8395;10819,0,0,0,2,1,3
14462,30,2629,6795,0,0,0,0,1,1
14463,30,2631,6802,0,0,0,1,0,1
14464,30,2632,6803;6804,0,0,0,0,2,2
14465,30,2637,6813,0,0,0,0,1,1
14466,30,2638,6816;11847;12119;12333,0,0,3,1,0,4
14467,30,2640,6822,0,0,0,0,1,1
14468,30,2641,6824,0,0,0,0,1,1
14469,30,2643,6829;10565,0,0,0,2,0,2
14470,30,2645,6832,0,0,0,0,1,1
14471,30,2646,6834;6838,0,0,0,1,1,2
14472,30,2648,6848;6849;13052;13132;13579,0,2,1,2,0,5
14473,30,2650,6853,0,0,0,1,0,1
14474,30,2651,9460,0,0,0,0,1,1
14475,30,2652,943;6860,0,0,0,0,2,2
14476,30,2655,6871,0,0,0,0,1,1
14477,30,2656,6872,0,0,0,0,1,1
14478,30,2660,6883,0,0,0,0,1,1
14479,30,2666,6896,0,0,0,0,1,1
14480,30,2670,8228,0,0,0,0,1,1
14481,30,2672,6907,0,0,0,0,1,1
14482,30,2673,6909,0,0,0,0,1,1
14483,30,2674,6912;6913,0,0,0,0,2,2
14484,30,2675,1683;6915,0,0,0,1,1,2
14485,30,2676,6917,0,0,0,0,1,1
14486,30,2678,3260;6924,0,0,0,0,2,2
14487,30,2680,6926,0,0,0,0,1,1
14488,30,2681,1541;6928,0,0,0,0,2,2
14489,30,2683,6931;6932,0,0,0,1,1,2
14490,30,2684,6934,0,0,0,0,1,1
14491,30,2687,6943,0,0,0,0,1,1
14492,30,2689,6945;6946,0,0,0,0,2,2
14493,30,2690,6254;6952;10159,0,0,0,3,0,3
14494,30,2692,6958,0,0,0,0,1,1
14495,30,2693,4410;6959,0,0,0,0,2,2
14496,30,2694,6961;9886,0,0,0,0,2,2
14497,30,2697,3495;6965,0,0,0,0,2,2
14498,30,2698,834;5534,0,0,0,0,2,2
14499,30,2699,6968;6969;10943;11499,0,0,0,4,0,4
14500,30,2701,6976,0,0,0,0,1,1
14501,30,2702,6978,0,0,0,1,0,1
14502,30,2703,6979,0,0,0,0,1,1
14503,30,2704,6985;11576,0,0,1,1,0,2
14504,30,2705,6987;6988;6990,0,0,0,2,1,3
14505,30,2706,6992;6994,0,0,0,0,2,2
14506,30,2708,6998,0,0,0,0,1,1
14507,30,2709,7002,0,0,0,0,1,1
14508,30,2715,7018,0,0,0,0,1,1
14509,30,2716,7023,0,0,0,0,1,1
14510,30,2717,4178;7026,0,0,0,0,2,2
14511,30,2718,5953;7028,0,0,0,2,0,2
14512,30,2719,7036,0,0,0,1,0,1
14513,30,2720,7040,0,0,0,1,0,1
14514,30,2722,7043;7044,0,0,0,1,1,2
14515,30,2723,6007;7045;10524;10576,0,0,0,4,0,4
14516,30,2725,7047;7048;11357,0,0,0,2,1,3
14517,30,2726,9190,0,0,0,0,1,1
14518,30,2728,7055,0,0,0,0,1,1
14519,30,2729,7057,0,0,0,0,1,1
14520,30,2730,7059,0,0,0,0,1,1
14521,30,2731,7061,0,0,0,0,1,1
14522,30,2732,7063,0,0,0,0,1,1
14523,30,2737,7082,0,0,0,0,1,1
14524,30,2739,7085,0,0,0,0,1,1
14525,30,2741,5801;7089,0,0,0,0,2,2
14526,30,2742,7090;7091,0,0,0,1,1,2
14527,30,2743,7092,0,0,0,0,1,1
14528,30,2744,7094;8357;10774;11988,0,0,1,3,0,4
14529,30,2745,7096;7098;8120;10751,0,0,0,4,0,4
14530,30,2746,2372;7101;12817;12946;13405,0,1,2,2,0,5
14531,30,2748,1273;7104,0,0,0,0,2,2
14532,30,2750,7111;7112,0,0,0,1,1,2
14533,30,2751,7113,0,0,0,0,1,1
14534,30,2753,7120,0,0,0,0,1,1
14535,30,2754,7122;7124,0,0,0,0,2,2
14536,30,2758,914;7133,0,0,0,0,2,2
14537,30,2759,2913;7135;10163;10867;11345,0,0,0,5,0,5
14538,30,2761,7139;7140,0,0,0,1,1,2
14539,30,2763,7147,0,0,0,0,1,1
14540,30,2764,7151;8592;12038;13038,0,0,2,2,0,4
14541,30,2765,7153;8362,0,0,0,0,2,2
14542,30,2766,7154;7157;7158,0,0,0,2,1,3
14543,30,2769,7162;10727,0,0,0,2,0,2
14544,30,2770,5582;10500;11349;11956,0,0,1,3,0,4
14545,30,2772,1176;7167,0,0,0,2,0,2
14546,30,2773,7169,0,0,0,0,1,1
14547,30,2776,7179,0,0,0,1,0,1
14548,30,2780,4356,0,0,0,0,1,1
14549,30,2782,5123,0,0,0,0,1,1
14550,30,2784,7196,0,0,0,0,1,1
14551,30,2785,7198;7199,0,0,0,1,1,2
14552,30,2787,3502;7203;11649;11930;12294;13206,0,1,3,2,0,6
14553,30,2788,7204,0,0,0,0,1,1
14554,30,2789,7208,0,0,0,0,1,1
14555,30,2791,5183;6648,0,0,0,0,2,2
14556,30,2792,7214,0,0,0,0,1,1
14557,30,2796,7225,0,0,0,0,1,1
14558,30,2797,7228;7229,0,0,0,1,1,2
14559,30,2799,6745,0,0,0,0,1,1
14560,30,2800,7233,0,0,0,0,1,1
14561,30,2802,7241;9495;10107;11136,0,0,0,4,0,4
14562,30,2803,7242,0,0,0,0,1,1
14563,30,2807,7250,0,0,0,0,1,1
14564,30,2809,7252;7253;11586;12034,0,0,2,1,1,4
14565,30,2811,6622;7258,0,0,0,0,2,2
14566,30,2814,7263,0,0,0,0,1,1
14567,30,2815,7266,0,0,0,0,1,1
14568,30,2816,7268,0,0,0,0,1,1
14569,30,2817,2663;7269,0,0,0,0,2,2
14570,30,2818,7270,0,0,0,0,1,1
14571,30,2819,7273;7274,0,0,0,1,1,2
14572,30,2820,6524;7277;11087,0,0,0,3,0,3
14573,30,2821,7279,0,0,0,0,1,1
14574,30,2822,7281,0,0,0,0,1,1
14575,30,2823,7284,0,0,0,0,1,1
14576,30,2827,7295,0,0,0,1,0,1
14577,30,2830,5037;7299,0,0,0,0,2,2
14578,30,2832,7305,0,0,0,0,1,1
14579,30,2836,1460;7318,0,0,0,0,2,2
14580,30,2838,7320;7322,0,0,0,1,1,2
14581,30,2839,7325;10005;11094,0,0,0,3,0,3
14582,30,2842,5752;7333,0,0,0,0,2,2
14583,30,2845,7337,0,0,0,0,1,1
14584,30,2846,7338,0,0,0,0,1,1
14585,30,2848,7348,0,0,0,0,1,1
14586,30,2850,7351,0,0,0,0,1,1
14587,30,2851,3382;7355;11840,0,0,1,2,0,3
14588,30,2853,7358;7360,0,0,0,0,2,2
14589,30,2854,7362,0,0,0,0,1,1
14590,30,2855,597;7364,0,0,0,0,2,2
14591,30,2862,7380,0,0,0,0,1,1
14592,30,2863,7384;11127,0,0,0,2,0,2
14593,30,2864,1353;7386,0,0,0,0,2,2
14594,30,2865,7387,0,0,0,0,1,1
14595,30,2867,7392;7395,0,0,0,1,1,2
14596,30,2869,8828;8890,0,0,0,2,0,2
14597,30,2870,7400;7401;7405,0,0,0,2,1,3
14598,30,2871,7406;10235;10446;12010,0,0,1,3,0,4
14599,30,2872,7407,0,0,0,0,1,1
14600,30,2874,7415,0,0,0,0,1,1
14601,30,2875,680;10934,0,0,0,2,0,2
14602,30,2878,7427,0,0,0,0,1,1
14603,30,2879,1948;7429;10987;11187;11510,0,0,0,5,0,5
14604,30,2882,7438;7440,0,0,0,1,1,2
14605,30,2883,7442;7445,0,0,0,1,1,2
14606,30,2885,1622;6238;7449;12743;12988,0,0,2,2,1,5
14607,30,2887,7453,0,0,0,1,0,1
14608,30,2891,7458;7459,0,0,0,0,2,2
14609,30,2893,7467,0,0,0,0,1,1
14610,30,2894,7468,0,0,0,0,1,1
14611,30,2895,2324;8772,0,0,0,0,2,2
14612,30,2896,5644;7472;10128;11232,0,0,0,4,0,4
14613,30,2899,7457;7480,0,0,0,0,2,2
14614,30,2900,7482;8537;8539;10345,0,0,0,4,0,4
14615,30,2902,7486;7487,0,0,0,0,2,2
14616,30,2903,7489;7490,0,0,0,1,1,2
14617,30,2905,7672;8590;11308;11545;12033;12520,0,0,3,3,0,6
14618,30,2906,7497,0,0,0,1,0,1
14619,30,2907,7501;10049,0,0,0,2,0,2
14620,30,2908,7504;7809,0,0,0,2,0,2
14621,30,2912,7514,0,0,0,0,1,1
14622,30,2915,2634;7526;11137,0,0,0,3,0,3
14623,30,2916,7529,0,0,0,1,0,1
14624,30,2919,7536;7539;9666;12202;12569,0,0,2,2,1,5
14625,30,2920,7540;8158,0,0,0,0,2,2
14626,30,2921,7541;9271,0,0,0,2,0,2
14627,30,2925,2855;7555,0,0,0,2,0,2
14628,30,2926,7556,0,0,0,0,1,1
14629,30,2927,7560,0,0,0,0,1,1
14630,30,2930,7566,0,0,0,0,1,1
14631,30,2933,7574,0,0,0,0,1,1
14632,30,2938,7586,0,0,0,0,1,1
14633,30,2940,1346;7589,0,0,0,0,2,2
14634,30,2941,7591,0,0,0,0,1,1
14635,30,2942,7594;7596,0,0,0,1,1,2
14636,30,2944,5875;7599,0,0,0,1,1,2
14637,30,2945,7602,0,0,0,0,1,1
14638,30,2947,7606;7607;10948,0,0,0,2,1,3
14639,30,2949,7610,0,0,0,0,1,1
14640,30,2950,1264;7613,0,0,0,2,0,2
14641,30,2952,7619;7622,0,0,0,1,1,2
14642,30,2954,7627,0,0,0,1,0,1
14643,30,2956,7631,0,0,0,0,1,1
14644,30,2960,6881;7641,0,0,0,0,2,2
14645,30,2962,7646,0,0,0,0,1,1
14646,30,2963,7647,0,0,0,0,1,1
14647,30,2965,2130;8609;10936,0,0,0,3,0,3
14648,30,2966,7562;7652,0,0,0,0,2,2
14649,30,2967,7655,0,0,0,0,1,1
14650,30,2968,7660,0,0,0,0,1,1
14651,30,2969,7178;7664,0,0,0,1,1,2
14652,30,2970,7666,0,0,0,0,1,1
14653,30,2972,7668,0,0,0,0,1,1
14654,30,2973,7674,0,0,0,0,1,1
14655,30,2975,7680,0,0,0,0,1,1
14656,30,2981,7695,0,0,0,0,1,1
14657,30,2982,7700;10916,0,0,0,2,0,2
14658,30,2983,4171;7702,0,0,0,0,2,2
14659,30,2985,7707;7708;7709,0,0,0,2,1,3
14660,30,2986,4954;7711,0,0,0,2,0,2
14661,30,2989,7716;7717,0,0,0,0,2,2
14662,30,2990,7379;7718,0,0,0,0,2,2
14663,30,2997,7737;7738,0,0,0,1,1,2
14664,30,2998,7741,0,0,0,0,1,1
14665,30,2999,7743,0,0,0,0,1,1
14666,30,3000,4248;7745,0,0,0,0,2,2
14667,30,3002,7751,0,0,0,0,1,1
14668,30,3004,3898;7755,0,0,0,0,2,2
14669,30,3006,7757,0,0,0,0,1,1
14670,30,3008,7760,0,0,0,0,1,1
14671,30,3009,4960,0,0,0,1,0,1
14672,30,3011,7769,0,0,0,0,1,1
14673,30,3013,7771;11703,0,0,1,0,1,2
14674,30,3014,7774,0,0,0,0,1,1
14675,30,3015,7775,0,0,0,0,1,1
14676,30,3016,7779,0,0,0,0,1,1
14677,30,3017,7782,0,0,0,0,1,1
14678,30,3021,1166;7792;11330,0,0,0,3,0,3
14679,30,3022,7793;10115;13230;13739,0,2,0,2,0,4
14680,30,3023,7795,0,0,0,0,1,1
14681,30,3025,6332;7798,0,0,0,1,1,2
14682,30,3026,7174;9106,0,0,0,0,2,2
14683,30,3027,7805,0,0,0,0,1,1
14684,30,3028,4507;7807,0,0,0,2,0,2
14685,30,3030,7814,0,0,0,0,1,1
14686,30,3031,7817,0,0,0,0,1,1
14687,30,3032,7821,0,0,0,0,1,1
14688,30,3033,7823;7824,0,0,0,0,2,2
14689,30,3036,7832,0,0,0,0,1,1
14690,30,3039,7840,0,0,0,0,1,1
14691,30,3041,2076;7847,0,0,0,0,2,2
14692,30,3042,7850,0,0,0,0,1,1
14693,30,3045,7854;8753;10882;11449,0,0,0,4,0,4
14694,30,3046,5527;7857,0,0,0,0,2,2
14695,30,3051,7869,0,0,0,0,1,1
14696,30,3052,7875,0,0,0,1,0,1
14697,30,3053,2001,0,0,0,0,1,1
14698,30,3054,1516;7878,0,0,0,2,0,2
14699,30,3055,7879,0,0,0,0,1,1
14700,30,3056,1334;13200;13640;13691,0,3,0,1,0,4
14701,30,3057,380;7883,0,0,0,0,2,2
14702,30,3060,7887;7888,0,0,0,0,2,2
14703,30,3061,7892;7893,0,0,0,1,1,2
14704,30,3063,7898,0,0,0,0,1,1
14705,30,3064,2652;7901,0,0,0,0,2,2
14706,30,3065,3629;7903,0,0,0,2,0,2
14707,30,3067,7907;9431;11014;11236;11654,0,0,1,4,0,5
14708,30,3069,7910;7911,0,0,0,0,2,2
14709,30,3070,7075;7915;11307,0,0,0,3,0,3
14710,30,3071,7916;8751,0,0,0,1,1,2
14711,30,3072,2017;7920;11279,0,0,0,3,0,3
14712,30,3075,7928;7929,0,0,0,1,1,2
14713,30,3079,7938,0,0,0,0,1,1
14714,30,3080,7940;7943,0,0,0,0,2,2
14715,30,3081,5113;7946;7947;10013;13226;13768,0,2,0,4,0,6
14716,30,3082,7948;7949;11126,0,0,0,2,1,3
14717,30,3083,7950;7951;10263,0,0,0,1,2,3
14718,30,3084,7952,0,0,0,0,1,1
14719,30,3088,7958;7959,0,0,0,0,2,2
14720,30,3091,7967,0,0,0,0,1,1
14721,30,3092,7971;7972,0,0,0,1,1,2
14722,30,3093,7974,0,0,0,0,1,1
14723,30,3095,7977,0,0,0,0,1,1
14724,30,3096,7980,0,0,0,0,1,1
14725,30,3098,7984,0,0,0,0,1,1
14726,30,3099,4395;7986;11574,0,0,1,2,0,3
14727,30,3100,7987;11485;11753;12171,0,0,2,2,0,4
14728,30,3101,7991;8659,0,0,0,0,2,2
14729,30,3102,6326;7996;10799,0,0,0,3,0,3
14730,30,3107,8007;9143,0,0,0,0,2,2
14731,30,3108,8009,0,0,0,0,1,1
14732,30,3109,844;8580;10729;10981;11994,0,0,1,4,0,5
14733,30,3112,8018;8019;9295;10355,0,0,0,4,0,4
14734,30,3113,8023,0,0,0,0,1,1
14735,30,3114,8029,0,0,0,0,1,1
14736,30,3115,8032,0,0,0,0,1,1
14737,30,3116,8036;8040,0,0,0,1,1,2
14738,30,3117,8041,0,0,0,0,1,1
14739,30,3120,8048,0,0,0,0,1,1
14740,30,3122,1105;8056,0,0,0,0,2,2
14741,30,3123,8058,0,0,0,0,1,1
14742,30,3126,4116;8064,0,0,0,0,2,2
14743,30,3127,8066,0,0,0,0,1,1
14744,30,3128,556,0,0,0,0,1,1
14745,30,3130,8072;8073,0,0,0,0,2,2
14746,30,3132,8076;9826,0,0,0,2,0,2
14747,30,3136,8084,0,0,0,0,1,1
14748,30,3137,8085;8086;10404;10615;10691;11155;11713,0,0,1,6,0,7
14749,30,3139,8091,0,0,0,0,1,1
14750,30,3141,8094;8096,0,0,0,0,2,2
14751,30,3142,8098;10938,0,0,0,2,0,2
14752,30,3144,8103,0,0,0,0,1,1
14753,30,3145,5612;8104,0,0,0,0,2,2
14754,30,3146,8105,0,0,0,0,1,1
14755,30,3147,8108;11796,0,0,1,1,0,2
14756,30,3148,7213;8112,0,0,0,0,2,2
14757,30,3150,8118,0,0,0,0,1,1
14758,30,3151,2759;5653;11131,0,0,0,3,0,3
14759,30,3152,8126;8127,0,0,0,0,2,2
14760,30,3153,8128;8129;10156;10456;10689,0,0,0,4,1,5
14761,30,3154,4134;8131,0,0,0,1,1,2
14762,30,3155,7583,0,0,0,0,1,1
14763,30,3157,8138;8139,0,0,0,1,1,2
14764,30,3158,2486;3668;10543,0,0,0,3,0,3
14765,30,3159,8143;8146,0,0,0,2,0,2
14766,30,3160,3688;3690;8147;8150;10153,0,0,0,5,0,5
14767,30,3162,8155,0,0,0,0,1,1
14768,30,3163,8156;10628;11408;11748,0,0,1,3,0,4
14769,30,3165,8160,0,0,0,0,1,1
14770,30,3167,8162,0,0,0,0,1,1
14771,30,3168,8166;10133,0,0,0,2,0,2
14772,30,3170,8174,0,0,0,0,1,1
14773,30,3172,7658;8179,0,0,0,0,2,2
14774,30,3176,7693,0,0,0,0,1,1
14775,30,3178,8193;8194,0,0,0,1,1,2
14776,30,3179,8196,0,0,0,0,1,1
14777,30,3180,8199;8200,0,0,0,0,2,2
14778,30,3182,8203;9528,0,0,0,0,2,2
14779,30,3183,8205,0,0,0,0,1,1
14780,30,3186,8210,0,0,0,0,1,1
14781,30,3188,8212,0,0,0,0,1,1
14782,30,3189,3718;11467,0,0,0,2,0,2
14783,30,3190,8215,0,0,0,0,1,1
14784,30,3192,8223,0,0,0,0,1,1
14785,30,3193,6588,0,0,0,1,0,1
14786,30,3194,8227;8229,0,0,0,0,2,2
14787,30,3198,8235;8236,0,0,0,1,1,2
14788,30,3199,8239;9412;11742,0,0,1,2,0,3
14789,30,3201,8241,0,0,0,1,0,1
14790,30,3202,5285;8243;11065,0,0,0,2,1,3
14791,30,3204,1945;8245,0,0,0,1,1,2
14792,30,3205,8247;8248;10761,0,0,0,2,1,3
14793,30,3206,8250;8251,0,0,0,1,1,2
14794,30,3210,8259,0,0,0,0,1,1
14795,30,3212,1596;8263;10021,0,0,0,3,0,3
14796,30,3214,8266;8267,0,0,0,2,0,2
14797,30,3216,8275;8276,0,0,0,1,1,2
14798,30,3218,8281,0,0,0,0,1,1
14799,30,3219,2212;5902,0,0,0,0,2,2
14800,30,3220,8289,0,0,0,0,1,1
14801,30,3222,8296,0,0,0,0,1,1
14802,30,3223,8298;9576,0,0,0,0,2,2
14803,30,3224,8299,0,0,0,0,1,1
14804,30,3225,8300,0,0,0,0,1,1
14805,30,3227,8304;8305;8306,0,0,0,2,1,3
14806,30,3228,8309,0,0,0,0,1,1
14807,30,3232,8321;8323,0,0,0,1,1,2
14808,30,3234,8327,0,0,0,0,1,1
14809,30,3235,8329,0,0,0,0,1,1
14810,30,3236,8334;11424,0,0,0,2,0,2
14811,30,3237,2189;8337;11060;11181;12184,0,0,1,4,0,5
14812,30,3238,8340;9429;10452,0,0,0,3,0,3
14813,30,3239,8342,0,0,0,0,1,1
14814,30,3240,8344;8345,0,0,0,1,1,2
14815,30,3243,8350;10675;11430;11805,0,0,1,3,0,4
14816,30,3245,8355,0,0,0,0,1,1
14817,30,3248,8359,0,0,0,0,1,1
14818,30,3250,8366,0,0,0,0,1,1
14819,30,3251,4077,0,0,0,0,1,1
14820,30,3252,8371,0,0,0,0,1,1
14821,30,3253,8373,0,0,0,0,1,1
14822,30,3255,8380,0,0,0,0,1,1
14823,30,3256,2379,0,0,0,0,1,1
14824,30,3258,5959;8387;10771;10891;11314,0,0,0,5,0,5
14825,30,3259,8390,0,0,0,0,1,1
14826,30,3260,2825;11313;11439;12307,0,0,1,3,0,4
14827,30,3261,858;2506,0,0,0,0,2,2
14828,30,3262,2687,0,0,0,0,1,1
14829,30,3264,150;8404,0,0,0,0,2,2
14830,30,3267,8414,0,0,0,0,1,1
14831,30,3268,8415;8416,0,0,0,0,2,2
14832,30,3269,8419,0,0,0,0,1,1
14833,30,3270,8422,0,0,0,0,1,1
14834,30,3271,8426;8427;11209,0,0,0,2,1,3
14835,30,3274,95;8433,0,0,0,0,2,2
14836,30,3275,8434,0,0,0,0,1,1
14837,30,3277,8438,0,0,0,0,1,1
14838,30,3279,8441;8442;8658,0,0,0,1,2,3
14839,30,3280,8444,0,0,0,0,1,1
14840,30,3281,8448,0,0,0,0,1,1
14841,30,3282,7474;8450,0,0,0,2,0,2
14842,30,3283,8452,0,0,0,0,1,1
14843,30,3285,8459,0,0,0,0,1,1
14844,30,3286,8460,0,0,0,0,1,1
14845,30,3287,8462,0,0,0,0,1,1
14846,30,3288,8464;10392;11502,0,0,0,3,0,3
14847,30,3289,8467;8468,0,0,0,0,2,2
14848,30,3290,8471,0,0,0,0,1,1
14849,30,3291,8475,0,0,0,0,1,1
14850,30,3295,8485,0,0,0,0,1,1
14851,30,3297,8495;8496,0,0,0,0,2,2
14852,30,3298,8500,0,0,0,0,1,1
14853,30,3299,8503,0,0,0,0,1,1
14854,30,3301,8506;9080,0,0,0,0,2,2
14855,30,3303,8509,0,0,0,1,0,1
14856,30,3304,8510;8511,0,0,0,0,2,2
14857,30,3305,6162;8515,0,0,0,1,1,2
14858,30,3312,8531,0,0,0,0,1,1
14859,30,3314,8533,0,0,0,0,1,1
14860,30,3316,8540;8542,0,0,0,2,0,2
14861,30,3318,8551,0,0,0,1,0,1
14862,30,3319,271;8554;11240;11610;11853,0,0,2,3,0,5
14863,30,3320,593;8557,0,0,0,0,2,2
14864,30,3321,8558,0,0,0,0,1,1
14865,30,3323,5353;8564;8565,0,0,0,2,1,3
14866,30,3324,8569,0,0,0,0,1,1
14867,30,3330,8579,0,0,0,0,1,1
14868,30,3332,449;8582,0,0,0,0,2,2
14869,30,3333,6048;8585,0,0,0,0,2,2
14870,30,3335,8588,0,0,0,0,1,1
14871,30,3336,8593,0,0,0,0,1,1
14872,30,3338,8599;8600,0,0,0,0,2,2
14873,30,3341,8607,0,0,0,0,1,1
14874,30,3343,195;10563;11516;11580,0,0,1,3,0,4
14875,30,3344,8613,0,0,0,0,1,1
14876,30,3346,8621,0,0,0,0,1,1
14877,30,3347,8626,0,0,0,0,1,1
14878,30,3348,8631,0,0,0,0,1,1
14879,30,3352,8640,0,0,0,0,1,1
14880,30,3353,8645;8646,0,0,0,0,2,2
14881,30,3354,8647,0,0,0,0,1,1
14882,30,3356,8653;8654,0,0,0,0,2,2
14883,30,3357,8655,0,0,0,0,1,1
14884,30,3361,8663,0,0,0,0,1,1
14885,30,3362,8666,0,0,0,0,1,1
14886,30,3365,8670,0,0,0,0,1,1
14887,30,3366,2875;8560;8674;8675;12344;12702;13122;13331,0,2,2,4,0,8
14888,30,3370,8687,0,0,0,0,1,1
14889,30,3371,8689,0,0,0,0,1,1
14890,30,3372,8692,0,0,0,0,1,1
14891,30,3373,8694,0,0,0,0,1,1
14892,30,3375,8701;10018;13658,0,1,0,2,0,3
14893,30,3376,8563,0,0,0,0,1,1
14894,30,3379,8706;8707,0,0,0,0,2,2
14895,30,3380,8708,0,0,0,0,1,1
14896,30,3382,8715,0,0,0,0,1,1
14897,30,3383,4496,0,0,0,0,1,1
14898,30,3384,4938;8723;10150,0,0,0,3,0,3
14899,30,3385,7170;8724,0,0,0,0,2,2
14900,30,3386,1292,0,0,0,0,1,1
14901,30,3387,5224;8728,0,0,0,2,0,2
14902,30,3388,8729,0,0,0,0,1,1
14903,30,3390,8732;8733,0,0,0,0,2,2
14904,30,3392,8736;8737,0,0,0,0,2,2
14905,30,3396,4233;8749,0,0,0,0,2,2
14906,30,3397,8752,0,0,0,0,1,1
14907,30,3398,8755;11166;11679,0,0,1,2,0,3
14908,30,3400,8761;8762,0,0,0,0,2,2
14909,30,3401,8763;8764,0,0,0,2,0,2
14910,30,3404,8773;8774,0,0,0,0,2,2
14911,30,3407,6027;8783,0,0,0,0,2,2
14912,30,3408,8787,0,0,0,0,1,1
14913,30,3411,8790,0,0,0,1,0,1
14914,30,3413,8799,0,0,0,1,0,1
14915,30,3415,8802;8803,0,0,0,0,2,2
14916,30,3416,8804;8805,0,0,0,1,1,2
14917,30,3418,8811;8813,0,0,0,0,2,2
14918,30,3420,2833;8819;8823;11869;12014,0,0,2,2,1,5
14919,30,3421,8824;8825,0,0,0,1,1,2
14920,30,3422,8829,0,0,0,0,1,1
14921,30,3423,8833,0,0,0,0,1,1
14922,30,3424,8121;8834;11412,0,0,0,3,0,3
14923,30,3425,8837,0,0,0,0,1,1
14924,30,3426,8841,0,0,0,0,1,1
14925,30,3427,8843;8844,0,0,0,2,0,2
14926,30,3429,8847,0,0,0,0,1,1
14927,30,3431,8852;8854,0,0,0,1,1,2
14928,30,3432,3222;5458;8857;8858;12120;12248;12336,0,0,3,4,0,7
14929,30,3433,8860,0,0,0,0,1,1
14930,30,3434,5884,0,0,0,0,1,1
14931,30,3435,3256;8862;12517;12838;13794,0,1,2,2,0,5
14932,30,3437,8866,0,0,0,0,1,1
14933,30,3439,6215;8870,0,0,0,2,0,2
14934,30,3442,8875;9792,0,0,0,0,2,2
14935,30,3446,8883;8884,0,0,0,1,1,2
14936,30,3448,8891,0,0,0,0,1,1
14937,30,3449,5069;8895;11109,0,0,0,3,0,3
14938,30,3450,4918;8897,0,0,0,0,2,2
14939,30,3451,8901,0,0,0,0,1,1
14940,30,3453,8907,0,0,0,0,1,1
14941,30,3456,8914;8915,0,0,0,0,2,2
14942,30,3458,8918;8919,0,0,0,0,2,2
14943,30,3461,4190;8926,0,0,0,0,2,2
14944,30,3462,8929;8930,0,0,0,0,2,2
14945,30,3464,8937,0,0,0,0,1,1
14946,30,3465,8383;8938,0,0,0,0,2,2
14947,30,3467,8941;8942;10085,0,0,0,2,1,3
14948,30,3468,8943,0,0,0,0,1,1
14949,30,3469,4990;8949;13343,0,1,0,2,0,3
14950,30,3470,8952,0,0,0,0,1,1
14951,30,3472,8958,0,0,0,0,1,1
14952,30,3475,8341;8965;8967,0,0,0,1,2,3
14953,30,3476,8968;8969,0,0,0,0,2,2
14954,30,3477,8970,0,0,0,0,1,1
14955,30,3479,8100;8978;13755,0,1,0,2,0,3
14956,30,3482,8982;8983,0,0,0,0,2,2
14957,30,3483,8988;8989,0,0,0,0,2,2
14958,30,3485,6513;8991,0,0,0,1,1,2
14959,30,3487,8998;9728;12717;12810,0,0,2,2,0,4
14960,30,3488,7159;9000,0,0,0,1,1,2
14961,30,3489,9002,0,0,0,0,1,1
14962,30,3490,9005,0,0,0,0,1,1
14963,30,3491,9011,0,0,0,0,1,1
14964,30,3492,9012,0,0,0,0,1,1
14965,30,3493,1980;9014,0,0,0,1,1,2
14966,30,3495,9019,0,0,0,0,1,1
14967,30,3496,9023,0,0,0,0,1,1
14968,30,3497,9024;9025,0,0,0,0,2,2
14969,30,3499,5169;9028,0,0,0,1,1,2
14970,30,3500,9029,0,0,0,0,1,1
14971,30,3501,9031,0,0,0,0,1,1
14972,30,3502,4485,0,0,0,0,1,1
14973,30,3503,9035,0,0,0,0,1,1
14974,30,3504,9038;9043,0,0,0,1,1,2
14975,30,3505,9044;9046,0,0,0,1,1,2
14976,30,3507,1673;9050,0,0,0,1,1,2
14977,30,3509,9052,0,0,0,0,1,1
14978,30,3510,9055;10632,0,0,0,2,0,2
14979,30,3514,9064,0,0,0,0,1,1
14980,30,3515,1850;9065,0,0,0,0,2,2
14981,30,3516,9067,0,0,0,0,1,1
14982,30,3517,423;9070;10584,0,0,0,3,0,3
14983,30,3519,9076;10647;11458,0,0,0,3,0,3
14984,30,3520,9081,0,0,0,0,1,1
14985,30,3521,3970,0,0,0,0,1,1
14986,30,3523,8114;8490,0,0,0,0,2,2
14987,30,3527,9096;9098,0,0,0,1,1,2
14988,30,3529,9107,0,0,0,0,1,1
14989,30,3531,9111,0,0,0,0,1,1
14990,30,3532,8022;9116,0,0,0,0,2,2
14991,30,3533,9120,0,0,0,0,1,1
14992,30,3535,9124,0,0,0,0,1,1
14993,30,3536,9129,0,0,0,0,1,1
14994,30,3537,9131;10715,0,0,0,2,0,2
14995,30,3538,9133,0,0,0,0,1,1
14996,30,3539,4542;9138;12404;12984,0,0,2,2,0,4
14997,30,3540,9141,0,0,0,0,1,1
14998,30,3544,9147,0,0,0,0,1,1
14999,30,3545,9149,0,0,0,0,1,1
15000,30,3547,9154,0,0,0,0,1,1
15001,30,3549,8238;9157;9162;12087;12274;12282;12445;12974;13282,0,1,5,2,1,9
15002,30,3550,9163,0,0,0,0,1,1
15003,30,3553,2674;9173,0,0,0,0,2,2
15004,30,3554,9174,0,0,0,0,1,1
15005,30,3555,9176;9177,0,0,0,0,2,2
15006,30,3556,9179,0,0,0,0,1,1
15007,30,3557,9180,0,0,0,0,1,1
15008,30,3558,9181;9182,0,0,0,0,2,2
15009,30,3559,9184,0,0,0,1,0,1
15010,30,3560,1611;9185,0,0,0,0,2,2
15011,30,3566,9201,0,0,0,0,1,1
15012,30,3567,9202;9203,0,0,0,0,2,2
15013,30,3569,9206,0,0,0,0,1,1
15014,30,3570,9212,0,0,0,0,1,1
15015,30,3573,9222;9223;9227,0,0,0,1,2,3
15016,30,3574,9228;9229,0,0,0,0,2,2
15017,30,3577,9240,0,0,0,0,1,1
15018,30,3578,1205;9241,0,0,0,0,2,2
15019,30,3579,6863;9242;11633;11838,0,0,2,2,0,4
15020,30,3580,9243,0,0,0,0,1,1
15021,30,3584,860,0,0,0,0,1,1
15022,30,3587,9261;9262,0,0,0,0,2,2
15023,30,3588,2328;9267,0,0,0,2,0,2
15024,30,3589,7571,0,0,0,0,1,1
15025,30,3591,9273,0,0,0,0,1,1
15026,30,3592,9274;10067;10274,0,0,0,3,0,3
15027,30,3593,9276,0,0,0,0,1,1
15028,30,3595,3412,0,0,0,0,1,1
15029,30,3598,9287,0,0,0,0,1,1
15030,30,3600,288,0,0,0,0,1,1
15031,30,3601,4405,0,0,0,0,1,1
15032,30,3604,9297,0,0,0,0,1,1
15033,30,3605,9301;11249,0,0,0,2,0,2
15034,30,3606,9302;9304;10473,0,0,0,1,2,3
15035,30,3611,9312;9313,0,0,0,1,1,2
15036,30,3612,303;9315,0,0,0,1,1,2
15037,30,3613,9319,0,0,0,1,0,1
15038,30,3619,9335,0,0,0,0,1,1
15039,30,3620,75;9340;11712,0,0,1,2,0,3
15040,30,3621,9341,0,0,0,0,1,1
15041,30,3622,5954;9343,0,0,0,0,2,2
15042,30,3624,5233,0,0,0,0,1,1
15043,30,3625,9349;11009;11200,0,0,0,3,0,3
15044,30,3626,9354,0,0,0,0,1,1
15045,30,3628,9360;9361,0,0,0,1,1,2
15046,30,3629,9363;9365,0,0,0,1,1,2
15047,30,3630,9283;9366,0,0,0,0,2,2
15048,30,3631,9372,0,0,0,0,1,1
15049,30,3632,9374;9375,0,0,0,0,2,2
15050,30,3633,9377,0,0,0,0,1,1
15051,30,3634,1732;9378,0,0,0,2,0,2
15052,30,3636,9382,0,0,0,0,1,1
15053,30,3637,9384,0,0,0,1,0,1
15054,30,3638,6226;9385,0,0,0,0,2,2
15055,30,3639,1689;9386;9388,0,0,0,1,2,3
15056,30,3640,9390;9391,0,0,0,2,0,2
15057,30,3641,9395,0,0,0,0,1,1
15058,30,3643,4504;9399,0,0,0,0,2,2
15059,30,3645,9404;9405,0,0,0,0,2,2
15060,30,3646,9407;10820,0,0,0,2,0,2
15061,30,3647,4444;9409,0,0,0,0,2,2
15062,30,3648,9413;9414,0,0,0,2,0,2
15063,30,3649,8001;9416,0,0,0,0,2,2
15064,30,3650,1539;9422,0,0,0,0,2,2
15065,30,3651,9426;10748,0,0,0,2,0,2
15066,30,3654,8026;9435;12141,0,0,1,2,0,3
15067,30,3655,9438,0,0,0,0,1,1
15068,30,3658,9442,0,0,0,0,1,1
15069,30,3662,9452;9453,0,0,0,1,1,2
15070,30,3667,9466,0,0,0,0,1,1
15071,30,3668,9468,0,0,0,0,1,1
15072,30,3670,9474,0,0,0,0,1,1
15073,30,3671,9476,0,0,0,0,1,1
15074,30,3672,9477;11212,0,0,0,2,0,2
15075,30,3673,286;9479,0,0,0,0,2,2
15076,30,3674,9483,0,0,0,0,1,1
15077,30,3677,9493,0,0,0,0,1,1
15078,30,3679,9496;10216,0,0,0,2,0,2
15079,30,3683,9505,0,0,0,0,1,1
15080,30,3684,5628;9507;11099;11582,0,0,1,3,0,4
15081,30,3685,9509;9510;9511,0,0,0,2,1,3
15082,30,3686,2464;9512,0,0,0,1,1,2
15083,30,3687,9518;9519;12477;12617,0,0,2,2,0,4
15084,30,3688,419;9521;10802,0,0,0,3,0,3
15085,30,3690,244;9525,0,0,0,0,2,2
15086,30,3691,9530,0,0,0,0,1,1
15087,30,3693,9535,0,0,0,0,1,1
15088,30,3694,9537,0,0,0,0,1,1
15089,30,3695,9539,0,0,0,0,1,1
15090,30,3696,9541,0,0,0,0,1,1
15091,30,3698,9546,0,0,0,0,1,1
15092,30,3699,9548;9549;10303,0,0,0,2,1,3
15093,30,3700,9550;9551,0,0,0,0,2,2
15094,30,3702,307;9554;11275,0,0,0,2,1,3
15095,30,3703,9555,0,0,0,0,1,1
15096,30,3704,9560;9561;9939,0,0,0,1,2,3
15097,30,3705,9566,0,0,0,0,1,1
15098,30,3706,9568,0,0,0,0,1,1
15099,30,3708,9574,0,0,0,0,1,1
15100,30,3709,8088;9577,0,0,0,0,2,2
15101,30,3710,988;9580;12893;13152,0,1,1,2,0,4
15102,30,3711,9581,0,0,0,0,1,1
15103,30,3712,9583;9584,0,0,0,0,2,2
15104,30,3713,5548;9587,0,0,0,2,0,2
15105,30,3714,9591,0,0,0,0,1,1
15106,30,3716,2219;9597,0,0,0,2,0,2
15107,30,3717,9599,0,0,0,0,1,1
15108,30,3719,9604;9605,0,0,0,2,0,2
15109,30,3722,9613,0,0,0,0,1,1
15110,30,3723,9614;9615,0,0,0,0,2,2
15111,30,3724,2407;9618,0,0,0,0,2,2
15112,30,3725,9436;9619,0,0,0,2,0,2
15113,30,3726,9621;11371;11433;12804,0,0,1,3,0,4
15114,30,3728,9628,0,0,0,0,1,1
15115,30,3730,9632,0,0,0,0,1,1
15116,30,3732,9635;9636,0,0,0,1,1,2
15117,30,3734,9640,0,0,0,0,1,1
15118,30,3736,5008;11139;12207,0,0,1,2,0,3
15119,30,3737,9646;9647,0,0,0,1,1,2
15120,30,3738,9650,0,0,0,0,1,1
15121,30,3739,9653,0,0,0,0,1,1
15122,30,3740,9656;9657,0,0,0,0,2,2
15123,30,3743,9661,0,0,0,0,1,1
15124,30,3744,3891;9663,0,0,0,0,2,2
15125,30,3747,9670;9671,0,0,0,1,1,2
15126,30,3748,9673,0,0,0,0,1,1
15127,30,3749,5342;9675,0,0,0,0,2,2
15128,30,3750,3201;9694;12343;13441,0,1,1,2,0,4
15129,30,3752,179;9688,0,0,0,2,0,2
15130,30,3753,9690;9691,0,0,0,0,2,2
15131,30,3756,9701,0,0,0,0,1,1
15132,30,3759,7615;9708,0,0,0,0,2,2
15133,30,3760,9712,0,0,0,0,1,1
15134,30,3763,9718,0,0,0,0,1,1
15135,30,3765,9724,0,0,0,0,1,1
15136,30,3766,9730,0,0,0,0,1,1
15137,30,3769,9736,0,0,0,1,0,1
15138,30,3770,9738;9740,0,0,0,1,1,2
15139,30,3771,9742;12533;12941,0,0,2,1,0,3
15140,30,3772,9743,0,0,0,0,1,1
15141,30,3774,8984;9748;9750;11959,0,0,1,3,0,4
15142,30,3775,9752,0,0,0,0,1,1
15143,30,3776,3302,0,0,0,0,1,1
15144,30,3778,9759,0,0,0,0,1,1
15145,30,3779,9440;9763,0,0,0,0,2,2
15146,30,3780,9766,0,0,0,0,1,1
15147,30,3782,9772,0,0,0,0,1,1
15148,30,3783,9774;9775,0,0,0,0,2,2
15149,30,3784,9713;9778;12013,0,0,1,2,0,3
15150,30,3786,9785;9788,0,0,0,1,1,2
15151,30,3787,9789;9791,0,0,0,0,2,2
15152,30,3788,9793,0,0,0,0,1,1
15153,30,3791,2308;9801,0,0,0,0,2,2
15154,30,3792,4554;9803;10312;10512;10864,0,0,0,5,0,5
15155,30,3793,9807,0,0,0,0,1,1
15156,30,3794,8934;9808;11362;11836;12329,0,0,2,3,0,5
15157,30,3797,9815;11346;12961,0,0,1,2,0,3
15158,30,3800,9823,0,0,0,0,1,1
15159,30,3804,9841,0,0,0,0,1,1
15160,30,3806,9846,0,0,0,0,1,1
15161,30,3809,9852,0,0,0,1,0,1
15162,30,3810,9855;9856,0,0,0,0,2,2
15163,30,3812,9859,0,0,0,0,1,1
15164,30,3813,9863,0,0,0,0,1,1
15165,30,3817,1952;9870;10983;11168;12929,0,0,1,4,0,5
15166,30,3819,9875,0,0,0,0,1,1
15167,30,3820,9876;9877,0,0,0,0,2,2
15168,30,3822,213;5175;8270;9888;11865;12055;12648;12846,0,0,4,4,0,8
15169,30,3823,9890,0,0,0,0,1,1
15170,30,3824,9893,0,0,0,0,1,1
15171,30,3827,5026;9900;11064;11807;12016,0,0,2,3,0,5
15172,30,3828,6703;9902,0,0,0,0,2,2
15173,30,3831,3548;9907;11188,0,0,0,3,0,3
15174,30,3832,5226,0,0,0,0,1,1
15175,30,3833,9914;9915,0,0,0,1,1,2
15176,30,3837,9924,0,0,0,0,1,1
15177,30,3838,9929,0,0,0,0,1,1
15178,30,3839,5671;9931;10977;11049,0,0,0,4,0,4
15179,30,3841,782;9934;10687;11300,0,0,0,4,0,4
15180,30,3844,9943;9945,0,0,0,0,2,2
15181,30,3845,2060;9949,0,0,0,0,2,2
15182,30,3849,9956;9957,0,0,0,1,1,2
15183,30,3850,6255;9958,0,0,0,0,2,2
15184,30,3852,9960,0,0,0,0,1,1
15185,30,3853,7800;9964,0,0,0,0,2,2
15186,30,3855,9971,0,0,0,0,1,1
15187,30,3856,9972;9973,0,0,0,0,2,2
15188,30,3859,9981;9982,0,0,0,0,2,2
15189,30,3860,9983;9984;9986;9987,0,0,0,3,1,4
15190,30,3862,9989;9991,0,0,0,1,1,2
15191,30,3863,9993,0,0,0,0,1,1
15192,30,3865,10000;10002,0,0,0,0,2,2
15193,30,3866,22;1906;10962;11504,0,0,0,4,0,4
15194,30,3868,299;9944;10722,0,0,0,3,0,3
15195,30,3869,7669;7849;11573,0,0,1,2,0,3
15196,30,3870,442,0,0,0,0,1,1
15197,30,3871,492;6504;10924;11312,0,0,0,4,0,4
15198,30,3872,487;549,0,0,0,2,0,2
15199,30,3876,657;10001,0,0,0,0,2,2
15200,30,3877,979;2099,0,0,0,0,2,2
15201,30,3879,1569,0,0,0,1,0,1
15202,30,3880,1737,0,0,0,0,1,1
15203,30,3881,2380;3910;10885,0,0,0,3,0,3
15204,30,3883,1989;7661,0,0,0,0,2,2
15205,30,3884,2135,0,0,0,0,1,1
15206,30,3885,576;974;10954;11331,0,0,0,4,0,4
15207,30,3886,9193,0,0,0,0,1,1
15208,30,3888,2288,0,0,0,0,1,1
15209,30,3889,2346,0,0,0,0,1,1
15210,30,3890,9970,0,0,0,0,1,1
15211,30,3891,2527,0,0,0,0,1,1
15212,30,3892,6259,0,0,0,0,1,1
15213,30,3895,2717;7573,0,0,0,0,2,2
15214,30,3896,2771,0,0,0,0,1,1
15215,30,3899,3100;3625,0,0,0,0,2,2
15216,30,3901,1740,0,0,0,0,1,1
15217,30,3902,3291;11213,0,0,0,2,0,2
15218,30,3904,3865;5508;11523,0,0,0,3,0,3
15219,30,3905,3979;9480;11088;12052,0,0,1,3,0,4
15220,30,3906,4111,0,0,0,1,0,1
15221,30,3909,4243;4971,0,0,0,0,2,2
15222,30,3910,4563,0,0,0,0,1,1
15223,30,3911,5110,0,0,0,0,1,1
15224,30,3912,4880;9919,0,0,0,1,1,2
15225,30,3913,2864;5058;10137;10592;11159,0,0,0,5,0,5
15226,30,3914,4051;6074;11646,0,0,1,2,0,3
15227,30,3915,5124,0,0,0,0,1,1
15228,30,3916,5208;9878,0,0,0,2,0,2
15229,30,3917,2588;8981,0,0,0,0,2,2
15230,30,3919,5411;6509,0,0,0,0,2,2
15231,30,3920,5767,0,0,0,0,1,1
15232,30,3921,96;8543;11151,0,0,0,3,0,3
15233,30,3925,2438;8622;10561;11353,0,0,0,4,0,4
15234,30,3926,9060;9303,0,0,0,0,2,2
15235,30,3927,6757;10800;11045;11752;12773,0,0,2,3,0,5
15236,30,3929,5777,0,0,0,0,1,1
15237,30,3930,7542;9977,0,0,0,2,0,2
15238,30,3931,4621;7547,0,0,0,0,2,2
15239,30,3932,7759,0,0,0,0,1,1
15240,30,3933,5764;7843,0,0,0,2,0,2
15241,30,3935,7985,0,0,0,0,1,1
15242,30,3936,4740;8062,0,0,0,0,2,2
15243,30,3938,7645;8221,0,0,0,0,2,2
15244,30,3939,202;9159,0,0,0,0,2,2
15245,30,3940,8394,0,0,0,0,1,1
15246,30,3941,6221;8489,0,0,0,0,2,2
15247,30,3943,8936,0,0,0,0,1,1
15248,30,3944,7137;8999,0,0,0,0,2,2
15249,30,3945,1947;9136,0,0,0,0,2,2
15250,30,3946,3922;4188;10120;12363,0,0,1,3,0,4
15251,30,3947,9367,0,0,0,0,1,1
15252,30,3949,6311;9449;11026,0,0,0,3,0,3
15253,30,3950,964;9522,0,0,0,0,2,2
15254,30,3952,9828,0,0,0,0,1,1
15255,30,3953,9871,0,0,0,0,1,1
15256,30,3954,1561;9911;10923,0,0,0,3,0,3
15257,30,3957,752;3061;12063,365,0,1,2,0,3
15258,30,3959,509,365,0,0,0,1,1
15259,30,3960,5699,365,0,0,1,0,1
15260,30,3961,669,365,0,0,0,1,1
15261,30,3962,728;1695;10933;11112,365,0,0,4,0,4
15262,30,3964,954;7643,365,0,0,0,2,2
15263,30,3965,1174;9331,365,0,0,0,2,2
15264,30,3966,7838;11491,365,0,0,2,0,2
15265,30,3967,459;12879,365,0,1,1,0,2
15266,30,3969,3140;11946;12259,365,0,2,1,0,3
15267,30,3970,5351,365,0,0,0,1,1
15268,30,3972,2171;5721,365,0,0,0,2,2
15269,30,3973,2410;3092,365,0,0,0,2,2
15270,30,3974,9439,365,0,0,0,1,1
15271,30,3975,2723;11004;11441,365,0,0,3,0,3
15272,30,3976,258,365,0,0,0,1,1
15273,30,3977,2804;11142;11986,365,0,1,2,0,3
15274,30,3978,2930;9990;11304,365,0,0,3,0,3
15275,30,3979,2647;2998,365,0,0,0,2,2
15276,30,3980,516;3066;11477,365,0,0,3,0,3
15277,30,3981,6566,365,0,0,0,1,1
15278,30,3985,1368;3394,365,0,0,0,2,2
15279,30,3986,3396;8378;10718;11299;11473;12296,365,0,1,5,0,6
15280,30,3987,3432;5766;11189,365,0,0,3,0,3
15281,30,3988,3444;8946,365,0,0,0,2,2
15282,30,3989,3544;8024,365,0,0,0,2,2
15283,30,3991,916;3923;10177;11225,365,0,0,3,1,4
15284,30,3992,4560;6619;10775;11191,365,0,0,3,1,4
15285,30,3995,259;1277,365,0,0,0,2,2
15286,30,3996,4944,365,0,0,0,1,1
15287,30,3997,4968;6396,365,0,0,1,1,2
15288,30,3998,1640;3833;10694;11418,365,0,0,4,0,4
15289,30,4000,4827;12410;12745,365,0,2,1,0,3
15290,30,4003,681,365,0,0,0,1,1
15291,30,4004,9572;11904;12094,365,0,2,1,0,3
15292,30,4005,9811,365,0,0,0,1,1
15293,30,4006,4889;5900;11405,365,0,0,3,0,3
15294,30,4008,6020,365,0,0,0,1,1
15295,30,4009,2210;6021;10976;11221;11764,365,0,1,4,0,5
15296,30,4010,6031;7244,365,0,0,0,2,2
15297,30,4011,3133;10227;10508,365,0,0,3,0,3
15298,30,4012,9556,365,0,0,0,1,1
15299,30,4014,828;6797,365,0,0,0,2,2
15300,30,4015,6799;8315;8681,365,0,0,3,0,3
15301,30,4016,3062;3397;11632,365,0,1,2,0,3
15302,30,4017,3868;10480;11596,365,0,1,2,0,3
15303,30,4018,6390;10232,365,0,0,2,0,2
15304,30,4020,7644,365,0,0,0,1,1
15305,30,4022,6222;7819;11406,365,0,0,3,0,3
15306,30,4024,1913;7858,365,0,0,0,2,2
15307,30,4025,7886,365,0,0,0,1,1
15308,30,4026,7917,365,0,0,0,1,1
15309,30,4027,7997;8696;11145;11328;11455,365,0,0,5,0,5
15310,30,4028,3157;5878;10757;11021,365,0,0,4,0,4
15311,30,4029,8021;9559,365,0,0,0,2,2
15312,30,4033,3632;6993,365,0,0,0,2,2
15313,30,4035,4907;6674,365,0,0,0,2,2
15314,30,4040,9428;10264,365,0,0,2,0,2
15315,30,4041,3667;9432,365,0,0,0,2,2
15316,30,4042,9461;9829,365,0,0,0,2,2
15317,30,4043,8286;9482,365,0,0,0,2,2
15318,30,4045,9950,365,0,0,0,1,1
15319,30,4046,143;8125,730,0,0,0,2,2
15320,30,4047,200;8849,730,0,0,0,2,2
15321,30,4048,3255;6184;11364,730,0,0,3,0,3
15322,30,4049,329,730,0,0,1,0,1
15323,30,4051,437,730,0,0,0,1,1
15324,30,4052,489;3429;11512;11862;12580,730,0,2,3,0,5
15325,30,4053,2949;10413;11095,730,0,0,3,0,3
15326,30,4055,2980;5617;11767,730,0,1,2,0,3
15327,30,4056,692,730,0,0,0,1,1
15328,30,4058,948;5619;10701,730,0,0,3,0,3
15329,30,4059,951;3996;10702;11334;11416,730,0,0,5,0,5
15330,30,4061,1401;5239,730,0,0,0,2,2
15331,30,4062,903;9848;12980;13123,730,1,1,2,0,4
15332,30,4065,1745;6581;10831;11623;12631;12681,730,0,3,3,0,6
15333,30,4066,1783;4619;10862;11178,730,0,0,4,0,4
15334,30,4067,1801;1846;10841;11637;12285;12463,730,0,3,3,0,6
15335,30,4068,7066;7919;11125,730,0,0,3,0,3
15336,30,4069,7206,730,0,0,0,1,1
15337,30,4071,524;7261,730,0,0,0,2,2
15338,30,4072,2165;2403,730,0,0,0,2,2
15339,30,4075,2337,730,0,0,0,1,1
15340,30,4076,917,730,0,0,0,1,1
15341,30,4084,2676,730,0,0,0,1,1
15342,30,4086,2801;8992,730,0,0,0,2,2
15343,30,4089,3192,730,0,0,0,1,1
15344,30,4090,3257,730,0,0,0,1,1
15345,30,4092,4348,730,0,0,0,1,1
15346,30,4093,3643;3815,730,0,0,0,2,2
15347,30,4094,3792;11739;11923,730,0,2,1,0,3
15348,30,4095,1688;3892,730,0,0,0,2,2
15349,30,4096,406;3924,730,0,0,0,2,2
15350,30,4098,2334;3984,730,0,0,1,1,2
15351,30,4099,4030;5216,730,0,0,2,0,2
15352,30,4101,7942,730,0,0,0,1,1
15353,30,4103,4273,730,0,0,1,0,1
15354,30,4104,592;4287,730,0,0,0,2,2
15355,30,4105,4377;8830,730,0,0,2,0,2
15356,30,4106,4384;7000;11842;12177;12542,730,0,3,2,0,5
15357,30,4108,4659,730,0,0,0,1,1
15358,30,4109,4909;6856,730,0,0,2,0,2
15359,30,4112,5087;9166,730,0,0,2,0,2
15360,30,4114,262,730,0,0,1,0,1
15361,30,4116,7;6345,730,0,0,2,0,2
15362,30,4117,730;5542,730,0,0,1,1,2
15363,30,4118,5684;10783,730,0,0,2,0,2
15364,30,4122,720;2203;12039;12415,730,0,2,2,0,4
15365,30,4124,4794,730,0,0,0,1,1
15366,30,4126,6438,730,0,0,0,1,1
15367,30,4127,158;10373;10521;10880,730,0,0,4,0,4
15368,30,4128,6890,730,0,0,0,1,1
15369,30,4129,5571;6922;10776;11664,730,0,1,3,0,4
15370,30,4130,6936;7021;11183;11420,730,0,0,4,0,4
15371,30,4131,7074;8662;11975,730,0,1,2,0,3
15372,30,4134,3305,730,0,0,0,1,1
15373,30,4137,5109;7582,730,0,0,0,2,2
15374,30,4138,7592;11350;11750;12173,730,0,2,2,0,4
15375,30,4140,7871;8757;11505;12449;12871,730,0,2,3,0,5
15376,30,4141,5419;7899;11297;12208,730,0,1,3,0,4
15377,30,4143,8173,730,0,0,0,1,1
15378,30,4144,4482;8277;10801;11197;11325,730,0,0,5,0,5
15379,30,4145,8322;9105;11028;11287;11363;11617;12324,730,0,2,5,0,7
15380,30,4148,6060;8392,730,0,0,0,2,2
15381,30,4149,9168,730,0,0,0,1,1
15382,30,4153,8957,730,0,0,0,1,1
15383,30,4156,1209;5103,730,0,0,2,0,2
15384,30,4157,9186,730,0,0,0,1,1
15385,30,4158,1074;4218;11199;11530;11657,730,0,1,4,0,5
15386,30,4159,3750;5972;10559;11384,730,0,0,4,0,4
15387,30,4160,9490,730,0,0,0,1,1
15388,30,4161,6679;9508,730,0,0,0,2,2
15389,30,4162,9524,730,0,0,0,1,1
15390,30,4164,5819,730,0,0,0,1,1
15391,30,4165,1447;9762;11398;11715,730,0,1,3,0,4
15392,30,4168,9813,730,0,0,0,1,1
15393,30,4170,9857,730,0,0,0,1,1
15394,30,4171,10;4284;10887;11262;12334,1095,0,1,4,0,5
15395,30,4172,38;1509;11280;11648;12386,1095,0,2,3,0,5
15396,30,4173,45;5748;11567;11733,1095,0,2,2,0,4
15397,30,4174,3103;12216,1095,0,1,1,0,2
15398,30,4178,417;2297,1095,0,0,0,2,2
15399,30,4179,1212;11570;11921;12028;12497,1095,0,4,1,0,5
15400,30,4180,578;5810;12069,1095,0,1,2,0,3
15401,30,4181,655;9895,1095,0,0,1,1,2
15402,30,4183,467;685;12708,1095,0,1,2,0,3
15403,30,4185,6550,1095,0,0,0,1,1
15404,30,4187,5000;7035;11534;11893;12163,1095,0,3,2,0,5
15405,30,4189,7007,1095,0,0,0,1,1
15406,30,4190,2133,1095,0,0,0,1,1
15407,30,4191,1224,1095,0,0,0,1,1
15408,30,4192,1247;9721,1095,0,0,2,0,2
15409,30,4194,1458;12765,1095,0,1,1,0,2
15410,30,4195,1490;1790,1095,0,0,0,2,2
15411,30,4196,1563,1095,0,0,0,1,1
15412,30,4197,1655;6761,1095,0,0,2,0,2
15413,30,4198,1821;6302,1095,0,0,0,2,2
15414,30,4199,1974,1095,0,0,1,0,1
15415,30,4200,2152,1095,0,0,0,1,1
15416,30,4202,2351;4015;11817;12154;12616,1095,0,3,2,0,5
15417,30,4205,4170;10651;12252,1095,0,1,2,0,3
15418,30,4206,1603;4925;11376;11553,1095,0,1,3,0,4
15419,30,4209,9622,1095,0,0,0,1,1
15420,30,4211,2986;3235,1095,0,0,0,2,2
15421,30,4212,3239;7998;11288;11915;12190,1095,0,2,3,0,5
15422,30,4213,3471;5679,1095,0,0,2,0,2
15423,30,4216,7079,1095,0,0,1,0,1
15424,30,4217,4001;7272;10663;10959,1095,0,0,4,0,4
15425,30,4218,4002;5070;11390,1095,0,0,3,0,3
15426,30,4221,3549;4207,1095,0,0,0,2,2
15427,30,4223,4490;4923;11301,1095,0,0,3,0,3
15428,30,4225,4559;6587;11615;11716,1095,0,2,2,0,4
15429,30,4226,4797;10905;11465,1095,0,0,3,0,3
15430,30,4230,4577;5982;11321;11717;11885,1095,0,2,3,0,5
15431,30,4234,3759;5379,1095,0,0,2,0,2
15432,30,4236,5430;5755,1095,0,0,1,1,2
15433,30,4237,1424;5769;10705;10822,1095,0,0,4,0,4
15434,30,4238,5816,1095,0,0,0,1,1
15435,30,4239,5547;5928;11544;12157,1095,0,2,2,0,4
15436,30,4245,4148;6334,1095,0,0,2,0,2
15437,30,4246,4821;6428,1095,0,0,0,2,2
15438,30,4247,6646,1095,0,0,0,1,1
15439,30,4248,4522;6837;10874;10994,1095,0,0,4,0,4
15440,30,4249,2556;6914;11251;11579,1095,0,1,3,0,4
15441,30,4250,5410;5489;12222,1095,0,1,2,0,3
15442,30,4252,5871;7294;11348,1095,0,0,3,0,3
15443,30,4253,1183;7317,1095,0,0,0,2,2
15444,30,4254,926;7321;10426,1095,0,0,3,0,3
15445,30,4255,7363;9298,1095,0,0,0,2,2
15446,30,4257,3675;7372;12797;13027,1095,0,2,2,0,4
15447,30,4259,2612;7426,1095,0,0,0,2,2
15448,30,4260,1179;7516;11409,1095,0,0,3,0,3
15449,30,4261,5490;7585,1095,0,0,2,0,2
15450,30,4262,1532;5052,1095,0,0,0,2,2
15451,30,4263,7603;7722;10533;11396,1095,0,0,4,0,4
15452,30,4264,2350;9526;11451;11820;11974;12689;13081,1095,0,4,3,0,7
15453,30,4265,5201;10741;11872,1095,0,1,2,0,3
15454,30,4266,3339;7844,1095,0,0,2,0,2
15455,30,4268,6544;11810;12385,1095,0,2,1,0,3
15456,30,4272,181;8455;11005;11415,1095,0,0,4,0,4
15457,30,4273,3708;8483;11519;12512,1095,0,1,3,0,4
15458,30,4274,5343,1095,0,0,0,1,1
15459,30,4275,205;7138;12130,1095,0,1,2,0,3
15460,30,4276,794;8859;11786;12072,1095,0,2,2,0,4
15461,30,4278,2682;4533,1095,0,0,0,2,2
15462,30,4281,5366;9165;11104;11950,1095,0,1,3,0,4
15463,30,4282,4908;12471,1095,0,1,1,0,2
15464,30,4285,3289;5605,1095,0,0,2,0,2
15465,30,4286,9601,1095,0,0,0,1,1
15466,30,4287,5443;6910;12083;12281,1095,0,2,2,0,4
15467,30,4288,8175;9727;10444;10736;11886,1095,0,1,4,0,5
15468,30,4293,9600,1095,0,0,0,1,1
15469,30,4296,436,1460,0,0,0,1,1
15470,30,4297,486;8925,1460,0,0,2,0,2
15471,30,4298,583;11826;11884;12133,1460,0,3,1,0,4
15472,30,4299,643;11475,1460,0,0,2,0,2
15473,30,4300,3727;7286,1460,0,0,2,0,2
15474,30,4301,710,1460,0,0,0,1,1
15475,30,4302,795;4888;11222,1460,0,0,3,0,3
15476,30,4303,811;7604;10990;11190;11481;12026,1460,0,1,5,0,6
15477,30,4304,871;11020;12427,1460,0,1,2,0,3
15478,30,4305,881,1460,0,0,0,1,1
15479,30,4306,895;5737,1460,0,0,2,0,2
15480,30,4307,977;4602;11511,1460,0,0,3,0,3
15481,30,4308,999;4094,1460,0,0,0,2,2
15482,30,4309,1059;1842;11382,1460,0,0,3,0,3
15483,30,4311,4492,1460,0,0,1,0,1
15484,30,4312,1213;10686;11342;11939;12353,1460,0,2,3,0,5
15485,30,4313,1227,1460,0,0,0,1,1
15486,30,4314,973,1460,0,0,0,1,1
15487,30,4315,1333;7692,1460,0,0,2,0,2
15488,30,4316,1499;5709;11514;11993;12534,1460,0,2,3,0,5
15489,30,4317,371;1590,1460,0,0,1,1,2
15490,30,4320,4756;11459;11699;12619,1460,0,2,2,0,4
15491,30,4322,2126;2281,1460,0,0,0,2,2
15492,30,4323,2392,1460,0,0,0,1,1
15493,30,4326,2724;3799,1460,0,0,0,2,2
15494,30,4327,106;2731,1460,0,0,0,2,2
15495,30,4328,1536;2834;12435;12540,1460,0,2,2,0,4
15496,30,4329,2843;4527;11521,1460,0,0,3,0,3
15497,30,4330,2887;9786;11626;12706,1460,0,2,2,0,4
15498,30,4335,3621;9947;11795;12169;12465,1460,0,3,2,0,5
15499,30,4337,2301;3709;11370,1460,0,0,3,0,3
15500,30,4338,8456;8760;12008,1460,0,1,2,0,3
15501,30,4340,5905;9562;11797;12634,1460,0,2,2,0,4
15502,30,4341,3832;7485;11072;12074,1460,0,1,3,0,4
15503,30,4342,3946;7624,1460,0,0,1,1,2
15504,30,4344,4076,1460,0,0,0,1,1
15505,30,4345,2232;4169;10892;11563,1460,0,1,3,0,4
15506,30,4347,1250;4315;10996;11979;12720,1460,0,2,3,0,5
15507,30,4348,4335,1460,0,0,0,1,1
15508,30,4349,390;8135;11683;12819,1460,0,2,2,0,4
15509,30,4350,4707;11332;11638,1460,0,1,2,0,3
15510,30,4352,8770,1460,0,0,0,1,1
15511,30,4353,1054;4920;10671,1460,0,0,3,0,3
15512,30,4355,5017;11666,1460,0,1,1,0,2
15513,30,4359,4126,1460,0,0,0,1,1
15514,30,4360,5377;6586;11123;11518;11724,1460,0,1,4,0,5
15515,30,4362,908;5741;11161;11489;11598,1460,0,1,4,0,5
15516,30,4364,1978;5857;10585;11223,1460,0,0,4,0,4
15517,30,4366,3184;5899,1460,0,0,2,0,2
15518,30,4369,4197;11337,1460,0,0,2,0,2
15519,30,4370,1526;9369;12599,1460,0,1,2,0,3
15520,30,4372,5114;10945;11672;12263,1460,0,2,2,0,4
15521,30,4375,7989;11422;11625;11916;12241;12483,1460,0,4,2,0,6
15522,30,4376,6489;6728;12134;12271;13028,1460,0,3,2,0,5
15523,30,4378,6819;9257,1460,0,0,2,0,2
15524,30,4380,2394;3566;12160,1460,0,1,2,0,3
15525,30,4381,6452;6986;11461,1460,0,0,3,0,3
15526,30,4382,1718,1460,0,0,0,1,1
15527,30,4383,7107,1460,0,0,0,1,1
15528,30,4384,2427,1460,0,0,0,1,1
15529,30,4385,2516;9424;11503;11948;12030;12182;12287;12769;13155,1460,1,5,3,0,9
15530,30,4387,6133,1460,0,0,1,0,1
15531,30,4389,7517;8602,1460,0,0,0,2,2
15532,30,4390,7868;7925;12117;12476,1460,0,2,2,0,4
15533,30,4391,6211,1460,0,0,1,0,1
15534,30,4392,2525;8070,1460,0,0,1,1,2
15535,30,4396,2722;8202,1460,0,0,0,2,2
15536,30,4397,8284;8538,1460,0,0,2,0,2
15537,30,4402,1218;8488;11976,1460,0,1,2,0,3
15538,30,4403,7495;12707;13044,1460,0,2,1,0,3
15539,30,4404,8966;9238;10746;11483,1460,0,0,4,0,4
15540,30,4405,8568;8987;11010;11316;12143,1460,0,1,4,0,5
15541,30,4406,4375;9113,1460,0,0,2,0,2
15542,30,4408,6198;9299,1460,0,0,2,0,2
15543,30,4409,6318;9500;13072,1460,0,1,2,0,3
15544,30,4410,9660,1460,0,0,0,1,1
15545,30,4411,1833;9697,1460,0,0,0,2,2
15546,30,4412,6413;9769;13037,1460,0,1,2,0,3
15547,30,4413,9777;12389,1460,0,1,1,0,2
15548,30,4414,4085;9809;10856;11153;11799;12085,1460,0,2,4,0,6
15549,30,4415,1741;3994;13036,1460,0,1,2,0,3
15550,30,4416,3161;4873;12795;13207,1460,1,1,2,0,4
15551,30,4417,71;4336;11558,1825,0,1,2,0,3
15552,30,4418,199;8519;11380;11933;12907;13408,1825,1,2,3,0,6
15553,30,4419,201,1825,0,0,0,1,1
15554,30,4420,141;4623,1825,0,0,0,2,2
15555,30,4421,296;7076,1825,0,0,2,0,2
15556,30,4422,304,1825,0,0,0,1,1
15557,30,4423,439;705;10778;11613;11782;11947;12411;13446,1825,1,4,3,0,8
15558,30,4424,636;11432,1825,0,0,2,0,2
15559,30,4426,1352;6736;12181;12376;13078,1825,0,3,2,0,5
15560,30,4427,3572;7557,1825,0,0,0,2,2
15561,30,4430,642;1525;11369,1825,0,0,3,0,3
15562,30,4431,411;6655,1825,0,0,1,1,2
15563,30,4435,6196;9357,1825,0,0,2,0,2
15564,30,4437,3219;12441,1825,0,1,1,0,2
15565,30,4438,3165;4898;10877;11120,1825,0,0,4,0,4
15566,30,4440,3208;7012;12448;12590,1825,0,2,2,0,4
15567,30,4441,3229,1825,0,0,0,1,1
15568,30,4442,3648;7523;11488,1825,0,0,3,0,3
15569,30,4443,3308;6407;11375,1825,0,0,3,0,3
15570,30,4444,3384,1825,0,0,1,0,1
15571,30,4445,1122;3463;12412,1825,0,1,2,0,3
15572,30,4446,8285;9009;11022;11851;12328;13400;13616,1825,2,2,3,0,7
15573,30,4448,3565,1825,0,0,0,1,1
15574,30,4451,3595;3850;11140;11402;11487,1825,0,0,5,0,5
15575,30,4452,3934;5888;12081,1825,0,1,2,0,3
15576,30,4453,3961;4062;10661;11924,1825,0,1,3,0,4
15577,30,4454,1151;3962;10588,1825,0,0,3,0,3
15578,30,4455,4046;8996;11241;11778,1825,0,1,3,0,4
15579,30,4457,1387;11761;13006,1825,0,2,1,0,3
15580,30,4460,4474;8718,1825,0,0,2,0,2
15581,30,4461,4487;8672;11771,1825,0,1,2,0,3
15582,30,4462,4678;4838;11079;11286,1825,0,0,4,0,4
15583,30,4463,4711;9089,1825,0,0,0,2,2
15584,30,4464,4751;5160;11710,1825,0,1,2,0,3
15585,30,4465,5566,1825,0,0,0,1,1
15586,30,4470,8552;10644,1825,0,0,2,0,2
15587,30,4471,2285;5046;10649;10930;11296;11572,1825,0,1,5,0,6
15588,30,4472,5234;9830,1825,0,0,2,0,2
15589,30,4473,5235;11029,1825,0,0,2,0,2
15590,30,4474,5295,1825,0,0,0,1,1
15591,30,4476,1417;5391,1825,0,0,0,2,2
15592,30,4477,2316;5546;11144;11995,1825,0,1,3,0,4
15593,30,4483,4314;6022,1825,0,0,2,0,2
15594,30,4485,5811;6207;11326;11351;11549;12166;12646,1825,0,3,4,0,7
15595,30,4486,6313;8561;10791;11006;11056;11323;11581;11718;12873,1825,0,3,6,0,9
15596,30,4488,6456;7116,1825,0,0,0,2,2
15597,30,4489,5703;6530;11755;12111;12496,1825,0,3,2,0,5
15598,30,4490,356;6637;10789;11148;12700,1825,0,1,4,0,5
15599,30,4491,6649;11227;12108,1825,0,1,2,0,3
15600,30,4492,6070;6653;11515;12407;12886,1825,0,2,3,0,5
15601,30,4493,3539;6782;11052;12242;12374,1825,0,2,3,0,5
15602,30,4494,6929,1825,0,0,0,1,1
15603,30,4495,7845,1825,0,0,0,1,1
15604,30,4496,7210,1825,0,0,0,1,1
15605,30,4498,7256;7508;11008;11284;11593,1825,0,1,4,0,5
15606,30,4501,7051;7382;12124;12140,1825,0,2,2,0,4
15607,30,4502,7559,1825,0,0,0,1,1
15608,30,4503,773;9256;11138;11587,1825,0,1,3,0,4
15609,30,4505,6582;10910;11255;11689;11887;13041,1825,0,3,3,0,6
15610,30,4506,7685,1825,0,0,0,1,1
15611,30,4507,7721;9329;11327,1825,0,0,2,1,3
15612,30,4508,5448;7815;11859,1825,0,1,2,0,3
15613,30,4510,7882;8985;10928,1825,0,0,3,0,3
15614,30,4511,7933,1825,0,0,1,0,1
15615,30,4513,8030,1825,0,0,0,1,1
15616,30,4514,8082,1825,0,0,0,1,1
15617,30,4517,550,1825,0,0,0,1,1
15618,30,4519,8617,1825,0,0,1,0,1
15619,30,4520,4103;8628;13252,1825,1,0,2,0,3
15620,30,4521,8744;9352;11084;13223,1825,1,0,3,0,4
15621,30,4522,3362;8176;11097;11368,1825,0,0,4,0,4
15622,30,4523,2580;9225;11708;12116;12345,1825,0,3,2,0,5
15623,30,4524,9032;9651;10852;10972;11024;12178,1825,0,1,5,0,6
15624,30,4525,1055;9077;11295;11501;11540,1825,0,1,4,0,5
15625,30,4526,7601;9097;11492;11954;12350,1825,0,2,3,0,5
15626,30,4527,9119;9127,1825,0,0,0,2,2
15627,30,4530,568;9356;12854,1825,0,1,2,0,3
15628,30,4531,2156;9368;11157;11630,1825,0,1,3,0,4
15629,30,4533,3538;9648;11529;12092;13173;13618,1825,2,1,3,0,6
15630,30,4534,2366;9817;11691;12299,1825,0,2,2,0,4
15631,30,4536,1317;9963;11551;12632,1825,0,2,2,0,4
15632,30,4538,110;4274;13390,2190,1,0,2,0,3
15633,30,4539,112;2881;11058;11498;11647,2190,0,1,4,0,5
15634,30,4542,863;6330,2190,0,0,2,0,2
15635,30,4543,1009,2190,0,0,0,1,1
15636,30,4544,209;5210,2190,0,0,2,0,2
15637,30,4546,1367,2190,0,0,0,1,1
15638,30,4548,1556;4615,2190,0,0,2,0,2
15639,30,4550,1610,2190,0,0,0,1,1
15640,30,4551,1788;3004;11427;11967;12912,2190,0,2,3,0,5
15641,30,4553,2136,2190,0,0,0,1,1
15642,30,4554,2141;5166;11186;11329;11525,2190,0,0,5,0,5
15643,30,4555,8864;9882;11546;11793,2190,0,2,2,0,4
15644,30,4556,950;2480,2190,0,0,2,0,2
15645,30,4557,2563,2190,0,0,0,1,1
15646,30,4558,2621;9006;11053;11354;11591;11849;11907;12454,2190,0,4,4,0,8
15647,30,4559,2655,2190,0,0,1,0,1
15648,30,4560,2670;7671;11207;11404;11568;11706;12082;12250;12393,2190,0,5,4,0,9
15649,30,4561,64;2811;11779;11966,2190,0,2,2,0,4
15650,30,4562,2821;9464,2190,0,0,2,0,2
15651,30,4563,2865;3315;10974;11452;11808,2190,0,1,4,0,5
15652,30,4566,5706;6281,2190,0,0,2,0,2
15653,30,4568,3139,2190,0,0,0,1,1
15654,30,4569,7343;8619;11436,2190,0,0,3,0,3
15655,30,4570,3199,2190,0,0,0,1,1
15656,30,4571,9459,2190,0,0,0,1,1
15657,30,4572,3531;4654;11248,2190,0,0,3,0,3
15658,30,4574,2433;6947;11292;12301;12865,2190,0,2,3,0,5
15659,30,4575,3746,2190,0,0,0,1,1
15660,30,4576,3768;9897;10953;12293,2190,0,1,3,0,4
15661,30,4578,2295;3860,2190,0,0,2,0,2
15662,30,4579,3955;8124;11730;12793,2190,0,2,2,0,4
15663,30,4580,2490;4000,2190,0,0,2,0,2
15664,30,4581,4012,2190,0,0,0,1,1
15665,30,4582,4073;8269;10850;11229;12331,2190,0,1,4,0,5
15666,30,4583,4475;8679;11057;11290;11414;11594,2190,0,1,5,0,6
15667,30,4585,8388;9573;12273,2190,0,1,2,0,3
15668,30,4586,9831,2190,0,0,0,1,1
15669,30,4587,4813,2190,0,0,0,1,1
15670,30,4588,3720,2190,0,0,0,1,1
15671,30,4591,817;1415;11339;11711;12115;12596,2190,0,3,3,0,6
15672,30,4593,1824;5606;11681;12966,2190,0,2,2,0,4
15673,30,4595,4893,2190,0,0,0,1,1
15674,30,4597,5896;8349,2190,0,0,2,0,2
15675,30,4598,5963;6170;11970;12236,2190,0,2,2,0,4
15676,30,4599,3387;3985;10813;11507;11535,2190,0,1,4,0,5
15677,30,4600,6118;6503;12918,2190,0,1,2,0,3
15678,30,4601,1116;6347;12589,2190,0,1,2,0,3
15679,30,4605,6594,2190,0,0,0,1,1
15680,30,4606,4594;6602;10780,2190,0,0,3,0,3
15681,30,4607,3164;6774;11728;11990,2190,0,2,2,0,4
15682,30,4608,7001;7227,2190,0,0,0,2,2
15683,30,4610,6854;7102,2190,0,0,2,0,2
15684,30,4611,6191;7222,2190,0,0,2,0,2
15685,30,4612,7331;9854,2190,0,0,2,0,2
15686,30,4613,7353;7691;11816,2190,0,1,2,0,3
15687,30,4614,6193,2190,0,0,1,0,1
15688,30,4615,5518;7705;11918,2190,0,1,2,0,3
15689,30,4619,4141;6262;7874;11431;11844;11897,2190,0,2,4,0,6
15690,30,4620,7982,2190,0,0,0,1,1
15691,30,4621,8184;8479;10969;12105,2190,0,1,3,0,4
15692,30,4623,8204,2190,0,0,0,1,1
15693,30,4624,8318;11343;11606;12368,2190,0,2,2,0,4
15694,30,4627,779;8398,2190,0,0,0,2,2
15695,30,4629,5261;8798;11901,2190,0,1,2,0,3
15696,30,4632,7183,2190,0,0,0,1,1
15697,30,4633,9370;11561;12009,2190,0,2,1,0,3
15698,30,4634,9484;9926;11614;11707;12035,2190,0,3,2,0,5
15699,30,4637,9590,2190,0,0,0,1,1
15700,30,4638,9616,2190,0,0,1,0,1
15701,30,4639,8408;9643;12418,2190,0,1,2,0,3
15702,30,4640,2500;9677;12527;13269,2190,1,1,2,0,4
15703,30,4641,9825,2190,0,0,1,0,1
15704,30,4643,2901;4053;12967;13617,2190,1,1,2,0,4
15705,30,4645,232;7930,2555,0,0,2,0,2
15706,30,4646,1583;2892;12201,2555,0,1,2,0,3
15707,30,4647,278;488;11798;12499;12556,2555,0,3,2,0,5
15708,30,4648,289,2555,0,0,0,1,1
15709,30,4649,350;8039;12359;12913;13010,2555,0,3,2,0,5
15710,30,4650,355;4220,2555,0,0,2,0,2
15711,30,4653,9265,2555,0,0,1,0,1
15712,30,4654,1332;3338;12623,2555,0,1,2,0,3
15713,30,4655,9358;11781;12217;12444,2555,0,3,1,0,4
15714,30,4656,1372;5661;11864;12639,2555,0,2,2,0,4
15715,30,4657,1399;5981;11837,2555,0,1,2,0,3
15716,30,4658,6354;9224;11631;11905,2555,0,2,2,0,4
15717,30,4659,1814;8331;11811;12919,2555,0,2,2,0,4
15718,30,4660,1901;7657,2555,0,0,2,0,2
15719,30,4661,1653;1932;12089;12498,2555,0,2,2,0,4
15720,30,4662,1935;11356;12870,2555,0,1,2,0,3
15721,30,4664,1230;2289;11700,2555,0,1,2,0,3
15722,30,4666,603;3678;11195,2555,0,0,3,0,3
15723,30,4668,2605;8226;11791,2555,0,1,2,0,3
15724,30,4669,2681;10855,2555,0,0,2,0,2
15725,30,4670,2766;4979;10863;11754,2555,0,1,3,0,4
15726,30,4671,2800;9501;12735,2555,0,1,2,0,3
15727,30,4672,2058;6971;12955;13519,2555,1,1,2,0,4
15728,30,4674,1207;3144;11537;11813,2555,0,2,2,0,4
15729,30,4675,1494;3268;11440;11989,2555,0,1,3,0,4
15730,30,4676,3277;9114;12559,2555,0,1,2,0,3
15731,30,4677,1505;3524;11595;12613,2555,0,2,2,0,4
15732,30,4678,3574;6102;11652,2555,0,1,2,0,3
15733,30,4679,3703;6767,2555,0,0,2,0,2
15734,30,4681,3766;7342,2555,0,0,2,0,2
15735,30,4683,4101;7391;11445;11655;12298,2555,0,2,3,0,5
15736,30,4684,4224;9996;10886,2555,0,0,3,0,3
15737,30,4685,4239,2555,0,0,0,1,1
15738,30,4686,4258;7255;11531;11832;12210,2555,0,3,2,0,5
15739,30,4688,714;4272;10853;11453;11751;11932,2555,0,2,4,0,6
15740,30,4689,1692;4398;11107,2555,0,0,3,0,3
15741,30,4690,8583,2555,0,0,0,1,1
15742,30,4691,7058;11172;11397;11639,2555,0,1,3,0,4
15743,30,4692,8272;9588;11016;11480;12524,2555,0,1,4,0,5
15744,30,4697,686;8618;12370,2555,0,1,2,0,3
15745,30,4699,5167,2555,0,0,0,1,1
15746,30,4700,2067;8680;11244;11834;12289,2555,0,2,3,0,5
15747,30,4701,5327,2555,0,0,0,1,1
15748,30,4703,2310;5499,2555,0,0,0,2,2
15749,30,4706,4978;5604;11383;11547,2555,0,1,3,0,4
15750,30,4708,5691;6164;11787;11962,2555,0,2,2,0,4
15751,30,4709,65;5799;11496,2555,0,0,3,0,3
15752,30,4710,2692;5988;11403;12833,2555,0,1,3,0,4
15753,30,4714,3131,2555,0,0,0,1,1
15754,30,4715,1910;6409,2555,0,0,0,2,2
15755,30,4716,6440;9797;11749,2555,0,1,2,0,3
15756,30,4717,6473,2555,0,0,0,1,1
15757,30,4718,272;6701;11520;11608;11690,2555,0,2,3,0,5
15758,30,4719,203;1140;10939;11464,2555,0,0,4,0,4
15759,30,4720,404;6769;11176;11729;12254,2555,0,2,3,0,5
15760,30,4721,4198;6778,2555,0,0,0,2,2
15761,30,4723,2007;6867;10963;13094;13198,2555,1,1,3,0,5
15762,30,4724,6949;8822;11940;12875;13430,2555,1,2,2,0,5
15763,30,4725,6951;8831;11634,2555,0,1,2,0,3
15764,30,4726,7078;8122;11821;13047,2555,0,2,2,0,4
15765,30,4728,2022;7820,2555,0,0,0,2,2
15766,30,4729,3125;7569;11086;13096,2555,0,1,3,0,4
15767,30,4730,4649;8516;11030,2555,0,0,3,0,3
15768,30,4731,316;6037;12450;13229,2555,1,1,2,0,4
15769,30,4732,7926,2555,0,0,1,0,1
15770,30,4733,8002;8006,2555,0,0,0,2,2
15771,30,4734,3436;11283;11758,2555,0,1,2,0,3
15772,30,4735,8087;9843;11320;11454,2555,0,0,4,0,4
15773,30,4736,8157,2555,0,0,0,1,1
15774,30,4737,3218;8271;11470;12257,2555,0,1,3,0,4
15775,30,4738,986;8501,2555,0,0,2,0,2
15776,30,4739,8596;12239,2555,0,1,1,0,2
15777,30,4740,7072;8740;13145,2555,1,0,2,0,3
15778,30,4742,8795,2555,0,0,0,1,1
15779,30,4746,3418;9214,2555,0,0,2,0,2
15780,30,4747,9328;11119;11400,2555,0,0,3,0,3
15781,30,4748,1612,2555,0,0,0,1,1
15782,30,4750,7341;9499;12255;12722,2555,0,2,2,0,4
15783,30,4753,2628,2555,0,0,1,0,1
15784,30,4755,7307;9883;11676;11938,2555,0,2,2,0,4
15785,30,4757,1061;9898;11554;11937;12159,2555,0,3,2,0,5
15786,30,4758,42,2920,0,0,0,1,1
15787,30,4759,146;4129;12737;13577,2920,1,1,2,0,4
15788,30,4761,9145;11224;12186;12539,2920,0,2,2,0,4
15789,30,4767,687,2920,0,0,0,1,1
15790,30,4770,864;1235;12991,2920,0,1,2,0,3
15791,30,4771,1016;11772,2920,0,1,1,0,2
15792,30,4772,892;3406;12137,2920,0,1,2,0,3
15793,30,4774,1099;7992;12051;12818,2920,0,2,2,0,4
15794,30,4775,1634;2355;11951;12125;12578,2920,0,3,2,0,5
15795,30,4776,1123;1648;12023;12371,2920,0,2,2,0,4
15796,30,4778,931;1882;12096,2920,0,1,2,0,3
15797,30,4779,1936;5013;11385;12582,2920,0,1,3,0,4
15798,30,4780,933;11857;12253,2920,0,2,1,0,3
15799,30,4781,2169;8292;13074,2920,0,1,2,0,3
15800,30,4782,1925;8493;13131,2920,1,0,2,0,3
15801,30,4784,2840;8627;11759;12003;12653;12862,2920,0,4,2,0,6
15802,30,4785,2016;2861,2920,0,0,2,0,2
15803,30,4788,55;2960;11889;12319,2920,0,2,2,0,4
15804,30,4789,3155;3704;11322;11909;12321,2920,0,2,3,0,5
15805,30,4791,2812;3193,2920,0,0,2,0,2
15806,30,4792,3207;4713;11130;11341,2920,0,0,4,0,4
15807,30,4793,3374;7185;11922;12906,2920,0,2,2,0,4
15808,30,4794,3449;5870;12782,2920,0,1,2,0,3
15809,30,4796,4209;4500;12191,2920,0,1,2,0,3
15810,30,4797,3959;11725;11794;12107,2920,0,3,1,0,4
15811,30,4798,3533;6375,2920,0,0,2,0,2
15812,30,4800,3626,2920,0,0,0,1,1
15813,30,4801,3695;9392;12251,2920,0,1,2,0,3
15814,30,4802,3812;7921,2920,0,0,2,0,2
15815,30,4803,2180;8417,2920,0,0,2,0,2
15816,30,4804,3849;3879;11220;12245,2920,0,1,3,0,4
15817,30,4805,3940;7403,2920,0,0,2,0,2
15818,30,4806,4022;8425;11541;11935;12864,2920,0,3,2,0,5
15819,30,4807,2456;4044;12925,2920,0,1,2,0,3
15820,30,4808,4411;11391;11912;12234,2920,0,2,2,0,4
15821,30,4811,2359;4399,2920,0,0,2,0,2
15822,30,4813,3518;4949;11538;11777;12771,2920,0,3,2,0,5
15823,30,4814,5086;6295;12097;12638,2920,0,2,2,0,4
15824,30,4815,5125,2920,0,0,0,1,1
15825,30,4816,4924;12339;12604;13244,2920,1,2,1,0,4
15826,30,4817,4637;5378;12128;12149;12358,2920,0,3,2,0,5
15827,30,4821,2581;6770;12423;13095,2920,0,2,2,0,4
15828,30,4822,5864;7034;11741;12303;12485;12602;13352,2920,1,4,2,0,7
15829,30,4824,4582;7293;11871;12473,2920,0,2,2,0,4
15830,30,4825,6284;9189;11902;12801;13108,2920,1,2,2,0,5
15831,30,4826,6454;8443;11671;12043,2920,0,2,2,0,4
15832,30,4827,6464;8013;11031;11463;11560;11870,2920,0,2,4,0,6
15833,30,4828,565;6618;11231;11468,2920,0,0,4,0,4
15834,30,4829,6688;6700;11466;11873;12508,2920,0,2,3,0,5
15835,30,4830,4799;6718;11565;11845,2920,0,2,2,0,4
15836,30,4831,293;7180;10999;12006;12809,2920,0,2,3,0,5
15837,30,4833,3120;8177;12084;12658,2920,0,2,2,0,4
15838,30,4836,6636;7419;11336;11555;12059,2920,0,2,3,0,5
15839,30,4838,3641,2920,0,0,0,1,1
15840,30,4839,4770;6604;11588;11878;12261;13495,2920,1,3,2,0,6
15841,30,4841,2816;7889;13507,2920,1,0,2,0,3
15842,30,4844,7181;8167;12633,2920,0,1,2,0,3
15843,30,4845,8254,2920,0,0,0,1,1
15844,30,4846,6989;8807;12148;12821,2920,0,2,2,0,4
15845,30,4847,4854;8406;12147,2920,0,1,2,0,3
15846,30,4851,8169;8784;12040,2920,0,1,2,0,3
15847,30,4854,2093;8997;11281,2920,0,0,3,0,3
15848,30,4856,1647;9196;12044,2920,0,1,2,0,3
15849,30,4857,8123;9355;11964;12229;12272,2920,0,3,2,0,5
15850,30,4858,3895;12567,2920,0,1,1,0,2
15851,30,4859,513;9664;11500;11722;12220;12600,2920,0,3,3,0,6
15852,30,4860,6036;9681;12277,2920,0,1,2,0,3
15853,30,4861,620,2920,0,0,0,1,1
15854,30,4862,7378;9833;11167,2920,0,0,1,2,3
15855,30,4863,848;9930,2920,0,0,2,0,2
15856,30,4864,3011;6689;11239;12078;12835,2920,0,2,3,0,5
15857,30,4867,37;7398;11564;11704;11775,3285,0,3,2,0,5
15858,30,4869,116;4373;12041;12591,3285,0,2,2,0,4
15859,30,4870,128;1728,3285,0,0,0,2,2
15860,30,4871,4628;11309;12603,3285,0,1,2,0,3
15861,30,4872,188;8187,3285,0,0,2,0,2
15862,30,4873,13;6820;12265;12472,3285,0,2,2,0,4
15863,30,4874,375;381,3285,0,0,0,2,2
15864,30,4875,6629;11532;11883;12934;13350,3285,1,3,1,0,5
15865,30,4876,536;4280,3285,0,0,2,0,2
15866,30,4878,6699;9280;11302;11386;12622;12938,3285,0,2,4,0,6
15867,30,4880,877;9879;12650;13615,3285,1,1,2,0,4
15868,30,4881,952;8083;11744;12400;12964,3285,0,3,2,0,5
15869,30,4882,958;9799;12785,3285,0,1,2,0,3
15870,30,4883,3376;9816;11071;11446;12131,3285,0,1,4,0,5
15871,30,4885,7013,3285,0,0,0,1,1
15872,30,4886,1658;7245,3285,0,0,0,2,2
15873,30,4890,4320;11089,3285,0,0,2,0,2
15874,30,4891,4435;9649,3285,0,0,2,0,2
15875,30,4892,1977,3285,0,0,0,1,1
15876,30,4893,6054;9245;11259;11372;13040,3285,0,1,4,0,5
15877,30,4894,936,3285,0,0,1,0,1
15878,30,4895,2205,3285,0,0,0,1,1
15879,30,4896,3788,3285,0,0,1,0,1
15880,30,4898,1386;2417;12824;13204,3285,1,1,2,0,4
15881,30,4899,3698;5159;11132;12656;13610,3285,1,1,3,0,5
15882,30,4900,4553;8903;12205;12478,3285,0,2,2,0,4
15883,30,4903,3789,3285,0,0,0,1,1
15884,30,4905,3276;6405;11815;12183;13568,3285,1,2,2,0,5
15885,30,4907,8650;12262;13016;13348;13450,3285,2,2,1,0,5
15886,30,4909,3523;5949;11762;12073;13552,3285,1,2,2,0,5
15887,30,4910,6559,3285,0,0,1,0,1
15888,30,4913,3633;8214,3285,0,0,2,0,2
15889,30,4914,4401;5774;12698,3285,0,1,2,0,3
15890,30,4915,3672;6847;12394,3285,0,1,2,0,3
15891,30,4916,3716;4576;12685,3285,0,1,2,0,3
15892,30,4918,3869;9188;12007;12462,3285,0,2,2,0,4
15893,30,4919,3070;3968;11036;11476;12110,3285,0,1,4,0,5
15894,30,4922,1318;11562;11763,3285,0,2,1,0,3
15895,30,4923,4479;4499;11046;11609,3285,0,1,3,0,4
15896,30,4925,793;4721;11888;12226,3285,0,2,2,0,4
15897,30,4926,9570,3285,0,0,0,1,1
15898,30,4927,2217;4131,3285,0,0,1,1,2
15899,30,4931,5692;5936;12024;13288,3285,1,1,2,0,4
15900,30,4932,4517,3285,0,0,1,0,1
15901,30,4933,2383;5863;11833;12362,3285,0,2,2,0,4
15902,30,4934,5257;8595;11658,3285,0,1,2,0,3
15903,30,4935,3741;9768;12304;12637;13660,3285,1,2,2,0,5
15904,30,4936,6120,3285,0,0,0,1,1
15905,30,4937,6188;11268;11443;11622;12958,3285,0,2,3,0,5
15906,30,4938,4514;6285;11770;12022,3285,0,2,2,0,4
15907,30,4939,2080;6486,3285,0,0,0,2,2
15908,30,4940,6537,3285,0,0,1,0,1
15909,30,4941,4850;6727;11460;12062;12885,3285,0,2,3,0,5
15910,30,4944,6954;8808;12060;12501;12703,3285,0,3,2,0,5
15911,30,4945,6792;6970;11899;12198,3285,0,2,2,0,4
15912,30,4947,7192;9985;11285;11692;11903;12750;13149,3285,1,3,3,0,7
15913,30,4949,2215;2395;11882;12624;13264,3285,1,2,2,0,5
15914,30,4950,4293;7428;11076;11203,3285,0,0,4,0,4
15915,30,4951,3417;7461;12436;12994,3285,0,2,2,0,4
15916,30,4952,3575;7488;12032,3285,0,1,2,0,3
15917,30,4953,7752,3285,0,0,0,1,1
15918,30,4956,9462,3285,0,0,0,1,1
15919,30,4958,8319,3285,0,0,0,1,1
15920,30,4959,6542;8368,3285,0,0,2,0,2
15921,30,4960,1707;8466;11238,3285,0,0,3,0,3
15922,30,4962,5021;9351;11592,3285,0,1,2,0,3
15923,30,4963,8911,3285,0,0,0,1,1
15924,30,4964,8623;9221;11360,3285,0,0,3,0,3
15925,30,4965,2429,3285,0,0,0,1,1
15926,30,4966,7330;9017;11548;11661;12311,3285,0,3,2,0,5
15927,30,4967,8748,3285,0,0,0,1,1
15928,30,4969,1238;6420;11875,3285,0,1,2,0,3
15929,30,4971,5675;8262,3285,0,0,1,1,2
15930,30,4972,6064;7025,3285,0,0,2,0,2
15931,30,4973,2654;9818;11425;11585;12438;12669;12806;13110;13585,3285,2,4,3,0,9
15932,30,4975,2972;9739;11478;12012,3285,0,1,3,0,4
15933,30,4977,153;7525;11335;11559;13175;13512,3650,2,1,3,0,6
15934,30,4978,348;7068;13526,3650,1,0,2,0,3
15935,30,4979,360;3298;11900,3650,0,1,2,0,3
15936,30,4980,336;4294,3650,0,0,2,0,2
15937,30,4981,721;1364;11271;12340;12790;13093;13281;13712,3650,2,3,3,0,8
15938,30,4982,2656;7746;11656;11999;13201,3650,1,2,2,0,5
15939,30,4983,1032;9455;11493,3650,0,0,3,0,3
15940,30,4984,3407;6878;13476,3650,1,0,2,0,3
15941,30,4986,1256,3650,0,0,0,1,1
15942,30,4987,3381;8110;12693;13504,3650,1,1,2,0,4
15943,30,4989,1351;8099;11856;12029;12550;12905,3650,0,4,2,0,6
15944,30,4990,1416;2799;12379,3650,0,1,2,0,3
15945,30,4993,7046,3650,0,0,0,1,1
15946,30,4994,1933;7554;12482;13222,3650,1,1,2,0,4
15947,30,4995,2018,3650,0,0,0,1,1
15948,30,4997,2362,3650,0,0,0,1,1
15949,30,4998,2384;9891,3650,0,0,2,0,2
15950,30,4999,1217;2404;12091;12258;12417,3650,0,3,2,0,5
15951,30,5000,8361,3650,0,0,0,1,1
15952,30,5001,2593;6933;11556;11696;12260,3650,0,3,2,0,5
15953,30,5002,3520;8336;11448;11892,3650,0,1,3,0,4
15954,30,5003,4859;7275;12142;12349,3650,0,2,2,0,4
15955,30,5004,1141;1599;12753;13548,3650,1,1,2,0,4
15956,30,5006,3930;8826;12068,3650,0,1,2,0,3
15957,30,5007,3240;7825,3650,0,0,2,0,2
15958,30,5008,333;6616;11769;11931,3650,0,2,2,0,4
15959,30,5010,4061,3650,0,0,1,0,1
15960,30,5011,4308;5662;12509;13311,3650,1,1,2,0,4
15961,30,5012,393;1666;11876,3650,0,1,2,0,3
15962,30,5014,630;4581;11355;11590;11776,3650,0,2,3,0,5
15963,30,5015,2669;11170;11246;12373;12395,3650,0,2,3,0,5
15964,30,5016,4823;8842,3650,0,0,0,2,2
15965,30,5017,4953;8796;11417;12756,3650,0,1,3,0,4
15966,30,5018,5157,3650,0,0,0,1,1
15967,30,5019,955,3650,0,0,0,1,1
15968,30,5020,111;5195,3650,0,0,2,0,2
15969,30,5021,5572;8297;11557;12420;12902,3650,0,3,2,0,5
15970,30,5023,6278;8589;11848;12233,3650,0,2,2,0,4
15971,30,5024,6750;12341,3650,0,1,1,0,2
15972,30,5025,147;9021,3650,0,0,2,0,2
15973,30,5028,3492;5950;11982;13062,3650,0,2,2,0,4
15974,30,5029,6068;6846,3650,0,0,2,0,2
15975,30,5030,444;6773;13356;13481,3650,2,0,2,0,4
15976,30,5031,2629;6661;12076;12227,3650,0,2,2,0,4
15977,30,5033,4095;7450,3650,0,0,0,2,2
15978,30,5036,9139;9423;11513;12869;13391,3650,1,1,3,0,5
15979,30,5038,6592;8005,3650,0,0,2,0,2
15980,30,5039,2475;8106;11737;11927;12853;13652,3650,1,3,2,0,6
15981,30,5040,8719,3650,0,0,1,0,1
15982,30,5041,2033;8307;12431;12792,3650,0,2,2,0,4
15983,30,5042,8291;8473;11261;11524;11850;11991;12391;12932;13021;13458,3650,1,5,4,0,10
15984,30,5044,8921;9634,3650,0,0,1,1,2
15985,30,5045,6982;8977;11310;13007,3650,0,1,3,0,4
15986,30,5046,4045;8384;11783,3650,0,1,2,0,3
15987,30,5047,2543;5964;12671;13160,3650,1,1,2,0,4
15988,30,5049,3;11419;11942,3650,0,1,2,0,3
15989,30,5051,706;9517,3650,0,0,2,0,2
15990,30,5052,9637;12061;12458,3650,0,2,1,0,3
15991,30,5053,4187;9642;11395,3650,0,0,3,0,3
15992,30,5054,7969;9782;12649;13425,3650,1,1,2,0,4
15993,30,5056,36;4860;11435;11675;12221;12772,4015,0,3,3,0,6
15994,30,5057,48,4015,0,0,1,0,1
15995,30,5058,49;5525;11944;12922,4015,0,2,2,0,4
15996,30,5059,102,4015,0,0,0,1,1
15997,30,5060,189;9134;11603;12230,4015,0,2,2,0,4
15998,30,5061,239;8389;13089;13218,4015,1,1,2,0,4
15999,30,5062,260,4015,0,0,0,1,1
16000,30,5063,298,4015,0,0,1,0,1
16001,30,5067,43;684,4015,0,0,2,0,2
16002,30,5068,182;11399;11719,4015,0,1,2,0,3
16003,30,5069,1064;5302;12452;12664,4015,0,2,2,0,4
16004,30,5070,2008;3087;11257;11723;12290;12732,4015,0,3,3,0,6
16005,30,5071,1593,4015,0,0,0,1,1
16006,30,5072,1608;7939;13105,4015,1,0,2,0,3
16007,30,5074,1963;6531;11338;12001;12640;13033,4015,0,3,3,0,6
16008,30,5075,2010;9285,4015,0,0,2,0,2
16009,30,5076,2273;11333;11600;13124,4015,1,1,2,0,4
16010,30,5077,2291;9226;12495;13647,4015,1,1,2,0,4
16011,30,5078,983,4015,0,0,1,0,1
16012,30,5079,2498;6879;11392;12747;13153,4015,1,1,3,0,5
16013,30,5081,2878;5025;12811;13234;13365,4015,2,1,2,0,5
16014,30,5085,2244;3012,4015,0,0,2,0,2
16015,30,5086,3027;11910,4015,0,1,1,0,2
16016,30,5087,1746;2979;11542;12123;12347;12826,4015,0,4,2,0,6
16017,30,5088,1979;3173;3776;11347;11757;12419,4015,0,2,4,0,6
16018,30,5090,3335,4015,0,0,1,0,1
16019,30,5091,1987;3400;12098;12571;13071,4015,0,3,2,0,5
16020,30,5092,8290;8567;11841;12050;12461,4015,0,3,2,0,5
16021,30,5093,3527;7699,4015,0,0,2,0,2
16022,30,5094,1251;3636,4015,0,0,2,0,2
16023,30,5095,3673;12138,4015,0,1,1,0,2
16024,30,5098,3076;4186;12067,4015,0,1,2,0,3
16025,30,5099,4283;11917;13100,4015,1,1,1,0,3
16026,30,5101,4486;6157;12492,4015,0,1,2,0,3
16027,30,5102,3872;4510;11589;12629,4015,0,2,2,0,4
16028,30,5103,4607,4015,0,0,0,1,1
16029,30,5104,4767,4015,0,0,0,1,1
16030,30,5105,4874;8014;11727,4015,0,1,2,0,3
16031,30,5106,985;3309;12114;12536,4015,0,2,2,0,4
16032,30,5107,5616,4015,0,0,1,0,1
16033,30,5108,8498;11641;12231;13169,4015,1,2,1,0,4
16034,30,5111,7238;11743;12428;12748;13659,4015,1,3,1,0,5
16035,30,5112,5590;9485;12266;12635,4015,0,2,2,0,4
16036,30,5116,6240;8469;12694,4015,0,1,2,0,3
16037,30,5117,1751;5395;12080;12515;12741;12945,4015,0,4,2,0,6
16038,30,5118,2265;8815;11662;11952;12194,4015,0,3,2,0,5
16039,30,5120,5723;6536;11644;13340;13645,4015,2,1,2,0,5
16040,30,5121,5722;6595;11908,4015,0,1,2,0,3
16041,30,5123,5537,4015,0,0,0,1,1
16042,30,5124,2175;6981;12760;13433,4015,1,1,2,0,4
16043,30,5125,1339;3960,4015,0,0,2,0,2
16044,30,5126,3215;7073;12557;12705,4015,0,2,2,0,4
16045,30,5127,7739;9045;11550;11983;12652,4015,0,3,2,0,5
16046,30,5129,3674;7494;11855,4015,0,1,2,0,3
16047,30,5130,3986;9231;11943;12662,4015,0,2,2,0,4
16048,30,5131,7618,4015,0,0,0,1,1
16049,30,5134,1770;9844;11774;13019;13318,4015,1,2,2,0,5
16050,30,5137,8253;8756;11790;12174;12308,4015,0,3,2,0,5
16051,30,5140,4655;8037;11760;12218;12384,4015,0,3,2,0,5
16052,30,5141,9030,4015,0,0,0,1,1
16053,30,5142,5063;11379;11818;11961,4015,0,2,2,0,4
16054,30,5144,479;9220;12335,4015,0,1,2,0,3
16055,30,5146,9118;9665;11635;13513,4015,1,1,2,0,4
16056,30,5147,3696;9687;12286;12562,4015,0,2,2,0,4
16057,30,5149,6751;9756;11429;11963;12749;13416,4015,1,2,3,0,6
16058,30,5153,74;11684;11868;12017,4380,0,3,1,0,4
16059,30,5155,183,4380,0,0,1,0,1
16060,30,5156,224,4380,0,0,0,1,1
16061,30,5157,347;11705,4380,0,1,1,0,2
16062,30,5158,616;4307;13178,4380,1,0,2,0,3
16063,30,5160,766,4380,0,0,0,1,1
16064,30,5161,3758;5002;11509;11911;12491,4380,0,2,3,0,5
16065,30,5163,1084;2783;11822;12102,4380,0,2,2,0,4
16066,30,5165,891;1270;12711;12979,4380,0,2,2,0,4
16067,30,5166,221,4380,0,0,0,1,1
16068,30,5167,1522;8198;11660;12215;12791;12960;13720,4380,1,4,2,0,7
16069,30,5168,2322;2815;11604;12310;12474;12726,4380,0,4,2,0,6
16070,30,5173,1313;2027;12714;13292,4380,1,1,2,0,4
16071,30,5174,2083;9345,4380,0,0,0,2,2
16072,30,5175,584;2091;12291;12551;13048,4380,0,3,2,0,5
16073,30,5177,2231;2693;11736;12422,4380,0,2,2,0,4
16074,30,5178,2251,4380,0,0,0,1,1
16075,30,5179,5970;6308;13233,4380,1,0,2,0,3
16076,30,5183,2544;7024;11673;11919,4380,0,2,2,0,4
16077,30,5184,2798;9974;11846;12581,4380,0,2,2,0,4
16078,30,5186,4597,4380,0,0,0,1,1
16079,30,5187,561;2787;12090;12197,4380,0,2,2,0,4
16080,30,5188,2390;2807,4380,0,0,0,2,2
16081,30,5189,2891;4511,4380,0,0,2,0,2
16082,30,5190,1192;2959;13750,4380,1,0,2,0,3
16083,30,5191,2995;5072;11645;12129;12369,4380,0,3,2,0,5
16084,30,5194,1001;3121;11474,4380,0,0,3,0,3
16085,30,5195,3204,4380,0,0,0,1,1
16086,30,5196,3351;11365;11456,4380,0,0,3,0,3
16087,30,5197,3202;3468;12380;12467,4380,0,2,2,0,4
16088,30,5198,2742;3493;11597;11785,4380,0,2,2,0,4
16089,30,5199,1698;3730;12610;13005;13375,4380,1,2,2,0,5
16090,30,5202,3856;4781,4380,0,0,0,2,2
16091,30,5203,2239;6158;11695;11768;12228,4380,0,3,2,0,5
16092,30,5204,7914;9102;12574;13066,4380,0,2,2,0,4
16093,30,5206,9236,4380,0,0,0,1,1
16094,30,5207,1427;6453;12740;13381,4380,1,1,2,0,4
16095,30,5208,4855;8497;12049;12575;12927,4380,0,3,2,0,5
16096,30,5211,4505;8853;12351,4380,0,1,2,0,3
16097,30,5213,1705;5643;11607;12850,4380,0,2,2,0,4
16098,30,5214,4964,4380,0,0,0,1,1
16099,30,5215,4816;8874,4380,0,0,0,2,2
16100,30,5216,5132,4380,0,0,0,1,1
16101,30,5218,5212;9321;11401;11533;11860,4380,0,2,3,0,5
16102,30,5219,212;1148,4380,0,0,2,0,2
16103,30,5220,5967;8899;12206;12999,4380,0,2,2,0,4
16104,30,5222,7681;8779;13241,4380,1,0,2,0,3
16105,30,5225,4267;7777;12642;13802,4380,1,1,2,0,4
16106,30,5226,6861;7683,4380,0,0,2,0,2
16107,30,5227,6868,4380,0,0,0,1,1
16108,30,5230,6973;7867;11674;12521,4380,0,2,2,0,4
16109,30,5232,2880;7029;11745;12100;12665,4380,0,3,2,0,5
16110,30,5233,3931;4263,4380,0,0,1,1,2
16111,30,5234,7141,4380,0,0,1,0,1
16112,30,5236,7306;8283;12716;13176,4380,1,1,2,0,4
16113,30,5238,3116;7357;11830;12004;12246,4380,0,3,2,0,5
16114,30,5239,7385,4380,0,0,1,0,1
16115,30,5240,2108;7503;11678;11998;12077;12998,4380,0,4,2,0,6
16116,30,5242,7077;7679;11437;11839;12071;12475,4380,0,3,3,0,6
16117,30,5245,3402;7913;12101;12468;13760,4380,1,2,2,0,5
16118,30,5246,2555;7995;11773;12113;12558,4380,0,3,2,0,5
16119,30,5248,8079,4380,0,0,0,1,1
16120,30,5251,7173,4380,0,0,0,1,1
16121,30,5252,4449;8741;11936;12232,4380,0,2,2,0,4
16122,30,5253,8780;8922;11469;12031;12135;12456;12839;13186,4380,1,4,3,0,8
16123,30,5254,3710;8806;12947;13792,4380,1,1,2,0,4
16124,30,5256,9022,4380,0,0,0,1,1
16125,30,5257,9040;12193,4380,0,1,1,0,2
16126,30,5259,9498,4380,0,0,0,1,1
16127,30,5260,3951;9552,4380,0,0,2,0,2
16128,30,5261,9589;12723;13510,4380,1,1,1,0,3
16129,30,5263,6948;7236,4380,0,0,2,0,2
16130,30,5265,4016;5451;11863;12153;12900,4745,0,3,2,0,5
16131,30,5266,25;9925,4745,0,0,1,1,2
16132,30,5267,107;11602;11843,4745,0,2,1,0,3
16133,30,5268,240;7776;12487;12855;13367,4745,1,2,2,0,5
16134,30,5274,786;6275;11766;12046;12736;13588,4745,1,3,2,0,6
16135,30,5277,1076,4745,0,0,0,1,1
16136,30,5279,1654;3028;11971;12451;12805,4745,0,3,2,0,5
16137,30,5281,1559,4745,0,0,0,1,1
16138,30,5282,1609;4481;12185;12326;12577,4745,0,3,2,0,5
16139,30,5285,3455;7019;12388;12968;13172,4745,1,2,2,0,5
16140,30,5286,50;7142;11577;11992;12457;12766,4745,0,4,2,0,6
16141,30,5287,2462;3944,4745,0,0,2,0,2
16142,30,5288,9450;9976;11517;11584;12103,4745,0,2,3,0,5
16143,30,5290,2791,4745,0,0,0,1,1
16144,30,5291,1766;2842;11788;11920;12882,4745,0,3,2,0,5
16145,30,5292,8894;12682;13472,4745,1,1,1,0,3
16146,30,5293,3025;9047,4745,0,0,1,1,2
16147,30,5295,3234;9033;12570;12678;12996,4745,0,3,2,0,5
16148,30,5296,3320,4745,0,0,0,1,1
16149,30,5299,837;3467,4745,0,0,2,0,2
16150,30,5300,1652;3401;12047;12874,4745,0,2,2,0,4
16151,30,5302,1787;3749;12203;12306;13353,4745,1,2,2,0,5
16152,30,5303,3793,4745,0,0,0,1,1
16153,30,5305,1966;3873;13484;13804,4745,2,0,2,0,4
16154,30,5306,3945;8759;12500;13065,4745,0,2,2,0,4
16155,30,5308,1344;4252;11780;12823,4745,0,2,2,0,4
16156,30,5309,7534;9015;12042;12777;13491,4745,1,2,2,0,5
16157,30,5310,8743,4745,0,0,0,1,1
16158,30,5311,4558,4745,0,0,0,1,1
16159,30,5315,5044;8566;11960;13158,4745,1,1,2,0,4
16160,30,5316,5181;7747;11714;11852;12544;12812,4745,0,4,2,0,6
16161,30,5317,1444;5516,4745,0,0,0,2,2
16162,30,5318,3458;5565;11508;11697;12995,4745,0,2,3,0,5
16163,30,5319,3380;5805;12352;12414;12827;13420,4745,1,3,2,0,6
16164,30,5320,4630;5962;11636;11861;13649,4745,1,2,2,0,5
16165,30,5323,6;3069;12167;12398;12825,4745,0,3,2,0,5
16166,30,5324,6201;9400;11981;12878,4745,0,2,2,0,4
16167,30,5326,7212;9454;12784;12949,4745,0,2,2,0,4
16168,30,5327,2434;7127;11616;11685;12297;12831;13055,4745,0,5,2,0,7
16169,30,5328,6555;11627;12348;12481,4745,0,3,1,0,4
16170,30,5331,3404;6738,4745,0,0,0,2,2
16171,30,5332,6517,4745,0,0,0,1,1
16172,30,5335,7149;7414,4745,0,0,1,1,2
16173,30,5336,1161;3717;12240;13138,4745,1,1,2,0,4
16174,30,5337,7276;8892;12502;12836;13247,4745,1,2,2,0,5
16175,30,5338,3238;7300;12249;12267;13024,4745,0,3,2,0,5
16176,30,5339,7496;7704;12730,4745,0,1,2,0,3
16177,30,5340,7500,4745,0,0,1,0,1
16178,30,5341,1789;7553;12021;13117,4745,1,1,2,0,4
16179,30,5342,54;12104,4745,0,1,1,0,2
16180,30,5343,3956;8505,4745,0,0,2,0,2
16181,30,5344,6918;8514;11688;12168;12516,4745,0,3,2,0,5
16182,30,5345,5396;8520;12522;12920;13378,4745,1,2,2,0,5
16183,30,5346,8527;9693;13505,4745,1,0,2,0,3
16184,30,5347,5137;8065;12397;12858,4745,0,2,2,0,4
16185,30,5348,236;1750;11621;11802,4745,0,2,2,0,4
16186,30,5349,8629;9003;11721;12447,4745,0,2,2,0,4
16187,30,5350,2699;8643;12594;12923;13140;13237,4745,2,2,2,0,6
16188,30,5351,1500;8912;12636;12895,4745,0,2,2,0,4
16189,30,5352,953;11653;11800;12459;13043;13761,4745,1,4,1,0,6
16190,30,5353,9417;9798;12377;12563,4745,0,2,2,0,4
16191,30,5354,9488,4745,0,0,1,0,1
16192,30,5355,2168;2449;11659;12109,4745,0,2,2,0,4
16193,30,5356,8401,4745,0,0,0,1,1
16194,30,5357,3457;9684;12151,4745,0,1,2,0,3
16195,30,5358,294;5190;11914;12572,4745,0,2,2,0,4
16196,30,5359,6631;9726,4745,0,0,2,0,2
16197,30,5360,8797;9837,4745,0,0,2,0,2
16198,30,5362,144,5110,0,0,0,1,1
16199,30,5363,175;7696;11650;12127;12883;13414,5110,1,3,2,0,6
16200,30,5364,216;6719;12383;12399;13580,5110,1,2,2,0,5
16201,30,5367,639;4828;11877;12292;12944,5110,0,3,2,0,5
16202,30,5368,648;1572;12225;12323;12406;12781;13076,5110,0,5,2,0,7
16203,30,5369,853;7460;12269;13656,5110,1,1,2,0,4
16204,30,5370,883,5110,0,0,0,1,1
16205,30,5372,1477;1714;12744;13142,5110,1,1,2,0,4
16206,30,5373,679;1535,5110,0,0,2,0,2
16207,30,5374,1642,5110,0,0,0,1,1
16208,30,5377,944;6905;11612;12699,5110,0,2,2,0,4
16209,30,5378,2517;9112,5110,0,0,2,0,2
16210,30,5379,2623;9899,5110,0,0,0,2,2
16211,30,5380,2300;2789;11958;12330;12978;13267,5110,1,3,2,0,6
16212,30,5382,8716,5110,0,0,0,1,1
16213,30,5384,870;3428;12401;13355,5110,1,1,2,0,4
16214,30,5385,3611;8133;12112;12921,5110,0,2,2,0,4
16215,30,5386,3691;9709;12667;13151;13722,5110,2,1,2,0,5
16216,30,5388,1986;5573;12439;12541,5110,0,2,2,0,4
16217,30,5389,3978,5110,0,0,1,0,1
16218,30,5390,8312;9558,5110,0,0,0,2,2
16219,30,5391,4035;12546,5110,0,1,1,0,2
16220,30,5393,4070;7990;12464;12888;13332,5110,1,2,2,0,5
16221,30,5394,4264,5110,0,0,0,1,1
16222,30,5395,8303,5110,0,0,0,1,1
16223,30,5396,3389;4691,5110,0,0,1,1,2
16224,30,5397,2364;4963;12770;13039;13726,5110,1,2,2,0,5
16225,30,5398,5031;5688;12725,5110,0,1,2,0,3
16226,30,5400,5588,5110,0,0,0,1,1
16227,30,5401,4595;5674;12280;12764;13723,5110,1,2,2,0,5
16228,30,5404,4043;6101;11941;12200;13164,5110,1,2,2,0,5
16229,30,5406,6154;8268;11968,5110,0,1,2,0,3
16230,30,5408,480;6353;11792;13477,5110,1,1,2,0,4
16231,30,5409,802;6406;12579,5110,0,1,2,0,3
16232,30,5410,6693;12025;12443;13057;13273,5110,1,3,1,0,5
16233,30,5411,2594;2750;12857,5110,0,1,2,0,3
16234,30,5412,6791;6950;11628;12375;12489;12887,5110,0,4,2,0,6
16235,30,5413,6875;8845;12093;12561;12993,5110,0,3,2,0,5
16236,30,5414,7030,5110,0,0,1,0,1
16237,30,5415,2870;7039;11812;12037;13553,5110,1,2,2,0,5
16238,30,5416,2014;3476;12320;12851,5110,0,2,2,0,4
16239,30,5417,7367;8050,5110,0,0,2,0,2
16240,30,5418,7409,5110,0,0,0,1,1
16241,30,5420,9251,5110,0,0,0,1,1
16242,30,5421,7332;7697;12150;12433,5110,0,2,2,0,4
16243,30,5422,7872;8746;12086;12366;12405;12593,5110,0,4,2,0,6
16244,30,5423,1548;8168;12742,5110,0,1,2,0,3
16245,30,5424,1239;8252,5110,0,0,2,0,2
16246,30,5425,8370,5110,0,0,0,1,1
16247,30,5426,753;8827;12048;12264;13730,5110,1,2,2,0,5
16248,30,5427,9027,5110,0,0,0,1,1
16249,30,5428,6526;9068;12322;12982,5110,0,2,2,0,4
16250,30,5429,5806;9210;12244;13298;13626,5110,2,1,2,0,5
16251,30,5430,4737,5110,0,0,0,1,1
16252,30,5431,9586,5110,0,0,0,1,1
16253,30,5433,1471;6404;12416;12718;12903,5110,0,3,2,0,5
16254,30,5434,5735;9853;11680;12537;13192;13783,5110,2,2,2,0,6
16255,30,5435,352,5110,0,0,1,0,1
16256,30,5436,2963;7561;12005;12808,5475,0,2,2,0,4
16257,30,5437,87;631;11686;12952,5475,0,2,2,0,4
16258,30,5438,6130,5475,0,0,0,1,1
16259,30,5440,378;5043;12199;12842;13402;13729,5475,2,2,2,0,6
16260,30,5441,431;5792;12065;12421,5475,0,2,2,0,4
16261,30,5442,2795;5715,5475,0,0,2,0,2
16262,30,5443,2651;9783;12532;13174,5475,1,1,2,0,4
16263,30,5444,896;7826;12145;13304;13494,5475,2,1,2,0,5
16264,30,5445,902;9940;11806;12219,5475,0,2,2,0,4
16265,30,5446,1163;4290;12531;13354,5475,1,1,2,0,4
16266,30,5447,1056;8288;13103;13413,5475,2,0,2,0,4
16267,30,5448,1093;5425;11665;11880;12605;12884;13715,5475,1,4,2,0,7
16268,30,5449,3045;11965;12247,5475,0,2,1,0,3
16269,30,5451,1584;4690;12937;13255,5475,1,1,2,0,4
16270,30,5452,2009;6112;12440;12672;13184,5475,1,2,2,0,5
16271,30,5456,1575;5232;13156;13457,5475,2,0,2,0,4
16272,30,5457,2059;12904,5475,0,1,1,0,2
16273,30,5458,1803;5850;12392;13020,5475,0,2,2,0,4
16274,30,5459,1838,5475,0,0,0,1,1
16275,30,5460,1962;6139;11823;12513,5475,0,2,2,0,4
16276,30,5461,8863,5475,0,0,0,1,1
16277,30,5462,2146;2268,5475,0,0,2,0,2
16278,30,5463,574;2159;12256;12899,5475,0,2,2,0,4
16279,30,5466,2499;6108,5475,0,0,2,0,2
16280,30,5468,1451;2948;12514;13163;13578,5475,2,1,2,0,5
16281,30,5471,3359;13602,5475,1,0,1,0,2
16282,30,5472,7119;11756;12045;12704,5475,0,3,1,0,4
16283,30,5473,3504;3530;12973;13294,5475,1,1,2,0,4
16284,30,5474,3513,5475,0,0,0,1,1
16285,30,5475,3586;3639,5475,0,0,2,0,2
16286,30,5476,3794;5241;12687;13148,5475,1,1,2,0,4
16287,30,5478,3921;6117;11803;12027;12430,5475,0,3,2,0,5
16288,30,5479,9248,5475,0,0,0,1,1
16289,30,5480,4154,5475,0,0,0,1,1
16290,30,5482,1147;4381;12056;12279,5475,0,2,2,0,4
16291,30,5483,5116,5475,0,0,1,0,1
16292,30,5484,7189,5475,0,0,0,1,1
16293,30,5485,5134,5475,0,0,1,0,1
16294,30,5486,1706;6675;12942,5475,0,1,2,0,3
16295,30,5487,5170;5196;12529;12692,5475,0,2,2,0,4
16296,30,5488,4140;5277,5475,0,0,2,0,2
16297,30,5490,865;5526,5475,0,0,2,0,2
16298,30,5491,5955,5475,0,0,1,0,1
16299,30,5492,5725,5475,0,0,0,1,1
16300,30,5493,5843;9123,5475,0,0,0,2,2
16301,30,5494,9765;9849;12675;13092,5475,0,2,2,0,4
16302,30,5495,3263;6242,5475,0,0,0,2,2
16303,30,5496,6403,5475,0,0,0,1,1
16304,30,5497,7728;8010;12243;12863;13274;13434;13693,5475,3,2,2,0,7
16305,30,5499,6641;12480;12868;13067,5475,0,3,1,0,4
16306,30,5500,2481;6743;11997;12155,5475,0,2,2,0,4
16307,30,5501,2964;13051;13179,5475,1,1,1,0,3
16308,30,5502,4509;9776;13221;13310,5475,2,0,2,0,4
16309,30,5504,7086,5475,0,0,0,1,1
16310,30,5505,5985;7156;11784;13582,5475,1,1,2,0,4
16311,30,5508,4074;7383;11835;11996;12316;12807;13341,5475,1,4,2,0,7
16312,30,5509,7413,5475,0,0,0,1,1
16313,30,5510,5174;7520;12156;13334,5475,1,1,2,0,4
16314,30,5511,7659;7725,5475,0,0,0,2,2
16315,30,5512,7323;7894;12327;12788;13600,5475,1,2,2,0,5
16316,30,5514,8020,5475,0,0,1,0,1
16317,30,5516,8182,5475,0,0,0,1,1
16318,30,5517,1571;8273;12709;12917,5475,0,2,2,0,4
16319,30,5518,6299;8365;12844;13280;13575,5475,2,1,2,0,5
16320,30,5519,8449,5475,0,0,0,1,1
16321,30,5520,724,5475,0,0,0,1,1
16322,30,5521,3475;8556;13589,5475,1,0,2,0,3
16323,30,5522,3214;5441;12469,5475,0,1,2,0,3
16324,30,5523,1027;1287;12162;13133;13493,5475,2,1,2,0,5
16325,30,5527,1169;8785;12620;12926,5475,0,2,2,0,4
16326,30,5530,5372,5475,0,0,0,1,1
16327,30,5532,6857;9007;12479,5475,0,1,2,0,3
16328,30,5533,3573;9215;12283;12840;13128,5475,1,2,2,0,5
16329,30,5535,2976;7257;12798;13026;13259,5475,1,2,2,0,5
16330,30,5539,26;9704,5475,0,0,0,2,2
16331,30,5540,1450;9720;11831;12338;12911;12981,5475,0,4,2,0,6
16332,30,5543,61;8703;13118;13559,5840,2,0,2,0,4
16333,30,5544,250;838;12601;12939,5840,0,2,2,0,4
16334,30,5545,79;277;12066;12409;13303;13742,5840,2,2,2,0,6
16335,30,5546,367;13648,5840,1,0,1,0,2
16336,30,5548,447;1467;12088;12214;12992,5840,0,3,2,0,5
16337,30,5549,632;12881;13219;13407,5840,2,1,1,0,4
16338,30,5553,1266;13500;13594,5840,2,0,1,0,3
16339,30,5554,1267;12364;12962,5840,0,2,1,0,3
16340,30,5555,319;12172;12587;13098;13421,5840,1,3,1,0,5
16341,30,5556,4385;8877;12674;13190;13642;13808,5840,3,1,2,0,6
16342,30,5557,326;1649;12576,5840,0,1,2,0,3
16343,30,5558,1899,5840,0,0,0,1,1
16344,30,5559,674;8038;12164;12315;13018,5840,0,3,2,0,5
16345,30,5560,5128;12284,5840,0,1,1,0,2
16346,30,5561,2389;6632;13361,5840,1,0,2,0,3
16347,30,5563,2694;4856;11895;12106,5840,0,2,2,0,4
16348,30,5564,163;11985;12598;13426,5840,1,2,1,0,4
16349,30,5565,4098,5840,0,0,0,1,1
16350,30,5567,4892;7712;11928;12018;13136,5840,1,2,2,0,5
16351,30,5568,2910;7016;12963;13529,5840,1,1,2,0,4
16352,30,5569,2965;10100;13449,5840,1,0,2,0,3
16353,30,5571,2975;8278;13530,5840,1,0,2,0,3
16354,30,5572,839;3145;12095;12209,5840,0,2,2,0,4
16355,30,5573,1388;3156,5840,0,0,2,0,2
16356,30,5574,3247;4337;12196;13415,5840,1,1,2,0,4
16357,30,5580,1157;3738;12057;12943,5840,0,2,2,0,4
16358,30,5581,3841;9364;13634,5840,1,0,2,0,3
16359,30,5582,5521;11867;11874;12170,5840,0,3,1,0,4
16360,30,5583,3863;10073;12775;13631,5840,1,1,2,0,4
16361,30,5584,3963;4634;13455;13583,5840,2,0,2,0,4
16362,30,5585,3367;4023;12278;12779,5840,0,2,2,0,4
16363,30,5586,7801,5840,0,0,1,0,1
16364,30,5588,4869,5840,0,0,0,1,1
16365,30,5591,5666;11879,5840,0,1,1,0,2
16366,30,5593,5355;6876,5840,0,0,0,2,2
16367,30,5596,5991,5840,0,0,1,0,1
16368,30,5599,8513,5840,0,0,0,1,1
16369,30,5600,6809;9735;11894;13459,5840,1,1,2,0,4
16370,30,5601,6382;7054,5840,0,0,2,0,2
16371,30,5602,6444;9710;12696;13091,5840,0,2,2,0,4
16372,30,5603,6480;6839;12767;13070;13251,5840,1,2,2,0,5
16373,30,5605,7324;8932,5840,0,0,2,0,2
16374,30,5607,7396;9667;12506;13248;13621,5840,2,1,2,0,5
16375,30,5608,5937;11934;12565,5840,0,2,1,0,3
16376,30,5609,5202;5860;12715;13313,5840,1,1,2,0,4
16377,30,5610,2369;7789;12493;12738,5840,0,2,2,0,4
16378,30,5611,7193;7802;11955;12585;12987;13208,5840,1,3,2,0,6
16379,30,5612,2294;7818,5840,0,0,2,0,2
16380,30,5613,4374;7896;12519,5840,0,1,2,0,3
16381,30,5614,1544;7912;12606;13236,5840,1,1,2,0,4
16382,30,5615,4617;8047;13189;13643,5840,2,0,2,0,4
16383,30,5616,8080,5840,0,0,0,1,1
16384,30,5617,4057;8302;11890;12684;13129,5840,1,2,2,0,5
16385,30,5618,3132;8407;11891;12346,5840,0,2,2,0,4
16386,30,5619,2468,5840,0,0,1,0,1
16387,30,5620,8747;9676,5840,0,0,2,0,2
16388,30,5624,7128;9230;12688;12841,5840,0,2,2,0,4
16389,30,5626,5809;9339;11980;13150,5840,1,1,2,0,4
16390,30,5627,9069;9506;13130;13444,5840,2,0,2,0,4
16391,30,5628,9596;9608;12224;12372,5840,0,2,2,0,4
16392,30,5629,2330;9654;12573;12924;13527,5840,1,2,2,0,5
16393,30,5630,1096;4034;11969;12880;13088,5840,0,3,2,0,5
16394,30,5631,44;3209;12317;13045,6205,0,2,2,0,4
16395,30,5632,405;2063;11906;12654;13790,6205,1,2,2,0,5
16396,30,5633,219;8494;11913;12011;12342;13699,6205,1,3,2,0,6
16397,30,5634,1478,6205,0,0,1,0,1
16398,30,5635,546;665;12510;12965;13677,6205,1,2,2,0,5
16399,30,5636,801,6205,0,0,1,0,1
16400,30,5638,1263;4950;12670;13346,6205,1,1,2,0,4
16401,30,5639,1284;6363;12547;13212,6205,1,1,2,0,4
16402,30,5640,1305;10038;13239;13675,6205,2,0,2,0,4
16403,30,5641,1158;10204;12070;12486,6205,0,2,2,0,4
16404,30,5642,1428;1670;11953;12313;12507;13806,6205,1,3,2,0,6
16405,30,5643,1700;3337;12020;12295;13735,6205,1,2,2,0,5
16406,30,5645,1837;10164;12564;13490,6205,1,1,2,0,4
16407,30,5646,1944,6205,0,0,1,0,1
16408,30,5647,1134,6205,0,0,1,0,1
16409,30,5648,2539;12710;12915;13225,6205,1,2,1,0,4
16410,30,5649,2092;8616;11925,6205,0,1,2,0,3
16411,30,5650,2250;10044;12036;13232,6205,1,1,2,0,4
16412,30,5651,2339;10055;12179;12355;13770,6205,1,2,2,0,5
16413,30,5652,1321;12054;12553,6205,0,2,1,0,3
16414,30,5654,804;2545,6205,0,0,2,0,2
16415,30,5655,2700;6001,6205,0,0,2,0,2
16416,30,5656,2741;7237;12000,6205,0,1,2,0,3
16417,30,5657,2784;3601;12822;13369;13785,6205,2,1,2,0,5
16418,30,5659,2871;3874,6205,0,0,2,0,2
16419,30,5661,3010;7191,6205,0,0,2,0,2
16420,30,5662,3071;10060;13374;13499,6205,2,0,2,0,4
16421,30,5663,3107;9063,6205,0,0,2,0,2
16422,30,5664,6017,6205,0,0,0,1,1
16423,30,5665,10201;10309;13141;13315,6205,2,0,2,0,4
16424,30,5666,3281;12212;12774,6205,0,2,1,0,3
16425,30,5667,3737,6205,0,0,0,1,1
16426,30,5669,3772,6205,0,0,0,1,1
16427,30,5670,3969,6205,0,0,1,0,1
16428,30,5671,4075;7316;12402;12950;13387,6205,1,2,2,0,5
16429,30,5672,4204,6205,0,0,0,1,1
16430,30,5673,440;4257;11957;12302;13508,6205,1,2,2,0,5
16431,30,5674,4471;10180;11973;12460;13287,6205,1,2,2,0,5
16432,30,5676,2234;12180;12618;12914,6205,0,3,1,0,4
16433,30,5679,975,6205,0,0,0,1,1
16434,30,5680,4833;12300;13107;13514,6205,2,1,1,0,4
16435,30,5681,2876;10365;12719;13752,6205,1,1,2,0,4
16436,30,5682,4997,6205,0,0,0,1,1
16437,30,5683,4106;5135,6205,0,0,2,0,2
16438,30,5684,5144,6205,0,0,0,1,1
16439,30,5685,5297;13474;13728,6205,2,0,1,0,3
16440,30,5686,5480;7304;13295;13496,6205,2,0,2,0,4
16441,30,5687,2147,6205,0,0,1,0,1
16442,30,5688,5186;5642;12494;12568,6205,0,2,2,0,4
16443,30,5690,5775,6205,0,0,1,0,1
16444,30,5692,5992;8052,6205,0,0,2,0,2
16445,30,5693,5969;6183;12192;12408;12728,6205,0,3,2,0,5
16446,30,5694,6296;6885;12935;13210,6205,1,1,2,0,4
16447,30,5698,6483,6205,0,0,0,1,1
16448,30,5699,5228;6525;13261;13595,6205,2,0,2,0,4
16449,30,5700,6529,6205,0,0,1,0,1
16450,30,5701,741;6019,6205,0,0,0,2,2
16451,30,5702,4680;6692;12680,6205,0,1,2,0,3
16452,30,5703,6967;13231,6205,1,0,1,0,2
16453,30,5705,7706,6205,0,0,0,1,1
16454,30,5706,3266;10054;11987;12238;13009,6205,0,3,2,0,5
16455,30,5707,7466;9571;12354,6205,0,1,2,0,3
16456,30,5708,6003;7510;13205;13525,6205,2,0,2,0,4
16457,30,5709,7634;9827,6205,0,0,2,0,2
16458,30,5710,7723,6205,0,0,1,0,1
16459,30,5711,8092;8144;13260,6205,1,0,2,0,3
16460,30,5712,430;1288;12713,6205,0,1,2,0,3
16461,30,5713,466,6205,0,0,0,1,1
16462,30,5714,3811,6205,0,0,1,0,1
16463,30,5715,8465,6205,0,0,0,1,1
16464,30,5716,8642;12643,6205,0,1,1,0,2
16465,30,5717,4959;8885,6205,0,0,2,0,2
16466,30,5719,9150;9626;12584;13146,6205,1,1,2,0,4
16467,30,5720,6601;9266;12325;12799,6205,0,2,2,0,4
16468,30,5722,9389;9729;12802;13217;13371,6205,2,1,2,0,5
16469,30,5723,6421;9394;12746;13312,6205,1,1,2,0,4
16470,30,5724,1847;9606;12015;12630,6205,0,2,2,0,4
16471,30,5725,7794;13119;13358,6205,2,0,1,0,3
16472,30,5726,9741,6205,0,0,1,0,1
16473,30,5727,160;9751;12378;12641,6205,0,2,2,0,4
16474,30,5728,56,6570,0,0,1,0,1
16475,30,5729,135;5892;13545;13731,6570,2,0,2,0,4
16476,30,5730,8356,6570,0,0,0,1,1
16477,30,5732,10118;10294;13073;13383,6570,1,1,2,0,4
16478,30,5733,10174;12786;13109;13431,6570,2,1,1,0,4
16479,30,5734,612;909;13030;13324,6570,1,1,2,0,4
16480,30,5735,653;3136;12866;13097,6570,0,2,2,0,4
16481,30,5739,1152;10042;12064;12426;12829,6570,0,3,2,0,5
16482,30,5740,1242;3346,6570,0,0,2,0,2
16483,30,5742,1301;8332;12356;12820,6570,0,2,2,0,4
16484,30,5743,1308;10006;12187;13084,6570,0,2,2,0,4
16485,30,5744,1359;10146;12118;12195;13170;13335;13485,6570,3,2,2,0,7
16486,30,5746,1538;7344;12126;12403,6570,0,2,2,0,4
16487,30,5747,1564;7373;13587,6570,1,0,2,0,3
16488,30,5749,1615;6482,6570,0,0,0,2,2
16489,30,5750,1637,6570,0,0,1,0,1
16490,30,5751,1940;10080;12136;12432,6570,0,2,2,0,4
16491,30,5752,1721;10251;12175;12690;13238,6570,1,2,2,0,5
16492,30,5753,1726;12158;13025,6570,0,2,1,0,3
16493,30,5754,7340,6570,0,0,1,0,1
16494,30,5755,2290,6570,0,0,1,0,1
16495,30,5760,2442;10088;12612;13171,6570,1,1,2,0,4
16496,30,5761,1723;2671,6570,0,0,0,2,2
16497,30,5762,2919;6088;13537,6570,1,0,2,0,3
16498,30,5763,3003;3834;12121;12837;13319;13543,6570,2,2,2,0,6
16499,30,5764,3038;3190,6570,0,0,2,0,2
16500,30,5767,3377;6289,6570,0,0,2,0,2
16501,30,5768,477;3578;12144;12367;12691;13437,6570,1,3,2,0,6
16502,30,5771,1775;7464,6570,0,0,2,0,2
16503,30,5772,4455,6570,0,0,0,1,1
16504,30,5773,4633;5901;13099;13249;13780,6570,2,1,2,0,5
16505,30,5774,4694;6660;12560,6570,0,1,2,0,3
16506,30,5776,9520;10167;13483;13769,6570,2,0,2,0,4
16507,30,5778,5442;6603;12235;13300,6570,1,1,2,0,4
16508,30,5781,4368;8375;12860;13235,6570,1,1,2,0,4
16509,30,5782,5920,6570,0,0,0,1,1
16510,30,5783,5966,6570,0,0,0,1,1
16511,30,5785,6197;9773,6570,0,0,2,0,2
16512,30,5786,7665;13337;13664,6570,2,0,1,0,3
16513,30,5787,6212;9099;12099;12543;13270,6570,1,2,2,0,5
16514,30,5791,4093;6729,6570,0,0,2,0,2
16515,30,5792,6781,6570,0,0,1,0,1
16516,30,5793,1236;6904;12530;12901,6570,0,2,2,0,4
16517,30,5795,7110;7410,6570,0,0,2,0,2
16518,30,5796,7530;10112;13059;13466;13532,6570,2,1,2,0,5
16519,30,5798,2354;7762;13112;13612,6570,2,0,2,0,4
16520,30,5799,7765;10229;12503;12731,6570,0,2,2,0,4
16521,30,5800,7856;10084,6570,0,0,2,0,2
16522,30,5802,8051;13329;13566,6570,2,0,1,0,3
16523,30,5803,8164,6570,0,0,0,1,1
16524,30,5806,2256;8396;12204;13162,6570,1,1,2,0,4
16525,30,5807,8721;10063;12997;13199;13411,6570,2,1,2,0,5
16526,30,5810,9292,6570,0,0,0,1,1
16527,30,5812,8220;9336;12211;13524,6570,1,1,2,0,4
16528,30,5813,9247;9425;12275;12627,6570,0,2,2,0,4
16529,30,5814,5978,6570,0,0,0,1,1
16530,30,5815,4704;9655;12752;13275,6570,1,1,2,0,4
16531,30,5817,9371,6570,0,0,1,0,1
16532,30,5818,9912,6570,0,0,0,1,1
16533,30,5819,81;476;12651;12843;13763,6935,1,2,2,0,5
16534,30,5820,94;10069;13542,6935,1,0,2,0,3
16535,30,5821,7402;12139;12729;13488,6935,1,2,1,0,4
16536,30,5823,2817,6935,0,0,1,0,1
16537,30,5824,349;6344;12856,6935,0,1,2,0,3
16538,30,5825,3748;12971;13268,6935,1,1,1,0,3
16539,30,5827,9420,6935,0,0,1,0,1
16540,30,5831,1371;6920,6935,0,0,2,0,2
16541,30,5833,10138,6935,0,0,1,0,1
16542,30,5834,1943;12213;12588;12816;12977,6935,0,4,1,0,5
16543,30,5835,2121;8109;13551,6935,1,0,2,0,3
16544,30,5836,2233;10223;13181;13576,6935,2,0,2,0,4
16545,30,5837,2245,6935,0,0,1,0,1
16546,30,5839,8697;10145;12268;12552,6935,0,2,2,0,4
16547,30,5840,2775;10030;13022,6935,0,1,2,0,3
16548,30,5841,2914,6935,0,0,0,1,1
16549,30,5843,3375;9316;13183;13256,6935,2,0,2,0,4
16550,30,5845,545;3126;12360;12892,6935,0,2,2,0,4
16551,30,5846,4448;10037;12657;13263;13397,6935,2,1,2,0,5
16552,30,5848,3555,6935,0,0,0,1,1
16553,30,5850,4221;10074;12413;13111;13462,6935,2,1,2,0,5
16554,30,5851,4259;7808;12721,6935,0,1,2,0,3
16555,30,5852,4299,6935,0,0,0,1,1
16556,30,5854,3127;4571;12595;12985;13125;13291,6935,2,2,2,0,6
16557,30,5855,7682,6935,0,0,1,0,1
16558,30,5856,4674,6935,0,0,0,1,1
16559,30,5858,4743;8418,6935,0,0,2,0,2
16560,30,5859,4785;5231;13461,6935,1,0,2,0,3
16561,30,5860,4868;10287;12276,6935,0,1,2,0,3
16562,30,5861,2765;9946;12429;12586;12800,6935,0,3,2,0,5
16563,30,5862,5097;7994,6935,0,0,2,0,2
16564,30,5863,5258;10158;12615;13101,6935,1,1,2,0,4
16565,30,5864,3583,6935,0,0,0,1,1
16566,30,5865,960;5367;12768;12948;13708,6935,1,2,2,0,5
16567,30,5867,5630;7310;13246;13599,6935,2,0,2,0,4
16568,30,5869,9326,6935,0,0,1,0,1
16569,30,5870,6110,6935,0,0,1,0,1
16570,30,5871,6159;10132;12655;13087;13604,6935,1,2,2,0,5
16571,30,5872,4752;6331,6935,0,0,2,0,2
16572,30,5873,169;6443;12312;12607;13388,6935,1,2,2,0,5
16573,30,5874,6466,6935,0,0,1,0,1
16574,30,5875,5743;6469;13277;13787,6935,2,0,2,0,4
16575,30,5877,7444;8553;12592;13188,6935,1,1,2,0,4
16576,30,5880,9199,6935,0,0,0,1,1
16577,30,5881,6465,6935,0,0,1,0,1
16578,30,5883,3725;7399,6935,0,0,2,0,2
16579,30,5884,4442;7425,6935,0,0,0,2,2
16580,30,5885,3886;7439,6935,0,0,2,0,2
16581,30,5888,3731;7550;12504;12780;12898,6935,0,3,2,0,5
16582,30,5889,7570;7733,6935,0,0,2,0,2
16583,30,5890,7781;9197;12897;13463,6935,1,1,2,0,4
16584,30,5891,7927;9692;12446;13080,6935,0,2,2,0,4
16585,30,5892,3981,6935,0,0,0,1,1
16586,30,5894,2971;4600,6935,0,0,2,0,2
16587,30,5895,7097;10237;13258,6935,1,0,2,0,3
16588,30,5896,8578,6935,0,0,1,0,1
16589,30,5898,9659,6935,0,0,0,1,1
16590,30,5899,9689;13209;13540,6935,2,0,1,0,3
16591,30,5900,5917;10186;12762;13309,6935,1,1,2,0,4
16592,30,5901,982;9042;12381;13321,6935,1,1,2,0,4
16593,30,5902,9151;10046;13187;13625,6935,2,0,2,0,4
16594,30,5903,9373,6935,0,0,0,1,1
16595,30,5905,217;9680;13423,6935,1,0,2,0,3
16596,30,5906,29;10206;12778,6935,0,1,2,0,3
16597,30,5908,10022;10210;13637;13798,6935,2,0,2,0,4
16598,30,5909,1619;10029;13569,6935,1,0,2,0,3
16599,30,5910,10033;10362;12425;12611;12677,6935,0,3,2,0,5
16600,30,5911,1144;10188;12488;12727,6935,0,2,2,0,4
16601,30,5912,10056;10297;12318;13469,6935,1,1,2,0,4
16602,30,5913,10079;10162;13773,6935,1,0,2,0,3
16603,30,5914,10099;10109;13285,6935,1,0,2,0,3
16604,30,5915,2818;10108;12644;13034;13121;13668;13674,6935,3,2,2,0,7
16605,30,5916,10113;10481;13487;13673,6935,2,0,2,0,4
16606,30,5918,448;10183;13126,7300,1,0,2,0,3
16607,30,5919,511;8470;12890;13075,7300,0,2,2,0,4
16608,30,5920,4548,7300,0,0,1,0,1
16609,30,5921,562;9927;13168;13528,7300,2,0,2,0,4
16610,30,5923,3995;4714;12337;12754;13399,7300,1,2,2,0,5
16611,30,5925,1021,7300,0,0,0,1,1
16612,30,5926,1162;5420,7300,0,0,2,0,2
16613,30,5927,1452;2689;12894;13314;13716,7300,2,1,2,0,5
16614,30,5928,1973;5390;13670,7300,1,0,2,0,3
16615,30,5929,3160,7300,0,0,0,1,1
16616,30,5930,2361;10401;12686;13293;13620,7300,2,1,2,0,5
16617,30,5931,1827,7300,0,0,0,1,1
16618,30,5934,3146;5479;13214;13323,7300,2,0,2,0,4
16619,30,5935,3185;10008;12382;13003;13592,7300,1,2,2,0,5
16620,30,5937,10121;10148;13002,7300,0,1,2,0,3
16621,30,5940,3808,7300,0,0,0,1,1
16622,30,5941,3847,7300,0,0,0,1,1
16623,30,5942,9041,7300,0,0,1,0,1
16624,30,5943,4092;7163;13196;13254,7300,2,0,2,0,4
16625,30,5944,3481;4304,7300,0,0,2,0,2
16626,30,5946,4544;9887;12396;13338,7300,1,1,2,0,4
16627,30,5947,4601,7300,0,0,1,0,1
16628,30,5949,4735,7300,0,0,1,0,1
16629,30,5950,4851;10057;13395,7300,1,0,2,0,3
16630,30,5952,5403,7300,0,0,0,1,1
16631,30,5955,5726;7176;12525;12986,7300,0,2,2,0,4
16632,30,5956,5738;12466;12673,7300,0,2,1,0,3
16633,30,5957,5798;5968;12453;12834,7300,0,2,2,0,4
16634,30,5958,7732;8624,7300,0,0,2,0,2
16635,30,5959,1682;6702;13809,7300,1,0,2,0,3
16636,30,5961,6764;6995;12424;13202,7300,1,1,2,0,4
16637,30,5964,4677;7172;12455;12794,7300,0,2,2,0,4
16638,30,5968,7481;10097;13680,7300,1,0,2,0,3
16639,30,5970,8031;8255,7300,0,0,1,1,2
16640,30,5971,5436;8328,7300,0,0,2,0,2
16641,30,5972,8372;9211;13042;13515,7300,1,1,2,0,4
16642,30,5973,8089,7300,0,0,0,1,1
16643,30,5974,8722,7300,0,0,1,0,1
16644,30,5975,2247;5736;13392,7300,1,0,2,0,3
16645,30,5976,8986,7300,0,0,1,0,1
16646,30,5977,5788;7521,7300,0,0,2,0,2
16647,30,5979,9962,7300,0,0,0,1,1
16648,30,5980,9749,7300,0,0,1,0,1
16649,30,5983,10017;10320;12390;13497,7300,1,1,2,0,4
16650,30,5984,10203;10252;13623;13709,7300,2,0,2,0,4
16651,30,5985,10519;12614;13056,7300,0,2,1,0,3
16652,30,5986,10106;10220;13443;13762,7300,2,0,2,0,4
16653,30,5987,10134;10142;13696,7300,1,0,2,0,3
16654,30,5988,10154;10498;12535;12867;13544,7300,1,2,2,0,5
16655,30,5989,4515;10187;13478;13741,7300,2,0,2,0,4
16656,30,5990,413,7665,0,0,1,0,1
16657,30,5992,1025,7665,0,0,0,1,1
16658,30,5993,10255;13606,7665,1,0,1,0,2
16659,30,5994,512;1604,7665,0,0,2,0,2
16660,30,5995,1623;8409,7665,0,0,2,0,2
16661,30,5996,1702;9951;12659,7665,0,1,2,0,3
16662,30,5997,1826,7665,0,0,1,0,1
16663,30,6000,5105;7394;12660;12933;13385,7665,1,2,2,0,5
16664,30,6003,10217;12830;13046,7665,0,2,1,0,3
16665,30,6005,2620;4955;12511;12930;13460;13655,7665,2,2,2,0,6
16666,30,6006,2625,7665,0,0,1,0,1
16667,30,6007,2707,7665,0,0,1,0,1
16668,30,6008,10280;13605,7665,1,0,1,0,2
16669,30,6009,2774;10306;12490;12803;13147;13546,7665,2,2,2,0,6
16670,30,6010,5333,7665,0,0,1,0,1
16671,30,6011,2788;6953;12470,7665,0,1,2,0,3
16672,30,6012,2920;3591;13698,7665,1,0,2,0,3
16673,30,6013,4271;5296;12484;13082,7665,0,2,2,0,4
16674,30,6015,3751,7665,0,0,0,1,1
16675,30,6016,4369,7665,0,0,1,0,1
16676,30,6017,4755;8421;13185;13633,7665,2,0,2,0,4
16677,30,6018,4861;6836,7665,0,0,2,0,2
16678,30,6020,5161;5310;13144;13669,7665,2,0,2,0,4
16679,30,6022,4229;5421,7665,0,0,2,0,2
16680,30,6023,5437;6114;13279;13734,7665,2,0,2,0,4
16681,30,6024,5598,7665,0,0,1,0,1
16682,30,6026,6205,7665,0,0,0,1,1
16683,30,6029,6991;8698;12957;13195,7665,1,1,2,0,4
16684,30,6030,5945,7665,0,0,0,1,1
16685,30,6031,6071;13058;13180,7665,1,1,1,0,3
16686,30,6032,1252;8573;12583,7665,0,1,2,0,3
16687,30,6033,6625;9016,7665,0,0,2,0,2
16688,30,6038,7121,7665,0,0,1,0,1
16689,30,6040,7211,7665,0,0,1,0,1
16690,30,6043,7505,7665,0,0,0,1,1
16691,30,6044,7852,7665,0,0,0,1,1
16692,30,6046,8324,7665,0,0,1,0,1
16693,30,6048,137,7665,0,0,1,0,1
16694,30,6050,1486;9078,7665,0,0,2,0,2
16695,30,6051,9082,7665,0,0,1,0,1
16696,30,6053,9682,7665,0,0,0,1,1
16697,30,6054,1487;9868,7665,0,0,2,0,2
16698,30,6056,10007;10431;12554;13609,7665,1,1,2,0,4
16699,30,6057,10014;10340;12661;13619,7665,1,1,2,0,4
16700,30,6058,10016;10395,7665,0,0,2,0,2
16701,30,6059,10034;10209;12908;13000;13228,7665,1,2,2,0,5
16702,30,6060,10015;10065;13429;13702,7665,2,0,2,0,4
16703,30,6061,10086;10230;13159;13240;13627,7665,3,0,2,0,5
16704,30,6062,10089;10178;13523,7665,1,0,2,0,3
16705,30,6063,494;10394;13432;13771,7665,2,0,2,0,4
16706,30,6064,10127;10141;13567;13747,7665,2,0,2,0,4
16707,30,6065,10157;12609;12813,7665,0,2,1,0,3
16708,30,6066,4883,7665,0,0,1,0,1
16709,30,6067,10171;10448;12566,7665,0,1,2,0,3
16710,30,6069,10293;10522;12758;13396,7665,1,1,2,0,4
16711,30,6070,10254;10583;12712;12953,7665,0,2,2,0,4
16712,30,6071,10261;10440;12849;13049;13636,7665,1,2,2,0,5
16713,30,6072,10265;10483;12628;13654,7665,1,1,2,0,4
16714,30,6073,10104;10567;13191;13564,7665,2,0,2,0,4
16715,30,6074,10275;10391;12545,7665,0,1,2,0,3
16716,30,6075,10277;10505;12555;13113;13807,7665,2,1,2,0,5
16717,30,6076,10197;10285;13035;13700,7665,1,1,2,0,4
16718,30,6077,10298;10321;12679;13265;13520,7665,2,1,2,0,5
16719,30,6078,10233;10307;12763;13454,7665,1,1,2,0,4
16720,30,6079,2085;10311;13442,7665,1,0,2,0,3
16721,30,6080,320;5064;13749,8030,1,0,2,0,3
16722,30,6081,582,8030,0,0,0,1,1
16723,30,6082,8545,8030,0,0,0,1,1
16724,30,6083,1630;7621;12608;12733,8030,0,2,2,0,4
16725,30,6084,5100;6389;12789;13253,8030,1,1,2,0,4
16726,30,6086,1197,8030,0,0,0,1,1
16727,30,6087,2360;3246;13120;13479,8030,2,0,2,0,4
16728,30,6089,2385,8030,0,0,1,0,1
16729,30,6090,2494;8149;12896,8030,0,1,2,0,3
16730,30,6095,2879,8030,0,0,1,0,1
16731,30,6096,3395,8030,0,0,1,0,1
16732,30,6098,3029;5329,8030,0,0,2,0,2
16733,30,6099,3612;5024;12931;13558,8030,1,1,2,0,4
16734,30,6102,4235;10380;12626;13017;13301;13745,8030,2,2,2,0,6
16735,30,6103,4396;8249,8030,0,0,2,0,2
16736,30,6104,10557;13644,8030,1,0,1,0,2
16737,30,6105,4370;9167,8030,0,0,2,0,2
16738,30,6106,4806;6035,8030,0,0,2,0,2
16739,30,6107,932;5191,8030,0,0,2,0,2
16740,30,6108,5322,8030,0,0,1,0,1
16741,30,6110,6393;10003;12625;12970,8030,0,2,2,0,4
16742,30,6111,1889,8030,0,0,1,0,1
16743,30,6112,2728;6309;12959;13325,8030,1,1,2,0,4
16744,30,6114,2031,8030,0,0,1,0,1
16745,30,6115,8145;10093;13031,8030,0,1,2,0,3
16746,30,6118,8591,8030,0,0,1,0,1
16747,30,6119,6155;8638;13197;13704,8030,2,0,2,0,4
16748,30,6120,8641;9419;13053,8030,0,1,2,0,3
16749,30,6121,2996;8688;12695;12972;13614,8030,1,2,2,0,5
16750,30,6122,8446,8030,0,0,1,0,1
16751,30,6126,10028;10545;12751,8030,0,1,2,0,3
16752,30,6127,4456;10051;13372,8030,1,0,2,0,3
16753,30,6128,10053;10090;12889,8030,0,1,2,0,3
16754,30,6129,10081;10246;12910;13283,8030,1,1,2,0,4
16755,30,6130,10302;10433;12872;12990;13501,8030,1,2,2,0,5
16756,30,6131,10101;10119;13418;13572,8030,2,0,2,0,4
16757,30,6132,10124;10215;13333;13622,8030,2,0,2,0,4
16758,30,6133,604,8030,0,0,1,0,1
16759,30,6134,5032;10192;13213;13377,8030,2,0,2,0,4
16760,30,6135,10211;10534;12755;13227,8030,1,1,2,0,4
16761,30,6136,10221;10535;13468,8030,1,0,2,0,3
16762,30,6137,10239;10454;13703,8030,1,0,2,0,3
16763,30,6138,10242;10618;12787;13004;13106,8030,1,2,2,0,5
16764,30,6139,10259;10640,8030,0,0,2,0,2
16765,30,6140,10047;10270;12739;12891;13436,8030,1,2,2,0,5
16766,30,6141,10271;10679,8030,0,0,2,0,2
16767,30,6142,10276;10653,8030,0,0,2,0,2
16768,30,6143,10582;13029;13137,8030,1,1,1,0,3
16769,30,6144,10281;10296;12814;13386;13687,8030,2,1,2,0,5
16770,30,6145,10304;10714,8030,0,0,2,0,2
16771,30,6146,10126;10269;13063;13177,8030,1,1,2,0,4
16772,30,6147,10327;10471;13054;13799,8030,1,1,2,0,4
16773,30,6148,10347;10384;12783;13079,8030,0,2,2,0,4
16774,30,6149,10361;10566,8030,0,0,2,0,2
16775,30,6150,10370,8030,0,0,1,0,1
16776,30,6151,10170;10383;13015;13242;13598,8030,2,1,2,0,5
16777,30,6152,10386;10719;12832;13115,8030,1,1,2,0,4
16778,30,6153,10389;10463,8030,0,0,2,0,2
16779,30,6154,10409;10726,8030,0,0,2,0,2
16780,30,6155,10432;10721,8030,0,0,2,0,2
16781,30,6156,136,8395,0,0,1,0,1
16782,30,6157,2810,8395,0,0,1,0,1
16783,30,6159,10513;12940;13357,8395,1,1,1,0,3
16784,30,6160,1231;13646;13717,8395,2,0,1,0,3
16785,30,6161,1248,8395,0,0,1,0,1
16786,30,6163,1495;2089,8395,0,0,2,0,2
16787,30,6166,1797;10114;12828;13220,8395,1,1,2,0,4
16788,30,6167,652,8395,0,0,1,0,1
16789,30,6168,2760,8395,0,0,1,0,1
16790,30,6169,2896;10012;13738,8395,1,0,2,0,3
16791,30,6171,3366;13650;13757,8395,2,0,1,0,3
16792,30,6172,3478,8395,0,0,1,0,1
16793,30,6173,3517;8237;13305,8395,1,0,2,0,3
16794,30,6174,4219,8395,0,0,1,0,1
16795,30,6178,4470,8395,0,0,1,0,1
16796,30,6179,4543,8395,0,0,1,0,1
16797,30,6180,4693,8395,0,0,1,0,1
16798,30,6182,10052;10353;12848,8395,0,1,2,0,3
16799,30,6184,5139,8395,0,0,1,0,1
16800,30,6185,3859,8395,0,0,1,0,1
16801,30,6187,6923,8395,0,0,1,0,1
16802,30,6189,7575,8395,0,0,1,0,1
16803,30,6192,8008,8395,0,0,1,0,1
16804,30,6193,9514,8395,0,0,1,0,1
16805,30,6194,8111;13090;13471,8395,1,1,1,0,3
16806,30,6195,5627;7900,8395,0,0,1,1,2
16807,30,6196,8474;10105;13803,8395,1,0,2,0,3
16808,30,6197,3267;5710,8395,0,0,2,0,2
16809,30,6199,1104;5814,8395,0,0,2,0,2
16810,30,6202,9714,8395,0,0,1,0,1
16811,30,6203,8928,8395,0,0,1,0,1
16812,30,6205,10256;13139,8395,1,0,1,0,2
16813,30,6206,10091;10314;13306,8395,1,0,2,0,3
16814,30,6207,10140;10200;13243;13607,8395,2,0,2,0,4
16815,30,6208,10551;10753,8395,0,0,2,0,2
16816,30,6209,10189;10516;13464,8395,1,0,2,0,3
16817,30,6210,10149;10258;13336;13676,8395,2,0,2,0,4
16818,30,6211,10262;10279;13639,8395,1,0,2,0,3
16819,30,6212,10272;10506;13134,8395,1,0,2,0,3
16820,30,6213,10286;10728,8395,0,0,2,0,2
16821,30,6214,10228;13266,8395,1,0,1,0,2
16822,30,6215,10328;10738;13086;13245;13682,8395,2,1,2,0,5
16823,30,6216,10350,8395,0,0,1,0,1
16824,30,6217,10324;10372,8395,0,0,2,0,2
16825,30,6218,10415;10604,8395,0,0,2,0,2
16826,30,6219,10418;10435;13498;13737,8395,2,0,2,0,4
16827,30,6220,10442;10656;13083;13127;13482,8395,2,1,2,0,5
16828,30,6221,10465;10879;12815;13320,8395,1,1,2,0,4
16829,30,6222,10476;10781;13573,8395,1,0,2,0,3
16830,30,6223,10455;10492;13521,8395,1,0,2,0,3
16831,30,6224,10291;10495;12859;13064;13584,8395,1,2,2,0,5
16832,30,6225,10657,8395,0,0,1,0,1
16833,30,6227,10479;10548;13135,8395,1,0,2,0,3
16834,30,6228,2497,8760,0,0,1,0,1
16835,30,6230,218;10208;12969,8760,0,1,2,0,3
16836,30,6231,9418,8760,0,0,1,0,1
16837,30,6235,987,8760,0,0,1,0,1
16838,30,6237,1493,8760,0,0,1,0,1
16839,30,6238,873;6765,8760,0,0,2,0,2
16840,30,6239,2176;5459;13710,8760,1,0,2,0,3
16841,30,6243,2534,8760,0,0,1,0,1
16842,30,6244,2476;3055;12877;13166,8760,1,1,2,0,4
16843,30,6245,3108;7311;13215,8760,1,0,2,0,3
16844,30,6246,7223,8760,0,0,1,0,1
16845,30,6248,3438,8760,0,0,1,0,1
16846,30,6249,1929;5047;13116;13586,8760,2,0,2,0,4
16847,30,6250,3600;3615;12852;13284,8760,1,1,2,0,4
16848,30,6251,4156,8760,0,0,0,1,1
16849,30,6252,8033;8711,8760,0,0,2,0,2
16850,30,6253,4700;5659,8760,0,0,2,0,2
16851,30,6254,4862;7404,8760,0,0,2,0,2
16852,30,6256,1031;5409;12916,8760,0,1,2,0,3
16853,30,6257,5464,8760,0,0,0,1,1
16854,30,6258,5698;10268;13597;13801,8760,2,0,2,0,4
16855,30,6259,5760,8760,0,0,0,1,1
16856,30,6261,5974,8760,0,0,1,0,1
16857,30,6262,6217,8760,0,0,1,0,1
16858,30,6263,3735;7315;13536;13690,8760,2,0,2,0,4
16859,30,6264,1618;6624;13438;13638,8760,2,0,2,0,4
16860,30,6265,6642;13800,8760,1,0,1,0,2
16861,30,6267,7698,8760,0,0,1,0,1
16862,30,6269,1360,8760,0,0,1,0,1
16863,30,6272,8376,8760,0,0,1,0,1
16864,30,6273,8437,8760,0,0,0,1,1
16865,30,6274,625;2747,8760,0,0,2,0,2
16866,30,6275,1693;7493,8760,0,0,2,0,2
16867,30,6276,4124;7155,8760,0,0,1,1,2
16868,30,6277,9835,8760,0,0,1,0,1
16869,30,6278,9838,8760,0,0,1,0,1
16870,30,6279,10035,8760,0,0,1,0,1
16871,30,6280,10045;10488,8760,0,0,2,0,2
16872,30,6281,10058;10381;13161;13389,8760,2,0,2,0,4
16873,30,6282,10617;10724;13707,8760,1,0,2,0,3
16874,30,6283,10071;10587;13012,8760,0,1,2,0,3
16875,30,6284,10076;10253;13574,8760,1,0,2,0,3
16876,30,6285,10096;10474,8760,0,0,2,0,2
16877,30,6286,10102;10374,8760,0,0,2,0,2
16878,30,6287,10103;10528;13419,8760,1,0,2,0,3
16879,30,6288,10125;10627;13001;13307,8760,1,1,2,0,4
16880,30,6290,10196;10720,8760,0,0,2,0,2
16881,30,6291,10117;10198;13302,8760,1,0,2,0,3
16882,30,6292,3241,8760,0,0,1,0,1
16883,30,6293,3318;9764;13403;13784,8760,2,0,2,0,4
16884,30,6294,10098;10250;13077,8760,0,1,2,0,3
16885,30,6295,10078;10292;13452;13714,8760,2,0,2,0,4
16886,30,6296,10066;10299;13467;13665;13743,8760,3,0,2,0,5
16887,30,6297,9563;10338;13789,8760,1,0,2,0,3
16888,30,6298,10339;10697,8760,0,0,2,0,2
16889,30,6299,10341;10652;13330;13681,8760,2,0,2,0,4
16890,30,6300,10342;10358,8760,0,0,2,0,2
16891,30,6301,10357;13679,8760,1,0,1,0,2
16892,30,6302,10241;10364,8760,0,0,2,0,2
16893,30,6303,10191;10377;13069;13296,8760,1,1,2,0,4
16894,30,6304,10408;10650;13561,8760,1,0,2,0,3
16895,30,6305,10428;10625,8760,0,0,2,0,2
16896,30,6306,10441;10907;13050;13475;13531,8760,2,1,2,0,5
16897,30,6307,10449;10710;13517,8760,1,0,2,0,3
16898,30,6308,10439;10470,8760,0,0,2,0,2
16899,30,6309,10244;10709,8760,0,0,2,0,2
16900,30,6310,10092;10532;13439,8760,1,0,2,0,3
16901,30,6311,10541;10613,8760,0,0,2,0,2
16902,30,6312,10682,8760,0,0,1,0,1
16903,30,6313,10550;10558;13316;13554,8760,2,0,2,0,4
16904,30,6314,10143;10572,8760,0,0,2,0,2
16905,30,6315,10599;10865;13470,8760,1,0,2,0,3
16906,30,6316,10445;10602;13465,8760,1,0,2,0,3
16907,30,6317,10485;10899;13013;13473,8760,1,1,2,0,4
16908,30,6318,10606,8760,0,0,1,0,1
16909,30,6321,829,9125,0,0,1,0,1
16910,30,6322,322,9125,0,0,0,1,1
16911,30,6323,751,9125,0,0,1,0,1
16912,30,6324,878;10344;13014;13262,9125,1,1,2,0,4
16913,30,6325,890,9125,0,0,1,0,1
16914,30,6326,2208,9125,0,0,1,0,1
16915,30,6327,10009;10027;13628,9125,1,0,2,0,3
16916,30,6329,1328,9125,0,0,1,0,1
16917,30,6330,1820,9125,0,0,1,0,1
16918,30,6331,1922,9125,0,0,1,0,1
16919,30,6332,2068;4846,9125,0,0,2,0,2
16920,30,6333,2117,9125,0,0,1,0,1
16921,30,6334,8879,9125,0,0,0,1,1
16922,30,6335,2727,9125,0,0,0,1,1
16923,30,6337,2942,9125,0,0,0,1,1
16924,30,6338,3085,9125,0,0,1,0,1
16925,30,6339,3118;13193;13518,9125,2,0,1,0,3
16926,30,6340,1668;1930,9125,0,0,2,0,2
16927,30,6341,3388,9125,0,0,1,0,1
16928,30,6342,421;3798;13085;13502,9125,1,1,2,0,4
16929,30,6344,4723,9125,0,0,1,0,1
16930,30,6346,5731,9125,0,0,1,0,1
16931,30,6347,3078;13060;13404,9125,1,1,1,0,3
16932,30,6350,2264;6626,9125,0,0,2,0,2
16933,30,6353,7115;10199;13506;13736,9125,2,0,2,0,4
16934,30,6354,6605,9125,0,0,1,0,1
16935,30,6355,5394,9125,0,0,1,0,1
16936,30,6357,9008,9125,0,0,1,0,1
16937,30,6359,9161,9125,0,0,1,0,1
16938,30,6360,6012;8502,9125,0,0,2,0,2
16939,30,6363,6325;9169,9125,0,0,2,0,2
16940,30,6364,1990,9125,0,0,1,0,1
16941,30,6365,10036;10110;13453,9125,1,0,2,0,3
16942,30,6366,10020;10586,9125,0,0,2,0,2
16943,30,6367,10059;10363,9125,0,0,2,0,2
16944,30,6368,7766;10075;13154;13427,9125,2,0,2,0,4
16945,30,6369,10082;10866;13562,9125,1,0,2,0,3
16946,30,6371,10168;10310;13165;13661,9125,2,0,2,0,4
16947,30,6372,10169;10575,9125,0,0,2,0,2
16948,30,6373,10175;10717,9125,0,0,2,0,2
16949,30,6374,10181;10319;13428,9125,1,0,2,0,3
16950,30,6375,10040;10213;13417,9125,1,0,2,0,3
16951,30,6376,10218;10510,9125,0,0,2,0,2
16952,30,6377,10379,9125,0,0,1,0,1
16953,30,6378,10083;10236;13555;13748,9125,2,0,2,0,4
16954,30,6379,10282;13362,9125,1,0,1,0,2
16955,30,6380,10249;10356;13557,9125,1,0,2,0,3
16956,30,6381,10313;10873,9125,0,0,2,0,2
16957,30,6382,10351;10570;13276,9125,1,0,2,0,3
16958,30,6383,10375;10403,9125,0,0,2,0,2
16959,30,6384,10387;10515;13613,9125,1,0,2,0,3
16960,30,6385,10388,9125,0,0,1,0,1
16961,30,6386,10360;10396,9125,0,0,2,0,2
16962,30,6387,10398;10593,9125,0,0,2,0,2
16963,30,6388,10144;10416;13781,9125,1,0,2,0,3
16964,30,6389,10419;10511;13596,9125,1,0,2,0,3
16965,30,6390,10219;10436;13326,9125,1,0,2,0,3
16966,30,6391,10438;11034;13373,9125,1,0,2,0,3
16967,30,6392,10457;10459,9125,0,0,2,0,2
16968,30,6393,10466;10639,9125,0,0,2,0,2
16969,30,6394,10475,9125,0,0,1,0,1
16970,30,6395,10477;10961;13167;13445,9125,2,0,2,0,4
16971,30,6396,10257;10486;13104,9125,1,0,2,0,3
16972,30,6397,10497;10770;13257;13563,9125,2,0,2,0,4
16973,30,6398,10352;10509;13380;13630,9125,2,0,2,0,4
16974,30,6399,10518;10952,9125,0,0,2,0,2
16975,30,6401,10526;13663,9125,1,0,1,0,2
16976,30,6402,10378;10527,9125,0,0,2,0,2
16977,30,6403,10095;10540;13447,9125,1,0,2,0,3
16978,30,6404,10549;10755,9125,0,0,2,0,2
16979,30,6405,10333;10568,9125,0,0,2,0,2
16980,30,6406,10574,9125,0,0,1,0,1
16981,30,6408,10331;10600;13570,9125,1,0,2,0,3
16982,30,6409,10821;13278,9125,1,0,1,0,2
16983,30,6410,10234;10612;13289,9125,1,0,2,0,3
16984,30,6411,10397;10621,9125,0,0,2,0,2
16985,30,6413,10655;10919;13678,9125,1,0,2,0,3
16986,30,6414,10614;10659;13345,9125,1,0,2,0,3
16987,30,6415,10662;10795;13194;13435;13611,9125,3,0,2,0,5
16988,30,6416,10881;13541,9125,1,0,1,0,2
16989,30,6417,10468;10680,9125,0,0,2,0,2
16990,30,6418,10681;10895;13299;13486,9125,2,0,2,0,4
16991,30,6419,10730;10769;13363;13492,9125,2,0,2,0,4
16992,30,6420,11011;13308,9125,1,0,1,0,2
16993,30,6421,10763;13271,9125,1,0,1,0,2
16994,30,6422,89,9490,0,0,1,0,1
16995,30,6423,228;10024;13157,9490,1,0,2,0,3
16996,30,6424,8814,9490,0,0,1,0,1
16997,30,6427,945,9490,0,0,1,0,1
16998,30,6428,1663,9490,0,0,1,0,1
16999,30,6429,2396;9056;13224;13347,9490,2,0,2,0,4
17000,30,6430,3046;7785;13360;13666,9490,2,0,2,0,4
17001,30,6431,3058,9490,0,0,1,0,1
17002,30,6432,4189;7197;13211;13379,9490,2,0,2,0,4
17003,30,6433,1100;9401,9490,0,0,2,0,2
17004,30,6435,4867,9490,0,0,1,0,1
17005,30,6436,5457,9490,0,0,1,0,1
17006,30,6437,5793,9490,0,0,1,0,1
17007,30,6438,5858,9490,0,0,1,0,1
17008,30,6441,6652,9490,0,0,1,0,1
17009,30,6442,6461;9317,9490,0,0,2,0,2
17010,30,6443,6567,9490,0,0,1,0,1
17011,30,6444,6694,9490,0,0,1,0,1
17012,30,6445,6735;7216,9490,0,0,2,0,2
17013,30,6447,5580,9490,0,0,1,0,1
17014,30,6449,2598;7346,9490,0,0,2,0,2
17015,30,6451,7418,9490,0,0,1,0,1
17016,30,6452,7443,9490,0,0,1,0,1
17017,30,6453,7714,9490,0,0,1,0,1
17018,30,6454,5402;9722,9490,0,0,2,0,2
17019,30,6455,7873,9490,0,0,1,0,1
17020,30,6456,4021,9490,0,0,1,0,1
17021,30,6457,69,9490,0,0,1,0,1
17022,30,6459,8201,9490,0,0,1,0,1
17023,30,6460,6078;9232,9490,0,0,2,0,2
17024,30,6461,9183,9490,0,0,0,1,1
17025,30,6462,10025;10672,9490,0,0,2,0,2
17026,30,6463,10050,9490,0,0,1,0,1
17027,30,6464,10172,9490,0,0,1,0,1
17028,30,6465,10151;10184;13401,9490,1,0,2,0,3
17029,30,6466,10195;10654;13581,9490,1,0,2,0,3
17030,30,6467,10212;10578,9490,0,0,2,0,2
17031,30,6468,10900,9490,0,0,1,0,1
17032,30,6469,10305;10421;13317;13424,9490,2,0,2,0,4
17033,30,6470,10325;10496;13632,9490,1,0,2,0,3
17034,30,6471,10330;10607;13694,9490,1,0,2,0,3
17035,30,6472,10332;10631,9490,0,0,2,0,2
17036,30,6473,10335;10502;13297;13653,9490,2,0,2,0,4
17037,30,6474,10411;10708;13349,9490,1,0,2,0,3
17038,30,6475,10645;10658;13290,9490,1,0,2,0,3
17039,30,6476,10422;10635,9490,0,0,2,0,2
17040,30,6477,10429;10838;13539,9490,1,0,2,0,3
17041,30,6478,10750,9490,0,0,1,0,1
17042,30,6479,10190;10484;13795,9490,1,0,2,0,3
17043,30,6480,10489;10967;13516,9490,1,0,2,0,3
17044,30,6481,10595;11093,9490,0,0,2,0,2
17045,30,6482,4535;10182;13651,9490,1,0,2,0,3
17046,30,6483,10598;10610,9490,0,0,2,0,2
17047,30,6485,10643;10898,9490,0,0,2,0,2
17048,30,6486,10664;10944,9490,0,0,2,0,2
17049,30,6487,10573;10669,9490,0,0,2,0,2
17050,30,6488,10667;10673;13657,9490,1,0,2,0,3
17051,30,6489,10642;10688,9490,0,0,2,0,2
17052,30,6490,10122;10692,9490,0,0,2,0,2
17053,30,6491,10407;10704;13772,9490,1,0,2,0,3
17054,30,6492,10619;10711;13359;13724,9490,2,0,2,0,4
17055,30,6493,10590;10737,9490,0,0,2,0,2
17056,30,6494,10739;11202;13550,9490,1,0,2,0,3
17057,30,6495,10744;10815,9490,0,0,2,0,2
17058,30,6496,10749;10832;13250,9490,1,0,2,0,3
17059,30,6497,10759;11077;13624,9490,1,0,2,0,3
17060,30,6498,10434;10760;13489;13756,9490,2,0,2,0,4
17061,30,6499,10765;11113;13368;13776,9490,2,0,2,0,4
17062,30,6500,11175,9490,0,0,1,0,1
17063,30,6501,10788;10913;13342;13382,9490,2,0,2,0,4
17064,30,6502,10792;11117,9490,0,0,2,0,2
17065,30,6503,10843;11082,9490,0,0,2,0,2
17066,30,6504,10676;10713;13451;13765,9490,2,0,2,0,4
17067,30,6505,10494;10884;13351,9490,1,0,2,0,3
17068,30,6507,157;4461,9855,0,0,2,0,2
17069,30,6508,6192,9855,0,0,1,0,1
17070,30,6509,5553;8878,9855,0,0,2,0,2
17071,30,6511,3561;5260,9855,0,0,2,0,2
17072,30,6513,1431,9855,0,0,1,0,1
17073,30,6514,1667,9855,0,0,1,0,1
17074,30,6516,10031;13777,9855,1,0,1,0,2
17075,30,6519,2163,9855,0,0,1,0,1
17076,30,6520,1592,9855,0,0,1,0,1
17077,30,6521,2365,9855,0,0,1,0,1
17078,30,6525,6696,9855,0,0,1,0,1
17079,30,6527,4109,9855,0,0,1,0,1
17080,30,6529,4379,9855,0,0,1,0,1
17081,30,6530,8931,9855,0,0,1,0,1
17082,30,6531,3072,9855,0,0,1,0,1
17083,30,6532,5027;10010;13410,9855,1,0,2,0,3
17084,30,6533,5328,9855,0,0,1,0,1
17085,30,6535,5890;10111;13786,9855,1,0,2,0,3
17086,30,6536,6002;10130;13635,9855,1,0,2,0,3
17087,30,6537,3403,9855,0,0,1,0,1
17088,30,6538,6246,9855,0,0,1,0,1
17089,30,6539,6564,9855,0,0,1,0,1
17090,30,6541,6744;10491,9855,0,0,2,0,2
17091,30,6542,2069;6805;13779,9855,1,0,2,0,3
17092,30,6543,6370,9855,0,0,1,0,1
17093,30,6544,3450,9855,0,0,1,0,1
17094,30,6545,5404,9855,0,0,1,0,1
17095,30,6546,523,9855,0,0,1,0,1
17096,30,6547,7881,9855,0,0,1,0,1
17097,30,6550,9281,9855,0,0,1,0,1
17098,30,6553,10447;13753,9855,1,0,1,0,2
17099,30,6554,2370,9855,0,0,1,0,1
17100,30,6555,10222,9855,0,0,1,0,1
17101,30,6556,10224;11115;13767,9855,1,0,2,0,3
17102,30,6557,10247,9855,0,0,1,0,1
17103,30,6558,10026,9855,0,0,1,0,1
17104,30,6560,10295;10329;13725,9855,1,0,2,0,3
17105,30,6561,10427;10633;13744,9855,1,0,2,0,3
17106,30,6562,10451;10842;13440,9855,1,0,2,0,3
17107,30,6563,10554;10904,9855,0,0,2,0,2
17108,30,6564,10601;10622,9855,0,0,2,0,2
17109,30,6565,10849,9855,0,0,1,0,1
17110,30,6566,10624;13695,9855,1,0,1,0,2
17111,30,6567,10530;10699,9855,0,0,2,0,2
17112,30,6568,10735;10825;13503;13556,9855,2,0,2,0,4
17113,30,6569,10742;11110;13758,9855,1,0,2,0,3
17114,30,6570,10569;10777,9855,0,0,2,0,2
17115,30,6571,10787;10968,9855,0,0,2,0,2
17116,30,6572,10790;11260;13394,9855,1,0,2,0,3
17117,30,6573,10798;10809;13727,9855,1,0,2,0,3
17118,30,6574,10734;10803,9855,0,0,2,0,2
17119,30,6575,10837;11085,9855,0,0,2,0,2
17120,30,6576,10851;11116;13406;13705,9855,2,0,2,0,4
17121,30,6577,10869;10998,9855,0,0,2,0,2
17122,30,6578,10348;10889;13692,9855,1,0,2,0,3
17123,30,6579,10786;10893,9855,0,0,2,0,2
17124,30,6580,10896;10901,9855,0,0,2,0,2
17125,30,6581,10911;11318,9855,0,0,2,0,2
17126,30,6582,10703;10921,9855,0,0,2,0,2
17127,30,6583,10922;10927;13376;13686,9855,2,0,2,0,4
17128,30,6584,10805;10925;13788,9855,1,0,2,0,3
17129,30,6585,10940;11265,9855,0,0,2,0,2
17130,30,6586,10950;11216;13805,9855,1,0,2,0,3
17131,30,6587,10812;10955,9855,0,0,2,0,2
17132,30,6588,10971;11252;13393,9855,1,0,2,0,3
17133,30,6589,10847;10975,9855,0,0,2,0,2
17134,30,6590,10988;11067,9855,0,0,2,0,2
17135,30,6592,119,10220,0,0,1,0,1
17136,30,6594,711,10220,0,0,1,0,1
17137,30,6595,920,10220,0,0,1,0,1
17138,30,6596,1035,10220,0,0,1,0,1
17139,30,6597,1065,10220,0,0,1,0,1
17140,30,6599,6261,10220,0,0,1,0,1
17141,30,6600,2013,10220,0,0,1,0,1
17142,30,6602,9263,10220,0,0,0,1,1
17143,30,6603,2373,10220,0,0,0,1,1
17144,30,6605,2502,10220,0,0,1,0,1
17145,30,6606,2701,10220,0,0,1,0,1
17146,30,6608,6306,10220,0,0,1,0,1
17147,30,6609,1343,10220,0,0,1,0,1
17148,30,6610,7050;9187;13711,10220,1,0,2,0,3
17149,30,6611,1199,10220,0,0,1,0,1
17150,30,6612,4149,10220,0,0,1,0,1
17151,30,6613,5432,10220,0,0,1,0,1
17152,30,6614,3341;13797,10220,1,0,1,0,2
17153,30,6616,1165;5314,10220,0,0,2,0,2
17154,30,6617,5554,10220,0,0,1,0,1
17155,30,6618,5939,10220,0,0,1,0,1
17156,30,6619,2893;6127;13601;13746,10220,2,0,2,0,4
17157,30,6620,6143;9804,10220,0,0,2,0,2
17158,30,6621,5014,10220,0,0,1,0,1
17159,30,6622,7724,10220,0,0,1,0,1
17160,30,6623,1304,10220,0,0,1,0,1
17161,30,6624,8840,10220,0,0,1,0,1
17162,30,6625,8132,10220,0,0,1,0,1
17163,30,6626,4285,10220,0,0,1,0,1
17164,30,6628,8612,10220,0,0,1,0,1
17165,30,6629,7744,10220,0,0,1,0,1
17166,30,6631,6053,10220,0,0,1,0,1
17167,30,6633,9998,10220,0,0,1,0,1
17168,30,6634,9037;10011;13641,10220,1,0,2,0,3
17169,30,6636,6571;10185;13608;13718,10220,2,0,2,0,4
17170,30,6637,10243;10678,10220,0,0,2,0,2
17171,30,6638,10278,10220,0,0,1,0,1
17172,30,6639,10288;10630;13534,10220,1,0,2,0,3
17173,30,6640,10160;10337;13549,10220,1,0,2,0,3
17174,30,6641,10147,10220,0,0,1,0,1
17175,30,6642,10359,10220,0,0,1,0,1
17176,30,6644,10461,10220,0,0,1,0,1
17177,30,6645,10482;11078;13689,10220,1,0,2,0,3
17178,30,6646,10043,10220,0,0,1,0,1
17179,30,6647,10267;10520,10220,0,0,2,0,2
17180,30,6648,10547,10220,0,0,1,0,1
17181,30,6649,10393;10552;13684,10220,1,0,2,0,3
17182,30,6650,10580;10756;13774,10220,1,0,2,0,3
17183,30,6651,10400;10581,10220,0,0,2,0,2
17184,30,6652,10636;13603,10220,1,0,1,0,2
17185,30,6653,10638;10883,10220,0,0,2,0,2
17186,30,6654,10594;10668,10220,0,0,2,0,2
17187,30,6655,10707;10980;13697,10220,1,0,2,0,3
17188,30,6656,10732;10912;13791,10220,1,0,2,0,3
17189,30,6657,10766;10937;13565,10220,1,0,2,0,3
17190,30,6658,10564;10779,10220,0,0,2,0,2
17191,30,6659,10782;10794;13662;13719,10220,2,0,2,0,4
17192,30,6660,10796,10220,0,0,1,0,1
17193,30,6661,10683;10806,10220,0,0,2,0,2
17194,30,6662,10634;10807;13793,10220,1,0,2,0,3
17195,30,6663,10810;10834;13759,10220,1,0,2,0,3
17196,30,6664,10876;11163,10220,0,0,2,0,2
17197,30,6665,10918;11410;13593,10220,1,0,2,0,3
17198,30,6666,10740;10942,10220,0,0,2,0,2
17199,30,6667,10956;11062,10220,0,0,2,0,2
17200,30,6668,10946;10991,10220,0,0,2,0,2
17201,30,6669,11000;11041;13590,10220,1,0,2,0,3
17202,30,6670,11013;13571,10220,1,0,1,0,2
17203,30,6671,11017;11205,10220,0,0,2,0,2
17204,30,6672,11027;11247;13533,10220,1,0,2,0,3
17205,30,6673,11035;11122,10220,0,0,2,0,2
17206,30,6674,10450;11051,10220,0,0,2,0,2
17207,30,6675,11073;11102,10220,0,0,2,0,2
17208,30,6676,11081;11192;13629,10220,1,0,2,0,3
17209,30,6677,11253;13671,10220,1,0,1,0,2
17210,30,6678,93,10585,0,0,1,0,1
17211,30,6679,617,10585,0,0,1,0,1
17212,30,6681,740,10585,0,0,1,0,1
17213,30,6682,978,10585,0,0,0,1,1
17214,30,6683,1030,10585,0,0,1,0,1
17215,30,6685,1139,10585,0,0,1,0,1
17216,30,6686,1699,10585,0,0,1,0,1
17217,30,6687,1967,10585,0,0,1,0,1
17218,30,6688,590,10585,0,0,1,0,1
17219,30,6689,4956,10585,0,0,1,0,1
17220,30,6690,3437,10585,0,0,1,0,1
17221,30,6691,6999,10585,0,0,1,0,1
17222,30,6692,4477,10585,0,0,1,0,1
17223,30,6693,4525,10585,0,0,1,0,1
17224,30,6694,4939;8382,10585,0,0,2,0,2
17225,30,6696,5301,10585,0,0,1,0,1
17226,30,6697,760,10585,0,0,1,0,1
17227,30,6698,6169;8902,10585,0,0,2,0,2
17228,30,6699,6202;10139;13775,10585,1,0,2,0,3
17229,30,6700,6535,10585,0,0,1,0,1
17230,30,6701,6561,10585,0,0,1,0,1
17231,30,6702,6612,10585,0,0,1,0,1
17232,30,6703,503,10585,0,0,1,0,1
17233,30,6704,1808,10585,0,0,1,0,1
17234,30,6705,6873,10585,0,0,1,0,1
17235,30,6706,3342,10585,0,0,1,0,1
17236,30,6707,7350,10585,0,0,1,0,1
17237,30,6709,9513,10585,0,0,1,0,1
17238,30,6710,2751;8057,10585,0,0,2,0,2
17239,30,6711,3177;6974,10585,0,0,2,0,2
17240,30,6712,4166,10585,0,0,1,0,1
17241,30,6713,3117,10585,0,0,1,0,1
17242,30,6714,959,10585,0,0,1,0,1
17243,30,6715,9975,10585,0,0,1,0,1
17244,30,6716,10039,10585,0,0,1,0,1
17245,30,6717,10087;10443;13782,10585,1,0,2,0,3
17246,30,6718,10048,10585,0,0,1,0,1
17247,30,6719,10129;10225;13683,10585,1,0,2,0,3
17248,30,6720,10317,10585,0,0,1,0,1
17249,30,6721,10231;10283;13706,10585,1,0,2,0,3
17250,30,6722,1432,10585,0,0,1,0,1
17251,30,6723,3952,10585,0,0,1,0,1
17252,30,6724,10290;10316;13672,10585,1,0,2,0,3
17253,30,6725,10334;10986;13778,10585,1,0,2,0,3
17254,30,6726,10402;10626,10585,0,0,2,0,2
17255,30,6727,10405;10504,10585,0,0,2,0,2
17256,30,6728,10410,10585,0,0,1,0,1
17257,30,6729,10417;10979,10585,0,0,2,0,2
17258,30,6730,10458,10585,0,0,1,0,1
17259,30,6731,10462;10816,10585,0,0,2,0,2
17260,30,6732,10487;10577,10585,0,0,2,0,2
17261,30,6733,10123,10585,0,0,1,0,1
17262,30,6734,10376;10829,10585,0,0,2,0,2
17263,30,6735,10301;10716,10585,0,0,2,0,2
17264,30,6736,10723;10870,10585,0,0,2,0,2
17265,30,6737,10731;10828,10585,0,0,2,0,2
17266,30,6738,10767,10585,0,0,1,0,1
17267,30,6739,10733;10773,10585,0,0,2,0,2
17268,30,6740,10860;11426,10585,0,0,2,0,2
17269,30,6741,10544,10585,0,0,1,0,1
17270,30,6742,10888;11106;13732,10585,1,0,2,0,3
17271,30,6743,10897;11043,10585,0,0,2,0,2
17272,30,6744,10917;11217;13685,10585,1,0,2,0,3
17273,30,6745,10608;10970,10585,0,0,2,0,2
17274,30,6746,10985;10992,10585,0,0,2,0,2
17275,30,6747,10833;11018,10585,0,0,2,0,2
17276,30,6748,10762;11032,10585,0,0,2,0,2
17277,30,6749,10931;11039,10585,0,0,2,0,2
17278,30,6750,11042;11237;13754,10585,1,0,2,0,3
17279,30,6751,10915;11070;13766,10585,1,0,2,0,3
17280,30,6752,10827;11141,10585,0,0,2,0,2
17281,30,6753,11146;11215,10585,0,0,2,0,2
17282,30,6754,11147;11497;13688,10585,1,0,2,0,3
17283,30,6755,10935;11152,10585,0,0,2,0,2
17284,30,6756,11164;11411;13701,10585,1,0,2,0,3
17285,30,6757,10666;11185,10585,0,0,2,0,2
17286,30,6758,11121;11206,10585,0,0,2,0,2
17287,30,6759,11156;11214,10585,0,0,2,0,2
17288,30,6760,63,10950,0,0,0,1,1
17289,30,6761,2246;9686,10950,0,0,2,0,2
17290,30,6762,810,10950,0,0,1,0,1
17291,30,6763,1010,10950,0,0,1,0,1
17292,30,6765,1111,10950,0,0,1,0,1
17293,30,6766,1115,10950,0,0,1,0,1
17294,30,6767,2356,10950,0,0,1,0,1
17295,30,6768,1363,10950,0,0,1,0,1
17296,30,6769,4165,10950,0,0,1,0,1
17297,30,6770,1565;10412,10950,0,0,2,0,2
17298,30,6771,1598,10950,0,0,1,0,1
17299,30,6772,4809,10950,0,0,1,0,1
17300,30,6773,2015,10950,0,0,1,0,1
17301,30,6774,2032;3679;13740,10950,1,0,2,0,3
17302,30,6775,9607,10950,0,0,1,0,1
17303,30,6776,6823,10950,0,0,1,0,1
17304,30,6777,3007,10950,0,0,1,0,1
17305,30,6778,3099,10950,0,0,1,0,1
17306,30,6779,3349,10950,0,0,1,0,1
17307,30,6780,537,10950,0,0,1,0,1
17308,30,6781,8171,10950,0,0,1,0,1
17309,30,6783,4815,10950,0,0,1,0,1
17310,30,6784,458,10950,0,0,1,0,1
17311,30,6785,2524,10950,0,0,1,0,1
17312,30,6786,5330,10950,0,0,1,0,1
17313,30,6787,586,10950,0,0,1,0,1
17314,30,6788,6187,10950,0,0,1,0,1
17315,30,6789,6801,10950,0,0,0,1,1
17316,30,6790,10266;13764,10950,1,0,1,0,2
17317,30,6791,1890,10950,0,0,1,0,1
17318,30,6792,6208,10950,0,0,1,0,1
17319,30,6793,5244,10950,0,0,1,0,1
17320,30,6794,8839,10950,0,0,1,0,1
17321,30,6795,9117,10950,0,0,1,0,1
17322,30,6796,7009,10950,0,0,1,0,1
17323,30,6797,9362,10950,0,0,1,0,1
17324,30,6798,9406,10950,0,0,1,0,1
17325,30,6799,9620,10950,0,0,1,0,1
17326,30,6800,9696,10950,0,0,1,0,1
17327,30,6801,7037,10950,0,0,1,0,1
17328,30,6802,10032;10136,10950,0,0,2,0,2
17329,30,6803,10193,10950,0,0,1,0,1
17330,30,6804,6911,10950,0,0,1,0,1
17331,30,6805,2729,10950,0,0,1,0,1
17332,30,6806,10165;10322,10950,0,0,2,0,2
17333,30,6807,10166;10385,10950,0,0,2,0,2
17334,30,6808,10437,10950,0,0,1,0,1
17335,30,6809,10061,10950,0,0,1,0,1
17336,30,6810,10499,10950,0,0,1,0,1
17337,30,6811,10503;10591,10950,0,0,2,0,2
17338,30,6812,10525;10725,10950,0,0,2,0,2
17339,30,6813,10523,10950,0,0,1,0,1
17340,30,6814,10152,10950,0,0,1,0,1
17341,30,6815,10562,10950,0,0,1,0,1
17342,30,6816,10597,10950,0,0,1,0,1
17343,30,6817,10430;10616,10950,0,0,2,0,2
17344,30,6818,10693,10950,0,0,1,0,1
17345,30,6819,10514,10950,0,0,1,0,1
17346,30,6820,10641;10712,10950,0,0,2,0,2
17347,30,6821,10469,10950,0,0,1,0,1
17348,30,6822,11276,10950,0,0,1,0,1
17349,30,6823,10764;10997,10950,0,0,2,0,2
17350,30,6824,10793,10950,0,0,1,0,1
17351,30,6825,10808;10823,10950,0,0,2,0,2
17352,30,6826,10814;10835,10950,0,0,2,0,2
17353,30,6827,10571;10839,10950,0,0,2,0,2
17354,30,6828,10903;11108,10950,0,0,2,0,2
17355,30,6829,10914;11063,10950,0,0,2,0,2
17356,30,6830,10920;11484,10950,0,0,2,0,2
17357,30,6831,10926;11269,10950,0,0,2,0,2
17358,30,6832,10698;10932,10950,0,0,2,0,2
17359,30,6833,10982;11074,10950,0,0,2,0,2
17360,30,6834,10995,10950,0,0,1,0,1
17361,30,6835,10747,10950,0,0,1,0,1
17362,30,6836,10696,10950,0,0,1,0,1
17363,30,6837,11019;11047,10950,0,0,2,0,2
17364,30,6838,10957;11023,10950,0,0,2,0,2
17365,30,6839,11037;11135,10950,0,0,2,0,2
17366,30,6840,11038;11059,10950,0,0,2,0,2
17367,30,6841,11054;11566,10950,0,1,1,0,2
17368,30,6842,10367;11083,10950,0,0,2,0,2
17369,30,6843,10989;11100,10950,0,0,2,0,2
17370,30,6844,11103;11194,10950,0,0,2,0,2
17371,30,6845,11114,10950,0,0,1,0,1
17372,30,6846,11124,10950,0,0,1,0,1
17373,30,6847,11012;11129,10950,0,0,2,0,2
17374,30,6848,11160;11230,10950,0,0,2,0,2
17375,30,6849,11171;11526,10950,0,0,2,0,2
17376,30,6850,11173;11413,10950,0,0,2,0,2
17377,30,6851,11174;11344,10950,0,0,2,0,2
17378,30,6852,10785;11266,10950,0,0,2,0,2
17379,30,6853,10909;11196,10950,0,0,2,0,2
17380,30,6854,11201;11629,10950,0,1,1,0,2
17381,30,6855,11204;11377,10950,0,0,2,0,2
17382,30,6856,11228;11543,10950,0,1,1,0,2
17383,30,6857,11243;11250,10950,0,0,2,0,2
17384,30,6858,11090,10950,0,0,1,0,1
17385,30,6859,11256;11527,10950,0,0,2,0,2
17386,30,6860,11258;11394,10950,0,0,2,0,2
17387,30,6861,11233;11264,10950,0,0,2,0,2
17388,30,6862,11272;11293,10950,0,0,2,0,2
17389,30,6863,11274;11366,10950,0,0,2,0,2
17390,30,6864,10752,10950,0,0,1,0,1
17391,30,6865,11277;11442,10950,0,0,2,0,2
17392,30,6866,11282;11444,10950,0,0,2,0,2
17393,30,6867,11303;11378,10950,0,0,2,0,2
17394,30,6868,11305;11450,10950,0,0,2,0,2
17395,30,6869,11096;11315,10950,0,0,2,0,2
17396,30,6870,10868;11324,10950,0,0,2,0,2
17397,40,1,4;3259;12270,0,0,0,3,0,3
17398,40,3,15,0,0,0,0,1,1
17399,40,4,18;4056;14557,0,1,0,2,0,3
17400,40,6,20;9603,0,0,0,0,2,2
17401,40,13,39;10845,0,0,0,1,1,2
17402,40,14,4063,0,0,0,0,1,1
17403,40,15,46,0,0,0,0,1,1
17404,40,17,53,0,0,0,0,1,1
17405,40,21,67,0,0,0,0,1,1
17406,40,22,70,0,0,0,0,1,1
17407,40,25,9208;11809,0,0,0,2,0,2
17408,40,27,86,0,0,0,0,1,1
17409,40,28,90;1720;12734;13751;14341;14883,0,1,2,3,0,6
17410,40,29,91;92,0,0,0,0,2,2
17411,40,33,99;100,0,0,0,0,2,2
17412,40,36,108;113,0,0,0,1,1,2
17413,40,38,117;3099;11667;11854,0,0,0,4,0,4
17414,40,43,131,0,0,0,0,1,1
17415,40,44,134,0,0,0,0,1,1
17416,40,45,8194;8867,0,0,0,0,2,2
17417,40,52,151;7297,0,0,0,0,2,2
17418,40,53,7876,0,0,0,0,1,1
17419,40,54,159;9347,0,0,0,1,1,2
17420,40,55,2306,0,0,0,0,1,1
17421,40,56,164,0,0,0,1,0,1
17422,40,58,167,0,0,0,0,1,1
17423,40,59,171,0,0,0,0,1,1
17424,40,60,173,0,0,0,0,1,1
17425,40,61,180,0,0,0,1,0,1
17426,40,67,198;2635,0,0,0,0,2,2
17427,40,69,207,0,0,0,0,1,1
17428,40,71,210;572;10207,0,0,0,1,2,3
17429,40,73,214,0,0,0,0,1,1
17430,40,74,1463,0,0,0,0,1,1
17431,40,77,226,0,0,0,0,1,1
17432,40,78,230,0,0,0,0,1,1
17433,40,84,249,0,0,0,0,1,1
17434,40,86,253;5298,0,0,0,0,2,2
17435,40,90,261,0,0,0,0,1,1
17436,40,92,264;2637,0,0,0,0,2,2
17437,40,93,268;10284;13547;14240,0,0,2,2,0,4
17438,40,94,269,0,0,0,0,1,1
17439,40,96,275,0,0,0,0,1,1
17440,40,104,8027,0,0,0,0,1,1
17441,40,107,301;302,0,0,0,0,2,2
17442,40,112,318,0,0,0,0,1,1
17443,40,113,321,0,0,0,0,1,1
17444,40,118,332,0,0,0,0,1,1
17445,40,119,337,0,0,0,0,1,1
17446,40,127,9894,0,0,0,0,1,1
17447,40,128,354,0,0,0,0,1,1
17448,40,129,358,0,0,0,0,1,1
17449,40,130,362,0,0,0,0,1,1
17450,40,131,364;7435,0,0,0,0,2,2
17451,40,132,310,0,0,0,0,1,1
17452,40,134,372;1878,0,0,0,0,2,2
17453,40,138,382,0,0,0,0,1,1
17454,40,139,384;385;386,0,0,0,1,2,3
17455,40,141,388;389,0,0,0,0,2,2
17456,40,142,391,0,0,0,0,1,1
17457,40,143,394;4885,0,0,0,0,2,2
17458,40,144,396;3992,0,0,0,1,1,2
17459,40,152,412,0,0,0,0,1,1
17460,40,156,418,0,0,0,0,1,1
17461,40,158,425,0,0,0,0,1,1
17462,40,159,427;428,0,0,0,0,2,2
17463,40,162,435,0,0,0,0,1,1
17464,40,165,446;506,0,0,0,0,2,2
17465,40,167,452;5030,0,0,0,0,2,2
17466,40,169,344;457;460;5506,0,0,0,2,2,4
17467,40,173,5615;12759;12876,0,0,1,2,0,3
17468,40,176,1390,0,0,0,0,1,1
17469,40,179,493,0,0,0,1,0,1
17470,40,180,495,0,0,0,0,1,1
17471,40,181,496;497,0,0,0,0,2,2
17472,40,182,498,0,0,0,0,1,1
17473,40,183,500;7164,0,0,0,2,0,2
17474,40,184,502,0,0,0,0,1,1
17475,40,188,510,0,0,0,0,1,1
17476,40,190,518;519,0,0,0,0,2,2
17477,40,191,522,0,0,0,0,1,1
17478,40,195,4638,0,0,0,0,1,1
17479,40,197,535,0,0,0,0,1,1
17480,40,203,3382;3813;12668,0,0,0,3,0,3
17481,40,208,1915,0,0,0,0,1,1
17482,40,210,573,0,0,0,0,1,1
17483,40,211,575;8570,0,0,0,0,2,2
17484,40,216,8358,0,0,0,0,1,1
17485,40,218,35;589,0,0,0,0,2,2
17486,40,220,595;596,0,0,0,0,2,2
17487,40,227,613;1307;13850;14151,0,0,2,2,0,4
17488,40,233,624,0,0,0,0,1,1
17489,40,235,629;11352,0,0,0,2,0,2
17490,40,240,644;9790,0,0,0,2,0,2
17491,40,243,651,0,0,0,0,1,1
17492,40,246,8522,0,0,0,0,1,1
17493,40,250,666;667,0,0,0,0,2,2
17494,40,253,671,0,0,0,0,1,1
17495,40,256,683,0,0,0,0,1,1
17496,40,257,688;4589,0,0,0,0,2,2
17497,40,264,697,0,0,0,0,1,1
17498,40,267,707,0,0,0,0,1,1
17499,40,269,709,0,0,0,0,1,1
17500,40,270,713,0,0,0,0,1,1
17501,40,273,718,0,0,0,0,1,1
17502,40,274,722,0,0,0,0,1,1
17503,40,276,729,0,0,0,0,1,1
17504,40,277,8898,0,0,0,0,1,1
17505,40,279,738;9852,0,0,0,0,2,2
17506,40,283,745;2242,0,0,0,0,2,2
17507,40,284,747,0,0,0,0,1,1
17508,40,286,750,0,0,0,0,1,1
17509,40,288,756;6575;10623,0,0,0,1,2,3
17510,40,291,6147;10978,0,0,0,2,0,2
17511,40,293,6539,0,0,0,0,1,1
17512,40,294,764;5094,0,0,0,0,2,2
17513,40,297,1545;7780;13114;13667;14220,0,0,3,2,0,5
17514,40,301,787,0,0,0,1,0,1
17515,40,303,1983,0,0,0,0,1,1
17516,40,304,9923;13480;13591;14436,0,0,3,1,0,4
17517,40,305,796;798,0,0,0,0,2,2
17518,40,306,799;800,0,0,0,0,2,2
17519,40,307,805;10289,0,0,0,1,1,2
17520,40,308,806;807,0,0,0,0,2,2
17521,40,309,808,0,0,0,0,1,1
17522,40,315,822,0,0,0,0,1,1
17523,40,318,831,0,0,0,0,1,1
17524,40,322,840,0,0,0,0,1,1
17525,40,327,854,0,0,0,0,1,1
17526,40,332,869;3919,0,0,0,1,1,2
17527,40,334,876;5401,0,0,0,0,2,2
17528,40,336,882,0,0,0,0,1,1
17529,40,337,884,0,0,0,0,1,1
17530,40,340,893;894,0,0,0,0,2,2
17531,40,350,921;4285;4736;7150;12538;12951;13398,0,0,2,5,0,7
17532,40,352,924,0,0,0,0,1,1
17533,40,353,929;9246;12701,0,0,0,3,0,3
17534,40,357,939;940,0,0,0,1,1,2
17535,40,361,949;11198,0,0,0,2,0,2
17536,40,365,965,0,0,0,0,1,1
17537,40,367,970,0,0,0,0,1,1
17538,40,369,3974;3976;3977,0,0,0,2,1,3
17539,40,370,989,0,0,0,0,1,1
17540,40,376,1000;3442,0,0,0,1,1,2
17541,40,378,1005,0,0,0,0,1,1
17542,40,382,1014;6783,0,0,0,0,2,2
17543,40,384,1019;6142;10273,0,0,0,1,2,3
17544,40,388,1028,0,0,0,0,1,1
17545,40,392,1039,0,0,0,0,1,1
17546,40,393,1044;7724;7890;10077;14116;14293,0,0,2,4,0,6
17547,40,395,1048,0,0,0,0,1,1
17548,40,398,1058,0,0,0,0,1,1
17549,40,400,1062,0,0,0,0,1,1
17550,40,403,1069,0,0,0,0,1,1
17551,40,405,1075;3452,0,0,0,0,2,2
17552,40,406,1077,0,0,0,0,1,1
17553,40,410,1082;9170,0,0,0,0,2,2
17554,40,411,1083,0,0,0,1,0,1
17555,40,412,1085,0,0,0,0,1,1
17556,40,414,1089,0,0,0,0,1,1
17557,40,415,1092;14582,0,1,0,1,0,2
17558,40,417,1098;9218,0,0,0,0,2,2
17559,40,418,1101,0,0,0,0,1,1
17560,40,420,1106;1107,0,0,0,2,0,2
17561,40,421,1108;8308,0,0,0,0,2,2
17562,40,423,1112,0,0,0,0,1,1
17563,40,425,1117;4255,0,0,0,0,2,2
17564,40,427,1120,0,0,0,0,1,1
17565,40,428,1124,0,0,0,0,1,1
17566,40,430,243;1129;10861,0,0,0,1,2,3
17567,40,431,1131;3646,0,0,0,0,2,2
17568,40,433,1135,0,0,0,0,1,1
17569,40,434,1137,0,0,0,0,1,1
17570,40,436,1146,0,0,0,0,1,1
17571,40,440,1164;7440,0,0,0,2,0,2
17572,40,448,1181;8904,0,0,0,1,1,2
17573,40,449,759,0,0,0,0,1,1
17574,40,451,1185;1186,0,0,0,0,2,2
17575,40,453,1190,0,0,0,0,1,1
17576,40,455,1196,0,0,0,0,1,1
17577,40,456,1198;7627,0,0,0,2,0,2
17578,40,459,1204,0,0,0,0,1,1
17579,40,466,1223,0,0,0,0,1,1
17580,40,467,1226,0,0,0,0,1,1
17581,40,468,1228,0,0,0,0,1,1
17582,40,472,1241,0,0,0,0,1,1
17583,40,474,3655;9623,0,0,0,0,2,2
17584,40,478,1260;3503;13143;13535,0,0,2,2,0,4
17585,40,483,1275;1276,0,0,0,0,2,2
17586,40,487,1283;8781,0,0,0,2,0,2
17587,40,488,1285;3676;12189,0,0,0,2,1,3
17588,40,490,1291,0,0,0,0,1,1
17589,40,491,1296;8317;12976,0,0,1,2,0,3
17590,40,493,1303,0,0,0,0,1,1
17591,40,494,528,0,0,0,0,1,1
17592,40,495,1309,0,0,0,0,1,1
17593,40,497,1316,0,0,0,0,1,1
17594,40,500,1324,0,0,0,0,1,1
17595,40,502,1327,0,0,0,0,1,1
17596,40,503,1329;6543,0,0,0,0,2,2
17597,40,505,6079,0,0,0,0,1,1
17598,40,508,1341,0,0,0,0,1,1
17599,40,509,1345;13364;13522;14170,0,0,3,1,0,4
17600,40,514,1361,0,0,0,0,1,1
17601,40,516,1366,0,0,0,0,1,1
17602,40,518,9207;10464,0,0,0,1,1,2
17603,40,519,1375;5704;11827;12365,0,0,0,4,0,4
17604,40,522,1382;10019;12989;13272;14772,0,1,2,2,0,5
17605,40,523,327;1383,0,0,0,0,2,2
17606,40,530,1397,0,0,0,0,1,1
17607,40,534,1405;9204,0,0,0,0,2,2
17608,40,535,1407,0,0,0,0,1,1
17609,40,540,1422;1423,0,0,0,0,2,2
17610,40,545,1435;1436,0,0,0,0,2,2
17611,40,547,1440,0,0,0,0,1,1
17612,40,548,1441,0,0,0,0,1,1
17613,40,553,1453;7690,0,0,0,2,0,2
17614,40,555,1456,0,0,0,0,1,1
17615,40,556,1461;10343;10817;12975;13370;13796;13997;14320,0,0,5,3,0,8
17616,40,559,1466,0,0,0,0,1,1
17617,40,560,1469,0,0,0,0,1,1
17618,40,561,1473;5771;12597,0,0,0,3,0,3
17619,40,562,1475,0,0,0,1,0,1
17620,40,563,1480,0,0,0,0,1,1
17621,40,565,1483;3685,0,0,0,0,2,2
17622,40,566,1488,0,0,0,0,1,1
17623,40,567,1491,0,0,0,0,1,1
17624,40,569,1497,0,0,0,0,1,1
17625,40,571,1502;5602,0,0,0,0,2,2
17626,40,573,1506;4815,0,0,0,1,1,2
17627,40,574,1507,0,0,0,0,1,1
17628,40,579,1520;1521,0,0,0,0,2,2
17629,40,582,517;1529,0,0,0,2,0,2
17630,40,588,1549,0,0,0,0,1,1
17631,40,590,1553;10064,0,0,0,1,1,2
17632,40,591,1555,0,0,0,0,1,1
17633,40,592,1558;2978,0,0,0,0,2,2
17634,40,593,1560,0,0,0,1,0,1
17635,40,598,1577;12983;13366,0,0,2,1,0,3
17636,40,606,1595,0,0,0,0,1,1
17637,40,607,8801,0,0,0,0,1,1
17638,40,611,1605;1606,0,0,0,1,1,2
17639,40,615,1620,0,0,0,1,0,1
17640,40,618,1628;1629,0,0,0,0,2,2
17641,40,619,1632,0,0,0,0,1,1
17642,40,620,178;1633;11701,0,0,0,3,0,3
17643,40,622,1638,0,0,0,0,1,1
17644,40,624,1643;4764,0,0,0,0,2,2
17645,40,632,1664;9901,0,0,0,0,2,2
17646,40,639,1684,0,0,0,0,1,1
17647,40,641,1690;1694,0,0,0,1,1,2
17648,40,642,4988,0,0,0,0,1,1
17649,40,648,1715;1776,0,0,0,2,0,2
17650,40,656,1743,0,0,0,0,1,1
17651,40,660,9192,0,0,0,0,1,1
17652,40,661,1756;3842;12528;12954;13328;13721,0,0,3,3,0,6
17653,40,665,1764,0,0,0,0,1,1
17654,40,667,1771;7499;12518;13925;14470,0,0,2,3,0,5
17655,40,671,1782,0,0,0,0,1,1
17656,40,677,1795,0,0,0,0,1,1
17657,40,682,1809,0,0,0,0,1,1
17658,40,684,1812;1813,0,0,0,0,2,2
17659,40,687,1818,0,0,0,0,1,1
17660,40,692,1830;7339,0,0,0,0,2,2
17661,40,695,4352,0,0,0,0,1,1
17662,40,696,1840;2015;13216;13384,0,0,2,2,0,4
17663,40,698,1843,0,0,0,0,1,1
17664,40,702,1853,0,0,0,0,1,1
17665,40,704,1856;7441,0,0,0,0,2,2
17666,40,709,1760;1868,0,0,0,0,2,2
17667,40,710,1869;2679,0,0,0,0,2,2
17668,40,713,1874,0,0,0,0,1,1
17669,40,714,1876,0,0,0,0,1,1
17670,40,716,879;1881,0,0,0,2,0,2
17671,40,719,1888,0,0,0,0,1,1
17672,40,720,1891,0,0,0,0,1,1
17673,40,721,1893,0,0,0,0,1,1
17674,40,723,1898,0,0,0,0,1,1
17675,40,728,1914,0,0,0,0,1,1
17676,40,730,1917;9761,0,0,0,0,2,2
17677,40,731,9969,0,0,0,0,1,1
17678,40,733,1923;1924,0,0,0,0,2,2
17679,40,735,3137;13918,0,0,1,1,0,2
17680,40,736,8154;9410,0,0,0,0,2,2
17681,40,738,5001;7509,0,0,0,2,0,2
17682,40,739,1937,0,0,0,0,1,1
17683,40,740,1938,0,0,0,0,1,1
17684,40,750,1965;2149,0,0,0,0,2,2
17685,40,751,1968;8451,0,0,0,0,2,2
17686,40,752,1969;1970,0,0,0,0,2,2
17687,40,753,1972,0,0,0,0,1,1
17688,40,754,1975,0,0,0,0,1,1
17689,40,759,1993;7937,0,0,0,2,0,2
17690,40,762,1997,0,0,0,0,1,1
17691,40,767,2005;5613,0,0,0,2,0,2
17692,40,768,7829,0,0,0,0,1,1
17693,40,771,2020,0,0,0,0,1,1
17694,40,772,2023;2024,0,0,0,1,1,2
17695,40,773,2026,0,0,0,0,1,1
17696,40,782,2052;6895,0,0,0,0,2,2
17697,40,784,1464;2057,0,0,0,0,2,2
17698,40,786,2062;8886;13827;14132,0,0,2,2,0,4
17699,40,787,2064,0,0,0,0,1,1
17700,40,788,2065,0,0,0,0,1,1
17701,40,792,2074;2075,0,0,0,0,2,2
17702,40,797,2087,0,0,0,0,1,1
17703,40,798,2088;2090,0,0,0,0,2,2
17704,40,799,2095,0,0,0,0,1,1
17705,40,801,2100,0,0,0,0,1,1
17706,40,803,2103;2809,0,0,0,0,2,2
17707,40,805,4379;5779;12237,0,0,0,3,0,3
17708,40,806,2109;3354,0,0,0,0,2,2
17709,40,809,2114;5370,0,0,0,0,2,2
17710,40,812,2120,0,0,0,0,1,1
17711,40,813,2123;4946;12526;13339,0,0,1,3,0,4
17712,40,816,2128,0,0,0,0,1,1
17713,40,818,2139;2142,0,0,0,1,1,2
17714,40,819,2143,0,0,0,0,1,1
17715,40,821,6028;10068,0,0,0,1,1,2
17716,40,825,3694;6082,0,0,0,0,2,2
17717,40,828,2162,0,0,0,0,1,1
17718,40,829,1023,0,0,0,0,1,1
17719,40,833,1931;2173;11539,0,0,0,3,0,3
17720,40,834,2178;11828,0,0,0,1,1,2
17721,40,841,2193,0,0,0,0,1,1
17722,40,844,2198,0,0,0,0,1,1
17723,40,850,2214,0,0,0,0,1,1
17724,40,851,2216;7783,0,0,0,0,2,2
17725,40,852,2221,0,0,0,0,1,1
17726,40,854,2229,0,0,0,0,1,1
17727,40,857,758;2238;10830,0,0,0,3,0,3
17728,40,859,2243,0,0,0,0,1,1
17729,40,862,2257;3580,0,0,0,0,2,2
17730,40,864,2263,0,0,0,0,1,1
17731,40,865,2266;2267,0,0,0,0,2,2
17732,40,866,2271,0,0,0,1,0,1
17733,40,867,2272,0,0,0,0,1,1
17734,40,868,2274;2275,0,0,0,0,2,2
17735,40,869,2277;2280,0,0,0,0,2,2
17736,40,873,1202;2287,0,0,0,0,2,2
17737,40,874,2293,0,0,0,0,1,1
17738,40,877,2299,0,0,0,0,1,1
17739,40,878,2303;2805;11801,0,0,0,3,0,3
17740,40,886,2320;2321;2323;4771;5365;6823;11949;12357;12663;12683;13023;13511,0,0,2,10,0,12
17741,40,889,2331;6398,0,0,0,0,2,2
17742,40,893,2409,0,0,0,0,1,1
17743,40,894,2342,0,0,0,1,0,1
17744,40,895,3189,0,0,0,0,1,1
17745,40,902,2367;3814,0,0,0,0,2,2
17746,40,904,2374,0,0,0,1,0,1
17747,40,909,2386,0,0,0,0,1,1
17748,40,912,2393,0,0,0,0,1,1
17749,40,918,2413,0,0,0,0,1,1
17750,40,919,2418;4793;11735;12223;14617,0,1,0,4,0,5
17751,40,921,2421,0,0,0,0,1,1
17752,40,928,2436,0,0,0,0,1,1
17753,40,930,2439;2440,0,0,0,0,2,2
17754,40,935,2454,0,0,0,0,1,1
17755,40,937,2460,0,0,0,0,1,1
17756,40,940,2471;2472,0,0,0,0,2,2
17757,40,944,2484,0,0,0,0,1,1
17758,40,947,2488,0,0,0,0,1,1
17759,40,948,2493,0,0,0,1,0,1
17760,40,951,2508;9585;12361,0,0,0,3,0,3
17761,40,953,2368;2513;10674,0,0,0,1,2,3
17762,40,956,2520,0,0,0,0,1,1
17763,40,957,2521,0,0,0,0,1,1
17764,40,960,2533,0,0,0,0,1,1
17765,40,961,2536,0,0,0,0,1,1
17766,40,962,2538;5562,0,0,0,0,2,2
17767,40,964,2541,0,0,0,0,1,1
17768,40,965,2547,0,0,0,0,1,1
17769,40,967,2550,0,0,0,0,1,1
17770,40,969,2554,0,0,0,0,1,1
17771,40,970,531;2558,0,0,0,0,2,2
17772,40,971,2561,0,0,0,0,1,1
17773,40,972,2564,0,0,0,0,1,1
17774,40,974,2567,0,0,0,0,1,1
17775,40,977,2574;2575,0,0,0,0,2,2
17776,40,978,80,0,0,0,1,0,1
17777,40,980,2153,0,0,0,0,1,1
17778,40,984,2591,0,0,0,0,1,1
17779,40,989,2602;7787,0,0,0,0,2,2
17780,40,990,5248;8649;12647;12845,0,0,1,3,0,4
17781,40,991,2608;8882;12213,0,0,0,1,2,3
17782,40,995,1211;2614,0,0,0,0,2,2
17783,40,997,2072,0,0,0,0,1,1
17784,40,998,2706,0,0,0,0,1,1
17785,40,1001,2630;4452,0,0,0,0,2,2
17786,40,1006,2639,0,0,0,0,1,1
17787,40,1010,2648;9406;12796,0,0,0,3,0,3
17788,40,1013,2658;3740,0,0,0,0,2,2
17789,40,1018,2666;2668,0,0,0,0,2,2
17790,40,1019,2673,0,0,0,0,1,1
17791,40,1023,2683,0,0,0,0,1,1
17792,40,1025,2691,0,0,0,0,1,1
17793,40,1027,2837,0,0,0,0,1,1
17794,40,1029,2698;9810,0,0,0,0,2,2
17795,40,1031,2703,0,0,0,0,1,1
17796,40,1033,9333,0,0,0,0,1,1
17797,40,1037,233;2712,0,0,0,0,2,2
17798,40,1039,5780,0,0,0,0,1,1
17799,40,1045,2738;5187;12505;12548;12936;13327,0,0,2,4,0,6
17800,40,1048,2749;5146,0,0,0,0,2,2
17801,40,1059,2748;2773;11486,0,0,0,2,1,3
17802,40,1062,2950;7177;13560;13851;14591,0,1,2,2,0,5
17803,40,1063,2786;4625;10371,0,0,0,1,2,3
17804,40,1065,2792,0,0,0,0,1,1
17805,40,1067,2797,0,0,0,0,1,1
17806,40,1069,2806;6176,0,0,0,1,1,2
17807,40,1071,2814,0,0,0,0,1,1
17808,40,1072,2819,0,0,0,0,1,1
17809,40,1073,2822,0,0,0,0,1,1
17810,40,1074,2823;6873;12305,0,0,0,3,0,3
17811,40,1076,2829,0,0,0,0,1,1
17812,40,1077,3781,0,0,0,0,1,1
17813,40,1078,7145,0,0,0,0,1,1
17814,40,1084,2851,0,0,0,0,1,1
17815,40,1086,2856,0,0,0,0,1,1
17816,40,1089,2866,0,0,0,0,1,1
17817,40,1090,2868,0,0,0,0,1,1
17818,40,1093,3293;6343,0,0,0,0,2,2
17819,40,1094,2882;4803,0,0,0,0,2,2
17820,40,1096,2885;8951,0,0,0,0,2,2
17821,40,1098,1719;12309;12697;12847,0,0,1,3,0,4
17822,40,1099,2888,0,0,0,0,1,1
17823,40,1103,7283,0,0,0,0,1,1
17824,40,1104,2903,0,0,0,0,1,1
17825,40,1105,2905,0,0,0,0,1,1
17826,40,1109,2911,0,0,0,1,0,1
17827,40,1111,2915,0,0,0,0,1,1
17828,40,1116,2926,0,0,0,0,1,1
17829,40,1121,2937;4841,0,0,0,0,2,2
17830,40,1123,2941,0,0,0,0,1,1
17831,40,1124,2944;9658,0,0,0,0,2,2
17832,40,1128,2956,0,0,0,0,1,1
17833,40,1129,2958;10768;11898,0,0,0,3,0,3
17834,40,1130,2962,0,0,0,0,1,1
17835,40,1133,6335;8338,0,0,0,2,0,2
17836,40,1136,2982,0,0,0,0,1,1
17837,40,1137,2984,0,0,0,0,1,1
17838,40,1138,10094,0,0,0,1,0,1
17839,40,1139,2988,0,0,0,0,1,1
17840,40,1149,3018,0,0,0,0,1,1
17841,40,1152,726;3024,0,0,0,2,0,2
17842,40,1153,6818,0,0,0,0,1,1
17843,40,1156,3040;3041;5088;6323;6972;9819;12549,0,0,0,3,4,7
17844,40,1158,3047,0,0,0,0,1,1
17845,40,1161,3053,0,0,0,0,1,1
17846,40,1164,3065,0,0,0,0,1,1
17847,40,1168,10553;10804;10934;11050;11210;11267;11426;14006;14055;14486;14653;14738;14795;15180,0,4,3,7,0,14
17848,40,1170,3080;8211,0,0,0,2,0,2
17849,40,1172,3086;9026,0,0,0,1,1,2
17850,40,1180,3105;10529,0,0,0,2,0,2
17851,40,1181,3109,0,0,0,0,1,1
17852,40,1185,3119;6447,0,0,0,0,2,2
17853,40,1186,3124;5485,0,0,0,0,2,2
17854,40,1189,6291,0,0,0,0,1,1
17855,40,1190,3135,0,0,0,0,1,1
17856,40,1191,3141;4531,0,0,0,1,1,2
17857,40,1192,3142;6371,0,0,0,0,2,2
17858,40,1193,3143,0,0,0,0,1,1
17859,40,1194,3148,0,0,0,0,1,1
17860,40,1198,3153,0,0,0,0,1,1
17861,40,1200,3163,0,0,0,0,1,1
17862,40,1201,3167,0,0,0,0,1,1
17863,40,1202,3169,0,0,0,0,1,1
17864,40,1203,3170;9781;10542,0,0,0,1,2,3
17865,40,1205,3174;11193,0,0,0,1,1,2
17866,40,1206,3176,0,0,0,0,1,1
17867,40,1208,5220,0,0,0,0,1,1
17868,40,1209,357;6720;12928,0,0,1,2,0,3
17869,40,1210,3187;3364,0,0,0,1,1,2
17870,40,1214,6479;7249,0,0,0,0,2,2
17871,40,1216,3206,0,0,0,0,1,1
17872,40,1220,3220;3221,0,0,0,1,1,2
17873,40,1224,3231,0,0,0,1,0,1
17874,40,1229,3249;10135,0,0,0,1,1,2
17875,40,1232,3253;6339,0,0,0,0,2,2
17876,40,1233,3258;6811,0,0,0,0,2,2
17877,40,1234,1769;12724,0,0,0,2,0,2
17878,40,1235,3262,0,0,0,0,1,1
17879,40,1237,3265,0,0,0,0,1,1
17880,40,1241,3274,0,0,0,0,1,1
17881,40,1243,3279,0,0,0,0,1,1
17882,40,1245,3285,0,0,0,0,1,1
17883,40,1248,3292,0,0,0,0,1,1
17884,40,1250,8868,0,0,0,0,1,1
17885,40,1257,3313,0,0,0,0,1,1
17886,40,1258,3317;3901,0,0,0,1,1,2
17887,40,1260,3322,0,0,0,0,1,1
17888,40,1268,3336;8792,0,0,0,0,2,2
17889,40,1269,3807;5654,0,0,0,0,2,2
17890,40,1271,634;3343,0,0,0,0,2,2
17891,40,1275,3356;8526;14468,0,0,1,2,0,3
17892,40,1276,5452,0,0,0,0,1,1
17893,40,1277,3361,0,0,0,0,1,1
17894,40,1280,3368;3369,0,0,0,0,2,2
17895,40,1281,3370;3371,0,0,0,0,2,2
17896,40,1282,3373,0,0,0,0,1,1
17897,40,1283,3378;10690,0,0,0,1,1,2
17898,40,1285,3386;6955;9975;13456;13713,0,0,2,3,0,5
17899,40,1286,7694,0,0,0,0,1,1
17900,40,1291,3410,0,0,0,0,1,1
17901,40,1292,672;3411,0,0,0,1,1,2
17902,40,1297,3423,0,0,0,0,1,1
17903,40,1299,3427,0,0,0,0,1,1
17904,40,1300,3430,0,0,0,0,1,1
17905,40,1301,3435,0,0,0,0,1,1
17906,40,1303,3441,0,0,0,0,1,1
17907,40,1306,3448,0,0,0,1,0,1
17908,40,1310,3460,0,0,0,0,1,1
17909,40,1315,3474,0,0,0,1,0,1
17910,40,1316,3479,0,0,0,0,1,1
17911,40,1322,3491,0,0,0,0,1,1
17912,40,1326,3687,0,0,0,0,1,1
17913,40,1327,1991;3505,0,0,0,0,2,2
17914,40,1329,3509;6516,0,0,0,0,2,2
17915,40,1331,3511;3512,0,0,0,0,2,2
17916,40,1332,3514;6923;10871,0,0,0,1,2,3
17917,40,1333,3515,0,0,0,0,1,1
17918,40,1335,3522,0,0,0,0,1,1
17919,40,1336,3525,0,0,0,0,1,1
17920,40,1337,3526;7650,0,0,0,0,2,2
17921,40,1339,3532;3534,0,0,0,0,2,2
17922,40,1340,3535,0,0,0,0,1,1
17923,40,1351,3567,0,0,0,0,1,1
17924,40,1352,3569,0,0,0,0,1,1
17925,40,1354,3577,0,0,0,0,1,1
17926,40,1357,3581,0,0,0,0,1,1
17927,40,1361,3597,0,0,0,0,1,1
17928,40,1362,8399,0,0,0,0,1,1
17929,40,1367,3609,0,0,0,0,1,1
17930,40,1368,3613,0,0,0,0,1,1
17931,40,1370,3618,0,0,0,0,1,1
17932,40,1371,3619,0,0,0,0,1,1
17933,40,1373,3623;5267,0,0,0,0,2,2
17934,40,1375,3627;3829;10685,0,0,0,1,2,3
17935,40,1378,3635,0,0,0,0,1,1
17936,40,1379,3638,0,0,0,0,1,1
17937,40,1383,3651,0,0,0,0,1,1
17938,40,1388,3661,0,0,0,0,1,1
17939,40,1394,3680,0,0,0,0,1,1
17940,40,1395,3682,0,0,0,0,1,1
17941,40,1397,3686,0,0,0,0,1,1
17942,40,1401,3697;7834,0,0,0,0,2,2
17943,40,1403,12;959;11670,0,0,0,3,0,3
17944,40,1404,1617,0,0,0,0,1,1
17945,40,1409,4929,0,0,0,0,1,1
17946,40,1411,3724,0,0,0,0,1,1
17947,40,1412,3729,0,0,0,0,1,1
17948,40,1415,922,0,0,0,0,1,1
17949,40,1416,5117,0,0,0,0,1,1
17950,40,1417,1365;4871;10424,0,0,0,1,2,3
17951,40,1419,8644,0,0,0,0,1,1
17952,40,1420,1873,0,0,0,0,1,1
17953,40,1421,3753;7993;13032,0,0,1,2,0,3
17954,40,1422,3754;3755,0,0,0,0,2,2
17955,40,1425,3761,0,0,0,0,1,1
17956,40,1426,3763;6659,0,0,0,0,2,2
17957,40,1427,616;3767,0,0,0,2,0,2
17958,40,1430,7129;8028,0,0,0,0,2,2
17959,40,1438,2943;3790,0,0,0,0,2,2
17960,40,1439,3791,0,0,0,0,1,1
17961,40,1441,3800,0,0,0,0,1,1
17962,40,1451,3826,0,0,0,0,1,1
17963,40,1452,3828,0,0,0,0,1,1
17964,40,1455,3840,0,0,0,1,0,1
17965,40,1456,3843,0,0,0,0,1,1
17966,40,1457,3845,0,0,0,0,1,1
17967,40,1458,3848;11929;12188,0,0,0,3,0,3
17968,40,1461,3855,0,0,0,0,1,1
17969,40,1463,3862,0,0,0,0,1,1
17970,40,1465,7578,0,0,0,0,1,1
17971,40,1466,3871,0,0,0,0,1,1
17972,40,1467,8691,0,0,0,0,1,1
17973,40,1468,1967;3880,0,0,0,1,1,2
17974,40,1471,3884;3885,0,0,0,0,2,2
17975,40,1475,3893,0,0,0,0,1,1
17976,40,1476,3897,0,0,0,0,1,1
17977,40,1484,3913,0,0,0,0,1,1
17978,40,1498,3953,0,0,0,0,1,1
17979,40,1501,3966;9152,0,0,0,0,2,2
17980,40,1502,3972,0,0,0,0,1,1
17981,40,1508,2138;3983,0,0,0,0,2,2
17982,40,1512,2776;3993,0,0,0,0,2,2
17983,40,1518,4009;4010,0,0,0,0,2,2
17984,40,1520,963;4013,0,0,0,0,2,2
17985,40,1521,4014;8463,0,0,0,0,2,2
17986,40,1522,4017,0,0,0,0,1,1
17987,40,1524,4020,0,0,0,0,1,1
17988,40,1526,4027,0,0,0,0,1,1
17989,40,1527,4029,0,0,0,0,1,1
17990,40,1529,5631,0,0,0,0,1,1
17991,40,1531,4038;4039,0,0,0,0,2,2
17992,40,1533,4042,0,0,0,0,1,1
17993,40,1535,4050,0,0,0,0,1,1
17994,40,1537,4058,0,0,0,0,1,1
17995,40,1540,279;4064,0,0,0,2,0,2
17996,40,1541,4066,0,0,0,1,0,1
17997,40,1550,1586;4088,0,0,0,1,1,2
17998,40,1551,4091;9750;13937;14350,0,0,2,2,0,4
17999,40,1555,2762,0,0,0,0,1,1
18000,40,1556,4099,0,0,0,0,1,1
18001,40,1557,4104,0,0,0,0,1,1
18002,40,1562,4117,0,0,0,0,1,1
18003,40,1570,6059,0,0,0,0,1,1
18004,40,1572,4135;4136,0,0,0,0,2,2
18005,40,1574,4139,0,0,0,0,1,1
18006,40,1575,4142;12079,0,0,0,2,0,2
18007,40,1577,3019;4147;4150;4151;7316;12402;12950;13068;13344;13387,0,0,4,6,0,10
18008,40,1578,2478,0,0,0,0,1,1
18009,40,1579,4153,0,0,0,0,1,1
18010,40,1580,4155,0,0,0,0,1,1
18011,40,1582,4159,0,0,0,0,1,1
18012,40,1583,4161;4162,0,0,0,0,2,2
18013,40,1584,1376;8893;13322,0,0,1,2,0,3
18014,40,1587,4172,0,0,0,0,1,1
18015,40,1588,4175;6607;11528,0,0,0,1,2,3
18016,40,1595,4192;4193,0,0,0,0,2,2
18017,40,1597,4195,0,0,0,0,1,1
18018,40,1600,4203,0,0,0,0,1,1
18019,40,1601,4205;9103;12757,0,0,0,3,0,3
18020,40,1602,4206,0,0,0,0,1,1
18021,40,1603,4211,0,0,0,0,1,1
18022,40,1607,4223,0,0,0,0,1,1
18023,40,1608,1679,0,0,0,0,1,1
18024,40,1610,3787,0,0,0,0,1,1
18025,40,1611,4231,0,0,0,0,1,1
18026,40,1616,4240;4241,0,0,0,0,2,2
18027,40,1621,4253;4254,0,0,0,0,2,2
18028,40,1622,4256,0,0,0,0,1,1
18029,40,1625,4262;5894,0,0,0,0,2,2
18030,40,1627,4220;4268;6845;7729;11208;11226;12058;12152;12165;13448,0,0,1,9,0,10
18031,40,1628,4269;4270,0,0,0,0,2,2
18032,40,1630,4282,0,0,0,0,1,1
18033,40,1631,4288,0,0,0,0,1,1
18034,40,1633,401;4291,0,0,0,1,1,2
18035,40,1634,4295;12676;12861;14537,0,1,1,2,0,4
18036,40,1635,4296,0,0,0,0,1,1
18037,40,1636,4298,0,0,0,0,1,1
18038,40,1639,4306;5883,0,0,0,0,2,2
18039,40,1644,4318;9995,0,0,0,0,2,2
18040,40,1645,4319;8423,0,0,0,0,2,2
18041,40,1647,4323;7165,0,0,0,0,2,2
18042,40,1648,4942,0,0,0,0,1,1
18043,40,1651,4330,0,0,0,0,1,1
18044,40,1652,1187,0,0,0,0,1,1
18045,40,1655,4338,0,0,0,0,1,1
18046,40,1658,4344,0,0,0,1,0,1
18047,40,1659,4345,0,0,0,0,1,1
18048,40,1660,4347;9126,0,0,0,0,2,2
18049,40,1665,7064,0,0,0,0,1,1
18050,40,1669,4365,0,0,0,1,0,1
18051,40,1670,4366,0,0,0,0,1,1
18052,40,1672,3210;4376,0,0,0,0,2,2
18053,40,1673,4380,0,0,0,0,1,1
18054,40,1674,4382,0,0,0,0,1,1
18055,40,1675,4387,0,0,0,0,1,1
18056,40,1677,4391,0,0,0,0,1,1
18057,40,1679,7497;9867;13008,0,0,1,2,0,3
18058,40,1689,818,0,0,0,0,1,1
18059,40,1694,4430,0,0,0,0,1,1
18060,40,1696,4433,0,0,0,0,1,1
18061,40,1697,4437,0,0,0,0,1,1
18062,40,1699,4440,0,0,0,0,1,1
18063,40,1701,4445,0,0,0,0,1,1
18064,40,1702,1178,0,0,0,0,1,1
18065,40,1703,4450,0,0,0,0,1,1
18066,40,1708,4463,0,0,0,0,1,1
18067,40,1710,4465,0,0,0,0,1,1
18068,40,1711,4467,0,0,0,0,1,1
18069,40,1712,4468;4469,0,0,0,0,2,2
18070,40,1713,4472;4476,0,0,0,2,0,2
18071,40,1716,4483,0,0,0,0,1,1
18072,40,1719,2917;4494,0,0,0,1,1,2
18073,40,1723,890;4506;12437;12666,0,0,0,4,0,4
18074,40,1724,4508;9122,0,0,0,0,2,2
18075,40,1725,1478;4516,0,0,0,2,0,2
18076,40,1728,1446;4521,0,0,0,0,2,2
18077,40,1729,4524;5600;11506,0,0,0,1,2,3
18078,40,1730,4526,0,0,0,0,1,1
18079,40,1731,4530,0,0,0,0,1,1
18080,40,1737,4541,0,0,0,0,1,1
18081,40,1739,4546;4547,0,0,0,0,2,2
18082,40,1746,7863,0,0,0,0,1,1
18083,40,1752,4578,0,0,0,0,1,1
18084,40,1753,4579,0,0,0,0,1,1
18085,40,1755,4587,0,0,0,1,0,1
18086,40,1761,4606,0,0,0,0,1,1
18087,40,1763,4612;5689,0,0,0,0,2,2
18088,40,1768,4626,0,0,0,0,1,1
18089,40,1775,4646,0,0,0,0,1,1
18090,40,1776,3002;4650,0,0,0,0,2,2
18091,40,1777,4653;7720;11479,0,0,0,2,1,3
18092,40,1784,4669,0,0,0,1,0,1
18093,40,1787,4673,0,0,0,0,1,1
18094,40,1789,4679,0,0,0,0,1,1
18095,40,1791,4684,0,0,0,0,1,1
18096,40,1793,3005;4688;4689;10677,0,0,0,2,2,4
18097,40,1794,4692;8353,0,0,0,0,2,2
18098,40,1796,1049;4699;13538;14225,0,0,2,2,0,4
18099,40,1798,4702,0,0,0,0,1,1
18100,40,1800,4708,0,0,0,0,1,1
18101,40,1802,4712,0,0,0,0,1,1
18102,40,1804,4717,0,0,0,0,1,1
18103,40,1805,4722;12146;12523;13422,0,0,1,3,0,4
18104,40,1807,1613;4727,0,0,0,0,2,2
18105,40,1811,4734;9716,0,0,0,0,2,2
18106,40,1813,4741;4742,0,0,0,0,2,2
18107,40,1815,4746,0,0,0,0,1,1
18108,40,1817,4753,0,0,0,0,1,1
18109,40,1821,2827;4766,0,0,0,0,2,2
18110,40,1824,4775,0,0,0,0,1,1
18111,40,1825,4776;9470,0,0,0,0,2,2
18112,40,1827,4780;7651,0,0,0,0,2,2
18113,40,1832,7071,0,0,0,0,1,1
18114,40,1833,732,0,0,0,0,1,1
18115,40,1834,4788,0,0,0,0,1,1
18116,40,1835,4789,0,0,0,0,1,1
18117,40,1840,4808,0,0,0,0,1,1
18118,40,1842,4812,0,0,0,0,1,1
18119,40,1848,4824,0,0,0,0,1,1
18120,40,1851,4830,0,0,0,0,1,1
18121,40,1852,4834,0,0,0,0,1,1
18122,40,1856,4844,0,0,0,0,1,1
18123,40,1858,4849,0,0,0,0,1,1
18124,40,1859,4853;11978,0,0,0,2,0,2
18125,40,1860,4858;9544,0,0,0,0,2,2
18126,40,1862,4870,0,0,0,0,1,1
18127,40,1865,1295;4878,0,0,0,0,2,2
18128,40,1866,4879,0,0,0,1,0,1
18129,40,1869,4891,0,0,0,0,1,1
18130,40,1872,4899;4900,0,0,0,1,1,2
18131,40,1875,4416;4905,0,0,0,0,2,2
18132,40,1877,3553;8851,0,0,0,0,2,2
18133,40,1878,4910,0,0,0,0,1,1
18134,40,1882,4922;5177,0,0,0,0,2,2
18135,40,1886,4934,0,0,0,0,1,1
18136,40,1887,4936,0,0,0,0,1,1
18137,40,1889,4945;14670,0,1,0,1,0,2
18138,40,1890,4948,0,0,0,0,1,1
18139,40,1891,4951,0,0,0,0,1,1
18140,40,1896,4970,0,0,0,0,1,1
18141,40,1898,4975,0,0,0,1,0,1
18142,40,1899,4977,0,0,0,0,1,1
18143,40,1901,4983;6434,0,0,0,1,1,2
18144,40,1903,6759,0,0,0,0,1,1
18145,40,1904,4986,0,0,0,0,1,1
18146,40,1906,4991;4992,0,0,0,0,2,2
18147,40,1908,4996,0,0,0,0,1,1
18148,40,1909,308,0,0,0,0,1,1
18149,40,1915,4165;5016;13203;14036,0,0,2,2,0,4
18150,40,1919,797;6181;10493;11494,0,0,0,2,2,4
18151,40,1922,5034,0,0,0,1,0,1
18152,40,1923,5036;8071;11278,0,0,0,1,2,3
18153,40,1926,5041,0,0,0,0,1,1
18154,40,1927,7278,0,0,0,0,1,1
18155,40,1935,5067;5068,0,0,0,1,1,2
18156,40,1937,5074,0,0,0,0,1,1
18157,40,1938,5076,0,0,0,0,1,1
18158,40,1942,191;5083,0,0,0,0,2,2
18159,40,1944,5091,0,0,0,0,1,1
18160,40,1945,5093;6283,0,0,0,0,2,2
18161,40,1946,5095,0,0,0,0,1,1
18162,40,1947,5099,0,0,0,0,1,1
18163,40,1948,5102;10965,0,0,0,2,0,2
18164,40,1960,5289,0,0,0,0,1,1
18165,40,1961,5127,0,0,0,0,1,1
18166,40,1962,5129,0,0,0,0,1,1
18167,40,1970,5150,0,0,0,0,1,1
18168,40,1972,4470;5156;14024;14428,0,0,2,2,0,4
18169,40,1974,5162;5163,0,0,0,0,2,2
18170,40,1975,8702,0,0,0,0,1,1
18171,40,1978,5172,0,0,0,0,1,1
18172,40,1980,699;5179,0,0,0,0,2,2
18173,40,1983,5185;8159;10941,0,0,0,1,2,3
18174,40,1984,5189,0,0,0,0,1,1
18175,40,1985,5194,0,0,0,0,1,1
18176,40,1986,1042;10984;11789,0,0,0,3,0,3
18177,40,1987,5197,0,0,0,0,1,1
18178,40,1991,5207;8430,0,0,0,0,2,2
18179,40,1992,5211,0,0,0,0,1,1
18180,40,1993,5213;5215,0,0,0,0,2,2
18181,40,1998,5227,0,0,0,0,1,1
18182,40,2001,5237,0,0,0,0,1,1
18183,40,2005,5247;5249,0,0,0,1,1,2
18184,40,2006,5251,0,0,0,0,1,1
18185,40,2014,5269,0,0,0,0,1,1
18186,40,2017,10754,0,0,0,1,0,1
18187,40,2018,5274;5478;10346,0,0,0,1,2,3
18188,40,2019,5276,0,0,0,0,1,1
18189,40,2022,5284,0,0,0,0,1,1
18190,40,2024,5291,0,0,0,0,1,1
18191,40,2025,2622;5293,0,0,0,1,1,2
18192,40,2028,5299,0,0,0,0,1,1
18193,40,2031,2455;5309;5311,0,0,0,3,0,3
18194,40,2032,5313;6862,0,0,0,0,2,2
18195,40,2033,5315;8171;11447,0,0,0,3,0,3
18196,40,2034,5318;5741,0,0,0,2,0,2
18197,40,2036,368;5321,0,0,0,0,2,2
18198,40,2041,5332;5626,0,0,0,0,2,2
18199,40,2045,5338;10023,0,0,0,1,1,2
18200,40,2046,5339,0,0,0,0,1,1
18201,40,2050,3785;5346,0,0,0,0,2,2
18202,40,2054,5356,0,0,0,0,1,1
18203,40,2057,1904;5363;11824,0,0,0,2,1,3
18204,40,2058,5574,0,0,0,0,1,1
18205,40,2060,5374,0,0,0,0,1,1
18206,40,2063,5383,0,0,0,0,1,1
18207,40,2064,5385,0,0,0,0,1,1
18208,40,2065,3254,0,0,0,0,1,1
18209,40,2066,5392;8731;10507,0,0,0,2,1,3
18210,40,2067,4675;5393,0,0,0,2,0,2
18211,40,2068,7143;11668;13011,0,0,1,2,0,3
18212,40,2071,4333;7797,0,0,0,0,2,2
18213,40,2073,5407,0,0,0,0,1,1
18214,40,2075,5415,0,0,0,0,1,1
18215,40,2076,5416,0,0,0,0,1,1
18216,40,2078,4031;4917,0,0,0,1,1,2
18217,40,2079,5423;5424,0,0,0,0,2,2
18218,40,2080,4927;5427,0,0,0,2,0,2
18219,40,2083,5435;9463,0,0,0,0,2,2
18220,40,2088,6647,0,0,0,0,1,1
18221,40,2089,5454,0,0,0,0,1,1
18222,40,2090,5456;5460,0,0,0,1,1,2
18223,40,2093,5463;8611,0,0,0,0,2,2
18224,40,2094,820;5465,0,0,0,0,2,2
18225,40,2096,3022;5468;10859,0,0,0,1,2,3
18226,40,2098,5473,0,0,0,0,1,1
18227,40,2100,5475,0,0,0,0,1,1
18228,40,2103,2487;5484,0,0,0,0,2,2
18229,40,2105,5488,0,0,0,0,1,1
18230,40,2106,5491,0,0,0,0,1,1
18231,40,2111,5504;6493,0,0,0,2,0,2
18232,40,2112,5505,0,0,0,0,1,1
18233,40,2117,5515,0,0,0,0,1,1
18234,40,2118,9393;11819;12621,0,0,0,3,0,3
18235,40,2120,5524,0,0,0,0,1,1
18236,40,2122,5528;8011,0,0,0,0,2,2
18237,40,2123,4866,0,0,0,0,1,1
18238,40,2125,1594;5532,0,0,0,0,2,2
18239,40,2132,5549,0,0,0,0,1,1
18240,40,2142,5578;5757;11624,0,0,0,3,0,3
18241,40,2148,7684,0,0,0,0,1,1
18242,40,2150,5592,0,0,0,0,1,1
18243,40,2152,5595;5596,0,0,0,0,2,2
18244,40,2154,5601,0,0,0,0,1,1
18245,40,2155,9948,0,0,0,0,1,1
18246,40,2159,1246,0,0,0,1,0,1
18247,40,2162,7598,0,0,0,0,1,1
18248,40,2168,5634,0,0,0,0,1,1
18249,40,2170,5640;5641,0,0,0,0,2,2
18250,40,2173,5649,0,0,0,1,0,1
18251,40,2174,5651,0,0,0,0,1,1
18252,40,2178,5660,0,0,0,0,1,1
18253,40,2179,5503,0,0,0,0,1,1
18254,40,2181,5667,0,0,0,0,1,1
18255,40,2186,5676;6141,0,0,0,0,2,2
18256,40,2194,5694;5695,0,0,0,0,2,2
18257,40,2195,5697,0,0,0,0,1,1
18258,40,2196,3603;5702,0,0,0,0,2,2
18259,40,2198,5707;5708,0,0,0,0,2,2
18260,40,2199,5711,0,0,0,0,1,1
18261,40,2202,1981;5717,0,0,0,0,2,2
18262,40,2208,5730,0,0,0,0,1,1
18263,40,2209,4762,0,0,0,0,1,1
18264,40,2210,5734,0,0,0,0,1,1
18265,40,2212,3151;5745;5749,0,0,0,2,1,3
18266,40,2215,9093,0,0,0,0,1,1
18267,40,2217,7966,0,0,0,0,1,1
18268,40,2226,5787,0,0,0,1,0,1
18269,40,2228,6439,0,0,0,0,1,1
18270,40,2229,5795,0,0,0,0,1,1
18271,40,2230,5796,0,0,0,0,1,1
18272,40,2235,7005,0,0,0,0,1,1
18273,40,2237,3391,0,0,0,0,1,1
18274,40,2243,1831;5822,0,0,0,0,2,2
18275,40,2244,5823,0,0,0,0,1,1
18276,40,2248,5833,0,0,0,0,1,1
18277,40,2249,5835,0,0,0,0,1,1
18278,40,2252,1894;5840;11619,0,0,0,1,2,3
18279,40,2255,5845,0,0,0,0,1,1
18280,40,2263,5865,0,0,0,0,1,1
18281,40,2264,4810;5868;10784;11294,0,0,0,4,0,4
18282,40,2265,5872,0,0,0,0,1,1
18283,40,2267,5877;6063,0,0,0,0,2,2
18284,40,2271,8230,0,0,0,0,1,1
18285,40,2274,5887;5889,0,0,0,1,1,2
18286,40,2275,5891;8181,0,0,0,0,2,2
18287,40,2278,4011;5897,0,0,0,0,2,2
18288,40,2279,5280,0,0,0,0,1,1
18289,40,2282,8684,0,0,0,0,1,1
18290,40,2283,5910,0,0,0,0,1,1
18291,40,2285,5916,0,0,0,0,1,1
18292,40,2286,4528;5918;11682,0,0,0,3,0,3
18293,40,2289,5923;6710,0,0,0,0,2,2
18294,40,2290,5913;5925;10772,0,0,0,1,2,3
18295,40,2291,3592;5929;5930;13733;14022,0,0,2,3,0,5
18296,40,2294,5935,0,0,0,0,1,1
18297,40,2301,2278;5951,0,0,0,0,2,2
18298,40,2302,5633,0,0,0,0,1,1
18299,40,2303,5957,0,0,0,0,1,1
18300,40,2305,28,0,0,0,0,1,1
18301,40,2306,5965,0,0,0,0,1,1
18302,40,2311,5979;5980,0,0,0,0,2,2
18303,40,2312,5983,0,0,0,0,1,1
18304,40,2314,5989;10743,0,0,0,2,0,2
18305,40,2317,10070;10315;13412;14452,0,0,2,2,0,4
18306,40,2319,6006;7676,0,0,0,0,2,2
18307,40,2320,4428,0,0,0,0,1,1
18308,40,2321,2252;6008,0,0,0,0,2,2
18309,40,2324,6014,0,0,0,0,1,1
18310,40,2333,2953;6038,0,0,0,0,2,2
18311,40,2334,2932;6039,0,0,0,0,2,2
18312,40,2335,40;6041,0,0,0,0,2,2
18313,40,2336,6043;6044,0,0,0,1,1,2
18314,40,2338,4215,0,0,0,0,1,1
18315,40,2341,6049;6050,0,0,0,0,2,2
18316,40,2342,5557;6052;7453,0,0,0,1,2,3
18317,40,2343,1537;6056;11984;14216,0,0,1,3,0,4
18318,40,2349,6065;8838,0,0,0,0,2,2
18319,40,2350,3180;6069,0,0,0,0,2,2
18320,40,2353,6077;9250,0,0,0,0,2,2
18321,40,2358,3280;6091,0,0,0,0,2,2
18322,40,2361,6095,0,0,0,0,1,1
18323,40,2366,1515;7964;12161,0,0,0,3,0,3
18324,40,2367,6113;7312,0,0,0,0,2,2
18325,40,2368,6115,0,0,0,0,1,1
18326,40,2373,282,0,0,0,0,1,1
18327,40,2375,7973,0,0,0,0,1,1
18328,40,2381,6239;12002;12442,0,0,0,3,0,3
18329,40,2383,6149,0,0,0,0,1,1
18330,40,2384,6150;11642,0,0,0,2,0,2
18331,40,2387,6160;6161,0,0,0,0,2,2
18332,40,2389,2559;6166;11972,0,0,0,3,0,3
18333,40,2390,6168,0,0,0,0,1,1
18334,40,2392,330;6174,0,0,0,2,0,2
18335,40,2395,6180,0,0,0,0,1,1
18336,40,2398,6190,0,0,0,0,1,1
18337,40,2399,6394;11804,0,0,0,1,1,2
18338,40,2401,9529,0,0,0,0,1,1
18339,40,2403,6204;8231,0,0,0,0,2,2
18340,40,2404,7288,0,0,0,0,1,1
18341,40,2405,266;6209,0,0,0,0,2,2
18342,40,2406,5461;6213,0,0,0,0,2,2
18343,40,2407,6214,0,0,0,0,1,1
18344,40,2408,6216,0,0,0,0,1,1
18345,40,2413,6229;8393,0,0,0,2,0,2
18346,40,2414,6233,0,0,0,1,0,1
18347,40,2418,7587;11158,0,0,0,1,1,2
18348,40,2427,6266;7188,0,0,0,0,2,2
18349,40,2430,6273;6274,0,0,0,0,2,2
18350,40,2431,3700;5603;6277;11605;12956,0,0,1,4,0,5
18351,40,2434,120;6290;13286;13409,0,0,2,2,0,4
18352,40,2436,4966,0,0,0,0,1,1
18353,40,2441,4916,0,0,0,0,1,1
18354,40,2444,6315,0,0,0,0,1,1
18355,40,2445,6317,0,0,0,0,1,1
18356,40,2446,6320;6321,0,0,0,0,2,2
18357,40,2449,6328,0,0,0,0,1,1
18358,40,2451,6333,0,0,0,0,1,1
18359,40,2453,6342,0,0,0,1,0,1
18360,40,2457,6351,0,0,0,0,1,1
18361,40,2460,6360,0,0,0,0,1,1
18362,40,2461,6362,0,0,0,0,1,1
18363,40,2463,6366;10964,0,0,0,2,0,2
18364,40,2468,6378;6379,0,0,0,1,1,2
18365,40,2469,9359,0,0,0,0,1,1
18366,40,2470,6381,0,0,0,0,1,1
18367,40,2471,6383,0,0,0,0,1,1
18368,40,2472,6384,0,0,0,0,1,1
18369,40,2479,5849;8099,0,0,0,2,0,2
18370,40,2485,6419,0,0,0,0,1,1
18371,40,2486,3212;6423,0,0,0,0,2,2
18372,40,2490,242;6431,0,0,0,0,2,2
18373,40,2491,6433,0,0,0,0,1,1
18374,40,2495,6067;6441,0,0,0,0,2,2
18375,40,2496,6446;8367,0,0,0,0,2,2
18376,40,2497,6448,0,0,0,0,1,1
18377,40,2499,6457,0,0,0,0,1,1
18378,40,2503,1026;6470;13102;13509,0,0,2,2,0,4
18379,40,2508,6477,0,0,0,0,1,1
18380,40,2509,8635,0,0,0,0,1,1
18381,40,2512,6485,0,0,0,0,1,1
18382,40,2513,6490,0,0,0,1,0,1
18383,40,2514,6492,0,0,0,0,1,1
18384,40,2518,6501,0,0,0,0,1,1
18385,40,2519,5438,0,0,0,1,0,1
18386,40,2520,6505;6599,0,0,0,0,2,2
18387,40,2521,4668;6506,0,0,0,1,1,2
18388,40,2527,6519;7638,0,0,0,0,2,2
18389,40,2528,6521,0,0,0,0,1,1
18390,40,2531,6532,0,0,0,0,1,1
18391,40,2534,6540,0,0,0,0,1,1
18392,40,2541,6563,0,0,0,0,1,1
18393,40,2542,2443;5906,0,0,0,0,2,2
18394,40,2543,6565,0,0,0,0,1,1
18395,40,2554,6585,0,0,0,0,1,1
18396,40,2555,6590;6591,0,0,0,0,2,2
18397,40,2563,6610;6611,0,0,0,0,2,2
18398,40,2565,6614;6746,0,0,0,0,2,2
18399,40,2569,3699;6628;12645;12909,0,0,1,3,0,4
18400,40,2574,7701,0,0,0,1,0,1
18401,40,2577,6650,0,0,0,0,1,1
18402,40,2579,6657,0,0,0,0,1,1
18403,40,2581,6663,0,0,0,0,1,1
18404,40,2583,6667;6668,0,0,0,0,2,2
18405,40,2584,6669,0,0,0,0,1,1
18406,40,2589,6680,0,0,0,0,1,1
18407,40,2590,3714,0,0,0,0,1,1
18408,40,2592,6686,0,0,0,0,1,1
18409,40,2595,324;6697;10336,0,0,0,1,2,3
18410,40,2596,765;6707,0,0,0,2,0,2
18411,40,2604,6730,0,0,0,0,1,1
18412,40,2606,6737,0,0,0,1,0,1
18413,40,2608,3083,0,0,0,0,1,1
18414,40,2611,6749,0,0,0,0,1,1
18415,40,2612,6752;6753,0,0,0,0,2,2
18416,40,2613,3563;6754,0,0,0,0,2,2
18417,40,2617,6762,0,0,0,0,1,1
18418,40,2618,2688,0,0,0,0,1,1
18419,40,2626,6788;8395,0,0,0,0,2,2
18420,40,2629,6795,0,0,0,0,1,1
18421,40,2631,6802;8269,0,0,0,2,0,2
18422,40,2637,6813,0,0,0,0,1,1
18423,40,2638,6816;11847;12333,0,0,0,3,0,3
18424,40,2643,10565;14767;15209,0,2,0,1,0,3
18425,40,2645,6832,0,0,0,0,1,1
18426,40,2646,6838,0,0,0,1,0,1
18427,40,2648,6848;6849;13052;13132;13579,0,0,3,2,0,5
18428,40,2651,9460,0,0,0,0,1,1
18429,40,2666,6896,0,0,0,0,1,1
18430,40,2670,8228,0,0,0,0,1,1
18431,40,2672,6907,0,0,0,0,1,1
18432,40,2673,6909,0,0,0,0,1,1
18433,40,2674,6913,0,0,0,0,1,1
18434,40,2675,1683;6915,0,0,0,0,2,2
18435,40,2676,6917,0,0,0,0,1,1
18436,40,2678,3260,0,0,0,0,1,1
18437,40,2680,6926,0,0,0,0,1,1
18438,40,2681,1541;6928,0,0,0,0,2,2
18439,40,2683,6931;6932,0,0,0,0,2,2
18440,40,2687,6943,0,0,0,0,1,1
18441,40,2690,6254;6952;10159,0,0,0,1,2,3
18442,40,2692,6958,0,0,0,0,1,1
18443,40,2693,4410,0,0,0,0,1,1
18444,40,2694,6961;9886,0,0,0,0,2,2
18445,40,2697,6965,0,0,0,0,1,1
18446,40,2698,834,0,0,0,0,1,1
18447,40,2699,6968;6969;10943,0,0,0,1,2,3
18448,40,2701,6976,0,0,0,0,1,1
18449,40,2702,6978,0,0,0,0,1,1
18450,40,2704,908;6985,0,0,0,2,0,2
18451,40,2705,6988;6990,0,0,0,1,1,2
18452,40,2709,7002,0,0,0,0,1,1
18453,40,2715,7018,0,0,0,0,1,1
18454,40,2717,4178;7026,0,0,0,0,2,2
18455,40,2718,7028,0,0,0,0,1,1
18456,40,2719,7036,0,0,0,1,0,1
18457,40,2722,7043;7044,0,0,0,1,1,2
18458,40,2723,6007;7045,0,0,0,0,2,2
18459,40,2725,7048;7836,0,0,0,2,0,2
18460,40,2730,7059,0,0,0,0,1,1
18461,40,2737,7082,0,0,0,0,1,1
18462,40,2739,7085,0,0,0,0,1,1
18463,40,2741,7089,0,0,0,0,1,1
18464,40,2742,7091,0,0,0,0,1,1
18465,40,2743,7092,0,0,0,0,1,1
18466,40,2744,7094;8357,0,0,0,1,1,2
18467,40,2745,7096;8120,0,0,0,0,2,2
18468,40,2746,2372;7101;12817;12946;13405;13907,0,0,4,2,0,6
18469,40,2748,1273,0,0,0,0,1,1
18470,40,2750,7112,0,0,0,0,1,1
18471,40,2751,7113,0,0,0,0,1,1
18472,40,2754,7122,0,0,0,0,1,1
18473,40,2758,7133,0,0,0,0,1,1
18474,40,2759,2913,0,0,0,0,1,1
18475,40,2761,7139,0,0,0,0,1,1
18476,40,2763,7147,0,0,0,0,1,1
18477,40,2764,7151;8592;13038;13984,0,0,2,2,0,4
18478,40,2765,7153,0,0,0,0,1,1
18479,40,2766,7157;7158,0,0,0,2,0,2
18480,40,2769,5333;7162,0,0,0,0,2,2
18481,40,2770,5582;10500,0,0,0,2,0,2
18482,40,2772,7167,0,0,0,0,1,1
18483,40,2776,7179,0,0,0,0,1,1
18484,40,2782,5123,0,0,0,0,1,1
18485,40,2785,7199,0,0,0,0,1,1
18486,40,2787,3502;7203;11649;11930;13206,0,0,1,4,0,5
18487,40,2791,5183;6648,0,0,0,0,2,2
18488,40,2792,7214,0,0,0,0,1,1
18489,40,2796,7225,0,0,0,0,1,1
18490,40,2797,7228;7734,0,0,0,2,0,2
18491,40,2799,6745,0,0,0,0,1,1
18492,40,2802,9495,0,0,0,0,1,1
18493,40,2803,7242,0,0,0,0,1,1
18494,40,2809,7252;7253;11586;12034,0,0,0,3,1,4
18495,40,2811,6622;7258,0,0,0,0,2,2
18496,40,2814,7263,0,0,0,0,1,1
18497,40,2815,7266,0,0,0,0,1,1
18498,40,2816,7268,0,0,0,0,1,1
18499,40,2817,2663;7269,0,0,0,0,2,2
18500,40,2819,7273;7274,0,0,0,0,2,2
18501,40,2820,6524;7277,0,0,0,1,1,2
18502,40,2821,7279,0,0,0,0,1,1
18503,40,2830,5037,0,0,0,0,1,1
18504,40,2836,1460;7318,0,0,0,0,2,2
18505,40,2838,7320,0,0,0,0,1,1
18506,40,2839,7325,0,0,0,1,0,1
18507,40,2851,7355;11840,0,0,0,2,0,2
18508,40,2853,7358,0,0,0,0,1,1
18509,40,2855,597,0,0,0,0,1,1
18510,40,2862,7380,0,0,0,0,1,1
18511,40,2863,5974;7384,0,0,0,1,1,2
18512,40,2864,7386,0,0,0,0,1,1
18513,40,2867,7395;14594,0,1,0,1,0,2
18514,40,2869,8828;8890,0,0,0,0,2,2
18515,40,2870,7400;7401,0,0,0,0,2,2
18516,40,2871,3450;7406;12010,0,0,0,3,0,3
18517,40,2874,7415,0,0,0,0,1,1
18518,40,2875,680,0,0,0,1,0,1
18519,40,2878,7427,0,0,0,0,1,1
18520,40,2879,1948;7429,0,0,0,1,1,2
18521,40,2882,7438,0,0,0,0,1,1
18522,40,2883,7442;7445,0,0,0,1,1,2
18523,40,2885,1622;3517;12743;12988,0,0,1,3,0,4
18524,40,2891,7459,0,0,0,0,1,1
18525,40,2893,7467,0,0,0,0,1,1
18526,40,2894,7468,0,0,0,0,1,1
18527,40,2895,2324;8772,0,0,0,0,2,2
18528,40,2896,5644;7472,0,0,0,0,2,2
18529,40,2900,7482;8537,0,0,0,0,2,2
18530,40,2903,7490,0,0,0,0,1,1
18531,40,2905,7672;8590;11545;12033;12520,0,0,0,5,0,5
18532,40,2907,7501,0,0,0,0,1,1
18533,40,2908,7504;7809,0,0,0,2,0,2
18534,40,2912,7514,0,0,0,0,1,1
18535,40,2915,2634;7526,0,0,0,0,2,2
18536,40,2916,7529,0,0,0,0,1,1
18537,40,2919,7539;9666;12202;12569,0,0,0,4,0,4
18538,40,2920,7540;8158,0,0,0,0,2,2
18539,40,2921,7541;9271,0,0,0,0,2,2
18540,40,2925,2855;7555;13913,0,0,1,2,0,3
18541,40,2926,7556,0,0,0,0,1,1
18542,40,2930,7566,0,0,0,0,1,1
18543,40,2933,7574,0,0,0,0,1,1
18544,40,2940,7589,0,0,0,0,1,1
18545,40,2941,7591,0,0,0,0,1,1
18546,40,2942,7596,0,0,0,1,0,1
18547,40,2944,5875;7599,0,0,0,0,2,2
18548,40,2947,7606;7607,0,0,0,0,2,2
18549,40,2950,1264;7613,0,0,0,0,2,2
18550,40,2952,7619;7622,0,0,0,1,1,2
18551,40,2960,6881,0,0,0,0,1,1
18552,40,2962,7646,0,0,0,0,1,1
18553,40,2965,2130;8609,0,0,0,0,2,2
18554,40,2966,7652,0,0,0,0,1,1
18555,40,2968,7660,0,0,0,0,1,1
18556,40,2969,7178;7664,0,0,0,0,2,2
18557,40,2975,7680,0,0,0,0,1,1
18558,40,2981,7695,0,0,0,0,1,1
18559,40,2982,7700;10916,0,0,0,1,1,2
18560,40,2985,7707;7708,0,0,0,0,2,2
18561,40,2986,4954;7711,0,0,0,2,0,2
18562,40,2990,7379,0,0,0,0,1,1
18563,40,2997,7737,0,0,0,0,1,1
18564,40,3000,4248;7745,0,0,0,0,2,2
18565,40,3002,7751,0,0,0,0,1,1
18566,40,3008,7760,0,0,0,0,1,1
18567,40,3011,7769,0,0,0,0,1,1
18568,40,3013,7771,0,0,0,0,1,1
18569,40,3014,7774,0,0,0,0,1,1
18570,40,3021,1166;7792,0,0,0,1,1,2
18571,40,3022,7793;10115;13230;13739;14224,0,0,3,2,0,5
18572,40,3025,6332;7798,0,0,0,0,2,2
18573,40,3026,7174,0,0,0,0,1,1
18574,40,3027,7805,0,0,0,0,1,1
18575,40,3028,4507;7807,0,0,0,0,2,2
18576,40,3031,7817,0,0,0,0,1,1
18577,40,3033,7823,0,0,0,0,1,1
18578,40,3041,2076;7847,0,0,0,0,2,2
18579,40,3045,7854;8753;11449,0,0,0,1,2,3
18580,40,3046,5527;7857,0,0,0,0,2,2
18581,40,3052,7875,0,0,0,0,1,1
18582,40,3053,2001,0,0,0,0,1,1
18583,40,3054,7878,0,0,0,0,1,1
18584,40,3055,7879,0,0,0,0,1,1
18585,40,3056,1334;3007;13200;13640;13691,0,0,3,2,0,5
18586,40,3060,7887,0,0,0,0,1,1
18587,40,3064,7901,0,0,0,0,1,1
18588,40,3065,3629;7903,0,0,0,0,2,2
18589,40,3067,7907,0,0,0,1,0,1
18590,40,3070,7075;7915,0,0,0,0,2,2
18591,40,3071,7916;8751,0,0,0,0,2,2
18592,40,3072,2017,0,0,0,0,1,1
18593,40,3075,4061;7928,0,0,0,2,0,2
18594,40,3081,5113;7946;7947;10013;13226;13768,0,0,2,4,0,6
18595,40,3082,7948;7949,0,0,0,1,1,2
18596,40,3083,7950;7951,0,0,0,0,2,2
18597,40,3095,7977,0,0,0,0,1,1
18598,40,3099,4395,0,0,0,1,0,1
18599,40,3100,7987;12171,0,0,0,2,0,2
18600,40,3101,7991,0,0,0,0,1,1
18601,40,3102,6326;7996;10799,0,0,0,1,2,3
18602,40,3107,8007;9143,0,0,0,0,2,2
18603,40,3109,8580;11994,0,0,0,1,1,2
18604,40,3112,8018;9295,0,0,0,2,0,2
18605,40,3114,8029,0,0,0,0,1,1
18606,40,3116,8040,0,0,0,1,0,1
18607,40,3120,8048,0,0,0,0,1,1
18608,40,3122,1105;8056,0,0,0,0,2,2
18609,40,3123,8058,0,0,0,0,1,1
18610,40,3126,4116;8064,0,0,0,0,2,2
18611,40,3130,8073,0,0,0,0,1,1
18612,40,3132,8076;13977;14434,0,0,2,1,0,3
18613,40,3137,8085;8086;10691;11155,0,0,0,3,1,4
18614,40,3142,8098,0,0,0,0,1,1
18615,40,3144,8103,0,0,0,0,1,1
18616,40,3145,5612;8104,0,0,0,0,2,2
18617,40,3147,8108;11796,0,0,0,1,1,2
18618,40,3148,8112,0,0,0,0,1,1
18619,40,3150,8118,0,0,0,0,1,1
18620,40,3151,2759;5653,0,0,0,0,2,2
18621,40,3153,8128,0,0,0,0,1,1
18622,40,3154,4134;8131,0,0,0,0,2,2
18623,40,3157,8138,0,0,0,0,1,1
18624,40,3158,2486;3668,0,0,0,0,2,2
18625,40,3159,8143;8146,0,0,0,1,1,2
18626,40,3160,3688;8147,0,0,0,0,2,2
18627,40,3163,1748;8156,0,0,0,0,2,2
18628,40,3165,8160,0,0,0,0,1,1
18629,40,3167,8162,0,0,0,0,1,1
18630,40,3168,8166;10133,0,0,0,1,1,2
18631,40,3172,8179,0,0,0,0,1,1
18632,40,3178,8193,0,0,0,0,1,1
18633,40,3179,8196,0,0,0,0,1,1
18634,40,3182,8203;9528,0,0,0,0,2,2
18635,40,3186,8210,0,0,0,0,1,1
18636,40,3189,2210;3718,0,0,0,2,0,2
18637,40,3192,8223,0,0,0,0,1,1
18638,40,3193,6588,0,0,0,0,1,1
18639,40,3194,8229,0,0,0,0,1,1
18640,40,3198,8236,0,0,0,0,1,1
18641,40,3199,8239;9412,0,0,0,0,2,2
18642,40,3201,8241,0,0,0,1,0,1
18643,40,3202,5285,0,0,0,0,1,1
18644,40,3204,1945;8245,0,0,0,0,2,2
18645,40,3205,8247;8248,0,0,0,0,2,2
18646,40,3206,8250;8251,0,0,0,0,2,2
18647,40,3212,8263;10021,0,0,0,1,1,2
18648,40,3214,7340,0,0,0,1,0,1
18649,40,3216,8275;8276,0,0,0,0,2,2
18650,40,3219,2212;5902,0,0,0,0,2,2
18651,40,3223,8298,0,0,0,0,1,1
18652,40,3227,8304;8305,0,0,0,0,2,2
18653,40,3232,8321,0,0,0,0,1,1
18654,40,3234,8327,0,0,0,0,1,1
18655,40,3236,7899;8334,0,0,0,2,0,2
18656,40,3237,2189,0,0,0,1,0,1
18657,40,3238,8340;9429;10452,0,0,0,1,2,3
18658,40,3240,8344,0,0,0,0,1,1
18659,40,3243,6535;8350;11430,0,0,0,2,1,3
18660,40,3248,8359,0,0,0,0,1,1
18661,40,3250,8366,0,0,0,0,1,1
18662,40,3251,4077,0,0,0,0,1,1
18663,40,3252,8371,0,0,0,0,1,1
18664,40,3256,2379,0,0,0,0,1,1
18665,40,3258,8387,0,0,0,0,1,1
18666,40,3259,8390,0,0,0,0,1,1
18667,40,3260,2825;11313;12307,0,0,0,3,0,3
18668,40,3261,858;2506,0,0,0,0,2,2
18669,40,3262,2687,0,0,0,0,1,1
18670,40,3264,8404,0,0,0,0,1,1
18671,40,3267,8414,0,0,0,0,1,1
18672,40,3268,8415;8416,0,0,0,0,2,2
18673,40,3270,8422,0,0,0,0,1,1
18674,40,3271,8427,0,0,0,0,1,1
18675,40,3274,95,0,0,0,0,1,1
18676,40,3275,8434,0,0,0,0,1,1
18677,40,3277,8438,0,0,0,0,1,1
18678,40,3279,8441;8442;8658,0,0,0,1,2,3
18679,40,3281,8448,0,0,0,0,1,1
18680,40,3282,7474;8450,0,0,0,0,2,2
18681,40,3283,8452,0,0,0,0,1,1
18682,40,3287,8462,0,0,0,0,1,1
18683,40,3288,8464,0,0,0,1,0,1
18684,40,3289,8467,0,0,0,0,1,1
18685,40,3291,8475,0,0,0,0,1,1
18686,40,3297,8496,0,0,0,0,1,1
18687,40,3298,8500,0,0,0,0,1,1
18688,40,3301,8506,0,0,0,0,1,1
18689,40,3303,8509,0,0,0,0,1,1
18690,40,3304,8511,0,0,0,0,1,1
18691,40,3305,6162,0,0,0,0,1,1
18692,40,3314,8533,0,0,0,0,1,1
18693,40,3316,8540;8542,0,0,0,1,1,2
18694,40,3318,8551,0,0,0,0,1,1
18695,40,3319,271;8554;11853,0,0,0,3,0,3
18696,40,3320,593,0,0,0,0,1,1
18697,40,3323,8564;8565,0,0,0,0,2,2
18698,40,3324,8569,0,0,0,0,1,1
18699,40,3332,449;8582,0,0,0,0,2,2
18700,40,3333,6048,0,0,0,0,1,1
18701,40,3335,8588,0,0,0,0,1,1
18702,40,3336,8593,0,0,0,0,1,1
18703,40,3338,8600,0,0,0,0,1,1
18704,40,3343,195;11580,0,0,0,2,0,2
18705,40,3344,8613,0,0,0,0,1,1
18706,40,3346,8621,0,0,0,0,1,1
18707,40,3347,8626,0,0,0,0,1,1
18708,40,3353,8645;8646,0,0,0,0,2,2
18709,40,3354,8647,0,0,0,0,1,1
18710,40,3356,8653,0,0,0,0,1,1
18711,40,3357,8655,0,0,0,0,1,1
18712,40,3362,8666,0,0,0,0,1,1
18713,40,3366,2875;8560;8674;8675;12702;13122;13331,0,0,2,5,0,7
18714,40,3373,8694,0,0,0,0,1,1
18715,40,3375,1808;10018;13658;13936,0,0,2,2,0,4
18716,40,3376,8563,0,0,0,0,1,1
18717,40,3379,8706,0,0,0,0,1,1
18718,40,3380,8708,0,0,0,0,1,1
18719,40,3384,8723;10150,0,0,0,1,1,2
18720,40,3385,7170;8724,0,0,0,0,2,2
18721,40,3386,1292,0,0,0,0,1,1
18722,40,3387,5224;8728,0,0,0,0,2,2
18723,40,3388,8729,0,0,0,0,1,1
18724,40,3390,8732,0,0,0,0,1,1
18725,40,3396,8749,0,0,0,0,1,1
18726,40,3397,8752,0,0,0,0,1,1
18727,40,3398,8755,0,0,0,1,0,1
18728,40,3400,8761;8762,0,0,0,0,2,2
18729,40,3401,8763;8764,0,0,0,0,2,2
18730,40,3404,8773;8774,0,0,0,0,2,2
18731,40,3407,6027;8783,0,0,0,0,2,2
18732,40,3415,8802,0,0,0,0,1,1
18733,40,3416,8804,0,0,0,1,0,1
18734,40,3420,2833;8819;8823;12014,0,0,0,3,1,4
18735,40,3421,8824;8825,0,0,0,1,1,2
18736,40,3422,8829,0,0,0,0,1,1
18737,40,3423,8833,0,0,0,0,1,1
18738,40,3424,8121;8834,0,0,0,0,2,2
18739,40,3426,8841,0,0,0,0,1,1
18740,40,3427,8844,0,0,0,0,1,1
18741,40,3431,8852,0,0,0,0,1,1
18742,40,3432,3222;5458;8857;8858;12248,0,0,0,5,0,5
18743,40,3433,8860,0,0,0,0,1,1
18744,40,3434,5884,0,0,0,0,1,1
18745,40,3435,3256;9267;12517;12838;13794,0,0,2,3,0,5
18746,40,3439,6215,0,0,0,0,1,1
18747,40,3442,8875;9792,0,0,0,0,2,2
18748,40,3446,8883,0,0,0,0,1,1
18749,40,3448,8891,0,0,0,0,1,1
18750,40,3449,5069;8895,0,0,0,1,1,2
18751,40,3450,8897,0,0,0,0,1,1
18752,40,3451,8901,0,0,0,0,1,1
18753,40,3453,8907,0,0,0,0,1,1
18754,40,3456,8915,0,0,0,0,1,1
18755,40,3458,8918,0,0,0,0,1,1
18756,40,3461,4190;8926,0,0,0,0,2,2
18757,40,3462,8929;8930,0,0,0,0,2,2
18758,40,3464,8937,0,0,0,0,1,1
18759,40,3465,8383;8938,0,0,0,0,2,2
18760,40,3467,8941;8942,0,0,0,0,2,2
18761,40,3469,4990;8949;13343;13868;15076,0,1,2,2,0,5
18762,40,3470,8952,0,0,0,0,1,1
18763,40,3472,8958,0,0,0,0,1,1
18764,40,3475,8341;8965;8967,0,0,0,1,2,3
18765,40,3476,8968;8969,0,0,0,0,2,2
18766,40,3477,8970,0,0,0,0,1,1
18767,40,3479,8100;8978;13755;13952,0,0,2,2,0,4
18768,40,3483,8988,0,0,0,0,1,1
18769,40,3485,6513;8991,0,0,0,0,2,2
18770,40,3487,8998;9728;12717;12810,0,0,1,3,0,4
18771,40,3488,9000,0,0,0,0,1,1
18772,40,3489,9002,0,0,0,0,1,1
18773,40,3491,9011,0,0,0,0,1,1
18774,40,3493,1980;9014,0,0,0,0,2,2
18775,40,3495,9019,0,0,0,0,1,1
18776,40,3496,9023,0,0,0,0,1,1
18777,40,3499,9028,0,0,0,0,1,1
18778,40,3500,9029,0,0,0,0,1,1
18779,40,3502,4485,0,0,0,0,1,1
18780,40,3503,9035,0,0,0,0,1,1
18781,40,3504,9038,0,0,0,0,1,1
18782,40,3507,1673;9050,0,0,0,0,2,2
18783,40,3509,9052,0,0,0,0,1,1
18784,40,3510,9055,0,0,0,0,1,1
18785,40,3514,9064,0,0,0,0,1,1
18786,40,3515,1850;9065,0,0,0,0,2,2
18787,40,3516,9067,0,0,0,0,1,1
18788,40,3517,423;9070,0,0,0,0,2,2
18789,40,3519,9076,0,0,0,1,0,1
18790,40,3520,9081,0,0,0,0,1,1
18791,40,3523,8114,0,0,0,0,1,1
18792,40,3529,9107,0,0,0,0,1,1
18793,40,3532,8022;9116,0,0,0,0,2,2
18794,40,3533,9120,0,0,0,0,1,1
18795,40,3536,9129,0,0,0,0,1,1
18796,40,3537,9131,0,0,0,0,1,1
18797,40,3539,4542;9138;12404;12984,0,0,1,3,0,4
18798,40,3540,9141,0,0,0,0,1,1
18799,40,3544,9147,0,0,0,0,1,1
18800,40,3547,9154,0,0,0,0,1,1
18801,40,3549,8238;9162;12445;12974;13282,0,0,2,3,0,5
18802,40,3554,9174,0,0,0,0,1,1
18803,40,3555,9176,0,0,0,0,1,1
18804,40,3556,9179,0,0,0,0,1,1
18805,40,3557,9180,0,0,0,0,1,1
18806,40,3560,1611;9185,0,0,0,0,2,2
18807,40,3566,9201,0,0,0,0,1,1
18808,40,3567,9202;9203,0,0,0,0,2,2
18809,40,3569,9206,0,0,0,0,1,1
18810,40,3570,9212,0,0,0,0,1,1
18811,40,3573,9227,0,0,0,1,0,1
18812,40,3578,1205;9241,0,0,0,0,2,2
18813,40,3579,6863;9242;11838,0,0,0,2,1,3
18814,40,3580,9243,0,0,0,0,1,1
18815,40,3587,9262,0,0,0,0,1,1
18816,40,3588,2328,0,0,0,0,1,1
18817,40,3589,7571,0,0,0,0,1,1
18818,40,3592,9274,0,0,0,0,1,1
18819,40,3598,9287,0,0,0,0,1,1
18820,40,3600,288,0,0,0,0,1,1
18821,40,3601,4405,0,0,0,0,1,1
18822,40,3605,193;9301;11249,0,0,0,3,0,3
18823,40,3606,9304,0,0,0,0,1,1
18824,40,3611,9312;9313,0,0,0,0,2,2
18825,40,3612,303,0,0,0,0,1,1
18826,40,3613,9319,0,0,0,0,1,1
18827,40,3619,9335,0,0,0,0,1,1
18828,40,3620,75;9340;11712,0,0,0,3,0,3
18829,40,3622,5954;9343,0,0,0,0,2,2
18830,40,3624,5233,0,0,0,0,1,1
18831,40,3625,9349,0,0,0,0,1,1
18832,40,3628,9360;9361,0,0,0,0,2,2
18833,40,3629,9365,0,0,0,1,0,1
18834,40,3630,9283,0,0,0,0,1,1
18835,40,3631,9372,0,0,0,0,1,1
18836,40,3634,1732;9378,0,0,0,1,1,2
18837,40,3637,9384,0,0,0,0,1,1
18838,40,3638,6226;9385,0,0,0,0,2,2
18839,40,3639,9386,0,0,0,0,1,1
18840,40,3640,9390;9391,0,0,0,1,1,2
18841,40,3643,4504;9399,0,0,0,0,2,2
18842,40,3645,9405,0,0,0,0,1,1
18843,40,3646,9407;10820,0,0,0,1,1,2
18844,40,3647,9409,0,0,0,0,1,1
18845,40,3648,9413;9414,0,0,0,0,2,2
18846,40,3649,8001;9416,0,0,0,0,2,2
18847,40,3650,1539;9422,0,0,0,0,2,2
18848,40,3651,9426,0,0,0,0,1,1
18849,40,3654,8026;12141,0,0,0,2,0,2
18850,40,3662,9453,0,0,0,0,1,1
18851,40,3667,9466,0,0,0,0,1,1
18852,40,3670,9474,0,0,0,0,1,1
18853,40,3671,9476,0,0,0,0,1,1
18854,40,3672,9477;11212,0,0,0,1,1,2
18855,40,3673,286;9479,0,0,0,0,2,2
18856,40,3674,9483,0,0,0,0,1,1
18857,40,3677,9493,0,0,0,0,1,1
18858,40,3679,9496,0,0,0,0,1,1
18859,40,3684,9507,0,0,0,1,0,1
18860,40,3685,9511,0,0,0,0,1,1
18861,40,3686,2464;9512,0,0,0,0,2,2
18862,40,3687,6208;9518;9519;12477;12617;14343,0,0,1,5,0,6
18863,40,3688,419;9521,0,0,0,0,2,2
18864,40,3690,244,0,0,0,0,1,1
18865,40,3693,9535,0,0,0,0,1,1
18866,40,3696,9541,0,0,0,0,1,1
18867,40,3698,9546,0,0,0,0,1,1
18868,40,3699,9548;9549,0,0,0,0,2,2
18869,40,3700,9550;9551,0,0,0,0,2,2
18870,40,3702,307;9554,0,0,0,0,2,2
18871,40,3703,9555,0,0,0,0,1,1
18872,40,3704,9560;9561;9939,0,0,0,1,2,3
18873,40,3706,9568,0,0,0,0,1,1
18874,40,3709,9577,0,0,0,0,1,1
18875,40,3710,988;9580;12893;13152,0,0,2,2,0,4
18876,40,3711,9581,0,0,0,0,1,1
18877,40,3713,9587,0,0,0,1,0,1
18878,40,3716,2219;9597,0,0,0,0,2,2
18879,40,3719,9604;9605,0,0,0,0,2,2
18880,40,3723,9614,0,0,0,0,1,1
18881,40,3724,2407;9618,0,0,0,0,2,2
18882,40,3725,9436;9619,0,0,0,2,0,2
18883,40,3726,6618;9621;11231;11433;12804,0,0,1,4,0,5
18884,40,3728,9628,0,0,0,0,1,1
18885,40,3730,9632,0,0,0,0,1,1
18886,40,3732,9635;9636,0,0,0,0,2,2
18887,40,3734,9640,0,0,0,0,1,1
18888,40,3737,9646;9647,0,0,0,0,2,2
18889,40,3739,9653,0,0,0,0,1,1
18890,40,3740,9656;9657,0,0,0,0,2,2
18891,40,3743,9661,0,0,0,0,1,1
18892,40,3744,9663,0,0,0,0,1,1
18893,40,3747,9671,0,0,0,0,1,1
18894,40,3748,9673,0,0,0,0,1,1
18895,40,3749,9675,0,0,0,0,1,1
18896,40,3750,3201;9694;12343;13441,0,0,1,3,0,4
18897,40,3752,179;9688,0,0,0,2,0,2
18898,40,3756,9701,0,0,0,0,1,1
18899,40,3759,7615;9708,0,0,0,0,2,2
18900,40,3763,9718,0,0,0,0,1,1
18901,40,3765,9724,0,0,0,0,1,1
18902,40,3766,9730,0,0,0,0,1,1
18903,40,3769,3420;9736;15114,0,1,0,2,0,3
18904,40,3770,9738,0,0,0,0,1,1
18905,40,3771,5433;9742;12533;12941,0,0,1,3,0,4
18906,40,3772,9743,0,0,0,0,1,1
18907,40,3774,8984;11959,0,0,0,2,0,2
18908,40,3779,9440,0,0,0,0,1,1
18909,40,3780,9766,0,0,0,0,1,1
18910,40,3784,9713;9778;12013,0,0,0,2,1,3
18911,40,3786,9788,0,0,0,1,0,1
18912,40,3787,9789;9791,0,0,0,0,2,2
18913,40,3788,9793,0,0,0,0,1,1
18914,40,3792,9803;10512,0,0,0,1,1,2
18915,40,3793,9807,0,0,0,0,1,1
18916,40,3794,8934;9808;11836,0,0,0,3,0,3
18917,40,3797,7986;9815;12961,0,0,1,2,0,3
18918,40,3817,10983;11168,0,0,0,2,0,2
18919,40,3820,9876,0,0,0,0,1,1
18920,40,3822,213;5175;8270;9888;11865;12055;12648;12846;14021;14891,0,1,2,7,0,10
18921,40,3824,9893,0,0,0,0,1,1
18922,40,3827,5026;9900,0,0,0,0,2,2
18923,40,3828,6703,0,0,0,0,1,1
18924,40,3831,3548;9907,0,0,0,0,2,2
18925,40,3832,5226,0,0,0,0,1,1
18926,40,3833,9914;9915,0,0,0,1,1,2
18927,40,3838,9929,0,0,0,0,1,1
18928,40,3839,9931,0,0,0,1,0,1
18929,40,3841,782;9934;11300,0,0,0,1,2,3
18930,40,3844,9943,0,0,0,0,1,1
18931,40,3845,9949,0,0,0,0,1,1
18932,40,3849,9956;9957,0,0,0,0,2,2
18933,40,3850,6255,0,0,0,0,1,1
18934,40,3853,9964,0,0,0,0,1,1
18935,40,3859,9982,0,0,0,0,1,1
18936,40,3860,9983;9986;9987,0,0,0,3,0,3
18937,40,3862,9991,0,0,0,0,1,1
18938,40,3865,10002,0,0,0,0,1,1
18939,40,3866,22;11504,0,0,0,1,1,2
18940,40,3868,299;9944;10722,0,0,0,1,2,3
18941,40,3869,7669;7849,0,0,0,0,2,2
18942,40,3870,442,0,0,0,0,1,1
18943,40,3871,492,0,0,0,1,0,1
18944,40,3872,487;549,0,0,0,0,2,2
18945,40,3876,657;10001,0,0,0,0,2,2
18946,40,3877,979,0,0,0,0,1,1
18947,40,3879,1569,0,0,0,0,1,1
18948,40,3881,2380;3910,0,0,0,0,2,2
18949,40,3883,1989;7661,0,0,0,0,2,2
18950,40,3885,576;974,0,0,0,0,2,2
18951,40,3888,2288,0,0,0,0,1,1
18952,40,3890,9970,0,0,0,0,1,1
18953,40,3891,2527,0,0,0,0,1,1
18954,40,3892,6259,0,0,0,0,1,1
18955,40,3895,2717;7573,0,0,0,0,2,2
18956,40,3896,2771,0,0,0,0,1,1
18957,40,3899,3100;3625,0,0,0,0,2,2
18958,40,3901,1740,0,0,0,0,1,1
18959,40,3902,3291,0,0,0,1,0,1
18960,40,3904,3865;5508,0,0,0,2,0,2
18961,40,3905,3979;9480;12052,0,0,0,1,2,3
18962,40,3906,4111,0,0,0,0,1,1
18963,40,3909,4971,0,0,0,0,1,1
18964,40,3911,5110,0,0,0,0,1,1
18965,40,3912,4880;9919,0,0,0,0,2,2
18966,40,3913,2864;5058,0,0,0,2,0,2
18967,40,3914,4051;6074,0,0,0,2,0,2
18968,40,3916,5208;9878,0,0,0,2,0,2
18969,40,3917,2588,0,0,0,0,1,1
18970,40,3919,5411,0,0,0,0,1,1
18971,40,3920,5767,0,0,0,0,1,1
18972,40,3921,2316;8543,0,0,0,2,0,2
18973,40,3925,2438;8622,0,0,0,2,0,2
18974,40,3926,9060;9303,0,0,0,0,2,2
18975,40,3927,1030;6757;11045;12773,0,0,0,4,0,4
18976,40,3929,5777,0,0,0,0,1,1
18977,40,3930,7542;9977,0,0,0,0,2,2
18978,40,3933,5764;7843,0,0,0,0,2,2
18979,40,3935,7985,0,0,0,0,1,1
18980,40,3936,4740,0,0,0,0,1,1
18981,40,3938,7645;8221,0,0,0,0,2,2
18982,40,3939,202;9159,0,0,0,0,2,2
18983,40,3941,8489,0,0,0,0,1,1
18984,40,3944,7137;8999,0,0,0,0,2,2
18985,40,3945,1947,0,0,0,0,1,1
18986,40,3946,3922;4188;10120;12363,0,0,0,4,0,4
18987,40,3949,6311,0,0,0,1,0,1
18988,40,3950,964;9522,0,0,0,0,2,2
18989,40,3952,9828,0,0,0,0,1,1
18990,40,3953,9871,0,0,0,0,1,1
18991,40,3954,1561;9911,0,0,0,0,2,2
18992,40,3957,752;3061;12063,365,0,0,3,0,3
18993,40,3960,5699,365,0,0,0,1,1
18994,40,3962,728;1695;11112,365,0,0,2,1,3
18995,40,3964,954,365,0,0,0,1,1
18996,40,3965,1174;9331,365,0,0,0,2,2
18997,40,3966,7838,365,0,0,0,1,1
18998,40,3967,45;459;12879,365,0,1,2,0,3
18999,40,3969,3140;9281,365,0,0,2,0,2
19000,40,3970,5351,365,0,0,0,1,1
19001,40,3972,2171;5721,365,0,0,0,2,2
19002,40,3973,3092,365,0,0,0,1,1
19003,40,3974,9439,365,0,0,0,1,1
19004,40,3975,2723;11441,365,0,0,2,0,2
19005,40,3976,258,365,0,0,0,1,1
19006,40,3977,2804,365,0,0,1,0,1
19007,40,3978,2930;9990,365,0,0,2,0,2
19008,40,3979,2998,365,0,0,0,1,1
19009,40,3980,516;3066;11477,365,0,0,1,2,3
19010,40,3985,1368;3394,365,0,0,0,2,2
19011,40,3986,3396;8378;11299;12296,365,0,0,4,0,4
19012,40,3987,3432;4751;5766,365,0,0,3,0,3
19013,40,3988,3444;8946,365,0,0,0,2,2
19014,40,3989,3544;8024,365,0,0,0,2,2
19015,40,3991,916;3923,365,0,0,0,2,2
19016,40,3992,4560,365,0,0,0,1,1
19017,40,3995,259;1277,365,0,0,0,2,2
19018,40,3997,4968;6396,365,0,0,0,2,2
19019,40,3998,3833,365,0,0,1,0,1
19020,40,4000,4827;6246;12410;12745,365,0,0,4,0,4
19021,40,4003,681,365,0,0,0,1,1
19022,40,4004,11904;15181,365,1,0,1,0,2
19023,40,4006,4889;5900,365,0,0,2,0,2
19024,40,4008,6020,365,0,0,0,1,1
19025,40,4009,5014;6021;10976;11764,365,0,0,4,0,4
19026,40,4011,3133,365,0,0,1,0,1
19027,40,4014,828;6797,365,0,0,0,2,2
19028,40,4015,6799;8315,365,0,0,0,2,2
19029,40,4016,3062;5554;11632,365,0,0,3,0,3
19030,40,4017,3868;10480;11596,365,0,0,2,1,3
19031,40,4024,7858,365,0,0,0,1,1
19032,40,4027,7997;8696,365,0,0,1,1,2
19033,40,4028,3157;5878,365,0,0,0,2,2
19034,40,4029,8021,365,0,0,0,1,1
19035,40,4033,3632;6993,365,0,0,0,2,2
19036,40,4040,9428,365,0,0,0,1,1
19037,40,4041,3667;9432,365,0,0,0,2,2
19038,40,4042,9461;9829,365,0,0,0,2,2
19039,40,4046,8125,730,0,0,0,1,1
19040,40,4047,200,730,0,0,0,1,1
19041,40,4048,3255;6184,730,0,0,2,0,2
19042,40,4052,489;3429,730,0,0,2,0,2
19043,40,4053,2949,730,0,0,1,0,1
19044,40,4055,2980;5617,730,0,0,2,0,2
19045,40,4058,948;5619,730,0,0,2,0,2
19046,40,4059,951;3996,730,0,0,2,0,2
19047,40,4062,3560;12761;12980;13123,730,0,2,2,0,4
19048,40,4065,1745;11623;12631;12681,730,0,0,4,0,4
19049,40,4066,1783;4619;11178,730,0,0,1,2,3
19050,40,4067,1846;11637;12463,730,0,0,3,0,3
19051,40,4068,7066;7919,730,0,0,0,2,2
19052,40,4071,524;7261,730,0,0,0,2,2
19053,40,4072,2165;2403,730,0,0,0,2,2
19054,40,4076,917,730,0,0,0,1,1
19055,40,4086,2801;8992,730,0,0,0,2,2
19056,40,4089,3192,730,0,0,0,1,1
19057,40,4090,3257,730,0,0,0,1,1
19058,40,4093,3643;3815,730,0,0,0,2,2
19059,40,4094,3792;9696;11739;11923,730,0,0,4,0,4
19060,40,4098,2334;3984,730,0,0,0,2,2
19061,40,4099,4030;5216,730,0,0,2,0,2
19062,40,4103,4273,730,0,0,1,0,1
19063,40,4104,592;4287,730,0,0,0,2,2
19064,40,4105,4377;8830,730,0,0,1,1,2
19065,40,4106,4384;11842;12542,730,0,0,3,0,3
19066,40,4108,4659,730,0,0,0,1,1
19067,40,4109,4909;6856,730,0,0,2,0,2
19068,40,4112,5087,730,0,0,1,0,1
19069,40,4114,262;8083,730,0,0,2,0,2
19070,40,4116,7;6345,730,0,0,2,0,2
19071,40,4117,730;5542,730,0,0,0,2,2
19072,40,4118,5684;6696,730,0,0,2,0,2
19073,40,4122,2203;12039;12415,730,0,0,3,0,3
19074,40,4127,158;3795;10880,730,0,0,2,1,3
19075,40,4129,5571;6922,730,0,0,2,0,2
19076,40,4130,6936;7021,730,0,0,2,0,2
19077,40,4131,7074;8662,730,0,0,2,0,2
19078,40,4134,3305,730,0,0,0,1,1
19079,40,4137,5109,730,0,0,0,1,1
19080,40,4138,7592;9686;12173,730,0,0,3,0,3
19081,40,4140,7293;8757;12449;12871,730,0,1,3,0,4
19082,40,4141,5419;11297,730,0,0,2,0,2
19083,40,4143,8173,730,0,0,0,1,1
19084,40,4144,4482;8277,730,0,0,2,0,2
19085,40,4145,8322;9105;11287;11617,730,0,0,4,0,4
19086,40,4148,8392,730,0,0,0,1,1
19087,40,4153,8957,730,0,0,0,1,1
19088,40,4156,1209,730,0,0,0,1,1
19089,40,4157,9186,730,0,0,0,1,1
19090,40,4158,1074;4218,730,0,0,2,0,2
19091,40,4159,3750;5972,730,0,0,1,1,2
19092,40,4160,9490,730,0,0,0,1,1
19093,40,4161,6679,730,0,0,0,1,1
19094,40,4164,5819,730,0,0,0,1,1
19095,40,4165,1447;9762,730,0,0,2,0,2
19096,40,4170,9857,730,0,0,0,1,1
19097,40,4171,3419;4284;10887;12334,1095,0,0,4,0,4
19098,40,4172,38;12386,1095,0,0,2,0,2
19099,40,4173,413;5748;11733,1095,0,0,3,0,3
19100,40,4174,3103;3116;12216,1095,0,0,3,0,3
19101,40,4178,2297,1095,0,0,0,1,1
19102,40,4179,1212;5939;12028;12497,1095,0,0,4,0,4
19103,40,4180,2179;5810;12069,1095,0,0,3,0,3
19104,40,4181,655;9895,1095,0,0,0,2,2
19105,40,4183,467;685;12708,1095,0,0,3,0,3
19106,40,4185,6550,1095,0,0,0,1,1
19107,40,4187,7035;12163,1095,0,0,2,0,2
19108,40,4190,2133,1095,0,0,0,1,1
19109,40,4192,9721,1095,0,0,1,0,1
19110,40,4194,1458;12765,1095,0,0,2,0,2
19111,40,4195,1790,1095,0,0,0,1,1
19112,40,4196,1563,1095,0,0,0,1,1
19113,40,4197,1655;6761,1095,0,0,2,0,2
19114,40,4199,1974,1095,0,0,1,0,1
19115,40,4202,4015;9008;12154;12616,1095,0,0,4,0,4
19116,40,4205,4170;6110;12252,1095,0,0,3,0,3
19117,40,4206,1603;4925,1095,0,0,2,0,2
19118,40,4209,9622,1095,0,0,0,1,1
19119,40,4211,2986;3235,1095,0,0,0,2,2
19120,40,4212,3850;7998,1095,0,0,2,0,2
19121,40,4213,3471;5679,1095,0,0,2,0,2
19122,40,4216,7079,1095,0,0,0,1,1
19123,40,4217,4001;10663;10959,1095,0,0,3,0,3
19124,40,4218,4002;5070,1095,0,0,1,1,2
19125,40,4221,3549,1095,0,0,0,1,1
19126,40,4223,4490,1095,0,0,0,1,1
19127,40,4225,62;4559;12816,1095,0,1,2,0,3
19128,40,4226,3072;4797,1095,0,0,0,2,2
19129,40,4230,4577;5982;11717;11885,1095,0,0,4,0,4
19130,40,4234,3759;5379,1095,0,0,2,0,2
19131,40,4236,5430;5755,1095,0,0,0,2,2
19132,40,4237,1424;5769;10822,1095,0,0,1,2,3
19133,40,4238,5816,1095,0,0,0,1,1
19134,40,4239,5547;5928,1095,0,0,2,0,2
19135,40,4245,4148;6334,1095,0,0,2,0,2
19136,40,4248,6837;10874;10994,1095,0,0,3,0,3
19137,40,4249,2556;6914;11579,1095,0,0,3,0,3
19138,40,4250,5489,1095,0,0,1,0,1
19139,40,4252,5871;7294,1095,0,0,2,0,2
19140,40,4253,7317,1095,0,0,0,1,1
19141,40,4254,926;7321,1095,0,0,0,2,2
19142,40,4255,7363;9298,1095,0,0,0,2,2
19143,40,4257,3675;7372;12797;13027,1095,0,1,3,0,4
19144,40,4259,2612;7426,1095,0,0,0,2,2
19145,40,4260,6306;7516,1095,0,0,0,2,2
19146,40,4261,5490;7585,1095,0,0,2,0,2
19147,40,4262,1532,1095,0,0,0,1,1
19148,40,4263,7603;7722;11396,1095,0,0,3,0,3
19149,40,4264,6782;9526;11974;12689;13081,1095,0,1,4,0,5
19150,40,4265,5201;7893;11872,1095,0,0,3,0,3
19151,40,4266,3339;7844,1095,0,0,0,2,2
19152,40,4268,1238;6544;12385,1095,0,0,3,0,3
19153,40,4272,181;8455;11005;11415,1095,0,0,4,0,4
19154,40,4274,5343,1095,0,0,0,1,1
19155,40,4275,205;7138,1095,0,0,2,0,2
19156,40,4276,794;8859;12072,1095,0,0,3,0,3
19157,40,4278,2682;4533,1095,0,0,0,2,2
19158,40,4281,5366;9165,1095,0,0,2,0,2
19159,40,4282,4908;12471,1095,0,0,2,0,2
19160,40,4285,3289;5605,1095,0,0,2,0,2
19161,40,4286,9601,1095,0,0,0,1,1
19162,40,4287,5443;6910;12083;12281,1095,0,0,4,0,4
19163,40,4288,8175;9727;11886,1095,0,0,3,0,3
19164,40,4297,8925,1460,0,0,0,1,1
19165,40,4298,583;8790,1460,0,0,2,0,2
19166,40,4299,643;9898;11475,1460,0,0,3,0,3
19167,40,4300,3727;7286,1460,0,0,2,0,2
19168,40,4301,710,1460,0,0,0,1,1
19169,40,4302,4888;11222,1460,0,0,2,0,2
19170,40,4303,811;7604;11481,1460,0,0,3,0,3
19171,40,4304,871;11020;12427,1460,0,0,3,0,3
19172,40,4305,881,1460,0,0,0,1,1
19173,40,4306,895;5737,1460,0,0,2,0,2
19174,40,4307,977;4602,1460,0,0,0,2,2
19175,40,4308,999,1460,0,0,0,1,1
19176,40,4309,1059;1842,1460,0,0,2,0,2
19177,40,4311,4492,1460,0,0,0,1,1
19178,40,4312,1213;7825;12353,1460,0,0,3,0,3
19179,40,4314,973,1460,0,0,0,1,1
19180,40,4315,1333,1460,0,0,1,0,1
19181,40,4316,1499;5709;11993;12534,1460,0,0,4,0,4
19182,40,4317,371,1460,0,0,0,1,1
19183,40,4320,4756;12619,1460,0,0,2,0,2
19184,40,4322,2126;2281,1460,0,0,0,2,2
19185,40,4326,2724;3799,1460,0,0,0,2,2
19186,40,4327,106;2731,1460,0,0,0,2,2
19187,40,4328,1536;2834;12435;12540,1460,0,0,4,0,4
19188,40,4329,2843;4527,1460,0,0,2,0,2
19189,40,4330,2887;9786,1460,0,0,2,0,2
19190,40,4335,3621;9947;12169;12465,1460,0,0,4,0,4
19191,40,4337,2301;3709,1460,0,0,2,0,2
19192,40,4338,8456;8760,1460,0,0,2,0,2
19193,40,4340,5905;9562;12634,1460,0,0,3,0,3
19194,40,4341,3832;7485,1460,0,0,2,0,2
19195,40,4342,3946;7624,1460,0,0,0,2,2
19196,40,4345,2232;4169,1460,0,0,2,0,2
19197,40,4347,1250;4315;12720,1460,0,0,3,0,3
19198,40,4349,8135;11683;12819,1460,0,1,2,0,3
19199,40,4350,4707;11638,1460,0,0,2,0,2
19200,40,4352,8770,1460,0,0,0,1,1
19201,40,4353,1054;4920,1460,0,0,0,2,2
19202,40,4355,5017;11666,1460,0,0,2,0,2
19203,40,4359,4126,1460,0,0,0,1,1
19204,40,4360,5377;6586,1460,0,0,2,0,2
19205,40,4364,1978;5857;10585,1460,0,0,1,2,3
19206,40,4366,3184;5899,1460,0,0,2,0,2
19207,40,4369,4197,1460,0,0,1,0,1
19208,40,4370,1526;12599,1460,0,0,2,0,2
19209,40,4372,5114;12263,1460,0,0,2,0,2
19210,40,4375,7989;11422;11625;12241;12483,1460,0,0,5,0,5
19211,40,4376,6489;6728;12134;12271;13028,1460,0,1,4,0,5
19212,40,4378,2350;6819,1460,0,0,2,0,2
19213,40,4380,2394;3566,1460,0,0,2,0,2
19214,40,4381,6452;6986,1460,0,0,2,0,2
19215,40,4382,1718,1460,0,0,0,1,1
19216,40,4384,2427,1460,0,0,0,1,1
19217,40,4385,9424;11948;12030;12182;12287;12769;13155,1460,0,1,6,0,7
19218,40,4387,6133,1460,0,0,1,0,1
19219,40,4389,7517;8602,1460,0,0,0,2,2
19220,40,4390,7868;7925;12476,1460,0,0,3,0,3
19221,40,4391,6211,1460,0,0,1,0,1
19222,40,4392,2525;8070,1460,0,0,0,2,2
19223,40,4396,2722,1460,0,0,0,1,1
19224,40,4397,8284;8538,1460,0,0,2,0,2
19225,40,4402,1218;8488,1460,0,0,2,0,2
19226,40,4403,5328;7495;12707;13044,1460,0,1,3,0,4
19227,40,4404,9238;9930;10746;11483,1460,0,0,4,0,4
19228,40,4405,8568;8987,1460,0,0,2,0,2
19229,40,4408,6198;9299,1460,0,0,0,2,2
19230,40,4409,6318;9500;13072,1460,0,1,2,0,3
19231,40,4412,6413;9769;13037,1460,0,1,2,0,3
19232,40,4413,7419;9777,1460,0,0,2,0,2
19233,40,4414,2351;9809;10856;11799,1460,0,0,4,0,4
19234,40,4415,1741;3994;13036,1460,0,1,2,0,3
19235,40,4416,4873;9114;12795;13207,1460,0,1,3,0,4
19236,40,4417,71;4336,1825,0,0,2,0,2
19237,40,4418,199;8519;12907;13408,1825,0,2,2,0,4
19238,40,4419,201,1825,0,0,0,1,1
19239,40,4421,296;7076,1825,0,0,2,0,2
19240,40,4423,439;705;11613;11947;12411;13446,1825,0,1,5,0,6
19241,40,4424,636,1825,0,0,1,0,1
19242,40,4426,1352;6736;13078,1825,0,1,2,0,3
19243,40,4427,3572;7557,1825,0,0,0,2,2
19244,40,4430,642;1525;11369,1825,0,0,3,0,3
19245,40,4431,411;6655,1825,0,0,0,2,2
19246,40,4435,6196;9357,1825,0,0,2,0,2
19247,40,4437,3219;12441,1825,0,0,2,0,2
19248,40,4438,3165;4898,1825,0,0,2,0,2
19249,40,4440,3208;4022;12448;12590,1825,0,0,4,0,4
19250,40,4442,3648;7523,1825,0,0,0,2,2
19251,40,4443,6407,1825,0,0,1,0,1
19252,40,4444,3384,1825,0,0,0,1,1
19253,40,4445,1122;3193;12412,1825,0,0,3,0,3
19254,40,4446,8285;9419;11851;12328;13400;13616,1825,0,2,4,0,6
19255,40,4451,3595;9677;11487,1825,0,0,3,0,3
19256,40,4452,3934;5888;12081,1825,0,0,3,0,3
19257,40,4453,3961;4062,1825,0,0,2,0,2
19258,40,4454,1151;3962,1825,0,0,2,0,2
19259,40,4455,4046;11241,1825,0,0,2,0,2
19260,40,4457,1387;4586;13006,1825,0,1,2,0,3
19261,40,4460,4474;8718,1825,0,0,2,0,2
19262,40,4461,4487;8672,1825,0,0,2,0,2
19263,40,4462,4678;4838,1825,0,0,1,1,2
19264,40,4463,9089,1825,0,0,0,1,1
19265,40,4464,5160;7570;11710,1825,0,0,3,0,3
19266,40,4465,5566,1825,0,0,0,1,1
19267,40,4470,8552,1825,0,0,1,0,1
19268,40,4471,2285;5046;11296;11572,1825,0,0,4,0,4
19269,40,4472,5234;9830,1825,0,0,0,2,2
19270,40,4473,5235,1825,0,0,0,1,1
19271,40,4476,1417,1825,0,0,0,1,1
19272,40,4477,5546;11995,1825,0,0,2,0,2
19273,40,4483,4314;6022,1825,0,0,2,0,2
19274,40,4485,5811;9714;11549;12166;12646,1825,0,0,5,0,5
19275,40,4486,6313;8561;12873,1825,0,1,2,0,3
19276,40,4488,6456,1825,0,0,0,1,1
19277,40,4489,5703;6530;11755;12496,1825,0,0,4,0,4
19278,40,4490,356;12700,1825,0,0,2,0,2
19279,40,4491,6649;12108,1825,0,0,2,0,2
19280,40,4492,6070;12407;12886,1825,0,1,2,0,3
19281,40,4493,3539;11052;12242;12374,1825,0,0,4,0,4
19282,40,4494,6929,1825,0,0,0,1,1
19283,40,4495,7845,1825,0,0,0,1,1
19284,40,4496,7210,1825,0,0,0,1,1
19285,40,4498,7256;7508;11284,1825,0,0,3,0,3
19286,40,4501,7051;7382;12140,1825,0,0,3,0,3
19287,40,4503,773;9256,1825,0,0,2,0,2
19288,40,4505,2180;6582;10910;13041,1825,0,1,3,0,4
19289,40,4507,7721;9329,1825,0,0,0,2,2
19290,40,4508,5448;7815;11859,1825,0,0,3,0,3
19291,40,4510,7882;8985,1825,0,0,2,0,2
19292,40,4511,7933,1825,0,0,0,1,1
19293,40,4514,8082,1825,0,0,0,1,1
19294,40,4520,4103;8628;13252,1825,0,1,2,0,3
19295,40,4521,1343;9352;11084;13223,1825,0,1,3,0,4
19296,40,4522,3362;8176;11097,1825,0,0,3,0,3
19297,40,4523,2580;9225;12116;12345,1825,0,0,4,0,4
19298,40,4524,4522;9032;10852;10972,1825,0,0,4,0,4
19299,40,4525,1055;8168;11501;12742,1825,0,0,4,0,4
19300,40,4526,7601;9097;11954,1825,0,0,3,0,3
19301,40,4530,404;568;12854,1825,0,1,2,0,3
19302,40,4531,2156;9368;11157;11630,1825,0,0,4,0,4
19303,40,4533,3538;9648;11529;13173;13618,1825,0,2,3,0,5
19304,40,4534,2366;9817;12299,1825,0,0,3,0,3
19305,40,4536,1317;9963;12632,1825,0,0,3,0,3
19306,40,4538,110;4274;13390,2190,0,1,2,0,3
19307,40,4539,112;2881,2190,0,0,2,0,2
19308,40,4542,863;6330,2190,0,0,2,0,2
19309,40,4543,1009,2190,0,0,0,1,1
19310,40,4544,209;5210,2190,0,0,0,2,2
19311,40,4546,1367,2190,0,0,0,1,1
19312,40,4548,1556;4615,2190,0,0,0,2,2
19313,40,4551,1788;3004;11967;12912,2190,0,1,3,0,4
19314,40,4554,2141;5166,2190,0,0,2,0,2
19315,40,4555,8864;9882,2190,0,0,2,0,2
19316,40,4556,2480,2190,0,0,1,0,1
19317,40,4558,2621;9006;11907,2190,0,0,3,0,3
19318,40,4559,2655,2190,0,0,1,0,1
19319,40,4560,2670;7671;11706;12250;12393,2190,0,0,5,0,5
19320,40,4561,1363;2811;11779;11966,2190,0,0,4,0,4
19321,40,4562,2821;9464,2190,0,0,0,2,2
19322,40,4563,2865;3315,2190,0,0,2,0,2
19323,40,4566,5706;6281,2190,0,0,2,0,2
19324,40,4569,7343;8619,2190,0,0,2,0,2
19325,40,4570,3199,2190,0,0,0,1,1
19326,40,4571,9459,2190,0,0,0,1,1
19327,40,4572,3531;4654,2190,0,0,2,0,2
19328,40,4574,2433;12301;12865,2190,0,1,2,0,3
19329,40,4576,3768;9897;12293,2190,0,0,3,0,3
19330,40,4578,2295;3860,2190,0,0,2,0,2
19331,40,4579,3955;8124;11730;12793,2190,0,0,4,0,4
19332,40,4580,2490,2190,0,0,0,1,1
19333,40,4582,4073,2190,0,0,1,0,1
19334,40,4583,4475;8679;11414,2190,0,0,3,0,3
19335,40,4585,8388;9573;12273,2190,0,0,3,0,3
19336,40,4586,9831,2190,0,0,0,1,1
19337,40,4587,4813,2190,0,0,0,1,1
19338,40,4591,817;1415;11711;12115;12596,2190,0,0,4,1,5
19339,40,4593,1824;5606;11681;12966,2190,0,1,3,0,4
19340,40,4597,8349,2190,0,0,0,1,1
19341,40,4598,5963;6170,2190,0,0,2,0,2
19342,40,4599,3985,2190,0,0,1,0,1
19343,40,4600,6118;6503;12918,2190,0,1,2,0,3
19344,40,4601,1116;6347;12589,2190,0,0,3,0,3
19345,40,4605,6594,2190,0,0,0,1,1
19346,40,4606,4594;5432,2190,0,0,2,0,2
19347,40,4607,3164;6774;11990,2190,0,0,3,0,3
19348,40,4608,7001,2190,0,0,0,1,1
19349,40,4610,7102,2190,0,0,1,0,1
19350,40,4611,6191,2190,0,0,1,0,1
19351,40,4612,7331;9854,2190,0,0,2,0,2
19352,40,4613,7353;7691,2190,0,0,2,0,2
19353,40,4614,6193,2190,0,0,0,1,1
19354,40,4615,5518;7705,2190,0,0,2,0,2
19355,40,4619,4141;7874;11431,2190,0,0,3,0,3
19356,40,4621,8479;12105,2190,0,0,1,1,2
19357,40,4624,8318;12368,2190,0,0,2,0,2
19358,40,4627,779;8398,2190,0,0,0,2,2
19359,40,4629,5261;8798;11901,2190,0,0,3,0,3
19360,40,4632,7183,2190,0,0,0,1,1
19361,40,4633,9370,2190,0,0,1,0,1
19362,40,4634,9484;9926;12035,2190,0,0,3,0,3
19363,40,4637,9590,2190,0,0,0,1,1
19364,40,4639,537;8408;12418;14076,2190,0,1,3,0,4
19365,40,4640,2500;5869;12527;13269,2190,0,1,3,0,4
19366,40,4643,10;4053;12967;13617,2190,0,2,2,0,4
19367,40,4645,232,2555,0,0,0,1,1
19368,40,4646,2892;9449,2555,0,0,2,0,2
19369,40,4647,278;12499;12556,2555,0,0,3,0,3
19370,40,4649,350;8039;12913;13010,2555,0,2,2,0,4
19371,40,4650,355;4375,2555,0,0,2,0,2
19372,40,4653,9265,2555,0,0,1,0,1
19373,40,4654,1332;3338;12623,2555,0,0,3,0,3
19374,40,4655,4548;9358;12217;12444,2555,0,0,4,0,4
19375,40,4656,1372;5661;11864,2555,0,0,3,0,3
19376,40,4657,1399;5981,2555,0,0,2,0,2
19377,40,4658,6354;9224;11631;11905,2555,0,0,4,0,4
19378,40,4659,8331;12919,2555,0,1,1,0,2
19379,40,4660,1901;7657,2555,0,0,2,0,2
19380,40,4661,1653;1932;12498,2555,0,0,3,0,3
19381,40,4662,590;1935;12870,2555,0,1,2,0,3
19382,40,4664,1230;2289,2555,0,0,2,0,2
19383,40,4666,603;3678,2555,0,0,2,0,2
19384,40,4668,2605;8226,2555,0,0,2,0,2
19385,40,4670,2766;4979;11754,2555,0,0,3,0,3
19386,40,4671,2800;9501;12735,2555,0,0,3,0,3
19387,40,4672,2058;6971;12955;13519,2555,0,2,2,0,4
19388,40,4674,1207;3144;11813,2555,0,0,3,0,3
19389,40,4675,1494,2555,0,0,1,0,1
19390,40,4676,2385;3277;12559,2555,0,0,3,0,3
19391,40,4677,1505;3524,2555,0,0,2,0,2
19392,40,4678,3574;6102,2555,0,0,2,0,2
19393,40,4679,3703;6767,2555,0,0,2,0,2
19394,40,4681,3766;7342,2555,0,0,2,0,2
19395,40,4683,4101;7391;11445;11655,2555,0,0,4,0,4
19396,40,4684,4224;9996,2555,0,0,0,2,2
19397,40,4685,4239,2555,0,0,0,1,1
19398,40,4686,4258;7255,2555,0,0,2,0,2
19399,40,4688,714;4272;10853,2555,0,0,3,0,3
19400,40,4689,1692,2555,0,0,1,0,1
19401,40,4690,8583,2555,0,0,0,1,1
19402,40,4691,7058;11639,2555,0,0,2,0,2
19403,40,4692,8272;9588;12524,2555,0,0,3,0,3
19404,40,4697,8618,2555,0,0,1,0,1
19405,40,4699,5167,2555,0,0,0,1,1
19406,40,4700,2067;8680;12289,2555,0,0,3,0,3
19407,40,4701,5327,2555,0,0,0,1,1
19408,40,4706,4978;5604;11383,2555,0,0,3,0,3
19409,40,4708,5691;6164,2555,0,0,2,0,2
19410,40,4709,5799;11496,2555,0,0,2,0,2
19411,40,4710,2692;5988;12833,2555,0,1,2,0,3
19412,40,4715,1910,2555,0,0,0,1,1
19413,40,4716,5330;6440,2555,0,0,2,0,2
19414,40,4718,272;6701;11608,2555,0,0,3,0,3
19415,40,4720,6769;9356;11176,2555,0,0,3,0,3
19416,40,4721,4198;6778,2555,0,0,0,2,2
19417,40,4723,6867;13094;13198,2555,0,2,1,0,3
19418,40,4724,6949;8822;12875;13430,2555,0,2,2,0,4
19419,40,4725,6951;8831;11634,2555,0,0,2,1,3
19420,40,4726,7078;8122;13047,2555,0,1,2,0,3
19421,40,4728,2022;7820,2555,0,0,0,2,2
19422,40,4729,3125;7569;13096,2555,0,1,2,0,3
19423,40,4730,4649;8516,2555,0,0,2,0,2
19424,40,4731,6037;6406;12450;13229,2555,0,1,3,0,4
19425,40,4733,8002;8006,2555,0,0,0,2,2
19426,40,4734,1801;3436;11758,2555,0,0,3,0,3
19427,40,4735,8087,2555,0,0,1,0,1
19428,40,4736,8157,2555,0,0,0,1,1
19429,40,4737,3218;8271,2555,0,0,2,0,2
19430,40,4738,986;8501,2555,0,0,2,0,2
19431,40,4739,8596,2555,0,0,1,0,1
19432,40,4740,7072;8740;13145,2555,0,1,2,0,3
19433,40,4746,3418;9214,2555,0,0,2,0,2
19434,40,4747,9328,2555,0,0,0,1,1
19435,40,4748,1612,2555,0,0,0,1,1
19436,40,4750,7341;9499;12722,2555,0,0,3,0,3
19437,40,4753,2628,2555,0,0,1,0,1
19438,40,4755,9883;11676,2555,0,0,2,0,2
19439,40,4757,1061;12159,2555,0,0,2,0,2
19440,40,4759,146;4129;12737;13577,2920,0,1,3,0,4
19441,40,4761,9145;9607;12539,2920,0,0,3,0,3
19442,40,4767,687,2920,0,0,0,1,1
19443,40,4770,864;1235;12991,2920,0,1,2,0,3
19444,40,4771,1016,2920,0,0,1,0,1
19445,40,4772,892;3406;12137,2920,0,0,3,0,3
19446,40,4774,1099;7992;12051;12818,2920,0,1,3,0,4
19447,40,4775,1634;2355;11951;12578,2920,0,0,4,0,4
19448,40,4776,1123;1648,2920,0,0,2,0,2
19449,40,4778,931;1882;12096,2920,0,0,3,0,3
19450,40,4779,1936;5013;12582,2920,0,0,3,0,3
19451,40,4780,933;11857;12253,2920,0,0,3,0,3
19452,40,4781,2169;8292;13074,2920,0,1,2,0,3
19453,40,4782,1925;8493;13131,2920,0,1,2,0,3
19454,40,4784,2840;8627;12003;12653;12862;12929,2920,0,2,4,0,6
19455,40,4785,2016;2861,2920,0,0,0,2,2
19456,40,4788,55;2960;12319,2920,0,0,3,0,3
19457,40,4789,3155;3704;12321,2920,0,0,3,0,3
19458,40,4791,2812,2920,0,0,1,0,1
19459,40,4792,3207;4713,2920,0,0,2,0,2
19460,40,4793,3374;7185;11922;12512;12906,2920,0,1,4,0,5
19461,40,4794,3449;5870;12782,2920,0,0,3,0,3
19462,40,4796,2817;4500,2920,0,0,2,0,2
19463,40,4797,3959;7682;11794,2920,0,0,3,0,3
19464,40,4798,3533;6375,2920,0,0,0,2,2
19465,40,4800,3626,2920,0,0,0,1,1
19466,40,4801,3695;9392;12251,2920,0,0,3,0,3
19467,40,4802,3812;7921,2920,0,0,2,0,2
19468,40,4803,8417;9797,2920,0,0,2,0,2
19469,40,4804,3849;3879;12245,2920,0,0,3,0,3
19470,40,4805,3940;7403,2920,0,0,2,0,2
19471,40,4806,1548;8425;12864,2920,0,1,2,0,3
19472,40,4807,4044;12925,2920,0,1,1,0,2
19473,40,4808,4411;11912;12234,2920,0,0,3,0,3
19474,40,4811,2359;4399,2920,0,0,2,0,2
19475,40,4813,3518;4949;11777;12771,2920,0,0,4,0,4
19476,40,4814,5086;6295;12097;12638,2920,0,0,4,0,4
19477,40,4816,4924;8019;13244,2920,0,1,2,0,3
19478,40,4817,4637;5378;12358,2920,0,0,3,0,3
19479,40,4821,2581;6770;12423;13095,2920,0,1,3,0,4
19480,40,4822,5864;7034;11741;12303;12485;12602;13352,2920,0,1,6,0,7
19481,40,4824,4582;11871;12473,2920,0,0,3,0,3
19482,40,4825,6284;9189;11902;12801;13108,2920,0,1,4,0,5
19483,40,4826,6454;8443;12043,2920,0,0,3,0,3
19484,40,4827,6464;8013;11870,2920,0,0,3,0,3
19485,40,4829,6688;6700;11873;12508,2920,0,0,4,0,4
19486,40,4830,4799;6718,2920,0,0,2,0,2
19487,40,4831,293;12006;12809,2920,0,1,2,0,3
19488,40,4833,3120;8177;12658,2920,0,0,3,0,3
19489,40,4836,6636;11555,2920,0,0,2,0,2
19490,40,4838,3641,2920,0,0,0,1,1
19491,40,4839,6604;11878;12261;13495,2920,0,1,3,0,4
19492,40,4841,2816;7889;13507,2920,0,1,2,0,3
19493,40,4844,7181;8167;12633,2920,0,0,3,0,3
19494,40,4845,8254,2920,0,0,0,1,1
19495,40,4846,6989;8807;12148;12821,2920,0,1,3,0,4
19496,40,4847,4854;8406,2920,0,0,2,0,2
19497,40,4851,6581;8169;12040,2920,0,0,3,0,3
19498,40,4854,2093;8997,2920,0,0,2,0,2
19499,40,4856,1647;9196;12044,2920,0,0,3,0,3
19500,40,4857,8123;9355;11964;12229;12272,2920,0,0,5,0,5
19501,40,4858,3895;7012;12567,2920,0,0,3,0,3
19502,40,4859,513;9664;11500;12220;12600,2920,0,0,5,0,5
19503,40,4860,6036;9681;12277,2920,0,0,3,0,3
19504,40,4861,620,2920,0,0,0,1,1
19505,40,4862,7378;9833,2920,0,0,0,2,2
19506,40,4863,848,2920,0,0,1,0,1
19507,40,4864,3011;6689;12835,2920,0,1,2,0,3
19508,40,4867,37;7398,3285,0,0,2,0,2
19509,40,4869,116;4373;12591,3285,0,0,3,0,3
19510,40,4870,1728,3285,0,0,0,1,1
19511,40,4871,2031;4628;11309,3285,0,0,3,0,3
19512,40,4872,188;8187,3285,0,0,2,0,2
19513,40,4873,6408;6820,3285,0,0,2,0,2
19514,40,4875,6629;11883;12934;13350,3285,0,2,2,0,4
19515,40,4876,536;4280,3285,0,0,2,0,2
19516,40,4878,6699;9280;12938;13946,3285,0,2,2,0,4
19517,40,4880,877;9879;12650;13615,3285,0,1,3,0,4
19518,40,4881,952;11744;12400;12964,3285,0,1,3,0,4
19519,40,4882,958;9799;12785,3285,0,0,3,0,3
19520,40,4883,3376;9816;11071;11446,3285,0,0,4,0,4
19521,40,4886,1658;7245,3285,0,0,0,2,2
19522,40,4890,4320,3285,0,0,0,1,1
19523,40,4891,4435;9649,3285,0,0,2,0,2
19524,40,4892,1977,3285,0,0,0,1,1
19525,40,4893,4109;9245;13040,3285,0,1,2,0,3
19526,40,4894,936,3285,0,0,1,0,1
19527,40,4896,3788,3285,0,0,0,1,1
19528,40,4898,1386;2417;12824;13204,3285,0,2,2,0,4
19529,40,4899,3698;5159;12656;13067;13610,3285,0,2,3,0,5
19530,40,4900,4553;8903;12478,3285,0,0,3,0,3
19531,40,4905,3276;6405;11815;12183;13568,3285,0,1,4,0,5
19532,40,4907,1304;8650;12262;13016;13348;13450,3285,0,3,3,0,6
19533,40,4909,3523;5949;13552,3285,0,1,2,0,3
19534,40,4910,6559,3285,0,0,1,0,1
19535,40,4913,3633;8214,3285,0,0,2,0,2
19536,40,4914,4401;7180;12698,3285,0,0,3,0,3
19537,40,4915,3672;6847;12394,3285,0,0,3,0,3
19538,40,4916,4576;12685,3285,0,0,2,0,2
19539,40,4918,3869;9188;12462,3285,0,0,3,0,3
19540,40,4919,3070;3968;11476;12110,3285,0,0,4,0,4
19541,40,4922,1318;11763,3285,0,0,2,0,2
19542,40,4923,4499;11609,3285,0,0,2,0,2
19543,40,4925,4721;11888;12226,3285,0,0,3,0,3
19544,40,4927,2217;4131,3285,0,0,0,2,2
19545,40,4931,5936;7728;12024;13288,3285,0,1,3,0,4
19546,40,4932,4517,3285,0,0,0,1,1
19547,40,4933,2383;5863,3285,0,0,2,0,2
19548,40,4934,5257;8595;11658,3285,0,0,3,0,3
19549,40,4935,3741;9768;12304;12637;13660,3285,0,1,4,0,5
19550,40,4937,6188;8928;11443;12958,3285,0,1,3,0,4
19551,40,4938,4514;6285;11770,3285,0,0,3,0,3
19552,40,4939,2080;6486,3285,0,0,0,2,2
19553,40,4941,4850;6727;12885,3285,0,1,2,0,3
19554,40,4944,6954;8808;12501;12703,3285,0,0,4,0,4
19555,40,4945,6792;6970;12198,3285,0,0,3,0,3
19556,40,4947,7192;13149,3285,0,1,1,0,2
19557,40,4949,2215;2395;12624;13264,3285,0,1,3,0,4
19558,40,4950,4293;11076,3285,0,0,2,0,2
19559,40,4951,3417;7461;12436;12994,3285,0,1,3,0,4
19560,40,4952,3575;7488;12032,3285,0,0,3,0,3
19561,40,4953,7752,3285,0,0,0,1,1
19562,40,4958,8319,3285,0,0,0,1,1
19563,40,4959,6542;8368,3285,0,0,0,2,2
19564,40,4960,5000;8466,3285,0,0,2,0,2
19565,40,4962,5021;9351;11592,3285,0,0,3,0,3
19566,40,4963,8911,3285,0,0,0,1,1
19567,40,4964,8623;11360,3285,0,0,2,0,2
19568,40,4965,2429,3285,0,0,0,1,1
19569,40,4966,7330;9017;11548;11661,3285,0,0,4,0,4
19570,40,4967,8748,3285,0,0,0,1,1
19571,40,4971,5675;8262,3285,0,0,0,2,2
19572,40,4972,6064;7025,3285,0,0,2,0,2
19573,40,4973,2654;9818;11425;12438;12669;12806;13110;13585,3285,0,3,5,0,8
19574,40,4975,9739,3285,0,0,1,0,1
19575,40,4977,153;7525;13175;13512;13942,3650,0,3,2,0,5
19576,40,4978,348;7068;13526,3650,0,1,2,0,3
19577,40,4979,360;3298,3650,0,0,2,0,2
19578,40,4980,336;4294,3650,0,0,0,2,2
19579,40,4981,1364;6494;12340;12790;13093;13281;13712,3650,0,3,4,0,7
19580,40,4982,2656;7746;11999;13201;14072,3650,0,2,3,0,5
19581,40,4983,1032,3650,0,0,1,0,1
19582,40,4984,1139;6878;13476,3650,0,1,2,0,3
19583,40,4986,1256,3650,0,0,0,1,1
19584,40,4987,3381;8110;12693;13504;13822,3650,0,2,3,0,5
19585,40,4989,1351;11856;12029;12550;12905,3650,0,1,4,0,5
19586,40,4990,1115;2799;12379,3650,0,0,3,0,3
19587,40,4994,1933;9651;12482;13222,3650,0,1,3,0,4
19588,40,4997,2362,3650,0,0,0,1,1
19589,40,4998,2384;9891;13820;14166;14730,3650,1,2,2,0,5
19590,40,4999,1217;2404;12417,3650,0,0,3,0,3
19591,40,5000,8361,3650,0,0,0,1,1
19592,40,5001,2593;6933;11696;12260,3650,0,0,4,0,4
19593,40,5002,810;3520,3650,0,0,2,0,2
19594,40,5003,7275;8912;12142;12349,3650,0,0,4,0,4
19595,40,5004,1141;1599;12753;13548,3650,0,1,3,0,4
19596,40,5006,3930;8826;12068,3650,0,0,3,0,3
19597,40,5007,3240,3650,0,0,1,0,1
19598,40,5008,333;6616;11931,3650,0,0,3,0,3
19599,40,5011,4308;4859;12509;13311,3650,0,1,3,0,4
19600,40,5012,393;1666;11876,3650,0,0,3,0,3
19601,40,5014,630;4581,3650,0,0,2,0,2
19602,40,5015,316;2669;11170;12395,3650,0,0,4,0,4
19603,40,5016,4823;8842,3650,0,0,0,2,2
19604,40,5017,4953;8796;12756,3650,0,0,3,0,3
19605,40,5019,955,3650,0,0,0,1,1
19606,40,5020,111;5195,3650,0,0,2,0,2
19607,40,5021,5572;8297;11557;12902,3650,0,1,3,0,4
19608,40,5023,6278;8589;11848,3650,0,0,3,0,3
19609,40,5024,6694;6750,3650,0,0,2,0,2
19610,40,5025,147;8306,3650,0,0,2,0,2
19611,40,5028,3492;5950;13062;13874,3650,0,2,2,0,4
19612,40,5029,6068;6846,3650,0,0,2,0,2
19613,40,5030,444;6773;13356;13481,3650,0,2,2,0,4
19614,40,5031,2629;6661;12227,3650,0,0,3,0,3
19615,40,5033,4095;7450,3650,0,0,0,2,2
19616,40,5036,9139;9423;11513;12869;13391,3650,0,2,3,0,5
19617,40,5038,6592;8005,3650,0,0,0,2,2
19618,40,5039,2475;8106;11737;12853;13652,3650,0,2,3,0,5
19619,40,5040,8719,3650,0,0,0,1,1
19620,40,5041,2033;8307;12431;12792,3650,0,0,4,0,4
19621,40,5042,8291;8473;11261;12391;12932;13021;13458,3650,0,3,4,0,7
19622,40,5044,8921;9634,3650,0,0,0,2,2
19623,40,5045,6982;8977;13007,3650,0,1,2,0,3
19624,40,5046,4045;8384;11783,3650,0,0,3,0,3
19625,40,5047,5964;12671;13160,3650,0,1,2,0,3
19626,40,5049,3;1485;11419,3650,0,0,3,0,3
19627,40,5051,706;9517,3650,0,0,2,0,2
19628,40,5052,3802;9637;12061;12458,3650,0,0,4,0,4
19629,40,5053,4187;9642,3650,0,0,2,0,2
19630,40,5054,7969;9782;12649;13425,3650,0,1,3,0,4
19631,40,5056,36;11435;12772,4015,0,0,3,0,3
19632,40,5058,49;5525;12922,4015,0,1,2,0,3
19633,40,5060,189;2959;12230,4015,0,0,3,0,3
19634,40,5061,239;13089;13218,4015,0,2,1,0,3
19635,40,5063,298,4015,0,0,0,1,1
19636,40,5067,43,4015,0,0,1,0,1
19637,40,5070,2008;3087;11257;11723;12732,4015,0,0,5,0,5
19638,40,5071,1593,4015,0,0,0,1,1
19639,40,5072,1608;7939;13105,4015,0,1,2,0,3
19640,40,5074,6531;12001;12640;13033,4015,0,1,3,0,4
19641,40,5075,2010;9285,4015,0,0,2,0,2
19642,40,5076,2273;5789;13124,4015,0,1,2,0,3
19643,40,5077,2291;9226;12495;13647,4015,0,1,3,0,4
19644,40,5079,2498;6879;12747;13153,4015,0,1,3,0,4
19645,40,5081,2972;5025;12811;13234;13365,4015,0,3,2,0,5
19646,40,5085,2244;3012,4015,0,0,2,0,2
19647,40,5086,3010;3027,4015,0,0,2,0,2
19648,40,5087,1746;2979;12826,4015,0,1,2,0,3
19649,40,5088,1979;3173;12419,4015,0,0,3,0,3
19650,40,5090,3335,4015,0,0,1,0,1
19651,40,5091,1987;3400;12571;13071,4015,0,1,3,0,4
19652,40,5092,8290;8567;11841;12050;12461,4015,0,0,5,0,5
19653,40,5093,3527;7699,4015,0,0,0,2,2
19654,40,5094,3636,4015,0,0,1,0,1
19655,40,5095,3673;12138,4015,0,0,2,0,2
19656,40,5098,3076;4186;12094,4015,0,0,2,1,3
19657,40,5099,4283;9985;11917;13100,4015,0,1,3,0,4
19658,40,5101,4486;6157;12492,4015,0,0,3,0,3
19659,40,5102,3872;4510;11589,4015,0,0,3,0,3
19660,40,5103,4607,4015,0,0,0,1,1
19661,40,5105,4874;8014,4015,0,0,2,0,2
19662,40,5106,985;1010;12114;12536,4015,0,0,4,0,4
19663,40,5107,5616,4015,0,0,1,0,1
19664,40,5108,4149;8498;13169,4015,0,1,2,0,3
19665,40,5111,1252;7238;12428;12748;13659,4015,0,1,4,0,5
19666,40,5112,5590;9485;12266;12635,4015,0,0,4,0,4
19667,40,5116,6240;8469;12694,4015,0,0,3,0,3
19668,40,5117,1751;5382;12080;12515;12741;12945;14204,4015,0,2,5,0,7
19669,40,5118,2265;8815;12194,4015,0,0,3,0,3
19670,40,5120,5723;13340;13645,4015,0,2,1,0,3
19671,40,5121,5722;6595;11908,4015,0,0,3,0,3
19672,40,5123,5537,4015,0,0,0,1,1
19673,40,5124,2175;6981;12760;13433,4015,0,1,3,0,4
19674,40,5125,1339;3960,4015,0,0,2,0,2
19675,40,5126,3215;7073;12557;12705,4015,0,0,4,0,4
19676,40,5127,7739;9045;11983,4015,0,0,3,0,3
19677,40,5129,3674;7494,4015,0,0,2,0,2
19678,40,5130,3986;11943;12662,4015,0,0,3,0,3
19679,40,5134,1770;9844;13019;13318,4015,0,2,2,0,4
19680,40,5137,8253;8756;12174;12308,4015,0,0,4,0,4
19681,40,5140,4655;8037;11760;12218;12384,4015,0,0,5,0,5
19682,40,5142,5063;7744;11818,4015,0,0,3,0,3
19683,40,5144,479;9220;12335;13831,4015,0,1,3,0,4
19684,40,5146,9118;9665;11635;13513,4015,0,1,3,0,4
19685,40,5147,3696;9687;12286,4015,0,0,3,0,3
19686,40,5149,3730;9756;11429;12749;13416,4015,0,1,4,0,5
19687,40,5153,74;1064;11868;12017;12664,4380,0,0,5,0,5
19688,40,5157,347;5353,4380,0,0,2,0,2
19689,40,5158,1637;4307;13178,4380,0,1,2,0,3
19690,40,5160,766,4380,0,0,0,1,1
19691,40,5161,3758;5002;12491,4380,0,0,3,0,3
19692,40,5163,2783,4380,0,0,1,0,1
19693,40,5165,891;1270;12711;12979,4380,0,1,3,0,4
19694,40,5166,221,4380,0,0,0,1,1
19695,40,5167,1328;8198;12791;12960;13720,4380,0,2,3,0,5
19696,40,5168,1136;2322;11604;12310;12474;12726,4380,0,0,6,0,6
19697,40,5173,1313;5692;12714;13292,4380,0,1,3,0,4
19698,40,5174,2083;9345,4380,0,0,0,2,2
19699,40,5175,584;2091;12291;13048,4380,0,1,3,0,4
19700,40,5177,2231;2693;11736;12422,4380,0,0,4,0,4
19701,40,5179,5970;13233,4380,0,1,1,0,2
19702,40,5183,2544;7024,4380,0,0,2,0,2
19703,40,5184,2798;9974;12581,4380,0,0,3,0,3
19704,40,5187,561;2787;12197,4380,0,0,3,0,3
19705,40,5188,2390;2807,4380,0,0,0,2,2
19706,40,5189,2891;13892;14254,4380,0,2,1,0,3
19707,40,5190,1192;13750,4380,0,1,1,0,2
19708,40,5191,2995;5072;12129;12369,4380,0,0,4,0,4
19709,40,5194,1001;3121,4380,0,0,2,0,2
19710,40,5196,96;3351,4380,0,0,2,0,2
19711,40,5197,3202;3468;12380,4380,0,0,3,0,3
19712,40,5198,2742;3493,4380,0,0,2,0,2
19713,40,5199,1698;8515;12610;13005;13375,4380,0,2,3,0,5
19714,40,5202,3856,4380,0,0,0,1,1
19715,40,5203,2239;6158;11695;11768,4380,0,0,4,0,4
19716,40,5204,7914;12574;13066,4380,0,1,2,0,3
19717,40,5206,9236,4380,0,0,0,1,1
19718,40,5207,1427;6453;12740;13381,4380,0,1,3,0,4
19719,40,5208,4855;8497;12575;12927,4380,0,1,3,0,4
19720,40,5211,4505;8853;12351,4380,0,0,3,0,3
19721,40,5213,1705;12850,4380,0,1,1,0,2
19722,40,5215,4816,4380,0,0,0,1,1
19723,40,5218,5212;9321,4380,0,0,1,1,2
19724,40,5219,1148,4380,0,0,1,0,1
19725,40,5220,7872;8899;12206;12999,4380,0,1,3,0,4
19726,40,5222,7681;8779;13241,4380,0,1,2,0,3
19727,40,5225,4267;7777;12642;13802,4380,0,1,3,0,4
19728,40,5226,7683,4380,0,0,1,0,1
19729,40,5230,6973;12521,4380,0,0,2,0,2
19730,40,5232,2880;7029;11745;12665,4380,0,0,4,0,4
19731,40,5233,3931;4263,4380,0,0,0,2,2
19732,40,5236,7306;8283;12716;13176,4380,0,1,3,0,4
19733,40,5238,2700;7357,4380,0,0,2,0,2
19734,40,5240,2108;7503;11998;12998,4380,0,1,3,0,4
19735,40,5242,7077;7679;11437;11839;12071;12475,4380,0,0,6,0,6
19736,40,5245,3402;7913;12468;13760,4380,0,1,3,0,4
19737,40,5246,2555;7995;11773;12113,4380,0,0,4,0,4
19738,40,5252,4449;8741;13858,4380,0,1,2,0,3
19739,40,5253,8780;8922;12031;12135;12456;12839;13186,4380,0,2,5,0,7
19740,40,5254,3710;8806;12947;13792,4380,0,2,2,0,4
19741,40,5257,1509;9040;12193,4380,0,0,3,0,3
19742,40,5259,9498,4380,0,0,0,1,1
19743,40,5260,2240;3951,4380,0,0,2,0,2
19744,40,5261,503;9589;12723;13510,4380,0,1,3,0,4
19745,40,5263,6948;7236,4380,0,0,2,0,2
19746,40,5265,4016;5451;12900,4745,0,1,2,0,3
19747,40,5266,25;9925,4745,0,0,0,2,2
19748,40,5267,107;4601;11843,4745,0,0,3,0,3
19749,40,5268,240;7776;12487;12855;13367,4745,0,2,3,0,5
19750,40,5274,786;6275;12736;13588,4745,0,1,3,0,4
19751,40,5277,1076,4745,0,0,0,1,1
19752,40,5279,1654;3028;12451;12805,4745,0,1,3,0,4
19753,40,5282,1609;4481;12577,4745,0,0,3,0,3
19754,40,5285,7019;12968;13172,4745,0,2,1,0,3
19755,40,5286,7142;11992;12457;12766,4745,0,0,4,0,4
19756,40,5287,2462;3944,4745,0,0,2,0,2
19757,40,5288,9450;9976;11517;11584;12103;13839;14097,4745,0,2,5,0,7
19758,40,5290,2791,4745,0,0,0,1,1
19759,40,5291,1766;2842;11920;12882,4745,0,1,3,0,4
19760,40,5292,7385;8894;12682;13472,4745,0,1,3,0,4
19761,40,5293,3025;9047,4745,0,0,0,2,2
19762,40,5295,3234;9033;12570;12678;12996,4745,0,1,4,0,5
19763,40,5296,3320,4745,0,0,0,1,1
19764,40,5299,837;3467,4745,0,0,2,0,2
19765,40,5300,1652;3401;12047;12874,4745,0,1,3,0,4
19766,40,5302,1787;3749;13353,4745,0,1,2,0,3
19767,40,5303,3793,4745,0,0,0,1,1
19768,40,5305,1966;3873;13484;13804;14028,4745,0,3,2,0,5
19769,40,5306,3945;8759;12500;13065,4745,0,1,3,0,4
19770,40,5308,1344;4252;11780;12823,4745,0,1,3,0,4
19771,40,5309,1416;9015;12042;12777;13491,4745,0,1,4,0,5
19772,40,5315,5044;8566;13158,4745,0,1,2,0,3
19773,40,5316,5181;7747;11852;12544;12812;14219,4745,0,2,4,0,6
19774,40,5317,1444,4745,0,0,0,1,1
19775,40,5318,3458;5565;12995;14201,4745,0,2,2,0,4
19776,40,5319,3380;12352;12414;12827;13420,4745,0,2,3,0,5
19777,40,5320,3859;4630;13649,4745,0,1,2,0,3
19778,40,5323,6;3069;12398;12825,4745,0,1,3,0,4
19779,40,5324,9400;12878,4745,0,1,1,0,2
19780,40,5326,7212;9454;12784;12949,4745,0,1,3,0,4
19781,40,5327,2434;7127;11685;12297;12831;13055,4745,0,2,4,0,6
19782,40,5328,801;6555;12481;12977;13885,4745,0,2,3,0,5
19783,40,5332,6517,4745,0,0,0,1,1
19784,40,5335,7149;7414,4745,0,0,0,2,2
19785,40,5336,1161;6353;12240;13138,4745,0,1,3,0,4
19786,40,5337,7276;12502;12836;13247;13943,4745,0,3,2,0,5
19787,40,5338,3238;7300;12267;13024,4745,0,1,3,0,4
19788,40,5339,7496;7704;12730,4745,0,0,3,0,3
19789,40,5341,1789;7553;13117,4745,0,1,2,0,3
19790,40,5342,54;2117,4745,0,0,2,0,2
19791,40,5343,3956;8505,4745,0,0,2,0,2
19792,40,5344,6918;8514;12516,4745,0,0,3,0,3
19793,40,5345,5396;8520;12522;12920;13378,4745,0,2,3,0,5
19794,40,5346,8527;9693;13505,4745,0,1,2,0,3
19795,40,5347,5137;8065;12397;12858,4745,0,1,3,0,4
19796,40,5348,1750,4745,0,0,1,0,1
19797,40,5349,8629;9003;11721;12447,4745,0,0,4,0,4
19798,40,5350,2699;4809;12923;13140;13237,4745,0,3,2,0,5
19799,40,5351,212;1500;12636;12895,4745,0,1,3,0,4
19800,40,5352,953;11800;12459;13043;13761,4745,0,2,3,0,5
19801,40,5353,9417;9798;12377;12563,4745,0,0,4,0,4
19802,40,5354,9488,4745,0,0,0,1,1
19803,40,5355,2449;12109,4745,0,0,2,0,2
19804,40,5356,8401,4745,0,0,0,1,1
19805,40,5357,3457;12151,4745,0,0,2,0,2
19806,40,5358,294;11914;13824;14125,4745,0,2,2,0,4
19807,40,5359,9726,4745,0,0,1,0,1
19808,40,5363,175;7696;12127;12883;13414,5110,0,2,3,0,5
19809,40,5364,216;6719;12383;12399;13580,5110,0,1,4,0,5
19810,40,5367,639;898;12944,5110,0,1,2,0,3
19811,40,5368,648;1572;12406;12781;13076,5110,0,1,4,0,5
19812,40,5369,7460;12269;13656,5110,0,1,2,0,3
19813,40,5372,1477;1714;12744;13142,5110,0,1,3,0,4
19814,40,5373,679,5110,0,0,1,0,1
19815,40,5374,1642,5110,0,0,0,1,1
19816,40,5377,944;6905;11612;12699,5110,0,0,4,0,4
19817,40,5378,2517;9112,5110,0,0,2,0,2
19818,40,5380,2789;6567;11958;12330;12978;13267;13939,5110,0,3,4,0,7
19819,40,5382,8716,5110,0,0,0,1,1
19820,40,5384,870;3428;12401;13355,5110,0,1,3,0,4
19821,40,5385,3611;8133;12112;12921,5110,0,1,3,0,4
19822,40,5386,3691;9709;12667;13151;13722,5110,0,2,3,0,5
19823,40,5388,1986;5573;12439;12541,5110,0,0,4,0,4
19824,40,5390,9558,5110,0,0,0,1,1
19825,40,5391,4035;6169;12546,5110,0,0,3,0,3
19826,40,5393,4070;7990;12464;12888;13332,5110,0,2,3,0,5
19827,40,5394,4264,5110,0,0,0,1,1
19828,40,5395,8303,5110,0,0,0,1,1
19829,40,5396,3389,5110,0,0,0,1,1
19830,40,5397,2364;4963;12770;13039;13726,5110,0,2,3,0,5
19831,40,5398,5031;5688;12725,5110,0,0,3,0,3
19832,40,5400,5588,5110,0,0,0,1,1
19833,40,5401,4595;5674;12764;13723;14271,5110,0,2,3,0,5
19834,40,5404,4043;6101;12200;13164,5110,0,1,3,0,4
19835,40,5406,1707;6154;11968,5110,0,0,3,0,3
19836,40,5408,480;13477,5110,0,1,1,0,2
19837,40,5409,802;9134;12579,5110,0,0,3,0,3
19838,40,5410,6693;7500;12025;12443;13057;13273,5110,0,2,4,0,6
19839,40,5411,2594;2750;12857,5110,0,1,2,0,3
19840,40,5412,6791;6950;12375;12887,5110,0,1,3,0,4
19841,40,5413,6875;8845;12561;12993,5110,0,1,3,0,4
19842,40,5414,7030,5110,0,0,1,0,1
19843,40,5415,2870;7039;11812;13553;13818;14762,5110,1,2,3,0,6
19844,40,5416,3476;12320;12851,5110,0,1,2,0,3
19845,40,5417,7367;8050,5110,0,0,2,0,2
19846,40,5420,9251,5110,0,0,0,1,1
19847,40,5421,7332;7697;12150;12433,5110,0,0,4,0,4
19848,40,5422,3437;8746;12086;12405;12593,5110,0,0,5,0,5
19849,40,5424,1239;8252,5110,0,0,2,0,2
19850,40,5426,753;8827;12264;13730,5110,0,1,3,0,4
19851,40,5427,9027,5110,0,0,0,1,1
19852,40,5428,6526;9068;12322;12982,5110,0,1,3,0,4
19853,40,5429,5806;9210;12244;13298;13626,5110,0,2,3,0,5
19854,40,5430,4737,5110,0,0,0,1,1
19855,40,5431,9586,5110,0,0,0,1,1
19856,40,5433,1471;6404;12416;12718;12903;13956,5110,0,2,4,0,6
19857,40,5434,5735;9853;12537;13192;13783,5110,0,2,3,0,5
19858,40,5435,352,5110,0,0,0,1,1
19859,40,5436,2963;7561;12005;12808,5475,0,1,3,0,4
19860,40,5437,87;631;12952;14249,5475,0,2,2,0,4
19861,40,5438,6130,5475,0,0,0,1,1
19862,40,5440,378;5043;12842;13402;13729,5475,0,3,2,0,5
19863,40,5441,431;5792;12421,5475,0,0,3,0,3
19864,40,5442,2795;5715,5475,0,0,2,0,2
19865,40,5443,2651;9783;12532;13174;14018,5475,0,2,3,0,5
19866,40,5444,896;7826;12145;13304;13494,5475,0,2,3,0,5
19867,40,5445,902;9940;13859,5475,0,1,2,0,3
19868,40,5446,1163;4290;12531;13354,5475,0,1,3,0,4
19869,40,5447,1056;8288;13103;13413;13957,5475,0,3,2,0,5
19870,40,5448,1093;5425;12605;12884;13715,5475,0,2,3,0,5
19871,40,5449,987;3045;11965,5475,0,0,3,0,3
19872,40,5451,1584;9643;12937;13255,5475,0,2,2,0,4
19873,40,5452,6112;12440;12672;13184,5475,0,1,3,0,4
19874,40,5456,1575;5232;13156;13457;14223,5475,0,3,2,0,5
19875,40,5457,2059;12904,5475,0,1,1,0,2
19876,40,5458,5850;13020;14449,5475,0,2,1,0,3
19877,40,5459,1838,5475,0,0,0,1,1
19878,40,5460,1962;6139;11823;12513,5475,0,0,4,0,4
19879,40,5461,8863,5475,0,0,0,1,1
19880,40,5462,2146;2268;15210,5475,1,0,2,0,3
19881,40,5463,574;2159;12256;12899,5475,0,1,3,0,4
19882,40,5466,2499;6108,5475,0,0,2,0,2
19883,40,5468,1451;2948;12514;13163;13578,5475,0,2,3,0,5
19884,40,5471,3359;9082;13602;14052,5475,0,2,2,0,4
19885,40,5472,6319;7119;12045;12704,5475,0,0,4,0,4
19886,40,5473,3504;3530;12973;13294;13825,5475,0,3,2,0,5
19887,40,5475,3586;3639,5475,0,0,2,0,2
19888,40,5476,3794;5241;12687;13148;14178;14316,5475,0,3,3,0,6
19889,40,5478,3921;6117;11803;12430,5475,0,0,4,0,4
19890,40,5479,9248,5475,0,0,0,1,1
19891,40,5480,4154,5475,0,0,0,1,1
19892,40,5482,1147;4381;12056;12279,5475,0,0,4,0,4
19893,40,5483,5116,5475,0,0,0,1,1
19894,40,5485,5134,5475,0,0,1,0,1
19895,40,5486,1706;6675;12942;13901,5475,0,2,2,0,4
19896,40,5487,5170;5196;12692,5475,0,0,3,0,3
19897,40,5488,4140,5475,0,0,1,0,1
19898,40,5490,865;5526,5475,0,0,2,0,2
19899,40,5491,5955,5475,0,0,0,1,1
19900,40,5492,5725,5475,0,0,0,1,1
19901,40,5493,5843;9123,5475,0,0,0,2,2
19902,40,5494,9765;9849;12675;13092;14250,5475,0,2,3,0,5
19903,40,5495,3263;6242,5475,0,0,0,2,2
19904,40,5496,6403,5475,0,0,0,1,1
19905,40,5497,6187;8010;12243;12863;13274;13434;13693,5475,0,4,3,0,7
19906,40,5500,2481;6743;11997;12155,5475,0,0,4,0,4
19907,40,5501,2964;3478;13051;13179;15144,5475,1,2,2,0,5
19908,40,5502,4509;9776;13221;13310,5475,0,2,2,0,4
19909,40,5505,5985;7156;13582;13855,5475,0,2,2,0,4
19910,40,5508,4074;7383;12316;12807;13341;14238,5475,0,3,3,0,6
19911,40,5510,5174;7520;12156;13334,5475,0,1,3,0,4
19912,40,5511,7659;7725,5475,0,0,0,2,2
19913,40,5512,7323;12327;12788;13600;14098,5475,0,2,3,0,5
19914,40,5517,1571;8273;12709;12917,5475,0,1,3,0,4
19915,40,5518,6299;8365;12844;13280;13575,5475,0,3,2,0,5
19916,40,5519,8449,5475,0,0,0,1,1
19917,40,5521,3475;8556;13589,5475,0,1,2,0,3
19918,40,5522,3214;5441;12469,5475,0,0,3,0,3
19919,40,5523,1027;1287;13133;13493,5475,0,2,2,0,4
19920,40,5527,1169;8785;12620;12926,5475,0,1,3,0,4
19921,40,5530,5372,5475,0,0,0,1,1
19922,40,5532,2027;6857;12479,5475,0,0,3,0,3
19923,40,5533,3573;9215;12283;12840;13128,5475,0,2,3,0,5
19924,40,5535,2976;12798;13026;13259,5475,0,2,2,0,4
19925,40,5539,26;9704,5475,0,0,0,2,2
19926,40,5540,1450;12911;12981,5475,0,2,1,0,3
19927,40,5543,61;8703;13118;13559,5840,0,2,2,0,4
19928,40,5544,250;838;12601;12939,5840,0,1,3,0,4
19929,40,5545,79;277;12066;12409;13303;13742;13986;14435,5840,0,4,4,0,8
19930,40,5546,367;13648;14038,5840,0,2,1,0,3
19931,40,5548,1467;3969;12214;12992,5840,0,1,3,0,4
19932,40,5549,632;12881;13219;13407,5840,0,3,1,0,4
19933,40,5553,1266;13500;13594,5840,0,2,1,0,3
19934,40,5554,1267;5449;12962;13837;13962,5840,0,3,2,0,5
19935,40,5555,319;12587;13098;13421,5840,0,2,2,0,4
19936,40,5556,4385;12674;13190;13642;13808,5840,0,3,2,0,5
19937,40,5557,326;1649;12576,5840,0,0,3,0,3
19938,40,5558,1899,5840,0,0,0,1,1
19939,40,5559,674;8038;12164;12315;13018,5840,0,1,4,0,5
19940,40,5560,2365;5128;12284,5840,0,0,3,0,3
19941,40,5561,2389;6632;13361;13889,5840,0,2,2,0,4
19942,40,5563,2694;4856;11895;12588,5840,0,0,4,0,4
19943,40,5564,163;13426,5840,0,1,1,0,2
19944,40,5565,4098,5840,0,0,0,1,1
19945,40,5567,7712;13136,5840,0,1,1,0,2
19946,40,5568,2369;7016;12963;13529,5840,0,2,2,0,4
19947,40,5569,2965;10100;13449;14573,5840,1,1,2,0,4
19948,40,5571,379;8278;13530;13810,5840,0,2,2,0,4
19949,40,5572,3145;12095;12209,5840,0,0,3,0,3
19950,40,5573,1388;3156,5840,0,0,2,0,2
19951,40,5574,1727;4337;13415;14196,5840,0,2,2,0,4
19952,40,5580,1157;12057;12943,5840,0,1,2,0,3
19953,40,5581,3841;9364;13634;14498;14568,5840,1,2,2,0,5
19954,40,5582,5521;11874;14053,5840,0,1,2,0,3
19955,40,5583,3863;10073;12775;13631,5840,0,1,3,0,4
19956,40,5584,4634;6261;13455;13583,5840,0,2,2,0,4
19957,40,5585,3367;4023;12278;12779;14002;14107,5840,0,2,4,0,6
19958,40,5588,4869,5840,0,0,0,1,1
19959,40,5591,3455;5666,5840,0,0,2,0,2
19960,40,5593,5355;6876,5840,0,0,0,2,2
19961,40,5596,5991,5840,0,0,1,0,1
19962,40,5599,8513,5840,0,0,0,1,1
19963,40,5600,6809;9735;13459;13903,5840,0,2,2,0,4
19964,40,5601,7054,5840,0,0,1,0,1
19965,40,5602,6444;9710;12696;13091,5840,0,1,3,0,4
19966,40,5603,4845;6839;12767;13070;13251,5840,0,2,3,0,5
19967,40,5605,7324,5840,0,0,1,0,1
19968,40,5607,7396;9667;12506;13248;13621,5840,0,2,3,0,5
19969,40,5608,5937;11934;12565,5840,0,0,3,0,3
19970,40,5609,5202;5860;12715;13313;13854,5840,0,2,3,0,5
19971,40,5610,7789;12493;12738;14167,5840,0,1,3,0,4
19972,40,5611,7193;9418;12585;12987;13208,5840,0,2,3,0,5
19973,40,5612,2294;7818,5840,0,0,2,0,2
19974,40,5613,4374;12519,5840,0,0,2,0,2
19975,40,5614,1544;7912;12606;13236,5840,0,1,3,0,4
19976,40,5615,4617;8047;13189;13643,5840,0,2,2,0,4
19977,40,5617,4057;8302;12684;13129;14400,5840,0,2,3,0,5
19978,40,5618,3132;7867,5840,0,0,2,0,2
19979,40,5620,9676,5840,0,0,1,0,1
19980,40,5624,7128;9230;12688;12841,5840,0,1,3,0,4
19981,40,5626,5809;9339;13150,5840,0,1,2,0,3
19982,40,5627,9069;9506;13130;13444,5840,0,2,2,0,4
19983,40,5628,9596;9608;12224;12372,5840,0,0,4,0,4
19984,40,5629,2330;9654;12573;12924;13527,5840,0,2,3,0,5
19985,40,5630,1096;4034;12880;13088,5840,0,2,2,0,4
19986,40,5631,44;3209;12317;13045,6205,0,1,3,0,4
19987,40,5632,405;2063;12654;13790,6205,0,1,3,0,4
19988,40,5633,219;8494;12011;13699,6205,0,1,3,0,4
19989,40,5635,665;12510;12965;13677;14391,6205,0,3,2,0,5
19990,40,5638,1263;4950;12670;13346,6205,0,1,3,0,4
19991,40,5639,1284;6363;12547;13212,6205,0,1,3,0,4
19992,40,5640,1305;10038;13239;13675,6205,0,2,2,0,4
19993,40,5641,1158;10204;12486,6205,0,0,3,0,3
19994,40,5642,1428;1670;12507;13806;14164,6205,0,2,3,0,5
19995,40,5643,1700;3337;12020;12295;13735,6205,0,1,4,0,5
19996,40,5645,4656;10164;12564;13490;14202,6205,0,2,3,0,5
19997,40,5648,2539;12710;12915;13225;14103,6205,0,3,2,0,5
19998,40,5649,2092;8616,6205,0,0,2,0,2
19999,40,5650,2250;10044;12036;13232,6205,0,1,3,0,4
20000,40,5651,2339;10055;12179;13770,6205,0,1,3,0,4
20001,40,5652,1321;12553,6205,0,0,2,0,2
20002,40,5654,804;2545;14080;14351,6205,0,2,2,0,4
20003,40,5655,6001;6207,6205,0,0,2,0,2
20004,40,5656,2741,6205,0,0,1,0,1
20005,40,5657,3601;12822;13369;13785,6205,0,3,1,0,4
20006,40,5659,2871,6205,0,0,1,0,1
20007,40,5661,7191,6205,0,0,1,0,1
20008,40,5662,3071;10060;13374;13499;13894,6205,0,3,2,0,5
20009,40,5663,3107;9063,6205,0,0,2,0,2
20010,40,5664,6017,6205,0,0,0,1,1
20011,40,5665,10201;10309;13141;13315;13995,6205,0,3,2,0,5
20012,40,5666,720;3281;12212;12774,6205,0,0,4,0,4
20013,40,5667,3737,6205,0,0,0,1,1
20014,40,5669,3772,6205,0,0,0,1,1
20015,40,5673,440;4257;13508,6205,0,1,2,0,3
20016,40,5674,10180;11973;13287,6205,0,1,2,0,3
20017,40,5676,1929;2234;12180;12618;12914;14019,6205,0,2,4,0,6
20018,40,5679,975,6205,0,0,0,1,1
20019,40,5680,4833;7037;12300;13107;13514;14121,6205,0,3,3,0,6
20020,40,5681,2876;12719;13752,6205,0,1,2,0,3
20021,40,5683,4106;5135;14179,6205,0,1,2,0,3
20022,40,5684,5144,6205,0,0,0,1,1
20023,40,5685,5297;13474;13728;13959;14511,6205,0,4,1,0,5
20024,40,5686,5480;7304;13295;13496,6205,0,2,2,0,4
20025,40,5687,2147,6205,0,0,0,1,1
20026,40,5688,5186;5642;12494,6205,0,0,3,0,3
20027,40,5692,5992;8052,6205,0,0,2,0,2
20028,40,5693,5969;6183;12408,6205,0,0,3,0,3
20029,40,5694,6554;6885;12935;13210,6205,0,2,2,0,4
20030,40,5699,5228;6525;13261;13595,6205,0,2,2,0,4
20031,40,5700,6529,6205,0,0,1,0,1
20032,40,5701,741;6019,6205,0,0,0,2,2
20033,40,5702,4680;6692;12680,6205,0,0,3,0,3
20034,40,5703,6967;13231;13969,6205,0,2,1,0,3
20035,40,5705,7706,6205,0,0,0,1,1
20036,40,5706,494;10054;13009,6205,0,1,2,0,3
20037,40,5707,7466;9571;12354,6205,0,0,3,0,3
20038,40,5708,7510;13205;13525;13886,6205,0,3,1,0,4
20039,40,5709,7634;9827;13828;14171,6205,0,2,2,0,4
20040,40,5710,7723,6205,0,0,1,0,1
20041,40,5711,8092;8144;13260,6205,0,1,2,0,3
20042,40,5712,430;1288;12713,6205,0,0,3,0,3
20043,40,5713,466,6205,0,0,0,1,1
20044,40,5714,3811,6205,0,0,1,0,1
20045,40,5716,945;8642;12643,6205,0,0,3,0,3
20046,40,5717,4959;8885,6205,0,0,2,0,2
20047,40,5719,2774;9626;12584;13146;14385,6205,0,2,3,0,5
20048,40,5720,6601;9266;12325;12799;14433,6205,0,1,4,0,5
20049,40,5722,9389;12802;13217;13371,6205,0,2,2,0,4
20050,40,5723,6421;9394;12746;13312;14318,6205,0,2,3,0,5
20051,40,5724,1847;9606;12015;12630;14445,6205,0,1,4,0,5
20052,40,5725,7794;13119;13358,6205,0,2,1,0,3
20053,40,5726,9741,6205,0,0,1,0,1
20054,40,5727,160;9751;12641;13866,6205,0,1,3,0,4
20055,40,5729,135;5892;13545;13731,6570,0,2,2,0,4
20056,40,5730,8356,6570,0,0,0,1,1
20057,40,5732,10118;10294;13073;13383,6570,0,2,2,0,4
20058,40,5733,6370;10174;12786;13109;13431;14262,6570,0,3,3,0,6
20059,40,5734,612;13030;13324;14712,6570,1,2,1,0,4
20060,40,5735,653;3136;12866;13097,6570,0,2,2,0,4
20061,40,5739,1152;10042;12064;12426;12829,6570,0,1,4,0,5
20062,40,5740,1242;3346,6570,0,0,2,0,2
20063,40,5742,7307;8332;12356;12820,6570,0,1,3,0,4
20064,40,5743,1308;10006;13084;14615,6570,1,1,2,0,4
20065,40,5744,1359;10146;12195;13170;13335;13485,6570,0,3,3,0,6
20066,40,5746,1538;7344;12403,6570,0,0,3,0,3
20067,40,5747,1564;9150;13587;13852,6570,0,2,2,0,4
20068,40,5749,6482,6570,0,0,0,1,1
20069,40,5751,1940;10080;12136;14677,6570,1,0,3,0,4
20070,40,5752,1721;10251;12175;12690;13238;14111,6570,0,2,4,0,6
20071,40,5753,1726;8799;13025,6570,0,1,2,0,3
20072,40,5755,2290,6570,0,0,1,0,1
20073,40,5760,6382;10088;12612;13171;14524,6570,0,2,3,0,5
20074,40,5761,1723;2671,6570,0,0,0,2,2
20075,40,5762,2919;6088;13537;14325,6570,0,2,2,0,4
20076,40,5763,3003;3834;12837;13319;13543,6570,0,3,2,0,5
20077,40,5764,3190,6570,0,0,0,1,1
20078,40,5767,3377;6289,6570,0,0,2,0,2
20079,40,5768,477;3578;12144;12691;13437;14257,6570,0,2,4,0,6
20080,40,5771,1775;7464,6570,0,0,2,0,2
20081,40,5772,4455,6570,0,0,0,1,1
20082,40,5773,4633;13099;13249;13780,6570,0,3,1,0,4
20083,40,5774,4694;6660;12560,6570,0,0,3,0,3
20084,40,5776,6003;10167;13483;13769,6570,0,2,2,0,4
20085,40,5778,5442;6603;12235;13300,6570,0,1,3,0,4
20086,40,5781,4368;8375;12860;13235,6570,0,2,2,0,4
20087,40,5785,6197;9773,6570,0,0,2,0,2
20088,40,5786,4832;7665;13337;13664,6570,0,2,2,0,4
20089,40,5787,461;9099;12543;13270,6570,0,1,3,0,4
20090,40,5791,4093;6729;13876;14011,6570,0,2,2,0,4
20091,40,5793,1236;6904;12530;12901,6570,0,1,3,0,4
20092,40,5796,7530;10112;13059;13466;13532;14627,6570,1,3,2,0,6
20093,40,5798,2354;7762;13112;13612;14145,6570,0,3,2,0,5
20094,40,5799,7765;10229;12503;12731;14378,6570,0,1,4,0,5
20095,40,5800,10084;13844;14538,6570,1,1,1,0,3
20096,40,5802,119;8051;13329;13566;13928,6570,0,3,2,0,5
20097,40,5806,2256;8396;13162,6570,0,1,2,0,3
20098,40,5807,8721;10063;12997;13199;13411;13917,6570,0,4,2,0,6
20099,40,5810,9292,6570,0,0,0,1,1
20100,40,5812,57;8220;12211;13524;13862,6570,0,2,3,0,5
20101,40,5813,9425;12275;12627,6570,0,0,3,0,3
20102,40,5814,5978,6570,0,0,0,1,1
20103,40,5815,4704;9655;12752;13275;14312,6570,0,2,3,0,5
20104,40,5818,9912,6570,0,0,0,1,1
20105,40,5819,81;476;12651;12843;13763,6935,0,2,3,0,5
20106,40,5820,94;10069;13542;14152,6935,0,2,2,0,4
20107,40,5821,7402;12729;13488,6935,0,1,2,0,3
20108,40,5824,349;6344;12856,6935,0,1,2,0,3
20109,40,5825,3748;7873;12971;13268,6935,0,2,2,0,4
20110,40,5827,9420,6935,0,0,1,0,1
20111,40,5831,1371;6920,6935,0,0,2,0,2
20112,40,5833,10067;10138;13905;14296,6935,0,2,2,0,4
20113,40,5835,2121;8109;13551;13996,6935,0,2,2,0,4
20114,40,5836,10223;13181;13576,6935,0,2,1,0,3
20115,40,5837,2245;6458,6935,0,0,2,0,2
20116,40,5839,8697;10145;12268;12552;13819,6935,0,1,4,0,5
20117,40,5840,2775;10030;13022;14091;14516,6935,0,3,2,0,5
20118,40,5841,2914,6935,0,0,0,1,1
20119,40,5843,3375;9316;13183;13256,6935,0,2,2,0,4
20120,40,5845,545;3126;12360;12892,6935,0,1,3,0,4
20121,40,5846,4448;10037;12657;13263;13397,6935,0,2,3,0,5
20122,40,5848,3555,6935,0,0,0,1,1
20123,40,5850,218;10074;13111;13462;14398,6935,0,3,2,0,5
20124,40,5851,4259;7808;12721,6935,0,0,3,0,3
20125,40,5854,3127;5301;12595;12985;13125;13291;13975,6935,0,4,3,0,7
20126,40,5858,4743;8418,6935,0,0,2,0,2
20127,40,5859,4785;5231;13461,6935,0,1,2,0,3
20128,40,5860,4868;10287;14387,6935,0,1,2,0,3
20129,40,5861,2765;9946;12429;12586;12800,6935,0,0,5,0,5
20130,40,5862,5097;7994,6935,0,0,2,0,2
20131,40,5863,5258;10158;12615;13101,6935,0,1,3,0,4
20132,40,5864,3583,6935,0,0,0,1,1
20133,40,5865,960;5367;12768;12948;13708;14215,6935,0,3,3,0,6
20134,40,5867,5630;7310;13246;13599,6935,0,2,2,0,4
20135,40,5869,9326,6935,0,0,0,1,1
20136,40,5871,10005;10132;12655;13087;13604;14735,6935,1,2,3,0,6
20137,40,5872,4752;6331,6935,0,0,2,0,2
20138,40,5873,169;6443;12312;12607;13388;14365;14813,6935,1,2,4,0,7
20139,40,5874,6466,6935,0,0,1,0,1
20140,40,5875,5743;6469;13277;13787;14210,6935,0,3,2,0,5
20141,40,5877,7444;8553;13188;13929,6935,0,2,2,0,4
20142,40,5880,9199,6935,0,0,0,1,1
20143,40,5881,6465,6935,0,0,1,0,1
20144,40,5883,3725,6935,0,0,1,0,1
20145,40,5884,4442;7425,6935,0,0,0,2,2
20146,40,5885,3886;7439,6935,0,0,2,0,2
20147,40,5888,3731;7550;12780;12898,6935,0,1,3,0,4
20148,40,5889,7733,6935,0,0,1,0,1
20149,40,5890,7781;9197;12897;13463;13873,6935,0,3,2,0,5
20150,40,5891,7927;9692;12446;13080,6935,0,1,3,0,4
20151,40,5892,3981,6935,0,0,0,1,1
20152,40,5894,2971;4600,6935,0,0,2,0,2
20153,40,5895,7097;10237;13258;14535;14665,6935,2,1,2,0,5
20154,40,5896,8578,6935,0,0,0,1,1
20155,40,5899,9689;13209;13540,6935,0,2,1,0,3
20156,40,5900,5917;10186;12762;13309,6935,0,1,3,0,4
20157,40,5901,982;9042;12381;13321,6935,0,1,3,0,4
20158,40,5902,10046;10062;13187;13625,6935,0,2,2,0,4
20159,40,5903,9373,6935,0,0,0,1,1
20160,40,5905,217;9680;13423,6935,0,1,2,0,3
20161,40,5906,29;10206;12778;14089,6935,0,1,3,0,4
20162,40,5908,10022;10210;13637;13798;14263,6935,0,3,2,0,5
20163,40,5909,3820;10029;13569;14194,6935,0,2,2,0,4
20164,40,5910,10033;10362;12425;12611;12677;14079,6935,0,1,5,0,6
20165,40,5911,1144;10188;12488;12727;14014,6935,0,1,4,0,5
20166,40,5912,10056;10297;13469;13971,6935,0,2,2,0,4
20167,40,5913,10079;10162;13773;14087,6935,0,2,2,0,4
20168,40,5914,10099;10109;13285;14124,6935,0,2,2,0,4
20169,40,5915,5731;10108;12644;13034;13121;13668;13674;15017,6935,1,4,3,0,8
20170,40,5916,10113;10481;13487;13673,6935,0,2,2,0,4
20171,40,5918,448;10183;13126;14114;14742,7300,1,2,2,0,5
20172,40,5919,511;8470;12890;13075,7300,0,2,2,0,4
20173,40,5921,562;9927;13168;13528,7300,0,2,2,0,4
20174,40,5923,4714;12337;12754;13399,7300,0,1,3,0,4
20175,40,5926,1162;5420,7300,0,0,2,0,2
20176,40,5927,1452;2689;12894;13314;13716,7300,0,3,2,0,5
20177,40,5928,2784;5390;13670;14319,7300,0,2,2,0,4
20178,40,5929,3160,7300,0,0,0,1,1
20179,40,5930,2361;10401;12686;13293;13620;14338,7300,0,3,3,0,6
20180,40,5931,1827,7300,0,0,0,1,1
20181,40,5934,3146;5479;13214;13323;14417,7300,0,3,2,0,5
20182,40,5935,1045;10008;13003;13592,7300,0,2,2,0,4
20183,40,5937,10121;13002;14032;14335;15133,7300,1,3,1,0,5
20184,40,5940,3808,7300,0,0,0,1,1
20185,40,5941,3847,7300,0,0,0,1,1
20186,40,5943,4092;7163;13196;13254,7300,0,2,2,0,4
20187,40,5944,3481;4304,7300,0,0,2,0,2
20188,40,5946,4544;9887;12396;13338,7300,0,1,3,0,4
20189,40,5949,505;4735,7300,0,0,2,0,2
20190,40,5950,4851;10057;13395;14077,7300,0,2,2,0,4
20191,40,5952,5403,7300,0,0,0,1,1
20192,40,5955,5726;7176;12525;12986,7300,0,1,3,0,4
20193,40,5956,5738,7300,0,0,1,0,1
20194,40,5957,5798;5968;12453;12834,7300,0,1,3,0,4
20195,40,5958,7732;8624,7300,0,0,2,0,2
20196,40,5959,1682;6702;13809;14039,7300,0,2,2,0,4
20197,40,5961,6764;6995;12424;13202,7300,0,1,3,0,4
20198,40,5964,4677;7172;12455;12794;13871,7300,0,1,4,0,5
20199,40,5968,7481;10097;13680;14465,7300,0,2,2,0,4
20200,40,5970,8255,7300,0,0,0,1,1
20201,40,5971,5436;8328,7300,0,0,2,0,2
20202,40,5972,8372;9211;13042;13515;14182,7300,0,3,2,0,5
20203,40,5974,5580,7300,0,0,0,1,1
20204,40,5975,2247;5736;13392;14102,7300,0,2,2,0,4
20205,40,5976,8986,7300,0,0,1,0,1
20206,40,5977,5788;7521,7300,0,0,2,0,2
20207,40,5979,9962,7300,0,0,0,1,1
20208,40,5980,6015;9749,7300,0,0,2,0,2
20209,40,5983,10017;10320;13497,7300,0,1,2,0,3
20210,40,5984,10252;13623;13709;14157,7300,0,3,1,0,4
20211,40,5985,10519;12614;13056;14439;14895,7300,1,2,2,0,5
20212,40,5986,6085;10220;13443;13762;14501,7300,0,3,2,0,5
20213,40,5987,10134;10142;13696;13884;14046,7300,0,3,2,0,5
20214,40,5988,10154;10498;12535;12867;13544,7300,0,2,3,0,5
20215,40,5989,4515;10187;13478;13741,7300,0,2,2,0,4
20216,40,5993,10222;10255;13606;14346,7665,0,2,2,0,4
20217,40,5994,512;1604,7665,0,0,2,0,2
20218,40,5995,1623;8409;13882;13989,7665,0,2,2,0,4
20219,40,5996,1702;12659,7665,0,0,2,0,2
20220,40,5997,1826,7665,0,0,0,1,1
20221,40,6000,5105;7394;12660;12933;13385,7665,0,2,3,0,5
20222,40,6003,3952;10217;12830;13046,7665,0,2,2,0,4
20223,40,6005,2620;4955;12511;12930;13460;13655;14336,7665,0,4,3,0,7
20224,40,6007,2707,7665,0,0,0,1,1
20225,40,6008,10280;13605;14410,7665,0,2,1,0,3
20226,40,6009,10043;10306;12490;12803;13147;13546,7665,0,2,4,0,6
20227,40,6011,2788;6953;12470,7665,0,0,3,0,3
20228,40,6012,2920;3591;13698;14212,7665,0,2,2,0,4
20229,40,6013,4271;5296;12484;13082,7665,0,1,3,0,4
20230,40,6015,3751,7665,0,0,0,1,1
20231,40,6016,4369,7665,0,0,1,0,1
20232,40,6017,4755;8421;13185;13633;14482,7665,0,3,2,0,5
20233,40,6018,4861;6836,7665,0,0,2,0,2
20234,40,6020,5161;5310;13144;13669;13897;14806,7665,1,3,2,0,6
20235,40,6022,4229;5421;14314,7665,0,1,2,0,3
20236,40,6023,5437;6114;13279;13734,7665,0,2,2,0,4
20237,40,6024,5598,7665,0,0,0,1,1
20238,40,6026,6205,7665,0,0,0,1,1
20239,40,6029,6991;8698;12957;13195,7665,0,2,2,0,4
20240,40,6030,5945,7665,0,0,0,1,1
20241,40,6031,6055;6071;13058;13180,7665,0,2,2,0,4
20242,40,6032,8573;12583,7665,0,0,2,0,2
20243,40,6033,6625;9016,7665,0,0,2,0,2
20244,40,6044,7852,7665,0,0,0,1,1
20245,40,6048,137,7665,0,0,0,1,1
20246,40,6050,1486;9078,7665,0,0,2,0,2
20247,40,6053,9682,7665,0,0,0,1,1
20248,40,6054,1487;9868,7665,0,0,0,2,2
20249,40,6056,10007;10431;12554;13609;13867;14355;14918,7665,1,3,3,0,7
20250,40,6057,10014;10340;12661;13619,7665,0,1,3,0,4
20251,40,6058,10016;10395;14147;14632,7665,1,1,2,0,4
20252,40,6059,4523;10209;12908;13000;13228,7665,0,3,2,0,5
20253,40,6060,1944;10065;13429;13702,7665,0,2,2,0,4
20254,40,6061,10086;10230;13159;13240;13627;14508,7665,0,4,2,0,6
20255,40,6062,10089;10178;13523;14153;14356,7665,0,3,2,0,5
20256,40,6063,10361;10394;13432;13771;14686,7665,1,2,2,0,5
20257,40,6064,10127;10141;13567;13747;14026,7665,0,3,2,0,5
20258,40,6067,10171;10448;12566;14345,7665,0,1,3,0,4
20259,40,6069,10522;12758;13396;14998,7665,1,1,2,0,4
20260,40,6070,10254;10583;12712;12953;14135;14492,7665,0,3,3,0,6
20261,40,6071,10261;10440;12849;13049;13636;14239;15225,7665,1,4,2,0,7
20262,40,6072,10265;10483;12628;13654;14311;14440;14641,7665,1,3,3,0,7
20263,40,6073,10104;10567;13564;14527;14544;14866,7665,2,2,2,0,6
20264,40,6074,10275;10391;12545;14045;14684,7665,1,1,3,0,5
20265,40,6075,10277;10505;12555;13113;13807,7665,0,2,3,0,5
20266,40,6076,7295;10197;13035;13700;13813;14564,7665,1,3,2,0,6
20267,40,6077,10298;10321;12679;13265;13520;14273;14620,7665,1,3,3,0,7
20268,40,6078,10233;10307;12763;13454;14203,7665,0,2,3,0,5
20269,40,6079,2085;10311;13442;14361,7665,0,2,2,0,4
20270,40,6080,320;5064;13749;14497,8030,0,2,2,0,4
20271,40,6081,582,8030,0,0,0,1,1
20272,40,6082,8545,8030,0,0,0,1,1
20273,40,6083,7621;12608;12733,8030,0,0,3,0,3
20274,40,6084,5100;6389;12789;13253;13899,8030,0,2,3,0,5
20275,40,6086,1197,8030,0,0,0,1,1
20276,40,6087,2360;3246;13120;13479;14376,8030,0,3,2,0,5
20277,40,6090,795;8149;12896;13934,8030,0,2,2,0,4
20278,40,6095,2879,8030,0,0,0,1,1
20279,40,6096,3395,8030,0,0,1,0,1
20280,40,6098,3029;5329,8030,0,0,2,0,2
20281,40,6099,3612;5024;12931;13558,8030,0,2,2,0,4
20282,40,6102,4235;10380;13017;13301;13745,8030,0,3,2,0,5
20283,40,6103,4396;8249,8030,0,0,1,1,2
20284,40,6104,10557;10700;13644;14173;14957,8030,1,2,2,0,5
20285,40,6105,4370;9167,8030,0,0,2,0,2
20286,40,6106,6035,8030,0,0,1,0,1
20287,40,6107,932;5191;13954,8030,0,1,2,0,3
20288,40,6108,5322,8030,0,0,0,1,1
20289,40,6110,6393;10003;12625;12970,8030,0,1,3,0,4
20290,40,6111,1889,8030,0,0,1,0,1
20291,40,6112,2728;6309;12959;13325,8030,0,2,2,0,4
20292,40,6115,8145;10093;13031;14035;14493,8030,0,3,2,0,5
20293,40,6118,8591,8030,0,0,1,0,1
20294,40,6119,6155;8638;13197;13704,8030,0,2,2,0,4
20295,40,6120,3978;8641;13053,8030,0,1,2,0,3
20296,40,6121,2996;8688;12695;12972;13614,8030,0,2,3,0,5
20297,40,6126,10028;10545;12751;13869;14261,8030,0,2,3,0,5
20298,40,6127,4456;10051;13372;14185,8030,0,2,2,0,4
20299,40,6128,10053;10090;12889;14033;14476,8030,0,3,2,0,5
20300,40,6129,10081;10246;12910;13283;14949,8030,1,2,2,0,5
20301,40,6130,10302;10433;12872;12990;13501,8030,0,3,2,0,5
20302,40,6131,10101;10119;13418;13572,8030,0,2,2,0,4
20303,40,6132,10124;10215;13333;13622,8030,0,2,2,0,4
20304,40,6133,604,8030,0,0,1,0,1
20305,40,6134,5032;10192;13213;13377;14599,8030,1,2,2,0,5
20306,40,6135,10211;10534;12755;13227;14000,8030,0,2,3,0,5
20307,40,6136,10221;10535;13468;14652;15167,8030,2,1,2,0,5
20308,40,6137,10239;10454;13703;15044,8030,1,1,2,0,4
20309,40,6138,10242;10618;12787;13004;13106;14056,8030,0,3,3,0,6
20310,40,6139,10259;10640;14479;15116,8030,1,1,2,0,4
20311,40,6140,10047;10270;12739;12891;13436,8030,0,2,3,0,5
20312,40,6141,10271;10679;14268;14783,8030,1,1,2,0,4
20313,40,6142,10276;10653;14914;15029,8030,2,0,2,0,4
20314,40,6143,10278;10582;13029;13137,8030,0,2,2,0,4
20315,40,6144,10281;10296;12814;13386;13687,8030,0,3,2,0,5
20316,40,6145,10714;13960;15128,8030,1,1,1,0,3
20317,40,6146,10126;10269;13063;13177,8030,0,2,2,0,4
20318,40,6147,10327;10471;13054;13799;13919,8030,0,3,2,0,5
20319,40,6148,10347;10384;12783;13079,8030,0,1,3,0,4
20320,40,6149,10155;10566;13904;14548;15147,8030,2,1,2,0,5
20321,40,6150,10370;10390;14211;14758,8030,1,1,2,0,4
20322,40,6151,10170;10383;13015;13242;13598;13940;14576;14769,8030,2,4,2,0,8
20323,40,6152,10386;10719;12832;13115;14086;14766,8030,1,3,2,0,6
20324,40,6153,10389;10463;14160;14610,8030,1,1,2,0,4
20325,40,6154,10203;10726;14337;14601;14880,8030,2,1,2,0,5
20326,40,6155,10432;10721;14716;15069,8030,2,0,2,0,4
20327,40,6156,136;6262;14188;14266,8395,0,2,2,0,4
20328,40,6157,2810,8395,0,0,1,0,1
20329,40,6159,10513;10615;12940;13357;14706,8395,1,2,2,0,5
20330,40,6160,1231;5040;13646;13717;14427,8395,0,3,2,0,5
20331,40,6161,1248,8395,0,0,0,1,1
20332,40,6163,1495;2089,8395,0,0,0,2,2
20333,40,6166,1797;10114;12828;13220,8395,0,2,2,0,4
20334,40,6167,652,8395,0,0,1,0,1
20335,40,6168,2760,8395,0,0,1,0,1
20336,40,6169,5522;10012;13738;14181;14446,8395,0,3,2,0,5
20337,40,6171,447;3366;13650;13757,8395,0,2,2,0,4
20338,40,6173,8237;13305;14908,8395,1,1,1,0,3
20339,40,6174,4219,8395,0,0,1,0,1
20340,40,6179,4543,8395,0,0,1,0,1
20341,40,6182,10052;10353;12848;13838,8395,0,2,2,0,4
20342,40,6184,5139,8395,0,0,0,1,1
20343,40,6189,7575,8395,0,0,0,1,1
20344,40,6192,8008,8395,0,0,0,1,1
20345,40,6193,9514,8395,0,0,1,0,1
20346,40,6194,2701;8111;13090;13471,8395,0,2,2,0,4
20347,40,6195,5627,8395,0,0,0,1,1
20348,40,6196,8474;10105;13803;14451,8395,0,2,2,0,4
20349,40,6197,3267;5710,8395,0,0,2,0,2
20350,40,6199,1104;5814,8395,0,0,2,0,2
20351,40,6205,10256;13139;14562;14975,8395,2,1,1,0,4
20352,40,6206,10314;13306;14396;14536,8395,1,2,1,0,4
20353,40,6207,10140;10200;13243;13607;14626,8395,1,2,2,0,5
20354,40,6208,10551;10753;14027;14340;14788;15013,8395,2,2,2,0,6
20355,40,6209,10189;10516;13464;14581;15037,8395,2,1,2,0,5
20356,40,6210,10072;10258;13336;13676,8395,0,2,2,0,4
20357,40,6211,10262;10279;13639;13993,8395,0,2,2,0,4
20358,40,6212,10272;10506;13134;14522;14868,8395,1,2,2,0,5
20359,40,6213,10286;10728;14718;14915,8395,2,0,2,0,4
20360,40,6214,1747;10228;13266;14300;14938,8395,1,2,2,0,5
20361,40,6215,10328;10738;13086;13245;13682;14085;14507,8395,0,5,2,0,7
20362,40,6216,10202;10350;14260;14741,8395,1,1,2,0,4
20363,40,6217,10324;10372;13872;14034,8395,0,2,2,0,4
20364,40,6218,10415;10604;14596;15081,8395,2,0,2,0,4
20365,40,6219,10418;10435;13498;13737;14295,8395,0,3,2,0,5
20366,40,6220,10318;10656;13083;13127;13482;14363,8395,0,4,2,0,6
20367,40,6221,10465;10879;12815;13320;13955;13992;14375,8395,0,5,2,0,7
20368,40,6222,10476;10781;13573;13972;14353,8395,0,3,2,0,5
20369,40,6223,1050;10455;13521;14041;14474,8395,0,3,2,0,5
20370,40,6224,10291;10495;12859;13064;13584;14285,8395,0,4,2,0,6
20371,40,6225,10657;10661;14010;14920,8395,1,1,2,0,4
20372,40,6227,10548;13135;13953,8395,0,2,1,0,3
20373,40,6228,2497,8760,0,0,0,1,1
20374,40,6230,10208;12969;13944,8760,0,2,1,0,3
20375,40,6237,3472;10227;14134;14509,8760,0,2,2,0,4
20376,40,6238,873;6765,8760,0,0,2,0,2
20377,40,6239,2176;5459;13710;14119,8760,0,2,2,0,4
20378,40,6243,1973;2534;13915;14726,8760,1,1,2,0,4
20379,40,6244,2233;3055;12877;13166,8760,0,2,2,0,4
20380,40,6245,3108;7311;13215;13983,8760,0,2,2,0,4
20381,40,6246,7223,8760,0,0,1,0,1
20382,40,6249,5047;13116;13586,8760,0,2,1,0,3
20383,40,6250,3600;3615;12852;13284,8760,0,2,2,0,4
20384,40,6251,4156,8760,0,0,0,1,1
20385,40,6252,8033;8711,8760,0,0,2,0,2
20386,40,6253,56;4700,8760,0,0,2,0,2
20387,40,6256,1031;5409;12916,8760,0,1,2,0,3
20388,40,6257,5464,8760,0,0,0,1,1
20389,40,6258,5698;10268;13597;13801,8760,0,2,2,0,4
20390,40,6262,6217,8760,0,0,0,1,1
20391,40,6263,3735;7315;13536;13690,8760,0,2,2,0,4
20392,40,6264,1618;6624;13438;13638,8760,0,2,2,0,4
20393,40,6265,6272;6642;13800;13941,8760,0,2,2,0,4
20394,40,6267,7698,8760,0,0,1,0,1
20395,40,6269,11;1360;13888;14070;14148,8760,0,3,2,0,5
20396,40,6272,8376,8760,0,0,1,0,1
20397,40,6273,8437,8760,0,0,0,1,1
20398,40,6274,625;2747,8760,0,0,1,1,2
20399,40,6275,1693;7493,8760,0,0,2,0,2
20400,40,6276,4124;7155,8760,0,0,0,2,2
20401,40,6277,9835,8760,0,0,0,1,1
20402,40,6280,10045;10488;13895;14540,8760,1,1,2,0,4
20403,40,6281,10381;10422;13161;13389;14126,8760,0,3,2,0,5
20404,40,6282,10617;10724;13707;14518;14809,8760,1,2,2,0,5
20405,40,6283,10071;10587;13012;14884,8760,1,1,2,0,4
20406,40,6284,10076;10253;13574;14553,8760,1,1,2,0,4
20407,40,6285,10096;10474;14140;14936,8760,1,1,2,0,4
20408,40,6286,10102;10374;14101;14308;15023,8760,1,2,2,0,5
20409,40,6287,10528;13419;14530;15035,8760,2,1,1,0,4
20410,40,6288,10125;10627;13001;13307,8760,0,2,2,0,4
20411,40,6290,10196;10720;14953,8760,1,0,2,0,3
20412,40,6291,10117;10198;13302;13923,8760,0,2,2,0,4
20413,40,6292,3241;10163;14416;14697,8760,1,1,2,0,4
20414,40,6293,3318;9764;13403;13784,8760,0,2,2,0,4
20415,40,6294,10098;10250;13077;13951,8760,0,2,2,0,4
20416,40,6295,10078;10292;13452;13714;14277,8760,0,3,2,0,5
20417,40,6296,10066;10299;13467;13665;13743,8760,0,3,2,0,5
20418,40,6297,9563;10338;13789;14064,8760,0,2,2,0,4
20419,40,6298,10647;10697;14139;14360,8760,0,2,2,0,4
20420,40,6299,10341;10652;13330;13681;14328,8760,0,3,2,0,5
20421,40,6300,10342;10358;13966;14287,8760,0,2,2,0,4
20422,40,6301,10357;13679;13921;14252,8760,0,3,1,0,4
20423,40,6302,10241;10364;14247;14663,8760,1,1,2,0,4
20424,40,6303,10191;10377;13069;13296,8760,0,2,2,0,4
20425,40,6304,10408;10650;13561;14281,8760,0,2,2,0,4
20426,40,6305,10020;10625;14437;14728,8760,1,1,2,0,4
20427,40,6306,10441;10907;13050;13475;13531;14426;14698,8760,1,4,2,0,7
20428,40,6307,10710;13517;13930;14298,8760,0,3,1,0,4
20429,40,6308,10439;10470;13832;14628,8760,1,1,2,0,4
20430,40,6309,10244;10709;14737;15036,8760,2,0,2,0,4
20431,40,6310,10092;10532;13439;14131;14510,8760,0,3,2,0,5
20432,40,6311,10541;10613;14218;14904,8760,1,1,2,0,4
20433,40,6312,10682;10694;14307;14584,8760,1,1,2,0,4
20434,40,6313,10558;13316;13554;14156;14496;15206,8760,1,4,1,0,6
20435,40,6314,10143;10572;13927;14267,8760,0,2,2,0,4
20436,40,6315,10599;10865;13470;14199;14789,8760,1,2,2,0,5
20437,40,6316,10547;10602;13465;13835;14413,8760,0,3,2,0,5
20438,40,6317,10758;10899;13013;13473;14939,8760,1,2,2,0,5
20439,40,6318,10179;10606;14512,8760,0,1,2,0,3
20440,40,6322,322,9125,0,0,0,1,1
20441,40,6323,751,9125,0,0,1,0,1
20442,40,6324,878;10344;13014;13262;14029,9125,0,3,2,0,5
20443,40,6326,2208,9125,0,0,0,1,1
20444,40,6327,10009;10027;13628;14462,9125,0,2,2,0,4
20445,40,6332,4846,9125,0,0,1,0,1
20446,40,6334,8879,9125,0,0,0,1,1
20447,40,6337,2942,9125,0,0,0,1,1
20448,40,6338,3085,9125,0,0,0,1,1
20449,40,6339,89;3118;13193;13518,9125,0,2,2,0,4
20450,40,6340,1668,9125,0,0,1,0,1
20451,40,6341,3388,9125,0,0,1,0,1
20452,40,6342,421;3798;13085;13502,9125,0,2,2,0,4
20453,40,6344,4723,9125,0,0,1,0,1
20454,40,6347,247;3078;13060;13404,9125,0,2,2,0,4
20455,40,6350,2264;6626,9125,0,0,2,0,2
20456,40,6353,7115;10199;13506;13736;14016,9125,0,3,2,0,5
20457,40,6354,6605,9125,0,0,1,0,1
20458,40,6355,5394,9125,0,0,1,0,1
20459,40,6359,3424;9161;14207;14270,9125,0,2,2,0,4
20460,40,6360,6012;8502,9125,0,0,2,0,2
20461,40,6363,6325;9169,9125,0,0,2,0,2
20462,40,6364,1990,9125,0,0,1,0,1
20463,40,6365,10036;10110;13453;14701,9125,1,1,2,0,4
20464,40,6366,10460;10586;13987;14246,9125,0,2,2,0,4
20465,40,6367,10363;14115;14494;14907,9125,1,2,1,0,4
20466,40,6368,7766;10075;13154;13427,9125,0,2,2,0,4
20467,40,6369,10866;13562;13896,9125,0,2,1,0,3
20468,40,6371,10168;10310;13165;13661;13898;14423,9125,0,4,2,0,6
20469,40,6372,10169;10575;14214;14569;15089,9125,2,1,2,0,5
20470,40,6373,10175;10717;14258;14629,9125,1,1,2,0,4
20471,40,6374,10319;13428;13912;15046,9125,1,2,1,0,4
20472,40,6375,10040;10213;13417;13817,9125,0,2,2,0,4
20473,40,6376,10218;10510;13891;14094;14324,9125,0,3,2,0,5
20474,40,6377,10274;10379;14067;14354,9125,0,2,2,0,4
20475,40,6378,10083;10236;13555;13748;14724,9125,1,2,2,0,5
20476,40,6379,10157;10282;12609;12813;13362;13900;14150;14823,9125,1,4,3,0,8
20477,40,6380,10131;10356;13557;13863;14227,9125,0,3,2,0,5
20478,40,6381,10313;10873;14074;14253;15207,9125,1,2,2,0,5
20479,40,6382,10570;13276;14144,9125,0,2,1,0,3
20480,40,6383,10375;10403;13879;14142;14519,9125,0,3,2,0,5
20481,40,6384,10387;13613;14051;15050,9125,1,2,1,0,4
20482,40,6385,10264;10388;14221;14515;15071,9125,1,2,2,0,5
20483,40,6386,10360;10396;13964;14174,9125,0,2,2,0,4
20484,40,6387,10398;10593;13922;14061;14297,9125,0,3,2,0,5
20485,40,6388,10416;13781;14015,9125,0,2,1,0,3
20486,40,6389,10511;13596;13924;13979;15216,9125,1,3,1,0,5
20487,40,6390,10219;10436;13326;13887,9125,0,2,2,0,4
20488,40,6391,10438;11034;13373;14974,9125,1,1,2,0,4
20489,40,6392,10457;10459;14104;14541;14878,9125,2,1,2,0,5
20490,40,6393,10466;10639;13847;14633,9125,1,1,2,0,4
20491,40,6394,10475,9125,0,0,1,0,1
20492,40,6395,10477;10961;13167;13445;14984,9125,1,2,2,0,5
20493,40,6396,10257;10486;13104;14310;14777;14900;14997,9125,3,2,2,0,7
20494,40,6397,10770;13257;13563;14049;14464;14555,9125,1,4,1,0,6
20495,40,6398,10352;10509;13380;13630;14372;14861,9125,1,3,2,0,6
20496,40,6399,10952;14066;14090;14903,9125,1,2,1,0,4
20497,40,6401,10526;10757;13663;14637,9125,1,1,2,0,4
20498,40,6402,10378;10527;13836;14065;14875,9125,1,2,2,0,5
20499,40,6403,10095;10540;13447;14242,9125,0,2,2,0,4
20500,40,6404,10755;14265;14919,9125,1,1,1,0,3
20501,40,6405,10333;10568;14187,9125,0,1,2,0,3
20502,40,6406,10172;10574;14169;14965,9125,1,1,2,0,4
20503,40,6408,10331;10600;13570;14898,9125,1,1,2,0,4
20504,40,6409,10821;10951;13278;14578,9125,1,1,2,0,4
20505,40,6410,10234;10612;13289;13909;14756,9125,1,2,2,0,5
20506,40,6411,10397;10621;13963;14235;14723,9125,1,2,2,0,5
20507,40,6413,10919;13678;14390;14622;14867,9125,2,2,1,0,5
20508,40,6414,10614;10659;13345;14799,9125,1,1,2,0,4
20509,40,6415,10662;10795;13194;13435;13611;14042;14774,9125,1,4,2,0,7
20510,40,6416,10641;10881;13541;14047,9125,0,2,2,0,4
20511,40,6417,10468;10680;14472;14683,9125,1,1,2,0,4
20512,40,6418,10681;10895;13299;13486;13861,9125,0,3,2,0,5
20513,40,6419,10730;10769;13363;13492;14671,9125,1,2,2,0,5
20514,40,6420,10745;11011;13308,9125,0,1,2,0,3
20515,40,6421,10708;10763;13271;14100,9125,0,2,2,0,4
20516,40,6423,228;10024;13157;14672,9490,1,1,2,0,4
20517,40,6424,6481;8814,9490,0,0,2,0,2
20518,40,6429,2396;9056;13224;13347,9490,0,2,2,0,4
20519,40,6430,3046;7785;13360;13666,9490,0,2,2,0,4
20520,40,6431,3058,9490,0,0,1,0,1
20521,40,6432,4189;7197;13211;13379;14112,9490,0,3,2,0,5
20522,40,6433,1100,9490,0,0,1,0,1
20523,40,6436,329;5457,9490,0,0,1,1,2
20524,40,6438,5858,9490,0,0,0,1,1
20525,40,6442,6461;9317;14063,9490,0,1,2,0,3
20526,40,6445,6735;7216,9490,0,0,2,0,2
20527,40,6449,2598;7346;13826,9490,0,1,2,0,3
20528,40,6451,7418,9490,0,0,1,0,1
20529,40,6452,7098;7443,9490,0,0,2,0,2
20530,40,6453,7714,9490,0,0,0,1,1
20531,40,6454,5402;9722;13843;14450,9490,0,2,2,0,4
20532,40,6456,4021,9490,0,0,1,0,1
20533,40,6457,69,9490,0,0,0,1,1
20534,40,6459,8201,9490,0,0,1,0,1
20535,40,6460,6078;9232,9490,0,0,2,0,2
20536,40,6462,10025;10672;14348;14968,9490,1,1,2,0,4
20537,40,6463,10050,9490,0,0,1,0,1
20538,40,6465,10151;10184;13401;14473,9490,0,2,2,0,4
20539,40,6466,10654;13581;13811;14669,9490,1,2,1,0,4
20540,40,6467,10212;10578;14502;15008,9490,1,1,2,0,4
20541,40,6468,10523;10900;14475,9490,0,1,2,0,3
20542,40,6469,10116;10305;13317;13424;14514,9490,0,3,2,0,5
20543,40,6470,10496;13632;14877,9490,1,1,1,0,3
20544,40,6471,10330;10607;13694;14017;14420;14778;15149,9490,2,3,2,0,7
20545,40,6472,10332;10631;14272,9490,0,1,2,0,3
20546,40,6473,3185;10502;13297;13653;14289,9490,0,3,2,0,5
20547,40,6474,10411;13349;13849;14299,9490,0,3,1,0,4
20548,40,6475,10645;10658;13290;14023;14422,9490,0,3,2,0,5
20549,40,6476,10590;10635;14060,9490,0,1,2,0,3
20550,40,6477,10429;10838;13539;13860;14781,9490,1,2,2,0,5
20551,40,6479,10190;10484;13795;13998;14621,9490,1,2,2,0,5
20552,40,6480,10489;10967;13516;14539;15119,9490,2,1,2,0,5
20553,40,6481,10595;11093;14073,9490,0,1,2,0,3
20554,40,6482,4535;10182;13651;13920,9490,0,2,2,0,4
20555,40,6483,10409;10610;14096;14721,9490,1,1,2,0,4
20556,40,6485,10537;10898;14640;15179,9490,2,0,2,0,4
20557,40,6486,10698;10944;14409;14648;15034,9490,2,1,2,0,5
20558,40,6487,10573;10669;13910;14607,9490,1,1,2,0,4
20559,40,6488,10667;10673;13657;15159,9490,1,1,2,0,4
20560,40,6489,10642;10688;14040;14773,9490,1,1,2,0,4
20561,40,6490,10122;10692;14092;14478,9490,0,2,2,0,4
20562,40,6491,10407;10704;13772;14048,9490,0,2,2,0,4
20563,40,6492,10619;13359;13724;14973,9490,1,2,1,0,4
20564,40,6493,10737;14703;15038,9490,2,0,1,0,3
20565,40,6494,10739;11202;13550;13890,9490,0,2,2,0,4
20566,40,6495,10744;10815;14644;15198,9490,2,0,2,0,4
20567,40,6496,10749;10832;13250;13840;14792,9490,1,2,2,0,5
20568,40,6497,10759;11077;13624;14520;14630;14854,9490,2,2,2,0,6
20569,40,6498,10760;13489;13756;14213;14469,9490,0,4,1,0,5
20570,40,6499,11113;13368;13776;14570,9490,1,2,1,0,4
20571,40,6500,11060;11175;14327,9490,0,1,2,0,3
20572,40,6501,10788;10913;13342;13382;14643;14842,9490,2,2,2,0,6
20573,40,6502,10792;11117;14430;14989,9490,1,1,2,0,4
20574,40,6503,11082;14198,9490,0,1,1,0,2
20575,40,6504,10676;10713;13451;13765;14419,9490,0,3,2,0,5
20576,40,6505,10494;10884;12868;13351;13848;14817,9490,1,3,2,0,6
20577,40,6507,157;4461,9855,0,0,0,2,2
20578,40,6508,3883;6192,9855,0,0,2,0,2
20579,40,6509,5553;8878,9855,0,0,2,0,2
20580,40,6511,3561;5260,9855,0,0,2,0,2
20581,40,6513,1431;2918,9855,0,0,0,2,2
20582,40,6514,1667,9855,0,0,1,0,1
20583,40,6516,10031;10194;13777;14189,9855,0,2,2,0,4
20584,40,6519,2163,9855,0,0,0,1,1
20585,40,6530,2681;8931,9855,0,0,2,0,2
20586,40,6532,5027;10010;13410;14393;14598,9855,1,2,2,0,5
20587,40,6535,5890;10111;13786;14618,9855,1,1,2,0,4
20588,40,6536,6002;10130;13635;14367,9855,0,2,2,0,4
20589,40,6537,3403,9855,0,0,1,0,1
20590,40,6539,6564,9855,0,0,0,1,1
20591,40,6541,6744;10491;14128;14872;15105,9855,2,1,2,0,5
20592,40,6542,2069;6805;13779,9855,0,1,2,0,3
20593,40,6545,5404,9855,0,0,0,1,1
20594,40,6546,523,9855,0,0,0,1,1
20595,40,6547,7040;14797,9855,1,0,1,0,2
20596,40,6553,10447;13753;14301,9855,0,2,1,0,3
20597,40,6554,2370,9855,0,0,1,0,1
20598,40,6556,11115;13767;14013,9855,0,2,1,0,3
20599,40,6557,10247;10467,9855,0,0,2,0,2
20600,40,6560,10295;10329;13725;13990,9855,0,2,2,0,4
20601,40,6561,10427;10633;13744;14146,9855,0,2,2,0,4
20602,40,6562,10451;10842;13440;14180,9855,0,2,2,0,4
20603,40,6563,10554;10904;14710;15129,9855,2,0,2,0,4
20604,40,6564,10601;10622;14001;14528,9855,0,2,2,0,4
20605,40,6566,1663;10624;13695;14284;14616,9855,1,2,2,0,5
20606,40,6567,10312;10699;14050;14332,9855,0,2,2,0,4
20607,40,6568,10735;10825;13503;13556,9855,0,2,2,0,4
20608,40,6569,10742;11110;13758;13967,9855,0,2,2,0,4
20609,40,6570,10777;13853;14206,9855,0,2,1,0,3
20610,40,6571,10666;10968;13829;14136,9855,0,2,2,0,4
20611,40,6572,10790;11260;13394;14209,9855,0,2,2,0,4
20612,40,6573,10798;10809;13727;14349;14645,9855,1,2,2,0,5
20613,40,6574,10734;10803;14163;14401,9855,0,2,2,0,4
20614,40,6575,10834;11085;13994;14874,9855,1,1,2,0,4
20615,40,6576,10851;11116;13406;13705,9855,0,2,2,0,4
20616,40,6577,10869;10998;13833;14905,9855,1,1,2,0,4
20617,40,6578,10889;10996;13692,9855,0,1,2,0,3
20618,40,6579,10786;10893;14682,9855,1,0,2,0,3
20619,40,6580,10896;10901;14278;14840,9855,1,1,2,0,4
20620,40,6581,10911;11318,9855,0,0,2,0,2
20621,40,6582,10703;10921;13950;14165;14234;14771;14838,9855,2,3,2,0,7
20622,40,6583,10922;10927;13376;13686;14477,9855,0,3,2,0,5
20623,40,6584,10805;10837;13788;13841,9855,0,2,2,0,4
20624,40,6585,10940;13877;15203,9855,1,1,1,0,3
20625,40,6586,10950;11216;13805;13842;14736,9855,1,2,2,0,5
20626,40,6587,10955;14455;15213,9855,1,1,1,0,3
20627,40,6588,10971;11252;13393;13881;14357;14608;14996,9855,2,3,2,0,7
20628,40,6589,10847;10975;14484;14556;15042,9855,2,1,2,0,5
20629,40,6590,10988;11067;14084;14333,9855,0,2,2,0,4
20630,40,6595,920,10220,0,0,1,0,1
20631,40,6596,1035,10220,0,0,1,0,1
20632,40,6597,1065,10220,0,0,1,0,1
20633,40,6599,6336;13908;13981,10220,0,2,1,0,3
20634,40,6600,2013,10220,0,0,1,0,1
20635,40,6602,9263,10220,0,0,0,1,1
20636,40,6603,2373,10220,0,0,0,1,1
20637,40,6605,2502,10220,0,0,0,1,1
20638,40,6610,7050;9187;13711,10220,0,1,2,0,3
20639,40,6611,1199,10220,0,0,0,1,1
20640,40,6613,4629,10220,0,0,1,0,1
20641,40,6614,3111;3341;13797;14162,10220,0,2,2,0,4
20642,40,6619,6127;9520;13601;13746,10220,0,2,2,0,4
20643,40,6624,8840,10220,0,0,1,0,1
20644,40,6628,10041;10326;13947;14195;14395,10220,0,3,2,0,5
20645,40,6633,9825;9998,10220,0,0,2,0,2
20646,40,6634,9037;10011;13641;13875;14329,10220,0,3,2,0,5
20647,40,6636,10185;13608;13718,10220,0,2,1,0,3
20648,40,6637,10611;10678;14687;15077,10220,2,0,2,0,4
20649,40,6639,10288;10630;13534;14613,10220,1,1,2,0,4
20650,40,6640,10160;10337;13549;14078;14675,10220,1,2,2,0,5
20651,40,6641,10147,10220,0,0,1,0,1
20652,40,6642,10267;10359;14054;14368;14763;15164,10220,2,2,2,0,6
20653,40,6644,10461,10220,0,0,1,0,1
20654,40,6645,10482;11078;12480;13689;13945;15125,10220,1,2,3,0,6
20655,40,6647,10517;10520;13968;15003,10220,1,1,2,0,4
20656,40,6649,10393;10552;13684;14012,10220,0,2,2,0,4
20657,40,6650,10580;10756;13774;14642,10220,1,1,2,0,4
20658,40,6651,10400;10581;14229;14713;14901,10220,2,1,2,0,5
20659,40,6652,10478;10636;13603;15010,10220,1,1,2,0,4
20660,40,6653,10638;10883;13812;14222;14605,10220,1,2,2,0,5
20661,40,6654,10668;14095;14635;14946,10220,2,1,1,0,4
20662,40,6655,10980;13697;14331,10220,0,2,1,0,3
20663,40,6656,10732;10912;13791;14233;14991,10220,1,2,2,0,5
20664,40,6657,10766;10937;13565;13980,10220,0,2,2,0,4
20665,40,6658,10564;10779;13926;14659;15199,10220,2,1,2,0,5
20666,40,6659,10794;13662;13719;15188,10220,1,2,1,0,4
20667,40,6660,10562;10796;14043;14525,10220,0,2,2,0,4
20668,40,6661,10683;10806;14168;14505,10220,0,2,2,0,4
20669,40,6662,10634;10807;13793;14638,10220,1,1,2,0,4
20670,40,6663,10446;10810;13759;13845,10220,0,2,2,0,4
20671,40,6664,10718;10876;14292;14483,10220,0,2,2,0,4
20672,40,6665,10995;11410;13593;13902;14037;14755,10220,1,3,2,0,6
20673,40,6666,10740;10942;13846;14302;15012,10220,1,2,2,0,5
20674,40,6667,11062;14503;15074,10220,1,1,1,0,3
20675,40,6668,10946;10991;13931;14388;14987;15134,10220,2,2,2,0,6
20676,40,6669,10727;11041;13590;15171,10220,1,1,2,0,4
20677,40,6670,11013;13571;13978;14631;14862,10220,2,2,1,0,5
20678,40,6671,11017;11205;14280;14819,10220,1,1,2,0,4
20679,40,6672,11027;11247;13533;13958;15120,10220,1,2,2,0,5
20680,40,6673,11035;11122;14624;15060,10220,2,0,2,0,4
20681,40,6674,10687;11051;15063,10220,1,0,2,0,3
20682,40,6675,11073;11102;14155;14835,10220,1,1,2,0,4
20683,40,6676,11081;11192;13629;13985,10220,0,2,2,0,4
20684,40,6677,11253;13671;14172;14604,10220,1,2,1,0,4
20685,40,6678,93,10585,0,0,1,0,1
20686,40,6679,617;7801,10585,0,0,2,0,2
20687,40,6681,740;10248;13974;14118,10585,0,2,2,0,4
20688,40,6686,1699;7920,10585,0,0,2,0,2
20689,40,6689,170;4956,10585,0,0,2,0,2
20690,40,6692,4477,10585,0,0,0,1,1
20691,40,6693,4525,10585,0,0,0,1,1
20692,40,6694,4939;8382,10585,0,0,2,0,2
20693,40,6697,361;760,10585,0,0,2,0,2
20694,40,6698,8902,10585,0,0,1,0,1
20695,40,6699,10139;13775;14572,10585,1,1,1,0,3
20696,40,6701,6561,10585,0,0,1,0,1
20697,40,6702,6612,10585,0,0,1,0,1
20698,40,6706,3342,10585,0,0,0,1,1
20699,40,6707,7350,10585,0,0,0,1,1
20700,40,6709,182;9513;13970,10585,0,1,2,0,3
20701,40,6710,2751;8057;13823;14317,10585,0,2,2,0,4
20702,40,6711,6974,10585,0,0,1,0,1
20703,40,6713,3117,10585,0,0,1,0,1
20704,40,6715,2468,10585,0,0,1,0,1
20705,40,6717,10087;10443;13782;14673,10585,1,1,2,0,4
20706,40,6718,10177;13982;14306,10585,0,2,1,0,3
20707,40,6719,10129;10225;13683;14397,10585,0,2,2,0,4
20708,40,6720,10317;10369;14488;14668,10585,1,1,2,0,4
20709,40,6721,10231;10283;13706;14109,10585,0,2,2,0,4
20710,40,6722,1432,10585,0,0,1,0,1
20711,40,6724,10290;10316;13672;14459,10585,0,2,2,0,4
20712,40,6725,10571;10986;13778;14646,10585,1,1,2,0,4
20713,40,6726,10402;10626;13991;14369;14856,10585,1,2,2,0,5
20714,40,6727,10405;10504;13856;14517;14786,10585,1,2,2,0,5
20715,40,6728,10410;14075;14236;15107,10585,1,2,1,0,4
20716,40,6729,10417;10979;14681,10585,1,0,2,0,3
20717,40,6730,10152;10458;13961;14315;14950,10585,1,2,2,0,5
20718,40,6731,10462;10816;14143;14543;15104,10585,2,1,2,0,5
20719,40,6732,10577;14342;14782,10585,1,1,1,0,3
20720,40,6733,10123;10354;14373;14752,10585,1,1,2,0,4
20721,40,6734,10376;10829;14123;15086;15109,10585,2,1,2,0,5
20722,40,6735,10301;10716;14707;15227,10585,2,0,2,0,4
20723,40,6736,10723;10870;13880;14585,10585,1,1,2,0,4
20724,40,6737,10731;10828;14286;15202,10585,1,1,2,0,4
20725,40,6738,10767;11191;14377;14960,10585,1,1,2,0,4
20726,40,6739,10733;13814;14241;14458,10585,0,3,1,0,4
20727,40,6742,10888;11106;13732;14256,10585,0,2,2,0,4
20728,40,6743,11043;13821;14765,10585,1,1,1,0,3
20729,40,6744,10917;11217;13685;13949;15226,10585,1,2,2,0,5
20730,40,6745,10608;10970;14068;14122;14441,10585,0,3,2,0,5
20731,40,6746,10355;10985;14323;14408;14859,10585,1,2,2,0,5
20732,40,6747,10833;11018;14099,10585,0,1,2,0,3
20733,40,6748,10762;11032;14282;14606;15096,10585,2,1,2,0,5
20734,40,6749,10931;11039;14321;14746,10585,1,1,2,0,4
20735,40,6750,11237;13754;14175,10585,0,2,1,0,3
20736,40,6751,11070;13766;14532,10585,1,1,1,0,3
20737,40,6752,10827;11141;14690,10585,1,0,2,0,3
20738,40,6753,11146;11215;14490;14560,10585,1,1,2,0,4
20739,40,6754,11497;13688;14303;14456;15052,10585,1,3,1,0,5
20740,40,6755,11055;11152;13830;14382;14912,10585,1,2,2,0,5
20741,40,6756,11164;11411;13701;14009;14937,10585,1,2,2,0,5
20742,40,6757,11185;13916;14005;14137,10585,0,3,1,0,4
20743,40,6758,11121;11206;14588;14847,10585,2,0,2,0,4
20744,40,6759,11156;11209;14534,10585,1,0,2,0,3
20745,40,6760,63,10950,0,0,0,1,1
20746,40,6761,2246,10950,0,0,1,0,1
20747,40,6765,1111;9616,10950,0,0,2,0,2
20748,40,6767,2356,10950,0,0,1,0,1
20749,40,6770,1565;10412;14352;14580,10950,1,1,2,0,4
20750,40,6771,1598,10950,0,0,0,1,1
20751,40,6774,2032;3679;13740;13870;14379,10950,0,3,2,0,5
20752,40,6779,48;3349,10950,0,0,2,0,2
20753,40,6785,2524,10950,0,0,1,0,1
20754,40,6789,6801,10950,0,0,0,1,1
20755,40,6790,10049;10266;13764;14347,10950,0,2,2,0,4
20756,40,6791,1890,10950,0,0,1,0,1
20757,40,6793,5244,10950,0,0,1,0,1
20758,40,6794,6560;8839;14025,10950,0,1,2,0,3
20759,40,6795,9117,10950,0,0,1,0,1
20760,40,6796,7009,10950,0,0,0,1,1
20761,40,6797,9362,10950,0,0,0,1,1
20762,40,6799,9620,10950,0,0,1,0,1
20763,40,6802,10032;10136;13935;14117,10950,0,2,2,0,4
20764,40,6803,10193,10950,0,0,1,0,1
20765,40,6804,6911,10950,0,0,1,0,1
20766,40,6805,2729,10950,0,0,1,0,1
20767,40,6806,10165;10322;13865;14004,10950,0,2,2,0,4
20768,40,6807,10166;10385;13932;14161;14425,10950,0,3,2,0,5
20769,40,6808,10263;10437;14237;14592,10950,1,1,2,0,4
20770,40,6809,10061;10426;14200;14394,10950,0,2,2,0,4
20771,40,6810,10499,10950,0,0,1,0,1
20772,40,6811,10503;14031;15025,10950,1,1,1,0,3
20773,40,6812,10525;14485;14873,10950,1,1,1,0,3
20774,40,6816,10597;11069;14415,10950,0,1,2,0,3
20775,40,6817,10430;10616;13938,10950,0,1,2,0,3
20776,40,6818,10693,10950,0,0,1,0,1
20777,40,6819,10514;11061;14639;15083,10950,2,0,2,0,4
20778,40,6820,10712;14577;15101,10950,2,0,1,0,3
20779,40,6822,11276;11466,10950,0,0,2,0,2
20780,40,6823,10764;10997;13948;14138;14696,10950,1,2,2,0,5
20781,40,6824,10793;10886;15165,10950,1,0,2,0,3
20782,40,6825,10808;10823;14506,10950,0,1,2,0,3
20783,40,6826,10814;10835;14082,10950,0,1,2,0,3
20784,40,6827,10839;11009;13911;14424,10950,0,2,2,0,4
20785,40,6828,10903;11108;14561,10950,1,0,2,0,3
20786,40,6829,10914;11063;15154,10950,1,0,2,0,3
20787,40,6830,11484;14383;14753,10950,1,1,1,0,3
20788,40,6831,10926;11269;13906;14184;14559,10950,1,2,2,0,5
20789,40,6832,10932;14158,10950,0,1,1,0,2
20790,40,6833,10982;11074;14793,10950,1,0,2,0,3
20791,40,6835,10747;11127;14130;14579,10950,1,1,2,0,4
20792,40,6836,10696;10902;14290;14406,10950,0,2,2,0,4
20793,40,6837,11019;11047;14044,10950,0,1,2,0,3
20794,40,6838,10957;11023;13976;15224,10950,1,1,2,0,4
20795,40,6839,11037;11135;14081;14334,10950,0,2,2,0,4
20796,40,6840,11059;13857;15117,10950,1,1,1,0,3
20797,40,6841,11054;11566;13893,10950,0,1,2,0,3
20798,40,6842,10367;11083;13864;14269,10950,0,2,2,0,4
20799,40,6843,11100;11404;14083;14447,10950,0,2,2,0,4
20800,40,6844,11103;11194;14120;14442;15030,10950,1,2,2,0,5
20801,40,6845,11114,10950,0,0,1,0,1
20802,40,6846,11124;11339;14785;15136,10950,2,0,2,0,4
20803,40,6847,11129;13914;14448,10950,0,2,1,0,3
20804,40,6848,11160;11230;14990,10950,1,0,2,0,3
20805,40,6849,11171;11526;13878;14294,10950,0,2,2,0,4
20806,40,6850,11173;11413;13883;14191;14731,10950,1,2,2,0,5
20807,40,6851,11344;11798;13834;14275;14796,10950,1,2,2,0,5
20808,40,6852,10785;11266,10950,0,0,2,0,2
20809,40,6853,10909;11196;13973;15138,10950,1,1,2,0,4
20810,40,6854,11201;11629;14057;15072,10950,1,1,2,0,4
20811,40,6855,11204;11377;14208;14583;14871,10950,2,1,2,0,5
20812,40,6856,11228;11543;14149,10950,0,1,2,0,3
20813,40,6857,11243;14438;15026;15161,10950,2,1,1,0,4
20814,40,6858,11090;11184;15018,10950,1,0,2,0,3
20815,40,6859,11256;11527;13816;14623;14831;14994;15146,10950,4,1,2,0,7
20816,40,6860,11258;11394;14358,10950,0,1,2,0,3
20817,40,6861,11056;11233;14890,10950,1,0,2,0,3
20818,40,6862,11272;11293;14304;14647,10950,1,1,2,0,4
20819,40,6863,11366;11467;14403,10950,0,1,2,0,3
20820,40,6864,10752;11025;14614,10950,1,0,2,0,3
20821,40,6865,11277;11442;14058,10950,0,1,2,0,3
20822,40,6866,11282;11444;15131,10950,1,0,2,0,3
20823,40,6867,11303;11378;14800;14881,10950,2,0,2,0,4
20824,40,6868,11305;11450;13815;14550,10950,1,1,2,0,4
20825,40,6869,11096;11315;14113;14454;15157,10950,1,2,2,0,5
20826,40,6870,10868;11324;15053,10950,1,0,2,0,3
20827,40,6871,2576;9510,11315,0,0,2,0,2
20828,40,6876,1952,11315,0,0,0,1,1
20829,40,6877,1963,11315,0,0,1,0,1
20830,40,6879,2815,11315,0,0,1,0,1
20831,40,6880,2422,11315,0,0,0,1,1
20832,40,6882,8643,11315,0,0,1,0,1
20833,40,6884,2300;4960,11315,0,0,2,0,2
20834,40,6886,839,11315,0,0,1,0,1
20835,40,6887,3239;7926,11315,0,0,2,0,2
20836,40,6888,4210;6098,11315,0,0,2,0,2
20837,40,6889,8877,11315,0,0,1,0,1
20838,40,6890,4938;6827,11315,0,0,0,2,2
20839,40,6891,5245,11315,0,0,1,0,1
20840,40,6893,5659;6369,11315,0,0,2,0,2
20841,40,6895,6348;10085;13933;14656,11315,1,1,2,0,4
20842,40,6896,9007,11315,0,0,1,0,1
20843,40,6897,3407,11315,0,0,1,0,1
20844,40,6902,8336,11315,0,0,1,0,1
20845,40,6903,8426,11315,0,0,0,1,1
20846,40,6904,8184,11315,0,0,0,1,1
20847,40,6905,7871;8797,11315,0,0,2,0,2
20848,40,6907,3540,11315,0,0,1,0,1
20849,40,6909,10544;10651;14110;14657,11315,1,1,2,0,4
20850,40,6911,10149;10729;14432;15169,11315,1,1,2,0,4
20851,40,6913,10039;10205;13965;14399,11315,0,2,2,0,4
20852,40,6915,10373;10563;14279,11315,0,1,2,0,3
20853,40,6916,10423;10882;14371;14714,11315,1,1,2,0,4
20854,40,6917,10425;10824;15145,11315,1,0,2,0,3
20855,40,6918,10428;10923;14602,11315,1,0,2,0,3
20856,40,6919,10235;10472;14552;14705,11315,2,0,2,0,4
20857,40,6920,10649;10783;14059;14370;14928,11315,1,2,2,0,5
20858,40,6921,10492;10701;14717;14899,11315,2,0,2,0,4
20859,40,6922,10508;11143;14003;14244,11315,0,2,2,0,4
20860,40,6924,10555;14030;14864,11315,1,1,1,0,3
20861,40,6925,10894;14722,11315,1,0,1,0,2
20862,40,6927,10774;14554,11315,1,0,1,0,2
20863,40,6928,10776;15168,11315,1,0,1,0,2
20864,40,6929,10791;10857;14940;14977,11315,2,0,2,0,4
20865,40,6930,10797;10885;14893,11315,1,0,2,0,3
20866,40,6931,10536;10811;15187,11315,1,0,2,0,3
20867,40,6932,10840;14283,11315,0,1,1,0,2
20868,40,6933,10858;10864;14366,11315,0,1,2,0,3
20869,40,6934,10862;10981;14453;14963,11315,1,1,2,0,4
20870,40,6935,10855;10863;15123,11315,1,0,2,0,3
20871,40,6936,11031;14575,11315,1,0,1,0,2
20872,40,6937,11514,11315,0,0,1,0,1
20873,40,6938,10775;10963,11315,0,0,2,0,2
20874,40,6939,10992;11301;14959,11315,1,0,2,0,3
20875,40,6940,11002;11295,11315,0,0,2,0,2
20876,40,6941,11049;14176,11315,0,1,1,0,2
20877,40,6943,11053;11180;14886,11315,1,0,2,0,3
20878,40,6944,11068;11086;15140,11315,1,0,2,0,3
20879,40,6945,11098;14008;14141,11315,0,2,1,0,3
20880,40,6946,10173;10224;14344;14499,11315,0,2,2,0,4
20881,40,6947,11120;14177;14666,11315,1,1,1,0,3
20882,40,6948,11026;11130;14526,11315,0,1,2,0,3
20883,40,6949,11132;11224;14558;15045,11315,2,0,2,0,4
20884,40,6950,11145;11582;14154;14495;15016,11315,1,2,2,0,5
20885,40,6951,10596;11150;14305;14882,11315,1,1,2,0,4
20886,40,6952,11163;11236,11315,0,0,2,0,2
20887,40,6953,11167;11482;14069,11315,0,1,2,0,3
20888,40,6954,10990;11181;14414;14743,11315,1,1,2,0,4
20889,40,6955,11040;11187;14828;15195,11315,2,0,2,0,4
20890,40,6956,11207;11538;14007;14461;14692,11315,1,2,2,0,5
20891,40,6958,11264,11315,0,0,1,0,1
20892,40,6959,11234;11373;14431;14715;14947,11315,2,1,2,0,5
20893,40,6960,10954;11268;14463;14748,11315,1,1,2,0,4
20894,40,6961,11308;11401;15196,11315,1,0,2,0,3
20895,40,6962,11311;14832;15099,11315,2,0,1,0,3
20896,40,6963,11314;11459;13988;14243;14679,11315,1,2,2,0,5
20897,40,6964,11336;11428;14186;14651,11315,1,1,2,0,4
20898,40,6965,11342;11697;14421,11315,0,1,2,0,3
20899,40,6966,11174;11289;14889;15011,11315,2,0,2,0,4
20900,40,6967,11080;11346;14062;14894,11315,1,1,2,0,4
20901,40,6968,11351;11719,11315,0,0,2,0,2
20902,40,6969,11321;11359;14190;15192,11315,1,1,2,0,4
20903,40,6970,11364;11698;14020,11315,0,1,2,0,3
20904,40,6971,11223;11382;14848;15091,11315,2,0,2,0,4
20905,40,6972,11399;11700;14764,11315,1,0,2,0,3
20906,40,6973,11407;11432;14071;14600;15007,11315,2,1,2,0,5
20907,40,6975,10026;10156;13999;14429,11680,0,2,2,0,4
20908,40,6976,546,11680,0,0,1,0,1
20909,40,6978,5314;6652,11680,0,0,2,0,2
20910,40,6981,1596,11680,0,0,0,1,1
20911,40,6986,1084,11680,0,0,1,0,1
20912,40,6987,2893,11680,0,0,1,0,1
20913,40,6989,3507;6252;14313,11680,0,1,2,0,3
20914,40,6991,3963;7709,11680,0,0,2,0,2
20915,40,6993,1671;5278,11680,0,0,2,0,2
20916,40,6994,6504,11680,0,0,0,1,1
20917,40,6997,7390,11680,0,0,0,1,1
20918,40,6998,7416,11680,0,0,1,0,1
20919,40,6999,1179,11680,0,0,0,1,1
20920,40,7003,9221,11680,0,0,1,0,1
20921,40,7004,9257,11680,0,0,1,0,1
20922,40,7005,9435,11680,0,0,0,1,1
20923,40,7008,8701;10524;14309;14649;14708,11680,2,1,2,0,5
20924,40,7009,10300;10750;14962;15153,11680,2,0,2,0,4
20925,40,7010,10349;10453;14159;14655,11680,1,1,2,0,4
20926,40,7011,10533;11227;14197;14836;15062,11680,2,1,2,0,5
20927,40,7012,10550,11680,0,0,1,0,1
20928,40,7013,11087;14205;14489,11680,0,2,1,0,3
20929,40,7014,10404;10420;14533;14662,11680,2,0,2,0,4
20930,40,7016,10589;10929;14192;14288,11680,0,2,2,0,4
20931,40,7017,10588;10609;14411,11680,0,1,2,0,3
20932,40,7018,11162;11440;14460;14807;14995,11680,2,1,2,0,5
20933,40,7019,10442,11680,0,0,1,0,1
20934,40,7020,10660;10741;14108;14932,11680,1,1,2,0,4
20935,40,7021,10705;10953;14504,11680,0,1,2,0,3
20936,40,7022,10646;10707;14992,11680,1,0,2,0,3
20937,40,7023,10780;14274;14444;15005,11680,1,2,1,0,4
20938,40,7024,10867;10872;14088;14364,11680,0,2,2,0,4
20939,40,7025,11006;11248,11680,0,0,2,0,2
20940,40,7026,11008;11375;14513;15163,11680,1,1,2,0,4
20941,40,7027,11089;11134;14546;14691,11680,2,0,2,0,4
20942,40,7028,11094;11323;14105;14467;14888,11680,1,2,2,0,5
20943,40,7029,10989,11680,0,0,1,0,1
20944,40,7030,11109;11172;14654,11680,1,0,2,0,3
20945,40,7031,11119;11575;14183;14892,11680,1,1,2,0,4
20946,40,7032,10935,11680,0,0,1,0,1
20947,40,7033,10947;11159;14885,11680,1,0,2,0,3
20948,40,7034,11197;11347;14129;14784;15049,11680,2,1,2,0,5
20949,40,7035,11229;11244;15065,11680,1,0,2,0,3
20950,40,7036,11807;14217;14810;14923,11680,2,1,1,0,4
20951,40,7037,10948,11680,0,0,1,0,1
20952,40,7038,11242;11361;15032,11680,1,0,2,0,3
20953,40,7039,11306;11615;14106;14934,11680,1,1,2,0,4
20954,40,7040,11329;11657;14093;14380;14545;15079,11680,2,2,2,0,6
20955,40,7041,11348;11673;14276;14798;15160,11680,2,1,2,0,5
20956,40,7042,11125;11370;14699,11680,1,0,2,0,3
20957,40,7043,11384;11704;14339;14500;14529;14732,11680,2,2,2,0,6
20958,40,7044,11434;11439;14944;15019,11680,2,0,2,0,4
20959,40,7045,11421;11455;14133;14549;15182,11680,2,1,2,0,5
20960,40,7046,11240;11468,11680,0,0,2,0,2
20961,40,7047,11328;11489;14127;15015,11680,1,1,2,0,4
20962,40,7048,11707;11835;14193,11680,0,1,2,0,3
20963,40,7049,11509;11740;14407,11680,0,1,2,0,3
20964,40,7050,11511;11650;14418,11680,0,1,2,0,3
20965,40,7054,4828,12045,0,0,1,0,1
20966,40,7055,774;803;14226;14259,12045,0,2,2,0,4
20967,40,7057,3717,12045,0,0,1,0,1
20968,40,7059,132,12045,0,0,0,1,1
20969,40,7060,236,12045,0,0,0,1,1
20970,40,7062,2818;8150;14954,12045,1,0,2,0,3
20971,40,7064,847;3268,12045,0,0,1,1,2
20972,40,7067,3469;9388,12045,0,0,2,0,2
20973,40,7068,3690;4436,12045,0,0,2,0,2
20974,40,7069,3831,12045,0,0,0,1,1
20975,40,7072,5962,12045,0,0,1,0,1
20976,40,7073,4806;8617,12045,0,0,2,0,2
20977,40,7081,6480;7972,12045,0,0,2,0,2
20978,40,7083,7121,12045,0,0,1,0,1
20979,40,7084,7222,12045,0,0,1,0,1
20980,40,7085,4075,12045,0,0,1,0,1
20981,40,7086,853,12045,0,0,1,0,1
20982,40,7087,9826,12045,0,0,1,0,1
20983,40,7088,8267,12045,0,0,1,0,1
20984,40,7089,8539,12045,0,0,1,0,1
20985,40,7090,6212,12045,0,0,1,0,1
20986,40,7093,9455,12045,0,0,1,0,1
20987,40,7095,8747,12045,0,0,1,0,1
20988,40,7096,4221,12045,0,0,1,0,1
20989,40,7097,10128;10214;14362;14612,12045,1,1,2,0,4
20990,40,7098,10137;10260;14251;14780,12045,1,1,2,0,4
20991,40,7099,10303;10304;14700;14818;15094,12045,3,0,2,0,5
20992,40,7100,10345;10579;14231,12045,0,1,2,0,3
20993,40,7102,10473;10966;14927,12045,1,0,2,0,3
20994,40,7103,10546;14264;14729,12045,1,1,1,0,3
20995,40,7104,10549;10637;14779;15102,12045,2,0,2,0,4
20996,40,7106,10368;14480;14674;15004,12045,2,1,1,0,4
20997,40,7107,10521;10628;14230;15028,12045,1,1,2,0,4
20998,40,7108,10632;10905;14404;14566,12045,1,1,2,0,4
20999,40,7109,10584;10831;14902,12045,1,0,2,0,3
21000,40,7110,10644;10836;14487;15112,12045,1,1,2,0,4
21001,40,7111,10960;11452,12045,0,0,2,0,2
21002,40,7112,10761;11033;15205,12045,1,0,2,0,3
21003,40,7114,10684;11091;14754,12045,1,0,2,0,3
21004,40,7115,11104;11288;14839;15127,12045,2,0,2,0,4
21005,40,7116,10765;11522;15212,12045,1,0,2,0,3
21006,40,7117,11144;11478;14571,12045,1,0,2,0,3
21007,40,7118,10648,12045,0,0,1,0,1
21008,40,7119,11189;11211;14863;15219,12045,2,0,2,0,4
21009,40,7120,11028;11200;14245;15197,12045,1,1,2,0,4
21010,40,7121,11203;11493,12045,0,0,2,0,2
21011,40,7122,11225;11743;15068,12045,1,0,2,0,3
21012,40,7123,10802;11255,12045,0,0,2,0,2
21013,40,7124,10892;11259,12045,0,0,2,0,2
21014,40,7125,11274;12125,12045,0,0,2,0,2
21015,40,7126,11280;11507;14255;14381;15228,12045,1,2,2,0,5
21016,40,7127,10890;11338;14322;14405;14841,12045,1,2,2,0,5
21017,40,7128,11317;14725;14869,12045,2,0,1,0,3
21018,40,7129,10771;11322;15093,12045,1,0,2,0,3
21019,40,7130,11356;11703;14330,12045,0,1,2,0,3
21020,40,7131,11379;11834;14611,12045,1,0,2,0,3
21021,40,7132,11015;11393;14359,12045,0,1,2,0,3
21022,40,7133,11065;11400;14228,12045,0,1,2,0,3
21023,40,7134,11821;14471,12045,0,1,1,0,2
21024,40,7135,11221;11453;14667;15122,12045,2,0,2,0,4
21025,40,7136,11464;11633,12045,0,0,2,0,2
21026,40,7137,11389;11470;14970,12045,1,0,2,0,3
21027,40,7138,11471;11499;14384;14827,12045,1,1,2,0,4
21028,40,7139,11505;11523,12045,0,0,2,0,2
21029,40,7140,11534;14326,12045,0,1,1,0,2
21030,40,7141,11533;11786;14232;14695,12045,1,1,2,0,4
21031,40,7142,11583;11594;14826,12045,1,0,2,0,3
21032,40,7143,11448;11588;14593,12045,1,0,2,0,3
21033,40,7144,11591;11884;14248;14650,12045,1,1,2,0,4
21034,40,7145,11600;11771;14412,12045,0,1,2,0,3
21035,40,7146,11343;11601;14291,12045,0,1,2,0,3
21036,40,7147,1906,12410,0,0,1,0,1
21037,40,7150,6390;9401,12410,0,0,2,0,2
21038,40,7151,721,12410,0,0,1,0,1
21039,40,7153,1803,12410,0,0,1,0,1
21040,40,7155,2839,12410,0,0,1,0,1
21041,40,7157,1165;2279,12410,0,0,2,0,2
21042,40,7158,3776;4748,12410,0,0,2,0,2
21043,40,7160,7428,12410,0,0,0,1,1
21044,40,7161,4434;9184,12410,0,0,1,1,2
21045,40,7168,5901;9046,12410,0,0,2,0,2
21046,40,7170,6054,12410,0,0,1,0,1
21047,40,7172,6643,12410,0,0,0,1,1
21048,40,7173,6296,12410,0,0,1,0,1
21049,40,7174,5742;7802,12410,0,0,2,0,2
21050,40,7176,7373,12410,0,0,1,0,1
21051,40,7177,622;7399,12410,0,0,1,1,2
21052,40,7178,1472;7405,12410,0,0,2,0,2
21053,40,7180,7819,12410,0,0,1,0,1
21054,40,7184,1468;8681,12410,0,0,2,0,2
21055,40,7185,4931;8744,12410,0,0,2,0,2
21056,40,7186,8932,12410,0,0,1,0,1
21057,40,7187,9043,12410,0,0,1,0,1
21058,40,7189,5671,12410,0,0,0,1,1
21059,40,7190,4199,12410,0,0,0,1,1
21060,40,7191,10015,12410,0,0,1,0,1
21061,40,7192,10107;11030;14563,12410,1,0,2,0,3
21062,40,7193,10285;10620;14636,12410,1,0,2,0,3
21063,40,7195,4867,12410,0,0,1,0,1
21064,40,7196,11281;14808;15022,12410,2,0,1,0,3
21065,40,7197,10243,12410,0,0,1,0,1
21066,40,7198,8612,12410,0,0,1,0,1
21067,40,7199,10334,12410,0,0,1,0,1
21068,40,7200,10103,12410,0,0,1,0,1
21069,40,7201,10539;10689;14804,12410,1,0,2,0,3
21070,40,7202,10559;11029,12410,0,0,2,0,2
21071,40,7203,10351,12410,0,0,1,0,1
21072,40,7205,10594;10974;15095,12410,1,0,2,0,3
21073,40,7207,10643;11312,12410,0,0,2,0,2
21074,40,7208,10706;10778;14747;15200,12410,2,0,2,0,4
21075,40,7209,10751;11022;14523;15006,12410,1,1,2,0,4
21076,40,7210,10308,12410,0,0,1,0,1
21077,40,7211,10787;10936;14951,12410,1,0,2,0,3
21078,40,7212,10812,12410,0,0,1,0,1
21079,40,7213,10323;10850;14457;15084,12410,1,1,2,0,4
21080,40,7214,10897,12410,0,0,1,0,1
21081,40,7215,11088;14521,12410,0,1,1,0,2
21082,40,7216,11003;11524;14625;14906,12410,2,0,2,0,4
21083,40,7217,11012;11488;15158,12410,1,0,2,0,3
21084,40,7218,10969;14542,12410,1,0,1,0,2
21085,40,7219,11092;11131;14921,12410,1,0,2,0,3
21086,40,7220,11044;11099;14858;15184,12410,2,0,2,0,4
21087,40,7221,11349;14597,12410,1,0,1,0,2
21088,40,7222,11169;11687;14392,12410,0,1,2,0,3
21089,40,7223,11182;11457;14844;15115,12410,2,0,2,0,4
21090,40,7225,11007;11218;14466,12410,0,1,2,0,3
21091,40,7226,11220;11512;15021,12410,1,0,2,0,3
21092,40,7227,11273;11392;14845;15230,12410,2,0,2,0,4
21093,40,7228,11279;14757;15088,12410,2,0,1,0,3
21094,40,7229,11298;11416,12410,0,0,2,0,2
21095,40,7230,11331;11367;14719,12410,1,0,2,0,3
21096,40,7231,11291;11571,12410,0,0,2,0,2
21097,40,7232,10924;11341;14386,12410,0,1,2,0,3
21098,40,7233,11358;11463;14925,12410,1,0,2,0,3
21099,40,7234,11319;11371;14740;14983,12410,2,0,2,0,4
21100,40,7235,11386;11420,12410,0,0,2,0,2
21101,40,7236,10860;11235,12410,0,0,2,0,2
21102,40,7237,11438;12053;14734;14852;15106,12410,3,0,2,0,5
21103,40,7238,11147,12410,0,0,1,0,1
21104,40,7239,11502;15110,12410,1,0,1,0,2
21105,40,7240,11518,12410,0,0,1,0,1
21106,40,7241,11537;11541;14897,12410,1,0,2,0,3
21107,40,7242,11546;11757;14402,12410,0,1,2,0,3
21108,40,7243,11553;11570;14972,12410,1,0,2,0,3
21109,40,7244,11558;11938;14791,12410,1,0,2,0,3
21110,40,7245,11397;11567,12410,0,0,2,0,2
21111,40,7246,11577;11795,12410,0,0,2,0,2
21112,40,7247,11460;11578;14547;14803,12410,2,0,2,0,4
21113,40,7248,11590;12128;14739;15073,12410,2,0,2,0,4
21114,40,7249,11618;11680;14678,12410,1,0,2,0,3
21115,40,7250,11620;15033,12410,1,0,1,0,2
21116,40,7251,11628;11688;14770,12410,1,0,2,0,3
21117,40,7252,11982;14389;14661,12410,1,1,1,0,3
21118,40,7253,11713;14443,12410,0,1,1,0,2
21119,40,7254,11490;11722,12410,0,0,2,0,2
21120,40,7255,11564;11725;14374;14590,12410,1,1,2,0,4
21121,40,7256,11663;11738;14491,12410,0,1,2,0,3
21122,40,7257,11747;12098;14481,12410,0,1,2,0,3
21123,40,7258,470,12775,0,0,1,0,1
21124,40,7261,1191,12775,0,0,1,0,1
21125,40,7262,1583,12775,0,0,1,0,1
21126,40,7267,2910,12775,0,0,1,0,1
21127,40,7268,7257,12775,0,0,1,0,1
21128,40,7269,8407,12775,0,0,1,0,1
21129,40,7270,8862;10501;14565;15078,12775,2,0,2,0,4
21130,40,7272,4757;9231,12775,0,0,2,0,2
21131,40,7273,4571,12775,0,0,1,0,1
21132,40,7274,793,12775,0,0,1,0,1
21133,40,7275,3161,12775,0,0,1,0,1
21134,40,7277,9166,12775,0,0,1,0,1
21135,40,7278,6159,12775,0,0,1,0,1
21136,40,7279,6238;7410,12775,0,0,2,0,2
21137,40,7280,5941,12775,0,0,0,1,1
21138,40,7284,8132,12775,0,0,1,0,1
21139,40,7285,8337,12775,0,0,1,0,1
21140,40,7286,8843,12775,0,0,0,1,1
21141,40,7288,1134,12775,0,0,1,0,1
21142,40,7290,1619,12775,0,0,1,0,1
21143,40,7291,10153,12775,0,0,1,0,1
21144,40,7292,10249,12775,0,0,1,0,1
21145,40,7293,10348,12775,0,0,1,0,1
21146,40,7294,10421,12775,0,0,1,0,1
21147,40,7296,10449,12775,0,0,1,0,1
21148,40,7297,10813;14964,12775,1,0,1,0,2
21149,40,7298,10702;10819;15080,12775,1,0,2,0,3
21150,40,7299,10826;10938;15092,12775,1,0,2,0,3
21151,40,7300,10848;11014;14952,12775,1,0,2,0,3
21152,40,7301,10854;11048,12775,0,0,2,0,2
21153,40,7303,10485;10715;14909,12775,1,0,2,0,3
21154,40,7304,10906;11095;14634;14680,12775,2,0,2,0,4
21155,40,7305,10925,12775,0,0,1,0,1
21156,40,7306,10987,12775,0,0,1,0,1
21157,40,7307,10844;11010;14824,12775,1,0,2,0,3
21158,40,7308,11036;11330;14658;14685,12775,2,0,2,0,4
21159,40,7309,10444;10675;14857;15156,12775,2,0,2,0,4
21160,40,7310,10908;11079;14586,12775,1,0,2,0,3
21161,40,7311,11136;11462;14979,12775,1,0,2,0,3
21162,40,7312,11139;11153;14694;15090,12775,2,0,2,0,4
21163,40,7313,11214,12775,0,0,1,0,1
21164,40,7314,11254;11283;14846;15173,12775,2,0,2,0,4
21165,40,7315,11263;11458;15031,12775,1,0,2,0,3
21166,40,7316,11310;11334;14704;15191,12775,2,0,2,0,4
21167,40,7317,11183;11340;14567;14829;15113,12775,3,0,2,0,5
21168,40,7318,11362,12775,0,0,1,0,1
21169,40,7319,11391;11731;14971,12775,1,0,2,0,3
21170,40,7320,11461;12121;14922,12775,1,0,2,0,3
21171,40,7321,11337;11480,12775,0,0,2,0,2
21172,40,7322,11219;11495;14531;14865,12775,2,0,2,0,4
21173,40,7323,10973;11498;14833;15002,12775,2,0,2,0,4
21174,40,7324,11742;14727,12775,1,0,1,0,2
21175,40,7325,11491;11519,12775,0,0,2,0,2
21176,40,7326,11530;11863,12775,0,0,2,0,2
21177,40,7327,11161;11531;14574,12775,1,0,2,0,3
21178,40,7328,11544;11648,12775,0,0,2,0,2
21179,40,7329,11611;11918;14733,12775,1,0,2,0,3
21180,40,7330,11598;11616;14776,12775,1,0,2,0,3
21181,40,7331,11644;15231,12775,1,0,1,0,2
21182,40,7332,11565;11653;14551,12775,1,0,2,0,3
21183,40,7333,11674;14759,12775,1,0,1,0,2
21184,40,7334,11699;11882;14619;14709;15043,12775,3,0,2,0,5
21185,40,7335,11525;11708;14802,12775,1,0,2,0,3
21186,40,7336,11573;11724;14589,12775,1,0,2,0,3
21187,40,7337,11151;11750;14815,12775,1,0,2,0,3
21188,40,7338,11759;12225;15027,12775,1,0,2,0,3
21189,40,7339,11761;11866;14595;14917;15137,12775,3,0,2,0,5
21190,40,7340,11772;12247;14609;14887;15057,12775,3,0,2,0,5
21191,40,7341,11790;12123;14603;14976,12775,2,0,2,0,4
21192,40,7342,11778;11805;14750,12775,1,0,2,0,3
21193,40,7343,11417,12775,0,0,1,0,1
21194,40,7344,11559;11837;14689;15222,12775,2,0,2,0,4
21195,40,7345,11858;12228;14870,12775,1,0,2,0,3
21196,40,7346,11640;11869;14980,12775,1,0,2,0,3
21197,40,7347,183,13140,0,0,1,0,1
21198,40,7348,383;10576;14587;14851,13140,2,0,2,0,4
21199,40,7350,3309,13140,0,0,1,0,1
21200,40,7351,6111,13140,0,0,1,0,1
21201,40,7353,3874,13140,0,0,1,0,1
21202,40,7354,2901,13140,0,0,1,0,1
21203,40,7356,3387,13140,0,0,1,0,1
21204,40,7357,9684,13140,0,0,1,0,1
21205,40,7358,7272,13140,0,0,0,1,1
21206,40,7361,3247,13140,0,0,1,0,1
21207,40,7362,4862,13140,0,0,1,0,1
21208,40,7363,5190,13140,0,0,1,0,1
21209,40,7365,6853,13140,0,0,0,1,1
21210,40,7370,8324,13140,0,0,1,0,1
21211,40,7371,9098;9720,13140,0,0,2,0,2
21212,40,7372,6143;9804,13140,0,0,2,0,2
21213,40,7373,4085;7141,13140,0,0,2,0,2
21214,40,7374,3266,13140,0,0,1,0,1
21215,40,7376,10106,13140,0,0,1,0,1
21216,40,7377,10058,13140,0,0,1,0,1
21217,40,7378,10216;10392;14702;14834,13140,2,0,2,0,4
21218,40,7381,4883;10413;14664;14958,13140,2,0,2,0,4
21219,40,7382,10325,13140,0,0,1,0,1
21220,40,7383,10293,13140,0,0,1,0,1
21221,40,7384,10543;10671;14744;14850,13140,2,0,2,0,4
21222,40,7385,10598,13140,0,0,1,0,1
21223,40,7386,10695;10958;14794;14825;15186,13140,3,0,2,0,5
21224,40,7387,10530,13140,0,0,1,0,1
21225,40,7389,10875;14985,13140,1,0,1,0,2
21226,40,7390,11024;15111,13140,1,0,1,0,2
21227,40,7391,10933;10949;14749;15056,13140,2,0,2,0,4
21228,40,7392,11004;11111;15055,13140,1,0,2,0,3
21229,40,7393,10736;11016;14982,13140,1,0,2,0,3
21230,40,7394,11057;11833;14787,13140,1,0,2,0,3
21231,40,7395,11058;11072;14760;14933,13140,2,0,2,0,4
21232,40,7396,11105;11551,13140,0,0,2,0,2
21233,40,7397,11107;14860,13140,1,0,1,0,2
21234,40,7398,11046;11133;15218,13140,1,0,2,0,3
21235,40,7399,11166;11326;15058;15139,13140,2,0,2,0,4
21236,40,7400,10891;11190;14751;15085,13140,2,0,2,0,4
21237,40,7401,11270;11550,13140,0,0,2,0,2
21238,40,7402,11405;11677;14801,13140,1,0,2,0,3
21239,40,7403,11409,13140,0,0,1,0,1
21240,40,7404,11436;11485;15190,13140,1,0,2,0,3
21241,40,7405,11465;14688;14926,13140,2,0,1,0,3
21242,40,7406,11503;11606,13140,0,0,2,0,2
21243,40,7407,11290;11515;14805,13140,1,0,2,0,3
21244,40,7408,11354;11535;15121,13140,1,0,2,0,3
21245,40,7409,11585,13140,0,0,1,0,1
21246,40,7410,11456;11614;14790,13140,1,0,2,0,3
21247,40,7411,11626;12246;14879;15135,13140,2,0,2,0,4
21248,40,7412,11646;11689;14911,13140,1,0,2,0,3
21249,40,7413,11651;12205,13140,0,0,2,0,2
21250,40,7414,11662;11969,13140,0,0,2,0,2
21251,40,7415,11302;11693;15151,13140,1,0,2,0,3
21252,40,7416,11602;11727;14896,13140,1,0,2,0,3
21253,40,7417,11728;11897;14775;14924,13140,2,0,2,0,4
21254,40,7418,11665;11935,13140,0,0,2,0,2
21255,40,7419,11774,13140,0,0,1,0,1
21256,40,7420,11784;12371;14761;15059,13140,2,0,2,0,4
21257,40,7421,11810;12131;14711;15067,13140,2,0,2,0,4
21258,40,7423,11664;11822;14768;15223,13140,2,0,2,0,4
21259,40,7424,11734;11825;15040,13140,1,0,2,0,3
21260,40,7425,11831;12101;14660;15009,13140,2,0,2,0,4
21261,40,7426,11844;12176;15132,13140,1,0,2,0,3
21262,40,7427,11849;12221;15070,13140,1,0,2,0,3
21263,40,7428,11887;12060,13140,0,0,2,0,2
21264,40,7429,11694;11889;14693,13140,1,0,2,0,3
21265,40,7430,11817;11900,13140,0,0,2,0,2
21266,40,7431,11540;11903,13140,0,0,2,0,2
21267,40,7432,11921,13140,0,0,1,0,1
21268,40,7433,11925;11937;14745,13140,1,0,2,0,3
21269,40,7434,11911;11926;15061,13140,1,0,2,0,3
21270,40,7435,11607;11932;14676;14820,13140,2,0,2,0,4
21271,40,7436,11752,13140,0,0,1,0,1
21272,40,7437,11957;12162;14814;15130,13140,2,0,2,0,4
21273,40,7438,11971;12000;14720;15152,13140,2,0,2,0,4
21274,40,7440,1251;9371,13505,0,0,2,0,2
21275,40,7441,1522,13505,0,0,1,0,1
21276,40,7442,1930,13505,0,0,1,0,1
21277,40,7443,5395,13505,0,0,1,0,1
21278,40,7444,2009,13505,0,0,1,0,1
21279,40,7445,2168,13505,0,0,1,0,1
21280,40,7446,4511,13505,0,0,1,0,1
21281,40,7447,3397,13505,0,0,1,0,1
21282,40,7449,3438,13505,0,0,1,0,1
21283,40,7450,1640,13505,0,0,1,0,1
21284,40,7451,1883;5662,13505,0,0,2,0,2
21285,40,7453,3716,13505,0,0,1,0,1
21286,40,7456,2878,13505,0,0,1,0,1
21287,40,7457,5308,13505,0,0,0,1,1
21288,40,7458,6653,13505,0,0,1,0,1
21289,40,7459,8268,13505,0,0,1,0,1
21290,40,7460,7000,13505,0,0,1,0,1
21291,40,7462,7237,13505,0,0,1,0,1
21292,40,7463,8892,13505,0,0,1,0,1
21293,40,7466,6861,13505,0,0,1,0,1
21294,40,7467,7534,13505,0,0,1,0,1
21295,40,7468,8854;9332,13505,0,0,2,0,2
21296,40,7471,6420;9951,13505,0,0,2,0,2
21297,40,7472,6202,13505,0,0,1,0,1
21298,40,7473,1837,13505,0,0,1,0,1
21299,40,7474,10034,13505,0,0,1,0,1
21300,40,7475,10238;10962;14811;15075,13505,2,0,2,0,4
21301,40,7477,10335,13505,0,0,1,0,1
21302,40,7478,10414;10490;14822,13505,1,0,2,0,3
21303,40,7479,10419,13505,0,0,1,0,1
21304,40,7481,10445,13505,0,0,1,0,1
21305,40,7482,10479,13505,0,0,1,0,1
21306,40,7483,10560;10878;14812,13505,1,0,2,0,3
21307,40,7484,10161;10592;14876;15217,13505,2,0,2,0,4
21308,40,7486,10939;10999;14821,13505,1,0,2,0,3
21309,40,7487,11000,13505,0,0,1,0,1
21310,40,7488,10800;11064;14853,13505,1,0,2,0,3
21311,40,7489,10843,13505,0,0,1,0,1
21312,40,7491,10605;11126;14816,13505,1,0,2,0,3
21313,40,7492,11138;11186;14830;15155,13505,2,0,2,0,4
21314,40,7493,11140;11332,13505,0,0,2,0,2
21315,40,7494,11075;11142;14929;14967,13505,2,0,2,0,4
21316,40,7495,11154,13505,0,0,1,0,1
21317,40,7496,11265,13505,0,0,1,0,1
21318,40,7497,11286,13505,0,0,1,0,1
21319,40,7498,11066;11292;14943;14993,13505,2,0,2,0,4
21320,40,7499,11307,13505,0,0,1,0,1
21321,40,7500,11357;12004,13505,0,0,2,0,2
21322,40,7501,11316;11408;14930,13505,1,0,2,0,3
21323,40,7502,11451;11860;14837,13505,1,0,2,0,3
21324,40,7503,11245;11474,13505,0,0,2,0,2
21325,40,7504,11246;11516;14843,13505,1,0,2,0,3
21326,40,7505,11554;11979,13505,0,0,2,0,2
21327,40,7506,11552;11581,13505,0,0,2,0,2
21328,40,7507,11599;12181;14931,13505,1,0,2,0,3
21329,40,7508,11939;11980,13505,0,0,2,0,2
21330,40,7509,11560;11627;14935,13505,1,0,2,0,3
21331,40,7510,11641;11684,13505,0,0,2,0,2
21332,40,7511,11643;11732,13505,0,0,2,0,2
21333,40,7512,11660;12203,13505,0,0,2,0,2
21334,40,7513,11672;11776;15051,13505,1,0,2,0,3
21335,40,7514,11427;11678,13505,0,0,2,0,2
21336,40,7515,11766;14916,13505,1,0,1,0,2
21337,40,7516,11788;12472;15162,13505,1,0,2,0,3
21338,40,7517,11569;11793;14941,13505,1,0,2,0,3
21339,40,7518,11875;12219,13505,0,0,2,0,2
21340,40,7519,11877;12342;15054;15141,13505,2,0,2,0,4
21341,40,7520,11880;11960;14855,13505,1,0,2,0,3
21342,40,7521,11893;12302;15214,13505,1,0,2,0,3
21343,40,7522,11894;12249,13505,0,0,2,0,2
21344,40,7523,11610;11896;15000,13505,1,0,2,0,3
21345,40,7524,11899;12324;15066,13505,1,0,2,0,3
21346,40,7525,11915;12167;14956,13505,1,0,2,0,3
21347,40,7526,11927;12346;14942;14988,13505,2,0,2,0,4
21348,40,7527,11941;12091,13505,0,0,2,0,2
21349,40,7528,11726;11955,13505,0,0,2,0,2
21350,40,7529,11961;14910,13505,1,0,1,0,2
21351,40,7530,11981,13505,0,0,1,0,1
21352,40,7531,11753;11987,13505,0,0,2,0,2
21353,40,7532,12376,13505,0,0,1,0,1
21354,40,7533,12018;12204,13505,0,0,2,0,2
21355,40,7534,11692;12065,13505,0,0,2,0,2
21356,40,7535,11751;12067,13505,0,0,2,0,2
21357,40,7536,12073;12392;15047,13505,1,0,2,0,3
21358,40,7537,12089;12093;15185,13505,1,0,2,0,3
21359,40,7538,11936;12099;14999;15229,13505,2,0,2,0,4
21360,40,7539,11769;12107;14849,13505,1,0,2,0,3
21361,40,7540,12120;12460;14913,13505,1,0,2,0,3
21362,40,7541,12124;12529,13505,0,0,2,0,2
21363,40,7542,488;7404,13870,0,0,2,0,2
21364,40,7543,3463,13870,0,0,1,0,1
21365,40,7544,1247,13870,0,0,1,0,1
21366,40,7547,65,13870,0,0,1,0,1
21367,40,7549,2975,13870,0,0,1,0,1
21368,40,7550,3177;3198,13870,0,0,2,0,2
21369,40,7553,7896,13870,0,0,1,0,1
21370,40,7554,6053,13870,0,0,1,0,1
21371,40,7555,6450;7465,13870,0,0,2,0,2
21372,40,7556,50,13870,0,0,1,0,1
21373,40,7557,7211,13870,0,0,1,0,1
21374,40,7561,2494,13870,0,0,1,0,1
21375,40,7562,1814,13870,0,0,1,0,1
21376,40,7563,8966,13870,0,0,1,0,1
21377,40,7564,9740,13870,0,0,1,0,1
21378,40,7566,10144,13870,0,0,1,0,1
21379,40,7567,1493,13870,0,0,1,0,1
21380,40,7569,10399;10406;14966,13870,1,0,2,0,3
21381,40,7570,10515,13870,0,0,1,0,1
21382,40,7571,10531;10538;14978;15178,13870,2,0,2,0,4
21383,40,7572,10487,13870,0,0,1,0,1
21384,40,7573,10591,13870,0,0,1,0,1
21385,40,7574,10434,13870,0,0,1,0,1
21386,40,7575,10801;10841;15087,13870,1,0,2,0,3
21387,40,7577,10664,13870,0,0,1,0,1
21388,40,7578,10956,13870,0,0,1,0,1
21389,40,7579,11001;11262,13870,0,0,2,0,2
21390,40,7580,11021;11195;15118,13870,1,0,2,0,3
21391,40,7581,11376,13870,0,0,1,0,1
21392,40,7582,10556;11118;14961,13870,1,0,2,0,3
21393,40,7583,10977;11199;14981,13870,1,0,2,0,3
21394,40,7584,11250,13870,0,0,1,0,1
21395,40,7585,10232,13870,0,0,1,0,1
21396,40,7586,11333;11365;15048,13870,1,0,2,0,3
21397,40,7587,11350;11656,13870,0,0,2,0,2
21398,40,7588,11388;11720;15041,13870,1,0,2,0,3
21399,40,7589,11406;11675;15124,13870,1,0,2,0,3
21400,40,7590,11418,13870,0,0,1,0,1
21401,40,7591,11454;11469;14948,13870,1,0,2,0,3
21402,40,7592,11285,13870,0,0,1,0,1
21403,40,7593,11238;11510;15143,13870,1,0,2,0,3
21404,40,7594,10928,13870,0,0,1,0,1
21405,40,7595,11508,13870,0,0,1,0,1
21406,40,7596,11536;11561;15014,13870,1,0,2,0,3
21407,40,7597,11574;12118,13870,0,0,2,0,2
21408,40,7598,11593;12434;15194,13870,1,0,2,0,3
21409,40,7599,11659;12062;15204,13870,1,0,2,0,3
21410,40,7600,11690;11975,13870,0,0,2,0,2
21411,40,7601,11748;12070,13870,0,0,2,0,2
21412,40,7602,11775;11933,13870,0,0,2,0,2
21413,40,7603,11806,13870,0,0,1,0,1
21414,40,7604,11345;11811;14969;15201,13870,2,0,2,0,4
21415,40,7605,11816;12104;15177,13870,1,0,2,0,3
21416,40,7606,11861;12187,13870,0,0,2,0,2
21417,40,7607,11714;11916,13870,0,0,2,0,2
21418,40,7608,11942;12092;14955,13870,1,0,2,0,3
21419,40,7609,11924;11944;15098,13870,1,0,2,0,3
21420,40,7610,11950;12160,13870,0,0,2,0,2
21421,40,7611,11956;12639,13870,0,0,2,0,2
21422,40,7612,11962;12191;15150,13870,1,0,2,0,3
21423,40,7613,11802;11963;15215,13870,1,0,2,0,3
21424,40,7614,11976,13870,0,0,1,0,1
21425,40,7615,11702,13870,0,0,1,0,1
21426,40,7616,11989;12364;15024,13870,1,0,2,0,3
21427,40,7617,12019;12413;15001,13870,1,0,2,0,3
21428,40,7618,12022;12626,13870,0,0,2,0,2
21429,40,7619,11890;12026,13870,0,0,2,0,2
21430,40,7620,12037;12265;15020,13870,1,0,2,0,3
21431,40,7621,12007;12049;15064,13870,1,0,2,0,3
21432,40,7622,12078;12254,13870,0,0,2,0,2
21433,40,7623,11814;12329;15039,13870,1,0,2,0,3
21434,40,7624,12085;12208,13870,0,0,2,0,2
21435,40,7625,12100;12350;14945,13870,1,0,2,0,3
21436,40,7626,12111;12580,13870,0,0,2,0,2
21437,40,7627,12168;12389;15082,13870,1,0,2,0,3
21438,40,7628,11679;12178;15175,13870,1,0,2,0,3
21439,40,7629,12192;12604;15166,13870,1,0,2,0,3
21440,40,7630,12201;12207,13870,0,0,2,0,2
21441,40,7631,12210;12598,13870,0,0,2,0,2
21442,40,7632,12215;12232,13870,0,0,2,0,2
21443,40,7633,12231;12551;14986;15174,13870,2,0,2,0,4
21444,40,7634,12255;12454;15189,13870,1,0,2,0,3
21445,40,7635,12130;12259,13870,0,0,2,0,2
21446,40,7637,334,14235,0,0,1,0,1
21447,40,7638,6781,14235,0,0,1,0,1
21448,40,7639,6537;9113,14235,0,0,2,0,2
21449,40,7641,2625,14235,0,0,1,0,1
21450,40,7642,1592,14235,0,0,1,0,1
21451,40,7643,5643,14235,0,0,1,0,1
21452,40,7645,4166,14235,0,0,1,0,1
21453,40,7646,2442,14235,0,0,1,0,1
21454,40,7647,2456;6222,14235,0,0,2,0,2
21455,40,7648,950;1140,14235,0,0,2,0,2
21456,40,7649,3708,14235,0,0,1,0,1
21457,40,7650,5775,14235,0,0,1,0,1
21458,40,7651,3477,14235,0,0,1,0,1
21459,40,7652,7554,14235,0,0,1,0,1
21460,40,7653,9041,14235,0,0,1,0,1
21461,40,7654,7894,14235,0,0,1,0,1
21462,40,7656,9748,14235,0,0,1,0,1
21463,40,7657,9009,14235,0,0,1,0,1
21464,40,7658,9247,14235,0,0,1,0,1
21465,40,7659,9369,14235,0,0,1,0,1
21466,40,7663,2896,14235,0,0,1,0,1
21467,40,7664,10059,14235,0,0,1,0,1
21468,40,7665,2476,14235,0,0,1,0,1
21469,40,7666,10148,14235,0,0,1,0,1
21470,40,7667,10004;10240;15108,14235,1,0,2,0,3
21471,40,7668,10091,14235,0,0,1,0,1
21472,40,7669,10181,14235,0,0,1,0,1
21473,40,7670,10339,14235,0,0,1,0,1
21474,40,7671,10670;11188;15097,14235,1,0,2,0,3
21475,40,7672,10773,14235,0,0,1,0,1
21476,40,7673,10789,14235,0,0,1,0,1
21477,40,7675,10915,14235,0,0,1,0,1
21478,40,7676,10945,14235,0,0,1,0,1
21479,40,7677,11038,14235,0,0,1,0,1
21480,40,7678,11042;11372,14235,0,0,2,0,2
21481,40,7679,10930,14235,0,0,1,0,1
21482,40,7680,11137;11275,14235,0,0,2,0,2
21483,40,7681,11232,14235,0,0,1,0,1
21484,40,7682,11320;11325,14235,0,0,2,0,2
21485,40,7683,11327,14235,0,0,1,0,1
21486,40,7684,11381;11691,14235,0,0,2,0,2
21487,40,7685,11387;11521,14235,0,0,2,0,2
21488,40,7686,11797,14235,0,0,1,0,1
21489,40,7687,11472,14235,0,0,1,0,1
21490,40,7688,11473;11654,14235,0,0,2,0,2
21491,40,7689,11562;11636;15193,14235,1,0,2,0,3
21492,40,7690,11403;11568,14235,0,0,2,0,2
21493,40,7691,11622;11686;15176,14235,1,0,2,0,3
21494,40,7692,11542;11647,14235,0,0,2,0,2
21495,40,7693,11671;11919,14235,0,0,2,0,2
21496,40,7694,11576;11705,14235,0,0,2,0,2
21497,40,7695,11335;11595,14235,0,0,2,0,2
21498,40,7696,11716,14235,0,0,1,0,1
21499,40,7697,11355;11746,14235,0,0,2,0,2
21500,40,7698,11765;11862,14235,0,0,2,0,2
21501,40,7699,11785;12366,14235,0,0,2,0,2
21502,40,7700,11820;12568,14235,0,0,2,0,2
21503,40,7701,11830;11850;15142,14235,1,0,2,0,3
21504,40,7702,11556;11832;15103,14235,1,0,2,0,3
21505,40,7703,11892;11910,14235,0,0,2,0,2
21506,40,7704,11928,14235,0,0,1,0,1
21507,40,7705,11826;11945,14235,0,0,2,0,2
21508,40,7706,11952,14235,0,0,1,0,1
21509,40,7707,11953,14235,0,0,1,0,1
21510,40,7708,11970;12196,14235,0,0,2,0,2
21511,40,7709,11977;12298;15100,14235,1,0,2,0,3
21512,40,7710,11985;12314,14235,0,0,2,0,2
21513,40,7711,12016;12157;15148,14235,1,0,2,0,3
21514,40,7712,11767;12038;15221,14235,1,0,2,0,3
21515,40,7713,12054;12562,14235,0,0,2,0,2
21516,40,7714,11402;12059,14235,0,0,2,0,2
21517,40,7715,11909;12074,14235,0,0,2,0,2
21518,40,7716,11782;12075,14235,0,0,2,0,2
21519,40,7717,12076;12592,14235,0,0,2,0,2
21520,40,7718,12021;12087;15172,14235,1,0,2,0,3
21521,40,7719,12288;15208,14235,1,0,1,0,2
21522,40,7720,12102;12117;15170,14235,1,0,2,0,3
21523,40,7721,12012;12122,14235,0,0,2,0,2
21524,40,7722,12048;12126;15126,14235,1,0,2,0,3
21525,40,7723,11424;12143,14235,0,0,2,0,2
21526,40,7724,12158;12776,14235,0,0,2,0,2
21527,40,7725,12170,14235,0,0,1,0,1
21528,40,7726,12184;12728,14235,0,0,2,0,2
21529,40,7727,12185;12603,14235,0,0,2,0,2
21530,40,7728,12149;12199;15220,14235,1,0,2,0,3
21531,40,7729,12233,14235,0,0,1,0,1
21532,40,7730,12238;12673,14235,0,0,2,0,2
21533,40,7731,12239;12558,14235,0,0,2,0,2
21534,40,7732,12362,14235,0,0,1,0,1
21535,40,7733,12326,14235,0,0,1,0,1
21536,40,7734,12084;12466,14235,0,0,2,0,2
21537,40,7735,12336;12348,14235,0,0,2,0,2
21538,40,7736,12341;12432;15211,14235,1,0,2,0,3
21539,40,7737,12292;12355;15183,14235,1,0,2,0,3
21540,40,7738,12282;12373,14235,0,0,2,0,2
21541,40,7739,11808;12382,14235,0,0,2,0,2
21542,40,7740,12258;12388,14235,0,0,2,0,2
21543,40,7742,909,14600,0,0,1,0,1
21544,40,7743,686,14600,0,0,1,0,1
21545,40,7745,3738,14600,0,0,1,0,1
21546,40,7746,4693,14600,0,0,1,0,1
21547,40,7747,1630,14600,0,0,1,0,1
21548,40,7748,5008;9552,14600,0,0,2,0,2
21549,40,7750,4398,14600,0,0,1,0,1
21550,40,7752,4860,14600,0,0,1,0,1
21551,40,7753,5192,14600,0,0,1,0,1
21552,40,7754,6999,14600,0,0,1,0,1
21553,40,7755,6308,14600,0,0,1,0,1
21554,40,7756,6571,14600,0,0,1,0,1
21555,40,7757,4770,14600,0,0,1,0,1
21556,40,7758,8020,14600,0,0,1,0,1
21557,40,7759,6854,14600,0,0,1,0,1
21558,40,7760,7881,14600,0,0,1,0,1
21559,40,7761,9843,14600,0,0,1,0,1
21560,40,7762,8996,14600,0,0,1,0,1
21561,40,7763,9128,14600,0,0,1,0,1
21562,40,7764,5331,14600,0,0,1,0,1
21563,40,7765,6201,14600,0,0,1,0,1
21564,40,7766,9838,14600,0,0,1,0,1
21565,40,7767,10048,14600,0,0,1,0,1
21566,40,7768,7856,14600,0,0,1,0,1
21567,40,7769,4471,14600,0,0,1,0,1
21568,40,7770,10195,14600,0,0,1,0,1
21569,40,7771,10035,14600,0,0,1,0,1
21570,40,7772,10497,14600,0,0,1,0,1
21571,40,7773,10561;11239,14600,0,0,2,0,2
21572,40,7774,10569,14600,0,0,1,0,1
21573,40,7775,10655,14600,0,0,1,0,1
21574,40,7776,10686;10748,14600,0,0,2,0,2
21575,40,7777,10456,14600,0,0,1,0,1
21576,40,7778,10782;10993,14600,0,0,2,0,2
21577,40,7779,10818,14600,0,0,1,0,1
21578,40,7780,10846,14600,0,0,1,0,1
21579,40,7781,10849,14600,0,0,1,0,1
21580,40,7782,10082,14600,0,0,1,0,1
21581,40,7783,10918,14600,0,0,1,0,1
21582,40,7784,10518,14600,0,0,1,0,1
21583,40,7785,10665,14600,0,0,1,0,1
21584,40,7786,10877,14600,0,0,1,0,1
21585,40,7787,11101,14600,0,0,1,0,1
21586,40,7788,11412,14600,0,0,1,0,1
21587,40,7789,11148;11597,14600,0,0,2,0,2
21588,40,7790,11149;11251,14600,0,0,2,0,2
21589,40,7791,11213,14600,0,0,1,0,1
21590,40,7792,11271;11645,14600,0,0,2,0,2
21591,40,7793,11123,14600,0,0,1,0,1
21592,40,7794,11380;11781,14600,0,0,2,0,2
21593,40,7795,11353;11390,14600,0,0,2,0,2
21594,40,7796,11304;11395,14600,0,0,2,0,2
21595,40,7797,11128,14600,0,0,1,0,1
21596,40,7798,10920,14600,0,0,1,0,1
21597,40,7799,11532;11906,14600,0,0,2,0,2
21598,40,7800,11563;11718,14600,0,0,2,0,2
21599,40,7801,11603,14600,0,0,1,0,1
21600,40,7802,11621;11669,14600,0,0,2,0,2
21601,40,7803,11652,14600,0,0,1,0,1
21602,40,7804,11492,14600,0,0,1,0,1
21603,40,7805,11709;11946,14600,0,0,2,0,2
21604,40,7806,11729;11762,14600,0,0,2,0,2
21605,40,7807,11749;12276,14600,0,0,2,0,2
21606,40,7808,11423;11756,14600,0,0,2,0,2
21607,40,7809,11829;12420,14600,0,0,2,0,2
21608,40,7810,11846;12139,14600,0,0,2,0,2
21609,40,7811,11855,14600,0,0,1,0,1
21610,40,7812,11791;11867,14600,0,0,2,0,2
21611,40,7813,11385;11891,14600,0,0,2,0,2
21612,40,7814,11913;12323,14600,0,0,2,0,2
21613,40,7815,11879;11988,14600,0,0,2,0,2
21614,40,7816,11940;11991,14600,0,0,2,0,2
21615,40,7817,11845;12008,14600,0,0,2,0,2
21616,40,7818,12023;12119,14600,0,0,2,0,2
21617,40,7819,11587;12041,14600,0,0,2,0,2
21618,40,7820,12077;12306,14600,0,0,2,0,2
21619,40,7821,12082;12347,14600,0,0,2,0,2
21620,40,7822,12090,14600,0,0,1,0,1
21621,40,7823,11792;12106,14600,0,0,2,0,2
21622,40,7824,12132;12572,14600,0,0,2,0,2
21623,40,7825,11787;12133,14600,0,0,2,0,2
21624,40,7826,12147;12750,14600,0,0,2,0,2
21625,40,7827,11363;12177,14600,0,0,2,0,2
21626,40,7828,12186;12387,14600,0,0,2,0,2
21627,40,7829,12190;12622,14600,0,0,2,0,2
21628,40,7830,12222;12285,14600,0,0,2,0,2
21629,40,7831,12236;12274,14600,0,0,2,0,2
21630,40,7832,12172;12257,14600,0,0,2,0,2
21631,40,7833,12088,14600,0,0,1,0,1
21632,40,7834,12294,14600,0,0,1,0,1
21633,40,7835,12311;12629,14600,0,0,2,0,2
21634,40,7836,12313;12367,14600,0,0,2,0,2
21635,40,7837,12009;12318,14600,0,0,2,0,2
21636,40,7838,12331;12332,14600,0,0,2,0,2
21637,40,7839,11715;12338,14600,0,0,2,0,2
21638,40,7840,12027;12339,14600,0,0,2,0,2
21639,40,7841,12344;12706,14600,0,0,2,0,2
21640,40,7842,12153;12359,14600,0,0,2,0,2
21641,40,7843,11996,14600,0,0,1,0,1
21642,40,7844,12280;12378,14600,0,0,2,0,2
21643,40,7845,11986;12390,14600,0,0,2,0,2
21644,40,7846,12290;12452,14600,0,0,2,0,2
21645,40,7847,12467;12594,14600,0,0,2,0,2
21646,40,7848,12370;12489,14600,0,0,2,0,2
21647,40,7849,12504;12652,14600,0,0,2,0,2
21648,50,1,4;3259,0,0,0,0,2,2
21649,50,3,15,0,0,0,0,1,1
21650,50,4,18;4056;14557,0,0,1,2,0,3
21651,50,6,9603,0,0,0,0,1,1
21652,50,13,39,0,0,0,0,1,1
21653,50,25,9208,0,0,0,0,1,1
21654,50,27,86,0,0,0,0,1,1
21655,50,28,90;1720;4946;6299;13751;14341;14883,0,0,2,5,0,7
21656,50,29,92,0,0,0,0,1,1
21657,50,36,113,0,0,0,1,0,1
21658,50,38,117;3099,0,0,0,0,2,2
21659,50,43,131,0,0,0,0,1,1
21660,50,45,8194;8867,0,0,0,0,2,2
21661,50,54,9347,0,0,0,0,1,1
21662,50,56,164,0,0,0,0,1,1
21663,50,61,180,0,0,0,0,1,1
21664,50,69,207,0,0,0,0,1,1
21665,50,71,210,0,0,0,0,1,1
21666,50,92,264;2637,0,0,0,0,2,2
21667,50,93,268;10284;13547;14240;15651,0,0,2,3,0,5
21668,50,96,275,0,0,0,0,1,1
21669,50,107,301,0,0,0,0,1,1
21670,50,112,318,0,0,0,0,1,1
21671,50,113,321,0,0,0,0,1,1
21672,50,127,9894,0,0,0,0,1,1
21673,50,128,354,0,0,0,0,1,1
21674,50,129,358,0,0,0,0,1,1
21675,50,130,362,0,0,0,0,1,1
21676,50,131,364,0,0,0,0,1,1
21677,50,134,1878,0,0,0,0,1,1
21678,50,139,385,0,0,0,0,1,1
21679,50,144,396;3992,0,0,0,0,2,2
21680,50,159,427,0,0,0,0,1,1
21681,50,162,435,0,0,0,0,1,1
21682,50,167,452,0,0,0,0,1,1
21683,50,169,460;5506,0,0,0,0,2,2
21684,50,179,493,0,0,0,1,0,1
21685,50,181,496;497,0,0,0,0,2,2
21686,50,183,500;7164,0,0,0,0,2,2
21687,50,184,502,0,0,0,0,1,1
21688,50,195,4638,0,0,0,0,1,1
21689,50,203,3382;3813;12668,0,0,0,1,2,3
21690,50,218,589,0,0,0,0,1,1
21691,50,220,595,0,0,0,0,1,1
21692,50,227,613;1307;13850;14151,0,0,0,4,0,4
21693,50,233,624,0,0,0,0,1,1
21694,50,235,629,0,0,0,0,1,1
21695,50,240,644,0,0,0,0,1,1
21696,50,246,8522,0,0,0,0,1,1
21697,50,250,667,0,0,0,0,1,1
21698,50,253,671,0,0,0,0,1,1
21699,50,257,688;4589,0,0,0,0,2,2
21700,50,267,707,0,0,0,0,1,1
21701,50,270,713,0,0,0,0,1,1
21702,50,273,718,0,0,0,0,1,1
21703,50,274,722,0,0,0,0,1,1
21704,50,279,738;9852,0,0,0,0,2,2
21705,50,283,745;2242,0,0,0,0,2,2
21706,50,288,756;6575,0,0,0,0,2,2
21707,50,291,6147;10978,0,0,0,1,1,2
21708,50,294,764,0,0,0,0,1,1
21709,50,297,1545;7780;13114;13667;14220,0,0,0,5,0,5
21710,50,301,787,0,0,0,0,1,1
21711,50,304,1537;9923;13480;13591;14436,0,0,1,4,0,5
21712,50,307,805,0,0,0,0,1,1
21713,50,308,806,0,0,0,0,1,1
21714,50,318,831,0,0,0,0,1,1
21715,50,327,854,0,0,0,0,1,1
21716,50,332,869;3919,0,0,0,0,2,2
21717,50,334,876,0,0,0,0,1,1
21718,50,337,884,0,0,0,0,1,1
21719,50,340,893,0,0,0,0,1,1
21720,50,350,921;1522;4285;7150;12951,0,0,0,5,0,5
21721,50,352,924,0,0,0,0,1,1
21722,50,357,939,0,0,0,0,1,1
21723,50,361,949,0,0,0,0,1,1
21724,50,365,965,0,0,0,0,1,1
21725,50,369,3976;3977,0,0,0,1,1,2
21726,50,370,989,0,0,0,0,1,1
21727,50,376,1000;3442,0,0,0,0,2,2
21728,50,382,1014;6783,0,0,0,0,2,2
21729,50,384,1019,0,0,0,0,1,1
21730,50,393,7724;7890;10077;14116;14293,0,0,1,4,0,5
21731,50,403,1069,0,0,0,0,1,1
21732,50,405,1075,0,0,0,0,1,1
21733,50,406,1077,0,0,0,0,1,1
21734,50,410,1082;9170,0,0,0,0,2,2
21735,50,411,1083,0,0,0,0,1,1
21736,50,414,1089,0,0,0,0,1,1
21737,50,415,1092;14582,0,0,1,1,0,2
21738,50,417,9218,0,0,0,0,1,1
21739,50,420,1106,0,0,0,0,1,1
21740,50,430,243,0,0,0,0,1,1
21741,50,431,3646,0,0,0,0,1,1
21742,50,434,1137,0,0,0,0,1,1
21743,50,440,1164;7440,0,0,0,2,0,2
21744,50,448,1181;8904,0,0,0,0,2,2
21745,50,451,1185,0,0,0,0,1,1
21746,50,453,1190,0,0,0,0,1,1
21747,50,456,1198;7627,0,0,0,0,2,2
21748,50,466,1223,0,0,0,0,1,1
21749,50,468,1228,0,0,0,0,1,1
21750,50,474,9623,0,0,0,0,1,1
21751,50,478,1260;3503,0,0,0,2,0,2
21752,50,487,1283;8781,0,0,0,0,2,2
21753,50,491,1296;8317;12976,0,0,0,2,1,3
21754,50,495,1309,0,0,0,0,1,1
21755,50,497,1316,0,0,0,0,1,1
21756,50,509,1345;13522;14170,0,0,0,3,0,3
21757,50,514,1361,0,0,0,0,1,1
21758,50,516,1366,0,0,0,0,1,1
21759,50,518,9207,0,0,0,0,1,1
21760,50,519,1375;5704,0,0,0,1,1,2
21761,50,522,1382;10019;12989;14772,0,0,1,3,0,4
21762,50,523,327,0,0,0,0,1,1
21763,50,534,1405;9204,0,0,0,0,2,2
21764,50,535,1407,0,0,0,0,1,1
21765,50,540,1422;1423,0,0,0,0,2,2
21766,50,545,1436,0,0,0,0,1,1
21767,50,547,1440,0,0,0,0,1,1
21768,50,553,1453;7690,0,0,0,0,2,2
21769,50,555,1456,0,0,0,0,1,1
21770,50,556,1461;7257;10121;10343;12975;13002;13796;13997;14032;14320;14335;15133,0,0,3,9,0,12
21771,50,560,1469,0,0,0,0,1,1
21772,50,561,1473;5771,0,0,0,0,2,2
21773,50,562,1475,0,0,0,0,1,1
21774,50,565,1483,0,0,0,0,1,1
21775,50,567,1491,0,0,0,0,1,1
21776,50,569,1497,0,0,0,0,1,1
21777,50,571,1502,0,0,0,0,1,1
21778,50,573,1506;4815,0,0,0,0,2,2
21779,50,579,1520;1521,0,0,0,0,2,2
21780,50,582,517,0,0,0,0,1,1
21781,50,590,1553;10064,0,0,0,1,1,2
21782,50,592,1558;2978,0,0,0,0,2,2
21783,50,593,1560,0,0,0,0,1,1
21784,50,598,1577;13366,0,0,0,2,0,2
21785,50,607,8801,0,0,0,0,1,1
21786,50,611,1605,0,0,0,0,1,1
21787,50,615,1620,0,0,0,0,1,1
21788,50,619,1632,0,0,0,0,1,1
21789,50,620,1633,0,0,0,0,1,1
21790,50,624,1643;4764,0,0,0,0,2,2
21791,50,641,1694,0,0,0,1,0,1
21792,50,642,4988,0,0,0,0,1,1
21793,50,648,1715;1776,0,0,0,0,2,2
21794,50,656,1743,0,0,0,0,1,1
21795,50,661,1756;3842;12954;13328,0,0,0,4,0,4
21796,50,665,1764,0,0,0,0,1,1
21797,50,667,1771;7499;12518;13925;14470,0,0,1,4,0,5
21798,50,682,1809,0,0,0,0,1,1
21799,50,684,1812;1813,0,0,0,0,2,2
21800,50,696,1840,0,0,0,1,0,1
21801,50,698,1843,0,0,0,0,1,1
21802,50,702,1853,0,0,0,0,1,1
21803,50,704,1856;7441,0,0,0,0,2,2
21804,50,709,1868,0,0,0,0,1,1
21805,50,710,1869,0,0,0,0,1,1
21806,50,713,1874,0,0,0,0,1,1
21807,50,716,879;1881,0,0,0,0,2,2
21808,50,719,1888,0,0,0,0,1,1
21809,50,720,1891,0,0,0,0,1,1
21810,50,721,1893,0,0,0,0,1,1
21811,50,728,1914,0,0,0,0,1,1
21812,50,731,9969,0,0,0,0,1,1
21813,50,733,1923;1924,0,0,0,0,2,2
21814,50,735,3137;13918,0,0,0,2,0,2
21815,50,736,8154;9410,0,0,0,0,2,2
21816,50,738,5001,0,0,0,0,1,1
21817,50,750,1965;2149,0,0,0,0,2,2
21818,50,751,1968,0,0,0,0,1,1
21819,50,752,1970,0,0,0,0,1,1
21820,50,753,1972,0,0,0,0,1,1
21821,50,759,1993;7937,0,0,0,0,2,2
21822,50,762,1997,0,0,0,0,1,1
21823,50,767,2005,0,0,0,0,1,1
21824,50,768,7829,0,0,0,0,1,1
21825,50,772,2023;3540,0,0,0,0,2,2
21826,50,773,2026,0,0,0,0,1,1
21827,50,784,1464,0,0,0,0,1,1
21828,50,786,2062;8886;13827;14132,0,0,0,4,0,4
21829,50,788,2065,0,0,0,0,1,1
21830,50,792,2075,0,0,0,0,1,1
21831,50,798,2088,0,0,0,0,1,1
21832,50,803,2103,0,0,0,0,1,1
21833,50,805,5779;12237,0,0,0,2,0,2
21834,50,806,2109,0,0,0,0,1,1
21835,50,813,2123;12526,0,0,0,2,0,2
21836,50,818,2142,0,0,0,1,0,1
21837,50,819,2143,0,0,0,0,1,1
21838,50,829,1023,0,0,0,0,1,1
21839,50,833,1931;2173,0,0,0,0,2,2
21840,50,834,2178,0,0,0,0,1,1
21841,50,851,2216;7783,0,0,0,0,2,2
21842,50,852,2221,0,0,0,0,1,1
21843,50,857,758;2238,0,0,0,0,2,2
21844,50,862,2257,0,0,0,0,1,1
21845,50,864,2263,0,0,0,0,1,1
21846,50,865,2266;2267,0,0,0,0,2,2
21847,50,866,2271,0,0,0,1,0,1
21848,50,867,2272,0,0,0,0,1,1
21849,50,869,2280,0,0,0,0,1,1
21850,50,873,1202;2287,0,0,0,0,2,2
21851,50,874,2293,0,0,0,0,1,1
21852,50,877,2299,0,0,0,0,1,1
21853,50,878,2303;2805,0,0,0,0,2,2
21854,50,886,2321;2323;5365;6823;13023,0,0,0,4,1,5
21855,50,895,3189,0,0,0,0,1,1
21856,50,902,3814,0,0,0,0,1,1
21857,50,919,2418;4793;14617,0,0,1,2,0,3
21858,50,930,2439,0,0,0,0,1,1
21859,50,940,2471,0,0,0,0,1,1
21860,50,951,2508;9585,0,0,0,1,1,2
21861,50,953,2368,0,0,0,0,1,1
21862,50,960,2533,0,0,0,0,1,1
21863,50,962,5562,0,0,0,0,1,1
21864,50,965,2547,0,0,0,0,1,1
21865,50,967,2550,0,0,0,0,1,1
21866,50,970,531;2558,0,0,0,0,2,2
21867,50,972,2564,0,0,0,0,1,1
21868,50,974,2567,0,0,0,0,1,1
21869,50,977,2574,0,0,0,0,1,1
21870,50,978,80,0,0,0,0,1,1
21871,50,984,2591,0,0,0,0,1,1
21872,50,989,2602,0,0,0,0,1,1
21873,50,990,8649;12845,0,0,0,2,0,2
21874,50,991,12213;12508;16496,0,1,0,2,0,3
21875,50,995,2614,0,0,0,0,1,1
21876,50,998,2706,0,0,0,0,1,1
21877,50,1001,2630,0,0,0,0,1,1
21878,50,1010,2648;9406,0,0,0,1,1,2
21879,50,1013,2658;3740,0,0,0,0,2,2
21880,50,1031,2703,0,0,0,0,1,1
21881,50,1033,9333,0,0,0,0,1,1
21882,50,1037,233;2712,0,0,0,0,2,2
21883,50,1039,5780,0,0,0,0,1,1
21884,50,1045,2738;5187;12936;13327,0,0,0,4,0,4
21885,50,1048,2749,0,0,0,0,1,1
21886,50,1059,2748,0,0,0,0,1,1
21887,50,1062,6561;7177;13851;14591,0,0,1,3,0,4
21888,50,1063,2786;4625,0,0,0,0,2,2
21889,50,1069,2806;6176,0,0,0,0,2,2
21890,50,1074,2823;6873;12305,0,0,0,1,2,3
21891,50,1076,2829,0,0,0,0,1,1
21892,50,1086,2856,0,0,0,0,1,1
21893,50,1093,3293;6343,0,0,0,0,2,2
21894,50,1098,1719,0,0,0,0,1,1
21895,50,1103,7283,0,0,0,0,1,1
21896,50,1104,2903,0,0,0,0,1,1
21897,50,1111,2915,0,0,0,0,1,1
21898,50,1121,2937,0,0,0,0,1,1
21899,50,1124,2944;9658,0,0,0,0,2,2
21900,50,1129,2958;10768;11898,0,0,0,2,1,3
21901,50,1130,2962,0,0,0,0,1,1
21902,50,1133,8338,0,0,0,1,0,1
21903,50,1138,10094,0,0,0,1,0,1
21904,50,1149,3018,0,0,0,0,1,1
21905,50,1152,726;3024,0,0,0,0,2,2
21906,50,1156,3040;3041;5088;6323;6972;9819;12549,0,0,0,2,5,7
21907,50,1168,10691;10804;10934;11050;11210;11267;11426;14006;14486;14653;14738;14795;15180;15328;15947,0,1,6,8,0,15
21908,50,1170,3080;8211,0,0,0,0,2,2
21909,50,1172,9026,0,0,0,0,1,1
21910,50,1180,3105,0,0,0,0,1,1
21911,50,1181,3109,0,0,0,0,1,1
21912,50,1185,6447,0,0,0,0,1,1
21913,50,1186,3124,0,0,0,0,1,1
21914,50,1189,6291,0,0,0,0,1,1
21915,50,1191,3141,0,0,0,1,0,1
21916,50,1192,6371,0,0,0,0,1,1
21917,50,1193,3143,0,0,0,0,1,1
21918,50,1194,3148,0,0,0,0,1,1
21919,50,1201,3167,0,0,0,0,1,1
21920,50,1202,3169,0,0,0,0,1,1
21921,50,1205,3174,0,0,0,0,1,1
21922,50,1209,357;6720;12928,0,0,0,1,2,3
21923,50,1210,3187;3364,0,0,0,0,2,2
21924,50,1216,3206,0,0,0,0,1,1
21925,50,1220,3220;3221,0,0,0,0,2,2
21926,50,1224,3231,0,0,0,0,1,1
21927,50,1229,3249,0,0,0,0,1,1
21928,50,1232,6339,0,0,0,0,1,1
21929,50,1233,3258,0,0,0,0,1,1
21930,50,1234,1769,0,0,0,0,1,1
21931,50,1235,3262,0,0,0,0,1,1
21932,50,1245,3285,0,0,0,0,1,1
21933,50,1250,8868,0,0,0,0,1,1
21934,50,1258,3901,0,0,0,1,0,1
21935,50,1269,3807;5654,0,0,0,0,2,2
21936,50,1275,3356;8526;14468,0,0,1,1,1,3
21937,50,1280,3368,0,0,0,0,1,1
21938,50,1282,3373,0,0,0,0,1,1
21939,50,1283,3378,0,0,0,0,1,1
21940,50,1285,3386;6955;9975;13456;13713,0,0,0,3,2,5
21941,50,1286,7694,0,0,0,0,1,1
21942,50,1291,3410,0,0,0,0,1,1
21943,50,1292,672;3411,0,0,0,0,2,2
21944,50,1297,3423,0,0,0,0,1,1
21945,50,1299,3427,0,0,0,0,1,1
21946,50,1300,3430,0,0,0,0,1,1
21947,50,1306,3448,0,0,0,0,1,1
21948,50,1315,3474,0,0,0,0,1,1
21949,50,1326,3687,0,0,0,0,1,1
21950,50,1327,1991;3505,0,0,0,0,2,2
21951,50,1329,3509;6516,0,0,0,0,2,2
21952,50,1332,3514;6923,0,0,0,0,2,2
21953,50,1337,3526;7650,0,0,0,0,2,2
21954,50,1339,3532;3534,0,0,0,0,2,2
21955,50,1361,3597,0,0,0,0,1,1
21956,50,1370,3618,0,0,0,0,1,1
21957,50,1371,3619,0,0,0,0,1,1
21958,50,1375,3627;10685,0,0,0,1,1,2
21959,50,1403,12;959,0,0,0,0,2,2
21960,50,1404,1617,0,0,0,0,1,1
21961,50,1409,4929,0,0,0,0,1,1
21962,50,1416,5117,0,0,0,0,1,1
21963,50,1417,1365;4871,0,0,0,0,2,2
21964,50,1419,8644,0,0,0,0,1,1
21965,50,1421,3753;7993;13032,0,0,0,3,0,3
21966,50,1422,3754,0,0,0,0,1,1
21967,50,1427,616;3767,0,0,0,0,2,2
21968,50,1438,3790,0,0,0,0,1,1
21969,50,1441,3800,0,0,0,0,1,1
21970,50,1452,3828,0,0,0,0,1,1
21971,50,1455,3840,0,0,0,1,0,1
21972,50,1457,3845,0,0,0,0,1,1
21973,50,1458,3848,0,0,0,0,1,1
21974,50,1468,1967;3880,0,0,0,0,2,2
21975,50,1501,3966;9152,0,0,0,0,2,2
21976,50,1508,3983,0,0,0,0,1,1
21977,50,1512,2776,0,0,0,0,1,1
21978,50,1518,4010,0,0,0,0,1,1
21979,50,1520,963;4013,0,0,0,0,2,2
21980,50,1524,4020,0,0,0,0,1,1
21981,50,1526,4027,0,0,0,0,1,1
21982,50,1529,5631,0,0,0,0,1,1
21983,50,1531,4039,0,0,0,0,1,1
21984,50,1533,4042,0,0,0,0,1,1
21985,50,1535,4050,0,0,0,0,1,1
21986,50,1540,279;4064,0,0,0,0,2,2
21987,50,1541,4066,0,0,0,0,1,1
21988,50,1550,4088,0,0,0,0,1,1
21989,50,1551,4091;9750;13937;14350,0,0,1,3,0,4
21990,50,1557,4104,0,0,0,0,1,1
21991,50,1570,6059,0,0,0,0,1,1
21992,50,1572,4135,0,0,0,0,1,1
21993,50,1575,4142,0,0,0,0,1,1
21994,50,1577,3019;4150;4151;5311;7316;12950;13387,0,0,0,7,0,7
21995,50,1579,4153,0,0,0,0,1,1
21996,50,1583,4161,0,0,0,0,1,1
21997,50,1584,1376;8893;13322,0,0,0,2,1,3
21998,50,1587,4172,0,0,0,0,1,1
21999,50,1588,4175,0,0,0,0,1,1
22000,50,1595,4193,0,0,0,0,1,1
22001,50,1601,4205;9103,0,0,0,0,2,2
22002,50,1607,4223,0,0,0,0,1,1
22003,50,1608,1679,0,0,0,0,1,1
22004,50,1616,4240;4241,0,0,0,0,2,2
22005,50,1627,4220;4268;6845;13448,0,0,0,3,1,4
22006,50,1633,401;4291,0,0,0,0,2,2
22007,50,1634,4295;14537,0,0,1,1,0,2
22008,50,1635,4296,0,0,0,0,1,1
22009,50,1636,4298,0,0,0,0,1,1
22010,50,1639,4306;5883,0,0,0,0,2,2
22011,50,1644,4318;9995,0,0,0,0,2,2
22012,50,1645,8423,0,0,0,0,1,1
22013,50,1647,4323,0,0,0,0,1,1
22014,50,1651,4330,0,0,0,0,1,1
22015,50,1658,4344,0,0,0,0,1,1
22016,50,1672,4376,0,0,0,0,1,1
22017,50,1674,4382,0,0,0,0,1,1
22018,50,1679,9867,0,0,0,0,1,1
22019,50,1696,4433,0,0,0,0,1,1
22020,50,1702,1178,0,0,0,0,1,1
22021,50,1713,4472,0,0,0,0,1,1
22022,50,1716,4483,0,0,0,0,1,1
22023,50,1719,2917;4494,0,0,0,0,2,2
22024,50,1723,890;4506;12437,0,0,0,1,2,3
22025,50,1725,1478;4516,0,0,0,2,0,2
22026,50,1728,1446;4521,0,0,0,0,2,2
22027,50,1729,4524;5600,0,0,0,0,2,2
22028,50,1730,4526,0,0,0,0,1,1
22029,50,1731,4530,0,0,0,0,1,1
22030,50,1739,4546;4547,0,0,0,0,2,2
22031,50,1763,4612,0,0,0,0,1,1
22032,50,1775,4646,0,0,0,0,1,1
22033,50,1777,4653;7720,0,0,0,0,2,2
22034,50,1784,4669,0,0,0,1,0,1
22035,50,1787,4673,0,0,0,0,1,1
22036,50,1791,4684,0,0,0,0,1,1
22037,50,1793,4688;10677,0,0,0,1,1,2
22038,50,1794,8353,0,0,0,0,1,1
22039,50,1796,1049;4699;13538;14225,0,0,0,4,0,4
22040,50,1798,4702,0,0,0,0,1,1
22041,50,1802,4712,0,0,0,0,1,1
22042,50,1805,3921;4722;12523,0,0,0,3,0,3
22043,50,1811,4734;9716,0,0,0,0,2,2
22044,50,1813,4742,0,0,0,0,1,1
22045,50,1815,4746,0,0,0,0,1,1
22046,50,1821,2827,0,0,0,0,1,1
22047,50,1824,4775,0,0,0,0,1,1
22048,50,1825,4776;9470,0,0,0,0,2,2
22049,50,1827,4780;7651,0,0,0,0,2,2
22050,50,1833,732,0,0,0,0,1,1
22051,50,1834,4788,0,0,0,0,1,1
22052,50,1848,4824,0,0,0,0,1,1
22053,50,1851,4830,0,0,0,0,1,1
22054,50,1859,4853,0,0,0,0,1,1
22055,50,1860,4858;9544,0,0,0,0,2,2
22056,50,1862,4870,0,0,0,0,1,1
22057,50,1872,4899,0,0,0,0,1,1
22058,50,1877,8851,0,0,0,0,1,1
22059,50,1878,4910,0,0,0,0,1,1
22060,50,1889,4945;9722;14670,0,0,1,2,0,3
22061,50,1890,4948,0,0,0,0,1,1
22062,50,1891,4951,0,0,0,0,1,1
22063,50,1896,4970,0,0,0,0,1,1
22064,50,1898,4975,0,0,0,0,1,1
22065,50,1901,4983,0,0,0,0,1,1
22066,50,1906,4991;4992,0,0,0,0,2,2
22067,50,1915,4165;5016;13203;14036,0,0,0,3,1,4
22068,50,1919,797,0,0,0,0,1,1
22069,50,1922,5034,0,0,0,0,1,1
22070,50,1923,5036,0,0,0,0,1,1
22071,50,1935,5068,0,0,0,0,1,1
22072,50,1942,191;5083,0,0,0,0,2,2
22073,50,1945,5093;6283,0,0,0,0,2,2
22074,50,1946,5095,0,0,0,0,1,1
22075,50,1947,5099,0,0,0,0,1,1
22076,50,1948,5102,0,0,0,0,1,1
22077,50,1961,5127,0,0,0,0,1,1
22078,50,1972,5156;14024;14428,0,0,1,2,0,3
22079,50,1974,5163,0,0,0,0,1,1
22080,50,1975,8702,0,0,0,0,1,1
22081,50,1978,5172,0,0,0,0,1,1
22082,50,1980,5179,0,0,0,0,1,1
22083,50,1986,1042,0,0,0,0,1,1
22084,50,1991,5207;8430,0,0,0,0,2,2
22085,50,1998,5227,0,0,0,0,1,1
22086,50,2001,5237,0,0,0,0,1,1
22087,50,2005,5247;5249,0,0,0,1,1,2
22088,50,2006,5251,0,0,0,0,1,1
22089,50,2018,5274;5478;10346,0,0,0,1,2,3
22090,50,2019,5276,0,0,0,0,1,1
22091,50,2024,5291,0,0,0,0,1,1
22092,50,2025,2622;5293,0,0,0,0,2,2
22093,50,2031,2455;5309,0,0,0,0,2,2
22094,50,2032,5313,0,0,0,0,1,1
22095,50,2033,5315;8171,0,0,0,0,2,2
22096,50,2034,5741,0,0,0,0,1,1
22097,50,2036,5321,0,0,0,0,1,1
22098,50,2041,5332;5626,0,0,0,0,2,2
22099,50,2045,5338,0,0,0,0,1,1
22100,50,2050,3785,0,0,0,0,1,1
22101,50,2057,1904;5363,0,0,0,0,2,2
22102,50,2063,5383,0,0,0,0,1,1
22103,50,2065,3254,0,0,0,0,1,1
22104,50,2066,5392;8731,0,0,0,0,2,2
22105,50,2067,4675;5393,0,0,0,0,2,2
22106,50,2068,6781;7143;11668,0,0,0,3,0,3
22107,50,2071,4333;7797,0,0,0,0,2,2
22108,50,2075,5415,0,0,0,0,1,1
22109,50,2076,5416,0,0,0,0,1,1
22110,50,2078,4031,0,0,0,0,1,1
22111,50,2079,5423;5424,0,0,0,0,2,2
22112,50,2080,4927;5427,0,0,0,0,2,2
22113,50,2083,5435;9463,0,0,0,0,2,2
22114,50,2090,5460,0,0,0,1,0,1
22115,50,2094,820,0,0,0,0,1,1
22116,50,2096,3022;5468,0,0,0,0,2,2
22117,50,2100,5475,0,0,0,0,1,1
22118,50,2106,5491,0,0,0,0,1,1
22119,50,2111,5504;6493,0,0,0,0,2,2
22120,50,2118,9393;11819,0,0,0,1,1,2
22121,50,2120,5524,0,0,0,0,1,1
22122,50,2122,5528;8011,0,0,0,0,2,2
22123,50,2125,5532,0,0,0,0,1,1
22124,50,2132,5549,0,0,0,0,1,1
22125,50,2142,5578,0,0,0,0,1,1
22126,50,2152,5596,0,0,0,0,1,1
22127,50,2154,5601,0,0,0,0,1,1
22128,50,2155,9948,0,0,0,0,1,1
22129,50,2159,1246,0,0,0,0,1,1
22130,50,2170,5640;5641,0,0,0,0,2,2
22131,50,2173,5649,0,0,0,0,1,1
22132,50,2179,5503,0,0,0,0,1,1
22133,50,2186,6141,0,0,0,0,1,1
22134,50,2194,5694;5695,0,0,0,0,2,2
22135,50,2195,5697,0,0,0,0,1,1
22136,50,2198,5708,0,0,0,0,1,1
22137,50,2199,5711,0,0,0,0,1,1
22138,50,2202,5717,0,0,0,0,1,1
22139,50,2212,3151;5749,0,0,0,0,2,2
22140,50,2215,9093,0,0,0,0,1,1
22141,50,2217,7966,0,0,0,0,1,1
22142,50,2228,6439,0,0,0,0,1,1
22143,50,2229,5795,0,0,0,0,1,1
22144,50,2230,5796,0,0,0,0,1,1
22145,50,2237,3391,0,0,0,0,1,1
22146,50,2243,1831;5822,0,0,0,0,2,2
22147,50,2249,5835,0,0,0,0,1,1
22148,50,2252,1894;5840,0,0,0,0,2,2
22149,50,2255,5845,0,0,0,0,1,1
22150,50,2263,5865,0,0,0,0,1,1
22151,50,2264,4810;5868,0,0,0,0,2,2
22152,50,2267,5877,0,0,0,0,1,1
22153,50,2274,5887;5889,0,0,0,0,2,2
22154,50,2278,5897,0,0,0,0,1,1
22155,50,2279,5280,0,0,0,0,1,1
22156,50,2282,8684,0,0,0,0,1,1
22157,50,2283,5910,0,0,0,0,1,1
22158,50,2285,5916,0,0,0,0,1,1
22159,50,2286,4528;5918,0,0,0,0,2,2
22160,50,2289,5923;6710,0,0,0,0,2,2
22161,50,2290,5913;5925,0,0,0,0,2,2
22162,50,2291,3592;5930;8109;14022,0,0,0,4,0,4
22163,50,2302,5633,0,0,0,0,1,1
22164,50,2303,5957,0,0,0,0,1,1
22165,50,2311,5980,0,0,0,0,1,1
22166,50,2312,5983,0,0,0,0,1,1
22167,50,2314,5989,0,0,0,0,1,1
22168,50,2317,10070;10315;13412;14452,0,0,1,3,0,4
22169,50,2319,6006;7676,0,0,0,0,2,2
22170,50,2320,4428,0,0,0,0,1,1
22171,50,2333,6038,0,0,0,0,1,1
22172,50,2334,2932;6039,0,0,0,0,2,2
22173,50,2335,40;6041,0,0,0,0,2,2
22174,50,2336,6043;6044,0,0,0,0,2,2
22175,50,2338,4215,0,0,0,0,1,1
22176,50,2342,6052;7453,0,0,0,0,2,2
22177,50,2343,6056;8892;14216;15391,0,0,1,3,0,4
22178,50,2349,6065;8838,0,0,0,0,2,2
22179,50,2350,3180,0,0,0,0,1,1
22180,50,2366,1515;7964,0,0,0,0,2,2
22181,50,2368,6115,0,0,0,0,1,1
22182,50,2381,6239;12002;12442,0,0,0,2,1,3
22183,50,2384,6150,0,0,0,0,1,1
22184,50,2389,2559;6166,0,0,0,2,0,2
22185,50,2392,330;6174,0,0,0,0,2,2
22186,50,2395,6180,0,0,0,0,1,1
22187,50,2399,6394;11804,0,0,0,1,1,2
22188,50,2403,6204;8231,0,0,0,0,2,2
22189,50,2405,6209,0,0,0,0,1,1
22190,50,2406,5461,0,0,0,0,1,1
22191,50,2407,6214,0,0,0,0,1,1
22192,50,2408,6216,0,0,0,0,1,1
22193,50,2413,6229;8393,0,0,0,0,2,2
22194,50,2418,11158;15487;15658,0,0,2,1,0,3
22195,50,2430,6274,0,0,0,0,1,1
22196,50,2431,5603;6277;12956,0,0,0,1,2,3
22197,50,2434,120;6290,0,0,0,2,0,2
22198,50,2436,4966,0,0,0,0,1,1
22199,50,2446,6321,0,0,0,0,1,1
22200,50,2457,6351,0,0,0,0,1,1
22201,50,2463,6366,0,0,0,0,1,1
22202,50,2468,6378;6379,0,0,0,0,2,2
22203,50,2471,6383,0,0,0,0,1,1
22204,50,2479,8099,0,0,0,1,0,1
22205,50,2486,3212;6423,0,0,0,0,2,2
22206,50,2490,242;6431,0,0,0,0,2,2
22207,50,2495,6067;6441,0,0,0,0,2,2
22208,50,2496,6446;8367,0,0,0,0,2,2
22209,50,2497,6448,0,0,0,0,1,1
22210,50,2503,4523;6470;13102,0,0,0,3,0,3
22211,50,2512,6485,0,0,0,0,1,1
22212,50,2513,6490,0,0,0,1,0,1
22213,50,2518,6501,0,0,0,0,1,1
22214,50,2519,5438,0,0,0,0,1,1
22215,50,2521,4668,0,0,0,0,1,1
22216,50,2527,6519;7638,0,0,0,0,2,2
22217,50,2542,2443,0,0,0,0,1,1
22218,50,2555,6591,0,0,0,0,1,1
22219,50,2563,6610,0,0,0,0,1,1
22220,50,2565,6746,0,0,0,0,1,1
22221,50,2569,3699,0,0,0,1,0,1
22222,50,2574,7701,0,0,0,0,1,1
22223,50,2581,6663,0,0,0,0,1,1
22224,50,2583,6667,0,0,0,0,1,1
22225,50,2584,6669,0,0,0,0,1,1
22226,50,2589,6680,0,0,0,0,1,1
22227,50,2590,3714,0,0,0,0,1,1
22228,50,2595,324;6697,0,0,0,0,2,2
22229,50,2596,765;6707,0,0,0,2,0,2
22230,50,2604,6730,0,0,0,0,1,1
22231,50,2606,6737,0,0,0,0,1,1
22232,50,2612,6753,0,0,0,0,1,1
22233,50,2613,3563;6754,0,0,0,0,2,2
22234,50,2618,2688,0,0,0,0,1,1
22235,50,2626,6788;8395,0,0,0,0,2,2
22236,50,2631,6802;8269,0,0,0,0,2,2
22237,50,2637,6813,0,0,0,0,1,1
22238,50,2638,12333,0,0,0,1,0,1
22239,50,2643,10193;10565;14767;15209,0,0,2,2,0,4
22240,50,2648,4471;6848;6849,0,0,0,3,0,3
22241,50,2666,6896,0,0,0,0,1,1
22242,50,2674,6913,0,0,0,0,1,1
22243,50,2675,1683;6915,0,0,0,0,2,2
22244,50,2681,1541;6928,0,0,0,0,2,2
22245,50,2683,6931,0,0,0,0,1,1
22246,50,2690,6952,0,0,0,0,1,1
22247,50,2693,4410,0,0,0,0,1,1
22248,50,2694,6961,0,0,0,0,1,1
22249,50,2697,6965,0,0,0,0,1,1
22250,50,2699,6968;6969,0,0,0,0,2,2
22251,50,2702,6978,0,0,0,0,1,1
22252,50,2704,908;6985,0,0,0,0,2,2
22253,50,2705,6988,0,0,0,0,1,1
22254,50,2722,7043,0,0,0,0,1,1
22255,50,2725,7048;7836,0,0,0,0,2,2
22256,50,2744,7094;8357,0,0,0,0,2,2
22257,50,2745,8120,0,0,0,0,1,1
22258,50,2746,2372;7101;13907,0,0,0,3,0,3
22259,50,2750,7112,0,0,0,0,1,1
22260,50,2764,7151;8592;13984,0,0,0,3,0,3
22261,50,2766,7157;7158,0,0,0,1,1,2
22262,50,2769,5333;7162,0,0,0,0,2,2
22263,50,2770,5582,0,0,0,0,1,1
22264,50,2772,7167,0,0,0,0,1,1
22265,50,2785,7199,0,0,0,0,1,1
22266,50,2787,3502;7203;11930,0,0,0,2,1,3
22267,50,2797,7228;7734,0,0,0,0,2,2
22268,50,2802,9495,0,0,0,0,1,1
22269,50,2809,7252;7253,0,0,0,0,2,2
22270,50,2811,6622,0,0,0,0,1,1
22271,50,2814,7263,0,0,0,0,1,1
22272,50,2817,7269,0,0,0,0,1,1
22273,50,2820,7277,0,0,0,0,1,1
22274,50,2836,7318,0,0,0,0,1,1
22275,50,2839,7325,0,0,0,0,1,1
22276,50,2851,7355,0,0,0,0,1,1
22277,50,2862,7380,0,0,0,0,1,1
22278,50,2863,5974;7384,0,0,0,0,2,2
22279,50,2867,7395;14594,0,0,1,1,0,2
22280,50,2869,8828;8890,0,0,0,0,2,2
22281,50,2870,7401,0,0,0,0,1,1
22282,50,2871,3450;7406,0,0,0,0,2,2
22283,50,2875,680,0,0,0,0,1,1
22284,50,2879,1948,0,0,0,0,1,1
22285,50,2885,1622;3517,0,0,0,2,0,2
22286,50,2895,8772,0,0,0,0,1,1
22287,50,2896,5644;7472,0,0,0,0,2,2
22288,50,2900,7482;8537,0,0,0,0,2,2
22289,50,2903,7490,0,0,0,0,1,1
22290,50,2905,7672;8590,0,0,0,0,2,2
22291,50,2908,7504;7809,0,0,0,0,2,2
22292,50,2915,2634;7526,0,0,0,0,2,2
22293,50,2916,7529,0,0,0,0,1,1
22294,50,2919,7539;9666,0,0,0,1,1,2
22295,50,2920,7540;8158,0,0,0,0,2,2
22296,50,2921,7541,0,0,0,0,1,1
22297,50,2925,2855;13913,0,0,0,2,0,2
22298,50,2940,7589,0,0,0,0,1,1
22299,50,2942,7596,0,0,0,1,0,1
22300,50,2944,5875;7599,0,0,0,0,2,2
22301,50,2947,7606;7607,0,0,0,0,2,2
22302,50,2950,7613,0,0,0,0,1,1
22303,50,2952,7622,0,0,0,1,0,1
22304,50,2965,2130;8609,0,0,0,0,2,2
22305,50,2969,7178;7664,0,0,0,0,2,2
22306,50,2975,7680,0,0,0,0,1,1
22307,50,2982,7700,0,0,0,0,1,1
22308,50,2985,7708,0,0,0,0,1,1
22309,50,2986,4954;7711,0,0,0,0,2,2
22310,50,3011,7769,0,0,0,0,1,1
22311,50,3014,7774,0,0,0,0,1,1
22312,50,3021,1166;7792,0,0,0,0,2,2
22313,50,3022,7793;10115;13739;14224,0,0,0,4,0,4
22314,50,3025,7798,0,0,0,0,1,1
22315,50,3026,7174,0,0,0,0,1,1
22316,50,3028,4507,0,0,0,0,1,1
22317,50,3045,7854;8753;11449,0,0,0,1,2,3
22318,50,3046,7857,0,0,0,0,1,1
22319,50,3052,7875,0,0,0,0,1,1
22320,50,3053,2001,0,0,0,0,1,1
22321,50,3054,7878,0,0,0,0,1,1
22322,50,3056,1334;3007;13691,0,0,0,3,0,3
22323,50,3065,3629;7903,0,0,0,0,2,2
22324,50,3067,7907,0,0,0,0,1,1
22325,50,3070,7915,0,0,0,0,1,1
22326,50,3071,7916,0,0,0,0,1,1
22327,50,3072,2017,0,0,0,0,1,1
22328,50,3075,4061;7928,0,0,0,0,2,2
22329,50,3081,5113;7946;7947;10013;13226;13768,0,0,0,4,2,6
22330,50,3082,7948,0,0,0,0,1,1
22331,50,3083,7951,0,0,0,0,1,1
22332,50,3099,4395,0,0,0,0,1,1
22333,50,3100,7987,0,0,0,0,1,1
22334,50,3101,7991,0,0,0,0,1,1
22335,50,3102,6326;7996,0,0,0,0,2,2
22336,50,3107,8007;9143,0,0,0,0,2,2
22337,50,3109,8580,0,0,0,0,1,1
22338,50,3112,9295,0,0,0,0,1,1
22339,50,3114,8029,0,0,0,0,1,1
22340,50,3132,4075;8076;13977;14434,0,0,1,3,0,4
22341,50,3137,8085;8086,0,0,0,0,2,2
22342,50,3142,8098,0,0,0,0,1,1
22343,50,3144,8103,0,0,0,0,1,1
22344,50,3147,8108,0,0,0,0,1,1
22345,50,3148,8112,0,0,0,0,1,1
22346,50,3151,2759;5653,0,0,0,0,2,2
22347,50,3154,4134;8131,0,0,0,0,2,2
22348,50,3158,2486;3668,0,0,0,0,2,2
22349,50,3159,8143;8146,0,0,0,1,1,2
22350,50,3160,3688;8147,0,0,0,0,2,2
22351,50,3163,1748;8156,0,0,0,0,2,2
22352,50,3165,8160,0,0,0,0,1,1
22353,50,3167,8162,0,0,0,0,1,1
22354,50,3168,8166;10133,0,0,0,1,1,2
22355,50,3189,2210;3718,0,0,0,0,2,2
22356,50,3193,6588,0,0,0,0,1,1
22357,50,3199,8239;9412,0,0,0,0,2,2
22358,50,3201,8241,0,0,0,0,1,1
22359,50,3204,1945;8245,0,0,0,0,2,2
22360,50,3205,8247;8248,0,0,0,0,2,2
22361,50,3206,8250;8251,0,0,0,0,2,2
22362,50,3212,8263;10021,0,0,0,1,1,2
22363,50,3214,7340,0,0,0,0,1,1
22364,50,3216,8275;8276,0,0,0,0,2,2
22365,50,3227,8305,0,0,0,0,1,1
22366,50,3232,8321,0,0,0,0,1,1
22367,50,3236,8334,0,0,0,0,1,1
22368,50,3238,8340;9429;10452,0,0,0,1,2,3
22369,50,3240,8344,0,0,0,0,1,1
22370,50,3243,6535;8350;11430,0,0,0,1,2,3
22371,50,3258,8387,0,0,0,0,1,1
22372,50,3260,2013;2825,0,0,0,0,2,2
22373,50,3261,858,0,0,0,0,1,1
22374,50,3262,2687,0,0,0,0,1,1
22375,50,3264,8404,0,0,0,0,1,1
22376,50,3267,8414,0,0,0,0,1,1
22377,50,3268,8415,0,0,0,0,1,1
22378,50,3271,8427,0,0,0,0,1,1
22379,50,3275,8434,0,0,0,0,1,1
22380,50,3279,8442,0,0,0,1,0,1
22381,50,3281,8448,0,0,0,0,1,1
22382,50,3282,7474;8450,0,0,0,0,2,2
22383,50,3283,8452,0,0,0,0,1,1
22384,50,3288,8464,0,0,0,0,1,1
22385,50,3297,8496,0,0,0,0,1,1
22386,50,3304,8511,0,0,0,0,1,1
22387,50,3305,6162,0,0,0,0,1,1
22388,50,3316,8540;8542,0,0,0,0,2,2
22389,50,3319,271;8554,0,0,0,0,2,2
22390,50,3320,593,0,0,0,0,1,1
22391,50,3323,8564;8565,0,0,0,0,2,2
22392,50,3343,195,0,0,0,0,1,1
22393,50,3344,8613,0,0,0,0,1,1
22394,50,3347,8626,0,0,0,0,1,1
22395,50,3353,8645,0,0,0,0,1,1
22396,50,3366,2875;8674;8675;9562;13122,0,0,0,2,3,5
22397,50,3375,1808;10018;13936,0,0,0,3,0,3
22398,50,3379,8706,0,0,0,0,1,1
22399,50,3384,8723,0,0,0,0,1,1
22400,50,3387,5224,0,0,0,0,1,1
22401,50,3390,8732,0,0,0,0,1,1
22402,50,3398,8755,0,0,0,0,1,1
22403,50,3400,8761,0,0,0,0,1,1
22404,50,3401,8763;8764,0,0,0,0,2,2
22405,50,3404,8773,0,0,0,0,1,1
22406,50,3407,8783,0,0,0,0,1,1
22407,50,3416,8804,0,0,0,0,1,1
22408,50,3420,2833;5615;8819,0,0,0,2,1,3
22409,50,3421,8824,0,0,0,0,1,1
22410,50,3423,8833,0,0,0,0,1,1
22411,50,3424,8834,0,0,0,0,1,1
22412,50,3432,3222;5458;8857;8858,0,0,0,0,4,4
22413,50,3433,8860,0,0,0,0,1,1
22414,50,3435,3256;9267,0,0,0,2,0,2
22415,50,3439,6215,0,0,0,0,1,1
22416,50,3446,8883,0,0,0,0,1,1
22417,50,3448,8891,0,0,0,0,1,1
22418,50,3449,5069;8895,0,0,0,0,2,2
22419,50,3456,8915,0,0,0,0,1,1
22420,50,3461,4190,0,0,0,0,1,1
22421,50,3465,8938,0,0,0,0,1,1
22422,50,3467,8941;8942,0,0,0,0,2,2
22423,50,3469,8949;13343;13868;15076,0,0,1,3,0,4
22424,50,3476,8968,0,0,0,0,1,1
22425,50,3479,8100;8978,0,0,0,2,0,2
22426,50,3485,6513;8991,0,0,0,0,2,2
22427,50,3487,8998;12717,0,0,0,2,0,2
22428,50,3488,9000,0,0,0,0,1,1
22429,50,3502,4485,0,0,0,0,1,1
22430,50,3503,9035,0,0,0,0,1,1
22431,50,3507,9050,0,0,0,0,1,1
22432,50,3510,9055,0,0,0,0,1,1
22433,50,3515,9065,0,0,0,0,1,1
22434,50,3517,423;9070,0,0,0,0,2,2
22435,50,3519,9076,0,0,0,0,1,1
22436,50,3523,8114,0,0,0,0,1,1
22437,50,3536,9129,0,0,0,0,1,1
22438,50,3537,9131,0,0,0,0,1,1
22439,50,3539,9138;12984,0,0,0,1,1,2
22440,50,3549,3873;8238;9162;12445;12974;13282,0,0,0,6,0,6
22441,50,3560,9185,0,0,0,0,1,1
22442,50,3578,1205;9241,0,0,0,0,2,2
22443,50,3579,6863,0,0,0,0,1,1
22444,50,3580,9243,0,0,0,0,1,1
22445,50,3587,9262,0,0,0,0,1,1
22446,50,3588,2328,0,0,0,0,1,1
22447,50,3592,9274,0,0,0,0,1,1
22448,50,3605,193;9301;11249,0,0,0,1,2,3
22449,50,3606,9304,0,0,0,0,1,1
22450,50,3611,9312,0,0,0,0,1,1
22451,50,3613,9319,0,0,0,0,1,1
22452,50,3620,75,0,0,0,1,0,1
22453,50,3622,5954,0,0,0,0,1,1
22454,50,3624,5233,0,0,0,0,1,1
22455,50,3628,9360,0,0,0,0,1,1
22456,50,3634,1732;9378,0,0,0,0,2,2
22457,50,3637,9384,0,0,0,0,1,1
22458,50,3640,9390,0,0,0,0,1,1
22459,50,3643,9399,0,0,0,0,1,1
22460,50,3645,9405,0,0,0,0,1,1
22461,50,3646,9407;10820,0,0,0,1,1,2
22462,50,3648,9413;9414,0,0,0,0,2,2
22463,50,3649,8001,0,0,0,0,1,1
22464,50,3650,9422,0,0,0,0,1,1
22465,50,3651,9426,0,0,0,0,1,1
22466,50,3654,8026,0,0,0,0,1,1
22467,50,3662,9453,0,0,0,0,1,1
22468,50,3667,9466,0,0,0,0,1,1
22469,50,3672,9477,0,0,0,0,1,1
22470,50,3673,286,0,0,0,0,1,1
22471,50,3679,9496,0,0,0,0,1,1
22472,50,3684,9507,0,0,0,0,1,1
22473,50,3685,9511,0,0,0,0,1,1
22474,50,3686,2464,0,0,0,0,1,1
22475,50,3687,9518;9519;14343,0,0,1,2,0,3
22476,50,3688,9521,0,0,0,0,1,1
22477,50,3690,244,0,0,0,0,1,1
22478,50,3693,9535,0,0,0,0,1,1
22479,50,3699,9549,0,0,0,0,1,1
22480,50,3700,9551,0,0,0,0,1,1
22481,50,3702,307;9554,0,0,0,0,2,2
22482,50,3704,9560;9561;9939,0,0,0,1,2,3
22483,50,3709,9577,0,0,0,0,1,1
22484,50,3710,988;9580;13152,0,0,0,3,0,3
22485,50,3713,9587,0,0,0,0,1,1
22486,50,3716,2219;9597,0,0,0,0,2,2
22487,50,3719,9604;9605,0,0,0,0,2,2
22488,50,3724,2407,0,0,0,0,1,1
22489,50,3725,9436;9619,0,0,0,0,2,2
22490,50,3726,6618;9621,0,0,0,0,2,2
22491,50,3734,9640,0,0,0,0,1,1
22492,50,3737,9647,0,0,0,0,1,1
22493,50,3749,9675,0,0,0,0,1,1
22494,50,3750,3201;9694;12343;13441,0,0,0,4,0,4
22495,50,3752,179;9688,0,0,0,1,1,2
22496,50,3756,9701,0,0,0,0,1,1
22497,50,3759,7615;9708,0,0,0,0,2,2
22498,50,3769,3420;9736;15114,0,0,1,2,0,3
22499,50,3770,9738,0,0,0,0,1,1
22500,50,3771,5433;9742,0,0,0,2,0,2
22501,50,3774,8984,0,0,0,0,1,1
22502,50,3784,9778;12013,0,0,0,1,1,2
22503,50,3787,9789,0,0,0,0,1,1
22504,50,3792,9803,0,0,0,0,1,1
22505,50,3794,8934;9808;11836,0,0,0,1,2,3
22506,50,3797,7986;9815,0,0,0,0,2,2
22507,50,3817,10983;11745;15456;15657,0,0,2,2,0,4
22508,50,3822,213;8270;9888;12055;14021;14891,0,0,1,5,0,6
22509,50,3824,9893,0,0,0,0,1,1
22510,50,3827,5026;9900,0,0,0,0,2,2
22511,50,3831,9907,0,0,0,0,1,1
22512,50,3832,5226,0,0,0,0,1,1
22513,50,3833,9914;9915,0,0,0,0,2,2
22514,50,3839,9931,0,0,0,0,1,1
22515,50,3841,782;9934,0,0,0,0,2,2
22516,50,3844,9943,0,0,0,0,1,1
22517,50,3849,9956;9957,0,0,0,0,2,2
22518,50,3850,6255,0,0,0,0,1,1
22519,50,3853,9964,0,0,0,0,1,1
22520,50,3860,2524;5329;9986;9987,0,0,0,4,0,4
22521,50,3862,9991,0,0,0,0,1,1
22522,50,3866,22,0,0,0,0,1,1
22523,50,3868,299;9944;10722,0,0,0,1,2,3
22524,50,3869,7669;7849,0,0,0,0,2,2
22525,50,3872,487,0,0,0,0,1,1
22526,50,3876,10001,0,0,0,0,1,1
22527,50,3877,979,0,0,0,0,1,1
22528,50,3879,1569,0,0,0,0,1,1
22529,50,3881,2380;3910,0,0,0,0,2,2
22530,50,3883,1989,0,0,0,0,1,1
22531,50,3885,576;974,0,0,0,0,2,2
22532,50,3888,2288,0,0,0,0,1,1
22533,50,3899,3100;3625,0,0,0,0,2,2
22534,50,3901,1740,0,0,0,0,1,1
22535,50,3902,3291,0,0,0,0,1,1
22536,50,3904,3865;5508,0,0,0,0,2,2
22537,50,3905,9480,0,0,0,0,1,1
22538,50,3906,4111,0,0,0,0,1,1
22539,50,3913,5058,0,0,0,0,1,1
22540,50,3914,4051,0,0,0,0,1,1
22541,50,3916,5208;9878,0,0,0,0,2,2
22542,50,3921,2316;8543,0,0,0,0,2,2
22543,50,3925,2438;8622,0,0,0,0,2,2
22544,50,3926,9060;9303,0,0,0,0,2,2
22545,50,3927,1030;6757,0,0,0,0,2,2
22546,50,3930,9977,0,0,0,0,1,1
22547,50,3933,5764;7843,0,0,0,0,2,2
22548,50,3936,4740,0,0,0,0,1,1
22549,50,3938,8221,0,0,0,0,1,1
22550,50,3939,9159,0,0,0,0,1,1
22551,50,3941,8489,0,0,0,0,1,1
22552,50,3946,3922;4188;12363,0,0,0,1,2,3
22553,50,3949,6311,0,0,0,0,1,1
22554,50,3953,9871,0,0,0,0,1,1
22555,50,3954,1561;9911,0,0,0,0,2,2
22556,50,3957,3061,365,0,0,0,1,1
22557,50,3960,5699,365,0,0,0,1,1
22558,50,3962,728;1695,365,0,0,0,2,2
22559,50,3965,1174,365,0,0,0,1,1
22560,50,3966,7838,365,0,0,0,1,1
22561,50,3967,45;459,365,0,0,0,2,2
22562,50,3969,3140;9281,365,0,0,0,2,2
22563,50,3975,2723,365,0,0,0,1,1
22564,50,3976,258,365,0,0,0,1,1
22565,50,3977,2804,365,0,0,0,1,1
22566,50,3978,2930;9990,365,0,0,0,2,2
22567,50,3980,516;3066,365,0,0,0,2,2
22568,50,3986,3396;8378;11299,365,0,0,1,2,3
22569,50,3987,3432;4751;5766,365,0,0,1,2,3
22570,50,3988,3444,365,0,0,0,1,1
22571,50,3992,4560,365,0,0,0,1,1
22572,50,3997,4968;6396,365,0,0,0,2,2
22573,50,4000,4827;6246,365,0,0,0,2,2
22574,50,4004,11904;15181;15631,365,0,2,1,0,3
22575,50,4006,4889;5900,365,0,0,0,2,2
22576,50,4009,5014;6021;11764,365,0,0,1,2,3
22577,50,4011,3133,365,0,0,0,1,1
22578,50,4014,828,365,0,0,0,1,1
22579,50,4015,6799;8315,365,0,0,0,2,2
22580,50,4016,3062;5554;11632,365,0,0,1,2,3
22581,50,4017,3868,365,0,0,0,1,1
22582,50,4024,7858,365,0,0,0,1,1
22583,50,4027,7997;8696,365,0,0,0,2,2
22584,50,4028,3157,365,0,0,0,1,1
22585,50,4033,3632;6993,365,0,0,0,2,2
22586,50,4040,9428,365,0,0,0,1,1
22587,50,4041,9432,365,0,0,0,1,1
22588,50,4047,200,730,0,0,0,1,1
22589,50,4048,6184,730,0,0,0,1,1
22590,50,4052,489;3429,730,0,0,0,2,2
22591,50,4053,2949,730,0,0,0,1,1
22592,50,4055,2980;5617,730,0,0,0,2,2
22593,50,4058,948;5619,730,0,0,0,2,2
22594,50,4059,951;3996,730,0,0,0,2,2
22595,50,4062,3438;3560,730,0,0,0,2,2
22596,50,4065,1745,730,0,0,0,1,1
22597,50,4066,1783;4619,730,0,0,0,2,2
22598,50,4067,1846;12463,730,0,0,1,1,2
22599,50,4068,7066,730,0,0,0,1,1
22600,50,4071,524,730,0,0,0,1,1
22601,50,4094,3792;9696,730,0,0,0,2,2
22602,50,4098,2334,730,0,0,0,1,1
22603,50,4099,4030;5216,730,0,0,0,2,2
22604,50,4103,4273,730,0,0,0,1,1
22605,50,4104,592,730,0,0,0,1,1
22606,50,4105,4377;8830,730,0,0,0,2,2
22607,50,4106,4384,730,0,0,0,1,1
22608,50,4109,4909;6856,730,0,0,0,2,2
22609,50,4112,5087,730,0,0,0,1,1
22610,50,4114,262;8083,730,0,0,0,2,2
22611,50,4116,7;6345,730,0,0,0,2,2
22612,50,4117,730;5542,730,0,0,0,2,2
22613,50,4118,5684;6696,730,0,0,0,2,2
22614,50,4122,2203,730,0,0,0,1,1
22615,50,4127,158;3795,730,0,0,0,2,2
22616,50,4129,5571;6922,730,0,0,0,2,2
22617,50,4130,7021,730,0,0,0,1,1
22618,50,4131,7074;8662,730,0,0,0,2,2
22619,50,4137,5109,730,0,0,0,1,1
22620,50,4138,7592;9686,730,0,0,0,2,2
22621,50,4140,7293;8757;12871,730,0,0,1,2,3
22622,50,4141,3716;5419;11297,730,0,0,1,2,3
22623,50,4143,8173,730,0,0,0,1,1
22624,50,4144,4482;8277,730,0,0,0,2,2
22625,50,4145,8322;9105;11617,730,0,0,1,2,3
22626,50,4148,8392,730,0,0,0,1,1
22627,50,4156,1209,730,0,0,0,1,1
22628,50,4158,1074;4218,730,0,0,0,2,2
22629,50,4165,1447;9762,730,0,0,0,2,2
22630,50,4170,9857,730,0,0,0,1,1
22631,50,4171,3419;4284;12334,1095,0,0,1,2,3
22632,50,4172,38;12386,1095,0,0,1,1,2
22633,50,4173,413;5748,1095,0,0,0,2,2
22634,50,4174,3103;3116;12216,1095,0,0,1,2,3
22635,50,4179,1212;5939,1095,0,0,0,2,2
22636,50,4180,2179;5810,1095,0,0,0,2,2
22637,50,4183,467;685;12708,1095,0,0,1,2,3
22638,50,4185,6550,1095,0,0,0,1,1
22639,50,4187,7035;8996,1095,0,0,0,2,2
22640,50,4190,2133,1095,0,0,0,1,1
22641,50,4192,9721,1095,0,0,0,1,1
22642,50,4194,1458,1095,0,0,0,1,1
22643,50,4197,1655;6761,1095,0,0,0,2,2
22644,50,4199,1974,1095,0,0,0,1,1
22645,50,4202,4015;9008;12616,1095,0,0,2,1,3
22646,50,4205,4170;6110,1095,0,0,1,1,2
22647,50,4206,1603;4925,1095,0,0,0,2,2
22648,50,4209,9622,1095,0,0,0,1,1
22649,50,4211,2986,1095,0,0,0,1,1
22650,50,4212,7998,1095,0,0,1,0,1
22651,50,4213,3471;5679,1095,0,0,0,2,2
22652,50,4216,7079,1095,0,0,0,1,1
22653,50,4217,4001,1095,0,0,0,1,1
22654,50,4218,4002;5070,1095,0,0,0,2,2
22655,50,4223,4490,1095,0,0,0,1,1
22656,50,4225,62;4559;12816,1095,0,0,1,2,3
22657,50,4226,3072;4797,1095,0,0,0,2,2
22658,50,4230,4577;11717,1095,0,0,1,1,2
22659,50,4234,3759;5379,1095,0,0,0,2,2
22660,50,4236,5755,1095,0,0,0,1,1
22661,50,4237,1424;5769,1095,0,0,0,2,2
22662,50,4239,5547;5928,1095,0,0,0,2,2
22663,50,4245,4148;6334,1095,0,0,0,2,2
22664,50,4248,6837,1095,0,0,0,1,1
22665,50,4249,2556;6914,1095,0,0,0,2,2
22666,50,4250,5489,1095,0,0,0,1,1
22667,50,4252,5871;7294,1095,0,0,0,2,2
22668,50,4253,7317,1095,0,0,0,1,1
22669,50,4254,926;7321,1095,0,0,0,2,2
22670,50,4257,3675;6982,1095,0,0,0,2,2
22671,50,4260,6306;7516,1095,0,0,0,2,2
22672,50,4261,5490,1095,0,0,0,1,1
22673,50,4263,7603;7722,1095,0,0,0,2,2
22674,50,4264,9526;12689;13081,1095,0,0,2,1,3
22675,50,4265,5201;7893,1095,0,0,1,1,2
22676,50,4266,3339,1095,0,0,0,1,1
22677,50,4268,1238;6544,1095,0,0,1,1,2
22678,50,4272,181;8455,1095,0,0,0,2,2
22679,50,4275,205;7138,1095,0,0,0,2,2
22680,50,4276,794;8859,1095,0,0,0,2,2
22681,50,4278,2682,1095,0,0,0,1,1
22682,50,4281,5366;9165,1095,0,0,1,1,2
22683,50,4282,4908;9221,1095,0,0,1,1,2
22684,50,4285,3289;5605,1095,0,0,0,2,2
22685,50,4287,5443;6910;12083,1095,0,0,1,2,3
22686,50,4288,8175;9727,1095,0,0,0,2,2
22687,50,4297,8925,1460,0,0,0,1,1
22688,50,4298,583;8790,1460,0,0,0,2,2
22689,50,4299,643;9898,1460,0,0,0,2,2
22690,50,4300,3727;7286,1460,0,0,0,2,2
22691,50,4302,4888,1460,0,0,1,0,1
22692,50,4303,7604,1460,0,0,1,0,1
22693,50,4304,871;12427,1460,0,0,1,1,2
22694,50,4305,881,1460,0,0,0,1,1
22695,50,4306,895;5737,1460,0,0,0,2,2
22696,50,4307,977;4602,1460,0,0,0,2,2
22697,50,4309,1059,1460,0,0,0,1,1
22698,50,4311,4492,1460,0,0,0,1,1
22699,50,4312,1213;7825,1460,0,0,0,2,2
22700,50,4315,1333;9843,1460,0,0,0,2,2
22701,50,4316,1499;5709,1460,0,0,1,1,2
22702,50,4317,371,1460,0,0,0,1,1
22703,50,4320,4756;6308,1460,0,0,1,1,2
22704,50,4322,2281,1460,0,0,0,1,1
22705,50,4328,1536;2834;12435;12540,1460,0,0,2,2,4
22706,50,4329,2843;4527,1460,0,0,0,2,2
22707,50,4330,2887,1460,0,0,0,1,1
22708,50,4335,3621;9947,1460,0,0,0,2,2
22709,50,4337,2301,1460,0,0,0,1,1
22710,50,4338,8456;8760,1460,0,0,0,2,2
22711,50,4340,5905,1460,0,0,1,0,1
22712,50,4341,3832;7485,1460,0,0,0,2,2
22713,50,4342,3946;7624,1460,0,0,0,2,2
22714,50,4345,2232;4169,1460,0,0,0,2,2
22715,50,4347,1250;4315,1460,0,0,0,2,2
22716,50,4349,8135,1460,0,0,1,0,1
22717,50,4350,4707,1460,0,0,0,1,1
22718,50,4353,4920,1460,0,0,0,1,1
22719,50,4355,5017,1460,0,0,0,1,1
22720,50,4360,5377;6586,1460,0,0,0,2,2
22721,50,4366,5899,1460,0,0,0,1,1
22722,50,4369,4197,1460,0,0,0,1,1
22723,50,4370,1526,1460,0,0,1,0,1
22724,50,4372,5114;8747,1460,0,0,0,2,2
22725,50,4375,7989,1460,0,0,0,1,1
22726,50,4376,6489;6728;13028,1460,0,0,1,2,3
22727,50,4378,2350;6819,1460,0,0,0,2,2
22728,50,4380,2394;3566,1460,0,0,1,1,2
22729,50,4381,6452;6986,1460,0,0,0,2,2
22730,50,4382,1718,1460,0,0,0,1,1
22731,50,4385,9424;12030,1460,0,0,1,1,2
22732,50,4387,6133,1460,0,0,0,1,1
22733,50,4389,7517,1460,0,0,0,1,1
22734,50,4390,7868;7925,1460,0,0,0,2,2
22735,50,4391,6211,1460,0,0,0,1,1
22736,50,4392,2525,1460,0,0,0,1,1
22737,50,4397,8284,1460,0,0,0,1,1
22738,50,4402,1218,1460,0,0,1,0,1
22739,50,4403,7495;13044,1460,0,0,1,1,2
22740,50,4404,9238;11483,1460,0,0,1,1,2
22741,50,4405,8568;8987,1460,0,0,0,2,2
22742,50,4408,6198;9299,1460,0,0,0,2,2
22743,50,4409,6318;13072,1460,0,0,2,0,2
22744,50,4412,6413;9769,1460,0,0,0,2,2
22745,50,4413,7419;9777,1460,0,0,0,2,2
22746,50,4414,2351;9809;10856,1460,0,0,1,2,3
22747,50,4415,1741;3994,1460,0,0,0,2,2
22748,50,4416,4873;9114,1460,0,0,0,2,2
22749,50,4417,71;4336,1825,0,0,0,2,2
22750,50,4418,199;8519,1825,0,0,1,1,2
22751,50,4421,7076,1825,0,0,0,1,1
22752,50,4423,439;705,1825,0,0,0,2,2
22753,50,4424,636,1825,0,0,0,1,1
22754,50,4426,1352;6736,1825,0,0,2,0,2
22755,50,4427,3572,1825,0,0,0,1,1
22756,50,4430,642;1525,1825,0,0,1,1,2
22757,50,4431,411;6655,1825,0,0,0,2,2
22758,50,4435,6196;9357,1825,0,0,0,2,2
22759,50,4437,3219;12441,1825,0,0,2,0,2
22760,50,4438,3165;4898,1825,0,0,0,2,2
22761,50,4440,3208;4022,1825,0,0,0,2,2
22762,50,4442,3648;7523,1825,0,0,0,2,2
22763,50,4444,3384,1825,0,0,0,1,1
22764,50,4445,1122;3193,1825,0,0,1,1,2
22765,50,4446,8285;9419;13616,1825,0,0,3,0,3
22766,50,4451,3595;9677;11487,1825,0,0,2,1,3
22767,50,4452,4374,1825,0,0,0,1,1
22768,50,4453,3961;4062,1825,0,0,0,2,2
22769,50,4454,1151;3962,1825,0,0,0,2,2
22770,50,4455,4046;11241,1825,0,0,1,1,2
22771,50,4457,1387;4586;13006,1825,0,0,3,0,3
22772,50,4460,4474,1825,0,0,0,1,1
22773,50,4461,4487;8672,1825,0,0,0,2,2
22774,50,4462,4678;4838,1825,0,0,0,2,2
22775,50,4464,5160;7570,1825,0,0,1,1,2
22776,50,4470,8552,1825,0,0,0,1,1
22777,50,4471,2285;5046;11572,1825,0,0,1,2,3
22778,50,4472,5234,1825,0,0,0,1,1
22779,50,4473,5235,1825,0,0,0,1,1
22780,50,4477,5546,1825,0,0,0,1,1
22781,50,4483,4314,1825,0,0,0,1,1
22782,50,4485,5811;9714;12166,1825,0,0,1,2,3
22783,50,4486,6313;8561,1825,0,0,1,1,2
22784,50,4489,5703;6530;12496,1825,0,0,1,2,3
22785,50,4490,356;9041;12700,1825,0,0,2,1,3
22786,50,4491,6649,1825,0,0,0,1,1
22787,50,4492,3136;6070,1825,0,0,2,0,2
22788,50,4493,3539,1825,0,0,0,1,1
22789,50,4498,7256;7508,1825,0,0,0,2,2
22790,50,4501,7051;7382,1825,0,0,0,2,2
22791,50,4503,773,1825,0,0,0,1,1
22792,50,4505,2180;6582,1825,0,0,1,1,2
22793,50,4507,9329,1825,0,0,0,1,1
22794,50,4508,5448;11859,1825,0,0,1,1,2
22795,50,4510,7882;8985,1825,0,0,1,1,2
22796,50,4511,7933,1825,0,0,0,1,1
22797,50,4520,4103;8628,1825,0,0,1,1,2
22798,50,4521,1343;9352,1825,0,0,0,2,2
22799,50,4522,3362;8176,1825,0,0,0,2,2
22800,50,4524,4522;9032,1825,0,0,0,2,2
22801,50,4525,1055;8168,1825,0,0,0,2,2
22802,50,4526,7601;9097,1825,0,0,0,2,2
22803,50,4530,404;568;12854,1825,0,0,3,0,3
22804,50,4531,2156;9368;11630,1825,0,0,1,2,3
22805,50,4533,3538;13173;13618,1825,0,0,3,0,3
22806,50,4534,2366;9817,1825,0,0,0,2,2
22807,50,4536,1317;9963,1825,0,0,0,2,2
22808,50,4538,4274,2190,0,0,0,1,1
22809,50,4539,112;2881,2190,0,0,1,1,2
22810,50,4542,863;6330,2190,0,0,0,2,2
22811,50,4544,209;5210,2190,0,0,0,2,2
22812,50,4548,1556,2190,0,0,0,1,1
22813,50,4551,1788;3004,2190,0,0,0,2,2
22814,50,4554,2141;5166,2190,0,0,0,2,2
22815,50,4555,8864;9882,2190,0,0,0,2,2
22816,50,4556,2480,2190,0,0,0,1,1
22817,50,4558,2621;9006,2190,0,0,0,2,2
22818,50,4559,2655,2190,0,0,0,1,1
22819,50,4560,2670;7671,2190,0,0,0,2,2
22820,50,4561,1363;2811;11779,2190,0,0,1,2,3
22821,50,4562,2821,2190,0,0,0,1,1
22822,50,4563,2865;3315,2190,0,0,2,0,2
22823,50,4566,5706,2190,0,0,0,1,1
22824,50,4569,7343;8619,2190,0,0,1,1,2
22825,50,4571,9459,2190,0,0,0,1,1
22826,50,4572,3531;4654,2190,0,0,1,1,2
22827,50,4574,2433;8336;12865,2190,0,0,3,0,3
22828,50,4576,3768;9897,2190,0,0,0,2,2
22829,50,4578,2295;3860,2190,0,0,0,2,2
22830,50,4579,3955;8124,2190,0,0,0,2,2
22831,50,4580,2490,2190,0,0,0,1,1
22832,50,4582,4073,2190,0,0,0,1,1
22833,50,4583,4475;8679;11414,2190,0,0,2,1,3
22834,50,4585,8388;9573,2190,0,0,1,1,2
22835,50,4587,4813,2190,0,0,0,1,1
22836,50,4591,817;1415,2190,0,0,0,2,2
22837,50,4593,1824;5606;12966,2190,0,0,3,0,3
22838,50,4597,8349,2190,0,0,0,1,1
22839,50,4598,6170,2190,0,0,1,0,1
22840,50,4599,3985,2190,0,0,0,1,1
22841,50,4600,6118;6503,2190,0,0,0,2,2
22842,50,4601,1116,2190,0,0,0,1,1
22843,50,4605,6594,2190,0,0,0,1,1
22844,50,4606,5432,2190,0,0,0,1,1
22845,50,4607,3164;6774,2190,0,0,0,2,2
22846,50,4608,7001,2190,0,0,0,1,1
22847,50,4610,7102,2190,0,0,0,1,1
22848,50,4611,6191,2190,0,0,1,0,1
22849,50,4612,7331;9854,2190,0,0,0,2,2
22850,50,4613,7353;7691,2190,0,0,0,2,2
22851,50,4614,6193,2190,0,0,0,1,1
22852,50,4615,5518;7705,2190,0,0,0,2,2
22853,50,4619,4141;7874,2190,0,0,0,2,2
22854,50,4621,8479,2190,0,0,0,1,1
22855,50,4624,8318,2190,0,0,0,1,1
22856,50,4629,5261;8798,2190,0,0,0,2,2
22857,50,4633,9370,2190,0,0,0,1,1
22858,50,4634,9926,2190,0,0,0,1,1
22859,50,4639,537;8408;12418;14076,2190,0,0,4,0,4
22860,50,4640,2500;13269,2190,0,0,2,0,2
22861,50,4643,10;4053,2190,0,0,0,2,2
22862,50,4645,232,2555,0,0,0,1,1
22863,50,4646,2892;9449,2555,0,0,0,2,2
22864,50,4647,278,2555,0,0,0,1,1
22865,50,4649,350;8039,2555,0,0,1,1,2
22866,50,4650,355;4375,2555,0,0,0,2,2
22867,50,4653,9265,2555,0,0,0,1,1
22868,50,4654,1332;3338,2555,0,0,0,2,2
22869,50,4655,4548;9358;12217;12444,2555,0,0,2,2,4
22870,50,4656,1372;5661,2555,0,0,0,2,2
22871,50,4657,1399;5981,2555,0,0,1,1,2
22872,50,4658,6354,2555,0,0,1,0,1
22873,50,4660,1901,2555,0,0,0,1,1
22874,50,4661,1653;1932,2555,0,0,2,0,2
22875,50,4662,590;1935,2555,0,0,1,1,2
22876,50,4664,1230;2289,2555,0,0,0,2,2
22877,50,4666,603;3678,2555,0,0,2,0,2
22878,50,4668,2605;8226,2555,0,0,0,2,2
22879,50,4670,2766;4979;11754,2555,0,0,2,1,3
22880,50,4671,2800;9501,2555,0,0,0,2,2
22881,50,4672,2058;6971,2555,0,0,1,1,2
22882,50,4674,1207;3144,2555,0,0,0,2,2
22883,50,4675,1494,2555,0,0,0,1,1
22884,50,4676,3277,2555,0,0,1,0,1
22885,50,4677,1505;3524,2555,0,0,0,2,2
22886,50,4678,3574;6102,2555,0,0,2,0,2
22887,50,4679,3703;6767,2555,0,0,0,2,2
22888,50,4681,3766;7342,2555,0,0,1,1,2
22889,50,4683,7391;11445,2555,0,0,2,0,2
22890,50,4684,4224;9996,2555,0,0,0,2,2
22891,50,4686,4258;7255,2555,0,0,0,2,2
22892,50,4688,4272,2555,0,0,1,0,1
22893,50,4689,1692;2168,2555,0,0,2,0,2
22894,50,4692,9588,2555,0,0,1,0,1
22895,50,4700,2067;8680,2555,0,0,0,2,2
22896,50,4706,4978;5604,2555,0,0,0,2,2
22897,50,4708,5691;6164,2555,0,0,0,2,2
22898,50,4710,2692;5988;12833,2555,0,0,2,1,3
22899,50,4715,1910,2555,0,0,0,1,1
22900,50,4716,5330;6440,2555,0,0,0,2,2
22901,50,4718,272;6701,2555,0,0,0,2,2
22902,50,4720,6769;9356,2555,0,0,0,2,2
22903,50,4721,6778,2555,0,0,0,1,1
22904,50,4723,6867;13094,2555,0,0,1,1,2
22905,50,4724,8822;12875;13430,2555,0,0,3,0,3
22906,50,4725,6951;8831,2555,0,0,0,2,2
22907,50,4726,7078;8122,2555,0,0,1,1,2
22908,50,4728,7820,2555,0,0,0,1,1
22909,50,4729,3125;7569,2555,0,0,0,2,2
22910,50,4730,4649;8516,2555,0,0,0,2,2
22911,50,4731,6037;6406,2555,0,0,1,1,2
22912,50,4734,1801;3436,2555,0,0,0,2,2
22913,50,4735,8087,2555,0,0,0,1,1
22914,50,4736,8157,2555,0,0,0,1,1
22915,50,4737,3218;8271,2555,0,0,0,2,2
22916,50,4738,986;8501,2555,0,0,0,2,2
22917,50,4739,8596,2555,0,0,0,1,1
22918,50,4740,7072;8740;13145,2555,0,0,1,2,3
22919,50,4746,3418;9214,2555,0,0,0,2,2
22920,50,4747,9328,2555,0,0,0,1,1
22921,50,4750,7341;9499,2555,0,0,2,0,2
22922,50,4755,9883,2555,0,0,1,0,1
22923,50,4757,11953;12159;15793,2555,0,1,2,0,3
22924,50,4759,146;4129;12737,2920,0,0,2,1,3
22925,50,4761,9145;9607,2920,0,0,0,2,2
22926,50,4767,687,2920,0,0,0,1,1
22927,50,4770,864;12991,2920,0,0,1,1,2
22928,50,4771,1016,2920,0,0,0,1,1
22929,50,4772,892;12137,2920,0,0,1,1,2
22930,50,4774,1099;2787,2920,0,0,1,1,2
22931,50,4775,1634;2355;11951;12578,2920,0,0,2,2,4
22932,50,4776,1123;1648,2920,0,0,1,1,2
22933,50,4778,931;1882,2920,0,0,0,2,2
22934,50,4779,1936;5013,2920,0,0,0,2,2
22935,50,4780,933;2290;11857,2920,0,0,2,1,3
22936,50,4781,2169;8292;13074,2920,0,0,1,2,3
22937,50,4782,1925;8493,2920,0,0,0,2,2
22938,50,4784,2840;8627;12929,2920,0,0,2,1,3
22939,50,4788,55;2960,2920,0,0,2,0,2
22940,50,4789,3155;3704,2920,0,0,1,1,2
22941,50,4792,3207;4713,2920,0,0,2,0,2
22942,50,4793,159;7185;12906,2920,0,0,2,1,3
22943,50,4794,3449;12782,2920,0,0,2,0,2
22944,50,4796,2817;4500,2920,0,0,0,2,2
22945,50,4797,3959;7682;11794,2920,0,0,1,2,3
22946,50,4798,6375,2920,0,0,0,1,1
22947,50,4800,3626,2920,0,0,0,1,1
22948,50,4801,3695;9392,2920,0,0,1,1,2
22949,50,4802,3812;7921,2920,0,0,0,2,2
22950,50,4803,8417;9797,2920,0,0,0,2,2
22951,50,4804,3849;3879,2920,0,0,0,2,2
22952,50,4805,3940;7403,2920,0,0,0,2,2
22953,50,4806,1548;8425,2920,0,0,0,2,2
22954,50,4807,4044,2920,0,0,0,1,1
22955,50,4808,4411;9684;11912,2920,0,0,1,2,3
22956,50,4811,2359;4399,2920,0,0,0,2,2
22957,50,4813,3518;4949,2920,0,0,1,1,2
22958,50,4814,5086;6295;12638,2920,0,0,2,1,3
22959,50,4816,4924;8019;13244,2920,0,0,3,0,3
22960,50,4817,4637;12358,2920,0,0,1,1,2
22961,50,4821,2581;6770;13095,2920,0,0,3,0,3
22962,50,4822,5864;7034;11741;13352,2920,0,0,2,2,4
22963,50,4824,4582;11871,2920,0,0,1,1,2
22964,50,4825,6284,2920,0,0,1,0,1
22965,50,4826,6454;8443;12043,2920,0,0,1,2,3
22966,50,4827,4723;6464,2920,0,0,2,0,2
22967,50,4829,6688;6700,2920,0,0,2,0,2
22968,50,4830,4799;6718,2920,0,0,1,1,2
22969,50,4831,293,2920,0,0,1,0,1
22970,50,4833,3120,2920,0,0,1,0,1
22971,50,4836,1084;6636,2920,0,0,0,2,2
22972,50,4839,561;6604;11878;13495,2920,0,0,3,1,4
22973,50,4841,2816;7889,2920,0,0,1,1,2
22974,50,4844,8167,2920,0,0,1,0,1
22975,50,4846,6989;8807;12148,2920,0,0,2,1,3
22976,50,4851,6581;8169,2920,0,0,1,1,2
22977,50,4854,2093;8997,2920,0,0,0,2,2
22978,50,4856,1647;9196,2920,0,0,0,2,2
22979,50,4857,8123;9355;12272,2920,0,0,2,1,3
22980,50,4858,3895;7012;12567,2920,0,0,1,2,3
22981,50,4859,513;9664,2920,0,0,1,1,2
22982,50,4860,6036;9681,2920,0,0,1,1,2
22983,50,4862,9833,2920,0,0,0,1,1
22984,50,4863,848,2920,0,0,0,1,1
22985,50,4864,3011;6689,2920,0,0,0,2,2
22986,50,4867,37,3285,0,0,1,0,1
22987,50,4869,116;4373,3285,0,0,1,1,2
22988,50,4871,4628;11309,3285,0,0,2,0,2
22989,50,4872,188;8187,3285,0,0,0,2,2
22990,50,4873,6408;6820,3285,0,0,1,1,2
22991,50,4875,6629;7036,3285,0,0,2,0,2
22992,50,4876,536;4280,3285,0,0,0,2,2
22993,50,4878,6699;9280,3285,0,0,2,0,2
22994,50,4880,6111;9879;13615,3285,0,0,3,0,3
22995,50,4881,952;11744;12400,3285,0,0,2,1,3
22996,50,4882,9799,3285,0,0,1,0,1
22997,50,4883,3376;9816,3285,0,0,2,0,2
22998,50,4891,4435;9649,3285,0,0,1,1,2
22999,50,4893,4109;9245,3285,0,0,2,0,2
23000,50,4894,936,3285,0,0,0,1,1
23001,50,4896,3788,3285,0,0,0,1,1
23002,50,4898,1386;2493;12824;13204,3285,0,0,4,0,4
23003,50,4899,3698;5159,3285,0,0,1,1,2
23004,50,4900,4553;8903,3285,0,0,1,1,2
23005,50,4905,3276;6405,3285,0,0,2,0,2
23006,50,4907,1304;8650;12262;13348,3285,0,0,4,0,4
23007,50,4909,3523;5949;13552,3285,0,0,2,1,3
23008,50,4910,6559,3285,0,0,1,0,1
23009,50,4913,3633;8214,3285,0,0,0,2,2
23010,50,4914,4401;7180;12698,3285,0,0,1,2,3
23011,50,4915,3672;6847,3285,0,0,1,1,2
23012,50,4916,4576,3285,0,0,1,0,1
23013,50,4918,3869;9188;12462,3285,0,0,2,1,3
23014,50,4919,3070,3285,0,0,1,0,1
23015,50,4922,1318,3285,0,0,0,1,1
23016,50,4923,4499,3285,0,0,0,1,1
23017,50,4925,4721,3285,0,0,1,0,1
23018,50,4927,2217;4131,3285,0,0,0,2,2
23019,50,4931,5936;7728,3285,0,0,2,0,2
23020,50,4932,4517,3285,0,0,0,1,1
23021,50,4933,2383;5863,3285,0,0,1,1,2
23022,50,4934,5257;8595,3285,0,0,0,2,2
23023,50,4935,3741;9454;12637;13660,3285,0,0,4,0,4
23024,50,4937,6188;8928,3285,0,0,1,1,2
23025,50,4938,4514;6285,3285,0,0,2,0,2
23026,50,4939,2080;6486,3285,0,0,0,2,2
23027,50,4941,4850;6727,3285,0,0,0,2,2
23028,50,4944,8808,3285,0,0,1,0,1
23029,50,4945,3417;6792;12198,3285,0,0,3,0,3
23030,50,4947,1640;7192,3285,0,0,1,1,2
23031,50,4949,2215;2395,3285,0,0,2,0,2
23032,50,4950,4293,3285,0,0,0,1,1
23033,50,4951,2839;7461;12994,3285,0,0,3,0,3
23034,50,4952,3575;7488,3285,0,0,2,0,2
23035,50,4959,6542,3285,0,0,0,1,1
23036,50,4960,5000;8466,3285,0,0,1,1,2
23037,50,4962,5021;9351,3285,0,0,0,2,2
23038,50,4964,8623,3285,0,0,1,0,1
23039,50,4966,7330;9017,3285,0,0,0,2,2
23040,50,4971,5675;8262,3285,0,0,0,2,2
23041,50,4972,6064;7025,3285,0,0,0,2,2
23042,50,4973,2654;9818;12669;13110;13585,3285,0,0,5,0,5
23043,50,4975,9739,3285,0,0,1,0,1
23044,50,4977,153;7525;13942,3650,0,0,3,0,3
23045,50,4978,348;7068,3650,0,0,1,1,2
23046,50,4979,360;3298,3650,0,0,1,1,2
23047,50,4980,336;4294,3650,0,0,0,2,2
23048,50,4981,1364;6494;12340;12790;13093,3650,0,0,5,0,5
23049,50,4982,2656;7746;11999;14072,3650,0,0,3,1,4
23050,50,4984,1139;6878,3650,0,0,2,0,2
23051,50,4987,3381;8110;13504;13822,3650,0,0,4,0,4
23052,50,4989,1351;9455;12029,3650,0,0,2,1,3
23053,50,4990,1115;2799,3650,0,0,2,0,2
23054,50,4994,1933;9651,3650,0,0,1,1,2
23055,50,4998,2384;9891;13820;14166;14730,3650,0,1,4,0,5
23056,50,4999,2404;5244,3650,0,0,2,0,2
23057,50,5001,2593;6933,3650,0,0,0,2,2
23058,50,5002,3520;8177,3650,0,0,2,0,2
23059,50,5003,7275,3650,0,0,1,0,1
23060,50,5004,1141;1599;13548,3650,0,0,3,0,3
23061,50,5006,8826,3650,0,0,0,1,1
23062,50,5008,333;6616;11931,3650,0,0,3,0,3
23063,50,5011,4308;4859;12509,3650,0,0,3,0,3
23064,50,5012,393;1666,3650,0,0,0,2,2
23065,50,5014,630;4581,3650,0,0,2,0,2
23066,50,5015,2669;7729,3650,0,0,2,0,2
23067,50,5016,8842,3650,0,0,0,1,1
23068,50,5017,4953;8796,3650,0,0,1,1,2
23069,50,5020,111;5195,3650,0,0,0,2,2
23070,50,5023,6278;8589;11848,3650,0,0,2,1,3
23071,50,5024,6694;6750,3650,0,0,0,2,2
23072,50,5025,147;8306,3650,0,0,0,2,2
23073,50,5028,3492;5950;13874,3650,0,0,3,0,3
23074,50,5029,6068;6846,3650,0,0,0,2,2
23075,50,5030,444;6773,3650,0,0,2,0,2
23076,50,5031,2629;6661,3650,0,0,2,0,2
23077,50,5036,9139;9423,3650,0,0,2,0,2
23078,50,5038,6592;8005,3650,0,0,0,2,2
23079,50,5039,2475;8106,3650,0,0,2,0,2
23080,50,5041,2033;6612,3650,0,0,2,0,2
23081,50,5042,8291;13021;13458,3650,0,0,3,0,3
23082,50,5044,9634,3650,0,0,0,1,1
23083,50,5045,8977;13007,3650,0,0,2,0,2
23084,50,5046,4045;8384,3650,0,0,0,2,2
23085,50,5047,5964;9826;12671,3650,0,0,3,0,3
23086,50,5049,3;1485,3650,0,0,2,0,2
23087,50,5051,706;9517,3650,0,0,0,2,2
23088,50,5052,3802;9637,3650,0,0,2,0,2
23089,50,5053,9642,3650,0,0,0,1,1
23090,50,5054,7969;9782;13425,3650,0,0,3,0,3
23091,50,5056,36;2291,4015,0,0,1,1,2
23092,50,5058,49;5525;12922,4015,0,0,1,2,3
23093,50,5060,189;2959,4015,0,0,2,0,2
23094,50,5061,239;13218,4015,0,0,1,1,2
23095,50,5063,298,4015,0,0,0,1,1
23096,50,5067,43,4015,0,0,0,1,1
23097,50,5070,2008;3087;11257,4015,0,0,3,0,3
23098,50,5071,1593,4015,0,0,0,1,1
23099,50,5072,1608;13105,4015,0,0,2,0,2
23100,50,5074,6296;6531,4015,0,0,2,0,2
23101,50,5075,2010;9285,4015,0,0,0,2,2
23102,50,5076,2273,4015,0,0,1,0,1
23103,50,5077,9226;13647,4015,0,0,2,0,2
23104,50,5079,2498;12747,4015,0,0,2,0,2
23105,50,5081,2972;5025,4015,0,0,2,0,2
23106,50,5085,2244,4015,0,0,0,1,1
23107,50,5086,3010;3027,4015,0,0,0,2,2
23108,50,5087,1746;2979,4015,0,0,2,0,2
23109,50,5088,1979;3173,4015,0,0,1,1,2
23110,50,5090,3335,4015,0,0,0,1,1
23111,50,5091,1987;13071,4015,0,0,2,0,2
23112,50,5092,8290;8567;11841;12050,4015,0,0,3,1,4
23113,50,5093,3527,4015,0,0,0,1,1
23114,50,5094,3636,4015,0,0,0,1,1
23115,50,5095,3673,4015,0,0,0,1,1
23116,50,5098,3076;4186,4015,0,0,0,2,2
23117,50,5099,4283;9985,4015,0,0,1,1,2
23118,50,5101,4486;6157,4015,0,0,1,1,2
23119,50,5102,3872;4510,4015,0,0,2,0,2
23120,50,5103,4607,4015,0,0,0,1,1
23121,50,5105,4874;8014,4015,0,0,0,2,2
23122,50,5106,1010,4015,0,0,1,0,1
23123,50,5107,5616,4015,0,0,0,1,1
23124,50,5111,1252;12428,4015,0,0,1,1,2
23125,50,5112,9485,4015,0,0,1,0,1
23126,50,5116,6240;8469,4015,0,0,0,2,2
23127,50,5117,1751;5382;12741;14204,4015,0,0,4,0,4
23128,50,5118,2265;8815;12194,4015,0,0,1,2,3
23129,50,5120,5723;7418;13340;13645,4015,0,0,4,0,4
23130,50,5121,5722;6595,4015,0,0,1,1,2
23131,50,5124,2175;6981;13433,4015,0,0,3,0,3
23132,50,5125,1339;3960,4015,0,0,1,1,2
23133,50,5126,3215;7073;12705,4015,0,0,3,0,3
23134,50,5127,7739;9045;11983,4015,0,0,3,0,3
23135,50,5129,3674;7494,4015,0,0,0,2,2
23136,50,5130,3986;5396,4015,0,0,2,0,2
23137,50,5134,9844,4015,0,0,1,0,1
23138,50,5137,8756,4015,0,0,0,1,1
23139,50,5140,4655;8037,4015,0,0,2,0,2
23140,50,5142,5063;8986;11818,4015,0,0,3,0,3
23141,50,5144,479;9220;13831,4015,0,0,3,0,3
23142,50,5146,9118;9665;13513,4015,0,0,3,0,3
23143,50,5147,3696;9687,4015,0,0,2,0,2
23144,50,5149,9756;11429;12749,4015,0,0,3,0,3
23145,50,5153,74;1064;11868,4380,0,0,3,0,3
23146,50,5157,347;5353,4380,0,0,2,0,2
23147,50,5158,1637;4307,4380,0,0,2,0,2
23148,50,5161,3758;5002,4380,0,0,2,0,2
23149,50,5163,2783;3407,4380,0,0,1,1,2
23150,50,5165,891;1270;12979,4380,0,0,2,1,3
23151,50,5167,7990;8198,4380,0,0,2,0,2
23152,50,5168,1136;2322,4380,0,0,2,0,2
23153,50,5173,1313;6954,4380,0,0,2,0,2
23154,50,5174,2083;9345,4380,0,0,0,2,2
23155,50,5175,2091;7894;13048,4380,0,0,2,1,3
23156,50,5177,2231,4380,0,0,1,0,1
23157,50,5179,5970,4380,0,0,0,1,1
23158,50,5183,2544;7024,4380,0,0,2,0,2
23159,50,5184,2798,4380,0,0,1,0,1
23160,50,5188,2390;2807,4380,0,0,0,2,2
23161,50,5189,2891;7222;14254,4380,0,1,2,0,3
23162,50,5190,1192;13750,4380,0,0,2,0,2
23163,50,5191,2995;5072;12129;12369,4380,0,0,4,0,4
23164,50,5194,1001;3121,4380,0,0,2,0,2
23165,50,5196,3351,4380,0,0,0,1,1
23166,50,5197,3202;3468,4380,0,0,1,1,2
23167,50,5198,2742;3493,4380,0,0,0,2,2
23168,50,5199,1698;8515;13005,4380,0,0,3,0,3
23169,50,5202,3856,4380,0,0,0,1,1
23170,50,5203,2239;6158;11695,4380,0,0,3,0,3
23171,50,5204,5425;7914,4380,0,0,2,0,2
23172,50,5207,1427;6453;12740;13381,4380,0,0,4,0,4
23173,50,5208,4855;8497;12575,4380,0,0,3,0,3
23174,50,5211,7873;8853,4380,0,0,2,0,2
23175,50,5213,1705;3738,4380,0,0,2,0,2
23176,50,5215,4816,4380,0,0,0,1,1
23177,50,5218,5212;9321,4380,0,0,0,2,2
23178,50,5219,1148,4380,0,0,0,1,1
23179,50,5220,7872;8899,4380,0,0,1,1,2
23180,50,5222,7681;8779;13241,4380,0,0,3,0,3
23181,50,5225,4267;7777;12642,4380,0,0,2,1,3
23182,50,5226,7683,4380,0,0,0,1,1
23183,50,5230,2385;6973,4380,0,0,1,1,2
23184,50,5232,2880;7029,4380,0,0,2,0,2
23185,50,5233,4263,4380,0,0,0,1,1
23186,50,5236,7306;13176,4380,0,0,2,0,2
23187,50,5238,7357,4380,0,0,1,0,1
23188,50,5240,2108;7503,4380,0,0,2,0,2
23189,50,5242,7077;7679;12071,4380,0,0,2,1,3
23190,50,5245,3402;7913;12468,4380,0,0,3,0,3
23191,50,5246,2555;11773;12113,4380,0,0,3,0,3
23192,50,5252,4449;8741;13858,4380,0,0,2,1,3
23193,50,5253,12456;12548;12839,4380,0,0,3,0,3
23194,50,5254,3710;8643;12947,4380,0,0,3,0,3
23195,50,5257,1509;9040,4380,0,0,0,2,2
23196,50,5260,2240;3951,4380,0,0,0,2,2
23197,50,5261,503;9589;12723,4380,0,0,3,0,3
23198,50,5263,6948;7236,4380,0,0,0,2,2
23199,50,5265,4016;5451,4745,0,0,0,2,2
23200,50,5266,25,4745,0,0,0,1,1
23201,50,5267,107;4601,4745,0,0,2,0,2
23202,50,5268,240;12487,4745,0,0,2,0,2
23203,50,5274,786;6275;13588,4745,0,0,3,0,3
23204,50,5279,1654;3028,4745,0,0,2,0,2
23205,50,5282,1609;4481,4745,0,0,2,0,2
23206,50,5285,7019,4745,0,0,0,1,1
23207,50,5286,2893;7142,4745,0,0,2,0,2
23208,50,5287,2462;3944,4745,0,0,0,2,2
23209,50,5288,9450;9976;11584;13839;14097,4745,0,0,5,0,5
23210,50,5291,1766;2842;12882,4745,0,0,3,0,3
23211,50,5292,7385;8894,4745,0,0,2,0,2
23212,50,5295,3234;9033,4745,0,0,2,0,2
23213,50,5299,837;3467,4745,0,0,0,2,2
23214,50,5300,1652;3401,4745,0,0,2,0,2
23215,50,5302,1787;3749;13353,4745,0,0,3,0,3
23216,50,5305,1966;13484;13804;14028,4745,0,0,4,0,4
23217,50,5306,3945;8759;13065,4745,0,0,3,0,3
23218,50,5308,1344;4252,4745,0,0,2,0,2
23219,50,5309,1416;9015;13491,4745,0,0,2,1,3
23220,50,5315,5044;8566,4745,0,0,2,0,2
23221,50,5316,5181;7747;14219,4745,0,0,3,0,3
23222,50,5317,1444,4745,0,0,0,1,1
23223,50,5318,3458;14201,4745,0,0,2,0,2
23224,50,5319,3380;12352;13420,4745,0,0,3,0,3
23225,50,5320,3859;4630;13649,4745,0,0,3,0,3
23226,50,5323,6;3069;12398,4745,0,0,1,2,3
23227,50,5326,4509;7212,4745,0,0,2,0,2
23228,50,5327,2434;7127,4745,0,0,2,0,2
23229,50,5328,801;6555;12481;13885,4745,0,0,4,0,4
23230,50,5335,7149;7414,4745,0,0,0,2,2
23231,50,5336,1161;6353,4745,0,0,2,0,2
23232,50,5337,2494;7276;13247;13943,4745,0,0,4,0,4
23233,50,5338,3238;7300,4745,0,0,1,1,2
23234,50,5339,7496;7704,4745,0,0,1,1,2
23235,50,5341,1789;7553;13117,4745,0,0,2,1,3
23236,50,5342,54;2117,4745,0,0,0,2,2
23237,50,5343,3956;8505,4745,0,0,0,2,2
23238,50,5344,6918;8514,4745,0,0,2,0,2
23239,50,5345,8520,4745,0,0,1,0,1
23240,50,5346,9693,4745,0,0,1,0,1
23241,50,5347,5137;8065,4745,0,0,2,0,2
23242,50,5348,1750,4745,0,0,0,1,1
23243,50,5349,8629;9003;12447,4745,0,0,3,0,3
23244,50,5350,2699;4809;12923;13140,4745,0,0,4,0,4
23245,50,5351,212;1500;12636,4745,0,0,3,0,3
23246,50,5352,953;12459;13043,4745,0,0,3,0,3
23247,50,5353,9417,4745,0,0,1,0,1
23248,50,5355,2449,4745,0,0,1,0,1
23249,50,5357,3457,4745,0,0,0,1,1
23250,50,5358,294;3834;11914;13824;14125,4745,0,0,5,0,5
23251,50,5359,9726,4745,0,0,0,1,1
23252,50,5363,7696;12127;12883;13414,5110,0,0,4,0,4
23253,50,5364,216;8560;12383;12399,5110,0,0,4,0,4
23254,50,5367,639;898,5110,0,0,2,0,2
23255,50,5368,648;1572;13076;15578,5110,0,1,3,0,4
23256,50,5369,7460;8922;13656,5110,0,0,2,1,3
23257,50,5372,1477;1714;12744,5110,0,0,3,0,3
23258,50,5373,679,5110,0,0,1,0,1
23259,50,5377,944;6905,5110,0,0,2,0,2
23260,50,5378,9112,5110,0,0,0,1,1
23261,50,5380,2789;6567;13267,5110,0,0,3,0,3
23262,50,5384,2031;3428;12401;13355,5110,0,0,4,0,4
23263,50,5385,3611;8133,5110,0,0,1,1,2
23264,50,5386,3691;9709;12667;13722,5110,0,0,4,0,4
23265,50,5388,1986;5573,5110,0,0,1,1,2
23266,50,5390,9558,5110,0,0,0,1,1
23267,50,5391,4035;6169,5110,0,0,1,1,2
23268,50,5393,4070;13332,5110,0,0,2,0,2
23269,50,5397,2364;4963;13726,5110,0,0,3,0,3
23270,50,5398,5031;5688,5110,0,0,1,1,2
23271,50,5401,4595;5674;13723;14271,5110,0,1,3,0,4
23272,50,5404,4043;13164,5110,0,0,2,0,2
23273,50,5406,6154;11968,5110,0,0,2,0,2
23274,50,5408,480;4021;13477,5110,0,0,3,0,3
23275,50,5409,802;9134;12579,5110,0,0,2,1,3
23276,50,5410,6693;7500;13273,5110,0,0,3,0,3
23277,50,5411,2594;2750,5110,0,0,1,1,2
23278,50,5412,6791;6950,5110,0,0,2,0,2
23279,50,5413,6875;8845;12993,5110,0,0,3,0,3
23280,50,5414,7030,5110,0,0,0,1,1
23281,50,5415,2870;7039;11812;13818;14762,5110,0,1,4,0,5
23282,50,5416,3476,5110,0,0,1,0,1
23283,50,5417,7367;8050,5110,0,0,0,2,2
23284,50,5420,9251,5110,0,0,0,1,1
23285,50,5421,7332;7697;12433,5110,0,0,3,0,3
23286,50,5422,3437;8746;12086,5110,0,0,3,0,3
23287,50,5424,1239;8252,5110,0,0,0,2,2
23288,50,5426,753;8827;13730,5110,0,0,3,0,3
23289,50,5428,6526;9068,5110,0,0,1,1,2
23290,50,5429,5806;9210;13298;13626,5110,0,0,4,0,4
23291,50,5433,1471;6404;12416;12903;13956,5110,0,0,5,0,5
23292,50,5434,5735;9853;12537;13783,5110,0,0,4,0,4
23293,50,5435,352,5110,0,0,0,1,1
23294,50,5436,2963;7561,5475,0,0,2,0,2
23295,50,5437,87;631;14249,5475,0,1,2,0,3
23296,50,5438,6130,5475,0,0,0,1,1
23297,50,5440,378;5043;13402,5475,0,0,3,0,3
23298,50,5441,431;5792;12421,5475,0,0,3,0,3
23299,50,5443,2651;9783;14018,5475,0,0,3,0,3
23300,50,5444,896;7826;13304;13494,5475,0,0,4,0,4
23301,50,5445,902;9940;13859,5475,0,0,3,0,3
23302,50,5446,1163;4290;13354,5475,0,0,3,0,3
23303,50,5447,8288;13413;13957,5475,0,0,3,0,3
23304,50,5448,1093;12884;13715,5475,0,0,3,0,3
23305,50,5449,987;3045,5475,0,0,2,0,2
23306,50,5451,1584;12937,5475,0,0,2,0,2
23307,50,5452,349;6112;13184,5475,0,0,3,0,3
23308,50,5456,1575;5232;13156;13457;14223,5475,0,0,5,0,5
23309,50,5457,2059,5475,0,0,0,1,1
23310,50,5458,5850;9365;13020;14449,5475,0,1,3,0,4
23311,50,5460,11441;11823;12513;13229;15656;15939;16023,5475,1,2,4,0,7
23312,50,5461,8863,5475,0,0,0,1,1
23313,50,5462,2146;2268;15210,5475,0,1,2,0,3
23314,50,5463,574;2159;12899,5475,0,0,3,0,3
23315,50,5466,2499;6108,5475,0,0,0,2,2
23316,50,5468,1451;2948,5475,0,0,2,0,2
23317,50,5471,3359;9082;13602,5475,0,0,3,0,3
23318,50,5472,6319;7119,5475,0,0,0,2,2
23319,50,5473,3504;3530;12973;13825,5475,0,0,4,0,4
23320,50,5475,3586;3639,5475,0,0,0,2,2
23321,50,5476,3794;5241;14178;14316,5475,0,1,3,0,4
23322,50,5478,5190;6117;12430,5475,0,0,3,0,3
23323,50,5480,4154,5475,0,0,0,1,1
23324,50,5482,1147;4736;12279,5475,0,0,3,0,3
23325,50,5486,1706;6675;13901,5475,0,0,3,0,3
23326,50,5487,5170;5196,5475,0,0,2,0,2
23327,50,5488,4140,5475,0,0,0,1,1
23328,50,5490,5526,5475,0,0,1,0,1
23329,50,5492,5725,5475,0,0,0,1,1
23330,50,5493,5843;9123,5475,0,0,0,2,2
23331,50,5494,9765;9849;14250,5475,0,1,2,0,3
23332,50,5495,6242,5475,0,0,0,1,1
23333,50,5497,6187;8010;13274;13693,5475,0,0,4,0,4
23334,50,5500,2481;6743;11997,5475,0,0,3,0,3
23335,50,5501,2964;13051;15144,5475,0,1,2,0,3
23336,50,5502,9776,5475,0,0,1,0,1
23337,50,5505,5985;7156;13582;13855,5475,0,0,4,0,4
23338,50,5508,4074;7383;14238,5475,0,1,2,0,3
23339,50,5510,7520;8376,5475,0,0,2,0,2
23340,50,5511,7659,5475,0,0,0,1,1
23341,50,5512,50;7323;12327;13600;14098,5475,0,0,5,0,5
23342,50,5517,1571;8273,5475,0,0,2,0,2
23343,50,5518,5787;8365;12844;13575,5475,0,0,4,0,4
23344,50,5519,8449,5475,0,0,0,1,1
23345,50,5521,3475;8556;13589,5475,0,0,3,0,3
23346,50,5522,3214;5441,5475,0,0,0,2,2
23347,50,5527,8785;12926,5475,0,0,2,0,2
23348,50,5532,2027;6857,5475,0,0,2,0,2
23349,50,5533,9215;13128,5475,0,0,2,0,2
23350,50,5535,2976;12798;13026,5475,0,0,3,0,3
23351,50,5539,26,5475,0,0,0,1,1
23352,50,5540,1450;12981,5475,0,0,2,0,2
23353,50,5543,61;8703;13118,5840,0,0,3,0,3
23354,50,5544,250;838;12939,5840,0,0,3,0,3
23355,50,5545,79;277;13742;13986;14435,5840,0,1,4,0,5
23356,50,5546,367;13648;14038,5840,0,0,3,0,3
23357,50,5548,1467;3969;12214,5840,0,0,3,0,3
23358,50,5549,632;2250,5840,0,0,2,0,2
23359,50,5553,1266;4571,5840,0,0,2,0,2
23360,50,5554,1267;5449;13837;13962,5840,0,0,4,0,4
23361,50,5555,319;8324,5840,0,0,2,0,2
23362,50,5556,3403;4385;12674;13190;13642;13808,5840,0,0,6,0,6
23363,50,5557,326;1649;12576,5840,0,0,2,1,3
23364,50,5559,674;8038;12315,5840,0,0,3,0,3
23365,50,5560,2365;5128,5840,0,0,2,0,2
23366,50,5561,2389;6632,5840,0,0,2,0,2
23367,50,5563,2694;4856;11895,5840,0,0,3,0,3
23368,50,5564,163;1803;13426,5840,0,0,3,0,3
23369,50,5567,2580;4542;13136,5840,0,0,2,1,3
23370,50,5569,2965;10100;14573,5840,0,1,2,0,3
23371,50,5571,8278;13530;13810,5840,0,0,3,0,3
23372,50,5573,1388;3156,5840,0,0,2,0,2
23373,50,5574,2910;4337;13415;14196,5840,0,0,4,0,4
23374,50,5580,470;1157;12943,5840,0,0,3,0,3
23375,50,5581,3841;9364;13634;14498;14568,5840,0,2,3,0,5
23376,50,5582,5174;5521;14053,5840,0,0,3,0,3
23377,50,5583,3863;10073,5840,0,0,2,0,2
23378,50,5584,4634,5840,0,0,1,0,1
23379,50,5585,2015;3367;14002;14107,5840,0,0,4,0,4
23380,50,5591,5666,5840,0,0,0,1,1
23381,50,5600,6809;9735;13903,5840,0,0,3,0,3
23382,50,5601,7054,5840,0,0,1,0,1
23383,50,5602,6444;9710,5840,0,0,2,0,2
23384,50,5603,1107;6839;13070;13251,5840,0,0,4,0,4
23385,50,5605,7324,5840,0,0,1,0,1
23386,50,5607,2085;9667;12506;13621,5840,0,0,4,0,4
23387,50,5608,5937;5962,5840,0,0,2,0,2
23388,50,5609,5202;5860;12715;13313;13854,5840,0,0,5,0,5
23389,50,5610,6212;7789;12493;14167,5840,0,0,4,0,4
23390,50,5611,7193;9418;13208,5840,0,0,3,0,3
23391,50,5612,2294;7818,5840,0,0,0,2,2
23392,50,5614,1544,5840,0,0,1,0,1
23393,50,5615,4617;8047,5840,0,0,2,0,2
23394,50,5617,4057;8302;12684;14400;15750,5840,0,2,3,0,5
23395,50,5618,7867,5840,0,0,1,0,1
23396,50,5620,9676,5840,0,0,0,1,1
23397,50,5624,5134;7128;12688,5840,0,0,3,0,3
23398,50,5626,5809,5840,0,0,1,0,1
23399,50,5627,9069;9506;13444,5840,0,0,3,0,3
23400,50,5628,9596;9608;12224,5840,0,0,3,0,3
23401,50,5629,2330;9654,5840,0,0,2,0,2
23402,50,5630,1096;4034;13088,5840,0,0,3,0,3
23403,50,5631,44;8612;13045,6205,0,0,3,0,3
23404,50,5632,2063;5929;13790,6205,0,0,3,0,3
23405,50,5633,219;8494,6205,0,0,2,0,2
23406,50,5635,665;7555;13677;14391,6205,0,1,3,0,4
23407,50,5638,4950;5799;13346,6205,0,0,1,2,3
23408,50,5639,1284;6363;13212,6205,0,0,3,0,3
23409,50,5640,1305;10038;13675,6205,0,0,3,0,3
23410,50,5641,1158;10204,6205,0,0,2,0,2
23411,50,5642,1428;3874;13806;14164,6205,0,0,4,0,4
23412,50,5643,1700;13735,6205,0,0,2,0,2
23413,50,5645,4656;10164;13490;14202,6205,0,0,4,0,4
23414,50,5648,1667;2539;13225;14103,6205,0,0,4,0,4
23415,50,5649,2092;8616,6205,0,0,1,1,2
23416,50,5650,10044;12036;13232,6205,0,0,3,0,3
23417,50,5651,2339;10055;13770,6205,0,0,3,0,3
23418,50,5654,804;2545;14080;14351,6205,0,1,3,0,4
23419,50,5655,6001;6207,6205,0,0,0,2,2
23420,50,5656,2741,6205,0,0,0,1,1
23421,50,5657,2369;3601;12822;13529;13785,6205,0,0,5,0,5
23422,50,5661,7191,6205,0,0,0,1,1
23423,50,5662,3071;10060;13374;13499;13894,6205,0,0,5,0,5
23424,50,5663,3107;9063,6205,0,0,0,2,2
23425,50,5664,6017,6205,0,0,0,1,1
23426,50,5665,10201;13995,6205,0,0,2,0,2
23427,50,5666,720;3281,6205,0,0,0,2,2
23428,50,5667,3737,6205,0,0,0,1,1
23429,50,5673,440;4257;13508,6205,0,0,3,0,3
23430,50,5674,10023;10180;13287,6205,0,0,3,0,3
23431,50,5676,1929;2234,6205,0,0,2,0,2
23432,50,5679,975,6205,0,0,0,1,1
23433,50,5680,4833;7037,6205,0,0,2,0,2
23434,50,5681,2876,6205,0,0,1,0,1
23435,50,5683,4106;5135;14179,6205,0,0,3,0,3
23436,50,5684,5144,6205,0,0,0,1,1
23437,50,5685,5297;13474;13959;14511,6205,0,1,3,0,4
23438,50,5686,5480;7304,6205,0,0,2,0,2
23439,50,5688,5186;5642,6205,0,0,2,0,2
23440,50,5692,5992;8052,6205,0,0,2,0,2
23441,50,5693,5969,6205,0,0,1,0,1
23442,50,5694,6554;6885;12935,6205,0,0,3,0,3
23443,50,5699,5228;6525;13261;13595,6205,0,0,4,0,4
23444,50,5700,6529,6205,0,0,0,1,1
23445,50,5701,741,6205,0,0,0,1,1
23446,50,5702,4680;6692,6205,0,0,1,1,2
23447,50,5703,1630;6967;13231;13969,6205,0,0,4,0,4
23448,50,5705,7706,6205,0,0,0,1,1
23449,50,5706,494;10054,6205,0,0,2,0,2
23450,50,5707,7466;9571,6205,0,0,0,2,2
23451,50,5708,3388;7510;13205;13525;13886,6205,0,0,5,0,5
23452,50,5709,7634;9827;13828;14171,6205,0,0,4,0,4
23453,50,5711,8092;8144,6205,0,0,0,2,2
23454,50,5712,430;1288,6205,0,0,1,1,2
23455,50,5713,466,6205,0,0,0,1,1
23456,50,5714,3811,6205,0,0,0,1,1
23457,50,5716,945;8642,6205,0,0,1,1,2
23458,50,5717,4959;8885,6205,0,0,2,0,2
23459,50,5719,93;9626;12584;14385,6205,0,1,3,0,4
23460,50,5720,6601;9266;14433,6205,0,1,2,0,3
23461,50,5722,9389;9400;12802,6205,0,0,3,0,3
23462,50,5723,6421;9394;12746;13312;14318,6205,0,1,4,0,5
23463,50,5724,1847;9606;14445,6205,0,1,2,0,3
23464,50,5725,7794;13358,6205,0,0,2,0,2
23465,50,5726,9741,6205,0,0,1,0,1
23466,50,5727,9751;13866,6205,0,0,2,0,2
23467,50,5729,135;9728;13545;13731,6570,0,0,4,0,4
23468,50,5732,10118;10294;13383,6570,0,0,3,0,3
23469,50,5733,4023;10174;14262,6570,0,1,2,0,3
23470,50,5734,612;13030;14712,6570,0,1,2,0,3
23471,50,5735,653,6570,0,0,1,0,1
23472,50,5739,1152;10042,6570,0,0,2,0,2
23473,50,5740,1242;3346,6570,0,0,2,0,2
23474,50,5742,7307;8332,6570,0,0,2,0,2
23475,50,5743,1308;10006;14615,6570,0,1,2,0,3
23476,50,5744,10146;13170,6570,0,0,2,0,2
23477,50,5746,1538;7344;12403,6570,0,0,3,0,3
23478,50,5747,1564;9150;13587;13852,6570,0,0,4,0,4
23479,50,5749,6482,6570,0,0,0,1,1
23480,50,5751,1940;10080;14677,6570,0,1,2,0,3
23481,50,5752,1721;10251;14111,6570,0,0,3,0,3
23482,50,5753,1726;8799,6570,0,0,2,0,2
23483,50,5760,6382;10088;14524,6570,0,1,2,0,3
23484,50,5761,2671,6570,0,0,0,1,1
23485,50,5762,2919;6088;14325,6570,0,1,2,0,3
23486,50,5763,3003;6466;12837;13319,6570,0,0,4,0,4
23487,50,5764,3190,6570,0,0,0,1,1
23488,50,5767,3377;6289,6570,0,0,0,2,2
23489,50,5768,477;3578;13437;14257,6570,0,1,3,0,4
23490,50,5771,1775;7464,6570,0,0,0,2,2
23491,50,5772,4455,6570,0,0,0,1,1
23492,50,5773,4633;13099;13780,6570,0,0,3,0,3
23493,50,5774,4694;6660,6570,0,0,1,1,2
23494,50,5776,6003;10167;13483;13769,6570,0,0,4,0,4
23495,50,5778,5442;6603,6570,0,0,2,0,2
23496,50,5781,4368;8375;12860;13235,6570,0,0,4,0,4
23497,50,5785,6197;9773,6570,0,0,0,2,2
23498,50,5786,4832;7665;13337,6570,0,0,3,0,3
23499,50,5787,461;9099;13270,6570,0,0,3,0,3
23500,50,5791,4093;8967;13876;14011,6570,0,0,4,0,4
23501,50,5793,1236;7121,6570,0,0,2,0,2
23502,50,5796,10112;13059;13532;14627,6570,0,1,3,0,4
23503,50,5798,2354;7762;13612;14145,6570,0,0,4,0,4
23504,50,5799,7765;10229;14378,6570,0,1,2,0,3
23505,50,5800,546;10084;13844;14538,6570,0,1,3,0,4
23506,50,5802,119;8051;13329;13566;13928,6570,0,0,5,0,5
23507,50,5806,2256;8396,6570,0,0,2,0,2
23508,50,5807,10063;12997;13917,6570,0,0,3,0,3
23509,50,5810,9292,6570,0,0,0,1,1
23510,50,5812,57;8220;12211;13524;13862,6570,0,0,5,0,5
23511,50,5813,5991;9425,6570,0,0,2,0,2
23512,50,5815,4704;9655;12752;14312,6570,0,1,3,0,4
23513,50,5819,476;12651;12843;13763,6935,0,0,4,0,4
23514,50,5820,10069;13542;14152,6935,0,0,3,0,3
23515,50,5821,7402;13488,6935,0,0,2,0,2
23516,50,5824,6344,6935,0,0,1,0,1
23517,50,5825,3748;13268,6935,0,0,2,0,2
23518,50,5827,9420,6935,0,0,1,0,1
23519,50,5831,1371;6920,6935,0,0,0,2,2
23520,50,5833,10048;10138;13905;14296,6935,0,1,3,0,4
23521,50,5835,2121;13551,6935,0,0,2,0,2
23522,50,5836,5643;10223;13576,6935,0,0,3,0,3
23523,50,5837,2245;6458,6935,0,0,0,2,2
23524,50,5839,8697;10145;13819,6935,0,0,3,0,3
23525,50,5840,2775;10030;13022;14091;14516,6935,0,1,4,0,5
23526,50,5843,3375,6935,0,0,1,0,1
23527,50,5845,545;3126,6935,0,0,2,0,2
23528,50,5846,4448;10037;13263,6935,0,0,3,0,3
23529,50,5848,3555,6935,0,0,0,1,1
23530,50,5850,218;10074;13462;14398,6935,0,1,3,0,4
23531,50,5851,4259;7808,6935,0,0,1,1,2
23532,50,5854,3127;5301;13125,6935,0,0,3,0,3
23533,50,5858,4743;8418,6935,0,0,2,0,2
23534,50,5859,4785;5231,6935,0,0,0,2,2
23535,50,5860,10287;14387,6935,0,1,1,0,2
23536,50,5861,2765;9946;12800,6935,0,0,2,1,3
23537,50,5862,5097;7994,6935,0,0,2,0,2
23538,50,5863,5258;10158;13101,6935,0,0,3,0,3
23539,50,5865,960;5367;13708;14215,6935,0,0,4,0,4
23540,50,5867,5630;7310;13246;13599,6935,0,0,4,0,4
23541,50,5871,10005;10132;14735,6935,0,1,2,0,3
23542,50,5872,4752;6331,6935,0,0,2,0,2
23543,50,5873,169;6443;12607;14365;14813,6935,0,2,3,0,5
23544,50,5875,1044;6469;13787;14210;15616,6935,0,1,4,0,5
23545,50,5877,7444;8553,6935,0,0,2,0,2
23546,50,5883,3725,6935,0,0,0,1,1
23547,50,5884,4442,6935,0,0,0,1,1
23548,50,5885,3886;7439,6935,0,0,2,0,2
23549,50,5888,3731;7550;12898,6935,0,0,3,0,3
23550,50,5890,7781;9197;12897;13873,6935,0,0,4,0,4
23551,50,5891,7927;9692,6935,0,0,1,1,2
23552,50,5894,2971;4600,6935,0,0,0,2,2
23553,50,5895,7097;10237;13258;14535;14665,6935,0,2,3,0,5
23554,50,5896,8578,6935,0,0,0,1,1
23555,50,5899,9689,6935,0,0,1,0,1
23556,50,5900,5917;10186;13309,6935,0,0,3,0,3
23557,50,5901,982,6935,0,0,1,0,1
23558,50,5902,10046;10062,6935,0,0,2,0,2
23559,50,5905,217;9680,6935,0,0,2,0,2
23560,50,5906,29;10206;14089;15962,6935,1,0,3,0,4
23561,50,5908,10022;10210;13637;13798;14263,6935,0,1,4,0,5
23562,50,5909,3820;10029;13569;14194,6935,0,0,4,0,4
23563,50,5910,10033;10362;12425;14079,6935,0,0,4,0,4
23564,50,5911,10089;10188;14014,6935,0,0,3,0,3
23565,50,5912,10056;10297,6935,0,0,2,0,2
23566,50,5913,10079;10162;14087,6935,0,0,3,0,3
23567,50,5914,10099;10109;13285;14124,6935,0,0,4,0,4
23568,50,5915,386;10108;13121;13668;13674;15017,6935,0,1,5,0,6
23569,50,5916,10481;13487;13673;15304,6935,0,1,3,0,4
23570,50,5918,448;10183;14114;14742,7300,0,1,3,0,4
23571,50,5919,511;8470;13075,7300,0,0,3,0,3
23572,50,5921,562;9927;13528,7300,0,0,3,0,3
23573,50,5923,4714;6407;13399,7300,0,0,3,0,3
23574,50,5926,1162;5420,7300,0,0,0,2,2
23575,50,5927,1452;2689;12894,7300,0,0,3,0,3
23576,50,5928,3337;5390;14319,7300,0,1,2,0,3
23577,50,5930,2361;10401;13293;14338,7300,0,1,3,0,4
23578,50,5934,3146;5479;14417,7300,0,1,2,0,3
23579,50,5935,1045;10008;13003,7300,0,0,3,0,3
23580,50,5943,4092;7163;13196,7300,0,0,3,0,3
23581,50,5946,4544;9887;12396;13338,7300,0,0,4,0,4
23582,50,5949,505;4735,7300,0,0,0,2,2
23583,50,5950,4851;10057;13395;14077,7300,0,0,4,0,4
23584,50,5955,5726;7176;12986,7300,0,0,3,0,3
23585,50,5957,5798;5968,7300,0,0,2,0,2
23586,50,5958,7732;8624,7300,0,0,2,0,2
23587,50,5959,1682;6702;13809;14039,7300,0,0,4,0,4
23588,50,5961,6995;12424,7300,0,0,2,0,2
23589,50,5964,4677;7172;12455;12794,7300,0,0,4,0,4
23590,50,5968,7481;10097;14465,7300,0,1,2,0,3
23591,50,5970,8255,7300,0,0,0,1,1
23592,50,5971,5436;8328,7300,0,0,2,0,2
23593,50,5972,8372;9211;14182,7300,0,0,3,0,3
23594,50,5974,5580,7300,0,0,0,1,1
23595,50,5975,2247;5736;14102,7300,0,0,3,0,3
23596,50,5977,5788;7521,7300,0,0,2,0,2
23597,50,5980,6015;9749,7300,0,0,2,0,2
23598,50,5983,10082;10320;13497,7300,0,0,3,0,3
23599,50,5984,10252;10371;13623;14157,7300,0,0,4,0,4
23600,50,5985,10058;10519;14439;14895,7300,0,2,2,0,4
23601,50,5986,6085;10220;13443;14501,7300,0,1,3,0,4
23602,50,5987,10134;10142;13696;13884;14046,7300,0,0,5,0,5
23603,50,5988,10498,7300,0,0,1,0,1
23604,50,5989,10187;13741,7300,0,0,2,0,2
23605,50,5993,10160;10255;13606;14346;15358,7665,0,2,3,0,5
23606,50,5994,512;1604,7665,0,0,2,0,2
23607,50,5995,1623;8409;13882;13989,7665,0,0,4,0,4
23608,50,6000,5105;7394,7665,0,0,2,0,2
23609,50,6003,3952;10217,7665,0,0,2,0,2
23610,50,6005,2620;4955;13460;13655;14336,7665,0,1,4,0,5
23611,50,6007,2707,7665,0,0,0,1,1
23612,50,6008,10280;13605;14410,7665,0,1,2,0,3
23613,50,6009,10043;10306;13546;15270;15573,7665,0,2,3,0,5
23614,50,6011,2788;6953,7665,0,0,0,2,2
23615,50,6012,2920;3591;14212,7665,0,0,3,0,3
23616,50,6013,4271;9227;13082,7665,0,0,3,0,3
23617,50,6016,4369,7665,0,0,1,0,1
23618,50,6017,4755;8421;13633;14482,7665,0,1,3,0,4
23619,50,6018,6836,7665,0,0,0,1,1
23620,50,6020,5161;5310;13669;13897;14806,7665,0,1,4,0,5
23621,50,6022,4229;14314,7665,0,1,1,0,2
23622,50,6023,5437;6114;13734,7665,0,0,3,0,3
23623,50,6024,5598,7665,0,0,0,1,1
23624,50,6026,6205,7665,0,0,0,1,1
23625,50,6029,5775;8698;12957,7665,0,0,3,0,3
23626,50,6030,5945,7665,0,0,0,1,1
23627,50,6032,7698;8573;12583,7665,0,0,2,1,3
23628,50,6033,9016,7665,0,0,0,1,1
23629,50,6044,7852,7665,0,0,0,1,1
23630,50,6048,137,7665,0,0,0,1,1
23631,50,6050,1486;9078,7665,0,0,0,2,2
23632,50,6053,9682,7665,0,0,0,1,1
23633,50,6054,1487,7665,0,0,0,1,1
23634,50,6056,10431;13609;13867;14355;14918,7665,0,2,3,0,5
23635,50,6057,10014;10340,7665,0,0,2,0,2
23636,50,6058,10016;10395;14147;14632,7665,0,1,3,0,4
23637,50,6059,10209;13000,7665,0,0,2,0,2
23638,50,6060,1944;10065;13702,7665,0,0,3,0,3
23639,50,6061,10086;10230;14508,7665,0,1,2,0,3
23640,50,6062,8877;10178;14153;14356,7665,0,1,3,0,4
23641,50,6063,10361;10394;13432;13771;14686,7665,0,1,4,0,5
23642,50,6064,10127;10141;13747;14026,7665,0,0,4,0,4
23643,50,6067,10171;10448;14345,7665,0,1,2,0,3
23644,50,6069,10522;12758;14998,7665,0,1,2,0,3
23645,50,6070,10254;10583;12712;14135;14492,7665,0,1,4,0,5
23646,50,6071,10261;10440;13049;13636;14239;15225,7665,0,2,4,0,6
23647,50,6072,10265;10483;14311;14440;14641,7665,0,3,2,0,5
23648,50,6073,10104;10567;13564;14527;14544;14866;15361,7665,0,4,3,0,7
23649,50,6074,10275;10391;14045;14684,7665,0,1,3,0,4
23650,50,6075,10277;10505;13113;13807,7665,0,0,4,0,4
23651,50,6076,7295;10197;13700;14564,7665,0,1,3,0,4
23652,50,6077,10298;10321;13520;14273;14620,7665,0,2,3,0,5
23653,50,6078,10233;10307;13454;14203,7665,0,0,4,0,4
23654,50,6079,10135;10311;14361,7665,0,1,2,0,3
23655,50,6080,320;5064;13749;14497,8030,0,1,3,0,4
23656,50,6081,582,8030,0,0,0,1,1
23657,50,6082,8545,8030,0,0,0,1,1
23658,50,6083,7621;12733,8030,0,0,2,0,2
23659,50,6084,5100;6389;13253;13899,8030,0,0,4,0,4
23660,50,6087,2360;3246;13120;14376,8030,0,1,3,0,4
23661,50,6090,795;8149;12896,8030,0,0,2,1,3
23662,50,6095,2879,8030,0,0,0,1,1
23663,50,6096,3395,8030,0,0,0,1,1
23664,50,6098,3029,8030,0,0,1,0,1
23665,50,6099,3612;5024;12931,8030,0,0,2,1,3
23666,50,6102,4235;10380;13017,8030,0,0,3,0,3
23667,50,6103,4396;8249,8030,0,0,0,2,2
23668,50,6104,10557;10700;14173;14957,8030,0,1,3,0,4
23669,50,6105,4370;9167,8030,0,0,0,2,2
23670,50,6107,932;13954,8030,0,0,2,0,2
23671,50,6108,5322,8030,0,0,0,1,1
23672,50,6110,6393;10003;12970,8030,0,0,3,0,3
23673,50,6111,1889,8030,0,0,0,1,1
23674,50,6112,6309;13325,8030,0,0,2,0,2
23675,50,6115,8145;10093;14035;14493,8030,0,1,3,0,4
23676,50,6118,8591,8030,0,0,1,0,1
23677,50,6119,6155;8638;13704,8030,0,0,3,0,3
23678,50,6120,4854;8641,8030,0,0,1,1,2
23679,50,6121,2996;8688;12695;13614,8030,0,0,4,0,4
23680,50,6126,10545;12751;13869;14261,8030,0,1,3,0,4
23681,50,6127,4456;10051;14185,8030,0,0,3,0,3
23682,50,6128,10053;10090;14033;14476,8030,0,1,3,0,4
23683,50,6129,10081;10246;13283;14949;15317,8030,0,2,3,0,5
23684,50,6130,10302;10433;12872,8030,0,0,3,0,3
23685,50,6131,10101;10119;13572;15240,8030,0,1,3,0,4
23686,50,6132,10124;10215;13333;13622,8030,0,0,4,0,4
23687,50,6134,10034;10192;13213;14599,8030,0,1,3,0,4
23688,50,6135,1050;10211;14000,8030,0,0,3,0,3
23689,50,6136,10221;10535;14652;15167,8030,0,2,2,0,4
23690,50,6137,10239;10454;13703;15044;15350,8030,0,2,3,0,5
23691,50,6138,10242;10618;14056,8030,0,0,3,0,3
23692,50,6139,10259;10640;14479;15116,8030,0,2,2,0,4
23693,50,6140,10270,8030,0,0,1,0,1
23694,50,6141,10271;10679;14268;14783,8030,0,2,2,0,4
23695,50,6142,10276;10653;14914;15029,8030,0,2,2,0,4
23696,50,6143,10278;10582;13029,8030,0,0,3,0,3
23697,50,6144,10281;10296;13386;13687,8030,0,0,4,0,4
23698,50,6145,10714;13960;15128,8030,0,1,2,0,3
23699,50,6146,10126;10269;13063;13177,8030,0,0,4,0,4
23700,50,6147,10327;10471;13799;15559,8030,0,1,3,0,4
23701,50,6148,10113;10347,8030,0,0,2,0,2
23702,50,6149,10155;10566;13904;14548;15147,8030,0,2,3,0,5
23703,50,6150,10195;10390;14211;14758,8030,0,1,3,0,4
23704,50,6151,10170;10383;13015;13598;13940;14576;14769,8030,0,2,5,0,7
23705,50,6152,10386;10719;12832;14086;14766,8030,0,1,4,0,5
23706,50,6153,10389;10463;14160;14610;15565,8030,0,2,3,0,5
23707,50,6154,10203;10726;14337;14601;14880,8030,0,3,2,0,5
23708,50,6155,10432;10721;14716;15069;15741,8030,0,3,2,0,5
23709,50,6156,136;6262;14188;14266,8395,0,1,3,0,4
23710,50,6157,2810,8395,0,0,0,1,1
23711,50,6159,10513;10615;12940;13357;14706,8395,0,1,4,0,5
23712,50,6160,1231;5040;13717;14427,8395,0,1,3,0,4
23713,50,6161,1248,8395,0,0,0,1,1
23714,50,6163,2089,8395,0,0,0,1,1
23715,50,6166,1797;10114,8395,0,0,2,0,2
23716,50,6167,652;5738,8395,0,0,2,0,2
23717,50,6168,2760,8395,0,0,1,0,1
23718,50,6169,5522;10012;14181;14446,8395,0,1,3,0,4
23719,50,6171,3366;13650,8395,0,0,2,0,2
23720,50,6173,8237;14908,8395,0,1,1,0,2
23721,50,6174,4219,8395,0,0,1,0,1
23722,50,6179,4543,8395,0,0,1,0,1
23723,50,6182,10052;10353,8395,0,0,2,0,2
23724,50,6184,5139,8395,0,0,0,1,1
23725,50,6189,7575,8395,0,0,0,1,1
23726,50,6192,8008,8395,0,0,0,1,1
23727,50,6193,9514,8395,0,0,1,0,1
23728,50,6194,2701;8111;13090,8395,0,0,3,0,3
23729,50,6195,5627,8395,0,0,0,1,1
23730,50,6196,8474;10105;14451,8395,0,1,2,0,3
23731,50,6197,3267;5710,8395,0,0,2,0,2
23732,50,6199,5814,8395,0,0,1,0,1
23733,50,6205,10015;10256;14562;14975,8395,0,2,2,0,4
23734,50,6206,10091;10314;14396;14536,8395,0,2,2,0,4
23735,50,6207,10140;10200;13243;14626,8395,0,1,3,0,4
23736,50,6208,10551;10753;14027;14340;14788;15013;15287,8395,0,4,3,0,7
23737,50,6209,10189;10516;13464;14581;15037,8395,0,2,3,0,5
23738,50,6210,10072;10258;13336,8395,0,0,3,0,3
23739,50,6211,10262;10279;13639;13993,8395,0,0,4,0,4
23740,50,6212,10272;10506;14522;14868,8395,0,2,2,0,4
23741,50,6213,10728;14718;14915;15313,8395,0,3,1,0,4
23742,50,6214,1359;10228;13266;14300;14938,8395,0,2,3,0,5
23743,50,6215,10328;10738;13086;13245;13682;14085;14507,8395,0,1,6,0,7
23744,50,6216,10202;10350;14260;14741,8395,0,2,2,0,4
23745,50,6217,10324;10372;13872;14034,8395,0,0,4,0,4
23746,50,6218,10415;10604;14596;15081,8395,0,2,2,0,4
23747,50,6219,10418;10435;13498;13737;14295,8395,0,1,4,0,5
23748,50,6220,10318;10656;13482;14363;15382;15581,8395,0,3,3,0,6
23749,50,6221,10465;10879;13992;14375;15359,8395,0,2,3,0,5
23750,50,6222,10781;13972;14353,8395,0,1,2,0,3
23751,50,6223,10333;10455;13521;14041;14474,8395,0,1,4,0,5
23752,50,6224,10291;10495;14285;15404;15586,8395,0,3,2,0,5
23753,50,6225,10657;10661;14010;14920,8395,0,1,3,0,4
23754,50,6227,2896;10548;13135;13953,8395,0,0,4,0,4
23755,50,6228,2497,8760,0,0,0,1,1
23756,50,6230,10144;10208;12969;13944,8760,0,0,4,0,4
23757,50,6237,3472;10227;14134;14509,8760,0,1,3,0,4
23758,50,6238,873;6765,8760,0,0,0,2,2
23759,50,6239,2176;5459;14119,8760,0,0,3,0,3
23760,50,6243,1973;2534;14726,8760,0,1,2,0,3
23761,50,6244,2233;3055,8760,0,0,2,0,2
23762,50,6245,3108;7311;13215;13983,8760,0,0,4,0,4
23763,50,6246,7223,8760,0,0,1,0,1
23764,50,6249,5047;13116,8760,0,0,2,0,2
23765,50,6250,3600;3615;13284,8760,0,0,3,0,3
23766,50,6252,8033;8711,8760,0,0,0,2,2
23767,50,6253,56;4700,8760,0,0,2,0,2
23768,50,6256,1031;5409,8760,0,0,0,2,2
23769,50,6258,10268,8760,0,0,1,0,1
23770,50,6262,6217,8760,0,0,0,1,1
23771,50,6263,3735;7315;13690,8760,0,0,3,0,3
23772,50,6264,1618;6624;13438;13638,8760,0,0,4,0,4
23773,50,6265,6272;6642;13800,8760,0,0,3,0,3
23774,50,6269,11;1360;14070;14148,8760,0,0,4,0,4
23775,50,6273,8437,8760,0,0,0,1,1
23776,50,6274,625;2747,8760,0,0,0,2,2
23777,50,6275,7493,8760,0,0,0,1,1
23778,50,6276,4124;7155,8760,0,0,0,2,2
23779,50,6277,9835,8760,0,0,0,1,1
23780,50,6280,10488;14540,8760,0,1,1,0,2
23781,50,6281,10381;10422;14126;15464,8760,0,1,3,0,4
23782,50,6282,10617;10724;13707;14518;14809,8760,0,2,3,0,5
23783,50,6283,10071;10587;13012;14884,8760,0,1,3,0,4
23784,50,6284,10076;10253;13574;14553,8760,0,1,3,0,4
23785,50,6285,10096;10474;14140;14936,8760,0,1,3,0,4
23786,50,6286,10374;14101;14308;15023,8760,0,2,2,0,4
23787,50,6287,1619;10528;14530;15035,8760,0,2,2,0,4
23788,50,6288,10125;10627;13001,8760,0,0,3,0,3
23789,50,6290,10066;10720;14953;15312;15968,8760,1,2,2,0,5
23790,50,6291,10117;10198;13302;13923,8760,0,0,4,0,4
23791,50,6292,3241;10163;14416;14697,8760,0,2,2,0,4
23792,50,6293,3318;9764;13784,8760,0,0,3,0,3
23793,50,6294,10098;10250;13951,8760,0,0,3,0,3
23794,50,6295,10078;10292;13452;14277,8760,0,1,3,0,4
23795,50,6296,94;10299;13665;13743,8760,0,0,4,0,4
23796,50,6297,9563;10338;13789,8760,0,0,3,0,3
23797,50,6298,10647;10697;14139;14360;15495,8760,0,2,3,0,5
23798,50,6299,10341;10652;14328,8760,0,1,2,0,3
23799,50,6300,10358;13966;14287,8760,0,1,2,0,3
23800,50,6301,2476;10357;13679;13921;14252;15453,8760,0,2,4,0,6
23801,50,6302,10241;10364;14247;14663,8760,0,2,2,0,4
23802,50,6303,10377;13069;13296,8760,0,0,3,0,3
23803,50,6304,10408;10650;14281,8760,0,1,2,0,3
23804,50,6305,10020;10625;14437;14728,8760,0,2,2,0,4
23805,50,6306,10441;10907;13050;13531;14426;14698,8760,0,2,4,0,6
23806,50,6307,10710;13517;13930;14298,8760,0,1,3,0,4
23807,50,6308,10439;10470;13832;14628,8760,0,1,3,0,4
23808,50,6309,10244;10709;14737;15036,8760,0,2,2,0,4
23809,50,6310,10532;14131;14510,8760,0,1,2,0,3
23810,50,6311,10434;10613;14218;14904,8760,0,1,3,0,4
23811,50,6312,10682;10694;14307;14584,8760,0,2,2,0,4
23812,50,6313,10336;10558;14156;14496;15206,8760,0,2,3,0,5
23813,50,6314,10143;10572;13927;14267,8760,0,1,3,0,4
23814,50,6315,10599;10865;13470;14199;14789,8760,0,1,4,0,5
23815,50,6316,10547;10602;13465;13835;14413;16172,8760,1,1,4,0,6
23816,50,6317,10899;13013;14939,8760,0,1,2,0,3
23817,50,6318,10179;14512;15542;15804,8760,0,3,1,0,4
23818,50,6322,322,9125,0,0,0,1,1
23819,50,6323,751,9125,0,0,1,0,1
23820,50,6324,10344;10419;13262;14029,9125,0,0,4,0,4
23821,50,6327,839;10027;14462,9125,0,1,2,0,3
23822,50,6332,4846,9125,0,0,1,0,1
23823,50,6334,8879,9125,0,0,0,1,1
23824,50,6338,3085,9125,0,0,0,1,1
23825,50,6339,89;3118;13193,9125,0,0,3,0,3
23826,50,6340,1668;6991,9125,0,0,2,0,2
23827,50,6342,421;3798,9125,0,0,2,0,2
23828,50,6347,247;3078,9125,0,0,2,0,2
23829,50,6350,2264;6626,9125,0,0,0,2,2
23830,50,6353,10199;13506;14016,9125,0,0,3,0,3
23831,50,6354,6605,9125,0,0,1,0,1
23832,50,6355,5394,9125,0,0,1,0,1
23833,50,6359,3424;9161;14207;14270,9125,0,1,3,0,4
23834,50,6360,6012;8502,9125,0,0,0,2,2
23835,50,6363,6325;9169,9125,0,0,0,2,2
23836,50,6365,10036;10110;13453;14701,9125,0,1,3,0,4
23837,50,6366,10586;10702;13987;14246,9125,0,1,3,0,4
23838,50,6367,10045;10363;14115;14494;14907,9125,0,2,3,0,5
23839,50,6368,2975;10075,9125,0,0,2,0,2
23840,50,6369,10449;10866;13896;15491,9125,0,1,3,0,4
23841,50,6371,10168;10310;13661;13898;14423,9125,0,1,4,0,5
23842,50,6372,10286;10575;14214;14569;15089,9125,0,2,3,0,5
23843,50,6373,10175;10717;14258;14629,9125,0,2,2,0,4
23844,50,6374,10300;10319;13428;13912;15046;15399,9125,0,2,4,0,6
23845,50,6375,10040;10213;13417;13817,9125,0,0,4,0,4
23846,50,6376,10218;10510;14094;14324,9125,0,1,3,0,4
23847,50,6377,10274;10379;14067;14354,9125,0,1,3,0,4
23848,50,6378,10083;10236;14724,9125,0,1,2,0,3
23849,50,6379,10157;10282;13362;14823,9125,0,1,3,0,4
23850,50,6380,10131;10356;13557;14227,9125,0,1,3,0,4
23851,50,6381,10313;10873;14074;14253;15207,9125,0,2,3,0,5
23852,50,6382,10335;10570;13276;14144;15623,9125,0,1,4,0,5
23853,50,6383,10238;10403;14519,9125,0,1,2,0,3
23854,50,6384,10148;10387;13613;14051;15050,9125,0,1,4,0,5
23855,50,6385,10264;10388;14221;14515;15071,9125,0,2,3,0,5
23856,50,6386,10360;13964;14174,9125,0,0,3,0,3
23857,50,6387,10398;10755;13922;14061;14265;14297;14919;15427;15472;15649,9125,0,6,4,0,10
23858,50,6388,10416;13781;14015,9125,0,0,3,0,3
23859,50,6389,10293;10511;13596;13924;13979;15216,9125,0,1,5,0,6
23860,50,6390,10219;10436;13326;13887,9125,0,0,4,0,4
23861,50,6391,10910;11034;13373;14974;15874,9125,0,2,3,0,5
23862,50,6392,10150;10457;14104;14541;14878,9125,0,2,3,0,5
23863,50,6393,10466;13847;14633,9125,0,1,2,0,3
23864,50,6394,10690;10816;15753;15894,9125,0,2,2,0,4
23865,50,6395,10961;14984,9125,0,1,1,0,2
23866,50,6396,10257;10486;14310;14777;14900;14997,9125,0,4,2,0,6
23867,50,6397,10770;13257;13563;14049;14464;14555,9125,0,2,4,0,6
23868,50,6398,10352;10509;13630;14372;14861;15588,9125,0,3,3,0,6
23869,50,6399,10553;10952;14066;14090;14903,9125,0,1,4,0,5
23870,50,6401,10526;10757;13663;14637,9125,0,1,3,0,4
23871,50,6402,10378;10527;13836;14065;14875;15605,9125,0,2,4,0,6
23872,50,6403,10312;10540;14242,9125,0,1,2,0,3
23873,50,6405,10568;14187;15686,9125,0,1,2,0,3
23874,50,6406,10172;10574;14169;14965,9125,0,1,3,0,4
23875,50,6408,10600;14898,9125,0,1,1,0,2
23876,50,6409,10821;14578,9125,0,1,1,0,2
23877,50,6410,10234;10612;14756;15337;15887,9125,0,3,2,0,5
23878,50,6411,10621;13963;14235;14723,9125,0,2,2,0,4
23879,50,6413,10919;14390;14622;14867,9125,0,3,1,0,4
23880,50,6414,10659;14799,9125,0,1,1,0,2
23881,50,6415,10662;10795;13611;14042;14774,9125,0,1,4,0,5
23882,50,6416,10641;10881,9125,0,0,2,0,2
23883,50,6417,10533;10680;14472;14683,9125,0,2,2,0,4
23884,50,6418,10681;10895;13486;13861;15881,9125,0,1,4,0,5
23885,50,6419,10730;10769;14671;15640,9125,0,2,2,0,4
23886,50,6420,10745;11011;15440,9125,0,1,2,0,3
23887,50,6421,10708;10763;14100,9125,0,0,3,0,3
23888,50,6423,228;10024;14672,9490,0,1,2,0,3
23889,50,6424,6481;8814,9490,0,0,0,2,2
23890,50,6429,2396;9056;13347,9490,0,0,3,0,3
23891,50,6430,3046;13360,9490,0,0,2,0,2
23892,50,6431,3058,9490,0,0,1,0,1
23893,50,6432,4189;7197;13379,9490,0,0,3,0,3
23894,50,6436,329;5457,9490,0,0,0,2,2
23895,50,6438,5858,9490,0,0,0,1,1
23896,50,6442,2784;6461;14063,9490,0,0,3,0,3
23897,50,6445,6735;7216,9490,0,0,0,2,2
23898,50,6449,2598;7346,9490,0,0,2,0,2
23899,50,6452,7098;7443,9490,0,0,2,0,2
23900,50,6453,7714,9490,0,0,0,1,1
23901,50,6454,5402;13843;14450,9490,0,1,2,0,3
23902,50,6457,69,9490,0,0,0,1,1
23903,50,6459,8201,9490,0,0,1,0,1
23904,50,6460,6078;9232,9490,0,0,0,2,2
23905,50,6462,10025;10672;14348;14968,9490,0,2,2,0,4
23906,50,6465,10151;10184;14473,9490,0,1,2,0,3
23907,50,6466,10438;10654;13811;14669,9490,0,1,3,0,4
23908,50,6467,10212;10578;14502;15008,9490,0,2,2,0,4
23909,50,6468,10523;10900;14475;15374;15808,9490,0,3,2,0,5
23910,50,6469,10116;10305;13317;13424;14514,9490,0,1,4,0,5
23911,50,6470,10421;10496;13632;14877,9490,0,1,3,0,4
23912,50,6471,10330;10607;13694;14420;14778;15149,9490,0,3,3,0,6
23913,50,6472,10332;10631;14272;15759,9490,0,2,2,0,4
23914,50,6473,9247;10502;13653;14289,9490,0,1,3,0,4
23915,50,6474,10249;10411;13849,9490,0,0,3,0,3
23916,50,6475,10645;10658;14023;14422;15554,9490,0,2,3,0,5
23917,50,6476,10590;10635;14060;15571,9490,0,1,3,0,4
23918,50,6477,10838;14781,9490,0,1,1,0,2
23919,50,6479,10190;10484;13795;13998;14621,9490,0,1,4,0,5
23920,50,6480,10489;10967;14539;15119,9490,0,2,2,0,4
23921,50,6481,10595;11093;14073;15425,9490,0,1,3,0,4
23922,50,6482,4535;10182;13920,9490,0,0,3,0,3
23923,50,6483,10092;10610;14096;14721,9490,0,1,3,0,4
23924,50,6485,10537;10898;14640;15179,9490,0,2,2,0,4
23925,50,6486,10944;14409;14648;15034,9490,0,3,1,0,4
23926,50,6487,10669;13910;14607,9490,0,1,2,0,3
23927,50,6488,10667;10673;15159,9490,0,1,2,0,3
23928,50,6489,10642;14040;14773,9490,0,1,2,0,3
23929,50,6490,10122;10692;14092;14478,9490,0,1,3,0,4
23930,50,6491,10407;10704;13772;14048,9490,0,0,4,0,4
23931,50,6492,10518;10619;13724;14973,9490,0,1,3,0,4
23932,50,6493,10737;14703;15038,9490,0,2,1,0,3
23933,50,6494,11202;13890;15281,9490,0,1,2,0,3
23934,50,6495,10815;14644;15198,9490,0,2,1,0,3
23935,50,6496,10749;10832;13250;13840;14792,9490,0,1,4,0,5
23936,50,6497,10744;11077;14520;14630;14854,9490,0,3,2,0,5
23937,50,6498,10760;13756;14213;14469,9490,0,1,3,0,4
23938,50,6499,11000;11113;13776;14570,9490,0,1,3,0,4
23939,50,6500,11060;11175;14327;15367;15615,9490,0,3,2,0,5
23940,50,6501,10788;10913;13342;13382;14643;14842,9490,0,2,4,0,6
23941,50,6502,10792;11117;14430;14989,9490,0,2,2,0,4
23942,50,6503,11038;11082;14198;15458;16334,9490,1,1,3,0,5
23943,50,6504,10676;10713;13451;13765;14419,9490,0,1,4,0,5
23944,50,6505,10494;10884;13848;14817,9490,0,1,3,0,4
23945,50,6507,157;4461,9855,0,0,0,2,2
23946,50,6508,3883;6192,9855,0,0,0,2,2
23947,50,6509,5553;8878,9855,0,0,2,0,2
23948,50,6511,3561;5260,9855,0,0,2,0,2
23949,50,6513,1431;2918,9855,0,0,0,2,2
23950,50,6516,10031;10194,9855,0,0,2,0,2
23951,50,6530,2681;8931,9855,0,0,2,0,2
23952,50,6532,5027;10010;13410;14393;14598,9855,0,2,3,0,5
23953,50,6535,8040;10111;13786;14618,9855,0,1,3,0,4
23954,50,6536,6002;10130;14367,9855,0,1,2,0,3
23955,50,6539,6564,9855,0,0,0,1,1
23956,50,6541,6744;10491;14872;15105,9855,0,2,2,0,4
23957,50,6542,2069;6805,9855,0,0,2,0,2
23958,50,6546,523,9855,0,0,0,1,1
23959,50,6547,2950;7040;14797,9855,0,1,2,0,3
23960,50,6553,10447;13753;14301,9855,0,1,2,0,3
23961,50,6554,2370,9855,0,0,1,0,1
23962,50,6556,10928;11115;14013,9855,0,0,3,0,3
23963,50,6557,10247;10467;15397;15564,9855,0,2,2,0,4
23964,50,6560,10295;10329;13725;13990,9855,0,0,4,0,4
23965,50,6561,10159;10427;13744;14146,9855,0,0,4,0,4
23966,50,6562,10451;10842;13440;14180,9855,0,0,4,0,4
23967,50,6563,10904;14710;15129,9855,0,2,1,0,3
23968,50,6564,10601;10622;14001;14528;15362,9855,0,2,3,0,5
23969,50,6566,1663;10624;14284;14616,9855,0,2,2,0,4
23970,50,6567,10699;10833;14050;14332,9855,0,1,3,0,4
23971,50,6568,10735;10825;13556;15486,9855,0,1,3,0,4
23972,50,6569,10742;11110;13758;13967,9855,0,0,4,0,4
23973,50,6570,10639;10777;13853;14206,9855,0,0,4,0,4
23974,50,6571,10666;10968;13829;14136,9855,0,0,4,0,4
23975,50,6572,10790;11260;13394;14209;15614,9855,0,1,4,0,5
23976,50,6573,10754;10809;13727;14349;14645,9855,0,2,3,0,5
23977,50,6574,10734;10803;14163;14401;15940,9855,0,2,3,0,5
23978,50,6575,10834;11085;13994;14874,9855,0,1,3,0,4
23979,50,6576,10851;11116;13406;13705,9855,0,0,4,0,4
23980,50,6577,10998;13833;14905,9855,0,1,2,0,3
23981,50,6578,10889;10996;13692;15547,9855,0,1,3,0,4
23982,50,6579,10863;10893;14682;15346;16038,9855,1,2,2,0,5
23983,50,6580,10674;10896;14278;14840,9855,0,2,2,0,4
23984,50,6581,11318;15530,9855,0,1,1,0,2
23985,50,6582,10703;10921;14234;14771;14838,9855,0,3,2,0,5
23986,50,6583,10922;10927;14477,9855,0,1,2,0,3
23987,50,6584,10805;10837;13788;13841,9855,0,0,4,0,4
23988,50,6585,10940;11044;15203,9855,0,1,2,0,3
23989,50,6586,10758;11216;13842;14736;15450;16293,9855,1,2,3,0,6
23990,50,6587,10955;14455;15213,9855,0,2,1,0,3
23991,50,6588,10971;11252;13393;14357;14608;14996;15407,9855,0,4,3,0,7
23992,50,6589,10847;10975;14484;14556;15042;15430,9855,0,4,2,0,6
23993,50,6590,10988;11067;14084;14333;15252,9855,0,2,3,0,5
23994,50,6595,920,10220,0,0,1,0,1
23995,50,6597,1065,10220,0,0,0,1,1
23996,50,6599,5331;6336;13908;13981,10220,0,0,4,0,4
23997,50,6605,2502,10220,0,0,0,1,1
23998,50,6610,7050;9187;13711,10220,0,0,2,1,3
23999,50,6611,1199,10220,0,0,0,1,1
24000,50,6613,4629,10220,0,0,0,1,1
24001,50,6614,3111;3341;14162,10220,0,0,3,0,3
24002,50,6619,6127;9520;13601;13746,10220,0,0,4,0,4
24003,50,6624,8840,10220,0,0,1,0,1
24004,50,6628,2729;10326;13947;14195;14395,10220,0,1,4,0,5
24005,50,6633,9825;9998,10220,0,0,0,2,2
24006,50,6634,9037;10011;13641;13875;14329,10220,0,1,4,0,5
24007,50,6636,10185;13718,10220,0,0,2,0,2
24008,50,6637,10611;10678;14687;15077,10220,0,2,2,0,4
24009,50,6639,10288;10630;13534;14613,10220,0,1,3,0,4
24010,50,6640,10337;10444;13549;14078;14675,10220,0,1,4,0,5
24011,50,6641,10147,10220,0,0,1,0,1
24012,50,6642,10267;10359;14054;14368;14763;15164,10220,0,3,3,0,6
24013,50,6644,10461;10916;15690;15970,10220,1,1,2,0,4
24014,50,6645,11078;13945;15125;15682,10220,0,2,2,0,4
24015,50,6647,10517;10520;13968;15003,10220,0,1,3,0,4
24016,50,6649,10050;10552;14012,10220,0,0,3,0,3
24017,50,6650,10580;10756;13774;14642,10220,0,1,3,0,4
24018,50,6651,10400;10581;14229;14713;14901,10220,0,3,2,0,5
24019,50,6652,10636;15010,10220,0,1,1,0,2
24020,50,6653,10638;10883;13812;14222;14605,10220,0,1,4,0,5
24021,50,6654,10668;10693;14095;14635;14946,10220,0,2,3,0,5
24022,50,6655,10550;10980;13697;14331,10220,0,1,3,0,4
24023,50,6656,10732;10912;13791;14233;14991,10220,0,2,3,0,5
24024,50,6657,10766;10937;13565;13980,10220,0,0,4,0,4
24025,50,6658,10564;10779;13926;14659;15199,10220,0,2,3,0,5
24026,50,6659,10482;10794;13719;15188;15236;15460,10220,0,3,3,0,6
24027,50,6660,10562;10796;14043;14525,10220,0,1,3,0,4
24028,50,6661,10683;10806;14168;14505;15321,10220,0,2,3,0,5
24029,50,6662,10634;10807;13793;14638,10220,0,1,3,0,4
24030,50,6663,10446;10810;13759;13845,10220,0,0,4,0,4
24031,50,6664,10876;14292;14483;15577,10220,0,3,1,0,4
24032,50,6665,10995;11410;14037;14755,10220,0,1,3,0,4
24033,50,6666,10740;10942;13846;14302;15012,10220,0,2,3,0,5
24034,50,6667,11062;14503;15074;15707,10220,0,3,1,0,4
24035,50,6668,10946;10991;13931;14388;14987;15134,10220,0,3,3,0,6
24036,50,6669,10727;11041;15171,10220,0,1,2,0,3
24037,50,6670,11013;13571;13978;14631;14862,10220,0,2,3,0,5
24038,50,6671,11017;11205;14280;14819,10220,0,2,2,0,4
24039,50,6672,11247;13958;15120;15335,10220,0,2,2,0,4
24040,50,6673,11035;11122;14624;15060,10220,0,2,2,0,4
24041,50,6674,11051;15063;15983,10220,1,1,1,0,3
24042,50,6675,11073;14155;14835;15692,10220,0,2,2,0,4
24043,50,6676,11081;11192;13629;13985;15931;16044,10220,1,1,4,0,6
24044,50,6677,10915;11253;13671;14172;14604,10220,0,1,4,0,5
24045,50,6679,617;7801,10585,0,0,0,2,2
24046,50,6681,10248;13974;14118,10585,0,0,3,0,3
24047,50,6686,1699;7920,10585,0,0,0,2,2
24048,50,6689,170;4956,10585,0,0,2,0,2
24049,50,6694,4939;8382,10585,0,0,0,2,2
24050,50,6697,760,10585,0,0,0,1,1
24051,50,6698,8902,10585,0,0,0,1,1
24052,50,6699,10035;10139;13775;14572,10585,0,1,3,0,4
24053,50,6706,3342,10585,0,0,0,1,1
24054,50,6709,182;9513,10585,0,0,2,0,2
24055,50,6710,2751;8057;13823;14317,10585,0,1,3,0,4
24056,50,6711,6974,10585,0,0,0,1,1
24057,50,6713,3117,10585,0,0,1,0,1
24058,50,6715,2468,10585,0,0,0,1,1
24059,50,6717,10087;10443;14673,10585,0,1,2,0,3
24060,50,6718,10177;13982;14306,10585,0,1,2,0,3
24061,50,6719,10129;10225;14397,10585,0,1,2,0,3
24062,50,6720,10317;10369;14488;14668,10585,0,2,2,0,4
24063,50,6721,10166;10231;13706;14109,10585,0,0,4,0,4
24064,50,6722,1432,10585,0,0,1,0,1
24065,50,6724,10290;10316;13672;14459,10585,0,1,3,0,4
24066,50,6725,10571;10986;13778;14646,10585,0,1,3,0,4
24067,50,6726,10402;10626;13991;14369;14856,10585,0,2,3,0,5
24068,50,6727,10405;10504;13856;14517;14786,10585,0,2,3,0,5
24069,50,6728,10243;10410;14075;14236;15107,10585,0,2,3,0,5
24070,50,6729,10417;10979;14681;15331,10585,0,2,2,0,4
24071,50,6730,10152;10458;13961;14315;14950,10585,0,2,3,0,5
24072,50,6731,10351;10462;14543;15104,10585,0,2,2,0,4
24073,50,6732,10068;10577;14342;14782,10585,0,2,2,0,4
24074,50,6733,10354;14373;14752,10585,0,2,1,0,3
24075,50,6734,10829;14123;15086;15109;15699,10585,0,3,2,0,5
24076,50,6735,10301;10716;14707;15227,10585,0,2,2,0,4
24077,50,6736,10723;10870;13880;14585;15697;16253,10585,1,2,3,0,6
24078,50,6737,10731;10828;14286;15202;15747,10585,0,3,2,0,5
24079,50,6738,11097;11191;14377;14960,10585,0,2,2,0,4
24080,50,6739,10733;13814;14241;14458,10585,0,2,2,0,4
24081,50,6742,10888;14256,10585,0,1,1,0,2
24082,50,6743,10530;11043;14765,10585,0,1,2,0,3
24083,50,6744,10917;11217;13685;13949;15226,10585,0,1,4,0,5
24084,50,6745,10608;10970;14068;14122;14441,10585,0,1,4,0,5
24085,50,6746,10355;10985;14323;14408;14859,10585,0,3,2,0,5
24086,50,6747,11018;14099;15482,10585,0,1,2,0,3
24087,50,6748,10762;11032;14282;14606;15096;16280,10585,1,3,2,0,6
24088,50,6749,10931;11039;14321;14746,10585,0,2,2,0,4
24089,50,6750,11005;11237;13754;14175;15724,10585,0,1,4,0,5
24090,50,6751,10924;11070;13766;14532,10585,0,1,3,0,4
24091,50,6752,10827;11141;14690;15348,10585,0,2,2,0,4
24092,50,6753,11146;11215;14490;14560;15904;15984;16453,10585,2,3,2,0,7
24093,50,6754,11320;11497;14303;14456;15052;15636;16015,10585,1,4,2,0,7
24094,50,6755,11055;11152;13830;14382;14912,10585,0,2,3,0,5
24095,50,6756,11164;11411;14009;14937,10585,0,1,3,0,4
24096,50,6757,10901;11185;13916;14005;14137,10585,0,0,5,0,5
24097,50,6758,11121;11206;14588;14847,10585,0,2,2,0,4
24098,50,6759,11156;11209;14534;15353,10585,0,2,2,0,4
24099,50,6760,63,10950,0,0,0,1,1
24100,50,6761,2246,10950,0,0,0,1,1
24101,50,6765,1111;9616,10950,0,0,0,2,2
24102,50,6767,2356,10950,0,0,1,0,1
24103,50,6770,10412;14352;14580,10950,0,2,1,0,3
24104,50,6771,1598,10950,0,0,0,1,1
24105,50,6774,2032;3679;13870;14379,10950,0,1,3,0,4
24106,50,6779,48;3349,10950,0,0,0,2,2
24107,50,6790,6911;10266;14347,10950,0,1,2,0,3
24108,50,6791,1890,10950,0,0,0,1,1
24109,50,6794,6560;8839,10950,0,0,2,0,2
24110,50,6795,9117,10950,0,0,1,0,1
24111,50,6796,7009,10950,0,0,0,1,1
24112,50,6797,9362,10950,0,0,0,1,1
24113,50,6799,9620,10950,0,0,0,1,1
24114,50,6802,10032;10136;14117,10950,0,0,3,0,3
24115,50,6806,1035;10165;13865;14004,10950,0,0,4,0,4
24116,50,6807,10308;10385;13932;14161;14425,10950,0,1,4,0,5
24117,50,6808,10263;10437;14237;14592,10950,0,2,2,0,4
24118,50,6809,10061;10426;14200;14394,10950,0,1,3,0,4
24119,50,6810,10499,10950,0,0,1,0,1
24120,50,6811,10095;10503;14031;15025,10950,0,1,3,0,4
24121,50,6812,10525;14485;14873,10950,0,2,1,0,3
24122,50,6816,10597;11069;14415;16115,10950,1,1,2,0,4
24123,50,6817,10430;10616;13938;15257,10950,0,1,3,0,4
24124,50,6819,11061;14639;15083;15371;16221,10950,1,3,1,0,5
24125,50,6820,10569;10712;14577;15101,10950,0,2,2,0,4
24126,50,6822,11276;11466;15536;16283,10950,1,1,2,0,4
24127,50,6823,10764;10997;13948;14138;14696,10950,0,1,4,0,5
24128,50,6824,10793;15165;15659;16020,10950,1,2,1,0,4
24129,50,6825,10808;10823;14506,10950,0,1,2,0,3
24130,50,6826,10814;10835;14082;15600,10950,0,1,3,0,4
24131,50,6827,10839;11009;13911;14424,10950,0,1,3,0,4
24132,50,6828,10903;11108;14561;15387,10950,0,2,2,0,4
24133,50,6829,10914;11063;15154,10950,0,1,2,0,3
24134,50,6830,11484;11670;14383;14753;15437,10950,0,3,2,0,5
24135,50,6831,11269;13906;14184;14559;16111,10950,1,1,3,0,5
24136,50,6832,10818;10932;14158;15498,10950,0,1,3,0,4
24137,50,6833,10982;11074;14793;15642;16128,10950,1,2,2,0,5
24138,50,6835,10747;11127;14130;14579;15884,10950,0,2,3,0,5
24139,50,6836,10696;10902;14290;14406;15898,10950,0,3,2,0,5
24140,50,6837,11019;11047;14044;16174,10950,1,0,3,0,4
24141,50,6838,10957;11023;13976;15224;16007;16470,10950,2,1,3,0,6
24142,50,6839,11037;11135;14081;14334;15519,10950,0,2,3,0,5
24143,50,6840,11059;13857;15117;15629,10950,0,2,2,0,4
24144,50,6841,11054;11566;15250,10950,0,1,2,0,3
24145,50,6842,10367;11083;13864;14269;15574,10950,0,2,3,0,5
24146,50,6843,11100;11404;14083;14447;16234,10950,1,1,3,0,5
24147,50,6844,10664;11103;14120;14442;15030;15618,10950,0,3,3,0,6
24148,50,6845,11114;11476;15612;16291;16503,10950,2,1,2,0,5
24149,50,6846,11124;11339;14785;15136;15394;15633,10950,0,4,2,0,6
24150,50,6847,10798;11129;13914;14448;15503,10950,0,2,3,0,5
24151,50,6848,11230;14990;15294,10950,0,2,1,0,3
24152,50,6849,11265;11526;13878;14294;15926,10950,0,2,3,0,5
24153,50,6850,11413;13883;14191;14731;15306,10950,0,2,3,0,5
24154,50,6851,11344;11798;14275;14796;16030,10950,1,2,2,0,5
24155,50,6852,11027;11266;15660;16360,10950,1,1,2,0,4
24156,50,6853,10909;11196;13973;15138,10950,0,1,3,0,4
24157,50,6854,11201;11629;14057;15072;15268,10950,0,2,3,0,5
24158,50,6855,11204;11377;14208;14583;14871;16158,10950,1,2,3,0,6
24159,50,6856,11228;11543;14149;15794;16140,10950,1,1,3,0,5
24160,50,6857,10951;11243;14438;15026;15161,10950,0,3,2,0,5
24161,50,6858,11090;11184;15018;15401,10950,0,2,2,0,4
24162,50,6859,11256;11527;13816;14623;14831;14994;15146;16378,10950,1,4,3,0,8
24163,50,6860,11258;11394;14358;15626,10950,0,2,2,0,4
24164,50,6861,11056;11233;14890;15445;15557;15787,10950,0,4,2,0,6
24165,50,6862,11293;14304;14647;15368;15426,10950,0,4,1,0,5
24166,50,6863,11366;11467;14403;15441,10950,0,2,2,0,4
24167,50,6864,10752;11025;14614,10950,0,1,2,0,3
24168,50,6865,11277;11442;14058;15647,10950,0,1,3,0,4
24169,50,6866,11380;11444;15131;15627,10950,0,2,2,0,4
24170,50,6867,11303;11378;14800;14881;15396,10950,0,3,2,0,5
24171,50,6868,11305;11450;13815;14550,10950,0,1,3,0,4
24172,50,6869,11096;11315;14113;14454;15157,10950,0,2,3,0,5
24173,50,6870,10868;11324;15053;15511,10950,0,2,2,0,4
24174,50,6871,2576;9510,11315,0,0,0,2,2
24175,50,6876,1952,11315,0,0,0,1,1
24176,50,6877,1963,11315,0,0,1,0,1
24177,50,6884,2300;4960,11315,0,0,2,0,2
24178,50,6887,3239;7926,11315,0,0,0,2,2
24179,50,6888,4210;6098,11315,0,0,0,2,2
24180,50,6890,4938;6827,11315,0,0,0,2,2
24181,50,6891,5245,11315,0,0,0,1,1
24182,50,6893,5659;6369,11315,0,0,2,0,2
24183,50,6895,6348;10085;13933;14656,11315,0,1,3,0,4
24184,50,6904,8184,11315,0,0,0,1,1
24185,50,6905,7871;8797,11315,0,0,0,2,2
24186,50,6909,10651;14110;14657,11315,0,1,2,0,3
24187,50,6911,10149;10729;14432;15169,11315,0,2,2,0,4
24188,50,6913,10205;10542;13965;14399,11315,0,1,3,0,4
24189,50,6915,10373;10563;14279;15356,11315,0,2,2,0,4
24190,50,6916,10423;10882;14371;14714,11315,0,2,2,0,4
24191,50,6917,10425;10824;15145;15527,11315,0,2,2,0,4
24192,50,6918,10428;10923;14602;15308,11315,0,2,2,0,4
24193,50,6919,10235;10472;14552;14705;15338,11315,0,3,2,0,5
24194,50,6920,10649;10783;14059;14370;14928,11315,0,2,3,0,5
24195,50,6921,10492;10701;14717;14899,11315,0,2,2,0,4
24196,50,6922,10508;11143;14003;14244;15553,11315,0,2,3,0,5
24197,50,6924,10059;10555;14030;14864,11315,0,1,3,0,4
24198,50,6925,10894;14722;15290,11315,0,2,1,0,3
24199,50,6927,10774;14554;15289,11315,0,2,1,0,3
24200,50,6928,10776;11003;15168;15680,11315,0,2,2,0,4
24201,50,6929,10791;10857;14940;14977,11315,0,2,2,0,4
24202,50,6930,10584;10885;14893,11315,0,1,2,0,3
24203,50,6931,10536;10811;15187,11315,0,1,2,0,3
24204,50,6932,10840;14283;16025,11315,1,1,1,0,3
24205,50,6933,10858;10864;14366,11315,0,1,2,0,3
24206,50,6934,10862;10981;14453;14963,11315,0,2,2,0,4
24207,50,6935,10855;15123,11315,0,1,1,0,2
24208,50,6936,11031;14575,11315,0,1,1,0,2
24209,50,6938,10775;10963;15402;15604,11315,0,2,2,0,4
24210,50,6939,10992;11301;14959;15999,11315,1,1,2,0,4
24211,50,6940,11002;11295;15375;15776,11315,0,2,2,0,4
24212,50,6941,11049;14176;16483,11315,1,0,2,0,3
24213,50,6943,11053;11180;14886,11315,0,1,2,0,3
24214,50,6944,11068;11086;15140;15805,11315,0,2,2,0,4
24215,50,6945,10874;11098;14008;14141;15457;15668,11315,0,2,4,0,6
24216,50,6946,10173;14344;14499,11315,0,2,1,0,3
24217,50,6947,11120;11214;14177;14666,11315,0,1,3,0,4
24218,50,6948,11026;11130;14526;16177,11315,1,1,2,0,4
24219,50,6949,11132;11224;14558;15045;15813,11315,0,3,2,0,5
24220,50,6950,11582;11702;14154;14495;15016;16250,11315,1,2,3,0,6
24221,50,6951,10596;11150;14305;14882,11315,0,2,2,0,4
24222,50,6952,10771;11236;15307;16082,11315,1,1,2,0,4
24223,50,6953,11167;11482;14069,11315,0,0,3,0,3
24224,50,6954,10990;11181;14414;14743,11315,0,2,2,0,4
24225,50,6955,11040;11187;14828;15195,11315,0,2,2,0,4
24226,50,6956,11207;11538;14007;14461;14692;15255;16222;16510,11315,2,3,3,0,8
24227,50,6959,11234;14431;14715;14947;15828,11315,0,4,1,0,5
24228,50,6960,10954;11268;14463;14748;15568;16313,11315,1,3,2,0,6
24229,50,6961,11308;15196;15478,11315,0,2,1,0,3
24230,50,6962,11311;14832;15099;15316;15650;15848;16282;16395,11315,2,5,1,0,8
24231,50,6963,11314;11459;13988;14243;14679;15315;16374,11315,1,3,3,0,7
24232,50,6964,11336;11428;14186;14651,11315,0,1,3,0,4
24233,50,6965,11329;11697;14421;15561;15910;16166,11315,1,3,2,0,6
24234,50,6966,11174;11289;14889;15011;15272,11315,0,3,2,0,5
24235,50,6967,11080;11346;14062;14894,11315,0,1,3,0,4
24236,50,6968,11351;11719;15385;15916,11315,0,2,2,0,4
24237,50,6969,11321;11359;15192,11315,0,1,2,0,3
24238,50,6970,11364;11698;14020;15393;15567;15673,11315,0,3,3,0,6
24239,50,6971,11223;11382;14848;15091;16099,11315,1,2,2,0,5
24240,50,6972,11700;14764,11315,0,1,1,0,2
24241,50,6973,11407;11432;14600;15007;16303,11315,1,2,2,0,5
24242,50,6975,10026;10156;13999;14429,11680,0,1,3,0,4
24243,50,6978,5314;6652,11680,0,0,0,2,2
24244,50,6981,1596,11680,0,0,0,1,1
24245,50,6989,3507;6252;14313,11680,0,1,2,0,3
24246,50,6991,7709,11680,0,0,1,0,1
24247,50,6993,1671;5278,11680,0,0,2,0,2
24248,50,6997,7390,11680,0,0,0,1,1
24249,50,6998,7416,11680,0,0,0,1,1
24250,50,7004,9257,11680,0,0,0,1,1
24251,50,7008,1727;10524;14309;14649;14708,11680,0,3,2,0,5
24252,50,7009,10750;14962;15153;15462,11680,0,3,1,0,4
24253,50,7010,10453;14159;14655,11680,0,1,2,0,3
24254,50,7011,11227;14197;14836;15062;15352;16306,11680,1,3,2,0,6
24255,50,7013,10598;11087;14205;14489;15310;16101,11680,1,2,3,0,6
24256,50,7014,10028;10420;14533;14662,11680,0,2,2,0,4
24257,50,7016,10589;10929;14192;14288;15398;15638,11680,0,3,3,0,6
24258,50,7017,10588;10609;14411;15484,11680,0,2,2,0,4
24259,50,7018,11162;11440;14460;14807;14995,11680,0,3,2,0,5
24260,50,7019,10442,11680,0,0,1,0,1
24261,50,7020,10660;10741;14108;14932,11680,0,1,3,0,4
24262,50,7021,10705;10953;14504;15342,11680,0,2,2,0,4
24263,50,7022,10646;10707;14992;15326,11680,0,2,2,0,4
24264,50,7023,10780;14274;14444;15005,11680,0,3,1,0,4
24265,50,7024,10867;10872;14088;14364,11680,0,1,3,0,4
24266,50,7025,11006;11248;15552;15818,11680,0,2,2,0,4
24267,50,7026,11008;11375;14513;15163;15744;15923;16155,11680,1,4,2,0,7
24268,50,7027,11089;11134;14546;14691;15376,11680,0,3,2,0,5
24269,50,7028,11094;11323;14105;14467;14888,11680,0,2,3,0,5
24270,50,7029,10989,11680,0,0,1,0,1
24271,50,7030,11109;11172;14654;15424,11680,0,2,2,0,4
24272,50,7031,11119;11575;14892;15993;16317,11680,2,1,2,0,5
24273,50,7032,10935;11415;15774,11680,0,1,2,0,3
24274,50,7033,10947;11159;14885;15403,11680,0,2,2,0,4
24275,50,7034,11197;11347;14129;14784;15049;15392;15608;16526,11680,1,4,3,0,8
24276,50,7035,11229;11244;15065;15493;16217,11680,1,2,2,0,5
24277,50,7036,11807;14217;14810;14923,11680,0,2,2,0,4
24278,50,7037,10948;11481;16063;16547,11680,2,0,2,0,4
24279,50,7038,11242;11361;15032;15845,11680,0,2,2,0,4
24280,50,7039,11306;11615;14106;14934;15602;16297,11680,1,2,3,0,6
24281,50,7040,11657;14380;14545;15079,11680,0,3,1,0,4
24282,50,7041,11348;11673;14276;14798;15160;15239,11680,0,4,2,0,6
24283,50,7042,11125;11370;14699;15836;16037;16556,11680,2,2,2,0,6
24284,50,7043,11384;11704;14339;14500;14529;14732;15769,11680,0,5,2,0,7
24285,50,7044,11434;11439;14944;15019;15273;15479,11680,0,4,2,0,6
24286,50,7045,11421;11455;14133;14549;15182,11680,0,2,3,0,5
24287,50,7046,11240;11468;15438;15593;15788;16321,11680,1,3,2,0,6
24288,50,7047,11328;11489;14127;15015;15816,11680,0,2,3,0,5
24289,50,7048,11264;11707;14193;15867,11680,0,1,3,0,4
24290,50,7049,11509;11740;14407;15248;15524;15875,11680,0,4,2,0,6
24291,50,7050,11511;11650;14418;16451,11680,1,1,2,0,4
24292,50,7054,4828,12045,0,0,1,0,1
24293,50,7055,774;803;14226;14259,12045,0,1,3,0,4
24294,50,7057,3717,12045,0,0,1,0,1
24295,50,7059,132,12045,0,0,0,1,1
24296,50,7060,236,12045,0,0,0,1,1
24297,50,7062,2818;8150;14954,12045,0,1,2,0,3
24298,50,7064,847;3268,12045,0,0,0,2,2
24299,50,7067,3469;9388,12045,0,0,0,2,2
24300,50,7068,3690;4436,12045,0,0,0,2,2
24301,50,7069,3831,12045,0,0,0,1,1
24302,50,7073,4806;8617,12045,0,0,0,2,2
24303,50,7081,6480;7972,12045,0,0,2,0,2
24304,50,7086,853,12045,0,0,0,1,1
24305,50,7088,8267,12045,0,0,0,1,1
24306,50,7089,8539,12045,0,0,1,0,1
24307,50,7096,4221,12045,0,0,1,0,1
24308,50,7097,10128;10214;14362;14612,12045,0,2,2,0,4
24309,50,7098,10260;14251;14780,12045,0,2,1,0,3
24310,50,7099,10181;10303;14700;14818;15094,12045,0,3,2,0,5
24311,50,7100,10345;10579;14231;15743,12045,0,2,2,0,4
24312,50,7102,10966;14927;15432,12045,0,2,1,0,3
24313,50,7103,10067;10546;14264;14729,12045,0,2,2,0,4
24314,50,7104,10549;10637;14779;15102,12045,0,2,2,0,4
24315,50,7106,10368;10476;14480;14674;15004,12045,0,3,2,0,5
24316,50,7107,10521;10628;14230;15028,12045,0,2,2,0,4
24317,50,7108,10632;10905;14404;14566,12045,0,2,2,0,4
24318,50,7109,10831;14902,12045,0,1,1,0,2
24319,50,7110,10644;10836;14487;15112;15666,12045,0,3,2,0,5
24320,50,7111,10960;11452;15665,12045,0,1,2,0,3
24321,50,7112,10761;11033;15205;15380;15539,12045,0,3,2,0,5
24322,50,7114,10684;11091;14754,12045,0,1,2,0,3
24323,50,7115,11104;11288;14839;15127;15477,12045,0,3,2,0,5
24324,50,7116,10765;11522;15212;15653;16236,12045,1,2,2,0,5
24325,50,7117,11144;11478;14571,12045,0,1,2,0,3
24326,50,7119,11189;11211;14863;15219,12045,0,2,2,0,4
24327,50,7120,11028;11200;14245;15197;15558,12045,0,3,2,0,5
24328,50,7121,11203;11493;15515,12045,0,1,2,0,3
24329,50,7122,11225;11743;15068;16406,12045,1,1,2,0,4
24330,50,7123,10802;11255;15324,12045,0,1,2,0,3
24331,50,7124,10892;11259;15363;15595,12045,0,2,2,0,4
24332,50,7125,11274;12125;16299,12045,1,0,2,0,3
24333,50,7126,11280;11507;14255;14381;15228;16201,12045,1,3,2,0,6
24334,50,7127,11338;11352;14322;14405;14841;15589,12045,0,4,2,0,6
24335,50,7128,10789;11317;14725;14869,12045,0,2,2,0,4
24336,50,7129,11322;15093;15370;15467;15754,12045,0,4,1,0,5
24337,50,7130,11356;11703;14330;16069,12045,1,1,2,0,4
24338,50,7131,11379;11834;14611;16008,12045,1,1,2,0,4
24339,50,7132,11015;11393;14359;15720;16284,12045,1,2,2,0,5
24340,50,7133,11065;11400;14228;16147,12045,1,1,2,0,4
24341,50,7134,11680;11821;14471;16121,12045,1,1,2,0,4
24342,50,7135,11221;11453;14667;15122;15592,12045,0,3,2,0,5
24343,50,7136,11464;11633;15305,12045,0,1,2,0,3
24344,50,7137,11389;11470;14970;15381,12045,0,2,2,0,4
24345,50,7138,11471;11499;14384;14827,12045,0,2,2,0,4
24346,50,7139,11523;15529,12045,0,1,1,0,2
24347,50,7140,11112;11534;14326;15340;15748,12045,0,3,2,0,5
24348,50,7141,11533;11786;14232;14695;15961,12045,1,2,2,0,5
24349,50,7142,11583;11594;14826;15475,12045,0,2,2,0,4
24350,50,7143,11448;11588;14593;15797,12045,0,2,2,0,4
24351,50,7144,11591;11884;14248;14650,12045,0,2,2,0,4
24352,50,7145,11600;11771;14412;15420,12045,0,2,2,0,4
24353,50,7146,11343;11601;14291;16131,12045,1,1,2,0,4
24354,50,7150,6390;9401,12410,0,0,0,2,2
24355,50,7151,721;8331,12410,0,0,2,0,2
24356,50,7157,1165;2279,12410,0,0,0,2,2
24357,50,7158,3776,12410,0,0,1,0,1
24358,50,7160,7428,12410,0,0,0,1,1
24359,50,7161,4434;9184,12410,0,0,0,2,2
24360,50,7168,9046,12410,0,0,1,0,1
24361,50,7170,6054,12410,0,0,1,0,1
24362,50,7172,6643,12410,0,0,0,1,1
24363,50,7174,5742;7802,12410,0,0,2,0,2
24364,50,7176,7373,12410,0,0,1,0,1
24365,50,7177,622;7399,12410,0,0,0,2,2
24366,50,7178,1472;7405,12410,0,0,2,0,2
24367,50,7180,7819,12410,0,0,0,1,1
24368,50,7184,1468,12410,0,0,1,0,1
24369,50,7185,4931;8744,12410,0,0,0,2,2
24370,50,7186,8932,12410,0,0,1,0,1
24371,50,7189,5671,12410,0,0,0,1,1
24372,50,7190,4199,12410,0,0,0,1,1
24373,50,7192,10107;11030;14563;15507,12410,0,2,2,0,4
24374,50,7193,10285;10620;14636;15300,12410,0,2,2,0,4
24375,50,7195,4867,12410,0,0,1,0,1
24376,50,7196,11281;14808;15022,12410,0,2,1,0,3
24377,50,7199,10334;10972;15448;15570,12410,0,2,2,0,4
24378,50,7200,10103,12410,0,0,1,0,1
24379,50,7201,10539;10689;14804;15238,12410,0,2,2,0,4
24380,50,7202,10559;11029;15344;15854,12410,0,2,2,0,4
24381,50,7205,10594;10974;15095;15447,12410,0,2,2,0,4
24382,50,7207,10643;11312;15517;15963;16200,12410,2,1,2,0,5
24383,50,7208,10706;10778;14747;15200,12410,0,2,2,0,4
24384,50,7209,11022;14523;15006,12410,0,2,1,0,3
24385,50,7211,10787;10936;14951;15496,12410,0,2,2,0,4
24386,50,7212,10812;10822;15669,12410,0,1,2,0,3
24387,50,7213,10323;10850;14457;15084,12410,0,2,2,0,4
24388,50,7214,10897,12410,0,0,1,0,1
24389,50,7215,11088;14521;15378,12410,0,2,1,0,3
24390,50,7216,11524;14625;14906;16086,12410,1,2,1,0,4
24391,50,7217,11012;11488;15158;16276,12410,1,1,2,0,4
24392,50,7218,10969;14542;15369,12410,0,2,1,0,3
24393,50,7219,11131;11171;14921;15285,12410,0,2,2,0,4
24394,50,7220,11099;14858;15184,12410,0,2,1,0,3
24395,50,7221,11349;11473;14597;15789,12410,0,2,2,0,4
24396,50,7222,11169;11687;14392;15705;16248,12410,1,2,2,0,5
24397,50,7223,11457;14844;15115;15679,12410,0,3,1,0,4
24398,50,7225,11218;11342;14466;15291,12410,0,2,2,0,4
24399,50,7226,11512;15021;15286;15771;16559,12410,1,3,1,0,5
24400,50,7227,10718;11273;14845;15230,12410,0,2,2,0,4
24401,50,7228,11279;14757;15088;15714,12410,0,3,1,0,4
24402,50,7229,11298;11416;15413;15777,12410,0,2,2,0,4
24403,50,7230,11331;11367;14719;15550,12410,0,2,2,0,4
24404,50,7231,11128;11571;15293;15560,12410,0,2,2,0,4
24405,50,7232,11341;14386;15889,12410,0,2,1,0,3
24406,50,7233,11358;11463;14925;15591;15964;16146,12410,2,2,2,0,6
24407,50,7234,11371;14740;14983;15389,12410,0,3,1,0,4
24408,50,7235,11386;11420;15628;16460,12410,1,1,2,0,4
24409,50,7236,10860;11235;15373;15725;15886,12410,0,3,2,0,5
24410,50,7237,11438;12053;14734;14852;15106,12410,0,3,2,0,5
24411,50,7238,11147,12410,0,0,1,0,1
24412,50,7239,10797;11502;15110;15820,12410,0,2,2,0,4
24413,50,7240,11518;11780;16145;16207,12410,2,0,2,0,4
24414,50,7241,11537;11541;14897;15535,12410,0,2,2,0,4
24415,50,7242,11546;11757;14402;15459,12410,0,2,2,0,4
24416,50,7243,11553;14972;16064,12410,1,1,1,0,3
24417,50,7244,11558;11938;14791,12410,0,1,2,0,3
24418,50,7245,11397;11567;15279;15739,12410,0,2,2,0,4
24419,50,7246,11577;11795;15261;15822,12410,0,2,2,0,4
24420,50,7247,11460;11578;14547;14803;15297,12410,0,3,2,0,5
24421,50,7248,11590;12128;14739;15073;15502;15702;15943,12410,1,4,2,0,7
24422,50,7249,11618;11739;14678;16132,12410,1,1,2,0,4
24423,50,7250,11620;15033;15449;15973,12410,1,2,1,0,4
24424,50,7251,11628;11688;14770;15406;16411,12410,1,2,2,0,5
24425,50,7252,11392;11982;14389;14661,12410,0,2,2,0,4
24426,50,7253,11713;11813;14443;15764;16384,12410,1,2,2,0,5
24427,50,7254,11722;15439;15761,12410,0,2,1,0,3
24428,50,7255,11564;11725;14374;14590,12410,0,2,2,0,4
24429,50,7256,11663;11738;14491;16336,12410,1,1,2,0,4
24430,50,7257,11747;12098;14481,12410,0,1,2,0,3
24431,50,7261,1191,12775,0,0,1,0,1
24432,50,7269,8407;8498,12775,0,0,2,0,2
24433,50,7270,8862;10501;14565;15078;15269,12775,0,3,2,0,5
24434,50,7272,4757;9231,12775,0,0,2,0,2
24435,50,7275,3161;8406,12775,0,0,1,1,2
24436,50,7279,7410,12775,0,0,1,0,1
24437,50,7280,5941,12775,0,0,0,1,1
24438,50,7284,8132,12775,0,0,0,1,1
24439,50,7286,8843,12775,0,0,0,1,1
24440,50,7288,1134,12775,0,0,1,0,1
24441,50,7291,10153,12775,0,0,1,0,1
24442,50,7293,10348;10845;15877,12775,0,1,2,0,3
24443,50,7297,10813;11048;14964,12775,0,1,2,0,3
24444,50,7298,10819;15080,12775,0,1,1,0,2
24445,50,7299,10826;10938;15092;15463,12775,0,2,2,0,4
24446,50,7300,10396;10848;14952;15327;15634,12775,0,3,2,0,5
24447,50,7301,10698;10854;15266;16193,12775,1,1,2,0,4
24448,50,7303,10485;10715;14909;15364,12775,0,2,2,0,4
24449,50,7304,10906;11095;14634;14680,12775,0,2,2,0,4
24450,50,7305,10784;15500,12775,0,1,1,0,2
24451,50,7306,10987,12775,0,0,1,0,1
24452,50,7307,10844;11010;14824,12775,0,1,2,0,3
24453,50,7308,11036;11330;14658;14685;15727,12775,0,3,2,0,5
24454,50,7309,10512;10675;14857;15156,12775,0,2,2,0,4
24455,50,7310,10908;14586;15237,12775,0,2,1,0,3
24456,50,7311,11136;11462;14979,12775,0,1,2,0,3
24457,50,7312,11153;14694;15090,12775,0,2,1,0,3
24458,50,7314,11254;11283;14846;15173;15302,12775,0,3,2,0,5
24459,50,7315,11263;11458;15031;16165,12775,1,1,2,0,4
24460,50,7316,11310;11334;14704;15191;15883,12775,0,3,2,0,5
24461,50,7317,11183;11340;14567;14829;15113;16012,12775,1,3,2,0,6
24462,50,7318,11362;11494;15773;15958,12775,1,1,2,0,4
24463,50,7319,11391;11731;14971;15343;15856;15975,12775,1,3,2,0,6
24464,50,7320,11461;12121;14922;15256,12775,0,2,2,0,4
24465,50,7321,11337;11480;15267,12775,0,1,2,0,3
24466,50,7322,11495;14531;14865;15607,12775,0,3,1,0,4
24467,50,7323,10973;11498;14833;15002;15610,12775,0,3,2,0,5
24468,50,7324,11742;14727;16062,12775,1,1,1,0,3
24469,50,7325,11166;11491;15583,12775,0,1,2,0,3
24470,50,7326,11530;11863;15584,12775,0,1,2,0,3
24471,50,7327,11531;11612;14574;15471;15681,12775,0,3,2,0,5
24472,50,7328,11648;15246;16416,12775,1,1,1,0,3
24473,50,7329,11611;11918;14733;15882;16355,12775,1,2,2,0,5
24474,50,7330,11598;11616;14776;16049;16540,12775,2,1,2,0,5
24475,50,7331,11508;11644;15231;15505,12775,0,2,2,0,4
24476,50,7332,11565;11653;14551;15868,12775,0,2,2,0,4
24477,50,7333,11634;11674;14759;15408,12775,0,2,2,0,4
24478,50,7334,11699;11882;14619;14709;15043;15411,12775,0,4,2,0,6
24479,50,7335,11525;11708;14802;15262,12775,0,2,2,0,4
24480,50,7336,11573;11724;14589;15752,12775,0,2,2,0,4
24481,50,7337,11151;11750;14815;15718,12775,0,2,2,0,4
24482,50,7338,11759;12225;15027;15780;16429,12775,1,2,2,0,5
24483,50,7339,11761;11866;14595;14917;15137,12775,0,3,2,0,5
24484,50,7340,11772;12247;14609;14887;15057,12775,0,3,2,0,5
24485,50,7341,11790;12123;14603;14976;15251;15914;16488,12775,1,4,2,0,7
24486,50,7342,11778;11805;14750;15562;16340,12775,1,2,2,0,5
24487,50,7343,11417;11517;15837;16316,12775,1,1,2,0,4
24488,50,7344,11559;11837;14689;15222;15833,12775,0,3,2,0,5
24489,50,7345,12116;12228;14870;16484,12775,1,1,2,0,4
24490,50,7346,11640;11869;14980;15377,12775,0,2,2,0,4
24491,50,7347,183,13140,0,0,0,1,1
24492,50,7348,383;10576;14587;14851,13140,0,2,2,0,4
24493,50,7350,3309,13140,0,0,1,0,1
24494,50,7354,2901,13140,0,0,0,1,1
24495,50,7356,2628;3387,13140,0,0,0,2,2
24496,50,7365,6853,13140,0,0,0,1,1
24497,50,7371,9098;9720,13140,0,0,2,0,2
24498,50,7372,6143;9804,13140,0,0,0,2,2
24499,50,7373,4085;7141,13140,0,0,0,2,2
24500,50,7376,10106,13140,0,0,1,0,1
24501,50,7378,10216;10392;14702;14834,13140,0,2,2,0,4
24502,50,7381,4883;10413;14664;14958,13140,0,2,2,0,4
24503,50,7382,10325,13140,0,0,1,0,1
24504,50,7384,10543;10671;14744;14850,13140,0,2,2,0,4
24505,50,7386,10695;10958;14794;14825;15186;15299,13140,0,4,2,0,6
24506,50,7389,10648;10875;14985,13140,0,1,2,0,3
24507,50,7390,10404;11024;15111;15548,13140,0,2,2,0,4
24508,50,7391,10933;10949;14749;15056,13140,0,2,2,0,4
24509,50,7392,11004;11111;15055;15543,13140,0,2,2,0,4
24510,50,7393,10736;11016;14982;15421,13140,0,2,2,0,4
24511,50,7394,11057;11833;14787;15271;16113,13140,1,2,2,0,5
24512,50,7395,11058;11072;14760;14933;15979,13140,1,2,2,0,5
24513,50,7396,11105;11551;15365;15728,13140,0,2,2,0,4
24514,50,7397,10120;11107;14860;15278,13140,0,2,2,0,4
24515,50,7398,11046;11133;15218;15360;15893,13140,0,3,2,0,5
24516,50,7399,11326;15058;15139,13140,0,2,1,0,3
24517,50,7400,10891;11190;14751;15085,13140,0,2,2,0,4
24518,50,7401,11270;11550;15319;16184;16238,13140,2,1,2,0,5
24519,50,7402,11405;11677;14801,13140,0,1,2,0,3
24520,50,7403,11409;11486;16014;16212;16487,13140,3,0,2,0,5
24521,50,7404,11436;11485;15190;15504;16326,13140,1,2,2,0,5
24522,50,7405,11465;14688;14926;16256,13140,1,2,1,0,4
24523,50,7406,11606;11608;15492;15799,13140,0,2,2,0,4
24524,50,7407,11290;11515;14805;15545;16232,13140,1,2,2,0,5
24525,50,7408,11354;11535;15121;15620;16515,13140,1,2,2,0,5
24526,50,7409,11585;12096;15976,13140,1,0,2,0,3
24527,50,7410,11456;11614;14790;15309,13140,0,2,2,0,4
24528,50,7411,12246;14879;15135;15652;16071,13140,1,3,1,0,5
24529,50,7412,11646;11689;14911;15737,13140,0,2,2,0,4
24530,50,7413,12205;15469;15921,13140,0,2,1,0,3
24531,50,7414,11969;16046,13140,1,0,1,0,2
24532,50,7415,11302;11693;15151;15862;16051,13140,1,2,2,0,5
24533,50,7416,11602;11727;14896;16274,13140,1,1,2,0,4
24534,50,7417,11728;11897;14775;14924;15685;16094,13140,1,3,2,0,6
24535,50,7418,11665;11935;15466;15726,13140,0,2,2,0,4
24536,50,7419,11774,13140,0,0,1,0,1
24537,50,7420,11784;12371;14761;15059;16213;16387,13140,2,2,2,0,6
24538,50,7421,12131;14711;15067,13140,0,2,1,0,3
24539,50,7423,11664;11822;14768;15223,13140,0,2,2,0,4
24540,50,7424,11734;11825;15040;16337,13140,1,1,2,0,4
24541,50,7425,11831;12101;14660;15009;15654,13140,0,3,2,0,5
24542,50,7426,12176;15132;15253;15905;16560,13140,1,3,1,0,5
24543,50,7427,11849;12221;15070;15499;16078,13140,1,2,2,0,5
24544,50,7428,11887;12060;16343,13140,1,0,2,0,3
24545,50,7429,11694;11889;14693,13140,0,1,2,0,3
24546,50,7430,11817;11900;16196;16398,13140,2,0,2,0,4
24547,50,7431,11540;11903;15731,13140,0,1,2,0,3
24548,50,7433,11925;11937;14745;15483,13140,0,2,2,0,4
24549,50,7434,11926;12157;15061;15263,13140,0,2,2,0,4
24550,50,7435,11607;11932;14676;14820,13140,0,2,2,0,4
24551,50,7436,11752;11901;16159,13140,1,0,2,0,3
24552,50,7437,11957;12162;14814;15130,13140,0,2,2,0,4
24553,50,7438,11971;12000;14720;15152;15869;16136,13140,1,3,2,0,6
24554,50,7440,9371,13505,0,0,0,1,1
24555,50,7442,1930,13505,0,0,1,0,1
24556,50,7443,5395,13505,0,0,1,0,1
24557,50,7446,4511,13505,0,0,1,0,1
24558,50,7447,3397,13505,0,0,0,1,1
24559,50,7451,1883;5662,13505,0,0,2,0,2
24560,50,7456,2878,13505,0,0,1,0,1
24561,50,7457,5308,13505,0,0,0,1,1
24562,50,7458,2812,13505,0,0,0,1,1
24563,50,7459,7733;8268,13505,0,0,0,2,2
24564,50,7460,7000,13505,0,0,0,1,1
24565,50,7462,7237,13505,0,0,0,1,1
24566,50,7466,2342;6861,13505,0,0,0,2,2
24567,50,7468,8854;9332,13505,0,0,2,0,2
24568,50,7471,6420;9951,13505,0,0,1,1,2
24569,50,7473,1837,13505,0,0,1,0,1
24570,50,7475,10962;14811;15075,13505,0,2,1,0,3
24571,50,7478,10414;10490;14822;15235;15435,13505,0,3,2,0,5
24572,50,7481,10445,13505,0,0,1,0,1
24573,50,7482,10479,13505,0,0,1,0,1
24574,50,7483,10878;14812;15711,13505,0,2,1,0,3
24575,50,7484,10161;10592;14876;15217;15390,13505,0,3,2,0,5
24576,50,7486,10939;10999;14821;15379,13505,0,2,2,0,4
24577,50,7488,10800;11064;14853;15277;16275,13505,1,2,2,0,5
24578,50,7489,10843;11477;15677,13505,0,1,2,0,3
24579,50,7491,10605;11126;14816;15414,13505,0,2,2,0,4
24580,50,7492,11138;11186;14830;15155,13505,0,2,2,0,4
24581,50,7493,11332;15264;15997,13505,1,1,1,0,3
24582,50,7494,11142;14929;14967,13505,0,2,1,0,3
24583,50,7495,11506;15510;15928,13505,0,2,1,0,3
24584,50,7497,10560;11286;15244;15832,13505,0,2,2,0,4
24585,50,7498,11292;14943;14993;15528,13505,0,3,1,0,4
24586,50,7499,11307;11528;15708,13505,0,1,2,0,3
24587,50,7500,11357;12004;15357,13505,0,1,2,0,3
24588,50,7501,11020;11408;14930;15245,13505,0,2,2,0,4
24589,50,7502,11605;11860;14837;15772,13505,0,2,2,0,4
24590,50,7503,11140;11474;15303,13505,0,1,2,0,3
24591,50,7504,11246;11516;14843,13505,0,1,2,0,3
24592,50,7505,11554;11979,13505,0,0,2,0,2
24593,50,7506,11552;11581;15295;16295,13505,1,1,2,0,4
24594,50,7507,11599;12181;14931;15766;16173,13505,1,2,2,0,5
24595,50,7508,11939;11980;15512;16372,13505,1,1,2,0,4
24596,50,7509,11560;11627;14935;15366;16450,13505,1,2,2,0,5
24597,50,7510,11641;11684;15419,13505,0,1,2,0,3
24598,50,7511,11643;11732;15341;16257,13505,1,1,2,0,4
24599,50,7512,11660;12203;15474;15957,13505,1,1,2,0,4
24600,50,7513,11479;11672;15051;15842,13505,0,2,2,0,4
24601,50,7514,11427;11678;15325;15959,13505,1,1,2,0,4
24602,50,7515,11475;11766;14916;15648,13505,0,2,2,0,4
24603,50,7516,11788;12472;15162,13505,0,1,2,0,3
24604,50,7517,11569;11793;14941;15280;15594,13505,0,3,2,0,5
24605,50,7518,11875;12219;15497;15672,13505,0,2,2,0,4
24606,50,7519,11877;12342;15054;15141;15476;15801,13505,0,4,2,0,6
24607,50,7520,11880;11960;14855;15800;16105;16557,13505,2,2,2,0,6
24608,50,7521,11893;12302;15214;16419,13505,1,1,2,0,4
24609,50,7522,11879;12249;16241,13505,1,0,2,0,3
24610,50,7523,11610;11896;15000;15915;16024;16331,13505,2,2,2,0,6
24611,50,7524,11899;12324;15066;15442,13505,0,2,2,0,4
24612,50,7525,12167;14956;15489;16391,13505,1,2,1,0,4
24613,50,7526,11927;12346;14942;14988,13505,0,2,2,0,4
24614,50,7527,11941;12091;16464,13505,1,0,2,0,3
24615,50,7528,11726;11955;15526,13505,0,1,2,0,3
24616,50,7529,11961;11994;14910;15770,13505,0,2,2,0,4
24617,50,7530,11797;11981;15844,13505,0,1,2,0,3
24618,50,7531,11753;11987;16338,13505,1,0,2,0,3
24619,50,7532,12376;15334;16010;16509,13505,2,1,1,0,4
24620,50,7533,12018;12204;15520;15556;15934,13505,0,3,2,0,5
24621,50,7534,11692;12065;16138;16209,13505,2,0,2,0,4
24622,50,7535,11751;12067;16106,13505,1,0,2,0,3
24623,50,7536,12073;12392;15047;15853,13505,0,2,2,0,4
24624,50,7537,12089;12093;15185;16433,13505,1,1,2,0,4
24625,50,7538,12099;12124;14999;15229;15455;15765;16224,13505,1,4,2,0,7
24626,50,7539,11769;12107;14849;15330,13505,0,2,2,0,4
24627,50,7540,12120;12460;14913;15890;16277,13505,1,2,2,0,5
24628,50,7541,12529;15494;15944;16553,13505,2,1,1,0,4
24629,50,7542,488;7404,13870,0,0,1,1,2
24630,50,7543,2795;3463,13870,0,0,0,2,2
24631,50,7547,65,13870,0,0,0,1,1
24632,50,7550,3177;3198,13870,0,0,0,2,2
24633,50,7553,7896,13870,0,0,0,1,1
24634,50,7554,6053,13870,0,0,1,0,1
24635,50,7555,6450;7465,13870,0,0,0,2,2
24636,50,7557,7211,13870,0,0,1,0,1
24637,50,7562,1814,13870,0,0,0,1,1
24638,50,7563,8966,13870,0,0,0,1,1
24639,50,7564,9740,13870,0,0,1,0,1
24640,50,7567,1493,13870,0,0,1,0,1
24641,50,7569,10399;14966;15254,13870,0,2,1,0,3
24642,50,7570,10515,13870,0,0,1,0,1
24643,50,7571,10531;10538;14978;15178,13870,0,2,2,0,4
24644,50,7573,10591,13870,0,0,1,0,1
24645,50,7575,10801;10841;15087,13870,0,1,2,0,3
24646,50,7578,10943;10956;15695;16050,13870,1,1,2,0,4
24647,50,7579,11001;11262;15345;15644;16077,13870,1,2,2,0,5
24648,50,7580,11021;11195;15118;16415,13870,1,1,2,0,4
24649,50,7582,10556;11118;14961;15232,13870,0,2,2,0,4
24650,50,7583,10977;11199;14981;15513,13870,0,2,2,0,4
24651,50,7584,11250,13870,0,0,1,0,1
24652,50,7585,10232,13870,0,0,1,0,1
24653,50,7586,11333;11365;15048;15925,13870,0,2,2,0,4
24654,50,7587,11350;11656;15395;16068,13870,1,1,2,0,4
24655,50,7588,11388;11720;15041;15613,13870,0,2,2,0,4
24656,50,7589,11406;11675;15124;15834,13870,0,2,2,0,4
24657,50,7590,11418;15288;16341,13870,1,1,1,0,3
24658,50,7591,11454;11469;14948;15260;15933,13870,0,3,2,0,5
24659,50,7592,11285,13870,0,0,1,0,1
24660,50,7593,11510;15143;15782,13870,0,2,1,0,3
24661,50,7596,11536;11561;15014;15790;15846,13870,0,3,2,0,5
24662,50,7597,11574;12118;15895,13870,0,1,2,0,3
24663,50,7598,11593;12434;15194;15810;16534,13870,1,2,2,0,5
24664,50,7599,11659;12062;15204,13870,0,1,2,0,3
24665,50,7600,11690;11975;15671;16543,13870,1,1,2,0,4
24666,50,7601,11748;12070;15955,13870,1,0,2,0,3
24667,50,7602,11775;11933;15809;16550,13870,1,1,2,0,4
24668,50,7603,11806,13870,0,0,1,0,1
24669,50,7604,11345;11811;14969;15201;15599,13870,0,3,2,0,5
24670,50,7605,11789;12104;15177;15917;16237,13870,1,2,2,0,5
24671,50,7606,12058;12187;16229,13870,1,0,2,0,3
24672,50,7607,11916;15601;16157;16388,13870,2,1,1,0,4
24673,50,7608,11942;12092;14955;15333;15625,13870,0,3,2,0,5
24674,50,7609,11924;11944;15098;15791,13870,0,2,2,0,4
24675,50,7610,11950;12160;15417;15667,13870,0,2,2,0,4
24676,50,7611,12639;16432,13870,1,0,1,0,2
24677,50,7612,11962;12191;15150;15637,13870,0,2,2,0,4
24678,50,7613,11963;15215;15688,13870,0,2,1,0,3
24679,50,7614,11976;12267;16508,13870,1,0,2,0,3
24680,50,7616,12364;15024,13870,0,1,1,0,2
24681,50,7617,12019;12413;15001;15745;16474,13870,1,2,2,0,5
24682,50,7618,12022;12626;15351;16171,13870,1,1,2,0,4
24683,50,7619,12026;15712,13870,0,1,1,0,2
24684,50,7620,12037;12265;15020;15891,13870,0,2,2,0,4
24685,50,7621,12007;12049;15064;16260,13870,1,1,2,0,4
24686,50,7622,12078;12254;15409;16151,13870,1,1,2,0,4
24687,50,7623,11814;12329;15039;15386,13870,0,2,2,0,4
24688,50,7624,12208;15723;16127,13870,1,1,1,0,3
24689,50,7625,12100;12350;14945;15298;15977,13870,1,2,2,0,5
24690,50,7626,12111;12580,13870,0,0,2,0,2
24691,50,7627,12389;15082,13870,0,1,1,0,2
24692,50,7628,11679;12178;15175;15827;16352,13870,1,2,2,0,5
24693,50,7629,12604;15166;15509,13870,0,2,1,0,3
24694,50,7630,12201;12207;15706,13870,0,1,2,0,3
24695,50,7631,12210;12598;15617;16134,13870,1,1,2,0,4
24696,50,7632,12215;12232;16279;16322,13870,2,0,2,0,4
24697,50,7633,12551;14986;15174;15329;16363,13870,1,3,1,0,5
24698,50,7634,12255;12454;15189;16479,13870,1,1,2,0,4
24699,50,7635,12130;12259;15323;15433;15696,13870,0,3,2,0,5
24700,50,7637,334,14235,0,0,1,0,1
24701,50,7639,6537;9113,14235,0,0,0,2,2
24702,50,7645,4166,14235,0,0,0,1,1
24703,50,7646,2442,14235,0,0,1,0,1
24704,50,7647,6222,14235,0,0,0,1,1
24705,50,7648,1140,14235,0,0,0,1,1
24706,50,7649,3708,14235,0,0,0,1,1
24707,50,7651,929;3477,14235,0,0,1,1,2
24708,50,7652,7554,14235,0,0,1,0,1
24709,50,7656,9748,14235,0,0,0,1,1
24710,50,7657,9009,14235,0,0,0,1,1
24711,50,7659,9369,14235,0,0,0,1,1
24712,50,7667,10004;10240;15108;15763,14235,0,2,2,0,4
24713,50,7670,10339,14235,0,0,1,0,1
24714,50,7671,10670;11188;15097;15301,14235,0,2,2,0,4
24715,50,7672,10773;11296;15518;15551,14235,0,2,2,0,4
24716,50,7676,10945,14235,0,0,1,0,1
24717,50,7678,11042;11372;15247;15936;16018;16418,14235,2,2,2,0,6
24718,50,7679,10930,14235,0,0,1,0,1
24719,50,7680,11275;11500;15314;16242,14235,1,1,2,0,4
24720,50,7681,11232,14235,0,0,1,0,1
24721,50,7682,11079;11325;15428;15814,14235,0,2,2,0,4
24722,50,7683,11327,14235,0,0,1,0,1
24723,50,7684,11381;11691;15243;16004,14235,1,1,2,0,4
24724,50,7685,11387;11521;15292;15861;16034;16100;16442,14235,3,2,2,0,7
24725,50,7687,11472;11735;15768;16011,14235,1,1,2,0,4
24726,50,7688,11294;11654;15400;15663,14235,0,2,2,0,4
24727,50,7689,11562;11636;15193;15713;16001,14235,1,2,2,0,5
24728,50,7690,11403;11568;15388;15434,14235,0,2,2,0,4
24729,50,7691,11622;11686;15176;15596;16327,14235,1,2,2,0,5
24730,50,7692,11137;11647;15485,14235,0,1,2,0,3
24731,50,7693,11671;11919;16076,14235,1,0,2,0,3
24732,50,7694,11576;11705;15336;15689,14235,0,2,2,0,4
24733,50,7695,11335;11595;15621;16153,14235,1,1,2,0,4
24734,50,7696,12014;15992,14235,1,0,1,0,2
24735,50,7697,11355;11746;15276;15555;16525,14235,1,2,2,0,5
24736,50,7698,11765;11862;15332;15674,14235,0,2,2,0,4
24737,50,7699,11785;12366;16491,14235,1,0,2,0,3
24738,50,7700,11820;12568;16045,14235,1,0,2,0,3
24739,50,7701,11850;15142;15501;16190,14235,1,2,1,0,4
24740,50,7702,11556;11832;15103;15416,14235,0,2,2,0,4
24741,50,7703,11892;11910;16376,14235,1,0,2,0,3
24742,50,7704,11928,14235,0,0,1,0,1
24743,50,7705,11945;15481;15670,14235,0,2,1,0,3
24744,50,7706,11685;11952;16002,14235,1,0,2,0,3
24745,50,7708,12196;15275,14235,0,1,1,0,2
24746,50,7709,11977;12298;15100,14235,0,1,2,0,3
24747,50,7710,11985;12314;15436;16066,14235,1,1,2,0,4
24748,50,7711,12016;12069;15148;15412,14235,0,2,2,0,4
24749,50,7712,11767;12038;15221;15490;15811,14235,0,3,2,0,5
24750,50,7713,12408;12562;16452,14235,1,0,2,0,3
24751,50,7714,11402;12059;15817;16288,14235,1,1,2,0,4
24752,50,7715,12074;15941,14235,0,1,1,0,2
24753,50,7716,11782;12075;15282;15872;16021;16269,14235,2,2,2,0,6
24754,50,7717,12076;12592;16098,14235,1,0,2,0,3
24755,50,7718,12021;12087;15172;15876,14235,0,2,2,0,4
24756,50,7719,12288;15208;16000,14235,1,1,1,0,3
24757,50,7720,12102;15170;15283,14235,0,2,1,0,3
24758,50,7721,12012;12122;15372;16445,14235,1,1,2,0,4
24759,50,7722,12048;12126;15126;15859;16230,14235,1,2,2,0,5
24760,50,7723,12143,14235,0,0,1,0,1
24761,50,7724,12776;15311;15598,14235,0,2,1,0,3
24762,50,7725,12170;12465;15873;16475,14235,1,1,2,0,4
24763,50,7726,12184;12728,14235,0,0,2,0,2
24764,50,7727,12185;12603;16465,14235,1,0,2,0,3
24765,50,7728,12149;12199;15220;15661;15965,14235,1,2,2,0,5
24766,50,7729,12233;12697;16035,14235,1,0,2,0,3
24767,50,7730,12673;15354,14235,0,1,1,0,2
24768,50,7731,12239;12558,14235,0,0,2,0,2
24769,50,7732,11853;12362;15641;16305,14235,1,1,2,0,4
24770,50,7734,12084;12466;16179;16310,14235,2,0,2,0,4
24771,50,7735,12336;12348;16397,14235,1,0,2,0,3
24772,50,7736,12173;12432;15211,14235,0,1,2,0,3
24773,50,7737,12292;15183,14235,0,1,1,0,2
24774,50,7738,12282;12373;15587;15826,14235,0,2,2,0,4
24775,50,7740,12258;12388;15488;15863,14235,0,2,2,0,4
24776,50,7742,909,14600,0,0,1,0,1
24777,50,7743,686,14600,0,0,0,1,1
24778,50,7746,4693,14600,0,0,1,0,1
24779,50,7748,5008;9552,14600,0,0,0,2,2
24780,50,7750,4398,14600,0,0,1,0,1
24781,50,7752,1032;4860,14600,0,0,2,0,2
24782,50,7753,5192,14600,0,0,0,1,1
24783,50,7754,6999,14600,0,0,0,1,1
24784,50,7756,6571,14600,0,0,1,0,1
24785,50,7757,4770,14600,0,0,1,0,1
24786,50,7758,8020,14600,0,0,1,0,1
24787,50,7763,3240;9128,14600,0,0,0,2,2
24788,50,7765,6201,14600,0,0,1,0,1
24789,50,7766,2871;9838,14600,0,0,2,0,2
24790,50,7772,10497;10623;16468,14600,1,0,2,0,3
24791,50,7773,10561;11239;15534;15888,14600,0,2,2,0,4
24792,50,7775,10655;11226;15819;16244,14600,1,1,2,0,4
24793,50,7776,10686;10748;15234;15531,14600,0,2,2,0,4
24794,50,7777,10456,14600,0,0,1,0,1
24795,50,7778,10782;10993;15265;15541,14600,0,2,2,0,4
24796,50,7780,10846;15284,14600,0,1,1,0,2
24797,50,7781,10849;10887;15537;16308,14600,1,1,2,0,4
24798,50,7783,10918;11084;15533;15840,14600,0,2,2,0,4
24799,50,7785,10665;11157;16055;16103,14600,2,0,2,0,4
24800,50,7786,10877;11076;16092,14600,1,0,2,0,3
24801,50,7787,10614;11178;15451;15693,14600,0,2,2,0,4
24802,50,7788,11154;11412;15258;16027,14600,1,1,2,0,4
24803,50,7789,11148;11597;15355;15575;16003,14600,1,2,2,0,5
24804,50,7790,11149;11251;15249;15736,14600,0,2,2,0,4
24805,50,7791,11213;15233;15580;15906,14600,0,3,1,0,4
24806,50,7792,11271;11645;15662;15929,14600,0,2,2,0,4
24807,50,7793,11278;15735;16499,14600,1,1,1,0,3
24808,50,7794,11781;15320;15622,14600,0,2,1,0,3
24809,50,7795,11353;11390;15242;15597,14600,0,2,2,0,4
24810,50,7796,11304;11395;15259;15538,14600,0,2,2,0,4
24811,50,7797,11160;11580;15465;16162,14600,1,1,2,0,4
24812,50,7798,10920,14600,0,0,1,0,1
24813,50,7799,11532;11906;15508;16206,14600,1,1,2,0,4
24814,50,7800,11563;11718;15431;16478,14600,1,1,2,0,4
24815,50,7801,11557;11603;15630;16164,14600,1,1,2,0,4
24816,50,7802,11621;11669;15384;15825,14600,0,2,2,0,4
24817,50,7803,11652;11815;16467,14600,1,0,2,0,3
24818,50,7804,11492;11768;15632;15749,14600,0,2,2,0,4
24819,50,7805,11549;11946;16490,14600,1,0,2,0,3
24820,50,7806,11729;11762;15241;16043;16554,14600,2,1,2,0,5
24821,50,7807,11749;12276,14600,0,0,2,0,2
24822,50,7808,11423;11756;15603,14600,0,1,2,0,3
24823,50,7809,11829;12420;15619,14600,0,1,2,0,3
24824,50,7810,11846;12139;15796;16286,14600,1,1,2,0,4
24825,50,7811,11855,14600,0,0,1,0,1
24826,50,7812,11791;11867;15296;15549,14600,0,2,2,0,4
24827,50,7813,11385;11891;15576;15716,14600,0,2,2,0,4
24828,50,7814,11913;12323;15678;16489,14600,1,1,2,0,4
24829,50,7815,11539;11988;15857;16143,14600,1,1,2,0,4
24830,50,7816,11894;11991;16040,14600,1,0,2,0,3
24831,50,7817,11845;12008;15418;15812;16285,14600,1,2,2,0,5
24832,50,7818,12023;12119;16223,14600,1,0,2,0,3
24833,50,7819,11587;12041;16026,14600,1,0,2,0,3
24834,50,7820,12077;12306;16156,14600,1,0,2,0,3
24835,50,7821,12082;12347;15806,14600,0,1,2,0,3
24836,50,7822,11940;12322;15423;15655;16287;16516,14600,2,2,2,0,6
24837,50,7823,11792;12106;16088,14600,1,0,2,0,3
24838,50,7824,12132;12572;15347;15516;15635;15966,14600,1,3,2,0,6
24839,50,7825,11787;12133;15722;16133,14600,1,1,2,0,4
24840,50,7826,12326;12750,14600,0,0,2,0,2
24841,50,7827,11363;12177;16059;16421,14600,2,0,2,0,4
24842,50,7828,12186;12387;16141;16346,14600,2,0,2,0,4
24843,50,7829,12190;12622;15824;15982;16289,14600,2,1,2,0,5
24844,50,7830,12222;12285,14600,0,0,2,0,2
24845,50,7831,12034;12274;16228,14600,1,0,2,0,3
24846,50,7832,12172;12257;16053,14600,1,0,2,0,3
24847,50,7833,12088;12775,14600,0,0,2,0,2
24848,50,7834,12171;12294;16469,14600,1,0,2,0,3
24849,50,7835,12311;12629;15405;15807,14600,0,2,2,0,4
24850,50,7836,12313;12367;15415;16498,14600,1,1,2,0,4
24851,50,7837,12009;12404,14600,0,0,2,0,2
24852,50,7838,12227;12332;15935;16052,14600,1,1,2,0,4
24853,50,7839,11715;12338;15349,14600,0,1,2,0,3
24854,50,7840,12027;12339;16056,14600,1,0,2,0,3
24855,50,7841,12344;12706;15274;15643,14600,0,2,2,0,4
24856,50,7842,12153;12359;15444;15579,14600,0,2,2,0,4
24857,50,7843,11996;12505;16401,14600,1,0,2,0,3
24858,50,7844,12280;12378,14600,0,0,2,0,2
24859,50,7845,11986;12390;15383;15540;15901,14600,0,3,2,0,5
24860,50,7846,12290;12452;15318;15803,14600,0,2,2,0,4
24861,50,7847,12594;15709,14600,0,1,1,0,2
24862,50,7848,12370;12489;16339,14600,1,0,2,0,3
24863,50,7849,12652;15339,14600,0,1,1,0,2
24864,50,7850,9246,14965,0,0,1,0,1
24865,50,7854,3255,14965,0,0,0,1,1
24866,50,7859,3481,14965,0,0,1,0,1
24867,50,7860,4505,14965,0,0,0,1,1
24868,50,7862,5982,14965,0,0,0,1,1
24869,50,7864,5565,14965,0,0,1,0,1
24870,50,7865,5715,14965,0,0,0,1,1
24871,50,7866,5789,14965,0,0,1,0,1
24872,50,7868,6949,14965,0,0,0,1,1
24873,50,7869,1321;3374,14965,0,0,1,1,2
24874,50,7870,3833;7372,14965,0,0,0,2,2
24875,50,7873,8806,14965,0,0,1,0,1
24876,50,7875,10049,14965,0,0,1,0,1
24877,50,7876,10304,14965,0,0,1,0,1
24878,50,7877,10384;10493,14965,0,0,2,0,2
24879,50,7879,10283;10585;15446;15985,14965,1,1,2,0,4
24880,50,7880,10687;10880,14965,0,0,2,0,2
24881,50,7883,11014;11838;15740;16065;16393,14965,2,1,2,0,5
24882,50,7884,10759;10941;15429;15899,14965,0,2,2,0,4
24883,50,7885,10554;11071;15452;15785,14965,0,2,2,0,4
24884,50,7886,11176;11383;15454;15675,14965,0,2,2,0,4
24885,50,7887,11194;11261;16097;16402,14965,2,0,2,0,4
24886,50,7888,10950;10965,14965,0,0,2,0,2
24887,50,7889,11373;11447;15521;15730;15987,14965,1,2,2,0,5
24888,50,7890,10890;11514;15755,14965,0,1,2,0,3
24889,50,7892,11369;11667;16095,14965,1,0,2,0,3
24890,50,7893,11419;15734,14965,0,1,1,0,2
24891,50,7894,11092;11504;15566;16358;16368,14965,2,1,2,0,5
24892,50,7895,11222;11545;15470;15710;16022,14965,1,2,2,0,5
24893,50,7896,11596;11635;15590;16281,14965,1,1,2,0,4
24894,50,7897,11625;11827;15721;16081,14965,1,1,2,0,4
24895,50,7898,11631;12495;15913;16019;16240,14965,2,1,2,0,5
24896,50,7899,11579;11661;15506;16548,14965,1,1,2,0,4
24897,50,7900,11776;12960,14965,0,0,2,0,2
24898,50,7901,11706,14965,0,0,1,0,1
24899,50,7902,11710;12248;16210,14965,1,0,2,0,3
24900,50,7903,11555;11824;15606;15878;16482,14965,1,2,2,0,5
24901,50,7904,11876;12057;16265,14965,1,0,2,0,3
24902,50,7905,11730;11886;15410;16471,14965,1,1,2,0,4
24903,50,7906,11943;11972;15443;15758;16137,14965,1,2,2,0,5
24904,50,7907,11873;11947;16072,14965,1,0,2,0,3
24905,50,7908,11954;12497,14965,0,0,2,0,2
24906,50,7909,12006;12732;15563;16150;16403,14965,2,1,2,0,5
24907,50,7910,11589;12011;15684,14965,0,1,2,0,3
24908,50,7911,12015;12870;15468;15781,14965,0,2,2,0,4
24909,50,7912,11770;12025;15798,14965,0,1,2,0,3
24910,50,7913,12040;12212;15990;16199,14965,2,0,2,0,4
24911,50,7914,11433;12068;16258,14965,1,0,2,0,3
24912,50,7915,12094;12381;15480;16529,14965,1,1,2,0,4
24913,50,7916,11964;12097;15912;16296,14965,1,1,2,0,4
24914,50,7917,12154;12299;15802;16263,14965,1,1,2,0,4
24915,50,7918,11921;12174;15779;16521,14965,1,1,2,0,4
24916,50,7919,12183;12287;15948,14965,1,0,2,0,3
24917,50,7920,12032;12240;15784;16109;16302,14965,2,1,2,0,5
24918,50,7921,12260;12564;15729;16524,14965,1,1,2,0,4
24919,50,7922,12031;12271;15514;15851,14965,0,2,2,0,4
24920,50,7923,12296;12787,14965,0,0,2,0,2
24921,50,7924,12593;12624;15572;16430,14965,1,1,2,0,4
24922,50,7925,12028;12308;15783,14965,0,1,2,0,3
24923,50,7926,12309;12530;16176;16457,14965,2,0,2,0,4
24924,50,7927,12316;12664,14965,0,0,2,0,2
24925,50,7928,12295;12320;15751,14965,0,1,2,0,3
24926,50,7929,12064;12541;16381,14965,1,0,2,0,3
24927,50,7930,12451;12932,14965,0,0,2,0,2
24928,50,7931,12353;12458;16266,14965,1,0,2,0,3
24929,50,7932,11929;12507;15860,14965,0,1,2,0,3
24930,50,7933,12555;15902;16090,14965,1,1,1,0,3
24931,50,7934,12553;12778;16357,14965,1,0,2,0,3
24932,50,7935,12565;12946;15473;15683;16096,14965,1,2,2,0,5
24933,50,7936,12595;16017,14965,1,0,1,0,2
24934,50,7937,12402;12599;16444,14965,1,0,2,0,3
24935,50,7938,12241;12609;16120,14965,1,0,2,0,3
24936,50,7939,12063;12621;16459,14965,1,0,2,0,3
24937,50,7940,12635;12690;16118,14965,1,0,2,0,3
24938,50,7941,12647;12699;15998,14965,1,0,2,0,3
24939,50,7942,12351;12658;15609,14965,0,1,2,0,3
24940,50,7943,12660;12757;15422,14965,0,1,2,0,3
24941,50,7944,110;1100,15330,0,0,1,1,2
24942,50,7945,811,15330,0,0,0,1,1
24943,50,7947,9643,15330,0,0,1,0,1
24944,50,7949,6879,15330,0,0,1,0,1
24945,50,7950,2517,15330,0,0,0,1,1
24946,50,7951,9225,15330,0,0,1,0,1
24947,50,7952,4149,15330,0,0,1,0,1
24948,50,7954,5557;10273;15738;15972,15330,1,1,2,0,4
24949,50,7955,9224,15330,0,0,0,1,1
24950,50,7956,2189;4862,15330,0,0,2,0,2
24951,50,7958,8013,15330,0,0,1,0,1
24952,50,7967,10424;10663;15645;15757,15330,0,2,2,0,4
24953,50,7968,10464;11212;15585;15762,15330,0,2,2,0,4
24954,50,7972,10196,15330,0,0,1,0,1
24955,50,7973,10739;11284;15778;16152,15330,1,1,2,0,4
24956,50,7974,10799;11966;15795,15330,0,1,2,0,3
24957,50,7975,10830;10853;15624;16080,15330,1,1,2,0,4
24958,50,7977,10959;10964;15525;16135,15330,1,1,2,0,4
24959,50,7978,10871;11007;16249,15330,1,0,2,0,3
24960,50,7979,11777;12052;15582;15919;16420,15330,1,2,2,0,5
24961,50,7981,11245;11883;16084;16549,15330,2,0,2,0,4
24962,50,7982,11313;11437;15786,15330,0,1,2,0,3
24963,50,7984,11503;11638;15569;15924;16425,15330,1,2,2,0,5
24964,50,7985,11376;12179;15930;16259,15330,1,1,2,0,4
24965,50,7989,11676;12156;15611,15330,0,1,2,0,3
24966,50,7990,11683;15532;16032,15330,1,1,1,0,3
24967,50,7991,11360;11696;15546,15330,0,1,2,0,3
24968,50,7992,11623;11783;15676;15927,15330,0,2,2,0,4
24969,50,7993,11801;12283;15885;16301,15330,1,1,2,0,4
24970,50,7994,11865;12384;16365,15330,1,0,2,0,3
24971,50,7995,11907;15792,15330,0,1,1,0,2
24972,50,7996,11755;11911;16124,15330,1,0,2,0,3
24973,50,7997,11842;11923;15760;15831,15330,0,2,2,0,4
24974,50,7998,11990;16231;16318,15330,2,0,1,0,3
24975,50,7999,12024;12784;15911;15971,15330,1,1,2,0,4
24976,50,8000,12105;12702;16033;16435,15330,2,0,2,0,4
24977,50,8001,12140;12409;15664;16424,15330,1,1,2,0,4
24978,50,8002,12365;15544;15850,15330,0,2,1,0,3
24979,50,8003,12168;12244;15956;16348,15330,2,0,2,0,4
24980,50,8004,11721;12169;16058;16273,15330,2,0,2,0,4
24981,50,8005,12175;12189;16399,15330,1,0,2,0,3
24982,50,8006,12042;12197;15639;16112,15330,1,1,2,0,4
24983,50,8007,12226;12589;16345;16528,15330,2,0,2,0,4
24984,50,8008,12242;12345;16423,15330,1,0,2,0,3
24985,50,8009,12243;12284,15330,0,0,2,0,2
24986,50,8010,11905;12245;15700,15330,0,1,2,0,3
24987,50,8011,11922;12253;16067,15330,1,0,2,0,3
24988,50,8012,12256;12264;15903;16075,15330,1,1,2,0,4
24989,50,8013,12821,15330,0,0,1,0,1
24990,50,8014,12010;12310,15330,0,0,2,0,2
24991,50,8015,12858,15330,0,0,1,0,1
24992,50,8016,12328;13211;15703,15330,0,1,2,0,3
24993,50,8017,12709,15330,0,0,1,0,1
24994,50,8018,12379;12773;16438,15330,1,0,2,0,3
24995,50,8019,12081;12393;16091,15330,1,0,2,0,3
24996,50,8020,12412;13281;16042,15330,1,0,2,0,3
24997,50,8021,12426;12759,15330,0,0,2,0,2
24998,50,8022,11847;12443;15523;16455,15330,1,1,2,0,4
24999,50,8023,12450;12812;15522;15687,15330,0,2,2,0,4
25000,50,8024,12476;12803,15330,0,0,2,0,2
25001,50,8025,12039;12512,15330,0,0,2,0,2
25002,50,8026,12655;16389,15330,1,0,1,0,2
25003,50,8027,12372;12499;15715,15330,0,1,2,0,3
25004,50,8028,12535;12949;15717;15847;15969,15330,1,2,2,0,5
25005,50,8029,12538;12925;16396,15330,1,0,2,0,3
25006,50,8030,12552;12982;15646,15330,0,1,2,0,3
25007,50,8031,12573;12781;16093,15330,1,0,2,0,3
25008,50,8032,12500;12770;15953;16375,15330,2,0,2,0,4
25009,50,8033,12250;12596,15330,0,0,2,0,2
25010,50,8034,12625;12711,15330,0,0,2,0,2
25011,50,8035,12202;12631;16500,15330,1,0,2,0,3
25012,50,8036,12640;12879;16233,15330,1,0,2,0,3
25013,50,8037,12659;13195;15815,15330,0,1,2,0,3
25014,50,8038,12701;13041;16089,15330,1,0,2,0,3
25015,50,8039,12745,15330,0,0,1,0,1
25016,50,8040,12417;12764;16477,15330,1,0,2,0,3
25017,50,8041,12766;13207;15892,15330,0,1,2,0,3
25018,50,8042,12788;15775,15330,0,1,1,0,2
25019,50,8043,12801,15330,0,0,1,0,1
25020,50,8044,7398,15695,0,0,1,0,1
25021,50,8052,3978,15695,0,0,0,1,1
25022,50,8053,5888,15695,0,0,0,1,1
25023,50,8054,3184,15695,0,0,0,1,1
25024,50,8057,6370,15695,0,0,1,0,1
25025,50,8058,6904,15695,0,0,1,0,1
25026,50,8060,3145;7115,15695,0,0,2,0,2
25027,50,8061,6342,15695,0,0,1,0,1
25028,50,8062,7723,15695,0,0,1,0,1
25029,50,8063,8538,15695,0,0,0,1,1
25030,50,8066,9974,15695,0,0,0,1,1
25031,50,8067,10222,15695,0,0,1,0,1
25032,50,8068,10322,15695,0,0,1,0,1
25033,50,8069,10406;10529;15938,15695,0,1,2,0,3
25034,50,8071,10468,15695,0,0,1,0,1
25035,50,8074,10477,15695,0,0,1,0,1
25036,50,8075,11145;11198;15821;15954,15695,1,1,2,0,4
25037,50,8076,11075;11155;15698;15942,15695,1,1,2,0,4
25038,50,8077,11291,15695,0,0,1,0,1
25039,50,8078,11272,15695,0,0,1,0,1
25040,50,8080,11586;11711;16443,15695,1,0,2,0,3
25041,50,8081,11542,15695,0,0,1,0,1
25042,50,8082,11443;11737;15742,15695,0,1,2,0,3
25043,50,8084,12047;12110;15974;16385,15695,2,0,2,0,4
25044,50,8085,11709;11974;16461,15695,1,0,2,0,3
25045,50,8086,11959;12559;16016;16304,15695,2,0,2,0,4
25046,50,8087,11854;11992;15989;16405,15695,2,0,2,0,4
25047,50,8088,11998;12273;16183,15695,1,0,2,0,3
25048,50,8089,12035;12335;16208,15695,1,0,2,0,3
25049,50,8090,12108;12511;16126;16330,15695,2,0,2,0,4
25050,50,8091,11970;12188,15695,0,0,2,0,2
25051,50,8093,11888;12297;15704;16441,15695,1,1,2,0,4
25052,50,8094,12319,15695,0,0,1,0,1
25053,50,8095,12341;12916,15695,0,0,2,0,2
25054,50,8096,12368;12485;16373,15695,1,0,2,0,3
25055,50,8097,12300;12391;16216,15695,1,0,2,0,3
25056,50,8098,11800;12405;16194,15695,1,0,2,0,3
25057,50,8099,12414;12561,15695,0,0,2,0,2
25058,50,8100,12483;12661;16362,15695,1,0,2,0,3
25059,50,8101,12438;12527;15866,15695,0,1,2,0,3
25060,50,8102,12134;12461;15865;16181,15695,1,1,2,0,4
25061,50,8103,12470;16561,15695,1,0,1,0,2
25062,50,8104,13097;15701,15695,0,1,1,0,2
25063,50,8105,12477;12785;16073,15695,1,0,2,0,3
25064,50,8106,12517;13365;15691;15835;16149,15695,1,2,2,0,5
25065,50,8107,12547;12892;15823,15695,0,1,2,0,3
25066,50,8108,12146;12571;15839;16251;16533,15695,2,1,2,0,5
25067,50,8109,12546;12586,15695,0,0,2,0,2
25068,50,8110,12611;13295;15719,15695,0,1,2,0,3
25069,50,8111,12478,15695,0,0,1,0,1
25070,50,8112,12484;12619;16005,15695,1,0,2,0,3
25071,50,8113,11934;11956;16342,15695,1,0,2,0,3
25072,50,8114,12044;12650;16290,15695,1,0,2,0,3
25073,50,8115,12623,15695,0,0,1,0,1
25074,50,8116,12727;12962;15746;16117;16278,15695,2,1,2,0,5
25075,50,8117,13234;15896;15991;16394,15695,2,1,1,0,4
25076,50,8118,12605;12735;15756;16060;16325,15695,2,1,2,0,5
25077,50,8119,12135;12765;15694;16057;16536,15695,2,1,2,0,5
25078,50,8120,12777;13171;15733;16364,15695,1,1,2,0,4
25079,50,8121,12791;12900;15978;16161,15695,2,0,2,0,4
25080,50,8122,12804;15849;16083;16370,15695,2,1,1,0,4
25081,50,8123,12810;12990;16123;16472,15695,2,0,2,0,4
25082,50,8124,12938,15695,0,0,1,0,1
25083,50,8125,12789;12820;15918,15695,0,1,2,0,3
25084,50,8126,12448;12829;15855,15695,0,1,2,0,3
25085,50,8127,12917,15695,0,0,1,0,1
25086,50,8128,12677;12838;15937,15695,0,1,2,0,3
25087,50,8129,12846;12855,15695,0,0,2,0,2
25088,50,8130,12864;13297;15908;16013,15695,1,1,2,0,4
25089,50,8131,12869;12902;16413,15695,1,0,2,0,3
25090,50,8132,12303;12881,15695,0,0,2,0,2
25091,50,8133,12415;12889,15695,0,0,2,0,2
25092,50,8134,12823;12890;16087;16519,15695,2,0,2,0,4
25093,50,8135,12891;13168;15732,15695,0,1,2,0,3
25094,50,8136,12469;12912;15767;16486,15695,1,1,2,0,4
25095,50,8137,12836;13939;16268;16426,15695,2,0,2,0,4
25096,50,8139,870,16060,0,0,1,0,1
25097,50,8140,4381,16060,0,0,0,1,1
25098,50,8141,584,16060,0,0,0,1,1
25099,50,8142,1217,16060,0,0,1,0,1
25100,50,8144,3968,16060,0,0,1,0,1
25101,50,8145,5963,16060,0,0,0,1,1
25102,50,8146,1707,16060,0,0,1,0,1
25103,50,8147,6970,16060,0,0,1,0,1
25104,50,8149,5328,16060,0,0,1,0,1
25105,50,8152,5248,16060,0,0,0,1,1
25106,50,8155,5731,16060,0,0,1,0,1
25107,50,8156,10309;10500,16060,0,0,2,0,2
25108,50,8158,10041,16060,0,0,1,0,1
25109,50,8159,10370,16060,0,0,1,0,1
25110,50,8160,10429,16060,0,0,1,0,1
25111,50,8161,10459,16060,0,0,1,0,1
25112,50,8163,10409;10994,16060,0,0,2,0,2
25113,50,8169,10852;10984;15900,16060,0,1,2,0,3
25114,50,8172,11282,16060,0,0,1,0,1
25115,50,8173,11300;11649;15841;16054,16060,1,1,2,0,4
25116,50,8174,11422;11425;15897;16530,16060,1,1,2,0,4
25117,50,8175,11170;11446;15843,16060,0,1,2,0,3
25118,50,8176,11843;16006;16271,16060,2,0,1,0,3
25119,50,8178,11544;12235;16267,16060,1,0,2,0,3
25120,50,8179,11570,16060,0,0,1,0,1
25121,50,8180,11604;11609;15852;16262;16422,16060,2,1,2,0,5
25122,50,8182,11490;12061;16492,16060,1,0,2,0,3
25123,50,8183,11666;11758;15838;15951;16427,16060,2,1,2,0,5
25124,50,8184,11816;12003;16531,16060,1,0,2,0,3
25125,50,8185,11839;12218;16225,16060,1,0,2,0,3
25126,50,8186,11639;11856;15864;16107,16060,1,1,2,0,4
25127,50,8187,11870;12281;16169,16060,1,0,2,0,3
25128,50,8188,11917;12361;16542,16060,1,0,2,0,3
25129,50,8189,11803;11949,16060,0,0,2,0,2
25130,50,8190,11993;12532,16060,0,0,2,0,2
25131,50,8191,12001;12293;15830,16060,0,1,2,0,3
25132,50,8192,12005;15988;16353,16060,2,0,1,0,3
25133,50,8193,11501;12020;15980,16060,1,0,2,0,3
25134,50,8194,12072;12492;16102;16407,16060,2,0,2,0,4
25135,50,8195,12095;16036,16060,1,0,1,0,2
25136,50,8196,12109;12887;16104,16060,1,0,2,0,3
25137,50,8197,12115;12195;15880,16060,0,1,2,0,3
25138,50,8198,12017;12150;16074,16060,1,0,2,0,3
25139,50,8199,12223;12325;15922,16060,0,1,2,0,3
25140,50,8200,12114;12337;15879;16448,16060,1,1,2,0,4
25141,50,8202,12321;12419;15322;16130,16060,1,1,2,0,4
25142,50,8203,12422,16060,0,0,1,0,1
25143,50,8204,12446;13107,16060,0,0,2,0,2
25144,50,8205,12449;12536;15946;16292,16060,2,0,2,0,4
25145,50,8206,12510,16060,0,0,1,0,1
25146,50,8207,12516;12911,16060,0,0,2,0,2
25147,50,8208,12231;12590;16408,16060,1,0,2,0,3
25148,50,8209,11958;12560;16168,16060,1,0,2,0,3
25149,50,8210,12486;12569;16494,16060,1,0,2,0,3
25150,50,8211,12587;12678;16070;16367,16060,2,0,2,0,4
25151,50,8212,12467;13089,16060,0,0,2,0,2
25152,50,8213,13516;15907;16061,16060,1,1,1,0,3
25153,50,8214,12588;12614,16060,0,0,2,0,2
25154,50,8215,12643;12825;15858;15995;16545,16060,2,1,2,0,5
25155,50,8216,12653;12835,16060,0,0,2,0,2
25156,50,8217,12691;13419;15967;16264,16060,2,0,2,0,4
25157,50,8218,12704;13046;16041;16247;16332,16060,3,0,2,0,5
25158,50,8219,12716;13368;16028;16323;16463,16060,3,0,2,0,5
25159,50,8220,12531;12731,16060,0,0,2,0,2
25160,50,8221,12756;13143;15829,16060,0,1,2,0,3
25161,50,8222,13146;16125,16060,1,0,1,0,2
25162,50,8223,12349;12780;15932,16060,0,1,2,0,3
25163,50,8224,12815;12831,16060,0,0,2,0,2
25164,50,8225,12721;12878;16505,16060,1,0,2,0,3
25165,50,8226,12686;12904,16060,0,0,2,0,2
25166,50,8227,12830;12921,16060,0,0,2,0,2
25167,50,8228,12739;12817,16060,0,0,2,0,2
25168,50,8229,12942;13255;15870;16539,16060,1,1,2,0,4
25169,50,8230,12570;12945;16144;16347,16060,2,0,2,0,4
25170,50,8231,12964,16060,0,0,1,0,1
25171,50,8232,12978;15909;16252,16060,1,1,1,0,3
25172,50,8233,12600;12983,16060,0,0,2,0,2
25173,50,8234,12999;13376,16060,0,0,2,0,2
25174,50,8235,13014;13359;15871,16060,0,1,2,0,3
25175,50,8236,12980;13025,16060,0,0,2,0,2
25176,50,8237,13052;13391,16060,0,0,2,0,2
25177,50,8238,12597;13058;15920;16320,16060,1,1,2,0,4
25178,50,8239,13078;13446,16060,0,0,2,0,2
25179,50,8240,9256,16425,0,0,0,1,1
25180,50,8242,8307,16425,0,0,1,0,1
25181,50,8244,3086,16425,0,0,0,1,1
25182,50,8246,3185,16425,0,0,1,0,1
25183,50,8247,5870,16425,0,0,1,0,1
25184,50,8248,6233,16425,0,0,1,0,1
25185,50,8249,5296,16425,0,0,1,0,1
25186,50,8251,2625,16425,0,0,1,0,1
25187,50,8252,5743,16425,0,0,1,0,1
25188,50,8253,4379,16425,0,0,0,1,1
25189,50,8254,4304;6238,16425,0,0,2,0,2
25190,50,8255,9500,16425,0,0,0,1,1
25191,50,8256,9230,16425,0,0,1,0,1
25192,50,8259,1169,16425,0,0,0,1,1
25193,50,8260,9317,16425,0,0,1,0,1
25194,50,8261,6782,16425,0,0,0,1,1
25195,50,8262,7766,16425,0,0,1,0,1
25196,50,8266,10534,16425,0,0,1,0,1
25197,50,8269,10746;15981,16425,1,0,1,0,2
25198,50,8271,10487;10861;16048,16425,1,0,2,0,3
25199,50,8277,11193;16122;16214,16425,2,0,1,0,3
25200,50,8278,11163,16425,0,0,1,0,1
25201,50,8280,11173,16425,0,0,1,0,1
25202,50,8281,11231;11712;15952;16178,16425,2,0,2,0,4
25203,50,8282,10911,16425,0,0,1,0,1
25204,50,8283,11435,16425,0,0,1,0,1
25205,50,8284,11496;11723;15996,16425,1,0,2,0,3
25206,50,8287,11810,16425,0,0,1,0,1
25207,50,8288,12161;12263;16114,16425,1,0,2,0,3
25208,50,8289,11851;12528,16425,0,0,2,0,2
25209,50,8291,11902;16079,16425,1,0,1,0,2
25210,50,8292,11965;12563,16425,0,0,2,0,2
25211,50,8293,11967;12193;15949,16425,1,0,2,0,3
25212,50,8294,12763,16425,0,0,1,0,1
25213,50,8295,12142;12680,16425,0,0,2,0,2
25214,50,8296,11424;11642;16349,16425,1,0,2,0,3
25215,50,8297,12610,16425,0,0,1,0,1
25216,50,8298,11861;12234;16185;16386,16425,2,0,2,0,4
25217,50,8299,12229;12743,16425,0,0,2,0,2
25218,50,8300,12286;16428,16425,1,0,1,0,2
25219,50,8301,11908;12291;16191;16495,16425,2,0,2,0,4
25220,50,8302,12331,16425,0,0,1,0,1
25221,50,8303,12355;12736,16425,0,0,2,0,2
25222,50,8304,12357;12808;16400,16425,1,0,2,0,3
25223,50,8305,12230;12360;16182,16425,1,0,2,0,3
25224,50,8306,12914;16129,16425,1,0,1,0,2
25225,50,8307,12431;12762,16425,0,0,2,0,2
25226,50,8308,12471;12520,16425,0,0,2,0,2
25227,50,8309,12480;12941,16425,0,0,2,0,2
25228,50,8310,12482;12730;15960,16425,1,0,2,0,3
25229,50,8311,12501,16425,0,0,1,0,1
25230,50,8312,12490;12525,16425,0,0,2,0,2
25231,50,8314,13132;16031,16425,1,0,1,0,2
25232,50,8315,12554;12876;15994,16425,1,0,2,0,3
25233,50,8316,12556;12848,16425,0,0,2,0,2
25234,50,8317,12410;12582,16425,0,0,2,0,2
25235,50,8318,12585;13104;16541,16425,1,0,2,0,3
25236,50,8320,12648,16425,0,0,1,0,1
25237,50,8321,12663;12933,16425,0,0,2,0,2
25238,50,8322,12676;13057;16226;16506,16425,2,0,2,0,4
25239,50,8323,12679;13037,16425,0,0,2,0,2
25240,50,8324,12694;13555;15950;16369,16425,2,0,2,0,4
25241,50,8325,12718;13216,16425,0,0,2,0,2
25242,50,8326,12725;12987;16039,16425,1,0,2,0,3
25243,50,8327,12748;13586,16425,0,0,2,0,2
25244,50,8328,12754;12774;16202;16324;16551,16425,3,0,2,0,5
25245,50,8329,12786;13036,16425,0,0,2,0,2
25246,50,8330,12682;12847;16047,16425,1,0,2,0,3
25247,50,8331,12644;12907,16425,0,0,2,0,2
25248,50,8332,12910;12915,16425,0,0,2,0,2
25249,50,8333,12514;12919;16167,16425,1,0,2,0,3
25250,50,8334,12885;12953,16425,0,0,2,0,2
25251,50,8335,13016;13501,16425,0,0,2,0,2
25252,50,8336,13024;13139,16425,0,0,2,0,2
25253,50,8337,13056;13181,16425,0,0,2,0,2
25254,50,8338,13073;13220,16425,0,0,2,0,2
25255,50,8339,13091;13206,16425,0,0,2,0,2
25256,50,8340,12591;13096;16085,16425,1,0,2,0,3
25257,50,8341,12474,16425,0,0,1,0,1
25258,50,8342,12927;13109;16261,16425,1,0,2,0,3
25259,50,8343,12868;13112,16425,0,0,2,0,2
25260,50,8344,13115,16425,0,0,1,0,1
25261,50,8345,13119;13537;15986,16425,1,0,2,0,3
25262,50,8346,13123;13377;16029;16239,16425,2,0,2,0,4
25263,50,8347,13137,16425,0,0,1,0,1
25264,50,8348,13151;13350;16009;16218,16425,2,0,2,0,4
25265,50,8349,12863;13166;16142;16383,16425,2,0,2,0,4
25266,50,8350,13133;13167;16189;16501,16425,2,0,2,0,4
25267,50,8351,13179;13514,16425,0,0,2,0,2
25268,50,8352,13180;13431;16335,16425,1,0,2,0,3
25269,50,8353,12634;13183;16535,16425,1,0,2,0,3
25270,50,8354,13228;13335;15945;16520,16425,2,0,2,0,4
25271,50,8355,13161;13230,16425,0,0,2,0,2
25272,50,8356,405,16790,0,0,1,0,1
25273,50,8357,714,16790,0,0,1,0,1
25274,50,8358,810;9043,16790,0,0,2,0,2
25275,50,8359,5692,16790,0,0,1,0,1
25276,50,8360,3209,16790,0,0,1,0,1
25277,50,8361,5421,16790,0,0,1,0,1
25278,50,8362,4845,16790,0,0,1,0,1
25279,50,8363,5032,16790,0,0,1,0,1
25280,50,8366,6719,16790,0,0,1,0,1
25281,50,8368,7181,16790,0,0,0,1,1
25282,50,8369,8283,16790,0,0,1,0,1
25283,50,8370,9166,16790,0,0,0,1,1
25284,50,8373,10191,16790,0,0,1,0,1
25285,50,8374,10039,16790,0,0,1,0,1
25286,50,8376,878,16790,0,0,1,0,1
25287,50,8377,10342,16790,0,0,1,0,1
25288,50,8379,10475,16790,0,0,1,0,1
25289,50,8382,10169,16790,0,0,1,0,1
25290,50,8383,10460,16790,0,0,1,0,1
25291,50,8386,10886;10976,16790,0,0,2,0,2
25292,50,8387,10376,16790,0,0,1,0,1
25293,50,8389,11287,16790,0,0,1,0,1
25294,50,8391,11513;11681;16170;16211,16790,2,0,2,0,4
25295,50,8393,11858,16790,0,0,1,0,1
25296,50,8394,11984;12033;16481,16790,1,0,2,0,3
25297,50,8395,12051;12144;16160,16790,1,0,2,0,3
25298,50,8397,12054,16790,0,0,1,0,1
25299,50,8398,12090;12602,16790,0,0,2,0,2
25300,50,8400,12152;12772;16195,16790,1,0,2,0,3
25301,50,8402,12165;12675;16119,16790,1,0,2,0,3
25302,50,8403,12209;12967,16790,0,0,2,0,2
25303,50,8404,12251;12278;16175,16790,1,0,2,0,3
25304,50,8405,12301;12918;16309,16790,1,0,2,0,3
25305,50,8406,12317;12797,16790,0,0,2,0,2
25306,50,8407,12406;12687;16235,16790,1,0,2,0,3
25307,50,8408,12440;12909;16110,16790,1,0,2,0,3
25308,50,8409,12374,16790,0,0,1,0,1
25309,50,8410,12488,16790,0,0,1,0,1
25310,50,8411,12857;16328,16790,1,0,1,0,2
25311,50,8412,12566;12895,16790,0,0,2,0,2
25312,50,8413,12581,16790,0,0,1,0,1
25313,50,8414,12269;12620;16319,16790,1,0,2,0,3
25314,50,8415,12713;13165,16790,0,0,2,0,2
25315,50,8416,12266;12627,16790,0,0,2,0,2
25316,50,8417,12577;12628;16437,16790,1,0,2,0,3
25317,50,8418,12908;13042;16245;16311,16790,2,0,2,0,4
25318,50,8419,12632;13103,16790,0,0,2,0,2
25319,50,8420,12641;13409;16215,16790,1,0,2,0,3
25320,50,8421,12645;13510;16270,16790,1,0,2,0,3
25321,50,8422,12646;12850;16507,16790,1,0,2,0,3
25322,50,8423,12681;13299,16790,0,0,2,0,2
25323,50,8424,12685;13223,16790,0,0,2,0,2
25324,50,8425,12665;12692;16154;16350,16790,2,0,2,0,4
25325,50,8426,12163;12252;16314;16502,16790,2,0,2,0,4
25326,50,8427,12710;13318,16790,0,0,2,0,2
25327,50,8428,12714;13423;16300,16790,1,0,2,0,3
25328,50,8429,12654;12726;16116;16493,16790,2,0,2,0,4
25329,50,8430,12753;13209,16790,0,0,2,0,2
25330,50,8431,12761;16192;16454,16790,2,0,1,0,3
25331,50,8432,12158;12277,16790,0,0,2,0,2
25332,50,8433,12304,16790,0,0,1,0,1
25333,50,8434,12793;13083;16197,16790,1,0,2,0,3
25334,50,8435,12439;12827;16412,16790,1,0,2,0,3
25335,50,8436,12312;13031;16180;16517,16790,2,0,2,0,4
25336,50,8437,12783;13035,16790,0,0,2,0,2
25337,50,8438,13039;13619,16790,0,0,2,0,2
25338,50,8439,13055;13535;16254,16790,1,0,2,0,3
25339,50,8440,13062;13194,16790,0,0,2,0,2
25340,50,8441,12666;13064;16203,16790,1,0,2,0,3
25341,50,8442,13066;13316,16790,0,0,2,0,2
25342,50,8443,13080,16790,0,0,1,0,1
25343,50,8444,12849;13292;16139;16537,16790,2,0,2,0,4
25344,50,8445,13106;13610,16790,0,0,2,0,2
25345,50,8446,13111;13272;16227,16790,1,0,2,0,3
25346,50,8447,12429;13159,16790,0,0,2,0,2
25347,50,8448,13160;13527,16790,0,0,2,0,2
25348,50,8449,12550;13163,16790,0,0,2,0,2
25349,50,8450,13172;13416;16198;16558,16790,2,0,2,0,4
25350,50,8451,13127;13189;16163,16790,1,0,2,0,3
25351,50,8452,13198;13240;16462,16790,1,0,2,0,3
25352,50,8453,13239;13617,16790,0,0,2,0,2
25353,50,8454,13222;13254,16790,0,0,2,0,2
25354,50,8455,13275;13577;16255;16436,16790,2,0,2,0,4
25355,50,8456,13092;13314,16790,0,0,2,0,2
25356,50,8457,13300;13473,16790,0,0,2,0,2
25357,50,8458,13306;13361;16148,16790,1,0,2,0,3
25358,50,8459,13018;13310,16790,0,0,2,0,2
25359,50,8460,13320;13536,16790,0,0,2,0,2
25360,50,8461,12998;13323,16790,0,0,2,0,2
25361,50,8462,13344;13439;16108;16351,16790,2,0,2,0,4
25362,50,8463,13349;13604,16790,0,0,2,0,2
25363,50,8464,13356;13533;16204;16361;16439,16790,3,0,2,0,5
25364,50,8466,316,17155,0,0,1,0,1
25365,50,8467,81,17155,0,0,1,0,1
25366,50,8468,6465,17155,0,0,1,0,1
25367,50,8469,1287,17155,0,0,1,0,1
25368,50,8471,1670,17155,0,0,1,0,1
25369,50,8472,5318,17155,0,0,1,0,1
25370,50,8473,1104;6838,17155,0,0,2,0,2
25371,50,8474,5175,17155,0,0,1,0,1
25372,50,8475,4476;6990,17155,0,0,2,0,2
25373,50,8476,6764,17155,0,0,0,1,1
25374,50,8477,7912,17155,0,0,1,0,1
25375,50,8478,3266,17155,0,0,1,0,1
25376,50,8480,9189,17155,0,0,1,0,1
25377,50,8481,7530,17155,0,0,1,0,1
25378,50,8483,10017,17155,0,0,1,0,1
25379,50,8486,10375,17155,0,0,1,0,1
25380,50,8488,10544,17155,0,0,1,0,1
25381,50,8489,10573,17155,0,0,1,0,1
25382,50,8492,10743,17155,0,0,1,0,1
25383,50,8493,10926,17155,0,0,1,0,1
25384,50,8494,11139,17155,0,0,1,0,1
25385,50,8496,11101,17155,0,0,1,0,1
25386,50,8497,11208,17155,0,0,1,0,1
25387,50,8498,11238,17155,0,0,1,0,1
25388,50,8501,11220,17155,0,0,1,0,1
25389,50,8503,11548;11872,17155,0,0,2,0,2
25390,50,8504,11168,17155,0,0,1,0,1
25391,50,8505,11799;11874;16272;16329,17155,2,0,2,0,4
25392,50,8506,11808,17155,0,0,1,0,1
25393,50,8507,11809;12141;16434,17155,1,0,2,0,3
25394,50,8509,11828,17155,0,0,1,0,1
25395,50,8510,11451,17155,0,0,1,0,1
25396,50,8511,11909;12080;16382,17155,1,0,2,0,3
25397,50,8512,11826;12261;16552,17155,1,0,2,0,3
25398,50,8514,11840;11936;16466,17155,1,0,2,0,3
25399,50,8515,12574;16377;16497,17155,2,0,1,0,3
25400,50,8516,12522,17155,0,0,1,0,1
25401,50,8517,12504,17155,0,0,1,0,1
25402,50,8518,12612;16186,17155,1,0,1,0,2
25403,50,8519,12542;12719,17155,0,0,2,0,2
25404,50,8520,12206;12615,17155,0,0,2,0,2
25405,50,8521,12544;12630;16458,17155,1,0,2,0,3
25406,50,8522,12633;13202,17155,0,0,2,0,2
25407,50,8523,12672;13142,17155,0,0,2,0,2
25408,50,8524,12683;13363,17155,0,0,2,0,2
25409,50,8525,12289;12693;16404,17155,1,0,2,0,3
25410,50,8526,12703;12963,17155,0,0,2,0,2
25411,50,8527,12534;12738,17155,0,0,2,0,2
25412,50,8528,12524,17155,0,0,1,0,1
25413,50,8529,13192;13370,17155,0,0,2,0,2
25414,50,8530,12707;12819;16518,17155,1,0,2,0,3
25415,50,8531,12806;12840,17155,0,0,2,0,2
25416,50,8532,12873;13500,17155,0,0,2,0,2
25417,50,8533,12874;13397,17155,0,0,2,0,2
25418,50,8534,12913;13467;16187,17155,1,0,2,0,3
25419,50,8535,12867;12924,17155,0,0,2,0,2
25420,50,8536,12948;13147,17155,0,0,2,0,2
25421,50,8537,12961;13434,17155,0,0,2,0,2
25422,50,8538,12988;13197;16344,17155,1,0,2,0,3
25423,50,8539,13019;13540;16356,17155,1,0,2,0,3
25424,50,8540,13067;13475,17155,0,0,2,0,2
25425,50,8541,12853;13068,17155,0,0,2,0,2
25426,50,8542,12813;13079,17155,0,0,2,0,2
25427,50,8543,12771;12834,17155,0,0,2,0,2
25428,50,8544,13124;13175;16511,17155,1,0,2,0,3
25429,50,8545,12972;13126,17155,0,0,2,0,2
25430,50,8546,13011;13131;16205,17155,1,0,2,0,3
25431,50,8547,12920;13134;16366,17155,1,0,2,0,3
25432,50,8548,12670;13138,17155,0,0,2,0,2
25433,50,8549,13141;16219,17155,1,0,1,0,2
25434,50,8550,12826;13150,17155,0,0,2,0,2
25435,50,8551,13237;16220;16298,17155,2,0,1,0,3
25436,50,8552,12905;13178;16514,17155,1,0,2,0,3
25437,50,8553,13009;13200,17155,0,0,2,0,2
25438,50,8554,13210;13449,17155,0,0,2,0,2
25439,50,8555,12959;13221,17155,0,0,2,0,2
25440,50,8556,13227;13860;16246;16371;16532,17155,3,0,2,0,5
25441,50,8557,12729;13087,17155,0,0,2,0,2
25442,50,8558,13162,17155,0,0,1,0,1
25443,50,8559,13248;13324,17155,0,0,2,0,2
25444,50,8560,13188;13249,17155,0,0,2,0,2
25445,50,8561,13264;13307,17155,0,0,2,0,2
25446,50,8562,13289;13345,17155,0,0,2,0,2
25447,50,8563,13594,17155,0,0,1,0,1
25448,50,8564,12968;13291,17155,0,0,2,0,2
25449,50,8565,13308;13388,17155,0,0,2,0,2
25450,50,8566,13331;13624,17155,0,0,2,0,2
25451,50,8567,12809;13238,17155,0,0,2,0,2
25452,50,8568,13384,17155,0,0,1,0,1
25453,50,8569,12880;13389,17155,0,0,2,0,2
25454,50,8570,13392,17155,0,0,1,0,1
25455,50,8571,13401;13492,17155,0,0,2,0,2
25456,50,8572,13404;13779;16243,17155,1,0,2,0,3
25457,50,8573,13301;13436;16449,17155,1,0,2,0,3
25458,50,8574,13445;13710,17155,0,0,2,0,2
25459,50,8575,13450;13745,17155,0,0,2,0,2
25460,50,8576,13469;13581,17155,0,0,2,0,2
25461,50,8577,13471;13909;16380,17155,1,0,2,0,3
25462,50,8578,13390;13493,17155,0,0,2,0,2
25463,50,8579,13505;13782;16188;16379,17155,2,0,2,0,4
25464,50,8580,9042,17520,0,0,1,0,1
25465,50,8581,5590,17520,0,0,1,0,1
25466,50,8582,5698,17520,0,0,1,0,1
25467,50,8584,7712,17520,0,0,1,0,1
25468,50,8585,9339,17520,0,0,1,0,1
25469,50,8586,2774,17520,0,0,1,0,1
25470,50,8587,7396,17520,0,0,1,0,1
25471,50,8588,160,17520,0,0,1,0,1
25472,50,8589,793,17520,0,0,1,0,1
25473,50,8590,5890,17520,0,0,1,0,1
25474,50,8591,10207;10480,17520,0,0,2,0,2
25475,50,8592,10224,17520,0,0,1,0,1
25476,50,8593,1747,17520,0,0,1,0,1
25477,50,8595,10289,17520,0,0,1,0,1
25478,50,8597,10331,17520,0,0,1,0,1
25479,50,8598,10393,17520,0,0,1,0,1
25480,50,8600,10507,17520,0,0,1,0,1
25481,50,8603,10473,17520,0,0,1,0,1
25482,50,8604,10751,17520,0,0,1,0,1
25483,50,8606,10925,17520,0,0,1,0,1
25484,50,8607,10786;11052;16294,17520,1,0,2,0,3
25485,50,8609,11102,17520,0,0,1,0,1
25486,50,8610,11123,17520,0,0,1,0,1
25487,50,8612,11161,17520,0,0,1,0,1
25488,50,8613,11316,17520,0,0,1,0,1
25489,50,8614,11396,17520,0,0,1,0,1
25490,50,8618,11701,17520,0,0,1,0,1
25491,50,8620,11835,17520,0,0,1,0,1
25492,50,8621,11733;11852;16312,17520,1,0,2,0,3
25493,50,8622,11915,17520,0,0,1,0,1
25494,50,8623,11948;12356;16359,17520,1,0,2,0,3
25495,50,8624,12136;12200,17520,0,0,2,0,2
25496,50,8625,12045;12180;16392,17520,1,0,2,0,3
25497,50,8626,12330;12828,17520,0,0,2,0,2
25498,50,8627,12380,17520,0,0,1,0,1
25499,50,8628,12436;12453;16544,17520,1,0,2,0,3
25500,50,8629,12457;12473;16315,17520,1,0,2,0,3
25501,50,8630,12182;12475,17520,0,0,2,0,2
25502,50,8631,12275;12502;16417,17520,1,0,2,0,3
25503,50,8632,12519,17520,0,0,1,0,1
25504,50,8633,12521,17520,0,0,1,0,1
25505,50,8634,12395,17520,0,0,1,0,1
25506,50,8635,12601;13033;16527,17520,1,0,2,0,3
25507,50,8636,12608;13422;16513,17520,1,0,2,0,3
25508,50,8637,12724;12767,17520,0,0,2,0,2
25509,50,8638,12734;12852;16555,17520,1,0,2,0,3
25510,50,8639,12423;12796,17520,0,0,2,0,2
25511,50,8640,12818;12996,17520,0,0,2,0,2
25512,50,8641,12268,17520,0,0,1,0,1
25513,50,8642,12769;12856,17520,0,0,2,0,2
25514,50,8643,12805;12862,17520,0,0,2,0,2
25515,50,8644,12958;13802,17520,0,0,2,0,2
25516,50,8645,12841;12977,17520,0,0,2,0,2
25517,50,8646,12995;13278,17520,0,0,2,0,2
25518,50,8647,13040;13523,17520,0,0,2,0,2
25519,50,8648,12799;13084;16307,17520,1,0,2,0,3
25520,50,8649,13100;13148;16354,17520,1,0,2,0,3
25521,50,8650,13155;13562;16409,17520,1,0,2,0,3
25522,50,8651,12893;13158,17520,0,0,2,0,2
25523,50,8652,13169;13459,17520,0,0,2,0,2
25524,50,8653,13199;16410,17520,1,0,1,0,2
25525,50,8654,13233;13378,17520,0,0,2,0,2
25526,50,8655,13098;13259;16447,17520,1,0,2,0,3
25527,50,8656,13603,17520,0,0,1,0,1
25528,50,8657,13027;13277,17520,0,0,2,0,2
25529,50,8658,12886;13294,17520,0,0,2,0,2
25530,50,8659,13311;13676,17520,0,0,2,0,2
25531,50,8660,14055;16476,17520,1,0,1,0,2
25532,50,8661,13334;13919;16333,17520,1,0,2,0,3
25533,50,8662,12877;13341,17520,0,0,2,0,2
25534,50,8663,12859;13367,17520,0,0,2,0,2
25535,50,8664,13371;13975;16390,17520,1,0,2,0,3
25536,50,8665,13372,17520,0,0,1,0,1
25537,50,8666,13380,17520,0,0,1,0,1
25538,50,8667,12606,17520,0,0,1,0,1
25539,50,8668,13396;14025,17520,0,0,2,0,2
25540,50,8669,13400;13635,17520,0,0,2,0,2
25541,50,8670,13411;13794,17520,0,0,2,0,2
25542,50,8671,13418;13952;16473,17520,1,0,2,0,3
25543,50,8672,13468;13476,17520,0,0,2,0,2
25544,50,8673,13010;13496,17520,0,0,2,0,2
25545,50,8674,13427;13502,17520,0,0,2,0,2
25546,50,8675,13201;13511,17520,0,0,2,0,2
25547,50,8676,13526;13738,17520,0,0,2,0,2
25548,50,8677,12861;13543;16538,17520,1,0,2,0,3
25549,50,8678,13550;13559,17520,0,0,2,0,2
25550,50,8679,13553;13762,17520,0,0,2,0,2
25551,50,8680,13554;13684,17520,0,0,2,0,2
25552,50,8681,13466;13567,17520,0,0,2,0,2
25553,50,8682,13252;13568;16414,17520,1,0,2,0,3
25554,50,8683,13580;13740,17520,0,0,2,0,2
25555,50,8684,13583;13821;16504,17520,1,0,2,0,3
25556,50,8685,13607;13805,17520,0,0,2,0,2
25557,50,8686,13627;13934;16431,17520,1,0,2,0,3
25558,50,8687,13640;13680,17520,0,0,2,0,2
25559,50,8688,13644;13792,17520,0,0,2,0,2
25560,50,8689,13664;13689,17520,0,0,2,0,2
25561,50,8690,13666;13801,17520,0,0,2,0,2
25562,50,8691,7856,17885,0,0,1,0,1
25563,50,8692,8297,17885,0,0,1,0,1
25564,50,8693,7445,17885,0,0,1,0,1
25565,50,8694,4771,17885,0,0,1,0,1
25566,50,8695,6071;7785,17885,0,0,2,0,2
25567,50,8696,9316,17885,0,0,1,0,1
25568,50,8697,4689,17885,0,0,1,0,1
25569,50,8699,5572,17885,0,0,1,0,1
25570,50,8700,5901,17885,0,0,1,0,1
25571,50,8701,2700,17885,0,0,0,1,1
25572,50,8702,175;1027,17885,0,0,2,0,2
25573,50,8704,3730,17885,0,0,1,0,1
25574,50,8705,958,17885,0,0,1,0,1
25575,50,8706,3247,17885,0,0,1,0,1
25576,50,8709,10478,17885,0,0,1,0,1
25577,50,8710,10688;11045,17885,0,0,2,0,2
25578,50,8711,11106,17885,0,0,1,0,1
25579,50,8714,11219,17885,0,0,1,0,1
25580,50,8715,11319,17885,0,0,1,0,1
25581,50,8717,11401,17885,0,0,1,0,1
25582,50,8718,11624,17885,0,0,1,0,1
25583,50,8719,11592;11682;16456,17885,1,0,2,0,3
25584,50,8720,11399,17885,0,0,1,0,1
25585,50,8721,11658,17885,0,0,1,0,1
25586,50,8722,11763,17885,0,0,1,0,1
25587,50,8723,11890,17885,0,0,1,0,1
25588,50,8724,11529,17885,0,0,1,0,1
25589,50,8725,11662,17885,0,0,1,0,1
25590,50,8726,11978;12760,17885,0,0,2,0,2
25591,50,8727,11760;12066;16546,17885,1,0,2,0,3
25592,50,8728,12079;12145,17885,0,0,2,0,2
25593,50,8729,12138;12722,17885,0,0,2,0,2
25594,50,8730,12151;13108,17885,0,0,2,0,2
25595,50,8731,12192,17885,0,0,1,0,1
25596,50,8732,11864,17885,0,0,1,0,1
25597,50,8733,12085,17885,0,0,1,0,1
25598,50,8734,12270,17885,0,0,1,0,1
25599,50,8735,12236,17885,0,0,1,0,1
25600,50,8736,11736,17885,0,0,1,0,1
25601,50,8737,12464;12934,17885,0,0,2,0,2
25602,50,8738,12307;12479;16440,17885,1,0,2,0,3
25603,50,8739,12491;13472,17885,0,0,2,0,2
25604,50,8740,12503,17885,0,0,1,0,1
25605,50,8741,12543;12930;16512,17885,1,0,2,0,3
25606,50,8742,12545;12662,17885,0,0,2,0,2
25607,50,8743,11885,17885,0,0,1,0,1
25608,50,8744,12155;12649,17885,0,0,2,0,2
25609,50,8745,12515,17885,0,0,1,0,1
25610,50,8746,12056,17885,0,0,1,0,1
25611,50,8747,12494;12768;16485,17885,1,0,2,0,3
25612,50,8748,12795;13403,17885,0,0,2,0,2
25613,50,8749,12407;12814,17885,0,0,2,0,2
25614,50,8750,12696;12851,17885,0,0,2,0,2
25615,50,8751,12901;13149,17885,0,0,2,0,2
25616,50,8752,12952;13280,17885,0,0,2,0,2
25617,50,8753,12971;13503,17885,0,0,2,0,2
25618,50,8754,12992;13408,17885,0,0,2,0,2
25619,50,8755,13034,17885,0,0,1,0,1
25620,50,8756,12792;13047,17885,0,0,2,0,2
25621,50,8757,13053;13185;16446,17885,1,0,2,0,3
25622,50,8758,12539,17885,0,0,1,0,1
25623,50,8759,13186;13236,17885,0,0,2,0,2
25624,50,8760,13214;13305,17885,0,0,2,0,2
25625,50,8761,13219;13544,17885,0,0,2,0,2
25626,50,8762,13405;13657,17885,0,0,2,0,2
25627,50,8763,13130;13421;16523,17885,1,0,2,0,3
25628,50,8764,13217;13429,17885,0,0,2,0,2
25629,50,8765,13435;13519,17885,0,0,2,0,2
25630,50,8766,13224;13442,17885,0,0,2,0,2
25631,50,8767,13447;13893;16480,17885,1,0,2,0,3
25632,50,8768,13507,17885,0,0,1,0,1
25633,50,8769,12807;13461,17885,0,0,2,0,2
25634,50,8770,13463;13481,17885,0,0,2,0,2
25635,50,8771,13479;13891,17885,0,0,2,0,2
25636,50,8772,12557;13485,17885,0,0,2,0,2
25637,50,8773,14142,17885,0,0,1,0,1
25638,50,8774,13518;13902,17885,0,0,2,0,2
25639,50,8775,13539;14143;16522,17885,1,0,2,0,3
25640,50,8776,12888;13560,17885,0,0,2,0,2
25641,50,8777,13375;13570,17885,0,0,2,0,2
25642,50,8778,12842;13584,17885,0,0,2,0,2
25643,50,8779,13764;13955,17885,0,0,2,0,2
25644,50,8780,13651;13701,17885,0,0,2,0,2
25645,50,8781,13654,17885,0,0,1,0,1
25646,50,8782,13592;13658,17885,0,0,2,0,2
25647,50,8783,13803,17885,0,0,1,0,1
25648,50,8784,13683;13970,17885,0,0,2,0,2
25649,50,8785,13686;14165,17885,0,0,2,0,2
25650,50,8786,14183,17885,0,0,1,0,1
25651,50,8787,13714;14112,17885,0,0,2,0,2
25652,50,8788,13716;13863,17885,0,0,2,0,2
25653,50,8789,13720;13826,17885,0,0,2,0,2
25654,50,8790,13286;13721,17885,0,0,2,0,2
25655,50,8791,13752;14052,17885,0,0,2,0,2
25656,50,8792,13608;13767,17885,0,0,2,0,2
25657,50,8793,13777,17885,0,0,1,0,1
25658,50,8794,13797;13871,17885,0,0,2,0,2
25659,50,8795,1565,18250,0,0,1,0,1
25660,50,8797,3478,18250,0,0,1,0,1
25661,50,8799,2009,18250,0,0,1,0,1
25662,50,8800,4515,18250,0,0,1,0,1
25663,50,8801,6261,18250,0,0,1,0,1
25664,50,8802,4868,18250,0,0,1,0,1
25665,50,8803,6159,18250,0,0,1,0,1
25666,50,8804,379,18250,0,0,1,0,1
25667,50,8805,1056,18250,0,0,1,0,1
25668,50,8806,8473,18250,0,0,1,0,1
25669,50,8807,1328,18250,0,0,1,0,1
25670,50,8808,8721,18250,0,0,1,0,1
25671,50,8809,10047,18250,0,0,1,0,1
25672,50,8810,10137,18250,0,0,1,0,1
25673,50,8811,10123,18250,0,0,1,0,1
25674,50,8812,10102,18250,0,0,1,0,1
25675,50,8813,10007,18250,0,0,1,0,1
25676,50,8814,10349,18250,0,0,1,0,1
25677,50,8815,10541,18250,0,0,1,0,1
25678,50,8816,10397,18250,0,0,1,0,1
25679,50,8817,10772,18250,0,0,1,0,1
25680,50,8819,10869,18250,0,0,1,0,1
25681,50,8821,10514,18250,0,0,1,0,1
25682,50,8822,11066;11796,18250,0,0,2,0,2
25683,50,8823,11182,18250,0,0,1,0,1
25684,50,8824,11505,18250,0,0,1,0,1
25685,50,8825,11519,18250,0,0,1,0,1
25686,50,8826,11613;11619,18250,0,0,2,0,2
25687,50,8827,11655;11920,18250,0,0,2,0,2
25688,50,8828,11714,18250,0,0,1,0,1
25689,50,8829,11802,18250,0,0,1,0,1
25690,50,8830,11637;11973,18250,0,0,2,0,2
25691,50,8831,11995,18250,0,0,1,0,1
25692,50,8832,11716,18250,0,0,1,0,1
25693,50,8833,12117,18250,0,0,1,0,1
25694,50,8834,11626,18250,0,0,1,0,1
25695,50,8835,12375;13008,18250,0,0,2,0,2
25696,50,8836,12385;13077,18250,0,0,2,0,2
25697,50,8837,12394;13085,18250,0,0,2,0,2
25698,50,8838,12397;12411,18250,0,0,2,0,2
25699,50,8839,12498,18250,0,0,1,0,1
25700,50,8840,12103;12617,18250,0,0,2,0,2
25701,50,8841,12618,18250,0,0,1,0,1
25702,50,8842,12112;12656,18250,0,0,2,0,2
25703,50,8843,12657,18250,0,0,1,0,1
25704,50,8844,12238,18250,0,0,1,0,1
25705,50,8845,12720;13157,18250,0,0,2,0,2
25706,50,8846,12164;12742,18250,0,0,2,0,2
25707,50,8847,12779;13478,18250,0,0,2,0,2
25708,50,8848,12811,18250,0,0,1,0,1
25709,50,8849,12944;13385,18250,0,0,2,0,2
25710,50,8850,12955;13187,18250,0,0,2,0,2
25711,50,8851,12965;13154,18250,0,0,2,0,2
25712,50,8852,12985;13838,18250,0,0,2,0,2
25713,50,8853,13038;13153,18250,0,0,2,0,2
25714,50,8854,13054,18250,0,0,1,0,1
25715,50,8855,13060;13929,18250,0,0,2,0,2
25716,50,8856,12866,18250,0,0,1,0,1
25717,50,8857,13129;13242,18250,0,0,2,0,2
25718,50,8858,12354,18250,0,0,1,0,1
25719,50,8859,13256;13695,18250,0,0,2,0,2
25720,50,8860,13174;13271,18250,0,0,2,0,2
25721,50,8861,13279;13515,18250,0,0,2,0,2
25722,50,8862,13288;13670,18250,0,0,2,0,2
25723,50,8863,13315,18250,0,0,1,0,1
25724,50,8864,13321;13688,18250,0,0,2,0,2
25725,50,8865,13330,18250,0,0,1,0,1
25726,50,8866,13351,18250,0,0,1,0,1
25727,50,8867,13398;14150,18250,0,0,2,0,2
25728,50,8868,13489,18250,0,0,1,0,1
25729,50,8869,13455,18250,0,0,1,0,1
25730,50,8870,13509;13590,18250,0,0,2,0,2
25731,50,8871,13512;14064,18250,0,0,2,0,2
25732,50,8872,13407;13541,18250,0,0,2,0,2
25733,50,8873,13558;13698,18250,0,0,2,0,2
25734,50,8874,13339;13561,18250,0,0,2,0,2
25735,50,8875,13364;13573,18250,0,0,2,0,2
25736,50,8876,13579;13761,18250,0,0,2,0,2
25737,50,8877,13593;13748,18250,0,0,2,0,2
25738,50,8878,13290,18250,0,0,1,0,1
25739,50,8879,13597;14047,18250,0,0,2,0,2
25740,50,8880,13260,18250,0,0,1,0,1
25741,50,8881,13620;13757,18250,0,0,2,0,2
25742,50,8882,13628;13889,18250,0,0,2,0,2
25743,50,8883,13631;13935,18250,0,0,2,0,2
25744,50,8884,13643;14017,18250,0,0,2,0,2
25745,50,8885,13646,18250,0,0,1,0,1
25746,50,8886,13652;14190,18250,0,0,2,0,2
25747,50,8887,13659;13834,18250,0,0,2,0,2
25748,50,8888,13662,18250,0,0,1,0,1
25749,50,8889,13678;13755,18250,0,0,2,0,2
25750,50,8890,13699,18250,0,0,1,0,1
25751,50,8891,13709;14121,18250,0,0,2,0,2
25752,50,8892,13265;13712,18250,0,0,2,0,2
25753,50,8893,13578;13728,18250,0,0,2,0,2
25754,50,8894,13729;14071,18250,0,0,2,0,2
25755,50,8895,13736,18250,0,0,1,0,1
25756,50,8896,13369;13760,18250,0,0,2,0,2
25757,50,8897,13733;13773,18250,0,0,2,0,2
25758,50,8898,13813;14093,18250,0,0,2,0,2
25759,50,8899,13877;13996,18250,0,0,2,0,2
25760,50,8900,13881;14299,18250,0,1,1,0,2
25761,50,8901,13888,18250,0,0,1,0,1
25762,50,8902,13892;14019,18250,0,0,2,0,2
25763,50,8903,13681;13895,18250,0,0,2,0,2
25764,50,8904,13900;14189,18250,0,0,2,0,2
25765,50,8905,13915;13971,18250,0,0,2,0,2
25766,50,8906,13879;13941,18250,0,0,2,0,2
25767,50,8907,13004;13946,18250,0,0,2,0,2
25768,50,8908,13625;13950,18250,0,0,2,0,2
25769,60,1,4;3259,0,0,0,0,2,2
25770,60,4,4056,0,0,0,0,1,1
25771,60,25,9208,0,0,0,0,1,1
25772,60,28,90;1720;4946;6299;13751;14883,0,0,0,3,3,6
25773,60,36,9316,0,0,0,0,1,1
25774,60,38,117,0,0,0,0,1,1
25775,60,45,8194;8867,0,0,0,0,2,2
25776,60,71,210,0,0,0,0,1,1
25777,60,92,264,0,0,0,0,1,1
25778,60,93,10284;15651,0,0,0,2,0,2
25779,60,113,321,0,0,0,0,1,1
25780,60,128,354,0,0,0,0,1,1
25781,60,134,1878,0,0,0,0,1,1
25782,60,144,396,0,0,0,0,1,1
25783,60,167,452,0,0,0,0,1,1
25784,60,169,5506,0,0,0,0,1,1
25785,60,179,493,0,0,0,1,0,1
25786,60,183,500;7164,0,0,0,0,2,2
25787,60,184,502,0,0,0,0,1,1
25788,60,203,3382;3813,0,0,0,0,2,2
25789,60,227,613;1307;13850,0,0,0,3,0,3
25790,60,233,624,0,0,0,0,1,1
25791,60,235,629,0,0,0,0,1,1
25792,60,240,644,0,0,0,0,1,1
25793,60,257,688;4589,0,0,0,0,2,2
25794,60,274,722,0,0,0,0,1,1
25795,60,283,745,0,0,0,0,1,1
25796,60,288,756,0,0,0,0,1,1
25797,60,291,6147,0,0,0,0,1,1
25798,60,297,1545;7780,0,0,0,2,0,2
25799,60,301,787,0,0,0,0,1,1
25800,60,304,1537;9923;14436,0,0,0,2,1,3
25801,60,332,869,0,0,0,0,1,1
25802,60,340,893,0,0,0,0,1,1
25803,60,350,921;4285;7150,0,0,0,0,3,3
25804,60,357,939,0,0,0,0,1,1
25805,60,365,965,0,0,0,0,1,1
25806,60,369,3976;3977,0,0,0,0,2,2
25807,60,370,989,0,0,0,0,1,1
25808,60,382,6783,0,0,0,0,1,1
25809,60,393,7724;7890;9722;10077,0,0,0,3,1,4
25810,60,410,1082,0,0,0,0,1,1
25811,60,411,1083,0,0,0,0,1,1
25812,60,415,1092,0,0,0,0,1,1
25813,60,420,1106,0,0,0,0,1,1
25814,60,430,243,0,0,0,0,1,1
25815,60,440,1164;7440,0,0,0,2,0,2
25816,60,448,8904,0,0,0,0,1,1
25817,60,456,1198;7627,0,0,0,0,2,2
25818,60,478,1260;3503,0,0,0,1,1,2
25819,60,487,8781,0,0,0,0,1,1
25820,60,491,1296;8317,0,0,0,0,2,2
25821,60,509,1345;8109;14170,0,0,0,2,1,3
25822,60,519,1375;5704,0,0,0,0,2,2
25823,60,522,1382;10019;14772,0,0,0,2,1,3
25824,60,553,7690,0,0,0,0,1,1
25825,60,556,1461;10121;10343;13997;14335,0,0,0,5,0,5
25826,60,560,1469,0,0,0,0,1,1
25827,60,561,1473;5771,0,0,0,0,2,2
25828,60,562,1475,0,0,0,0,1,1
25829,60,571,1502,0,0,0,0,1,1
25830,60,573,1506;4815,0,0,0,0,2,2
25831,60,590,10064,0,0,0,1,0,1
25832,60,592,1558;2978,0,0,0,0,2,2
25833,60,593,1560,0,0,0,0,1,1
25834,60,598,1577;13366,0,0,0,1,1,2
25835,60,607,8801,0,0,0,0,1,1
25836,60,611,1605,0,0,0,0,1,1
25837,60,615,1620,0,0,0,0,1,1
25838,60,619,1632,0,0,0,0,1,1
25839,60,620,1633,0,0,0,0,1,1
25840,60,624,1643;4764,0,0,0,0,2,2
25841,60,641,1694,0,0,0,0,1,1
25842,60,648,1715;1776,0,0,0,0,2,2
25843,60,661,1756;3842,0,0,0,1,1,2
25844,60,667,1771;7499;14470,0,0,0,1,2,3
25845,60,684,1812,0,0,0,0,1,1
25846,60,702,1853,0,0,0,0,1,1
25847,60,709,1868,0,0,0,0,1,1
25848,60,716,879,0,0,0,0,1,1
25849,60,720,1891,0,0,0,0,1,1
25850,60,728,1914,0,0,0,0,1,1
25851,60,733,1924,0,0,0,0,1,1
25852,60,735,3137,0,0,0,0,1,1
25853,60,736,8154,0,0,0,0,1,1
25854,60,738,5001,0,0,0,0,1,1
25855,60,750,1965,0,0,0,0,1,1
25856,60,752,1970,0,0,0,0,1,1
25857,60,759,1993,0,0,0,0,1,1
25858,60,767,2005,0,0,0,0,1,1
25859,60,768,7829,0,0,0,0,1,1
25860,60,786,8886;13827,0,0,0,2,0,2
25861,60,805,5779,0,0,0,0,1,1
25862,60,813,2123;5743,0,0,0,2,0,2
25863,60,829,1023,0,0,0,0,1,1
25864,60,833,2173,0,0,0,0,1,1
25865,60,857,2238,0,0,0,0,1,1
25866,60,866,2271,0,0,0,1,0,1
25867,60,873,2287,0,0,0,0,1,1
25868,60,878,2303;2805,0,0,0,0,2,2
25869,60,886,2321;2323;5365;6823,0,0,0,1,3,4
25870,60,902,3814,0,0,0,0,1,1
25871,60,919,2418;4793;14617,0,0,0,1,2,3
25872,60,940,2471,0,0,0,0,1,1
25873,60,951,9585,0,0,0,0,1,1
25874,60,967,2550,0,0,0,0,1,1
25875,60,972,2564,0,0,0,0,1,1
25876,60,974,2567,0,0,0,0,1,1
25877,60,978,80,0,0,0,0,1,1
25878,60,990,8649,0,0,0,0,1,1
25879,60,991,12508;16496,0,0,1,1,0,2
25880,60,998,2706,0,0,0,0,1,1
25881,60,1001,2630,0,0,0,0,1,1
25882,60,1010,2648;9406,0,0,0,0,2,2
25883,60,1013,3740,0,0,0,0,1,1
25884,60,1045,2738;13327,0,0,0,2,0,2
25885,60,1062,6561;7177,0,0,0,2,0,2
25886,60,1063,2786;4625,0,0,0,0,2,2
25887,60,1069,2806,0,0,0,0,1,1
25888,60,1074,2823;6873,0,0,0,0,2,2
25889,60,1093,6343,0,0,0,0,1,1
25890,60,1098,1719,0,0,0,0,1,1
25891,60,1111,2915,0,0,0,0,1,1
25892,60,1121,2937,0,0,0,0,1,1
25893,60,1129,2958,0,0,0,0,1,1
25894,60,1133,8338,0,0,0,0,1,1
25895,60,1156,9819,0,0,0,0,1,1
25896,60,1168,10773;10804;11050;11210;11426;11779;14653;14795;15180;15328;15947,0,0,1,10,0,11
25897,60,1170,3080;8211,0,0,0,0,2,2
25898,60,1180,3105,0,0,0,0,1,1
25899,60,1185,6447,0,0,0,0,1,1
25900,60,1191,3141;8721,0,0,0,2,0,2
25901,60,1205,3174,0,0,0,0,1,1
25902,60,1209,357;12928,0,0,0,1,1,2
25903,60,1229,3249,0,0,0,0,1,1
25904,60,1234,1769,0,0,0,0,1,1
25905,60,1258,3901,0,0,0,1,0,1
25906,60,1269,3807,0,0,0,0,1,1
25907,60,1275,3356;8526,0,0,0,1,1,2
25908,60,1282,3373,0,0,0,0,1,1
25909,60,1283,3378,0,0,0,0,1,1
25910,60,1285,3386;6955,0,0,0,1,1,2
25911,60,1292,672;3411,0,0,0,0,2,2
25912,60,1306,3448,0,0,0,0,1,1
25913,60,1315,3474,0,0,0,0,1,1
25914,60,1332,3514,0,0,0,0,1,1
25915,60,1337,3526,0,0,0,0,1,1
25916,60,1339,3534,0,0,0,0,1,1
25917,60,1371,3619,0,0,0,0,1,1
25918,60,1375,3627;10685,0,0,0,1,1,2
25919,60,1403,959,0,0,0,0,1,1
25920,60,1417,4871,0,0,0,0,1,1
25921,60,1421,3753;7993,0,0,0,0,2,2
25922,60,1427,616;3767,0,0,0,0,2,2
25923,60,1452,3828,0,0,0,0,1,1
25924,60,1457,3845,0,0,0,0,1,1
25925,60,1458,3848,0,0,0,0,1,1
25926,60,1468,3880,0,0,0,0,1,1
25927,60,1501,3966,0,0,0,0,1,1
25928,60,1508,3983,0,0,0,0,1,1
25929,60,1540,279;4064,0,0,0,0,2,2
25930,60,1541,4066,0,0,0,0,1,1
25931,60,1550,4088,0,0,0,0,1,1
25932,60,1551,4091;9750;13937;14350,0,0,0,2,2,4
25933,60,1577,4150;4151;5311;7316;12950,0,0,0,5,0,5
25934,60,1579,4153,0,0,0,0,1,1
25935,60,1583,4161,0,0,0,0,1,1
25936,60,1584,1376,0,0,0,0,1,1
25937,60,1587,4172,0,0,0,0,1,1
25938,60,1588,4175,0,0,0,0,1,1
25939,60,1601,4205;9103,0,0,0,0,2,2
25940,60,1627,4220;4268;6845;13448,0,0,0,1,3,4
25941,60,1633,401,0,0,0,0,1,1
25942,60,1634,4295;14537,0,0,0,2,0,2
25943,60,1636,4298,0,0,0,0,1,1
25944,60,1644,9995,0,0,0,0,1,1
25945,60,1658,4344,0,0,0,0,1,1
25946,60,1679,9867,0,0,0,0,1,1
25947,60,1713,4472,0,0,0,0,1,1
25948,60,1719,2917;4494,0,0,0,0,2,2
25949,60,1723,890,0,0,0,0,1,1
25950,60,1725,1478;4516,0,0,0,1,1,2
25951,60,1729,4524;5600,0,0,0,0,2,2
25952,60,1777,4653,0,0,0,0,1,1
25953,60,1784,4669,0,0,0,1,0,1
25954,60,1796,1049,0,0,0,1,0,1
25955,60,1805,3921;4722,0,0,0,0,2,2
25956,60,1824,4775,0,0,0,0,1,1
25957,60,1825,4776,0,0,0,0,1,1
25958,60,1827,4780,0,0,0,0,1,1
25959,60,1862,4870,0,0,0,0,1,1
25960,60,1872,4899,0,0,0,0,1,1
25961,60,1878,4910,0,0,0,0,1,1
25962,60,1889,4945;14670,0,0,0,1,1,2
25963,60,1898,4975,0,0,0,0,1,1
25964,60,1901,4983,0,0,0,0,1,1
25965,60,1906,4991,0,0,0,0,1,1
25966,60,1915,4165;5016,0,0,0,0,2,2
25967,60,1922,5034,0,0,0,0,1,1
25968,60,1923,5036,0,0,0,0,1,1
25969,60,1947,5099,0,0,0,0,1,1
25970,60,1972,5156;14024;14428,0,0,0,2,1,3
25971,60,1986,1042,0,0,0,0,1,1
25972,60,2005,5249,0,0,0,0,1,1
25973,60,2018,5274;5478,0,0,0,0,2,2
25974,60,2025,5293,0,0,0,0,1,1
25975,60,2031,2455;5309,0,0,0,0,2,2
25976,60,2033,5315;8171,0,0,0,0,2,2
25977,60,2034,5741,0,0,0,0,1,1
25978,60,2036,5321,0,0,0,0,1,1
25979,60,2057,1904,0,0,0,0,1,1
25980,60,2066,8731,0,0,0,0,1,1
25981,60,2067,5393,0,0,0,0,1,1
25982,60,2068,6781;7143,0,0,0,0,2,2
25983,60,2078,4031,0,0,0,0,1,1
25984,60,2079,5423,0,0,0,0,1,1
25985,60,2080,4927,0,0,0,0,1,1
25986,60,2090,5460,0,0,0,0,1,1
25987,60,2096,3022;5468,0,0,0,0,2,2
25988,60,2100,5475,0,0,0,0,1,1
25989,60,2111,6493,0,0,0,0,1,1
25990,60,2118,9393;11819,0,0,0,1,1,2
25991,60,2120,5524,0,0,0,0,1,1
25992,60,2122,8011,0,0,0,0,1,1
25993,60,2125,5532,0,0,0,0,1,1
25994,60,2142,5578,0,0,0,0,1,1
25995,60,2155,9948,0,0,0,0,1,1
25996,60,2159,1246,0,0,0,0,1,1
25997,60,2173,5649,0,0,0,0,1,1
25998,60,2194,5694,0,0,0,0,1,1
25999,60,2198,5708,0,0,0,0,1,1
26000,60,2199,5711,0,0,0,0,1,1
26001,60,2202,5717,0,0,0,0,1,1
26002,60,2212,3151;5749,0,0,0,0,2,2
26003,60,2215,9093,0,0,0,0,1,1
26004,60,2243,5822,0,0,0,0,1,1
26005,60,2252,1894;5840,0,0,0,0,2,2
26006,60,2264,4810;5868,0,0,0,0,2,2
26007,60,2274,5889,0,0,0,0,1,1
26008,60,2285,5916,0,0,0,0,1,1
26009,60,2286,4528,0,0,0,0,1,1
26010,60,2290,5913,0,0,0,0,1,1
26011,60,2291,3592;5930;8932,0,0,0,2,1,3
26012,60,2303,5957,0,0,0,0,1,1
26013,60,2311,5980,0,0,0,0,1,1
26014,60,2317,10070;10315;14452,0,0,0,3,0,3
26015,60,2319,7676,0,0,0,0,1,1
26016,60,2333,6038,0,0,0,0,1,1
26017,60,2334,2932;6039,0,0,0,0,2,2
26018,60,2336,6043;6044,0,0,0,0,2,2
26019,60,2338,4215,0,0,0,0,1,1
26020,60,2342,6052;7453,0,0,0,0,2,2
26021,60,2343,6056;8892;15391,0,0,0,1,2,3
26022,60,2349,8838,0,0,0,0,1,1
26023,60,2366,1515;7964,0,0,0,0,2,2
26024,60,2384,6150,0,0,0,0,1,1
26025,60,2389,2559;6166,0,0,0,0,2,2
26026,60,2392,6174,0,0,0,0,1,1
26027,60,2395,6180,0,0,0,0,1,1
26028,60,2399,11519;11804;16687;16728,0,0,2,2,0,4
26029,60,2403,8231,0,0,0,0,1,1
26030,60,2413,6229,0,0,0,0,1,1
26031,60,2418,11158;15487;15658,0,0,0,3,0,3
26032,60,2431,5603;6277,0,0,0,0,2,2
26033,60,2434,120;6290,0,0,0,0,2,2
26034,60,2446,6321,0,0,0,0,1,1
26035,60,2468,6379,0,0,0,0,1,1
26036,60,2479,8099,0,0,0,0,1,1
26037,60,2486,3212;6423,0,0,0,0,2,2
26038,60,2490,242;6431,0,0,0,0,2,2
26039,60,2495,6067,0,0,0,0,1,1
26040,60,2496,8367,0,0,0,0,1,1
26041,60,2503,4523;6470,0,0,0,2,0,2
26042,60,2513,6490,0,0,0,1,0,1
26043,60,2519,5438,0,0,0,0,1,1
26044,60,2521,4668,0,0,0,0,1,1
26045,60,2527,6519,0,0,0,0,1,1
26046,60,2563,6610,0,0,0,0,1,1
26047,60,2569,3699,0,0,0,0,1,1
26048,60,2596,765,0,0,0,0,1,1
26049,60,2604,6730,0,0,0,0,1,1
26050,60,2606,6737,0,0,0,0,1,1
26051,60,2631,6802,0,0,0,0,1,1
26052,60,2637,6813,0,0,0,0,1,1
26053,60,2638,12333;16697,0,0,1,1,0,2
26054,60,2643,10485;10565;14767;15209,0,0,0,4,0,4
26055,60,2648,4471;6848;6849,0,0,0,2,1,3
26056,60,2674,6913,0,0,0,0,1,1
26057,60,2681,1541,0,0,0,0,1,1
26058,60,2693,4410,0,0,0,0,1,1
26059,60,2699,6968;6969,0,0,0,0,2,2
26060,60,2704,908;6985,0,0,0,0,2,2
26061,60,2725,7048;7836,0,0,0,0,2,2
26062,60,2744,7094;8357,0,0,0,0,2,2
26063,60,2745,8120,0,0,0,0,1,1
26064,60,2746,7101;13907,0,0,0,1,1,2
26065,60,2764,7151;8592,0,0,0,0,2,2
26066,60,2766,7157;9042,0,0,0,1,1,2
26067,60,2769,7162,0,0,0,0,1,1
26068,60,2770,5582,0,0,0,0,1,1
26069,60,2785,7199,0,0,0,0,1,1
26070,60,2787,3502;7203,0,0,0,0,2,2
26071,60,2797,7734,0,0,0,0,1,1
26072,60,2802,9495,0,0,0,0,1,1
26073,60,2809,7252,0,0,0,0,1,1
26074,60,2820,7277,0,0,0,0,1,1
26075,60,2836,7318,0,0,0,0,1,1
26076,60,2851,7355,0,0,0,0,1,1
26077,60,2863,5974;7384,0,0,0,0,2,2
26078,60,2867,7395;14594,0,0,0,1,1,2
26079,60,2869,8828;8890,0,0,0,0,2,2
26080,60,2871,3450;7406,0,0,0,0,2,2
26081,60,2875,680,0,0,0,0,1,1
26082,60,2879,1948,0,0,0,0,1,1
26083,60,2885,1622,0,0,0,1,0,1
26084,60,2896,7472,0,0,0,0,1,1
26085,60,2905,7672;8590,0,0,0,0,2,2
26086,60,2908,7504;7809,0,0,0,0,2,2
26087,60,2915,7526,0,0,0,0,1,1
26088,60,2919,9666,0,0,0,0,1,1
26089,60,2921,7541,0,0,0,0,1,1
26090,60,2925,2855,0,0,0,1,0,1
26091,60,2942,7596,0,0,0,0,1,1
26092,60,2952,7622;9710,0,0,0,1,1,2
26093,60,2986,4954;7711,0,0,0,0,2,2
26094,60,3021,1166;7792,0,0,0,0,2,2
26095,60,3022,7793;10115,0,0,0,1,1,2
26096,60,3028,4507,0,0,0,0,1,1
26097,60,3054,7878,0,0,0,0,1,1
26098,60,3056,1334;3007,0,0,0,1,1,2
26099,60,3067,7907,0,0,0,0,1,1
26100,60,3070,7915,0,0,0,0,1,1
26101,60,3072,2017,0,0,0,0,1,1
26102,60,3075,4061;7928,0,0,0,0,2,2
26103,60,3081,7946;7947;10013,0,0,0,2,1,3
26104,60,3082,7948,0,0,0,0,1,1
26105,60,3083,7951,0,0,0,0,1,1
26106,60,3099,4395,0,0,0,0,1,1
26107,60,3100,7987,0,0,0,0,1,1
26108,60,3112,9295,0,0,0,0,1,1
26109,60,3132,4075;8076;14434,0,0,0,2,1,3
26110,60,3137,8085,0,0,0,0,1,1
26111,60,3151,5653,0,0,0,0,1,1
26112,60,3154,4134,0,0,0,0,1,1
26113,60,3158,3668,0,0,0,0,1,1
26114,60,3159,8143;8146,0,0,0,1,1,2
26115,60,3163,1748;8156,0,0,0,0,2,2
26116,60,3189,2210;3718,0,0,0,0,2,2
26117,60,3193,6588,0,0,0,0,1,1
26118,60,3199,8239;9412,0,0,0,0,2,2
26119,60,3201,8241,0,0,0,0,1,1
26120,60,3204,8245,0,0,0,0,1,1
26121,60,3212,8263;10021,0,0,0,1,1,2
26122,60,3216,8276,0,0,0,0,1,1
26123,60,3227,8305,0,0,0,0,1,1
26124,60,3232,8321,0,0,0,0,1,1
26125,60,3236,8334,0,0,0,0,1,1
26126,60,3238,8340,0,0,0,0,1,1
26127,60,3243,6535,0,0,0,0,1,1
26128,60,3260,2013;2825,0,0,0,0,2,2
26129,60,3262,2687,0,0,0,0,1,1
26130,60,3271,8427,0,0,0,0,1,1
26131,60,3282,8450,0,0,0,0,1,1
26132,60,3288,8464,0,0,0,0,1,1
26133,60,3316,8540,0,0,0,0,1,1
26134,60,3319,271;8554,0,0,0,0,2,2
26135,60,3323,8564,0,0,0,0,1,1
26136,60,3366,2875;8674;8675;9562,0,0,0,0,4,4
26137,60,3401,8763,0,0,0,0,1,1
26138,60,3416,8804,0,0,0,0,1,1
26139,60,3420,2833;5615,0,0,0,0,2,2
26140,60,3421,8824,0,0,0,0,1,1
26141,60,3423,8833,0,0,0,0,1,1
26142,60,3424,8834,0,0,0,0,1,1
26143,60,3432,3222;5458;8858,0,0,0,0,3,3
26144,60,3435,3256;9267,0,0,0,1,1,2
26145,60,3439,6215,0,0,0,0,1,1
26146,60,3449,5069;8895,0,0,0,0,2,2
26147,60,3456,8915,0,0,0,0,1,1
26148,60,3469,8949;13343,0,0,0,1,1,2
26149,60,3479,8100;8978,0,0,0,1,1,2
26150,60,3485,6513;8991,0,0,0,0,2,2
26151,60,3507,9050,0,0,0,0,1,1
26152,60,3517,423;9070,0,0,0,0,2,2
26153,60,3519,9076,0,0,0,0,1,1
26154,60,3537,9131,0,0,0,0,1,1
26155,60,3539,9138;12984,0,0,0,1,1,2
26156,60,3549,3873;8238;9162,0,0,0,1,2,3
26157,60,3579,6863,0,0,0,0,1,1
26158,60,3592,9274,0,0,0,0,1,1
26159,60,3605,193;9301,0,0,0,0,2,2
26160,60,3606,9304,0,0,0,0,1,1
26161,60,3613,9319,0,0,0,0,1,1
26162,60,3620,75,0,0,0,0,1,1
26163,60,3628,9360,0,0,0,0,1,1
26164,60,3634,1732;9378,0,0,0,0,2,2
26165,60,3637,9384,0,0,0,0,1,1
26166,60,3646,10820,0,0,0,1,0,1
26167,60,3651,9426,0,0,0,0,1,1
26168,60,3654,8026,0,0,0,0,1,1
26169,60,3662,9453,0,0,0,0,1,1
26170,60,3679,9496,0,0,0,0,1,1
26171,60,3684,9507,0,0,0,0,1,1
26172,60,3685,9511,0,0,0,0,1,1
26173,60,3687,9518;9519,0,0,0,1,1,2
26174,60,3688,9521,0,0,0,0,1,1
26175,60,3704,9561,0,0,0,0,1,1
26176,60,3710,988;9580,0,0,0,1,1,2
26177,60,3719,9604;9605,0,0,0,0,2,2
26178,60,3725,9436;9619,0,0,0,0,2,2
26179,60,3726,6618;9621,0,0,0,0,2,2
26180,60,3737,9647,0,0,0,0,1,1
26181,60,3750,3201;9694,0,0,0,0,2,2
26182,60,3752,179;9688,0,0,0,0,2,2
26183,60,3759,9708,0,0,0,0,1,1
26184,60,3769,3420;9736;15114,0,0,0,2,1,3
26185,60,3771,5433;9742,0,0,0,2,0,2
26186,60,3774,8984,0,0,0,0,1,1
26187,60,3784,9778;12013,0,0,0,1,1,2
26188,60,3794,8934;9808;11836,0,0,0,1,2,3
26189,60,3797,7986;9815,0,0,0,0,2,2
26190,60,3817,10983;11745;15456;15657,0,0,0,4,0,4
26191,60,3822,213;7445;8270;9888;14891,0,0,0,3,2,5
26192,60,3831,9907,0,0,0,0,1,1
26193,60,3833,9915,0,0,0,0,1,1
26194,60,3839,9931,0,0,0,0,1,1
26195,60,3841,9934,0,0,0,0,1,1
26196,60,3849,9957,0,0,0,0,1,1
26197,60,3860,2524;5329;9986;9987,0,0,0,1,3,4
26198,60,3862,9991,0,0,0,0,1,1
26199,60,3868,299,0,0,0,0,1,1
26200,60,3869,7669,0,0,0,0,1,1
26201,60,3872,487,0,0,0,0,1,1
26202,60,3877,979,0,0,0,0,1,1
26203,60,3881,2380,0,0,0,0,1,1
26204,60,3885,974,0,0,0,0,1,1
26205,60,3899,3100;3625,0,0,0,0,2,2
26206,60,3902,3291,0,0,0,0,1,1
26207,60,3904,3865;5508,0,0,0,0,2,2
26208,60,3913,5058,0,0,0,0,1,1
26209,60,3914,4051,0,0,0,0,1,1
26210,60,3916,5208;9878,0,0,0,0,2,2
26211,60,3921,2316,0,0,0,0,1,1
26212,60,3925,2438;8622,0,0,0,0,2,2
26213,60,3927,1030,0,0,0,0,1,1
26214,60,3946,3922;4188;12363,0,0,0,1,2,3
26215,60,3949,6311,0,0,0,0,1,1
26216,60,3957,3061,365,0,0,0,1,1
26217,60,3960,5699,365,0,0,0,1,1
26218,60,3962,728,365,0,0,0,1,1
26219,60,3966,7838,365,0,0,0,1,1
26220,60,3967,459,365,0,0,0,1,1
26221,60,3969,3140,365,0,0,0,1,1
26222,60,3975,2723,365,0,0,0,1,1
26223,60,3977,2804,365,0,0,0,1,1
26224,60,3978,9990,365,0,0,0,1,1
26225,60,3986,3396;8378,365,0,0,0,2,2
26226,60,3987,3432;4751,365,0,0,0,2,2
26227,60,4000,4827;6246,365,0,0,0,2,2
26228,60,4004,11810;11904;15631,365,0,0,3,0,3
26229,60,4006,4889;5900,365,0,0,0,2,2
26230,60,4009,5014;6021,365,0,0,0,2,2
26231,60,4011,3133,365,0,0,0,1,1
26232,60,4015,8315,365,0,0,0,1,1
26233,60,4016,3062;5554;11632,365,0,0,1,2,3
26234,60,4027,7997,365,0,0,0,1,1
26235,60,4040,9428,365,0,0,0,1,1
26236,60,4048,6184,730,0,0,0,1,1
26237,60,4052,489,730,0,0,0,1,1
26238,60,4053,2949,730,0,0,0,1,1
26239,60,4055,5617,730,0,0,0,1,1
26240,60,4058,948;5619,730,0,0,0,2,2
26241,60,4059,951;3996,730,0,0,0,2,2
26242,60,4062,3560,730,0,0,0,1,1
26243,60,4065,1745,730,0,0,0,1,1
26244,60,4066,4619,730,0,0,0,1,1
26245,60,4067,1846;12463,730,0,0,1,1,2
26246,60,4094,3792,730,0,0,0,1,1
26247,60,4099,4030;5216,730,0,0,0,2,2
26248,60,4103,4273,730,0,0,0,1,1
26249,60,4105,4377,730,0,0,0,1,1
26250,60,4106,4384,730,0,0,0,1,1
26251,60,4109,4909;6856,730,0,0,0,2,2
26252,60,4112,5087,730,0,0,0,1,1
26253,60,4114,262;8083,730,0,0,0,2,2
26254,60,4116,7;6345,730,0,0,0,2,2
26255,60,4118,5684;6696,730,0,0,0,2,2
26256,60,4122,2203,730,0,0,0,1,1
26257,60,4127,158,730,0,0,0,1,1
26258,60,4129,6922,730,0,0,0,1,1
26259,60,4130,7021,730,0,0,0,1,1
26260,60,4131,7074,730,0,0,0,1,1
26261,60,4138,7592,730,0,0,0,1,1
26262,60,4140,7293;8757,730,0,0,0,2,2
26263,60,4141,3716;5419,730,0,0,0,2,2
26264,60,4144,4482;8277,730,0,0,0,2,2
26265,60,4145,11617,730,0,0,1,0,1
26266,60,4156,1209,730,0,0,0,1,1
26267,60,4158,1074;4218,730,0,0,0,2,2
26268,60,4165,1447;9762,730,0,0,0,2,2
26269,60,4171,3419;4284,1095,0,0,0,2,2
26270,60,4172,38,1095,0,0,0,1,1
26271,60,4173,413;5748,1095,0,0,0,2,2
26272,60,4174,3103,1095,0,0,0,1,1
26273,60,4179,1212;5939,1095,0,0,0,2,2
26274,60,4180,2179,1095,0,0,0,1,1
26275,60,4183,467,1095,0,0,0,1,1
26276,60,4187,7035;8996,1095,0,0,0,2,2
26277,60,4192,9721,1095,0,0,0,1,1
26278,60,4199,1974,1095,0,0,0,1,1
26279,60,4202,4015;9008;12616,1095,0,0,1,2,3
26280,60,4205,4170,1095,0,0,0,1,1
26281,60,4206,1603,1095,0,0,0,1,1
26282,60,4212,7998,1095,0,0,0,1,1
26283,60,4213,3471,1095,0,0,0,1,1
26284,60,4217,4001,1095,0,0,0,1,1
26285,60,4218,5070,1095,0,0,0,1,1
26286,60,4223,4490,1095,0,0,0,1,1
26287,60,4225,62,1095,0,0,0,1,1
26288,60,4230,4577,1095,0,0,0,1,1
26289,60,4234,3759;5379,1095,0,0,0,2,2
26290,60,4236,5755,1095,0,0,0,1,1
26291,60,4237,5769,1095,0,0,0,1,1
26292,60,4239,5547;5928,1095,0,0,0,2,2
26293,60,4245,4148;6334,1095,0,0,0,2,2
26294,60,4248,6837,1095,0,0,0,1,1
26295,60,4249,2556;6914,1095,0,0,0,2,2
26296,60,4250,5489,1095,0,0,0,1,1
26297,60,4252,5871;7294,1095,0,0,0,2,2
26298,60,4257,3675;6982,1095,0,0,0,2,2
26299,60,4260,6306,1095,0,0,0,1,1
26300,60,4261,5490,1095,0,0,0,1,1
26301,60,4263,7603;7722,1095,0,0,0,2,2
26302,60,4264,9526,1095,0,0,0,1,1
26303,60,4265,5201;7893,1095,0,0,0,2,2
26304,60,4268,1238;6544,1095,0,0,0,2,2
26305,60,4272,8455,1095,0,0,0,1,1
26306,60,4275,205;7138,1095,0,0,0,2,2
26307,60,4276,8859,1095,0,0,0,1,1
26308,60,4281,5366;9165,1095,0,0,0,2,2
26309,60,4282,4908;9221,1095,0,0,0,2,2
26310,60,4285,3289,1095,0,0,0,1,1
26311,60,4287,5443;12083,1095,0,0,1,1,2
26312,60,4288,9727,1095,0,0,0,1,1
26313,60,4297,8925,1460,0,0,0,1,1
26314,60,4298,583;8790,1460,0,0,0,2,2
26315,60,4299,643;9898,1460,0,0,0,2,2
26316,60,4300,3727;7286,1460,0,0,0,2,2
26317,60,4302,4888,1460,0,0,0,1,1
26318,60,4303,7604,1460,0,0,0,1,1
26319,60,4304,871,1460,0,0,0,1,1
26320,60,4306,895;5737,1460,0,0,0,2,2
26321,60,4307,4602,1460,0,0,0,1,1
26322,60,4309,1059,1460,0,0,0,1,1
26323,60,4311,4492,1460,0,0,0,1,1
26324,60,4312,1213;7825,1460,0,0,0,2,2
26325,60,4315,9843,1460,0,0,0,1,1
26326,60,4316,1499;5709,1460,0,0,0,2,2
26327,60,4320,4756;6308,1460,0,0,0,2,2
26328,60,4329,2843,1460,0,0,0,1,1
26329,60,4330,2887,1460,0,0,0,1,1
26330,60,4335,9947,1460,0,0,0,1,1
26331,60,4337,2301,1460,0,0,0,1,1
26332,60,4338,8760,1460,0,0,0,1,1
26333,60,4340,5905,1460,0,0,0,1,1
26334,60,4341,3832,1460,0,0,0,1,1
26335,60,4345,2232;4169,1460,0,0,0,2,2
26336,60,4347,1250;4315,1460,0,0,0,2,2
26337,60,4349,8135,1460,0,0,0,1,1
26338,60,4350,4707,1460,0,0,0,1,1
26339,60,4355,5017,1460,0,0,0,1,1
26340,60,4360,5377;6586,1460,0,0,0,2,2
26341,60,4369,4197,1460,0,0,0,1,1
26342,60,4370,1526,1460,0,0,0,1,1
26343,60,4375,7989,1460,0,0,0,1,1
26344,60,4376,6489;6728,1460,0,0,0,2,2
26345,60,4378,2350;6819,1460,0,0,0,2,2
26346,60,4380,3566,1460,0,0,0,1,1
26347,60,4381,6452;6986,1460,0,0,0,2,2
26348,60,4385,9424,1460,0,0,0,1,1
26349,60,4387,6133,1460,0,0,0,1,1
26350,60,4389,7517,1460,0,0,0,1,1
26351,60,4390,7868,1460,0,0,0,1,1
26352,60,4391,6211,1460,0,0,0,1,1
26353,60,4392,2525,1460,0,0,0,1,1
26354,60,4397,8284,1460,0,0,0,1,1
26355,60,4402,1218,1460,0,0,0,1,1
26356,60,4403,7495;13044,1460,0,0,1,1,2
26357,60,4405,8568,1460,0,0,0,1,1
26358,60,4408,6198;9299,1460,0,0,0,2,2
26359,60,4409,6318,1460,0,0,0,1,1
26360,60,4412,6413;9769,1460,0,0,0,2,2
26361,60,4413,7419;9777,1460,0,0,0,2,2
26362,60,4414,9809,1460,0,0,0,1,1
26363,60,4415,1741;3994,1460,0,0,0,2,2
26364,60,4416,4873;9114,1460,0,0,0,2,2
26365,60,4417,4336,1825,0,0,0,1,1
26366,60,4418,199;8519,1825,0,0,0,2,2
26367,60,4423,439;705,1825,0,0,0,2,2
26368,60,4426,1352;6736,1825,0,0,0,2,2
26369,60,4430,642;1525,1825,0,0,0,2,2
26370,60,4431,411,1825,0,0,0,1,1
26371,60,4435,6196;9357,1825,0,0,0,2,2
26372,60,4437,3219;12441,1825,0,0,1,1,2
26373,60,4438,4898,1825,0,0,0,1,1
26374,60,4442,3648,1825,0,0,0,1,1
26375,60,4444,3384,1825,0,0,0,1,1
26376,60,4445,3193,1825,0,0,0,1,1
26377,60,4446,8285;9419,1825,0,0,0,2,2
26378,60,4451,3595;11487,1825,0,0,1,1,2
26379,60,4452,4374,1825,0,0,0,1,1
26380,60,4453,3961;4062,1825,0,0,0,2,2
26381,60,4454,1151;3962,1825,0,0,0,2,2
26382,60,4455,4046,1825,0,0,0,1,1
26383,60,4457,1387;4586,1825,0,0,0,2,2
26384,60,4460,4474,1825,0,0,0,1,1
26385,60,4461,4487;8672,1825,0,0,0,2,2
26386,60,4462,4838,1825,0,0,0,1,1
26387,60,4470,8552,1825,0,0,0,1,1
26388,60,4471,2285,1825,0,0,0,1,1
26389,60,4472,5234,1825,0,0,0,1,1
26390,60,4483,4314,1825,0,0,0,1,1
26391,60,4485,5811;9714,1825,0,0,0,2,2
26392,60,4486,6313;8561,1825,0,0,0,2,2
26393,60,4489,5703;6530,1825,0,0,0,2,2
26394,60,4490,356;9041,1825,0,0,0,2,2
26395,60,4492,3136;6070,1825,0,0,0,2,2
26396,60,4493,3539,1825,0,0,0,1,1
26397,60,4498,7256;7508,1825,0,0,0,2,2
26398,60,4505,2180;6582,1825,0,0,0,2,2
26399,60,4507,9329,1825,0,0,0,1,1
26400,60,4508,5448,1825,0,0,0,1,1
26401,60,4510,7882,1825,0,0,0,1,1
26402,60,4511,7933,1825,0,0,0,1,1
26403,60,4520,4103,1825,0,0,0,1,1
26404,60,4521,1343;9352,1825,0,0,0,2,2
26405,60,4522,3362;8176,1825,0,0,0,2,2
26406,60,4524,4522;9032,1825,0,0,0,2,2
26407,60,4525,8168,1825,0,0,0,1,1
26408,60,4526,7601;9097,1825,0,0,0,2,2
26409,60,4530,568,1825,0,0,0,1,1
26410,60,4531,2156;9368,1825,0,0,0,2,2
26411,60,4533,3538,1825,0,0,0,1,1
26412,60,4534,2366;9817,1825,0,0,0,2,2
26413,60,4536,1317;9963,1825,0,0,0,2,2
26414,60,4538,4274,2190,0,0,0,1,1
26415,60,4539,112;2881,2190,0,0,0,2,2
26416,60,4542,863;6330,2190,0,0,0,2,2
26417,60,4544,209,2190,0,0,0,1,1
26418,60,4548,1556,2190,0,0,0,1,1
26419,60,4551,1788;3004,2190,0,0,0,2,2
26420,60,4554,5166,2190,0,0,0,1,1
26421,60,4555,8864;9882,2190,0,0,0,2,2
26422,60,4556,2480,2190,0,0,0,1,1
26423,60,4558,2621;9006,2190,0,0,0,2,2
26424,60,4560,2670,2190,0,0,0,1,1
26425,60,4561,1363;2811,2190,0,0,0,2,2
26426,60,4562,2821,2190,0,0,0,1,1
26427,60,4563,2865;3315,2190,0,0,0,2,2
26428,60,4569,7343;8619,2190,0,0,0,2,2
26429,60,4572,3531;4654,2190,0,0,0,2,2
26430,60,4574,2433;8336,2190,0,0,0,2,2
26431,60,4576,3768;9897,2190,0,0,0,2,2
26432,60,4578,2295;3860,2190,0,0,0,2,2
26433,60,4579,3955;8124,2190,0,0,0,2,2
26434,60,4580,2490,2190,0,0,0,1,1
26435,60,4582,4073,2190,0,0,0,1,1
26436,60,4583,4475;8679,2190,0,0,0,2,2
26437,60,4585,8388;9573,2190,0,0,0,2,2
26438,60,4591,817;1415,2190,0,0,0,2,2
26439,60,4593,1824;5606;12966,2190,0,0,1,2,3
26440,60,4598,6170,2190,0,0,0,1,1
26441,60,4599,3985,2190,0,0,0,1,1
26442,60,4600,6118;6503,2190,0,0,0,2,2
26443,60,4606,5432,2190,0,0,0,1,1
26444,60,4607,3164;6774,2190,0,0,0,2,2
26445,60,4610,7102,2190,0,0,0,1,1
26446,60,4611,6191,2190,0,0,0,1,1
26447,60,4612,7331;9854,2190,0,0,0,2,2
26448,60,4613,7353;7691,2190,0,0,0,2,2
26449,60,4614,6193,2190,0,0,0,1,1
26450,60,4615,5518;7705,2190,0,0,0,2,2
26451,60,4619,4141;7874,2190,0,0,0,2,2
26452,60,4621,8479,2190,0,0,0,1,1
26453,60,4624,8318,2190,0,0,0,1,1
26454,60,4629,5261;8798,2190,0,0,0,2,2
26455,60,4633,9370,2190,0,0,0,1,1
26456,60,4634,9926,2190,0,0,0,1,1
26457,60,4639,537;8408;12418,2190,0,0,1,2,3
26458,60,4640,2500,2190,0,0,0,1,1
26459,60,4646,2892;9449,2555,0,0,0,2,2
26460,60,4647,278,2555,0,0,0,1,1
26461,60,4649,350;8039,2555,0,0,0,2,2
26462,60,4650,355;4375,2555,0,0,0,2,2
26463,60,4654,1332;3338,2555,0,0,0,2,2
26464,60,4655,4548;12444,2555,0,0,1,1,2
26465,60,4656,1372,2555,0,0,0,1,1
26466,60,4657,1399;5981,2555,0,0,0,2,2
26467,60,4658,6354,2555,0,0,0,1,1
26468,60,4660,1901,2555,0,0,0,1,1
26469,60,4661,1653,2555,0,0,0,1,1
26470,60,4662,1935,2555,0,0,0,1,1
26471,60,4664,2289,2555,0,0,0,1,1
26472,60,4666,603;3678,2555,0,0,0,2,2
26473,60,4668,2605;8226,2555,0,0,0,2,2
26474,60,4670,2766;4979,2555,0,0,0,2,2
26475,60,4671,2800;9501,2555,0,0,0,2,2
26476,60,4672,2058;6971,2555,0,0,0,2,2
26477,60,4674,1207;3144,2555,0,0,0,2,2
26478,60,4676,3277,2555,0,0,0,1,1
26479,60,4677,1505;3524,2555,0,0,0,2,2
26480,60,4678,3574;6102,2555,0,0,0,2,2
26481,60,4679,3703;6767,2555,0,0,0,2,2
26482,60,4681,3766;7342,2555,0,0,0,2,2
26483,60,4683,7391;11445,2555,0,0,1,1,2
26484,60,4686,4258,2555,0,0,0,1,1
26485,60,4689,1692;2168,2555,0,0,0,2,2
26486,60,4692,9588,2555,0,0,0,1,1
26487,60,4700,8680,2555,0,0,0,1,1
26488,60,4706,4978;5604,2555,0,0,0,2,2
26489,60,4708,5691;6164,2555,0,0,0,2,2
26490,60,4710,2692;5988,2555,0,0,0,2,2
26491,60,4716,5330;6440,2555,0,0,0,2,2
26492,60,4718,272;6701,2555,0,0,0,2,2
26493,60,4720,6769;9356,2555,0,0,0,2,2
26494,60,4721,6778,2555,0,0,0,1,1
26495,60,4723,6867,2555,0,0,0,1,1
26496,60,4724,8822,2555,0,0,0,1,1
26497,60,4725,6951;8831,2555,0,0,0,2,2
26498,60,4726,7078,2555,0,0,0,1,1
26499,60,4729,3125;7569,2555,0,0,0,2,2
26500,60,4730,4649,2555,0,0,0,1,1
26501,60,4731,6037;6406,2555,0,0,0,2,2
26502,60,4734,1801;3436,2555,0,0,0,2,2
26503,60,4735,8087,2555,0,0,0,1,1
26504,60,4738,986;8501,2555,0,0,0,2,2
26505,60,4739,8596,2555,0,0,0,1,1
26506,60,4740,8740,2555,0,0,0,1,1
26507,60,4746,3418;9214,2555,0,0,0,2,2
26508,60,4747,9328,2555,0,0,0,1,1
26509,60,4750,7341;9499,2555,0,0,0,2,2
26510,60,4755,9883,2555,0,0,0,1,1
26511,60,4757,12159;15793;16586,2555,0,2,1,0,3
26512,60,4759,146;4129,2920,0,0,0,2,2
26513,60,4761,9607,2920,0,0,0,1,1
26514,60,4770,12991,2920,0,0,1,0,1
26515,60,4771,1016,2920,0,0,0,1,1
26516,60,4772,892;12137,2920,0,0,1,1,2
26517,60,4774,1099;2787,2920,0,0,0,2,2
26518,60,4775,1634;2355;12578,2920,0,0,1,2,3
26519,60,4776,1123;1648,2920,0,0,0,2,2
26520,60,4778,931;1882,2920,0,0,0,2,2
26521,60,4779,1936,2920,0,0,0,1,1
26522,60,4780,933;2290;11857,2920,0,0,1,2,3
26523,60,4781,2169;8292;13074,2920,0,0,1,2,3
26524,60,4782,1925;8493,2920,0,0,0,2,2
26525,60,4784,2840;8627,2920,0,0,0,2,2
26526,60,4788,55;2960,2920,0,0,0,2,2
26527,60,4789,3155;3704,2920,0,0,0,2,2
26528,60,4792,3207;4713,2920,0,0,0,2,2
26529,60,4793,159;7185;12906,2920,0,0,1,2,3
26530,60,4794,3449,2920,0,0,0,1,1
26531,60,4796,2817;4500,2920,0,0,0,2,2
26532,60,4797,3959,2920,0,0,0,1,1
26533,60,4798,6375,2920,0,0,0,1,1
26534,60,4801,3695;9392,2920,0,0,0,2,2
26535,60,4802,3812;7921,2920,0,0,0,2,2
26536,60,4803,8417;9797,2920,0,0,0,2,2
26537,60,4804,3879,2920,0,0,0,1,1
26538,60,4805,3940,2920,0,0,0,1,1
26539,60,4806,1548;8425,2920,0,0,0,2,2
26540,60,4808,4411,2920,0,0,0,1,1
26541,60,4811,4399,2920,0,0,0,1,1
26542,60,4813,4949,2920,0,0,0,1,1
26543,60,4814,6295,2920,0,0,0,1,1
26544,60,4816,4924;8019,2920,0,0,0,2,2
26545,60,4821,2581;6770;13095,2920,0,0,1,2,3
26546,60,4822,5864,2920,0,0,0,1,1
26547,60,4824,4582,2920,0,0,0,1,1
26548,60,4825,6284,2920,0,0,0,1,1
26549,60,4826,6454;8443,2920,0,0,0,2,2
26550,60,4827,4723;6464,2920,0,0,0,2,2
26551,60,4829,6688;6700,2920,0,0,0,2,2
26552,60,4830,4799;6718,2920,0,0,0,2,2
26553,60,4831,293,2920,0,0,0,1,1
26554,60,4833,3120,2920,0,0,0,1,1
26555,60,4836,1084;6636,2920,0,0,0,2,2
26556,60,4839,6604,2920,0,0,0,1,1
26557,60,4841,7889,2920,0,0,0,1,1
26558,60,4844,8167,2920,0,0,0,1,1
26559,60,4846,8807;12148,2920,0,0,1,1,2
26560,60,4851,6581,2920,0,0,0,1,1
26561,60,4854,2093;8997,2920,0,0,0,2,2
26562,60,4856,1647;9196,2920,0,0,0,2,2
26563,60,4857,8123;9355;12272,2920,0,0,1,2,3
26564,60,4858,3895;7012,2920,0,0,0,2,2
26565,60,4859,513;9664,2920,0,0,0,2,2
26566,60,4863,848,2920,0,0,0,1,1
26567,60,4864,3011;6689,2920,0,0,0,2,2
26568,60,4867,37,3285,0,0,0,1,1
26569,60,4869,116;4373,3285,0,0,0,2,2
26570,60,4871,4628,3285,0,0,0,1,1
26571,60,4872,8187,3285,0,0,0,1,1
26572,60,4873,6820,3285,0,0,0,1,1
26573,60,4875,6629;7036,3285,0,0,0,2,2
26574,60,4876,536;4280,3285,0,0,0,2,2
26575,60,4878,6699;9280,3285,0,0,0,2,2
26576,60,4880,6111;9879;13615,3285,0,0,1,2,3
26577,60,4881,952,3285,0,0,0,1,1
26578,60,4882,9799,3285,0,0,0,1,1
26579,60,4883,3376;9816,3285,0,0,0,2,2
26580,60,4891,4435;9649,3285,0,0,0,2,2
26581,60,4893,4109;9245,3285,0,0,0,2,2
26582,60,4894,936,3285,0,0,0,1,1
26583,60,4896,3788,3285,0,0,0,1,1
26584,60,4898,1386;2493;12824,3285,0,0,1,2,3
26585,60,4899,3698;5159,3285,0,0,0,2,2
26586,60,4900,4553,3285,0,0,0,1,1
26587,60,4905,3276;6405,3285,0,0,0,2,2
26588,60,4907,1304;8650,3285,0,0,0,2,2
26589,60,4909,3523;5949,3285,0,0,0,2,2
26590,60,4910,6559,3285,0,0,0,1,1
26591,60,4914,4401;7180,3285,0,0,0,2,2
26592,60,4916,4576,3285,0,0,0,1,1
26593,60,4918,3869;9188;12462,3285,0,0,1,2,3
26594,60,4919,3070,3285,0,0,0,1,1
26595,60,4922,1318,3285,0,0,0,1,1
26596,60,4923,4499,3285,0,0,0,1,1
26597,60,4925,4721,3285,0,0,0,1,1
26598,60,4927,2217;4131,3285,0,0,0,2,2
26599,60,4931,5936;7728,3285,0,0,0,2,2
26600,60,4933,2383;5863,3285,0,0,0,2,2
26601,60,4934,5257;8595,3285,0,0,0,2,2
26602,60,4935,3741;9454,3285,0,0,0,2,2
26603,60,4937,6188;8928,3285,0,0,0,2,2
26604,60,4938,4514;6285,3285,0,0,0,2,2
26605,60,4941,4850;6727,3285,0,0,0,2,2
26606,60,4944,8808,3285,0,0,0,1,1
26607,60,4945,6792,3285,0,0,0,1,1
26608,60,4947,1640;7192,3285,0,0,0,2,2
26609,60,4949,2215;2395,3285,0,0,0,2,2
26610,60,4951,2839;7461,3285,0,0,0,2,2
26611,60,4952,3575;7488,3285,0,0,0,2,2
26612,60,4959,6542,3285,0,0,0,1,1
26613,60,4960,5000;8466,3285,0,0,0,2,2
26614,60,4964,8623,3285,0,0,0,1,1
26615,60,4966,7330,3285,0,0,0,1,1
26616,60,4971,8262,3285,0,0,0,1,1
26617,60,4972,6064,3285,0,0,0,1,1
26618,60,4973,9818,3285,0,0,0,1,1
26619,60,4975,9739,3285,0,0,0,1,1
26620,60,4977,153;7525,3650,0,0,0,2,2
26621,60,4978,348;7068,3650,0,0,0,2,2
26622,60,4979,360;3298,3650,0,0,0,2,2
26623,60,4980,336;4294,3650,0,0,0,2,2
26624,60,4981,1364;12340,3650,0,0,1,1,2
26625,60,4982,2656;7746,3650,0,0,0,2,2
26626,60,4984,1139;6878,3650,0,0,0,2,2
26627,60,4987,3381;8110,3650,0,0,0,2,2
26628,60,4989,1351;9455;12029,3650,0,0,1,2,3
26629,60,4990,1115;2799,3650,0,0,0,2,2
26630,60,4994,1933,3650,0,0,0,1,1
26631,60,4998,9891;14730,3650,0,0,2,0,2
26632,60,4999,2404;5244,3650,0,0,0,2,2
26633,60,5001,2593;6933,3650,0,0,0,2,2
26634,60,5002,3520,3650,0,0,0,1,1
26635,60,5003,7275,3650,0,0,0,1,1
26636,60,5004,1141;1599,3650,0,0,0,2,2
26637,60,5006,8826,3650,0,0,0,1,1
26638,60,5008,333;6616;11931,3650,0,0,1,2,3
26639,60,5011,4308;4859,3650,0,0,0,2,2
26640,60,5012,393;1666,3650,0,0,0,2,2
26641,60,5014,630;4581,3650,0,0,0,2,2
26642,60,5015,2669;7729,3650,0,0,0,2,2
26643,60,5017,4953;8796,3650,0,0,0,2,2
26644,60,5020,111,3650,0,0,0,1,1
26645,60,5023,8589;11848,3650,0,0,1,1,2
26646,60,5024,6750,3650,0,0,0,1,1
26647,60,5025,147;8306,3650,0,0,0,2,2
26648,60,5028,3492;5950,3650,0,0,0,2,2
26649,60,5029,6846,3650,0,0,0,1,1
26650,60,5030,444;6773,3650,0,0,0,2,2
26651,60,5031,2629;6661,3650,0,0,0,2,2
26652,60,5036,9139;9423,3650,0,0,0,2,2
26653,60,5039,2475;8106,3650,0,0,0,2,2
26654,60,5041,2033;6612,3650,0,0,0,2,2
26655,60,5042,8291,3650,0,0,0,1,1
26656,60,5045,8977,3650,0,0,0,1,1
26657,60,5046,4045,3650,0,0,0,1,1
26658,60,5047,5964,3650,0,0,0,1,1
26659,60,5049,3,3650,0,0,0,1,1
26660,60,5051,706;9517,3650,0,0,0,2,2
26661,60,5052,9637,3650,0,0,0,1,1
26662,60,5053,9642,3650,0,0,0,1,1
26663,60,5054,7969,3650,0,0,0,1,1
26664,60,5056,36;2291,4015,0,0,0,2,2
26665,60,5058,49;5525,4015,0,0,0,2,2
26666,60,5060,189;2959,4015,0,0,0,2,2
26667,60,5061,239,4015,0,0,0,1,1
26668,60,5063,298,4015,0,0,0,1,1
26669,60,5070,2008;3087,4015,0,0,0,2,2
26670,60,5072,1608,4015,0,0,0,1,1
26671,60,5074,6296;6531,4015,0,0,0,2,2
26672,60,5076,2273,4015,0,0,0,1,1
26673,60,5077,9226;13647,4015,0,0,1,1,2
26674,60,5079,2498;9693,4015,0,0,0,2,2
26675,60,5081,2972;5025,4015,0,0,0,2,2
26676,60,5085,2244,4015,0,0,0,1,1
26677,60,5086,3010;3027,4015,0,0,0,2,2
26678,60,5087,1746;2979,4015,0,0,0,2,2
26679,60,5088,1979,4015,0,0,0,1,1
26680,60,5090,3335,4015,0,0,0,1,1
26681,60,5091,1987;13071,4015,0,0,1,1,2
26682,60,5092,8290;8567;11841,4015,0,0,1,2,3
26683,60,5093,3527,4015,0,0,0,1,1
26684,60,5094,3636,4015,0,0,0,1,1
26685,60,5095,3673,4015,0,0,0,1,1
26686,60,5099,4283;9985,4015,0,0,0,2,2
26687,60,5101,4486;6157,4015,0,0,0,2,2
26688,60,5102,3872;4510,4015,0,0,0,2,2
26689,60,5105,4874;8014,4015,0,0,0,2,2
26690,60,5106,1010,4015,0,0,0,1,1
26691,60,5107,5616,4015,0,0,0,1,1
26692,60,5111,1252;12428,4015,0,0,1,1,2
26693,60,5112,9485,4015,0,0,0,1,1
26694,60,5116,6240;8469,4015,0,0,0,2,2
26695,60,5117,1751;5382,4015,0,0,0,2,2
26696,60,5118,2265,4015,0,0,0,1,1
26697,60,5120,5723;13340,4015,0,0,1,1,2
26698,60,5121,6595,4015,0,0,0,1,1
26699,60,5124,2175;6981,4015,0,0,0,2,2
26700,60,5125,1339;3960,4015,0,0,0,2,2
26701,60,5126,3215;7073;12705,4015,0,0,1,2,3
26702,60,5127,7739;9045,4015,0,0,0,2,2
26703,60,5129,3674;7494,4015,0,0,0,2,2
26704,60,5130,3986;5396,4015,0,0,0,2,2
26705,60,5134,9844,4015,0,0,0,1,1
26706,60,5140,4655;8037,4015,0,0,0,2,2
26707,60,5142,5063;8986,4015,0,0,0,2,2
26708,60,5144,479;9220,4015,0,0,0,2,2
26709,60,5146,9118,4015,0,0,0,1,1
26710,60,5147,9687,4015,0,0,0,1,1
26711,60,5149,9756;11429,4015,0,0,1,1,2
26712,60,5153,74;1064,4380,0,0,0,2,2
26713,60,5157,347;5353,4380,0,0,0,2,2
26714,60,5158,1637;4307,4380,0,0,0,2,2
26715,60,5161,3758;5002,4380,0,0,0,2,2
26716,60,5163,2783,4380,0,0,0,1,1
26717,60,5165,891,4380,0,0,0,1,1
26718,60,5167,7990;8198,4380,0,0,0,2,2
26719,60,5168,1136;2322,4380,0,0,0,2,2
26720,60,5173,1313;6954,4380,0,0,0,2,2
26721,60,5174,2083,4380,0,0,0,1,1
26722,60,5175,2091;7894;13048,4380,0,0,1,2,3
26723,60,5177,2231,4380,0,0,0,1,1
26724,60,5179,5970,4380,0,0,0,1,1
26725,60,5183,2544;7024,4380,0,0,0,2,2
26726,60,5184,2798,4380,0,0,0,1,1
26727,60,5188,2807,4380,0,0,0,1,1
26728,60,5189,2891;7222,4380,0,0,0,2,2
26729,60,5190,1192;6624;13750,4380,0,0,1,2,3
26730,60,5191,5072;12129,4380,0,0,1,1,2
26731,60,5194,1001;3121,4380,0,0,0,2,2
26732,60,5196,3351,4380,0,0,0,1,1
26733,60,5197,3202;3468,4380,0,0,0,2,2
26734,60,5198,2742;3493,4380,0,0,0,2,2
26735,60,5199,1698;8515,4380,0,0,0,2,2
26736,60,5203,2239;6158;11695,4380,0,0,1,2,3
26737,60,5204,5425;7914,4380,0,0,0,2,2
26738,60,5207,1427;6453,4380,0,0,0,2,2
26739,60,5208,4855;8497;12575,4380,0,0,1,2,3
26740,60,5211,7873;8853,4380,0,0,0,2,2
26741,60,5213,1705;3738,4380,0,0,0,2,2
26742,60,5218,5212;9321,4380,0,0,0,2,2
26743,60,5219,1148,4380,0,0,0,1,1
26744,60,5220,7872;8899,4380,0,0,0,2,2
26745,60,5222,7681;8779,4380,0,0,0,2,2
26746,60,5225,4267;7777,4380,0,0,0,2,2
26747,60,5226,7683,4380,0,0,0,1,1
26748,60,5230,2385,4380,0,0,0,1,1
26749,60,5232,2880;7029,4380,0,0,0,2,2
26750,60,5236,7306,4380,0,0,0,1,1
26751,60,5240,2108;7503,4380,0,0,0,2,2
26752,60,5242,7077;7679,4380,0,0,0,2,2
26753,60,5245,3402;7913;12468,4380,0,0,1,2,3
26754,60,5246,2555,4380,0,0,0,1,1
26755,60,5252,4449;8741,4380,0,0,0,2,2
26756,60,5253,12548;12839;13063;16977;17427;17543,4380,2,1,3,0,6
26757,60,5254,8643,4380,0,0,0,1,1
26758,60,5257,1509;9040,4380,0,0,0,2,2
26759,60,5260,2240;3951,4380,0,0,0,2,2
26760,60,5261,9589,4380,0,0,0,1,1
26761,60,5263,7236,4380,0,0,0,1,1
26762,60,5265,5451,4745,0,0,0,1,1
26763,60,5267,107;4601,4745,0,0,0,2,2
26764,60,5268,240;12487,4745,0,0,1,1,2
26765,60,5274,6275,4745,0,0,1,0,1
26766,60,5279,1654;3028,4745,0,0,0,2,2
26767,60,5282,1609;4481,4745,0,0,0,2,2
26768,60,5285,7019,4745,0,0,0,1,1
26769,60,5286,7142,4745,0,0,0,1,1
26770,60,5287,3944,4745,0,0,0,1,1
26771,60,5288,9450;9976;14097,4745,0,0,2,1,3
26772,60,5291,1766;2842,4745,0,0,0,2,2
26773,60,5292,8894,4745,0,0,0,1,1
26774,60,5295,3234;9033,4745,0,0,0,2,2
26775,60,5299,837;3467,4745,0,0,0,2,2
26776,60,5300,1652;3401,4745,0,0,0,2,2
26777,60,5302,1787;3749;13353,4745,0,0,1,2,3
26778,60,5305,1966,4745,0,0,0,1,1
26779,60,5306,3945;8759;13065,4745,0,0,1,2,3
26780,60,5308,1344;4252,4745,0,0,0,2,2
26781,60,5309,1416;9015;13491,4745,0,0,1,2,3
26782,60,5315,5044;8566,4745,0,0,0,2,2
26783,60,5316,5181;7747,4745,0,0,0,2,2
26784,60,5318,3458,4745,0,0,0,1,1
26785,60,5319,3380,4745,0,0,0,1,1
26786,60,5320,4630,4745,0,0,0,1,1
26787,60,5323,6;3069;12398,4745,0,0,1,2,3
26788,60,5326,4509;7212,4745,0,0,0,2,2
26789,60,5327,2434,4745,0,0,0,1,1
26790,60,5328,801;6555,4745,0,0,0,2,2
26791,60,5336,1161;6353,4745,0,0,0,2,2
26792,60,5337,2494;7276,4745,0,0,0,2,2
26793,60,5339,7496;7704,4745,0,0,0,2,2
26794,60,5341,1789;7553,4745,0,0,0,2,2
26795,60,5342,54;2117,4745,0,0,0,2,2
26796,60,5343,3956;8505,4745,0,0,0,2,2
26797,60,5344,6918;8514,4745,0,0,0,2,2
26798,60,5345,8520,4745,0,0,0,1,1
26799,60,5347,5137,4745,0,0,0,1,1
26800,60,5348,1750,4745,0,0,0,1,1
26801,60,5349,8629;9003,4745,0,0,0,2,2
26802,60,5350,2699;12923;13140,4745,0,0,2,1,3
26803,60,5351,212;1500;12636,4745,0,0,1,2,3
26804,60,5352,953,4745,0,0,0,1,1
26805,60,5353,9417,4745,0,0,0,1,1
26806,60,5355,2449,4745,0,0,0,1,1
26807,60,5357,3457,4745,0,0,0,1,1
26808,60,5358,294;3834,4745,0,0,0,2,2
26809,60,5359,9726,4745,0,0,0,1,1
26810,60,5363,11593;12127;12576;12883;13414;13696;16830;16852,5110,0,2,6,0,8
26811,60,5364,216;8560;12383,5110,0,0,1,2,3
26812,60,5368,648;1572;15578,5110,0,0,1,2,3
26813,60,5369,7460;8922;13656,5110,0,0,1,2,3
26814,60,5372,1477;1714,5110,0,0,0,2,2
26815,60,5373,679,5110,0,0,0,1,1
26816,60,5377,944;6905,5110,0,0,0,2,2
26817,60,5378,9112,5110,0,0,0,1,1
26818,60,5380,6567;13267,5110,0,0,1,1,2
26819,60,5384,2031;3428,5110,0,0,0,2,2
26820,60,5385,3611;8133,5110,0,0,0,2,2
26821,60,5386,3691;9709,5110,0,0,0,2,2
26822,60,5388,1986,5110,0,0,0,1,1
26823,60,5391,4035,5110,0,0,0,1,1
26824,60,5393,4070,5110,0,0,0,1,1
26825,60,5397,2364;4963,5110,0,0,0,2,2
26826,60,5398,5031;5688,5110,0,0,0,2,2
26827,60,5401,4595;5674,5110,0,0,0,2,2
26828,60,5404,4043,5110,0,0,0,1,1
26829,60,5406,6154,5110,0,0,0,1,1
26830,60,5408,480;4021,5110,0,0,0,2,2
26831,60,5409,802;9134,5110,0,0,0,2,2
26832,60,5410,6693;7500,5110,0,0,0,2,2
26833,60,5411,2594;2750,5110,0,0,0,2,2
26834,60,5412,6389;6950,5110,0,0,0,2,2
26835,60,5413,6875;8845;12993,5110,0,0,1,2,3
26836,60,5415,2870,5110,0,0,1,0,1
26837,60,5416,3476,5110,0,0,0,1,1
26838,60,5417,7367,5110,0,0,0,1,1
26839,60,5421,7332;7697;12433,5110,0,0,1,2,3
26840,60,5422,3437;8746,5110,0,0,0,2,2
26841,60,5424,1239,5110,0,0,0,1,1
26842,60,5426,753;8827,5110,0,0,0,2,2
26843,60,5428,6526;9068,5110,0,0,0,2,2
26844,60,5429,5806;9210;13298;13626,5110,0,0,2,2,4
26845,60,5433,1471;6404,5110,0,0,0,2,2
26846,60,5434,5735;9853,5110,0,0,0,2,2
26847,60,5436,2963;7561,5475,0,0,1,1,2
26848,60,5437,87;14249,5475,0,0,1,1,2
26849,60,5440,378,5475,0,0,0,1,1
26850,60,5441,431;5792,5475,0,0,0,2,2
26851,60,5443,2651;9783;14018,5475,0,0,1,2,3
26852,60,5444,896,5475,0,0,0,1,1
26853,60,5445,902;9940,5475,0,0,0,2,2
26854,60,5446,1163;4290,5475,0,0,0,2,2
26855,60,5447,786;8288,5475,0,0,1,1,2
26856,60,5448,1093;13715,5475,0,0,1,1,2
26857,60,5449,987;3045,5475,0,0,0,2,2
26858,60,5451,1584;12937,5475,0,0,1,1,2
26859,60,5452,349;6112,5475,0,0,0,2,2
26860,60,5456,1575;5232,5475,0,0,0,2,2
26861,60,5457,2059,5475,0,0,0,1,1
26862,60,5458,5850,5475,0,0,0,1,1
26863,60,5460,11441;11823;12513;13229;15656;15939;16023;16850,5475,0,3,5,0,8
26864,60,5462,2146;2268,5475,0,0,0,2,2
26865,60,5463,574;2159,5475,0,0,1,1,2
26866,60,5466,2499;6108,5475,0,0,0,2,2
26867,60,5468,1451;2948,5475,0,0,0,2,2
26868,60,5471,3359;9082,5475,0,0,0,2,2
26869,60,5472,7119,5475,0,0,0,1,1
26870,60,5473,3504;3530,5475,0,0,0,2,2
26871,60,5475,3586;3639,5475,0,0,0,2,2
26872,60,5476,3794;5241,5475,0,0,0,2,2
26873,60,5478,5190;6117;12430,5475,0,0,1,2,3
26874,60,5482,1147;4736,5475,0,0,0,2,2
26875,60,5486,1706;6675,5475,0,0,0,2,2
26876,60,5487,5170;5196,5475,0,0,0,2,2
26877,60,5488,4140,5475,0,0,0,1,1
26878,60,5490,5526,5475,0,0,0,1,1
26879,60,5494,9765;9849,5475,0,0,2,0,2
26880,60,5497,6187;8010,5475,0,0,0,2,2
26881,60,5500,2481;6743;11997,5475,0,0,1,2,3
26882,60,5501,2964;7766,5475,0,0,2,0,2
26883,60,5502,9776,5475,0,0,0,1,1
26884,60,5505,5985;7156;13582;13855,5475,0,0,2,2,4
26885,60,5508,4074;7383,5475,0,0,1,1,2
26886,60,5510,7520;8376,5475,0,0,0,2,2
26887,60,5512,50;7323;12327;13600,5475,0,0,2,2,4
26888,60,5517,1571;8273,5475,0,0,0,2,2
26889,60,5518,5787;8365,5475,0,0,0,2,2
26890,60,5521,3475;8556,5475,0,0,0,2,2
26891,60,5522,3214;5441,5475,0,0,0,2,2
26892,60,5527,8785,5475,0,0,0,1,1
26893,60,5532,2027;6857,5475,0,0,0,2,2
26894,60,5533,9215,5475,0,0,0,1,1
26895,60,5535,1565;2976;13026,5475,0,0,3,0,3
26896,60,5539,26,5475,0,0,0,1,1
26897,60,5540,1450,5475,0,0,0,1,1
26898,60,5543,61;8703;13118,5840,0,0,2,1,3
26899,60,5544,250;838;12939,5840,0,0,1,2,3
26900,60,5545,79;277,5840,0,0,0,2,2
26901,60,5546,367,5840,0,0,0,1,1
26902,60,5548,1467;3969,5840,0,0,0,2,2
26903,60,5549,632;2250,5840,0,0,0,2,2
26904,60,5553,1266;4571,5840,0,0,0,2,2
26905,60,5554,1267;5449;13837;13962,5840,0,0,3,1,4
26906,60,5555,319;8324,5840,0,0,0,2,2
26907,60,5556,3403;4385,5840,0,0,2,0,2
26908,60,5557,326;1649,5840,0,0,0,2,2
26909,60,5559,674;8038;12315,5840,0,0,1,2,3
26910,60,5560,5128,5840,0,0,0,1,1
26911,60,5561,2389;6632,5840,0,0,1,1,2
26912,60,5563,2694;4856,5840,0,0,0,2,2
26913,60,5564,163;1803,5840,0,0,0,2,2
26914,60,5567,2580,5840,0,0,0,1,1
26915,60,5569,2965;10100,5840,0,0,2,0,2
26916,60,5571,8278;13530,5840,0,0,2,0,2
26917,60,5573,1388;3156,5840,0,0,2,0,2
26918,60,5574,2910;4337,5840,0,0,2,0,2
26919,60,5580,1157,5840,0,0,0,1,1
26920,60,5581,9364,5840,0,0,0,1,1
26921,60,5582,5521,5840,0,0,1,0,1
26922,60,5583,10073,5840,0,0,1,0,1
26923,60,5584,4634,5840,0,0,1,0,1
26924,60,5585,2015;14002,5840,0,0,2,0,2
26925,60,5591,5666,5840,0,0,0,1,1
26926,60,5600,6809;9735,5840,0,0,2,0,2
26927,60,5601,7054,5840,0,0,1,0,1
26928,60,5603,1107;6839;13070;13251,5840,0,0,4,0,4
26929,60,5607,2085,5840,0,0,1,0,1
26930,60,5608,5937;5962,5840,0,0,1,1,2
26931,60,5609,5202;5860;13854,5840,0,0,1,2,3
26932,60,5610,7789;12493,5840,0,0,2,0,2
26933,60,5611,7193;9418,5840,0,0,0,2,2
26934,60,5612,7818,5840,0,0,0,1,1
26935,60,5615,4617;8047,5840,0,0,1,1,2
26936,60,5617,4057;8302;15750,5840,0,1,1,1,3
26937,60,5618,7867,5840,0,0,0,1,1
26938,60,5620,9676,5840,0,0,0,1,1
26939,60,5624,5134;7128,5840,0,0,0,2,2
26940,60,5626,5809,5840,0,0,0,1,1
26941,60,5627,9069;9506;13444,5840,0,0,2,1,3
26942,60,5628,9596;9608,5840,0,0,0,2,2
26943,60,5629,2330;9654,5840,0,0,0,2,2
26944,60,5630,1096;4034,5840,0,0,0,2,2
26945,60,5631,44;8612,6205,0,0,2,0,2
26946,60,5632,2063;6212,6205,0,0,2,0,2
26947,60,5633,219;8494,6205,0,0,1,1,2
26948,60,5635,665;7555;14391,6205,0,0,2,1,3
26949,60,5638,4950;5799;13346,6205,0,0,1,2,3
26950,60,5639,1284;6363,6205,0,0,2,0,2
26951,60,5640,10038,6205,0,0,1,0,1
26952,60,5641,1158;10204,6205,0,0,2,0,2
26953,60,5642,1428;5032,6205,0,0,2,0,2
26954,60,5643,1700;4845,6205,0,0,2,0,2
26955,60,5648,1667;2539,6205,0,0,1,1,2
26956,60,5649,8616,6205,0,0,0,1,1
26957,60,5650,1305;10044;13232,6205,0,0,2,1,3
26958,60,5651,2339;10055,6205,0,0,2,0,2
26959,60,5654,804;2545;14351,6205,0,0,2,1,3
26960,60,5655,6001;6207,6205,0,0,0,2,2
26961,60,5656,2741,6205,0,0,0,1,1
26962,60,5657,2369;3601,6205,0,0,1,1,2
26963,60,5661,7191,6205,0,0,0,1,1
26964,60,5662,3071;10060,6205,0,0,2,0,2
26965,60,5663,3107;9063,6205,0,0,0,2,2
26966,60,5665,494;10201;13995,6205,0,0,3,0,3
26967,60,5666,720;3281,6205,0,0,0,2,2
26968,60,5673,440;4257,6205,0,0,0,2,2
26969,60,5674,10180,6205,0,0,1,0,1
26970,60,5676,2234,6205,0,0,1,0,1
26971,60,5680,4833;7037,6205,0,0,2,0,2
26972,60,5683,4106,6205,0,0,1,0,1
26973,60,5685,5297,6205,0,0,0,1,1
26974,60,5686,5480;7304,6205,0,0,1,1,2
26975,60,5688,5186;5642,6205,0,0,1,1,2
26976,60,5692,5992;8052,6205,0,0,2,0,2
26977,60,5693,5969,6205,0,0,0,1,1
26978,60,5694,6554;6885,6205,0,0,0,2,2
26979,60,5699,5228,6205,0,0,1,0,1
26980,60,5700,6529,6205,0,0,0,1,1
26981,60,5702,4680;6692,6205,0,0,0,2,2
26982,60,5703,1630;6967,6205,0,0,0,2,2
26983,60,5706,10054,6205,0,0,1,0,1
26984,60,5707,7466;9571,6205,0,0,0,2,2
26985,60,5708,3388;7510;13525,6205,0,0,2,1,3
26986,60,5709,7634;9827,6205,0,0,2,0,2
26987,60,5711,8092;8144,6205,0,0,0,2,2
26988,60,5712,430;1288,6205,0,0,0,2,2
26989,60,5713,466,6205,0,0,0,1,1
26990,60,5714,3811,6205,0,0,0,1,1
26991,60,5716,945;8642,6205,0,0,0,2,2
26992,60,5717,4959;8885,6205,0,0,1,1,2
26993,60,5719,93;9626,6205,0,0,2,0,2
26994,60,5720,2142;6601,6205,0,0,0,2,2
26995,60,5722,9389;9400;12802,6205,0,0,1,2,3
26996,60,5723,6421,6205,0,0,0,1,1
26997,60,5724,9606;14445,6205,0,0,1,1,2
26998,60,5725,7794,6205,0,0,1,0,1
26999,60,5726,9741,6205,0,0,1,0,1
27000,60,5729,135;9728;13731,6570,0,0,1,2,3
27001,60,5732,10118,6570,0,0,1,0,1
27002,60,5733,4023;10174,6570,0,0,2,0,2
27003,60,5734,14712,6570,0,0,1,0,1
27004,60,5739,10042,6570,0,0,1,0,1
27005,60,5740,1242,6570,0,0,1,0,1
27006,60,5742,7307;8332,6570,0,0,0,2,2
27007,60,5743,1308;10006,6570,0,0,2,0,2
27008,60,5746,1538;12403,6570,0,0,2,0,2
27009,60,5747,1564;9150;13587,6570,0,0,3,0,3
27010,60,5751,10080;14677,6570,0,0,2,0,2
27011,60,5752,1721,6570,0,0,1,0,1
27012,60,5753,1726,6570,0,0,0,1,1
27013,60,5760,6382;10088,6570,0,0,2,0,2
27014,60,5762,6088;14325,6570,0,0,1,1,2
27015,60,5763,3003,6570,0,0,0,1,1
27016,60,5767,3377;6289,6570,0,0,0,2,2
27017,60,5768,477;3578;14257,6570,0,0,2,1,3
27018,60,5771,1775;7464,6570,0,0,0,2,2
27019,60,5773,4633;13780,6570,0,0,1,1,2
27020,60,5774,4694;6660,6570,0,0,0,2,2
27021,60,5776,6003;10167;13769,6570,0,0,2,1,3
27022,60,5778,5442;6603,6570,0,0,0,2,2
27023,60,5781,4368;8375;12860,6570,0,0,1,2,3
27024,60,5785,6197;9773,6570,0,0,0,2,2
27025,60,5786,4832;7665,6570,0,0,1,1,2
27026,60,5787,461;9099,6570,0,0,2,0,2
27027,60,5791,4093;8967;13876,6570,0,0,2,1,3
27028,60,5793,1236;7121,6570,0,0,0,2,2
27029,60,5796,1468;10112;14627,6570,0,0,3,0,3
27030,60,5798,2354;7762,6570,0,0,1,1,2
27031,60,5799,7765;10229,6570,0,0,2,0,2
27032,60,5800,546;10084;13844,6570,0,0,3,0,3
27033,60,5802,119;8051,6570,0,0,0,2,2
27034,60,5806,2256;8396,6570,0,0,0,2,2
27035,60,5807,1493;10063;13917,6570,0,0,3,0,3
27036,60,5812,57;8220,6570,0,0,0,2,2
27037,60,5813,5991;9425,6570,0,0,1,1,2
27038,60,5815,4704;9655;12752;14312,6570,0,0,4,0,4
27039,60,5819,476,6935,0,0,0,1,1
27040,60,5820,3874;10069,6935,0,0,2,0,2
27041,60,5821,5890;7402,6935,0,0,1,1,2
27042,60,5824,6344,6935,0,0,0,1,1
27043,60,5825,3748,6935,0,0,0,1,1
27044,60,5827,9420,6935,0,0,0,1,1
27045,60,5831,1371;6920,6935,0,0,0,2,2
27046,60,5833,10048;10138,6935,0,0,2,0,2
27047,60,5835,2121,6935,0,0,1,0,1
27048,60,5836,5643;10223,6935,0,0,2,0,2
27049,60,5837,2245,6935,0,0,0,1,1
27050,60,5839,8697;10145,6935,0,0,2,0,2
27051,60,5840,10030;13022,6935,0,0,2,0,2
27052,60,5843,3375,6935,0,0,0,1,1
27053,60,5845,545;3126,6935,0,0,2,0,2
27054,60,5846,4448;10037,6935,0,0,1,1,2
27055,60,5850,218;10074,6935,0,0,2,0,2
27056,60,5851,7808,6935,0,0,0,1,1
27057,60,5854,3127;5301,6935,0,0,1,1,2
27058,60,5858,8418,6935,0,0,1,0,1
27059,60,5859,5231,6935,0,0,0,1,1
27060,60,5860,10017;10287;14387,6935,0,0,3,0,3
27061,60,5861,2765;9946,6935,0,0,0,2,2
27062,60,5862,5097;7994,6935,0,0,1,1,2
27063,60,5863,5258;10158,6935,0,0,2,0,2
27064,60,5865,960;5367,6935,0,0,2,0,2
27065,60,5867,5630;7310;13246;13599,6935,0,0,3,1,4
27066,60,5871,10005;10132,6935,0,0,2,0,2
27067,60,5872,4752;6331,6935,0,0,1,1,2
27068,60,5873,169;6443,6935,0,0,1,1,2
27069,60,5875,6469;15616,6935,0,0,2,0,2
27070,60,5877,7444;8553,6935,0,0,1,1,2
27071,60,5883,3725,6935,0,0,0,1,1
27072,60,5885,3886;7439,6935,0,0,1,1,2
27073,60,5888,3731;7550,6935,0,0,0,2,2
27074,60,5890,9197,6935,0,0,1,0,1
27075,60,5891,7927;9692,6935,0,0,0,2,2
27076,60,5894,2971;4600,6935,0,0,0,2,2
27077,60,5895,7097;10237,6935,0,0,1,1,2
27078,60,5900,5917;10186,6935,0,0,1,1,2
27079,60,5901,982,6935,0,0,0,1,1
27080,60,5902,10046;10062,6935,0,0,2,0,2
27081,60,5905,217;9680,6935,0,0,0,2,2
27082,60,5906,4868;10206;15962,6935,0,1,2,0,3
27083,60,5908,10022;10210;13798,6935,0,0,3,0,3
27084,60,5909,3820;10029,6935,0,0,2,0,2
27085,60,5910,10033;10362,6935,0,0,2,0,2
27086,60,5911,10089;10188,6935,0,0,2,0,2
27087,60,5912,10056;10297,6935,0,0,2,0,2
27088,60,5914,10099;10109,6935,0,0,2,0,2
27089,60,5915,386;10108,6935,0,0,2,0,2
27090,60,5916,10481;15304,6935,0,0,2,0,2
27091,60,5918,10183;14114;14742,7300,0,0,3,0,3
27092,60,5919,511;8470;13075,7300,0,0,1,2,3
27093,60,5921,562;9927,7300,0,0,2,0,2
27094,60,5923,4714;6407,7300,0,0,0,2,2
27095,60,5926,1162;5420,7300,0,0,0,2,2
27096,60,5927,1452;2689,7300,0,0,0,2,2
27097,60,5928,3337;5390,7300,0,0,0,2,2
27098,60,5930,2361;10401;14338,7300,0,0,3,0,3
27099,60,5934,3146;5479,7300,0,0,1,1,2
27100,60,5935,1045;10008,7300,0,0,2,0,2
27101,60,5943,7163,7300,0,0,1,0,1
27102,60,5946,4544;9887,7300,0,0,2,0,2
27103,60,5949,505;4735,7300,0,0,0,2,2
27104,60,5950,4851;10057,7300,0,0,2,0,2
27105,60,5955,5726;7176;12986,7300,0,0,1,2,3
27106,60,5957,5798;5968,7300,0,0,0,2,2
27107,60,5958,7732;8624,7300,0,0,0,2,2
27108,60,5959,1682;6702,7300,0,0,2,0,2
27109,60,5961,6995;12424,7300,0,0,1,1,2
27110,60,5964,4677;7172;12455;12794,7300,0,0,3,1,4
27111,60,5968,7481;10097,7300,0,0,2,0,2
27112,60,5970,8255,7300,0,0,0,1,1
27113,60,5971,5436,7300,0,0,1,0,1
27114,60,5972,9211;14182,7300,0,0,2,0,2
27115,60,5974,5580,7300,0,0,0,1,1
27116,60,5975,2247,7300,0,0,0,1,1
27117,60,5977,5788;7521,7300,0,0,0,2,2
27118,60,5980,6015;9749,7300,0,0,2,0,2
27119,60,5983,10082;10320,7300,0,0,2,0,2
27120,60,5984,10252,7300,0,0,1,0,1
27121,60,5985,10058;10519,7300,0,0,2,0,2
27122,60,5986,6085;10220;13443,7300,0,0,3,0,3
27123,60,5987,10142;13884;14046,7300,0,0,3,0,3
27124,60,5989,10187,7300,0,0,1,0,1
27125,60,5993,10160;10255;14346,7665,0,0,3,0,3
27126,60,5994,512;1604,7665,0,0,0,2,2
27127,60,5995,1623;8409,7665,0,0,2,0,2
27128,60,6000,5105;7394,7665,0,0,0,2,2
27129,60,6003,3952;10217,7665,0,0,1,1,2
27130,60,6005,2620;4955;13655;14336,7665,0,0,2,2,4
27131,60,6007,2707,7665,0,0,0,1,1
27132,60,6008,2876;10280;14410,7665,0,0,3,0,3
27133,60,6009,10306;15270;15573,7665,0,0,3,0,3
27134,60,6011,2788,7665,0,0,0,1,1
27135,60,6012,2920;3591,7665,0,0,2,0,2
27136,60,6013,4271;9227;13082,7665,0,0,1,2,3
27137,60,6017,4755;8421,7665,0,0,1,1,2
27138,60,6018,6836,7665,0,0,0,1,1
27139,60,6020,5161;5310;14806,7665,0,0,3,0,3
27140,60,6022,4229,7665,0,0,1,0,1
27141,60,6023,5437;6114,7665,0,0,1,1,2
27142,60,6024,5598,7665,0,0,0,1,1
27143,60,6029,8698,7665,0,0,1,0,1
27144,60,6032,7698;8573;12583,7665,0,0,1,2,3
27145,60,6048,137,7665,0,0,0,1,1
27146,60,6050,1486;9078,7665,0,0,0,2,2
27147,60,6056,10431;13609,7665,0,0,2,0,2
27148,60,6057,10014;10340,7665,0,0,2,0,2
27149,60,6058,10016;10395;14632,7665,0,0,3,0,3
27150,60,6059,3481;10209,7665,0,0,2,0,2
27151,60,6061,10086;10230;14508,7665,0,0,3,0,3
27152,60,6062,8877;10178;14356,7665,0,0,3,0,3
27153,60,6063,10361;10394;14686,7665,0,0,3,0,3
27154,60,6064,10127;10141,7665,0,0,2,0,2
27155,60,6067,10171;10448;14345,7665,0,0,3,0,3
27156,60,6069,10522,7665,0,0,1,0,1
27157,60,6070,10254;10583,7665,0,0,2,0,2
27158,60,6071,10261;10440;15225,7665,0,0,3,0,3
27159,60,6072,10265;10483;14440;14641,7665,0,0,4,0,4
27160,60,6073,10104;10567;14544,7665,0,0,3,0,3
27161,60,6074,10275;10391,7665,0,0,2,0,2
27162,60,6075,10047;10505;13113,7665,0,0,3,0,3
27163,60,6076,7295;10197,7665,0,0,2,0,2
27164,60,6077,10298;10321;13520;14273;14620,7665,0,0,5,0,5
27165,60,6078,10233;10307;13454,7665,0,0,3,0,3
27166,60,6079,10135;10311,7665,0,0,2,0,2
27167,60,6080,320;5064;14497,8030,0,0,1,2,3
27168,60,6083,7621,8030,0,0,0,1,1
27169,60,6084,5100,8030,0,0,0,1,1
27170,60,6087,2360;3246;13120,8030,0,0,2,1,3
27171,60,6090,795;8149,8030,0,0,0,2,2
27172,60,6095,2879,8030,0,0,0,1,1
27173,60,6096,3395,8030,0,0,0,1,1
27174,60,6098,3029,8030,0,0,0,1,1
27175,60,6099,3612;5024,8030,0,0,0,2,2
27176,60,6102,4235;10380,8030,0,0,2,0,2
27177,60,6103,8249,8030,0,0,0,1,1
27178,60,6104,10557;10700,8030,0,0,2,0,2
27179,60,6105,4370,8030,0,0,0,1,1
27180,60,6107,932,8030,0,0,0,1,1
27181,60,6110,6393;10003,8030,0,0,2,0,2
27182,60,6111,1889,8030,0,0,0,1,1
27183,60,6112,6309,8030,0,0,1,0,1
27184,60,6115,10093,8030,0,0,1,0,1
27185,60,6118,8591,8030,0,0,0,1,1
27186,60,6119,6155;8638,8030,0,0,0,2,2
27187,60,6120,4854;8641,8030,0,0,0,2,2
27188,60,6121,2996;8688;13614,8030,0,0,1,2,3
27189,60,6126,10545;13869,8030,0,0,2,0,2
27190,60,6127,4456;10051;14185,8030,0,0,3,0,3
27191,60,6128,10053;10090,8030,0,0,2,0,2
27192,60,6129,10081;10246;14949,8030,0,0,3,0,3
27193,60,6130,10302;10433;12872,8030,0,0,3,0,3
27194,60,6131,10101;10119;13572,8030,0,0,3,0,3
27195,60,6132,10215;13333;13622,8030,0,0,3,0,3
27196,60,6134,10192;14599,8030,0,0,2,0,2
27197,60,6135,1050;10211,8030,0,0,2,0,2
27198,60,6136,10535,8030,0,0,1,0,1
27199,60,6137,10239;10454;15044;15350,8030,0,0,4,0,4
27200,60,6138,10618,8030,0,0,1,0,1
27201,60,6139,10259;10640;14479,8030,0,0,3,0,3
27202,60,6141,10679;14783,8030,0,0,2,0,2
27203,60,6142,10276;10653;15029,8030,0,0,3,0,3
27204,60,6143,10278;10582,8030,0,0,2,0,2
27205,60,6144,10281;10296,8030,0,0,2,0,2
27206,60,6145,10634;10714;13960,8030,0,0,3,0,3
27207,60,6146,10126;10269,8030,0,0,2,0,2
27208,60,6147,10471;15559,8030,0,0,2,0,2
27209,60,6148,10113;10347,8030,0,0,2,0,2
27210,60,6149,10566;15147,8030,0,0,2,0,2
27211,60,6150,10195;10390,8030,0,0,2,0,2
27212,60,6151,10170;10383;13940,8030,0,0,3,0,3
27213,60,6152,10386;10719;14766,8030,0,0,3,0,3
27214,60,6153,10389;10463;14160;14610;15565,8030,0,0,5,0,5
27215,60,6154,10203;14880,8030,0,0,2,0,2
27216,60,6155,10432;10721;15069;15741,8030,0,1,3,0,4
27217,60,6156,6262,8395,0,0,1,0,1
27218,60,6157,2810,8395,0,0,0,1,1
27219,60,6159,10513;10644,8395,0,0,2,0,2
27220,60,6160,1231;5040,8395,0,0,1,1,2
27221,60,6163,2089,8395,0,0,0,1,1
27222,60,6166,1797,8395,0,0,0,1,1
27223,60,6167,652;5738,8395,0,0,1,1,2
27224,60,6169,5522;10012,8395,0,0,2,0,2
27225,60,6171,3366;6348;13650,8395,0,0,3,0,3
27226,60,6173,8237,8395,0,0,0,1,1
27227,60,6174,4219,8395,0,0,0,1,1
27228,60,6179,4543,8395,0,0,0,1,1
27229,60,6182,10150;10353,8395,0,0,2,0,2
27230,60,6189,7575,8395,0,0,0,1,1
27231,60,6192,8008,8395,0,0,0,1,1
27232,60,6193,9514,8395,0,0,1,0,1
27233,60,6194,2701;8111,8395,0,0,1,1,2
27234,60,6195,5627,8395,0,0,0,1,1
27235,60,6196,8474;14451,8395,0,0,1,1,2
27236,60,6197,3267;5710,8395,0,0,1,1,2
27237,60,6199,5814,8395,0,0,1,0,1
27238,60,6205,4956;10256;14562,8395,0,0,3,0,3
27239,60,6206,10091;10314,8395,0,0,2,0,2
27240,60,6207,10140;10200;14626,8395,0,0,3,0,3
27241,60,6208,10551;10753;15287,8395,0,0,3,0,3
27242,60,6209,10516;13464;14581;15037,8395,0,0,4,0,4
27243,60,6210,10072;10258,8395,0,0,2,0,2
27244,60,6211,10262;10279,8395,0,0,2,0,2
27245,60,6212,10272;10506,8395,0,0,2,0,2
27246,60,6213,10665;10728;15313,8395,0,0,3,0,3
27247,60,6214,1359;10228;14300,8395,0,0,3,0,3
27248,60,6215,10738;13086,8395,0,0,2,0,2
27249,60,6216,10202;10350;14260,8395,0,0,3,0,3
27250,60,6218,10415;10604,8395,0,0,2,0,2
27251,60,6219,10418;10435;14295,8395,0,0,3,0,3
27252,60,6220,10318;10656;13482;15382;15581,8395,0,0,5,0,5
27253,60,6221,10465;10879;14375,8395,0,0,3,0,3
27254,60,6222,10781,8395,0,0,1,0,1
27255,60,6223,10333;10455,8395,0,0,2,0,2
27256,60,6224,10291;10495;15404;15586,8395,0,0,4,0,4
27257,60,6225,10657;14010,8395,0,0,2,0,2
27258,60,6227,2896;10548;13953,8395,0,0,3,0,3
27259,60,6230,10079;10208,8760,0,0,2,0,2
27260,60,6237,3472;10227,8760,0,0,2,0,2
27261,60,6238,873;6765,8760,0,0,0,2,2
27262,60,6239,2176;5459,8760,0,0,1,1,2
27263,60,6243,1973;2534;14726,8760,0,0,1,2,3
27264,60,6244,2233;3055,8760,0,0,2,0,2
27265,60,6245,3108;7311,8760,0,0,0,2,2
27266,60,6249,5047,8760,0,0,0,1,1
27267,60,6250,3600;3615,8760,0,0,0,2,2
27268,60,6252,8711,8760,0,0,0,1,1
27269,60,6253,56;4700,8760,0,0,1,1,2
27270,60,6256,1031;5409,8760,0,0,0,2,2
27271,60,6258,6159,8760,0,0,1,0,1
27272,60,6262,6217,8760,0,0,0,1,1
27273,60,6263,3735;7315,8760,0,0,1,1,2
27274,60,6264,1618,8760,0,0,1,0,1
27275,60,6265,6272;6642,8760,0,0,2,0,2
27276,60,6269,11;1360;14148,8760,0,0,2,1,3
27277,60,6274,625;2747,8760,0,0,0,2,2
27278,60,6275,7493,8760,0,0,0,1,1
27279,60,6280,10488,8760,0,0,1,0,1
27280,60,6281,10381;10422;15464,8760,0,0,3,0,3
27281,60,6282,10617;10724;14809,8760,0,0,3,0,3
27282,60,6283,10071;10587,8760,0,0,2,0,2
27283,60,6284,10253,8760,0,0,1,0,1
27284,60,6285,10096;10474,8760,0,0,2,0,2
27285,60,6286,10331;10374;14308;15023,8760,0,0,4,0,4
27286,60,6288,10032;10627,8760,0,0,2,0,2
27287,60,6290,10066;10720;14953;15312;15968,8760,0,1,4,0,5
27288,60,6291,10117;10198,8760,0,0,2,0,2
27289,60,6292,3241;10163;14416,8760,0,0,3,0,3
27290,60,6293,3318;9764,8760,0,0,1,1,2
27291,60,6294,10098;10250,8760,0,0,2,0,2
27292,60,6295,10078;10292,8760,0,0,2,0,2
27293,60,6296,10299;13665,8760,0,0,2,0,2
27294,60,6297,9563;10338,8760,0,0,2,0,2
27295,60,6298,10475;10697;14360;15495,8760,0,0,4,0,4
27296,60,6299,10341;10652,8760,0,0,2,0,2
27297,60,6300,10052;10358,8760,0,0,2,0,2
27298,60,6301,2476;10357;13679;15453,8760,0,0,4,0,4
27299,60,6302,10241;10364;14663,8760,0,0,3,0,3
27300,60,6303,10377;13069;13296,8760,0,0,3,0,3
27301,60,6304,10408;10650,8760,0,0,2,0,2
27302,60,6305,10020;10625;14728,8760,0,0,3,0,3
27303,60,6306,10907;13531;14698,8760,0,0,3,0,3
27304,60,6307,10346;10710,8760,0,0,2,0,2
27305,60,6308,10470;13832;14628,8760,0,0,3,0,3
27306,60,6309,10244;10709;14737;15036,8760,0,0,4,0,4
27307,60,6310,10193;10532;14510,8760,0,0,3,0,3
27308,60,6311,10434;10613,8760,0,0,2,0,2
27309,60,6312,10682;10694;14307,8760,0,0,3,0,3
27310,60,6313,10336;10558;15206,8760,0,0,3,0,3
27311,60,6314,10143;10572,8760,0,0,2,0,2
27312,60,6315,10599;10865;14199,8760,0,0,3,0,3
27313,60,6316,10547;10602;16172,8760,0,1,2,0,3
27314,60,6317,10899,8760,0,0,1,0,1
27315,60,6318,10179;15542;15804,8760,0,1,2,0,3
27316,60,6334,8879,9125,0,0,0,1,1
27317,60,6339,89;3118,9125,0,0,1,1,2
27318,60,6340,1668;6991,9125,0,0,2,0,2
27319,60,6342,421;3798,9125,0,0,0,2,2
27320,60,6347,247;3078,9125,0,0,0,2,2
27321,60,6350,2264,9125,0,0,0,1,1
27322,60,6353,10199;10304,9125,0,0,2,0,2
27323,60,6355,5394,9125,0,0,0,1,1
27324,60,6359,3424;9161,9125,0,0,1,1,2
27325,60,6360,8502,9125,0,0,0,1,1
27326,60,6363,9169,9125,0,0,0,1,1
27327,60,6365,10036;14701,9125,0,0,2,0,2
27328,60,6366,10586;10702;13987;14246,9125,0,0,4,0,4
27329,60,6367,10363;14907,9125,0,0,2,0,2
27330,60,6368,2975;10075,9125,0,0,2,0,2
27331,60,6369,10866;13896;15491,9125,0,0,3,0,3
27332,60,6371,10168;10310;13898,9125,0,0,3,0,3
27333,60,6372,10286;10575;15089,9125,0,0,3,0,3
27334,60,6373,10717;14258,9125,0,0,2,0,2
27335,60,6374,10300;10319;15399,9125,0,0,3,0,3
27336,60,6375,10040;10213,9125,0,0,2,0,2
27337,60,6376,10218;10510;14094,9125,0,0,3,0,3
27338,60,6377,10274;10379,9125,0,0,2,0,2
27339,60,6378,10083;10236,9125,0,0,2,0,2
27340,60,6379,10282;14823,9125,0,0,2,0,2
27341,60,6380,10131;10356,9125,0,0,2,0,2
27342,60,6381,10873;14253;15207,9125,0,0,3,0,3
27343,60,6382,10335;10570;15623,9125,0,0,3,0,3
27344,60,6383,10324;10403,9125,0,0,2,0,2
27345,60,6384,10148;10387;15050,9125,0,0,3,0,3
27346,60,6385,10264;10388;14515;15071,9125,0,0,4,0,4
27347,60,6386,7856;10360;13964,9125,0,0,3,0,3
27348,60,6387,10398;10755;15427;15472;15649,9125,0,0,5,0,5
27349,60,6388,10166;10416;13781,9125,0,0,3,0,3
27350,60,6389,10293;10511;13596;15216,9125,0,0,4,0,4
27351,60,6390,10219;10436,9125,0,0,2,0,2
27352,60,6391,10910;11034;14974;15874,9125,0,1,3,0,4
27353,60,6392,10153;10457;14541;14878,9125,0,0,4,0,4
27354,60,6393,10466;10541;14633,9125,0,0,3,0,3
27355,60,6394,10690;10816;15753;15894,9125,0,2,2,0,4
27356,60,6395,10666;10961,9125,0,0,2,0,2
27357,60,6396,10257;10486;14900,9125,0,0,3,0,3
27358,60,6397,10460;10770,9125,0,0,2,0,2
27359,60,6398,10352;10509;13630;15588,9125,0,0,4,0,4
27360,60,6399,10553;10952;14066,9125,0,0,3,0,3
27361,60,6401,10526;14637,9125,0,0,2,0,2
27362,60,6402,10378;10527,9125,0,0,2,0,2
27363,60,6403,10312;10540,9125,0,0,2,0,2
27364,60,6405,10349;10568;15686,9125,0,1,2,0,3
27365,60,6406,10172;10574;14965,9125,0,0,3,0,3
27366,60,6408,10039;10600,9125,0,0,2,0,2
27367,60,6409,10821,9125,0,0,1,0,1
27368,60,6410,10234;10612;14756;15337;15887,9125,0,1,4,0,5
27369,60,6411,10544;10621,9125,0,0,2,0,2
27370,60,6413,10691;10919;14390,9125,0,0,3,0,3
27371,60,6414,10507;10659;14799,9125,0,0,3,0,3
27372,60,6415,10795;14774,9125,0,0,2,0,2
27373,60,6416,10641;10881,9125,0,0,2,0,2
27374,60,6417,10680;10743,9125,0,0,2,0,2
27375,60,6418,10681;10895;15881,9125,0,1,2,0,3
27376,60,6419,10730;10769;14671;15640,9125,0,0,4,0,4
27377,60,6420,10745;11011;15440,9125,0,0,3,0,3
27378,60,6421,10708;10763;14100,9125,0,0,3,0,3
27379,60,6423,228;10024;14672,9490,0,0,2,1,3
27380,60,6424,6481;8814,9490,0,0,0,2,2
27381,60,6429,2396;9056,9490,0,0,1,1,2
27382,60,6430,1432;3046;13360,9490,0,0,3,0,3
27383,60,6431,3058,9490,0,0,1,0,1
27384,60,6432,7197,9490,0,0,0,1,1
27385,60,6442,2784;6461,9490,0,0,1,1,2
27386,60,6445,7216,9490,0,0,0,1,1
27387,60,6449,2598,9490,0,0,1,0,1
27388,60,6452,7098;7443,9490,0,0,1,1,2
27389,60,6454,5402;13843,9490,0,0,1,1,2
27390,60,6459,8201;9751,9490,0,0,2,0,2
27391,60,6460,9232,9490,0,0,0,1,1
27392,60,6462,10672;14348;14968,9490,0,0,3,0,3
27393,60,6465,10151;10184;14473,9490,0,0,3,0,3
27394,60,6466,10438;10654;13811,9490,0,0,3,0,3
27395,60,6467,10323;10578;15008,9490,0,0,3,0,3
27396,60,6468,10523;10900;15374,9490,0,0,3,0,3
27397,60,6469,10116;10305,9490,0,0,2,0,2
27398,60,6470,10496;14877,9490,0,0,2,0,2
27399,60,6471,10330;10607;15149,9490,0,0,3,0,3
27400,60,6472,10332;10631;14272;15759,9490,0,1,3,0,4
27401,60,6473,9247;10502;13653,9490,0,0,3,0,3
27402,60,6474,10249;10411;13849,9490,0,0,3,0,3
27403,60,6475,10645;10658;14023;14422;15554,9490,0,0,5,0,5
27404,60,6476,10590;10635;15571,9490,0,0,3,0,3
27405,60,6477,10838,9490,0,0,1,0,1
27406,60,6479,10190;10484,9490,0,0,2,0,2
27407,60,6480,10489;10967;15119,9490,0,0,3,0,3
27408,60,6481,10595;11093;15425,9490,0,0,3,0,3
27409,60,6482,4535;10182,9490,0,0,2,0,2
27410,60,6483,10092;10610,9490,0,0,2,0,2
27411,60,6485,10537;10898,9490,0,0,2,0,2
27412,60,6486,10944;14648,9490,0,0,2,0,2
27413,60,6487,10370;10669,9490,0,0,2,0,2
27414,60,6488,10569;10673;15159,9490,0,0,3,0,3
27415,60,6489,10642;14773,9490,0,0,2,0,2
27416,60,6490,10692;14092,9490,0,0,2,0,2
27417,60,6491,10407;10704,9490,0,0,2,0,2
27418,60,6492,10518;10619;14973,9490,0,0,3,0,3
27419,60,6493,10737;10869;15038,9490,0,0,3,0,3
27420,60,6494,10973;11202;15281,9490,0,0,3,0,3
27421,60,6495,10815;14644;15198,9490,0,0,3,0,3
27422,60,6496,10456;10832,9490,0,0,2,0,2
27423,60,6497,10803;11077;14630,9490,0,0,3,0,3
27424,60,6498,10760,9490,0,0,1,0,1
27425,60,6499,11000;11113,9490,0,0,2,0,2
27426,60,6500,11060;11175;15367;15615,9490,0,0,4,0,4
27427,60,6501,10913;13342,9490,0,0,2,0,2
27428,60,6502,11117;14989,9490,0,0,2,0,2
27429,60,6503,11038;11082;15458;16334,9490,0,1,3,0,4
27430,60,6504,10676,9490,0,0,1,0,1
27431,60,6505,10494;10884;14817,9490,0,0,3,0,3
27432,60,6508,3883;6192,9855,0,0,0,2,2
27433,60,6509,5553;8878,9855,0,0,0,2,2
27434,60,6511,3561;5260,9855,0,0,1,1,2
27435,60,6513,2918,9855,0,0,0,1,1
27436,60,6516,10031;10194,9855,0,0,2,0,2
27437,60,6532,5027;10010;14598,9855,0,0,2,1,3
27438,60,6535,8040;10111,9855,0,0,2,0,2
27439,60,6536,6002;10130,9855,0,0,2,0,2
27440,60,6541,6744;10491;15105,9855,0,0,3,0,3
27441,60,6542,2069;6805,9855,0,0,0,2,2
27442,60,6546,523,9855,0,0,0,1,1
27443,60,6547,2950;7040,9855,0,0,1,1,2
27444,60,6553,10133;10447,9855,0,0,2,0,2
27445,60,6554,2370,9855,0,0,1,0,1
27446,60,6556,10928;11115,9855,0,0,2,0,2
27447,60,6557,10247;10467;15397;15564,9855,0,0,4,0,4
27448,60,6560,10295;10329,9855,0,0,2,0,2
27449,60,6561,10159;10427;13744,9855,0,0,3,0,3
27450,60,6562,10451;10842,9855,0,0,2,0,2
27451,60,6564,10601;10622;15362,9855,0,0,3,0,3
27452,60,6566,1663;10624;14284;14616,9855,0,0,4,0,4
27453,60,6567,10699;10833;14332,9855,0,0,3,0,3
27454,60,6568,10735;10825;15486,9855,0,0,3,0,3
27455,60,6569,10742;11110,9855,0,0,2,0,2
27456,60,6570,10639;10777,9855,0,0,2,0,2
27457,60,6571,10687;10968,9855,0,0,2,0,2
27458,60,6572,11260;11319;13394;15614,9855,0,0,4,0,4
27459,60,6573,10754;10809;14645,9855,0,0,3,0,3
27460,60,6574,10734;14401;15940,9855,0,1,2,0,3
27461,60,6575,10834;11085;14874,9855,0,0,3,0,3
27462,60,6576,10851;11116,9855,0,0,2,0,2
27463,60,6577,10998,9855,0,0,1,0,1
27464,60,6578,10271;10889;15547,9855,0,0,3,0,3
27465,60,6579,10863;10893;14682;15346;16038,9855,0,1,4,0,5
27466,60,6580,10765;10896;14840,9855,0,0,3,0,3
27467,60,6581,11318;15530,9855,0,0,2,0,2
27468,60,6582,10571;10703,9855,0,0,2,0,2
27469,60,6583,10922;10927;14477,9855,0,0,3,0,3
27470,60,6584,10805,9855,0,0,1,0,1
27471,60,6585,10940;11044;15203,9855,0,0,3,0,3
27472,60,6586,10758;11216;15450;16293,9855,0,1,3,0,4
27473,60,6587,10911;15213,9855,0,0,2,0,2
27474,60,6588,10971;11252;15407,9855,0,0,3,0,3
27475,60,6589,10847;10975;14484;15042;15430,9855,0,0,5,0,5
27476,60,6590,10988;15252,9855,0,0,2,0,2
27477,60,6595,920,10220,0,0,0,1,1
27478,60,6597,1065,10220,0,0,0,1,1
27479,60,6599,5331;6336,10220,0,0,2,0,2
27480,60,6610,7050;9187;13711,10220,0,0,1,2,3
27481,60,6611,1199,10220,0,0,0,1,1
27482,60,6613,4629,10220,0,0,0,1,1
27483,60,6614,3111;3341,10220,0,0,2,0,2
27484,60,6619,6127,10220,0,0,1,0,1
27485,60,6624,8840,10220,0,0,1,0,1
27486,60,6628,2729;10326,10220,0,0,2,0,2
27487,60,6633,9825;9998,10220,0,0,0,2,2
27488,60,6634,6571;10011;14329,10220,0,0,3,0,3
27489,60,6636,10185,10220,0,0,1,0,1
27490,60,6637,10678;15077,10220,0,0,2,0,2
27491,60,6639,10288;10630;13534,10220,0,0,3,0,3
27492,60,6641,10147,10220,0,0,1,0,1
27493,60,6642,10359,10220,0,0,1,0,1
27494,60,6645,11078;15682,10220,0,1,1,0,2
27495,60,6647,10520,10220,0,0,1,0,1
27496,60,6649,10050;10552,10220,0,0,2,0,2
27497,60,6650,10580;10756;14642,10220,0,0,3,0,3
27498,60,6651,10400;10581,10220,0,0,2,0,2
27499,60,6652,10289;10636;15010,10220,0,0,3,0,3
27500,60,6653,10638;10883,10220,0,0,2,0,2
27501,60,6654,10668;10693;14635;14946,10220,0,0,4,0,4
27502,60,6655,10550;10980;14331,10220,0,0,3,0,3
27503,60,6656,10732;10912;14991,10220,0,0,3,0,3
27504,60,6657,10766;10937,10220,0,0,2,0,2
27505,60,6658,10779;14659;15199,10220,0,0,3,0,3
27506,60,6659,10794;15188;15236;15460,10220,0,0,4,0,4
27507,60,6660,10562;10796,10220,0,0,2,0,2
27508,60,6661,10683;10806;15321,10220,0,0,3,0,3
27509,60,6662,10807;13793;14638,10220,0,0,3,0,3
27510,60,6663,10446;10810,10220,0,0,2,0,2
27511,60,6664,10876;10920;15577,10220,0,0,3,0,3
27512,60,6665,10995;11410;14755,10220,0,0,3,0,3
27513,60,6666,10740;10942;13846,10220,0,0,3,0,3
27514,60,6667,10849;11062;15074;15707,10220,0,1,3,0,4
27515,60,6668,10991;14388,10220,0,0,2,0,2
27516,60,6669,10727;11041,10220,0,0,2,0,2
27517,60,6670,10956;11013;14631;14862,10220,0,0,4,0,4
27518,60,6671,11205;14280,10220,0,0,2,0,2
27519,60,6672,11247;15120;15335,10220,0,0,3,0,3
27520,60,6673,11035;11122;15060,10220,0,0,3,0,3
27521,60,6674,11051;15983,10220,0,1,1,0,2
27522,60,6675,11073;14835;15692,10220,0,1,2,0,3
27523,60,6676,11081;11192;15931;16044,10220,0,2,2,0,4
27524,60,6677,10915;11253,10220,0,0,2,0,2
27525,60,6679,617;7801,10585,0,0,0,2,2
27526,60,6681,10041;10248;13974,10585,0,0,3,0,3
27527,60,6686,1699;7920,10585,0,0,0,2,2
27528,60,6689,170,10585,0,0,0,1,1
27529,60,6698,8902,10585,0,0,0,1,1
27530,60,6699,10035;10139;14572,10585,0,0,3,0,3
27531,60,6706,3342,10585,0,0,0,1,1
27532,60,6709,182,10585,0,0,0,1,1
27533,60,6710,2751;8057,10585,0,0,2,0,2
27534,60,6713,3117,10585,0,0,0,1,1
27535,60,6715,2468,10585,0,0,0,1,1
27536,60,6717,10443;10473;14673,10585,0,0,3,0,3
27537,60,6718,3185;10177,10585,0,0,2,0,2
27538,60,6719,10225,10585,0,0,1,0,1
27539,60,6720,10317;10369,10585,0,0,2,0,2
27540,60,6721,10231;10277;14109,10585,0,0,3,0,3
27541,60,6724,10290;10316;14459,10585,0,0,3,0,3
27542,60,6725,10986,10585,0,0,1,0,1
27543,60,6726,10402,10585,0,0,1,0,1
27544,60,6727,10405;10504;13856,10585,0,0,3,0,3
27545,60,6728,10243;10410,10585,0,0,2,0,2
27546,60,6729,10417;10979;14681;15331,10585,0,0,4,0,4
27547,60,6730,10152;10458,10585,0,0,2,0,2
27548,60,6731,10462;14543;15104,10585,0,0,3,0,3
27549,60,6732,10068;10577;14342;14782,10585,0,0,4,0,4
27550,60,6733,10354;14373;14752,10585,0,0,3,0,3
27551,60,6734,10515;10829;15109;15699,10585,0,1,3,0,4
27552,60,6735,10301;10716;14707;15227,10585,0,0,4,0,4
27553,60,6736,10723;10870;15697;16253,10585,0,2,2,0,4
27554,60,6737,10731;10828;15747,10585,0,1,2,0,3
27555,60,6738,11097;11191;14377;14960,10585,0,0,4,0,4
27556,60,6739,10733,10585,0,0,1,0,1
27557,60,6742,10888;10926;14256,10585,0,0,3,0,3
27558,60,6743,10530;11043,10585,0,0,2,0,2
27559,60,6744,10917;11217;13685;15226,10585,0,0,4,0,4
27560,60,6745,10608;10970;14441,10585,0,0,3,0,3
27561,60,6746,10355;10985;14859,10585,0,0,3,0,3
27562,60,6747,11018;11186;15482,10585,0,0,3,0,3
27563,60,6748,10762;11032;16280,10585,0,1,2,0,3
27564,60,6749,10931;11039,10585,0,0,2,0,2
27565,60,6750,10957;11237;15724,10585,0,1,2,0,3
27566,60,6751,11070,10585,0,0,1,0,1
27567,60,6752,10827;11141;15348,10585,0,0,3,0,3
27568,60,6753,11146;11215;15904;15984;16453,10585,0,3,2,0,5
27569,60,6754,11497;15636;16015,10585,0,1,2,0,3
27570,60,6755,11055;11152;14912,10585,0,0,3,0,3
27571,60,6756,11164;11411;16678,10585,0,1,2,0,3
27572,60,6757,10901;11185,10585,0,0,2,0,2
27573,60,6758,11121;11206,10585,0,0,2,0,2
27574,60,6759,11156;11209;14534;15353,10585,0,0,4,0,4
27575,60,6765,9616,10950,0,0,0,1,1
27576,60,6767,2356,10950,0,0,0,1,1
27577,60,6770,10397;10412;14352,10950,0,0,3,0,3
27578,60,6774,2032;3679;13870,10950,0,0,2,1,3
27579,60,6779,48,10950,0,0,0,1,1
27580,60,6790,6911;10266;14347,10950,0,0,3,0,3
27581,60,6791,1890,10950,0,0,0,1,1
27582,60,6794,6560,10950,0,0,1,0,1
27583,60,6799,9620,10950,0,0,0,1,1
27584,60,6802,1044;10136,10950,0,0,2,0,2
27585,60,6806,1035;10165,10950,0,0,2,0,2
27586,60,6807,10308;10385,10950,0,0,2,0,2
27587,60,6808,10263;10437;14237;14592,10950,0,0,4,0,4
27588,60,6809,10426;10459,10950,0,0,2,0,2
27589,60,6810,10499,10950,0,0,1,0,1
27590,60,6811,10503,10950,0,0,1,0,1
27591,60,6812,10525;10904;14710;15129,10950,0,0,4,0,4
27592,60,6816,10597;11069;14415;16115,10950,0,1,3,0,4
27593,60,6817,10616,10950,0,0,1,0,1
27594,60,6819,10945;11061;15371;16221,10950,0,1,3,0,4
27595,60,6820,10712;15101,10950,0,0,2,0,2
27596,60,6822,11276;11466;15536;16283,10950,0,1,3,0,4
27597,60,6823,10764;10997,10950,0,0,2,0,2
27598,60,6824,10598;10793;15659;16020,10950,0,1,3,0,4
27599,60,6825,10808;10823,10950,0,0,2,0,2
27600,60,6826,10814;10835;15600,10950,0,0,3,0,3
27601,60,6827,10839;11009,10950,0,0,2,0,2
27602,60,6828,11108;11147;14561;15387,10950,0,0,4,0,4
27603,60,6829,11063,10950,0,0,1,0,1
27604,60,6830,11204;11484;15437,10950,0,0,3,0,3
27605,60,6831,11269;16111,10950,0,1,1,0,2
27606,60,6832,10818;10932;15498,10950,0,0,3,0,3
27607,60,6833,10982;11074;15642;16128,10950,0,1,3,0,4
27608,60,6835,11127;15884,10950,0,1,1,0,2
27609,60,6836,10696;10902;15898,10950,0,1,2,0,3
27610,60,6837,11019;11047;16174,10950,0,1,2,0,3
27611,60,6838,11023;15224;16007;16470,10950,0,2,2,0,4
27612,60,6839,10921;11135;15519,10950,0,0,3,0,3
27613,60,6840,11059;13857;15117;15629,10950,0,0,4,0,4
27614,60,6841,11054;11566;15250,10950,0,0,3,0,3
27615,60,6842,10367;11083;15574,10950,0,0,3,0,3
27616,60,6843,11100;11404;14083;14447;16234,10950,0,1,4,0,5
27617,60,6844,10664;11103;15618,10950,0,0,3,0,3
27618,60,6845,11114;11476;15612;16291;16503,10950,0,2,3,0,5
27619,60,6846,11124;11339;15633,10950,0,0,3,0,3
27620,60,6847,10798;11129;14448;15503,10950,0,0,4,0,4
27621,60,6848,11230;14990;15294,10950,0,0,3,0,3
27622,60,6849,11265;11526;13878;15926,10950,0,1,3,0,4
27623,60,6850,10960;11413;14191;14731;15306,10950,0,0,5,0,5
27624,60,6851,11344;11798;16030,10950,0,1,2,0,3
27625,60,6852,11027;11266;15660;16360,10950,0,1,3,0,4
27626,60,6853,10909;11196,10950,0,0,2,0,2
27627,60,6854,11201;11629;15268,10950,0,0,3,0,3
27628,60,6855,11068;11377;14583;16158,10950,0,1,3,0,4
27629,60,6856,11228;11543;15794;16140,10950,0,2,2,0,4
27630,60,6857,10951;11243;14438;15161,10950,0,0,4,0,4
27631,60,6858,11090;11184;15018;15401,10950,0,0,4,0,4
27632,60,6859,11256;11527;14831;14994;15146;16378,10950,0,1,5,0,6
27633,60,6860,11394;15626,10950,0,0,2,0,2
27634,60,6861,11233;15445;15557;15787,10950,0,1,3,0,4
27635,60,6862,11293;15426,10950,0,0,2,0,2
27636,60,6863,11366;11467;15441,10950,0,0,3,0,3
27637,60,6864,10752;11025;14614,10950,0,0,3,0,3
27638,60,6865,11277;11442,10950,0,0,2,0,2
27639,60,6866,11380;11444;15131;15627;16756,10950,0,1,4,0,5
27640,60,6867,11303;11378;14800;14881,10950,0,0,4,0,4
27641,60,6868,11305;11450;14550,10950,0,0,3,0,3
27642,60,6869,11096;11315;15157,10950,0,0,3,0,3
27643,60,6870,11324;11399;15053;15511,10950,0,0,4,0,4
27644,60,6871,9510,11315,0,0,0,1,1
27645,60,6884,2300;4960,11315,0,0,1,1,2
27646,60,6887,7926,11315,0,0,0,1,1
27647,60,6888,4210,11315,0,0,0,1,1
27648,60,6890,4938,11315,0,0,0,1,1
27649,60,6891,5245,11315,0,0,0,1,1
27650,60,6893,5659;6369,11315,0,0,1,1,2
27651,60,6895,2062;10085;14656,11315,0,0,2,1,3
27652,60,6909,10376;10651;14657,11315,0,0,3,0,3
27653,60,6911,10729;15169,11315,0,0,2,0,2
27654,60,6913,10205;10542,11315,0,0,2,0,2
27655,60,6915,10373;10563;15356,11315,0,0,3,0,3
27656,60,6916,10882,11315,0,0,1,0,1
27657,60,6917,10429;10824;15145;15527,11315,0,0,4,0,4
27658,60,6918,10923;15308,11315,0,0,2,0,2
27659,60,6919,10235;10472;14552;14705;15338,11315,0,0,5,0,5
27660,60,6920,10649;10783;14928,11315,0,0,3,0,3
27661,60,6921,10492;10701,11315,0,0,2,0,2
27662,60,6922,10508;11143;14244;15553,11315,0,0,4,0,4
27663,60,6924,10059;10555;14864,11315,0,0,3,0,3
27664,60,6925,10788;10894;15290,11315,0,0,3,0,3
27665,60,6927,10774;10918;14554,11315,0,0,3,0,3
27666,60,6928,10776;11003;15168;15680,11315,0,1,3,0,4
27667,60,6929,10791;10857,11315,0,0,2,0,2
27668,60,6930,10584;10885,11315,0,0,2,0,2
27669,60,6931,10536;10811,11315,0,0,2,0,2
27670,60,6932,10339;10840;16025,11315,0,1,2,0,3
27671,60,6933,10858,11315,0,0,1,0,1
27672,60,6934,10862;10981;14963,11315,0,0,3,0,3
27673,60,6935,10744;10855;15123,11315,0,0,3,0,3
27674,60,6936,10963;11031,11315,0,0,2,0,2
27675,60,6938,10775;15402;15604,11315,0,0,3,0,3
27676,60,6939,10992;11301;14959;15999,11315,0,1,3,0,4
27677,60,6940,11295;15375;15776,11315,0,1,2,0,3
27678,60,6941,10930;11049;14176;16483,11315,0,1,3,0,4
27679,60,6943,11053,11315,0,0,1,0,1
27680,60,6944,11086;15805,11315,0,1,1,0,2
27681,60,6945,10874;11098;15457;15668,11315,0,1,3,0,4
27682,60,6946,10173,11315,0,0,1,0,1
27683,60,6947,11120;11214;14177;14666,11315,0,0,4,0,4
27684,60,6948,11026;11130;14526;16177,11315,0,1,3,0,4
27685,60,6949,11132;11224;14558;15045;15813,11315,0,1,4,0,5
27686,60,6950,11582;11702;15016;16250,11315,0,1,3,0,4
27687,60,6951,11150,11315,0,0,1,0,1
27688,60,6952,10771;11236;15307;16082;16818,11315,0,2,3,0,5
27689,60,6953,11167;11482;16588,11315,0,1,2,0,3
27690,60,6954,10990;11181;14743,11315,0,0,3,0,3
27691,60,6955,11040;11187;14828,11315,0,0,3,0,3
27692,60,6956,11207;11538;14461;14692;15255;16222;16510,11315,0,2,5,0,7
27693,60,6959,11234;11451;14431;15828,11315,0,1,3,0,4
27694,60,6960,10954;11268;14748;15568;16313,11315,0,1,4,0,5
27695,60,6961,11308;15196;15478,11315,0,0,3,0,3
27696,60,6962,11134;11311;14832;15099;15316;15650;15848;16282;16395,11315,0,3,6,0,9
27697,60,6963,11459;15315;16374,11315,0,1,2,0,3
27698,60,6964,11336;11428;14186;14651,11315,0,0,4,0,4
27699,60,6965,11626;11697;14421;15561;15910;16166,11315,0,2,4,0,6
27700,60,6966,11174;11289;15272,11315,0,0,3,0,3
27701,60,6967,11080;11346;14894,11315,0,0,3,0,3
27702,60,6968,11351;11719;15385;15916,11315,0,1,3,0,4
27703,60,6969,11321;11359;15192,11315,0,0,3,0,3
27704,60,6970,11364;11698;14020;15393;15567;15673,11315,0,1,5,0,6
27705,60,6971,11223;11382;15091;16099,11315,0,1,3,0,4
27706,60,6972,11670;11700;14764;16810,11315,0,1,3,0,4
27707,60,6973,11407;11432;16303,11315,0,1,2,0,3
27708,60,6975,10026;10156;14429,11680,0,0,3,0,3
27709,60,6989,3507;6252,11680,0,0,2,0,2
27710,60,6991,7709,11680,0,0,1,0,1
27711,60,6993,1671;5278,11680,0,0,1,1,2
27712,60,6997,7390,11680,0,0,0,1,1
27713,60,6998,7416,11680,0,0,0,1,1
27714,60,7008,10524;14708,11680,0,0,2,0,2
27715,60,7009,10750;14962;15462,11680,0,0,3,0,3
27716,60,7010,10129;10453,11680,0,0,2,0,2
27717,60,7011,11180;11227;14836;16306,11680,0,1,3,0,4
27718,60,7013,11087;15310;16101,11680,0,1,2,0,3
27719,60,7014,10103;10420;14533,11680,0,0,3,0,3
27720,60,7016,10589;10929;14288;15398;15638,11680,0,0,5,0,5
27721,60,7017,10588;10609;15484,11680,0,0,3,0,3
27722,60,7018,11162;11440;14995,11680,0,0,3,0,3
27723,60,7020,10660;10741,11680,0,0,2,0,2
27724,60,7021,10705;10953;14504;15342,11680,0,0,4,0,4
27725,60,7022,10646;10707;15326,11680,0,0,3,0,3
27726,60,7023,10780;10868;14274;15005,11680,0,0,4,0,4
27727,60,7024,10867;10872,11680,0,0,2,0,2
27728,60,7025,11133;11248;15552;15818,11680,0,1,3,0,4
27729,60,7026,11375;15163;15744;15923;16155,11680,0,3,2,0,5
27730,60,7027,11089;14691;15376,11680,0,0,3,0,3
27731,60,7028,11094;11323;14888,11680,0,0,3,0,3
27732,60,7030,11109;11172;14654;15424,11680,0,0,4,0,4
27733,60,7031,11119;11575;14892;15993;16317,11680,0,2,3,0,5
27734,60,7032,10935;11415;15774,11680,0,1,2,0,3
27735,60,7033,10947;11159;14885;15403,11680,0,0,4,0,4
27736,60,7034,11197;11347;14129;15392;15608;16526,11680,0,1,5,0,6
27737,60,7035,11229;15065;15493;16217,11680,0,1,3,0,4
27738,60,7036,11807;14810,11680,0,0,2,0,2
27739,60,7037,10948;11481;16063;16547,11680,0,2,2,0,4
27740,60,7038,11242;11361;15845,11680,0,1,2,0,3
27741,60,7039,11306;11615;14934;15602;16297;17206,11680,1,1,4,0,6
27742,60,7040,11327;11657;14545;15079,11680,0,0,4,0,4
27743,60,7041,11348;11673;15160;15239,11680,0,0,4,0,4
27744,60,7042,11370;14699;15836;16037;16556,11680,0,3,2,0,5
27745,60,7043,11384;11704;14339;15769;16733;17566,11680,1,2,3,0,6
27746,60,7044,11434;14944;15019;15273;15479;17105,11680,0,1,5,0,6
27747,60,7045,11421;11455;15182,11680,0,0,3,0,3
27748,60,7046,11240;11468;15438;15593;15788;16321,11680,0,2,4,0,6
27749,60,7047,10837;11489;15015;15816,11680,0,1,3,0,4
27750,60,7048,11707;15867,11680,0,1,1,0,2
27751,60,7049,11509;11740;15248;15524;15875,11680,0,1,4,0,5
27752,60,7050,11511;11650;16451,11680,0,1,2,0,3
27753,60,7054,4828,12045,0,0,0,1,1
27754,60,7055,774;803,12045,0,0,0,2,2
27755,60,7057,3717,12045,0,0,0,1,1
27756,60,7059,132,12045,0,0,0,1,1
27757,60,7062,2818;8150,12045,0,0,2,0,2
27758,60,7064,3268,12045,0,0,0,1,1
27759,60,7067,3469;9388,12045,0,0,0,2,2
27760,60,7068,3690;4436,12045,0,0,0,2,2
27761,60,7073,4806;8617,12045,0,0,0,2,2
27762,60,7081,6480;7972,12045,0,0,1,1,2
27763,60,7089,8539,12045,0,0,0,1,1
27764,60,7096,4221,12045,0,0,1,0,1
27765,60,7097,10128;10214;14362,12045,0,0,3,0,3
27766,60,7098,2760;10260;14251;14780,12045,0,0,4,0,4
27767,60,7099,10181;10303;14700;15094,12045,0,0,4,0,4
27768,60,7100,10345;10579;15743,12045,0,1,2,0,3
27769,60,7102,10444;10966;13549;14927;15432,12045,0,0,5,0,5
27770,60,7103,10067;10546;14264,12045,0,0,3,0,3
27771,60,7104,10549;10637;15102,12045,0,0,3,0,3
27772,60,7106,10368;10476;15004,12045,0,0,3,0,3
27773,60,7107,10521;10628;15028,12045,0,0,3,0,3
27774,60,7108,10632;10905;14404;14566,12045,0,0,4,0,4
27775,60,7109,10222;10831,12045,0,0,2,0,2
27776,60,7110,10684;10836;15112;15666,12045,0,1,3,0,4
27777,60,7111,11452;15665;16656,12045,0,2,1,0,3
27778,60,7112,11033;15205;15539,12045,0,0,3,0,3
27779,60,7114,11091,12045,0,0,1,0,1
27780,60,7115,11104;11288;14839;15127;15477,12045,0,0,5,0,5
27781,60,7116,11522;15212;15653;16236,12045,0,1,3,0,4
27782,60,7117,11144;11478,12045,0,0,2,0,2
27783,60,7119,11189;11211,12045,0,0,2,0,2
27784,60,7120,11200;15197;15558,12045,0,0,3,0,3
27785,60,7121,11102;11493;15515,12045,0,0,3,0,3
27786,60,7122,11225;11743;16406,12045,0,1,2,0,3
27787,60,7123,10802;11255;15324,12045,0,0,3,0,3
27788,60,7124,11259;15363;15595,12045,0,0,3,0,3
27789,60,7125,11274;12125;16299,12045,0,1,2,0,3
27790,60,7126,11280;15228;16201,12045,0,1,2,0,3
27791,60,7127,11338;14322;14841;15589,12045,0,0,4,0,4
27792,60,7128,10789;11317;14725,12045,0,0,3,0,3
27793,60,7129,11322;15093;15370;15467;15754,12045,0,1,4,0,5
27794,60,7130,11356;11703;16069,12045,0,1,2,0,3
27795,60,7131,11379;11834;14611;16008,12045,0,1,3,0,4
27796,60,7132,11015;11393;15720;16284,12045,0,2,2,0,4
27797,60,7133,11065;11400;14228;16147,12045,0,1,3,0,4
27798,60,7134,11680;11821;14471;16121,12045,0,1,3,0,4
27799,60,7135,11221;11453;14667;15122;15592,12045,0,0,5,0,5
27800,60,7136,11464;11633;15305,12045,0,0,3,0,3
27801,60,7137,11389;11470;14970,12045,0,0,3,0,3
27802,60,7138,11471;11499,12045,0,0,2,0,2
27803,60,7139,11067;11523;15529,12045,0,0,3,0,3
27804,60,7140,11112;11534;15340;15748,12045,0,1,3,0,4
27805,60,7141,11533;11786;14695;15961,12045,0,1,3,0,4
27806,60,7142,11583;11594;14826;15475,12045,0,0,4,0,4
27807,60,7143,11588;15797,12045,0,1,1,0,2
27808,60,7144,11591;11884,12045,0,0,2,0,2
27809,60,7145,11285;15420,12045,0,0,2,0,2
27810,60,7146,11601;16131;17077,12045,0,2,1,0,3
27811,60,7150,6390;9401,12410,0,0,0,2,2
27812,60,7151,721;8331,12410,0,0,0,2,2
27813,60,7157,1165,12410,0,0,0,1,1
27814,60,7158,3776,12410,0,0,0,1,1
27815,60,7160,7428,12410,0,0,0,1,1
27816,60,7161,9184,12410,0,0,0,1,1
27817,60,7170,6054;9046,12410,0,0,0,2,2
27818,60,7172,6643,12410,0,0,0,1,1
27819,60,7174,5742,12410,0,0,0,1,1
27820,60,7176,7373,12410,0,0,0,1,1
27821,60,7177,622,12410,0,0,0,1,1
27822,60,7178,1472;7405,12410,0,0,1,1,2
27823,60,7185,4931,12410,0,0,0,1,1
27824,60,7192,10107;11030;15507,12410,0,0,3,0,3
27825,60,7193,10620;14636;15300,12410,0,0,3,0,3
27826,60,7195,4867,12410,0,0,1,0,1
27827,60,7196,14193;14808;17394;17531,12410,2,0,2,0,4
27828,60,7199,10334;10972;15448;15570,12410,0,0,4,0,4
27829,60,7201,10539;10689;14804;15238,12410,0,0,4,0,4
27830,60,7202,10559;11029;15344;15854,12410,0,1,3,0,4
27831,60,7205,10594;10974;15095;15447,12410,0,0,4,0,4
27832,60,7207,10643;11312;15517;15963;16200,12410,0,2,3,0,5
27833,60,7208,10706;10778;15200,12410,0,0,3,0,3
27834,60,7209,10573;11022;14523;15006,12410,0,0,4,0,4
27835,60,7211,10787;10936,12410,0,0,2,0,2
27836,60,7212,10812;10822;15669,12410,0,1,2,0,3
27837,60,7213,10238;10850;15084,12410,0,0,3,0,3
27838,60,7215,11002;11088;14521,12410,0,0,3,0,3
27839,60,7216,11291;11524;14625;14906;16086,12410,0,1,4,0,5
27840,60,7217,11012;11488;15158;16276;17330,12410,1,1,3,0,5
27841,60,7218,10969;15369,12410,0,0,2,0,2
27842,60,7219,11131;11171;14921;15285,12410,0,0,4,0,4
27843,60,7220,11099;15184,12410,0,0,2,0,2
27844,60,7221,11349;11473;14597;15789,12410,0,1,3,0,4
27845,60,7222,11169;11687;15705;16248;16620,12410,0,3,2,0,5
27846,60,7223,11457;11773;15679,12410,0,1,2,0,3
27847,60,7225,11218;11342;15291,12410,0,0,3,0,3
27848,60,7226,11512;15021;15286;15771;16559,12410,0,2,3,0,5
27849,60,7227,11267;11273;15230,12410,0,0,3,0,3
27850,60,7228,11008;11279;14757;15088;15714,12410,0,1,4,0,5
27851,60,7229,11298;11416;15413;15777,12410,0,1,3,0,4
27852,60,7230,11331;11367;15550,12410,0,0,3,0,3
27853,60,7231,11128;11571;15560,12410,0,0,3,0,3
27854,60,7232,11106;11341;14386;15889,12410,0,1,3,0,4
27855,60,7233,11358;14925;15591;15964;16146,12410,0,2,3,0,5
27856,60,7234,11371;14740;14983;15389,12410,0,0,4,0,4
27857,60,7235,11386;11420;15628;16460,12410,0,1,3,0,4
27858,60,7236,10860;11235;15373;15725;15886,12410,0,2,3,0,5
27859,60,7237,11438;12053;14734;15106,12410,0,0,4,0,4
27860,60,7239,10797;11502;15110;15820,12410,0,1,3,0,4
27861,60,7240,11518;11780;16145;16207;17037,12410,0,3,2,0,5
27862,60,7241,11537;11541;15535,12410,0,0,3,0,3
27863,60,7242,11757;11782;14402;15459,12410,0,0,4,0,4
27864,60,7243,11553;11584;16064,12410,0,1,2,0,3
27865,60,7244,11558;11938;14791;17238,12410,1,0,3,0,4
27866,60,7245,11567;15279;15739,12410,0,1,2,0,3
27867,60,7246,11577;11795;15822,12410,0,1,2,0,3
27868,60,7247,11460;11578;14547;15297,12410,0,0,4,0,4
27869,60,7248,12128;15502;15702;15943;16953,12410,0,3,2,0,5
27870,60,7249,11618;16132,12410,0,1,1,0,2
27871,60,7250,11620;15033;15449;15973,12410,0,1,3,0,4
27872,60,7251,11628;11688;14770;15406;16411,12410,0,1,4,0,5
27873,60,7252,11392;11982;14389,12410,0,0,3,0,3
27874,60,7253,11713;11813;15764;16384,12410,0,2,2,0,4
27875,60,7254,11173;11722;15439;15761,12410,0,1,3,0,4
27876,60,7255,11564,12410,0,0,1,0,1
27877,60,7256,11663;11738;14491;16336,12410,0,1,3,0,4
27878,60,7257,11747;12098;16748,12410,0,1,2,0,3
27879,60,7261,1191,12775,0,0,1,0,1
27880,60,7269,8407;8498,12775,0,0,0,2,2
27881,60,7270,8862;10501;15269,12775,0,0,3,0,3
27882,60,7272,4757;9231,12775,0,0,0,2,2
27883,60,7275,8406,12775,0,0,0,1,1
27884,60,7279,7410,12775,0,0,1,0,1
27885,60,7280,5941,12775,0,0,0,1,1
27886,60,7284,8132,12775,0,0,0,1,1
27887,60,7293,10348;10845;15877,12775,0,1,2,0,3
27888,60,7297,10813;14964,12775,0,0,2,0,2
27889,60,7298,10819;10989,12775,0,0,2,0,2
27890,60,7299,10826;10938;15092;15463,12775,0,0,4,0,4
27891,60,7300,10396;10848;14952;15327;15634,12775,0,0,5,0,5
27892,60,7301,10698;10854;15266;16193,12775,0,1,3,0,4
27893,60,7303,10564;10715;14909,12775,0,0,3,0,3
27894,60,7304,10906;11095;14680,12775,0,0,3,0,3
27895,60,7305,10784;11397;15500,12775,0,0,3,0,3
27896,60,7307,10844;11010,12775,0,0,2,0,2
27897,60,7308,11036;11330;15727,12775,0,1,2,0,3
27898,60,7309,10512;10675;14857;15156,12775,0,0,4,0,4
27899,60,7310,10751;10908;14586;15237,12775,0,0,4,0,4
27900,60,7311,11136;11462;14979,12775,0,0,3,0,3
27901,60,7312,11153;14694,12775,0,0,2,0,2
27902,60,7314,10886;11283;15173;15302;16738,12775,0,1,4,0,5
27903,60,7315,11458;15031;16165,12775,0,1,2,0,3
27904,60,7316,11334;15883,12775,0,1,1,0,2
27905,60,7317,11183;11340;16012;16718,12775,0,2,2,0,4
27906,60,7318,11362;11494;15773;15958,12775,0,2,2,0,4
27907,60,7319,11731;15343;15856;15975,12775,0,2,2,0,4
27908,60,7320,11875;12121;15256;16906,12775,0,1,3,0,4
27909,60,7321,11337;11480;15267,12775,0,0,3,0,3
27910,60,7322,11302;11495;15607,12775,0,0,3,0,3
27911,60,7323,11498;14833;15610,12775,0,0,3,0,3
27912,60,7324,11742;11864;16062,12775,0,1,2,0,3
27913,60,7325,11056;11491;15583;16696,12775,0,1,3,0,4
27914,60,7326,11530;11863;15584,12775,0,0,3,0,3
27915,60,7327,11531;11612;14574;15471;15681,12775,0,1,4,0,5
27916,60,7328,11552;11648;15246;16416,12775,0,1,3,0,4
27917,60,7329,11918;12034;15882;16355,12775,0,2,2,0,4
27918,60,7330,11598;11616;14776;16049;16540,12775,0,2,3,0,5
27919,60,7331,11508;15231;15505,12775,0,0,3,0,3
27920,60,7332,11565;11653;15868,12775,0,1,2,0,3
27921,60,7333,11674;11986,12775,0,0,2,0,2
27922,60,7334,11699;11882;14619;17315,12775,1,0,3,0,4
27923,60,7335,11525;11708;15262,12775,0,0,3,0,3
27924,60,7336,11573;11724;15752;16635,12775,0,2,2,0,4
27925,60,7337,11139;11151;15718,12775,0,1,2,0,3
27926,60,7338,11759;12225;15780;16429,12775,0,2,2,0,4
27927,60,7339,11761;11866;15137,12775,0,0,3,0,3
27928,60,7340,11774;12247;15057,12775,0,0,3,0,3
27929,60,7341,11686;11790;14603;15251;15914;16488;16973,12775,0,3,4,0,7
27930,60,7342,11778;11805;14750;15562;16340,12775,0,1,4,0,5
27931,60,7343,11417;11517;15837;16316,12775,0,2,2,0,4
27932,60,7344,11559;11837;14689;15222;15833;16654;16978,12775,0,3,4,0,7
27933,60,7345,12116;12228;14870;16484,12775,0,1,3,0,4
27934,60,7346,11640;11869;16685,12775,0,1,2,0,3
27935,60,7347,183,13140,0,0,0,1,1
27936,60,7348,383;10576;14587;14851,13140,0,0,4,0,4
27937,60,7350,3309,13140,0,0,0,1,1
27938,60,7356,2628,13140,0,0,0,1,1
27939,60,7371,9098,13140,0,0,1,0,1
27940,60,7372,6143;9804,13140,0,0,0,2,2
27941,60,7373,7141,13140,0,0,0,1,1
27942,60,7376,10106,13140,0,0,1,0,1
27943,60,7378,10216;14834,13140,0,0,2,0,2
27944,60,7381,4883;10413;14664,13140,0,0,3,0,3
27945,60,7382,10325,13140,0,0,1,0,1
27946,60,7384,10543;10671;14744,13140,0,0,3,0,3
27947,60,7386,10695;10958;14794;15299,13140,0,0,4,0,4
27948,60,7389,10648;10875,13140,0,0,2,0,2
27949,60,7390,10404;11024;15111;15548,13140,0,0,4,0,4
27950,60,7391,10933;10949;15056,13140,0,0,3,0,3
27951,60,7392,11004;11111;15543,13140,0,0,3,0,3
27952,60,7393,10736;11016;15421,13140,0,0,3,0,3
27953,60,7394,11833;12038;15271;16113,13140,0,1,3,0,4
27954,60,7395,11058;11072;14933;15979,13140,0,1,3,0,4
27955,60,7396,11105;11551;15365;15728,13140,0,1,3,0,4
27956,60,7397,10120;11107;14860;15278,13140,0,0,4,0,4
27957,60,7398,10662;11046;15218;15360;15893,13140,0,1,4,0,5
27958,60,7399,11326;15058;15139,13140,0,0,3,0,3
27959,60,7400,10891;11190,13140,0,0,2,0,2
27960,60,7401,11550;15319;16184;16238,13140,0,2,2,0,4
27961,60,7402,11405;11677;16939,13140,0,1,2,0,3
27962,60,7403,11409;11486;16014;16212;16487,13140,0,3,2,0,5
27963,60,7404,11436;11485;15190;15504;16326,13140,0,1,4,0,5
27964,60,7405,11396;11465;14688;16256,13140,0,1,3,0,4
27965,60,7406,11570;11606;15492;15799,13140,0,1,3,0,4
27966,60,7407,11354;11515;15545;16232,13140,0,1,3,0,4
27967,60,7408,11535;15620;16515,13140,0,1,2,0,3
27968,60,7409,11585;12096;15976;16571,13140,0,2,2,0,4
27969,60,7410,11456;11614;15309;16854,13140,0,1,3,0,4
27970,60,7411,11449;12246;15652;16071,13140,0,1,3,0,4
27971,60,7412,11646;11689;15737,13140,0,1,2,0,3
27972,60,7413,12205;15469;15921,13140,0,1,2,0,3
27973,60,7414,11969;11984;16046,13140,0,1,2,0,3
27974,60,7415,11542;11693;15151;15862;16051;16653;16812,13140,0,4,3,0,7
27975,60,7416,11602;11727;14896;16274,13140,0,1,3,0,4
27976,60,7417,11728;11897;15685;16094,13140,0,2,2,0,4
27977,60,7418,11935;12237;15466;15726,13140,0,1,3,0,4
27978,60,7420,11784;12371;14761;15059;16213;16387,13140,0,2,4,0,6
27979,60,7421,11968;12131;14711;15067;17006,13140,0,1,4,0,5
27980,60,7423,11664;11822;14768;15223,13140,0,0,4,0,4
27981,60,7424,11734;15040;16337,13140,0,1,2,0,3
27982,60,7425,11831;12101;14660;15009;15654,13140,0,0,5,0,5
27983,60,7426,11847;12176;15905;16560,13140,0,2,2,0,4
27984,60,7427,12221;15499;16078;17074,13140,0,2,2,0,4
27985,60,7428,11887;12060;16343;16665,13140,0,2,2,0,4
27986,60,7429,11694;11889;16932,13140,0,1,2,0,3
27987,60,7430,11817;11900;16196;16398,13140,0,2,2,0,4
27988,60,7431,11540;11903;15731,13140,0,1,2,0,3
27989,60,7433,11851;11937;15483;16684,13140,0,1,3,0,4
27990,60,7434,11926;12157;15061;15263;16699;17166,13140,0,2,4,0,6
27991,60,7435,11607;11932,13140,0,0,2,0,2
27992,60,7436,11752;11901;16159,13140,0,1,2,0,3
27993,60,7437,11957;12162;14814;15130;16601,13140,0,1,4,0,5
27994,60,7438,11971;12000;14720;15152;15869;16136,13140,0,2,4,0,6
27995,60,7442,1930,13505,0,0,1,0,1
27996,60,7446,4511,13505,0,0,0,1,1
27997,60,7451,1883;5662,13505,0,0,1,1,2
27998,60,7456,2878,13505,0,0,0,1,1
27999,60,7458,2812,13505,0,0,0,1,1
28000,60,7459,7733;8268,13505,0,0,0,2,2
28001,60,7460,7000,13505,0,0,0,1,1
28002,60,7462,7237,13505,0,0,0,1,1
28003,60,7466,2342,13505,0,0,0,1,1
28004,60,7468,8854,13505,0,0,0,1,1
28005,60,7471,6420;9951,13505,0,0,0,2,2
28006,60,7473,1837,13505,0,0,1,0,1
28007,60,7475,10461;10962,13505,0,0,2,0,2
28008,60,7478,10414;10490;14822;15235;15435,13505,0,0,5,0,5
28009,60,7481,10445,13505,0,0,1,0,1
28010,60,7483,10479;10878;14812;15711,13505,0,1,3,0,4
28011,60,7484,10592;14876;15390,13505,0,0,3,0,3
28012,60,7486,10939;10999,13505,0,0,2,0,2
28013,60,7488,10800;11064;15277;16275,13505,0,1,3,0,4
28014,60,7489,10843;11477;15677;16673,13505,0,2,2,0,4
28015,60,7491,10605;11126;14816;15414,13505,0,0,4,0,4
28016,60,7492,11007;11138,13505,0,0,2,0,2
28017,60,7493,11332;15264;15997,13505,0,1,2,0,3
28018,60,7494,10647;11142;14929;14967,13505,0,0,4,0,4
28019,60,7495,11506;15510;15928,13505,0,1,2,0,3
28020,60,7497,11286;15832,13505,0,1,1,0,2
28021,60,7498,10897;11292;14943;14993;15528,13505,0,0,5,0,5
28022,60,7499,11528;15708;16888,13505,0,2,1,0,3
28023,60,7500,11357;12004,13505,0,0,2,0,2
28024,60,7501,11408;16600,13505,0,1,1,0,2
28025,60,7502,11605;11860;14837;15772,13505,0,1,3,0,4
28026,60,7503,11140;11474;15303,13505,0,0,3,0,3
28027,60,7504,11246;11516,13505,0,0,2,0,2
28028,60,7505,11554;11979;16739;16923,13505,0,2,2,0,4
28029,60,7506,11581;11806;15295;16295,13505,0,1,3,0,4
28030,60,7507,11599;12181;14931;15766;16173,13505,0,2,3,0,5
28031,60,7508,11611;11980;16372,13505,0,1,2,0,3
28032,60,7509,11560;11627;14935;16450,13505,0,1,3,0,4
28033,60,7510,11641;11684;15419;16937,13505,0,1,3,0,4
28034,60,7511,11643;11732;15341;16257,13505,0,1,3,0,4
28035,60,7512,11660;12203;15957,13505,0,1,2,0,3
28036,60,7513,11658;11672;15051;15842,13505,0,1,3,0,4
28037,60,7514,11427;11678;15325;15959;16676,13505,0,2,3,0,5
28038,60,7515,11475;11766;15648,13505,0,0,3,0,3
28039,60,7516,12472;16842,13505,0,1,1,0,2
28040,60,7517,11569;11793;14941;15280;15594,13505,0,0,5,0,5
28041,60,7518,12117;12219;15497;15672,13505,0,1,3,0,4
28042,60,7519,12342;15054;15476;15801,13505,0,1,3,0,4
28043,60,7520,11880;11960;15800;16105;16557,13505,0,3,2,0,5
28044,60,7521,12302;15214;16419,13505,0,1,2,0,3
28045,60,7522,11879;12249;16241,13505,0,1,2,0,3
28046,60,7523,11610;11896;15915;16024;16331;17055;17139,13505,0,5,2,0,7
28047,60,7524,11899;12324;15442,13505,0,0,3,0,3
28048,60,7525,11505;12167;14956;15489;16391,13505,0,1,4,0,5
28049,60,7526,11927;12346;14942;14988,13505,0,0,4,0,4
28050,60,7527,11941;12091;16464,13505,0,1,2,0,3
28051,60,7528,11726;11955;15526;17222,13505,1,0,3,0,4
28052,60,7529,11961;11994;14910;15770,13505,0,1,3,0,4
28053,60,7530,11797;11981;15844;16574;16784,13505,0,3,2,0,5
28054,60,7531,11753;11987;16338,13505,0,1,2,0,3
28055,60,7532,12376;15334;16010;16509;16651;17032,13505,0,4,2,0,6
28056,60,7533,12204;15556;15934,13505,0,1,2,0,3
28057,60,7534,11692;12065;16138;16209;16633,13505,0,3,2,0,5
28058,60,7535,11751;12067;16106;17109,13505,0,2,2,0,4
28059,60,7536,12392;15047;15853,13505,0,1,2,0,3
28060,60,7537,12093;15185;16433,13505,0,1,2,0,3
28061,60,7538,12099;12124;14999;15229;15455;15765;16224,13505,0,2,5,0,7
28062,60,7539,11769;12107;15330,13505,0,0,3,0,3
28063,60,7540,12120;12460;14913;15890;16277;16969,13505,0,3,3,0,6
28064,60,7541,12056;12529;15494;15944;16553;16938,13505,0,3,3,0,6
28065,60,7542,488,13870,0,0,0,1,1
28066,60,7543,2795;3463,13870,0,0,0,2,2
28067,60,7547,65,13870,0,0,0,1,1
28068,60,7550,3177;3198,13870,0,0,0,2,2
28069,60,7553,7896,13870,0,0,0,1,1
28070,60,7554,6053,13870,0,0,0,1,1
28071,60,7555,6450,13870,0,0,0,1,1
28072,60,7557,7211,13870,0,0,0,1,1
28073,60,7562,1814,13870,0,0,0,1,1
28074,60,7563,8966,13870,0,0,0,1,1
28075,60,7564,9740;10270,13870,0,0,1,1,2
28076,60,7569,10399;14966;15254,13870,0,0,3,0,3
28077,60,7571,10137;10531;15178,13870,0,0,3,0,3
28078,60,7575,10801;10841,13870,0,0,2,0,2
28079,60,7578,10943;15695;16050,13870,0,2,1,0,3
28080,60,7579,11001;11262;15345;15644;16077,13870,0,1,4,0,5
28081,60,7580,11021;11195;15118;16415,13870,0,1,3,0,4
28082,60,7582,11118;14961;15232,13870,0,0,3,0,3
28083,60,7583,11199;14981;15513,13870,0,0,3,0,3
28084,60,7584,11250;11572;16746;16985,13870,0,2,2,0,4
28085,60,7585,10232,13870,0,0,1,0,1
28086,60,7586,11333;11365;15048;15925,13870,0,1,3,0,4
28087,60,7587,11350;11656;15395;16068,13870,0,1,3,0,4
28088,60,7588,11388;11720;15041;15613,13870,0,0,4,0,4
28089,60,7589,11675;15124;15834,13870,0,1,2,0,3
28090,60,7590,11418;11639;15288;16341,13870,0,1,3,0,4
28091,60,7591,11469;14948;15933,13870,0,1,2,0,3
28092,60,7593,11168;11510;15782,13870,0,1,2,0,3
28093,60,7596,11536;11561;15014;15790;15846,13870,0,2,3,0,5
28094,60,7597,11574;12118;15895,13870,0,1,2,0,3
28095,60,7598,11915;12434;15194;15810;16534;17158;17365,13870,1,3,3,0,7
28096,60,7599,12062;15204,13870,0,0,2,0,2
28097,60,7600,11690;11975;15671;16543;16822;17093,13870,0,4,2,0,6
28098,60,7601,11748;12070;15955,13870,0,1,2,0,3
28099,60,7602,11775;11933;15809;16550,13870,0,2,2,0,4
28100,60,7604,11345;11811;14969;15201;15599,13870,0,0,5,0,5
28101,60,7605,11789;12104;15177;15917;16237;17594,13870,1,2,3,0,6
28102,60,7606,12058;12187;16229;16955,13870,0,2,2,0,4
28103,60,7607,11802;11916;15601;16157;16388;17184,13870,1,2,3,0,6
28104,60,7608,11942;12092;15333;15625,13870,0,0,4,0,4
28105,60,7609,11924;11944;15098;15791,13870,0,1,3,0,4
28106,60,7610,11950;12160;15417;15667;16877,13870,0,2,3,0,5
28107,60,7611,12638;12639;16432,13870,0,1,2,0,3
28108,60,7612,11962;12191;15150;15637;17060,13870,0,1,4,0,5
28109,60,7613,11963;11996,13870,0,0,2,0,2
28110,60,7614,12267;16508,13870,0,1,1,0,2
28111,60,7616,12364,13870,0,0,1,0,1
28112,60,7617,12019;12413;15745;16474,13870,0,2,2,0,4
28113,60,7618,12380;12626;15351;16171,13870,0,1,3,0,4
28114,60,7619,11701;12026;15712,13870,0,1,2,0,3
28115,60,7620,12265;12518;15891,13870,0,1,2,0,3
28116,60,7621,11320;12049;16260,13870,0,1,2,0,3
28117,60,7622,12078;12254;15409;16151;16737,13870,0,2,3,0,5
28118,60,7623,11814;12329;15039;15386;17067,13870,0,1,4,0,5
28119,60,7624,12208;15723;16127,13870,0,2,1,0,3
28120,60,7625,12100;12350;15298;15977;16658,13870,0,2,3,0,5
28121,60,7626,12111;12580;16636,13870,0,1,2,0,3
28122,60,7627,12389;15082;16688;16732;17532,13870,1,2,2,0,5
28123,60,7628,11679;12178;15175;15827;16352,13870,0,2,3,0,5
28124,60,7629,12224;12604;15166;15509;17118,13870,0,1,4,0,5
28125,60,7630,12201;12207;15706;17548,13870,1,1,2,0,4
28126,60,7631,12210;12598;15617;16134;16927,13870,0,2,3,0,5
28127,60,7632,12232;16279;16322,13870,0,2,1,0,3
28128,60,7633,12480;12551;15329;16363;17396,13870,1,1,3,0,5
28129,60,7634,12255;12454;15189;16479,13870,0,1,3,0,4
28130,60,7635,12130;12259;15323;15433;15696,13870,0,1,4,0,5
28131,60,7637,334;10065,14235,0,0,2,0,2
28132,60,7639,6537;9113,14235,0,0,0,2,2
28133,60,7645,4166,14235,0,0,0,1,1
28134,60,7646,2442,14235,0,0,0,1,1
28135,60,7648,1140,14235,0,0,0,1,1
28136,60,7649,3708,14235,0,0,0,1,1
28137,60,7651,929;3477,14235,0,0,0,2,2
28138,60,7652,7554,14235,0,0,0,1,1
28139,60,7657,9009,14235,0,0,0,1,1
28140,60,7659,9369,14235,0,0,0,1,1
28141,60,7667,10004;10240;15108;15763,14235,0,1,3,0,4
28142,60,7671,10925;11188;15097;15301,14235,0,0,4,0,4
28143,60,7672,11166;11296;15518;15551,14235,0,0,4,0,4
28144,60,7678,11042;11372;15247;15936;16018;16418,14235,0,3,3,0,6
28145,60,7680,11275;11500;15314;16242,14235,0,1,3,0,4
28146,60,7682,11079;11325;15428;15814,14235,0,1,3,0,4
28147,60,7684,11381;11691;15243;16004,14235,0,1,3,0,4
28148,60,7685,11387;11521;15292;15861;16034;16100;16442,14235,0,4,3,0,7
28149,60,7687,11472;11735;15768;16011,14235,0,2,2,0,4
28150,60,7688,11294;11654;15400;15663;17047,14235,0,1,4,0,5
28151,60,7689,11562;11636;15193;15713;16001,14235,0,2,3,0,5
28152,60,7690,11403;11568;15388;15434,14235,0,0,4,0,4
28153,60,7691,11622;15596;16327,14235,0,1,2,0,3
28154,60,7692,11137;11647;15485;16774,14235,0,1,3,0,4
28155,60,7693,11671;11919;16076,14235,0,1,2,0,3
28156,60,7694,11576;11705;15336;15689,14235,0,1,3,0,4
28157,60,7695,11335;11595;15621;16153,14235,0,1,3,0,4
28158,60,7696,12014;15992,14235,0,1,1,0,2
28159,60,7697,11355;11746;15276;15555;16525,14235,0,1,4,0,5
28160,60,7698,11765;11862;15332;15674,14235,0,1,3,0,4
28161,60,7699,11785;12366;16491;16649,14235,0,2,2,0,4
28162,60,7700,12407;12568;16045,14235,0,1,2,0,3
28163,60,7701,11329;11850;15142;15501;16190,14235,0,1,4,0,5
28164,60,7702,11556;11832;15416;16583,14235,0,1,3,0,4
28165,60,7703,11892;16376;17201,14235,1,1,1,0,3
28166,60,7704,11928;12358;17066;17309,14235,1,1,2,0,4
28167,60,7705,11945;15670;17043,14235,0,2,1,0,3
28168,60,7706,11685;11952;16002,14235,0,1,2,0,3
28169,60,7708,12196;15275,14235,0,0,2,0,2
28170,60,7709,11977;12298;15100;17524,14235,1,0,3,0,4
28171,60,7710,11985;15436;16066,14235,0,1,2,0,3
28172,60,7711,12016;12069;15148;15412;17399,14235,1,0,4,0,5
28173,60,7712,11767;15221;15490;15811;16859,14235,0,2,3,0,5
28174,60,7713,12408;12562;16452,14235,0,1,2,0,3
28175,60,7714,12059;15817;16288;16691,14235,0,3,1,0,4
28176,60,7715,12074;15941,14235,0,1,1,0,2
28177,60,7716,11923;12075;15282;15872;16021;16269;16659,14235,0,4,3,0,7
28178,60,7717,12076;12592;16098;17395,14235,1,1,2,0,4
28179,60,7718,12021;12087;15172;15876;16890,14235,0,2,3,0,5
28180,60,7719,12288;15208;16000,14235,0,1,2,0,3
28181,60,7720,12102;15283;16565,14235,0,1,2,0,3
28182,60,7721,12012;12122;15372;16445;16630;17420,14235,1,2,3,0,6
28183,60,7722,12048;12126;15859;16230,14235,0,2,2,0,4
28184,60,7723,12143;16569,14235,0,1,1,0,2
28185,60,7724,12776;15598;17572,14235,1,0,2,0,3
28186,60,7725,12170;12465;15873;16475,14235,0,2,2,0,4
28187,60,7726,12728;17087;17272;17511,14235,2,1,1,0,4
28188,60,7727,12185;12603;16465;16794;17321,14235,1,2,2,0,5
28189,60,7728,12149;12199;15661;15965,14235,0,1,3,0,4
28190,60,7729,12233;12697;16035,14235,0,1,2,0,3
28191,60,7730,12489;12673;15354;17525,14235,1,0,3,0,4
28192,60,7731,12239;12558;16935;17600,14235,1,1,2,0,4
28193,60,7732,11853;12362;15641;16305;16916;17009,14235,0,3,3,0,6
28194,60,7734,12084;12466;16179;16310,14235,0,2,2,0,4
28195,60,7735,12336;16397,14235,0,1,1,0,2
28196,60,7736,12173;12432;15211;17614,14235,1,0,3,0,4
28197,60,7737,12292;12374;15183,14235,0,0,3,0,3
28198,60,7738,12282;12373;15587;15826,14235,0,1,3,0,4
28199,60,7740,12258;12388;15488;15863;16563,14235,0,2,3,0,5
28200,60,7742,909,14600,0,0,1,0,1
28201,60,7746,4693,14600,0,0,0,1,1
28202,60,7748,5008,14600,0,0,0,1,1
28203,60,7750,4398,14600,0,0,0,1,1
28204,60,7752,1032;4860,14600,0,0,0,2,2
28205,60,7753,5192,14600,0,0,0,1,1
28206,60,7754,6999,14600,0,0,0,1,1
28207,60,7757,4770,14600,0,0,0,1,1
28208,60,7758,8020,14600,0,0,0,1,1
28209,60,7763,3240,14600,0,0,0,1,1
28210,60,7765,6201,14600,0,0,0,1,1
28211,60,7772,10497;10623;16468,14600,0,1,2,0,3
28212,60,7773,10561;11239;15534;15888,14600,0,1,3,0,4
28213,60,7775,10655;11226;15819;16244,14600,0,2,2,0,4
28214,60,7776,10686;10748;15234;15531,14600,0,0,4,0,4
28215,60,7778,10782;10993;15265;15541,14600,0,0,4,0,4
28216,60,7780,10442;10846;15284,14600,0,0,3,0,3
28217,60,7781,10887;15537;16308,14600,0,1,2,0,3
28218,60,7783,10517;11084;15533;15840,14600,0,1,3,0,4
28219,60,7785,11017;11157;16055;16103,14600,0,2,2,0,4
28220,60,7786,10877;11076;16092,14600,0,1,2,0,3
28221,60,7787,10614;11178;15693,14600,0,1,2,0,3
28222,60,7788,11154;11412;15258;16027,14600,0,1,3,0,4
28223,60,7789,11148;11597;15355;15575;16003,14600,0,1,4,0,5
28224,60,7790,11149;11251;15249;15736,14600,0,1,3,0,4
28225,60,7791,11213;15233;15580;15906,14600,0,1,3,0,4
28226,60,7792,11271;11645;15662;15929,14600,0,1,3,0,4
28227,60,7793,11278;15735;16499,14600,0,2,1,0,3
28228,60,7794,11781;15622,14600,0,0,2,0,2
28229,60,7795,11353;11390;15242;15597;16924,14600,0,1,4,0,5
28230,60,7796,11304;11395;15259;15538,14600,0,0,4,0,4
28231,60,7797,11160;11580;15465;16162,14600,0,1,3,0,4
28232,60,7799,11906;15508;16206,14600,0,1,2,0,3
28233,60,7800,11718;15431;16478;16775,14600,0,2,2,0,4
28234,60,7801,11557;11603;15630;16164,14600,0,1,3,0,4
28235,60,7802,11621;11669;15384;15825,14600,0,1,3,0,4
28236,60,7803,11652;11815;16467;16652;16882,14600,0,3,2,0,5
28237,60,7804,11492;11768;15632;15749;16819,14600,0,2,3,0,5
28238,60,7805,11549;11946;16490;16705,14600,0,2,2,0,4
28239,60,7806,11659;11762;15241;16043;16554,14600,0,2,3,0,5
28240,60,7807,11749;12276;16792,14600,0,1,2,0,3
28241,60,7808,11423;11756;15603,14600,0,0,3,0,3
28242,60,7809,12352;12420;15619;16887;17144,14600,0,2,3,0,5
28243,60,7810,11846;12139;15796;16286;17223,14600,1,2,2,0,5
28244,60,7811,11855;12401;17176;17482,14600,2,0,2,0,4
28245,60,7812,11791;11867;15296;15549,14600,0,0,4,0,4
28246,60,7813,11385;11891;15576;15716,14600,0,1,3,0,4
28247,60,7814,11913;12323;15678;16489;17172,14600,1,2,2,0,5
28248,60,7815,11729;11988;15857;16143,14600,0,2,2,0,4
28249,60,7816,11877;11991;16040,14600,0,1,2,0,3
28250,60,7817,11845;12008;15812;16285;17019;17368,14600,1,3,2,0,6
28251,60,7818,12023;12119;16223,14600,0,1,2,0,3
28252,60,7819,11587;12041;16026,14600,0,1,2,0,3
28253,60,7820,12077;12306;16156;17161,14600,0,2,2,0,4
28254,60,7821,12082;12347;15806;16898,14600,0,2,2,0,4
28255,60,7822,11940;12322;15423;15655;16287;16516;17075;17191,14600,1,3,4,0,8
28256,60,7823,11792;12106;16088;17237,14600,1,1,2,0,4
28257,60,7824,12132;12572;15347;15635;15966;16715;17417,14600,1,2,4,0,7
28258,60,7825,11787;12133;15722;16133;17117,14600,0,3,2,0,5
28259,60,7826,12326;12750;16663;16988,14600,0,2,2,0,4
28260,60,7827,11363;12177;16059;16421;16970,14600,0,3,2,0,5
28261,60,7828,12186;12387;16141;16346,14600,0,2,2,0,4
28262,60,7829,12190;12622;15824;15982;16289;16693,14600,0,4,2,0,6
28263,60,7830,12222;12285;16619,14600,0,1,2,0,3
28264,60,7831,12274;12331;16228,14600,0,1,2,0,3
28265,60,7832,12172;12257;16053,14600,0,1,2,0,3
28266,60,7833,12633;12775;16930,14600,0,1,2,0,3
28267,60,7834,12171;12294;16469;16847,14600,0,2,2,0,4
28268,60,7835,12311;12629;15405;15807,14600,0,1,3,0,4
28269,60,7836,12313;12367;16498;17404,14600,1,1,2,0,4
28270,60,7837,12009;12404;16708;16994,14600,0,2,2,0,4
28271,60,7838,12227;12332;15935;16052,14600,0,2,2,0,4
28272,60,7839,11715;12338;15349,14600,0,0,3,0,3
28273,60,7840,12198;12339;16056;17220,14600,1,1,2,0,4
28274,60,7841,12344;12706;15274;15643;17244,14600,1,0,4,0,5
28275,60,7842,12153;12359;15444;15579;16980;17491,14600,1,1,4,0,6
28276,60,7843,12505;16401,14600,0,1,1,0,2
28277,60,7844,12280;12378;16848,14600,0,1,2,0,3
28278,60,7845,12390;15383;15540;15901,14600,0,1,3,0,4
28279,60,7846,12290;12452;15318;15803,14600,0,1,3,0,4
28280,60,7847,12594;16647,14600,0,1,1,0,2
28281,60,7848,12370;16339,14600,0,1,1,0,2
28282,60,7849,12054;12652;15339;17286,14600,1,0,3,0,4
28283,60,7850,9246,14965,0,0,0,1,1
28284,60,7860,4505,14965,0,0,0,1,1
28285,60,7864,5565,14965,0,0,0,1,1
28286,60,7865,5715,14965,0,0,0,1,1
28287,60,7866,5789,14965,0,0,0,1,1
28288,60,7868,6949,14965,0,0,0,1,1
28289,60,7869,1321;3374,14965,0,0,0,2,2
28290,60,7870,3833;7372,14965,0,0,0,2,2
28291,60,7873,8806,14965,0,0,0,1,1
28292,60,7875,10049,14965,0,0,1,0,1
28293,60,7877,10384;10493,14965,0,0,2,0,2
28294,60,7879,10283;10585;15446;15985,14965,0,1,3,0,4
28295,60,7883,11014;11838;15740;16065;16393,14965,0,3,2,0,5
28296,60,7884,10759;10941;15429;15899,14965,0,1,3,0,4
28297,60,7885,10554;11071;15452;15785,14965,0,1,3,0,4
28298,60,7886,11176;11383;15454;15675,14965,0,1,3,0,4
28299,60,7887,11194;11261;16097;16402;16660,14965,0,3,2,0,5
28300,60,7888,10950;10965;16593,14965,0,1,2,0,3
28301,60,7889,11373;11447;15521;15730;15987,14965,0,2,3,0,5
28302,60,7890,10890;11514;15755;16742,14965,0,2,2,0,4
28303,60,7892,11369;11667;16095;16934,14965,0,2,2,0,4
28304,60,7893,11287;11419;15734,14965,0,1,2,0,3
28305,60,7894,11092;11504;15566;16358;16368,14965,0,2,3,0,5
28306,60,7895,11222;11545;15470;15710;16022,14965,0,2,3,0,5
28307,60,7896,11596;11635;15590;16281,14965,0,1,3,0,4
28308,60,7897,11625;11827;15721;16081,14965,0,2,2,0,4
28309,60,7898,11631;12495;15913;16019;16240;17187,14965,1,3,2,0,6
28310,60,7899,11579;11661;15506;16548,14965,0,1,3,0,4
28311,60,7900,11776;12960;16778;17110;17314,14965,1,2,2,0,5
28312,60,7902,11710;12248;16210,14965,0,1,2,0,3
28313,60,7903,11555;11824;15606;15878;16482,14965,0,2,3,0,5
28314,60,7904,11876;12057;16265,14965,0,1,2,0,3
28315,60,7905,11730;11886;15410;16471;16821,14965,0,2,3,0,5
28316,60,7906,11943;15443;15758;16137;16714,14965,0,3,2,0,5
28317,60,7907,11873;11947;16072;16808,14965,0,2,2,0,4
28318,60,7908,11954;12497;16657;16799,14965,0,2,2,0,4
28319,60,7909,12006;12732;15563;16150;16403;17131,14965,0,3,3,0,6
28320,60,7910,11589;12011;15684,14965,0,1,2,0,3
28321,60,7911,12015;12870;15781;16922,14965,0,2,2,0,4
28322,60,7912,11770;12025;15798;16750,14965,0,2,2,0,4
28323,60,7913,12040;12212;15990;16199,14965,0,2,2,0,4
28324,60,7914,11433;12068;16258,14965,0,1,2,0,3
28325,60,7915,12381;15480;16529,14965,0,1,2,0,3
28326,60,7916,11964;12097;15912;16296;16694,14965,0,3,2,0,5
28327,60,7917,12154;12299;15802;16263,14965,0,2,2,0,4
28328,60,7918,12174;15779;16521;17153,14965,0,3,1,0,4
28329,60,7919,12183;12287;15948;16998,14965,0,2,2,0,4
28330,60,7920,12240;15784;16109;16302,14965,0,3,1,0,4
28331,60,7921,12260;12564;15729;16524;16845,14965,0,3,2,0,5
28332,60,7922,12031;12271;15514;15851;16707,14965,0,2,3,0,5
28333,60,7923,12296;12787;16896;17160,14965,0,2,2,0,4
28334,60,7924,12593;12624;15572;16430;17367,14965,1,1,3,0,5
28335,60,7925,12028;12308;15783;16797,14965,0,2,2,0,4
28336,60,7926,12309;12530;16176;16457;16834;17263,14965,1,3,2,0,6
28337,60,7927,12316;16603,14965,0,1,1,0,2
28338,60,7928,12295;12320;15751;16872,14965,0,2,2,0,4
28339,60,7929,12064;12541;16381;16618,14965,0,2,2,0,4
28340,60,7930,12451;12932;16762;17140,14965,0,2,2,0,4
28341,60,7931,12123;12353;16266;16856,14965,0,2,2,0,4
28342,60,7932,12507;12521;15860,14965,0,1,2,0,3
28343,60,7933,12555;15902;16090,14965,0,2,1,0,3
28344,60,7934,12553;12778;16357;16698,14965,0,2,2,0,4
28345,60,7935,12565;12946;15683;16096;17155;17336,14965,1,3,2,0,6
28346,60,7936,12447;12595;16017,14965,0,1,2,0,3
28347,60,7937,12402;16444;17563,14965,1,1,1,0,3
28348,60,7938,12241;12609;16120;17623,14965,1,1,2,0,4
28349,60,7939,12063;12621;16459,14965,0,1,2,0,3
28350,60,7940,12635;12690;16118;17011,14965,0,2,2,0,4
28351,60,7941,12699;15998;16723,14965,0,2,1,0,3
28352,60,7942,12351;12658;15609;16806;17599,14965,1,1,3,0,5
28353,60,7943,12660;12757;15422;16943,14965,0,1,3,0,4
28354,60,7944,1100,15330,0,0,0,1,1
28355,60,7947,9643,15330,0,0,0,1,1
28356,60,7949,6879,15330,0,0,0,1,1
28357,60,7951,9225,15330,0,0,0,1,1
28358,60,7952,4149,15330,0,0,0,1,1
28359,60,7954,10094;10273;15738;15972,15330,0,2,2,0,4
28360,60,7955,9224,15330,0,0,0,1,1
28361,60,7956,2189,15330,0,0,0,1,1
28362,60,7958,8013,15330,0,0,0,1,1
28363,60,7967,10424;10663;15645;15757,15330,0,1,3,0,4
28364,60,7968,11212;15585;15762,15330,0,1,2,0,3
28365,60,7972,10196,15330,0,0,1,0,1
28366,60,7973,10739;11284;15778;16152,15330,0,2,2,0,4
28367,60,7974,10799;11966;15795;15970;17022,15330,0,3,2,0,5
28368,60,7975,10830;10853;15624;16080,15330,0,1,3,0,4
28369,60,7977,10959;10964;15525;16135,15330,0,1,3,0,4
28370,60,7978,10871;16249,15330,0,1,1,0,2
28371,60,7979,11777;12052;15582;15919;16420,15330,0,2,3,0,5
28372,60,7981,11245;11883;16084;16549,15330,0,2,2,0,4
28373,60,7982,11313;11437;15786,15330,0,1,2,0,3
28374,60,7984,11503;11638;15569;15924;16425,15330,0,2,3,0,5
28375,60,7985,11376;12179;15930;16259,15330,0,2,2,0,4
28376,60,7989,11676;12156;15611;16853,15330,0,1,3,0,4
28377,60,7990,11683;15532;16032,15330,0,1,2,0,3
28378,60,7991,11360;11696;15546;16623,15330,0,1,3,0,4
28379,60,7992,11783;12089;15676;15927;16564,15330,0,3,2,0,5
28380,60,7993,11801;12283;15885;16301,15330,0,2,2,0,4
28381,60,7994,11865;12384;16365,15330,0,1,2,0,3
28382,60,7995,11706;11907;15792,15330,0,1,2,0,3
28383,60,7996,11755;11911;16124;16967,15330,0,2,2,0,4
28384,60,7997,11842;15760;15831;16689,15330,0,3,1,0,4
28385,60,7998,11990;12022;16231;16318,15330,0,2,2,0,4
28386,60,7999,12024;12784;15911;15971;17046,15330,0,3,2,0,5
28387,60,8000,12105;12702;16033;16435,15330,0,2,2,0,4
28388,60,8001,12140;12409;15664;16424;17407,15330,1,1,3,0,5
28389,60,8002,12365;15544;15850;17086,15330,0,2,2,0,4
28390,60,8003,12168;12244;15956;16348;17538,15330,1,2,2,0,5
28391,60,8004,11721;12169;16058;16273,15330,0,2,2,0,4
28392,60,8005,12175;12189;16399;17130,15330,0,2,2,0,4
28393,60,8006,11925;12197;15639;16112;16785;16952,15330,0,3,3,0,6
28394,60,8007,12072;12589;16345;16528,15330,0,2,2,0,4
28395,60,8008,12242;12345;16423;16644,15330,0,2,2,0,4
28396,60,8009,12243;12284;16615,15330,0,1,2,0,3
28397,60,8010,11905;12245;15700;16907,15330,0,2,2,0,4
28398,60,8011,11922;12253;16067,15330,0,1,2,0,3
28399,60,8012,12256;12264;15903;16075;16628;17073,15330,0,4,2,0,6
28400,60,8013,12395;12821;16974;17344,15330,1,1,2,0,4
28401,60,8014,12310;16710,15330,0,1,1,0,2
28402,60,8015,12637;12858;16996,15330,0,1,2,0,3
28403,60,8016,12328;13211;15703;16639,15330,0,2,2,0,4
28404,60,8017,12648;12709;17527,15330,1,0,2,0,3
28405,60,8018,12379;12773;16438;16624,15330,0,2,2,0,4
28406,60,8019,12081;12393;16091;16681,15330,0,2,2,0,4
28407,60,8020,12412;13281;16042;17342,15330,1,1,2,0,4
28408,60,8021,12426;12759;16804,15330,0,1,2,0,3
28409,60,8022,12443;15523;16455;16634;17287,15330,1,2,2,0,5
28410,60,8023,12812;15687;16643,15330,0,2,1,0,3
28411,60,8024,12803;16712;17091,15330,0,2,1,0,3
28412,60,8025,12039;12512;16625,15330,0,1,2,0,3
28413,60,8026,12273;12655;16389,15330,0,1,2,0,3
28414,60,8027,12150;12499;15715;17232,15330,1,1,2,0,4
28415,60,8028,12949;15717;15847;15969,15330,0,3,1,0,4
28416,60,8029,12538;12925;16396,15330,0,1,2,0,3
28417,60,8030,12552;12982;15646;16629;16962,15330,0,2,3,0,5
28418,60,8031,12573;12781;16093,15330,0,1,2,0,3
28419,60,8032,12500;12770;15953;16375;16840,15330,0,3,2,0,5
28420,60,8033,12596;12740;16867;16968,15330,0,2,2,0,4
28421,60,8034,12625;12711;17373;17545,15330,2,0,2,0,4
28422,60,8035,12202;12631;16500;16655,15330,0,2,2,0,4
28423,60,8036,12879;16233,15330,0,1,1,0,2
28424,60,8037,12659;13195;15815;17231;17535,15330,2,1,2,0,5
28425,60,8038,12701;13041;16089;16704,15330,0,2,2,0,4
28426,60,8039,12745,15330,0,0,1,0,1
28427,60,8040,12417;12764;16477,15330,0,1,2,0,3
28428,60,8041,12766;13207;15892;16757,15330,0,2,2,0,4
28429,60,8042,12556;12788;15775;16813,15330,0,2,2,0,4
28430,60,8043,12801,15330,0,0,1,0,1
28431,60,8044,7398,15695,0,0,0,1,1
28432,60,8052,3978,15695,0,0,0,1,1
28433,60,8053,5888,15695,0,0,0,1,1
28434,60,8054,3184,15695,0,0,0,1,1
28435,60,8057,6370,15695,0,0,1,0,1
28436,60,8058,6904,15695,0,0,0,1,1
28437,60,8060,3145;7115,15695,0,0,2,0,2
28438,60,8061,6342,15695,0,0,0,1,1
28439,60,8062,7723,15695,0,0,0,1,1
28440,60,8063,8538,15695,0,0,0,1,1
28441,60,8068,10162;10322,15695,0,0,2,0,2
28442,60,8069,10406;10529;15938,15695,0,1,2,0,3
28443,60,8074,10477,15695,0,0,1,0,1
28444,60,8075,11145;11198;15821;15954,15695,0,2,2,0,4
28445,60,8076,11075;11155;15698;15942,15695,0,2,2,0,4
28446,60,8078,11272,15695,0,0,1,0,1
28447,60,8080,11586;11711;16443;16802,15695,0,2,2,0,4
28448,60,8082,10718;11443;15742;16868,15695,0,2,2,0,4
28449,60,8084,12047;12110;15974;16385;16640,15695,0,3,2,0,5
28450,60,8085,11709;11974;16461;16700,15695,0,2,2,0,4
28451,60,8086,11959;12559;16016;16304;16920,15695,0,3,2,0,5
28452,60,8087,11854;11992;15989;16405,15695,0,2,2,0,4
28453,60,8088,11998;16183;16613;17331,15695,1,2,1,0,4
28454,60,8089,12035;12335;16208;16873,15695,0,2,2,0,4
28455,60,8090,12511;16126;16330,15695,0,2,1,0,3
28456,60,8091,11970;12188;16598;16899,15695,0,2,2,0,4
28457,60,8093,11888;12297;15704;16441,15695,0,2,2,0,4
28458,60,8094,12071;12319;17020,15695,0,1,2,0,3
28459,60,8095,12341;12916;16567;16901,15695,0,2,2,0,4
28460,60,8096,12368;12485;16373;16725,15695,0,2,2,0,4
28461,60,8097,12391;16216;17622,15695,1,1,1,0,3
28462,60,8098,11800;12405;16194;17261,15695,1,1,2,0,4
28463,60,8099,12414;12561;16731,15695,0,1,2,0,3
28464,60,8100,12483;12661;16362,15695,0,1,2,0,3
28465,60,8101,12438;12527;15866;16913,15695,0,2,2,0,4
28466,60,8102,12134;12461;15865;16181,15695,0,2,2,0,4
28467,60,8103,12108;12470;16561,15695,0,1,2,0,3
28468,60,8104,13097;13235;15701;16717,15695,0,2,2,0,4
28469,60,8105,12477;12785;16073;17377,15695,1,1,2,0,4
28470,60,8106,12517;13365;15691;15835;16149;16795,15695,0,4,2,0,6
28471,60,8107,12547;12892;15823,15695,0,1,2,0,3
28472,60,8108,12571;15839;16251;16533,15695,0,3,1,0,4
28473,60,8109,12546;12586;16761,15695,0,1,2,0,3
28474,60,8110,13213;13295,15695,0,0,2,0,2
28475,60,8111,12478;12537;16928;17326,15695,1,1,2,0,4
28476,60,8112,12484;16005;16763,15695,0,2,1,0,3
28477,60,8113,11934;11956;16342;17213,15695,1,1,2,0,4
28478,60,8114,12044;12650;16290,15695,0,1,2,0,3
28479,60,8115,12042;12623;16638;16963,15695,0,2,2,0,4
28480,60,8116,12727;12962;15746;16117;16278,15695,0,3,2,0,5
28481,60,8117,13093;13234;15896;15991;16394;16950;17398,15695,1,4,2,0,7
28482,60,8118,12605;12735;15756;16060;16325,15695,0,3,2,0,5
28483,60,8119,12765;15694;16057;16536;17689,15695,1,3,1,0,5
28484,60,8120,12777;13171;15733;16364;16782;17406,15695,1,3,2,0,6
28485,60,8121,12791;12900;15978;16161;16679,15695,0,3,2,0,5
28486,60,8122,12804;13001;15849;16083;16370,15695,0,3,2,0,5
28487,60,8123,12810;12990;16123;16472,15695,0,2,2,0,4
28488,60,8124,12723;12938,15695,0,0,2,0,2
28489,60,8125,12789;12820;15918,15695,0,1,2,0,3
28490,60,8126,12448;12829;15855,15695,0,1,2,0,3
28491,60,8127,12674;12917,15695,0,0,2,0,2
28492,60,8128,12677;12838;15937;17671,15695,1,1,2,0,4
28493,60,8129,12846;12855;16626,15695,0,1,2,0,3
28494,60,8130,12864;13297;15908;16013;17064;17509,15695,1,3,2,0,6
28495,60,8131,12515;12902;16413,15695,0,1,2,0,3
28496,60,8132,12303;12881;16779,15695,0,1,2,0,3
28497,60,8133,12415;12889,15695,0,0,2,0,2
28498,60,8134,12823;12890;16087;16519,15695,0,2,2,0,4
28499,60,8135,13168;15732;17024;17606,15695,1,2,1,0,4
28500,60,8136,12912;15767;16486,15695,0,2,1,0,3
28501,60,8137,12836;13939;16268;16426;16590;16987;17441;17583,15695,2,4,2,0,8
28502,60,8139,870,16060,0,0,0,1,1
28503,60,8140,4381,16060,0,0,0,1,1
28504,60,8141,584,16060,0,0,0,1,1
28505,60,8142,1217,16060,0,0,0,1,1
28506,60,8145,5963,16060,0,0,0,1,1
28507,60,8147,6970,16060,0,0,0,1,1
28508,60,8149,5328,16060,0,0,0,1,1
28509,60,8152,5248,16060,0,0,0,1,1
28510,60,8155,5731,16060,0,0,0,1,1
28511,60,8156,10309;10500,16060,0,0,2,0,2
28512,60,8163,10409;10994,16060,0,0,2,0,2
28513,60,8169,10852;10984;15900,16060,0,1,2,0,3
28514,60,8172,11282,16060,0,0,1,0,1
28515,60,8173,11300;11649;15841;16054,16060,0,2,2,0,4
28516,60,8174,11422;11425;15897;16530,16060,0,2,2,0,4
28517,60,8175,11170;11446;15843;16670,16060,0,2,2,0,4
28518,60,8176,11316;11843;16006;16271;17258,16060,1,2,2,0,5
28519,60,8178,12235;16267;16592,16060,0,2,1,0,3
28520,60,8179,11454;11812;16726;17029,16060,0,2,2,0,4
28521,60,8180,11604;11609;15852;16262;16422,16060,0,3,2,0,5
28522,60,8182,12061;16492,16060,0,1,1,0,2
28523,60,8183,11666;11758;15838;15951;16427,16060,0,3,2,0,5
28524,60,8184,11816;12003;16531;16711;17010,16060,0,3,2,0,5
28525,60,8185,12218;16225;16576,16060,0,2,1,0,3
28526,60,8186,11461;11856;15864;16107,16060,0,2,2,0,4
28527,60,8187,11870;12281;16169,16060,0,1,2,0,3
28528,60,8188,11917;12361;16542,16060,0,1,2,0,3
28529,60,8189,11803;11949;16734,16060,0,1,2,0,3
28530,60,8190,11993;12532;16753,16060,0,1,2,0,3
28531,60,8191,12001;12293;15830,16060,0,1,2,0,3
28532,60,8192,11600;12005;15988;16353;16769,16060,0,3,2,0,5
28533,60,8193,11501;12020;15980,16060,0,1,2,0,3
28534,60,8194,12492;16102;16407,16060,0,2,1,0,3
28535,60,8195,11921;12095;16036,16060,0,1,2,0,3
28536,60,8196,12109;12887;16104;17677,16060,1,1,2,0,4
28537,60,8197,12115;12195;15880;16594,16060,0,2,2,0,4
28538,60,8198,11978;12017;16074;16798,16060,0,2,2,0,4
28539,60,8199,12325;12372;15922;17672,16060,1,1,2,0,4
28540,60,8200,12337;12458;15879;16448,16060,0,2,2,0,4
28541,60,8202,12321;12419;15322;16130,16060,0,1,3,0,4
28542,60,8204,12446;13107;16815;17085;17464,16060,1,2,2,0,5
28543,60,8205,12032;12536;15946;16292;16772,16060,0,3,2,0,5
28544,60,8206,12510;12832;17639,16060,1,0,2,0,3
28545,60,8207,12516;16841;16960,16060,0,2,1,0,3
28546,60,8208,12231;12590;16408,16060,0,1,2,0,3
28547,60,8209,11958;12560;16168;16860,16060,0,2,2,0,4
28548,60,8210,12486;12569;16494;16617,16060,0,2,2,0,4
28549,60,8211,12587;12678;16070;16367,16060,0,2,2,0,4
28550,60,8212,12467;13089;16577;16823;17348,16060,1,2,2,0,5
28551,60,8213,12951;13516;15907;16061;17483,16060,1,2,2,0,5
28552,60,8214,12588;16706;17350;17665,16060,2,1,1,0,4
28553,60,8215,12643;12825;15858;15995;16545,16060,0,3,2,0,5
28554,60,8216,12653;12835;16844;16957,16060,0,2,2,0,4
28555,60,8217,12691;13419;15967;16264,16060,0,2,2,0,4
28556,60,8218,13046;16041;16247;16332,16060,0,3,1,0,4
28557,60,8219,12716;13368;16028;16323;16463,16060,0,3,2,0,5
28558,60,8220,12531;12731;16596;16780;16981;17467,16060,1,3,2,0,6
28559,60,8221,12756;13143;15829;17143,16060,0,2,2,0,4
28560,60,8222,12931;13146;16125;16752,16060,0,2,2,0,4
28561,60,8223,12349;12780;15932;16814,16060,0,2,2,0,4
28562,60,8224,12815;12831;16892,16060,0,1,2,0,3
28563,60,8225,12721;12878;16505,16060,0,1,2,0,3
28564,60,8226,12904;16914;17227,16060,1,1,1,0,3
28565,60,8227,12830;12921,16060,0,0,2,0,2
28566,60,8228,12739;12817;17135;17551,16060,1,1,2,0,4
28567,60,8229,12942;13255;15870;16539;16933;17358,16060,1,3,2,0,6
28568,60,8230,12570;12945;16144;16347,16060,0,2,2,0,4
28569,60,8231,12964;16690;17090,16060,0,2,1,0,3
28570,60,8232,12978;15909;16252;16910,16060,0,3,1,0,4
28571,60,8233,12600;12983;16730;17539,16060,1,1,2,0,4
28572,60,8234,12999;13376;17164;17316,16060,1,1,2,0,4
28573,60,8235,13014;13359;15871;16858;17371,16060,1,2,2,0,5
28574,60,8237,13052;13391;15690;16926,16060,0,2,2,0,4
28575,60,8238,12597;13058;15920;16320,16060,0,2,2,0,4
28576,60,8239,13446;13497;16683;17556,16060,1,1,2,0,4
28577,60,8242,8307,16425,0,0,0,1,1
28578,60,8244,3086,16425,0,0,0,1,1
28579,60,8248,6233,16425,0,0,1,0,1
28580,60,8249,5296,16425,0,0,0,1,1
28581,60,8251,2625,16425,0,0,0,1,1
28582,60,8254,4304;6238,16425,0,0,1,1,2
28583,60,8255,9500,16425,0,0,0,1,1
28584,60,8256,9230,16425,0,0,0,1,1
28585,60,8259,1169,16425,0,0,0,1,1
28586,60,8260,9317,16425,0,0,0,1,1
28587,60,8261,6782,16425,0,0,0,1,1
28588,60,8269,10175;10746;15981,16425,0,1,2,0,3
28589,60,8271,10861;16048,16425,0,1,1,0,2
28590,60,8277,10478;11193;16122;16214,16425,0,2,2,0,4
28591,60,8281,11231;11712;15952;16178,16425,0,2,2,0,4
28592,60,8283,11435,16425,0,0,1,0,1
28593,60,8284,11496;11723;15996;16965,16425,0,2,2,0,4
28594,60,8288,12161;12263;16114,16425,0,1,2,0,3
28595,60,8291,11737;11902;16079,16425,0,1,2,0,3
28596,60,8292,12206;12563;16951,16425,0,1,2,0,3
28597,60,8293,11967;12193;15949;16790,16425,0,2,2,0,4
28598,60,8294,12763;12841;16789;17083,16425,0,2,2,0,4
28599,60,8295,12142;12680;16783;17042,16425,0,2,2,0,4
28600,60,8296,11424;11642;16349;16768;17120,16425,0,3,2,0,5
28601,60,8297,12610;17063,16425,0,1,1,0,2
28602,60,8298,11861;12234;16185;16386,16425,0,2,2,0,4
28603,60,8299,12229;12743;16631;17058,16425,0,2,2,0,4
28604,60,8300,12286;16428;16995,16425,0,2,1,0,3
28605,60,8301,11908;12291;16191;16495,16425,0,2,2,0,4
28606,60,8303,12355;12736;17101,16425,0,1,2,0,3
28607,60,8304,12357;12808;16400,16425,0,1,2,0,3
28608,60,8305,12230;12360;16182;16827,16425,0,2,2,0,4
28609,60,8306,12914;13021;16129,16425,0,1,2,0,3
28610,60,8307,12431,16425,0,0,1,0,1
28611,60,8308,12471;12520;16570;17070;17298,16425,1,2,2,0,5
28612,60,8309,12941;13028;17340;17627,16425,2,0,2,0,4
28613,60,8310,12482;12730;15960;16720;17649,16425,1,2,2,0,5
28614,60,8311,12501;17378,16425,1,0,1,0,2
28615,60,8312,12490;12525;16999,16425,0,1,2,0,3
28616,60,8314,13132;16031;17327,16425,1,1,1,0,3
28617,60,8315,12554;12876;15994;16759;16954;17592,16425,1,3,2,0,6
28618,60,8316,12737;12848;16919,16425,0,1,2,0,3
28619,60,8317,12582;17040;17534,16425,1,1,1,0,3
28620,60,8318,12585;13104;16541;17328,16425,1,1,2,0,4
28621,60,8321,12933,16425,0,0,1,0,1
28622,60,8322,13057;13148;16226;16506,16425,0,2,2,0,4
28623,60,8323,13037;16855;17457,16425,1,1,1,0,3
28624,60,8324,12694;13555;15950;16369;17136,16425,0,3,2,0,5
28625,60,8325,12718;13216;17209,16425,1,0,2,0,3
28626,60,8326,12725;12987;16039;16607,16425,0,2,2,0,4
28627,60,8327,12748;13586;17363;17633,16425,2,0,2,0,4
28628,60,8328,12754;16202;16324;16551;17122,16425,0,4,1,0,5
28629,60,8329,12786;13036;17460,16425,1,0,2,0,3
28630,60,8330,12519;12847;16047;17415,16425,1,1,2,0,4
28631,60,8331,12644;12907,16425,0,0,2,0,2
28632,60,8332,12910;12915,16425,0,0,2,0,2
28633,60,8333,12514;12919;16167;17418,16425,1,1,2,0,4
28634,60,8334,12885;12953;17003;17409,16425,1,1,2,0,4
28635,60,8335,13016;13501;16773;17285;17448,16425,2,1,2,0,5
28636,60,8336,13024;13139;16595;16876,16425,0,2,2,0,4
28637,60,8337,12869;13181;16959;17504,16425,1,1,2,0,4
28638,60,8338,12449;13220;17481,16425,1,0,2,0,3
28639,60,8339,13091;13206;17134;17211,16425,1,1,2,0,4
28640,60,8340,12591;13096;16085;17297,16425,1,1,2,0,4
28641,60,8342,13109;13336;16261;17171,16425,1,1,2,0,4
28642,60,8343,12868;13112;17266;17506,16425,2,0,2,0,4
28643,60,8344,12927;13115;16948,16425,0,1,2,0,3
28644,60,8345,13119;13537;15986;16917,16425,0,2,2,0,4
28645,60,8346,12504;13377;16029;16239,16425,0,2,2,0,4
28646,60,8347,13007;13137;17555,16425,1,0,2,0,3
28647,60,8348,13304;13350;16009;16218;17012;17204,16425,1,3,2,0,6
28648,60,8349,12863;13166;16142;16383,16425,0,2,2,0,4
28649,60,8350,13133;13167;16189;16501,16425,0,2,2,0,4
28650,60,8351,13179;13514,16425,0,0,2,0,2
28651,60,8352,13180;13431;16335;16675,16425,0,2,2,0,4
28652,60,8353,12634;13183;16535;17034,16425,0,2,2,0,4
28653,60,8354,13228;13335;15945;16520;16786;17177,16425,1,3,2,0,6
28654,60,8355,12994;13161;17629,16425,1,0,2,0,3
28655,60,8356,405,16790,0,0,0,1,1
28656,60,8357,714,16790,0,0,0,1,1
28657,60,8358,810;9043,16790,0,0,0,2,2
28658,60,8359,5692,16790,0,0,0,1,1
28659,60,8361,5421,16790,0,0,1,0,1
28660,60,8366,6719,16790,0,0,0,1,1
28661,60,8368,7181,16790,0,0,0,1,1
28662,60,8369,8283,16790,0,0,0,1,1
28663,60,8370,9166,16790,0,0,0,1,1
28664,60,8376,878,16790,0,0,1,0,1
28665,60,8382,10169,16790,0,0,1,0,1
28666,60,8386,10976;16589,16790,0,1,1,0,2
28667,60,8391,11513;11681;16170;16211;16608,16790,0,3,2,0,5
28668,60,8393,11858,16790,0,0,1,0,1
28669,60,8394,12033;16481,16790,0,1,1,0,2
28670,60,8395,12051;12144;16160,16790,0,1,2,0,3
28671,60,8398,12090;12602;17080,16790,0,1,2,0,3
28672,60,8400,12152;12772;16195;16911,16790,0,2,2,0,4
28673,60,8402,12165;12675;16119,16790,0,1,2,0,3
28674,60,8403,12209;12967;16751;17059,16790,0,2,2,0,4
28675,60,8404,12251;12278;16175;16672,16790,0,2,2,0,4
28676,60,8405,12301;12918;16309;16883,16790,0,2,2,0,4
28677,60,8406,12317;12797;16621,16790,0,1,2,0,3
28678,60,8407,12406;12687;16235;16642;16870,16790,0,3,2,0,5
28679,60,8408,12909;16110;16585,16790,0,2,1,0,3
28680,60,8411,12584;12857;16328;16941;17652,16790,1,2,2,0,5
28681,60,8412,12566;12895;16667;16702,16790,0,2,2,0,4
28682,60,8413,12581;13287;17625,16790,1,0,2,0,3
28683,60,8414,12269;12620;16319;17062,16790,0,2,2,0,4
28684,60,8415,12713;13165;17546;17636,16790,2,0,2,0,4
28685,60,8416,12266;12627;16719,16790,0,1,2,0,3
28686,60,8417,12577;12628;16437,16790,0,1,2,0,3
28687,60,8418,12908;13042;16245;16311;17007,16790,0,3,2,0,5
28688,60,8419,12632;13103,16790,0,0,2,0,2
28689,60,8420,12641;13409;16215,16790,0,1,2,0,3
28690,60,8421,12645;13510;16270;17246,16790,1,1,2,0,4
28691,60,8422,12646;12850;16507;17521;17660,16790,2,1,2,0,5
28692,60,8423,12681;13299;16622;17288,16790,1,1,2,0,4
28693,60,8424,12685;13223;17302;17537,16790,2,0,2,0,4
28694,60,8425,12665;12692;16154;16350;16942;17253,16790,1,3,2,0,6
28695,60,8426,12252;16314;16502,16790,0,2,1,0,3
28696,60,8427,12710;13318;16835;17497,16790,1,1,2,0,4
28697,60,8428,13204;13423;16300;16599;17595,16790,1,2,2,0,5
28698,60,8429,12726;16116;16493;16788,16790,0,3,1,0,4
28699,60,8430,13209;16903,16790,0,1,1,0,2
28700,60,8431,12761;16192;16454;16871,16790,0,3,1,0,4
28701,60,8432,12158;12277;16572;17251,16790,1,1,2,0,4
28702,60,8433,12304,16790,0,0,1,0,1
28703,60,8434,12793;13083;16197;16562,16790,0,2,2,0,4
28704,60,8435,12439;12827;16412;16900;17390,16790,1,2,2,0,5
28705,60,8436,13031;16180;16517,16790,0,2,1,0,3
28706,60,8437,12783;13035;17056;17212,16790,1,1,2,0,4
28707,60,8438,13039;13619,16790,0,0,2,0,2
28708,60,8439,13055;13535;16254;16745;17292,16790,1,2,2,0,5
28709,60,8440,13062;13194,16790,0,0,2,0,2
28710,60,8441,12666;13064;16203;16807;16946,16790,0,3,2,0,5
28711,60,8442,13066;13316;16771;17294;17353,16790,2,1,2,0,5
28712,60,8443,13080;13564,16790,0,0,2,0,2
28713,60,8444,12523;13292;16139;16537;16864,16790,0,3,2,0,5
28714,60,8445,13106;13610;17500,16790,1,0,2,0,3
28715,60,8446,13111;13272;16227;17463,16790,1,1,2,0,4
28716,60,8447,12429;13159;16604;17422,16790,1,1,2,0,4
28717,60,8448,13006;13527,16790,0,0,2,0,2
28718,60,8449,12550;13163;17439;17616,16790,2,0,2,0,4
28719,60,8450,13172;13416;16198;16558;17230;17405,16790,2,2,2,0,6
28720,60,8451,13127;13189;16163;16602,16790,0,2,2,0,4
28721,60,8452,13198;13240;16462,16790,0,1,2,0,3
28722,60,8453,13239;13617,16790,0,0,2,0,2
28723,60,8454,13222;13254;16566;17196;17522,16790,2,1,2,0,5
28724,60,8455,13275;13577;16255;16436;16936;17159,16790,0,4,2,0,6
28725,60,8456,13092;13314;17195,16790,1,0,2,0,3
28726,60,8457,13300;13473;16893,16790,0,1,2,0,3
28727,60,8458,13306;13361;16148;17510,16790,1,1,2,0,4
28728,60,8459,13018;13310;17354,16790,1,0,2,0,3
28729,60,8460,13320;13536,16790,0,0,2,0,2
28730,60,8461,12998;13323;17438,16790,1,0,2,0,3
28731,60,8462,13439;16108;16351,16790,0,2,1,0,3
28732,60,8463,13102;13604,16790,0,0,2,0,2
28733,60,8464,13356;13533;16204;16361;16439;16861,16790,0,4,2,0,6
28734,60,8466,316,17155,0,0,0,1,1
28735,60,8467,81,17155,0,0,0,1,1
28736,60,8468,6465,17155,0,0,0,1,1
28737,60,8469,1287,17155,0,0,0,1,1
28738,60,8471,1670,17155,0,0,0,1,1
28739,60,8472,5318,17155,0,0,0,1,1
28740,60,8473,1104;6838,17155,0,0,1,1,2
28741,60,8474,5175;10164,17155,0,0,2,0,2
28742,60,8476,6764,17155,0,0,0,1,1
28743,60,8477,7912,17155,0,0,0,1,1
28744,60,8478,3266,17155,0,0,1,0,1
28745,60,8480,9189,17155,0,0,0,1,1
28746,60,8481,7530,17155,0,0,1,0,1
28747,60,8496,11101;11257,17155,0,0,2,0,2
28748,60,8497,11208;11249;16904,17155,0,1,2,0,3
28749,60,8501,11220,17155,0,0,1,0,1
28750,60,8503,11548;11872;16764;17008,17155,0,2,2,0,4
28751,60,8505,11799;11874;16272;16329,17155,0,2,2,0,4
28752,60,8506,11912;12334;16862,17155,0,1,2,0,3
28753,60,8507,11809;12141;16434;16736,17155,0,2,2,0,4
28754,60,8509,11828;12086;17621,17155,1,0,2,0,3
28755,60,8511,12027;12080;16382,17155,0,1,2,0,3
28756,60,8512,11826;12261;16552;16839,17155,0,2,2,0,4
28757,60,8514,11840;11936;16466;16776,17155,0,2,2,0,4
28758,60,8515,12574;12844;16377;16497;17380,17155,1,2,2,0,5
28759,60,8518,12612;16186,17155,0,1,1,0,2
28760,60,8519,12719;17138,17155,0,1,1,0,2
28761,60,8520,12615;16677;16921;17218,17155,1,2,1,0,4
28762,60,8521,12544;12630;16458;17582,17155,1,1,2,0,4
28763,60,8522,13202;17076,17155,0,1,1,0,2
28764,60,8523,12672;13142;16905;17318,17155,1,1,2,0,4
28765,60,8524,12683;13363;17057,17155,0,1,2,0,3
28766,60,8525,12289;12693;16404;16931,17155,0,2,2,0,4
28767,60,8526,12703;12963;16682,17155,0,1,2,0,3
28768,60,8527,12534;12738;17018,17155,0,1,2,0,3
28769,60,8528,12524;13030;17276,17155,1,0,2,0,3
28770,60,8529,13192;13370;16584;17041,17155,0,2,2,0,4
28771,60,8530,12707;12819;16518;16743,17155,0,2,2,0,4
28772,60,8531,12806;12840;17489,17155,1,0,2,0,3
28773,60,8532,12873;13500,17155,0,0,2,0,2
28774,60,8533,12874;13397;17514,17155,1,0,2,0,3
28775,60,8534,12913;13467;16187;16587,17155,0,2,2,0,4
28776,60,8535,12867;12924,17155,0,0,2,0,2
28777,60,8536,12948;16744,17155,0,1,1,0,2
28778,60,8537,13434;13438;17499,17155,1,0,2,0,3
28779,60,8538,12988;13184;16344;16716,17155,0,2,2,0,4
28780,60,8539,13019;13540;16356;16831;17347,17155,1,2,2,0,5
28781,60,8540,13067;13475;16836,17155,0,1,2,0,3
28782,60,8541,13068;16897;17178,17155,1,1,1,0,3
28783,60,8542,12450;12813;17436,17155,1,0,2,0,3
28784,60,8543,12771;12834;17045;17376,17155,1,1,2,0,4
28785,60,8544,13124;13175;16511;16805,17155,0,2,2,0,4
28786,60,8545,12972;13126;16692;16765;17391,17155,1,2,2,0,5
28787,60,8546,13011;13131;16205;16609;17026,17155,0,3,2,0,5
28788,60,8547,13134;16366,17155,0,1,1,0,2
28789,60,8548,12670;13138,17155,0,0,2,0,2
28790,60,8549,13141;16219,17155,0,1,1,0,2
28791,60,8550,12826;13150;17339,17155,1,0,2,0,3
28792,60,8551,12837;13237;16220;16298;16820,17155,0,3,2,0,5
28793,60,8552,12905;13178;16514;16616,17155,0,2,2,0,4
28794,60,8553,13009;13200,17155,0,0,2,0,2
28795,60,8554,13449,17155,0,0,1,0,1
28796,60,8555,12959;13221;17052,17155,0,1,2,0,3
28797,60,8556,13227;13860;16246;16371;16532,17155,0,3,2,0,5
28798,60,8557,12729;13087;17088;17307,17155,1,1,2,0,4
28799,60,8558,13162,17155,0,0,1,0,1
28800,60,8559,13248;13324;17295;17447,17155,2,0,2,0,4
28801,60,8560,13188;13249,17155,0,0,2,0,2
28802,60,8561,13264;16721;17002;17320,17155,1,2,1,0,4
28803,60,8562,12980;13289;16703;17039;17558,17155,1,2,2,0,5
28804,60,8563,13243;13594,17155,0,0,2,0,2
28805,60,8564,12968;13291;16606;16918,17155,0,2,2,0,4
28806,60,8565,13308;13388;17603,17155,1,0,2,0,3
28807,60,8566,13331;13624;17304,17155,1,0,2,0,3
28808,60,8567,12809;13238;17503,17155,1,0,2,0,3
28809,60,8568,13384,17155,0,0,1,0,1
28810,60,8569,12880;13389;17324,17155,1,0,2,0,3
28811,60,8570,13392;16568;17229,17155,1,1,1,0,3
28812,60,8571,13147;13492;16801;17323,17155,1,1,2,0,4
28813,60,8572,13404;13779;16243;16581;17071,17155,0,3,2,0,5
28814,60,8573,13301;13436;16449;16741;17013,17155,0,3,2,0,5
28815,60,8574,13445,17155,0,0,1,0,1
28816,60,8575,13450;13745;17494,17155,1,0,2,0,3
28817,60,8576,13469;13581;17529,17155,1,0,2,0,3
28818,60,8577,13471;13909;16380,17155,0,1,2,0,3
28819,60,8578,13390;13493;16902,17155,0,1,2,0,3
28820,60,8579,13505;13782;16188;16379;16770,17155,0,3,2,0,5
28821,60,8581,5590,17520,0,0,0,1,1
28822,60,8582,5698,17520,0,0,1,0,1
28823,60,8584,1544;7712,17520,0,0,0,2,2
28824,60,8585,9339,17520,0,0,0,1,1
28825,60,8586,2774,17520,0,0,1,0,1
28826,60,8587,7396,17520,0,0,1,0,1
28827,60,8588,160,17520,0,0,0,1,1
28828,60,8589,793,17520,0,0,0,1,1
28829,60,8591,10207;10480,17520,0,0,2,0,2
28830,60,8592,10224;10452,17520,0,0,2,0,2
28831,60,8593,1747,17520,0,0,1,0,1
28832,60,8598,10393,17520,0,0,1,0,1
28833,60,8607,10786;11052;16294,17520,0,1,2,0,3
28834,60,8610,11123;11241,17520,0,0,2,0,2
28835,60,8612,11161;11299,17520,0,0,2,0,2
28836,60,8620,11835,17520,0,0,1,0,1
28837,60,8621,11733;11852;16312;16578;17240,17520,1,2,2,0,5
28838,60,8623,11948;12356;15022;16359,17520,0,1,3,0,4
28839,60,8624,12136;16605;16849;17308,17520,1,2,1,0,4
28840,60,8625,11930;12045;16392,17520,0,1,2,0,3
28841,60,8626,12330;12828;16895;17069,17520,0,2,2,0,4
28842,60,8628,12436;12453;16544;17400,17520,1,1,2,0,4
28843,60,8629,12457;12473;16315;16645,17520,0,2,2,0,4
28844,60,8630,12475;17082,17520,0,1,1,0,2
28845,60,8631,12275;12502;16417;16843,17520,0,2,2,0,4
28846,60,8635,12601;13033;16527;16803;17215,17520,1,2,2,0,5
28847,60,8636,13422;13455;16513;16984,17520,0,2,2,0,4
28848,60,8637,12724;12767;17113;17189;17480,17520,2,1,2,0,5
28849,60,8638,12734;12852;16555;17014;17379,17520,1,2,2,0,5
28850,60,8639,12423;12796;17608,17520,1,0,2,0,3
28851,60,8640,12818,17520,0,0,1,0,1
28852,60,8641,12268,17520,0,0,1,0,1
28853,60,8642,12769;12856;17648,17520,1,0,2,0,3
28854,60,8643,12805;12862,17520,0,0,2,0,2
28855,60,8644,13802;16760,17520,0,1,1,0,2
28856,60,8645,12977;17602,17520,1,0,1,0,2
28857,60,8646,12995;13278;17233,17520,1,0,2,0,3
28858,60,8647,13040;13523,17520,0,0,2,0,2
28859,60,8648,12854;13084;16307;16811;17079,17520,0,3,2,0,5
28860,60,8649,13100;16354;17015,17520,0,2,1,0,3
28861,60,8650,13155;13562;16409,17520,0,1,2,0,3
28862,60,8651,12522;13158;16824;16958,17520,0,2,2,0,4
28863,60,8652,13169;13459;17239,17520,1,0,2,0,3
28864,60,8653,13199;13347;16410,17520,0,1,2,0,3
28865,60,8654,13233;13378;17450,17520,1,0,2,0,3
28866,60,8655,13098;13259;16447;17609,17520,1,1,2,0,4
28867,60,8656,13603;13931;17207;17360;17518,17520,3,0,2,0,5
28868,60,8657,13027;13277;16991,17520,0,1,2,0,3
28869,60,8658,12886;13294;17428,17520,1,0,2,0,3
28870,60,8659,13311;13676,17520,0,0,2,0,2
28871,60,8660,14055;16476;17000;17236,17520,1,2,1,0,4
28872,60,8661,13334;13919;16333;17226;17319;17496,17520,3,1,2,0,6
28873,60,8662,12877;13341;16650,17520,0,1,2,0,3
28874,60,8663,12859;13367;17097;17249;17425,17520,2,1,2,0,5
28875,60,8664,13975;16390;16671;16880;17570,17520,1,3,1,0,5
28876,60,8665,13372,17520,0,0,1,0,1
28877,60,8666,12981;13380;16727,17520,0,1,2,0,3
28878,60,8667,12606;12668;17277,17520,1,0,2,0,3
28879,60,8668,13396;14025;17487,17520,1,0,2,0,3
28880,60,8669,13400;13635,17520,0,0,2,0,2
28881,60,8670,13411;13794;16722;17313,17520,1,1,2,0,4
28882,60,8671,13418;13952;16473;16611,17520,0,2,2,0,4
28883,60,8672,13468;13476,17520,0,0,2,0,2
28884,60,8673,13010;13496,17520,0,0,2,0,2
28885,60,8674,13427;13502,17520,0,0,2,0,2
28886,60,8675,13201;13511,17520,0,0,2,0,2
28887,60,8677,12893;13543;16538;16664;16866;17141,17520,0,4,2,0,6
28888,60,8678,13550;13559,17520,0,0,2,0,2
28889,60,8679,13762;17684,17520,1,0,1,0,2
28890,60,8680,13554;13684,17520,0,0,2,0,2
28891,60,8681,13567;17576,17520,1,0,1,0,2
28892,60,8682,13568;16414;16966,17520,0,2,1,0,3
28893,60,8683,13580;13740,17520,0,0,2,0,2
28894,60,8684,13583;13821;16504;16800,17520,0,2,2,0,4
28895,60,8685,13607;13805,17520,0,0,2,0,2
28896,60,8686,13627;13934;16431;16680,17520,0,2,2,0,4
28897,60,8687,13640;13680;17247,17520,1,0,2,0,3
28898,60,8688,13644;13792;17033;17520,17520,1,1,2,0,4
28899,60,8689,13664;16956;17129,17520,0,2,1,0,3
28900,60,8690,13666;13801;16816,17520,0,1,2,0,3
28901,60,8692,8297,17885,0,0,0,1,1
28902,60,8694,4771,17885,0,0,0,1,1
28903,60,8695,6071;7785,17885,0,0,1,1,2
28904,60,8697,4689,17885,0,0,0,1,1
28905,60,8699,5572,17885,0,0,0,1,1
28906,60,8700,5901,17885,0,0,0,1,1
28907,60,8701,2700,17885,0,0,0,1,1
28908,60,8702,175;1027,17885,0,0,1,1,2
28909,60,8704,3730,17885,0,0,0,1,1
28910,60,8705,958,17885,0,0,0,1,1
28911,60,8706,3247,17885,0,0,1,0,1
28912,60,8710,10688;11045;16661,17885,0,1,2,0,3
28913,60,8718,11624;11717;16885,17885,0,1,2,0,3
28914,60,8719,11592;11682;16456;16740,17885,0,2,2,0,4
28915,60,8722,11763,17885,0,0,1,0,1
28916,60,8724,11529,17885,0,0,1,0,1
28917,60,8725,11662;11744;16749,17885,0,1,2,0,3
28918,60,8726,12669;12760;16777;17397,17885,1,1,2,0,4
28919,60,8727,11760;12066;16546,17885,0,1,2,0,3
28920,60,8728,12079;12145;16612,17885,0,1,2,0,3
28921,60,8729,12138;12722;16949,17885,0,1,2,0,3
28922,60,8730,12151;13108;17393;17565,17885,2,0,2,0,4
28923,60,8731,12192;12744;17300,17885,1,0,2,0,3
28924,60,8734,12270;12396;17443;17542,17885,2,0,2,0,4
28925,60,8735,12043;12236;17630,17885,1,0,2,0,3
28926,60,8736,11754;11898;17050;17145,17885,0,2,2,0,4
28927,60,8737,12464;12934,17885,0,0,2,0,2
28928,60,8738,12307;12479;16440;17477,17885,1,1,2,0,4
28929,60,8739,12816;13472;17624,17885,1,0,2,0,3
28930,60,8741,12930;16512;16669;17495,17885,1,2,1,0,4
28931,60,8742,12545;12662;16993,17885,0,1,2,0,3
28932,60,8743,11885,17885,0,0,1,0,1
28933,60,8744,12155;12649;17078,17885,0,1,2,0,3
28934,60,8747,12494;12768;16485;16646;16915,17885,0,3,2,0,5
28935,60,8748,12795;13403,17885,0,0,2,0,2
28936,60,8749,12814;17065;17484,17885,1,1,1,0,3
28937,60,8750,12851;16674;17384,17885,1,1,1,0,3
28938,60,8751,12901;13149;17126,17885,0,1,2,0,3
28939,60,8752,12952;13280;16747;17688,17885,1,1,2,0,4
28940,60,8753,12971;13503,17885,0,0,2,0,2
28941,60,8754,13408,17885,0,0,1,0,1
28942,60,8755,13034;14031;17490,17885,1,0,2,0,3
28943,60,8756,13047;17541;17685,17885,2,0,1,0,3
28944,60,8757,13053;13185;16446;16641,17885,0,2,2,0,4
28945,60,8759,13186;13236,17885,0,0,2,0,2
28946,60,8760,13214;13305;17515,17885,1,0,2,0,3
28947,60,8761,13219;13544;17183,17885,1,0,2,0,3
28948,60,8762,13405;13657;16767;17190;17612,17885,2,1,2,0,5
28949,60,8763,13130;13421;16523,17885,0,1,2,0,3
28950,60,8764,13429;16925,17885,0,1,1,0,2
28951,60,8765,13435;13519,17885,0,0,2,0,2
28952,60,8766,13224;13442;17325,17885,1,0,2,0,3
28953,60,8767,13612;13893;16480;16735;17657,17885,1,2,2,0,5
28954,60,8768,13507;16884,17885,0,1,1,0,2
28955,60,8769,12807;13461,17885,0,0,2,0,2
28956,60,8770,13463;13481;17051;17267,17885,1,1,2,0,4
28957,60,8771,13479;16817;17157,17885,0,2,1,0,3
28958,60,8772,12557;13485,17885,0,0,2,0,2
28959,60,8773,13552;14142;17169;17501,17885,2,0,2,0,4
28960,60,8774,13518;13902,17885,0,0,2,0,2
28961,60,8775,13539;14143;16522;16865,17885,0,2,2,0,4
28962,60,8776,12888;13560;17127,17885,0,1,2,0,3
28963,60,8777,13375;13570;16874;17692,17885,1,1,2,0,4
28964,60,8778,12842;13584;17312;17567,17885,2,0,2,0,4
28965,60,8779,13764;13955;17096,17885,0,1,2,0,3
28966,60,8780,13701;16580;17585,17885,1,1,1,0,3
28967,60,8781,13645;13654;17174,17885,1,0,2,0,3
28968,60,8782,13592;17061,17885,0,1,1,0,2
28969,60,8783,13410;13803;16809;16997,17885,0,2,2,0,4
28970,60,8784,13683;13970;16881;17210,17885,1,1,2,0,4
28971,60,8785,14165;16686;17299,17885,1,1,1,0,3
28972,60,8786,13351;14183;17508,17885,1,0,2,0,3
28973,60,8787,13714;14112,17885,0,0,2,0,2
28974,60,8788,13716;13863,17885,0,0,2,0,2
28975,60,8789,13720;13826;16582;16791;16908,17885,0,3,2,0,5
28976,60,8790,13721;16662;16909;17421,17885,1,2,1,0,4
28977,60,8791,13752;14052;16610;17382,17885,1,1,2,0,4
28978,60,8792,13767,17885,0,0,1,0,1
28979,60,8793,13777;13868,17885,0,0,2,0,2
28980,60,8794,13797;13871;16796;17291,17885,1,1,2,0,4
28981,60,8797,3478,18250,0,0,1,0,1
28982,60,8800,4515,18250,0,0,1,0,1
28983,60,8801,6261,18250,0,0,0,1,1
28984,60,8804,379;6444,18250,0,0,2,0,2
28985,60,8805,1056;7324,18250,0,0,0,2,2
28986,60,8806,8473,18250,0,0,0,1,1
28987,60,8807,1328,18250,0,0,0,1,1
28988,60,8811,10123,18250,0,0,1,0,1
28989,60,8812,10102;10722,18250,0,0,2,0,2
28990,60,8813,10007,18250,0,0,1,0,1
28991,60,8817,10772,18250,0,0,1,0,1
28992,60,8821,10514;10978,18250,0,0,2,0,2
28993,60,8822,11066;11796;16627;16837,18250,0,2,2,0,4
28994,60,8823,11182;11741,18250,0,0,2,0,2
28995,60,8826,11613;11619;16632,18250,0,1,2,0,3
28996,60,8827,11655;11920;16575;17279,18250,1,1,2,0,4
28997,60,8828,11714;11895;16912,18250,0,1,2,0,3
28998,60,8830,11637;11973;16573;17517,18250,1,1,2,0,4
28999,60,8831,11890;11995;16614;16929,18250,0,2,2,0,4
29000,60,8832,11716;12425;16846;17634,18250,1,1,2,0,4
29001,60,8835,12375;13008,18250,0,0,2,0,2
29002,60,8836,12385;13077,18250,0,0,2,0,2
29003,60,8837,12394;13085;17044;17167,18250,0,2,2,0,4
29004,60,8838,12397;12411;16878,18250,0,1,2,0,3
29005,60,8839,12498;12540;17185,18250,1,0,2,0,3
29006,60,8840,12103;12617;17111,18250,0,1,2,0,3
29007,60,8841,12618;12940,18250,0,0,2,0,2
29008,60,8842,12112;12656;16964,18250,0,1,2,0,3
29009,60,8843,12399;12657;17284,18250,1,0,2,0,3
29010,60,8845,12720;13157;16971,18250,0,1,2,0,3
29011,60,8846,12742;17180,18250,1,0,1,0,2
29012,60,8847,12779;13478,18250,0,0,2,0,2
29013,60,8848,12811;17426,18250,1,0,1,0,2
29014,60,8849,12642;12944;17115,18250,0,1,2,0,3
29015,60,8850,12955;13187,18250,0,0,2,0,2
29016,60,8851,12965;13154;17264;17502,18250,2,0,2,0,4
29017,60,8852,12985;13838;16701,18250,0,1,2,0,3
29018,60,8853,13038;13153,18250,0,0,2,0,2
29019,60,8854,12891;13054;16961;17216,18250,1,1,2,0,4
29020,60,8855,13929;13985;17444,18250,1,0,2,0,3
29021,60,8856,12866;12989,18250,0,0,2,0,2
29022,60,8857,13129;13242;17005,18250,0,1,2,0,3
29023,60,8858,12354;12798;17154;17596,18250,1,1,2,0,4
29024,60,8859,13256;13695;16863;17403,18250,1,1,2,0,4
29025,60,8860,13174;13271;16666,18250,0,1,2,0,3
29026,60,8861,13279;13515;17357,18250,1,0,2,0,3
29027,60,8862,13670,18250,0,0,1,0,1
29028,60,8863,13315;13574,18250,0,0,2,0,2
29029,60,8864,13688;17268,18250,1,0,1,0,2
29030,60,8865,13330;13348;17035;17505,18250,1,1,2,0,4
29031,60,8867,13398;14150;17150;17401,18250,1,1,2,0,4
29032,60,8868,13486;13588;17103;17214,18250,1,1,2,0,4
29033,60,8870,13509;13590,18250,0,0,2,0,2
29034,60,8871,13512;14064;16591,18250,0,1,2,0,3
29035,60,8872,13407;13541;17089;17547;17593,18250,2,1,2,0,5
29036,60,8873,13558;13698;17260,18250,1,0,2,0,3
29037,60,8874,13339;13561;16869;17106,18250,0,2,2,0,4
29038,60,8875,13364;13573;17429,18250,1,0,2,0,3
29039,60,8876,13579;13761;16766,18250,0,1,2,0,3
29040,60,8877,13593;13748,18250,0,0,2,0,2
29041,60,8878,13290,18250,0,0,1,0,1
29042,60,8879,13597;14047;16668;17188;17303,18250,2,1,2,0,5
29043,60,8880,13260;13637;17675,18250,1,0,2,0,3
29044,60,8882,13628;13889;16648;16787;17440,18250,1,2,2,0,5
29045,60,8883,13631;13935;17311,18250,1,0,2,0,3
29046,60,8884,13725;14017;16879;17197,18250,1,1,2,0,4
29047,60,8885,13646,18250,0,0,1,0,1
29048,60,8886,13652;14190;16754;16894,18250,0,2,2,0,4
29049,60,8887,13659;13834;17100,18250,0,1,2,0,3
29050,60,8888,13662;14080;17590,18250,1,0,2,0,3
29051,60,8889,13678;13755,18250,0,0,2,0,2
29052,60,8890,14065;14268,18250,0,0,2,0,2
29053,60,8891,13709;14121;17387,18250,1,0,2,0,3
29054,60,8892,13265;13712;17370,18250,1,0,2,0,3
29055,60,8893,13578;13728;16637;17571,18250,1,1,2,0,4
29056,60,8894,13729;14071;16597;16833;17198,18250,1,2,2,0,5
29057,60,8895,13736;14096,18250,0,0,2,0,2
29058,60,8896,13369;13760;16758;17372,18250,1,1,2,0,4
29059,60,8897,13733;13773,18250,0,0,2,0,2
29060,60,8898,13813;14093;16729;17092;17329;17434,18250,2,2,2,0,6
29061,60,8899,13877;13996;17498,18250,1,0,2,0,3
29062,60,8900,13881;14299;17351;17568,18250,2,0,2,0,4
29063,60,8901,13203;13888;16825;17102;17408,18250,1,2,2,0,5
29064,60,8902,13892;14019;17618,18250,1,0,2,0,3
29065,60,8903,13681;13963,18250,0,0,2,0,2
29066,60,8904,13900;14189,18250,0,0,2,0,2
29067,60,8905,13915;13971;16781,18250,0,1,2,0,3
29068,60,8906,13879;13941;16579;17628,18250,1,1,2,0,4
29069,60,8907,13004;13946;17147;17259,18250,1,1,2,0,4
29070,60,8908,13625;13950;17392,18250,1,0,2,0,3
29071,60,8909,448,18615,0,0,1,0,1
29072,60,8910,1619;10146,18615,0,0,2,0,2
29073,60,8911,8799,18615,0,0,0,1,1
29074,60,8913,653;2365,18615,0,0,1,1,2
29075,60,8914,7418,18615,0,0,0,1,1
29076,60,8918,5775,18615,0,0,1,0,1
29077,60,8919,7385,18615,0,0,0,1,1
29078,60,8920,9037,18615,0,0,0,1,1
29079,60,8923,10134,18615,0,0,1,0,1
29080,60,8924,10144,18615,0,0,1,0,1
29081,60,8934,10790;11430;16972,18615,0,1,2,0,3
29082,60,8940,11630;11665,18615,0,0,2,0,2
29083,60,8943,11839;12002;16695;16986,18615,0,2,2,0,4
29084,60,8946,11859;12262;16713,18615,0,1,2,0,3
29085,60,8947,12279,18615,0,0,1,0,1
29086,60,8948,11808,18615,0,0,1,0,1
29087,60,8950,12526;13451,18615,0,0,2,0,2
29088,60,8951,12250,18615,0,0,1,0,1
29089,60,8952,12549;12749;16724,18615,0,1,2,0,3
29090,60,8953,12684;13262;17561,18615,1,0,2,0,3
29091,60,8954,12386;12695;16709;16829,18615,0,2,2,0,4
29092,60,8955,12700;12822;17250;17414,18615,2,0,2,0,4
29093,60,8956,12717;12733;16755;17243,18615,1,1,2,0,4
29094,60,8957,12503;12741;17068,18615,0,1,2,0,3
29095,60,8958,12751;13128;17084;17217,18615,1,1,2,0,4
29096,60,8959,13079,18615,0,0,1,0,1
29097,60,8960,12865;12936,18615,0,0,2,0,2
29098,60,8962,12746;12929;17104,18615,0,1,2,0,3
29099,60,8963,12947;13110,18615,0,0,2,0,2
29100,60,8964,12957;13606,18615,0,0,2,0,2
29101,60,8965,12970;13245;16851,18615,0,1,2,0,3
29102,60,8966,12973;13012,18615,0,0,2,0,2
29103,60,8967,13005;13575;17346;17683,18615,2,0,2,0,4
29104,60,8968,13029;14132,18615,0,0,2,0,2
29105,60,8969,13164;13620,18615,0,0,2,0,2
29106,60,8970,12421;13215;17455,18615,1,0,2,0,3
29107,60,8971,13258;13508,18615,0,0,2,0,2
29108,60,8972,13263;14206,18615,0,0,2,0,2
29109,60,8973,13273;13441;17310;17476,18615,2,0,2,0,4
29110,60,8974,13293;13766,18615,0,0,2,0,2
29111,60,8975,12926;13302,18615,0,0,2,0,2
29112,60,8976,13328;13546;17031,18615,0,1,2,0,3
29113,60,8977,13428;13749,18615,0,0,2,0,2
29114,60,8979,13317;13538;17128,18615,0,1,2,0,3
29115,60,8980,13686;13979;16891;17168;17513,18615,2,1,2,0,5
29116,60,8981,13557;13968,18615,0,0,2,0,2
29117,60,8982,13663;17027;17431,18615,1,1,1,0,3
29118,60,8983,13618;14210,18615,0,0,2,0,2
29119,60,8984,13636;13705;17423,18615,1,0,2,0,3
29120,60,8985,13393;13784,18615,0,0,2,0,2
29121,60,8986,13639;14011;17416,18615,1,0,2,0,3
29122,60,8987,13671;13824;17306,18615,1,0,2,0,3
29123,60,8988,13672;13991;17152;17402,18615,1,1,2,0,4
29124,60,8989,13673;14155;17281;17530,18615,2,0,2,0,4
29125,60,8990,14285,18615,0,0,1,0,1
29126,60,8991,13693;13772,18615,0,0,2,0,2
29127,60,8992,13727;14291,18615,0,0,2,0,2
29128,60,8993,13470;13759,18615,0,0,2,0,2
29129,60,8994,13841;14458;17282,18615,1,0,2,0,3
29130,60,8995,13913;14502;16886;17432,18615,1,1,2,0,4
29131,60,8996,13951;14328;17412;17512,18615,2,0,2,0,4
29132,60,8997,14048;17194;17453,18615,2,0,1,0,3
29133,60,8998,13999;14254;17175,18615,1,0,2,0,3
29134,60,8999,14000;14349,18615,0,0,2,0,2
29135,60,9000,13753;14021;17472,18615,1,0,2,0,3
29136,60,9001,13923;14022;17587,18615,1,0,2,0,3
29137,60,9002,14315,18615,0,0,1,0,1
29138,60,9003,14051;14125,18615,0,0,2,0,2
29139,60,9004,14061;14359,18615,0,0,2,0,2
29140,60,9005,13840;14067;17654,18615,1,0,2,0,3
29141,60,9006,13810;14069;16793,18615,0,1,2,0,3
29142,60,9007,13602;14074,18615,0,0,2,0,2
29143,60,9008,14032;14075,18615,0,0,2,0,2
29144,60,9009,13787;14084;16975,18615,0,1,2,0,3
29145,60,9011,7802,18980,0,0,0,1,1
29146,60,9012,5929,18980,0,0,1,0,1
29147,60,9013,6791,18980,0,0,0,1,1
29148,60,9014,4743,18980,0,0,0,1,1
29149,60,9015,5766,18980,0,0,1,0,1
29150,60,9021,4656,18980,0,0,0,1,1
29151,60,9023,2871;5557,18980,0,0,2,0,2
29152,60,9026,10155,18980,0,0,1,0,1
29153,60,9033,11037,18980,0,0,1,0,1
29154,60,9034,11750;11999,18980,0,0,2,0,2
29155,60,9039,10468;11309;16976,18980,0,1,2,0,3
29156,60,9042,11725;11868;17173;17687,18980,2,0,2,0,4
29157,60,9045,12194;16828,18980,0,1,1,0,2
29158,60,9046,11894,18980,0,0,1,0,1
29159,60,9051,12214,18980,0,0,1,0,1
29160,60,9052,12215;12935;17430,18980,1,0,2,0,3
29161,60,9054,12211;12442;17125,18980,0,1,2,0,3
29162,60,9055,11788,18980,0,0,1,0,1
29163,60,9056,12491,18980,0,0,1,0,1
29164,60,9058,12607;13231;16875,18980,0,1,2,0,3
29165,60,9060,12714;12976;17359,18980,1,0,2,0,3
29166,60,9061,12715;12975;16889;17016;17179,18980,1,2,2,0,5
29167,60,9062,12135;13090,18980,0,0,2,0,2
29168,60,9063,12845;13023;17202,18980,1,0,2,0,3
29169,60,9064,12849;13094;17036;17528,18980,1,1,2,0,4
29170,60,9065,12400,18980,0,0,1,0,1
29171,60,9066,12996;13642;17676,18980,1,0,2,0,3
29172,60,9067,12871,18980,0,0,1,0,1
29173,60,9068,12979;13059,18980,0,0,2,0,2
29174,60,9069,13051;13121;17054;17273,18980,1,1,2,0,4
29175,60,9070,13116;13122;17526,18980,1,0,2,0,3
29176,60,9071,13488;13768,18980,0,0,2,0,2
29177,60,9072,13208;13226,18980,0,0,2,0,2
29178,60,9073,13218;13379,18980,0,0,2,0,2
29179,60,9075,12833;13261,18980,0,0,2,0,2
29180,60,9076,12496;13266;16989;17170,18980,1,1,2,0,4
29181,60,9077,13282;13313;16940;17474,18980,1,1,2,0,4
29182,60,9078,13352;13629;17219;17296,18980,2,0,2,0,4
29183,60,9079,13374;13807;17283;17578,18980,2,0,2,0,4
29184,60,9080,13381;14303,18980,0,0,2,0,2
29185,60,9081,13385;13692,18980,0,0,2,0,2
29186,60,9082,13387;13420,18980,0,0,2,0,2
29187,60,9083,13426;13771,18980,0,0,2,0,2
29188,60,9084,13432;13487,18980,0,0,2,0,2
29189,60,9085,13710;14292,18980,0,0,2,0,2
29190,60,9086,13386;13447,18980,0,0,2,0,2
29191,60,9087,13212;13480;17620,18980,1,0,2,0,3
29192,60,9088,13160;13177,18980,0,0,2,0,2
29193,60,9089,13634;14159;17048;17186,18980,1,1,2,0,4
29194,60,9090,13649;14004;16838;17536,18980,1,1,2,0,4
29195,60,9091,13667;14276,18980,0,0,2,0,2
29196,60,9092,12974;13669;17017;17451;17601,18980,2,1,2,0,5
29197,60,9093,13703;13911;17553,18980,1,0,2,0,3
29198,60,9094,13674;13707;17181,18980,1,0,2,0,3
29199,60,9095,13517;14095,18980,0,0,2,0,2
29200,60,9096,14567;16857;17193,18980,1,1,1,0,3
29201,60,9097,13774;14340,18980,0,0,2,0,2
29202,60,9098,13490;13814;16832,18980,0,1,2,0,3
29203,60,9099,13820;14318,18980,0,0,2,0,2
29204,60,9100,13830;14494;17388,18980,1,0,2,0,3
29205,60,9101,13836;14406,18980,0,0,2,0,2
29206,60,9102,13867;14327,18980,0,0,2,0,2
29207,60,9103,13758;14063;17289;17682,18980,2,0,2,0,4
29208,60,9104,13641;13890;17116;17611,18980,1,1,2,0,4
29209,60,9105,13897;14439,18980,0,0,2,0,2
29210,60,9106,13916;14293;17479,18980,1,0,2,0,3
29211,60,9107,13312;13920;17149,18980,0,1,2,0,3
29212,60,9108,14212,18980,0,0,1,0,1
29213,60,9109,13145;13956;17452,18980,1,0,2,0,3
29214,60,9110,13958,18980,0,0,1,0,1
29215,60,9111,13270;13967,18980,0,0,2,0,2
29216,60,9112,13981;17072,18980,0,1,1,0,2
29217,60,9113,13988;14478,18980,0,0,2,0,2
29218,60,9114,13872;14008;17352;17574,18980,2,0,2,0,4
29219,60,9115,14034;14070,18980,0,0,2,0,2
29220,60,9116,14037;14215,18980,0,0,2,0,2
29221,60,9117,14057;14475;16983;17224,18980,1,1,2,0,4
29222,60,9118,14153,18980,0,0,1,0,1
29223,60,9119,14130;14302,18980,0,0,2,0,2
29224,60,9120,14081;14496,18980,0,0,2,0,2
29225,60,9121,14085;14102,18980,0,0,2,0,2
29226,60,9122,14110;14263,18980,0,0,2,0,2
29227,60,9123,14137;14590;16826;17468,18980,1,1,2,0,4
29228,60,9124,13835;14169,18980,0,0,2,0,2
29229,60,9125,14171;14530;17030;17615,18980,1,1,2,0,4
29230,60,9127,6466,19345,0,0,0,1,1
29231,60,9131,7257,19345,0,0,1,0,1
29232,60,9135,10028,19345,0,0,1,0,1
29233,60,9142,10498,19345,0,0,1,0,1
29234,60,9144,11203,19345,0,0,1,0,1
29235,60,9146,11479,19345,0,0,1,0,1
29236,60,9149,11772;12036;17151,19345,0,1,2,0,3
29237,60,9150,11406;11794;17248,19345,1,0,2,0,3
29238,60,9151,11951;12427;17081;17647,19345,1,1,2,0,4
29239,60,9153,12050;17038,19345,0,1,1,0,2
29240,60,9154,12055;12216;17112,19345,0,1,2,0,3
29241,60,9156,11871;12113;17021,19345,0,1,2,0,3
29242,60,9157,12223,19345,0,0,1,0,1
29243,60,9158,12226,19345,0,0,1,0,1
29244,60,9159,11976,19345,0,0,1,0,1
29245,60,9160,11893,19345,0,0,1,0,1
29246,60,9161,12664,19345,0,0,1,0,1
29247,60,9163,12481,19345,0,0,1,0,1
29248,60,9165,12506;13225;17028,19345,0,1,2,0,3
29249,60,9166,12579;12843;17280;17435,19345,2,0,2,0,4
29250,60,9167,12651;12790;17637,19345,1,0,2,0,3
29251,60,9168,12682,19345,0,0,1,0,1
29252,60,9169,13332;13484,19345,0,0,2,0,2
29253,60,9170,12182;12747;16947,19345,0,1,2,0,3
29254,60,9171,12640;12899,19345,0,0,2,0,2
29255,60,9172,12435;12896,19345,0,0,2,0,2
29256,60,9173,12884;12898;17025,19345,0,1,2,0,3
29257,60,9174,12943;13930;17182,19345,1,0,2,0,3
29258,60,9175,12954;13648,19345,0,0,2,0,2
29259,60,9176,12312;13173,19345,0,0,2,0,2
29260,60,9177,13072;17107;17591,19345,1,1,1,0,3
29261,60,9178,13088;13412,19345,0,0,2,0,2
29262,60,9179,13123;14029;17208,19345,1,0,2,0,3
29263,60,9180,13125;13357;17165;17466,19345,1,1,2,0,4
29264,60,9181,13136;13831;17278,19345,1,0,2,0,3
29265,60,9182,13170;13718,19345,0,0,2,0,2
29266,60,9183,13193;13402,19345,0,0,2,0,2
29267,60,9184,13217,19345,0,0,1,0,1
29268,60,9185,13230,19345,0,0,1,0,1
29269,60,9186,13253;13477;17361,19345,1,0,2,0,3
29270,60,9187,13285;13440,19345,0,0,2,0,2
29271,60,9188,13205;13322;17148;17200,19345,1,1,2,0,4
29272,60,9189,13325;17645,19345,1,0,1,0,2
29273,60,9190,13326;13861,19345,0,0,2,0,2
29274,60,9192,13395;14231,19345,0,0,2,0,2
29275,60,9193,13424;13818,19345,0,0,2,0,2
29276,60,9194,13210,19345,0,0,1,0,1
29277,60,9195,13474;13922;17095;17338,19345,1,1,2,0,4
29278,60,9196,13489;14168,19345,0,0,2,0,2
29279,60,9197,13498,19345,0,0,1,0,1
29280,60,9198,13043;13433,19345,0,0,2,0,2
29281,60,9199,13548;14316;17235,19345,1,0,2,0,3
29282,60,9200,13585;14009;17668,19345,1,0,2,0,3
29283,60,9201,13349,19345,0,0,1,0,1
29284,60,9202,13605;13677;17334,19345,1,0,2,0,3
29285,60,9203,13791;17053;17343,19345,1,1,1,0,3
29286,60,9204,13452;13633;17132,19345,0,1,2,0,3
29287,60,9205,13689;14107;16992;17597,19345,1,1,2,0,4
29288,60,9206,13691;13723;17381,19345,1,0,2,0,3
29289,60,9207,13730;14374;16944;17661,19345,1,1,2,0,4
29290,60,9208,13739;14164;16979;17234,19345,1,1,2,0,4
29291,60,9209,13747;13973;16990;17681,19345,1,1,2,0,4
29292,60,9210,13763;13809;16982;17410,19345,1,1,2,0,4
29293,60,9211,14056;17123,19345,0,1,1,0,2
29294,60,9212,13458;13815;17133,19345,0,1,2,0,3
29295,60,9213,13786;13823;17471,19345,1,0,2,0,3
29296,60,9214,14580,19345,0,0,1,0,1
29297,60,9215,13886;14370,19345,0,0,2,0,2
29298,60,9216,13906;13966,19345,0,0,2,0,2
29299,60,9217,13257;14089;17540,19345,1,0,2,0,3
29300,60,9218,13959;14411;16945;17337;17362;17664,19345,3,1,2,0,6
29301,60,9219,13754;13961;17580,19345,1,0,2,0,3
29302,60,9220,13571;13965;17004;17146,19345,0,2,2,0,4
29303,60,9221,13842;13972,19345,0,0,2,0,2
29304,60,9222,14033;14235,19345,0,0,2,0,2
29305,60,9223,14040;14499;17049,19345,0,1,2,0,3
29306,60,9224,13927,19345,0,0,1,0,1
29307,60,9225,14098;14789;17461,19345,1,0,2,0,3
29308,60,9227,14124;14413,19345,0,0,2,0,2
29309,60,9228,13848;14126,19345,0,0,2,0,2
29310,60,9229,14133;14365,19345,0,0,2,0,2
29311,60,9230,14134;14353,19345,0,0,2,0,2
29312,60,9231,13687;14140,19345,0,0,2,0,2
29313,60,9232,14144;14605;17589,19345,1,0,2,0,3
29314,60,9233,14161;14464;17257;17475,19345,2,0,2,0,4
29315,60,9234,14180;14715,19345,0,0,2,0,2
29316,60,9235,13817;14229,19345,0,0,2,0,2
29317,60,9236,14062;14259,19345,0,0,2,0,2
29318,60,9237,14099;14270,19345,0,0,2,0,2
29319,60,9238,13790;14277;17114,19345,0,1,2,0,3
29320,60,9239,14282;14319;17023;17322;17470,19345,2,1,2,0,5
29321,60,9240,14287,19345,0,0,1,0,1
29322,60,9241,13713;14305,19345,0,0,2,0,2
29323,60,9242,14306;14675;17001;17262;17533,19345,2,1,2,0,5
29324,60,9243,14330;14615;17094,19345,0,1,2,0,3
29325,60,9244,14323;14364;17156;17586,19345,1,1,2,0,4
29326,60,9245,6707,19710,0,0,0,1,1
29327,60,9246,4476;4699,19710,0,0,1,1,2
29328,60,9247,5187,19710,0,0,0,1,1
29329,60,9248,2893,19710,0,0,0,1,1
29330,60,9249,3863,19710,0,0,1,0,1
29331,60,9250,10439,19710,0,0,1,0,1
29332,60,9253,10670,19710,0,0,1,0,1
29333,60,9256,11028;11414,19710,0,0,2,0,2
29334,60,9260,11328,19710,0,0,1,0,1
29335,60,9264,11818;11878;17162,19710,0,1,2,0,3
29336,60,9265,11057,19710,0,0,1,0,1
29337,60,9268,11939,19710,0,0,1,0,1
29338,60,9271,12305;12369;17098,19710,0,1,2,0,3
29339,60,9273,12445;12903,19710,0,0,2,0,2
29340,60,9275,12542,19710,0,0,1,0,1
29341,60,9276,12667,19710,0,0,1,0,1
29342,60,9277,12474,19710,0,0,1,0,1
29343,60,9279,12956,19710,0,0,1,0,1
29344,60,9280,13049;13284;17270,19710,1,0,2,0,3
29345,60,9281,13081;13513;17124,19710,0,1,2,0,3
29346,60,9282,13117;13494;17108;17345,19710,1,1,2,0,4
29347,60,9284,13196;13283,19710,0,0,2,0,2
29348,60,9285,13032;13338,19710,0,0,2,0,2
29349,60,9286,13399;13524;17163,19710,0,1,2,0,3
29350,60,9287,12608,19710,0,0,1,0,1
29351,60,9288,12897;13430;17142;17642,19710,1,1,2,0,4
29352,60,9289,13437;14006;17493,19710,1,0,2,0,3
29353,60,9290,13152;13465;17374,19710,1,0,2,0,3
29354,60,9291,12861;13015,19710,0,0,2,0,2
29355,60,9292,13547,19710,0,0,1,0,1
29356,60,9293,13556;13905;17099;17254,19710,1,1,2,0,4
29357,60,9294,13601;14149;17119;17228,19710,1,1,2,0,4
29358,60,9295,13757;13808;17666,19710,1,0,2,0,3
29359,60,9296,13661;13858;17199;17389,19710,2,0,2,0,4
29360,60,9297,13675;13799;17473;17690,19710,2,0,2,0,4
29361,60,9298,13859,19710,0,0,1,0,1
29362,60,9299,13778;14131,19710,0,0,2,0,2
29363,60,9300,13499;13796,19710,0,0,2,0,2
29364,60,9301,13822;14135,19710,0,0,2,0,2
29365,60,9302,13829;14073,19710,0,0,2,0,2
29366,60,9303,13839;13933,19710,0,0,2,0,2
29367,60,9304,13866;14366,19710,0,0,2,0,2
29368,60,9305,13804;13882;17293,19710,1,0,2,0,3
29369,60,9306,14224,19710,0,0,1,0,1
29370,60,9307,14344,19710,0,0,1,0,1
29371,60,9308,13984;14463;17290;17446,19710,2,0,2,0,4
29372,60,9309,13770;13990,19710,0,0,2,0,2
29373,60,9310,14247;14417,19710,0,0,2,0,2
29374,60,9311,13994;14311;17203,19710,1,0,2,0,3
29375,60,9312,14028;14437;17579,19710,1,0,2,0,3
29376,60,9313,13704;14077;17523,19710,1,0,2,0,3
29377,60,9314,13724;14136;17465,19710,1,0,2,0,3
29378,60,9315,14101,19710,0,0,1,0,1
29379,60,9316,14079;14771,19710,0,0,2,0,2
29380,60,9317,14139,19710,0,0,1,0,1
29381,60,9318,14146;14584;17137,19710,0,1,2,0,3
29382,60,9319,14030;14151;17486,19710,1,0,2,0,3
29383,60,9320,14156;14866;17121;17411,19710,1,1,2,0,4
29384,60,9321,14172;14739,19710,0,0,2,0,2
29385,60,9322,14201,19710,0,0,1,0,1
29386,60,9323,14238;14527,19710,0,0,2,0,2
29387,60,9324,13726;14321,19710,0,0,2,0,2
29388,60,9325,13788;14333;17255;17419;17655,19710,3,0,2,0,5
29389,60,9326,13816;14363;17241;17449,19710,2,0,2,0,4
29390,60,9327,14381;14753;17516,19710,1,0,2,0,3
29391,60,9328,13785;14385;17375,19710,1,0,2,0,3
29392,60,9329,13980;14398,19710,0,0,2,0,2
29393,60,9330,14718,19710,0,0,1,0,1
29394,60,9331,14400;14797,19710,0,0,2,0,2
29395,60,9332,14407;14821,19710,0,0,2,0,2
29396,60,9333,14432;14897,19710,0,0,2,0,2
29397,60,9334,14457;14560,19710,0,0,2,0,2
29398,60,9335,13983;14469,19710,0,0,2,0,2
29399,60,9336,13978;14481,19710,0,0,2,0,2
29400,60,9337,14036;14503;17245,19710,1,0,2,0,3
29401,60,9338,14727;14890,19710,0,0,2,0,2
29402,60,9339,14166;14514,19710,0,0,2,0,2
29403,60,9340,14241;14522,19710,0,0,2,0,2
29404,60,9341,3517;9689,20075,0,0,0,2,2
29405,60,9342,6990,20075,0,0,1,0,1
29406,60,9343,3859,20075,0,0,0,1,1
29407,60,9345,7344,20075,0,0,0,1,1
29408,60,9347,2384,20075,0,0,0,1,1
29409,60,9348,29,20075,0,0,1,0,1
29410,60,9349,10015,20075,0,0,1,0,1
29411,60,9350,10267,20075,0,0,1,0,1
29412,60,9352,10419,20075,0,0,1,0,1
29413,60,9353,10087,20075,0,0,1,0,1
29414,60,9356,10212,20075,0,0,1,0,1
29415,60,9357,10125,20075,0,0,1,0,1
29416,60,9358,10864,20075,0,0,1,0,1
29417,60,9363,11297,20075,0,0,1,0,1
29418,60,9364,11539;11764;17584,20075,1,0,2,0,3
29419,60,9365,11544,20075,0,0,1,0,1
29420,60,9367,11608,20075,0,0,1,0,1
29421,60,9370,11820,20075,0,0,1,0,1
29422,60,9372,11972,20075,0,0,1,0,1
29423,60,9373,11402,20075,0,0,1,0,1
29424,60,9375,12348,20075,0,0,1,0,1
29425,60,9376,11829,20075,0,0,1,0,1
29426,60,9377,12437;12459;17383,20075,1,0,2,0,3
29427,60,9379,11929,20075,0,0,1,0,1
29428,60,9382,12894,20075,0,0,1,0,1
29429,60,9384,12708;13002;17256;17659,20075,2,0,2,0,4
29430,60,9385,12704,20075,0,0,1,0,1
29431,60,9386,13060,20075,0,0,1,0,1
29432,60,9387,13073,20075,0,0,1,0,1
29433,60,9388,12671;13309;17269,20075,1,0,2,0,3
29434,60,9389,13078,20075,0,0,1,0,1
29435,60,9390,13156;13337;17413,20075,1,0,2,0,3
29436,60,9391,13076,20075,0,0,1,0,1
29437,60,9392,13345,20075,0,0,1,0,1
29438,60,9393,13000;13151,20075,0,0,2,0,2
29439,60,9394,13355;13565;17644,20075,1,0,2,0,3
29440,60,9395,13373;13495,20075,0,0,2,0,2
29441,60,9396,13453;14042,20075,0,0,2,0,2
29442,60,9397,13460;17192,20075,1,0,1,0,2
29443,60,9398,13529;13864,20075,0,0,2,0,2
29444,60,9399,13611;14194,20075,0,0,2,0,2
29445,60,9400,13660;13702;17549,20075,1,0,2,0,3
29446,60,9401,13521;13668,20075,0,0,2,0,2
29447,60,9402,13276;13737,20075,0,0,2,0,2
29448,60,9403,13743;14013,20075,0,0,2,0,2
29449,60,9404,13621,20075,0,0,1,0,1
29450,60,9405,13383;13833;17225,20075,1,0,2,0,3
29451,60,9406,14578;17385;17691,20075,2,0,1,0,3
29452,60,9407,13722;14123;17349,20075,1,0,2,0,3
29453,60,9408,13862;17332,20075,1,0,1,0,2
29454,60,9409,14309;14474,20075,0,0,2,0,2
29455,60,9410,13899;14483,20075,0,0,2,0,2
29456,60,9411,13901;14281,20075,0,0,2,0,2
29457,60,9412,13616;13948,20075,0,0,2,0,2
29458,60,9413,13998;14855;17341,20075,1,0,2,0,3
29459,60,9414,13551;14005,20075,0,0,2,0,2
29460,60,9415,14015;14204;17638,20075,1,0,2,0,3
29461,60,9416,14043;14531,20075,0,0,2,0,2
29462,60,9417,13800,20075,0,0,1,0,1
29463,60,9418,14059;14853;17454;17674,20075,2,0,2,0,4
29464,60,9419,13462;14060;17433,20075,1,0,2,0,3
29465,60,9420,13699,20075,0,0,1,0,1
29466,60,9421,14087;14427,20075,0,0,2,0,2
29467,60,9422,14007;14090,20075,0,0,2,0,2
29468,60,9423,14091;14741,20075,0,0,2,0,2
29469,60,9424,14039;14104,20075,0,0,2,0,2
29470,60,9425,14106;14516,20075,0,0,2,0,2
29471,60,9426,14108;14805,20075,0,0,2,0,2
29472,60,9427,13943;14111,20075,0,0,2,0,2
29473,60,9428,14179,20075,0,0,1,0,1
29474,60,9429,14207;14255;17462,20075,1,0,2,0,3
29475,60,9430,14202;14209;17544,20075,1,0,2,0,3
29476,60,9431,14035;14220;17221,20075,1,0,2,0,3
29477,60,9432,14058;14221,20075,0,0,2,0,2
29478,60,9433,14196;14226,20075,0,0,2,0,2
29479,60,9434,14250;14357,20075,0,0,2,0,2
29480,60,9435,14383;14824;17355;17564;17573,20075,3,0,2,0,5
29481,60,9436,14408,20075,0,0,1,0,1
29482,60,9437,13885;14419,20075,0,0,2,0,2
29483,60,9438,14453,20075,0,0,1,0,1
29484,60,9439,14174;14454,20075,0,0,2,0,2
29485,60,9440,14294;14482,20075,0,0,2,0,2
29486,60,9441,14489;14585;17252;17632,20075,2,0,2,0,4
29487,60,9442,14505;15063,20075,0,0,2,0,2
29488,60,9443,14480;14507,20075,0,0,2,0,2
29489,60,9444,14082;14517,20075,0,0,2,0,2
29490,60,9445,13932;14524,20075,0,0,2,0,2
29491,60,9446,14539;14854,20075,0,0,2,0,2
29492,60,9447,14551;14684,20075,0,0,2,0,2
29493,60,9448,14289;14573,20075,0,0,2,0,2
29494,60,9449,14589;14765,20075,0,0,2,0,2
29495,60,9450,14591;14863,20075,0,0,2,0,2
29496,60,9451,14426;14609;17205,20075,1,0,2,0,3
29497,60,9452,14612,20075,0,0,1,0,1
29498,60,9453,14613;14724,20075,0,0,2,0,2
29499,60,9454,13914;14622,20075,0,0,2,0,2
29500,60,9455,14368;14623,20075,0,0,2,0,2
29501,60,9456,14624;15027;17242,20075,1,0,2,0,3
29502,60,9457,14629;14971;17478,20075,1,0,2,0,3
29503,60,9458,14242;14643;17265;17335;17653,20075,3,0,2,0,5
29504,60,9459,14652;15086;17364,20075,1,0,2,0,3
29505,60,9460,18,20440,0,0,1,0,1
29506,60,9461,9520;10344,20440,0,0,2,0,2
29507,60,9462,8372,20440,0,0,1,0,1
29508,60,9463,10034,20440,0,0,1,0,1
29509,60,9464,10061,20440,0,0,1,0,1
29510,60,9466,10327,20440,0,0,1,0,1
29511,60,9467,10487,20440,0,0,1,0,1
29512,60,9470,10161,20440,0,0,1,0,1
29513,60,9472,10747;10768,20440,0,0,2,0,2
29514,60,9475,11483,20440,0,0,1,0,1
29515,60,9477,10464,20440,0,0,1,0,1
29516,60,9478,10996,20440,0,0,1,0,1
29517,60,9479,11290,20440,0,0,1,0,1
29518,60,9481,11310,20440,0,0,1,0,1
29519,60,9482,11352,20440,0,0,1,0,1
29520,60,9483,11314,20440,0,0,1,0,1
29521,60,9484,11490,20440,0,0,1,0,1
29522,60,9488,11849;12217;17456,20440,1,0,2,0,3
29523,60,9491,11953,20440,0,0,1,0,1
29524,60,9492,12007,20440,0,0,1,0,1
29525,60,9493,12073,20440,0,0,1,0,1
29526,60,9494,12166;17301,20440,1,0,1,0,2
29527,60,9495,11965,20440,0,0,1,0,1
29528,60,9496,12567;12922;17274,20440,1,0,2,0,3
29529,60,9498,12686,20440,0,0,1,0,1
29530,60,9502,13101;13591,20440,0,0,2,0,2
29531,60,9503,13135;13765,20440,0,0,2,0,2
29532,60,9504,13190;13329;17424;17679,20440,2,0,2,0,4
29533,60,9505,13244;13910;17519,20440,1,0,2,0,3
29534,60,9506,13307,20440,0,0,1,0,1
29535,60,9508,12961,20440,0,0,1,0,1
29536,60,9509,13936,20440,0,0,1,0,1
29537,60,9510,13506;13694;17663,20440,1,0,2,0,3
29538,60,9511,13545,20440,0,0,1,0,1
29539,60,9512,13589;13945;17271,20440,1,0,2,0,3
29540,60,9513,13608;14297,20440,0,0,2,0,2
29541,60,9514,13643,20440,0,0,1,0,1
29542,60,9515,13651,20440,0,0,1,0,1
29543,60,9516,13598,20440,0,0,1,0,1
29544,60,9517,12882;13706;17305;17610,20440,2,0,2,0,4
29545,60,9518,13717;13719,20440,0,0,2,0,2
29546,60,9521,13851;14298,20440,0,0,2,0,2
29547,60,9522,13891,20440,0,0,1,0,1
29548,60,9523,13977,20440,0,0,1,0,1
29549,60,9524,12875;13924;17366,20440,1,0,2,0,3
29550,60,9525,13912;13925,20440,0,0,2,0,2
29551,60,9526,13783;13954;17669,20440,1,0,2,0,3
29552,60,9527,13908,20440,0,0,1,0,1
29553,60,9528,13989;15049,20440,0,0,2,0,2
29554,60,9529,14014;14184,20440,0,0,2,0,2
29555,60,9530,14115;14513;17643,20440,1,0,2,0,3
29556,60,9531,14120;14754;17386,20440,1,0,2,0,3
29557,60,9532,14117;14147,20440,0,0,2,0,2
29558,60,9533,14162;14646;17333,20440,1,0,2,0,3
29559,60,9534,14163;14267,20440,0,0,2,0,2
29560,60,9535,14175;14217,20440,0,0,2,0,2
29561,60,9536,14213;14655,20440,0,0,2,0,2
29562,60,9537,14222;14232,20440,0,0,2,0,2
29563,60,9538,13563;14233,20440,0,0,2,0,2
29564,60,9539,15017,20440,0,0,1,0,1
29565,60,9540,14278;14902,20440,0,0,2,0,2
29566,60,9541,14286;14424,20440,0,0,2,0,2
29567,60,9542,14053;14313,20440,0,0,2,0,2
29568,60,9543,14113;14314;17673,20440,1,0,2,0,3
29569,60,9544,13873,20440,0,0,1,0,1
29570,60,9545,14248,20440,0,0,1,0,1
29571,60,9546,14072;14376,20440,0,0,2,0,2
29572,60,9547,14382,20440,0,0,1,0,1
29573,60,9548,14444;14827,20440,0,0,2,0,2
29574,60,9549,14420;14456,20440,0,0,2,0,2
29575,60,9550,14462;14958,20440,0,0,2,0,2
29576,60,9551,14465;14884,20440,0,0,2,0,2
29577,60,9552,13874;14105,20440,0,0,2,0,2
29578,60,9553,14301;14485,20440,0,0,2,0,2
29579,60,9554,14487;14577,20440,0,0,2,0,2
29580,60,9555,14492;14709,20440,0,0,2,0,2
29581,60,9556,14145;14501,20440,0,0,2,0,2
29582,60,9557,14509,20440,0,0,1,0,1
29583,60,9558,14068;14512;17640,20440,1,0,2,0,3
29584,60,9559,14535;14838,20440,0,0,2,0,2
29585,60,9560,14555;15215,20440,0,0,2,0,2
29586,60,9561,14559;14847;17488,20440,1,0,2,0,3
29587,60,9562,14661,20440,0,0,1,0,1
29588,60,9563,13741,20440,0,0,1,0,1
29589,60,9564,14568;14601,20440,0,0,2,0,2
29590,60,9565,14563;14600,20440,0,0,2,0,2
29591,60,9566,14908;17560;17631,20440,2,0,1,0,3
29592,60,9567,14553;14639;17459,20440,1,0,2,0,3
29593,60,9568,14640;14687,20440,0,0,2,0,2
29594,60,9569,14683;14998,20440,0,0,2,0,2
29595,60,9570,14693;17554,20440,1,0,1,0,2
29596,60,9571,14571;14697,20440,0,0,2,0,2
29597,60,9572,14717;14945;17275;17550,20440,2,0,2,0,4
29598,60,9573,14399;14869,20440,0,0,2,0,2
29599,60,9574,14738;15154,20440,0,0,2,0,2
29600,60,9575,14758;15078,20440,0,0,2,0,2
29601,60,9576,14759;14843;17317,20440,1,0,2,0,3
29602,60,9577,14435;14779,20440,0,0,2,0,2
29603,60,9578,839;8998,20805,0,0,2,0,2
29604,60,9579,10018;10023,20805,0,0,2,0,2
29605,60,9580,10110,20805,0,0,1,0,1
29606,60,9582,3840,20805,0,0,0,1,1
29607,60,9583,10095,20805,0,0,1,0,1
29608,60,9584,10157,20805,0,0,1,0,1
29609,60,9585,10328,20805,0,0,1,0,1
29610,60,9586,10611;10856,20805,0,0,2,0,2
29611,60,9589,10149;10677,20805,0,0,2,0,2
29612,60,9590,10761,20805,0,0,1,0,1
29613,60,9591,10428,20805,0,0,1,0,1
29614,60,9593,10533,20805,0,0,1,0,1
29615,60,9594,10987,20805,0,0,1,0,1
29616,60,9595,11005,20805,0,0,1,0,1
29617,60,9598,11020,20805,0,0,1,0,1
29618,60,9599,11507,20805,0,0,1,0,1
29619,60,9601,11634,20805,0,0,1,0,1
29620,60,9602,11391,20805,0,0,1,0,1
29621,60,9603,11623,20805,0,0,1,0,1
29622,60,9607,12180,20805,0,0,1,0,1
29623,60,9609,12010,20805,0,0,1,0,1
29624,60,9610,12300,20805,0,0,1,0,1
29625,60,9611,13045,20805,0,0,1,0,1
29626,60,9612,12599,20805,0,0,1,0,1
29627,60,9613,12663,20805,0,0,1,0,1
29628,60,9614,12696,20805,0,0,1,0,1
29629,60,9615,12712,20805,0,0,1,0,1
29630,60,9617,12654,20805,0,0,1,0,1
29631,60,9618,12800;13099;17562,20805,1,0,2,0,3
29632,60,9619,12543,20805,0,0,1,0,1
29633,60,9620,12535,20805,0,0,1,0,1
29634,60,9621,12688;12969;17442;17626,20805,2,0,2,0,4
29635,60,9622,12689;13017,20805,0,0,2,0,2
29636,60,9623,13050;13613,20805,0,0,2,0,2
29637,60,9624,13056,20805,0,0,1,0,1
29638,60,9625,13269;14265,20805,0,0,2,0,2
29639,60,9626,13354;13776,20805,0,0,2,0,2
29640,60,9627,13020,20805,0,0,1,0,1
29641,60,9628,13504,20805,0,0,1,0,1
29642,60,9629,13569;13949,20805,0,0,2,0,2
29643,60,9630,13576;13697,20805,0,0,2,0,2
29644,60,9631,13632;13746,20805,0,0,2,0,2
29645,60,9633,13735;13957,20805,0,0,2,0,2
29646,60,9634,13852;13938;17656,20805,1,0,2,0,3
29647,60,9635,13853;14939,20805,0,0,2,0,2
29648,60,9636,14409,20805,0,0,1,0,1
29649,60,9637,13700;13944,20805,0,0,2,0,2
29650,60,9638,13969;14425,20805,0,0,2,0,2
29651,60,9639,13806;13976,20805,0,0,2,0,2
29652,60,9640,14026,20805,0,0,1,0,1
29653,60,9641,14118;14520,20805,0,0,2,0,2
29654,60,9642,13993;14122;17678,20805,1,0,2,0,3
29655,60,9643,14154;14850,20805,0,0,2,0,2
29656,60,9644,14157;14236,20805,0,0,2,0,2
29657,60,9645,14158;14570,20805,0,0,2,0,2
29658,60,9646,14188;14468,20805,0,0,2,0,2
29659,60,9647,13658;14243,20805,0,0,2,0,2
29660,60,9648,14317;14604;17445,20805,1,0,2,0,3
29661,60,9649,14275,20805,0,0,1,0,1
29662,60,9650,14358;14393,20805,0,0,2,0,2
29663,60,9651,14240;14384,20805,0,0,2,0,2
29664,60,9652,14050;14396,20805,0,0,2,0,2
29665,60,9653,14245;14403,20805,0,0,2,0,2
29666,60,9654,14279;14443;17507,20805,1,0,2,0,3
29667,60,9655,14466;15126;17559;17604,20805,2,0,2,0,4
29668,60,9656,14086;14536,20805,0,0,2,0,2
29669,60,9657,14540;14745,20805,0,0,2,0,2
29670,60,9658,14582,20805,0,0,1,0,1
29671,60,9659,14261;14595,20805,0,0,2,0,2
29672,60,9660,14596;14930,20805,0,0,2,0,2
29673,60,9661,14564;14647,20805,0,0,2,0,2
29674,60,9662,14392;14649,20805,0,0,2,0,2
29675,60,9663,14658;14763,20805,0,0,2,0,2
29676,60,9664,14266;14674;17369;17650,20805,2,0,2,0,4
29677,60,9665,14676;14825,20805,0,0,2,0,2
29678,60,9666,14704;15034,20805,0,0,2,0,2
29679,60,9667,14548;14706;17356;17557,20805,2,0,2,0,4
29680,60,9668,14003;14732,20805,0,0,2,0,2
29681,60,9669,13690;14769,20805,0,0,2,0,2
29682,60,9670,14775;15135,20805,0,0,2,0,2
29683,60,9671,14593;14781,20805,0,0,2,0,2
29684,60,9672,14785;15035,20805,0,0,2,0,2
29685,60,9673,14786;15260;17577,20805,1,0,2,0,3
29686,60,9674,14607;14801,20805,0,0,2,0,2
29687,60,9675,14813;15240,20805,0,0,2,0,2
29688,60,9676,14849;15187;17437;17581,20805,2,0,2,0,4
29689,60,9677,14856;14951,20805,0,0,2,0,2
29690,60,9678,14871;15176,20805,0,0,2,0,2
29691,60,9679,14873;15317;17667,20805,1,0,2,0,3
29692,60,9680,14875,20805,0,0,1,0,1
29693,60,9681,14886;15364;17680,20805,1,0,2,0,3
29694,60,9682,14887;15070,20805,0,0,2,0,2
29695,60,9683,14893,20805,0,0,1,0,1
29696,60,9684,14736;14916,20805,0,0,2,0,2
29697,60,9685,14917,20805,0,0,1,0,1
29698,60,9686,14868;14924,20805,0,0,2,0,2
29699,60,9687,14926;15394,20805,0,0,2,0,2
29700,60,9688,14940;14986,20805,0,0,2,0,2
29701,60,9689,1940,21170,0,0,1,0,1
29702,60,9690,10242,21170,0,0,1,0,1
29703,60,9691,10313,21170,0,0,1,0,1
29704,60,9692,10449,21170,0,0,1,0,1
29705,60,9694,10285;10528,21170,0,0,2,0,2
29706,60,9695,10534,21170,0,0,1,0,1
29707,60,9697,10025,21170,0,0,1,0,1
29708,60,9698,10538,21170,0,0,1,0,1
29709,60,9699,10423,21170,0,0,1,0,1
29710,60,9700,10946,21170,0,0,1,0,1
29711,60,9703,10934,21170,0,0,1,0,1
29712,60,9706,11125,21170,0,0,1,0,1
29713,60,9707,11006,21170,0,0,1,0,1
29714,60,9709,11563;11914,21170,0,0,2,0,2
29715,60,9711,11736;12030;17469,21170,1,0,2,0,3
29716,60,9713,11983,21170,0,0,1,0,1
29717,60,9714,11909,21170,0,0,1,0,1
29718,60,9715,12085,21170,0,0,1,0,1
29719,60,9716,12200,21170,0,0,1,0,1
29720,60,9717,12698,21170,0,0,1,0,1
29721,60,9718,12184,21170,0,0,1,0,1
29722,60,9719,12753,21170,0,0,1,0,1
29723,60,9720,12676,21170,0,0,1,0,1
29724,60,9722,12440,21170,0,0,1,0,1
29725,60,9723,13003;13358;17458,21170,1,0,2,0,3
29726,60,9724,12416,21170,0,0,1,0,1
29727,60,9726,13362;13825,21170,0,0,2,0,2
29728,60,9728,13522,21170,0,0,1,0,1
29729,60,9729,13553,21170,0,0,1,0,1
29730,60,9730,13819;14784;17670,21170,1,0,2,0,3
29731,60,9731,13903;14397,21170,0,0,2,0,2
29732,60,9732,13682;13904;17588,21170,1,0,2,0,3
29733,60,9733,13542;13921;17485,21170,1,0,2,0,3
29734,60,9734,13371,21170,0,0,1,0,1
29735,60,9735,14012,21170,0,0,1,0,1
29736,60,9736,14038;14197,21170,0,0,2,0,2
29737,60,9737,14045;14208,21170,0,0,2,0,2
29738,60,9738,14078;14372,21170,0,0,2,0,2
29739,60,9739,13894;14088,21170,0,0,2,0,2
29740,60,9740,14103;14195,21170,0,0,2,0,2
29741,60,9741,14138;14216,21170,0,0,2,0,2
29742,60,9742,14152;14326,21170,0,0,2,0,2
29743,60,9743,14192;14557,21170,0,0,2,0,2
29744,60,9744,14218;14746,21170,0,0,2,0,2
29745,60,9745,14227;15522,21170,0,0,2,0,2
29746,60,9746,14361,21170,0,0,1,0,1
29747,60,9747,14271;14829,21170,0,0,2,0,2
29748,60,9748,14341,21170,0,0,1,0,1
29749,60,9749,13918,21170,0,0,1,0,1
29750,60,9750,13992,21170,0,0,1,0,1
29751,60,9751,14430;14542,21170,0,0,2,0,2
29752,60,9752,14446;14696,21170,0,0,2,0,2
29753,60,9753,14262;14460,21170,0,0,2,0,2
29754,60,9754,14203;14486,21170,0,0,2,0,2
29755,60,9755,14511;14848,21170,0,0,2,0,2
29756,60,9756,14519;14861;17658,21170,1,0,2,0,3
29757,60,9757,14529;14865,21170,0,0,2,0,2
29758,60,9758,14116;14532,21170,0,0,2,0,2
29759,60,9759,14001;14549,21170,0,0,2,0,2
29760,60,9760,14575;15415,21170,0,0,2,0,2
29761,60,9761,14488;14576,21170,0,0,2,0,2
29762,60,9762,14214;14579,21170,0,0,2,0,2
29763,60,9763,14669;15072,21170,0,0,2,0,2
29764,60,9764,14678;14842,21170,0,0,2,0,2
29765,60,9765,14703,21170,0,0,1,0,1
29766,60,9766,14713;14722,21170,0,0,2,0,2
29767,60,9767,14735;14922,21170,0,0,2,0,2
29768,60,9768,13734;14751,21170,0,0,2,0,2
29769,60,9769,14787;15379,21170,0,0,2,0,2
29770,60,9770,14569;14790;17641,21170,1,0,2,0,3
29771,60,9771,14793;17646,21170,1,0,1,0,2
29772,60,9772,14498;14802,21170,0,0,2,0,2
29773,60,9773,14819,21170,0,0,1,0,1
29774,60,9774,14830;15411,21170,0,0,2,0,2
29775,60,9775,14852;15174,21170,0,0,2,0,2
29776,60,9776,14867;14937,21170,0,0,2,0,2
29777,60,9777,14538;14895,21170,0,0,2,0,2
29778,60,9778,14915;15121,21170,0,0,2,0,2
29779,60,9779,14872;14918,21170,0,0,2,0,2
29780,60,9780,14749;14936;17569,21170,1,0,2,0,3
29781,60,9781,14938;15289,21170,0,0,2,0,2
29782,60,9782,15170;17552;17575,21170,2,0,1,0,3
29783,60,9783,14976;15068,21170,0,0,2,0,2
29784,60,9784,14977;15210,21170,0,0,2,0,2
29785,60,9785,14980;15000,21170,0,0,2,0,2
29786,60,9786,15003,21170,0,0,1,0,1
29787,60,9787,14777;15011,21170,0,0,2,0,2
29788,60,9788,15012;15026;17619,21170,1,0,2,0,3
29789,60,9789,15043;15473,21170,0,0,2,0,2
29790,60,9790,14923;15062,21170,0,0,2,0,2
29791,60,9791,14954;15066,21170,0,0,2,0,2
29792,60,9792,14815;15076,21170,0,0,2,0,2
29793,60,9793,14820;15080,21170,0,0,2,0,2
29794,60,9794,15081;17492,21170,1,0,1,0,2
29795,60,9795,15090;15195;17686,21170,1,0,2,0,3
29796,60,9796,10043,21535,0,0,1,0,1
29797,60,9797,10124,21535,0,0,1,0,1
29798,60,9798,10221,21535,0,0,1,0,1
29799,60,9799,10371,21535,0,0,1,0,1
29800,60,9800,10076,21535,0,0,1,0,1
29801,60,9801,10351,21535,0,0,1,0,1
29802,60,9802,10556,21535,0,0,1,0,1
29803,60,9803,10661,21535,0,0,1,0,1
29804,60,9804,10757,21535,0,0,1,0,1
29805,60,9806,10924,21535,0,0,1,0,1
29806,60,9807,10903,21535,0,0,1,0,1
29807,60,9808,10977,21535,0,0,1,0,1
29808,60,9809,11254,21535,0,0,1,0,1
29809,60,9810,11307,21535,0,0,1,0,1
29810,60,9811,11258,21535,0,0,1,0,1
29811,60,9812,11263,21535,0,0,1,0,1
29812,60,9813,11546,21535,0,0,1,0,1
29813,60,9814,11270,21535,0,0,1,0,1
29814,60,9817,12422,21535,0,0,1,0,1
29815,60,9818,12476,21535,0,0,1,0,1
29816,60,9819,12619,21535,0,0,1,0,1
29817,60,9820,12456,21535,0,0,1,0,1
29818,60,9821,12509,21535,0,0,1,0,1
29819,60,9823,12782;13319;17662,21535,1,0,2,0,3
29820,60,9824,12799,21535,0,0,1,0,1
29821,60,9826,12958,21535,0,0,1,0,1
29822,60,9827,13105,21535,0,0,1,0,1
29823,60,9828,13197;13795,21535,0,0,2,0,2
29824,60,9829,13268;13756;17617,21535,1,0,2,0,3
29825,60,9830,13250;13382,21535,0,0,2,0,2
29826,60,9831,12997,21535,0,0,1,0,1
29827,60,9832,13401,21535,0,0,1,0,1
29828,60,9833,13406;13828,21535,0,0,2,0,2
29829,60,9834,13466,21535,0,0,1,0,1
29830,60,9835,13483,21535,0,0,1,0,1
29831,60,9836,14076;14211,21535,0,0,2,0,2
29832,60,9837,13176,21535,0,0,1,0,1
29833,60,9838,13526;13738,21535,0,0,2,0,2
29834,60,9839,13532,21535,0,0,1,0,1
29835,60,9840,13252,21535,0,0,1,0,1
29836,60,9841,13595;14200,21535,0,0,2,0,2
29837,60,9843,13288,21535,0,0,1,0,1
29838,60,9844,13775;13928,21535,0,0,2,0,2
29839,60,9845,13847;14219,21535,0,0,2,0,2
29840,60,9846,13865;14394,21535,0,0,2,0,2
29841,60,9847,13883,21535,0,0,1,0,1
29842,60,9848,13742,21535,0,0,1,0,1
29843,60,9849,13982;14702;17635,21535,1,0,2,0,3
29844,60,9850,14044;14324,21535,0,0,2,0,2
29845,60,9851,13274;14054,21535,0,0,2,0,2
29846,60,9852,14198,21535,0,0,1,0,1
29847,60,9853,14167;14679,21535,0,0,2,0,2
29848,60,9854,14181;14412,21535,0,0,2,0,2
29849,60,9855,14187;14500,21535,0,0,2,0,2
29850,60,9856,13623;13789,21535,0,0,2,0,2
29851,60,9857,14252;14310;17605,21535,1,0,2,0,3
29852,60,9858,14269,21535,0,0,1,0,1
29853,60,9859,13895,21535,0,0,1,0,1
29854,60,9860,14320;14343,21535,0,0,2,0,2
29855,60,9861,14041;14334,21535,0,0,2,0,2
29856,60,9862,14337;14588,21535,0,0,2,0,2
29857,60,9863,14205;14354,21535,0,0,2,0,2
29858,60,9864,14369;14721,21535,0,0,2,0,2
29859,60,9865,14141;14405,21535,0,0,2,0,2
29860,60,9866,14423;14602,21535,0,0,2,0,2
29861,60,9867,14450;14476,21535,0,0,2,0,2
29862,60,9868,14455;14818,21535,0,0,2,0,2
29863,60,9869,14914;17613,21535,1,0,1,0,2
29864,60,9870,14490,21535,0,0,1,0,1
29865,60,9871,14546,21535,0,0,1,0,1
29866,60,9872,14230;14556,21535,0,0,2,0,2
29867,60,9873,14723;14984,21535,0,0,2,0,2
29868,60,9874,14788;15647;17607,21535,1,0,2,0,3
29869,60,9875,14792;15245,21535,0,0,2,0,2
29870,60,9876,14380;14796,21535,0,0,2,0,2
29871,60,9877,14371;14798,21535,0,0,2,0,2
29872,60,9878,14803,21535,0,0,1,0,1
29873,60,9879,14882;15141;17598,21535,1,0,2,0,3
29874,60,9880,14898;15171,21535,0,0,2,0,2
29875,60,9881,14879;14899,21535,0,0,2,0,2
29876,60,9882,14920;15013,21535,0,0,2,0,2
29877,60,9883,14955;15496,21535,0,0,2,0,2
29878,60,9884,14972,21535,0,0,1,0,1
29879,60,9885,14685;14985,21535,0,0,2,0,2
29880,60,9886,14418;14987,21535,0,0,2,0,2
29881,60,9887,14997;15293;17651,21535,1,0,2,0,3
29882,60,9888,15030;15468,21535,0,0,2,0,2
29883,60,9889,15046;15481,21535,0,0,2,0,2
29884,60,9890,14493;15064,21535,0,0,2,0,2
29885,60,9891,15075;15520,21535,0,0,2,0,2
29886,60,9892,14650,21535,0,0,1,0,1
29887,60,9893,15083;15366,21535,0,0,2,0,2
29888,60,9894,14911;15103,21535,0,0,2,0,2
29889,60,9895,15113,21535,0,0,1,0,1
29890,60,9896,15125,21535,0,0,1,0,1
29891,60,9897,15107;15132,21535,0,0,2,0,2
29892,60,9898,14729;15133,21535,0,0,2,0,2
29893,60,9899,15096;15138,21535,0,0,2,0,2
29894,60,9900,14901;15143,21535,0,0,2,0,2
29895,60,9901,15052;15144,21535,0,0,2,0,2
29896,60,9902,15002;15167,21535,0,0,2,0,2
29897,60,9903,14957,21535,0,0,1,0,1
29898,60,9904,15202,21535,0,0,1,0,1
29899,60,9905,94,21900,0,0,1,0,1
29900,60,9906,10045,21900,0,0,1,0,1
29901,60,9907,10122,21900,0,0,1,0,1
29902,60,9908,10674,21900,0,0,1,0,1
29903,60,9909,10482,21900,0,0,1,0,1
29904,60,9910,11048,21900,0,0,1,0,1
29905,60,9912,10792,21900,0,0,1,0,1
29906,60,9913,10892,21900,0,0,1,0,1
29907,60,9914,11439,21900,0,0,1,0,1
29908,60,9915,11463,21900,0,0,1,0,1
29909,60,9916,11343,21900,0,0,1,0,1
29910,60,9917,11668;11739,21900,0,0,2,0,2
29911,60,9918,11238,21900,0,0,1,0,1
29912,60,9919,11401,21900,0,0,1,0,1
29913,60,9921,11910,21900,0,0,1,0,1
29914,60,9922,11532,21900,0,0,1,0,1
29915,60,9923,12314,21900,0,0,1,0,1
29916,60,9924,12018,21900,0,0,1,0,1
29917,60,9925,12088,21900,0,0,1,0,1
29918,60,9926,12094,21900,0,0,1,0,1
29919,60,9927,12163,21900,0,0,1,0,1
29920,60,9928,12114,21900,0,0,1,0,1
29921,60,9929,12343;12758,21900,0,0,2,0,2
29922,60,9930,12410,21900,0,0,1,0,1
29923,60,9931,12469,21900,0,0,1,0,1
29924,60,9932,12213,21900,0,0,1,0,1
29925,60,9933,12146,21900,0,0,1,0,1
29926,60,9934,12614,21900,0,0,1,0,1
29927,60,9935,12679,21900,0,0,1,0,1
29928,60,9936,12647,21900,0,0,1,0,1
29929,60,9937,12774,21900,0,0,1,0,1
29930,60,9938,12792,21900,0,0,1,0,1
29931,60,9939,12853,21900,0,0,1,0,1
29932,60,9940,12992,21900,0,0,1,0,1
29933,60,9941,13344,21900,0,0,1,0,1
29934,60,9942,13013,21900,0,0,1,0,1
29935,60,9943,13114;13417,21900,0,0,2,0,2
29936,60,9944,13241,21900,0,0,1,0,1
29937,60,9945,13247;13812,21900,0,0,2,0,2
29938,60,9946,13286,21900,0,0,1,0,1
29939,60,9947,13456,21900,0,0,1,0,1
29940,60,9948,13413;14049,21900,0,0,2,0,2
29941,60,9949,13415,21900,0,0,1,0,1
29942,60,9950,13425;13845,21900,0,0,2,0,2
29943,60,9951,13528,21900,0,0,1,0,1
29944,60,9952,13321,21900,0,0,1,0,1
29945,60,9953,13708;14296,21900,0,0,2,0,2
29946,60,9954,13947,21900,0,0,1,0,1
29947,60,9955,13887;14225,21900,0,0,2,0,2
29948,60,9956,13457,21900,0,0,1,0,1
29949,60,9957,13942,21900,0,0,1,0,1
29950,60,9958,13986,21900,0,0,1,0,1
29951,60,9959,14016,21900,0,0,1,0,1
29952,60,9960,14027;14449,21900,0,0,2,0,2
29953,60,9961,13566;14234,21900,0,0,2,0,2
29954,60,9962,13880;14178,21900,0,0,2,0,2
29955,60,9963,14223;14668,21900,0,0,2,0,2
29956,60,9964,14239;14367,21900,0,0,2,0,2
29957,60,9965,14304,21900,0,0,1,0,1
29958,60,9966,14290;14355,21900,0,0,2,0,2
29959,60,9967,14379;14716,21900,0,0,2,0,2
29960,60,9968,13875;14395,21900,0,0,2,0,2
29961,60,9969,14442;14846,21900,0,0,2,0,2
29962,60,9970,14472,21900,0,0,1,0,1
29963,60,9971,14378;14495,21900,0,0,2,0,2
29964,60,9972,14119;14525,21900,0,0,2,0,2
29965,60,9973,14528,21900,0,0,1,0,1
29966,60,9974,14608;14982,21900,0,0,2,0,2
29967,60,9975,14618,21900,0,0,1,0,1
29968,60,9976,14621;14665,21900,0,0,2,0,2
29969,60,9977,14634;14778,21900,0,0,2,0,2
29970,60,9978,14565,21900,0,0,1,0,1
29971,60,9979,14662;15007,21900,0,0,2,0,2
29972,60,9980,14173;14690,21900,0,0,2,0,2
29973,60,9981,14733,21900,0,0,1,0,1
29974,60,9982,14283;14762,21900,0,0,2,0,2
29975,60,9983,14844;15320,21900,0,0,2,0,2
29976,60,9984,14845;15073,21900,0,0,2,0,2
29977,60,9985,14889;15380,21900,0,0,2,0,2
29978,60,9986,14506;14903,21900,0,0,2,0,2
29979,60,9987,14904;15474,21900,0,0,2,0,2
29980,60,9988,14905;15253,21900,0,0,2,0,2
29981,60,9989,14467,21900,0,0,1,0,1
29982,60,9990,14919;15032,21900,0,0,2,0,2
29983,60,9991,14932;15418,21900,0,0,2,0,2
29984,60,9992,14947;15257,21900,0,0,2,0,2
29985,60,9993,14950,21900,0,0,1,0,1
29986,60,9994,14807;14975,21900,0,0,2,0,2
29987,60,9995,14978;15186,21900,0,0,2,0,2
29988,60,9996,14992;15134,21900,0,0,2,0,2
29989,60,9997,14996;15001,21900,0,0,2,0,2
29990,60,9998,15020;15605,21900,0,0,2,0,2
29991,60,9999,15024;15244,21900,0,0,2,0,2
29992,60,10000,14414;15025,21900,0,0,2,0,2
29993,60,10001,15115;15688,21900,0,1,1,0,2
29994,60,10002,14858;15116,21900,0,0,2,0,2
29995,60,10003,14714;15128,21900,0,0,2,0,2
29996,60,10004,15136;15709,21900,0,1,1,0,2
29997,60,10005,14606;15140,21900,0,0,2,0,2
29998,60,10006,14811;15153,21900,0,0,2,0,2
29999,60,10007,15155;15808,21900,0,1,1,0,2
30000,60,10008,14518;15162,21900,0,0,2,0,2
30001,60,10009,15165;15408,21900,0,0,2,0,2
30002,60,10010,15055;15181,21900,0,0,2,0,2
30003,60,10011,15191,21900,0,0,1,0,1
30004,60,10012,15217,21900,0,0,1,0,1
30005,60,10013,14719;15220,21900,0,0,2,0,2
30006,60,10014,15179;15261,21900,0,0,2,0,2
30007,60,10015,14747;15311,21900,0,0,2,0,2
30008,60,10016,15352,21900,0,0,1,0,1
30009,60,10017,15357;15719,21900,0,1,1,0,2
30010,60,10018,15358;15377,21900,0,0,2,0,2
30011,60,10019,15359;15512,21900,0,0,2,0,2
30012,60,10020,15219;15361,21900,0,0,2,0,2
30013,60,10021,15164;15368,21900,0,0,2,0,2
30014,60,10022,15087;15378,21900,0,0,2,0,2
30015,60,10023,15381;15516,21900,0,0,2,0,2
30016,60,10024,15396;15451,21900,0,0,2,0,2
30017,70,4,4056,0,0,0,0,1,1
30018,70,25,9208,0,0,0,0,1,1
30019,70,28,90;1720;4946;6299,0,0,0,0,4,4
30020,70,36,9316,0,0,0,0,1,1
30021,70,38,117,0,0,0,0,1,1
30022,70,93,10284,0,0,0,0,1,1
30023,70,169,5506,0,0,0,0,1,1
30024,70,179,493,0,0,0,0,1,1
30025,70,203,3813,0,0,0,0,1,1
30026,70,227,1307,0,0,0,0,1,1
30027,70,235,629,0,0,0,0,1,1
30028,70,291,6147,0,0,0,0,1,1
30029,70,297,1545;7780,0,0,0,0,2,2
30030,70,304,1537,0,0,0,0,1,1
30031,70,350,921;7150,0,0,0,0,2,2
30032,70,369,3976;3977,0,0,0,0,2,2
30033,70,393,7724;7890;10077,0,0,0,0,3,3
30034,70,415,1092,0,0,0,0,1,1
30035,70,440,1164,0,0,0,0,1,1
30036,70,448,8904,0,0,0,0,1,1
30037,70,456,7627,0,0,0,0,1,1
30038,70,478,1260;3503,0,0,0,0,2,2
30039,70,491,8317,0,0,0,0,1,1
30040,70,509,1345,0,0,0,0,1,1
30041,70,519,1375;5704,0,0,0,0,2,2
30042,70,522,1382;10019,0,0,0,0,2,2
30043,70,553,7690,0,0,0,0,1,1
30044,70,556,1461;10121;10343,0,0,0,0,3,3
30045,70,561,5771,0,0,0,0,1,1
30046,70,573,4815,0,0,0,0,1,1
30047,70,598,1577,0,0,0,0,1,1
30048,70,607,8801,0,0,0,0,1,1
30049,70,620,1633,0,0,0,0,1,1
30050,70,641,1694,0,0,0,0,1,1
30051,70,648,1715,0,0,0,0,1,1
30052,70,661,1756;3842,0,0,0,0,2,2
30053,70,667,7499,0,0,0,0,1,1
30054,70,735,3137,0,0,0,0,1,1
30055,70,736,8154,0,0,0,0,1,1
30056,70,759,1993,0,0,0,0,1,1
30057,70,786,8886;13827,0,0,0,1,1,2
30058,70,805,5779,0,0,0,0,1,1
30059,70,813,2123,0,0,0,0,1,1
30060,70,857,2238,0,0,0,0,1,1
30061,70,866,2271,0,0,0,0,1,1
30062,70,886,2321;2323,0,0,0,0,2,2
30063,70,919,2418,0,0,0,0,1,1
30064,70,951,9585,0,0,0,0,1,1
30065,70,978,80,0,0,0,0,1,1
30066,70,990,8649,0,0,0,0,1,1
30067,70,991,12508;16496,0,0,0,2,0,2
30068,70,998,2706,0,0,0,0,1,1
30069,70,1010,2648,0,0,0,0,1,1
30070,70,1045,2738;13327,0,0,0,1,1,2
30071,70,1062,6561;7177,0,0,0,0,2,2
30072,70,1069,2806,0,0,0,0,1,1
30073,70,1074,2823;6873,0,0,0,0,2,2
30074,70,1133,8338,0,0,0,0,1,1
30075,70,1156,9819,0,0,0,0,1,1
30076,70,1168,10666;10773;10804;11050;11210;11214;11426,0,0,0,6,1,7
30077,70,1170,8211,0,0,0,0,1,1
30078,70,1191,3141;8721,0,0,0,0,2,2
30079,70,1209,357;12928,0,0,0,1,1,2
30080,70,1258,3901,0,0,0,0,1,1
30081,70,1275,3356,0,0,0,0,1,1
30082,70,1285,3386;6955,0,0,0,0,2,2
30083,70,1292,3411,0,0,0,0,1,1
30084,70,1332,3514,0,0,0,0,1,1
30085,70,1375,10685,0,0,0,0,1,1
30086,70,1421,3753;7993,0,0,0,0,2,2
30087,70,1427,616,0,0,0,0,1,1
30088,70,1458,3848,0,0,0,0,1,1
30089,70,1468,3880,0,0,0,0,1,1
30090,70,1540,4064,0,0,0,0,1,1
30091,70,1551,4091;9750,0,0,0,0,2,2
30092,70,1577,4150;4151;5311;7316;12950,0,0,0,1,4,5
30093,70,1588,4175,0,0,0,0,1,1
30094,70,1601,9103,0,0,0,0,1,1
30095,70,1627,4220;4268;6845;13448,0,0,0,1,3,4
30096,70,1634,4295,0,0,0,0,1,1
30097,70,1636,4298,0,0,0,0,1,1
30098,70,1725,1478;4516,0,0,0,0,2,2
30099,70,1729,5600,0,0,0,0,1,1
30100,70,1777,4653,0,0,0,0,1,1
30101,70,1784,4669,0,0,0,0,1,1
30102,70,1796,1049,0,0,0,0,1,1
30103,70,1805,3921;4722,0,0,0,0,2,2
30104,70,1872,4899,0,0,0,0,1,1
30105,70,1889,14670,0,0,0,1,0,1
30106,70,1898,4975,0,0,0,0,1,1
30107,70,1901,4983,0,0,0,0,1,1
30108,70,1915,4165;5016,0,0,0,0,2,2
30109,70,1972,5156,0,0,0,0,1,1
30110,70,2005,5249,0,0,0,0,1,1
30111,70,2018,5274,0,0,0,0,1,1
30112,70,2031,5309,0,0,0,0,1,1
30113,70,2033,5315,0,0,0,0,1,1
30114,70,2034,5741,0,0,0,0,1,1
30115,70,2036,5321,0,0,0,0,1,1
30116,70,2068,7143,0,0,0,0,1,1
30117,70,2079,5423,0,0,0,0,1,1
30118,70,2090,5460,0,0,0,0,1,1
30119,70,2111,6493,0,0,0,0,1,1
30120,70,2118,9393,0,0,0,0,1,1
30121,70,2159,1246,0,0,0,0,1,1
30122,70,2212,5749,0,0,0,0,1,1
30123,70,2252,1894;5840,0,0,0,0,2,2
30124,70,2286,4528,0,0,0,0,1,1
30125,70,2291,3592;5930;8932,0,0,0,0,3,3
30126,70,2317,10315,0,0,0,0,1,1
30127,70,2343,6056;8892;15391,0,0,0,1,2,3
30128,70,2366,1515;7964,0,0,0,0,2,2
30129,70,2389,2559,0,0,0,0,1,1
30130,70,2392,6174,0,0,0,0,1,1
30131,70,2399,11519;11804;16687;16728,0,0,0,4,0,4
30132,70,2413,6229,0,0,0,0,1,1
30133,70,2418,11158,0,0,0,1,0,1
30134,70,2431,5603,0,0,0,0,1,1
30135,70,2434,120;6290,0,0,0,0,2,2
30136,70,2479,8099,0,0,0,0,1,1
30137,70,2486,6423,0,0,0,0,1,1
30138,70,2503,4523;6470,0,0,0,0,2,2
30139,70,2521,4668,0,0,0,0,1,1
30140,70,2569,3699,0,0,0,0,1,1
30141,70,2596,765,0,0,0,0,1,1
30142,70,2638,11894;12333;16697,0,0,0,3,0,3
30143,70,2643,10485;10565,0,0,0,0,2,2
30144,70,2648,4471;6848;6849,0,0,0,0,3,3
30145,70,2725,7048,0,0,0,0,1,1
30146,70,2744,8357,0,0,0,0,1,1
30147,70,2764,7151;8592,0,0,0,0,2,2
30148,70,2766,7157;9042,0,0,0,0,2,2
30149,70,2787,3502;7203,0,0,0,0,2,2
30150,70,2797,7734,0,0,0,0,1,1
30151,70,2820,7277,0,0,0,0,1,1
30152,70,2863,7384,0,0,0,0,1,1
30153,70,2867,7395,0,0,0,0,1,1
30154,70,2871,3450;7406,0,0,0,0,2,2
30155,70,2875,680,0,0,0,0,1,1
30156,70,2879,1948,0,0,0,0,1,1
30157,70,2885,1622,0,0,0,0,1,1
30158,70,2896,7472,0,0,0,0,1,1
30159,70,2905,7672,0,0,0,0,1,1
30160,70,2919,9666,0,0,0,0,1,1
30161,70,2925,2855,0,0,0,0,1,1
30162,70,2942,7596,0,0,0,0,1,1
30163,70,2952,9710,0,0,0,0,1,1
30164,70,2986,7711,0,0,0,0,1,1
30165,70,3021,7792,0,0,0,0,1,1
30166,70,3022,7793;10115,0,0,0,0,2,2
30167,70,3054,7878,0,0,0,0,1,1
30168,70,3056,1334;3007,0,0,0,0,2,2
30169,70,3067,7907,0,0,0,0,1,1
30170,70,3070,7915,0,0,0,0,1,1
30171,70,3081,7946;7947;10013,0,0,0,0,3,3
30172,70,3099,4395,0,0,0,0,1,1
30173,70,3100,7987,0,0,0,0,1,1
30174,70,3112,9295,0,0,0,0,1,1
30175,70,3132,4075;8076,0,0,0,0,2,2
30176,70,3158,3668,0,0,0,0,1,1
30177,70,3159,8146,0,0,0,0,1,1
30178,70,3163,8156,0,0,0,0,1,1
30179,70,3189,3718,0,0,0,0,1,1
30180,70,3193,6588,0,0,0,0,1,1
30181,70,3201,8241,0,0,0,0,1,1
30182,70,3212,10021,0,0,0,0,1,1
30183,70,3232,8321,0,0,0,0,1,1
30184,70,3236,8334,0,0,0,0,1,1
30185,70,3243,6535,0,0,0,0,1,1
30186,70,3260,2013;2825,0,0,0,0,2,2
30187,70,3319,271,0,0,0,0,1,1
30188,70,3323,8564,0,0,0,0,1,1
30189,70,3366,8674;8675;9562,0,0,0,0,3,3
30190,70,3420,2833;5615,0,0,0,0,2,2
30191,70,3421,8824,0,0,0,0,1,1
30192,70,3432,5458,0,0,0,0,1,1
30193,70,3435,3256,0,0,0,0,1,1
30194,70,3469,8949;13343,0,0,0,1,1,2
30195,70,3479,8100;8978,0,0,0,0,2,2
30196,70,3519,9076,0,0,0,0,1,1
30197,70,3539,9138,0,0,0,0,1,1
30198,70,3549,3873;8238,0,0,0,0,2,2
30199,70,3620,75,0,0,0,0,1,1
30200,70,3634,1732;9378,0,0,0,0,2,2
30201,70,3646,10820,0,0,0,1,0,1
30202,70,3687,9518;9519,0,0,0,0,2,2
30203,70,3704,9561,0,0,0,0,1,1
30204,70,3710,9580,0,0,0,0,1,1
30205,70,3719,9604,0,0,0,0,1,1
30206,70,3725,9436,0,0,0,0,1,1
30207,70,3726,9621,0,0,0,0,1,1
30208,70,3750,3201;9694,0,0,0,0,2,2
30209,70,3752,179;9688,0,0,0,0,2,2
30210,70,3769,3420;9736,0,0,0,0,2,2
30211,70,3771,5433;9742,0,0,0,0,2,2
30212,70,3774,8984,0,0,0,0,1,1
30213,70,3797,7986,0,0,0,0,1,1
30214,70,3817,10983;11082;11745;16334,0,0,0,4,0,4
30215,70,3822,213;7445;8270;9888,0,0,0,0,4,4
30216,70,3833,9915,0,0,0,0,1,1
30217,70,3839,9931,0,0,0,0,1,1
30218,70,3860,2524;5329;9986;9987,0,0,0,0,4,4
30219,70,3885,974,0,0,0,0,1,1
30220,70,3902,3291,0,0,0,0,1,1
30221,70,3904,3865;5508,0,0,0,0,2,2
30222,70,3916,5208,0,0,0,0,1,1
30223,70,3921,2316,0,0,0,0,1,1
30224,70,3925,8622,0,0,0,0,1,1
30225,70,3927,1030,0,0,0,0,1,1
30226,70,3946,3922;4188,0,0,0,0,2,2
30227,70,3957,3061,365,0,0,0,1,1
30228,70,3967,459,365,0,0,0,1,1
30229,70,3977,2804,365,0,0,0,1,1
30230,70,3986,3396;8378,365,0,0,0,2,2
30231,70,3987,4751,365,0,0,0,1,1
30232,70,4000,4827,365,0,0,0,1,1
30233,70,4004,11904;15631,365,0,0,2,0,2
30234,70,4016,3062,365,0,0,0,1,1
30235,70,4027,7997,365,0,0,0,1,1
30236,70,4048,6184,730,0,0,0,1,1
30237,70,4053,2949,730,0,0,0,1,1
30238,70,4055,5617,730,0,0,0,1,1
30239,70,4058,948,730,0,0,0,1,1
30240,70,4059,3996,730,0,0,0,1,1
30241,70,4062,3560,730,0,0,0,1,1
30242,70,4066,4619,730,0,0,0,1,1
30243,70,4067,12463;12752,730,0,0,2,0,2
30244,70,4094,3792,730,0,0,0,1,1
30245,70,4103,4273,730,0,0,0,1,1
30246,70,4109,6856,730,0,0,0,1,1
30247,70,4114,262;8083,730,0,0,0,2,2
30248,70,4129,6922,730,0,0,0,1,1
30249,70,4130,7021,730,0,0,0,1,1
30250,70,4140,7293;8757,730,0,0,0,2,2
30251,70,4141,3716;5419,730,0,0,0,2,2
30252,70,4144,8277,730,0,0,0,1,1
30253,70,4145,11617;11623,730,0,0,2,0,2
30254,70,4171,4284,1095,0,0,0,1,1
30255,70,4172,38,1095,0,0,0,1,1
30256,70,4173,413,1095,0,0,0,1,1
30257,70,4174,3103,1095,0,0,0,1,1
30258,70,4179,1212,1095,0,0,0,1,1
30259,70,4180,2179,1095,0,0,0,1,1
30260,70,4183,467,1095,0,0,0,1,1
30261,70,4187,7035,1095,0,0,0,1,1
30262,70,4202,4015,1095,0,0,0,1,1
30263,70,4217,4001,1095,0,0,0,1,1
30264,70,4218,5070,1095,0,0,0,1,1
30265,70,4234,3759,1095,0,0,0,1,1
30266,70,4239,5547,1095,0,0,0,1,1
30267,70,4248,6837,1095,0,0,0,1,1
30268,70,4249,6914,1095,0,0,0,1,1
30269,70,4250,5489,1095,0,0,0,1,1
30270,70,4257,3675;6982,1095,0,0,0,2,2
30271,70,4263,7603,1095,0,0,0,1,1
30272,70,4264,9526,1095,0,0,0,1,1
30273,70,4265,7893,1095,0,0,0,1,1
30274,70,4268,1238,1095,0,0,0,1,1
30275,70,4275,205;7138,1095,0,0,0,2,2
30276,70,4276,8859,1095,0,0,0,1,1
30277,70,4281,9165,1095,0,0,0,1,1
30278,70,4287,5443;12083,1095,0,0,1,1,2
30279,70,4298,583,1460,0,0,0,1,1
30280,70,4300,7286,1460,0,0,0,1,1
30281,70,4302,4888,1460,0,0,0,1,1
30282,70,4303,7604,1460,0,0,0,1,1
30283,70,4304,871,1460,0,0,0,1,1
30284,70,4306,895;5737,1460,0,0,0,2,2
30285,70,4307,4602,1460,0,0,0,1,1
30286,70,4312,1213;7825,1460,0,0,0,2,2
30287,70,4315,9843,1460,0,0,0,1,1
30288,70,4320,4756;6308,1460,0,0,0,2,2
30289,70,4335,9947,1460,0,0,0,1,1
30290,70,4338,8760,1460,0,0,0,1,1
30291,70,4340,5905,1460,0,0,0,1,1
30292,70,4341,3832,1460,0,0,0,1,1
30293,70,4345,2232,1460,0,0,0,1,1
30294,70,4347,1250;4315,1460,0,0,0,2,2
30295,70,4349,8135,1460,0,0,0,1,1
30296,70,4355,5017,1460,0,0,0,1,1
30297,70,4360,6586,1460,0,0,0,1,1
30298,70,4370,1526,1460,0,0,0,1,1
30299,70,4375,7989,1460,0,0,0,1,1
30300,70,4376,6489;6728,1460,0,0,0,2,2
30301,70,4378,6819,1460,0,0,0,1,1
30302,70,4380,3566,1460,0,0,0,1,1
30303,70,4381,6452,1460,0,0,0,1,1
30304,70,4385,9424,1460,0,0,0,1,1
30305,70,4387,6133,1460,0,0,0,1,1
30306,70,4391,6211,1460,0,0,0,1,1
30307,70,4397,8284,1460,0,0,0,1,1
30308,70,4402,1218,1460,0,0,0,1,1
30309,70,4409,6318,1460,0,0,0,1,1
30310,70,4412,6413;9769,1460,0,0,0,2,2
30311,70,4413,7419,1460,0,0,0,1,1
30312,70,4415,1741,1460,0,0,0,1,1
30313,70,4418,199;8519,1825,0,0,0,2,2
30314,70,4423,439;705,1825,0,0,0,2,2
30315,70,4426,1352;6736,1825,0,0,0,2,2
30316,70,4430,642;1525,1825,0,0,0,2,2
30317,70,4438,4898,1825,0,0,0,1,1
30318,70,4445,3193,1825,0,0,0,1,1
30319,70,4446,8285,1825,0,0,0,1,1
30320,70,4451,3595,1825,0,0,0,1,1
30321,70,4453,3961;4062,1825,0,0,0,2,2
30322,70,4454,1151,1825,0,0,0,1,1
30323,70,4455,4046,1825,0,0,0,1,1
30324,70,4461,4487;8672,1825,0,0,0,2,2
30325,70,4462,4838,1825,0,0,0,1,1
30326,70,4470,8552,1825,0,0,0,1,1
30327,70,4483,4314,1825,0,0,0,1,1
30328,70,4485,5811;9714,1825,0,0,0,2,2
30329,70,4486,6313;8561,1825,0,0,0,2,2
30330,70,4489,6530,1825,0,0,0,1,1
30331,70,4490,356,1825,0,0,0,1,1
30332,70,4498,7256,1825,0,0,0,1,1
30333,70,4505,6582,1825,0,0,0,1,1
30334,70,4508,5448,1825,0,0,0,1,1
30335,70,4510,7882,1825,0,0,0,1,1
30336,70,4520,4103,1825,0,0,0,1,1
30337,70,4521,9352,1825,0,0,0,1,1
30338,70,4524,4522;9032,1825,0,0,0,2,2
30339,70,4525,8168,1825,0,0,0,1,1
30340,70,4526,7601,1825,0,0,0,1,1
30341,70,4530,568,1825,0,0,0,1,1
30342,70,4531,2156;9368,1825,0,0,0,2,2
30343,70,4533,3538,1825,0,0,0,1,1
30344,70,4536,9963,1825,0,0,0,1,1
30345,70,4539,2881,2190,0,0,0,1,1
30346,70,4551,1788;3004,2190,0,0,0,2,2
30347,70,4554,5166,2190,0,0,0,1,1
30348,70,4555,8864;9882,2190,0,0,0,2,2
30349,70,4560,2670,2190,0,0,0,1,1
30350,70,4561,1363,2190,0,0,0,1,1
30351,70,4569,8619,2190,0,0,0,1,1
30352,70,4572,3531;4654,2190,0,0,0,2,2
30353,70,4574,2433;8336,2190,0,0,0,2,2
30354,70,4576,3768,2190,0,0,0,1,1
30355,70,4578,3860,2190,0,0,0,1,1
30356,70,4579,3955,2190,0,0,0,1,1
30357,70,4582,4073,2190,0,0,0,1,1
30358,70,4583,8679,2190,0,0,0,1,1
30359,70,4585,8388,2190,0,0,0,1,1
30360,70,4593,1824,2190,0,0,0,1,1
30361,70,4600,6118,2190,0,0,0,1,1
30362,70,4606,5432,2190,0,0,0,1,1
30363,70,4607,3164,2190,0,0,0,1,1
30364,70,4610,7102,2190,0,0,0,1,1
30365,70,4611,6191,2190,0,0,0,1,1
30366,70,4612,9854,2190,0,0,0,1,1
30367,70,4613,7691,2190,0,0,0,1,1
30368,70,4615,7705,2190,0,0,0,1,1
30369,70,4619,4141,2190,0,0,0,1,1
30370,70,4633,9370,2190,0,0,0,1,1
30371,70,4634,9926,2190,0,0,0,1,1
30372,70,4639,537;12418,2190,0,0,1,1,2
30373,70,4640,2500,2190,0,0,0,1,1
30374,70,4647,278,2555,0,0,0,1,1
30375,70,4649,350;8039,2555,0,0,0,2,2
30376,70,4650,355;4375,2555,0,0,0,2,2
30377,70,4654,1332;3338,2555,0,0,0,2,2
30378,70,4656,1372,2555,0,0,0,1,1
30379,70,4657,1399;5981,2555,0,0,0,2,2
30380,70,4658,6354,2555,0,0,0,1,1
30381,70,4660,1901,2555,0,0,0,1,1
30382,70,4661,1653,2555,0,0,0,1,1
30383,70,4662,1935,2555,0,0,0,1,1
30384,70,4666,603,2555,0,0,0,1,1
30385,70,4668,2605;8226,2555,0,0,0,2,2
30386,70,4671,2800;9501,2555,0,0,0,2,2
30387,70,4672,2058;6971,2555,0,0,0,2,2
30388,70,4676,3277,2555,0,0,0,1,1
30389,70,4677,3524,2555,0,0,0,1,1
30390,70,4678,3574,2555,0,0,0,1,1
30391,70,4679,3703;6767,2555,0,0,0,2,2
30392,70,4681,3766;7342,2555,0,0,0,2,2
30393,70,4683,7391,2555,0,0,0,1,1
30394,70,4689,1692;2168,2555,0,0,0,2,2
30395,70,4700,8680,2555,0,0,0,1,1
30396,70,4706,5604,2555,0,0,0,1,1
30397,70,4708,5691;6164,2555,0,0,0,2,2
30398,70,4710,2692;5988,2555,0,0,0,2,2
30399,70,4716,6440,2555,0,0,0,1,1
30400,70,4718,272;6701,2555,0,0,0,2,2
30401,70,4720,9356,2555,0,0,0,1,1
30402,70,4725,6951;8831,2555,0,0,0,2,2
30403,70,4729,3125;7569,2555,0,0,0,2,2
30404,70,4730,4649,2555,0,0,0,1,1
30405,70,4731,6037;6406,2555,0,0,0,2,2
30406,70,4734,1801;3436,2555,0,0,0,2,2
30407,70,4735,8087,2555,0,0,0,1,1
30408,70,4738,986;8501,2555,0,0,0,2,2
30409,70,4746,9214,2555,0,0,0,1,1
30410,70,4750,7341;9499,2555,0,0,0,2,2
30411,70,4755,9883,2555,0,0,0,1,1
30412,70,4757,12159;12349;15793,2555,0,0,3,0,3
30413,70,4759,146;4129,2920,0,0,0,2,2
30414,70,4761,9607,2920,0,0,0,1,1
30415,70,4770,12991,2920,0,0,1,0,1
30416,70,4771,1016,2920,0,0,0,1,1
30417,70,4772,12137,2920,0,0,1,0,1
30418,70,4774,1099;2787,2920,0,0,0,2,2
30419,70,4775,2355,2920,0,0,0,1,1
30420,70,4776,1123,2920,0,0,0,1,1
30421,70,4778,1882,2920,0,0,0,1,1
30422,70,4779,1936,2920,0,0,0,1,1
30423,70,4780,933;11857,2920,0,0,1,1,2
30424,70,4781,2169,2920,0,0,0,1,1
30425,70,4782,8493,2920,0,0,0,1,1
30426,70,4784,2840,2920,0,0,0,1,1
30427,70,4788,2960,2920,0,0,0,1,1
30428,70,4789,3155;3704,2920,0,0,0,2,2
30429,70,4792,4713,2920,0,0,0,1,1
30430,70,4793,159;7185,2920,0,0,0,2,2
30431,70,4794,3449,2920,0,0,0,1,1
30432,70,4796,2817,2920,0,0,0,1,1
30433,70,4797,3959,2920,0,0,0,1,1
30434,70,4801,9392,2920,0,0,0,1,1
30435,70,4802,3812,2920,0,0,0,1,1
30436,70,4804,3879,2920,0,0,0,1,1
30437,70,4805,3940,2920,0,0,0,1,1
30438,70,4806,8425,2920,0,0,0,1,1
30439,70,4813,4949,2920,0,0,0,1,1
30440,70,4814,6295,2920,0,0,0,1,1
30441,70,4816,4924,2920,0,0,0,1,1
30442,70,4821,2581;6770;13095,2920,0,0,1,2,3
30443,70,4824,4582,2920,0,0,0,1,1
30444,70,4825,6284,2920,0,0,0,1,1
30445,70,4827,4723;6464,2920,0,0,0,2,2
30446,70,4829,6688;6700,2920,0,0,0,2,2
30447,70,4831,293,2920,0,0,0,1,1
30448,70,4833,3120,2920,0,0,0,1,1
30449,70,4836,1084;6636,2920,0,0,0,2,2
30450,70,4846,8807,2920,0,0,0,1,1
30451,70,4851,6581,2920,0,0,0,1,1
30452,70,4854,2093;8997,2920,0,0,0,2,2
30453,70,4857,8123;9355,2920,0,0,0,2,2
30454,70,4864,3011;6689,2920,0,0,0,2,2
30455,70,4867,37,3285,0,0,0,1,1
30456,70,4869,4373,3285,0,0,0,1,1
30457,70,4871,4628,3285,0,0,0,1,1
30458,70,4873,6820,3285,0,0,0,1,1
30459,70,4875,6629,3285,0,0,0,1,1
30460,70,4878,6699,3285,0,0,0,1,1
30461,70,4880,6111;9879,3285,0,0,0,2,2
30462,70,4883,3376;9816,3285,0,0,0,2,2
30463,70,4891,9649,3285,0,0,0,1,1
30464,70,4893,4109,3285,0,0,0,1,1
30465,70,4894,936,3285,0,0,0,1,1
30466,70,4898,1386;2493,3285,0,0,0,2,2
30467,70,4899,3698;5159,3285,0,0,0,2,2
30468,70,4905,3276;6405,3285,0,0,0,2,2
30469,70,4907,8650,3285,0,0,0,1,1
30470,70,4909,3523;5949,3285,0,0,0,2,2
30471,70,4910,6559,3285,0,0,0,1,1
30472,70,4914,4401,3285,0,0,0,1,1
30473,70,4919,3070,3285,0,0,0,1,1
30474,70,4923,4499,3285,0,0,0,1,1
30475,70,4925,4721,3285,0,0,0,1,1
30476,70,4931,7728,3285,0,0,0,1,1
30477,70,4933,5863,3285,0,0,0,1,1
30478,70,4937,6188,3285,0,0,0,1,1
30479,70,4938,4514,3285,0,0,0,1,1
30480,70,4941,4850,3285,0,0,0,1,1
30481,70,4944,8808,3285,0,0,0,1,1
30482,70,4945,6792,3285,0,0,0,1,1
30483,70,4947,1640,3285,0,0,0,1,1
30484,70,4949,2215;2395,3285,0,0,0,2,2
30485,70,4951,7461,3285,0,0,0,1,1
30486,70,4952,7488,3285,0,0,0,1,1
30487,70,4960,5000;8466,3285,0,0,0,2,2
30488,70,4964,8623,3285,0,0,0,1,1
30489,70,4966,7330,3285,0,0,0,1,1
30490,70,4972,6064,3285,0,0,0,1,1
30491,70,4975,9739,3285,0,0,0,1,1
30492,70,4977,153;7525,3650,0,0,0,2,2
30493,70,4978,7068,3650,0,0,0,1,1
30494,70,4979,360,3650,0,0,0,1,1
30495,70,4981,1364;12340,3650,0,0,1,1,2
30496,70,4982,2656,3650,0,0,0,1,1
30497,70,4984,1139;6878,3650,0,0,0,2,2
30498,70,4987,3381;8110,3650,0,0,0,2,2
30499,70,4989,1351,3650,0,0,0,1,1
30500,70,4990,1115;2799,3650,0,0,0,2,2
30501,70,4994,1933,3650,0,0,0,1,1
30502,70,4998,9891;14730,3650,0,0,1,1,2
30503,70,4999,2404;5244,3650,0,0,0,2,2
30504,70,5001,6933,3650,0,0,0,1,1
30505,70,5002,3520,3650,0,0,0,1,1
30506,70,5003,7275,3650,0,0,0,1,1
30507,70,5004,1141;1599,3650,0,0,0,2,2
30508,70,5006,8826,3650,0,0,0,1,1
30509,70,5008,333,3650,0,0,0,1,1
30510,70,5011,4308;4859,3650,0,0,0,2,2
30511,70,5012,1666,3650,0,0,0,1,1
30512,70,5014,630;4581,3650,0,0,0,2,2
30513,70,5015,2669,3650,0,0,0,1,1
30514,70,5017,4953,3650,0,0,0,1,1
30515,70,5023,8589,3650,0,0,0,1,1
30516,70,5024,6750,3650,0,0,0,1,1
30517,70,5025,8306,3650,0,0,0,1,1
30518,70,5028,3492,3650,0,0,0,1,1
30519,70,5030,444;6773,3650,0,0,0,2,2
30520,70,5031,2629,3650,0,0,0,1,1
30521,70,5036,9139,3650,0,0,0,1,1
30522,70,5039,8106,3650,0,0,0,1,1
30523,70,5041,2033;6612,3650,0,0,0,2,2
30524,70,5042,8291,3650,0,0,0,1,1
30525,70,5045,8977,3650,0,0,0,1,1
30526,70,5047,5964,3650,0,0,0,1,1
30527,70,5049,3,3650,0,0,0,1,1
30528,70,5051,706,3650,0,0,0,1,1
30529,70,5052,9637,3650,0,0,0,1,1
30530,70,5056,36,4015,0,0,0,1,1
30531,70,5058,5525,4015,0,0,0,1,1
30532,70,5060,189;2959,4015,0,0,0,2,2
30533,70,5070,2008,4015,0,0,0,1,1
30534,70,5072,1608,4015,0,0,0,1,1
30535,70,5074,6296;6531,4015,0,0,0,2,2
30536,70,5076,2273,4015,0,0,0,1,1
30537,70,5077,9226;13647,4015,0,0,1,1,2
30538,70,5079,2498;9693,4015,0,0,0,2,2
30539,70,5081,2972;5025,4015,0,0,0,2,2
30540,70,5085,2244,4015,0,0,0,1,1
30541,70,5086,3027,4015,0,0,0,1,1
30542,70,5087,1746,4015,0,0,0,1,1
30543,70,5088,1979,4015,0,0,0,1,1
30544,70,5090,3335,4015,0,0,0,1,1
30545,70,5091,1987,4015,0,0,0,1,1
30546,70,5092,8567,4015,0,0,0,1,1
30547,70,5099,4283,4015,0,0,0,1,1
30548,70,5101,4486,4015,0,0,0,1,1
30549,70,5102,3872;4510,4015,0,0,0,2,2
30550,70,5105,4874,4015,0,0,0,1,1
30551,70,5106,1010,4015,0,0,0,1,1
30552,70,5112,9485,4015,0,0,0,1,1
30553,70,5116,6240,4015,0,0,0,1,1
30554,70,5117,1751,4015,0,0,0,1,1
30555,70,5120,5723;13340,4015,0,0,1,1,2
30556,70,5121,6595,4015,0,0,0,1,1
30557,70,5124,2175;6981,4015,0,0,0,2,2
30558,70,5125,1339,4015,0,0,0,1,1
30559,70,5126,3215;7073,4015,0,0,0,2,2
30560,70,5127,7739;9045,4015,0,0,0,2,2
30561,70,5129,7494,4015,0,0,0,1,1
30562,70,5130,3986,4015,0,0,0,1,1
30563,70,5134,9844,4015,0,0,0,1,1
30564,70,5142,5063,4015,0,0,0,1,1
30565,70,5144,479;9220,4015,0,0,0,2,2
30566,70,5146,9118,4015,0,0,0,1,1
30567,70,5147,9687,4015,0,0,0,1,1
30568,70,5149,9756;11429,4015,0,0,1,1,2
30569,70,5153,74,4380,0,0,0,1,1
30570,70,5157,347,4380,0,0,0,1,1
30571,70,5158,1637;4307,4380,0,0,0,2,2
30572,70,5161,3758;5002,4380,0,0,0,2,2
30573,70,5165,891,4380,0,0,0,1,1
30574,70,5167,8198,4380,0,0,0,1,1
30575,70,5168,2322,4380,0,0,0,1,1
30576,70,5173,1313,4380,0,0,0,1,1
30577,70,5175,7894;13048,4380,0,0,1,1,2
30578,70,5177,2231,4380,0,0,0,1,1
30579,70,5183,2544;7024,4380,0,0,0,2,2
30580,70,5184,2798,4380,0,0,0,1,1
30581,70,5189,2891,4380,0,0,0,1,1
30582,70,5190,1192;6624;13750,4380,0,0,1,2,3
30583,70,5191,5072,4380,0,0,0,1,1
30584,70,5194,1001;3121,4380,0,0,0,2,2
30585,70,5199,1698,4380,0,0,0,1,1
30586,70,5203,6158,4380,0,0,0,1,1
30587,70,5204,5425,4380,0,0,0,1,1
30588,70,5207,1427;6453,4380,0,0,0,2,2
30589,70,5208,4855;8497,4380,0,0,0,2,2
30590,70,5211,7873,4380,0,0,0,1,1
30591,70,5213,1705;3738,4380,0,0,0,2,2
30592,70,5218,9321,4380,0,0,0,1,1
30593,70,5219,1148,4380,0,0,0,1,1
30594,70,5222,7681,4380,0,0,0,1,1
30595,70,5225,4267;7777,4380,0,0,0,2,2
30596,70,5230,2385,4380,0,0,0,1,1
30597,70,5232,7029,4380,0,0,0,1,1
30598,70,5236,7306,4380,0,0,0,1,1
30599,70,5240,2108;7503,4380,0,0,0,2,2
30600,70,5242,7077;7679,4380,0,0,0,2,2
30601,70,5245,3402;7913;12468,4380,0,0,1,2,3
30602,70,5246,2555,4380,0,0,0,1,1
30603,70,5252,4449;8741,4380,0,0,0,2,2
30604,70,5253,12007;12548;12839;13063;16977;17427;17543;18025,4380,0,4,4,0,8
30605,70,5254,8643,4380,0,0,0,1,1
30606,70,5257,9040,4380,0,0,0,1,1
30607,70,5260,2240,4380,0,0,0,1,1
30608,70,5261,9589,4380,0,0,0,1,1
30609,70,5263,7236,4380,0,0,0,1,1
30610,70,5265,5451,4745,0,0,0,1,1
30611,70,5267,107;4601,4745,0,0,0,2,2
30612,70,5268,240,4745,0,0,0,1,1
30613,70,5274,6275,4745,0,0,0,1,1
30614,70,5279,1654;3028,4745,0,0,0,2,2
30615,70,5282,4481,4745,0,0,0,1,1
30616,70,5286,7142,4745,0,0,0,1,1
30617,70,5287,3944,4745,0,0,0,1,1
30618,70,5288,9450,4745,0,0,0,1,1
30619,70,5291,2842,4745,0,0,0,1,1
30620,70,5292,8894,4745,0,0,0,1,1
30621,70,5295,3234,4745,0,0,0,1,1
30622,70,5299,3467,4745,0,0,0,1,1
30623,70,5300,1652;3401,4745,0,0,0,2,2
30624,70,5302,3749,4745,0,0,0,1,1
30625,70,5306,3945;8759,4745,0,0,0,2,2
30626,70,5308,1344,4745,0,0,0,1,1
30627,70,5309,9015,4745,0,0,0,1,1
30628,70,5315,5044;8566,4745,0,0,0,2,2
30629,70,5316,5181;7747,4745,0,0,0,2,2
30630,70,5318,3458,4745,0,0,0,1,1
30631,70,5319,3380,4745,0,0,0,1,1
30632,70,5320,4630,4745,0,0,0,1,1
30633,70,5323,3069,4745,0,0,0,1,1
30634,70,5326,7212,4745,0,0,0,1,1
30635,70,5327,2434,4745,0,0,0,1,1
30636,70,5328,801;6555,4745,0,0,0,2,2
30637,70,5336,1161;6353,4745,0,0,0,2,2
30638,70,5337,2494;7276,4745,0,0,0,2,2
30639,70,5339,7496;7704,4745,0,0,0,2,2
30640,70,5341,1789;7553,4745,0,0,0,2,2
30641,70,5342,54;2117,4745,0,0,0,2,2
30642,70,5344,8514,4745,0,0,0,1,1
30643,70,5345,8520,4745,0,0,0,1,1
30644,70,5347,5137,4745,0,0,0,1,1
30645,70,5349,8629,4745,0,0,0,1,1
30646,70,5350,2699,4745,0,0,0,1,1
30647,70,5351,212;1500,4745,0,0,0,2,2
30648,70,5352,953,4745,0,0,0,1,1
30649,70,5353,9417,4745,0,0,0,1,1
30650,70,5355,2449,4745,0,0,0,1,1
30651,70,5357,3457,4745,0,0,0,1,1
30652,70,5358,294;3834,4745,0,0,0,2,2
30653,70,5359,9726,4745,0,0,0,1,1
30654,70,5363,11715;12127;12576;12883;13414;13696;16830;16852;17935;18252;18406,5110,2,1,8,0,11
30655,70,5364,216;8560;12383,5110,0,0,1,2,3
30656,70,5368,648;1572;15578,5110,0,0,1,2,3
30657,70,5369,8922,5110,0,0,0,1,1
30658,70,5372,1714,5110,0,0,0,1,1
30659,70,5377,944;6905,5110,0,0,0,2,2
30660,70,5380,6567,5110,0,0,0,1,1
30661,70,5384,2031;3428,5110,0,0,0,2,2
30662,70,5385,3611;8133,5110,0,0,0,2,2
30663,70,5386,3691;9709,5110,0,0,0,2,2
30664,70,5388,1986,5110,0,0,0,1,1
30665,70,5391,4035,5110,0,0,0,1,1
30666,70,5393,4070,5110,0,0,0,1,1
30667,70,5397,4963,5110,0,0,0,1,1
30668,70,5398,5031,5110,0,0,0,1,1
30669,70,5401,4595;5674,5110,0,0,0,2,2
30670,70,5404,4043,5110,0,0,0,1,1
30671,70,5406,6154,5110,0,0,0,1,1
30672,70,5408,4021,5110,0,0,0,1,1
30673,70,5409,9134,5110,0,0,0,1,1
30674,70,5410,7500,5110,0,0,0,1,1
30675,70,5411,2594;2750,5110,0,0,0,2,2
30676,70,5412,6389,5110,0,0,0,1,1
30677,70,5413,6875,5110,0,0,0,1,1
30678,70,5415,2870,5110,0,0,0,1,1
30679,70,5417,7367,5110,0,0,0,1,1
30680,70,5421,7332;7697,5110,0,0,0,2,2
30681,70,5424,1239,5110,0,0,0,1,1
30682,70,5426,753;8827,5110,0,0,0,2,2
30683,70,5429,5806;9210;13298,5110,0,0,1,2,3
30684,70,5433,1471;6404,5110,0,0,0,2,2
30685,70,5434,5735,5110,0,0,0,1,1
30686,70,5436,2963,5475,0,0,0,1,1
30687,70,5437,87,5475,0,0,0,1,1
30688,70,5440,378,5475,0,0,0,1,1
30689,70,5441,431;5792,5475,0,0,0,2,2
30690,70,5443,2651;9783,5475,0,0,0,2,2
30691,70,5444,896,5475,0,0,0,1,1
30692,70,5445,902,5475,0,0,0,1,1
30693,70,5446,1163,5475,0,0,0,1,1
30694,70,5447,786;8288,5475,0,0,0,2,2
30695,70,5448,1093,5475,0,0,0,1,1
30696,70,5449,987;3045,5475,0,0,0,2,2
30697,70,5456,1575;5232,5475,0,0,0,2,2
30698,70,5457,2059,5475,0,0,0,1,1
30699,70,5458,5850,5475,0,0,0,1,1
30700,70,5460,11441;11823;12513;13229;16850,5475,0,0,5,0,5
30701,70,5462,2146;2268,5475,0,0,0,2,2
30702,70,5463,574;2159,5475,0,0,0,2,2
30703,70,5466,2499;6108,5475,0,0,0,2,2
30704,70,5468,1451;2948,5475,0,0,0,2,2
30705,70,5471,3359;9082,5475,0,0,0,2,2
30706,70,5472,7119,5475,0,0,0,1,1
30707,70,5473,3504;3530,5475,0,0,0,2,2
30708,70,5476,3794;5241,5475,0,0,0,2,2
30709,70,5478,5190;6117,5475,0,0,0,2,2
30710,70,5482,1147,5475,0,0,0,1,1
30711,70,5486,1706;6675,5475,0,0,0,2,2
30712,70,5488,4140,5475,0,0,0,1,1
30713,70,5490,5526,5475,0,0,0,1,1
30714,70,5494,9765;9849,5475,0,0,0,2,2
30715,70,5497,8010,5475,0,0,0,1,1
30716,70,5500,2481;6743,5475,0,0,0,2,2
30717,70,5501,7766,5475,0,0,0,1,1
30718,70,5502,9776,5475,0,0,0,1,1
30719,70,5505,5985;7156,5475,0,0,0,2,2
30720,70,5508,4074,5475,0,0,0,1,1
30721,70,5510,7520,5475,0,0,0,1,1
30722,70,5512,50;7323,5475,0,0,0,2,2
30723,70,5517,1571;8273,5475,0,0,0,2,2
30724,70,5518,5787;8365,5475,0,0,0,2,2
30725,70,5521,8556,5475,0,0,0,1,1
30726,70,5522,3214,5475,0,0,0,1,1
30727,70,5527,8785,5475,0,0,0,1,1
30728,70,5532,2027;6857,5475,0,0,0,2,2
30729,70,5533,9215,5475,0,0,0,1,1
30730,70,5535,1565,5475,0,0,0,1,1
30731,70,5540,1450,5475,0,0,0,1,1
30732,70,5543,61;8703,5840,0,0,0,2,2
30733,70,5544,250;838,5840,0,0,0,2,2
30734,70,5545,79,5840,0,0,0,1,1
30735,70,5546,367,5840,0,0,0,1,1
30736,70,5548,1467,5840,0,0,0,1,1
30737,70,5549,632;2250,5840,0,0,0,2,2
30738,70,5553,1266;4571,5840,0,0,0,2,2
30739,70,5554,1267;5449,5840,0,0,0,2,2
30740,70,5555,319,5840,0,0,0,1,1
30741,70,5556,3403;4385,5840,0,0,0,2,2
30742,70,5559,674;8038,5840,0,0,0,2,2
30743,70,5560,5128,5840,0,0,0,1,1
30744,70,5561,2389,5840,0,0,0,1,1
30745,70,5563,2694,5840,0,0,0,1,1
30746,70,5564,163;1803,5840,0,0,0,2,2
30747,70,5567,2580,5840,0,0,0,1,1
30748,70,5569,2965;10100,5840,0,0,0,2,2
30749,70,5571,8278,5840,0,0,0,1,1
30750,70,5573,1388;3156,5840,0,0,0,2,2
30751,70,5574,2910;4337,5840,0,0,0,2,2
30752,70,5580,1157,5840,0,0,0,1,1
30753,70,5581,9364,5840,0,0,0,1,1
30754,70,5582,5521,5840,0,0,0,1,1
30755,70,5583,10073,5840,0,0,0,1,1
30756,70,5584,4634,5840,0,0,0,1,1
30757,70,5591,5666,5840,0,0,0,1,1
30758,70,5600,6809,5840,0,0,0,1,1
30759,70,5603,1107,5840,0,0,0,1,1
30760,70,5607,2085,5840,0,0,0,1,1
30761,70,5608,5937;5962,5840,0,0,0,2,2
30762,70,5609,5202;5860,5840,0,0,0,2,2
30763,70,5610,7789;12493,5840,0,0,1,1,2
30764,70,5611,7193;9418,5840,0,0,0,2,2
30765,70,5612,7818,5840,0,0,0,1,1
30766,70,5615,8047,5840,0,0,0,1,1
30767,70,5617,8302,5840,0,0,0,1,1
30768,70,5620,9676,5840,0,0,0,1,1
30769,70,5624,5134;7128,5840,0,0,0,2,2
30770,70,5626,5809,5840,0,0,0,1,1
30771,70,5627,9069;9506;13444,5840,0,0,1,2,3
30772,70,5628,9596;9608,5840,0,0,0,2,2
30773,70,5629,2330;9654,5840,0,0,0,2,2
30774,70,5630,1096;4034,5840,0,0,0,2,2
30775,70,5631,8612,6205,0,0,0,1,1
30776,70,5632,2063;6212,6205,0,0,0,2,2
30777,70,5633,219;8494,6205,0,0,0,2,2
30778,70,5635,7555,6205,0,0,0,1,1
30779,70,5638,4950,6205,0,0,0,1,1
30780,70,5639,1284;6363,6205,0,0,0,2,2
30781,70,5641,1158;10204,6205,0,0,0,2,2
30782,70,5642,1428,6205,0,0,0,1,1
30783,70,5643,1700;4845,6205,0,0,0,2,2
30784,70,5648,1667;2539,6205,0,0,0,2,2
30785,70,5650,1305;10044,6205,0,0,0,2,2
30786,70,5651,2339;10055,6205,0,0,0,2,2
30787,70,5654,804;2545;14351,6205,0,0,1,2,3
30788,70,5655,6207,6205,0,0,0,1,1
30789,70,5656,2741,6205,0,0,0,1,1
30790,70,5657,3601,6205,0,0,0,1,1
30791,70,5662,10060,6205,0,0,0,1,1
30792,70,5663,9063,6205,0,0,0,1,1
30793,70,5665,494;10201,6205,0,0,0,2,2
30794,70,5666,720,6205,0,0,0,1,1
30795,70,5673,440;4257,6205,0,0,0,2,2
30796,70,5674,10180,6205,0,0,0,1,1
30797,70,5676,2234,6205,0,0,0,1,1
30798,70,5680,4833;7037,6205,0,0,0,2,2
30799,70,5683,4106,6205,0,0,0,1,1
30800,70,5685,5297,6205,0,0,0,1,1
30801,70,5686,5480;7304,6205,0,0,0,2,2
30802,70,5688,5186;5642,6205,0,0,0,2,2
30803,70,5692,5992;8052,6205,0,0,0,2,2
30804,70,5693,5969,6205,0,0,0,1,1
30805,70,5694,6885,6205,0,0,0,1,1
30806,70,5699,5228,6205,0,0,0,1,1
30807,70,5700,6529,6205,0,0,0,1,1
30808,70,5702,4680;6692,6205,0,0,0,2,2
30809,70,5706,10054,6205,0,0,0,1,1
30810,70,5707,7466;9571,6205,0,0,0,2,2
30811,70,5708,3388;7510;13525,6205,0,0,1,2,3
30812,70,5709,9827,6205,0,0,0,1,1
30813,70,5712,1288,6205,0,0,0,1,1
30814,70,5714,3811,6205,0,0,0,1,1
30815,70,5716,945,6205,0,0,0,1,1
30816,70,5717,4959;8885,6205,0,0,0,2,2
30817,70,5719,93,6205,0,0,0,1,1
30818,70,5720,2142;6601,6205,0,0,0,2,2
30819,70,5722,9389,6205,0,0,0,1,1
30820,70,5723,6421,6205,0,0,0,1,1
30821,70,5724,14274;14445;18392,6205,1,0,2,0,3
30822,70,5725,7794,6205,0,0,0,1,1
30823,70,5726,9741,6205,0,0,0,1,1
30824,70,5729,135;9728,6570,0,0,0,2,2
30825,70,5732,10118,6570,0,0,0,1,1
30826,70,5733,10174,6570,0,0,0,1,1
30827,70,5734,14712;14795,6570,0,0,2,0,2
30828,70,5739,10042,6570,0,0,0,1,1
30829,70,5740,1242,6570,0,0,0,1,1
30830,70,5742,8332,6570,0,0,0,1,1
30831,70,5743,1308;10006,6570,0,0,0,2,2
30832,70,5746,1538;12403,6570,0,0,1,1,2
30833,70,5747,1564;9150;13587,6570,0,0,1,2,3
30834,70,5751,10080,6570,0,0,0,1,1
30835,70,5752,1721,6570,0,0,0,1,1
30836,70,5760,6382;10088,6570,0,0,0,2,2
30837,70,5762,6088,6570,0,0,0,1,1
30838,70,5763,3003,6570,0,0,0,1,1
30839,70,5767,6289,6570,0,0,0,1,1
30840,70,5768,477;3578,6570,0,0,0,2,2
30841,70,5771,1775;7464,6570,0,0,0,2,2
30842,70,5773,4633,6570,0,0,0,1,1
30843,70,5774,4694,6570,0,0,0,1,1
30844,70,5776,6003;10167,6570,0,0,0,2,2
30845,70,5781,8375,6570,0,0,0,1,1
30846,70,5786,4832;7665,6570,0,0,0,2,2
30847,70,5787,461;9099,6570,0,0,0,2,2
30848,70,5791,4093;8967,6570,0,0,0,2,2
30849,70,5793,1236;7121,6570,0,0,0,2,2
30850,70,5796,1468;10112;14627,6570,0,0,1,2,3
30851,70,5798,7762,6570,0,0,0,1,1
30852,70,5799,7765;10229,6570,0,0,0,2,2
30853,70,5800,546;10084;13844,6570,0,0,1,2,3
30854,70,5802,8051,6570,0,0,0,1,1
30855,70,5807,1493;10063,6570,0,0,0,2,2
30856,70,5812,57,6570,0,0,0,1,1
30857,70,5813,5991;9425,6570,0,0,0,2,2
30858,70,5815,4704;9655,6570,0,0,0,2,2
30859,70,5819,476,6935,0,0,0,1,1
30860,70,5820,3874;10069,6935,0,0,0,2,2
30861,70,5821,7402,6935,0,0,0,1,1
30862,70,5825,3748,6935,0,0,0,1,1
30863,70,5831,1371;6920,6935,0,0,0,2,2
30864,70,5833,10048;10138,6935,0,0,0,2,2
30865,70,5835,2121,6935,0,0,0,1,1
30866,70,5836,10223,6935,0,0,0,1,1
30867,70,5837,2245,6935,0,0,0,1,1
30868,70,5839,8697;10145,6935,0,0,0,2,2
30869,70,5840,10030,6935,0,0,0,1,1
30870,70,5843,3375,6935,0,0,0,1,1
30871,70,5845,545;3126,6935,0,0,0,2,2
30872,70,5846,4448;10037,6935,0,0,0,2,2
30873,70,5850,218;10074,6935,0,0,0,2,2
30874,70,5851,7808,6935,0,0,0,1,1
30875,70,5854,3127;5301,6935,0,0,0,2,2
30876,70,5859,5231,6935,0,0,0,1,1
30877,70,5860,10017;10287,6935,0,0,0,2,2
30878,70,5861,2765,6935,0,0,0,1,1
30879,70,5862,5097;7994,6935,0,0,0,2,2
30880,70,5863,5258;10158,6935,0,0,0,2,2
30881,70,5865,960,6935,0,0,0,1,1
30882,70,5867,5630;7310;13246,6935,0,0,1,2,3
30883,70,5871,10005;10132,6935,0,0,0,2,2
30884,70,5872,4752;6331,6935,0,0,0,2,2
30885,70,5873,169;6443,6935,0,0,0,2,2
30886,70,5875,6469,6935,0,0,0,1,1
30887,70,5877,7444;8553,6935,0,0,0,2,2
30888,70,5885,3886;7439,6935,0,0,0,2,2
30889,70,5888,3731;7550,6935,0,0,0,2,2
30890,70,5890,9197,6935,0,0,0,1,1
30891,70,5891,9692,6935,0,0,0,1,1
30892,70,5894,4600,6935,0,0,0,1,1
30893,70,5895,7097;10237,6935,0,0,0,2,2
30894,70,5900,5917;10186,6935,0,0,0,2,2
30895,70,5901,982,6935,0,0,0,1,1
30896,70,5902,10046,6935,0,0,0,1,1
30897,70,5905,217;9680,6935,0,0,0,2,2
30898,70,5906,4868;10206,6935,0,0,0,2,2
30899,70,5908,10022;10210,6935,0,0,0,2,2
30900,70,5909,3820;10029,6935,0,0,0,2,2
30901,70,5910,10033;10362,6935,0,0,0,2,2
30902,70,5911,10089;10188,6935,0,0,0,2,2
30903,70,5912,10056;10297,6935,0,0,0,2,2
30904,70,5914,10109,6935,0,0,0,1,1
30905,70,5915,386;10108,6935,0,0,0,2,2
30906,70,5916,10481;15304,6935,0,0,1,1,2
30907,70,5918,10183,7300,0,0,0,1,1
30908,70,5919,511,7300,0,0,0,1,1
30909,70,5921,562;9927,7300,0,0,0,2,2
30910,70,5923,4714;6407,7300,0,0,0,2,2
30911,70,5927,1452;2689,7300,0,0,0,2,2
30912,70,5928,3337;5390,7300,0,0,0,2,2
30913,70,5930,2361;10401,7300,0,0,0,2,2
30914,70,5934,5479,7300,0,0,0,1,1
30915,70,5935,1045;10008,7300,0,0,0,2,2
30916,70,5943,7163,7300,0,0,0,1,1
30917,70,5946,4544;9887,7300,0,0,0,2,2
30918,70,5949,4735,7300,0,0,0,1,1
30919,70,5950,4851;10057,7300,0,0,0,2,2
30920,70,5955,5726,7300,0,0,0,1,1
30921,70,5957,5798;5968,7300,0,0,0,2,2
30922,70,5958,7732;8624,7300,0,0,0,2,2
30923,70,5959,1682;6702,7300,0,0,0,2,2
30924,70,5964,4677;7172;12455;12794,7300,0,0,2,2,4
30925,70,5968,7481;10097,7300,0,0,0,2,2
30926,70,5971,5436,7300,0,0,0,1,1
30927,70,5972,9211,7300,0,0,0,1,1
30928,70,5975,2247,7300,0,0,0,1,1
30929,70,5980,9749,7300,0,0,0,1,1
30930,70,5983,10082;10320,7300,0,0,0,2,2
30931,70,5985,10058;10519,7300,0,0,0,2,2
30932,70,5986,10220;13443,7300,0,0,1,1,2
30933,70,5987,10142,7300,0,0,0,1,1
30934,70,5989,10187,7300,0,0,0,1,1
30935,70,5993,10160;10255;14346,7665,0,0,1,2,3
30936,70,5994,512;1604,7665,0,0,0,2,2
30937,70,5995,1623;8409,7665,0,0,0,2,2
30938,70,6000,7394,7665,0,0,0,1,1
30939,70,6003,3952;10217,7665,0,0,0,2,2
30940,70,6005,2620,7665,0,0,0,1,1
30941,70,6007,2707,7665,0,0,0,1,1
30942,70,6008,10280,7665,0,0,0,1,1
30943,70,6009,10306;15270,7665,0,0,1,1,2
30944,70,6012,2920;3591,7665,0,0,0,2,2
30945,70,6013,4271;9227,7665,0,0,0,2,2
30946,70,6017,8421,7665,0,0,0,1,1
30947,70,6018,6836,7665,0,0,0,1,1
30948,70,6020,5161,7665,0,0,0,1,1
30949,70,6022,4229,7665,0,0,0,1,1
30950,70,6023,5437;6114,7665,0,0,0,2,2
30951,70,6029,8698,7665,0,0,0,1,1
30952,70,6032,7698;8573,7665,0,0,0,2,2
30953,70,6048,137,7665,0,0,0,1,1
30954,70,6050,1486,7665,0,0,0,1,1
30955,70,6056,10431,7665,0,0,0,1,1
30956,70,6057,10014;10340,7665,0,0,0,2,2
30957,70,6058,10016;10395,7665,0,0,0,2,2
30958,70,6059,3481;10209,7665,0,0,0,2,2
30959,70,6061,10086;10230;14508,7665,0,0,1,2,3
30960,70,6062,8877;10178,7665,0,0,0,2,2
30961,70,6063,10361;10394,7665,0,0,0,2,2
30962,70,6064,10127;10141,7665,0,0,0,2,2
30963,70,6067,10171;10448,7665,0,0,0,2,2
30964,70,6070,10254;10583,7665,0,0,0,2,2
30965,70,6071,10261;10440;15225,7665,0,0,1,2,3
30966,70,6072,10265;10483;14641,7665,0,0,1,2,3
30967,70,6073,10104;10567,7665,0,0,0,2,2
30968,70,6074,10275;10391,7665,0,0,0,2,2
30969,70,6075,10047;10505,7665,0,0,0,2,2
30970,70,6076,7295;10197,7665,0,0,0,2,2
30971,70,6077,10298;13520,7665,0,0,1,1,2
30972,70,6078,10233;10307;13454,7665,0,0,1,2,3
30973,70,6079,10135;10311,7665,0,0,0,2,2
30974,70,6080,320;5064,8030,0,0,0,2,2
30975,70,6083,7621,8030,0,0,0,1,1
30976,70,6084,5100,8030,0,0,0,1,1
30977,70,6087,2360;3246,8030,0,0,0,2,2
30978,70,6090,8149,8030,0,0,0,1,1
30979,70,6096,3395,8030,0,0,0,1,1
30980,70,6098,3029,8030,0,0,0,1,1
30981,70,6099,3612,8030,0,0,0,1,1
30982,70,6102,4235;10380,8030,0,0,0,2,2
30983,70,6104,10557;10700,8030,0,0,0,2,2
30984,70,6105,4370,8030,0,0,0,1,1
30985,70,6107,932,8030,0,0,0,1,1
30986,70,6110,6393;10003,8030,0,0,0,2,2
30987,70,6111,1889,8030,0,0,0,1,1
30988,70,6112,6309,8030,0,0,0,1,1
30989,70,6115,10093,8030,0,0,0,1,1
30990,70,6118,8591,8030,0,0,0,1,1
30991,70,6119,6155;8638,8030,0,0,0,2,2
30992,70,6120,8641,8030,0,0,0,1,1
30993,70,6121,2996;8688,8030,0,0,0,2,2
30994,70,6126,10545;13869,8030,0,0,1,1,2
30995,70,6127,4456;10051;14185,8030,0,0,1,2,3
30996,70,6128,10053;10090,8030,0,0,0,2,2
30997,70,6129,10081;10246,8030,0,0,0,2,2
30998,70,6130,10302;10433,8030,0,0,0,2,2
30999,70,6131,10119;13572,8030,0,0,1,1,2
31000,70,6132,10215,8030,0,0,0,1,1
31001,70,6134,10192,8030,0,0,0,1,1
31002,70,6135,1050;10211,8030,0,0,0,2,2
31003,70,6136,10535,8030,0,0,0,1,1
31004,70,6137,10239;10454;15350,8030,0,0,1,2,3
31005,70,6141,10679,8030,0,0,0,1,1
31006,70,6142,10276;10653,8030,0,0,0,2,2
31007,70,6143,10278;10582,8030,0,0,0,2,2
31008,70,6144,10281;10296,8030,0,0,0,2,2
31009,70,6145,10634;10714,8030,0,0,0,2,2
31010,70,6146,10126;10269,8030,0,0,0,2,2
31011,70,6147,10471,8030,0,0,0,1,1
31012,70,6148,10113;10347,8030,0,0,0,2,2
31013,70,6149,15147,8030,0,0,1,0,1
31014,70,6150,10195;10390,8030,0,0,0,2,2
31015,70,6151,10170;10383,8030,0,0,0,2,2
31016,70,6152,10719,8030,0,0,0,1,1
31017,70,6153,10389;10463,8030,0,0,0,2,2
31018,70,6154,10203,8030,0,0,0,1,1
31019,70,6155,10432;10721,8030,0,0,0,2,2
31020,70,6156,6262,8395,0,0,0,1,1
31021,70,6157,2810,8395,0,0,0,1,1
31022,70,6159,10513;10644,8395,0,0,0,2,2
31023,70,6160,1231;5040,8395,0,0,0,2,2
31024,70,6166,1797,8395,0,0,0,1,1
31025,70,6167,652;5738,8395,0,0,0,2,2
31026,70,6169,5522;10012,8395,0,0,0,2,2
31027,70,6171,3366;6348;13650,8395,0,0,1,2,3
31028,70,6173,8237,8395,0,0,0,1,1
31029,70,6174,4219,8395,0,0,0,1,1
31030,70,6179,4543,8395,0,0,0,1,1
31031,70,6182,10150;10353,8395,0,0,0,2,2
31032,70,6193,9514,8395,0,0,0,1,1
31033,70,6194,2701;8111,8395,0,0,0,2,2
31034,70,6196,8474,8395,0,0,0,1,1
31035,70,6197,3267;5710,8395,0,0,0,2,2
31036,70,6199,5814,8395,0,0,0,1,1
31037,70,6205,4956;10256,8395,0,0,0,2,2
31038,70,6206,10091;10314,8395,0,0,0,2,2
31039,70,6207,10140,8395,0,0,0,1,1
31040,70,6208,10551,8395,0,0,0,1,1
31041,70,6209,10516;14581;15037,8395,0,0,2,1,3
31042,70,6210,10258,8395,0,0,0,1,1
31043,70,6211,10262;10279,8395,0,0,0,2,2
31044,70,6212,10272;10506,8395,0,0,0,2,2
31045,70,6213,10665;10728,8395,0,0,0,2,2
31046,70,6214,1359;10228,8395,0,0,0,2,2
31047,70,6215,10738,8395,0,0,0,1,1
31048,70,6216,10202;10350,8395,0,0,0,2,2
31049,70,6218,10415;10604,8395,0,0,0,2,2
31050,70,6219,10418;10435,8395,0,0,0,2,2
31051,70,6220,10318;10656;15382,8395,0,0,1,2,3
31052,70,6221,10465;10879,8395,0,0,1,1,2
31053,70,6223,10333;10455,8395,0,0,0,2,2
31054,70,6224,10291;10495,8395,0,0,0,2,2
31055,70,6225,10657,8395,0,0,0,1,1
31056,70,6227,2896;10548,8395,0,0,0,2,2
31057,70,6230,10079;10208,8760,0,0,0,2,2
31058,70,6237,10227,8760,0,0,0,1,1
31059,70,6238,6765,8760,0,0,0,1,1
31060,70,6239,2176;5459,8760,0,0,0,2,2
31061,70,6243,1973;2534,8760,0,0,0,2,2
31062,70,6244,2233;3055,8760,0,0,0,2,2
31063,70,6245,3108;7311,8760,0,0,0,2,2
31064,70,6249,5047,8760,0,0,0,1,1
31065,70,6252,8711,8760,0,0,0,1,1
31066,70,6253,4700,8760,0,0,0,1,1
31067,70,6258,6159,8760,0,0,0,1,1
31068,70,6263,3735,8760,0,0,0,1,1
31069,70,6264,1618,8760,0,0,0,1,1
31070,70,6265,6272,8760,0,0,0,1,1
31071,70,6269,11;1360,8760,0,0,0,2,2
31072,70,6274,625;2747,8760,0,0,0,2,2
31073,70,6281,10381;10422,8760,0,0,0,2,2
31074,70,6282,10617;10724,8760,0,0,0,2,2
31075,70,6283,10587,8760,0,0,0,1,1
31076,70,6284,10253,8760,0,0,0,1,1
31077,70,6285,10096;10474,8760,0,0,0,2,2
31078,70,6286,10331;10374;15023,8760,0,0,1,2,3
31079,70,6288,10627,8760,0,0,0,1,1
31080,70,6290,10066;10720,8760,0,0,0,2,2
31081,70,6291,10117;10198,8760,0,0,0,2,2
31082,70,6292,3241;10163,8760,0,0,0,2,2
31083,70,6293,3318;9764,8760,0,0,0,2,2
31084,70,6294,10522,8760,0,0,0,1,1
31085,70,6295,10078;10292,8760,0,0,0,2,2
31086,70,6296,10299,8760,0,0,0,1,1
31087,70,6297,10338,8760,0,0,0,1,1
31088,70,6298,10475;10697,8760,0,0,0,2,2
31089,70,6299,10341;10652,8760,0,0,0,2,2
31090,70,6300,10052;10358,8760,0,0,0,2,2
31091,70,6301,2476;10357,8760,0,0,0,2,2
31092,70,6302,10241,8760,0,0,0,1,1
31093,70,6303,10377,8760,0,0,0,1,1
31094,70,6304,10408;10650,8760,0,0,0,2,2
31095,70,6305,10020;10625,8760,0,0,0,2,2
31096,70,6306,10907;14698,8760,0,0,2,0,2
31097,70,6307,10346;10710,8760,0,0,0,2,2
31098,70,6308,10470,8760,0,0,0,1,1
31099,70,6309,10244;10709,8760,0,0,0,2,2
31100,70,6310,10193;10532,8760,0,0,0,2,2
31101,70,6311,10434;10613,8760,0,0,0,2,2
31102,70,6312,10682;10694,8760,0,0,0,2,2
31103,70,6313,10336;10558,8760,0,0,0,2,2
31104,70,6314,10572,8760,0,0,0,1,1
31105,70,6315,10599;10865,8760,0,0,1,1,2
31106,70,6316,10124;10602;16172,8760,0,0,1,2,3
31107,70,6318,10179,8760,0,0,0,1,1
31108,70,6339,89;3118,9125,0,0,0,2,2
31109,70,6340,1668;6991,9125,0,0,0,2,2
31110,70,6342,3798,9125,0,0,0,1,1
31111,70,6347,247;3078,9125,0,0,0,2,2
31112,70,6353,10199;10304,9125,0,0,0,2,2
31113,70,6355,5394,9125,0,0,0,1,1
31114,70,6359,3424;9161,9125,0,0,0,2,2
31115,70,6365,10036,9125,0,0,0,1,1
31116,70,6366,10586;10702,9125,0,0,0,2,2
31117,70,6368,2975;10075,9125,0,0,0,2,2
31118,70,6369,10866;13896,9125,0,0,2,0,2
31119,70,6371,10168;10310,9125,0,0,0,2,2
31120,70,6372,10286;10575;15089,9125,0,0,1,2,3
31121,70,6373,10499;10717,9125,0,0,0,2,2
31122,70,6374,10300;10319,9125,0,0,0,2,2
31123,70,6375,10213,9125,0,0,0,1,1
31124,70,6376,10218;10510,9125,0,0,0,2,2
31125,70,6377,10379,9125,0,0,0,1,1
31126,70,6378,10083;10236,9125,0,0,0,2,2
31127,70,6379,10282,9125,0,0,0,1,1
31128,70,6380,10131;10356,9125,0,0,0,2,2
31129,70,6381,10873;14253,9125,0,0,2,0,2
31130,70,6382,10335;10570,9125,0,0,0,2,2
31131,70,6383,10324;10403,9125,0,0,0,2,2
31132,70,6384,10148;15050,9125,0,0,1,1,2
31133,70,6385,10264;10388,9125,0,0,0,2,2
31134,70,6386,7856;10360,9125,0,0,0,2,2
31135,70,6387,10398;10755,9125,0,0,0,2,2
31136,70,6388,10416,9125,0,0,0,1,1
31137,70,6389,10293;10511,9125,0,0,0,2,2
31138,70,6390,10219;10436,9125,0,0,0,2,2
31139,70,6391,10910;11034;15874,9125,0,0,3,0,3
31140,70,6392,10457,9125,0,0,0,1,1
31141,70,6393,10466;14633,9125,0,0,1,1,2
31142,70,6394,10690;10816;15894,9125,0,0,2,1,3
31143,70,6395,10961,9125,0,0,1,0,1
31144,70,6396,10257;14900,9125,0,0,1,1,2
31145,70,6397,10460;10770,9125,0,0,1,1,2
31146,70,6398,10352;10509,9125,0,0,0,2,2
31147,70,6399,10553;10952,9125,0,0,1,1,2
31148,70,6401,10526,9125,0,0,0,1,1
31149,70,6402,10378;10527,9125,0,0,0,2,2
31150,70,6403,10312;10540,9125,0,0,0,2,2
31151,70,6405,10349;10568,9125,0,0,0,2,2
31152,70,6406,10172;10574,9125,0,0,0,2,2
31153,70,6408,10039;10600,9125,0,0,0,2,2
31154,70,6409,10821,9125,0,0,1,0,1
31155,70,6410,10234;10612,9125,0,0,0,2,2
31156,70,6411,10544;10621,9125,0,0,0,2,2
31157,70,6413,10691;10919,9125,0,0,1,1,2
31158,70,6414,10507;10659;14799,9125,0,0,1,2,3
31159,70,6415,10795,9125,0,0,1,0,1
31160,70,6416,10641;10881,9125,0,0,1,1,2
31161,70,6417,10680;10743,9125,0,0,0,2,2
31162,70,6418,10681;10984,9125,0,0,1,1,2
31163,70,6419,10622;10730;14671;15640,9125,0,0,2,2,4
31164,70,6420,10745;11011,9125,0,0,1,1,2
31165,70,6421,10727;10763,9125,0,0,0,2,2
31166,70,6423,228;10024,9490,0,0,0,2,2
31167,70,6424,6481,9490,0,0,0,1,1
31168,70,6429,2396,9490,0,0,0,1,1
31169,70,6430,1432;3046,9490,0,0,0,2,2
31170,70,6431,3058,9490,0,0,0,1,1
31171,70,6432,7197,9490,0,0,0,1,1
31172,70,6442,2784;6461,9490,0,0,0,2,2
31173,70,6445,7216,9490,0,0,0,1,1
31174,70,6449,2598,9490,0,0,0,1,1
31175,70,6452,7098;7443,9490,0,0,0,2,2
31176,70,6454,5402,9490,0,0,0,1,1
31177,70,6459,8201;9751,9490,0,0,0,2,2
31178,70,6462,10672;14968,9490,0,0,1,1,2
31179,70,6465,10184,9490,0,0,0,1,1
31180,70,6466,10438;10654;13811,9490,0,0,1,2,3
31181,70,6467,10323;10578,9490,0,0,0,2,2
31182,70,6468,10523;10900,9490,0,0,1,1,2
31183,70,6469,10116;10305,9490,0,0,0,2,2
31184,70,6470,10496,9490,0,0,0,1,1
31185,70,6471,10330;10607,9490,0,0,0,2,2
31186,70,6472,10332;10631;15759,9490,0,0,1,2,3
31187,70,6473,9247;10502,9490,0,0,0,2,2
31188,70,6474,10249;13849,9490,0,0,1,1,2
31189,70,6475,10645;10658,9490,0,0,0,2,2
31190,70,6476,10590;10635;15571,9490,0,0,1,2,3
31191,70,6477,10838,9490,0,0,1,0,1
31192,70,6479,10190;10484,9490,0,0,0,2,2
31193,70,6480,10489;10967,9490,0,0,1,1,2
31194,70,6481,11093,9490,0,0,1,0,1
31195,70,6482,4535;10182,9490,0,0,0,2,2
31196,70,6483,10092;10610,9490,0,0,0,2,2
31197,70,6485,10537;10898,9490,0,0,1,1,2
31198,70,6486,10274;10944,9490,0,0,1,1,2
31199,70,6487,10370;10669,9490,0,0,0,2,2
31200,70,6488,10673,9490,0,0,0,1,1
31201,70,6489,10642;14773,9490,0,0,1,1,2
31202,70,6490,10692,9490,0,0,0,1,1
31203,70,6491,10407;10704,9490,0,0,0,2,2
31204,70,6492,10518;10619,9490,0,0,0,2,2
31205,70,6493,10737;10869;15038,9490,0,0,2,1,3
31206,70,6494,10973;11202,9490,0,0,2,0,2
31207,70,6495,10815,9490,0,0,1,0,1
31208,70,6496,10456;10832,9490,0,0,1,1,2
31209,70,6497,10803;11077,9490,0,0,2,0,2
31210,70,6499,11000;11113,9490,0,0,2,0,2
31211,70,6500,11060;11175,9490,0,0,2,0,2
31212,70,6501,10913;11015,9490,0,0,2,0,2
31213,70,6502,11117,9490,0,0,1,0,1
31214,70,6505,10494;10884,9490,0,0,1,1,2
31215,70,6508,3883;6192,9855,0,0,0,2,2
31216,70,6509,5553,9855,0,0,0,1,1
31217,70,6511,3561;5260,9855,0,0,0,2,2
31218,70,6513,2918,9855,0,0,0,1,1
31219,70,6516,10031;10194,9855,0,0,0,2,2
31220,70,6532,5027;10010;14598,9855,0,0,1,2,3
31221,70,6535,8040;10111,9855,0,0,0,2,2
31222,70,6536,6002,9855,0,0,0,1,1
31223,70,6541,6744;10491,9855,0,0,0,2,2
31224,70,6542,2069;6805,9855,0,0,0,2,2
31225,70,6547,2950;7040,9855,0,0,0,2,2
31226,70,6553,10133;10447,9855,0,0,0,2,2
31227,70,6554,2370,9855,0,0,0,1,1
31228,70,6556,10928;11115,9855,0,0,2,0,2
31229,70,6557,10247;10467,9855,0,0,0,2,2
31230,70,6560,10295;10329,9855,0,0,0,2,2
31231,70,6561,10159;10427,9855,0,0,0,2,2
31232,70,6562,10451;10842,9855,0,0,1,1,2
31233,70,6564,10601,9855,0,0,0,1,1
31234,70,6566,1663;10624;14284,9855,0,0,1,2,3
31235,70,6567,10699;10833;14332,9855,0,0,2,1,3
31236,70,6568,10735;10825;15486,9855,0,0,2,1,3
31237,70,6569,10742;11110,9855,0,0,1,1,2
31238,70,6570,10639;10777,9855,0,0,1,1,2
31239,70,6572,11260;11263,9855,0,0,2,0,2
31240,70,6573,10754;10809,9855,0,0,1,1,2
31241,70,6574,10734,9855,0,0,0,1,1
31242,70,6575,10834;11085,9855,0,0,2,0,2
31243,70,6576,11116,9855,0,0,1,0,1
31244,70,6577,10998,9855,0,0,1,0,1
31245,70,6578,10271;10889;15547,9855,0,0,2,1,3
31246,70,6579,10863;10893;16038,9855,0,0,3,0,3
31247,70,6580,10765;10896,9855,0,0,1,1,2
31248,70,6581,11318;15530,9855,0,0,2,0,2
31249,70,6582,10571;10703,9855,0,0,0,2,2
31250,70,6583,10922;10927,9855,0,0,2,0,2
31251,70,6584,10805,9855,0,0,1,0,1
31252,70,6585,10940;11044,9855,0,0,2,0,2
31253,70,6586,10758;11216,9855,0,0,1,1,2
31254,70,6588,10971;11252,9855,0,0,2,0,2
31255,70,6589,10847;10975,9855,0,0,2,0,2
31256,70,6590,10988,9855,0,0,1,0,1
31257,70,6595,920,10220,0,0,0,1,1
31258,70,6599,5331;6336,10220,0,0,0,2,2
31259,70,6610,7050,10220,0,0,0,1,1
31260,70,6611,1199,10220,0,0,0,1,1
31261,70,6614,3111;3341,10220,0,0,0,2,2
31262,70,6619,6127,10220,0,0,0,1,1
31263,70,6624,8840,10220,0,0,0,1,1
31264,70,6628,2729;10326,10220,0,0,0,2,2
31265,70,6633,9825;9998,10220,0,0,0,2,2
31266,70,6634,6571;10011,10220,0,0,0,2,2
31267,70,6636,10185,10220,0,0,0,1,1
31268,70,6637,10678;11057,10220,0,0,1,1,2
31269,70,6639,10288;10630;13534,10220,0,0,1,2,3
31270,70,6641,10147,10220,0,0,0,1,1
31271,70,6642,10359,10220,0,0,0,1,1
31272,70,6647,10520,10220,0,0,0,1,1
31273,70,6649,10050;10552,10220,0,0,0,2,2
31274,70,6650,10580;10756,10220,0,0,0,2,2
31275,70,6651,10581,10220,0,0,0,1,1
31276,70,6652,10289;10636,10220,0,0,0,2,2
31277,70,6653,10883,10220,0,0,1,0,1
31278,70,6654,10668;10693,10220,0,0,0,2,2
31279,70,6655,10550,10220,0,0,0,1,1
31280,70,6656,10732;10912,10220,0,0,1,1,2
31281,70,6657,10766;10937,10220,0,0,2,0,2
31282,70,6658,10779,10220,0,0,1,0,1
31283,70,6659,10794,10220,0,0,1,0,1
31284,70,6660,10562;10796,10220,0,0,1,1,2
31285,70,6662,10807,10220,0,0,1,0,1
31286,70,6663,10446;10810,10220,0,0,1,1,2
31287,70,6664,10876;10920,10220,0,0,2,0,2
31288,70,6665,10995;11410;14755,10220,0,0,3,0,3
31289,70,6666,10740;10942;13846,10220,0,0,2,1,3
31290,70,6667,10849;11062,10220,0,0,2,0,2
31291,70,6668,10405;10991,10220,0,0,1,1,2
31292,70,6669,11041,10220,0,0,1,0,1
31293,70,6670,10956;11013;14631,10220,0,0,3,0,3
31294,70,6673,11035;11122,10220,0,0,2,0,2
31295,70,6674,11051;11058,10220,0,0,2,0,2
31296,70,6675,10792;11073,10220,0,0,2,0,2
31297,70,6676,11081;11192;16044,10220,0,0,3,0,3
31298,70,6677,10977;11253,10220,0,0,2,0,2
31299,70,6681,10041;10248,10585,0,0,0,2,2
31300,70,6686,1699;7920,10585,0,0,0,2,2
31301,70,6689,170,10585,0,0,0,1,1
31302,70,6698,8902,10585,0,0,0,1,1
31303,70,6699,10139,10585,0,0,0,1,1
31304,70,6709,182,10585,0,0,0,1,1
31305,70,6710,2751;8057,10585,0,0,0,2,2
31306,70,6713,3117,10585,0,0,0,1,1
31307,70,6715,2468,10585,0,0,0,1,1
31308,70,6717,10443;10473,10585,0,0,0,2,2
31309,70,6718,3185;10177,10585,0,0,0,2,2
31310,70,6719,10225,10585,0,0,0,1,1
31311,70,6720,10317;10369,10585,0,0,0,2,2
31312,70,6721,10231;10277,10585,0,0,0,2,2
31313,70,6724,10290;10316,10585,0,0,0,2,2
31314,70,6725,10986,10585,0,0,1,0,1
31315,70,6726,10402,10585,0,0,0,1,1
31316,70,6727,10504,10585,0,0,0,1,1
31317,70,6728,10243;10410,10585,0,0,0,2,2
31318,70,6729,10417;10979;15331,10585,0,0,2,1,3
31319,70,6730,10152;10458,10585,0,0,0,2,2
31320,70,6731,10462,10585,0,0,0,1,1
31321,70,6732,10068;10577,10585,0,0,0,2,2
31322,70,6733,10354;14373,10585,0,0,1,1,2
31323,70,6734,10515;10829;15109,10585,0,0,2,1,3
31324,70,6735,10716,10585,0,0,0,1,1
31325,70,6736,10723;10870,10585,0,0,1,1,2
31326,70,6737,10731;10828;15747,10585,0,0,2,1,3
31327,70,6738,11097;11191;14377,10585,0,0,3,0,3
31328,70,6739,10733,10585,0,0,0,1,1
31329,70,6742,10888;10926,10585,0,0,2,0,2
31330,70,6743,10530;11043,10585,0,0,1,1,2
31331,70,6744,10917;13685,10585,0,0,2,0,2
31332,70,6745,10608;10970,10585,0,0,1,1,2
31333,70,6746,10355;10985,10585,0,0,1,1,2
31334,70,6748,10762;11032,10585,0,0,1,1,2
31335,70,6749,10931;11039,10585,0,0,2,0,2
31336,70,6750,11004;11237,10585,0,0,2,0,2
31337,70,6751,11070,10585,0,0,1,0,1
31338,70,6752,10827;11141;15348,10585,0,0,3,0,3
31339,70,6753,11146;11215;15904;16453,10585,0,0,4,0,4
31340,70,6754,11471;11497;16015,10585,0,0,3,0,3
31341,70,6755,11055;11152,10585,0,0,2,0,2
31342,70,6756,11164;11411;16678,10585,0,0,3,0,3
31343,70,6757,10901;11185,10585,0,0,2,0,2
31344,70,6758,11121;11206,10585,0,0,2,0,2
31345,70,6759,11156,10585,0,0,1,0,1
31346,70,6765,9616,10950,0,0,0,1,1
31347,70,6767,2356,10950,0,0,0,1,1
31348,70,6770,10397;10412;14352,10950,0,0,1,2,3
31349,70,6774,2032;3679,10950,0,0,0,2,2
31350,70,6790,14347;14566,10950,0,0,2,0,2
31351,70,6794,6560,10950,0,0,0,1,1
31352,70,6799,9620,10950,0,0,0,1,1
31353,70,6802,1044;10136,10950,0,0,0,2,2
31354,70,6806,10165,10950,0,0,0,1,1
31355,70,6807,10308;10385,10950,0,0,0,2,2
31356,70,6808,10263,10950,0,0,0,1,1
31357,70,6809,10426;10459,10950,0,0,0,2,2
31358,70,6811,10429;10503,10950,0,0,0,2,2
31359,70,6812,10525;10904,10950,0,0,1,1,2
31360,70,6816,10597;11069,10950,0,0,1,1,2
31361,70,6817,10464;10616,10950,0,0,0,2,2
31362,70,6819,10945;11061,10950,0,0,2,0,2
31363,70,6820,10712,10950,0,0,0,1,1
31364,70,6822,11276;11466,10950,0,0,2,0,2
31365,70,6823,10764;10997,10950,0,0,1,1,2
31366,70,6824,10598;10793;15659,10950,0,0,2,1,3
31367,70,6825,10808;10823,10950,0,0,2,0,2
31368,70,6826,10814;10835,10950,0,0,2,0,2
31369,70,6827,10839;11009,10950,0,0,2,0,2
31370,70,6828,11108;11147;14561;15387,10950,0,0,4,0,4
31371,70,6830,11204;11484,10950,0,0,2,0,2
31372,70,6831,11269;16111,10950,0,0,2,0,2
31373,70,6832,10818;10932,10950,0,0,2,0,2
31374,70,6833,11074;15642,10950,0,0,2,0,2
31375,70,6835,11127,10950,0,0,1,0,1
31376,70,6836,10696;10902,10950,0,0,1,1,2
31377,70,6837,11019;11047,10950,0,0,2,0,2
31378,70,6838,10662;11023;16470,10950,0,0,2,1,3
31379,70,6839,10921;11135,10950,0,0,2,0,2
31380,70,6840,10799;11059,10950,0,0,2,0,2
31381,70,6841,11054;11566,10950,0,0,2,0,2
31382,70,6842,10367;11083,10950,0,0,1,1,2
31383,70,6843,11100;11404;14083,10950,0,0,3,0,3
31384,70,6844,10664;11103;15618,10950,0,0,2,1,3
31385,70,6845,11114;11476;16291;16503,10950,0,0,4,0,4
31386,70,6846,11124;11339,10950,0,0,2,0,2
31387,70,6847,10798;11129,10950,0,0,2,0,2
31388,70,6848,11230;11328,10950,0,0,2,0,2
31389,70,6849,11265;11526,10950,0,0,2,0,2
31390,70,6850,10960;11413;15306,10950,0,0,3,0,3
31391,70,6851,11344;11798,10950,0,0,2,0,2
31392,70,6852,11266;16360,10950,0,0,2,0,2
31393,70,6853,10909;11196,10950,0,0,2,0,2
31394,70,6854,11629,10950,0,0,1,0,1
31395,70,6855,11377;16158,10950,0,0,2,0,2
31396,70,6856,11228;11543,10950,0,0,2,0,2
31397,70,6857,11243,10950,0,0,1,0,1
31398,70,6858,11090;11184,10950,0,0,2,0,2
31399,70,6859,11256;11527;14994,10950,0,0,3,0,3
31400,70,6860,11394;11401,10950,0,0,2,0,2
31401,70,6861,11183;11233;15787,10950,0,0,3,0,3
31402,70,6862,11293,10950,0,0,1,0,1
31403,70,6863,11366,10950,0,0,1,0,1
31404,70,6864,10752;11025;14614,10950,0,0,2,1,3
31405,70,6865,11277;11442,10950,0,0,2,0,2
31406,70,6866,11380;11444;16756,10950,0,0,3,0,3
31407,70,6867,11378,10950,0,0,1,0,1
31408,70,6868,11450,10950,0,0,1,0,1
31409,70,6869,11315,10950,0,0,1,0,1
31410,70,6870,11324;15053,10950,0,0,2,0,2
31411,70,6871,9510,11315,0,0,0,1,1
31412,70,6884,2300;4960,11315,0,0,0,2,2
31413,70,6890,4938,11315,0,0,0,1,1
31414,70,6893,5659;6369,11315,0,0,0,2,2
31415,70,6895,2062;10085,11315,0,0,0,2,2
31416,70,6909,10376;10651,11315,0,0,0,2,2
31417,70,6911,10729,11315,0,0,0,1,1
31418,70,6913,10205;10542,11315,0,0,0,2,2
31419,70,6915,10373,11315,0,0,0,1,1
31420,70,6916,10882,11315,0,0,1,0,1
31421,70,6917,10708;10824,11315,0,0,1,1,2
31422,70,6918,10923;15308,11315,0,0,2,0,2
31423,70,6919,10235;10472;14552;15338,11315,0,0,2,2,4
31424,70,6920,10649;10783,11315,0,0,1,1,2
31425,70,6921,10492;10701,11315,0,0,0,2,2
31426,70,6922,10508;11143;14244,11315,0,0,2,1,3
31427,70,6924,10059;10555,11315,0,0,0,2,2
31428,70,6925,10894,11315,0,0,1,0,1
31429,70,6927,10774;10918,11315,0,0,2,0,2
31430,70,6928,10776;11003,11315,0,0,2,0,2
31431,70,6929,10791;10857,11315,0,0,2,0,2
31432,70,6930,10584;10885,11315,0,0,1,1,2
31433,70,6931,10536;10811,11315,0,0,1,1,2
31434,70,6932,10339;10840;16025,11315,0,0,2,1,3
31435,70,6933,10858,11315,0,0,1,0,1
31436,70,6934,10862;10981,11315,0,0,2,0,2
31437,70,6935,10744;10855,11315,0,0,1,1,2
31438,70,6936,10963;11031,11315,0,0,2,0,2
31439,70,6938,10775,11315,0,0,1,0,1
31440,70,6939,11301;14959,11315,0,0,2,0,2
31441,70,6940,11203;11295;15375;15776,11315,0,0,4,0,4
31442,70,6941,10930;11049,11315,0,0,2,0,2
31443,70,6943,11053,11315,0,0,1,0,1
31444,70,6944,11086,11315,0,0,1,0,1
31445,70,6945,10874;11098,11315,0,0,2,0,2
31446,70,6946,10173,11315,0,0,0,1,1
31447,70,6948,11026,11315,0,0,1,0,1
31448,70,6949,11132;11224;15813,11315,0,0,3,0,3
31449,70,6950,11582;11702;15016,11315,0,0,3,0,3
31450,70,6952,10771;11236;16818,11315,0,0,3,0,3
31451,70,6953,11167;11482;16588,11315,0,0,3,0,3
31452,70,6954,10990;11181;14743,11315,0,0,3,0,3
31453,70,6955,11040;11187,11315,0,0,2,0,2
31454,70,6956,11207;11538;16510,11315,0,0,3,0,3
31455,70,6959,11234,11315,0,0,1,0,1
31456,70,6960,10954;11268,11315,0,0,2,0,2
31457,70,6962,11134;11311;14832;15316;16282;16395,11315,0,0,6,0,6
31458,70,6963,11125;11459;15315;16374,11315,0,0,4,0,4
31459,70,6964,11336;11428;14651,11315,0,0,3,0,3
31460,70,6965,11626;11697;15910;16166,11315,0,0,4,0,4
31461,70,6966,11174;11289,11315,0,0,2,0,2
31462,70,6967,11080;11346,11315,0,0,2,0,2
31463,70,6968,11719;11749,11315,0,0,2,0,2
31464,70,6969,11321;11359,11315,0,0,2,0,2
31465,70,6970,11364;11698,11315,0,0,2,0,2
31466,70,6971,11195;11382;16099,11315,0,0,3,0,3
31467,70,6972,11670;11700;16810,11315,0,0,3,0,3
31468,70,6973,11407;11432,11315,0,0,2,0,2
31469,70,6975,10026;10156,11680,0,0,0,2,2
31470,70,6989,3507;6252,11680,0,0,0,2,2
31471,70,6991,7709,11680,0,0,0,1,1
31472,70,6993,1671;5278,11680,0,0,0,2,2
31473,70,6998,7416,11680,0,0,0,1,1
31474,70,7008,10524;14708,11680,0,0,1,1,2
31475,70,7009,10674;10750,11680,0,0,0,2,2
31476,70,7010,10453,11680,0,0,0,1,1
31477,70,7011,11180;11227;14836;16306,11680,0,0,4,0,4
31478,70,7013,10687;11087,11680,0,0,1,1,2
31479,70,7014,10103;10420,11680,0,0,0,2,2
31480,70,7016,10589;10929,11680,0,0,1,1,2
31481,70,7017,10588;10609,11680,0,0,0,2,2
31482,70,7018,11162;14995,11680,0,0,2,0,2
31483,70,7020,10660;10899,11680,0,0,1,1,2
31484,70,7021,10705;10953;14504,11680,0,0,2,1,3
31485,70,7022,10646;10707,11680,0,0,0,2,2
31486,70,7023,10780,11680,0,0,1,0,1
31487,70,7024,10867;10872,11680,0,0,2,0,2
31488,70,7025,11133;11248;15552,11680,0,0,3,0,3
31489,70,7026,11140;11375;15923,11680,0,0,3,0,3
31490,70,7027,11089,11680,0,0,1,0,1
31491,70,7028,11323,11680,0,0,1,0,1
31492,70,7030,11109;11172,11680,0,0,2,0,2
31493,70,7031,11119;11575,11680,0,0,2,0,2
31494,70,7032,10935;11415,11680,0,0,2,0,2
31495,70,7033,11159,11680,0,0,1,0,1
31496,70,7034,11197;11347;16526,11680,0,0,3,0,3
31497,70,7035,11229;15493;16217,11680,0,0,3,0,3
31498,70,7036,11807;14810,11680,0,0,2,0,2
31499,70,7037,11481;16063;16547,11680,0,0,3,0,3
31500,70,7038,11242;11361;15845,11680,0,0,3,0,3
31501,70,7039,11306;11615;14934;15602;16297;17206,11680,0,1,5,0,6
31502,70,7040,11327;11657;15079,11680,0,0,3,0,3
31503,70,7041,11348;11673,11680,0,0,2,0,2
31504,70,7042,10864;11370;16556,11680,0,0,3,0,3
31505,70,7043,11384;11704;14339;16733;17566,11680,0,1,4,0,5
31506,70,7044,11387;11434;17105,11680,0,1,2,0,3
31507,70,7045,11421;11455,11680,0,0,2,0,2
31508,70,7046,11240;11468;16321,11680,0,0,3,0,3
31509,70,7047,11489;11756,11680,0,0,2,0,2
31510,70,7048,11707;15867,11680,0,0,2,0,2
31511,70,7049,11509;11740;15248,11680,0,0,3,0,3
31512,70,7050,11511;11650;16451,11680,0,0,3,0,3
31513,70,7055,774;803,12045,0,0,0,2,2
31514,70,7057,3717,12045,0,0,0,1,1
31515,70,7059,132,12045,0,0,0,1,1
31516,70,7062,8150,12045,0,0,0,1,1
31517,70,7067,3469;9388,12045,0,0,0,2,2
31518,70,7068,3690;4436,12045,0,0,0,2,2
31519,70,7073,8617,12045,0,0,0,1,1
31520,70,7081,6480;7972,12045,0,0,0,2,2
31521,70,7089,8539,12045,0,0,0,1,1
31522,70,7096,4221,12045,0,0,0,1,1
31523,70,7097,10128;10214,12045,0,0,0,2,2
31524,70,7098,10260,12045,0,0,0,1,1
31525,70,7099,10181;10303,12045,0,0,0,2,2
31526,70,7100,10345;10579,12045,0,0,0,2,2
31527,70,7102,10444;10966;13549,12045,0,0,2,1,3
31528,70,7103,10067;10546,12045,0,0,0,2,2
31529,70,7104,10549;10637,12045,0,0,0,2,2
31530,70,7106,10476;15004,12045,0,0,1,1,2
31531,70,7107,10521;10628,12045,0,0,0,2,2
31532,70,7108,10632;10905,12045,0,0,1,1,2
31533,70,7109,10222;10831,12045,0,0,1,1,2
31534,70,7110,10836,12045,0,0,1,0,1
31535,70,7111,11435;11452;15665;16656,12045,0,0,4,0,4
31536,70,7112,11033;15539,12045,0,0,2,0,2
31537,70,7115,11104;11288,12045,0,0,2,0,2
31538,70,7116,11522;15653,12045,0,0,2,0,2
31539,70,7117,11144;11478,12045,0,0,2,0,2
31540,70,7119,11189;11211,12045,0,0,2,0,2
31541,70,7120,10911;11200;15197,12045,0,0,3,0,3
31542,70,7121,11102;11493,12045,0,0,2,0,2
31543,70,7122,11225;11743;16406,12045,0,0,3,0,3
31544,70,7123,10802;11255;15324,12045,0,0,3,0,3
31545,70,7124,11259;11319,12045,0,0,2,0,2
31546,70,7125,11274;12125;16299,12045,0,0,3,0,3
31547,70,7126,11280,12045,0,0,1,0,1
31548,70,7127,11338;14322,12045,0,0,2,0,2
31549,70,7128,10789;11317;14725,12045,0,0,3,0,3
31550,70,7129,10934;11322;15370;15754,12045,0,0,4,0,4
31551,70,7130,11356;11703,12045,0,0,2,0,2
31552,70,7131,11379;11834,12045,0,0,2,0,2
31553,70,7132,11096;11393;16284,12045,0,0,3,0,3
31554,70,7133,11065;11400,12045,0,0,2,0,2
31555,70,7134,11680;11821,12045,0,0,2,0,2
31556,70,7135,11221;11453;15592,12045,0,0,3,0,3
31557,70,7136,11464;11633,12045,0,0,2,0,2
31558,70,7137,11470,12045,0,0,1,0,1
31559,70,7138,11499,12045,0,0,1,0,1
31560,70,7139,11067;11523,12045,0,0,2,0,2
31561,70,7140,11112;11534;15748,12045,0,0,3,0,3
31562,70,7141,11533;11786;14695,12045,0,0,3,0,3
31563,70,7142,11583;11594;15475,12045,0,0,3,0,3
31564,70,7144,11884,12045,0,0,1,0,1
31565,70,7146,11601;17077,12045,0,1,1,0,2
31566,70,7150,6390,12410,0,0,0,1,1
31567,70,7151,8331,12410,0,0,0,1,1
31568,70,7158,3776,12410,0,0,0,1,1
31569,70,7170,6054;9046,12410,0,0,0,2,2
31570,70,7174,5742,12410,0,0,0,1,1
31571,70,7176,7373,12410,0,0,0,1,1
31572,70,7177,622,12410,0,0,0,1,1
31573,70,7178,1472;7405,12410,0,0,0,2,2
31574,70,7185,4931,12410,0,0,0,1,1
31575,70,7192,10107;11030,12410,0,0,1,1,2
31576,70,7193,10259;10620,12410,0,0,0,2,2
31577,70,7195,4867,12410,0,0,0,1,1
31578,70,7196,14193;14808;17394;17531;18124;18426,12410,1,3,2,0,6
31579,70,7199,10334;10972,12410,0,0,1,1,2
31580,70,7201,10539;10689,12410,0,0,0,2,2
31581,70,7202,10559;11029,12410,0,0,1,1,2
31582,70,7205,10594;10974,12410,0,0,1,1,2
31583,70,7207,11312;15963,12410,0,0,2,0,2
31584,70,7208,10706;10778,12410,0,0,1,1,2
31585,70,7209,10573;11022,12410,0,0,1,1,2
31586,70,7211,10787;10936,12410,0,0,2,0,2
31587,70,7212,10812;10822,12410,0,0,2,0,2
31588,70,7213,10850;11028;15084,12410,0,0,3,0,3
31589,70,7215,11002;11088,12410,0,0,2,0,2
31590,70,7216,11291;11524;16086,12410,0,0,3,0,3
31591,70,7217,11012;11488;16276;17330,12410,0,1,3,0,4
31592,70,7218,10969;15369,12410,0,0,2,0,2
31593,70,7220,10757;11099,12410,0,0,1,1,2
31594,70,7221,11349,12410,0,0,1,0,1
31595,70,7222,11687;16620,12410,0,0,2,0,2
31596,70,7223,11457;15679,12410,0,0,2,0,2
31597,70,7225,11218;11342,12410,0,0,2,0,2
31598,70,7226,11270;11512;15286,12410,0,0,3,0,3
31599,70,7227,11267;11273,12410,0,0,2,0,2
31600,70,7228,11008;11279,12410,0,0,2,0,2
31601,70,7229,11298;11416;15777,12410,0,0,3,0,3
31602,70,7230,11331;11367;15550,12410,0,0,3,0,3
31603,70,7231,11571,12410,0,0,1,0,1
31604,70,7232,11106;11341,12410,0,0,2,0,2
31605,70,7233,11358,12410,0,0,1,0,1
31606,70,7234,10957;11371,12410,0,0,2,0,2
31607,70,7235,11386;11420;16460,12410,0,0,3,0,3
31608,70,7236,11235;15725,12410,0,0,2,0,2
31609,70,7237,11438;12053,12410,0,0,2,0,2
31610,70,7239,10797;11502,12410,0,0,2,0,2
31611,70,7240,11518;11780;17037,12410,0,1,2,0,3
31612,70,7241,11537;11541,12410,0,0,2,0,2
31613,70,7242,11757;11782;14402,12410,0,0,3,0,3
31614,70,7243,11553;11584;16064,12410,0,0,3,0,3
31615,70,7244,11938;17238,12410,0,1,1,0,2
31616,70,7245,11529;11567,12410,0,0,2,0,2
31617,70,7246,11577;11795,12410,0,0,2,0,2
31618,70,7247,11578;14547;15297,12410,0,0,3,0,3
31619,70,7248,12128;15702;16953,12410,0,1,2,0,3
31620,70,7249,11618;16132,12410,0,0,2,0,2
31621,70,7250,11620;15449,12410,0,0,2,0,2
31622,70,7251,11628;16411,12410,0,0,2,0,2
31623,70,7252,11887;11982,12410,0,0,2,0,2
31624,70,7253,11713;11849,12410,0,0,2,0,2
31625,70,7254,11173;11722,12410,0,0,2,0,2
31626,70,7256,11663;11738,12410,0,0,2,0,2
31627,70,7257,11747;12098;16748,12410,0,0,3,0,3
31628,70,7261,1191,12775,0,0,0,1,1
31629,70,7269,8498,12775,0,0,0,1,1
31630,70,7270,8862;10501,12775,0,0,0,2,2
31631,70,7272,9231,12775,0,0,0,1,1
31632,70,7279,7410,12775,0,0,0,1,1
31633,70,7284,8132,12775,0,0,0,1,1
31634,70,7293,10348;10845;15877,12775,0,0,2,1,3
31635,70,7297,10400;10813,12775,0,0,1,1,2
31636,70,7298,10819;10989,12775,0,0,2,0,2
31637,70,7299,10938;15092,12775,0,0,2,0,2
31638,70,7300,10848;15634,12775,0,0,2,0,2
31639,70,7301,10698;10772;15266,12775,0,0,2,1,3
31640,70,7303,10564;10715,12775,0,0,0,2,2
31641,70,7304,10906;11095,12775,0,0,2,0,2
31642,70,7305,10784;15500,12775,0,0,2,0,2
31643,70,7307,10844;11010,12775,0,0,2,0,2
31644,70,7308,11330;11479;15727,12775,0,0,3,0,3
31645,70,7309,10512;10675,12775,0,0,0,2,2
31646,70,7310,10751;10908,12775,0,0,1,1,2
31647,70,7311,11136;11462,12775,0,0,2,0,2
31648,70,7312,11153;14694,12775,0,0,2,0,2
31649,70,7314,11283;11303;15173;15302;16738,12775,0,0,5,0,5
31650,70,7315,11285;11458;15031;15420,12775,0,0,4,0,4
31651,70,7316,10987;11334,12775,0,0,2,0,2
31652,70,7317,11340;16718,12775,0,0,2,0,2
31653,70,7318,11494;15773;15958,12775,0,0,3,0,3
31654,70,7319,11731;15975,12775,0,0,2,0,2
31655,70,7320,11978;12121;15256;16906,12775,0,0,4,0,4
31656,70,7321,11337;11480,12775,0,0,2,0,2
31657,70,7322,11302;11495;15607,12775,0,0,3,0,3
31658,70,7323,11498,12775,0,0,1,0,1
31659,70,7324,11742;11864;16062,12775,0,0,3,0,3
31660,70,7325,11056;11491;16696,12775,0,0,3,0,3
31661,70,7326,11530;11863,12775,0,0,2,0,2
31662,70,7327,11531;11612,12775,0,0,2,0,2
31663,70,7328,11552;16416,12775,0,0,2,0,2
31664,70,7329,11918;12034;16355,12775,0,0,3,0,3
31665,70,7330,11598;11616;16540,12775,0,0,3,0,3
31666,70,7331,11508,12775,0,0,1,0,1
31667,70,7332,11565;11653,12775,0,0,2,0,2
31668,70,7333,11674,12775,0,0,1,0,1
31669,70,7334,11699;11882;17315,12775,0,1,2,0,3
31670,70,7335,11708;15262,12775,0,0,2,0,2
31671,70,7336,11573;11724;15752;16635,12775,0,0,4,0,4
31672,70,7337,11139;11151,12775,0,0,2,0,2
31673,70,7338,11759;12225,12775,0,0,2,0,2
31674,70,7339,11761;11866,12775,0,0,2,0,2
31675,70,7340,11774;12247,12775,0,0,2,0,2
31676,70,7341,11686;11790;15251;15914;16488;16973,12775,0,1,5,0,6
31677,70,7342,11778;11805;14750,12775,0,0,3,0,3
31678,70,7343,11417;11517;16316,12775,0,0,3,0,3
31679,70,7344,11559;11837;15833;16654;16978,12775,0,1,4,0,5
31680,70,7345,12116;12228;16484,12775,0,0,3,0,3
31681,70,7346,11640;11869;16685,12775,0,0,3,0,3
31682,70,7348,383;10576;14851,13140,0,0,1,2,3
31683,70,7356,2628,13140,0,0,0,1,1
31684,70,7371,9098,13140,0,0,0,1,1
31685,70,7373,7141,13140,0,0,0,1,1
31686,70,7376,10106;10363,13140,0,0,0,2,2
31687,70,7378,10216,13140,0,0,0,1,1
31688,70,7381,4883;10413,13140,0,0,0,2,2
31689,70,7382,10325,13140,0,0,0,1,1
31690,70,7384,10543;10671,13140,0,0,0,2,2
31691,70,7386,10958,13140,0,0,1,0,1
31692,70,7389,10648;10875,13140,0,0,1,1,2
31693,70,7390,10404;15111,13140,0,0,1,1,2
31694,70,7391,10933;10949,13140,0,0,2,0,2
31695,70,7392,10925;11111,13140,0,0,2,0,2
31696,70,7393,10736;11016,13140,0,0,1,1,2
31697,70,7394,11833;16113,13140,0,0,2,0,2
31698,70,7395,11072,13140,0,0,1,0,1
31699,70,7396,11105;11551;15728,13140,0,0,3,0,3
31700,70,7397,10806;11107,13140,0,0,2,0,2
31701,70,7398,10769;11046;15218;15893,13140,0,0,4,0,4
31702,70,7399,11326,13140,0,0,1,0,1
31703,70,7400,10891;11190,13140,0,0,2,0,2
31704,70,7401,11037;11550;16184;16238,13140,0,0,4,0,4
31705,70,7402,11405;11677;16939,13140,0,0,3,0,3
31706,70,7403,11409;11486;16487,13140,0,0,3,0,3
31707,70,7404,11436;11485;16326,13140,0,0,3,0,3
31708,70,7405,11396;11465;14688;16256,13140,0,0,4,0,4
31709,70,7406,11570;11606,13140,0,0,2,0,2
31710,70,7407,11354;11515;16232,13140,0,0,3,0,3
31711,70,7408,11310;11535;16515,13140,0,0,3,0,3
31712,70,7409,11585;12096;16571,13140,0,0,3,0,3
31713,70,7410,11456;11614;16854,13140,0,0,3,0,3
31714,70,7411,11449;12246,13140,0,0,2,0,2
31715,70,7412,11646;11689;15737,13140,0,0,3,0,3
31716,70,7413,12205,13140,0,0,1,0,1
31717,70,7414,11969;11984;16046,13140,0,0,3,0,3
31718,70,7415,11542;15862;16051;16653;16812,13140,0,0,5,0,5
31719,70,7416,11602;11727;16274,13140,0,0,3,0,3
31720,70,7417,11728;11897;16094,13140,0,0,3,0,3
31721,70,7418,11935;12237;15466;15726,13140,0,0,4,0,4
31722,70,7420,11784;12371;16213;16387,13140,0,0,4,0,4
31723,70,7421,12131;17006,13140,0,1,1,0,2
31724,70,7423,11822;14768,13140,0,0,2,0,2
31725,70,7424,11734;15040,13140,0,0,2,0,2
31726,70,7425,11831;12101;14660,13140,0,0,3,0,3
31727,70,7426,11847;12176,13140,0,0,2,0,2
31728,70,7427,12221;16078;17074,13140,0,1,2,0,3
31729,70,7428,12060;12192;16665,13140,0,0,3,0,3
31730,70,7429,11694;11889;16932,13140,0,0,3,0,3
31731,70,7430,11817;11900;16398,13140,0,0,3,0,3
31732,70,7431,11540;11903,13140,0,0,2,0,2
31733,70,7433,11851;11937;16684,13140,0,0,3,0,3
31734,70,7434,11926;12157;16699;17166,13140,0,1,3,0,4
31735,70,7435,11607;11932,13140,0,0,2,0,2
31736,70,7436,11752;11901,13140,0,0,2,0,2
31737,70,7437,12162,13140,0,0,1,0,1
31738,70,7438,11971;12000;15152,13140,0,0,3,0,3
31739,70,7442,1930,13505,0,0,0,1,1
31740,70,7446,4511,13505,0,0,0,1,1
31741,70,7451,1883;5662,13505,0,0,0,2,2
31742,70,7456,2878,13505,0,0,0,1,1
31743,70,7459,7733,13505,0,0,0,1,1
31744,70,7468,8854,13505,0,0,0,1,1
31745,70,7471,6420;9951,13505,0,0,0,2,2
31746,70,7473,1837,13505,0,0,0,1,1
31747,70,7475,10461;10962,13505,0,0,1,1,2
31748,70,7478,10414;10490,13505,0,0,0,2,2
31749,70,7481,10445;10498,13505,0,0,0,2,2
31750,70,7483,10479;15711,13505,0,0,1,1,2
31751,70,7484,10592;15390,13505,0,0,1,1,2
31752,70,7486,10939;10999,13505,0,0,2,0,2
31753,70,7488,11007;11064;15277;16275,13505,0,0,4,0,4
31754,70,7489,10843;11477,13505,0,0,2,0,2
31755,70,7491,11126,13505,0,0,1,0,1
31756,70,7492,11138,13505,0,0,1,0,1
31757,70,7493,11332;15264,13505,0,0,2,0,2
31758,70,7494,10647;11142,13505,0,0,1,1,2
31759,70,7495,11439;11506,13505,0,0,2,0,2
31760,70,7497,11286,13505,0,0,1,0,1
31761,70,7498,10897;11292;15528,13505,0,0,3,0,3
31762,70,7499,10903;11528,13505,0,0,2,0,2
31763,70,7500,11357;12004,13505,0,0,2,0,2
31764,70,7501,11068;11408;16600,13505,0,0,3,0,3
31765,70,7503,11474,13505,0,0,1,0,1
31766,70,7504,11246;11516,13505,0,0,2,0,2
31767,70,7505,11554;11979;16923,13505,0,0,3,0,3
31768,70,7506,11581;11806;16295,13505,0,0,3,0,3
31769,70,7507,11599;12181;16173,13505,0,0,3,0,3
31770,70,7508,11397;11980;16372,13505,0,0,3,0,3
31771,70,7509,11560;11627;14935;16450,13505,0,0,4,0,4
31772,70,7510,11684;16937,13505,0,0,2,0,2
31773,70,7511,11643;11732;15341;16257,13505,0,0,4,0,4
31774,70,7512,11660;12203;15957,13505,0,0,3,0,3
31775,70,7513,11658;11672,13505,0,0,2,0,2
31776,70,7514,11427;11678;15959;16676,13505,0,0,4,0,4
31777,70,7515,11525;11766,13505,0,0,2,0,2
31778,70,7516,12472;12657;16842,13505,0,0,3,0,3
31779,70,7517,11793;14941;15280,13505,0,0,3,0,3
31780,70,7518,12117;12219,13505,0,0,2,0,2
31781,70,7519,12342;12388,13505,0,0,2,0,2
31782,70,7520,11880;11960;15800;16557,13505,0,0,4,0,4
31783,70,7521,12302,13505,0,0,1,0,1
31784,70,7522,11958;12249,13505,0,0,2,0,2
31785,70,7523,11610;11896;16024;16331;17055;17139,13505,0,2,4,0,6
31786,70,7524,12324;15442,13505,0,0,2,0,2
31787,70,7525,11505;12167;15489,13505,0,0,3,0,3
31788,70,7526,11927;12346;14942;14988,13505,0,0,4,0,4
31789,70,7527,12091;16464,13505,0,0,2,0,2
31790,70,7528,11955;15526;17222,13505,0,1,2,0,3
31791,70,7529,11961;11994;14910,13505,0,0,3,0,3
31792,70,7530,11981;16574;16784,13505,0,0,3,0,3
31793,70,7531,11753;11987;16338,13505,0,0,3,0,3
31794,70,7532,12376;15334;16509;16651;17032,13505,0,1,4,0,5
31795,70,7533,12204;12279,13505,0,0,2,0,2
31796,70,7534,11692;12065;16138;16209;16633,13505,0,0,5,0,5
31797,70,7535,11925;12067;17109,13505,0,1,2,0,3
31798,70,7536,12314;12392;15047,13505,0,0,3,0,3
31799,70,7537,12093;16433,13505,0,0,2,0,2
31800,70,7538,11996;12099;16224,13505,0,0,3,0,3
31801,70,7539,11769;12107;15330,13505,0,0,3,0,3
31802,70,7540,12120;12460;16969;17833,13505,0,2,2,0,4
31803,70,7541,12056;12529;15944;16938,13505,0,0,4,0,4
31804,70,7542,488,13870,0,0,0,1,1
31805,70,7547,65,13870,0,0,0,1,1
31806,70,7550,3198,13870,0,0,0,1,1
31807,70,7555,6450,13870,0,0,0,1,1
31808,70,7557,7211,13870,0,0,0,1,1
31809,70,7562,1814,13870,0,0,0,1,1
31810,70,7564,9740;10270,13870,0,0,0,2,2
31811,70,7569,10399,13870,0,0,0,1,1
31812,70,7571,10137;10531,13870,0,0,0,2,2
31813,70,7575,10801;10841,13870,0,0,2,0,2
31814,70,7578,10661;10943,13870,0,0,1,1,2
31815,70,7579,11001;15644;16077,13870,0,0,3,0,3
31816,70,7580,11021;16415,13870,0,0,2,0,2
31817,70,7582,11118,13870,0,0,1,0,1
31818,70,7583,14981,13870,0,0,1,0,1
31819,70,7584,11250;11572;16746;16985,13870,0,1,3,0,4
31820,70,7585,10232,13870,0,0,0,1,1
31821,70,7586,11333;11365,13870,0,0,2,0,2
31822,70,7587,11350;11656,13870,0,0,2,0,2
31823,70,7588,11720;15041,13870,0,0,2,0,2
31824,70,7589,11579;11675,13870,0,0,2,0,2
31825,70,7590,11418;11639;15288;16341,13870,0,0,4,0,4
31826,70,7591,11128;15933,13870,0,0,2,0,2
31827,70,7593,11168;11510,13870,0,0,2,0,2
31828,70,7596,11536;11733,13870,0,0,2,0,2
31829,70,7597,12118,13870,0,0,1,0,1
31830,70,7598,11915;12434;15194;16534;17158;17365,13870,0,2,4,0,6
31831,70,7599,11634;12062;15204,13870,0,0,3,0,3
31832,70,7600,11975;15671;16543;17093,13870,0,1,3,0,4
31833,70,7601,11748;12070,13870,0,0,2,0,2
31834,70,7602,11933;16550,13870,0,0,2,0,2
31835,70,7604,11345;11811;15599,13870,0,0,3,0,3
31836,70,7605,11789;12104;17594,13870,0,1,2,0,3
31837,70,7606,12187;16955,13870,0,1,1,0,2
31838,70,7607,11802;11916;16157;16388;17184,13870,0,1,4,0,5
31839,70,7608,11942;12092;15625,13870,0,0,3,0,3
31840,70,7609,11924;11944,13870,0,0,2,0,2
31841,70,7610,11950;12160;16877,13870,0,0,3,0,3
31842,70,7611,12638;12639,13870,0,0,2,0,2
31843,70,7612,11962;12191;15637,13870,0,0,3,0,3
31844,70,7613,11963,13870,0,0,1,0,1
31845,70,7614,12267;16508,13870,0,0,2,0,2
31846,70,7617,12019;12413;15745;16474,13870,0,0,4,0,4
31847,70,7618,12146;12626,13870,0,0,2,0,2
31848,70,7619,11608;12026,13870,0,0,2,0,2
31849,70,7620,12265;12518,13870,0,0,2,0,2
31850,70,7621,11320;12049;16260;17775,13870,0,1,3,0,4
31851,70,7622,12078;12254;15409;16737,13870,0,0,4,0,4
31852,70,7623,11814;12329;15039;17067,13870,0,1,3,0,4
31853,70,7624,12208;16127,13870,0,0,2,0,2
31854,70,7625,12100;12350;16658,13870,0,0,3,0,3
31855,70,7626,12327;12580;16636,13870,0,0,3,0,3
31856,70,7627,11953;12389;16688;16732;17532,13870,0,1,4,0,5
31857,70,7628,11679;12178,13870,0,0,2,0,2
31858,70,7629,12224;12604;17118,13870,0,1,2,0,3
31859,70,7630,12201;12207;15706;17548,13870,0,1,3,0,4
31860,70,7631,12210;12598;16927,13870,0,0,3,0,3
31861,70,7632,11939;12232;16279;16322,13870,0,0,4,0,4
31862,70,7633,12480;12551;16363;17396,13870,0,1,3,0,4
31863,70,7634,12073;12454,13870,0,0,2,0,2
31864,70,7635,12130;12259;15323;15696,13870,0,0,4,0,4
31865,70,7637,334;10065,14235,0,0,0,2,2
31866,70,7639,9113,14235,0,0,0,1,1
31867,70,7646,2442,14235,0,0,0,1,1
31868,70,7648,1140,14235,0,0,0,1,1
31869,70,7651,929;3477,14235,0,0,0,2,2
31870,70,7652,7554,14235,0,0,0,1,1
31871,70,7657,9009,14235,0,0,0,1,1
31872,70,7667,10004;10240;15763,14235,0,0,1,2,3
31873,70,7671,11188;15301,14235,0,0,2,0,2
31874,70,7672,11166;11296;15551,14235,0,0,3,0,3
31875,70,7678,11042;11372;16018,14235,0,0,3,0,3
31876,70,7680,11275;11500;16242,14235,0,0,3,0,3
31877,70,7682,11079;11325;15428,14235,0,0,3,0,3
31878,70,7684,11691,14235,0,0,1,0,1
31879,70,7685,11521;15861;16100;16442,14235,0,0,4,0,4
31880,70,7687,11472;11735,14235,0,0,2,0,2
31881,70,7688,11294;11654;15663;17047,14235,0,1,3,0,4
31882,70,7689,11562;11636;16001,14235,0,0,3,0,3
31883,70,7690,11568,14235,0,0,1,0,1
31884,70,7691,11622;15596,14235,0,0,2,0,2
31885,70,7692,11647;15485;16774,14235,0,0,3,0,3
31886,70,7693,11671;11919,14235,0,0,2,0,2
31887,70,7694,11576,14235,0,0,1,0,1
31888,70,7695,11335;11595,14235,0,0,2,0,2
31889,70,7696,12014;15992,14235,0,0,2,0,2
31890,70,7697,11272;11746;15276;15555;16525,14235,0,0,5,0,5
31891,70,7699,11785;12366;16491,14235,0,0,3,0,3
31892,70,7700,12407;12568,14235,0,0,2,0,2
31893,70,7701,11329;11850;16190,14235,0,0,3,0,3
31894,70,7702,11556;11832;16583,14235,0,0,3,0,3
31895,70,7703,11892;11983;17201,14235,0,1,2,0,3
31896,70,7704,12358;17066;17309,14235,0,2,1,0,3
31897,70,7705,11751;11945;15670;17043,14235,0,1,3,0,4
31898,70,7706,11685;11952,14235,0,0,2,0,2
31899,70,7709,12298;15100;17524,14235,0,1,2,0,3
31900,70,7710,11659;11985;15436,14235,0,0,3,0,3
31901,70,7711,12111;15412;17399,14235,0,1,2,0,3
31902,70,7712,11544;16859,14235,0,0,2,0,2
31903,70,7713,12562;16452,14235,0,0,2,0,2
31904,70,7714,11652;12059;16691,14235,0,0,3,0,3
31905,70,7715,11976;12074,14235,0,0,2,0,2
31906,70,7716,11923;12075;15872;16659,14235,0,0,4,0,4
31907,70,7717,12076;12592;16098;17395,14235,0,1,3,0,4
31908,70,7718,12087;16890,14235,0,0,2,0,2
31909,70,7719,12288;12348;16000,14235,0,0,3,0,3
31910,70,7720,12102;12124;16565,14235,0,0,3,0,3
31911,70,7721,12122;16445;16630;17420,14235,0,1,3,0,4
31912,70,7722,12048;12126,14235,0,0,2,0,2
31913,70,7723,12064;12143;16569,14235,0,0,3,0,3
31914,70,7724,12469;12776;17572,14235,0,1,2,0,3
31915,70,7725,12465;16475,14235,0,0,2,0,2
31916,70,7726,12728;17087;17272;17511,14235,0,3,1,0,4
31917,70,7727,12185;12603;16465;16794;17321,14235,0,1,4,0,5
31918,70,7728,12149;12199,14235,0,0,2,0,2
31919,70,7729,12233;12697;16035,14235,0,0,3,0,3
31920,70,7730,12673;17525,14235,0,1,1,0,2
31921,70,7731,12239;12558;16935;17600,14235,0,1,3,0,4
31922,70,7732,11853;12362;15641;16305;16916;17009,14235,0,1,5,0,6
31923,70,7734,12084;12466;16310,14235,0,0,3,0,3
31924,70,7735,11810;12336;16397,14235,0,0,3,0,3
31925,70,7736,12173;12432;17614,14235,0,1,2,0,3
31926,70,7737,12292;12374,14235,0,0,2,0,2
31927,70,7738,12373;12729,14235,0,0,2,0,2
31928,70,7740,11858;12258;15863;16563,14235,0,0,4,0,4
31929,70,7742,909,14600,0,0,0,1,1
31930,70,7746,4693,14600,0,0,0,1,1
31931,70,7748,5008,14600,0,0,0,1,1
31932,70,7750,4398,14600,0,0,0,1,1
31933,70,7752,1032;4860,14600,0,0,0,2,2
31934,70,7753,5192,14600,0,0,0,1,1
31935,70,7757,4770,14600,0,0,0,1,1
31936,70,7758,8020,14600,0,0,0,1,1
31937,70,7763,3240,14600,0,0,0,1,1
31938,70,7765,6201,14600,0,0,0,1,1
31939,70,7772,10497;10623;16468,14600,0,0,1,2,3
31940,70,7773,10561;11239,14600,0,0,1,1,2
31941,70,7775,10655;11226,14600,0,0,1,1,2
31942,70,7776,10686;15234,14600,0,0,1,1,2
31943,70,7778,10782;10993;15265,14600,0,0,3,0,3
31944,70,7780,10442;10846,14600,0,0,1,1,2
31945,70,7781,10670;10887;16308,14600,0,0,2,1,3
31946,70,7783,10517;15840,14600,0,0,1,1,2
31947,70,7785,11017;11157;16103,14600,0,0,3,0,3
31948,70,7786,10877;11076,14600,0,0,2,0,2
31949,70,7787,10614;11178,14600,0,0,1,1,2
31950,70,7788,11154;11412,14600,0,0,2,0,2
31951,70,7789,11148;11597,14600,0,0,2,0,2
31952,70,7790,10924;11131;15249,14600,0,0,3,0,3
31953,70,7791,11213;15906,14600,0,0,2,0,2
31954,70,7792,11220;11271;15929,14600,0,0,3,0,3
31955,70,7793,11005;11278;16499,14600,0,0,3,0,3
31956,70,7794,11781;11808;15622,14600,0,0,3,0,3
31957,70,7795,11353;11390;15597;16924,14600,0,0,4,0,4
31958,70,7796,11304;15259,14600,0,0,2,0,2
31959,70,7797,11160;11580,14600,0,0,2,0,2
31960,70,7799,11532;11906;15508,14600,0,0,3,0,3
31961,70,7800,11718;11951;16478;16775,14600,0,0,4,0,4
31962,70,7801,11557;11603,14600,0,0,2,0,2
31963,70,7802,11669,14600,0,0,1,0,1
31964,70,7803,11815;16882,14600,0,0,2,0,2
31965,70,7804,11492;11768;16819,14600,0,0,3,0,3
31966,70,7805,11549;11946;16490;16705,14600,0,0,4,0,4
31967,70,7806,11388;11762;16554,14600,0,0,3,0,3
31968,70,7807,12276;12481;16792,14600,0,0,3,0,3
31969,70,7808,11423,14600,0,0,1,0,1
31970,70,7809,12420;16887;17144,14600,0,1,2,0,3
31971,70,7810,11846;12139;15796;17223,14600,0,1,3,0,4
31972,70,7811,11855;12401;17176;17482,14600,0,2,2,0,4
31973,70,7812,11791;11867;15296,14600,0,0,3,0,3
31974,70,7813,11385;11891,14600,0,0,2,0,2
31975,70,7814,11913;12323;17172,14600,0,1,2,0,3
31976,70,7815,11988,14600,0,0,1,0,1
31977,70,7816,11991;16040,14600,0,0,2,0,2
31978,70,7817,12008;16285;17019;17368,14600,0,2,2,0,4
31979,70,7818,12023;12119,14600,0,0,2,0,2
31980,70,7819,11587;12041,14600,0,0,2,0,2
31981,70,7820,12077;12306;17161,14600,0,1,2,0,3
31982,70,7821,12082;12347;16898,14600,0,0,3,0,3
31983,70,7822,11835;12322;16516;17075;17191,14600,0,2,3,0,5
31984,70,7823,11792;12106;17237,14600,0,1,2,0,3
31985,70,7824,12132;12572;15635;15966;16715;17417,14600,0,1,5,0,6
31986,70,7825,11787;12133;17117,14600,0,1,2,0,3
31987,70,7826,12326;12750;16988,14600,0,1,2,0,3
31988,70,7827,11363;12177;16421;16970,14600,0,1,3,0,4
31989,70,7828,12186;16141;16346,14600,0,0,3,0,3
31990,70,7829,12190;12622;15982;16693,14600,0,0,4,0,4
31991,70,7830,12222;12285,14600,0,0,2,0,2
31992,70,7831,12274;12331,14600,0,0,2,0,2
31993,70,7832,12172;12257,14600,0,0,2,0,2
31994,70,7833,12633;12775;16930,14600,0,0,3,0,3
31995,70,7834,12171;12294;16469;16847,14600,0,0,4,0,4
31996,70,7835,12311;12629;15405,14600,0,0,3,0,3
31997,70,7836,12313;12367;17404;17813,14600,0,2,2,0,4
31998,70,7837,12009;12404;16708;16994,14600,0,1,3,0,4
31999,70,7838,11965;12332;16052,14600,0,0,3,0,3
32000,70,7839,12338,14600,0,0,1,0,1
32001,70,7840,12339;16056;17220,14600,0,1,2,0,3
32002,70,7841,12706;12789;15643;17244,14600,0,1,3,0,4
32003,70,7842,12081;12359;16980;17491,14600,0,2,2,0,4
32004,70,7843,12505;12663;16401;17998,14600,0,1,3,0,4
32005,70,7844,11957;12280;16848,14600,0,0,3,0,3
32006,70,7845,12390;12441;15383,14600,0,0,3,0,3
32007,70,7846,12290;15318,14600,0,0,2,0,2
32008,70,7847,12424;12594;16647,14600,0,0,3,0,3
32009,70,7848,12303;12370,14600,0,0,2,0,2
32010,70,7849,12054;12652;17286,14600,0,1,2,0,3
32011,70,7864,5565,14965,0,0,0,1,1
32012,70,7865,5715,14965,0,0,0,1,1
32013,70,7866,5789,14965,0,0,0,1,1
32014,70,7868,6949,14965,0,0,0,1,1
32015,70,7869,1321,14965,0,0,0,1,1
32016,70,7870,3833,14965,0,0,0,1,1
32017,70,7873,8806,14965,0,0,0,1,1
32018,70,7875,10049,14965,0,0,0,1,1
32019,70,7877,10384;10493,14965,0,0,0,2,2
32020,70,7879,10283;10585;15985,14965,0,0,1,2,3
32021,70,7883,11014;11838,14965,0,0,2,0,2
32022,70,7884,10759;10941;15899,14965,0,0,2,1,3
32023,70,7885,10554;11071,14965,0,0,1,1,2
32024,70,7886,11176,14965,0,0,1,0,1
32025,70,7887,11194;11261;16402,14965,0,0,3,0,3
32026,70,7888,10965;16593,14965,0,0,2,0,2
32027,70,7889,11373;11447,14965,0,0,2,0,2
32028,70,7890,11514;16742,14965,0,0,2,0,2
32029,70,7892,11667;16934,14965,0,0,2,0,2
32030,70,7893,11287;11419,14965,0,0,2,0,2
32031,70,7894,11092;11504;16358;16368,14965,0,0,4,0,4
32032,70,7895,11222;11545,14965,0,0,2,0,2
32033,70,7896,11635;15590,14965,0,0,2,0,2
32034,70,7897,11625;11827;16081,14965,0,0,3,0,3
32035,70,7898,12032;12495;15913;15946;16292;17187,14965,0,1,5,0,6
32036,70,7899,11661,14965,0,0,1,0,1
32037,70,7900,11776;12960;16778;17110;17314,14965,0,2,3,0,5
32038,70,7902,11710;12248;16210,14965,0,0,3,0,3
32039,70,7903,11824;15878;16482,14965,0,0,3,0,3
32040,70,7904,12057;12268;16265,14965,0,0,3,0,3
32041,70,7905,11730;11886;16821,14965,0,0,3,0,3
32042,70,7906,11943;16137;16714,14965,0,0,3,0,3
32043,70,7907,11873;11947;16808,14965,0,0,3,0,3
32044,70,7908,11954;12497;16657;16799,14965,0,0,4,0,4
32045,70,7909,12006;12732;16403;17131,14965,0,1,3,0,4
32046,70,7910,11589;12011;15684,14965,0,0,3,0,3
32047,70,7911,12015;12870;15781;16922,14965,0,0,4,0,4
32048,70,7912,11770;12025;15798;16750,14965,0,0,4,0,4
32049,70,7913,12212,14965,0,0,1,0,1
32050,70,7914,11433;12068;16258,14965,0,0,3,0,3
32051,70,7915,12378;12381,14965,0,0,2,0,2
32052,70,7916,12097;16296;16694,14965,0,0,3,0,3
32053,70,7917,12154;12299,14965,0,0,2,0,2
32054,70,7918,11936;12174;16521;17153,14965,0,1,3,0,4
32055,70,7919,12183;12287;15948;16998,14965,0,1,3,0,4
32056,70,7920,11968;12240,14965,0,0,2,0,2
32057,70,7921,12260;12564;16524;16845,14965,0,0,4,0,4
32058,70,7922,12031;12271;16707,14965,0,0,3,0,3
32059,70,7923,12296;12787;16896;17160,14965,0,1,3,0,4
32060,70,7924,12593;12624;17367,14965,0,1,2,0,3
32061,70,7925,12308;16797,14965,0,0,2,0,2
32062,70,7926,12309;12530;16176;16834;17263,14965,0,1,4,0,5
32063,70,7927,12316,14965,0,0,1,0,1
32064,70,7928,12295;16872,14965,0,0,2,0,2
32065,70,7929,12344;12541;16381;16618,14965,0,0,4,0,4
32066,70,7930,12451;12932;16762;17140,14965,0,1,3,0,4
32067,70,7931,12123;12353;16266;16856,14965,0,0,4,0,4
32068,70,7932,12507;12521,14965,0,0,2,0,2
32069,70,7933,12555;12853;15902;16090,14965,0,0,4,0,4
32070,70,7934,12553;12778;16357;16698,14965,0,0,4,0,4
32071,70,7935,12565;12946;15683;17155;17336;18483,14965,1,2,3,0,6
32072,70,7936,12447;12501;17378,14965,0,1,2,0,3
32073,70,7937,12402;17563,14965,0,1,1,0,2
32074,70,7938,12241;12609;17623;18028,14965,0,2,2,0,4
32075,70,7939,12063;12621;16459,14965,0,0,3,0,3
32076,70,7940,12635;12690;17011,14965,0,1,2,0,3
32077,70,7941,12699;15998;16723,14965,0,0,3,0,3
32078,70,7942,12351;12658;16806;17599,14965,0,1,3,0,4
32079,70,7943,12757;16943,14965,0,0,2,0,2
32080,70,7947,9643,15330,0,0,0,1,1
32081,70,7949,6879,15330,0,0,0,1,1
32082,70,7952,4149,15330,0,0,0,1,1
32083,70,7954,10094;10273;15972,15330,0,0,1,2,3
32084,70,7956,2189,15330,0,0,0,1,1
32085,70,7958,8013,15330,0,0,0,1,1
32086,70,7967,10424;10663;15757,15330,0,0,1,2,3
32087,70,7968,11006;11212,15330,0,0,2,0,2
32088,70,7972,10196,15330,0,0,0,1,1
32089,70,7973,10739;11284;16152,15330,0,0,2,1,3
32090,70,7974,11966;12214;17022,15330,0,1,2,0,3
32091,70,7975,10830;10853,15330,0,0,2,0,2
32092,70,7977,10449;10964,15330,0,0,1,1,2
32093,70,7978,10871,15330,0,0,1,0,1
32094,70,7979,11777;12052;15582;16420,15330,0,0,4,0,4
32095,70,7981,11245;11883;16084,15330,0,0,3,0,3
32096,70,7982,11313;11437,15330,0,0,2,0,2
32097,70,7984,11503;11638;16425,15330,0,0,3,0,3
32098,70,7985,11376;12179;16259,15330,0,0,3,0,3
32099,70,7989,11676;12156;16853,15330,0,0,3,0,3
32100,70,7990,11683;11836;15532,15330,0,0,3,0,3
32101,70,7991,11696;15546;16623,15330,0,0,3,0,3
32102,70,7992,11688;11783;16564,15330,0,0,3,0,3
32103,70,7993,11801;12283,15330,0,0,2,0,2
32104,70,7994,11865;12384;16365,15330,0,0,3,0,3
32105,70,7995,11706;11907;15792,15330,0,0,3,0,3
32106,70,7996,11755;11911;16967,15330,0,1,2,0,3
32107,70,7997,11399;11842;16689,15330,0,0,3,0,3
32108,70,7998,11990;12022;16231,15330,0,0,3,0,3
32109,70,7999,12024;12784;17046,15330,0,1,2,0,3
32110,70,8000,12105;12702;16435,15330,0,0,3,0,3
32111,70,8001,12140;12409;16424;17407,15330,0,1,3,0,4
32112,70,8002,12069;12365;17086,15330,0,1,2,0,3
32113,70,8003,12244;15956;16348;17538,15330,0,1,3,0,4
32114,70,8004,11721;12169;16058;16273,15330,0,0,4,0,4
32115,70,8005,12175;12189;16399;17130,15330,0,1,3,0,4
32116,70,8006,12197;12341;16785;16952,15330,0,1,3,0,4
32117,70,8007,12072;12589,15330,0,0,2,0,2
32118,70,8008,12018;12242,15330,0,0,2,0,2
32119,70,8009,12284;16615,15330,0,0,2,0,2
32120,70,8010,11905;12245;16907,15330,0,0,3,0,3
32121,70,8011,11922;12253;16067,15330,0,0,3,0,3
32122,70,8012,12256;12264;16075;16628;17073,15330,0,1,4,0,5
32123,70,8013,12821;16974;17344,15330,0,2,1,0,3
32124,70,8014,12310;16710,15330,0,0,2,0,2
32125,70,8015,12637;12858;16996,15330,0,1,2,0,3
32126,70,8016,12328;13211;15703;16639,15330,0,0,4,0,4
32127,70,8017,12648;12709;17527;17983,15330,0,2,2,0,4
32128,70,8018,12379;12773;16624,15330,0,0,3,0,3
32129,70,8019,11779;12393;16681,15330,0,0,3,0,3
32130,70,8020,12412;13281;17342,15330,0,1,2,0,3
32131,70,8021,12426;12759;16804,15330,0,0,3,0,3
32132,70,8022,12443;12516;15523;16960;17287;17918,15330,0,3,3,0,6
32133,70,8023,12640;12812,15330,0,0,2,0,2
32134,70,8024,12803;16712;17091,15330,0,1,2,0,3
32135,70,8025,12039;12512,15330,0,0,2,0,2
32136,70,8026,12655;16389,15330,0,0,2,0,2
32137,70,8027,12499;15715;17232,15330,0,1,2,0,3
32138,70,8028,12612;12949,15330,0,0,2,0,2
32139,70,8029,12538;12925;16396,15330,0,0,3,0,3
32140,70,8030,12552;12982;16629;16962,15330,0,1,3,0,4
32141,70,8031,12573;12781,15330,0,0,2,0,2
32142,70,8032,12500;12770;15953;16840,15330,0,0,4,0,4
32143,70,8033,12596;12740;16867;16968,15330,0,1,3,0,4
32144,70,8034,12625;12711;17373;17545,15330,0,2,2,0,4
32145,70,8035,12631;16500;16655,15330,0,0,3,0,3
32146,70,8036,12879;16233,15330,0,0,2,0,2
32147,70,8037,13195;15815;17231;17535,15330,0,2,2,0,4
32148,70,8038,12701;13041;16089;16704,15330,0,0,4,0,4
32149,70,8039,12745;13074,15330,0,0,2,0,2
32150,70,8040,12417;12764;16477,15330,0,0,3,0,3
32151,70,8041,12766;13207;16757,15330,0,0,3,0,3
32152,70,8042,12556;12788;15775;16813,15330,0,0,4,0,4
32153,70,8043,12801;12906,15330,0,0,2,0,2
32154,70,8044,7398,15695,0,0,0,1,1
32155,70,8053,5888,15695,0,0,0,1,1
32156,70,8057,6370,15695,0,0,0,1,1
32157,70,8058,6904,15695,0,0,0,1,1
32158,70,8060,3145;7115,15695,0,0,0,2,2
32159,70,8061,6342,15695,0,0,0,1,1
32160,70,8068,10162,15695,0,0,0,1,1
32161,70,8069,10406;10529,15695,0,0,0,2,2
32162,70,8075,11145;11198;15821;15954,15695,0,0,4,0,4
32163,70,8076,11075;11155;15942,15695,0,0,3,0,3
32164,70,8080,11586;11711;16443;16802,15695,0,0,4,0,4
32165,70,8082,11443;16868,15695,0,0,2,0,2
32166,70,8084,12047;15974;16385,15695,0,0,3,0,3
32167,70,8085,11709;11974;16461;16700,15695,0,0,4,0,4
32168,70,8086,11959;12559;16016;16304;16920,15695,0,0,5,0,5
32169,70,8087,11854;11992,15695,0,0,2,0,2
32170,70,8088,11705;11998;16613;17331,15695,0,1,3,0,4
32171,70,8089,12035;12335;16208;16873,15695,0,0,4,0,4
32172,70,8090,12198;12511;16330,15695,0,0,3,0,3
32173,70,8091,12188;16598;16899,15695,0,0,3,0,3
32174,70,8093,11888;12297;16441,15695,0,0,3,0,3
32175,70,8094,12071;12319;17020,15695,0,1,2,0,3
32176,70,8095,12916;16567;16901,15695,0,0,3,0,3
32177,70,8096,12155;12368;16725,15695,0,0,3,0,3
32178,70,8097,12380;12391;17622,15695,0,1,2,0,3
32179,70,8098,11800;12405;16194;17261,15695,0,1,3,0,4
32180,70,8099,12414;12561;16731,15695,0,0,3,0,3
32181,70,8100,12483;12661,15695,0,0,2,0,2
32182,70,8101,12438;12527;16913,15695,0,0,3,0,3
32183,70,8102,12134;12461,15695,0,0,2,0,2
32184,70,8103,12108;12470;16561,15695,0,0,3,0,3
32185,70,8104,13097;13235;16717,15695,0,0,3,0,3
32186,70,8105,12477;12785;17377,15695,0,1,2,0,3
32187,70,8106,12517;13365;16149;16795,15695,0,0,4,0,4
32188,70,8107,12547;12892;15823,15695,0,0,3,0,3
32189,70,8108,12535;12571;16533,15695,0,0,3,0,3
32190,70,8109,12586;16761,15695,0,0,2,0,2
32191,70,8110,13295;13353,15695,0,0,2,0,2
32192,70,8111,12478;12537;16928;17326,15695,0,1,3,0,4
32193,70,8112,12484;16763,15695,0,0,2,0,2
32194,70,8113,11934;11956;16342;17213,15695,0,1,3,0,4
32195,70,8114,12044;12650,15695,0,0,2,0,2
32196,70,8115,12042;12623;16638;16963,15695,0,1,3,0,4
32197,70,8116,12727;12962,15695,0,0,2,0,2
32198,70,8117,13093;13234;15896;15991;16394;16950;17398,15695,0,2,5,0,7
32199,70,8118,12735;16060,15695,0,0,2,0,2
32200,70,8119,12692;12765;17689,15695,0,1,2,0,3
32201,70,8120,12777;13171;16364;17406;17710;17894,15695,0,3,3,0,6
32202,70,8121,12791;12900;16161;16679,15695,0,0,4,0,4
32203,70,8122,12273;12804;15849;16370,15695,0,0,4,0,4
32204,70,8123,12810;16123;16472,15695,0,0,3,0,3
32205,70,8124,12723;12938;17801,15695,0,1,2,0,3
32206,70,8126,12448;12829,15695,0,0,2,0,2
32207,70,8127,12674;12917,15695,0,0,2,0,2
32208,70,8128,12677;12838;15937;17671,15695,0,1,3,0,4
32209,70,8129,12549;12855;16626,15695,0,0,3,0,3
32210,70,8130,12864;13297;17064;17509,15695,0,2,2,0,4
32211,70,8131,12515;12902;17713,15695,0,1,2,0,3
32212,70,8132,12462;12881,15695,0,0,2,0,2
32213,70,8133,12415;12889;17782,15695,0,1,2,0,3
32214,70,8134,12823,15695,0,0,1,0,1
32215,70,8135,13168;13311;15732;17024;17606,15695,0,2,3,0,5
32216,70,8136,12543;12912;16486;18273,15695,1,0,3,0,4
32217,70,8137,12836;13939;16268;16426;16590;16987;17441;17583;18494,15695,1,3,5,0,9
32218,70,8139,870,16060,0,0,0,1,1
32219,70,8141,584,16060,0,0,0,1,1
32220,70,8147,6970,16060,0,0,0,1,1
32221,70,8149,5328,16060,0,0,0,1,1
32222,70,8152,5248,16060,0,0,0,1,1
32223,70,8155,5731,16060,0,0,0,1,1
32224,70,8156,10309;10500,16060,0,0,0,2,2
32225,70,8163,10409;10994,16060,0,0,1,1,2
32226,70,8172,11205,16060,0,0,1,0,1
32227,70,8173,11649,16060,0,0,1,0,1
32228,70,8174,11422;16530,16060,0,0,2,0,2
32229,70,8175,11170;11446;16670,16060,0,0,3,0,3
32230,70,8176,11316;11843;16271;17258,16060,0,1,3,0,4
32231,70,8178,12010;12235;16267;16592,16060,0,0,4,0,4
32232,70,8179,11454;11812;16726;17029,16060,0,1,3,0,4
32233,70,8180,11604;11609,16060,0,0,2,0,2
32234,70,8182,11460;12061;16492,16060,0,0,3,0,3
32235,70,8183,11666;11758;15951;16427,16060,0,0,4,0,4
32236,70,8184,12003;16711;17010,16060,0,1,2,0,3
32237,70,8185,12218,16060,0,0,1,0,1
32238,70,8186,11461;11856;15864,16060,0,0,3,0,3
32239,70,8187,11870;12281,16060,0,0,2,0,2
32240,70,8188,11917;12361;16542,16060,0,0,3,0,3
32241,70,8189,11803;11949;16734,16060,0,0,3,0,3
32242,70,8190,11977;12532,16060,0,0,2,0,2
32243,70,8191,12001;12293,16060,0,0,2,0,2
32244,70,8192,12005;16353;16769,16060,0,0,3,0,3
32245,70,8193,12020;15980,16060,0,0,2,0,2
32246,70,8194,11645;12492;16407,16060,0,0,3,0,3
32247,70,8195,11921;12095;16036,16060,0,0,3,0,3
32248,70,8196,12109;12887;16104;17677,16060,0,1,3,0,4
32249,70,8197,12115;12195;16594,16060,0,0,3,0,3
32250,70,8198,11841;12017;16798,16060,0,0,3,0,3
32251,70,8199,12325;12372;17672,16060,0,1,2,0,3
32252,70,8200,12337;12458;16448,16060,0,0,3,0,3
32253,70,8202,12321;12419;16130,16060,0,0,3,0,3
32254,70,8204,12446;13107;16815;17085;17464;17696,16060,0,3,3,0,6
32255,70,8206,12510;12832;17639,16060,0,1,2,0,3
32256,70,8208,12231;12590;16408,16060,0,0,3,0,3
32257,70,8209,12560;16860,16060,0,0,2,0,2
32258,70,8210,12486;12569;16617,16060,0,0,3,0,3
32259,70,8211,12587;12678;16367,16060,0,0,3,0,3
32260,70,8212,12467;13089;16577;16823;17348;17812,16060,0,2,4,0,6
32261,70,8213,12705;13516;17483;17742,16060,0,2,2,0,4
32262,70,8214,12452;12588;16706;17350;17665,16060,0,2,3,0,5
32263,70,8215,12643;12825;15858;16545,16060,0,0,4,0,4
32264,70,8216,12653;12835;16844;16957,16060,0,1,3,0,4
32265,70,8217,12691;13419;18070,16060,0,1,2,0,3
32266,70,8218,12456;13046;16247;16332,16060,0,0,4,0,4
32267,70,8219,12716;13368;16323;16463,16060,0,0,4,0,4
32268,70,8220,12531;12731;16596;16780;16981;17467,16060,0,2,4,0,6
32269,70,8221,12542;13143;17143,16060,0,1,2,0,3
32270,70,8222,12931;13146;16752,16060,0,0,3,0,3
32271,70,8223,12608;12780;16814,16060,0,0,3,0,3
32272,70,8224,12815;12831;16892,16060,0,0,3,0,3
32273,70,8225,12721;12878,16060,0,0,2,0,2
32274,70,8226,12250;12904;16914;17227,16060,0,1,3,0,4
32275,70,8227,12830;12921,16060,0,0,2,0,2
32276,70,8228,12739;12817;17135;17551,16060,0,2,2,0,4
32277,70,8229,12942;13255;16539;16933;17358,16060,0,1,4,0,5
32278,70,8230,12570;12945;16144;16347,16060,0,0,4,0,4
32279,70,8231,12964;13185;16690;17090,16060,0,1,3,0,4
32280,70,8232,12978;15909;16910,16060,0,0,3,0,3
32281,70,8233,12600;12983;16730;17539,16060,0,1,3,0,4
32282,70,8234,12999;13376;17164;17316;17950,16060,0,3,2,0,5
32283,70,8235,13014;13359;16858;17371,16060,0,1,3,0,4
32284,70,8237,13364;13391;16926,16060,0,0,3,0,3
32285,70,8238,12597;13058;15920;16320,16060,0,0,4,0,4
32286,70,8239,13446;13497;17556,16060,0,1,2,0,3
32287,70,8242,8307,16425,0,0,0,1,1
32288,70,8244,3086,16425,0,0,0,1,1
32289,70,8248,6233,16425,0,0,0,1,1
32290,70,8254,4304;6238,16425,0,0,0,2,2
32291,70,8261,6782,16425,0,0,0,1,1
32292,70,8269,10175;10746;15981,16425,0,0,1,2,3
32293,70,8271,10482;10861,16425,0,0,1,1,2
32294,70,8277,10478;11193;16214,16425,0,0,2,1,3
32295,70,8281,11231;11712,16425,0,0,2,0,2
32296,70,8284,11496;11723;16965,16425,0,1,2,0,3
32297,70,8288,12161;12263,16425,0,0,2,0,2
32298,70,8291,11737;11902;16079,16425,0,0,3,0,3
32299,70,8292,12223;12563;16951,16425,0,1,2,0,3
32300,70,8293,11967;12193;15949;16790,16425,0,0,4,0,4
32301,70,8294,12763;12841;16789;17083,16425,0,1,3,0,4
32302,70,8295,12142;12680;16783;17042,16425,0,1,3,0,4
32303,70,8296,11424;11642;16768;17120,16425,0,1,3,0,4
32304,70,8297,12440;12610,16425,0,0,2,0,2
32305,70,8298,11861;12234,16425,0,0,2,0,2
32306,70,8299,12743;16631;17058,16425,0,1,2,0,3
32307,70,8300,12180;12286;16995,16425,0,1,2,0,3
32308,70,8301,11908;12291;16191;16495,16425,0,0,4,0,4
32309,70,8303,12355;12736;17101,16425,0,1,2,0,3
32310,70,8304,12357;12808;16400,16425,0,0,3,0,3
32311,70,8305,12230;12360;16182;16827,16425,0,0,4,0,4
32312,70,8306,12914;13021;16129,16425,0,0,3,0,3
32313,70,8307,12431,16425,0,0,1,0,1
32314,70,8308,12471;12520;17070;17298,16425,0,2,2,0,4
32315,70,8309,12941;13028;17340;17627,16425,0,2,2,0,4
32316,70,8310,12482;12730;15960;16720;17649,16425,0,1,4,0,5
32317,70,8312,12490;12525;16999;17770,16425,0,2,2,0,4
32318,70,8314,13132;13286;16031;17327,16425,0,1,3,0,4
32319,70,8315,12554;12876;15994;16759;16954;17592;17701,16425,0,3,4,0,7
32320,70,8316,12737;12848;16919,16425,0,0,3,0,3
32321,70,8317,12272;12582;17040;17534,16425,0,2,2,0,4
32322,70,8318,12585;13104;16541;17328,16425,0,1,3,0,4
32323,70,8321,12410;12933;17700,16425,0,1,2,0,3
32324,70,8322,13057;13148;16506,16425,0,0,3,0,3
32325,70,8323,12647;13037;16855;17457,16425,0,1,3,0,4
32326,70,8324,12694;13555;17136,16425,0,1,2,0,3
32327,70,8325,12718;13216;17209,16425,0,1,2,0,3
32328,70,8326,12725;12987;16607,16425,0,0,3,0,3
32329,70,8327,13022;13586;17363;17633;18086,16425,0,3,2,0,5
32330,70,8328,12304;12754;16324;16551;17122;17911,16425,0,2,4,0,6
32331,70,8329,12786;13036;17460,16425,0,1,2,0,3
32332,70,8330,12519;12847;16047;17415,16425,0,1,3,0,4
32333,70,8331,12644;12907;17972,16425,0,1,2,0,3
32334,70,8332,12910;12915;18145,16425,0,1,2,0,3
32335,70,8333,12919;16167;17418,16425,0,1,2,0,3
32336,70,8334,12885;12953;17003;17409,16425,0,2,2,0,4
32337,70,8335,13016;13501;16773;17285;17448,16425,0,2,3,0,5
32338,70,8336,13024;13139;16595;16876,16425,0,0,4,0,4
32339,70,8337,13181;16959;17504,16425,0,2,1,0,3
32340,70,8338,12449;13220;17481,16425,0,1,2,0,3
32341,70,8339,13091;13206;17134;17211,16425,0,2,2,0,4
32342,70,8340,12591;13096;16085;17297,16425,0,1,3,0,4
32343,70,8342,12437;13109;16261;17171,16425,0,1,3,0,4
32344,70,8343,12868;13112;17266;17506,16425,0,2,2,0,4
32345,70,8344,12927;13115;16948,16425,0,1,2,0,3
32346,70,8345,13489;13537;16917;18114,16425,0,1,3,0,4
32347,70,8346,12504;13377;16239,16425,0,0,3,0,3
32348,70,8347,13007;13137;17555,16425,0,1,2,0,3
32349,70,8348,13350;16218;17012;17204,16425,0,2,2,0,4
32350,70,8349,12863;13166;16383,16425,0,0,3,0,3
32351,70,8350,13167;16189,16425,0,0,2,0,2
32352,70,8351,13179;13514,16425,0,0,2,0,2
32353,70,8352,13180;16335,16425,0,0,2,0,2
32354,70,8353,12634;13183;17034,16425,0,1,2,0,3
32355,70,8354,13335;15945;16520;16786;17177,16425,0,1,4,0,5
32356,70,8355,12994;13161;17629,16425,0,1,2,0,3
32357,70,8357,714,16790,0,0,0,1,1
32358,70,8358,810;9043,16790,0,0,0,2,2
32359,70,8359,5692,16790,0,0,0,1,1
32360,70,8361,5421,16790,0,0,0,1,1
32361,70,8366,6719,16790,0,0,0,1,1
32362,70,8368,7181,16790,0,0,0,1,1
32363,70,8370,9166,16790,0,0,0,1,1
32364,70,8376,878,16790,0,0,0,1,1
32365,70,8382,10169,16790,0,0,0,1,1
32366,70,8386,10976;16589,16790,0,0,2,0,2
32367,70,8391,11513;11681;16608,16790,0,0,3,0,3
32368,70,8394,11631;12033;16481,16790,0,0,3,0,3
32369,70,8395,12051;12144,16790,0,0,2,0,2
32370,70,8398,12090;12602;17080,16790,0,1,2,0,3
32371,70,8400,12152;12772;16911;17834,16790,0,1,3,0,4
32372,70,8402,12165;12675;16119,16790,0,0,3,0,3
32373,70,8403,12209;12967;16751;17059,16790,0,1,3,0,4
32374,70,8404,12251;12278;16672,16790,0,0,3,0,3
32375,70,8405,12301;12918;16883,16790,0,0,3,0,3
32376,70,8406,12317;16621,16790,0,0,2,0,2
32377,70,8407,12406;12687;16235;16642;16870,16790,0,0,5,0,5
32378,70,8408,12430;12909;16585;17768,16790,0,1,3,0,4
32379,70,8411,12584;12857;16328;16941;17652,16790,0,1,4,0,5
32380,70,8412,12566;12895;16667;16702,16790,0,0,4,0,4
32381,70,8413,13019;13287;17625,16790,0,1,2,0,3
32382,70,8414,12269;12620;16319,16790,0,0,3,0,3
32383,70,8415,12713;13165;17546;17636,16790,0,2,2,0,4
32384,70,8416,12627;16719,16790,0,0,2,0,2
32385,70,8417,12577;12628,16790,0,0,2,0,2
32386,70,8418,12908;13042;16311;17007,16790,0,1,3,0,4
32387,70,8419,12632;13103,16790,0,0,2,0,2
32388,70,8420,12641;13409;16215;18643,16790,1,0,3,0,4
32389,70,8421,12645;13510;16270;17246;18270,16790,1,1,3,0,5
32390,70,8422,12646;12850;16507;17521;17660,16790,0,2,3,0,5
32391,70,8423,12681;13299;16622;17288;17841;18420,16790,1,2,3,0,6
32392,70,8424,12685;13223;17302;17537,16790,0,2,2,0,4
32393,70,8425,12665;16154;16350;16942;17253,16790,0,1,4,0,5
32394,70,8426,11546;12252;16502,16790,0,0,3,0,3
32395,70,8427,12710;13318;16835;17497;18143,16790,0,2,3,0,5
32396,70,8428,13204;13423;16300;17595,16790,0,1,3,0,4
32397,70,8429,12726;12774;16788,16790,0,0,3,0,3
32398,70,8430,12676;13209;16903,16790,0,0,3,0,3
32399,70,8431,12761;16192;16871,16790,0,0,3,0,3
32400,70,8432,12158;12277;16572;17251,16790,0,1,3,0,4
32401,70,8434,13083;16197,16790,0,0,2,0,2
32402,70,8435,12439;12827;16900;17390,16790,0,1,3,0,4
32403,70,8436,12712;13031;16180,16790,0,0,3,0,3
32404,70,8437,12783;13035;17056;17212,16790,0,2,2,0,4
32405,70,8438,13342;13619,16790,0,0,2,0,2
32406,70,8439,12980;13535;16745;17292,16790,0,1,3,0,4
32407,70,8440,13062;13194,16790,0,0,2,0,2
32408,70,8441,12666;13064;16807;16946,16790,0,1,3,0,4
32409,70,8442,13316;17294;17353,16790,0,2,1,0,3
32410,70,8443,13080;13564,16790,0,0,2,0,2
32411,70,8444,12523;13292;16139;16864,16790,0,0,4,0,4
32412,70,8445,13106;13610;17500,16790,0,1,2,0,3
32413,70,8446,13230;13272;17463,16790,0,1,2,0,3
32414,70,8447,12429;13159;16604;17422,16790,0,1,3,0,4
32415,70,8449,12550;13163;17439;17616,16790,0,2,2,0,4
32416,70,8450,13172;13416;16198;16558;17230;17405;18061,16790,0,3,4,0,7
32417,70,8451,13189;16602,16790,0,0,2,0,2
32418,70,8452,13198;13240;16462;18229,16790,1,0,3,0,4
32419,70,8453,13617,16790,0,0,1,0,1
32420,70,8454,12956;13254;16566;17196;17522;17735,16790,0,3,3,0,6
32421,70,8455,13577;16436;17159;18271,16790,1,1,2,0,4
32422,70,8456,13092;13314;17195,16790,0,1,2,0,3
32423,70,8457,13300;13473;16893,16790,0,0,3,0,3
32424,70,8458,12809;13361;17510,16790,0,1,2,0,3
32425,70,8459,13018;13310;17354,16790,0,1,2,0,3
32426,70,8460,13320;13536,16790,0,0,2,0,2
32427,70,8461,13082;13323;17438;17820,16790,0,2,2,0,4
32428,70,8462,13232;13439;16351;17720;18150,16790,0,2,3,0,5
32429,70,8463,13102;13604,16790,0,0,2,0,2
32430,70,8464,13427;13533;16361;16861,16790,0,0,4,0,4
32431,70,8466,316,17155,0,0,0,1,1
32432,70,8467,81,17155,0,0,0,1,1
32433,70,8468,6465,17155,0,0,0,1,1
32434,70,8469,1287,17155,0,0,0,1,1
32435,70,8471,1670,17155,0,0,0,1,1
32436,70,8473,6838,17155,0,0,0,1,1
32437,70,8474,5175;10164,17155,0,0,0,2,2
32438,70,8477,7912,17155,0,0,0,1,1
32439,70,8478,3266,17155,0,0,0,1,1
32440,70,8481,7530,17155,0,0,0,1,1
32441,70,8496,11257,17155,0,0,1,0,1
32442,70,8497,11208;11249,17155,0,0,2,0,2
32443,70,8503,11548;11872;16764;17008,17155,0,1,3,0,4
32444,70,8505,11799;11874,17155,0,0,2,0,2
32445,70,8506,11912;12334;16862,17155,0,0,3,0,3
32446,70,8507,11809;12141;16736,17155,0,0,3,0,3
32447,70,8509,11940;12086;17621,17155,0,1,2,0,3
32448,70,8511,12080;16382,17155,0,0,2,0,2
32449,70,8512,11826;12261;16839,17155,0,0,3,0,3
32450,70,8514,11840;16466;16776,17155,0,0,3,0,3
32451,70,8515,12574;12844;16497;17380,17155,0,1,3,0,4
32452,70,8519,12719;17138;17731,17155,0,2,1,0,3
32453,70,8520,12354;12615;16677;16921;17218,17155,0,1,4,0,5
32454,70,8521,12544;12630;17582,17155,0,1,2,0,3
32455,70,8522,13202;17076,17155,0,1,1,0,2
32456,70,8523,12672;13142;16905;17318;18360,17155,1,1,3,0,5
32457,70,8524,12683;13363;17057,17155,0,1,2,0,3
32458,70,8525,12693;16404,17155,0,0,2,0,2
32459,70,8526,12963;16682,17155,0,0,2,0,2
32460,70,8527,12738;12869;17018,17155,0,1,2,0,3
32461,70,8528,12524;13030;17276;18484,17155,1,1,2,0,4
32462,70,8529,13192;13370;17041,17155,0,1,2,0,3
32463,70,8530,12688;12707;16743,17155,0,0,3,0,3
32464,70,8531,12806;12840;17489;17992,17155,0,2,2,0,4
32465,70,8532,12873;13500,17155,0,0,2,0,2
32466,70,8533,12874;13397;17514,17155,0,1,2,0,3
32467,70,8534,13467;16587,17155,0,0,2,0,2
32468,70,8535,12867;12924,17155,0,0,2,0,2
32469,70,8536,12398;12948;16744;17866,17155,0,1,3,0,4
32470,70,8537,13434;13438;17499,17155,0,1,2,0,3
32471,70,8538,12988;13184;16344;16716,17155,0,0,4,0,4
32472,70,8539,13540;16356;16831;17347;17896,17155,0,2,3,0,5
32473,70,8540,13067;13475;16836,17155,0,0,3,0,3
32474,70,8541,12435;13068;16897;17178,17155,0,1,3,0,4
32475,70,8542,12450;12813;17436,17155,0,1,2,0,3
32476,70,8543,12771;12834;17045;17376,17155,0,2,2,0,4
32477,70,8544,13124;13175;16805;17903,17155,0,1,3,0,4
32478,70,8545,12972;13126;16692;16765;17391,17155,0,1,4,0,5
32479,70,8546,13011;13131;16609;17026,17155,0,1,3,0,4
32480,70,8547,12654;13134;16366;17781,17155,0,1,3,0,4
32481,70,8548,12670;13138;17956,17155,0,1,2,0,3
32482,70,8549,13141;16219,17155,0,0,2,0,2
32483,70,8550,12826;13150;17339,17155,0,1,2,0,3
32484,70,8551,12837;13237;16220;16820,17155,0,0,4,0,4
32485,70,8552,12905;13178;16514;17927;18189,17155,0,2,3,0,5
32486,70,8553,13009;13200,17155,0,0,2,0,2
32487,70,8554,13449,17155,0,0,1,0,1
32488,70,8555,12959;13221;17052,17155,0,1,2,0,3
32489,70,8556,13227;13860;16371;16532;17885,17155,0,1,4,0,5
32490,70,8557,12614;13087;17088;17307;17853,17155,0,3,2,0,5
32491,70,8558,13162;13670,17155,0,0,2,0,2
32492,70,8559,13248;13324;17295;17447,17155,0,2,2,0,4
32493,70,8560,13188;13249;17879,17155,0,1,2,0,3
32494,70,8561,13264;16721;17002;17320;17794,17155,0,3,2,0,5
32495,70,8562,13289;16703;17039;17558,17155,0,2,2,0,4
32496,70,8563,13243;13594;17816,17155,0,1,2,0,3
32497,70,8564,12968;13291;16918,17155,0,0,3,0,3
32498,70,8565,13308;13388;17603;17861;17962,17155,0,3,2,0,5
32499,70,8566,13331;13624;17304,17155,0,1,2,0,3
32500,70,8567,13238;17503;18312,17155,1,1,1,0,3
32501,70,8568,13098;13384;18148,17155,0,1,2,0,3
32502,70,8569,12880;13389;17324,17155,0,1,2,0,3
32503,70,8570,13055;13392;16568;17229;17757,17155,0,2,3,0,5
32504,70,8571,13147;13492;16801;17323,17155,0,1,3,0,4
32505,70,8572,13217;13779;16581;17071;18469,17155,1,1,3,0,5
32506,70,8573,13301;16449;17013,17155,0,1,2,0,3
32507,70,8574,13445;17991,17155,0,1,1,0,2
32508,70,8575,13450;17494,17155,0,1,1,0,2
32509,70,8576,13581;13602;17529;18001,17155,0,2,2,0,4
32510,70,8577,13471;13909;18403,17155,1,0,2,0,3
32511,70,8578,13390;13493;16902,17155,0,0,3,0,3
32512,70,8579,13655;13782;16379;16770;17960,17155,0,1,4,0,5
32513,70,8581,5590,17520,0,0,0,1,1
32514,70,8582,5698,17520,0,0,0,1,1
32515,70,8584,1544;7712,17520,0,0,0,2,2
32516,70,8587,7396,17520,0,0,0,1,1
32517,70,8588,160,17520,0,0,0,1,1
32518,70,8589,793,17520,0,0,0,1,1
32519,70,8591,10207;10480,17520,0,0,0,2,2
32520,70,8592,10224;10452,17520,0,0,0,2,2
32521,70,8593,1747,17520,0,0,0,1,1
32522,70,8598,10393,17520,0,0,0,1,1
32523,70,8607,10643;11052,17520,0,0,1,1,2
32524,70,8610,11241,17520,0,0,1,0,1
32525,70,8612,11161;11299,17520,0,0,2,0,2
32526,70,8621,11852;16312;16578;17240,17520,0,1,3,0,4
32527,70,8623,12028;12356;15022;16359,17520,0,0,4,0,4
32528,70,8624,12136;16605;16849;17308;18000,17520,0,2,3,0,5
32529,70,8625,11930;12045,17520,0,0,2,0,2
32530,70,8626,12828;13290;16895;17069,17520,0,1,3,0,4
32531,70,8628,12436;12453;17400,17520,0,1,2,0,3
32532,70,8629,12457;12473;16315;16645,17520,0,0,4,0,4
32533,70,8630,12475;17082,17520,0,1,1,0,2
32534,70,8631,12275;12502;16417;16843,17520,0,0,4,0,4
32535,70,8635,12601;13033;16527;16803;17215,17520,0,1,4,0,5
32536,70,8636,13422;13455;16513;16984;17814;17890;18044,17520,0,4,3,0,7
32537,70,8637,12724;12767;17113;17189;17480,17520,0,3,2,0,5
32538,70,8638,12734;12852;16555;17014;17379,17520,0,2,3,0,5
32539,70,8639,12423;12796;17608,17520,0,1,2,0,3
32540,70,8640,12698;12818,17520,0,0,2,0,2
32541,70,8642,12769;12856;17648,17520,0,1,2,0,3
32542,70,8643,12805;12862;18218,17520,1,0,2,0,3
32543,70,8644,13658;13802;16760;17999,17520,0,1,3,0,4
32544,70,8645,12679;12977;17602,17520,0,1,2,0,3
32545,70,8646,12995;13278;17233,17520,0,1,2,0,3
32546,70,8647,13523,17520,0,0,1,0,1
32547,70,8648,12854;13084;16811;17079;17839,17520,0,2,3,0,5
32548,70,8649,13060;13100;16354;17015,17520,0,1,3,0,4
32549,70,8650,13155;13562;18016,17520,0,1,2,0,3
32550,70,8651,12522;13158;16824;16958,17520,0,1,3,0,4
32551,70,8652,13169;13459;17239;17709,17520,0,2,2,0,4
32552,70,8653,13199;13347;18053;18285,17520,1,1,2,0,4
32553,70,8654,13233;13378;17450,17520,0,1,2,0,3
32554,70,8655,13259;16447;17609,17520,0,1,2,0,3
32555,70,8656,13603;13931;17207;17360;17518,17520,0,3,2,0,5
32556,70,8657,12974;13277;16991;17937,17520,0,2,2,0,4
32557,70,8658,13294;17428;17743,17520,0,2,1,0,3
32558,70,8659,13371;13676;18598,17520,1,0,2,0,3
32559,70,8660,13582;14055;16476;17000;17236,17520,0,2,3,0,5
32560,70,8661,13334;13919;16333;17226;17319;17496;17727,17520,0,4,3,0,7
32561,70,8662,12877;13341,17520,0,0,2,0,2
32562,70,8663,12859;13367;17097;17249;17425,17520,0,3,2,0,5
32563,70,8664,12993;13975;16390;16671;16880;17570;17844;18066;18470,17520,1,3,5,0,9
32564,70,8665,13372;13856;18084,17520,0,1,2,0,3
32565,70,8666,13380;16727,17520,0,0,2,0,2
32566,70,8667,12606;12668;17277,17520,0,1,2,0,3
32567,70,8668,13396;14025;17487,17520,0,1,2,0,3
32568,70,8669,13400;13635;18031,17520,0,1,2,0,3
32569,70,8670,13411;13794;17313,17520,0,1,2,0,3
32570,70,8671,13952;16473;16611;17966,17520,0,1,3,0,4
32571,70,8672,13476,17520,0,0,1,0,1
32572,70,8673,13010;13496,17520,0,0,2,0,2
32573,70,8674,13502,17520,0,0,1,0,1
32574,70,8675,13201;13511,17520,0,0,2,0,2
32575,70,8677,13241;13543;16538;16664;16866;17141;18672,17520,1,1,5,0,7
32576,70,8678,13118;13559,17520,0,0,2,0,2
32577,70,8679,13762;13837;17684;18059,17520,0,2,2,0,4
32578,70,8680,13554;13684,17520,0,0,2,0,2
32579,70,8681,13252;13567;17576,17520,0,1,2,0,3
32580,70,8682,13296;13568;16414;16966;18142,17520,0,2,3,0,5
32581,70,8683,13580;13740;18202,17520,0,1,2,0,3
32582,70,8684,13583;13821;16800;17912,17520,0,1,3,0,4
32583,70,8685,13607;13805,17520,0,0,2,0,2
32584,70,8686,13622;13934;16431;16680;17857,17520,0,1,4,0,5
32585,70,8687,13640;13680;17247;18508,17520,1,1,2,0,4
32586,70,8688,13653;13792;17033;17520;17697,17520,0,3,2,0,5
32587,70,8689,13498;13664;16956;17129;17800,17520,0,3,2,0,5
32588,70,8690,13491;13666;16816;17826,17520,0,1,3,0,4
32589,70,8692,8297,17885,0,0,0,1,1
32590,70,8694,4771,17885,0,0,0,1,1
32591,70,8695,6071,17885,0,0,0,1,1
32592,70,8697,4689,17885,0,0,0,1,1
32593,70,8699,5572,17885,0,0,0,1,1
32594,70,8700,5901,17885,0,0,0,1,1
32595,70,8702,175;1027,17885,0,0,0,2,2
32596,70,8704,3730,17885,0,0,0,1,1
32597,70,8706,3247,17885,0,0,0,1,1
32598,70,8710,10688;11045;16661,17885,0,0,2,1,3
32599,70,8718,11624;11717;16885,17885,0,0,3,0,3
32600,70,8719,11592;11682;16740,17885,0,0,3,0,3
32601,70,8722,11763,17885,0,0,1,0,1
32602,70,8725,11662;11744;16749,17885,0,0,3,0,3
32603,70,8726,12669;12760;16777;17397,17885,0,1,3,0,4
32604,70,8727,11760;12066;16546,17885,0,0,3,0,3
32605,70,8728,12079;12145,17885,0,0,2,0,2
32606,70,8729,12138;12722;16949,17885,0,1,2,0,3
32607,70,8730,12151;13108;17393;17565,17885,0,2,2,0,4
32608,70,8731,12428;12744;17300,17885,0,1,2,0,3
32609,70,8734,12396;17443;17542,17885,0,2,1,0,3
32610,70,8735,12043;17630,17885,0,1,1,0,2
32611,70,8736,11754;11898;17050;17145,17885,0,2,2,0,4
32612,70,8737,12464;12934,17885,0,0,2,0,2
32613,70,8738,12307;12479;17477,17885,0,1,2,0,3
32614,70,8739,12816;13472;17624,17885,0,1,2,0,3
32615,70,8741,12583;12930;16669;17495,17885,0,1,3,0,4
32616,70,8742,12662;16993,17885,0,1,1,0,2
32617,70,8743,11885;12364,17885,0,0,2,0,2
32618,70,8744,12649;17078,17885,0,1,1,0,2
32619,70,8747,12494;12768;16646;16915,17885,0,0,4,0,4
32620,70,8748,12795;13403;18146,17885,0,1,2,0,3
32621,70,8749,12352;12814;17065;17484,17885,0,2,2,0,4
32622,70,8750,12213;12851;16674;17384,17885,0,1,3,0,4
32623,70,8751,12901;13149;17126,17885,0,1,2,0,3
32624,70,8752,12416;13280;16747;17688,17885,0,1,3,0,4
32625,70,8753,12971;13503,17885,0,0,2,0,2
32626,70,8754,13001;13408;17734,17885,0,1,2,0,3
32627,70,8755,13034;14031;17490;18260,17885,1,1,2,0,4
32628,70,8756,12792;13047;17541;17685,17885,0,2,2,0,4
32629,70,8757,13053;16641,17885,0,0,2,0,2
32630,70,8759,13186;13236;17846,17885,0,1,2,0,3
32631,70,8760,13214;13305;17515;18060,17885,0,2,2,0,4
32632,70,8761,13219;13544;17183;18317,17885,1,1,2,0,4
32633,70,8762,13657;16767;17190;17612,17885,0,2,2,0,4
32634,70,8763,13130;13421;16523,17885,0,0,3,0,3
32635,70,8764,13429;16925;18079;18119,17885,0,2,2,0,4
32636,70,8765,13435;13519,17885,0,0,2,0,2
32637,70,8766,13267;13442;17325,17885,0,1,2,0,3
32638,70,8767,13893;16735;17657;18091,17885,0,2,2,0,4
32639,70,8768,13079;13507;16884,17885,0,0,3,0,3
32640,70,8769,12807;13461;18207,17885,0,1,2,0,3
32641,70,8770,13463;13481;17051;17267,17885,0,2,2,0,4
32642,70,8771,13479;16817;17157;17754,17885,0,2,2,0,4
32643,70,8772,12557;13485;18274,17885,1,0,2,0,3
32644,70,8773,13552;14142;17169;17501;18537,17885,1,2,2,0,5
32645,70,8774,13518;13902,17885,0,0,2,0,2
32646,70,8775,13539;14143;16522;16865;17858;17931,17885,0,2,4,0,6
32647,70,8776,13288;13560;17127;18385,17885,1,1,2,0,4
32648,70,8777,13375;13570;16874;17692;18104,17885,0,2,3,0,5
32649,70,8778,12842;13584;17312;17567;17741,17885,0,3,2,0,5
32650,70,8779,13764;13955;17096,17885,0,1,2,0,3
32651,70,8780,13601;13701;16580;17585;18002;18013,17885,0,3,3,0,6
32652,70,8781,13645;13654;17174,17885,0,1,2,0,3
32653,70,8782,13592;17061;17985;18134,17885,0,3,1,0,4
32654,70,8783,13410;13803;16809;16997,17885,0,1,3,0,4
32655,70,8784,13683;13970;16881;17210;17790,17885,0,2,3,0,5
32656,70,8785,14165;16686;17299;18063;18219,17885,1,2,2,0,5
32657,70,8786,13351;14183;17508;17973,17885,0,2,2,0,4
32658,70,8787,13714;14112,17885,0,0,2,0,2
32659,70,8788,13863;17977;18127,17885,0,2,1,0,3
32660,70,8789,13720;13826;16582;16908;18473,17885,1,0,4,0,5
32661,70,8790,13210;13721;16909;17421;17740,17885,0,2,3,0,5
32662,70,8791,13752;14052;17382,17885,0,1,2,0,3
32663,70,8792,13415;13767,17885,0,0,2,0,2
32664,70,8793,13777;13868,17885,0,0,2,0,2
32665,70,8794,13871;16796;17291;18439,17885,1,1,2,0,4
32666,70,8797,3478,18250,0,0,0,1,1
32667,70,8801,6261,18250,0,0,0,1,1
32668,70,8804,379;6444,18250,0,0,0,2,2
32669,70,8805,1056;7324,18250,0,0,0,2,2
32670,70,8807,1328,18250,0,0,0,1,1
32671,70,8811,10123,18250,0,0,0,1,1
32672,70,8812,10102;10722,18250,0,0,0,2,2
32673,70,8813,10007,18250,0,0,0,1,1
32674,70,8821,10514;10978,18250,0,0,1,1,2
32675,70,8822,11796;16627;16837,18250,0,0,3,0,3
32676,70,8823,11182;11741,18250,0,0,2,0,2
32677,70,8826,11613;11619;16632,18250,0,0,3,0,3
32678,70,8827,11920;16575;17279,18250,0,1,2,0,3
32679,70,8828,11714;11895;16912,18250,0,0,3,0,3
32680,70,8830,11973;16573;17517,18250,0,1,2,0,3
32681,70,8831,11890;11995;16614;16929,18250,0,0,4,0,4
32682,70,8832,11972;12425;16846;17634,18250,0,1,3,0,4
32683,70,8835,12375;13008,18250,0,0,2,0,2
32684,70,8836,12385;13077,18250,0,0,2,0,2
32685,70,8837,13085;13125;17044;17167,18250,0,2,2,0,4
32686,70,8838,12397;12411;16878,18250,0,0,3,0,3
32687,70,8839,12498;12540;17185;17823,18250,0,2,2,0,4
32688,70,8840,12103;12617;17111,18250,0,1,2,0,3
32689,70,8841,12618;12940,18250,0,0,2,0,2
32690,70,8842,12112;12656;16964;17755,18250,0,2,2,0,4
32691,70,8843,12399;17284,18250,0,1,1,0,2
32692,70,8845,12720;16971,18250,0,1,1,0,2
32693,70,8846,12742;13120;17180,18250,0,1,2,0,3
32694,70,8847,12779;13478,18250,0,0,2,0,2
32695,70,8848,12422;12811;17426,18250,0,1,2,0,3
32696,70,8849,12944;17115;17957,18250,0,2,1,0,3
32697,70,8850,12955;13187;17797,18250,0,1,2,0,3
32698,70,8851,12965;13154;17264;17502;17778,18250,0,3,2,0,5
32699,70,8852,12985;13838;16701,18250,0,0,3,0,3
32700,70,8853,13038;13153,18250,0,0,2,0,2
32701,70,8854,12891;13054;16961;17216,18250,0,2,2,0,4
32702,70,8855,13929;17444;17842,18250,0,2,1,0,3
32703,70,8856,12989,18250,0,0,1,0,1
32704,70,8857,13129;13242;17005,18250,0,1,2,0,3
32705,70,8858,12363;12798;17154;17596,18250,0,2,2,0,4
32706,70,8859,13256;13695;16863;17403;18130,18250,0,2,3,0,5
32707,70,8860,13174;13271;16666,18250,0,0,3,0,3
32708,70,8861,13279;13515;17357,18250,0,1,2,0,3
32709,70,8863,13315;13574;18033,18250,0,1,2,0,3
32710,70,8864,13307;17268;17693;17919,18250,0,3,1,0,4
32711,70,8865,13330;13348;17035;17505;17981,18250,0,3,2,0,5
32712,70,8867,13398;14150;17150;17401;17878,18250,0,3,2,0,5
32713,70,8868,13486;13588;17103;17214;17921,18250,0,3,2,0,5
32714,70,8870,13590,18250,0,0,1,0,1
32715,70,8871,13512;14064;16591;17881,18250,0,1,3,0,4
32716,70,8872,13407;13541;17089;17547;17593,18250,0,3,2,0,5
32717,70,8873,13531;13698;17260,18250,0,1,2,0,3
32718,70,8874,13339;13561;16869;17106,18250,0,1,3,0,4
32719,70,8875,13573;17429,18250,0,1,1,0,2
32720,70,8876,13304;13761;16766;17845,18250,0,1,3,0,4
32721,70,8877,13593;13748;17808;18489,18250,1,1,2,0,4
32722,70,8879,13597;14047;16668;17188;17303,18250,0,2,3,0,5
32723,70,8880,13260;13637;17675;17871,18250,0,2,2,0,4
32724,70,8882,13889;17440,18250,0,1,1,0,2
32725,70,8883,13631;13935;17311;17888;18177;18544,18250,1,3,2,0,6
32726,70,8884,13265;14017;16879;17197;18197,18250,0,2,3,0,5
32727,70,8885,13646;14280;18139,18250,0,1,2,0,3
32728,70,8886,13652;14190;16894,18250,0,0,3,0,3
32729,70,8887,13659;13834;17100;17876;18689,18250,1,2,2,0,5
32730,70,8888,13662;14080;17590;17714,18250,0,2,2,0,4
32731,70,8889,13678;13755,18250,0,0,2,0,2
32732,70,8890,14065;14268,18250,0,0,2,0,2
32733,70,8891,13709;14121;17387;18126,18250,0,2,2,0,4
32734,70,8892,13346;13712;17370;18023;18238,18250,1,2,2,0,5
32735,70,8893,13578;13728;17571,18250,0,1,2,0,3
32736,70,8894,14071;16597;16833;17198,18250,0,1,3,0,4
32737,70,8895,13736;14096;17963;18258,18250,1,1,2,0,4
32738,70,8896,13369;13760;16758;17372;17872,18250,0,2,3,0,5
32739,70,8897,13733;13773,18250,0,0,2,0,2
32740,70,8898,13813;14093;16729;17092;17329;17434;17908;18623,18250,1,4,3,0,8
32741,70,8899,13877;13996;17498;17988,18250,0,2,2,0,4
32742,70,8900,14299;14416;17351;17568;17773,18250,0,3,2,0,5
32743,70,8901,13203;13888;16825;17102;17408,18250,0,2,3,0,5
32744,70,8902,13892;14019;17618;17865;18137,18250,0,3,2,0,5
32745,70,8903,13366;13681;18172;18284,18250,1,1,2,0,4
32746,70,8904,13900;14189;18286;18657,18250,2,0,2,0,4
32747,70,8905,13915;13971;16781;18232,18250,1,0,3,0,4
32748,70,8906,13879;13941;17628,18250,0,1,2,0,3
32749,70,8907,13004;13946;17147;17259,18250,0,2,2,0,4
32750,70,8908,13950;17392;17947,18250,0,2,1,0,3
32751,70,8909,448,18615,0,0,0,1,1
32752,70,8910,10146,18615,0,0,0,1,1
32753,70,8911,8799,18615,0,0,0,1,1
32754,70,8913,653;2365,18615,0,0,0,2,2
32755,70,8918,5775,18615,0,0,0,1,1
32756,70,8919,7385,18615,0,0,0,1,1
32757,70,8920,9037,18615,0,0,0,1,1
32758,70,8923,10134,18615,0,0,0,1,1
32759,70,8924,10144,18615,0,0,0,1,1
32760,70,8934,10790;11430;16972,18615,0,1,2,0,3
32761,70,8940,11630;11665,18615,0,0,2,0,2
32762,70,8943,11839;12002;16695;16986,18615,0,1,3,0,4
32763,70,8946,11859;12262;16713,18615,0,0,3,0,3
32764,70,8950,12526,18615,0,0,1,0,1
32765,70,8952,12749;16724,18615,0,0,2,0,2
32766,70,8953,12684;13262;17561,18615,0,1,2,0,3
32767,70,8954,12206;12695;16709;16829,18615,0,0,4,0,4
32768,70,8955,12822;17250;17414,18615,0,2,1,0,3
32769,70,8956,12733;16755;17243,18615,0,1,2,0,3
32770,70,8957,12741;12992;17068,18615,0,1,2,0,3
32771,70,8958,13128;17084;17217,18615,0,2,1,0,3
32772,70,8962,12746;12929;17104,18615,0,1,2,0,3
32773,70,8963,12947;13110,18615,0,0,2,0,2
32774,70,8964,12957;13606,18615,0,0,2,0,2
32775,70,8965,12970;13245;16851,18615,0,0,3,0,3
32776,70,8966,12973;13012,18615,0,0,2,0,2
32777,70,8967,13005;13575;17346;17683,18615,0,2,2,0,4
32778,70,8968,13942;14132,18615,0,0,2,0,2
32779,70,8969,13164;18680,18615,1,0,1,0,2
32780,70,8970,12421;13215;17455,18615,0,1,2,0,3
32781,70,8971,13258;13508;17946,18615,0,1,2,0,3
32782,70,8972,13263;14206;18237;18649,18615,2,0,2,0,4
32783,70,8973,13113;13441;17310;17476,18615,0,2,2,0,4
32784,70,8974,13766,18615,0,0,1,0,1
32785,70,8975,12926;13302,18615,0,0,2,0,2
32786,70,8976,13328;13546;17031;18138;18709,18615,1,2,2,0,5
32787,70,8977,13428;13749,18615,0,0,2,0,2
32788,70,8979,13317;13538;17128;18416,18615,1,1,2,0,4
32789,70,8980,13979;16891;17168;17513,18615,0,2,2,0,4
32790,70,8981,13557;13968;18153,18615,0,1,2,0,3
32791,70,8982,12893;13663;17027;17431,18615,0,2,2,0,4
32792,70,8983,13618;14210;18014;18329,18615,1,1,2,0,4
32793,70,8984,13636;13705;17423;17695,18615,0,2,2,0,4
32794,70,8985,13393;13784,18615,0,0,2,0,2
32795,70,8986,13639;14011;17416;17705,18615,0,2,2,0,4
32796,70,8987,13824;17306;18140,18615,0,2,1,0,3
32797,70,8988,13672;13991;17152;17402,18615,0,2,2,0,4
32798,70,8989,13800;14155;17281;17530,18615,0,2,2,0,4
32799,70,8990,14285,18615,0,0,1,0,1
32800,70,8991,13693;13772;17724;17922,18615,0,2,2,0,4
32801,70,8992,13727;14291,18615,0,0,2,0,2
32802,70,8993,12958;13470;17704,18615,0,1,2,0,3
32803,70,8994,14458;17282;18298;18568,18615,2,1,1,0,4
32804,70,8995,13913;14502;16886;17432;17984;18443,18615,1,2,3,0,6
32805,70,8996,13951;14328;17412;17512;17703,18615,0,3,2,0,5
32806,70,8997,14048;14177;17194;17453;17940,18615,0,3,2,0,5
32807,70,8998,13999;14254;17175;18279,18615,1,1,2,0,4
32808,70,8999,14000;14349;18712,18615,1,0,2,0,3
32809,70,9000,13753;14021;17472;18106,18615,0,2,2,0,4
32810,70,9001,13923;14022;17587;17837,18615,0,2,2,0,4
32811,70,9002,14315;17952;18588,18615,1,1,1,0,3
32812,70,9003,14051;14125;17762,18615,0,1,2,0,3
32813,70,9004,14061;14359,18615,0,0,2,0,2
32814,70,9005,13840;14067;17654;17868,18615,0,2,2,0,4
32815,70,9006,13810;14069;16793;18305;18635,18615,2,0,3,0,5
32816,70,9007,14074;18136;18472,18615,1,1,1,0,3
32817,70,9008,13547;14075;17891;18340,18615,1,1,2,0,4
32818,70,9009,13787;14084;16975;18009,18615,0,2,2,0,4
32819,70,9011,7802,18980,0,0,0,1,1
32820,70,9012,5929,18980,0,0,0,1,1
32821,70,9013,6791,18980,0,0,0,1,1
32822,70,9014,4743,18980,0,0,0,1,1
32823,70,9021,4656,18980,0,0,0,1,1
32824,70,9023,2871,18980,0,0,0,1,1
32825,70,9026,10155,18980,0,0,0,1,1
32826,70,9034,11750;11999,18980,0,0,2,0,2
32827,70,9039,10468;11309;16976,18980,0,1,1,1,3
32828,70,9042,11725;11868;17173;17687,18980,0,2,2,0,4
32829,70,9045,12194;16828,18980,0,0,2,0,2
32830,70,9052,12215;12935;17430;17990,18980,0,2,2,0,4
32831,70,9054,12211;12442;17125,18980,0,1,2,0,3
32832,70,9055,11788,18980,0,0,1,0,1
32833,70,9056,12491;12937,18980,0,0,2,0,2
32834,70,9058,12607;13231;16875;18198,18980,0,1,3,0,4
32835,70,9060,12714;12976;17359;17974,18980,0,2,2,0,4
32836,70,9061,12715;12975;16889;17016;17179,18980,0,2,3,0,5
32837,70,9062,12135;13090;17840;17900,18980,0,2,2,0,4
32838,70,9063,12845;13023;17202,18980,0,1,2,0,3
32839,70,9064,12270;13094;17036;17528,18980,0,2,2,0,4
32840,70,9065,12400;12433,18980,0,0,2,0,2
32841,70,9066,12996;13642;17676;18344,18980,1,1,2,0,4
32842,70,9068,12979;13059;17698,18980,0,1,2,0,3
32843,70,9069,13121;17054;17273,18980,0,2,1,0,3
32844,70,9070,13116;13122;17526,18980,0,1,2,0,3
32845,70,9071,13488;13768;17786;18226;18338,18980,2,1,2,0,5
32846,70,9072,13208;13226;17964,18980,0,1,2,0,3
32847,70,9073,13218;13379;17789,18980,0,1,2,0,3
32848,70,9075,12833;13261;17779,18980,0,1,2,0,3
32849,70,9076,12496;13266;16989;17170;17809;17958,18980,0,4,2,0,6
32850,70,9077,13282;13313;16940;17474,18980,0,1,3,0,4
32851,70,9078,13352;13629;17219;17296,18980,0,2,2,0,4
32852,70,9079,13374;13807;17283;17578,18980,0,2,2,0,4
32853,70,9080,14303,18980,0,0,1,0,1
32854,70,9081,13385;13692,18980,0,0,2,0,2
32855,70,9082,13387;13420,18980,0,0,2,0,2
32856,70,9083,13426;13771;17752;18307,18980,1,1,2,0,4
32857,70,9084,13432;17729;18235,18980,1,1,1,0,3
32858,70,9085,13710;14292;18164;18250,18980,1,1,2,0,4
32859,70,9086,13386;13447;17851,18980,0,1,2,0,3
32860,70,9087,13212;13480;17620;18394,18980,1,1,2,0,4
32861,70,9088,13160;13177,18980,0,0,2,0,2
32862,70,9089,13634;14159;17048;17186;18200,18980,0,3,2,0,5
32863,70,9090,13989;14004;16838;17536;17965;18399;18608,18980,2,2,3,0,7
32864,70,9091,13667;14276;18056;18746,18980,1,1,2,0,4
32865,70,9092,12951;13669;17017;17451;17601,18980,0,3,2,0,5
32866,70,9093,13703;13911;17553;18102,18980,0,2,2,0,4
32867,70,9094,13674;13707;17181;17766,18980,0,2,2,0,4
32868,70,9095,13517;14095,18980,0,0,2,0,2
32869,70,9096,13781;14567;16857;17193,18980,0,1,3,0,4
32870,70,9097,13774;14340,18980,0,0,2,0,2
32871,70,9098,13490;13814;16832,18980,0,0,3,0,3
32872,70,9099,13820;14318,18980,0,0,2,0,2
32873,70,9100,13830;14494;17388;18418,18980,1,1,2,0,4
32874,70,9101,13836;14406;18255,18980,1,0,2,0,3
32875,70,9102,13867;14327;17870;17980;18039,18980,0,3,2,0,5
32876,70,9103,13758;14063;17289;17682,18980,0,2,2,0,4
32877,70,9104,13641;13890;17116;17611;17869;18073,18980,0,4,2,0,6
32878,70,9105,14439;17771;18041,18980,0,2,1,0,3
32879,70,9106,13916;14293;17479;17924;18209,18980,0,3,2,0,5
32880,70,9107,13920;17149;18462;18683,18980,2,1,1,0,4
32881,70,9108,13878;14212,18980,0,0,2,0,2
32882,70,9109,13145;13956;17452;18296,18980,1,1,2,0,4
32883,70,9110,13528;13958;17847,18980,0,1,2,0,3
32884,70,9111,13270;13967,18980,0,0,2,0,2
32885,70,9112,13456;13981;17072;18515,18980,1,1,2,0,4
32886,70,9113,14478,18980,0,0,1,0,1
32887,70,9114,13872;14008;17352;17574;18323,18980,1,2,2,0,5
32888,70,9115,14034;14070,18980,0,0,2,0,2
32889,70,9116,14215;14467;17785,18980,0,1,2,0,3
32890,70,9117,14475;16983;17224;18048,18980,0,3,1,0,4
32891,70,9118,13529;14153;18193,18980,0,1,2,0,3
32892,70,9119,13643;14130;17769;18035,18980,0,2,2,0,4
32893,70,9120,14081;14496;18154;18606,18980,1,1,2,0,4
32894,70,9121,14085;14102,18980,0,0,2,0,2
32895,70,9122,14110;14263,18980,0,0,2,0,2
32896,70,9123,14137;14590;16826;17468,18980,0,1,3,0,4
32897,70,9124,13835;14169,18980,0,0,2,0,2
32898,70,9125,14171;14530;17030;17615,18980,0,2,2,0,4
32899,70,9127,6466,19345,0,0,0,1,1
32900,70,9135,10028,19345,0,0,0,1,1
32901,70,9149,11772;12036;17151,19345,0,1,2,0,3
32902,70,9150,11406;11794;17248,19345,0,1,2,0,3
32903,70,9151,12427;17081;17647,19345,0,2,1,0,3
32904,70,9153,12050;17038,19345,0,1,1,0,2
32905,70,9154,12055;12216;17112,19345,0,1,2,0,3
32906,70,9156,11871;12113;17021,19345,0,1,2,0,3
32907,70,9160,11893;12315,19345,0,0,2,0,2
32908,70,9161,12664;13656,19345,0,0,2,0,2
32909,70,9165,12506;13225;17028;18071,19345,0,2,2,0,4
32910,70,9166,12579;12843;17280;17435,19345,0,2,2,0,4
32911,70,9167,12651;12790;17637,19345,0,1,2,0,3
32912,70,9168,12682;13065,19345,0,0,2,0,2
32913,70,9169,13332;17712;18191,19345,0,2,1,0,3
32914,70,9170,12182;12747;16947,19345,0,1,2,0,3
32915,70,9171,12899,19345,0,0,1,0,1
32916,70,9172,12896;13071,19345,0,0,2,0,2
32917,70,9173,12884;12898;17025,19345,0,1,2,0,3
32918,70,9174,12943;13930;17182;17856,19345,0,2,2,0,4
32919,70,9175,12954;13648,19345,0,0,2,0,2
32920,70,9176,12312;13173,19345,0,0,2,0,2
32921,70,9177,13072;17107;17591,19345,0,2,1,0,3
32922,70,9178,13088;13412;18088,19345,0,1,2,0,3
32923,70,9179,13123;14029;17208;17893,19345,0,2,2,0,4
32924,70,9180,12619;13357;17165;17466,19345,0,2,2,0,4
32925,70,9181,13136;13831;17278,19345,0,1,2,0,3
32926,70,9182,13170;13718,19345,0,0,2,0,2
32927,70,9183,13193;13402,19345,0,0,2,0,2
32928,70,9186,13253;13477;17361,19345,0,1,2,0,3
32929,70,9187,13285;13440;17751,19345,0,1,2,0,3
32930,70,9188,13205;13322;17148;17200,19345,0,2,2,0,4
32931,70,9189,13056;13325;17645,19345,0,1,2,0,3
32932,70,9190,13326;13861,19345,0,0,2,0,2
32933,70,9192,13395;14231;18299;18414;18628,19345,3,0,2,0,5
32934,70,9193,13424;13818,19345,0,0,2,0,2
32935,70,9195,13474;13922;17095;17338;17746,19345,0,3,2,0,5
32936,70,9196,14168,19345,0,0,1,0,1
32937,70,9198,13433,19345,0,0,1,0,1
32938,70,9199,13548;14316;17235;17730;18417,19345,1,2,2,0,5
32939,70,9200,13585;14009;17668,19345,0,1,2,0,3
32940,70,9201,13349,19345,0,0,1,0,1
32941,70,9202,13605;13677;17334;17917,19345,0,2,2,0,4
32942,70,9203,13306;13791;17053;17343,19345,0,2,2,0,4
32943,70,9204,13452;13633;17132,19345,0,1,2,0,3
32944,70,9205,13689;14107;16992;17597,19345,0,2,2,0,4
32945,70,9206,13691;13723;17381,19345,0,1,2,0,3
32946,70,9207,13730;14374;16944;17661;18049;18646,19345,1,2,3,0,6
32947,70,9208,13739;14164;16979;17234;17805,19345,0,3,2,0,5
32948,70,9209,13747;13973;16990;17681;18405;18652,19345,2,2,2,0,6
32949,70,9210,13763;13809;16982;17410;17753;18101,19345,0,4,2,0,6
32950,70,9211,13895;14056;17123;18554,19345,1,1,2,0,4
32951,70,9212,13801;13815;17133;17726;17882,19345,0,3,2,0,5
32952,70,9213,13786;13823;17471;17939,19345,0,2,2,0,4
32953,70,9214,14575;14580;18185;18365,19345,1,1,2,0,4
32954,70,9215,13886;14370,19345,0,0,2,0,2
32955,70,9216,13906;13966,19345,0,0,2,0,2
32956,70,9217,14089;17540;18334,19345,1,1,1,0,3
32957,70,9218,14411;14606;16945;17337;17362;17664;18396;18527,19345,2,4,2,0,8
32958,70,9219,13754;13961;17580;18275,19345,1,1,2,0,4
32959,70,9220,13571;13965;17004;17146;17832,19345,0,3,2,0,5
32960,70,9221,13866;13972;18054,19345,0,1,2,0,3
32961,70,9222,14033;14235,19345,0,0,2,0,2
32962,70,9223,14040;14499;17049;17802,19345,0,2,2,0,4
32963,70,9225,14098;14789;17461,19345,0,1,2,0,3
32964,70,9227,14124;14413;18159,19345,0,1,2,0,3
32965,70,9228,13848;14126;18208,19345,0,1,2,0,3
32966,70,9229,14133;14365,19345,0,0,2,0,2
32967,70,9230,14134;14353;17760;18043,19345,0,2,2,0,4
32968,70,9231,13687;14140,19345,0,0,2,0,2
32969,70,9232,14144;14605;17589;18391,19345,1,1,2,0,4
32970,70,9233,14161;14464;17257;17475;17994;18346,19345,1,3,2,0,6
32971,70,9234,14180;14715,19345,0,0,2,0,2
32972,70,9235,13817;14229;17836;18052;18261,19345,1,2,2,0,5
32973,70,9236,14062;14259;18068,19345,0,1,2,0,3
32974,70,9237,14099;14270;18597,19345,1,0,2,0,3
32975,70,9238,13790;14277;17114;17799;18108,19345,0,3,2,0,5
32976,70,9239,14282;14319;17023;17322;17470,19345,0,3,2,0,5
32977,70,9240,14287;18564,19345,1,0,1,0,2
32978,70,9241,13713;14305,19345,0,0,2,0,2
32979,70,9242,14306;14675;17001;17262;17533;17989;18723,19345,1,4,2,0,7
32980,70,9243,14330;14615;17094;18504,19345,1,1,2,0,4
32981,70,9244,14323;14364;17156;17586;17780,19345,0,3,2,0,5
32982,70,9246,4476;4699,19710,0,0,0,2,2
32983,70,9247,5187,19710,0,0,0,1,1
32984,70,9248,2893,19710,0,0,0,1,1
32985,70,9249,3863,19710,0,0,0,1,1
32986,70,9250,10439,19710,0,0,0,1,1
32987,70,9256,11414,19710,0,0,1,0,1
32988,70,9264,11818;11878;17162,19710,0,1,2,0,3
32989,70,9271,12305;12369;17098;17928,19710,0,2,2,0,4
32990,70,9273,12445;12903,19710,0,0,2,0,2
32991,70,9276,12667;13333;17942,19710,0,1,2,0,3
32992,70,9277,12474,19710,0,0,1,0,1
32993,70,9280,13284;17270,19710,0,1,1,0,2
32994,70,9281,13081;13513;17124;17975,19710,0,2,2,0,4
32995,70,9282,13117;13494;17108;17345;17759;18400;18589,19710,2,3,2,0,7
32996,70,9284,13196;13283;17716;17929,19710,0,2,2,0,4
32997,70,9285,13032;13338;17765;18017,19710,0,2,2,0,4
32998,70,9286,13399;13524;17163;17803;17969,19710,0,3,2,0,5
32999,70,9288,12897;13430;17142;17642;18389,19710,1,2,2,0,5
33000,70,9289,13437;14006;17493;17867,19710,0,2,2,0,4
33001,70,9290,13152;13465;17374,19710,0,1,2,0,3
33002,70,9291,12861;13015,19710,0,0,2,0,2
33003,70,9293,13905;17099;17254;18244,19710,1,2,1,0,4
33004,70,9294,14149;17119;17228,19710,0,2,1,0,3
33005,70,9295,13757;13808;17666;18287,19710,1,1,2,0,4
33006,70,9296,13661;13858;17199;17389,19710,0,2,2,0,4
33007,70,9297,13404;13675;17473;17690,19710,0,2,2,0,4
33008,70,9298,13614;13859;18660,19710,1,0,2,0,3
33009,70,9299,14131,19710,0,0,1,0,1
33010,70,9300,13499;13796;18176;18432,19710,1,1,2,0,4
33011,70,9301,13855;14135;18122,19710,0,1,2,0,3
33012,70,9302,13484;14073;18500,19710,1,0,2,0,3
33013,70,9303,13839;13933;17863;18407,19710,1,1,2,0,4
33014,70,9304,14366;17864,19710,0,1,1,0,2
33015,70,9305,13804;13882;17293,19710,0,1,2,0,3
33016,70,9306,13700;14224,19710,0,0,2,0,2
33017,70,9307,14344;14927;18343,19710,1,0,2,0,3
33018,70,9308,13984;14463;17290;17446;18249,19710,1,2,2,0,5
33019,70,9309,13770;13990,19710,0,0,2,0,2
33020,70,9310,14247;14417,19710,0,0,2,0,2
33021,70,9311,13994;14311;17203;17887;18467,19710,1,2,2,0,5
33022,70,9312,14028;14437;17579;17898;18370,19710,1,2,2,0,5
33023,70,9313,13704;14077;17523;18120,19710,0,2,2,0,4
33024,70,9314,14136;17465;17995,19710,0,2,1,0,3
33025,70,9316,14079;14771;18737,19710,1,0,2,0,3
33026,70,9317,13457;14139;17873;18179,19710,0,2,2,0,4
33027,70,9318,14146;14584;17137;18254,19710,1,1,2,0,4
33028,70,9319,13715;14151;17486;17976,19710,0,2,2,0,4
33029,70,9320,14156;14866;17121;17411;18493;18725,19710,2,2,2,0,6
33030,70,9321,14739,19710,0,0,1,0,1
33031,70,9322,14201;14331,19710,0,0,2,0,2
33032,70,9323,14238;14527;18511;18555,19710,2,0,2,0,4
33033,70,9324,13726;14321,19710,0,0,2,0,2
33034,70,9325,13788;14333;17255;17419;17655,19710,0,3,2,0,5
33035,70,9326,13816;14363;17241;17449;17756,19710,0,3,2,0,5
33036,70,9327,14381;14753;17516,19710,0,1,2,0,3
33037,70,9328,13785;14385;17375,19710,0,1,2,0,3
33038,70,9329,13980;14398,19710,0,0,2,0,2
33039,70,9330,14705;14718,19710,0,0,2,0,2
33040,70,9332,14407;14821;18402,19710,1,0,2,0,3
33041,70,9333,14897;18280;18319,19710,2,0,1,0,3
33042,70,9334,14457;17722,19710,0,1,1,0,2
33043,70,9335,13983;14469,19710,0,0,2,0,2
33044,70,9336,13978;14481;17874,19710,0,1,2,0,3
33045,70,9337,14036;14503;17245,19710,0,1,2,0,3
33046,70,9338,14391;14727;18497,19710,1,0,2,0,3
33047,70,9339,14166;14514;18326,19710,1,0,2,0,3
33048,70,9340,14241;14522;17707;18567,19710,1,1,2,0,4
33049,70,9341,3517;9689,20075,0,0,0,2,2
33050,70,9342,6990,20075,0,0,0,1,1
33051,70,9343,3859,20075,0,0,0,1,1
33052,70,9345,7344,20075,0,0,0,1,1
33053,70,9347,2384,20075,0,0,0,1,1
33054,70,9348,29,20075,0,0,0,1,1
33055,70,9349,10015,20075,0,0,0,1,1
33056,70,9350,10267,20075,0,0,0,1,1
33057,70,9352,10419,20075,0,0,0,1,1
33058,70,9353,10087,20075,0,0,0,1,1
33059,70,9356,10212,20075,0,0,0,1,1
33060,70,9357,10125,20075,0,0,0,1,1
33061,70,9364,11539;11764;17584,20075,0,1,2,0,3
33062,70,9370,11820,20075,0,0,1,0,1
33063,70,9376,11829,20075,0,0,1,0,1
33064,70,9377,12459;17383,20075,0,1,1,0,2
33065,70,9379,11929;12196,20075,0,0,2,0,2
33066,70,9382,12894,20075,0,0,1,0,1
33067,70,9384,12708;13002;17256;17659,20075,0,2,2,0,4
33068,70,9385,13665,20075,0,0,1,0,1
33069,70,9387,13073,20075,0,0,1,0,1
33070,70,9388,12671;13309;17269,20075,0,1,2,0,3
33071,70,9389,13078,20075,0,0,1,0,1
33072,70,9390,13052;13337;17413,20075,0,1,2,0,3
33073,70,9391,12509;13076,20075,0,0,2,0,2
33074,70,9392,13345,20075,0,0,1,0,1
33075,70,9393,12487;13000,20075,0,0,2,0,2
33076,70,9394,13355;13565;17644,20075,0,1,2,0,3
33077,70,9395,13373;13495,20075,0,0,2,0,2
33078,70,9396,13932;14042;18603,20075,1,0,2,0,3
33079,70,9397,12966;13460;17192,20075,0,1,2,0,3
33080,70,9398,13864;18239,20075,1,0,1,0,2
33081,70,9399,13611;14194;18507,20075,1,0,2,0,3
33082,70,9400,13660;13702;17549,20075,0,1,2,0,3
33083,70,9401,13521;13668;17788,20075,0,1,2,0,3
33084,70,9402,13276;13737;18371,20075,1,0,2,0,3
33085,70,9403,13743;14013,20075,0,0,2,0,2
33086,70,9404,13621,20075,0,0,1,0,1
33087,70,9405,13383;13833;17225;18170;18320,20075,1,2,2,0,5
33088,70,9406,14578;17385;17691,20075,0,2,1,0,3
33089,70,9407,13722;14123;17349;18116,20075,0,2,2,0,4
33090,70,9408,13862;17332,20075,0,1,1,0,2
33091,70,9409,14309;14474,20075,0,0,2,0,2
33092,70,9410,13899;14483,20075,0,0,2,0,2
33093,70,9411,13901;14281;17821;18199;18474,20075,1,2,2,0,5
33094,70,9412,13616;13948;18089,20075,0,1,2,0,3
33095,70,9413,13998;14855;17341,20075,0,1,2,0,3
33096,70,9414,13551;14005;18294,20075,1,0,2,0,3
33097,70,9415,14015;14204;17638;17943;18645,20075,1,2,2,0,5
33098,70,9416,14531;17859;18173,20075,0,2,1,0,3
33099,70,9418,14853;14891;17454;17674,20075,0,2,2,0,4
33100,70,9419,14060;14198;17433,20075,0,1,2,0,3
33101,70,9420,13699,20075,0,0,1,0,1
33102,70,9421,14205;14427;17916;18195,20075,0,2,2,0,4
33103,70,9422,14007;14090,20075,0,0,2,0,2
33104,70,9423,14741;18301;18531,20075,2,0,1,0,3
33105,70,9424,14039;14104;17798;18027;18728,20075,1,2,2,0,5
33106,70,9425,14106;14516;17831,20075,0,1,2,0,3
33107,70,9426,14108;14805;18345;18466,20075,2,0,2,0,4
33108,70,9428,13599;14179;17982;18262;18674,20075,2,1,2,0,5
33109,70,9429,14207;14255;17462;18247,20075,1,1,2,0,4
33110,70,9430,14035;14202;17544,20075,0,1,2,0,3
33111,70,9431,14220;17221;18427,20075,1,1,1,0,3
33112,70,9432,14058;14221,20075,0,0,2,0,2
33113,70,9433,14196;14226,20075,0,0,2,0,2
33114,70,9434,14250;14357,20075,0,0,2,0,2
33115,70,9435,14383;14824;17355;17564;17573;17944;18227,20075,1,4,2,0,7
33116,70,9436,13883;14408;17884;18558,20075,1,1,2,0,4
33117,70,9437,13885;14419,20075,0,0,2,0,2
33118,70,9438,13873;14453,20075,0,0,2,0,2
33119,70,9439,14174;14454;18194;18459,20075,1,1,2,0,4
33120,70,9440,14294;14482;18094;18223,20075,1,1,2,0,4
33121,70,9441,14489;14585;17252;17632,20075,0,2,2,0,4
33122,70,9442,14505;15063,20075,0,0,2,0,2
33123,70,9443,14480;14507,20075,0,0,2,0,2
33124,70,9444,14237;14517,20075,0,0,2,0,2
33125,70,9445,14524,20075,0,0,1,0,1
33126,70,9446,14539;14854,20075,0,0,2,0,2
33127,70,9447,14551;14684,20075,0,0,2,0,2
33128,70,9448,14289;14573;18561;18699,20075,2,0,2,0,4
33129,70,9449,14589;14765,20075,0,0,2,0,2
33130,70,9450,14591;14863,20075,0,0,2,0,2
33131,70,9451,14426;14609;17205;18112,20075,0,2,2,0,4
33132,70,9452,14612,20075,0,0,1,0,1
33133,70,9453,14613;14724,20075,0,0,2,0,2
33134,70,9454,13914;14622,20075,0,0,2,0,2
33135,70,9455,14623;18614,20075,1,0,1,0,2
33136,70,9456,14624;15027;17242;18272;18540,20075,2,1,2,0,5
33137,70,9457,14629;14971;17478;17933;18698,20075,1,2,2,0,5
33138,70,9458,14643;17265;17335;17653;18364,20075,1,3,1,0,5
33139,70,9459,14652;15086;17364;18302;18446,20075,2,1,2,0,5
33140,70,9460,18,20440,0,0,0,1,1
33141,70,9461,9520;10344,20440,0,0,0,2,2
33142,70,9462,8372,20440,0,0,0,1,1
33143,70,9463,10034,20440,0,0,0,1,1
33144,70,9464,10061;10252,20440,0,0,0,2,2
33145,70,9466,10327;10760,20440,0,0,0,2,2
33146,70,9470,10161,20440,0,0,0,1,1
33147,70,9472,10747;10768,20440,0,0,1,1,2
33148,70,9475,11483;11848,20440,0,0,2,0,2
33149,70,9478,10640;10996,20440,0,0,1,1,2
33150,70,9479,11290,20440,0,0,1,0,1
33151,70,9483,11314,20440,0,0,1,0,1
33152,70,9484,11490;11860,20440,0,0,2,0,2
33153,70,9488,12184;12217;17456,20440,0,1,2,0,3
33154,70,9494,11596;12166;17301,20440,0,1,2,0,3
33155,70,9496,12567;12922;17274,20440,0,1,2,0,3
33156,70,9502,13101;13591,20440,0,0,2,0,2
33157,70,9503,13135;13765,20440,0,0,2,0,2
33158,70,9504,13312;13329;17424;17679,20440,0,2,2,0,4
33159,70,9505,13244;13910;17519;17920,20440,0,2,2,0,4
33160,70,9508,12961,20440,0,0,1,0,1
33161,70,9509,13936;13947;18038,20440,0,1,2,0,3
33162,70,9510,13506;13694;17663,20440,0,1,2,0,3
33163,70,9511,13545,20440,0,0,1,0,1
33164,70,9512,13589;13945;17271;18190,20440,0,2,2,0,4
33165,70,9513,13608;14297;18047;18707,20440,1,1,2,0,4
33166,70,9516,13598;14390,20440,0,0,2,0,2
33167,70,9517,12882;13706;17305;17610,20440,0,2,2,0,4
33168,70,9518,13717;13719;18160,20440,0,1,2,0,3
33169,70,9521,13851;14298;17745;18069;18251,20440,1,2,2,0,5
33170,70,9522,13891;14345,20440,0,0,2,0,2
33171,70,9523,13482;13977;17708;17895,20440,0,2,2,0,4
33172,70,9524,12875;13924;17366,20440,0,1,2,0,3
33173,70,9525,13912;13925;18626,20440,1,0,2,0,3
33174,70,9526,13783;13954;17669;18129;18539,20440,1,2,2,0,5
33175,70,9529,14014;14184,20440,0,0,2,0,2
33176,70,9530,14115;14513;17643;18356,20440,1,1,2,0,4
33177,70,9531,14120;14754;17386;17719;18099;18613,20440,1,3,2,0,6
33178,70,9532,13394;14117,20440,0,0,2,0,2
33179,70,9533,14162;14646;17333;18074,20440,0,2,2,0,4
33180,70,9534,14163;14267;17850;18240,20440,1,1,2,0,4
33181,70,9535,14175;14217;18157,20440,0,1,2,0,3
33182,70,9536,14213;14655;18650,20440,1,0,2,0,3
33183,70,9537,14222;14232,20440,0,0,2,0,2
33184,70,9538,13563;14233,20440,0,0,2,0,2
33185,70,9539,15017;15088;18162,20440,0,1,2,0,3
33186,70,9540,14278;14902;18107,20440,0,1,2,0,3
33187,70,9541,14286;14424;18004;18593,20440,1,1,2,0,4
33188,70,9542,14053;14313;17702,20440,0,1,2,0,3
33189,70,9543,14113;14314;17673;17699;18055;18383,20440,1,3,2,0,6
33190,70,9545,14248;14256,20440,0,0,2,0,2
33191,70,9546,14072;14376;17723;18629,20440,1,1,2,0,4
33192,70,9547,14451;18579,20440,1,0,1,0,2
33193,70,9548,14444;14827;18021;18433,20440,1,1,2,0,4
33194,70,9549,14420;14456,20440,0,0,2,0,2
33195,70,9550,14462;14958;18230;18584,20440,2,0,2,0,4
33196,70,9552,13874;14105;18201;18373,20440,1,1,2,0,4
33197,70,9553,14301;14485;17902;18662,20440,1,1,2,0,4
33198,70,9554,14487;17706;18010,20440,0,2,1,0,3
33199,70,9555,14492;14709;18037,20440,0,1,2,0,3
33200,70,9556,14501;18451,20440,1,0,1,0,2
33201,70,9557,14509,20440,0,0,1,0,1
33202,70,9558,14068;14512;17640;17883;18547,20440,1,2,2,0,5
33203,70,9559,14535;14838;17733,20440,0,1,2,0,3
33204,70,9560,14555;15215,20440,0,0,2,0,2
33205,70,9561,14559;14847;17488;17904;18665,20440,1,2,2,0,5
33206,70,9562,14661;18404;18562,20440,2,0,1,0,3
33207,70,9563,13741;13870;18476,20440,1,0,2,0,3
33208,70,9564,14568;14601;17818;18596,20440,1,1,2,0,4
33209,70,9565,14600,20440,0,0,1,0,1
33210,70,9566,14811;14908;17560;17631,20440,0,2,2,0,4
33211,70,9567,14260;14639;17459;17829,20440,0,2,2,0,4
33212,70,9568,14640;14687;18633,20440,1,0,2,0,3
33213,70,9569,14683;14998,20440,0,0,2,0,2
33214,70,9570,13963;14693;17554;17728,20440,0,2,2,0,4
33215,70,9571,14101;14571;18203;18736,20440,1,1,2,0,4
33216,70,9572,14717;14945;17275;17550;18040;18513,20440,1,3,2,0,6
33217,70,9573,14399;14869,20440,0,0,2,0,2
33218,70,9574,15154;17767,20440,0,1,1,0,2
33219,70,9575,14758;15078;18118;18378,20440,1,1,2,0,4
33220,70,9576,14759;14843;17317,20440,0,1,2,0,3
33221,70,9577,14435;14779,20440,0,0,2,0,2
33222,70,9578,839;8998,20805,0,0,0,2,2
33223,70,9579,10018;10023,20805,0,0,0,2,2
33224,70,9580,10110,20805,0,0,0,1,1
33225,70,9582,3840,20805,0,0,0,1,1
33226,70,9583,10095,20805,0,0,0,1,1
33227,70,9584,10157,20805,0,0,0,1,1
33228,70,9585,10328,20805,0,0,0,1,1
33229,70,9586,10611;10856,20805,0,0,1,1,2
33230,70,9589,10149;10677,20805,0,0,0,2,2
33231,70,9590,11063,20805,0,0,1,0,1
33232,70,9591,10428,20805,0,0,0,1,1
33233,70,9593,10488;10533,20805,0,0,0,2,2
33234,70,9599,11507,20805,0,0,1,0,1
33235,70,9602,11391,20805,0,0,1,0,1
33236,70,9610,12300,20805,0,0,1,0,1
33237,70,9611,12986;13045,20805,0,0,2,0,2
33238,70,9612,12599,20805,0,0,1,0,1
33239,70,9613,12058;12575,20805,0,0,2,0,2
33240,70,9618,12800;13099;17562;17815,20805,0,2,2,0,4
33241,70,9621,12969;17442;17626,20805,0,2,1,0,3
33242,70,9622,12689;13017,20805,0,0,2,0,2
33243,70,9623,13050;13613;18167,20805,0,1,2,0,3
33244,70,9625,13269;14265;18350;18612,20805,2,0,2,0,4
33245,70,9626,13354;13776;17747;17978;18276;18447,20805,2,2,2,0,6
33246,70,9628,13504;17749,20805,0,1,1,0,2
33247,70,9629,13569;13949;18019;18151,20805,0,2,2,0,4
33248,70,9630,13576;13697;17949;18221,20805,1,1,2,0,4
33249,70,9631,13632;13746;17715;18441,20805,1,1,2,0,4
33250,70,9633,13735;13957;17806,20805,0,1,2,0,3
33251,70,9634,13852;13938;17656;17849;18186,20805,0,3,2,0,5
33252,70,9635,13853;14939;17852,20805,0,1,2,0,3
33253,70,9636,14409,20805,0,0,1,0,1
33254,70,9637,13336;13944,20805,0,0,2,0,2
33255,70,9638,13969;14425;17791,20805,0,1,2,0,3
33256,70,9639,13806;13976;17744;18175;18412,20805,1,2,2,0,5
33257,70,9640,14026;17951,20805,0,1,1,0,2
33258,70,9641,14118;14520,20805,0,0,2,0,2
33259,70,9642,13993;14122;17678;17892,20805,0,2,2,0,4
33260,70,9643,14154;14850;18658,20805,1,0,2,0,3
33261,70,9644,14236;17979;18471,20805,1,1,1,0,3
33262,70,9645,14158;14570;18631,20805,1,0,2,0,3
33263,70,9646,14188;14468,20805,0,0,2,0,2
33264,70,9648,14317;14604;17445;17877,20805,0,2,2,0,4
33265,70,9649,14275,20805,0,0,1,0,1
33266,70,9651,14240;14384;18664,20805,1,0,2,0,3
33267,70,9652,14050;14396,20805,0,0,2,0,2
33268,70,9653,14245;14403;18022,20805,0,1,2,0,3
33269,70,9654,14279;14443;17507,20805,0,1,2,0,3
33270,70,9655,15126;17559;17604,20805,0,2,1,0,3
33271,70,9656,14086;14536;18225;18368,20805,2,0,2,0,4
33272,70,9658,14582;17725;17830,20805,0,2,1,0,3
33273,70,9659,14595;18008;18192;18482;18595,20805,2,2,1,0,5
33274,70,9660,14596;14930;18018;18182,20805,0,2,2,0,4
33275,70,9661,14564;14647;18367,20805,1,0,2,0,3
33276,70,9662,14740,20805,0,0,1,0,1
33277,70,9663,14658;14763;18282,20805,1,0,2,0,3
33278,70,9664,14266;14674;17369;17650,20805,0,2,2,0,4
33279,70,9665,14676;14825;17787;18051,20805,0,2,2,0,4
33280,70,9666,14704;15034,20805,0,0,2,0,2
33281,70,9667,14548;14706;17356;17557,20805,0,2,2,0,4
33282,70,9668,14732,20805,0,0,1,0,1
33283,70,9669,14769,20805,0,0,1,0,1
33284,70,9670,14775;15135;18012;18550,20805,1,1,2,0,4
33285,70,9671,14781,20805,0,0,1,0,1
33286,70,9672,14785;15035,20805,0,0,2,0,2
33287,70,9673,14786;15260;17577;17763;18241,20805,1,2,2,0,5
33288,70,9674,14782;14801,20805,0,0,2,0,2
33289,70,9675,14813;15240,20805,0,0,2,0,2
33290,70,9676,14849;15187;17437;17581;17717;17860;18600,20805,1,4,2,0,7
33291,70,9677,14856;14951;17750;18109,20805,0,2,2,0,4
33292,70,9678,15176,20805,0,0,1,0,1
33293,70,9679,14685;14873;17667,20805,0,1,2,0,3
33294,70,9680,14875;14964;18029;18369,20805,1,1,2,0,4
33295,70,9681,14886;15364;17680;17827,20805,0,2,2,0,4
33296,70,9682,14887;15070;18300;18387;18669,20805,3,0,2,0,5
33297,70,9683,14893;15345,20805,0,0,2,0,2
33298,70,9684,14916,20805,0,0,1,0,1
33299,70,9685,14884;14917;18676,20805,1,0,2,0,3
33300,70,9686,14924;17986;18481,20805,1,1,1,0,3
33301,70,9687,14926;15394,20805,0,0,2,0,2
33302,70,9688,14986,20805,0,0,1,0,1
33303,70,9689,1940,21170,0,0,0,1,1
33304,70,9694,10285;10528,21170,0,0,0,2,2
33305,70,9695,10534,21170,0,0,0,1,1
33306,70,9697,10025,21170,0,0,0,1,1
33307,70,9698,10538,21170,0,0,0,1,1
33308,70,9699,10423,21170,0,0,0,1,1
33309,70,9709,11563;11914,21170,0,0,2,0,2
33310,70,9711,12030;17469,21170,0,1,1,0,2
33311,70,9714,12013,21170,0,0,1,0,1
33312,70,9715,12085,21170,0,0,1,0,1
33313,70,9719,12753;12820,21170,0,0,2,0,2
33314,70,9722,12581;13070;18026,21170,0,1,2,0,3
33315,70,9723,13003;13358;17458;17721,21170,0,2,2,0,4
33316,70,9726,13362;13825;18046,21170,0,1,2,0,3
33317,70,9728,13522;13898,21170,0,0,2,0,2
33318,70,9730,13819;14784;17670;17910,21170,0,2,2,0,4
33319,70,9731,14397,21170,0,0,1,0,1
33320,70,9732,13904;17588;17855;18264;18429,21170,2,2,1,0,5
33321,70,9733,13542;13921;17485;17906,21170,0,2,2,0,4
33322,70,9735,14012;18077;18528,21170,1,1,1,0,3
33323,70,9736,14038;14197;18163;18648,21170,1,1,2,0,4
33324,70,9737,14045;14208,21170,0,0,2,0,2
33325,70,9738,14078;14372,21170,0,0,2,0,2
33326,70,9739,13894;14088,21170,0,0,2,0,2
33327,70,9740,14103;14195;18098;18618,21170,1,1,2,0,4
33328,70,9741,14138;14216,21170,0,0,2,0,2
33329,70,9742,14152;14326;18524;18695,21170,2,0,2,0,4
33330,70,9743,14192;14557;17776;18036;18337;18431,21170,2,2,2,0,6
33331,70,9744,14218;14746;17792,21170,0,1,2,0,3
33332,70,9745,14227;15522,21170,0,0,2,0,2
33333,70,9746,14361;14642;18348;18700,21170,2,0,2,0,4
33334,70,9747,14829;18390,21170,1,0,1,0,2
33335,70,9748,14341,21170,0,0,1,0,1
33336,70,9750,13992;14404;17774,21170,0,1,2,0,3
33337,70,9751,14542;17909;18011;18362;18557,21170,2,2,1,0,5
33338,70,9752,14696,21170,0,0,1,0,1
33339,70,9753,14389;14460;18083,21170,0,1,2,0,3
33340,70,9754,14203;14486;18149,21170,0,1,2,0,3
33341,70,9755,14511;14848;18281;18450,21170,2,0,2,0,4
33342,70,9756,14519;14861;17658;17694;17987;18354,21170,1,3,2,0,6
33343,70,9757,14529;14865,21170,0,0,2,0,2
33344,70,9758,14116;14532;18464,21170,1,0,2,0,3
33345,70,9759,14001;14549;17948;18611,21170,1,1,2,0,4
33346,70,9760,15252;15415;18093,21170,0,1,2,0,3
33347,70,9761,14576,21170,0,0,1,0,1
33348,70,9762,14214;14579;18361;18570,21170,2,0,2,0,4
33349,70,9763,14669;15072,21170,0,0,2,0,2
33350,70,9764,14678,21170,0,0,1,0,1
33351,70,9765,14666;14703;18738,21170,1,0,2,0,3
33352,70,9766,14713;14722,21170,0,0,2,0,2
33353,70,9767,14735;14922;18322;18621,21170,2,0,2,0,4
33354,70,9768,14264;14751;18057,21170,0,1,2,0,3
33355,70,9769,14787;15379;18722,21170,1,0,2,0,3
33356,70,9770,14569;14790;17641;18165,21170,0,2,2,0,4
33357,70,9771,14100;14793;17646;18617,21170,1,1,2,0,4
33358,70,9772,14498;14802,21170,0,0,2,0,2
33359,70,9773,15995;18372;18718,21170,2,0,1,0,3
33360,70,9774,15342;15411;18573;18747,21170,2,0,2,0,4
33361,70,9775,14852;15174,21170,0,0,2,0,2
33362,70,9777,14538;14895;17737;18546,21170,1,1,2,0,4
33363,70,9778,14915;15121;18379;18673,21170,2,0,2,0,4
33364,70,9779,14872;17748;18078,21170,0,2,1,0,3
33365,70,9780,14749;14936;17569;17843,21170,0,2,2,0,4
33366,70,9781,14938;15289;18196,21170,0,1,2,0,3
33367,70,9782,15170;15853;17552;17575;18217;18434,21170,2,2,2,0,6
33368,70,9783,14976;15068;18498;18703,21170,2,0,2,0,4
33369,70,9784,14977;15210;18183,21170,0,1,2,0,3
33370,70,9785,14980;15000;17783;18381,21170,1,1,2,0,4
33371,70,9786,14707,21170,0,0,1,0,1
33372,70,9787,14777;15011,21170,0,0,2,0,2
33373,70,9788,15026;15044;17619,21170,0,1,2,0,3
33374,70,9789,15043;15473,21170,0,0,2,0,2
33375,70,9790,14697;14923;18324,21170,1,0,2,0,3
33376,70,9791,14954;15066;18445;18592,21170,2,0,2,0,4
33377,70,9792,14815;15076;17738,21170,0,1,2,0,3
33378,70,9793,14820;15080;17848;18103;18398;18448,21170,2,2,2,0,6
33379,70,9794,14648;15081;17492;18293,21170,1,1,2,0,4
33380,70,9795,15195;17686;18411,21170,1,1,1,0,3
33381,70,9799,10371,21535,0,0,0,1,1
33382,70,9801,10351;10676,21535,0,0,0,2,2
33383,70,9802,10781,21535,0,0,1,0,1
33384,70,9810,11307;11632,21535,0,0,2,0,2
33385,70,9811,11258,21535,0,0,1,0,1
33386,70,9818,12476,21535,0,0,1,0,1
33387,70,9823,13319;17662,21535,0,1,1,0,2
33388,70,9824,12824;12849,21535,0,0,2,0,2
33389,70,9827,13105,21535,0,0,1,0,1
33390,70,9828,13197;13795,21535,0,0,2,0,2
33391,70,9829,13268;13756;17617;17880;18616,21535,1,2,2,0,5
33392,70,9830,13382;17913,21535,0,1,1,0,2
33393,70,9831,12997;13530,21535,0,0,2,0,2
33394,70,9832,13401;13609,21535,0,0,2,0,2
33395,70,9833,13406;13828;17970,21535,0,1,2,0,3
33396,70,9834,13466,21535,0,0,1,0,1
33397,70,9836,14076;14211;18690,21535,1,0,2,0,3
33398,70,9837,13176;13711,21535,0,0,2,0,2
33399,70,9838,13526;13738,21535,0,0,2,0,2
33400,70,9839,13671;13742,21535,0,0,2,0,2
33401,70,9841,13927;14200,21535,0,0,2,0,2
33402,70,9844,13775;13928,21535,0,0,2,0,2
33403,70,9845,13847;14219,21535,0,0,2,0,2
33404,70,9846,13865;14394,21535,0,0,2,0,2
33405,70,9847,14587;18578,21535,1,0,1,0,2
33406,70,9849,13982;14702;17635;18729,21535,1,1,2,0,4
33407,70,9850,14324,21535,0,0,1,0,1
33408,70,9851,13274;14054,21535,0,0,2,0,2
33409,70,9853,14167;14679;18487,21535,1,0,2,0,3
33410,70,9854,14412,21535,0,0,1,0,1
33411,70,9856,13623;13789,21535,0,0,2,0,2
33412,70,9857,14252;17605,21535,0,1,1,0,2
33413,70,9858,14269;14272,21535,0,0,2,0,2
33414,70,9860,14320;14343,21535,0,0,2,0,2
33415,70,9861,14041;14334,21535,0,0,2,0,2
33416,70,9863,14354;17824,21535,0,1,1,0,2
33417,70,9864,14369;14721,21535,0,0,2,0,2
33418,70,9865,14141;14405,21535,0,0,2,0,2
33419,70,9866,14423;14602;17761,21535,0,1,2,0,3
33420,70,9867,14450;14476;18076,21535,0,1,2,0,3
33421,70,9868,14455;14818;18491,21535,1,0,2,0,3
33422,70,9869,14776;14914;17613;18005;18681,21535,1,2,2,0,5
33423,70,9870,14490;15118;18574,21535,1,0,2,0,3
33424,70,9871,14546,21535,0,0,1,0,1
33425,70,9872,14329;14556;17777;18152,21535,0,2,2,0,4
33426,70,9873,14723;14984;18739,21535,1,0,2,0,3
33427,70,9874,14788;15647;17607;17967,21535,0,2,2,0,4
33428,70,9875,14878;15245;17838,21535,0,1,2,0,3
33429,70,9876,14380;14796,21535,0,0,2,0,2
33430,70,9877,14371;14798,21535,0,0,2,0,2
33431,70,9878,14803;17732;18161;18563,21535,1,2,1,0,4
33432,70,9879,14882;15141;17598;18121,21535,0,2,2,0,4
33433,70,9880,15171;18518,21535,1,0,1,0,2
33434,70,9881,14461;14879;18184;18644,21535,1,1,2,0,4
33435,70,9882,14920;15013;18291;18479,21535,2,0,2,0,4
33436,70,9883,15226;15496;18314;18571,21535,2,0,2,0,4
33437,70,9884,14972,21535,0,0,1,0,1
33438,70,9885,14985,21535,0,0,1,0,1
33439,70,9886,14418;14987;18355;18449;18691,21535,3,0,2,0,5
33440,70,9887,14997;15293;17651;17793;18461,21535,1,2,2,0,5
33441,70,9888,15030;15468,21535,0,0,2,0,2
33442,70,9889,15046;15481;18111;18591,21535,1,1,2,0,4
33443,70,9890,14493;15064;17739;18128;18395,21535,1,2,2,0,5
33444,70,9891,15075;15520;17804;18006,21535,0,2,2,0,4
33445,70,9892,14448;14599;17828;18075;18115,21535,0,3,2,0,5
33446,70,9893,15083;15366,21535,0,0,2,0,2
33447,70,9894,14911;15103;17825;18384,21535,1,1,2,0,4
33448,70,9895,15113;18490;18677,21535,2,0,1,0,3
33449,70,9896,15125;15785,21535,0,0,2,0,2
33450,70,9897,15107;15132;17736;17807,21535,0,2,2,0,4
33451,70,9898,14729;15133,21535,0,0,2,0,2
33452,70,9899,15138,21535,0,0,1,0,1
33453,70,9900,14901;15143,21535,0,0,2,0,2
33454,70,9901,15052;15144,21535,0,0,2,0,2
33455,70,9902,15002;15167;17718;17835;18295;18708,21535,2,2,2,0,6
33456,70,9903,14957;15478;18304,21535,1,0,2,0,3
33457,70,9904,14973;15202,21535,0,0,2,0,2
33458,70,9905,94,21900,0,0,0,1,1
33459,70,9906,10045,21900,0,0,0,1,1
33460,70,9910,10968;11048,21900,0,0,2,0,2
33461,70,9913,10892,21900,0,0,1,0,1
33462,70,9915,11463;11695,21900,0,0,2,0,2
33463,70,9916,11343,21900,0,0,1,0,1
33464,70,9917,11668;11739,21900,0,0,2,0,2
33465,70,9918,11238,21900,0,0,1,0,1
33466,70,9921,11910,21900,0,0,1,0,1
33467,70,9925,12088,21900,0,0,1,0,1
33468,70,9926,12094,21900,0,0,1,0,1
33469,70,9927,12163;12636,21900,0,0,2,0,2
33470,70,9928,11997;12114,21900,0,0,2,0,2
33471,70,9929,12343;12758;17711,21900,0,1,2,0,3
33472,70,9941,13344,21900,0,0,1,0,1
33473,70,9942,13013,21900,0,0,1,0,1
33474,70,9943,13114;13417;17810,21900,0,1,2,0,3
33475,70,9945,13247;13812;17936;18210,21900,1,1,2,0,4
33476,70,9948,13413;14049;18572,21900,1,0,2,0,3
33477,70,9950,13425;13845;18278,21900,1,0,2,0,3
33478,70,9953,13708;14296,21900,0,0,2,0,2
33479,70,9955,13887;14225;17822,21900,0,1,2,0,3
33480,70,9959,14016;14342,21900,0,0,2,0,2
33481,70,9960,14027;14449,21900,0,0,2,0,2
33482,70,9961,14234;18097;18458,21900,1,1,1,0,3
33483,70,9962,13880;14178,21900,0,0,2,0,2
33484,70,9963,14668;18308,21900,1,0,1,0,2
33485,70,9964,14239;14367;17758;18386,21900,1,1,2,0,4
33486,70,9966,14290;14355;18428,21900,1,0,2,0,3
33487,70,9967,14379;14716,21900,0,0,2,0,2
33488,70,9968,13875;14395,21900,0,0,2,0,2
33489,70,9970,14597;18478,21900,1,0,1,0,2
33490,70,9971,14378;14495;17954,21900,0,1,2,0,3
33491,70,9972,14119;14525;18113,21900,0,1,2,0,3
33492,70,9973,14393;14528;18438,21900,1,0,2,0,3
33493,70,9974,14608;14982;18714,21900,1,0,2,0,3
33494,70,9975,14618;15106,21900,0,0,2,0,2
33495,70,9976,14621;14665;18096;18141;18233;18488;18641,21900,3,2,2,0,7
33496,70,9977,14778,21900,0,0,1,0,1
33497,70,9978,14870;18435;18532,21900,2,0,1,0,3
33498,70,9979,14662;15007;18333;18585;18651,21900,3,0,2,0,5
33499,70,9980,14173;14690;17899,21900,0,1,2,0,3
33500,70,9981,14733,21900,0,0,1,0,1
33501,70,9982,14283;14762;17930;18135;18647,21900,1,2,2,0,5
33502,70,9983,14862;15320;17905;18245;18717,21900,2,1,2,0,5
33503,70,9984,14845;15073;18267;18492,21900,2,0,2,0,4
33504,70,9985,14889;15380,21900,0,0,2,0,2
33505,70,9986,14506;14903;18538,21900,1,0,2,0,3
33506,70,9987,15462;15474,21900,0,0,2,0,2
33507,70,9988,14905;15253;18030;18358,21900,1,1,2,0,4
33508,70,9990,14919;15032;18283,21900,1,0,2,0,3
33509,70,9991,14932;15418,21900,0,0,2,0,2
33510,70,9992,15257,21900,0,0,1,0,1
33511,70,9993,14933;14950;18123;18288,21900,1,1,2,0,4
33512,70,9994,14807;14975,21900,0,0,2,0,2
33513,70,9995,14978;15186;18671,21900,1,0,2,0,3
33514,70,9996,14992;15134;18347;18495,21900,2,0,2,0,4
33515,70,9997,15001,21900,0,0,1,0,1
33516,70,9998,15020;15605;17772;17968;18082,21900,0,3,2,0,5
33517,70,9999,15024;15244;18656,21900,1,0,2,0,3
33518,70,10000,15025;17819;18220;18601,21900,2,1,1,0,4
33519,70,10001,15688,21900,0,0,1,0,1
33520,70,10002,14720;15116;17764,21900,0,1,2,0,3
33521,70,10003,14714;15128,21900,0,0,2,0,2
33522,70,10004,15709,21900,0,0,1,0,1
33523,70,10005,15140,21900,0,0,1,0,1
33524,70,10006,15051;15153,21900,0,0,2,0,2
33525,70,10007,15155;15808;18388,21900,1,0,2,0,3
33526,70,10008,14518;15162;17961;18637,21900,1,1,2,0,4
33527,70,10009,15165;15408;18401;18502,21900,2,0,2,0,4
33528,70,10010,15055;15181,21900,0,0,2,0,2
33529,70,10011,15191;17932,21900,0,1,1,0,2
33530,70,10012,15217,21900,0,0,1,0,1
33531,70,10013,14500;15220,21900,0,0,2,0,2
33532,70,10014,15179;15261;17889;18090;18342,21900,1,2,2,0,5
33533,70,10015,14747;15311,21900,0,0,2,0,2
33534,70,10016,15352,21900,0,0,1,0,1
33535,70,10017,15357;15719;17854;18174,21900,0,2,2,0,4
33536,70,10018,15358;15377,21900,0,0,2,0,2
33537,70,10019,15359;15512;17901;18015;18147;18535,21900,1,3,2,0,6
33538,70,10020,14438;15361;18408,21900,1,0,2,0,3
33539,70,10021,15164;15368;18212,21900,1,0,2,0,3
33540,70,10022,14783;15378,21900,0,0,2,0,2
33541,70,10023,15381;15516;18735,21900,1,0,2,0,3
33542,70,10024,15396;15451,21900,0,0,2,0,2
33543,70,10026,6911,22265,0,0,0,1,1
33544,70,10030,10868;11018,22265,0,0,2,0,2
33545,70,10031,10915,22265,0,0,1,0,1
33546,70,10032,10959,22265,0,0,1,0,1
33547,70,10036,11729;12029,22265,0,0,2,0,2
33548,70,10038,11564,22265,0,0,1,0,1
33549,70,10040,12021;12148,22265,0,0,2,0,2
33550,70,10043,12819;12923;18166,22265,0,1,2,0,3
33551,70,10044,12503;12872,22265,0,0,2,0,2
33552,70,10045,12616;12860,22265,0,0,2,0,2
33553,70,10047,13151,22265,0,0,1,0,1
33554,70,10049,13780;13857,22265,0,0,2,0,2
33555,70,10050,13049,22265,0,0,1,0,1
33556,70,10052,13487,22265,0,0,1,0,1
33557,70,10053,13953;18456,22265,1,0,1,0,2
33558,70,10054,13558,22265,0,0,1,0,1
33559,70,10055,13550,22265,0,0,1,0,1
33560,70,10056,13627;13995;18694,22265,1,0,2,0,3
33561,70,10058,13842;14273,22265,0,0,2,0,2
33562,70,10059,13464;13843;18327;18523,22265,2,0,2,0,4
33563,70,10060,13881;14020;18297,22265,1,0,2,0,3
33564,70,10061,14043;14228,22265,0,0,2,0,2
33565,70,10062,14018;14059;18520,22265,1,0,2,0,3
33566,70,10063,14066;14094;18424,22265,1,0,2,0,3
33567,70,10064,14302;14761,22265,0,0,2,0,2
33568,70,10065,13822;13974;18727,22265,1,0,2,0,3
33569,70,10066,14756,22265,0,0,1,0,1
33570,70,10067,13595;14109,22265,0,0,2,0,2
33571,70,10068,14023;14246,22265,0,0,2,0,2
33572,70,10069,14262,22265,0,0,1,0,1
33573,70,10070,14307;14583,22265,0,0,2,0,2
33574,70,10071,14588;15206,22265,0,0,2,0,2
33575,70,10072,14348;14909;18697,22265,1,0,2,0,3
33576,70,10073,14770;15056,22265,0,0,2,0,2
33577,70,10074,14160;14431;17796;18007;18536,22265,1,2,2,0,5
33578,70,10075,14362;14470,22265,0,0,2,0,2
33579,70,10076,14534;14841;17971,22265,0,1,2,0,3
33580,70,10077,14526;15098;18413;18580,22265,2,0,2,0,4
33581,70,10078,14594;14653;18265;18622,22265,2,0,2,0,4
33582,70,10080,14616;18509,22265,1,0,1,0,2
33583,70,10081,14656;15033,22265,0,0,2,0,2
33584,70,10082,14663;15650;17862;18032;18686,22265,1,2,2,0,5
33585,70,10083,14699;15189,22265,0,0,2,0,2
33586,70,10084,14890;14970,22265,0,0,2,0,2
33587,70,10085,14731,22265,0,0,1,0,1
33588,70,10086,14752;15422,22265,0,0,2,0,2
33589,70,10087,14689;14757;18236,22265,1,0,2,0,3
33590,70,10088,14258;14422,22265,0,0,2,0,2
33591,70,10089,14792;15525;18442,22265,1,0,2,0,3
33592,70,10090,14831;15247,22265,0,0,2,0,2
33593,70,10093,15120;15137,22265,0,0,2,0,2
33594,70,10094,14251;14888,22265,0,0,2,0,2
33595,70,10095,14816;14907;18248;18499,22265,2,0,2,0,4
33596,70,10096,14949;15413;18259,22265,1,0,2,0,3
33597,70,10097,14956;14963;18080;18277,22265,1,1,2,0,4
33598,70,10098,14969;15802;18206;18353,22265,1,1,2,0,4
33599,70,10099,14574;14983,22265,0,0,2,0,2
33600,70,10100,15018,22265,0,0,1,0,1
33601,70,10101,15019;15029,22265,0,0,2,0,2
33602,70,10102,15054;15131,22265,0,0,2,0,2
33603,70,10103,15059;15287;18131,22265,0,1,2,0,3
33604,70,10104,15285,22265,0,0,1,0,1
33605,70,10105,14812;15142;18181;18512,22265,1,1,2,0,4
33606,70,10106,14953;18331;18640,22265,2,0,1,0,3
33607,70,10107,15161,22265,0,0,1,0,1
33608,70,10108,14804;15182;17795;17953;18505,22265,1,2,2,0,5
33609,70,10109,15188;15395,22265,0,0,2,0,2
33610,70,10110,15090;15557,22265,0,0,2,0,2
33611,70,10111,15200,22265,0,0,1,0,1
33612,70,10112,15203,22265,0,0,1,0,1
33613,70,10113,14191;15207,22265,0,0,2,0,2
33614,70,10114,15806,22265,0,0,1,0,1
33615,70,10115,15228;15628;17914;18330;18675,22265,2,1,2,0,5
33616,70,10116,15229;15495,22265,0,0,2,0,2
33617,70,10117,15230;15435;18486,22265,1,0,2,0,3
33618,70,10118,14562;15237,22265,0,0,2,0,2
33619,70,10119,15239;15410,22265,0,0,2,0,2
33620,70,10121,15268;15884;17817;18243,22265,1,1,2,0,4
33621,70,10122,15278;15826;17811;18619,22265,1,1,2,0,4
33622,70,10123,15279;15751,22265,0,0,2,0,2
33623,70,10124,15282;15682;17941;18132,22265,0,2,2,0,4
33624,70,10125,15283;15457;18171;18744,22265,1,1,2,0,4
33625,70,10126,15664;15819,22265,0,0,2,0,2
33626,70,10127,15299;15680;18376,22265,1,0,2,0,3
33627,70,10128,15327;17897,22265,0,1,1,0,2
33628,70,10129,15028;15332;18003;18155,22265,0,2,2,0,4
33629,70,10130,15102;15347;17784;17915,22265,0,2,2,0,4
33630,70,10131,15351;15613;17907,22265,0,1,2,0,3
33631,70,10132,15393,22265,0,0,1,0,1
33632,70,10133,15399;15609;18310;18740,22265,2,0,2,0,4
33633,70,10134,15407;15455;18133;18256,22265,1,1,2,0,4
33634,70,10135,15401;15934;18222;18463,22265,2,0,2,0,4
33635,70,10136,15414;15769;17875;18081,22265,0,2,2,0,4
33636,70,10137,15437;15598,22265,0,0,2,0,2
33637,70,10138,15447;15938;18062,22265,0,1,2,0,3
33638,70,10139,14965;15454;18180;18577,22265,1,1,2,0,4
33639,70,10141,15471;15477;18366,22265,1,0,2,0,3
33640,70,10142,15482,22265,0,0,1,0,1
33641,70,10143,14928;15498;17926;18092,22265,0,2,2,0,4
33642,70,10144,15505;15556;18020,22265,0,1,2,0,3
33643,70,10145,15509;15657;17996;18215,22265,1,1,2,0,4
33644,70,10146,15416;15513,22265,0,0,2,0,2
33645,70,10148,10386,22630,0,0,0,1,1
33646,70,10149,10547,22630,0,0,0,1,1
33647,70,10154,11251,22630,0,0,1,0,1
33648,70,10155,11209,22630,0,0,1,0,1
33649,70,10156,11305,22630,0,0,1,0,1
33650,70,10158,11150;11392,22630,0,0,2,0,2
33651,70,10160,11931,22630,0,0,1,0,1
33652,70,10161,11948,22630,0,0,1,0,1
33653,70,10164,12255,22630,0,0,1,0,1
33654,70,10168,12289,22630,0,0,1,0,1
33655,70,10172,12799,22630,0,0,1,0,1
33656,70,10175,12866;12871,22630,0,0,2,0,2
33657,70,10177,13119,22630,0,0,1,0,1
33658,70,10178,12696;13140,22630,0,0,2,0,2
33659,70,10180,13213,22630,0,0,1,0,1
33660,70,10183,12782;13020,22630,0,0,2,0,2
33661,70,10185,13600,22630,0,0,1,0,1
33662,70,10187,13579;13731;18357,22630,1,0,2,0,3
33663,70,10188,13458;13769;18306;18576,22630,2,0,2,0,4
33664,70,10190,13884;14300,22630,0,0,2,0,2
33665,70,10191,13682,22630,0,0,1,0,1
33666,70,10192,13907;13997,22630,0,0,2,0,2
33667,70,10193,13959;14452,22630,0,0,2,0,2
33668,70,10194,14003,22630,0,0,1,0,1
33669,70,10195,14129;14800,22630,0,0,2,0,2
33670,70,10196,14387;18477,22630,1,0,1,0,2
33671,70,10197,14558;18701,22630,1,0,1,0,2
33672,70,10199,14187;14358,22630,0,0,2,0,2
33673,70,10200,14223;14479;17938;18158,22630,0,2,2,0,4
33674,70,10201,14491,22630,0,0,1,0,1
33675,70,10202,14521;14611;17934,22630,0,1,2,0,3
33676,70,10203,14545;14859,22630,0,0,2,0,2
33677,70,10204,14553,22630,0,0,1,0,1
33678,70,10205,13960;14554,22630,0,0,2,0,2
33679,70,10207,15061;18716,22630,1,0,1,0,2
33680,70,10208,14628;18352;18541,22630,2,0,1,0,3
33681,70,10209,14630;14840;18696,22630,1,0,2,0,3
33682,70,10210,14650,22630,0,0,1,0,1
33683,70,10211,14654;14952;17886;18067;18710,22630,1,2,2,0,5
33684,70,10212,14024;14659;17945;18496,22630,1,1,2,0,4
33685,70,10213,14681;15444,22630,0,0,2,0,2
33686,70,10214,14312;14700,22630,0,0,2,0,2
33687,70,10215,14710;15465,22630,0,0,2,0,2
33688,70,10216,14711;14726;17955;18377,22630,1,1,2,0,4
33689,70,10217,14737;15159,22630,0,0,2,0,2
33690,70,10218,14748;15101;18105,22630,0,1,2,0,3
33691,70,10219,14791;14876;18290,22630,1,0,2,0,3
33692,70,10220,14400,22630,0,0,1,0,1
33693,70,10221,14822;15779;17925;18095,22630,0,2,2,0,4
33694,70,10222,14826;15235,22630,0,0,2,0,2
33695,70,10223,14833;18205,22630,0,1,1,0,2
33696,70,10224,15145;15623,22630,0,0,2,0,2
33697,70,10225,14904;15630,22630,0,0,2,0,2
33698,70,10226,14823;14948,22630,0,0,2,0,2
33699,70,10227,15008;15460;18188;18375,22630,1,1,2,0,4
33700,70,10228,15048;15458;17923;18168;18551;18704,22630,2,2,2,0,6
33701,70,10229,15058;15544,22630,0,0,2,0,2
33702,70,10230,15168,22630,0,0,1,0,1
33703,70,10231,14898,22630,0,0,1,0,1
33704,70,10232,14937;15180;18024;18638,22630,1,1,2,0,4
33705,70,10233,15201;15214,22630,0,0,2,0,2
33706,70,10234,14533;15213,22630,0,0,2,0,2
33707,70,10235,15300;18211,22630,1,0,1,0,2
33708,70,10236,15317;15517,22630,0,0,2,0,2
33709,70,10237,14979;15319;18341,22630,1,0,2,0,3
33710,70,10239,15123;15329;17997;18321,22630,1,1,2,0,4
33711,70,10240,15371,22630,0,0,1,0,1
33712,70,10241,15067;15384;18072,22630,0,1,2,0,3
33713,70,10242,15093;15406,22630,0,0,2,0,2
33714,70,10243,15014;15423;18214,22630,1,0,2,0,3
33715,70,10244,15192;15448,22630,0,0,2,0,2
33716,70,10245,14906;15453;18042;18144,22630,0,2,2,0,4
33717,70,10246,15456;15713;18594,22630,1,0,2,0,3
33718,70,10247,15463;15790,22630,0,0,2,0,2
33719,70,10248,15452;15480;18741,22630,1,0,2,0,3
33720,70,10249,15497;18204;18374,22630,1,1,1,0,3
33721,70,10250,15404;15788,22630,0,0,2,0,2
33722,70,10251,15538;15678;17959;18110;18234,22630,1,2,2,0,5
33723,70,10252,15553;15935;17993,22630,0,1,2,0,3
33724,70,10253,15514;15558,22630,0,0,2,0,2
33725,70,10254,15568;15770,22630,0,0,2,0,2
33726,70,10255,15433;15569,22630,0,0,2,0,2
33727,70,10256,15488;15585,22630,0,0,2,0,2
33728,70,10259,10595;10618,22995,0,0,0,2,2
33729,70,10260,10032,22995,0,0,0,1,1
33730,70,10263,10238,22995,0,0,0,1,1
33731,70,10266,10860;11078,22995,0,0,2,0,2
33732,70,10267,11300;11487,22995,0,0,2,0,2
33733,70,10273,11297;11352,22995,0,0,2,0,2
33734,70,10274,11402,22995,0,0,1,0,1
33735,70,10275,11845,22995,0,0,1,0,1
33736,70,10276,11591;11862,22995,0,0,2,0,2
33737,70,10277,11970,22995,0,0,1,0,1
33738,70,10285,12150,22995,0,0,1,0,1
33739,70,10286,11993,22995,0,0,1,0,1
33740,70,10288,12489,22995,0,0,1,0,1
33741,70,10292,12888,22995,0,0,1,0,1
33742,70,10296,13431,22995,0,0,1,0,1
33743,70,10297,13222;13630,22995,0,0,2,0,2
33744,70,10301,13940,22995,0,0,1,0,1
33745,70,10303,13596;14046;18268;18468,22995,2,0,2,0,4
33746,70,10307,14199;14242,22995,0,0,2,0,2
33747,70,10310,14030;14337;18581,22995,1,0,2,0,3
33748,70,10311,14032;14767,22995,0,0,2,0,2
33749,70,10312,14037,22995,0,0,1,0,1
33750,70,10313,14308;15042;18311,22995,1,0,2,0,3
33751,70,10314,14338;14846,22995,0,0,2,0,2
33752,70,10315,14288;14429,22995,0,0,2,0,2
33753,70,10316,14523,22995,0,0,1,0,1
33754,70,10317,14577,22995,0,0,1,0,1
33755,70,10318,14626;14632,22995,0,0,2,0,2
33756,70,10319,14637;18587,22995,1,0,1,0,2
33757,70,10320,14356;14638,22995,0,0,2,0,2
33758,70,10321,14664;15507;18734,22995,1,0,2,0,3
33759,70,10322,14091;14375;18586,22995,1,0,2,0,3
33760,70,10323,14415;14772;18552;18743,22995,2,0,2,0,4
33761,70,10324,14817;14990;18397;18685,22995,2,0,2,0,4
33762,70,10325,14842;14961;18510;18639,22995,2,0,2,0,4
33763,70,10326,14960;15536,22995,0,0,2,0,2
33764,70,10327,14991;15321,22995,0,0,2,0,2
33765,70,10328,15057;15548,22995,0,0,2,0,2
33766,70,10329,15649;15734,22995,0,0,2,0,2
33767,70,10330,14466;14867,22995,0,0,2,0,2
33768,70,10331,15196;15579;18430;18678,22995,2,0,2,0,4
33769,70,10332,15212;18224,22995,1,0,1,0,2
33770,70,10333,15160;15223,22995,0,0,2,0,2
33771,70,10334,15227;15340;18100,22995,0,1,2,0,3
33772,70,10335,15275;15895,22995,0,0,2,0,2
33773,70,10336,15104;15281,22995,0,0,2,0,2
33774,70,10337,15094;15322,22995,0,0,2,0,2
33775,70,10338,15333;15855;18269,22995,1,0,2,0,3
33776,70,10339,15346;15918;18065,22995,0,1,2,0,3
33777,70,10340,15356;15515;18156,22995,0,1,2,0,3
33778,70,10341,14857;15363,22995,0,0,2,0,2
33779,70,10342,15397;15689,22995,0,0,2,0,2
33780,70,10343,15491;15887,22995,0,0,2,0,2
33781,70,10344,14967;15494;18542,22995,1,0,2,0,3
33782,70,10345,15503;15842;18058;18336,22995,1,1,2,0,4
33783,70,10346,15511;15814,22995,0,0,2,0,2
33784,70,10347,15518;15707,22995,0,0,2,0,2
33785,70,10348,15533;15829;18050;18659,22995,1,1,2,0,4
33786,70,10349,15537;15967;18085,22995,0,1,2,0,3
33787,70,10350,15392;15541,22995,0,0,2,0,2
33788,70,10351,15549;15667,22995,0,0,2,0,2
33789,70,10352,15562;15964,22995,0,0,2,0,2
33790,70,10353,15267;15575;18257;18533,22995,2,0,2,0,4
33791,70,10354,15310;15588;18742,22995,1,0,2,0,3
33792,70,10355,15611;15889;18521,22995,1,0,2,0,3
33793,70,10356,15431;15626;18064;18425,22995,1,1,2,0,4
33794,70,10357,15545;15629;18242,22995,1,0,2,0,3
33795,70,10358,14894;15645;18087;18316,22995,1,1,2,0,4
33796,70,10359,15654;16155;18034,22995,0,1,2,0,3
33797,70,10360,16029;18687,22995,1,0,1,0,2
33798,70,10361,15441;15676;18666,22995,1,0,2,0,3
33799,70,10362,15681;16179;18117,22995,0,1,2,0,3
33800,70,10363,15685;15973;18045;18216;18480,22995,2,1,2,0,5
33801,70,10364,15704;16020;18522;18663,22995,2,0,2,0,4
33802,70,10365,15716,22995,0,0,1,0,1
33803,70,10366,15722;16076,22995,0,0,2,0,2
33804,70,10367,15432;15758;18187;18246,22995,1,1,2,0,4
33805,70,10368,15564;15761,22995,0,0,2,0,2
33806,70,10369,15766;16041,22995,0,0,2,0,2
33807,70,10370,15254;15772,22995,0,0,2,0,2
33808,70,10371,15782,22995,0,0,1,0,1
33809,70,10372,15122;15786,22995,0,0,2,0,2
33810,70,10373,15794;15888,22995,0,0,2,0,2
33811,70,10374,15295;15527,22995,0,0,2,0,2
33812,70,10379,10951;11120,23360,0,0,2,0,2
33813,70,10380,10761,23360,0,0,0,1,1
33814,70,10383,11094;11308,23360,0,0,2,0,2
33815,70,10384,11351,23360,0,0,1,0,1
33816,70,10385,11223,23360,0,0,1,0,1
33817,70,10386,10718,23360,0,0,0,1,1
33818,70,10389,10948,23360,0,0,1,0,1
33819,70,10392,11611,23360,0,0,1,0,1
33820,70,10397,12227,23360,0,0,1,0,1
33821,70,10398,12394,23360,0,0,1,0,1
33822,70,10403,12395,23360,0,0,1,0,1
33823,70,10404,12936,23360,0,0,1,0,1
33824,70,10405,13027,23360,0,0,1,0,1
33825,70,10406,13029;13527,23360,0,0,2,0,2
33826,70,10408,13111,23360,0,0,1,0,1
33827,70,10409,13156,23360,0,0,1,0,1
33828,70,10410,13360;13751,23360,0,0,2,0,2
33829,70,10412,13505,23360,0,0,1,0,1
33830,70,10413,13469,23360,0,0,1,0,1
33831,70,10415,13734;14428,23360,0,0,2,0,2
33832,70,10416,13876;14619,23360,0,0,2,0,2
33833,70,10418,14002;14617,23360,0,0,2,0,2
33834,70,10419,13626,23360,0,0,1,0,1
33835,70,10420,14809;18501,23360,1,0,1,0,2
33836,70,10421,14147;14336,23360,0,0,2,0,2
33837,70,10423,14360,23360,0,0,1,0,1
33838,70,10424,14421,23360,0,0,1,0,1
33839,70,10425,14465;15015,23360,0,0,2,0,2
33840,70,10426,14471;15305,23360,0,0,2,0,2
33841,70,10428,14335;14543,23360,0,0,2,0,2
33842,70,10429,14510;14541,23360,0,0,2,0,2
33843,70,10430,14563;15060,23360,0,0,2,0,2
33844,70,10431,14368;14780,23360,0,0,2,0,2
33845,70,10432,14636;14921;18549,23360,1,0,2,0,3
33846,70,10433,14477;14682,23360,0,0,2,0,2
33847,70,10434,14794;15091,23360,0,0,2,0,2
33848,70,10435,14892;15294,23360,0,0,2,0,2
33849,70,10436,14943,23360,0,0,1,0,1
33850,70,10437,14962;15021;18325,23360,1,0,2,0,3
33851,70,10439,15365;18328;18632,23360,2,0,1,0,3
33852,70,10440,15095;15921;18410,23360,1,0,2,0,3
33853,70,10441,15097;15421;18724,23360,1,0,2,0,3
33854,70,10442,15112;18713,23360,1,0,1,0,2
33855,70,10443,14858;15403;18422,23360,1,0,2,0,3
33856,70,10444,15082;15119,23360,0,0,2,0,2
33857,70,10445,15130;15632;18292,23360,1,0,2,0,3
33858,70,10446,15146;15633,23360,0,0,2,0,2
33859,70,10447,15901,23360,0,0,1,0,1
33860,70,10448,14929;15151,23360,0,0,2,0,2
33861,70,10450,14989;15175,23360,0,0,2,0,2
33862,70,10451,14885;15211;18289,23360,1,0,2,0,3
33863,70,10452,15219;15822,23360,0,0,2,0,2
33864,70,10453,15263;15443;18745,23360,1,0,2,0,3
33865,70,10454,15298;15919,23360,0,0,2,0,2
33866,70,10455,15099;15335;18465;18630,23360,2,0,2,0,4
33867,70,10456,15374;15744,23360,0,0,2,0,2
33868,70,10457,15376;15705;18526,23360,1,0,2,0,3
33869,70,10458,15386;16008;18655,23360,1,0,2,0,3
33870,70,10459,15426;15701;18454,23360,1,0,2,0,3
33871,70,10460,14974;15439,23360,0,0,2,0,2
33872,70,10461,15177;15440;18453;18733,23360,2,0,2,0,4
33873,70,10462,15492;15750;18460;18607,23360,2,0,2,0,4
33874,70,10463,15521;15936;18169;18556,23360,1,1,2,0,4
33875,70,10464,14603;15566,23360,0,0,2,0,2
33876,70,10465,15570;15979,23360,0,0,2,0,2
33877,70,10466,15337;15580;18455;18566,23360,2,0,2,0,4
33878,70,10467,15519;15583;18452,23360,1,0,2,0,3
33879,70,10468,15589;15939,23360,0,0,2,0,2
33880,70,10469,15593;16043,23360,0,0,2,0,2
33881,70,10470,15309;15606,23360,0,0,2,0,2
33882,70,10471,15811;15952;18228;18380,23360,2,0,2,0,4
33883,70,10472,15617;15692,23360,0,0,2,0,2
33884,70,10473,15655;16288;18315,23360,1,0,2,0,3
33885,70,10474,15660;15697;18359;18421,23360,2,0,2,0,4
33886,70,10475,15658;18534,23360,1,0,1,0,2
33887,70,10476,15669;16053,23360,0,0,2,0,2
33888,70,10477,15675;15866,23360,0,0,2,0,2
33889,70,10478,15686;15844;18231;18332,23360,2,0,2,0,4
33890,70,10479,15006;15718,23360,0,0,2,0,2
33891,70,10480,15724;16134;18125,23360,0,1,2,0,3
33892,70,10481,15693;15733,23360,0,0,2,0,2
33893,70,10482,15183;15738,23360,0,0,2,0,2
33894,70,10483,15743;16057,23360,0,0,2,0,2
33895,70,10484,15534;15749,23360,0,0,2,0,2
33896,70,10485,15484;15755,23360,0,0,2,0,2
33897,70,10486,15762;15984,23360,0,0,2,0,2
33898,70,10487,15812;16203,23360,0,0,2,0,2
33899,70,10488,15839;15968;18213;18475;18679,23360,3,0,2,0,5
33900,70,10489,15843;16223;18178,23360,0,1,2,0,3
33901,70,10490,15847;15879,23360,0,0,2,0,2
33902,70,10491,15850;16005,23360,0,0,2,0,2
33903,70,10492,15860;16168;18253,23360,1,0,2,0,3
33904,70,10493,15425;15876,23360,0,0,2,0,2
33905,70,10494,15890;16125;18393,23360,1,0,2,0,3
33906,70,10495,15735;15907,23360,0,0,2,0,2
33907,70,10496,15224;15925,23360,0,0,2,0,2
33908,70,10498,10684,23725,0,0,0,1,1
33909,70,10499,10982,23725,0,0,1,0,1
33910,70,10504,11467;11819,23725,0,0,2,0,2
33911,70,10507,10890,23725,0,0,1,0,1
33912,70,10508,11555,23725,0,0,1,0,1
33913,70,10512,12444,23725,0,0,1,0,1
33914,70,10516,13157,23725,0,0,1,0,1
33915,70,10517,12846,23725,0,0,1,0,1
33916,70,10519,12686;13069,23725,0,0,2,0,2
33917,70,10520,12703,23725,0,0,1,0,1
33918,70,10521,12990,23725,0,0,1,0,1
33919,70,10522,12998,23725,0,0,1,0,1
33920,70,10524,12939,23725,0,0,1,0,1
33921,70,10526,13190,23725,0,0,1,0,1
33922,70,10527,13250,23725,0,0,1,0,1
33923,70,10529,13759;13850,23725,0,0,2,0,2
33924,70,10530,12748,23725,0,0,1,0,1
33925,70,10531,13649,23725,0,0,1,0,1
33926,70,10534,13745;14350,23725,0,0,2,0,2
33927,70,10536,14092;14645;18335;18503,23725,2,0,2,0,4
33928,70,10538,13566,23725,0,0,1,0,1
33929,70,10541,14257;14388,23725,0,0,2,0,2
33930,70,10542,14447;14680,23725,0,0,2,0,2
33931,70,10543,14484;14766,23725,0,0,2,0,2
33932,70,10544,15290,23725,0,0,1,0,1
33933,70,10546,14592,23725,0,0,1,0,1
33934,70,10548,14625;14667,23725,0,0,2,0,2
33935,70,10549,14814;14999;18457;18654,23725,2,0,2,0,4
33936,70,10550,14899;15573,23725,0,0,2,0,2
33937,70,10551,14944;15312;18349,23725,1,0,2,0,3
33938,70,10552,14955;15464,23725,0,0,2,0,2
33939,70,10554,14993;15077,23725,0,0,2,0,2
33940,70,10555,15110,23725,0,0,1,0,1
33941,70,10556,14620;15148,23725,0,0,2,0,2
33942,70,10557,15190;16201,23725,0,0,2,0,2
33943,70,10558,15178;15236;18624,23725,1,0,2,0,3
33944,70,10559,15604;18313;18575,23725,2,0,1,0,3
33945,70,10561,15074;15720,23725,0,0,2,0,2
33946,70,10562,14830,23725,0,0,1,0,1
33947,70,10564,16070;16165,23725,0,0,2,0,2
33948,70,10565,15446;15797,23725,0,0,2,0,2
33949,70,10566,15469;16293;18263,23725,1,0,2,0,3
33950,70,10567,15476;16055,23725,0,0,2,0,2
33951,70,10568,15434;15479;18719,23725,1,0,2,0,3
33952,70,10569,15065;15490,23725,0,0,2,0,2
33953,70,10570,15572;16314;18688,23725,1,0,2,0,3
33954,70,10571,15576;16114,23725,0,0,2,0,2
33955,70,10572,15185;15584,23725,0,0,2,0,2
33956,70,10573,15591;15600,23725,0,0,2,0,2
33957,70,10574,15487;15666,23725,0,0,2,0,2
33958,70,10575,15674;16283,23725,0,0,2,0,2
33959,70,10576,15710;15795,23725,0,0,2,0,2
33960,70,10577,15741;16131;18266;18625,23725,2,0,2,0,4
33961,70,10578,15774;16092,23725,0,0,2,0,2
33962,70,10579,15430;15780,23725,0,0,2,0,2
33963,70,10580,15610,23725,0,0,1,0,1
33964,70,10581,15835;15900,23725,0,0,2,0,2
33965,70,10582,15857;15903,23725,0,0,2,0,2
33966,70,10583,15880;16376;18409;18559,23725,2,0,2,0,4
33967,70,10584,15917;16163;18309;18517;18560,23725,3,0,2,0,5
33968,70,10585,15238;15976,23725,0,0,2,0,2
33969,70,10586,15978;16229;18303;18436,23725,2,0,2,0,4
33970,70,10587,16006;16159;18514,23725,1,0,2,0,3
33971,70,10588,15156;16042,23725,0,0,2,0,2
33972,70,10589,15241;16054;18351,23725,1,0,2,0,3
33973,70,10590,15438;15816,23725,0,0,2,0,2
33974,70,10591,10852;11091,24090,0,0,2,0,2
33975,70,10592,10886,24090,0,0,1,0,1
33976,70,10596,10605,24090,0,0,0,1,1
33977,70,10599,11593,24090,0,0,1,0,1
33978,70,10601,11641,24090,0,0,1,0,1
33979,70,10602,11381,24090,0,0,1,0,1
33980,70,10604,12089,24090,0,0,1,0,1
33981,70,10613,12345,24090,0,0,1,0,1
33982,70,10619,12534;12865,24090,0,0,2,0,2
33983,70,10620,12229,24090,0,0,1,0,1
33984,70,10621,12952,24090,0,0,1,0,1
33985,70,10622,13127,24090,0,0,1,0,1
33986,70,10626,13418,24090,0,0,1,0,1
33987,70,10627,13483,24090,0,0,1,0,1
33988,70,10628,13436,24090,0,0,1,0,1
33989,70,10629,13462;13798,24090,0,0,2,0,2
33990,70,10631,13628,24090,0,0,1,0,1
33991,70,10632,13673,24090,0,0,1,0,1
33992,70,10633,13724,24090,0,0,1,0,1
33993,70,10635,13625,24090,0,0,1,0,1
33994,70,10638,13778;14386,24090,0,0,2,0,2
33995,70,10640,13854;14295,24090,0,0,2,0,2
33996,70,10641,14057,24090,0,0,1,0,1
33997,70,10642,14176,24090,0,0,1,0,1
33998,70,10643,14082,24090,0,0,1,0,1
33999,70,10644,14540,24090,0,0,1,0,1
34000,70,10645,14430;14797,24090,0,0,2,0,2
34001,70,10646,14610,24090,0,0,1,0,1
34002,70,10647,14742,24090,0,0,1,0,1
34003,70,10648,14774;14834,24090,0,0,2,0,2
34004,70,10649,14828;14864;18440,24090,1,0,2,0,3
34005,70,10650,14918;15274;18667,24090,1,0,2,0,3
34006,70,10651,14896,24090,0,0,1,0,1
34007,70,10652,15062,24090,0,0,1,0,1
34008,70,10653,14744;14966,24090,0,0,2,0,2
34009,70,10654,15012,24090,0,0,1,0,1
34010,70,10655,14515;15117,24090,0,0,2,0,2
34011,70,10656,15124;15721;18382,24090,1,0,2,0,3
34012,70,10657,15163;15216,24090,0,0,2,0,2
34013,70,10658,15205;15314,24090,0,0,2,0,2
34014,70,10659,14764;15208;18545,24090,1,0,2,0,3
34015,70,10660,14719,24090,0,0,1,0,1
34016,70,10661,15231;15502,24090,0,0,2,0,2
34017,70,10662,14839;15233,24090,0,0,2,0,2
34018,70,10663,15250;16065,24090,0,0,2,0,2
34019,70,10664,15303;15639,24090,0,0,2,0,2
34020,70,10665,15349;15620,24090,0,0,2,0,2
34021,70,10666,15362;15892,24090,0,0,2,0,2
34022,70,10667,15373,24090,0,0,1,0,1
34023,70,10668,15385;15827,24090,0,0,2,0,2
34024,70,10669,15427;16325,24090,0,0,2,0,2
34025,70,10670,15810;18444;18620,24090,2,0,1,0,3
34026,70,10671,15535;15961,24090,0,0,2,0,2
34027,70,10672,15554;16045,24090,0,0,2,0,2
34028,70,10673,15506;15565,24090,0,0,2,0,2
34029,70,10674,15612;15668,24090,0,0,2,0,2
34030,70,10675,15614;15687;18415;18715,24090,2,0,2,0,4
34031,70,10676,15166;15616,24090,0,0,2,0,2
34032,70,10677,15627;16004,24090,0,0,2,0,2
34033,70,10678,15636;15764,24090,0,0,2,0,2
34034,70,10679,15646;16183,24090,0,0,2,0,2
34035,70,10680,15652;16128,24090,0,0,2,0,2
34036,70,10681,15661,24090,0,0,1,0,1
34037,70,10682,15691;15854,24090,0,0,2,0,2
34038,70,10683,15729;15825,24090,0,0,2,0,2
34039,70,10684,15559;15771,24090,0,0,2,0,2
34040,70,10685,15784;15817,24090,0,0,2,0,2
34041,70,10686,15789;15970,24090,0,0,2,0,2
34042,70,10687,15809;16028,24090,0,0,2,0,2
34043,70,10688,15824;16071,24090,0,0,2,0,2
34044,70,10689,15619;15831,24090,0,0,2,0,2
34045,70,10690,15856;16171,24090,0,0,2,0,2
34046,70,10691,15881;16021,24090,0,0,2,0,2
34047,70,10692,15911;16226,24090,0,0,2,0,2
34048,70,10693,15912;16393;18339;18525;18569,24090,3,0,2,0,5
34049,70,10694,15922;16186,24090,0,0,2,0,2
34050,70,10695,15924;16278,24090,0,0,2,0,2
34051,70,10696,15926;15997,24090,0,0,2,0,2
34052,70,10697,15927;16405;18516;18726,24090,2,0,2,0,4
34053,70,10698,16003;16471;18599,24090,1,0,2,0,3
34054,70,10699,16073;16147,24090,0,0,2,0,2
34055,70,10700,15885;16022;18553,24090,1,0,2,0,3
34056,70,10701,15198;16023,24090,0,0,2,0,2
34057,70,10702,16030;18363;18548,24090,2,0,1,0,3
34058,70,10703,16039;16236,24090,0,0,2,0,2
34059,70,10704,15690;16227,24090,0,0,2,0,2
34060,70,10705,16250,24090,0,0,1,0,1
34061,70,10706,16050;16195;18711,24090,1,0,2,0,3
34062,70,10707,16080;16087,24090,0,0,2,0,2
34063,70,10708,16105;16309,24090,0,0,2,0,2
34064,70,10709,16121;16479;18318;18602;18731,24090,3,0,2,0,5
34065,70,10710,15875;16122;18661,24090,1,0,2,0,3
34066,70,10711,15731;16140,24090,0,0,2,0,2
34067,70,10712,16146;16440,24090,0,0,2,0,2
34068,70,10713,16061;16148;18530,24090,1,0,2,0,3
34069,70,10714,11383,24455,0,0,1,0,1
34070,70,10715,11403,24455,0,0,1,0,1
34071,70,10718,11020,24455,0,0,1,0,1
34072,70,10719,11588,24455,0,0,1,0,1
34073,70,10722,12012,24455,0,0,1,0,1
34074,70,10724,12226,24455,0,0,1,0,1
34075,70,10725,12330,24455,0,0,1,0,1
34076,70,10726,12153,24455,0,0,1,0,1
34077,70,10727,12578;12659,24455,0,0,2,0,2
34078,70,10728,13026;13086,24455,0,0,2,0,2
34079,70,10733,13356,24455,0,0,1,0,1
34080,70,10734,13075;13744,24455,0,0,2,0,2
34081,70,10735,13039,24455,0,0,1,0,1
34082,70,10736,13799,24455,0,0,1,0,1
34083,70,10737,13615,24455,0,0,1,0,1
34084,70,10739,14114;14436,24455,0,0,2,0,2
34085,70,10741,14157,24455,0,0,1,0,1
34086,70,10744,14261,24455,0,0,1,0,1
34087,70,10745,14010;14537,24455,0,0,2,0,2
34088,70,10746,14607,24455,0,0,1,0,1
34089,70,10747,14644;15036,24455,0,0,2,0,2
34090,70,10749,15326,24455,0,0,1,0,1
34091,70,10750,14097;14806,24455,0,0,2,0,2
34092,70,10751,14837;15246,24455,0,0,2,0,2
34093,70,10752,14913,24455,0,0,1,0,1
34094,70,10753,15313,24455,0,0,1,0,1
34095,70,10754,15096;15708,24455,0,0,2,0,2
34096,70,10755,14673;15158,24455,0,0,2,0,2
34097,70,10756,15193,24455,0,0,1,0,1
34098,70,10758,14672;15105,24455,0,0,2,0,2
34099,70,10759,15242;15603,24455,0,0,2,0,2
34100,70,10760,15255;15886,24455,0,0,2,0,2
34101,70,10761,15271;15467,24455,0,0,2,0,2
34102,70,10762,14657;15273;18423;18583,24455,2,0,2,0,4
34103,70,10763,15292;15328;18732,24455,1,0,2,0,3
34104,70,10764,15087;15581,24455,0,0,2,0,2
34105,70,10765,15398;15459,24455,0,0,2,0,2
34106,70,10766,15419,24455,0,0,1,0,1
34107,70,10767,15510;15930;18419,24455,1,0,2,0,3
34108,70,10768,15624;15915;18627,24455,1,0,2,0,3
34109,70,10769,15472;15638;18668,24455,1,0,2,0,3
34110,70,10770,15673;15778,24455,0,0,2,0,2
34111,70,10771,15695;16118,24455,0,0,2,0,2
34112,70,10772,15699;15869;18702,24455,1,0,2,0,3
34113,70,10773,15746;16037,24455,0,0,2,0,2
34114,70,10774,15756;15931,24455,0,0,2,0,2
34115,70,10775,15760;15803,24455,0,0,2,0,2
34116,70,10776,15767;16455,24455,0,0,2,0,2
34117,70,10777,15783;16199,24455,0,0,2,0,2
34118,70,10778,15791;16097,24455,0,0,2,0,2
34119,70,10779,15799;15838,24455,0,0,2,0,2
34120,70,10780,15818;16007,24455,0,0,2,0,2
34121,70,10781,15882;15905,24455,0,0,2,0,2
34122,70,10782,15615;15883,24455,0,0,2,0,2
34123,70,10783,15897;16160,24455,0,0,2,0,2
34124,70,10784,15595;15928,24455,0,0,2,0,2
34125,70,10785,15950;16101,24455,0,0,2,0,2
34126,70,10786,15962;16579;18437,24455,1,0,2,0,3
34127,70,10787,15987;16391,24455,0,0,2,0,2
34128,70,10788,15996;16313,24455,0,0,2,0,2
34129,70,10789,16017;16033,24455,0,0,2,0,2
34130,70,10790,16066;16200;18610,24455,1,0,2,0,3
34131,70,10791,15429;16069;18506,24455,1,0,2,0,3
34132,70,10792,16102;16637;18605,24455,1,0,2,0,3
34133,70,10793,16116;16412;18609,24455,1,0,2,0,3
34134,70,10794,16164;16548,24455,0,0,2,0,2
34135,70,10795,16193;16255,24455,0,0,2,0,2
34136,70,10796,15940;16221;18519,24455,1,0,2,0,3
34137,70,10797,16225;16660;18485,24455,1,0,2,0,3
34138,70,10798,16241;16281,24455,0,0,2,0,2
34139,70,10799,16254;16643;18529;18693,24455,2,0,2,0,4
34140,70,10800,15694;16272,24455,0,0,2,0,2
34141,70,10801,11066,24820,0,0,1,0,1
34142,70,10802,10947,24820,0,0,1,0,1
34143,70,10803,11036,24820,0,0,1,0,1
34144,70,10804,11425,24820,0,0,1,0,1
34145,70,10805,11451,24820,0,0,1,0,1
34146,70,10806,11389,24820,0,0,1,0,1
34147,70,10807,11574,24820,0,0,1,0,1
34148,70,10809,11201;11445,24820,0,0,2,0,2
34149,70,10811,11773,24820,0,0,1,0,1
34150,70,10812,11816,24820,0,0,1,0,1
34151,70,10813,11664,24820,0,0,1,0,1
34152,70,10814,12236,24820,0,0,1,0,1
34153,70,10818,12485,24820,0,0,1,0,1
34154,70,10820,12386,24820,0,0,1,0,1
34155,70,10821,12717;12802,24820,0,0,2,0,2
34156,70,10822,12756,24820,0,0,1,0,1
34157,70,10823,12913,24820,0,0,1,0,1
34158,70,10824,12981,24820,0,0,1,0,1
34159,70,10825,13044,24820,0,0,1,0,1
34160,70,10826,13468,24820,0,0,1,0,1
34161,70,10827,13725,24820,0,0,1,0,1
34162,70,10828,13829;13987,24820,0,0,2,0,2
34163,70,10829,13937,24820,0,0,1,0,1
34164,70,10830,13943,24820,0,0,1,0,1
34165,70,10831,14044,24820,0,0,1,0,1
34166,70,10832,14087,24820,0,0,1,0,1
34167,70,10833,13257,24820,0,0,1,0,1
34168,70,10834,14111;14145,24820,0,0,2,0,2
34169,70,10835,14170;14325,24820,0,0,2,0,2
34170,70,10836,14182;14440,24820,0,0,2,0,2
34171,70,10837,14304,24820,0,0,1,0,1
34172,70,10838,14441;15049,24820,0,0,2,0,2
34173,70,10839,14382;14473,24820,0,0,2,0,2
34174,70,10840,14459,24820,0,0,1,0,1
34175,70,10841,14488;15307,24820,0,0,2,0,2
34176,70,10842,14230,24820,0,0,1,0,1
34177,70,10843,14472,24820,0,0,1,0,1
34178,70,10844,13962;14635,24820,0,0,2,0,2
34179,70,10845,14686;15586,24820,0,0,2,0,2
34180,70,10846,14692;15129,24820,0,0,2,0,2
34181,70,10847,13832;14410,24820,0,0,2,0,2
34182,70,10848,14446;15009,24820,0,0,2,0,2
34183,70,10849,14392,24820,0,0,1,0,1
34184,70,10850,14593,24820,0,0,1,0,1
34185,70,10851,14271,24820,0,0,1,0,1
34186,70,10852,14844,24820,0,0,1,0,1
34187,70,10853,14877;14880,24820,0,0,2,0,2
34188,70,10854,14432;14912;18730,24820,1,0,2,0,3
34189,70,10855,15005,24820,0,0,1,0,1
34190,70,10856,14738;15169,24820,0,0,2,0,2
34191,70,10857,14691,24820,0,0,1,0,1
34192,70,10858,14734;15184,24820,0,0,2,0,2
34193,70,10859,15172;15258,24820,0,0,2,0,2
34194,70,10860,15269;15820,24820,0,0,2,0,2
34195,70,10861,15284;16174,24820,0,0,2,0,2
34196,70,10862,14497,24820,0,0,1,0,1
34197,70,10863,15343;15389;18642,24820,1,0,2,0,3
34198,70,10864,15045;15360,24820,0,0,2,0,2
34199,70,10865,15108;15388,24820,0,0,2,0,2
34200,70,10866,15353;15483,24820,0,0,2,0,2
34201,70,10867,14835,24820,0,0,1,0,1
34202,70,10868,15499;15993,24820,0,0,2,0,2
34203,70,10869,15540;15834,24820,0,0,2,0,2
34204,70,10870,15424;18604,24820,1,0,1,0,2
34205,70,10871,15594;15836;18684,24820,1,0,2,0,3
34206,70,10872,15621,24820,0,0,1,0,1
34207,70,10873,15071,24820,0,0,1,0,1
34208,70,10874,15672;16228,24820,0,0,2,0,2
34209,70,10875,15712;16095,24820,0,0,2,0,2
34210,70,10876,15736;16386,24820,0,0,2,0,2
34211,70,10877,15542;15742,24820,0,0,2,0,2
34212,70,10878,16107,24820,0,0,1,0,1
34213,70,10879,15656;15804,24820,0,0,2,0,2
34214,70,10880,15807;15841,24820,0,0,2,0,2
34215,70,10881,15832;16392,24820,0,0,2,0,2
34216,70,10882,15740;15837;18582,24820,1,0,2,0,3
34217,70,10883,15846;16126,24820,0,0,2,0,2
34218,70,10884,16181,24820,0,0,1,0,1
34219,70,10885,15891,24820,0,0,1,0,1
34220,70,10886,15908;16106,24820,0,0,2,0,2
34221,70,10887,15932;15969,24820,0,0,2,0,2
34222,70,10888,15983,24820,0,0,1,0,1
34223,70,10889,15986;16248,24820,0,0,2,0,2
34224,70,10890,15990;16109,24820,0,0,2,0,2
34225,70,10891,15999;16511;18706,24820,1,0,2,0,3
34226,70,10892,15698;16012,24820,0,0,2,0,2
34227,70,10893,16049;16286;18543,24820,1,0,2,0,3
34228,70,10894,16112;16135,24820,0,0,2,0,2
34229,70,10895,16117;16552,24820,0,0,2,0,2
34230,70,10896,15943;16145,24820,0,0,2,0,2
34231,70,10897,15916;16151,24820,0,0,2,0,2
34232,70,10898,15524;16156;18590,24820,1,0,2,0,3
34233,70,10899,16196;16289,24820,0,0,2,0,2
34234,70,10900,16205;16754;18720,24820,1,0,2,0,3
34235,70,10901,16048,24820,0,0,1,0,1
34236,70,10902,16230;16501,24820,0,0,2,0,2
34237,70,10903,16211;16243,24820,0,0,2,0,2
34238,70,10904,16142;16246,24820,0,0,2,0,2
34239,70,10905,16264;16494,24820,0,0,2,0,2
34240,70,10906,16483,24820,0,0,1,0,1
34241,70,10907,16345;16454,24820,0,0,2,0,2
34242,70,10908,16352;16570;18615,24820,1,0,2,0,3
34243,70,10909,16369,24820,0,0,1,0,1
34244,70,10910,16082;16373,24820,0,0,2,0,2
34245,70,10911,16378,24820,0,0,1,0,1
34246,70,10912,16409;16535,24820,0,0,2,0,2
34247,70,10913,16410;16739;18565,24820,1,0,2,0,3
34248,70,10914,16434;16771,24820,0,0,2,0,2
34249,70,10915,16438;16467,24820,0,0,2,0,2
34250,70,10916,11254,25185,0,0,1,0,1
34251,70,10917,11282,25185,0,0,1,0,1
34252,70,10918,10992,25185,0,0,1,0,1
34253,70,10919,11360,25185,0,0,1,0,1
34254,70,10921,11813,25185,0,0,1,0,1
34255,70,10922,11621,25185,0,0,1,0,1
34256,70,10923,11637,25185,0,0,1,0,1
34257,70,10924,11986,25185,0,0,1,0,1
34258,70,10925,12168,25185,0,0,1,0,1
34259,70,10926,12266,25185,0,0,1,0,1
34260,70,10927,12320,25185,0,0,1,0,1
34261,70,10928,12408,25185,0,0,1,0,1
34262,70,10931,12700,25185,0,0,1,0,1
34263,70,10932,12605,25185,0,0,1,0,1
34264,70,10934,12890,25185,0,0,1,0,1
34265,70,10935,12886;12984,25185,0,0,2,0,2
34266,70,10936,12514,25185,0,0,1,0,1
34267,70,10937,13051,25185,0,0,1,0,1
34268,70,10938,13133,25185,0,0,1,0,1
34269,70,10939,13405,25185,0,0,1,0,1
34270,70,10942,13040,25185,0,0,1,0,1
34271,70,10943,13532,25185,0,0,1,0,1
34272,70,10944,13275,25185,0,0,1,0,1
34273,70,10945,13612,25185,0,0,1,0,1
34274,70,10946,13509,25185,0,0,1,0,1
34275,70,10947,13690,25185,0,0,1,0,1
34276,70,10948,13556,25185,0,0,1,0,1
34277,70,10949,13985,25185,0,0,1,0,1
34278,70,10950,14148,25185,0,0,1,0,1
34279,70,10951,14209;14701,25185,0,0,2,0,2
34280,70,10952,14946,25185,0,0,1,0,1
34281,70,10953,14181,25185,0,0,1,0,1
34282,70,10954,13841,25185,0,0,1,0,1
34283,70,10955,14544,25185,0,0,1,0,1
34284,70,10956,14550;14860;18682,25185,1,0,2,0,3
34285,70,10957,14572,25185,0,0,1,0,1
34286,70,10958,14586,25185,0,0,1,0,1
34287,70,10959,14634;14745,25185,0,0,2,0,2
34288,70,10962,14868,25185,0,0,1,0,1
34289,70,10963,14883,25185,0,0,1,0,1
34290,70,10964,14736,25185,0,0,1,0,1
34291,70,10965,14925;15367,25185,0,0,2,0,2
34292,70,10966,14414;14677,25185,0,0,2,0,2
34293,70,10967,15115,25185,0,0,1,0,1
34294,70,10968,15139;15355,25185,0,0,2,0,2
34295,70,10969,15272,25185,0,0,1,0,1
34296,70,10970,15336,25185,0,0,1,0,1
34297,70,10971,14874;15344,25185,0,0,2,0,2
34298,70,10972,15209;15402;18634,25185,1,0,2,0,3
34299,70,10973,15445;15868,25185,0,0,2,0,2
34300,70,10974,15529;15870,25185,0,0,2,0,2
34301,70,10975,15561;16185,25185,0,0,2,0,2
34302,70,10976,15563;16177,25185,0,0,2,0,2
34303,70,10977,15574,25185,0,0,1,0,1
34304,70,10978,15601;16032;18636,25185,1,0,2,0,3
34305,70,10979,15243,25185,0,0,1,0,1
34306,70,10980,15648;15871,25185,0,0,2,0,2
34307,70,10981,15560;15651,25185,0,0,2,0,2
34308,70,10982,15450;15662,25185,0,0,2,0,2
34309,70,10983,15714,25185,0,0,1,0,1
34310,70,10984,15753;16216,25185,0,0,2,0,2
34311,70,10985,15801;16013,25185,0,0,2,0,2
34312,70,10986,15805;15965,25185,0,0,2,0,2
34313,70,10987,15222;15865,25185,0,0,2,0,2
34314,70,10988,15470;15947,25185,0,0,2,0,2
34315,70,10989,15955;16531;18721,25185,1,0,2,0,3
34316,70,10990,14819,25185,0,0,1,0,1
34317,70,10991,15848;16014,25185,0,0,2,0,2
34318,70,10992,16019;16136,25185,0,0,2,0,2
34319,70,10993,15971;16026,25185,0,0,2,0,2
34320,70,10994,15765;16027,25185,0,0,2,0,2
34321,70,10995,15608;16059,25185,0,0,2,0,2
34322,70,10996,16068;16413,25185,0,0,2,0,2
34323,70,10997,16083,25185,0,0,1,0,1
34324,70,10998,16088,25185,0,0,1,0,1
34325,70,10999,16091,25185,0,0,1,0,1
34326,70,11000,16034;16093,25185,0,0,2,0,2
34327,70,11001,15577;16110,25185,0,0,2,0,2
34328,70,11002,16124;16251,25185,0,0,2,0,2
34329,70,11003,16153;16444,25185,0,0,2,0,2
34330,70,11004,15859,25185,0,0,1,0,1
34331,70,11005,16212;16380,25185,0,0,2,0,2
34332,70,11006,16222;16498,25185,0,0,2,0,2
34333,70,11007,16240;16753,25185,0,0,2,0,2
34334,70,11008,16244;16586;18670,25185,1,0,2,0,3
34335,70,11009,15830;16245,25185,0,0,2,0,2
34336,70,11010,15941;16263,25185,0,0,2,0,2
34337,70,11011,16120;16269,25185,0,0,2,0,2
34338,70,11012,16187;16298;18705,25185,1,0,2,0,3
34339,70,11013,16301;16779,25185,0,0,2,0,2
34340,70,11014,16302;16772,25185,0,0,2,0,2
34341,70,11015,16318;16599,25185,0,0,2,0,2
34342,70,11016,16336;16559,25185,0,0,2,0,2
34343,70,11017,16340,25185,0,0,1,0,1
34344,70,11018,16349;16841;18653,25185,1,0,2,0,3
34345,70,11019,16384;16504,25185,0,0,2,0,2
34346,70,11020,16422;16429,25185,0,0,2,0,2
34347,70,11021,16423;16485,25185,0,0,2,0,2
34348,70,11022,16115;16428,25185,0,0,2,0,2
34349,70,11023,16432;16536,25185,0,0,2,0,2
34350,70,11024,16010;16437;18692,25185,1,0,2,0,3
34351,70,11025,16446;16560,25185,0,0,2,0,2
34352,70,11026,16377;16457,25185,0,0,2,0,2
34353,70,11027,16458,25185,0,0,1,0,1
34354,70,11028,16480;16625,25185,0,0,2,0,2
34355,70,11029,16327,25185,0,0,1,0,1
34356,70,11030,16489;16493,25185,0,0,2,0,2
34357,70,11031,16519;16601,25185,0,0,2,0,2
34358,70,11032,16277;16549,25185,0,0,2,0,2
34359,70,11033,16439;16553,25185,0,0,2,0,2
34360,70,11034,11027,25550,0,0,1,0,1
34361,70,11035,11362,25550,0,0,1,0,1
34362,70,11036,11473,25550,0,0,1,0,1
34363,70,11037,11501,25550,0,0,1,0,1
34364,70,11038,11600,25550,0,0,1,0,1
34365,70,11039,11169,25550,0,0,1,0,1
34366,70,11041,11569,25550,0,0,1,0,1
34367,70,11042,11899,25550,0,0,1,0,1
34368,70,11043,11775,25550,0,0,1,0,1
34369,70,11044,11964,25550,0,0,1,0,1
34370,70,11045,11909,25550,0,0,1,0,1
34371,70,11046,12038,25550,0,0,1,0,1
34372,70,11047,12110,25550,0,0,1,0,1
34373,70,11048,12027,25550,0,0,1,0,1
34374,70,11049,11941,25550,0,0,1,0,1
34375,70,11050,12200,25550,0,0,1,0,1
34376,70,11051,12243,25550,0,0,1,0,1
34377,70,11052,12545,25550,0,0,1,0,1
34378,70,11053,12546,25550,0,0,1,0,1
34379,70,11054,12202,25550,0,0,1,0,1
34380,70,11055,12751,25550,0,0,1,0,1
34381,70,11056,12642,25550,0,0,1,0,1
34382,70,11057,13006,25550,0,0,1,0,1
34383,70,11058,13043,25550,0,0,1,0,1
34384,70,11059,13066,25550,0,0,1,0,1
34385,70,11060,12793,25550,0,0,1,0,1
34386,70,11061,13224,25550,0,0,1,0,1
34387,70,11063,13381,25550,0,0,1,0,1
34388,70,11064,13453,25550,0,0,1,0,1
34389,70,11065,13239,25550,0,0,1,0,1
34390,70,11066,13644,25550,0,0,1,0,1
34391,70,11067,12704,25550,0,0,1,0,1
34392,70,11068,13679,25550,0,0,1,0,1
34393,70,11069,13729,25550,0,0,1,0,1
34394,70,11070,13293,25550,0,0,1,0,1
34395,70,11071,13793,25550,0,0,1,0,1
34396,70,11072,13716,25550,0,0,1,0,1
34397,70,11073,13797,25550,0,0,1,0,1
34398,70,11074,13897,25550,0,0,1,0,1
34399,70,11075,13903,25550,0,0,1,0,1
34400,70,11076,13908,25550,0,0,1,0,1
34401,70,11077,13918,25550,0,0,1,0,1
34402,70,11080,14310,25550,0,0,1,0,1
34403,70,11081,14249,25550,0,0,1,0,1
34404,70,11082,13917;14401,25550,0,0,2,0,2
34405,70,11083,14560,25550,0,0,1,0,1
34406,70,11085,14172,25550,0,0,1,0,1
34407,70,11086,14565,25550,0,0,1,0,1
34408,70,11087,14881;15828,25550,0,0,2,0,2
34409,70,11088,14931,25550,0,0,1,0,1
34410,70,11089,15157,25550,0,0,1,0,1
34411,70,11090,14940,25550,0,0,1,0,1
34412,70,11091,14996,25550,0,0,1,0,1
34413,70,11092,15010,25550,0,0,1,0,1
34414,70,11093,14434;15069,25550,0,0,2,0,2
34415,70,11094,14728;15114,25550,0,0,2,0,2
34416,70,11095,15136,25550,0,0,1,0,1
34417,70,11096,15150;15199,25550,0,0,2,0,2
34418,70,11097,14871,25550,0,0,1,0,1
34419,70,11098,15232;15354,25550,0,0,2,0,2
34420,70,11099,14947,25550,0,0,1,0,1
34421,70,11100,15127;15291,25550,0,0,2,0,2
34422,70,11101,15400;16150,25550,0,0,2,0,2
34423,70,11102,15417,25550,0,0,1,0,1
34424,70,11103,15504,25550,0,0,1,0,1
34425,70,11104,15543;16002,25550,0,0,2,0,2
34426,70,11105,15339;15587,25550,0,0,2,0,2
34427,70,11106,15677,25550,0,0,1,0,1
34428,70,11107,15723;15989,25550,0,0,2,0,2
34429,70,11108,15730;16178,25550,0,0,2,0,2
34430,70,11109,15739;16287,25550,0,0,2,0,2
34431,70,11110,15852;16108,25550,0,0,2,0,2
34432,70,11111,15149,25550,0,0,1,0,1
34433,70,11112,15977,25550,0,0,1,0,1
34434,70,11113,16096,25550,0,0,1,0,1
34435,70,11114,16009,25550,0,0,1,0,1
34436,70,11115,15700;16011,25550,0,0,2,0,2
34437,70,11116,15372,25550,0,0,1,0,1
34438,70,11117,15988,25550,0,0,1,0,1
34439,70,11118,15717,25550,0,0,1,0,1
34440,70,11119,16133;16741,25550,0,0,2,0,2
34441,70,11120,16143;16162,25550,0,0,2,0,2
34442,70,11121,16169,25550,0,0,1,0,1
34443,70,11122,16188,25550,0,0,1,0,1
34444,70,11123,16202;16652,25550,0,0,2,0,2
34445,70,11124,15531;16204,25550,0,0,2,0,2
34446,70,11125,16206;16619,25550,0,0,2,0,2
34447,70,11126,15325;16207,25550,0,0,2,0,2
34448,70,11127,16234;16634,25550,0,0,2,0,2
34449,70,11128,16170;16249,25550,0,0,2,0,2
34450,70,11129,16252;17062,25550,0,1,1,0,2
34451,70,11130,16262;16610,25550,0,0,2,0,2
34452,70,11131,15567;16290,25550,0,0,2,0,2
34453,70,11132,16294;16518,25550,0,0,2,0,2
34454,70,11133,16303;17063,25550,0,1,1,0,2
34455,70,11134,16307;16683,25550,0,0,2,0,2
34456,70,11135,16280;16337,25550,0,0,2,0,2
34457,70,11136,15873;16339,25550,0,0,2,0,2
34458,70,11137,15851;16343,25550,0,0,2,0,2
34459,70,11138,16362,25550,0,0,1,0,1
34460,70,11139,16237;16375,25550,0,0,2,0,2
34461,70,11140,16418;16644,25550,0,0,2,0,2
34462,70,11141,16430;16822,25550,0,0,2,0,2
34463,70,11142,16072;16456,25550,0,0,2,0,2
34464,70,11143,16512;16722,25550,0,0,2,0,2
34465,70,11144,16528;16612,25550,0,0,2,0,2
34466,70,11145,16175;16537,25550,0,0,2,0,2
34467,70,11146,16544;16888,25550,0,0,2,0,2
34468,70,11147,16419;16562,25550,0,0,2,0,2
34469,70,11148,16576;16782,25550,0,0,2,0,2
34470,70,11149,16584;16662,25550,0,0,2,0,2
34471,70,11150,16329;16603,25550,0,0,2,0,2
34472,70,11151,16606;16931,25550,0,0,2,0,2
34473,70,11152,16074;16616,25550,0,0,2,0,2
34474,70,11153,16640;16936,25550,0,0,2,0,2
34475,70,11154,16648;16904,25550,0,0,2,0,2
34476,70,11155,16649;16791,25550,0,0,2,0,2
34477,70,11156,16529;16650,25550,0,0,2,0,2
34478,70,11157,16317;16663,25550,0,0,2,0,2
34479,70,11158,16673;17060,25550,0,1,1,0,2
34480,70,11159,16253;16675,25550,0,0,2,0,2
34481,80,4,4056,0,0,0,0,1,1
34482,80,28,90;1720;4946,0,0,0,0,3,3
34483,80,36,9316,0,0,0,0,1,1
34484,80,93,10284,0,0,0,0,1,1
34485,80,179,493,0,0,0,0,1,1
34486,80,227,1307,0,0,0,0,1,1
34487,80,297,1545;7780,0,0,0,0,2,2
34488,80,350,921;7150,0,0,0,0,2,2
34489,80,393,7724;10077,0,0,0,0,2,2
34490,80,440,1164,0,0,0,0,1,1
34491,80,478,1260;3503,0,0,0,0,2,2
34492,80,509,1345,0,0,0,0,1,1
34493,80,522,1382;10019,0,0,0,0,2,2
34494,80,553,7690,0,0,0,0,1,1
34495,80,556,1461;10121;10343,0,0,0,0,3,3
34496,80,598,1577,0,0,0,0,1,1
34497,80,641,1694,0,0,0,0,1,1
34498,80,661,3842,0,0,0,0,1,1
34499,80,667,7499,0,0,0,0,1,1
34500,80,786,8886,0,0,0,0,1,1
34501,80,813,2123,0,0,0,0,1,1
34502,80,886,2321;2323,0,0,0,0,2,2
34503,80,919,2418,0,0,0,0,1,1
34504,80,951,9585,0,0,0,0,1,1
34505,80,990,8649,0,0,0,0,1,1
34506,80,991,12019;12508,0,0,0,2,0,2
34507,80,1045,2738,0,0,0,0,1,1
34508,80,1062,6561;7177,0,0,0,0,2,2
34509,80,1156,9819,0,0,0,0,1,1
34510,80,1168,10666;10804;11050;11210;11214;11426,0,0,0,0,6,6
34511,80,1191,3141;8721,0,0,0,0,2,2
34512,80,1258,3901,0,0,0,0,1,1
34513,80,1275,3356,0,0,0,0,1,1
34514,80,1285,6955,0,0,0,0,1,1
34515,80,1375,10685,0,0,0,0,1,1
34516,80,1421,3753,0,0,0,0,1,1
34517,80,1468,3880,0,0,0,0,1,1
34518,80,1551,4091;9750,0,0,0,0,2,2
34519,80,1577,4150;4151;5311;7316,0,0,0,0,4,4
34520,80,1627,4268;6845,0,0,0,0,2,2
34521,80,1725,4516,0,0,0,0,1,1
34522,80,1784,4669,0,0,0,0,1,1
34523,80,1796,1049,0,0,0,0,1,1
34524,80,1872,4899,0,0,0,0,1,1
34525,80,1915,5016,0,0,0,0,1,1
34526,80,1972,5156,0,0,0,0,1,1
34527,80,2005,5249,0,0,0,0,1,1
34528,80,2068,7143,0,0,0,0,1,1
34529,80,2090,5460,0,0,0,0,1,1
34530,80,2291,3592;5930,0,0,0,0,2,2
34531,80,2317,10315,0,0,0,0,1,1
34532,80,2399,11519;11804,0,0,0,0,2,2
34533,80,2418,11158,0,0,0,0,1,1
34534,80,2431,5603,0,0,0,0,1,1
34535,80,2479,8099,0,0,0,0,1,1
34536,80,2503,6470,0,0,0,0,1,1
34537,80,2569,3699,0,0,0,0,1,1
34538,80,2596,765,0,0,0,0,1,1
34539,80,2638,11894;12333;16697,0,0,0,3,0,3
34540,80,2643,10565,0,0,0,0,1,1
34541,80,2648,6848;6849,0,0,0,0,2,2
34542,80,2764,8592,0,0,0,0,1,1
34543,80,2766,9042,0,0,0,0,1,1
34544,80,2787,7203,0,0,0,0,1,1
34545,80,2867,7395,0,0,0,0,1,1
34546,80,2885,1622,0,0,0,0,1,1
34547,80,2919,9666,0,0,0,0,1,1
34548,80,2925,2855,0,0,0,0,1,1
34549,80,2942,7596,0,0,0,0,1,1
34550,80,3022,10115,0,0,0,0,1,1
34551,80,3056,1334,0,0,0,0,1,1
34552,80,3081,10013,0,0,0,0,1,1
34553,80,3132,4075;8076,0,0,0,0,2,2
34554,80,3212,10021,0,0,0,0,1,1
34555,80,3420,5615,0,0,0,0,1,1
34556,80,3432,5458,0,0,0,0,1,1
34557,80,3435,3256,0,0,0,0,1,1
34558,80,3469,8949,0,0,0,0,1,1
34559,80,3479,8100;8978,0,0,0,0,2,2
34560,80,3539,9138,0,0,0,0,1,1
34561,80,3646,10820,0,0,0,0,1,1
34562,80,3687,9519,0,0,0,0,1,1
34563,80,3710,9580,0,0,0,0,1,1
34564,80,3750,3201,0,0,0,0,1,1
34565,80,3752,179;9688,0,0,0,0,2,2
34566,80,3769,3420;9736,0,0,0,0,2,2
34567,80,3771,5433;9742,0,0,0,0,2,2
34568,80,3774,8984,0,0,0,0,1,1
34569,80,3817,10983;11082;11745,0,0,0,0,3,3
34570,80,3822,8270;9888,0,0,0,0,2,2
34571,80,3860,2524;9986;9987,0,0,0,0,3,3
34572,80,3967,459,365,0,0,0,1,1
34573,80,4004,11904;15631,365,0,0,2,0,2
34574,80,4016,3062,365,0,0,0,1,1
34575,80,4048,6184,730,0,0,0,1,1
34576,80,4053,2949,730,0,0,0,1,1
34577,80,4062,3560,730,0,0,0,1,1
34578,80,4067,12463;12752,730,0,0,2,0,2
34579,80,4145,11617;11623,730,0,0,0,2,2
34580,80,4172,38,1095,0,0,0,1,1
34581,80,4179,1212,1095,0,0,0,1,1
34582,80,4202,4015,1095,0,0,0,1,1
34583,80,4234,3759,1095,0,0,0,1,1
34584,80,4248,6837,1095,0,0,0,1,1
34585,80,4257,6982,1095,0,0,0,1,1
34586,80,4276,8859,1095,0,0,0,1,1
34587,80,4287,12083,1095,0,0,1,0,1
34588,80,4303,7604,1460,0,0,0,1,1
34589,80,4312,7825,1460,0,0,0,1,1
34590,80,4320,4756,1460,0,0,0,1,1
34591,80,4345,2232,1460,0,0,0,1,1
34592,80,4347,1250,1460,0,0,0,1,1
34593,80,4360,6586,1460,0,0,0,1,1
34594,80,4413,7419,1460,0,0,0,1,1
34595,80,4430,642,1825,0,0,0,1,1
34596,80,4454,1151,1825,0,0,0,1,1
34597,80,4455,4046,1825,0,0,0,1,1
34598,80,4470,8552,1825,0,0,0,1,1
34599,80,4505,6582,1825,0,0,0,1,1
34600,80,4508,5448,1825,0,0,0,1,1
34601,80,4531,9368,1825,0,0,0,1,1
34602,80,4585,8388,2190,0,0,0,1,1
34603,80,4593,1824,2190,0,0,0,1,1
34604,80,4611,6191,2190,0,0,0,1,1
34605,80,4613,7691,2190,0,0,0,1,1
34606,80,4633,9370,2190,0,0,0,1,1
34607,80,4649,8039,2555,0,0,0,1,1
34608,80,4650,4375,2555,0,0,0,1,1
34609,80,4654,3338,2555,0,0,0,1,1
34610,80,4661,1653,2555,0,0,0,1,1
34611,80,4662,1935,2555,0,0,0,1,1
34612,80,4666,603,2555,0,0,0,1,1
34613,80,4668,8226,2555,0,0,0,1,1
34614,80,4672,2058,2555,0,0,0,1,1
34615,80,4679,3703;6767,2555,0,0,0,2,2
34616,80,4683,7391,2555,0,0,0,1,1
34617,80,4689,2168,2555,0,0,0,1,1
34618,80,4710,2692,2555,0,0,0,1,1
34619,80,4730,4649,2555,0,0,0,1,1
34620,80,4731,6037;6406,2555,0,0,0,2,2
34621,80,4734,3436,2555,0,0,0,1,1
34622,80,4757,12159;12349;15793,2555,0,0,3,0,3
34623,80,4770,12704;12991,2920,0,0,2,0,2
34624,80,4771,1016,2920,0,0,0,1,1
34625,80,4772,12137,2920,0,0,1,0,1
34626,80,4780,933,2920,0,0,0,1,1
34627,80,4781,2169,2920,0,0,0,1,1
34628,80,4784,2840,2920,0,0,0,1,1
34629,80,4792,4713,2920,0,0,0,1,1
34630,80,4794,3449,2920,0,0,0,1,1
34631,80,4796,2817,2920,0,0,0,1,1
34632,80,4802,3812,2920,0,0,0,1,1
34633,80,4816,4924,2920,0,0,0,1,1
34634,80,4821,13095,2920,0,0,1,0,1
34635,80,4827,6464,2920,0,0,0,1,1
34636,80,4836,6636,2920,0,0,0,1,1
34637,80,4846,8807,2920,0,0,0,1,1
34638,80,4851,6581,2920,0,0,0,1,1
34639,80,4857,8123;9355,2920,0,0,0,2,2
34640,80,4864,3011,2920,0,0,0,1,1
34641,80,4867,37,3285,0,0,0,1,1
34642,80,4871,4628,3285,0,0,0,1,1
34643,80,4873,6820,3285,0,0,0,1,1
34644,80,4875,6629,3285,0,0,0,1,1
34645,80,4880,6111;9879,3285,0,0,0,2,2
34646,80,4883,3376,3285,0,0,0,1,1
34647,80,4893,4109,3285,0,0,0,1,1
34648,80,4894,936,3285,0,0,0,1,1
34649,80,4898,1386,3285,0,0,0,1,1
34650,80,4905,6405,3285,0,0,0,1,1
34651,80,4907,8650,3285,0,0,0,1,1
34652,80,4923,4499,3285,0,0,0,1,1
34653,80,4925,4721,3285,0,0,0,1,1
34654,80,4931,7728,3285,0,0,0,1,1
34655,80,4933,5863,3285,0,0,0,1,1
34656,80,4945,6792,3285,0,0,0,1,1
34657,80,4949,2215,3285,0,0,0,1,1
34658,80,4951,7461,3285,0,0,0,1,1
34659,80,4952,7488,3285,0,0,0,1,1
34660,80,4966,7330,3285,0,0,0,1,1
34661,80,4977,153;7525,3650,0,0,0,2,2
34662,80,4978,7068,3650,0,0,0,1,1
34663,80,4981,1364,3650,0,0,0,1,1
34664,80,4982,2656,3650,0,0,0,1,1
34665,80,4984,1139,3650,0,0,0,1,1
34666,80,4987,8110,3650,0,0,0,1,1
34667,80,4990,2799,3650,0,0,0,1,1
34668,80,4998,14651;14730,3650,0,0,2,0,2
34669,80,4999,2404,3650,0,0,0,1,1
34670,80,5002,3520,3650,0,0,0,1,1
34671,80,5004,1599,3650,0,0,0,1,1
34672,80,5006,8826,3650,0,0,0,1,1
34673,80,5012,1666,3650,0,0,0,1,1
34674,80,5031,2629,3650,0,0,0,1,1
34675,80,5041,6612,3650,0,0,0,1,1
34676,80,5042,8291,3650,0,0,0,1,1
34677,80,5045,8977,3650,0,0,0,1,1
34678,80,5049,3,3650,0,0,0,1,1
34679,80,5052,9637,3650,0,0,0,1,1
34680,80,5058,5525,4015,0,0,0,1,1
34681,80,5060,189,4015,0,0,0,1,1
34682,80,5074,6531,4015,0,0,0,1,1
34683,80,5076,2273,4015,0,0,0,1,1
34684,80,5077,9226,4015,0,0,0,1,1
34685,80,5079,2498,4015,0,0,0,1,1
34686,80,5091,1987,4015,0,0,0,1,1
34687,80,5099,4283,4015,0,0,0,1,1
34688,80,5112,9485,4015,0,0,0,1,1
34689,80,5117,1751,4015,0,0,0,1,1
34690,80,5120,5723,4015,0,0,0,1,1
34691,80,5121,6595,4015,0,0,0,1,1
34692,80,5124,6981,4015,0,0,0,1,1
34693,80,5126,7073,4015,0,0,0,1,1
34694,80,5127,7739;9045,4015,0,0,0,2,2
34695,80,5134,9844,4015,0,0,0,1,1
34696,80,5142,5063,4015,0,0,0,1,1
34697,80,5144,479;9220,4015,0,0,0,2,2
34698,80,5149,11429,4015,0,0,0,1,1
34699,80,5158,4307,4380,0,0,0,1,1
34700,80,5161,5002,4380,0,0,0,1,1
34701,80,5165,891,4380,0,0,0,1,1
34702,80,5167,8198,4380,0,0,0,1,1
34703,80,5173,1313,4380,0,0,0,1,1
34704,80,5189,2891,4380,0,0,0,1,1
34705,80,5190,1192,4380,0,0,0,1,1
34706,80,5194,3121,4380,0,0,0,1,1
34707,80,5203,6158,4380,0,0,0,1,1
34708,80,5204,5425,4380,0,0,0,1,1
34709,80,5207,1427,4380,0,0,0,1,1
34710,80,5208,8497,4380,0,0,0,1,1
34711,80,5213,3738,4380,0,0,0,1,1
34712,80,5230,2385,4380,0,0,0,1,1
34713,80,5236,7306,4380,0,0,0,1,1
34714,80,5240,2108;7503,4380,0,0,0,2,2
34715,80,5246,2555,4380,0,0,0,1,1
34716,80,5253,12548;12839;13063;17427;17543;18025,4380,0,1,5,0,6
34717,80,5261,9589,4380,0,0,0,1,1
34718,80,5267,4601,4745,0,0,0,1,1
34719,80,5282,4481,4745,0,0,0,1,1
34720,80,5286,7142,4745,0,0,0,1,1
34721,80,5295,3234,4745,0,0,0,1,1
34722,80,5300,1652,4745,0,0,0,1,1
34723,80,5306,8759,4745,0,0,0,1,1
34724,80,5316,7747,4745,0,0,0,1,1
34725,80,5318,3458,4745,0,0,0,1,1
34726,80,5326,7212,4745,0,0,0,1,1
34727,80,5327,2434,4745,0,0,0,1,1
34728,80,5337,7276,4745,0,0,0,1,1
34729,80,5341,7553,4745,0,0,0,1,1
34730,80,5345,8520,4745,0,0,0,1,1
34731,80,5349,8629,4745,0,0,0,1,1
34732,80,5350,2699,4745,0,0,0,1,1
34733,80,5352,953,4745,0,0,0,1,1
34734,80,5353,9417,4745,0,0,0,1,1
34735,80,5355,2449,4745,0,0,0,1,1
34736,80,5358,294;3834,4745,0,0,0,2,2
34737,80,5363,12127;12880;12883;13414;13696;17935;18252;18406,5110,0,2,6,0,8
34738,80,5368,648,5110,0,0,0,1,1
34739,80,5377,944,5110,0,0,0,1,1
34740,80,5384,3428,5110,0,0,0,1,1
34741,80,5386,3691,5110,0,0,0,1,1
34742,80,5393,4070,5110,0,0,0,1,1
34743,80,5398,5031,5110,0,0,0,1,1
34744,80,5408,4021,5110,0,0,0,1,1
34745,80,5409,9134,5110,0,0,0,1,1
34746,80,5412,6389,5110,0,0,0,1,1
34747,80,5415,2870,5110,0,0,0,1,1
34748,80,5417,7367,5110,0,0,0,1,1
34749,80,5424,1239,5110,0,0,0,1,1
34750,80,5429,13298,5110,0,0,1,0,1
34751,80,5434,5735,5110,0,0,0,1,1
34752,80,5436,2963,5475,0,0,0,1,1
34753,80,5437,87,5475,0,0,0,1,1
34754,80,5443,9783,5475,0,0,0,1,1
34755,80,5444,896,5475,0,0,0,1,1
34756,80,5447,786;8288,5475,0,0,0,2,2
34757,80,5448,1093,5475,0,0,0,1,1
34758,80,5460,11441;11823;12513;13229,5475,0,0,2,2,4
34759,80,5462,2146;2268,5475,0,0,0,2,2
34760,80,5463,574;2159,5475,0,0,0,2,2
34761,80,5468,2948,5475,0,0,0,1,1
34762,80,5471,3359;9082,5475,0,0,0,2,2
34763,80,5473,3504,5475,0,0,0,1,1
34764,80,5476,3794;5241,5475,0,0,0,2,2
34765,80,5478,5190;6117,5475,0,0,0,2,2
34766,80,5482,1147,5475,0,0,0,1,1
34767,80,5486,6675,5475,0,0,0,1,1
34768,80,5490,5526,5475,0,0,0,1,1
34769,80,5494,9765;9849,5475,0,0,0,2,2
34770,80,5500,2481,5475,0,0,0,1,1
34771,80,5508,4074,5475,0,0,0,1,1
34772,80,5510,7520,5475,0,0,0,1,1
34773,80,5512,50,5475,0,0,0,1,1
34774,80,5517,1571,5475,0,0,0,1,1
34775,80,5518,8365,5475,0,0,0,1,1
34776,80,5527,8785,5475,0,0,0,1,1
34777,80,5532,2027;6857,5475,0,0,0,2,2
34778,80,5533,9215,5475,0,0,0,1,1
34779,80,5540,1450,5475,0,0,0,1,1
34780,80,5543,61;8703,5840,0,0,0,2,2
34781,80,5544,838,5840,0,0,0,1,1
34782,80,5545,79,5840,0,0,0,1,1
34783,80,5546,367,5840,0,0,0,1,1
34784,80,5548,1467,5840,0,0,0,1,1
34785,80,5549,632;2250,5840,0,0,0,2,2
34786,80,5553,4571,5840,0,0,0,1,1
34787,80,5554,1267,5840,0,0,0,1,1
34788,80,5555,319,5840,0,0,0,1,1
34789,80,5556,3403,5840,0,0,0,1,1
34790,80,5559,8038,5840,0,0,0,1,1
34791,80,5560,5128,5840,0,0,0,1,1
34792,80,5564,163,5840,0,0,0,1,1
34793,80,5567,2580,5840,0,0,0,1,1
34794,80,5569,2965,5840,0,0,0,1,1
34795,80,5571,8278,5840,0,0,0,1,1
34796,80,5573,1388,5840,0,0,0,1,1
34797,80,5574,2910;4337,5840,0,0,0,2,2
34798,80,5580,1157,5840,0,0,0,1,1
34799,80,5582,5521,5840,0,0,0,1,1
34800,80,5583,10073,5840,0,0,0,1,1
34801,80,5584,4634,5840,0,0,0,1,1
34802,80,5600,6809,5840,0,0,0,1,1
34803,80,5603,1107,5840,0,0,0,1,1
34804,80,5607,2085,5840,0,0,0,1,1
34805,80,5609,5860,5840,0,0,0,1,1
34806,80,5610,7789,5840,0,0,0,1,1
34807,80,5611,7193,5840,0,0,0,1,1
34808,80,5615,8047,5840,0,0,0,1,1
34809,80,5617,8302,5840,0,0,0,1,1
34810,80,5626,5809,5840,0,0,0,1,1
34811,80,5627,9069;9506,5840,0,0,0,2,2
34812,80,5629,2330;9654,5840,0,0,0,2,2
34813,80,5630,1096;4034,5840,0,0,0,2,2
34814,80,5632,2063,6205,0,0,0,1,1
34815,80,5633,8494,6205,0,0,0,1,1
34816,80,5635,7555,6205,0,0,0,1,1
34817,80,5639,1284;6363,6205,0,0,0,2,2
34818,80,5641,10204,6205,0,0,0,1,1
34819,80,5642,1428,6205,0,0,0,1,1
34820,80,5643,1700;4845,6205,0,0,0,2,2
34821,80,5648,2539,6205,0,0,0,1,1
34822,80,5650,10044,6205,0,0,0,1,1
34823,80,5651,10055,6205,0,0,0,1,1
34824,80,5654,2545,6205,0,0,0,1,1
34825,80,5657,3601,6205,0,0,0,1,1
34826,80,5662,10060,6205,0,0,0,1,1
34827,80,5665,494;10201,6205,0,0,0,2,2
34828,80,5674,10180,6205,0,0,0,1,1
34829,80,5676,2234,6205,0,0,0,1,1
34830,80,5680,4833;7037,6205,0,0,0,2,2
34831,80,5683,4106,6205,0,0,0,1,1
34832,80,5685,5297,6205,0,0,0,1,1
34833,80,5688,5186;5642,6205,0,0,0,2,2
34834,80,5692,8052,6205,0,0,0,1,1
34835,80,5694,6885,6205,0,0,0,1,1
34836,80,5699,5228,6205,0,0,0,1,1
34837,80,5702,6692,6205,0,0,0,1,1
34838,80,5708,3388,6205,0,0,0,1,1
34839,80,5709,9827,6205,0,0,0,1,1
34840,80,5717,4959;8885,6205,0,0,0,2,2
34841,80,5719,93,6205,0,0,0,1,1
34842,80,5720,2142,6205,0,0,0,1,1
34843,80,5722,9389,6205,0,0,0,1,1
34844,80,5723,6421,6205,0,0,0,1,1
34845,80,5724,14274;14445;18392,6205,0,1,2,0,3
34846,80,5725,7794,6205,0,0,0,1,1
34847,80,5729,9728,6570,0,0,0,1,1
34848,80,5732,10118,6570,0,0,0,1,1
34849,80,5734,14712;14795,6570,0,0,2,0,2
34850,80,5739,10042,6570,0,0,0,1,1
34851,80,5740,1242,6570,0,0,0,1,1
34852,80,5751,10080,6570,0,0,0,1,1
34853,80,5752,1721,6570,0,0,0,1,1
34854,80,5762,6088,6570,0,0,0,1,1
34855,80,5768,477,6570,0,0,0,1,1
34856,80,5773,4633,6570,0,0,0,1,1
34857,80,5774,4694,6570,0,0,0,1,1
34858,80,5776,6003;10167,6570,0,0,0,2,2
34859,80,5786,4832;7665,6570,0,0,0,2,2
34860,80,5787,461,6570,0,0,0,1,1
34861,80,5791,8967,6570,0,0,0,1,1
34862,80,5799,10229,6570,0,0,0,1,1
34863,80,5800,10084;13844,6570,0,0,1,1,2
34864,80,5802,8051,6570,0,0,0,1,1
34865,80,5807,1493;10063,6570,0,0,0,2,2
34866,80,5812,57,6570,0,0,0,1,1
34867,80,5815,4704;9655,6570,0,0,0,2,2
34868,80,5819,476,6935,0,0,0,1,1
34869,80,5820,3874;10069,6935,0,0,0,2,2
34870,80,5821,7402,6935,0,0,0,1,1
34871,80,5825,3748,6935,0,0,0,1,1
34872,80,5833,10048;10138,6935,0,0,0,2,2
34873,80,5835,2121,6935,0,0,0,1,1
34874,80,5836,10223,6935,0,0,0,1,1
34875,80,5837,2245,6935,0,0,0,1,1
34876,80,5839,10145,6935,0,0,0,1,1
34877,80,5840,10030,6935,0,0,0,1,1
34878,80,5843,3375,6935,0,0,0,1,1
34879,80,5845,3126,6935,0,0,0,1,1
34880,80,5850,10074,6935,0,0,0,1,1
34881,80,5854,3127;5301,6935,0,0,0,2,2
34882,80,5859,5231,6935,0,0,0,1,1
34883,80,5860,10017,6935,0,0,0,1,1
34884,80,5862,5097;7994,6935,0,0,0,2,2
34885,80,5863,10158,6935,0,0,0,1,1
34886,80,5865,960,6935,0,0,0,1,1
34887,80,5867,7310,6935,0,0,0,1,1
34888,80,5871,10005;10132,6935,0,0,0,2,2
34889,80,5872,4752,6935,0,0,0,1,1
34890,80,5873,169,6935,0,0,0,1,1
34891,80,5875,6469,6935,0,0,0,1,1
34892,80,5877,7444;8553,6935,0,0,0,2,2
34893,80,5885,3886,6935,0,0,0,1,1
34894,80,5888,7550,6935,0,0,0,1,1
34895,80,5890,9197,6935,0,0,0,1,1
34896,80,5895,10237,6935,0,0,0,1,1
34897,80,5900,5917;10186,6935,0,0,0,2,2
34898,80,5901,982,6935,0,0,0,1,1
34899,80,5906,4868;10206,6935,0,0,0,2,2
34900,80,5908,10022;10210,6935,0,0,0,2,2
34901,80,5909,3820;10029,6935,0,0,0,2,2
34902,80,5910,10362,6935,0,0,0,1,1
34903,80,5911,10089;10188,6935,0,0,0,2,2
34904,80,5912,10056;10297,6935,0,0,0,2,2
34905,80,5914,10109,6935,0,0,0,1,1
34906,80,5915,386;10108,6935,0,0,0,2,2
34907,80,5916,10481;15304,6935,0,0,1,1,2
34908,80,5918,10183,7300,0,0,0,1,1
34909,80,5921,562;9927,7300,0,0,0,2,2
34910,80,5927,1452,7300,0,0,0,1,1
34911,80,5928,3337;5390,7300,0,0,0,2,2
34912,80,5930,2361,7300,0,0,0,1,1
34913,80,5934,5479,7300,0,0,0,1,1
34914,80,5935,1045;10008,7300,0,0,0,2,2
34915,80,5943,7163,7300,0,0,0,1,1
34916,80,5946,4544;9887,7300,0,0,0,2,2
34917,80,5950,4851;10057,7300,0,0,0,2,2
34918,80,5957,5968,7300,0,0,0,1,1
34919,80,5958,7732;8624,7300,0,0,0,2,2
34920,80,5959,1682;6702,7300,0,0,0,2,2
34921,80,5964,4677;7172,7300,0,0,0,2,2
34922,80,5968,10097,7300,0,0,0,1,1
34923,80,5971,5436,7300,0,0,0,1,1
34924,80,5972,9211,7300,0,0,0,1,1
34925,80,5975,2247,7300,0,0,0,1,1
34926,80,5980,9749,7300,0,0,0,1,1
34927,80,5983,10082;10320,7300,0,0,0,2,2
34928,80,5985,10519,7300,0,0,0,1,1
34929,80,5986,10220,7300,0,0,0,1,1
34930,80,5987,10142,7300,0,0,0,1,1
34931,80,5989,10187,7300,0,0,0,1,1
34932,80,5993,10160;10255,7665,0,0,0,2,2
34933,80,5994,512;1604,7665,0,0,0,2,2
34934,80,5995,1623,7665,0,0,0,1,1
34935,80,6000,7394,7665,0,0,0,1,1
34936,80,6003,3952;10217,7665,0,0,0,2,2
34937,80,6005,2620,7665,0,0,0,1,1
34938,80,6008,10280,7665,0,0,0,1,1
34939,80,6009,10306;15270,7665,0,0,1,1,2
34940,80,6012,2920;3591,7665,0,0,0,2,2
34941,80,6013,9227,7665,0,0,0,1,1
34942,80,6020,5161,7665,0,0,0,1,1
34943,80,6022,4229,7665,0,0,0,1,1
34944,80,6023,6114,7665,0,0,0,1,1
34945,80,6029,8698,7665,0,0,0,1,1
34946,80,6032,8573,7665,0,0,0,1,1
34947,80,6057,10014;10340,7665,0,0,0,2,2
34948,80,6058,10016;10395,7665,0,0,0,2,2
34949,80,6059,3481,7665,0,0,0,1,1
34950,80,6061,10086;14508,7665,0,0,1,1,2
34951,80,6062,10178,7665,0,0,0,1,1
34952,80,6063,10361,7665,0,0,0,1,1
34953,80,6064,10141,7665,0,0,0,1,1
34954,80,6067,10448,7665,0,0,0,1,1
34955,80,6070,10254;10583,7665,0,0,0,2,2
34956,80,6071,10261;10440,7665,0,0,0,2,2
34957,80,6072,10265;10483,7665,0,0,0,2,2
34958,80,6073,10104;10567,7665,0,0,0,2,2
34959,80,6074,10275,7665,0,0,0,1,1
34960,80,6075,10047;10505,7665,0,0,0,2,2
34961,80,6076,7295;10197,7665,0,0,0,2,2
34962,80,6077,10298,7665,0,0,0,1,1
34963,80,6078,10233;10307,7665,0,0,0,2,2
34964,80,6080,320;5064,8030,0,0,0,2,2
34965,80,6083,7621,8030,0,0,0,1,1
34966,80,6084,5100,8030,0,0,0,1,1
34967,80,6087,2360;3246,8030,0,0,0,2,2
34968,80,6098,3029,8030,0,0,0,1,1
34969,80,6099,3612,8030,0,0,0,1,1
34970,80,6102,4235;10380,8030,0,0,0,2,2
34971,80,6104,10557;10700,8030,0,0,0,2,2
34972,80,6107,932,8030,0,0,0,1,1
34973,80,6110,6393;10003,8030,0,0,0,2,2
34974,80,6112,6309,8030,0,0,0,1,1
34975,80,6115,10093,8030,0,0,0,1,1
34976,80,6119,6155;8638,8030,0,0,0,2,2
34977,80,6120,8641,8030,0,0,0,1,1
34978,80,6121,2996,8030,0,0,0,1,1
34979,80,6126,10545,8030,0,0,0,1,1
34980,80,6127,4456;10051,8030,0,0,0,2,2
34981,80,6128,10053;10090,8030,0,0,0,2,2
34982,80,6129,10081;10246,8030,0,0,0,2,2
34983,80,6130,10302;10433,8030,0,0,0,2,2
34984,80,6131,10119;13572,8030,0,0,1,1,2
34985,80,6134,10192,8030,0,0,0,1,1
34986,80,6135,10211,8030,0,0,0,1,1
34987,80,6136,10535,8030,0,0,0,1,1
34988,80,6137,10239;10454,8030,0,0,0,2,2
34989,80,6141,10679,8030,0,0,0,1,1
34990,80,6142,10276;10653,8030,0,0,0,2,2
34991,80,6143,10278;10582,8030,0,0,0,2,2
34992,80,6144,10281,8030,0,0,0,1,1
34993,80,6145,10634;10714,8030,0,0,0,2,2
34994,80,6146,10126,8030,0,0,0,1,1
34995,80,6147,10471,8030,0,0,0,1,1
34996,80,6148,10113;10347,8030,0,0,0,2,2
34997,80,6149,15147;15338,8030,0,0,2,0,2
34998,80,6150,10390,8030,0,0,0,1,1
34999,80,6151,10170;10383,8030,0,0,0,2,2
35000,80,6152,10719,8030,0,0,0,1,1
35001,80,6153,10389;10463,8030,0,0,0,2,2
35002,80,6154,10203,8030,0,0,0,1,1
35003,80,6155,10721,8030,0,0,0,1,1
35004,80,6156,6262,8395,0,0,0,1,1
35005,80,6159,10513;10644,8395,0,0,0,2,2
35006,80,6160,1231;5040,8395,0,0,0,2,2
35007,80,6166,1797,8395,0,0,0,1,1
35008,80,6167,652;5738,8395,0,0,0,2,2
35009,80,6169,10012,8395,0,0,0,1,1
35010,80,6171,3366;6348,8395,0,0,0,2,2
35011,80,6173,8237,8395,0,0,0,1,1
35012,80,6179,4543,8395,0,0,0,1,1
35013,80,6182,10150;10353,8395,0,0,0,2,2
35014,80,6194,8111,8395,0,0,0,1,1
35015,80,6196,8474,8395,0,0,0,1,1
35016,80,6197,3267,8395,0,0,0,1,1
35017,80,6199,5814,8395,0,0,0,1,1
35018,80,6205,4956,8395,0,0,0,1,1
35019,80,6206,10091;10314,8395,0,0,0,2,2
35020,80,6207,10140,8395,0,0,0,1,1
35021,80,6209,10516,8395,0,0,0,1,1
35022,80,6210,10258,8395,0,0,0,1,1
35023,80,6211,10279,8395,0,0,0,1,1
35024,80,6212,10272;10506,8395,0,0,0,2,2
35025,80,6213,10665,8395,0,0,0,1,1
35026,80,6214,10228,8395,0,0,0,1,1
35027,80,6215,10738,8395,0,0,0,1,1
35028,80,6216,10202;10350,8395,0,0,0,2,2
35029,80,6218,10604,8395,0,0,0,1,1
35030,80,6219,10418;10435,8395,0,0,0,2,2
35031,80,6220,10656,8395,0,0,0,1,1
35032,80,6221,10879,8395,0,0,0,1,1
35033,80,6223,10333;10455,8395,0,0,0,2,2
35034,80,6224,10291,8395,0,0,0,1,1
35035,80,6225,10657,8395,0,0,0,1,1
35036,80,6227,10548,8395,0,0,0,1,1
35037,80,6230,10079,8760,0,0,0,1,1
35038,80,6237,10227,8760,0,0,0,1,1
35039,80,6239,2176;5459,8760,0,0,0,2,2
35040,80,6243,1973;2534,8760,0,0,0,2,2
35041,80,6244,2233;3055,8760,0,0,0,2,2
35042,80,6245,3108;7311,8760,0,0,0,2,2
35043,80,6249,5047,8760,0,0,0,1,1
35044,80,6258,6159,8760,0,0,0,1,1
35045,80,6263,3735,8760,0,0,0,1,1
35046,80,6264,1618,8760,0,0,0,1,1
35047,80,6269,1360,8760,0,0,0,1,1
35048,80,6281,10381;10422,8760,0,0,0,2,2
35049,80,6282,10617;10724,8760,0,0,0,2,2
35050,80,6283,10587,8760,0,0,0,1,1
35051,80,6284,10253,8760,0,0,0,1,1
35052,80,6285,10096;10474,8760,0,0,0,2,2
35053,80,6286,10331;10374;15023,8760,0,0,1,2,3
35054,80,6288,10627,8760,0,0,0,1,1
35055,80,6290,10720,8760,0,0,0,1,1
35056,80,6291,10117,8760,0,0,0,1,1
35057,80,6292,3241;10163,8760,0,0,0,2,2
35058,80,6293,3318;9764,8760,0,0,0,2,2
35059,80,6294,10522,8760,0,0,0,1,1
35060,80,6295,10292,8760,0,0,0,1,1
35061,80,6296,10299,8760,0,0,0,1,1
35062,80,6297,10338,8760,0,0,0,1,1
35063,80,6298,10697,8760,0,0,0,1,1
35064,80,6299,10341;10652,8760,0,0,0,2,2
35065,80,6300,10052,8760,0,0,0,1,1
35066,80,6301,2476;10357,8760,0,0,0,2,2
35067,80,6302,10241,8760,0,0,0,1,1
35068,80,6303,10377,8760,0,0,0,1,1
35069,80,6304,10408;10650,8760,0,0,0,2,2
35070,80,6305,10625,8760,0,0,0,1,1
35071,80,6306,10907,8760,0,0,0,1,1
35072,80,6307,10346;10710,8760,0,0,0,2,2
35073,80,6308,10470,8760,0,0,0,1,1
35074,80,6309,10244;10709,8760,0,0,0,2,2
35075,80,6310,10193;10532,8760,0,0,0,2,2
35076,80,6311,10434;10613,8760,0,0,0,2,2
35077,80,6312,10682;10694,8760,0,0,0,2,2
35078,80,6313,10336;10558,8760,0,0,0,2,2
35079,80,6314,10572,8760,0,0,0,1,1
35080,80,6315,10599,8760,0,0,0,1,1
35081,80,6316,10124;10602,8760,0,0,0,2,2
35082,80,6318,10179,8760,0,0,0,1,1
35083,80,6339,89;3118,9125,0,0,0,2,2
35084,80,6340,1668,9125,0,0,0,1,1
35085,80,6342,3798,9125,0,0,0,1,1
35086,80,6366,10586;10702,9125,0,0,0,2,2
35087,80,6368,10075,9125,0,0,0,1,1
35088,80,6369,10866,9125,0,0,0,1,1
35089,80,6371,10310,9125,0,0,0,1,1
35090,80,6372,10575,9125,0,0,0,1,1
35091,80,6373,10499;10717,9125,0,0,0,2,2
35092,80,6374,10300;10319,9125,0,0,0,2,2
35093,80,6376,10510,9125,0,0,0,1,1
35094,80,6377,10379,9125,0,0,0,1,1
35095,80,6378,10236,9125,0,0,0,1,1
35096,80,6379,10282,9125,0,0,0,1,1
35097,80,6380,10131;10356,9125,0,0,0,2,2
35098,80,6381,10873,9125,0,0,0,1,1
35099,80,6382,10570,9125,0,0,0,1,1
35100,80,6383,10324;10403,9125,0,0,0,2,2
35101,80,6384,10148,9125,0,0,0,1,1
35102,80,6386,7856;10360,9125,0,0,0,2,2
35103,80,6387,10755,9125,0,0,0,1,1
35104,80,6388,10416,9125,0,0,0,1,1
35105,80,6389,10293;10511,9125,0,0,0,2,2
35106,80,6390,10219;10436,9125,0,0,0,2,2
35107,80,6391,10910;11034,9125,0,0,0,2,2
35108,80,6392,10457,9125,0,0,0,1,1
35109,80,6393,10466,9125,0,0,0,1,1
35110,80,6394,10690;10816;15894,9125,0,0,1,2,3
35111,80,6395,10961,9125,0,0,0,1,1
35112,80,6396,10257,9125,0,0,0,1,1
35113,80,6397,10770,9125,0,0,0,1,1
35114,80,6398,10509,9125,0,0,0,1,1
35115,80,6399,10553;10952,9125,0,0,0,2,2
35116,80,6401,10526,9125,0,0,0,1,1
35117,80,6402,10378;10527,9125,0,0,0,2,2
35118,80,6403,10312,9125,0,0,0,1,1
35119,80,6405,10568,9125,0,0,0,1,1
35120,80,6406,10172;10574,9125,0,0,0,2,2
35121,80,6408,10039;10600,9125,0,0,0,2,2
35122,80,6409,10821,9125,0,0,0,1,1
35123,80,6410,10234;10612,9125,0,0,0,2,2
35124,80,6411,10621,9125,0,0,0,1,1
35125,80,6413,10691;10919,9125,0,0,0,2,2
35126,80,6414,10507;10659;14799,9125,0,0,1,2,3
35127,80,6415,10795,9125,0,0,0,1,1
35128,80,6416,10641;10881,9125,0,0,0,2,2
35129,80,6417,10680;10743,9125,0,0,0,2,2
35130,80,6418,10681;10984,9125,0,0,0,2,2
35131,80,6419,10622;10730;15640,9125,0,0,1,2,3
35132,80,6420,11011,9125,0,0,0,1,1
35133,80,6421,10727;10763,9125,0,0,0,2,2
35134,80,6423,10024,9490,0,0,0,1,1
35135,80,6429,2396,9490,0,0,0,1,1
35136,80,6430,1432,9490,0,0,0,1,1
35137,80,6431,3058,9490,0,0,0,1,1
35138,80,6432,7197,9490,0,0,0,1,1
35139,80,6442,2784;6461,9490,0,0,0,2,2
35140,80,6449,2598,9490,0,0,0,1,1
35141,80,6452,7098,9490,0,0,0,1,1
35142,80,6459,9751,9490,0,0,0,1,1
35143,80,6462,10672,9490,0,0,0,1,1
35144,80,6465,10184,9490,0,0,0,1,1
35145,80,6466,10438;10654,9490,0,0,0,2,2
35146,80,6467,10578,9490,0,0,0,1,1
35147,80,6469,10305,9490,0,0,0,1,1
35148,80,6470,10496,9490,0,0,0,1,1
35149,80,6471,10607,9490,0,0,0,1,1
35150,80,6472,10332,9490,0,0,0,1,1
35151,80,6473,9247;10502,9490,0,0,0,2,2
35152,80,6474,10249,9490,0,0,0,1,1
35153,80,6475,10645,9490,0,0,0,1,1
35154,80,6476,10590;10635;15571,9490,0,0,1,2,3
35155,80,6477,10838,9490,0,0,0,1,1
35156,80,6479,10190;10484,9490,0,0,0,2,2
35157,80,6480,10489;10967,9490,0,0,0,2,2
35158,80,6481,11093,9490,0,0,0,1,1
35159,80,6482,4535;10182,9490,0,0,0,2,2
35160,80,6483,10610,9490,0,0,0,1,1
35161,80,6485,10537;10898,9490,0,0,0,2,2
35162,80,6486,10274;10944,9490,0,0,0,2,2
35163,80,6488,10673,9490,0,0,0,1,1
35164,80,6489,10642,9490,0,0,0,1,1
35165,80,6490,10692,9490,0,0,0,1,1
35166,80,6491,10407,9490,0,0,0,1,1
35167,80,6492,10518;10619,9490,0,0,0,2,2
35168,80,6493,10737;10869,9490,0,0,0,2,2
35169,80,6494,10973;11202,9490,0,0,0,2,2
35170,80,6495,10815,9490,0,0,0,1,1
35171,80,6496,10456;10832,9490,0,0,0,2,2
35172,80,6497,10803;11077,9490,0,0,0,2,2
35173,80,6499,11000;11113,9490,0,0,0,2,2
35174,80,6500,11060;11175,9490,0,0,0,2,2
35175,80,6501,10913;11015,9490,0,0,0,2,2
35176,80,6502,11117,9490,0,0,0,1,1
35177,80,6505,10494;10884,9490,0,0,0,2,2
35178,80,6509,5553,9855,0,0,0,1,1
35179,80,6511,3561;5260,9855,0,0,0,2,2
35180,80,6516,10031,9855,0,0,0,1,1
35181,80,6532,5027;10010,9855,0,0,0,2,2
35182,80,6535,8040;10111,9855,0,0,0,2,2
35183,80,6541,10491,9855,0,0,0,1,1
35184,80,6553,10447,9855,0,0,0,1,1
35185,80,6554,2370,9855,0,0,0,1,1
35186,80,6556,10928;11115,9855,0,0,0,2,2
35187,80,6557,10247;10467,9855,0,0,0,2,2
35188,80,6560,10329,9855,0,0,0,1,1
35189,80,6561,10159;10427,9855,0,0,0,2,2
35190,80,6562,10451;10842,9855,0,0,0,2,2
35191,80,6564,10601,9855,0,0,0,1,1
35192,80,6566,1663;10624,9855,0,0,0,2,2
35193,80,6567,10699;10833;14332,9855,0,0,1,2,3
35194,80,6568,10735;10825,9855,0,0,0,2,2
35195,80,6569,10742;11110,9855,0,0,0,2,2
35196,80,6570,10639,9855,0,0,0,1,1
35197,80,6572,11260;11263,9855,0,0,0,2,2
35198,80,6573,10754;10809,9855,0,0,0,2,2
35199,80,6575,10834;11085,9855,0,0,0,2,2
35200,80,6576,11116,9855,0,0,0,1,1
35201,80,6577,10998,9855,0,0,0,1,1
35202,80,6578,10271;10889;15547,9855,0,0,1,2,3
35203,80,6579,10863;16038,9855,0,0,1,1,2
35204,80,6580,10765;10896,9855,0,0,0,2,2
35205,80,6581,11318,9855,0,0,0,1,1
35206,80,6582,10571;10703,9855,0,0,0,2,2
35207,80,6583,10922;10927,9855,0,0,0,2,2
35208,80,6584,10805,9855,0,0,0,1,1
35209,80,6585,10940;11044,9855,0,0,0,2,2
35210,80,6586,10758;11216,9855,0,0,0,2,2
35211,80,6588,10971;11252,9855,0,0,0,2,2
35212,80,6589,10975,9855,0,0,0,1,1
35213,80,6590,10988,9855,0,0,0,1,1
35214,80,6599,5331;6336,10220,0,0,0,2,2
35215,80,6614,3341,10220,0,0,0,1,1
35216,80,6619,6127,10220,0,0,0,1,1
35217,80,6624,8840,10220,0,0,0,1,1
35218,80,6628,2729;10326,10220,0,0,0,2,2
35219,80,6634,10011,10220,0,0,0,1,1
35220,80,6636,10185,10220,0,0,0,1,1
35221,80,6637,11057,10220,0,0,0,1,1
35222,80,6639,10288;10630;13534,10220,0,0,1,2,3
35223,80,6641,10147,10220,0,0,0,1,1
35224,80,6647,10520,10220,0,0,0,1,1
35225,80,6649,10050;10552,10220,0,0,0,2,2
35226,80,6650,10756,10220,0,0,0,1,1
35227,80,6652,10289;10636,10220,0,0,0,2,2
35228,80,6653,10883,10220,0,0,0,1,1
35229,80,6654,10693,10220,0,0,0,1,1
35230,80,6656,10732;10912,10220,0,0,0,2,2
35231,80,6657,10766;10937,10220,0,0,0,2,2
35232,80,6658,10779,10220,0,0,0,1,1
35233,80,6659,10794,10220,0,0,0,1,1
35234,80,6660,10562;10796,10220,0,0,0,2,2
35235,80,6662,10807,10220,0,0,0,1,1
35236,80,6663,10446;10810,10220,0,0,0,2,2
35237,80,6664,10876;10920,10220,0,0,0,2,2
35238,80,6665,10995;11410;14755,10220,0,0,1,2,3
35239,80,6666,10740;10942;13846,10220,0,0,1,2,3
35240,80,6667,10849;11062,10220,0,0,0,2,2
35241,80,6668,10405;10991,10220,0,0,0,2,2
35242,80,6669,11041,10220,0,0,0,1,1
35243,80,6670,10956;11013,10220,0,0,0,2,2
35244,80,6673,11035;11122,10220,0,0,0,2,2
35245,80,6674,11051;11058,10220,0,0,0,2,2
35246,80,6675,10792;11073,10220,0,0,0,2,2
35247,80,6676,11081;11192;16044,10220,0,0,1,2,3
35248,80,6677,10977;11253,10220,0,0,0,2,2
35249,80,6681,10041;10248,10585,0,0,0,2,2
35250,80,6689,170,10585,0,0,0,1,1
35251,80,6699,10139,10585,0,0,0,1,1
35252,80,6709,182,10585,0,0,0,1,1
35253,80,6710,8057,10585,0,0,0,1,1
35254,80,6717,10443,10585,0,0,0,1,1
35255,80,6718,10177,10585,0,0,0,1,1
35256,80,6719,10225,10585,0,0,0,1,1
35257,80,6720,10317;10369,10585,0,0,0,2,2
35258,80,6721,10231;10277,10585,0,0,0,2,2
35259,80,6724,10290;10316,10585,0,0,0,2,2
35260,80,6725,10986,10585,0,0,0,1,1
35261,80,6726,10402,10585,0,0,0,1,1
35262,80,6727,10504,10585,0,0,0,1,1
35263,80,6728,10410,10585,0,0,0,1,1
35264,80,6729,10417,10585,0,0,0,1,1
35265,80,6730,10152;10458,10585,0,0,0,2,2
35266,80,6731,10462,10585,0,0,0,1,1
35267,80,6732,10068;10577,10585,0,0,0,2,2
35268,80,6733,10354,10585,0,0,0,1,1
35269,80,6734,10515;10829;15109,10585,0,0,1,2,3
35270,80,6735,10716,10585,0,0,0,1,1
35271,80,6736,10723;10870,10585,0,0,0,2,2
35272,80,6737,10731;10828,10585,0,0,0,2,2
35273,80,6738,11097;11191,10585,0,0,0,2,2
35274,80,6739,10733,10585,0,0,0,1,1
35275,80,6742,10888;10926,10585,0,0,0,2,2
35276,80,6743,10530;11043,10585,0,0,0,2,2
35277,80,6744,10917,10585,0,0,0,1,1
35278,80,6745,10608;10970,10585,0,0,0,2,2
35279,80,6746,10985,10585,0,0,0,1,1
35280,80,6748,10762;11032,10585,0,0,0,2,2
35281,80,6749,10931;11039,10585,0,0,0,2,2
35282,80,6750,11004;11237,10585,0,0,0,2,2
35283,80,6751,11070,10585,0,0,0,1,1
35284,80,6752,10827;11141;15348,10585,0,0,1,2,3
35285,80,6753,11146,10585,0,0,0,1,1
35286,80,6754,11471;11497,10585,0,0,0,2,2
35287,80,6755,11055;11152,10585,0,0,0,2,2
35288,80,6756,11164;11411,10585,0,0,0,2,2
35289,80,6757,10901;11185,10585,0,0,0,2,2
35290,80,6758,11121;11206,10585,0,0,0,2,2
35291,80,6759,11156,10585,0,0,0,1,1
35292,80,6770,10397;10412;14352,10950,0,0,1,2,3
35293,80,6794,6560,10950,0,0,0,1,1
35294,80,6802,1044;10136,10950,0,0,0,2,2
35295,80,6807,10385,10950,0,0,0,1,1
35296,80,6808,10263,10950,0,0,0,1,1
35297,80,6811,10429;10503,10950,0,0,0,2,2
35298,80,6812,10525;10904,10950,0,0,0,2,2
35299,80,6816,10597;11069,10950,0,0,0,2,2
35300,80,6817,10464;10616,10950,0,0,0,2,2
35301,80,6819,10945;11061,10950,0,0,0,2,2
35302,80,6820,10712,10950,0,0,0,1,1
35303,80,6822,11276;11466,10950,0,0,0,2,2
35304,80,6823,10764;10997,10950,0,0,0,2,2
35305,80,6824,10598;10793,10950,0,0,0,2,2
35306,80,6825,10823,10950,0,0,0,1,1
35307,80,6826,10814;10835,10950,0,0,0,2,2
35308,80,6827,10839,10950,0,0,0,1,1
35309,80,6828,11108;11147,10950,0,0,0,2,2
35310,80,6830,11204;11484,10950,0,0,0,2,2
35311,80,6831,11269,10950,0,0,0,1,1
35312,80,6832,10932,10950,0,0,0,1,1
35313,80,6833,11074,10950,0,0,0,1,1
35314,80,6835,11127,10950,0,0,0,1,1
35315,80,6836,10696,10950,0,0,0,1,1
35316,80,6837,11019;11047,10950,0,0,0,2,2
35317,80,6838,10662;11023,10950,0,0,0,2,2
35318,80,6839,10921;11135,10950,0,0,0,2,2
35319,80,6840,11059,10950,0,0,0,1,1
35320,80,6841,11566,10950,0,0,0,1,1
35321,80,6842,10367;11083,10950,0,0,0,2,2
35322,80,6843,11100;11404,10950,0,0,0,2,2
35323,80,6844,11103,10950,0,0,0,1,1
35324,80,6845,11476,10950,0,0,0,1,1
35325,80,6846,11124;11339,10950,0,0,0,2,2
35326,80,6847,10798;11129,10950,0,0,0,2,2
35327,80,6848,11230;11328,10950,0,0,0,2,2
35328,80,6849,11265;11526,10950,0,0,0,2,2
35329,80,6850,10960;11413,10950,0,0,0,2,2
35330,80,6851,11344;11798,10950,0,0,0,2,2
35331,80,6852,11266,10950,0,0,0,1,1
35332,80,6853,11196,10950,0,0,0,1,1
35333,80,6855,11377,10950,0,0,0,1,1
35334,80,6856,11228;11543,10950,0,0,0,2,2
35335,80,6857,11243,10950,0,0,0,1,1
35336,80,6858,11090;11184,10950,0,0,0,2,2
35337,80,6859,11256;11527,10950,0,0,0,2,2
35338,80,6860,11394;11401,10950,0,0,0,2,2
35339,80,6861,11233,10950,0,0,0,1,1
35340,80,6863,11366,10950,0,0,0,1,1
35341,80,6864,10752;11025,10950,0,0,0,2,2
35342,80,6865,11277;11442,10950,0,0,0,2,2
35343,80,6866,11444,10950,0,0,0,1,1
35344,80,6867,11378,10950,0,0,0,1,1
35345,80,6868,11450,10950,0,0,0,1,1
35346,80,6869,11315,10950,0,0,0,1,1
35347,80,6870,11324;15053,10950,0,0,1,1,2
35348,80,6884,2300;4960,11315,0,0,0,2,2
35349,80,6893,5659;6369,11315,0,0,0,2,2
35350,80,6895,2062;10085,11315,0,0,0,2,2
35351,80,6909,10651,11315,0,0,0,1,1
35352,80,6911,10729,11315,0,0,0,1,1
35353,80,6913,10205;10542,11315,0,0,0,2,2
35354,80,6915,10373,11315,0,0,0,1,1
35355,80,6916,10882,11315,0,0,0,1,1
35356,80,6917,10708;10824,11315,0,0,0,2,2
35357,80,6918,15489;19290,11315,0,1,1,0,2
35358,80,6919,10235;10472;14552,11315,0,0,1,2,3
35359,80,6920,10649;10783,11315,0,0,0,2,2
35360,80,6921,10701,11315,0,0,0,1,1
35361,80,6922,10508;11143;14244,11315,0,0,1,2,3
35362,80,6924,10059;10555,11315,0,0,0,2,2
35363,80,6927,10774;10918,11315,0,0,0,2,2
35364,80,6928,10776;11003,11315,0,0,0,2,2
35365,80,6929,10791;10857,11315,0,0,0,2,2
35366,80,6930,10584,11315,0,0,0,1,1
35367,80,6931,10536;10811,11315,0,0,0,2,2
35368,80,6932,10339,11315,0,0,0,1,1
35369,80,6933,10858,11315,0,0,0,1,1
35370,80,6934,10862;10981,11315,0,0,0,2,2
35371,80,6935,10855,11315,0,0,0,1,1
35372,80,6936,10963;11031,11315,0,0,0,2,2
35373,80,6938,10775,11315,0,0,0,1,1
35374,80,6939,11301,11315,0,0,0,1,1
35375,80,6940,11203;11295;15776,11315,0,0,1,2,3
35376,80,6941,10930;11049,11315,0,0,0,2,2
35377,80,6943,11053,11315,0,0,0,1,1
35378,80,6944,11086,11315,0,0,0,1,1
35379,80,6945,10874;11098,11315,0,0,0,2,2
35380,80,6946,10173,11315,0,0,0,1,1
35381,80,6948,11026,11315,0,0,0,1,1
35382,80,6949,11132;11224;15813,11315,0,0,1,2,3
35383,80,6950,11582;11702,11315,0,0,0,2,2
35384,80,6952,10771;11236,11315,0,0,0,2,2
35385,80,6953,11167;11482,11315,0,0,0,2,2
35386,80,6954,10990;11181,11315,0,0,0,2,2
35387,80,6955,11040,11315,0,0,0,1,1
35388,80,6956,11207;11538,11315,0,0,0,2,2
35389,80,6959,11234,11315,0,0,0,1,1
35390,80,6960,10954;11268,11315,0,0,0,2,2
35391,80,6962,11134;11311,11315,0,0,0,2,2
35392,80,6963,11125;11459;15315,11315,0,0,1,2,3
35393,80,6964,11336,11315,0,0,0,1,1
35394,80,6965,11626;11697;15910,11315,0,0,1,2,3
35395,80,6966,11174;11289,11315,0,0,0,2,2
35396,80,6968,11719;11749,11315,0,0,0,2,2
35397,80,6969,11321;11359,11315,0,0,0,2,2
35398,80,6970,11364;11698,11315,0,0,0,2,2
35399,80,6971,11195;11382,11315,0,0,0,2,2
35400,80,6972,11700,11315,0,0,0,1,1
35401,80,6973,11407;11432,11315,0,0,0,2,2
35402,80,6975,10026;10156,11680,0,0,0,2,2
35403,80,6989,3507;6252,11680,0,0,0,2,2
35404,80,6993,1671;5278,11680,0,0,0,2,2
35405,80,7008,10524,11680,0,0,0,1,1
35406,80,7009,10674;10750,11680,0,0,0,2,2
35407,80,7010,10453,11680,0,0,0,1,1
35408,80,7011,11180;11227,11680,0,0,0,2,2
35409,80,7013,10687,11680,0,0,0,1,1
35410,80,7014,10103;10420,11680,0,0,0,2,2
35411,80,7016,10929,11680,0,0,0,1,1
35412,80,7017,10588;10609,11680,0,0,0,2,2
35413,80,7018,11162,11680,0,0,0,1,1
35414,80,7020,10660;10899,11680,0,0,0,2,2
35415,80,7021,10705;14504,11680,0,0,1,1,2
35416,80,7022,10646;10707,11680,0,0,0,2,2
35417,80,7023,10780,11680,0,0,0,1,1
35418,80,7024,10872,11680,0,0,0,1,1
35419,80,7025,11133;11248,11680,0,0,0,2,2
35420,80,7026,11140;11375,11680,0,0,0,2,2
35421,80,7027,11089,11680,0,0,0,1,1
35422,80,7028,11323,11680,0,0,0,1,1
35423,80,7030,11109;11172,11680,0,0,0,2,2
35424,80,7031,11575,11680,0,0,0,1,1
35425,80,7032,11415,11680,0,0,0,1,1
35426,80,7034,11197;11347,11680,0,0,0,2,2
35427,80,7035,11229,11680,0,0,0,1,1
35428,80,7036,11807;11970,11680,0,0,1,1,2
35429,80,7037,11209;11481;16063,11680,0,0,1,2,3
35430,80,7038,11242;11361,11680,0,0,0,2,2
35431,80,7039,11306;11615;15602,11680,0,0,1,2,3
35432,80,7040,11657,11680,0,0,0,1,1
35433,80,7041,11348;11673,11680,0,0,0,2,2
35434,80,7042,10864;11370,11680,0,0,0,2,2
35435,80,7043,11704,11680,0,0,0,1,1
35436,80,7044,11387;11434,11680,0,0,0,2,2
35437,80,7045,11421;11455,11680,0,0,0,2,2
35438,80,7046,11240;11468,11680,0,0,0,2,2
35439,80,7047,11489;11756,11680,0,0,0,2,2
35440,80,7048,11707,11680,0,0,0,1,1
35441,80,7049,11509;11740;15248,11680,0,0,1,2,3
35442,80,7050,11650,11680,0,0,0,1,1
35443,80,7055,803,12045,0,0,0,1,1
35444,80,7062,8150,12045,0,0,0,1,1
35445,80,7068,4436,12045,0,0,0,1,1
35446,80,7081,6480;7972,12045,0,0,0,2,2
35447,80,7097,10214,12045,0,0,0,1,1
35448,80,7099,10181;10303,12045,0,0,0,2,2
35449,80,7100,10345;10579,12045,0,0,0,2,2
35450,80,7102,10444;13549,12045,0,0,1,1,2
35451,80,7103,10067;10546,12045,0,0,0,2,2
35452,80,7104,10637,12045,0,0,0,1,1
35453,80,7106,10476;15004,12045,0,0,1,1,2
35454,80,7107,10521;10628,12045,0,0,0,2,2
35455,80,7108,10632;10905,12045,0,0,0,2,2
35456,80,7109,10222;10831,12045,0,0,0,2,2
35457,80,7110,10836,12045,0,0,0,1,1
35458,80,7111,11435;11452;15665,12045,0,0,1,2,3
35459,80,7112,11033,12045,0,0,0,1,1
35460,80,7115,11288,12045,0,0,0,1,1
35461,80,7116,11522,12045,0,0,0,1,1
35462,80,7117,11478,12045,0,0,0,1,1
35463,80,7119,11189;11211,12045,0,0,0,2,2
35464,80,7120,11200;15197,12045,0,0,1,1,2
35465,80,7121,11493,12045,0,0,0,1,1
35466,80,7122,11593;11743,12045,0,0,0,2,2
35467,80,7123,10802;11255,12045,0,0,0,2,2
35468,80,7124,11259;11319,12045,0,0,0,2,2
35469,80,7125,11274;12125,12045,0,0,1,1,2
35470,80,7126,11280,12045,0,0,0,1,1
35471,80,7127,11338,12045,0,0,0,1,1
35472,80,7128,10789;11317;14725,12045,0,0,1,2,3
35473,80,7129,10934;11322;15754,12045,0,0,1,2,3
35474,80,7130,11356;11703,12045,0,0,0,2,2
35475,80,7131,11379;11834,12045,0,0,0,2,2
35476,80,7132,11096;11393,12045,0,0,0,2,2
35477,80,7133,11065;11400,12045,0,0,0,2,2
35478,80,7134,11680;11821,12045,0,0,0,2,2
35479,80,7135,11221,12045,0,0,0,1,1
35480,80,7136,11464;11633,12045,0,0,0,2,2
35481,80,7137,11470,12045,0,0,0,1,1
35482,80,7138,11499,12045,0,0,0,1,1
35483,80,7139,11067;11523,12045,0,0,0,2,2
35484,80,7140,11112;11534;15748,12045,0,0,1,2,3
35485,80,7141,11533;11786,12045,0,0,0,2,2
35486,80,7142,11583;11594,12045,0,0,0,2,2
35487,80,7144,11884,12045,0,0,1,0,1
35488,80,7146,11601,12045,0,0,0,1,1
35489,80,7158,3776,12410,0,0,0,1,1
35490,80,7170,9046,12410,0,0,0,1,1
35491,80,7176,7373,12410,0,0,0,1,1
35492,80,7178,1472;7405,12410,0,0,0,2,2
35493,80,7185,4931,12410,0,0,0,1,1
35494,80,7192,10107;11030,12410,0,0,0,2,2
35495,80,7193,10259;10620,12410,0,0,0,2,2
35496,80,7195,4867,12410,0,0,0,1,1
35497,80,7196,14193;14808;17531;18124;18426;18765,12410,0,3,3,0,6
35498,80,7199,10334;10972,12410,0,0,0,2,2
35499,80,7201,10689,12410,0,0,0,1,1
35500,80,7202,11029,12410,0,0,0,1,1
35501,80,7205,10594;10974,12410,0,0,0,2,2
35502,80,7207,11312,12410,0,0,0,1,1
35503,80,7208,10706;10778,12410,0,0,0,2,2
35504,80,7209,10573;11022,12410,0,0,0,2,2
35505,80,7211,10787;10936,12410,0,0,0,2,2
35506,80,7212,10812;10822,12410,0,0,0,2,2
35507,80,7213,10850,12410,0,0,0,1,1
35508,80,7215,11002;11088,12410,0,0,0,2,2
35509,80,7216,11291;11524,12410,0,0,0,2,2
35510,80,7217,11012;11488,12410,0,0,0,2,2
35511,80,7218,10969,12410,0,0,0,1,1
35512,80,7220,10757;11099,12410,0,0,0,2,2
35513,80,7221,11349,12410,0,0,0,1,1
35514,80,7222,11360;11687;16620,12410,0,0,1,2,3
35515,80,7223,11457,12410,0,0,0,1,1
35516,80,7225,11218;11342,12410,0,0,0,2,2
35517,80,7226,11270;11512;15286,12410,0,0,1,2,3
35518,80,7227,11267;11273,12410,0,0,0,2,2
35519,80,7228,11008;11279,12410,0,0,0,2,2
35520,80,7229,11298;11416,12410,0,0,0,2,2
35521,80,7230,11331;11367,12410,0,0,0,2,2
35522,80,7231,11574,12410,0,0,0,1,1
35523,80,7232,11106;11341,12410,0,0,0,2,2
35524,80,7233,11358,12410,0,0,0,1,1
35525,80,7234,10957;11371,12410,0,0,0,2,2
35526,80,7235,11386;11420,12410,0,0,0,2,2
35527,80,7236,11235,12410,0,0,0,1,1
35528,80,7237,11438;12053,12410,0,0,1,1,2
35529,80,7240,11518;11780,12410,0,0,0,2,2
35530,80,7241,11537;11541,12410,0,0,0,2,2
35531,80,7242,11757;11782,12410,0,0,0,2,2
35532,80,7243,11553;11584,12410,0,0,0,2,2
35533,80,7244,11600;11938;17238,12410,0,0,2,1,3
35534,80,7245,11529;11567,12410,0,0,0,2,2
35535,80,7246,11577;11795,12410,0,0,0,2,2
35536,80,7247,11578;11829;15297,12410,0,0,1,2,3
35537,80,7249,11618,12410,0,0,0,1,1
35538,80,7250,11620,12410,0,0,0,1,1
35539,80,7251,11628,12410,0,0,0,1,1
35540,80,7252,11887;11982,12410,0,0,2,0,2
35541,80,7253,11713;11849,12410,0,0,0,2,2
35542,80,7254,11173;11722,12410,0,0,0,2,2
35543,80,7256,11663;11738,12410,0,0,0,2,2
35544,80,7257,11747;12098;16748,12410,0,0,2,1,3
35545,80,7270,8862;10501,12775,0,0,0,2,2
35546,80,7279,7410,12775,0,0,0,1,1
35547,80,7293,10348;10845,12775,0,0,0,2,2
35548,80,7297,10400;10813,12775,0,0,0,2,2
35549,80,7298,10819;10989,12775,0,0,0,2,2
35550,80,7299,10938,12775,0,0,0,1,1
35551,80,7300,10848,12775,0,0,0,1,1
35552,80,7301,10698;10772,12775,0,0,0,2,2
35553,80,7303,10564,12775,0,0,0,1,1
35554,80,7304,10906;11095,12775,0,0,0,2,2
35555,80,7305,10784,12775,0,0,0,1,1
35556,80,7307,10844;11010,12775,0,0,0,2,2
35557,80,7308,11330;11479,12775,0,0,0,2,2
35558,80,7309,10512;10675,12775,0,0,0,2,2
35559,80,7310,10908,12775,0,0,0,1,1
35560,80,7311,11136;11462,12775,0,0,0,2,2
35561,80,7312,11153,12775,0,0,0,1,1
35562,80,7314,11283;11303;15173;15302;16738,12775,0,0,3,2,5
35563,80,7315,11285;11458,12775,0,0,0,2,2
35564,80,7316,10987;11334,12775,0,0,0,2,2
35565,80,7317,11254;11340,12775,0,0,0,2,2
35566,80,7318,11494;15958,12775,0,0,1,1,2
35567,80,7319,11449;11731;15975,12775,0,0,1,2,3
35568,80,7320,11978;12121;16906,12775,0,0,3,0,3
35569,80,7321,11337;11480,12775,0,0,0,2,2
35570,80,7322,11302;11495,12775,0,0,0,2,2
35571,80,7323,11498,12775,0,0,0,1,1
35572,80,7324,11742;11864,12775,0,0,0,2,2
35573,80,7325,11056;11491;16696,12775,0,0,1,2,3
35574,80,7326,11530;11863,12775,0,0,0,2,2
35575,80,7327,11531;11612,12775,0,0,0,2,2
35576,80,7329,12034;16355,12775,0,0,2,0,2
35577,80,7330,11598;11616;16540,12775,0,0,1,2,3
35578,80,7332,11565;11653,12775,0,0,0,2,2
35579,80,7333,11674,12775,0,0,0,1,1
35580,80,7334,11699;11882,12775,0,0,1,1,2
35581,80,7336,11724;15752,12775,0,0,1,1,2
35582,80,7337,11139;11151,12775,0,0,0,2,2
35583,80,7338,11759;12225,12775,0,0,1,1,2
35584,80,7339,11761;11866,12775,0,0,0,2,2
35585,80,7340,11774,12775,0,0,0,1,1
35586,80,7341,11686;11790,12775,0,0,0,2,2
35587,80,7342,11778;11805,12775,0,0,0,2,2
35588,80,7343,11417;11517,12775,0,0,0,2,2
35589,80,7344,11837;16978,12775,0,0,1,1,2
35590,80,7345,12228;16484,12775,0,0,2,0,2
35591,80,7346,11640;11869,12775,0,0,0,2,2
35592,80,7348,14851;15449,13140,0,0,2,0,2
35593,80,7376,10106;10363,13140,0,0,0,2,2
35594,80,7378,10216,13140,0,0,0,1,1
35595,80,7381,4883;10413,13140,0,0,0,2,2
35596,80,7382,10325,13140,0,0,0,1,1
35597,80,7384,10543;10671,13140,0,0,0,2,2
35598,80,7386,10958,13140,0,0,0,1,1
35599,80,7389,10648;10875,13140,0,0,0,2,2
35600,80,7390,10404,13140,0,0,0,1,1
35601,80,7391,10933;10949,13140,0,0,0,2,2
35602,80,7392,10925;11111,13140,0,0,0,2,2
35603,80,7393,10736,13140,0,0,0,1,1
35604,80,7394,11833;16113,13140,0,0,1,1,2
35605,80,7395,11072,13140,0,0,0,1,1
35606,80,7396,11105;11551;15728,13140,0,0,1,2,3
35607,80,7397,10806;11107,13140,0,0,0,2,2
35608,80,7398,10769;11046,13140,0,0,0,2,2
35609,80,7399,11326,13140,0,0,0,1,1
35610,80,7400,10891;11190,13140,0,0,0,2,2
35611,80,7401,11037;11550;16184,13140,0,0,1,2,3
35612,80,7402,11405;11677,13140,0,0,0,2,2
35613,80,7403,11486,13140,0,0,0,1,1
35614,80,7404,11436;11485,13140,0,0,0,2,2
35615,80,7406,11606,13140,0,0,0,1,1
35616,80,7407,11354,13140,0,0,0,1,1
35617,80,7408,11535,13140,0,0,0,1,1
35618,80,7409,11585;12096,13140,0,0,1,1,2
35619,80,7410,11614,13140,0,0,0,1,1
35620,80,7411,12246,13140,0,0,1,0,1
35621,80,7412,11646,13140,0,0,0,1,1
35622,80,7414,11984,13140,0,0,1,0,1
35623,80,7415,11542;12014;16051,13140,0,0,2,1,3
35624,80,7416,11602;11727,13140,0,0,0,2,2
35625,80,7417,11728;11897,13140,0,0,1,1,2
35626,80,7420,11784;12371,13140,0,0,1,1,2
35627,80,7423,11637;11822,13140,0,0,0,2,2
35628,80,7424,11734,13140,0,0,0,1,1
35629,80,7425,11831;12101;14660,13140,0,0,2,1,3
35630,80,7426,11847;12176,13140,0,0,1,1,2
35631,80,7427,11813;12221;17074,13140,0,0,2,1,3
35632,80,7428,12060;12192,13140,0,0,2,0,2
35633,80,7429,11694;11889,13140,0,0,1,1,2
35634,80,7430,11817;11900;16398,13140,0,0,2,1,3
35635,80,7431,11903,13140,0,0,1,0,1
35636,80,7433,11851;11937,13140,0,0,1,1,2
35637,80,7434,11926;17166,13140,0,0,2,0,2
35638,80,7435,11607;11932,13140,0,0,1,1,2
35639,80,7436,11752;11901,13140,0,0,1,1,2
35640,80,7438,11971;12000,13140,0,0,2,0,2
35641,80,7442,1930,13505,0,0,0,1,1
35642,80,7451,5662,13505,0,0,0,1,1
35643,80,7468,8854,13505,0,0,0,1,1
35644,80,7471,6420,13505,0,0,0,1,1
35645,80,7473,1837,13505,0,0,0,1,1
35646,80,7475,10461;10962,13505,0,0,0,2,2
35647,80,7478,10414;10490,13505,0,0,0,2,2
35648,80,7481,10445;10498,13505,0,0,0,2,2
35649,80,7483,10479;15711,13505,0,0,1,1,2
35650,80,7484,10592;15390,13505,0,0,1,1,2
35651,80,7486,10939;10999,13505,0,0,0,2,2
35652,80,7488,11007;11064,13505,0,0,0,2,2
35653,80,7489,10843;11477,13505,0,0,0,2,2
35654,80,7491,11126,13505,0,0,0,1,1
35655,80,7492,11138,13505,0,0,0,1,1
35656,80,7493,11332,13505,0,0,0,1,1
35657,80,7494,10647;11142,13505,0,0,0,2,2
35658,80,7495,11439;11506,13505,0,0,0,2,2
35659,80,7497,11286,13505,0,0,0,1,1
35660,80,7498,10897;11292,13505,0,0,0,2,2
35661,80,7499,10903;11528,13505,0,0,0,2,2
35662,80,7500,11357;12004,13505,0,0,1,1,2
35663,80,7501,11068;11408;16600,13505,0,0,1,2,3
35664,80,7504,11246;11516,13505,0,0,0,2,2
35665,80,7505,11554;11979,13505,0,0,1,1,2
35666,80,7506,11581;11806;16295,13505,0,0,1,2,3
35667,80,7507,11599;12181,13505,0,0,1,1,2
35668,80,7508,11397;11980,13505,0,0,1,1,2
35669,80,7509,11560;11627,13505,0,0,0,2,2
35670,80,7510,11684,13505,0,0,0,1,1
35671,80,7511,11643;11732;16257,13505,0,0,1,2,3
35672,80,7512,12203,13505,0,0,1,0,1
35673,80,7513,11658;11672,13505,0,0,0,2,2
35674,80,7514,11427;11678,13505,0,0,0,2,2
35675,80,7515,11525;11766,13505,0,0,0,2,2
35676,80,7516,12472;12657,13505,0,0,2,0,2
35677,80,7517,11793;11861,13505,0,0,0,2,2
35678,80,7518,12117;12219,13505,0,0,2,0,2
35679,80,7519,12342,13505,0,0,1,0,1
35680,80,7520,11880;11960,13505,0,0,2,0,2
35681,80,7521,12302,13505,0,0,1,0,1
35682,80,7522,12249,13505,0,0,1,0,1
35683,80,7523,11610;11896;16024;17055,13505,0,0,3,1,4
35684,80,7524,12237;12324,13505,0,0,2,0,2
35685,80,7525,11505;12167,13505,0,0,1,1,2
35686,80,7526,11927;12346,13505,0,0,2,0,2
35687,80,7527,12091;12403,13505,0,0,2,0,2
35688,80,7528,11955;17222,13505,0,0,2,0,2
35689,80,7529,11961;11994,13505,0,0,2,0,2
35690,80,7530,11981;16784,13505,0,0,2,0,2
35691,80,7531,11753;11987,13505,0,0,1,1,2
35692,80,7532,12376,13505,0,0,1,0,1
35693,80,7533,12204;12279,13505,0,0,2,0,2
35694,80,7534,11692;12065,13505,0,0,1,1,2
35695,80,7535,11925;12067;17109,13505,0,0,3,0,3
35696,80,7536,12314;12392,13505,0,0,2,0,2
35697,80,7538,11996,13505,0,0,1,0,1
35698,80,7539,11769;12107,13505,0,0,1,1,2
35699,80,7540,12460;17833,13505,0,0,2,0,2
35700,80,7541,12056;12529,13505,0,0,2,0,2
35701,80,7564,10270,13870,0,0,0,1,1
35702,80,7569,10399,13870,0,0,0,1,1
35703,80,7571,10531,13870,0,0,0,1,1
35704,80,7575,10801;10841,13870,0,0,0,2,2
35705,80,7578,10661;10943,13870,0,0,0,2,2
35706,80,7579,11001;16077,13870,0,0,1,1,2
35707,80,7580,11021,13870,0,0,0,1,1
35708,80,7582,11118,13870,0,0,0,1,1
35709,80,7584,11250;11572;16746,13870,0,0,1,2,3
35710,80,7586,11333;11365,13870,0,0,0,2,2
35711,80,7587,11656,13870,0,0,0,1,1
35712,80,7588,11463;11720,13870,0,0,0,2,2
35713,80,7589,11579;11675,13870,0,0,0,2,2
35714,80,7590,11418;11639,13870,0,0,0,2,2
35715,80,7591,11128,13870,0,0,0,1,1
35716,80,7593,11510,13870,0,0,0,1,1
35717,80,7596,11536;11733,13870,0,0,0,2,2
35718,80,7597,12118,13870,0,0,1,0,1
35719,80,7598,11915;12434;17158;17365,13870,0,0,4,0,4
35720,80,7599,11634;12062,13870,0,0,1,1,2
35721,80,7600,15671,13870,0,0,1,0,1
35722,80,7601,11748;12070,13870,0,0,1,1,2
35723,80,7602,11710;11933,13870,0,0,1,1,2
35724,80,7604,11345;11811,13870,0,0,0,2,2
35725,80,7605,11789;12104;17594,13870,0,0,2,1,3
35726,80,7606,12187;16955,13870,0,0,2,0,2
35727,80,7607,11916,13870,0,0,1,0,1
35728,80,7608,11942;12092,13870,0,0,2,0,2
35729,80,7609,11924;11944,13870,0,0,2,0,2
35730,80,7610,11950;12160,13870,0,0,2,0,2
35731,80,7611,12638;12639,13870,0,0,2,0,2
35732,80,7612,11962;12191,13870,0,0,2,0,2
35733,80,7613,11963,13870,0,0,1,0,1
35734,80,7614,12202;12267,13870,0,0,2,0,2
35735,80,7617,12413,13870,0,0,1,0,1
35736,80,7619,12026,13870,0,0,1,0,1
35737,80,7620,12265;12518,13870,0,0,2,0,2
35738,80,7621,11320;12049;17775,13870,0,0,2,1,3
35739,80,7622,12254;15409,13870,0,0,2,0,2
35740,80,7623,12200;12329,13870,0,0,2,0,2
35741,80,7624,11865;12208;16127,13870,0,0,2,1,3
35742,80,7625,12100;12350;16658,13870,0,0,3,0,3
35743,80,7626,12327;12580;16636,13870,0,0,3,0,3
35744,80,7627,11953;12389,13870,0,0,2,0,2
35745,80,7628,12178,13870,0,0,1,0,1
35746,80,7629,12604;12647,13870,0,0,2,0,2
35747,80,7630,12201;12207,13870,0,0,2,0,2
35748,80,7631,12210;12598,13870,0,0,2,0,2
35749,80,7632,12232;16279;16322,13870,0,0,3,0,3
35750,80,7633,12551;16363;17396,13870,0,0,3,0,3
35751,80,7634,12073;12454,13870,0,0,2,0,2
35752,80,7635,12130;12259,13870,0,0,2,0,2
35753,80,7637,334,14235,0,0,0,1,1
35754,80,7646,2442,14235,0,0,0,1,1
35755,80,7652,7554,14235,0,0,0,1,1
35756,80,7667,10240,14235,0,0,0,1,1
35757,80,7671,11188;15301,14235,0,0,1,1,2
35758,80,7672,11166;11296,14235,0,0,0,2,2
35759,80,7678,11042;11372,14235,0,0,0,2,2
35760,80,7680,11275;11500,14235,0,0,0,2,2
35761,80,7682,11325,14235,0,0,0,1,1
35762,80,7684,11691,14235,0,0,0,1,1
35763,80,7685,11521,14235,0,0,0,1,1
35764,80,7687,11472;11735,14235,0,0,0,2,2
35765,80,7688,11294;11654;15663;17047,14235,0,0,2,2,4
35766,80,7689,11562;11636,14235,0,0,0,2,2
35767,80,7690,11568,14235,0,0,0,1,1
35768,80,7691,11622,14235,0,0,0,1,1
35769,80,7692,11647,14235,0,0,0,1,1
35770,80,7693,11919,14235,0,0,1,0,1
35771,80,7694,11576,14235,0,0,0,1,1
35772,80,7695,11335,14235,0,0,0,1,1
35773,80,7697,11272;11746,14235,0,0,0,2,2
35774,80,7699,11785;12366,14235,0,0,1,1,2
35775,80,7700,12407;12568,14235,0,0,2,0,2
35776,80,7701,11329;11850,14235,0,0,0,2,2
35777,80,7702,11556;11832,14235,0,0,0,2,2
35778,80,7703,11892;11983,14235,0,0,2,0,2
35779,80,7704,12358;17066;17309,14235,0,0,3,0,3
35780,80,7705,11751;11945;17043,14235,0,0,2,1,3
35781,80,7706,11685;11952,14235,0,0,1,1,2
35782,80,7709,12298;17524,14235,0,0,2,0,2
35783,80,7710,11659,14235,0,0,0,1,1
35784,80,7711,12111;12218,14235,0,0,2,0,2
35785,80,7712,11544,14235,0,0,0,1,1
35786,80,7713,12562;16452,14235,0,0,2,0,2
35787,80,7714,11652;12059;16691,14235,0,0,2,1,3
35788,80,7715,11976;12074,14235,0,0,2,0,2
35789,80,7716,11923;12075;16659,14235,0,0,3,0,3
35790,80,7717,12076;12592,14235,0,0,2,0,2
35791,80,7718,12087;12214,14235,0,0,2,0,2
35792,80,7719,12229;12288;16000,14235,0,0,3,0,3
35793,80,7720,12102;12124;16565,14235,0,0,3,0,3
35794,80,7721,12122;17420,14235,0,0,2,0,2
35795,80,7722,12048;12126,14235,0,0,2,0,2
35796,80,7723,12064;12143,14235,0,0,2,0,2
35797,80,7724,11899;12776;17572,14235,0,0,3,0,3
35798,80,7725,16415;16475,14235,0,0,2,0,2
35799,80,7726,12728;17087;17511,14235,0,0,3,0,3
35800,80,7727,12185;12603;16465;17321,14235,0,0,4,0,4
35801,80,7728,12149;12199,14235,0,0,2,0,2
35802,80,7729,12697,14235,0,0,1,0,1
35803,80,7730,12673,14235,0,0,1,0,1
35804,80,7731,12239;12558;17600,14235,0,0,3,0,3
35805,80,7732,11853;12362;15641,14235,0,0,2,1,3
35806,80,7734,12466,14235,0,0,1,0,1
35807,80,7735,11810;12336,14235,0,0,1,1,2
35808,80,7736,12173;12432;17614,14235,0,0,3,0,3
35809,80,7737,12292;12374,14235,0,0,2,0,2
35810,80,7738,12373;12729,14235,0,0,2,0,2
35811,80,7740,11858;12258,14235,0,0,1,1,2
35812,80,7742,909,14600,0,0,0,1,1
35813,80,7748,5008,14600,0,0,0,1,1
35814,80,7772,10497;10623,14600,0,0,0,2,2
35815,80,7773,11239,14600,0,0,0,1,1
35816,80,7775,11226,14600,0,0,0,1,1
35817,80,7776,10686,14600,0,0,0,1,1
35818,80,7778,10782,14600,0,0,0,1,1
35819,80,7781,10670;10887;16308,14600,0,0,1,2,3
35820,80,7783,10517,14600,0,0,0,1,1
35821,80,7785,11157;16103,14600,0,0,1,1,2
35822,80,7786,10877;11076,14600,0,0,0,2,2
35823,80,7787,10614;11178,14600,0,0,0,2,2
35824,80,7788,11154;11412,14600,0,0,0,2,2
35825,80,7789,11148;11597,14600,0,0,0,2,2
35826,80,7790,10924;11131;15249,14600,0,0,1,2,3
35827,80,7791,11213;15906,14600,0,0,1,1,2
35828,80,7792,11220;11271;15929,14600,0,0,1,2,3
35829,80,7793,11005;11278;16499,14600,0,0,1,2,3
35830,80,7794,11781,14600,0,0,0,1,1
35831,80,7795,11353;11390;16924,14600,0,0,1,2,3
35832,80,7796,11304;15259,14600,0,0,1,1,2
35833,80,7797,11160;11580,14600,0,0,0,2,2
35834,80,7799,11532;11906,14600,0,0,1,1,2
35835,80,7800,11718;11951,14600,0,0,1,1,2
35836,80,7801,11557;11603,14600,0,0,0,2,2
35837,80,7802,11669,14600,0,0,0,1,1
35838,80,7804,11492;11768,14600,0,0,0,2,2
35839,80,7805,11549;11946,14600,0,0,1,1,2
35840,80,7806,11388;11762,14600,0,0,0,2,2
35841,80,7807,12276;12481,14600,0,0,2,0,2
35842,80,7808,11423,14600,0,0,0,1,1
35843,80,7809,12420,14600,0,0,1,0,1
35844,80,7810,11846;12139,14600,0,0,1,1,2
35845,80,7811,11855;12401;17176,14600,0,0,2,1,3
35846,80,7812,11791;11867,14600,0,0,0,2,2
35847,80,7813,11385;11891,14600,0,0,1,1,2
35848,80,7814,11913;12323;17172,14600,0,0,3,0,3
35849,80,7816,11991,14600,0,0,1,0,1
35850,80,7817,12008;16285,14600,0,0,2,0,2
35851,80,7818,12023;12119,14600,0,0,2,0,2
35852,80,7820,12222;12306,14600,0,0,2,0,2
35853,80,7821,12082;12347,14600,0,0,2,0,2
35854,80,7822,11835;12322;17075,14600,0,0,2,1,3
35855,80,7823,11792;12106;17237,14600,0,0,2,1,3
35856,80,7824,12132;12572;15635;16715;17417,14600,0,0,5,0,5
35857,80,7825,11787;12133,14600,0,0,1,1,2
35858,80,7826,12750,14600,0,0,1,0,1
35859,80,7827,11363;12177,14600,0,0,1,1,2
35860,80,7828,12186,14600,0,0,1,0,1
35861,80,7829,12190;12622,14600,0,0,2,0,2
35862,80,7830,12285,14600,0,0,1,0,1
35863,80,7831,12274;12331,14600,0,0,2,0,2
35864,80,7832,12172;12257,14600,0,0,2,0,2
35865,80,7833,12633;12775;16930,14600,0,0,3,0,3
35866,80,7834,12171;12294;16847,14600,0,0,3,0,3
35867,80,7835,12311;12629,14600,0,0,2,0,2
35868,80,7836,12313;12367;17404;17813,14600,0,0,4,0,4
35869,80,7837,12009;12404,14600,0,0,2,0,2
35870,80,7838,11965;12332,14600,0,0,2,0,2
35871,80,7841,12706;12789;17244,14600,0,0,3,0,3
35872,80,7842,12081;12359;17491,14600,0,0,3,0,3
35873,80,7843,12505;12663;17998,14600,0,0,3,0,3
35874,80,7844,12280;16848,14600,0,0,2,0,2
35875,80,7845,12390;12441,14600,0,0,2,0,2
35876,80,7846,11908;12290;15318,14600,0,0,3,0,3
35877,80,7847,12424;12594,14600,0,0,2,0,2
35878,80,7848,12303;12370,14600,0,0,2,0,2
35879,80,7849,12054;12652,14600,0,0,2,0,2
35880,80,7865,5715,14965,0,0,0,1,1
35881,80,7869,1321,14965,0,0,0,1,1
35882,80,7875,10049,14965,0,0,0,1,1
35883,80,7879,10283;10585;15985,14965,0,0,1,2,3
35884,80,7883,11014;11838,14965,0,0,0,2,2
35885,80,7884,10759;10941,14965,0,0,0,2,2
35886,80,7885,10554;11071,14965,0,0,0,2,2
35887,80,7886,11176,14965,0,0,0,1,1
35888,80,7887,11194;11261;16402,14965,0,0,1,2,3
35889,80,7888,10965,14965,0,0,0,1,1
35890,80,7889,11373;11447,14965,0,0,0,2,2
35891,80,7890,11514,14965,0,0,0,1,1
35892,80,7892,11667,14965,0,0,0,1,1
35893,80,7893,11287;11419,14965,0,0,0,2,2
35894,80,7894,11092;11504;16358,14965,0,0,1,2,3
35895,80,7895,11222;11545,14965,0,0,0,2,2
35896,80,7896,11635,14965,0,0,0,1,1
35897,80,7897,11827,14965,0,0,0,1,1
35898,80,7898,12495;16292,14965,0,0,2,0,2
35899,80,7900,11776;12960;17314,14965,0,0,2,1,3
35900,80,7902,12085;12248,14965,0,0,2,0,2
35901,80,7903,11729;11824;16482,14965,0,0,1,2,3
35902,80,7904,12057;12268;16265,14965,0,0,3,0,3
35903,80,7905,11730;11886,14965,0,0,1,1,2
35904,80,7906,11943;11948,14965,0,0,2,0,2
35905,80,7907,11873;11947,14965,0,0,2,0,2
35906,80,7908,11954;12497;16657,14965,0,0,3,0,3
35907,80,7909,12006;12732,14965,0,0,2,0,2
35908,80,7910,12011,14965,0,0,1,0,1
35909,80,7911,12015;12870,14965,0,0,2,0,2
35910,80,7912,11770;12025,14965,0,0,1,1,2
35911,80,7914,12068;16258,14965,0,0,2,0,2
35912,80,7915,12378;12381,14965,0,0,2,0,2
35913,80,7916,12097,14965,0,0,1,0,1
35914,80,7917,12154;12299,14965,0,0,2,0,2
35915,80,7918,11936;12174;17153,14965,0,0,3,0,3
35916,80,7919,12183;12287,14965,0,0,2,0,2
35917,80,7920,11968;12240,14965,0,0,2,0,2
35918,80,7921,12260;12564;16845,14965,0,0,3,0,3
35919,80,7922,12031;12271,14965,0,0,2,0,2
35920,80,7923,12296;12787;16896,14965,0,0,3,0,3
35921,80,7924,12593;12674,14965,0,0,2,0,2
35922,80,7926,12530,14965,0,0,1,0,1
35923,80,7927,12316,14965,0,0,1,0,1
35924,80,7928,11721;12295,14965,0,0,1,1,2
35925,80,7929,12344;12541;16618,14965,0,0,3,0,3
35926,80,7930,12451;17140,14965,0,0,2,0,2
35927,80,7931,12123;12353,14965,0,0,2,0,2
35928,80,7932,12507;12521,14965,0,0,2,0,2
35929,80,7934,12553;12932,14965,0,0,2,0,2
35930,80,7935,12565;12946;18483,14965,0,1,2,0,3
35931,80,7936,12447;12501;17378,14965,0,0,3,0,3
35932,80,7937,12402;12489;17563,14965,0,0,3,0,3
35933,80,7938,12241;12609;17623;18028,14965,0,1,3,0,4
35934,80,7939,12621,14965,0,0,1,0,1
35935,80,7940,12635;12690,14965,0,0,2,0,2
35936,80,7941,12317;12699,14965,0,0,2,0,2
35937,80,7942,12351;12658;17599,14965,0,0,3,0,3
35938,80,7943,12757;16943,14965,0,0,2,0,2
35939,80,7949,6879,15330,0,0,0,1,1
35940,80,7952,4149,15330,0,0,0,1,1
35941,80,7967,10663,15330,0,0,0,1,1
35942,80,7968,11006;11212,15330,0,0,0,2,2
35943,80,7972,10196,15330,0,0,0,1,1
35944,80,7973,10739;11284,15330,0,0,0,2,2
35945,80,7974,11966,15330,0,0,1,0,1
35946,80,7975,10830,15330,0,0,0,1,1
35947,80,7977,10449;10964,15330,0,0,0,2,2
35948,80,7979,11777;12052,15330,0,0,1,1,2
35949,80,7981,11245;11883,15330,0,0,1,1,2
35950,80,7982,11313;11437,15330,0,0,0,2,2
35951,80,7984,11503;11638,15330,0,0,0,2,2
35952,80,7985,11376;12179,15330,0,0,1,1,2
35953,80,7989,12156,15330,0,0,1,0,1
35954,80,7990,11683;15532,15330,0,0,1,1,2
35955,80,7991,11696,15330,0,0,0,1,1
35956,80,7992,11688;11783,15330,0,0,0,2,2
35957,80,7993,11801;12283,15330,0,0,1,1,2
35958,80,7994,12146;12384,15330,0,0,2,0,2
35959,80,7995,11706;11907;15792,15330,0,0,2,1,3
35960,80,7996,11755;11911;16967,15330,0,0,2,1,3
35961,80,7997,11399;11842,15330,0,0,0,2,2
35962,80,7998,11990;12022,15330,0,0,2,0,2
35963,80,7999,12024;12784,15330,0,0,2,0,2
35964,80,8000,12105;12702,15330,0,0,2,0,2
35965,80,8001,12409,15330,0,0,1,0,1
35966,80,8002,11788;12365;17086,15330,0,0,2,1,3
35967,80,8003,12244,15330,0,0,1,0,1
35968,80,8004,12169,15330,0,0,1,0,1
35969,80,8005,12175;17130,15330,0,0,2,0,2
35970,80,8006,12197,15330,0,0,1,0,1
35971,80,8007,12072;12589,15330,0,0,2,0,2
35972,80,8008,12018;12242,15330,0,0,2,0,2
35973,80,8009,12284,15330,0,0,1,0,1
35974,80,8010,11905;12245,15330,0,0,2,0,2
35975,80,8011,11922;12253,15330,0,0,2,0,2
35976,80,8012,12264;16628,15330,0,0,2,0,2
35977,80,8013,12394;12821;17344,15330,0,0,3,0,3
35978,80,8014,12310;12474,15330,0,0,2,0,2
35979,80,8015,12637;12858,15330,0,0,2,0,2
35980,80,8016,13211,15330,0,0,1,0,1
35981,80,8017,12709;17983,15330,0,0,2,0,2
35982,80,8018,12379;12773,15330,0,0,2,0,2
35983,80,8019,11779;12393,15330,0,0,1,1,2
35984,80,8020,13281,15330,0,0,1,0,1
35985,80,8021,12426;12759;16804,15330,0,0,3,0,3
35986,80,8022,12443;12516;17287;17918,15330,0,0,4,0,4
35987,80,8023,12812,15330,0,0,1,0,1
35988,80,8024,12803,15330,0,0,1,0,1
35989,80,8025,12039;12512,15330,0,0,2,0,2
35990,80,8027,12499;12545,15330,0,0,2,0,2
35991,80,8028,12949,15330,0,0,1,0,1
35992,80,8029,12584;12925,15330,0,0,2,0,2
35993,80,8030,12552;12982,15330,0,0,2,0,2
35994,80,8031,12573;12781,15330,0,0,2,0,2
35995,80,8032,12500;12770;16840,15330,0,0,3,0,3
35996,80,8033,12596;12740;16867,15330,0,0,3,0,3
35997,80,8034,12711;17373,15330,0,0,2,0,2
35998,80,8035,12631,15330,0,0,1,0,1
35999,80,8036,12879;16233,15330,0,0,2,0,2
36000,80,8037,13195;17231,15330,0,0,2,0,2
36001,80,8038,12701;13041;16089,15330,0,0,3,0,3
36002,80,8039,12745;13074,15330,0,0,2,0,2
36003,80,8040,12417;12764;16477,15330,0,0,3,0,3
36004,80,8041,12981;13207,15330,0,0,2,0,2
36005,80,8042,12556;12788,15330,0,0,2,0,2
36006,80,8043,12801;12906,15330,0,0,2,0,2
36007,80,8058,6904,15695,0,0,0,1,1
36008,80,8061,6342,15695,0,0,0,1,1
36009,80,8069,10406,15695,0,0,0,1,1
36010,80,8075,11198;15954,15695,0,0,1,1,2
36011,80,8076,11075;11155,15695,0,0,0,2,2
36012,80,8080,11586;11711,15695,0,0,0,2,2
36013,80,8082,11443,15695,0,0,0,1,1
36014,80,8084,11570;12047,15695,0,0,1,1,2
36015,80,8085,11709;11974,15695,0,0,1,1,2
36016,80,8086,11959;12559,15695,0,0,2,0,2
36017,80,8087,11854;11992,15695,0,0,1,1,2
36018,80,8088,11705;11998;17331,15695,0,0,2,1,3
36019,80,8089,12335;16873,15695,0,0,2,0,2
36020,80,8090,12198;12511,15695,0,0,2,0,2
36021,80,8091,12188;16899,15695,0,0,2,0,2
36022,80,8093,12297,15695,0,0,1,0,1
36023,80,8094,12071;12319;17020,15695,0,0,3,0,3
36024,80,8095,12805;12916,15695,0,0,2,0,2
36025,80,8096,12155;12368;16725,15695,0,0,3,0,3
36026,80,8097,12380;12391,15695,0,0,2,0,2
36027,80,8098,11800;12405;17261,15695,0,0,2,1,3
36028,80,8099,12414;12561,15695,0,0,2,0,2
36029,80,8100,12483;12661,15695,0,0,2,0,2
36030,80,8101,12438;12527;16913,15695,0,0,3,0,3
36031,80,8102,12134,15695,0,0,1,0,1
36032,80,8103,12108;12470,15695,0,0,2,0,2
36033,80,8104,12905;13097,15695,0,0,2,0,2
36034,80,8105,12785,15695,0,0,1,0,1
36035,80,8106,12517;13365;16795,15695,0,0,3,0,3
36036,80,8107,12547;12892;15823,15695,0,0,3,0,3
36037,80,8108,12535;12571;16533,15695,0,0,3,0,3
36038,80,8109,12586;16761,15695,0,0,2,0,2
36039,80,8110,13295;13353,15695,0,0,2,0,2
36040,80,8111,12478;12537;16928;17326,15695,0,0,4,0,4
36041,80,8112,12484;16763,15695,0,0,2,0,2
36042,80,8113,11934;11956,15695,0,0,2,0,2
36043,80,8114,12044;12650,15695,0,0,2,0,2
36044,80,8115,12468;12623,15695,0,0,2,0,2
36045,80,8116,12727;12962,15695,0,0,2,0,2
36046,80,8117,13093;13234;15896,15695,0,0,3,0,3
36047,80,8118,12735;12799,15695,0,0,2,0,2
36048,80,8119,12692;12765;17689,15695,0,0,3,0,3
36049,80,8120,13171;17710;17894,15695,0,0,3,0,3
36050,80,8121,12791;12900,15695,0,0,2,0,2
36051,80,8122,12804;16370,15695,0,0,2,0,2
36052,80,8123,12810;16123,15695,0,0,2,0,2
36053,80,8124,12938;13073;17801,15695,0,0,3,0,3
36054,80,8126,12383;12829,15695,0,0,2,0,2
36055,80,8127,12917,15695,0,0,1,0,1
36056,80,8128,12677;12838;15937;17671,15695,0,0,4,0,4
36057,80,8129,12549;12855;16626,15695,0,0,3,0,3
36058,80,8130,12864;13297;17509,15695,0,0,3,0,3
36059,80,8131,12515;12902;17713,15695,0,0,3,0,3
36060,80,8132,12462;12881,15695,0,0,2,0,2
36061,80,8133,12415;12889;17782,15695,0,0,3,0,3
36062,80,8134,12418;12823,15695,0,0,2,0,2
36063,80,8135,13168;13311;15732;17024,15695,0,0,4,0,4
36064,80,8136,12543;12912;18273,15695,0,1,2,0,3
36065,80,8137,12836;13939;16426;17441;17583;18494,15695,0,1,5,0,6
36066,80,8139,870,16060,0,0,0,1,1
36067,80,8147,6970,16060,0,0,0,1,1
36068,80,8155,5731,16060,0,0,0,1,1
36069,80,8156,10309;10500,16060,0,0,0,2,2
36070,80,8163,10409;10994,16060,0,0,0,2,2
36071,80,8172,11205,16060,0,0,0,1,1
36072,80,8174,11422,16060,0,0,0,1,1
36073,80,8175,11170;11446,16060,0,0,0,2,2
36074,80,8176,11316;11843;17258,16060,0,0,1,2,3
36075,80,8178,12010;12235,16060,0,0,2,0,2
36076,80,8179,11454;11812,16060,0,0,0,2,2
36077,80,8180,11604;11609,16060,0,0,0,2,2
36078,80,8182,11460;12061,16060,0,0,1,1,2
36079,80,8183,11666;11758,16060,0,0,0,2,2
36080,80,8184,12003;12300,16060,0,0,2,0,2
36081,80,8186,11461;11856;15864,16060,0,0,1,2,3
36082,80,8187,11870;12281,16060,0,0,1,1,2
36083,80,8188,11917;12361;16542,16060,0,0,3,0,3
36084,80,8189,11803;11949,16060,0,0,1,1,2
36085,80,8190,11977;12532,16060,0,0,2,0,2
36086,80,8192,11986;12005;16353,16060,0,0,3,0,3
36087,80,8193,12020;15980,16060,0,0,2,0,2
36088,80,8194,12492;16407,16060,0,0,2,0,2
36089,80,8195,11921;12095,16060,0,0,2,0,2
36090,80,8196,12109;12887;17677,16060,0,0,3,0,3
36091,80,8197,12115;12195,16060,0,0,2,0,2
36092,80,8198,11841;12017,16060,0,0,1,1,2
36093,80,8199,12325;12372;17672,16060,0,0,3,0,3
36094,80,8200,12337;12458,16060,0,0,2,0,2
36095,80,8202,12321;12419,16060,0,0,2,0,2
36096,80,8204,12446;13107;17085;17464;17696,16060,0,0,5,0,5
36097,80,8206,12510;12832,16060,0,0,2,0,2
36098,80,8208,12231;12590,16060,0,0,2,0,2
36099,80,8209,12560,16060,0,0,1,0,1
36100,80,8210,12486;12569,16060,0,0,2,0,2
36101,80,8211,12587;12678,16060,0,0,2,0,2
36102,80,8212,13089;16823;17812,16060,0,0,3,0,3
36103,80,8213,12705;13516;17483;17742,16060,0,0,4,0,4
36104,80,8214,12452;12588;17350;17665,16060,0,0,4,0,4
36105,80,8215,12643;12825;15858,16060,0,0,3,0,3
36106,80,8216,12653;12835;16957,16060,0,0,3,0,3
36107,80,8217,12691;18070,16060,0,1,1,0,2
36108,80,8218,13046,16060,0,0,1,0,1
36109,80,8219,12716;13368,16060,0,0,2,0,2
36110,80,8220,12531;12731;16981,16060,0,0,3,0,3
36111,80,8221,12542;13143,16060,0,0,2,0,2
36112,80,8222,12931;13146,16060,0,0,2,0,2
36113,80,8224,12815,16060,0,0,1,0,1
36114,80,8225,12721;12878,16060,0,0,2,0,2
36115,80,8226,12904,16060,0,0,1,0,1
36116,80,8227,12830,16060,0,0,1,0,1
36117,80,8228,12739;12817,16060,0,0,2,0,2
36118,80,8229,13255;16539;17358,16060,0,0,3,0,3
36119,80,8230,12570;12945;16347,16060,0,0,3,0,3
36120,80,8231,12964;13185,16060,0,0,2,0,2
36121,80,8232,12978,16060,0,0,1,0,1
36122,80,8233,12600;12983;16730,16060,0,0,3,0,3
36123,80,8234,12999;13376;17950,16060,0,0,3,0,3
36124,80,8235,13014;13359,16060,0,0,2,0,2
36125,80,8237,13364;13391,16060,0,0,2,0,2
36126,80,8238,12597;13058;16320,16060,0,0,3,0,3
36127,80,8239,13446;13497,16060,0,0,2,0,2
36128,80,8248,6233,16425,0,0,0,1,1
36129,80,8254,4304;6238,16425,0,0,0,2,2
36130,80,8269,10175;10746,16425,0,0,0,2,2
36131,80,8271,10482;10861,16425,0,0,0,2,2
36132,80,8277,10478,16425,0,0,0,1,1
36133,80,8281,11231;11712,16425,0,0,0,2,2
36134,80,8284,11496;11723,16425,0,0,0,2,2
36135,80,8288,12263,16425,0,0,1,0,1
36136,80,8291,11737;11902,16425,0,0,1,1,2
36137,80,8292,12223;12563;16951,16425,0,0,3,0,3
36138,80,8293,11967;12193,16425,0,0,2,0,2
36139,80,8294,12763;12841;17083,16425,0,0,3,0,3
36140,80,8295,12680;12893;17042,16425,0,0,3,0,3
36141,80,8296,11424;11642;17120,16425,0,0,1,2,3
36142,80,8297,12440;12610,16425,0,0,2,0,2
36143,80,8298,12234,16425,0,0,1,0,1
36144,80,8299,12743;16631;17058,16425,0,0,3,0,3
36145,80,8300,12180;12286,16425,0,0,2,0,2
36146,80,8301,12291,16425,0,0,1,0,1
36147,80,8303,12355;12736;17101,16425,0,0,3,0,3
36148,80,8304,12269;12808;16400,16425,0,0,3,0,3
36149,80,8305,12230;12360,16425,0,0,2,0,2
36150,80,8306,12914,16425,0,0,1,0,1
36151,80,8308,12520,16425,0,0,1,0,1
36152,80,8309,12941;13028;17340;17627,16425,0,0,4,0,4
36153,80,8310,12514;12730;17649,16425,0,0,3,0,3
36154,80,8312,12490;12525;17770,16425,0,0,3,0,3
36155,80,8314,13132;13286;17327,16425,0,0,3,0,3
36156,80,8315,12554;12876;17592,16425,0,0,3,0,3
36157,80,8316,12737;12848,16425,0,0,2,0,2
36158,80,8317,12582,16425,0,0,1,0,1
36159,80,8318,12585;13104,16425,0,0,2,0,2
36160,80,8321,12410;12933;17700,16425,0,0,3,0,3
36161,80,8322,13057,16425,0,0,1,0,1
36162,80,8323,12320;13037;17457,16425,0,0,3,0,3
36163,80,8324,12694;13555,16425,0,0,2,0,2
36164,80,8325,12718;13216,16425,0,0,2,0,2
36165,80,8326,12725;12987,16425,0,0,2,0,2
36166,80,8327,13006;13586;17363;17633;18086,16425,0,1,4,0,5
36167,80,8328,12304;12754;17911,16425,0,0,3,0,3
36168,80,8329,12326;13036,16425,0,0,2,0,2
36169,80,8330,12519;12847;16047;17415,16425,0,0,4,0,4
36170,80,8331,12644;12907;17414,16425,0,0,3,0,3
36171,80,8332,12581;12910;18145,16425,0,1,2,0,3
36172,80,8333,12919;17418,16425,0,0,2,0,2
36173,80,8334,12885;12953;17409,16425,0,0,3,0,3
36174,80,8335,12700;13501;17448,16425,0,0,3,0,3
36175,80,8336,13024;13139,16425,0,0,2,0,2
36176,80,8337,12625;13181,16425,0,0,2,0,2
36177,80,8338,13220;17481,16425,0,0,2,0,2
36178,80,8339,13091;13206,16425,0,0,2,0,2
36179,80,8340,13096;16085,16425,0,0,2,0,2
36180,80,8342,12437;13109;17171,16425,0,0,3,0,3
36181,80,8343,13112;13344;17506,16425,0,0,3,0,3
36182,80,8344,12927;13115;16948,16425,0,0,3,0,3
36183,80,8345,13489;13537;18114,16425,0,1,2,0,3
36184,80,8346,12504;13377,16425,0,0,2,0,2
36185,80,8347,13007;13137;17555,16425,0,0,3,0,3
36186,80,8348,12809;13350;16218,16425,0,0,3,0,3
36187,80,8349,12863;13166,16425,0,0,2,0,2
36188,80,8350,12605;13167,16425,0,0,2,0,2
36189,80,8351,13179;13514,16425,0,0,2,0,2
36190,80,8353,12634;13183,16425,0,0,2,0,2
36191,80,8354,13335;15945,16425,0,0,2,0,2
36192,80,8355,12994;13161;17629,16425,0,0,3,0,3
36193,80,8357,714,16790,0,0,0,1,1
36194,80,8361,5421,16790,0,0,0,1,1
36195,80,8376,878,16790,0,0,0,1,1
36196,80,8386,10976,16790,0,0,0,1,1
36197,80,8391,11513;11681;16608,16790,0,0,1,2,3
36198,80,8394,11631;12033,16790,0,0,1,1,2
36199,80,8395,12144,16790,0,0,1,0,1
36200,80,8400,12412;12772;17834,16790,0,0,3,0,3
36201,80,8402,12675,16790,0,0,1,0,1
36202,80,8403,12209;12967,16790,0,0,2,0,2
36203,80,8404,12251;12278,16790,0,0,2,0,2
36204,80,8405,12301;12918,16790,0,0,2,0,2
36205,80,8407,12406;12687;16235;16642,16790,0,0,4,0,4
36206,80,8408,12430;12909;17768,16790,0,0,3,0,3
36207,80,8411,12857;12888,16790,0,0,2,0,2
36208,80,8412,12895,16790,0,0,1,0,1
36209,80,8413,13019;13287;17625,16790,0,0,3,0,3
36210,80,8415,12854;13165;17546;17636,16790,0,0,4,0,4
36211,80,8416,12480;12627,16790,0,0,2,0,2
36212,80,8417,12577;12628,16790,0,0,2,0,2
36213,80,8419,12913;13103,16790,0,0,2,0,2
36214,80,8420,12641;13409;18643,16790,0,1,2,0,3
36215,80,8421,12645;13510;17246;18270,16790,0,1,3,0,4
36216,80,8422,12646;12850;16507;17660,16790,0,0,4,0,4
36217,80,8423,12681;13299;16622;17288;17841;18420,16790,0,1,5,0,6
36218,80,8424,12685;13223;17537,16790,0,0,3,0,3
36219,80,8425,12665;16350,16790,0,0,2,0,2
36220,80,8426,11546;12252,16790,0,0,1,1,2
36221,80,8427,12710;13318;18143,16790,0,1,2,0,3
36222,80,8428,13204;13423;17595,16790,0,0,3,0,3
36223,80,8429,12726;12846,16790,0,0,2,0,2
36224,80,8430,12676;13209,16790,0,0,2,0,2
36225,80,8431,12293;12761,16790,0,0,2,0,2
36226,80,8432,12277;16572;17251,16790,0,0,3,0,3
36227,80,8434,13083,16790,0,0,1,0,1
36228,80,8435,12439;12827;16900,16790,0,0,3,0,3
36229,80,8436,12712;13031,16790,0,0,2,0,2
36230,80,8437,13035;17212,16790,0,0,2,0,2
36231,80,8438,13342;13619,16790,0,0,2,0,2
36232,80,8439,12980;13535,16790,0,0,2,0,2
36233,80,8440,13062;13194,16790,0,0,2,0,2
36234,80,8441,13043;13064,16790,0,0,2,0,2
36235,80,8442,12939;13316,16790,0,0,2,0,2
36236,80,8443,13049;13564,16790,0,0,2,0,2
36237,80,8444,12523;13292,16790,0,0,2,0,2
36238,80,8445,13610;17500,16790,0,0,2,0,2
36239,80,8446,13272;17463,16790,0,0,2,0,2
36240,80,8447,13159;16604;17422,16790,0,0,3,0,3
36241,80,8449,12550;13163;17616,16790,0,0,3,0,3
36242,80,8450,13172;13416;16558;17230;18061,16790,0,1,4,0,5
36243,80,8451,13189;16602,16790,0,0,2,0,2
36244,80,8452,13198;13240;18229,16790,0,1,2,0,3
36245,80,8453,13617,16790,0,0,1,0,1
36246,80,8454,12956;13254;17522;17735,16790,0,0,4,0,4
36247,80,8455,13577;13793;17159;18271,16790,0,1,3,0,4
36248,80,8456,13092;13314,16790,0,0,2,0,2
36249,80,8457,13300;13473,16790,0,0,2,0,2
36250,80,8458,12874;13361;17510,16790,0,0,3,0,3
36251,80,8459,13018;13310,16790,0,0,2,0,2
36252,80,8460,13320;13536,16790,0,0,2,0,2
36253,80,8461,13082;13323;17820,16790,0,0,3,0,3
36254,80,8462,13151;13439;17720;18150,16790,0,1,3,0,4
36255,80,8463,13604,16790,0,0,1,0,1
36256,80,8464,13427;13533;16361,16790,0,0,3,0,3
36257,80,8466,316,17155,0,0,0,1,1
36258,80,8467,81,17155,0,0,0,1,1
36259,80,8468,6465,17155,0,0,0,1,1
36260,80,8474,10164,17155,0,0,0,1,1
36261,80,8478,3266,17155,0,0,0,1,1
36262,80,8481,7530,17155,0,0,0,1,1
36263,80,8497,11208;11249,17155,0,0,0,2,2
36264,80,8503,11548;11872,17155,0,0,1,1,2
36265,80,8505,11799;11874,17155,0,0,1,1,2
36266,80,8506,11912;12334,17155,0,0,2,0,2
36267,80,8507,11809;12141,17155,0,0,1,1,2
36268,80,8509,11940;12086;17621,17155,0,0,3,0,3
36269,80,8511,12080,17155,0,0,1,0,1
36270,80,8512,11826;12261,17155,0,0,1,1,2
36271,80,8514,11507;16466;16776,17155,0,0,2,1,3
36272,80,8515,12574;12844;17380,17155,0,0,3,0,3
36273,80,8519,12719;17138;17731,17155,0,0,3,0,3
36274,80,8520,12615;17218,17155,0,0,2,0,2
36275,80,8521,12386;12544;17582,17155,0,0,3,0,3
36276,80,8522,12189,17155,0,0,1,0,1
36277,80,8523,12672;13142;18360,17155,0,1,2,0,3
36278,80,8524,13328;13363,17155,0,0,2,0,2
36279,80,8525,12243;12693,17155,0,0,2,0,2
36280,80,8526,12774;12963;16682,17155,0,0,3,0,3
36281,80,8527,12738;12869,17155,0,0,2,0,2
36282,80,8528,12524;13030;18484,17155,0,1,2,0,3
36283,80,8529,13192;13370;17041,17155,0,0,3,0,3
36284,80,8530,12688;12707,17155,0,0,2,0,2
36285,80,8531,12840;17992,17155,0,0,2,0,2
36286,80,8532,12873;13500,17155,0,0,2,0,2
36287,80,8533,13397;17514,17155,0,0,2,0,2
36288,80,8534,12778;13467,17155,0,0,2,0,2
36289,80,8535,12867;12924,17155,0,0,2,0,2
36290,80,8536,12398;12948;17866,17155,0,0,3,0,3
36291,80,8537,13434;13438;17499,17155,0,0,3,0,3
36292,80,8538,12988;13184,17155,0,0,2,0,2
36293,80,8539,13540;17347;17896,17155,0,0,3,0,3
36294,80,8540,13067;13475,17155,0,0,2,0,2
36295,80,8541,12435;13068,17155,0,0,2,0,2
36296,80,8542,12813,17155,0,0,1,0,1
36297,80,8543,12771;12834;17376,17155,0,0,3,0,3
36298,80,8544,13175;16805;17903,17155,0,0,3,0,3
36299,80,8545,12972;13126;17391,17155,0,0,3,0,3
36300,80,8546,13011;13131,17155,0,0,2,0,2
36301,80,8547,12654;17781,17155,0,0,2,0,2
36302,80,8548,13022;13138;17956,17155,0,0,3,0,3
36303,80,8549,13141,17155,0,0,1,0,1
36304,80,8550,12826;13150;17339,17155,0,0,3,0,3
36305,80,8551,13237;16820,17155,0,0,2,0,2
36306,80,8552,13178;17927;18189,17155,0,1,2,0,3
36307,80,8553,13009;13200,17155,0,0,2,0,2
36308,80,8554,13449,17155,0,0,1,0,1
36309,80,8555,12959;13221;17052,17155,0,0,3,0,3
36310,80,8556,13860;17885,17155,0,0,2,0,2
36311,80,8557,12614;13087;17307;17853,17155,0,0,4,0,4
36312,80,8559,13324,17155,0,0,1,0,1
36313,80,8560,13188;13249;17879,17155,0,0,3,0,3
36314,80,8561,13264;16721;17002;17794,17155,0,0,4,0,4
36315,80,8562,12807;13289;17558,17155,0,0,3,0,3
36316,80,8563,13243;13594;17816,17155,0,0,3,0,3
36317,80,8564,12968;13291,17155,0,0,2,0,2
36318,80,8565,13388;17603;17861;17962,17155,0,0,4,0,4
36319,80,8566,13331;13624,17155,0,0,2,0,2
36320,80,8567,13238;17503;18312,17155,0,1,2,0,3
36321,80,8568,13384;18148,17155,0,1,1,0,2
36322,80,8569,13389;13488;17324,17155,0,0,3,0,3
36323,80,8570,13055;13392;17229;17757,17155,0,0,4,0,4
36324,80,8571,13147;13492,17155,0,0,2,0,2
36325,80,8572,13217;13779;16581;18469,17155,0,1,3,0,4
36326,80,8573,13039;13301;17013,17155,0,0,3,0,3
36327,80,8574,13445;13747;17991,17155,0,0,3,0,3
36328,80,8575,12795;13450,17155,0,0,2,0,2
36329,80,8576,13581;13602;17529;18001,17155,0,0,4,0,4
36330,80,8577,13471;13909;18403,17155,0,1,2,0,3
36331,80,8578,13390;13493,17155,0,0,2,0,2
36332,80,8579,13655;13782;16379;17960,17155,0,0,4,0,4
36333,80,8584,7712,17520,0,0,0,1,1
36334,80,8591,10207;10480,17520,0,0,0,2,2
36335,80,8592,10452,17520,0,0,0,1,1
36336,80,8593,1747,17520,0,0,0,1,1
36337,80,8598,10393,17520,0,0,0,1,1
36338,80,8607,10643;11052,17520,0,0,0,2,2
36339,80,8610,11241,17520,0,0,0,1,1
36340,80,8612,11161;11299,17520,0,0,0,2,2
36341,80,8621,11852;12255,17520,0,0,1,1,2
36342,80,8623,12028;12356,17520,0,0,2,0,2
36343,80,8624,12078;12136;16605;18000,17520,0,0,4,0,4
36344,80,8626,12828;13290;17069,17520,0,0,3,0,3
36345,80,8628,12453,17520,0,0,1,0,1
36346,80,8629,12457;12473,17520,0,0,2,0,2
36347,80,8630,12475;17082,17520,0,0,2,0,2
36348,80,8635,13033;17215,17520,0,0,2,0,2
36349,80,8636,13422;13455;17814;17890;18044,17520,0,1,4,0,5
36350,80,8637,12330;12724;17113,17520,0,0,3,0,3
36351,80,8638,12734;17379,17520,0,0,2,0,2
36352,80,8639,12423;12796;17608,17520,0,0,3,0,3
36353,80,8640,12698;12818,17520,0,0,2,0,2
36354,80,8642,12769;12856,17520,0,0,2,0,2
36355,80,8643,12354;12862;18218,17520,0,1,2,0,3
36356,80,8644,13415;13802;17999,17520,0,0,3,0,3
36357,80,8645,12679;12977;17602,17520,0,0,3,0,3
36358,80,8646,12995;13278,17520,0,0,2,0,2
36359,80,8647,13523,17520,0,0,1,0,1
36360,80,8648,13084;13343;17839,17520,0,0,3,0,3
36361,80,8649,13060;13100,17520,0,0,2,0,2
36362,80,8650,13155;13562;18016,17520,0,1,2,0,3
36363,80,8651,12522;13158;16824,17520,0,0,3,0,3
36364,80,8652,13459;17709,17520,0,0,2,0,2
36365,80,8653,13199;18053;18285,17520,0,2,1,0,3
36366,80,8654,13233;13378;17450,17520,0,0,3,0,3
36367,80,8655,12990;13259;17609,17520,0,0,3,0,3
36368,80,8656,13603;17360;17518,17520,0,0,3,0,3
36369,80,8657,12974;13277;16991;17937,17520,0,0,4,0,4
36370,80,8658,13294;17743,17520,0,0,2,0,2
36371,80,8659,13371;13676;18598,17520,0,1,2,0,3
36372,80,8660,13582;14055,17520,0,0,2,0,2
36373,80,8661,13334;13919;17226;17496;17727,17520,0,0,5,0,5
36374,80,8662,12877;13341,17520,0,0,2,0,2
36375,80,8663,12859;13367;17249;17425,17520,0,0,4,0,4
36376,80,8664,12993;13975;17844;18066;18470;19177,17520,0,3,3,0,6
36377,80,8665,13372;13856,17520,0,0,2,0,2
36378,80,8667,12606;12668,17520,0,0,2,0,2
36379,80,8668,13396;14025;17487,17520,0,0,3,0,3
36380,80,8669,13400;13635;18031,17520,0,1,2,0,3
36381,80,8670,13411,17520,0,0,1,0,1
36382,80,8671,13525;13952;17966,17520,0,0,3,0,3
36383,80,8673,13010;13496,17520,0,0,2,0,2
36384,80,8674,13021;13502,17520,0,0,2,0,2
36385,80,8675,13201;13511,17520,0,0,2,0,2
36386,80,8677,13241;13543;17141;18672,17520,0,1,3,0,4
36387,80,8678,13118;13559,17520,0,0,2,0,2
36388,80,8679,13762;13837;18059,17520,0,1,2,0,3
36389,80,8681,13567;17576,17520,0,0,2,0,2
36390,80,8682,13296;13568;16414;18142,17520,0,1,3,0,4
36391,80,8683,13580;13740;18202,17520,0,1,2,0,3
36392,80,8684,13532;13821;16800;17912,17520,0,0,4,0,4
36393,80,8685,13607;13805,17520,0,0,2,0,2
36394,80,8686,13622;13934;16431;17857,17520,0,0,4,0,4
36395,80,8687,13640;13680;17247;18508,17520,0,1,3,0,4
36396,80,8688,13653;13792;17033,17520,0,0,3,0,3
36397,80,8689,13498;13664;16956;17800,17520,0,0,4,0,4
36398,80,8690,13491;13666;17826,17520,0,0,3,0,3
36399,80,8692,8297,17885,0,0,0,1,1
36400,80,8695,6071,17885,0,0,0,1,1
36401,80,8697,4689,17885,0,0,0,1,1
36402,80,8699,5572,17885,0,0,0,1,1
36403,80,8702,175;1027,17885,0,0,0,2,2
36404,80,8706,3247,17885,0,0,0,1,1
36405,80,8710,11045,17885,0,0,0,1,1
36406,80,8718,11624;11717,17885,0,0,0,2,2
36407,80,8719,11592;11682,17885,0,0,0,2,2
36408,80,8725,11662;11744;16749,17885,0,0,1,2,3
36409,80,8726,12669;12760;16777;17397,17885,0,0,4,0,4
36410,80,8727,12066,17885,0,0,1,0,1
36411,80,8728,12079;12145,17885,0,0,2,0,2
36412,80,8729,12138;12722,17885,0,0,2,0,2
36413,80,8730,12151;13108,17885,0,0,2,0,2
36414,80,8731,12428;12744;17300,17885,0,0,3,0,3
36415,80,8734,12396;17542,17885,0,0,2,0,2
36416,80,8735,11763;12043,17885,0,0,1,1,2
36417,80,8736,11754;11820;17145,17885,0,0,1,2,3
36418,80,8737,12464;12934,17885,0,0,2,0,2
36419,80,8738,11909;12479;17477,17885,0,0,3,0,3
36420,80,8739,12816;13472;17624,17885,0,0,3,0,3
36421,80,8741,12583;12930;17495,17885,0,0,3,0,3
36422,80,8742,12431;12662,17885,0,0,2,0,2
36423,80,8743,11885;12364,17885,0,0,2,0,2
36424,80,8744,12343;12649,17885,0,0,2,0,2
36425,80,8747,12494;12768,17885,0,0,2,0,2
36426,80,8748,13156;13403;18146,17885,0,1,2,0,3
36427,80,8749,12352;12814,17885,0,0,2,0,2
36428,80,8750,12851,17885,0,0,1,0,1
36429,80,8751,12901;13149,17885,0,0,2,0,2
36430,80,8752,12416;13280;16747;17688,17885,0,0,4,0,4
36431,80,8753,12971;13503,17885,0,0,2,0,2
36432,80,8754,13408;17734,17885,0,0,2,0,2
36433,80,8755,13034;14031;17490;18260,17885,0,1,3,0,4
36434,80,8756,12792;13047;17541;17685,17885,0,0,4,0,4
36435,80,8757,12482;13053;16641,17885,0,0,3,0,3
36436,80,8759,13186;13236;17846,17885,0,0,3,0,3
36437,80,8760,13214;13305;18060,17885,0,1,2,0,3
36438,80,8761,13219;13544;17183;18317,17885,0,1,3,0,4
36439,80,8762,13027;13657;17190;17612,17885,0,0,4,0,4
36440,80,8763,13421,17885,0,0,1,0,1
36441,80,8764,12713;13429;18079;18119,17885,0,2,2,0,4
36442,80,8765,13519,17885,0,0,1,0,1
36443,80,8766,13267;13442,17885,0,0,2,0,2
36444,80,8767,12766;13893;18091,17885,0,1,2,0,3
36445,80,8768,13079;13507;16884,17885,0,0,3,0,3
36446,80,8769,13461;18207,17885,0,1,1,0,2
36447,80,8770,13463;13481,17885,0,0,2,0,2
36448,80,8771,13048;13479;17754,17885,0,0,3,0,3
36449,80,8772,12557;13485;18274,17885,0,1,2,0,3
36450,80,8773,14142;17169;18537;18772,17885,0,2,2,0,4
36451,80,8774,13902,17885,0,0,1,0,1
36452,80,8775,13539;14143;16522;16865;17858;17931,17885,0,0,6,0,6
36453,80,8776,13288;13560;17127;18385,17885,0,1,3,0,4
36454,80,8777,13375;13570;18104,17885,0,1,2,0,3
36455,80,8778,12842,17885,0,0,1,0,1
36456,80,8779,13955,17885,0,0,1,0,1
36457,80,8780,13601;13701;16580;18002;18013,17885,0,1,4,0,5
36458,80,8781,13654;17174,17885,0,0,2,0,2
36459,80,8782,13252;13592;17985;18134,17885,0,1,3,0,4
36460,80,8783,13803,17885,0,0,1,0,1
36461,80,8784,13683;13970;16881;17790,17885,0,0,4,0,4
36462,80,8785,13827;14165;17299;18063;18219,17885,0,2,3,0,5
36463,80,8786,13351;14183;17508;17973,17885,0,0,4,0,4
36464,80,8787,13714;14112,17885,0,0,2,0,2
36465,80,8788,13443;13863;17977;18127,17885,0,1,3,0,4
36466,80,8789,13720;13826;18473,17885,0,1,2,0,3
36467,80,8790,13210;13721;17421;17740,17885,0,0,4,0,4
36468,80,8791,13345;14052;17382,17885,0,0,3,0,3
36469,80,8792,13767,17885,0,0,1,0,1
36470,80,8793,13777;13868,17885,0,0,2,0,2
36471,80,8794,13871;14059;17291;18439,17885,0,1,3,0,4
36472,80,8797,3478,18250,0,0,0,1,1
36473,80,8801,6261,18250,0,0,0,1,1
36474,80,8804,379;6444,18250,0,0,0,2,2
36475,80,8805,7324,18250,0,0,0,1,1
36476,80,8807,1328,18250,0,0,0,1,1
36477,80,8811,10123,18250,0,0,0,1,1
36478,80,8812,10102,18250,0,0,0,1,1
36479,80,8813,10007,18250,0,0,0,1,1
36480,80,8821,10514;10978,18250,0,0,0,2,2
36481,80,8822,11796,18250,0,0,0,1,1
36482,80,8823,11741,18250,0,0,0,1,1
36483,80,8826,11613,18250,0,0,0,1,1
36484,80,8827,11920;17279,18250,0,0,2,0,2
36485,80,8828,11714;11895,18250,0,0,1,1,2
36486,80,8830,11816;11973,18250,0,0,1,1,2
36487,80,8831,11890;11995,18250,0,0,2,0,2
36488,80,8832,11972;12425;17634,18250,0,0,3,0,3
36489,80,8835,12375;13008,18250,0,0,2,0,2
36490,80,8836,12385;13077,18250,0,0,2,0,2
36491,80,8837,13085;13125,18250,0,0,2,0,2
36492,80,8838,12411;16878,18250,0,0,2,0,2
36493,80,8839,12498;12540;17185;17823,18250,0,0,4,0,4
36494,80,8840,12103;12617,18250,0,0,2,0,2
36495,80,8841,12940,18250,0,0,1,0,1
36496,80,8842,12656;16964;17755,18250,0,0,3,0,3
36497,80,8843,12399;12794,18250,0,0,2,0,2
36498,80,8845,12720,18250,0,0,1,0,1
36499,80,8846,12742;13120,18250,0,0,2,0,2
36500,80,8847,13119;13478,18250,0,0,2,0,2
36501,80,8848,12422;12811;17426,18250,0,0,3,0,3
36502,80,8849,12944;17957,18250,0,0,2,0,2
36503,80,8850,12955;13187;17797,18250,0,0,3,0,3
36504,80,8851,12965;13154;17264;17502;17778,18250,0,0,5,0,5
36505,80,8852,12985;13838,18250,0,0,2,0,2
36506,80,8853,13038;13153,18250,0,0,2,0,2
36507,80,8854,12891;13054,18250,0,0,2,0,2
36508,80,8855,13315;13929;17842,18250,0,0,3,0,3
36509,80,8856,12989,18250,0,0,1,0,1
36510,80,8857,13129;13242,18250,0,0,2,0,2
36511,80,8858,12363;12798,18250,0,0,2,0,2
36512,80,8859,13256;13695;18130,18250,0,1,2,0,3
36513,80,8860,13174;13271,18250,0,0,2,0,2
36514,80,8861,13515,18250,0,0,1,0,1
36515,80,8863,13574;18033,18250,0,1,1,0,2
36516,80,8864,13307;17693;17919,18250,0,0,3,0,3
36517,80,8865,13348;17981,18250,0,0,2,0,2
36518,80,8867,13105;14150;17150;17878,18250,0,0,4,0,4
36519,80,8868,13486;13588;17214;17921,18250,0,0,4,0,4
36520,80,8870,13590,18250,0,0,1,0,1
36521,80,8871,14064;17881,18250,0,0,2,0,2
36522,80,8872,13541;13811;17593,18250,0,0,3,0,3
36523,80,8873,13462;13698;17260;18815,18250,0,1,3,0,4
36524,80,8874,13339;13561,18250,0,0,2,0,2
36525,80,8875,13340;13573;17429,18250,0,0,3,0,3
36526,80,8876,13304;13761;17845,18250,0,0,3,0,3
36527,80,8877,13593;18489,18250,0,1,1,0,2
36528,80,8879,13405;14047;17303,18250,0,0,3,0,3
36529,80,8880,13260;13637;17871,18250,0,0,3,0,3
36530,80,8882,13448;13889,18250,0,0,2,0,2
36531,80,8883,13631;13935;17888;18177;18544,18250,0,2,3,0,5
36532,80,8884,14017;16879;17197;18197,18250,0,1,3,0,4
36533,80,8885,13646;14280;18139,18250,0,1,2,0,3
36534,80,8886,13652;14190,18250,0,0,2,0,2
36535,80,8887,13659;13834;17100;17876;18689,18250,0,1,4,0,5
36536,80,8888,13662;14080;17590;17714,18250,0,0,4,0,4
36537,80,8889,13678;13755,18250,0,0,2,0,2
36538,80,8890,14065;14268;19097;19492,18250,1,1,2,0,4
36539,80,8891,13709;14121;18126,18250,0,1,2,0,3
36540,80,8892,13346;13712;18023;18238,18250,0,2,2,0,4
36541,80,8893,13578;13728;17571,18250,0,0,3,0,3
36542,80,8894,14071;16833;17198,18250,0,0,3,0,3
36543,80,8895,13736;14096;17963;18258,18250,0,1,3,0,4
36544,80,8896,13529;13760;17372;17872,18250,0,0,4,0,4
36545,80,8897,13733;13773,18250,0,0,2,0,2
36546,80,8898,13813;14093;16729;17434;17908;18623,18250,0,1,5,0,6
36547,80,8899,13877;13996;17498;17988,18250,0,0,4,0,4
36548,80,8900,14299;14416;17568;17773,18250,0,0,4,0,4
36549,80,8901,13203;13888;17102;17408;18965,18250,0,1,4,0,5
36550,80,8902,14019;17618;17865;18137,18250,0,1,3,0,4
36551,80,8903,13453;13681;18172;18284,18250,0,2,2,0,4
36552,80,8904,13716;14189;18286;18657,18250,0,2,2,0,4
36553,80,8905,13915;13971;16781;18232,18250,0,1,3,0,4
36554,80,8906,13879;13941;17628,18250,0,0,3,0,3
36555,80,8907,13004;13946,18250,0,0,2,0,2
36556,80,8908,13556;13950;17392,18250,0,0,3,0,3
36557,80,8909,448,18615,0,0,0,1,1
36558,80,8910,10146,18615,0,0,0,1,1
36559,80,8913,653;2365,18615,0,0,0,2,2
36560,80,8918,5775,18615,0,0,0,1,1
36561,80,8919,7385,18615,0,0,0,1,1
36562,80,8924,10144,18615,0,0,0,1,1
36563,80,8934,11430,18615,0,0,0,1,1
36564,80,8940,11630,18615,0,0,0,1,1
36565,80,8943,11839;12002;16986,18615,0,0,2,1,3
36566,80,8946,11859;12262,18615,0,0,1,1,2
36567,80,8950,12444;12526,18615,0,0,2,0,2
36568,80,8952,12341;12749;16724,18615,0,0,3,0,3
36569,80,8953,13262;17561,18615,0,0,2,0,2
36570,80,8954,12206;12695,18615,0,0,2,0,2
36571,80,8955,17250;19595,18615,1,0,1,0,2
36572,80,8956,12632;12733;16755,18615,0,0,3,0,3
36573,80,8957,12266;12741,18615,0,0,2,0,2
36574,80,8958,13128;13275;17084;17217,18615,0,0,4,0,4
36575,80,8962,12746;12929,18615,0,0,2,0,2
36576,80,8963,12947;13110,18615,0,0,2,0,2
36577,80,8964,12957;13606,18615,0,0,2,0,2
36578,80,8965,12970;13245,18615,0,0,2,0,2
36579,80,8966,12973,18615,0,0,1,0,1
36580,80,8967,13575;17346,18615,0,0,2,0,2
36581,80,8968,13942;14132,18615,0,0,2,0,2
36582,80,8969,13164;18680,18615,0,1,1,0,2
36583,80,8970,13215,18615,0,0,1,0,1
36584,80,8971,13258;13508;17946,18615,0,0,3,0,3
36585,80,8972,14033;14206;18237;18649,18615,0,2,2,0,4
36586,80,8973,13113;13441,18615,0,0,2,0,2
36587,80,8974,13587;13766;18848,18615,0,1,2,0,3
36588,80,8975,12926,18615,0,0,1,0,1
36589,80,8976,13546;13748;18138;18709,18615,0,2,2,0,4
36590,80,8977,13428;13749,18615,0,0,2,0,2
36591,80,8979,13317;13538;18416,18615,0,1,2,0,3
36592,80,8980,13979;17513,18615,0,0,2,0,2
36593,80,8981,13557;13968;18153,18615,0,1,2,0,3
36594,80,8982,17027,18615,0,0,1,0,1
36595,80,8983,13618;14210;18014;18329,18615,0,2,2,0,4
36596,80,8984,13705;17423;17695,18615,0,0,3,0,3
36597,80,8985,13393;13784,18615,0,0,2,0,2
36598,80,8986,13639;14011;17416;17705,18615,0,0,4,0,4
36599,80,8987,13824;18140,18615,0,1,1,0,2
36600,80,8988,13672;13991;17402,18615,0,0,3,0,3
36601,80,8989,13800;14155;17281;17530,18615,0,0,4,0,4
36602,80,8990,14285,18615,0,0,1,0,1
36603,80,8991,13693;13772;17724;17922,18615,0,0,4,0,4
36604,80,8992,13727;14291,18615,0,0,2,0,2
36605,80,8993,13470,18615,0,0,1,0,1
36606,80,8994,13625;14458;18298;18568;19914,18615,1,2,2,0,5
36607,80,8995,13913;14502;17432;17984;18443,18615,0,1,4,0,5
36608,80,8996,13951;14328;17412;17512;17703,18615,0,0,5,0,5
36609,80,8997,14048;14177;17940,18615,0,0,3,0,3
36610,80,8998,13999;14254;18279,18615,0,1,2,0,3
36611,80,8999,14000;14349;18712,18615,0,1,2,0,3
36612,80,9000,13753;14021;18106;18904,18615,0,2,2,0,4
36613,80,9001,13923;14022;17587,18615,0,0,3,0,3
36614,80,9002,14061;14315;17952;18588,18615,0,1,3,0,4
36615,80,9003,14051;14125;17762,18615,0,0,3,0,3
36616,80,9004,14359,18615,0,0,1,0,1
36617,80,9005,13840;14067;17654,18615,0,0,3,0,3
36618,80,9006,13810;14069;18305;18635,18615,0,2,2,0,4
36619,80,9007,13615;14074;18136;18472,18615,0,2,2,0,4
36620,80,9008,13547;14075;17891;18340,18615,0,1,3,0,4
36621,80,9009,13787;14084;18009,18615,0,1,2,0,3
36622,80,9011,7802,18980,0,0,0,1,1
36623,80,9014,4743,18980,0,0,0,1,1
36624,80,9021,4656,18980,0,0,0,1,1
36625,80,9023,2871,18980,0,0,0,1,1
36626,80,9026,10155,18980,0,0,0,1,1
36627,80,9034,11750;11999,18980,0,0,1,1,2
36628,80,9039,10468;11309,18980,0,0,0,2,2
36629,80,9042,11725;11868,18980,0,0,0,2,2
36630,80,9052,12215;12935;17990,18980,0,0,3,0,3
36631,80,9054,12211;12442,18980,0,0,2,0,2
36632,80,9056,12491;12937,18980,0,0,2,0,2
36633,80,9058,12607;13231;18198,18980,0,1,2,0,3
36634,80,9060,12157;12976;17974,18980,0,0,3,0,3
36635,80,9061,12509;12975,18980,0,0,2,0,2
36636,80,9062,12135;13090;17840;17900,18980,0,0,4,0,4
36637,80,9063,12845;13023;17202,18980,0,0,3,0,3
36638,80,9064,12270;13094,18980,0,0,2,0,2
36639,80,9065,12400;12433,18980,0,0,2,0,2
36640,80,9066,12996;13642;17676;18344,18980,0,1,3,0,4
36641,80,9068,12979;13059;17698,18980,0,0,3,0,3
36642,80,9069,13121,18980,0,0,1,0,1
36643,80,9070,13066;13122;17526,18980,0,0,3,0,3
36644,80,9071,13768;17786;18226;18338,18980,0,2,2,0,4
36645,80,9072,13208;13226;17964,18980,0,0,3,0,3
36646,80,9073,13218;13379;17789,18980,0,0,3,0,3
36647,80,9075,12833;13261,18980,0,0,2,0,2
36648,80,9076,12496;13266;16989;17809;17958,18980,0,0,5,0,5
36649,80,9077,13282;13313;17474,18980,0,0,3,0,3
36650,80,9078,13352;13629;17219,18980,0,0,3,0,3
36651,80,9079,13374;13807;17578,18980,0,0,3,0,3
36652,80,9082,13387;13420,18980,0,0,2,0,2
36653,80,9083,13426;13771;17752;18307,18980,0,1,3,0,4
36654,80,9084,13013;13432;18235,18980,0,1,2,0,3
36655,80,9085,13673;14292;18164;18250;19427,18980,1,2,2,0,5
36656,80,9086,13386;13447,18980,0,0,2,0,2
36657,80,9087,13212;13480;17620;18394,18980,0,1,3,0,4
36658,80,9088,13177,18980,0,0,1,0,1
36659,80,9089,14159;14174;18200;18833,18980,0,2,2,0,4
36660,80,9090,13989;14004;17536;17965;18399;18608,18980,0,2,4,0,6
36661,80,9091,13667;18056;18746,18980,0,2,1,0,3
36662,80,9092,12951;13669;17451;17601,18980,0,0,4,0,4
36663,80,9093,13703;13911;18102,18980,0,1,2,0,3
36664,80,9094,13674;13707;17766,18980,0,0,3,0,3
36665,80,9095,13517;14095,18980,0,0,2,0,2
36666,80,9096,14567,18980,0,0,1,0,1
36667,80,9097,13774;14340,18980,0,0,2,0,2
36668,80,9098,13490;13814,18980,0,0,2,0,2
36669,80,9099,13820;14318,18980,0,0,2,0,2
36670,80,9100,13830;14494;17388;18418,18980,0,1,3,0,4
36671,80,9101,13836;14406;18255,18980,0,1,2,0,3
36672,80,9102,13897;14327;17870;17980;18039,18980,0,1,4,0,5
36673,80,9103,13758;14063,18980,0,0,2,0,2
36674,80,9104,13641;13890;17611;17869;18073,18980,0,1,4,0,5
36675,80,9105,14341;14439;17771;18041,18980,0,1,3,0,4
36676,80,9106,14293;17924;18209,18980,0,1,2,0,3
36677,80,9107,13735;13920;17149;18462;18683,18980,0,2,3,0,5
36678,80,9108,13878;14212,18980,0,0,2,0,2
36679,80,9109,13956;17452;18296,18980,0,1,2,0,3
36680,80,9110,13597;13958,18980,0,0,2,0,2
36681,80,9111,13279;13967,18980,0,0,2,0,2
36682,80,9112,13456;13981;17072;18515,18980,0,1,3,0,4
36683,80,9113,14062;14478;18830,18980,0,1,2,0,3
36684,80,9114,14008;14037;17352;18323,18980,0,1,3,0,4
36685,80,9115,14034;14070,18980,0,0,2,0,2
36686,80,9116,14215;14467;17785,18980,0,0,3,0,3
36687,80,9117,14358;14475;18048,18980,0,1,2,0,3
36688,80,9118,13621;14153;18193,18980,0,1,2,0,3
36689,80,9119,13643;14130;17769;18035,18980,0,1,3,0,4
36690,80,9120,14081;14496;18154;18606,18980,0,2,2,0,4
36691,80,9121,14085;14102,18980,0,0,2,0,2
36692,80,9122,14110;14263;19119,18980,0,1,2,0,3
36693,80,9123,14137;14590,18980,0,0,2,0,2
36694,80,9124,14169,18980,0,0,1,0,1
36695,80,9125,14171;14530;17030;17615,18980,0,0,4,0,4
36696,80,9135,10028,19345,0,0,0,1,1
36697,80,9149,11772;12036,19345,0,0,1,1,2
36698,80,9150,11508;11794;17248,19345,0,0,1,2,3
36699,80,9151,12427;17081;17647,19345,0,0,3,0,3
36700,80,9153,12050;17038,19345,0,0,2,0,2
36701,80,9154,12055;17112,19345,0,0,2,0,2
36702,80,9156,11871;12113,19345,0,0,1,1,2
36703,80,9160,11893;12315,19345,0,0,2,0,2
36704,80,9161,12664;13656,19345,0,0,2,0,2
36705,80,9165,12961;13225;18071,19345,0,1,2,0,3
36706,80,9166,12579;12843;17280,19345,0,0,3,0,3
36707,80,9167,12275;12790;17637,19345,0,0,3,0,3
36708,80,9168,12682;13065,19345,0,0,2,0,2
36709,80,9169,12779;13332;17712;18191,19345,0,1,3,0,4
36710,80,9170,12182;12747,19345,0,0,2,0,2
36711,80,9171,12899,19345,0,0,1,0,1
36712,80,9172,12896;13071,19345,0,0,2,0,2
36713,80,9174,12943;13930;17856,19345,0,0,3,0,3
36714,80,9175,12954;13648,19345,0,0,2,0,2
36715,80,9176,12312;13173,19345,0,0,2,0,2
36716,80,9177,12853;13072;17591,19345,0,0,3,0,3
36717,80,9178,13088;13412;18088,19345,0,1,2,0,3
36718,80,9179,13487;14029;17893,19345,0,0,3,0,3
36719,80,9180,13357;17466,19345,0,0,2,0,2
36720,80,9181,13136;13831;18995,19345,0,1,2,0,3
36721,80,9182,13454;13718,19345,0,0,2,0,2
36722,80,9183,13193;13402,19345,0,0,2,0,2
36723,80,9186,13253;13477;17361,19345,0,0,3,0,3
36724,80,9187,13440;17751,19345,0,0,2,0,2
36725,80,9188,13205;13322;17148;17200,19345,0,0,4,0,4
36726,80,9189,13056;13325,19345,0,0,2,0,2
36727,80,9190,13326;13861,19345,0,0,2,0,2
36728,80,9192,13395;14231;18299;18414;18628,19345,0,3,2,0,5
36729,80,9193,13424;13818,19345,0,0,2,0,2
36730,80,9195,13474;13922;17746,19345,0,0,3,0,3
36731,80,9196,14168,19345,0,0,1,0,1
36732,80,9198,13433;13484,19345,0,0,2,0,2
36733,80,9199,14316;17730;18417,19345,0,1,2,0,3
36734,80,9200,13585;14009;17668;18878,19345,0,1,3,0,4
36735,80,9201,13349,19345,0,0,1,0,1
36736,80,9202,13436;13677;17334;17917,19345,0,0,4,0,4
36737,80,9203,13306;13791;17053;17343,19345,0,0,4,0,4
36738,80,9204,13452;13633,19345,0,0,2,0,2
36739,80,9205,13689;14107,19345,0,0,2,0,2
36740,80,9206,13356;13691;17381,19345,0,0,3,0,3
36741,80,9207,13730;14374;17661;18049;18646,19345,0,2,3,0,5
36742,80,9208,13739;14164;16979;17805,19345,0,0,4,0,4
36743,80,9209,13973;18405;18652,19345,0,2,1,0,3
36744,80,9210,13809;17753;18101,19345,0,1,2,0,3
36745,80,9211,13895;14056;17123;18554,19345,0,1,3,0,4
36746,80,9212,13815;17133;17726;17882,19345,0,0,4,0,4
36747,80,9213,13786;13823;17939,19345,0,0,3,0,3
36748,80,9214,14575;14580;18185;18365,19345,0,2,2,0,4
36749,80,9215,14370,19345,0,0,1,0,1
36750,80,9216,13966,19345,0,0,1,0,1
36751,80,9217,14089;17540;18334,19345,0,1,2,0,3
36752,80,9218,14411;14606;17362;17664;18396;18527,19345,0,2,4,0,6
36753,80,9219,13754;13961;18275,19345,0,1,2,0,3
36754,80,9220,13886;13965;17146;17832,19345,0,0,4,0,4
36755,80,9221,13866;13972;18054,19345,0,1,2,0,3
36756,80,9222,14235,19345,0,0,1,0,1
36757,80,9223,14040;14499;17802;18944,19345,0,1,3,0,4
36758,80,9225,14098;14789;17461,19345,0,0,3,0,3
36759,80,9227,14124;14413;18159;19000,19345,0,2,2,0,4
36760,80,9228,13848;14126;18208,19345,0,1,2,0,3
36761,80,9229,14133;14365,19345,0,0,2,0,2
36762,80,9230,14134;17760;18043,19345,0,1,2,0,3
36763,80,9231,13687;14140,19345,0,0,2,0,2
36764,80,9232,14144;14605;17589;18391,19345,0,1,3,0,4
36765,80,9233,14161;14464;17475;17994;18346,19345,0,1,4,0,5
36766,80,9234,14180;14715;18837;19225,19345,0,2,2,0,4
36767,80,9235,13817;14229;17836;18052;18261,19345,0,2,3,0,5
36768,80,9236,13937;14259;18068,19345,0,1,2,0,3
36769,80,9237,14099;14270;18597,19345,0,1,2,0,3
36770,80,9238,13790;14277;17799;18108,19345,0,1,3,0,4
36771,80,9239,14282;14319;17470,19345,0,0,3,0,3
36772,80,9240,13690;14287;18564;19317,19345,0,2,2,0,4
36773,80,9241,13713;14305,19345,0,0,2,0,2
36774,80,9242,14675;14942;17001;17533;17989;18723,19345,0,1,5,0,6
36775,80,9243,14330;14615;17094;18504,19345,0,1,3,0,4
36776,80,9244,14323;14364;17780,19345,0,0,3,0,3
36777,80,9246,4476;4699,19710,0,0,0,2,2
36778,80,9248,2893,19710,0,0,0,1,1
36779,80,9250,10439,19710,0,0,0,1,1
36780,80,9256,11414,19710,0,0,0,1,1
36781,80,9264,11818;11878,19710,0,0,1,1,2
36782,80,9271,12305;12369;17098;17928,19710,0,0,4,0,4
36783,80,9273,12445;12903,19710,0,0,2,0,2
36784,80,9276,12667;13333;17942,19710,0,0,3,0,3
36785,80,9280,13284,19710,0,0,1,0,1
36786,80,9281,13081;13513;17975,19710,0,0,3,0,3
36787,80,9282,13117;13494;17345;17759;18400;18589,19710,0,2,4,0,6
36788,80,9284,13196;13283;17716;17929,19710,0,0,4,0,4
36789,80,9285,13032;13338;17765;18017,19710,0,1,3,0,4
36790,80,9286,13399;13524;17803;17969,19710,0,0,4,0,4
36791,80,9288,12897;13430;18389,19710,0,1,2,0,3
36792,80,9289,13437;14006;17493;17867,19710,0,0,4,0,4
36793,80,9290,13152;13465;17374,19710,0,0,3,0,3
36794,80,9291,12861;13015,19710,0,0,2,0,2
36795,80,9293,13645;13905;18244,19710,0,1,2,0,3
36796,80,9294,14149;14607;17119,19710,0,0,3,0,3
36797,80,9295,13757;13808;17666;18287,19710,0,1,3,0,4
36798,80,9296,13661;13858;17389,19710,0,0,3,0,3
36799,80,9297,13675;17473;17690,19710,0,0,3,0,3
36800,80,9298,13551;13859;18660,19710,0,1,2,0,3
36801,80,9299,13566;14131;19060,19710,0,1,2,0,3
36802,80,9300,13499;13796;18176;18432,19710,0,2,2,0,4
36803,80,9301,13855;14135;18122,19710,0,1,2,0,3
36804,80,9302,14073;18500;19544,19710,1,1,1,0,3
36805,80,9303,13933;17863;18407,19710,0,1,2,0,3
36806,80,9304,14366;17864;19171,19710,0,1,2,0,3
36807,80,9305,13750;13882,19710,0,0,2,0,2
36808,80,9306,14224,19710,0,0,1,0,1
36809,80,9307,14344;14927;18343;18875,19710,0,2,2,0,4
36810,80,9308,14463;18249;18849,19710,0,2,1,0,3
36811,80,9309,13770;13990,19710,0,0,2,0,2
36812,80,9310,13839;14417,19710,0,0,2,0,2
36813,80,9311,13994;14311;17887;18467,19710,0,1,3,0,4
36814,80,9312,14028;14437;17898;18370,19710,0,1,3,0,4
36815,80,9313,13704;14077;17523;18120,19710,0,1,3,0,4
36816,80,9314,13628;14136;17465;17995,19710,0,0,4,0,4
36817,80,9316,14079;14771;18737,19710,0,1,2,0,3
36818,80,9317,13457;14139;17873;18179,19710,0,1,3,0,4
36819,80,9318,14146;14584;17137;18254,19710,0,1,3,0,4
36820,80,9319,13715;14151;17976,19710,0,0,3,0,3
36821,80,9320,14156;14866;18493;18725,19710,0,2,2,0,4
36822,80,9322,14201;14331;18909,19710,0,1,2,0,3
36823,80,9323,14238;14527;18511;18555,19710,0,2,2,0,4
36824,80,9324,13726;14321,19710,0,0,2,0,2
36825,80,9325,13788;14333;17655,19710,0,0,3,0,3
36826,80,9326,13816;14363;17449;17756,19710,0,0,4,0,4
36827,80,9327,14381;14753;17516,19710,0,0,3,0,3
36828,80,9328,14385;17375,19710,0,0,2,0,2
36829,80,9329,13980;14398;19123,19710,0,1,2,0,3
36830,80,9330,14705;14718,19710,0,0,2,0,2
36831,80,9332,14407;14821;18402;19001,19710,0,2,2,0,4
36832,80,9333,14519;14897;18280;18319,19710,0,2,2,0,4
36833,80,9334,14457;17722;19035,19710,0,1,2,0,3
36834,80,9335,13983;14469;18906,19710,0,1,2,0,3
36835,80,9336,14481,19710,0,0,1,0,1
36836,80,9337,14036;14503;17245,19710,0,0,3,0,3
36837,80,9338,14727;18497;18888,19710,0,2,1,0,3
36838,80,9339,14166;14514;18326;19382,19710,1,1,2,0,4
36839,80,9340,14241;14522;17707;18567,19710,0,1,3,0,4
36840,80,9341,9689,20075,0,0,0,1,1
36841,80,9342,6990,20075,0,0,0,1,1
36842,80,9343,3859,20075,0,0,0,1,1
36843,80,9345,7344,20075,0,0,0,1,1
36844,80,9348,29,20075,0,0,0,1,1
36845,80,9349,10015,20075,0,0,0,1,1
36846,80,9350,10267,20075,0,0,0,1,1
36847,80,9352,10419,20075,0,0,0,1,1
36848,80,9353,10087,20075,0,0,0,1,1
36849,80,9357,10125,20075,0,0,0,1,1
36850,80,9364,11539;11764;17584,20075,0,0,1,2,3
36851,80,9377,12388;12459;17383,20075,0,0,3,0,3
36852,80,9379,11929;12196,20075,0,0,2,0,2
36853,80,9382,12894,20075,0,0,1,0,1
36854,80,9384,12708;13002;17659,20075,0,0,3,0,3
36855,80,9385,13665,20075,0,0,1,0,1
36856,80,9388,12671;13309,20075,0,0,2,0,2
36857,80,9390,13052;13337;17413,20075,0,0,3,0,3
36858,80,9393,12487;13000,20075,0,0,2,0,2
36859,80,9394,13394;13565,20075,0,0,2,0,2
36860,80,9395,13373;13495,20075,0,0,2,0,2
36861,80,9396,13932;14042;18603,20075,0,1,2,0,3
36862,80,9397,12966;13460,20075,0,0,2,0,2
36863,80,9398,13864;18239,20075,0,1,1,0,2
36864,80,9399,13611;14194;18507,20075,0,1,2,0,3
36865,80,9400,13660;13702,20075,0,0,2,0,2
36866,80,9401,13521;13668;17788,20075,0,0,3,0,3
36867,80,9402,13276;13737;18371;18895,20075,0,2,2,0,4
36868,80,9403,13743;14013,20075,0,0,2,0,2
36869,80,9405,13383;13833;18170;18320,20075,0,2,2,0,4
36870,80,9406,14347;14578;17691,20075,0,0,3,0,3
36871,80,9407,13722;14123;17349;18116,20075,0,1,3,0,4
36872,80,9408,13725;13862;17332,20075,0,0,3,0,3
36873,80,9409,14309;14474,20075,0,0,2,0,2
36874,80,9410,14483,20075,0,0,1,0,1
36875,80,9411,13901;14281;17821;18199;18474,20075,0,2,3,0,5
36876,80,9412,13616;13948;18089,20075,0,1,2,0,3
36877,80,9413,13998;14855;18762;19377,20075,1,1,2,0,4
36878,80,9414,14005;18294,20075,0,1,1,0,2
36879,80,9415,14015;14204;17638;17943;18645;18901,20075,0,2,4,0,6
36880,80,9416,14087;14531;17859;18173,20075,0,1,3,0,4
36881,80,9418,14853;14891;17454;17674,20075,0,0,4,0,4
36882,80,9419,14060;14198,20075,0,0,2,0,2
36883,80,9420,13699,20075,0,0,1,0,1
36884,80,9421,14205;14427;17916;18195;18839,20075,0,2,3,0,5
36885,80,9422,14007;14090,20075,0,0,2,0,2
36886,80,9423,14741;18301;18531,20075,0,2,1,0,3
36887,80,9424,14039;14104;17798;18027;18728,20075,0,2,3,0,5
36888,80,9425,14154;14516;17831,20075,0,0,3,0,3
36889,80,9426,14108;14805;18345;18466;19197,20075,0,3,2,0,5
36890,80,9428,13599;14179;18262;18674,20075,0,2,2,0,4
36891,80,9429,14207;14255;18247;19328,20075,0,2,2,0,4
36892,80,9430,14035;14202;18793,20075,0,1,2,0,3
36893,80,9431,14220;18427,20075,0,1,1,0,2
36894,80,9432,14058;14221,20075,0,0,2,0,2
36895,80,9433,14196;14226,20075,0,0,2,0,2
36896,80,9434,14250,20075,0,0,1,0,1
36897,80,9435,14383;14824;17355;17564;17573;18227;19231,20075,0,2,5,0,7
36898,80,9436,13883;14408;17884;18558;19552,20075,1,1,3,0,5
36899,80,9437,13885;14419,20075,0,0,2,0,2
36900,80,9438,13873;14453;18994,20075,0,1,2,0,3
36901,80,9439,13626;14454;18194;18459,20075,0,2,2,0,4
36902,80,9440,14482;18094;18223,20075,0,2,1,0,3
36903,80,9441,14489;14585,20075,0,0,2,0,2
36904,80,9442,14505;15063;18836;19067,20075,0,2,2,0,4
36905,80,9443,14480;14507,20075,0,0,2,0,2
36906,80,9444,14237;14517,20075,0,0,2,0,2
36907,80,9445,14346;14524,20075,0,0,2,0,2
36908,80,9446,14854;15039;18758,20075,0,1,2,0,3
36909,80,9447,14551;14684;19016,20075,0,1,2,0,3
36910,80,9448,14289;14573;18561;18699,20075,0,2,2,0,4
36911,80,9449,14589;14765,20075,0,0,2,0,2
36912,80,9450,14591;14863;19668,20075,1,0,2,0,3
36913,80,9451,14426;14609;18112,20075,0,1,2,0,3
36914,80,9452,14157;14612;18835;19050,20075,0,2,2,0,4
36915,80,9453,14724,20075,0,0,1,0,1
36916,80,9454,13914;14622,20075,0,0,2,0,2
36917,80,9455,14623;14871;18614;18854,20075,0,2,2,0,4
36918,80,9456,14624;15027;17242;18272;18540,20075,0,2,3,0,5
36919,80,9457,14629;14971;17478;17933;18698,20075,0,1,4,0,5
36920,80,9458,14643;14759;17265;17653;18364,20075,0,1,4,0,5
36921,80,9459,14652;15086;18302;18446,20075,0,2,2,0,4
36922,80,9460,18,20440,0,0,0,1,1
36923,80,9461,9520;10344,20440,0,0,0,2,2
36924,80,9463,10034,20440,0,0,0,1,1
36925,80,9466,10327;10760,20440,0,0,0,2,2
36926,80,9472,10747,20440,0,0,0,1,1
36927,80,9475,11483;11848,20440,0,0,0,2,2
36928,80,9478,10640;10996,20440,0,0,0,2,2
36929,80,9479,11290,20440,0,0,0,1,1
36930,80,9483,11314,20440,0,0,0,1,1
36931,80,9488,12217,20440,0,0,1,0,1
36932,80,9494,11596;12166,20440,0,0,1,1,2
36933,80,9496,12567;12922;17274,20440,0,0,3,0,3
36934,80,9502,13101;13591,20440,0,0,2,0,2
36935,80,9503,13765,20440,0,0,1,0,1
36936,80,9504,13312;13329;17424;17679,20440,0,0,4,0,4
36937,80,9505,13244;13910;17519,20440,0,0,3,0,3
36938,80,9509,13936;13947;18038,20440,0,1,2,0,3
36939,80,9510,13506;13694;17663,20440,0,0,3,0,3
36940,80,9511,13545,20440,0,0,1,0,1
36941,80,9512,13589;13945;17271;18190,20440,0,1,3,0,4
36942,80,9513,13608;14297;18047;18707,20440,0,2,2,0,4
36943,80,9516,13598;14390;19025,20440,0,1,2,0,3
36944,80,9517,12882;13706;17610,20440,0,0,3,0,3
36945,80,9518,13717;13719;18160,20440,0,1,2,0,3
36946,80,9521,13851;14298;17745;18069;18251,20440,0,2,3,0,5
36947,80,9522,14345,20440,0,0,1,0,1
36948,80,9523,13482;13977;17708;17895,20440,0,0,4,0,4
36949,80,9524,12875;13924;17366,20440,0,0,3,0,3
36950,80,9525,13912;13925;18626,20440,0,1,2,0,3
36951,80,9526,13783;13954;17669;18129;18539,20440,0,2,3,0,5
36952,80,9529,14014;14184,20440,0,0,2,0,2
36953,80,9530,14044;14513;17643;18356,20440,0,1,3,0,4
36954,80,9531,14120;14754;17386;17719;18099;18613,20440,0,2,4,0,6
36955,80,9532,14117,20440,0,0,1,0,1
36956,80,9533,14162;14646;18074,20440,0,1,2,0,3
36957,80,9534,14163;14267;17850;18240,20440,0,1,3,0,4
36958,80,9535,14175;14217;18157;19285,20440,0,2,2,0,4
36959,80,9536,14213;14655;18650,20440,0,1,2,0,3
36960,80,9537,14222;14232,20440,0,0,2,0,2
36961,80,9538,13563;14233,20440,0,0,2,0,2
36962,80,9539,15017;15088;18162;19326,20440,0,2,2,0,4
36963,80,9540,14278;14902;18107,20440,0,1,2,0,3
36964,80,9541,14115;14424;18004;18593,20440,0,1,3,0,4
36965,80,9542,13804;14313;17702;18863,20440,0,1,3,0,4
36966,80,9543,14113;14314;17673;17699;18055;18383;19116,20440,0,3,4,0,7
36967,80,9545,14248;14256,20440,0,0,2,0,2
36968,80,9546,14072;14376;17723;18629,20440,0,1,3,0,4
36969,80,9547,13841;14451;18579,20440,0,1,2,0,3
36970,80,9548,14444;14877;18021;18433;18916;19105;19425,20440,1,4,2,0,7
36971,80,9549,14420;14456,20440,0,0,2,0,2
36972,80,9550,14462;14958;18230;18584;18759,20440,0,3,2,0,5
36973,80,9552,13874;14105;18201;18373,20440,0,2,2,0,4
36974,80,9553,14301;14485;17902;18662,20440,0,1,3,0,4
36975,80,9554,14010;14487;18010,20440,0,1,2,0,3
36976,80,9555,14492;14709;18037;19042,20440,0,2,2,0,4
36977,80,9556,14371;14501;18451,20440,0,1,2,0,3
36978,80,9558,14068;14512;17640;17883;18547,20440,0,1,4,0,5
36979,80,9559,14535;14838;17733;18805;19199,20440,0,2,3,0,5
36980,80,9560,14555;15215;19321,20440,0,1,2,0,3
36981,80,9561,14559;14847;17904;18665;18818,20440,0,2,3,0,5
36982,80,9562,14045;14661;18404;18562,20440,0,2,2,0,4
36983,80,9563,13741;13870;18476,20440,0,1,2,0,3
36984,80,9564,14568;14601;17818;18596,20440,0,1,3,0,4
36985,80,9565,14600;19406,20440,1,0,1,0,2
36986,80,9566,14811;14908;17560;17631,20440,0,0,4,0,4
36987,80,9567,14260;14639;17459;17829,20440,0,0,4,0,4
36988,80,9568,14640;14687;18633,20440,0,1,2,0,3
36989,80,9569,14683;14998,20440,0,0,2,0,2
36990,80,9570,13963;14693;17554;17728;18797,20440,0,1,4,0,5
36991,80,9571,14101;14571;18203;18736,20440,0,2,2,0,4
36992,80,9572,14717;14945;17550;18040;18513;19470,20440,1,2,3,0,6
36993,80,9573,14399;14869;18853;18881,20440,0,2,2,0,4
36994,80,9574,14830;15154;19008,20440,0,1,2,0,3
36995,80,9575,15078;18118;18378,20440,0,2,1,0,3
36996,80,9576,14843;17317;18922,20440,0,1,2,0,3
36997,80,9577,14779,20440,0,0,1,0,1
36998,80,9578,839;8998,20805,0,0,0,2,2
36999,80,9579,10018;10023,20805,0,0,0,2,2
37000,80,9582,3840,20805,0,0,0,1,1
37001,80,9583,10095,20805,0,0,0,1,1
37002,80,9586,10856,20805,0,0,0,1,1
37003,80,9589,10677,20805,0,0,0,1,1
37004,80,9590,11063,20805,0,0,0,1,1
37005,80,9591,10428,20805,0,0,0,1,1
37006,80,9593,10488;10533,20805,0,0,0,2,2
37007,80,9602,11346;11391,20805,0,0,0,2,2
37008,80,9611,12986;13045,20805,0,0,2,0,2
37009,80,9612,12599,20805,0,0,1,0,1
37010,80,9613,12058;12575,20805,0,0,2,0,2
37011,80,9618,12800;13099;17815,20805,0,0,3,0,3
37012,80,9621,12408;12969,20805,0,0,2,0,2
37013,80,9622,12689;13017,20805,0,0,2,0,2
37014,80,9623,13613;18167,20805,0,1,1,0,2
37015,80,9625,13269;14265;18350;18612;18871,20805,0,3,2,0,5
37016,80,9626,13776;17747;17978;18276;18447,20805,0,2,3,0,5
37017,80,9628,13504;17749,20805,0,0,2,0,2
37018,80,9629,13569;13949;18019;18151,20805,0,2,2,0,4
37019,80,9630,13697;17949;18221,20805,0,1,2,0,3
37020,80,9631,13632;13746;18441,20805,0,1,2,0,3
37021,80,9633,13957;17806;19020,20805,0,1,2,0,3
37022,80,9634,13852;13938;17656;17849;18186,20805,0,1,4,0,5
37023,80,9635,13853;14939;17852,20805,0,0,3,0,3
37024,80,9637,13336;13944;18873,20805,0,1,2,0,3
37025,80,9638,13552;14425;17791,20805,0,0,3,0,3
37026,80,9639,13806;13976;17744;18175;18412,20805,0,2,3,0,5
37027,80,9640,14026;17951,20805,0,0,2,0,2
37028,80,9641,14118;14520,20805,0,0,2,0,2
37029,80,9642,13993;14122;17678;17892,20805,0,0,4,0,4
37030,80,9643,14850;18658;19153,20805,0,2,1,0,3
37031,80,9644,14043;14236;17979;18471;19012,20805,0,2,3,0,5
37032,80,9645,14158;14570;18631;19367,20805,1,1,2,0,4
37033,80,9646,14188;14468,20805,0,0,2,0,2
37034,80,9648,14317;14604;17877,20805,0,0,3,0,3
37035,80,9649,14275,20805,0,0,1,0,1
37036,80,9651,14384;18664,20805,0,1,1,0,2
37037,80,9652,14396,20805,0,0,1,0,1
37038,80,9653,14245;14403;18022,20805,0,1,2,0,3
37039,80,9654,14279;14443,20805,0,0,2,0,2
37040,80,9655,15126;17604;18824,20805,0,1,2,0,3
37041,80,9656,14086;14536;18225;18368,20805,0,2,2,0,4
37042,80,9658,14465;14582;17725;17830,20805,0,0,4,0,4
37043,80,9659,14565;14595;18008;18192;18482;18595;19082;19610,20805,1,5,2,0,8
37044,80,9660,14930;18018;18182,20805,0,2,1,0,3
37045,80,9661,14564;14647;18367;18977,20805,0,2,2,0,4
37046,80,9662,14740;14773,20805,0,0,2,0,2
37047,80,9663,14658;14763;18282,20805,0,1,2,0,3
37048,80,9664,14266;14674,20805,0,0,2,0,2
37049,80,9665,14676;14825;17787;18051;19098,20805,0,2,3,0,5
37050,80,9666,14704;15034;18856,20805,0,1,2,0,3
37051,80,9667,14548;14706;17356,20805,0,0,3,0,3
37052,80,9670,15135;18012;18550;19251,20805,0,3,1,0,4
37053,80,9672,14785;15035,20805,0,0,2,0,2
37054,80,9673,14786;15260;17763;18241,20805,0,1,3,0,4
37055,80,9674,14801,20805,0,0,1,0,1
37056,80,9675,14813;15240,20805,0,0,2,0,2
37057,80,9676,14849;15187;17581;17860;18600,20805,0,1,4,0,5
37058,80,9677,14856;14951;18109,20805,0,1,2,0,3
37059,80,9678,14880;15176;19152,20805,0,1,2,0,3
37060,80,9679,14685;14873;17667,20805,0,0,3,0,3
37061,80,9680,14875;14964;18029;18369,20805,0,2,2,0,4
37062,80,9681,14886;15364;17680;17827;18997,20805,0,1,4,0,5
37063,80,9682,14887;15070;18300;18387;18669,20805,0,3,2,0,5
37064,80,9683,15345;18980,20805,0,1,1,0,2
37065,80,9684,14916;19391,20805,1,0,1,0,2
37066,80,9685,14884;14917;18676,20805,0,1,2,0,3
37067,80,9686,14924;15115;17986;18481,20805,0,1,3,0,4
37068,80,9687,14926;15394,20805,0,0,2,0,2
37069,80,9688,14719;14986;18987,20805,0,1,2,0,3
37070,80,9694,10285;10528,21170,0,0,0,2,2
37071,80,9695,10534,21170,0,0,0,1,1
37072,80,9697,10025,21170,0,0,0,1,1
37073,80,9698,10538,21170,0,0,0,1,1
37074,80,9699,10423,21170,0,0,0,1,1
37075,80,9709,11563;11914,21170,0,0,1,1,2
37076,80,9714,11555;12013,21170,0,0,1,1,2
37077,80,9719,12753;12820,21170,0,0,2,0,2
37078,80,9722,13070;18026,21170,0,1,1,0,2
37079,80,9723,13003;13358;17458;17721,21170,0,0,4,0,4
37080,80,9726,13362;13825;18046,21170,0,1,2,0,3
37081,80,9728,13522;13898,21170,0,0,2,0,2
37082,80,9730,13819;14784;17670;17910,21170,0,0,4,0,4
37083,80,9731,13369;14397,21170,0,0,2,0,2
37084,80,9732,13647;13904;17855;18264;18429,21170,0,2,3,0,5
37085,80,9733,13542;13921;17906,21170,0,0,3,0,3
37086,80,9735,14012;18077;18528,21170,0,2,1,0,3
37087,80,9736,14038;14197;18163;18648,21170,0,2,2,0,4
37088,80,9737,13528;14208,21170,0,0,2,0,2
37089,80,9738,14078;14372,21170,0,0,2,0,2
37090,80,9739,13894;14088,21170,0,0,2,0,2
37091,80,9740,14103;14195;18098;18618,21170,0,2,2,0,4
37092,80,9741,14138;14216;19246,21170,0,1,2,0,3
37093,80,9742,14152;14326;18524;18695;19433,21170,1,2,2,0,5
37094,80,9743,14192;14557;17776;18036;18337;18431,21170,0,3,3,0,6
37095,80,9744,14746;17792;18814,21170,0,1,2,0,3
37096,80,9745,14227;15522;18770;19242,21170,0,2,2,0,4
37097,80,9746,14361;14642;18348;18700;18986,21170,0,3,2,0,5
37098,80,9747,14829;14883;18390;19281,21170,0,2,2,0,4
37099,80,9750,13548;14404;17774,21170,0,0,3,0,3
37100,80,9751,14542;17909;18011;18362;18557;19037,21170,0,4,2,0,6
37101,80,9753,14389;14460;18083,21170,0,1,2,0,3
37102,80,9754,14203;14486;18149,21170,0,1,2,0,3
37103,80,9755,14848;14862;18281;18450,21170,0,2,2,0,4
37104,80,9756,14861;14943;17658;17694;17987;18354;19642,21170,1,1,5,0,7
37105,80,9757,14529;14865;19311,21170,0,1,2,0,3
37106,80,9758,14116;14532;18464,21170,0,1,2,0,3
37107,80,9759,14549;17948;18611,21170,0,1,2,0,3
37108,80,9760,15252;15415;18093;19296,21170,0,2,2,0,4
37109,80,9761,14447;14576,21170,0,0,2,0,2
37110,80,9762,14214;14579;18361;18570,21170,0,2,2,0,4
37111,80,9763,14777;15072;18809;19017,21170,0,2,2,0,4
37112,80,9764,14678;14837;19892,21170,1,0,2,0,3
37113,80,9765,14666;14703;18738;19077,21170,0,2,2,0,4
37114,80,9766,14713;14722,21170,0,0,2,0,2
37115,80,9767,14735;14922;18322;18621,21170,0,2,2,0,4
37116,80,9768,14751;18057;19080,21170,0,2,1,0,3
37117,80,9769,15379;15412;18722;19091,21170,0,2,2,0,4
37118,80,9770,14790;17641;18165,21170,0,1,2,0,3
37119,80,9771,14100;14793;18617,21170,0,1,2,0,3
37120,80,9772,14498;14802,21170,0,0,2,0,2
37121,80,9773,15417;15995;18372;18718;18857;19599,21170,1,3,2,0,6
37122,80,9774,15342;15411;18573;18747;19057,21170,0,3,2,0,5
37123,80,9775,14852;15174;18784;19239,21170,0,2,2,0,4
37124,80,9777,14538;14895;17737;18546;19141,21170,0,2,3,0,5
37125,80,9778,14915;15121;18379;18673;19079,21170,0,3,2,0,5
37126,80,9779,14472;14872;17748;18078,21170,0,1,3,0,4
37127,80,9780,14749;14936;17569;17843,21170,0,0,4,0,4
37128,80,9781,14938;15289;18196;19004,21170,0,2,2,0,4
37129,80,9782,15170;15853;17575;18217;18434;18889,21170,0,3,3,0,6
37130,80,9783,14976;15068;18498;18703;19051,21170,0,3,2,0,5
37131,80,9784,14977;15210;18183;18985,21170,0,2,2,0,4
37132,80,9785,14980;15000;17783;18381;19469,21170,1,1,3,0,5
37133,80,9786,14707;15047,21170,0,0,2,0,2
37134,80,9787,14967;15011;18748;19665,21170,1,1,2,0,4
37135,80,9788,15026;15044;17619;18795,21170,0,1,3,0,4
37136,80,9789,15043;15473;19454;19750,21170,2,0,2,0,4
37137,80,9790,14697;14923;18324,21170,0,1,2,0,3
37138,80,9791,14954;15066;18445;18592,21170,0,2,2,0,4
37139,80,9792,14815;17738,21170,0,0,2,0,2
37140,80,9793,14820;15080;17848;18103;18398;18448,21170,0,3,3,0,6
37141,80,9794,15081;17492;18293,21170,0,1,2,0,3
37142,80,9795,15195;17686;18411;19081,21170,0,2,2,0,4
37143,80,9799,10371,21535,0,0,0,1,1
37144,80,9801,10351;10676,21535,0,0,0,2,2
37145,80,9802,10781,21535,0,0,0,1,1
37146,80,9810,11307;11632,21535,0,0,0,2,2
37147,80,9811,11258,21535,0,0,0,1,1
37148,80,9823,13016;13319;17662,21535,0,0,3,0,3
37149,80,9824,12824;12849,21535,0,0,2,0,2
37150,80,9828,13197;13795,21535,0,0,2,0,2
37151,80,9829,13268;13756;17617;17880;18616,21535,0,1,4,0,5
37152,80,9830,12998;13382;17913,21535,0,0,3,0,3
37153,80,9831,12997;13530,21535,0,0,2,0,2
37154,80,9832,13609,21535,0,0,1,0,1
37155,80,9833,13406;13828;17970,21535,0,0,3,0,3
37156,80,9836,14211;18690,21535,0,1,1,0,2
37157,80,9837,13176;13711,21535,0,0,2,0,2
37158,80,9838,13526;13738,21535,0,0,2,0,2
37159,80,9841,13927;14200,21535,0,0,2,0,2
37160,80,9844,13775;13928,21535,0,0,2,0,2
37161,80,9845,13847;14219,21535,0,0,2,0,2
37162,80,9846,13865;14394;19316,21535,0,1,2,0,3
37163,80,9847,14587;18578,21535,0,1,1,0,2
37164,80,9849,13982;14702;18729,21535,0,1,2,0,3
37165,80,9850,14324,21535,0,0,1,0,1
37166,80,9851,13274;14054;18958,21535,0,1,2,0,3
37167,80,9853,14167;14679;18487;18948,21535,0,2,2,0,4
37168,80,9854,14412,21535,0,0,1,0,1
37169,80,9856,13623;13789,21535,0,0,2,0,2
37170,80,9857,14252;17605;18928,21535,0,1,2,0,3
37171,80,9858,14269;14272,21535,0,0,2,0,2
37172,80,9860,14320,21535,0,0,1,0,1
37173,80,9861,14041;14334,21535,0,0,2,0,2
37174,80,9863,14253;14354;17824;19068,21535,0,1,3,0,4
37175,80,9864,14369;14721;18865;19361,21535,1,1,2,0,4
37176,80,9865,14141;14405,21535,0,0,2,0,2
37177,80,9866,14423;14602;17761,21535,0,0,3,0,3
37178,80,9867,14450;14476;18076,21535,0,1,2,0,3
37179,80,9868,14818;15479;18491;19065,21535,0,2,2,0,4
37180,80,9869,14776;14914;18005;18681;18915;19397,21535,1,2,3,0,6
37181,80,9870,15118;18574,21535,0,1,1,0,2
37182,80,9872,14556;18152;19006,21535,0,2,1,0,3
37183,80,9873,14723;14984;18739;18943;19032;19522,21535,1,3,2,0,6
37184,80,9874,14788;15647;17967;19026,21535,0,1,3,0,4
37185,80,9875,14878;15245;17838;18983,21535,0,1,3,0,4
37186,80,9876,14380;14796,21535,0,0,2,0,2
37187,80,9877,14798,21535,0,0,1,0,1
37188,80,9878,14803;15071;17732;18161;18563;19030,21535,0,3,3,0,6
37189,80,9879,14882;15141;17598;18121,21535,0,1,3,0,4
37190,80,9880,14831;15171;18518;18777;19162,21535,0,3,2,0,5
37191,80,9881,14879;18184;18644,21535,0,2,1,0,3
37192,80,9882,14920;15013;18291;18479,21535,0,2,2,0,4
37193,80,9883,15496;18314;18571;18976,21535,0,3,1,0,4
37194,80,9884,14972;15337,21535,0,0,2,0,2
37195,80,9885,14931;14985;19101;19331,21535,0,2,2,0,4
37196,80,9886,14418;14987;18355;18449;18691,21535,0,3,2,0,5
37197,80,9887,14997;15293;17793;18461,21535,0,1,3,0,4
37198,80,9888,15468;18934,21535,0,1,1,0,2
37199,80,9889,15046;15481;18111;18591;18902,21535,0,3,2,0,5
37200,80,9890,14493;15064;18128;18395,21535,0,2,2,0,4
37201,80,9891,15075;15520;17804;18006;18961,21535,0,2,3,0,5
37202,80,9892,14448;14599;17828;18075;18115,21535,0,2,3,0,5
37203,80,9893,15209;15366;19022,21535,0,1,2,0,3
37204,80,9894,15103;15435;17825;18384,21535,0,1,3,0,4
37205,80,9895,14544;15113;18490;18677,21535,0,2,2,0,4
37206,80,9896,15125;15785;18883;19243,21535,0,2,2,0,4
37207,80,9897,15107;15132;17736;17807,21535,0,0,4,0,4
37208,80,9898,14729;15133,21535,0,0,2,0,2
37209,80,9900,14901;15143;19325,21535,0,1,2,0,3
37210,80,9901,15052;15144;18785;19279,21535,0,2,2,0,4
37211,80,9902,15002;15167;17718;17835;18295;18708;19058,21535,0,3,4,0,7
37212,80,9903,14957;15478;18304;18991,21535,0,2,2,0,4
37213,80,9904,14973;15202,21535,0,0,2,0,2
37214,80,9905,94,21900,0,0,0,1,1
37215,80,9906,10045,21900,0,0,0,1,1
37216,80,9913,10892,21900,0,0,0,1,1
37217,80,9915,11695,21900,0,0,0,1,1
37218,80,9917,11668;11739,21900,0,0,0,2,2
37219,80,9918,11238,21900,0,0,0,1,1
37220,80,9921,11857;11910,21900,0,0,1,1,2
37221,80,9925,12088,21900,0,0,1,0,1
37222,80,9927,12163;12636,21900,0,0,2,0,2
37223,80,9928,11997;12114,21900,0,0,2,0,2
37224,80,9929,12110;12758;17711,21900,0,0,3,0,3
37225,80,9943,13114;13417;17810,21900,0,0,3,0,3
37226,80,9945,13812;17936;18210,21900,0,1,2,0,3
37227,80,9948,13413;14049;18572,21900,0,1,2,0,3
37228,80,9950,13425;13845;18278,21900,0,1,2,0,3
37229,80,9953,14296,21900,0,0,1,0,1
37230,80,9955,13887;14225;17822,21900,0,0,3,0,3
37231,80,9959,14016;14342,21900,0,0,2,0,2
37232,80,9961,14234;14271;18097;18458;18767,21900,0,3,2,0,5
37233,80,9962,14178,21900,0,0,1,0,1
37234,80,9963,14668;18308,21900,0,1,1,0,2
37235,80,9964,14239;14367;17758;18386;18754,21900,0,2,3,0,5
37236,80,9966,14290;14355;18428,21900,0,1,2,0,3
37237,80,9967,14379;14716,21900,0,0,2,0,2
37238,80,9968,13875;14395;19163,21900,0,1,2,0,3
37239,80,9970,14310;14597;18478,21900,0,1,2,0,3
37240,80,9971,14378;14495;17954,21900,0,0,3,0,3
37241,80,9972,14119;14525;18113;19164,21900,0,2,2,0,4
37242,80,9973,14393;14528;18438;18905,21900,0,2,2,0,4
37243,80,9974,14608;14982;18714;18884;19374,21900,1,2,2,0,5
37244,80,9975,14618;15106;19007,21900,0,1,2,0,3
37245,80,9976,14621;14665;18096;18141;18233;18488;18641,21900,0,5,2,0,7
37246,80,9977,14778,21900,0,0,1,0,1
37247,80,9978,14598;14870;18435;18532,21900,0,2,2,0,4
37248,80,9979,14662;15007;18333;18585;18651;18887;19265;19444,21900,1,5,2,0,8
37249,80,9980,14173;14690;17899;18872;19286,21900,0,2,3,0,5
37250,80,9982,14762;17930;18135;18647;19095,21900,0,3,2,0,5
37251,80,9983,14835;15320;17905;18245;18717;19711,21900,1,2,3,0,6
37252,80,9984,14561;14845;18267;18492,21900,0,2,2,0,4
37253,80,9985,14889;15380;19036;19379,21900,1,1,2,0,4
37254,80,9986,14506;14903;18538;18787,21900,0,2,2,0,4
37255,80,9987,15462;15474;19806,21900,1,0,2,0,3
37256,80,9988,14905;15253;18030;18358,21900,0,2,2,0,4
37257,80,9990,14919;15032;18283;19415,21900,1,1,2,0,4
37258,80,9991,14932;15418;19354,21900,1,0,2,0,3
37259,80,9993,14053;14933;18123;18288;19362,21900,1,2,2,0,5
37260,80,9994,14807;14975;19011,21900,0,1,2,0,3
37261,80,9995,14978;15186;18671;19464,21900,1,1,2,0,4
37262,80,9996,14992;15134;18347;18495;18812;19590,21900,1,3,2,0,6
37263,80,9998,15334;15605;17772;17968;18082,21900,0,1,4,0,5
37264,80,9999,15024;15244;18656,21900,0,1,2,0,3
37265,80,10000,14810;15025;17819;18220;18601,21900,0,2,3,0,5
37266,80,10001,15688;19466,21900,1,0,1,0,2
37267,80,10002,14720;15116;17764;19284,21900,0,1,3,0,4
37268,80,10003,14714;15128;19148;19530,21900,1,1,2,0,4
37269,80,10004,15110;15709;18821;19303,21900,0,2,2,0,4
37270,80,10005,15140,21900,0,0,1,0,1
37271,80,10006,15153;19159,21900,0,1,1,0,2
37272,80,10007,15155;15808;18388;18810;19340,21900,1,2,2,0,5
37273,80,10008,15162;17961;18637,21900,0,1,2,0,3
37274,80,10009,15149;15408;18401;18502;19066,21900,0,3,2,0,5
37275,80,10010,15055;15181,21900,0,0,2,0,2
37276,80,10011,15191;17932;19013,21900,0,1,2,0,3
37277,80,10012,15016;15217,21900,0,0,2,0,2
37278,80,10013,14500;15220;18920,21900,0,1,2,0,3
37279,80,10014,15261;17889;18090;18342,21900,0,2,2,0,4
37280,80,10015,15311,21900,0,0,1,0,1
37281,80,10017,15357;15719;17854;18174;19330;19822,21900,1,2,3,0,6
37282,80,10018,15358;15377;19167,21900,0,1,2,0,3
37283,80,10019,15359;15512;17901;18015;18147;18535;19547;19720,21900,2,3,3,0,8
37284,80,10020,14438;15361;18408;18877;19766,21900,1,2,2,0,5
37285,80,10021,15164;15368;18212;19096;19542,21900,1,2,2,0,5
37286,80,10022,15378,21900,0,0,1,0,1
37287,80,10023,15381;15516;18735;18918;19437,21900,1,2,2,0,5
37288,80,10024,15396;15451;19031,21900,0,1,2,0,3
37289,80,10026,6911,22265,0,0,0,1,1
37290,80,10030,11018,22265,0,0,0,1,1
37291,80,10031,10915,22265,0,0,0,1,1
37292,80,10032,10959,22265,0,0,0,1,1
37293,80,10036,12029,22265,0,0,1,0,1
37294,80,10038,11564,22265,0,0,0,1,1
37295,80,10040,12021;12148,22265,0,0,2,0,2
37296,80,10043,12819;12923;18166,22265,0,1,2,0,3
37297,80,10044,12872,22265,0,0,1,0,1
37298,80,10045,12616;12860,22265,0,0,2,0,2
37299,80,10049,13780;13857,22265,0,0,2,0,2
37300,80,10053,13953;18456,22265,0,1,1,0,2
37301,80,10054,13558,22265,0,0,1,0,1
37302,80,10055,13550,22265,0,0,1,0,1
37303,80,10056,13627;13995;18694;19615,22265,1,1,2,0,4
37304,80,10058,13842;14273,22265,0,0,2,0,2
37305,80,10059,13464;13843;18327;18523,22265,0,2,2,0,4
37306,80,10060,13881;14020;18297,22265,0,1,2,0,3
37307,80,10061,14228;18957,22265,0,1,1,0,2
37308,80,10062,14018;18520,22265,0,1,1,0,2
37309,80,10063,14066;14094;18424,22265,0,1,2,0,3
37310,80,10064,14302;14761,22265,0,0,2,0,2
37311,80,10065,13822;13974;18727,22265,0,1,2,0,3
37312,80,10066,14756,22265,0,0,1,0,1
37313,80,10067,13595;14109;19227,22265,0,1,2,0,3
37314,80,10068,14023;14246,22265,0,0,2,0,2
37315,80,10069,14262,22265,0,0,1,0,1
37316,80,10070,14307;14583;19255,22265,0,1,2,0,3
37317,80,10071,14588;15206,22265,0,0,2,0,2
37318,80,10072,14348;14909;18697;19287,22265,0,2,2,0,4
37319,80,10073,14770;15056;19212,22265,0,1,2,0,3
37320,80,10074,14160;14431;17796;18007;18536,22265,0,2,3,0,5
37321,80,10075,14470,22265,0,0,1,0,1
37322,80,10076,14841;17971,22265,0,0,2,0,2
37323,80,10077,14526;15098;18413;18580,22265,0,2,2,0,4
37324,80,10078,14553;14653;18265;18622,22265,0,2,2,0,4
37325,80,10080,14616;18509;18962,22265,0,2,1,0,3
37326,80,10081,14656;15033;18880,22265,0,1,2,0,3
37327,80,10082,14663;15650;17862;18032;18686,22265,0,2,3,0,5
37328,80,10083,14699;15189,22265,0,0,2,0,2
37329,80,10084,14890;14970,22265,0,0,2,0,2
37330,80,10085,14731;19142,22265,0,1,1,0,2
37331,80,10086,14752;15422,22265,0,0,2,0,2
37332,80,10087,14757;18236;18769,22265,0,2,1,0,3
37333,80,10088,14258;14422,22265,0,0,2,0,2
37334,80,10089,14792;15525;18442;18876;19350,22265,1,2,2,0,5
37335,80,10090,14691;15247;18966;19147,22265,0,2,2,0,4
37336,80,10093,15120,22265,0,0,1,0,1
37337,80,10094,14888;19289,22265,0,1,1,0,2
37338,80,10095,14816;14907;18248;18499,22265,0,2,2,0,4
37339,80,10096,14949;15413;18259;19202;19385,22265,1,2,2,0,5
37340,80,10097,14956;14963;18080;18277,22265,0,2,2,0,4
37341,80,10098,14969;15802;18206;18353;18807,22265,0,3,2,0,5
37342,80,10099,14574;14983,22265,0,0,2,0,2
37343,80,10101,15019;15029;19120,22265,0,1,2,0,3
37344,80,10102,15054;15131;18781,22265,0,1,2,0,3
37345,80,10103,15059;15287;18131,22265,0,1,2,0,3
37346,80,10104,15012;15285,22265,0,0,2,0,2
37347,80,10105,14934;15142;18181;18512,22265,0,2,2,0,4
37348,80,10106,14953;18331;18640,22265,0,2,1,0,3
37349,80,10107,15161;19268;19678,22265,1,1,1,0,3
37350,80,10108,15182;17795;17953;18505;19587,22265,1,1,3,0,5
37351,80,10109,15188;15395,22265,0,0,2,0,2
37352,80,10110,15557;18801;18885,22265,0,2,1,0,3
37353,80,10111,15200;16031;19182;19548,22265,1,1,2,0,4
37354,80,10112,15203;18760;19178,22265,0,2,1,0,3
37355,80,10113,14191;15207,22265,0,0,2,0,2
37356,80,10114,15504;15806;19045;19254,22265,0,2,2,0,4
37357,80,10115,15228;15628;17914;18330;18675;19314,22265,0,3,3,0,6
37358,80,10116,15229;15495,22265,0,0,2,0,2
37359,80,10117,15230;18486;18926,22265,0,2,1,0,3
37360,80,10118,14836;15237,22265,0,0,2,0,2
37361,80,10119,15239;15410;18779;19558,22265,1,1,2,0,4
37362,80,10121,15884;16056;17817;18243;19263,22265,0,2,3,0,5
37363,80,10122,15278;15826;17811;18619;18908,22265,0,2,3,0,5
37364,80,10123,15279;15751;19451,22265,1,0,2,0,3
37365,80,10124,15282;15682;17941;18132;19160,22265,0,2,3,0,5
37366,80,10125,15283;15457;18171;18744;19657,22265,1,2,2,0,5
37367,80,10126,15664;15819;19666,22265,1,0,2,0,3
37368,80,10127,15299;18376;19064,22265,0,2,1,0,3
37369,80,10128,15152;15327;17897;19647,22265,1,0,3,0,4
37370,80,10129,15028;15332;18003;18155,22265,0,1,3,0,4
37371,80,10130,15146;15347;17784;17915;19192,22265,0,1,4,0,5
37372,80,10131,15351;15613;17907;19692,22265,1,0,3,0,4
37373,80,10132,15393,22265,0,0,1,0,1
37374,80,10133,15609;18310;18740,22265,0,2,1,0,3
37375,80,10134,15407;15455;18133;18256;18771;19369,22265,1,3,2,0,6
37376,80,10135,15401;15934;18222;18463,22265,0,2,2,0,4
37377,80,10136,15414;15769;17875;18081,22265,0,1,3,0,4
37378,80,10137,15437;15598;19250,22265,0,1,2,0,3
37379,80,10138,15447;15938;18062;18973,22265,0,2,2,0,4
37380,80,10139,14965;15454;18180;18577,22265,0,2,2,0,4
37381,80,10141,15471;15477;18366;19157,22265,0,2,2,0,4
37382,80,10142,15482;19626,22265,1,0,1,0,2
37383,80,10143,15498;17926;18092;18782;18892,22265,0,3,2,0,5
37384,80,10144,15505;15556;18020;19103,22265,0,2,2,0,4
37385,80,10145,15509;15657;17996;18215;19495,22265,1,1,3,0,5
37386,80,10146,15416;15513;19804,22265,1,0,2,0,3
37387,80,10154,11251,22630,0,0,0,1,1
37388,80,10156,11305,22630,0,0,0,1,1
37389,80,10158,11150;11392,22630,0,0,0,2,2
37390,80,10160,11931,22630,0,0,1,0,1
37391,80,10175,12866;12871,22630,0,0,2,0,2
37392,80,10178,12696;13140,22630,0,0,2,0,2
37393,80,10180,13213,22630,0,0,1,0,1
37394,80,10183,12782;13020,22630,0,0,2,0,2
37395,80,10187,13579;13731;18357,22630,0,1,2,0,3
37396,80,10188,13458;13769;18306;18576,22630,0,2,2,0,4
37397,80,10190,13884;14300,22630,0,0,2,0,2
37398,80,10192,13907;13997,22630,0,0,2,0,2
37399,80,10193,13959;14452,22630,0,0,2,0,2
37400,80,10196,14387;14610;18477,22630,0,1,2,0,3
37401,80,10197,14558;18701;18964,22630,0,2,1,0,3
37402,80,10199,13600;14187,22630,0,0,2,0,2
37403,80,10200,14223;14479;17938;18158,22630,0,1,3,0,4
37404,80,10201,13614;14491,22630,0,0,2,0,2
37405,80,10203,14569;14859;19635,22630,1,0,2,0,3
37406,80,10204,14733,22630,0,0,1,0,1
37407,80,10205,13960;14554;19014,22630,0,1,2,0,3
37408,80,10207,14540;15061;18716;18776,22630,0,2,2,0,4
37409,80,10208,13903;14628;18352;18541,22630,0,2,2,0,4
37410,80,10209,14630;14840;18696;19214,22630,0,2,2,0,4
37411,80,10210,14449;14650,22630,0,0,2,0,2
37412,80,10211,14654;14952;17886;18067;18710,22630,0,2,3,0,5
37413,80,10212,14024;14659;17945;18496;18789,22630,0,2,3,0,5
37414,80,10213,14681;15444,22630,0,0,2,0,2
37415,80,10215,14710;15465;19460,22630,1,0,2,0,3
37416,80,10216,14726;17955;18377,22630,0,1,2,0,3
37417,80,10217,14737;15159,22630,0,0,2,0,2
37418,80,10218,14748;15101;18105;19023,22630,0,2,2,0,4
37419,80,10219,14791;14876;18290;19052,22630,0,2,2,0,4
37420,80,10220,13849;14400,22630,0,0,2,0,2
37421,80,10221,15272;15779;17925;18095;19849,22630,1,1,3,0,5
37422,80,10222,14826;15235,22630,0,0,2,0,2
37423,80,10223,14562;14833;18205,22630,0,1,2,0,3
37424,80,10224,15145;15623;18868;18894,22630,0,2,2,0,4
37425,80,10225,15630,22630,0,0,1,0,1
37426,80,10226,14823;14948;18845;19677,22630,1,1,2,0,4
37427,80,10227,15008;15460;18188;18375,22630,0,2,2,0,4
37428,80,10228,15458;17923;18168;18551;18704,22630,0,3,2,0,5
37429,80,10229,15058;15544,22630,0,0,2,0,2
37430,80,10231,15296,22630,0,0,1,0,1
37431,80,10232,14937;15180;18024;18638;19041;19132,22630,0,4,2,0,6
37432,80,10233,15201;15214,22630,0,0,2,0,2
37433,80,10234,15213;18960,22630,0,1,1,0,2
37434,80,10235,15300;18211,22630,0,1,1,0,2
37435,80,10236,15317;15517;18891;19339;19536,22630,2,1,2,0,5
37436,80,10237,15319;18341,22630,0,1,1,0,2
37437,80,10239,15123;15329;17997;18321;18910;19341,22630,1,2,3,0,6
37438,80,10240,15371;15902,22630,0,0,2,0,2
37439,80,10241,15067;15384;18072;19293,22630,0,2,2,0,4
37440,80,10242,15093;15406;19364;19661,22630,2,0,2,0,4
37441,80,10243,15014;15423;18214;19270,22630,0,2,2,0,4
37442,80,10244,15192;15448;18930,22630,0,1,2,0,3
37443,80,10245,14906;15453;18042;18144;18778,22630,0,3,2,0,5
37444,80,10246,15713;18594;18791,22630,0,2,1,0,3
37445,80,10247,15463;15790;17431;19184;19368;19787,22630,2,1,3,0,6
37446,80,10248,15452;15480;18741;19195,22630,0,2,2,0,4
37447,80,10249,15497;18204;18374,22630,0,2,1,0,3
37448,80,10250,15404;15788,22630,0,0,2,0,2
37449,80,10251,15538;15678;17959;18110;18234;18816,22630,0,3,3,0,6
37450,80,10252,15554;15935;17993;19021,22630,0,1,3,0,4
37451,80,10253,15514;15558;19384;19638,22630,2,0,2,0,4
37452,80,10254,15568;15770,22630,0,0,2,0,2
37453,80,10255,15433;15569;18813;19054,22630,0,2,2,0,4
37454,80,10256,15488;15585;18951;19181,22630,0,2,2,0,4
37455,80,10259,10595;10618,22995,0,0,0,2,2
37456,80,10260,10032,22995,0,0,0,1,1
37457,80,10263,10238,22995,0,0,0,1,1
37458,80,10266,10860;11078,22995,0,0,0,2,2
37459,80,10267,11300;11487,22995,0,0,0,2,2
37460,80,10273,11297;11352,22995,0,0,0,2,2
37461,80,10275,11708;11845,22995,0,0,0,2,2
37462,80,10276,11591;11862,22995,0,0,0,2,2
37463,80,10285,12150,22995,0,0,1,0,1
37464,80,10288,12012,22995,0,0,1,0,1
37465,80,10296,13431,22995,0,0,1,0,1
37466,80,10297,13222;13630,22995,0,0,2,0,2
37467,80,10303,13444;14046;18268;18468,22995,0,2,2,0,4
37468,80,10307,14199;14242,22995,0,0,2,0,2
37469,80,10310,14337;18581,22995,0,1,1,0,2
37470,80,10311,14032;14767;18768,22995,0,1,2,0,3
37471,80,10313,14308;15042;18311;18864;19112,22995,0,3,2,0,5
37472,80,10314,14782;14846;18936;19209,22995,0,2,2,0,4
37473,80,10315,14288;14429,22995,0,0,2,0,2
37474,80,10317,14577,22995,0,0,1,0,1
37475,80,10318,13943;14632;19069,22995,0,1,2,0,3
37476,80,10319,14637;18587,22995,0,1,1,0,2
37477,80,10320,14638;18780;18923;19149,22995,0,3,1,0,4
37478,80,10321,15507;18734,22995,0,1,1,0,2
37479,80,10322,14091;14375;18586,22995,0,1,2,0,3
37480,80,10323,14415;14772;18552;18743;18834,22995,0,3,2,0,5
37481,80,10324,14817;14990;18397;18685;18953,22995,0,3,2,0,5
37482,80,10325,14611;14961;17934;18510;18639,22995,0,2,3,0,5
37483,80,10326,15536;19439;19526,22995,2,0,1,0,3
37484,80,10327,14842;15321,22995,0,0,2,0,2
37485,80,10328,15057;15548,22995,0,0,2,0,2
37486,80,10329,15649;15734;19282;19453,22995,1,1,2,0,4
37487,80,10330,14466;14867;18927,22995,0,1,2,0,3
37488,80,10331,15196;15579;18430;18678;19158,22995,0,3,2,0,5
37489,80,10332,15212;18224;18942,22995,0,2,1,0,3
37490,80,10333,15160;15223;19702,22995,1,0,2,0,3
37491,80,10334,15227;15340;18100;19457,22995,1,1,2,0,4
37492,80,10335,15275;15895;19408,22995,1,0,2,0,3
37493,80,10336,15104;15281;19550,22995,1,0,2,0,3
37494,80,10337,15094;15322;19210,22995,0,1,2,0,3
37495,80,10338,15333;15855;18269;19630,22995,1,1,2,0,4
37496,80,10339,15346;15918;18065;19237;19419;19471,22995,2,2,2,0,6
37497,80,10340,15356;15515;18156;19063;19234,22995,0,3,2,0,5
37498,80,10341,14857;15363;19190,22995,0,1,2,0,3
37499,80,10342,15397;15689;19402;19620,22995,2,0,2,0,4
37500,80,10343,15491;15887;19363;19562,22995,2,0,2,0,4
37501,80,10344,15494;18542,22995,0,1,1,0,2
37502,80,10345,15503;15842;18058;18336,22995,0,2,2,0,4
37503,80,10346,15814,22995,0,0,1,0,1
37504,80,10347,15518;15707;18900;19410,22995,1,1,2,0,4
37505,80,10348,15533;15829;18050;18659;19256,22995,0,3,2,0,5
37506,80,10349,15967;18085;19535;19655,22995,2,1,1,0,4
37507,80,10350,15392;15541;19143;19223,22995,0,2,2,0,4
37508,80,10351,15549;15667;19193;19333,22995,1,1,2,0,4
37509,80,10352,15562;15964;18828,22995,0,1,2,0,3
37510,80,10353,15267;15575;18257;18533;19528,22995,1,2,2,0,5
37511,80,10354,15310;15588;18742;19248,22995,0,2,2,0,4
37512,80,10355,15611;15889;18521;18911,22995,0,2,2,0,4
37513,80,10356,15431;15626;18064;18425,22995,0,2,2,0,4
37514,80,10357,15545;15629;18242;19276,22995,0,2,2,0,4
37515,80,10358,14894;15645;18087;18316,22995,0,2,2,0,4
37516,80,10359,15654;16155;18034;18981,22995,0,2,2,0,4
37517,80,10360,15530;16029;18687,22995,0,1,2,0,3
37518,80,10361,15441;15676;18666;19416,22995,1,1,2,0,4
37519,80,10362,15511;16179;18117;19084;19908,22995,1,2,2,0,5
37520,80,10363,15685;15973;18045;18216;18480,22995,0,3,2,0,5
37521,80,10364,15949;16020;18522;18663;19027;19561,22995,1,3,2,0,6
37522,80,10365,15959;19329;19365,22995,1,1,1,0,3
37523,80,10366,16067;16076,22995,0,0,2,0,2
37524,80,10367,15432;15758;18187;18246;19782,22995,1,2,2,0,5
37525,80,10368,15564;15761,22995,0,0,2,0,2
37526,80,10369,15766;16041;18982;19124,22995,0,2,2,0,4
37527,80,10370,15254;15772,22995,0,0,2,0,2
37528,80,10371,14995;15782;18890;19109;19729,22995,1,2,2,0,5
37529,80,10372,15122;15786;18970;19840,22995,1,1,2,0,4
37530,80,10373,15794;15888,22995,0,0,2,0,2
37531,80,10374,15295;15527,22995,0,0,2,0,2
37532,80,10379,10951;11120,23360,0,0,0,2,2
37533,80,10380,10761,23360,0,0,0,1,1
37534,80,10383,11308,23360,0,0,0,1,1
37535,80,10384,11351,23360,0,0,0,1,1
37536,80,10385,11223,23360,0,0,0,1,1
37537,80,10386,10718,23360,0,0,0,1,1
37538,80,10389,10948,23360,0,0,0,1,1
37539,80,10392,11611,23360,0,0,0,1,1
37540,80,10397,12227,23360,0,0,1,0,1
37541,80,10403,12395,23360,0,0,1,0,1
37542,80,10406,13029;13527,23360,0,0,2,0,2
37543,80,10408,13111,23360,0,0,1,0,1
37544,80,10410,13360;13751,23360,0,0,2,0,2
37545,80,10412,13505;13692,23360,0,0,2,0,2
37546,80,10413,13469,23360,0,0,1,0,1
37547,80,10415,13734;14428,23360,0,0,2,0,2
37548,80,10416,13876;14619,23360,0,0,2,0,2
37549,80,10418,14002;14617;19428,23360,1,0,2,0,3
37550,80,10420,14809;18501;18751,23360,0,2,1,0,3
37551,80,10421,14147;14336,23360,0,0,2,0,2
37552,80,10423,14181;14360;18946,23360,0,1,2,0,3
37553,80,10424,14421;14523,23360,0,0,2,0,2
37554,80,10428,14335;14543;18749,23360,0,1,2,0,3
37555,80,10429,14510;14541;18783,23360,0,1,2,0,3
37556,80,10430,14563;15060;18840;19139,23360,0,2,2,0,4
37557,80,10431,14368;14780,23360,0,0,2,0,2
37558,80,10432,14921;18549,23360,0,1,1,0,2
37559,80,10433,14682,23360,0,0,1,0,1
37560,80,10434,14794;15091,23360,0,0,2,0,2
37561,80,10435,14892;15294;19486;19832,23360,2,0,2,0,4
37562,80,10437,14962;15021;18325;18774;19292,23360,0,3,2,0,5
37563,80,10439,15365;18328;18632;19200;19564,23360,1,3,1,0,5
37564,80,10440,15095;15921;18410;18755;19334,23360,1,2,2,0,5
37565,80,10441,15097;15421;18724;18959,23360,0,2,2,0,4
37566,80,10442,15065;15112;18713;18933;19009,23360,0,3,2,0,5
37567,80,10443,14858;15403;18422;19353;19740,23360,2,1,2,0,5
37568,80,10444,15082;15119;18937;19144,23360,0,2,2,0,4
37569,80,10445,15130;15632;18292;18825,23360,0,2,2,0,4
37570,80,10446,15309;15633,23360,0,0,2,0,2
37571,80,10447,15634;15901;19240;19436,23360,1,1,2,0,4
37572,80,10448,14929;15151;18799;19387,23360,1,1,2,0,4
37573,80,10450,14981;15175;18990,23360,0,1,2,0,3
37574,80,10451,14885;15211;18289;19775,23360,1,1,2,0,4
37575,80,10452,15219;15822;18963;19203,23360,0,2,2,0,4
37576,80,10453,15255;15443;18745;19680,23360,1,1,2,0,4
37577,80,10454,15622;15919;19087,23360,0,1,2,0,3
37578,80,10455,15335;18465;18630;19505,23360,1,2,1,0,4
37579,80,10456,15744,23360,0,0,1,0,1
37580,80,10457,15705;15863;18526;18841,23360,0,2,2,0,4
37581,80,10458,15386;16008;18655;18996;19736,23360,1,2,2,0,5
37582,80,10459,15426;15701;18454;19510,23360,1,1,2,0,4
37583,80,10460,14974;15439;18861;19633,23360,1,1,2,0,4
37584,80,10461,15177;15440;18453;18733,23360,0,2,2,0,4
37585,80,10462,14935;15750;18460;18607;18829;19758,23360,1,3,2,0,6
37586,80,10463,15521;15936;18169;18556;18803,23360,0,3,2,0,5
37587,80,10464,14603;15566;19319;19438,23360,1,1,2,0,4
37588,80,10465,15570;15979;19864,23360,1,0,2,0,3
37589,80,10466,15580;15696;18455;18566;18827,23360,0,3,2,0,5
37590,80,10467,15519;15583;18452;18764,23360,0,2,2,0,4
37591,80,10468,15589;15939;19222;19728,23360,1,1,2,0,4
37592,80,10469,15593;16043;19860,23360,1,0,2,0,3
37593,80,10470,15606;18860;19093;19847,23360,1,2,1,0,4
37594,80,10471,15811;15952;18228;18380;19089;19388,23360,1,3,2,0,6
37595,80,10472,15692;19538;19718,23360,2,0,1,0,3
37596,80,10473,15655;16288;18315;19039;19252;19872,23360,1,3,2,0,6
37597,80,10474,15697;16026;18359;18421;18846;19474,23360,1,3,2,0,6
37598,80,10475,15658;18534;18757;18978,23360,0,3,1,0,4
37599,80,10476,16053,23360,0,0,1,0,1
37600,80,10477,15675;15866,23360,0,0,2,0,2
37601,80,10478,15686;15844;18231;18332,23360,0,2,2,0,4
37602,80,10479,15006;15718,23360,0,0,2,0,2
37603,80,10480,16134;18125;18858,23360,0,2,1,0,3
37604,80,10481,15693;15733,23360,0,0,2,0,2
37605,80,10482,15183;15738,23360,0,0,2,0,2
37606,80,10483,15743;16057;19062;19529,23360,1,1,2,0,4
37607,80,10484,15534;15749,23360,0,0,2,0,2
37608,80,10485,15484;18843;19168,23360,0,2,1,0,3
37609,80,10486,15984;19233;19593,23360,1,1,1,0,3
37610,80,10487,15812;16203;19125;19394,23360,1,1,2,0,4
37611,80,10488,15839;15968;18213;18475;18679;19049,23360,0,4,2,0,6
37612,80,10489,15843;16223;18178;19386;19713,23360,2,1,2,0,5
37613,80,10490,15492;15879;19220,23360,0,1,2,0,3
37614,80,10491,15850;16005;18938;19215,23360,0,2,2,0,4
37615,80,10492,15860;16168;18253;18907,23360,0,2,2,0,4
37616,80,10493,15425;15876,23360,0,0,2,0,2
37617,80,10494,15914;16125;18393;18954,23360,0,2,2,0,4
37618,80,10495,15735;18763;19308;19521,23360,1,2,1,0,4
37619,80,10496,15925;18956;19228,23360,0,2,1,0,3
37620,80,10498,10684,23725,0,0,0,1,1
37621,80,10499,10982,23725,0,0,0,1,1
37622,80,10504,11467,23725,0,0,0,1,1
37623,80,10507,10890,23725,0,0,0,1,1
37624,80,10516,13157,23725,0,0,1,0,1
37625,80,10519,13069,23725,0,0,1,0,1
37626,80,10520,12703,23725,0,0,1,0,1
37627,80,10526,13190;13380,23725,0,0,2,0,2
37628,80,10529,13850,23725,0,0,1,0,1
37629,80,10531,13649;13869,23725,0,0,2,0,2
37630,80,10534,13745;14350,23725,0,0,2,0,2
37631,80,10536,14092;14645;18335;18503;18831,23725,0,3,2,0,5
37632,80,10541,14257;14388,23725,0,0,2,0,2
37633,80,10543,14484;14766;19085,23725,0,1,2,0,3
37634,80,10544,15290,23725,0,0,1,0,1
37635,80,10546,14592;14750,23725,0,0,2,0,2
37636,80,10548,14625;14667;19170,23725,0,1,2,0,3
37637,80,10549,14814;14999;18457;18654,23725,0,2,2,0,4
37638,80,10550,14899;15573,23725,0,0,2,0,2
37639,80,10551,14944;15312;18349;19166;19685,23725,1,2,2,0,5
37640,80,10552,14955;15464,23725,0,0,2,0,2
37641,80,10554,14993;15077,23725,0,0,2,0,2
37642,80,10555,15703,23725,0,0,1,0,1
37643,80,10556,14620;15148;19110;19716,23725,1,1,2,0,4
37644,80,10557,15190;16201;19048;19903,23725,1,1,2,0,4
37645,80,10558,15236;18624,23725,0,1,1,0,2
37646,80,10559,15604;18313;18575;19913,23725,1,2,1,0,4
37647,80,10561,15720,23725,0,0,1,0,1
37648,80,10564,16070;16165;18945,23725,0,1,2,0,3
37649,80,10565,15446;15797,23725,0,0,2,0,2
37650,80,10566,15469;16293;18263;18914,23725,0,2,2,0,4
37651,80,10567,16055;19879,23725,1,0,1,0,2
37652,80,10568,15434;18719;18874;19216,23725,0,3,1,0,4
37653,80,10570,16182;16314;18688;19463,23725,1,1,2,0,4
37654,80,10571,15576;16114,23725,0,0,2,0,2
37655,80,10572,15185;15584,23725,0,0,2,0,2
37656,80,10573,15591;15600;18817;19113,23725,0,2,2,0,4
37657,80,10574,15666;19660,23725,1,0,1,0,2
37658,80,10575,15757;16283;19342;19907,23725,2,0,2,0,4
37659,80,10576,15710;15795,23725,0,0,2,0,2
37660,80,10577,15741;16131;18266;18625,23725,0,2,2,0,4
37661,80,10578,15774;16092;19797,23725,1,0,2,0,3
37662,80,10580,15610,23725,0,0,1,0,1
37663,80,10581,15835;15900;19075,23725,0,1,2,0,3
37664,80,10582,15903;19165;19412,23725,1,1,1,0,3
37665,80,10583,16376;18409;18559;19681,23725,1,2,1,0,4
37666,80,10584,15917;16163;18309;18517;18560,23725,0,3,2,0,5
37667,80,10585,15238;15976;18931,23725,0,1,2,0,3
37668,80,10586,15978;16229;18303;18436,23725,0,2,2,0,4
37669,80,10587,16006;16159;18514;19005;19344,23725,1,2,2,0,5
37670,80,10588,15156;16042;18820,23725,0,1,2,0,3
37671,80,10589,15241;16054;18351;18826;19090,23725,0,3,2,0,5
37672,80,10590,15438;15816,23725,0,0,2,0,2
37673,80,10591,10852,24090,0,0,0,1,1
37674,80,10592,10886,24090,0,0,0,1,1
37675,80,10596,10605,24090,0,0,0,1,1
37676,80,10601,11641,24090,0,0,0,1,1
37677,80,10602,11381,24090,0,0,0,1,1
37678,80,10604,12089,24090,0,0,1,0,1
37679,80,10621,12952,24090,0,0,1,0,1
37680,80,10622,13127,24090,0,0,1,0,1
37681,80,10627,13483,24090,0,0,1,0,1
37682,80,10629,13798,24090,0,0,1,0,1
37683,80,10638,13778;14386,24090,0,0,2,0,2
37684,80,10640,13854;14295,24090,0,0,2,0,2
37685,80,10642,14176;14739,24090,0,0,2,0,2
37686,80,10643,14082,24090,0,0,1,0,1
37687,80,10645,14430;14797,24090,0,0,2,0,2
37688,80,10647,14742,24090,0,0,1,0,1
37689,80,10648,14774;14834;18903,24090,0,1,2,0,3
37690,80,10649,14357;14864;18440;18842,24090,0,2,2,0,4
37691,80,10650,14918;15274;18667,24090,0,1,2,0,3
37692,80,10651,14896;15036,24090,0,0,2,0,2
37693,80,10652,15092,24090,0,0,1,0,1
37694,80,10653,14744;14966,24090,0,0,2,0,2
37695,80,10655,15117;19628,24090,1,0,1,0,2
37696,80,10656,15124;15721;18382;18798;19601,24090,1,2,2,0,5
37697,80,10657,15163;19010,24090,0,1,1,0,2
37698,80,10659,14764;15208;18545;18984,24090,0,2,2,0,4
37699,80,10661,15231;15502;19541,24090,1,0,2,0,3
37700,80,10662,15233;18756;19512,24090,1,1,1,0,3
37701,80,10663,16065;19825,24090,1,0,1,0,2
37702,80,10664,15303;15639;19399;19586,24090,2,0,2,0,4
37703,80,10665,15349;15620;18855;19071,24090,0,2,2,0,4
37704,80,10666,15362;15892;18790;19299;19422;19881,24090,2,2,2,0,6
37705,80,10667,15316,24090,0,0,1,0,1
37706,80,10668,15827;19478;19857,24090,2,0,1,0,3
37707,80,10669,15427;16325;18788;19498,24090,1,1,2,0,4
37708,80,10670,15810;18444;18620,24090,0,2,1,0,3
37709,80,10671,15961;18832;18992;19664,24090,1,2,1,0,4
37710,80,10672,15619;16045,24090,0,0,2,0,2
37711,80,10673,15565;19076;19300,24090,0,2,1,0,3
37712,80,10674,15612;15668,24090,0,0,2,0,2
37713,80,10675,14994;15614;18415;18715,24090,0,2,2,0,4
37714,80,10676,15166;15616;19417;19679,24090,2,0,2,0,4
37715,80,10677,15627;16004,24090,0,0,2,0,2
37716,80,10678,15644;15764;18838,24090,0,1,2,0,3
37717,80,10679,15646;16183;19480,24090,1,0,2,0,3
37718,80,10680,15652;16128;19301,24090,0,1,2,0,3
37719,80,10681,15661;16232;19790,24090,1,0,2,0,3
37720,80,10682,15691;15854;19643,24090,1,0,2,0,3
37721,80,10683,15729;15825;19400;19592,24090,2,0,2,0,4
37722,80,10684,15559;15771,24090,0,0,2,0,2
37723,80,10685,15784;15817,24090,0,0,2,0,2
37724,80,10686,15789;15970;19616;19823,24090,2,0,2,0,4
37725,80,10687,16028;19297;19434;19732,24090,2,1,1,0,4
37726,80,10688,15824;16071;18929;19420;19603,24090,2,1,2,0,5
37727,80,10689,15831;19441,24090,1,0,1,0,2
37728,80,10690,15856;16171,24090,0,0,2,0,2
37729,80,10691,15881;16021;19768,24090,1,0,2,0,3
37730,80,10692,15911;16226;19440,24090,1,0,2,0,3
37731,80,10693,15912;16393;18339;18525;18569,24090,0,3,2,0,5
37732,80,10694,15352;16186;18935;19186,24090,0,2,2,0,4
37733,80,10695,15924;16278;19607,24090,1,0,2,0,3
37734,80,10696,15926;15997;19310;19649,24090,1,1,2,0,4
37735,80,10697,15927;16405;18516;18726;19448,24090,1,2,2,0,5
37736,80,10698,16003;16471;18599;18811;19002;19813,24090,1,3,2,0,6
37737,80,10699,16073;16147,24090,0,0,2,0,2
37738,80,10700,15885;16022;18553;18882,24090,0,2,2,0,4
37739,80,10701,15198;16023;19462;19691,24090,2,0,2,0,4
37740,80,10702,16030;18363;18548;18847,24090,0,3,1,0,4
37741,80,10703,15818;16236;19262;19648,24090,1,1,2,0,4
37742,80,10704,15690;16227;19572;19795,24090,2,0,2,0,4
37743,80,10705,16036;16250;19534,24090,1,0,2,0,3
37744,80,10706,16050;16195;18711;19723,24090,1,1,2,0,4
37745,80,10707,16087;16129;18800;19189,24090,0,2,2,0,4
37746,80,10708,16105;16309;19473,24090,1,0,2,0,3
37747,80,10709,16121;16479;18318;18602;18731,24090,0,3,2,0,5
37748,80,10710,16122;18661;18886,24090,0,2,1,0,3
37749,80,10711,15731;16140,24090,0,0,2,0,2
37750,80,10712,16440;18870;19861,24090,1,1,1,0,3
37751,80,10713,16148;18530;19204,24090,0,2,1,0,3
37752,80,10715,11403;12128,24455,0,0,1,1,2
37753,80,10719,11588,24455,0,0,0,1,1
37754,80,10724,12226,24455,0,0,1,0,1
37755,80,10726,12153;12338,24455,0,0,2,0,2
37756,80,10727,12578;12659,24455,0,0,2,0,2
37757,80,10728,13026;13086,24455,0,0,2,0,2
37758,80,10734,13075;13744,24455,0,0,2,0,2
37759,80,10736,13799;14339,24455,0,0,2,0,2
37760,80,10739,14436,24455,0,0,1,0,1
37761,80,10744,14261,24455,0,0,1,0,1
37762,80,10745,14537;14546;19352,24455,1,0,2,0,3
37763,80,10749,15102;15326;19173,24455,0,1,2,0,3
37764,80,10750,14097;14806;18773,24455,0,1,2,0,3
37765,80,10752,14913;15015,24455,0,0,2,0,2
37766,80,10753,15157;15313;19106,24455,0,1,2,0,3
37767,80,10754,15096;15708;18919;19278,24455,0,2,2,0,4
37768,80,10755,14673;15158;19581,24455,1,0,2,0,3
37769,80,10756,15193;15642,24455,0,0,2,0,2
37770,80,10758,15105;19043,24455,0,1,1,0,2
37771,80,10760,15759;15886;19829,24455,1,0,2,0,3
37772,80,10761,15467;18844,24455,0,1,1,0,2
37773,80,10762,15273;18423;18583,24455,0,2,1,0,3
37774,80,10763,15292;15328;18732,24455,0,1,2,0,3
37775,80,10764,15087;15581;19662;19841,24455,2,0,2,0,4
37776,80,10765,15398;19288;19494,24455,1,1,1,0,3
37777,80,10766,15041;15419;18859;19375,24455,1,1,2,0,4
37778,80,10767,15637;15930;18419;18822;19135;19370,24455,1,3,2,0,6
37779,80,10768,15624;15915;18627;19003,24455,0,2,2,0,4
37780,80,10769,15472;18668,24455,0,1,1,0,2
37781,80,10770,15673;15778,24455,0,0,2,0,2
37782,80,10771,15695;16118,24455,0,0,2,0,2
37783,80,10772,15869;18702;19183;19315,24455,0,3,1,0,4
37784,80,10773,15746;16037;19783,24455,1,0,2,0,3
37785,80,10774,15756;15931;19539,24455,1,0,2,0,3
37786,80,10776,15767;16455;18766;19844,24455,1,1,2,0,4
37787,80,10777,15783;16199;18899;19305,24455,0,2,2,0,4
37788,80,10778,15791;16097;18752;19156;19553;19755;19848,24455,3,2,2,0,7
37789,80,10779,15799;15838;18952;19557,24455,1,1,2,0,4
37790,80,10780,16007;18993;19650,24455,1,1,1,0,3
37791,80,10781,15882;15905;18879;19320;19456,24455,1,2,2,0,5
37792,80,10782,15615;15883;19575;19798,24455,2,0,2,0,4
37793,80,10783,15897;16160;19749,24455,1,0,2,0,3
37794,80,10784,15928;19309;19837,24455,1,1,1,0,3
37795,80,10785,15950;16101;19355;19886,24455,2,0,2,0,4
37796,80,10786,16274;16579;18437;18998,24455,0,2,2,0,4
37797,80,10787,15946;15987;18913,24455,0,1,2,0,3
37798,80,10788,15996;16313;19038;19411;19659,24455,2,1,2,0,5
37799,80,10789,16033;16035,24455,0,0,2,0,2
37800,80,10790,16200;16307;18610;18823,24455,0,2,2,0,4
37801,80,10791,15429;16069;18506;18941;19131,24455,0,3,2,0,5
37802,80,10792,16102;16637;18605;18967;19447,24455,1,2,2,0,5
37803,80,10793,16116;16412;18609;19150;19663,24455,1,2,2,0,5
37804,80,10794,16164;16548;19322;19393,24455,1,1,2,0,4
37805,80,10795,16193;16255;19697,24455,1,0,2,0,3
37806,80,10796,15940;16221;18519;19306,24455,0,2,2,0,4
37807,80,10797,16225;16660;18485;19244,24455,0,2,2,0,4
37808,80,10798,16241;16281;18974;19185,24455,0,2,2,0,4
37809,80,10799,16254;16643;18529;18693;18968;19307,24455,0,4,2,0,6
37810,80,10800,15694;16272;19533,24455,1,0,2,0,3
37811,80,10801,11066,24820,0,0,0,1,1
37812,80,10803,11474,24820,0,0,0,1,1
37813,80,10804,11425;11629,24820,0,0,0,2,2
37814,80,10806,11389,24820,0,0,0,1,1
37815,80,10809,11201;11445,24820,0,0,0,2,2
37816,80,10811,11773,24820,0,0,0,1,1
37817,80,10814,12205;12236,24820,0,0,2,0,2
37818,80,10818,12485,24820,0,0,1,0,1
37819,80,10821,12717;12898,24820,0,0,2,0,2
37820,80,10822,12756,24820,0,0,1,0,1
37821,80,10825,13044,24820,0,0,1,0,1
37822,80,10828,13829;13987,24820,0,0,2,0,2
37823,80,10833,13257,24820,0,0,1,0,1
37824,80,10834,14111;14145,24820,0,0,2,0,2
37825,80,10835,14170;14325,24820,0,0,2,0,2
37826,80,10836,14182;14440;19261,24820,0,1,2,0,3
37827,80,10838,14441;15049,24820,0,0,2,0,2
37828,80,10839,14473,24820,0,0,1,0,1
37829,80,10840,14353;14459,24820,0,0,2,0,2
37830,80,10841,14488;15307,24820,0,0,2,0,2
37831,80,10842,14409,24820,0,0,1,0,1
37832,80,10844,13962;14635,24820,0,0,2,0,2
37833,80,10845,14686;15586,24820,0,0,2,0,2
37834,80,10846,14692;15129,24820,0,0,2,0,2
37835,80,10847,13832;14410,24820,0,0,2,0,2
37836,80,10848,14446;15009;19249;19348,24820,1,1,2,0,4
37837,80,10849,14392;14732;18999;19839,24820,1,1,2,0,4
37838,80,10850,14593;15138;19821,24820,1,0,2,0,3
37839,80,10854,14581;14912;18730;19191,24820,0,2,2,0,4
37840,80,10856,14738;15169,24820,0,0,2,0,2
37841,80,10858,14734;15184;18955;19019,24820,0,2,2,0,4
37842,80,10859,15172;15258,24820,0,0,2,0,2
37843,80,10860,15269;15820;18912;19044,24820,0,2,2,0,4
37844,80,10861,15284;16174,24820,0,0,2,0,2
37845,80,10862,14680,24820,0,0,1,0,1
37846,80,10863,15343;15389;18642,24820,0,1,2,0,3
37847,80,10865,15108;15388,24820,0,0,2,0,2
37848,80,10866,15353;15483,24820,0,0,2,0,2
37849,80,10868,15499;15993;18932;19086;19349,24820,1,2,2,0,5
37850,80,10869,15540;15834;18808;18971,24820,0,2,2,0,4
37851,80,10870,15266;15424;18604;18898,24820,0,2,2,0,4
37852,80,10871,15836;18684;19122,24820,0,2,1,0,3
37853,80,10872,15621;16417,24820,0,0,2,0,2
37854,80,10874,15672;16228;19230;19566,24820,1,1,2,0,4
37855,80,10875,15712;16095,24820,0,0,2,0,2
37856,80,10876,16256;16386;18850;19040;19217,24820,0,3,2,0,5
37857,80,10877,15542;15742;18869;19100,24820,0,2,2,0,4
37858,80,10878,16107;19485;19709,24820,2,0,1,0,3
37859,80,10879,15656;15804,24820,0,0,2,0,2
37860,80,10880,15807,24820,0,0,1,0,1
37861,80,10881,15832;16392;19291,24820,0,1,2,0,3
37862,80,10882,15740;15837;18582;19271;19830,24820,1,2,2,0,5
37863,80,10883,15846;16126;19445,24820,1,0,2,0,3
37864,80,10884,16025;16181;19072;19272,24820,0,2,2,0,4
37865,80,10885,15165;15891,24820,0,0,2,0,2
37866,80,10886,16017;16106;19423,24820,1,0,2,0,3
37867,80,10887,15932;15969,24820,0,0,2,0,2
37868,80,10888,15983,24820,0,0,1,0,1
37869,80,10889,15986;16248;19715,24820,1,0,2,0,3
37870,80,10890,15990;16109,24820,0,0,2,0,2
37871,80,10891,15999;16511;18706;19047;19235,24820,0,3,2,0,5
37872,80,10892,15698;16012;19479,24820,1,0,2,0,3
37873,80,10893,16286;18543;19651,24820,1,1,1,0,3
37874,80,10894,15867;16112;19208;19430;19674,24820,2,1,2,0,5
37875,80,10895,16117;16552;19188;19559;19741,24820,2,1,2,0,5
37876,80,10896,15943;16145;19577;19791,24820,2,0,2,0,4
37877,80,10897,15916;16151;19432;19449,24820,2,0,2,0,4
37878,80,10898,15524;16156;18590;18786,24820,0,2,2,0,4
37879,80,10899,16196;19029;19570,24820,1,1,1,0,3
37880,80,10900,16205;16754;18720;19483,24820,1,1,2,0,4
37881,80,10902,15847;16501;19118,24820,0,1,2,0,3
37882,80,10903,15992;16243;18921,24820,0,1,2,0,3
37883,80,10904,16142;16246;18988;19694,24820,1,1,2,0,4
37884,80,10905,16264;16494,24820,0,0,2,0,2
37885,80,10906,16483;16836;19757;19905,24820,2,0,2,0,4
37886,80,10907,16345;16454;18939;19092;19395,24820,1,2,2,0,5
37887,80,10908,16352;16570;18615;18852;19074;19161,24820,0,4,2,0,6
37888,80,10909,16048;16369,24820,0,0,2,0,2
37889,80,10910,16373;19298;19686,24820,1,1,1,0,3
37890,80,10912,16409;16535,24820,0,0,2,0,2
37891,80,10913,16739;18565;19588;19831,24820,2,1,1,0,4
37892,80,10914,16434;16771;19146;19401;19573;19855,24820,3,1,2,0,6
37893,80,10915,16190;16467,24820,0,0,2,0,2
37894,80,10917,11282,25185,0,0,0,1,1
37895,80,10922,11621,25185,0,0,0,1,1
37896,80,10934,12890,25185,0,0,1,0,1
37897,80,10935,12886;12984,25185,0,0,2,0,2
37898,80,10938,13133,25185,0,0,1,0,1
37899,80,10942,13040,25185,0,0,1,0,1
37900,80,10946,13509,25185,0,0,1,0,1
37901,80,10950,14148;14627;19435,25185,1,0,2,0,3
37902,80,10951,14209;14701,25185,0,0,2,0,2
37903,80,10952,14946;19219;19910,25185,1,1,1,0,3
37904,80,10956,14550;14860;18682;19102;19346,25185,1,2,2,0,5
37905,80,10957,14572,25185,0,0,1,0,1
37906,80,10958,14586,25185,0,0,1,0,1
37907,80,10962,14868;15040;19196,25185,0,1,2,0,3
37908,80,10965,14925;15367,25185,0,0,2,0,2
37909,80,10966,14414;14677,25185,0,0,2,0,2
37910,80,10968,15139;15355,25185,0,0,2,0,2
37911,80,10970,15336,25185,0,0,1,0,1
37912,80,10971,14874;15344;18950;19046;19174,25185,0,3,2,0,5
37913,80,10972,15402;18634,25185,0,1,1,0,2
37914,80,10973,15726;15868;19207;19500,25185,1,1,2,0,4
37915,80,10974,15833;15870;19236;19513,25185,1,1,2,0,4
37916,80,10975,16185,25185,0,0,1,0,1
37917,80,10976,15563;16177;19347;19654,25185,2,0,2,0,4
37918,80,10977,15574;16016;19584,25185,1,0,2,0,3
37919,80,10978,16032;18636;19816,25185,1,1,1,0,3
37920,80,10979,15618,25185,0,0,1,0,1
37921,80,10980,15648;15871;19793,25185,1,0,2,0,3
37922,80,10981,15560;15651;18989;19053;19426,25185,1,2,2,0,5
37923,80,10982,15450;15662,25185,0,0,2,0,2
37924,80,10983,15714;16346,25185,0,0,2,0,2
37925,80,10984,15753;16216;19232;19591,25185,1,1,2,0,4
37926,80,10985,15801;16013;18969;19155;19621,25185,1,2,2,0,5
37927,80,10986,15715;15965;19094;19275,25185,0,2,2,0,4
37928,80,10987,15222;15865;19015;19175,25185,0,2,2,0,4
37929,80,10988,15470;15947;19211;19487,25185,1,1,2,0,4
37930,80,10989,15955;16531;18721;18804;19532,25185,1,2,2,0,5
37931,80,10990,14819;15045,25185,0,0,2,0,2
37932,80,10991,16014;19819,25185,1,0,1,0,2
37933,80,10992,16078;16136,25185,0,0,2,0,2
37934,80,10993,15674;15971;19507,25185,1,0,2,0,3
37935,80,10994,16027;18819;19056;19763,25185,1,2,1,0,4
37936,80,10995,15608;16059;19169;19515,25185,1,1,2,0,4
37937,80,10996,16068;16413;18924;19327,25185,0,2,2,0,4
37938,80,10997,16083;16692;19868,25185,1,0,2,0,3
37939,80,10998,16088,25185,0,0,1,0,1
37940,80,10999,16091;16709,25185,0,0,2,0,2
37941,80,11000,16034;16093,25185,0,0,2,0,2
37942,80,11001,15577;16110;19404;19667,25185,2,0,2,0,4
37943,80,11002,16124;16251;19527,25185,1,0,2,0,3
37944,80,11003,16444,25185,0,0,1,0,1
37945,80,11004,15859;16627;19511;19640,25185,2,0,2,0,4
37946,80,11006,16222;16498,25185,0,0,2,0,2
37947,80,11007,16240;16753,25185,0,0,2,0,2
37948,80,11008,16244;16586;18670;18940;19690,25185,1,2,2,0,5
37949,80,11009,15830;16245;19489,25185,1,0,2,0,3
37950,80,11010,15941;16263;19403;19645,25185,2,0,2,0,4
37951,80,11011,16120;16269;19145;19503,25185,1,1,2,0,4
37952,80,11012,16187;16298;18705;19136,25185,0,2,2,0,4
37953,80,11013,16301;16779,25185,0,0,2,0,2
37954,80,11014,16302;16772;19853,25185,1,0,2,0,3
37955,80,11015,16318;16599,25185,0,0,2,0,2
37956,80,11016,16336;16559;19206;19865,25185,1,1,2,0,4
37957,80,11017,15913;16340,25185,0,0,2,0,2
37958,80,11018,16349;16841;18653;19245;19571,25185,1,2,2,0,5
37959,80,11019,16384;16504,25185,0,0,2,0,2
37960,80,11020,16422,25185,0,0,1,0,1
37961,80,11021,16485;19302;19468;19629,25185,2,1,1,0,4
37962,80,11022,16115;16428;19221;19759,25185,1,1,2,0,4
37963,80,11023,16432;16536;19477;19771,25185,2,0,2,0,4
37964,80,11024,16010;16437;18692;19151,25185,0,2,2,0,4
37965,80,11025,16446;16560;18750;19523;19762,25185,2,1,2,0,5
37966,80,11026,16377;16457;19154,25185,0,1,2,0,3
37967,80,11027,16458,25185,0,0,1,0,1
37968,80,11028,16480;16625;18796;19213;19605,25185,1,2,2,0,5
37969,80,11029,16327;16803,25185,0,0,2,0,2
37970,80,11030,16489;16493;18792;19083,25185,0,2,2,0,4
37971,80,11031,16519;16601;19351;19609,25185,2,0,2,0,4
37972,80,11032,16549;19358,25185,1,0,1,0,2
37973,80,11033,16439;16553;19336;19812,25185,2,0,2,0,4
37974,80,11034,11027,25550,0,0,0,1,1
37975,80,11035,11362,25550,0,0,0,1,1
37976,80,11036,11473,25550,0,0,0,1,1
37977,80,11037,11501,25550,0,0,0,1,1
37978,80,11039,11169,25550,0,0,0,1,1
37979,80,11041,11569;12093,25550,0,0,1,1,2
37980,80,11043,11775,25550,0,0,0,1,1
37981,80,11044,11964,25550,0,0,1,0,1
37982,80,11045,12455,25550,0,0,1,0,1
37983,80,11046,12038;12928,25550,0,0,2,0,2
37984,80,11048,12027,25550,0,0,1,0,1
37985,80,11049,11941;12493,25550,0,0,2,0,2
37986,80,11055,12751,25550,0,0,1,0,1
37987,80,11056,12642,25550,0,0,1,0,1
37988,80,11060,12793,25550,0,0,1,0,1
37989,80,11061,13224,25550,0,0,1,0,1
37990,80,11066,13644,25550,0,0,1,0,1
37991,80,11068,13520,25550,0,0,1,0,1
37992,80,11070,13293;13896,25550,0,0,2,0,2
37993,80,11077,13918,25550,0,0,1,0,1
37994,80,11082,13917;14401,25550,0,0,2,0,2
37995,80,11085,13940;14172,25550,0,0,2,0,2
37996,80,11087,14881;15828;18806;19266;19698,25550,1,2,2,0,5
37997,80,11090,15218,25550,0,0,1,0,1
37998,80,11091,14996;15405;19499,25550,1,0,2,0,3
37999,80,11092,15010;15037,25550,0,0,2,0,2
38000,80,11093,14434;15069;19549,25550,1,0,2,0,3
38001,80,11094,14728;15114,25550,0,0,2,0,2
38002,80,11095,15136;15324,25550,0,0,2,0,2
38003,80,11096,15150;18893;19176,25550,0,2,1,0,3
38004,80,11098,15232;15354,25550,0,0,2,0,2
38005,80,11099,14947;15257,25550,0,0,2,0,2
38006,80,11100,15127;15291,25550,0,0,2,0,2
38007,80,11101,15400;16150,25550,0,0,2,0,2
38008,80,11104,15543;16002,25550,0,0,2,0,2
38009,80,11105,15018;15587,25550,0,0,2,0,2
38010,80,11106,15677,25550,0,0,1,0,1
38011,80,11107,15723;15989;19313,25550,0,1,2,0,3
38012,80,11108,15730;16178,25550,0,0,2,0,2
38013,80,11109,15739;16287;19198;19324;19359;19579,25550,2,2,2,0,6
38014,80,11110,15956;16108,25550,0,0,2,0,2
38015,80,11112,15977;15982;18775,25550,0,1,2,0,3
38016,80,11114,16009;16096;19373;19714,25550,2,0,2,0,4
38017,80,11115,15700;16011;18867,25550,0,1,2,0,3
38018,80,11116,15372;16474,25550,0,0,2,0,2
38019,80,11117,15988;16197;19545;19904,25550,2,0,2,0,4
38020,80,11118,15717,25550,0,0,1,0,1
38021,80,11119,16741,25550,0,0,1,0,1
38022,80,11120,16143;16162,25550,0,0,2,0,2
38023,80,11121,16169;16461;19870,25550,1,0,2,0,3
38024,80,11122,16188,25550,0,0,1,0,1
38025,80,11123,16366;16652;19567;19656,25550,2,0,2,0,4
38026,80,11124,15531;16204;18862;19778,25550,1,1,2,0,4
38027,80,11125,16206;16619;19338;19618,25550,2,0,2,0,4
38028,80,11126,15325;16207;19516,25550,1,0,2,0,3
38029,80,11127,16234;16634,25550,0,0,2,0,2
38030,80,11128,16170;16249;19614,25550,1,0,2,0,3
38031,80,11129,16252;17062;19820,25550,1,0,2,0,3
38032,80,11130,16610;18802;19383,25550,1,1,1,0,3
38033,80,11132,16294;16518;18866;19126;19634,25550,1,2,2,0,5
38034,80,11133,16303;17063,25550,0,0,2,0,2
38035,80,11134,16683;19115;19843,25550,1,1,1,0,3
38036,80,11135,16280;16337;19696,25550,1,0,2,0,3
38037,80,11136,15873;16339,25550,0,0,2,0,2
38038,80,11137,15851;16343;18917,25550,0,1,2,0,3
38039,80,11138,16362,25550,0,0,1,0,1
38040,80,11139,16237;16375;19033;19356;19767,25550,2,1,2,0,5
38041,80,11140,16418;16644;19652,25550,1,0,2,0,3
38042,80,11141,16421;16822;19597,25550,1,0,2,0,3
38043,80,11142,16072;16456,25550,0,0,2,0,2
38044,80,11143,16512;16722;18851;19024;19455;19730,25550,2,2,2,0,6
38045,80,11144,16528;16612,25550,0,0,2,0,2
38046,80,11145,16537;16818,25550,0,0,2,0,2
38047,80,11146,16868;16888;19619,25550,1,0,2,0,3
38048,80,11147,16424;16562;19555;19744,25550,2,0,2,0,4
38049,80,11148,16576;16782;18753,25550,0,1,2,0,3
38050,80,11149,16584;18761;19283,25550,0,2,1,0,3
38051,80,11150,16329;16603;18794;19264,25550,0,2,2,0,4
38052,80,11151,16606;16931,25550,0,0,2,0,2
38053,80,11152,16074;16616;18947;19028,25550,0,2,2,0,4
38054,80,11153,16936,25550,0,0,1,0,1
38055,80,11154,16904,25550,0,0,1,0,1
38056,80,11155,16649;16791;19906,25550,1,0,2,0,3
38057,80,11156,16650;19452,25550,1,0,1,0,2
38058,80,11157,16317;16663;19134;19700,25550,1,1,2,0,4
38059,80,11158,16673;17060;19138;19563,25550,1,1,2,0,4
38060,80,11159,16253;16675;19070;19241,25550,0,2,2,0,4
38061,80,11161,11589;11661,25915,0,0,0,2,2
38062,80,11162,11456;11815,25915,0,0,0,2,2
38063,80,11164,11384,25915,0,0,0,1,1
38064,80,11167,11540,25915,0,0,0,1,1
38065,80,11171,12069,25915,0,0,1,0,1
38066,80,11172,12077,25915,0,0,1,0,1
38067,80,11174,12469;12602,25915,0,0,2,0,2
38068,80,11176,12576;13076,25915,0,0,2,0,2
38069,80,11177,12063;12212,25915,0,0,2,0,2
38070,80,11178,12630,25915,0,0,1,0,1
38071,80,11180,12683,25915,0,0,1,0,1
38072,80,11182,12767;12950,25915,0,0,2,0,2
38073,80,11188,13232,25915,0,0,1,0,1
38074,80,11195,13723,25915,0,0,1,0,1
38075,80,11197,13583,25915,0,0,1,0,1
38076,80,11199,13270,25915,0,0,1,0,1
38077,80,11200,13872,25915,0,0,1,0,1
38078,80,11206,13650,25915,0,0,1,0,1
38079,80,11212,14027;14614,25915,0,0,2,0,2
38080,80,11214,15073;15442;19127;19260,25915,0,2,2,0,4
38081,80,11215,15090;15168,25915,0,0,2,0,2
38082,80,11216,14828;14988,25915,0,0,2,0,2
38083,80,11220,14839;15280,25915,0,0,2,0,2
38084,80,11221,15262,25915,0,0,1,0,1
38085,80,11222,15539,25915,0,0,1,0,1
38086,80,11223,14471;14900;19034;19258,25915,0,2,2,0,4
38087,80,11224,15331;16139;19836,25915,1,0,2,0,3
38088,80,11226,15360,25915,0,0,1,0,1
38089,80,11227,15251;15436;19684,25915,1,0,2,0,3
38090,80,11228,15755;16154,25915,0,0,2,0,2
38091,80,11230,15643;16334;19551;19898,25915,2,0,2,0,4
38092,80,11231,15653,25915,0,0,1,0,1
38093,80,11232,15706;15951;19774;19901,25915,2,0,2,0,4
38094,80,11233,15745,25915,0,0,1,0,1
38095,80,11234,15841;16209;19788,25915,1,0,2,0,3
38096,80,11235,15966;16284;19446;19675,25915,2,0,2,0,4
38097,80,11236,16062;16690,25915,0,0,2,0,2
38098,80,11237,15722;16380,25915,0,0,2,0,2
38099,80,11238,16104;16497;19777,25915,1,0,2,0,3
38100,80,11239,15890;16214;19337;19899,25915,2,0,2,0,4
38101,80,11240,16144;16443,25915,0,0,2,0,2
38102,80,11241,16157,25915,0,0,1,0,1
38103,80,11242,16176;16575;19646,25915,1,0,2,0,3
38104,80,11243,16210;19717,25915,1,0,1,0,2
38105,80,11244,16211;16554,25915,0,0,2,0,2
38106,80,11245,16273;16406;19859,25915,1,0,2,0,3
38107,80,11246,16299;16571;19247;19673,25915,1,1,2,0,4
38108,80,11247,16305,25915,0,0,1,0,1
38109,80,11248,16296;16310;19429;19742;19809,25915,3,0,2,0,5
38110,80,11249,16311;16947,25915,0,0,2,0,2
38111,80,11250,16365;19805,25915,1,0,1,0,2
38112,80,11251,15880;16442,25915,0,0,2,0,2
38113,80,11252,16705;16860;19760,25915,1,0,2,0,3
38114,80,11253,16433,25915,0,0,1,0,1
38115,80,11255,16469;16768;18897,25915,0,1,2,0,3
38116,80,11256,16472;16486;19695,25915,1,0,2,0,3
38117,80,11257,16798;19413;19636,25915,2,0,1,0,3
38118,80,11258,16490;16941,25915,0,0,2,0,2
38119,80,11259,16503;16826;18949;19180;19372,25915,1,2,2,0,5
38120,80,11260,15877;16462,25915,0,0,2,0,2
38121,80,11261,16508;16555;18972;19875,25915,1,1,2,0,4
38122,80,11262,16561;16984,25915,0,0,2,0,2
38123,80,11263,16425;16564;19765,25915,1,0,2,0,3
38124,80,11264,16262;16609,25915,0,0,2,0,2
38125,80,11265,16098;16617;19622;19803,25915,2,0,2,0,4
38126,80,11266,17103;18975;19107;19712,25915,1,2,1,0,4
38127,80,11267,16646;16785;19229,25915,0,1,2,0,3
38128,80,11268,16651;16944,25915,0,0,2,0,2
38129,80,11269,16654;16688;19371,25915,1,0,2,0,3
38130,80,11270,16661,25915,0,0,1,0,1
38131,80,11272,16360;16831;18979;19055;19827,25915,1,2,2,0,5
38132,80,11273,16732;17129;19088,25915,0,1,2,0,3
38133,80,11274,16516;16733,25915,0,0,2,0,2
38134,80,11275,16762,25915,0,0,1,0,1
38135,80,11276,17095;18925;19727,25915,1,1,1,0,3
38136,80,11277,16359;16770;19121;19852,25915,1,1,2,0,4
38137,80,11278,16703;16788;19546;19890,25915,2,0,2,0,4
38138,80,11279,16793;16869;18896,25915,0,1,2,0,3
38139,80,11280,16481;17135,25915,0,0,2,0,2
38140,80,11281,16330;16806,25915,0,0,2,0,2
38141,80,11282,16813;16963;19754,25915,1,0,2,0,3
38142,80,11283,11168,26280,0,0,0,1,1
38143,80,11288,11664;11860,26280,0,0,0,2,2
38144,80,11289,11715;12001,26280,0,0,1,1,2
38145,80,11294,12142;12162,26280,0,0,2,0,2
38146,80,11300,13227,26280,0,0,1,0,1
38147,80,11301,13230,26280,0,0,1,0,1
38148,80,11304,13102,26280,0,0,1,0,1
38149,80,11305,13636,26280,0,0,1,0,1
38150,80,11306,13710,26280,0,0,1,0,1
38151,80,11307,13931,26280,0,0,1,0,1
38152,80,11308,13571,26280,0,0,1,0,1
38153,80,11309,13969;14373,26280,0,0,2,0,2
38154,80,11310,13985;14303,26280,0,0,2,0,2
38155,80,11316,15001,26280,0,0,1,0,1
38156,80,11318,14594;14670,26280,0,0,2,0,2
38157,80,11322,14351;14910;19461,26280,1,0,2,0,3
38158,80,11323,14832;14968;19484,26280,1,0,2,0,3
38159,80,11324,14743;15111;19061;19179,26280,0,2,2,0,4
38160,80,11326,14688;14989,26280,0,0,2,0,2
38161,80,11327,15204;15234,26280,0,0,2,0,2
38162,80,11329,15265;15276,26280,0,0,2,0,2
38163,80,11330,15277;15383,26280,0,0,2,0,2
38164,80,11332,15330;15475,26280,0,0,2,0,2
38165,80,11334,15550;15727;19137;19450,26280,1,1,2,0,4
38166,80,11335,15350;15552,26280,0,0,2,0,2
38167,80,11336,15582;19114;19376,26280,1,1,1,0,3
38168,80,11338,15595,26280,0,0,1,0,1
38169,80,11339,15546;15625,26280,0,0,2,0,2
38170,80,11340,14509;14822,26280,0,0,2,0,2
38171,80,11341,15815;16532;19699;19808,26280,2,0,2,0,4
38172,80,11342,15670;15862;19641;19846,26280,2,0,2,0,4
38173,80,11343,15699;15798,26280,0,0,2,0,2
38174,80,11344,15904;16220;19269,26280,0,1,2,0,3
38175,80,11346,16080,26280,0,0,1,0,1
38176,80,11347,16019;16064;19506;19776,26280,2,0,2,0,4
38177,80,11348,16137;16404;19726;19909,26280,2,0,2,0,4
38178,80,11349,16149;16670;19323;19580,26280,1,1,2,0,4
38179,80,11350,16172;16819;19779,26280,1,0,2,0,3
38180,80,11351,16180;16700;19602;19894,26280,2,0,2,0,4
38181,80,11352,16189;16194;19637;19710,26280,2,0,2,0,4
38182,80,11353,16208;16681;19405;19658,26280,2,0,2,0,4
38183,80,11354,16319;19280;19576,26280,1,1,1,0,3
38184,80,11355,16247;16689,26280,0,0,2,0,2
38185,80,11356,16268;16300,26280,0,0,2,0,2
38186,80,11357,16525;16704;19378;19780,26280,2,0,2,0,4
38187,80,11358,16312;19295;19332,26280,1,1,1,0,3
38188,80,11359,16192;16332;19059;19201,26280,0,2,2,0,4
38189,80,11360,16735;16811;19318;19672,26280,1,1,2,0,4
38190,80,11361,15994;16364,26280,0,0,2,0,2
38191,80,11362,16387;16891,26280,0,0,2,0,2
38192,80,11363,16158;16390;19108;19769;19885,26280,2,1,2,0,5
38193,80,11364,16399;16488,26280,0,0,2,0,2
38194,80,11366,16403;19111;19238;19537;19734,26280,2,2,1,0,5
38195,80,11367,16666;16903;19431;19509;19800,26280,3,0,2,0,5
38196,80,11368,16478;16573,26280,0,0,2,0,2
38197,80,11369,16510;16630;19099;19130,26280,0,2,2,0,4
38198,80,11370,16435;16514;19259;19676;19911,26280,2,1,2,0,5
38199,80,11371,16557;17003,26280,0,0,2,0,2
38200,80,11372,16306;16563,26280,0,0,2,0,2
38201,80,11373,16086;16569;19706;19854,26280,2,0,2,0,4
38202,80,11374,16639;17116;19414;19671,26280,2,0,2,0,4
38203,80,11375,16669;16917,26280,0,0,2,0,2
38204,80,11376,16523;16665,26280,0,0,2,0,2
38205,80,11377,16679;16912,26280,0,0,2,0,2
38206,80,11378,16695;16940;19531,26280,1,0,2,0,3
38207,80,11379,16698;16897;19304;19520;19738,26280,2,1,2,0,5
38208,80,11380,16728;17306,26280,0,0,2,0,2
38209,80,11381,16751;17025,26280,0,0,2,0,2
38210,80,11382,16775;17122,26280,0,0,2,0,2
38211,80,11383,16694;16794;19104,26280,0,1,2,0,3
38212,80,11384,16677;16808;19396;19772,26280,2,0,2,0,4
38213,80,11385,16828,26280,0,0,1,0,1
38214,80,11386,17266;19257,26280,0,1,1,0,2
38215,80,11387,17144;19018,26280,0,1,1,0,2
38216,80,11388,16877;17180;19073;19226,26280,0,2,2,0,4
38217,80,11389,16611;16905;19078;19274,26280,0,2,2,0,4
38218,80,11390,16843;16909;19871,26280,1,0,2,0,3
38219,80,11391,16916;17154,26280,0,0,2,0,2
38220,80,11392,16645;17292,26280,0,0,2,0,2
38221,80,11393,16918;17077;19133;19764,26280,1,1,2,0,4
38222,80,11394,16231;16919,26280,0,0,2,0,2
38223,80,11397,11802,26645,0,0,0,1,1
38224,80,11399,12007,26645,0,0,1,0,1
38225,80,11400,11587,26645,0,0,0,1,1
38226,80,11403,11888,26645,0,0,1,0,1
38227,80,11404,11814;12131,26645,0,0,1,1,2
38228,80,11406,12476;12626,26645,0,0,2,0,2
38229,80,11407,12032,26645,0,0,1,0,1
38230,80,11411,12723,26645,0,0,1,0,1
38231,80,11412,12666,26645,0,0,1,0,1
38232,80,11416,13265,26645,0,0,1,0,1
38233,80,11417,13531,26645,0,0,1,0,1
38234,80,11418,13407,26645,0,0,1,0,1
38235,80,11419,13327;13381,26645,0,0,2,0,2
38236,80,11424,14076;14695,26645,0,0,2,0,2
38237,80,11425,14218,26645,0,0,1,0,1
38238,80,11426,14343,26645,0,0,1,0,1
38239,80,11427,14694,26645,0,0,1,0,1
38240,80,11428,14669;14708,26645,0,0,2,0,2
38241,80,11429,14547;14698,26645,0,0,2,0,2
38242,80,11433,14911,26645,0,0,1,0,1
38243,80,11435,15022;15050;19421;19585,26645,2,0,2,0,4
38244,80,11436,14812;15391,26645,0,0,2,0,2
38245,80,11439,15382;15466,26645,0,0,2,0,2
38246,80,11441,15523;15551;19802,26645,1,0,2,0,3
38247,80,11442,15607;16161,26645,0,0,2,0,2
38248,80,11443,15636,26645,0,0,1,0,1
38249,80,11444,15679;16427,26645,0,0,2,0,2
38250,80,11445,15684;15773;19277;19390,26645,1,1,2,0,4
38251,80,11446,15702;15763;19784,26645,1,0,2,0,3
38252,80,11447,15578;15781,26645,0,0,2,0,2
38253,80,11448,15298,26645,0,0,1,0,1
38254,80,11449,15920;16198;19194;19392,26645,1,1,2,0,4
38255,80,11450,15737;15953,26645,0,0,2,0,2
38256,80,11451,15861;15991;19543,26645,1,0,2,0,3
38257,80,11452,16111;16712;19343,26645,1,0,2,0,3
38258,80,11453,16132;16487;19631;19794,26645,2,0,2,0,4
38259,80,11454,16138;16191;19129;19294,26645,0,2,2,0,4
38260,80,11455,16242;16450;19140;19644,26645,1,1,2,0,4
38261,80,11456,16275;16448;19128;19589;19834,26645,2,1,2,0,5
38262,80,11457,16324;16333,26645,0,0,2,0,2
38263,80,11458,16420;19172;19357,26645,1,1,1,0,3
38264,80,11459,16099;16338,26645,0,0,2,0,2
38265,80,11460,16342;16942;19884,26645,1,0,2,0,3
38266,80,11461,16351;16816,26645,0,0,2,0,2
38267,80,11462,16348;16736,26645,0,0,2,0,2
38268,80,11463,16381;17134,26645,0,0,2,0,2
38269,80,11464,15974;16382;19504;19814,26645,2,0,2,0,4
38270,80,11465,16356;16419,26645,0,0,2,0,2
38271,80,11466,16445;17178;19117;19502,26645,1,1,2,0,4
38272,80,11467,16315;16447,26645,0,0,2,0,2
38273,80,11468,16119;16674;19424,26645,1,0,2,0,3
38274,80,11469,16509;16693;19253;19653,26645,1,1,2,0,4
38275,80,11470,16173;16538;19756,26645,1,0,2,0,3
38276,80,11471,16321;16543,26645,0,0,2,0,2
38277,80,11472,16152;16551,26645,0,0,2,0,2
38278,80,11473,16492;16588;19887,26645,1,0,2,0,3
38279,80,11474,16167;16202,26645,0,0,2,0,2
38280,80,11475,16614;16656,26645,0,0,2,0,2
38281,80,11476,16662;16971;19770,26645,1,0,2,0,3
38282,80,11477,16546;16671,26645,0,0,2,0,2
38283,80,11478,16463;16999,26645,0,0,2,0,2
38284,80,11479,15878;16684;19273;19880,26645,1,1,2,0,4
38285,80,11480,16585;16699,26645,0,0,2,0,2
38286,80,11481,16556;16708,26645,0,0,2,0,2
38287,80,11482,16388;16714;19639,26645,1,0,2,0,3
38288,80,11483,16720,26645,0,0,1,0,1
38289,80,11484,17168,26645,0,0,1,0,1
38290,80,11485,16506;16734,26645,0,0,2,0,2
38291,80,11486,16371;16568;19312;19335;19703,26645,2,1,2,0,5
38292,80,11487,16716;16758,26645,0,0,2,0,2
38293,80,11488,16653;16765,26645,0,0,2,0,2
38294,80,11489,16796;16911,26645,0,0,2,0,2
38295,80,11490,16814;16908;19467;19810,26645,2,0,2,0,4
38296,80,11491,16821;17051,26645,0,0,2,0,2
38297,80,11492,16476;16825;19459;19746,26645,2,0,2,0,4
38298,80,11493,16672;16830;19817,26645,1,0,2,0,3
38299,80,11494,16842;16915;19688,26645,1,0,2,0,3
38300,80,11495,16545;16851,26645,0,0,2,0,2
38301,80,11496,16856;16926,26645,0,0,2,0,2
38302,80,11497,16870;17014,26645,0,0,2,0,2
38303,80,11498,16835;16876,26645,0,0,2,0,2
38304,80,11499,16889;17106,26645,0,0,2,0,2
38305,80,11500,16593;16907;19897,26645,1,0,2,0,3
38306,80,11501,16925;17117,26645,0,0,2,0,2
38307,80,11502,16927;17177;19205,26645,0,1,2,0,3
38308,80,11504,16962;17221;19187;19442,26645,1,1,2,0,4
38309,80,11505,16968;17068;19224;19476,26645,1,1,2,0,4
38310,80,11506,16990;17128;19496,26645,1,0,2,0,3
38311,80,11507,16790;16992;19491;19724,26645,2,0,2,0,4
38312,80,11508,17004;17032;19669,26645,1,0,2,0,3
38313,80,11509,17227;19345;19556;19828,26645,3,0,1,0,4
38314,80,11510,16719;17019;19267;19752,26645,1,1,2,0,4
38315,80,11511,17026;17155;19472;19582,26645,2,0,2,0,4
38316,80,11512,16344;17029;19481;19624,26645,2,0,2,0,4
38317,80,11513,11679,27010,0,0,0,1,1
38318,80,11514,11671,27010,0,0,0,1,1
38319,80,11515,11808,27010,0,0,0,1,1
38320,80,11516,11625,27010,0,0,0,1,1
38321,80,11517,11559,27010,0,0,0,1,1
38322,80,11518,12216,27010,0,0,1,0,1
38323,80,11519,11433,27010,0,0,0,1,1
38324,80,11520,11343,27010,0,0,0,1,1
38325,80,11522,11958,27010,0,0,1,0,1
38326,80,11523,11957;11988,27010,0,0,2,0,2
38327,80,11524,12477,27010,0,0,1,0,1
38328,80,11525,12307,27010,0,0,1,0,1
38329,80,11527,12152,27010,0,0,1,0,1
38330,80,11530,12884,27010,0,0,1,0,1
38331,80,11533,12618;12865,27010,0,0,2,0,2
38332,80,11534,13012,27010,0,0,1,0,1
38333,80,11535,12715,27010,0,0,1,0,1
38334,80,11536,11993,27010,0,0,1,0,1
38335,80,11539,13302,27010,0,0,1,0,1
38336,80,11540,13398,27010,0,0,1,0,1
38337,80,11543,13468;13476,27010,0,0,2,0,2
38338,80,11545,13742;13752,27010,0,0,2,0,2
38339,80,11549,14634,27010,0,0,1,0,1
38340,80,11550,14700;14950,27010,0,0,2,0,2
38341,80,11551,14247,27010,0,0,1,0,1
38342,80,11552,15100;15194,27010,0,0,2,0,2
38343,80,11553,14671;15225,27010,0,0,2,0,2
38344,80,11554,15373;15603,27010,0,0,2,0,2
38345,80,11555,15376;15760;19381;19611,27010,2,0,2,0,4
38346,80,11556,15428;15528,27010,0,0,2,0,2
38347,80,11558,15529;15942;19889,27010,1,0,2,0,3
38348,80,11559,15592,27010,0,0,1,0,1
38349,80,11561,15681,27010,0,0,1,0,1
38350,80,11562,15074;15508;19517,27010,1,0,2,0,3
38351,80,11563,15803,27010,0,0,1,0,1
38352,80,11564,15796;15963,27010,0,0,2,0,2
38353,80,11565,15780;15852,27010,0,0,2,0,2
38354,80,11566,15874,27010,0,0,1,0,1
38355,80,11567,15268;15500,27010,0,0,2,0,2
38356,80,11568,15908,27010,0,0,1,0,1
38357,80,11569,15821;15922,27010,0,0,2,0,2
38358,80,11570,15923;15972;19514;19877,27010,2,0,2,0,4
38359,80,11571,15948;16372,27010,0,0,2,0,2
38360,80,11572,15669;16267;19560;19748;19856,27010,3,0,2,0,5
38361,80,11573,15599,27010,0,0,1,0,1
38362,80,11575,16597;19458;19850,27010,2,0,1,0,3
38363,80,11576,16686;19443,27010,1,0,1,0,2
38364,80,11577,16304;16774,27010,0,0,2,0,2
38365,80,11578,16276;16368,27010,0,0,2,0,2
38366,80,11579,15736,27010,0,0,1,0,1
38367,80,11580,17022;19465,27010,1,0,1,0,2
38368,80,11581,16058;16513;19508,27010,1,0,2,0,3
38369,80,11582,16297;16530,27010,0,0,2,0,2
38370,80,11583,16541;16866,27010,0,0,2,0,2
38371,80,11584,16594,27010,0,0,1,0,1
38372,80,11585,16578;16718,27010,0,0,2,0,2
38373,80,11586,16397;16857;19617;19733,27010,2,0,2,0,4
38374,80,11587,16621;16883,27010,0,0,2,0,2
38375,80,11588,15909;16638,27010,0,0,2,0,2
38376,80,11589,16596;16707,27010,0,0,2,0,2
38377,80,11590,16726;17170,27010,0,0,2,0,2
38378,80,11591,16766;16921;19896,27010,1,0,2,0,3
38379,80,11592,16773;17028;19389,27010,1,0,2,0,3
38380,80,11593,16789;16988;19792,27010,1,0,2,0,3
38381,80,11594,16737;16809,27010,0,0,2,0,2
38382,80,11595,16567;16846,27010,0,0,2,0,2
38383,80,11596,16863;17045,27010,0,0,2,0,2
38384,80,11597,16901;17393;19490;19900,27010,2,0,2,0,4
38385,80,11598,16932;17064;19789,27010,1,0,2,0,3
38386,80,11599,16935,27010,0,0,1,0,1
38387,80,11600,16875;16937,27010,0,0,2,0,2
38388,80,11601,16953;17253;19218;19407,27010,1,1,2,0,4
38389,80,11602,16756;16954,27010,0,0,2,0,2
38390,80,11603,16959;17196;19366,27010,1,0,2,0,3
38391,80,11604,16854;16976,27010,0,0,2,0,2
38392,80,11605,16982;17006,27010,0,0,2,0,2
38393,80,11606,17031;17163;19781,27010,1,0,2,0,3
38394,80,11607,17044;17257;19398;19497,27010,2,0,2,0,4
38395,80,11608,17017;17061,27010,0,0,2,0,2
38396,80,11609,17114;17411,27010,0,0,2,0,2
38397,80,11610,17079;17132,27010,0,0,2,0,2
38398,80,11611,11898,27375,0,0,1,0,1
38399,80,11612,11608,27375,0,0,0,1,1
38400,80,11613,11760,27375,0,0,0,1,1
38401,80,11614,12168,27375,0,0,1,0,1
38402,80,11618,12397,27375,0,0,1,0,1
38403,80,11621,12640,27375,0,0,1,0,1
38404,80,11622,12714,27375,0,0,1,0,1
38405,80,11627,13355,27375,0,0,1,0,1
38406,80,11628,13169,27375,0,0,1,0,1
38407,80,11629,13679,27375,0,0,1,0,1
38408,80,11630,13366,27375,0,0,1,0,1
38409,80,11631,13170,27375,0,0,1,0,1
38410,80,11632,13835,27375,0,0,1,0,1
38411,80,11633,13612,27375,0,0,1,0,1
38412,80,11634,13908,27375,0,0,1,0,1
38413,80,11641,14455;14800,27375,0,0,2,0,2
38414,80,11642,14941;15420;19568,27375,1,0,2,0,3
38415,80,11643,14497;14781,27375,0,0,2,0,2
38416,80,11644,15020,27375,0,0,1,0,1
38417,80,11645,14758,27375,0,0,1,0,1
38418,80,11646,14648,27375,0,0,1,0,1
38419,80,11650,14804;15256,27375,0,0,2,0,2
38420,80,11652,15306,27375,0,0,1,0,1
38421,80,11653,15308,27375,0,0,1,0,1
38422,80,11656,15594,27375,0,0,1,0,1
38423,80,11657,15485;15596,27375,0,0,2,0,2
38424,80,11658,15617;15981,27375,0,0,2,0,2
38425,80,11659,15687,27375,0,0,1,0,1
38426,80,11660,15704,27375,0,0,1,0,1
38427,80,11661,15747;15845,27375,0,0,2,0,2
38428,80,11662,15907;16040,27375,0,0,2,0,2
38429,80,11663,15960;16396,27375,0,0,2,0,2
38430,80,11664,15962;16213;19863,27375,1,0,2,0,3
38431,80,11665,16745;16792,27375,0,0,2,0,2
38432,80,11666,16289;16354,27375,0,0,2,0,2
38433,80,11667,16215;16550,27375,0,0,2,0,2
38434,80,11668,16219,27375,0,0,1,0,1
38435,80,11670,16238,27375,0,0,1,0,1
38436,80,11671,16084;16326,27375,0,0,2,0,2
38437,80,11672,16341;16464,27375,0,0,2,0,2
38438,80,11673,16495,27375,0,0,1,0,1
38439,80,11674,15893;16416;19606;19773,27375,2,0,2,0,4
38440,80,11675,16153,27375,0,0,1,0,1
38441,80,11676,16423;16664,27375,0,0,2,0,2
38442,80,11677,16470;16577;19565,27375,1,0,2,0,3
38443,80,11678,16429;16613,27375,0,0,2,0,2
38444,80,11679,16500;16623,27375,0,0,2,0,2
38445,80,11680,16629;16678,27375,0,0,2,0,2
38446,80,11681,16624;16702,27375,0,0,2,0,2
38447,80,11682,16706;17210,27375,0,0,2,0,2
38448,80,11683,16743,27375,0,0,1,0,1
38449,80,11684,16744;17297,27375,0,0,2,0,2
38450,80,11685,16769;16852,27375,0,0,2,0,2
38451,80,11686,16783;17480,27375,0,0,2,0,2
38452,80,11687,17239;19518,27375,1,0,1,0,2
38453,80,11688,16834;17076,27375,0,0,2,0,2
38454,80,11689,16844;17136,27375,0,0,2,0,2
38455,80,11690,16853;17312;19418;19488;19632,27375,3,0,2,0,5
38456,80,11691,16797,27375,0,0,1,0,1
38457,80,11692,16864;17160,27375,0,0,2,0,2
38458,80,11693,16874;17286,27375,0,0,2,0,2
38459,80,11694,16886;16972,27375,0,0,2,0,2
38460,80,11695,16894;17021,27375,0,0,2,0,2
38461,80,11696,16711;16933,27375,0,0,2,0,2
38462,80,11697,16934;17194;19753,27375,1,0,2,0,3
38463,80,11698,16938;16949,27375,0,0,2,0,2
38464,80,11699,16710;16945,27375,0,0,2,0,2
38465,80,11700,16960;17353;19360;19874,27375,2,0,2,0,4
38466,80,11701,16827;16965,27375,0,0,2,0,2
38467,80,11702,16526;16997,27375,0,0,2,0,2
38468,80,11703,17005;17057,27375,0,0,2,0,2
38469,80,11704,17015;17108,27375,0,0,2,0,2
38470,80,11705,16871;17039;19493;19721,27375,2,0,2,0,4
38471,80,11706,16837;17065;19409,27375,1,0,2,0,3
38472,80,11707,17035;17070,27375,0,0,2,0,2
38473,80,11708,16740;17080,27375,0,0,2,0,2
38474,80,11709,17089;17328;19862,27375,1,0,2,0,3
38475,80,11710,17090;17488;19380,27375,1,0,2,0,3
38476,80,11711,17151;17201,27375,0,0,2,0,2
38477,80,11712,17131;17156,27375,0,0,2,0,2
38478,80,11713,16727;17118;19482;19623,27375,2,0,2,0,4
38479,80,11714,17195;17562;19707,27375,1,0,2,0,3
38480,80,11715,17206;17357;19625,27375,1,0,2,0,3
38481,80,11716,16473;17223,27375,0,0,2,0,2
38482,80,11717,17088;17241,27375,0,0,2,0,2
38483,80,11718,16995;17262,27375,0,0,2,0,2
38484,80,11719,12042,27740,0,0,1,0,1
38485,80,11720,11930;12045,27740,0,0,2,0,2
38486,80,11721,12213,27740,0,0,1,0,1
38487,80,11722,12161,27740,0,0,1,0,1
38488,80,11723,12120,27740,0,0,1,0,1
38489,80,11725,11645,27740,0,0,0,1,1
38490,80,11726,12608;12655,27740,0,0,2,0,2
38491,80,11727,12619,27740,0,0,1,0,1
38492,80,11728,12450,27740,0,0,1,0,1
38493,80,11731,12915,27740,0,0,1,0,1
38494,80,11733,12936,27740,0,0,1,0,1
38495,80,11734,13235,27740,0,0,1,0,1
38496,80,11735,13285,27740,0,0,1,0,1
38497,80,11736,13404,27740,0,0,1,0,1
38498,80,11738,13671,27740,0,0,1,0,1
38499,80,11740,13658,27740,0,0,1,0,1
38500,80,11741,13162,27740,0,0,1,0,1
38501,80,11742,13700,27740,0,0,1,0,1
38502,80,11744,13051,27740,0,0,1,0,1
38503,80,11745,14284,27740,0,0,1,0,1
38504,80,11746,13708,27740,0,0,1,0,1
38505,80,11747,14306,27740,0,0,1,0,1
38506,80,11748,13685;14322,27740,0,0,2,0,2
38507,80,11750,14711;15089,27740,0,0,2,0,2
38508,80,11753,14991,27740,0,0,1,0,1
38509,80,11754,15178,27740,0,0,1,0,1
38510,80,11755,14979;15590,27740,0,0,2,0,2
38511,80,11757,15660,27740,0,0,1,0,1
38512,80,11758,15775;19867,27740,1,0,1,0,2
38513,80,11759,15840,27740,0,0,1,0,1
38514,80,11760,15857,27740,0,0,1,0,1
38515,80,11762,16468;16759,27740,0,0,2,0,2
38516,80,11764,16430,27740,0,0,1,0,1
38517,80,11765,16438,27740,0,0,1,0,1
38518,80,11766,16291;16534;19613,27740,1,0,2,0,3
38519,80,11767,16668;16973,27740,0,0,2,0,2
38520,80,11768,16676;16892,27740,0,0,2,0,2
38521,80,11769,16687;17012,27740,0,0,2,0,2
38522,80,11770,16742;16802,27740,0,0,2,0,2
38523,80,11771,16266;16589;19845,27740,1,0,2,0,3
38524,80,11772,16460;16778,27740,0,0,2,0,2
38525,80,11773,16130;16282;19745,27740,1,0,2,0,3
38526,80,11774,16807;17437,27740,0,0,2,0,2
38527,80,11775,16810;17243;19693;19807,27740,2,0,2,0,4
38528,80,11776,17187;19525,27740,1,0,1,0,2
38529,80,11777,16893,27740,0,0,1,0,1
38530,80,11778,16582,27740,0,0,1,0,1
38531,80,11780,16592;16885,27740,0,0,2,0,2
38532,80,11781,16902;17315,27740,0,0,2,0,2
38533,80,11782,17188;17394;19627,27740,1,0,2,0,3
38534,80,11783,16946,27740,0,0,1,0,1
38535,80,11784,16980;16985,27740,0,0,2,0,2
38536,80,11785,16998;17191;19893,27740,1,0,2,0,3
38537,80,11786,17010;17092;19902,27740,1,0,2,0,3
38538,80,11787,16817;17023,27740,0,0,2,0,2
38539,80,11788,17040;17059;19735,27740,1,0,2,0,3
38540,80,11789,17048,27740,0,0,1,0,1
38541,80,11790,17099;17410;19912,27740,1,0,2,0,3
38542,80,11791,17104;17687;19501,27740,1,0,2,0,3
38543,80,11792,17121;17504,27740,0,0,2,0,2
38544,80,11793,17125,27740,0,0,1,0,1
38545,80,11794,17142;17235;19600,27740,1,0,2,0,3
38546,80,11795,16701;17152,27740,0,0,2,0,2
38547,80,11796,17164;19475;19743,27740,2,0,1,0,3
38548,80,11797,17093;17175,27740,0,0,2,0,2
38549,80,11798,17181;17507,27740,0,0,2,0,2
38550,80,11799,17203,27740,0,0,1,0,1
38551,80,11800,17209;17445,27740,0,0,2,0,2
38552,80,11801,17220;17302,27740,0,0,2,0,2
38553,80,11802,17182;17252,27740,0,0,2,0,2
38554,80,11803,17255;17644;19519;19873,27740,2,0,2,0,4
38555,80,11804,17256;17278,27740,0,0,2,0,2
38556,80,11805,17289;17377;19569;19687,27740,2,0,2,0,4
38557,80,11806,17295;17371;19554,27740,1,0,2,0,3
38558,80,11807,17236;17310;19524;19785,27740,2,0,2,0,4
38559,80,11808,17285;17325;19574,27740,1,0,2,0,3
38560,80,11809,17333;17482;19540,27740,1,0,2,0,3
38561,80,11810,17335;17403;19888,27740,1,0,2,0,3
38562,80,11811,12090,28105,0,0,1,0,1
38563,80,11812,12116,28105,0,0,1,0,1
38564,80,11813,11939,28105,0,0,1,0,1
38565,80,11814,12250;12339,28105,0,0,2,0,2
38566,80,11815,12340;12345,28105,0,0,2,0,2
38567,80,11816,12094,28105,0,0,1,0,1
38568,80,11817,12566,28105,0,0,1,0,1
38569,80,11819,12272;12620,28105,0,0,2,0,2
38570,80,11820,12624,28105,0,0,1,0,1
38571,80,11822,12684,28105,0,0,1,0,1
38572,80,11823,12852,28105,0,0,1,0,1
38573,80,11824,12942,28105,0,0,1,0,1
38574,80,11825,13001,28105,0,0,1,0,1
38575,80,11826,13116,28105,0,0,1,0,1
38576,80,11827,13148,28105,0,0,1,0,1
38577,80,11828,12421,28105,0,0,1,0,1
38578,80,11829,12449,28105,0,0,1,0,1
38579,80,11833,13080,28105,0,0,1,0,1
38580,80,11834,13634,28105,0,0,1,0,1
38581,80,11835,13759,28105,0,0,1,0,1
38582,80,11836,13763,28105,0,0,1,0,1
38583,80,11837,13794,28105,0,0,1,0,1
38584,80,11838,13906,28105,0,0,1,0,1
38585,80,11839,13916,28105,0,0,1,0,1
38586,80,11840,13724,28105,0,0,1,0,1
38587,80,11841,13892;14377,28105,0,0,2,0,2
38588,80,11842,14030,28105,0,0,1,0,1
38589,80,11843,13670;13785,28105,0,0,2,0,2
38590,80,11844,14391;14696,28105,0,0,2,0,2
38591,80,11845,13992;14402,28105,0,0,2,0,2
38592,80,11846,14435,28105,0,0,1,0,1
38593,80,11847,14264,28105,0,0,1,0,1
38594,80,11848,14106;14641,28105,0,0,2,0,2
38595,80,11849,14249;14768,28105,0,0,2,0,2
38596,80,11850,14545,28105,0,0,1,0,1
38597,80,11852,15216;15305,28105,0,0,2,0,2
38598,80,11853,14657,28105,0,0,1,0,1
38599,80,11854,15205;15787,28105,0,0,2,0,2
38600,80,11856,15445,28105,0,0,1,0,1
38601,80,11858,15493;19670,28105,1,0,1,0,2
38602,80,11860,15567,28105,0,0,1,0,1
38603,80,11861,15399,28105,0,0,1,0,1
38604,80,11863,15535,28105,0,0,1,0,1
38605,80,11864,15805,28105,0,0,1,0,1
38606,80,11865,16391,28105,0,0,1,0,1
38607,80,11866,16052;16574,28105,0,0,2,0,2
38608,80,11867,16094,28105,0,0,1,0,1
38609,80,11869,16212,28105,0,0,1,0,1
38610,80,11870,16260;16615;19747,28105,1,0,2,0,3
38611,80,11871,16357,28105,0,0,1,0,1
38612,80,11872,16082;16290;19708,28105,1,0,2,0,3
38613,80,11873,16394;16760;19751,28105,1,0,2,0,3
38614,80,11874,16166;16408,28105,0,0,2,0,2
38615,80,11875,16410,28105,0,0,1,0,1
38616,80,11876,16459;17139,28105,0,0,2,0,2
38617,80,11877,16544;16633;19682,28105,1,0,2,0,3
38618,80,11878,16441;16491,28105,0,0,2,0,2
38619,80,11879,16502;16547;19882,28105,1,0,2,0,3
38620,80,11880,16018;16520,28105,0,0,2,0,2
38621,80,11881,16521,28105,0,0,1,0,1
38622,80,11882,16436;16527,28105,0,0,2,0,2
38623,80,11883,16451;16529,28105,0,0,2,0,2
38624,80,11884,16449;16587;19833,28105,1,0,2,0,3
38625,80,11885,16090;16590;19598;19796,28105,2,0,2,0,4
38626,80,11886,16591,28105,0,0,1,0,1
38627,80,11887,16401;16598,28105,0,0,2,0,2
38628,80,11888,16607;16910,28105,0,0,2,0,2
38629,80,11889,16632;16983,28105,0,0,2,0,2
38630,80,11890,16655;16975;19731,28105,1,0,2,0,3
38631,80,11891,16141,28105,0,0,1,0,1
38632,80,11892,16389,28105,0,0,1,0,1
38633,80,11893,16882,28105,0,0,1,0,1
38634,80,11894,16862;17282,28105,0,0,2,0,2
38635,80,11895,16887;16939;19612,28105,1,0,2,0,3
38636,80,11896,16890,28105,0,0,1,0,1
38637,80,11897,16922;17329,28105,0,0,2,0,2
38638,80,11898,16929;17067,28105,0,0,2,0,2
38639,80,11899,17000;17216;19851,28105,1,0,2,0,3
38640,80,11900,17054;17468,28105,0,0,2,0,2
38641,80,11901,16923;17073,28105,0,0,2,0,2
38642,80,11902,17097;17384,28105,0,0,2,0,2
38643,80,11903,17111;17440,28105,0,0,2,0,2
38644,80,11904,17124;17270,28105,0,0,2,0,2
38645,80,11905,16872,28105,0,0,1,0,1
38646,80,11906,17147;17298;19799,28105,1,0,2,0,3
38647,80,11907,17453;19594,28105,1,0,1,0,2
38648,80,11908,17205;17254;19683,28105,1,0,2,0,3
38649,80,11909,17259;17301;19786,28105,1,0,2,0,3
38650,80,11910,16829,28105,0,0,1,0,1
38651,80,11911,17277;17683;19608,28105,1,0,2,0,3
38652,80,11912,17034;17284;19878,28105,1,0,2,0,3
38653,80,11913,17290;17336,28105,0,0,2,0,2
38654,80,11914,17308;17566;19604;19725,28105,2,0,2,0,4
38655,80,11915,17007;17338,28105,0,0,2,0,2
38656,80,11916,17342,28105,0,0,1,0,1
38657,80,11917,17348;17399,28105,0,0,2,0,2
38658,80,11918,17354;17606;19578,28105,1,0,2,0,3
38659,80,11919,17359;17545;19883,28105,1,0,2,0,3
38660,80,11920,17367,28105,0,0,1,0,1
38661,80,11921,17692;19583;19801,28105,2,0,1,0,3
38662,80,11922,17407;17549,28105,0,0,2,0,2
38663,80,11923,17439;17486,28105,0,0,2,0,2
38664,80,11924,17456;17525;19596,28105,1,0,2,0,3
38665,80,11925,12461,28470,0,0,1,0,1
38666,80,11927,11396,28470,0,0,0,1,1
38667,80,11928,11660,28470,0,0,0,1,1
38668,80,11929,12256,28470,0,0,1,0,1
38669,80,11930,12448,28470,0,0,1,0,1
38670,80,11931,12436,28470,0,0,1,0,1
38671,80,11932,12546;13180,28470,0,0,2,0,2
38672,80,11933,12591,28470,0,0,1,0,1
38673,80,11934,12783,28470,0,0,1,0,1
38674,80,11935,12308;12357,28470,0,0,2,0,2
38675,80,11936,12921,28470,0,0,1,0,1
38676,80,11937,12831,28470,0,0,1,0,1
38677,80,11938,12958,28470,0,0,1,0,1
38678,80,11939,12992,28470,0,0,1,0,1
38679,80,11940,13098,28470,0,0,1,0,1
38680,80,11941,12777,28470,0,0,1,0,1
38681,80,11942,13385,28470,0,0,1,0,1
38682,80,11948,14185,28470,0,0,1,0,1
38683,80,11949,13729,28470,0,0,1,0,1
38684,80,11950,14294;15084,28470,0,0,2,0,2
38685,80,11951,14356,28470,0,0,1,0,1
38686,80,11952,14230,28470,0,0,1,0,1
38687,80,11953,14286,28470,0,0,1,0,1
38688,80,11954,14477;14631,28470,0,0,2,0,2
38689,80,11955,14511,28470,0,0,1,0,1
38690,80,11956,14518,28470,0,0,1,0,1
38691,80,11957,14329,28470,0,0,1,0,1
38692,80,11958,14613,28470,0,0,1,0,1
38693,80,11959,14636;15038,28470,0,0,2,0,2
38694,80,11960,14312,28470,0,0,1,0,1
38695,80,11962,14747,28470,0,0,1,0,1
38696,80,11964,14787,28470,0,0,1,0,1
38697,80,11965,14539,28470,0,0,1,0,1
38698,80,11966,14775,28470,0,0,1,0,1
38699,80,11967,14533,28470,0,0,1,0,1
38700,80,11968,14940,28470,0,0,1,0,1
38701,80,11969,15179,28470,0,0,1,0,1
38702,80,11970,15680,28470,0,0,1,0,1
38703,80,11971,15323;15725,28470,0,0,2,0,2
38704,80,11972,15099,28470,0,0,1,0,1
38705,80,11973,15083;15314,28470,0,0,2,0,2
38706,80,11974,15430,28470,0,0,1,0,1
38707,80,11975,15456,28470,0,0,1,0,1
38708,80,11976,15459,28470,0,0,1,0,1
38709,80,11978,15264;15933;19719,28470,1,0,2,0,3
38710,80,11979,15553,28470,0,0,1,0,1
38711,80,11980,15506,28470,0,0,1,0,1
38712,80,11981,15572,28470,0,0,1,0,1
38713,80,11982,15243;15246,28470,0,0,2,0,2
38714,80,11983,15486,28470,0,0,1,0,1
38715,80,11984,15762,28470,0,0,1,0,1
38716,80,11985,15288;15800,28470,0,0,2,0,2
38717,80,11986,15849;15998,28470,0,0,2,0,2
38718,80,11987,14769;15224,28470,0,0,2,0,2
38719,80,11988,15601,28470,0,0,1,0,1
38720,80,11989,16060;16239;19869,28470,1,0,2,0,3
38721,80,11990,16049,28470,0,0,1,0,1
38722,80,11992,15944;16395,28470,0,0,2,0,2
38723,80,11993,16331;16335,28470,0,0,2,0,2
38724,80,11994,15899,28470,0,0,1,0,1
38725,80,11995,16230,28470,0,0,1,0,1
38726,80,11996,16175,28470,0,0,1,0,1
38727,80,11997,16323;16583,28470,0,0,2,0,2
38728,80,11998,16647;16920;19818,28470,1,0,2,0,3
38729,80,11999,16717;16914,28470,0,0,2,0,2
38730,80,12000,17311,28470,0,0,1,0,1
38731,80,12001,16731;16780,28470,0,0,2,0,2
38732,80,12002,16812,28470,0,0,1,0,1
38733,80,12003,17115,28470,0,0,1,0,1
38734,80,12004,16838;17046,28470,0,0,2,0,2
38735,80,12005,16839;17527,28470,0,0,2,0,2
38736,80,12006,16849,28470,0,0,1,0,1
38737,80,12007,16969;17400,28470,0,0,2,0,2
38738,80,12008,16987;17645;19761,28470,1,0,2,0,3
38739,80,12009,17330,28470,0,0,1,0,1
38740,80,12010,17018,28470,0,0,1,0,1
38741,80,12011,16685;17050,28470,0,0,2,0,2
38742,80,12012,17091;17405,28470,0,0,2,0,2
38743,80,12013,17049;17096,28470,0,0,2,0,2
38744,80,12014,16635,28470,0,0,1,0,1
38745,80,12015,17107;17211,28470,0,0,2,0,2
38746,80,12016,17161;17552,28470,0,0,2,0,2
38747,80,12017,17179;17275;19739,28470,1,0,2,0,3
38748,80,12018,17184;17706;19858,28470,1,0,2,0,3
38749,80,12019,17189;17704;19895,28470,1,0,2,0,3
38750,80,12020,17199;17684;19722,28470,1,0,2,0,3
38751,80,12021,17207;17401;19704,28470,1,0,2,0,3
38752,80,12022,17208;17528,28470,0,0,2,0,2
38753,80,12023,16859;17233;19826,28470,1,0,2,0,3
38754,80,12024,17273;17538,28470,0,0,2,0,2
38755,80,12025,17036;17276,28470,0,0,2,0,2
38756,80,12026,17268;17304,28470,0,0,2,0,2
38757,80,12027,17313,28470,0,0,1,0,1
38758,80,12028,17316;17646,28470,0,0,2,0,2
38759,80,12029,17322;17729;19737,28470,1,0,2,0,3
38760,80,12030,17192;17323,28470,0,0,2,0,2
38761,80,12031,17165;17364;19701,28470,1,0,2,0,3
38762,80,12032,17337;17406;19866,28470,1,0,2,0,3
38763,80,12033,17037;17419,28470,0,0,2,0,2
38764,80,12034,17319;17433;19876,28470,1,0,2,0,3
38765,80,12035,17016;17436;19815,28470,1,0,2,0,3
38766,80,12036,17162;17455,28470,0,0,2,0,2
38767,80,12037,17467;17471;19824,28470,1,0,2,0,3
38768,80,12038,17193;17472,28470,0,0,2,0,2
38769,80,12039,17476;17565,28470,0,0,2,0,2
38770,80,12040,17484,28470,0,0,1,0,1
38771,80,12041,17489;17630,28470,0,0,2,0,2
38772,80,12042,17494;17580,28470,0,0,2,0,2
38773,80,12043,17521,28470,0,0,1,0,1
38774,80,12044,17551;17874;19705,28470,1,0,2,0,3
38775,80,12045,17837;19689,28470,1,0,1,0,2
38776,80,12046,17570,28470,0,0,1,0,1
38777,80,12048,12140,28835,0,0,1,0,1
38778,80,12049,12084,28835,0,0,1,0,1
38779,80,12050,12467,28835,0,0,1,0,1
38780,80,12051,12506,28835,0,0,1,0,1
38781,80,12052,12224,28835,0,0,1,0,1
38782,80,12054,12648,28835,0,0,1,0,1
38783,80,12055,12806,28835,0,0,1,0,1
38784,80,12056,12837,28835,0,0,1,0,1
38785,80,12057,12503,28835,0,0,1,0,1
38786,80,12058,13005,28835,0,0,1,0,1
38787,80,12059,13106,28835,0,0,1,0,1
38788,80,12060,13347,28835,0,0,1,0,1
38789,80,12061,13247,28835,0,0,1,0,1
38790,80,12062,13308;13684,28835,0,0,2,0,2
38791,80,12064,13410,28835,0,0,1,0,1
38792,80,12065,13512,28835,0,0,1,0,1
38793,80,12066,13435,28835,0,0,1,0,1
38794,80,12067,13401,28835,0,0,1,0,1
38795,80,12068,13050,28835,0,0,1,0,1
38796,80,12069,13880,28835,0,0,1,0,1
38797,80,12070,14050,28835,0,0,1,0,1
38798,80,12071,13466,28835,0,0,1,0,1
38799,80,12072,13596,28835,0,0,1,0,1
38800,80,12073,14382,28835,0,0,1,0,1
38801,80,12074,13984,28835,0,0,1,0,1
38802,80,12075,14362,28835,0,0,1,0,1
38803,80,12076,14560,28835,0,0,1,0,1
38804,80,12077,14596,28835,0,0,1,0,1
38805,80,12078,14304,28835,0,0,1,0,1
38806,80,12079,14626,28835,0,0,1,0,1
38807,80,12080,14672,28835,0,0,1,0,1
38808,80,12083,15076,28835,0,0,1,0,1
38809,80,12084,15062,28835,0,0,1,0,1
38810,80,12086,15079;15137,28835,0,0,2,0,2
38811,80,12088,15242,28835,0,0,1,0,1
38812,80,12089,14893,28835,0,0,1,0,1
38813,80,12090,14959,28835,0,0,1,0,1
38814,80,12091,15369,28835,0,0,1,0,1
38815,80,12092,15374,28835,0,0,1,0,1
38816,80,12093,15375;15387,28835,0,0,2,0,2
38817,80,12095,14960,28835,0,0,1,0,1
38818,80,12096,15537,28835,0,0,1,0,1
38819,80,12097,15561,28835,0,0,1,0,1
38820,80,12099,15809,28835,0,0,1,0,1
38821,80,12100,15848,28835,0,0,1,0,1
38822,80,12101,16001,28835,0,0,1,0,1
38823,80,12103,16039,28835,0,0,1,0,1
38824,80,12104,16061,28835,0,0,1,0,1
38825,80,12105,15250,28835,0,0,1,0,1
38826,80,12106,16075;16271;19842,28835,1,0,2,0,3
38827,80,12107,16079;16858,28835,0,0,2,0,2
38828,80,12108,16146,28835,0,0,1,0,1
38829,80,12109,16270,28835,0,0,1,0,1
38830,80,12110,16277,28835,0,0,1,0,1
38831,80,12111,16367;16861,28835,0,0,2,0,2
38832,80,12112,16374;16680,28835,0,0,2,0,2
38833,80,12113,16378,28835,0,0,1,0,1
38834,80,12115,16752,28835,0,0,1,0,1
38835,80,12116,16767;17351,28835,0,0,2,0,2
38836,80,12117,16815,28835,0,0,1,0,1
38837,80,12118,16850;17305,28835,0,0,2,0,2
38838,80,12119,16855,28835,0,0,1,0,1
38839,80,12120,16898,28835,0,0,1,0,1
38840,80,12121,16640,28835,0,0,1,0,1
38841,80,12122,16950;17186,28835,0,0,2,0,2
38842,80,12123,16952;17204,28835,0,0,2,0,2
38843,80,12124,16966;17228,28835,0,0,2,0,2
38844,80,12125,16496,28835,0,0,1,0,1
38845,80,12126,17213;17240,28835,0,0,2,0,2
38846,80,12127,16799,28835,0,0,1,0,1
38847,80,12128,16880;17269,28835,0,0,2,0,2
38848,80,12129,17318;17341,28835,0,0,2,0,2
38849,80,12130,17369;17556,28835,0,0,2,0,2
38850,80,12131,17368;17385,28835,0,0,2,0,2
38851,80,12132,17390;17539,28835,0,0,2,0,2
38852,80,12133,16996;17435,28835,0,0,2,0,2
38853,80,12134,17438;17701;19811,28835,1,0,2,0,3
38854,80,12135,17395;17443,28835,0,0,2,0,2
38855,80,12136,17485;17868,28835,0,0,2,0,2
38856,80,12137,17110;17497,28835,0,0,2,0,2
38857,80,12138,17517;17613,28835,0,0,2,0,2
38858,80,12139,17544;17750,28835,0,0,2,0,2
38859,80,12140,17520;17547,28835,0,0,2,0,2
38860,80,12141,17548;17779,28835,0,0,2,0,2
38861,80,12142,17557,28835,0,0,1,0,1
38862,80,12143,17559;17585,28835,0,0,2,0,2
38863,80,12144,17126;17567,28835,0,0,2,0,2
38864,80,12145,17579;17982,28835,0,0,2,0,2
38865,80,12146,17597;17682,28835,0,0,2,0,2
38866,80,12147,17607;17944;19838,28835,1,0,2,0,3
38867,80,12148,17622,28835,0,0,1,0,1
38868,80,12149,17626,28835,0,0,1,0,1
38869,80,12150,17263;17639,28835,0,0,2,0,2
38870,80,12151,17642;17847;19891,28835,1,0,2,0,3
38871,80,12152,17648;17777,28835,0,0,2,0,2
38872,80,12153,17272;17651,28835,0,0,2,0,2
38873,80,12154,17553;17652;19915,28835,1,0,2,0,3
38874,80,12155,17657;17947,28835,0,0,2,0,2
38875,80,12156,17505;17675,28835,0,0,2,0,2
38876,80,12157,16993;17681;19835,28835,1,0,2,0,3
38877,80,12158,12651;12908,29200,0,0,2,0,2
38878,80,12159,12686,29200,0,0,1,0,1
38879,80,12160,12165,29200,0,0,1,0,1
38880,80,12161,12748,29200,0,0,1,0,1
38881,80,12162,12273,29200,0,0,1,0,1
38882,80,12163,13078,29200,0,0,1,0,1
38883,80,12164,12601,29200,0,0,1,0,1
38884,80,12165,13239,29200,0,0,1,0,1
38885,80,12166,13246,29200,0,0,1,0,1
38886,80,12167,13248,29200,0,0,1,0,1
38887,80,12168,13330,29200,0,0,1,0,1
38888,80,12169,13518,29200,0,0,1,0,1
38889,80,12170,13576,29200,0,0,1,0,1
38890,80,12171,13781,29200,0,0,1,0,1
38891,80,12172,13764,29200,0,0,1,0,1
38892,80,12173,14251,29200,0,0,1,0,1
38893,80,12174,14083,29200,0,0,1,0,1
38894,80,12175,13682,29200,0,0,1,0,1
38895,80,12176,14240,29200,0,0,1,0,1
38896,80,12177,14114,29200,0,0,1,0,1
38897,80,12178,14490;14745,29200,0,0,2,0,2
38898,80,12179,14515,29200,0,0,1,0,1
38899,80,12181,14534,29200,0,0,1,0,1
38900,80,12182,14633,29200,0,0,1,0,1
38901,80,12183,14664,29200,0,0,1,0,1
38902,80,12184,14736,29200,0,0,1,0,1
38903,80,12185,14783,29200,0,0,1,0,1
38904,80,12186,14461,29200,0,0,1,0,1
38905,80,12187,14689,29200,0,0,1,0,1
38906,80,12188,15030,29200,0,0,1,0,1
38907,80,12189,15048,29200,0,0,1,0,1
38908,80,12190,15199,29200,0,0,1,0,1
38909,80,12191,15051,29200,0,0,1,0,1
38910,80,12192,15031,29200,0,0,1,0,1
38911,80,12193,15226,29200,0,0,1,0,1
38912,80,12194,15263,29200,0,0,1,0,1
38913,80,12195,15271;15777,29200,0,0,2,0,2
38914,80,12196,14898;15370,29200,0,0,2,0,2
38915,80,12197,15341;15683,29200,0,0,2,0,2
38916,80,12198,15638,29200,0,0,1,0,1
38917,80,12199,14928,29200,0,0,1,0,1
38918,80,12200,15526;15555,29200,0,0,2,0,2
38919,80,12201,15597,29200,0,0,1,0,1
38920,80,12202,14904,29200,0,0,1,0,1
38921,80,12203,15659,29200,0,0,1,0,1
38922,80,12204,15487,29200,0,0,1,0,1
38923,80,12205,15724,29200,0,0,1,0,1
38924,80,12206,15765,29200,0,0,1,0,1
38925,80,12207,15957;16566,29200,0,0,2,0,2
38926,80,12208,15716,29200,0,0,1,0,1
38927,80,12209,16046;16328,29200,0,0,2,0,2
38928,80,12210,15476,29200,0,0,1,0,1
38929,80,12211,16081,29200,0,0,1,0,1
38930,80,12212,16100;16217,29200,0,0,2,0,2
38931,80,12213,15875,29200,0,0,1,0,1
38932,80,12214,16066,29200,0,0,1,0,1
38933,80,12215,16224,29200,0,0,1,0,1
38934,80,12216,16383,29200,0,0,1,0,1
38935,80,12217,16453,29200,0,0,1,0,1
38936,80,12218,16411,29200,0,0,1,0,1
38937,80,12219,16524;16958,29200,0,0,2,0,2
38938,80,12220,16316;16595,29200,0,0,2,0,2
38939,80,12221,16667,29200,0,0,1,0,1
38940,80,12222,16713;17071,29200,0,0,2,0,2
38941,80,12223,16723;16970,29200,0,0,2,0,2
38942,80,12224,16133,29200,0,0,1,0,1
38943,80,12225,16259;16750,29200,0,0,2,0,2
38944,80,12226,16757;17143,29200,0,0,2,0,2
38945,80,12227,16786;17398,29200,0,0,2,0,2
38946,80,12228,16515;16801,29200,0,0,2,0,2
38947,80,12229,16832,29200,0,0,1,0,1
38948,80,12230,16895;17011,29200,0,0,2,0,2
38949,80,12231,16977;17469,29200,0,0,2,0,2
38950,80,12232,17008,29200,0,0,1,0,1
38951,80,12233,17009;17446,29200,0,0,2,0,2
38952,80,12234,17056;17173,29200,0,0,2,0,2
38953,80,12235,16961;17078,29200,0,0,2,0,2
38954,80,12236,17105;17697,29200,0,0,2,0,2
38955,80,12237,16994;17157,29200,0,0,2,0,2
38956,80,12238,17167;17224,29200,0,0,2,0,2
38957,80,12239,17225,29200,0,0,1,0,1
38958,80,12240,17234;17535,29200,0,0,2,0,2
38959,80,12241,17267;17442,29200,0,0,2,0,2
38960,80,12242,17283;17428,29200,0,0,2,0,2
38961,80,12243,17293;17447,29200,0,0,2,0,2
38962,80,12244,17294,29200,0,0,1,0,1
38963,80,12245,17296,29200,0,0,1,0,1
38964,80,12246,16764,29200,0,0,1,0,1
38965,80,12247,17370;17851,29200,0,0,2,0,2
38966,80,12248,16974;17430,29200,0,0,2,0,2
38967,80,12249,17232;17444,29200,0,0,2,0,2
38968,80,12250,17479;17717,29200,0,0,2,0,2
38969,80,12251,17501,29200,0,0,1,0,1
38970,80,12252,17515;17534,29200,0,0,2,0,2
38971,80,12253,17577;17741,29200,0,0,2,0,2
38972,80,12254,17586;17808,29200,0,0,2,0,2
38973,80,12255,17462;17588,29200,0,0,2,0,2
38974,80,12256,17574;17596,29200,0,0,2,0,2
38975,80,12257,17632;17972,29200,0,0,2,0,2
38976,80,12258,17532;17635,29200,0,0,2,0,2
38977,80,12259,17650;18084,29200,0,1,1,0,2
38978,80,12260,17387,29200,0,0,1,0,1
38979,80,12261,17715;17767,29200,0,0,2,0,2
38980,80,12262,17460;17739,29200,0,0,2,0,2
38981,90,4,4056,0,0,0,0,1,1
38982,90,28,90,0,0,0,0,1,1
38983,90,36,9316,0,0,0,0,1,1
38984,90,227,1307,0,0,0,0,1,1
38985,90,297,7780,0,0,0,0,1,1
38986,90,393,10077,0,0,0,0,1,1
38987,90,478,1260,0,0,0,0,1,1
38988,90,509,1345,0,0,0,0,1,1
38989,90,522,10019,0,0,0,0,1,1
38990,90,556,1461;10343,0,0,0,0,2,2
38991,90,598,1577,0,0,0,0,1,1
38992,90,886,2321,0,0,0,0,1,1
38993,90,991,12508,0,0,0,0,1,1
38994,90,1168,10804;11050;11210;11214;11426,0,0,0,0,5,5
38995,90,1191,8721,0,0,0,0,1,1
38996,90,1258,3901,0,0,0,0,1,1
38997,90,1285,6955,0,0,0,0,1,1
38998,90,1375,10685,0,0,0,0,1,1
38999,90,1784,4669,0,0,0,0,1,1
39000,90,1915,5016,0,0,0,0,1,1
39001,90,2005,5249,0,0,0,0,1,1
39002,90,2317,10315,0,0,0,0,1,1
39003,90,2399,11519;11804,0,0,0,0,2,2
39004,90,2418,11158,0,0,0,0,1,1
39005,90,2638,11894;12333,0,0,0,0,2,2
39006,90,2643,10565,0,0,0,0,1,1
39007,90,2648,6849,0,0,0,0,1,1
39008,90,2867,7395,0,0,0,0,1,1
39009,90,2919,9666,0,0,0,0,1,1
39010,90,2925,2855,0,0,0,0,1,1
39011,90,3022,10115,0,0,0,0,1,1
39012,90,3081,10013,0,0,0,0,1,1
39013,90,3132,8076,0,0,0,0,1,1
39014,90,3435,3256,0,0,0,0,1,1
39015,90,3646,10820,0,0,0,0,1,1
39016,90,3771,5433,0,0,0,0,1,1
39017,90,3817,10983;11082,0,0,0,0,2,2
39018,90,4004,11904;15631,365,0,0,1,1,2
39019,90,4067,12752,730,0,0,0,1,1
39020,90,4145,11617;11623,730,0,0,0,2,2
39021,90,4287,12083,1095,0,0,0,1,1
39022,90,4757,12159;12349;15793,2555,0,0,1,2,3
39023,90,4770,12991,2920,0,0,0,1,1
39024,90,4772,12137,2920,0,0,0,1,1
39025,90,4977,7525,3650,0,0,0,1,1
39026,90,4998,14651;14730,3650,0,0,2,0,2
39027,90,5049,3,3650,0,0,0,1,1
39028,90,5052,9637,3650,0,0,0,1,1
39029,90,5060,189,4015,0,0,0,1,1
39030,90,5074,6531,4015,0,0,0,1,1
39031,90,5117,1751,4015,0,0,0,1,1
39032,90,5127,7739,4015,0,0,0,1,1
39033,90,5149,11429,4015,0,0,0,1,1
39034,90,5173,1313,4380,0,0,0,1,1
39035,90,5253,12548;13063,4380,0,0,0,2,2
39036,90,5286,7142,4745,0,0,0,1,1
39037,90,5337,7276,4745,0,0,0,1,1
39038,90,5345,8520,4745,0,0,0,1,1
39039,90,5358,294,4745,0,0,0,1,1
39040,90,5363,12127;12880;12883;13414;13696;18406,5110,0,0,3,3,6
39041,90,5393,4070,5110,0,0,0,1,1
39042,90,5429,13298;13665,5110,0,0,2,0,2
39043,90,5436,2963,5475,0,0,0,1,1
39044,90,5443,9783,5475,0,0,0,1,1
39045,90,5460,11441;11823;13229,5475,0,0,0,3,3
39046,90,5462,2146,5475,0,0,0,1,1
39047,90,5471,3359,5475,0,0,0,1,1
39048,90,5478,6117,5475,0,0,0,1,1
39049,90,5490,5526,5475,0,0,0,1,1
39050,90,5508,4074,5475,0,0,0,1,1
39051,90,5527,8785,5475,0,0,0,1,1
39052,90,5543,8703,5840,0,0,0,1,1
39053,90,5564,163,5840,0,0,0,1,1
39054,90,5583,10073,5840,0,0,0,1,1
39055,90,5584,4634,5840,0,0,0,1,1
39056,90,5600,6809,5840,0,0,0,1,1
39057,90,5607,2085,5840,0,0,0,1,1
39058,90,5609,5860,5840,0,0,0,1,1
39059,90,5611,7193,5840,0,0,0,1,1
39060,90,5632,2063,6205,0,0,0,1,1
39061,90,5635,7555,6205,0,0,0,1,1
39062,90,5639,6363,6205,0,0,0,1,1
39063,90,5641,10204,6205,0,0,0,1,1
39064,90,5642,1428,6205,0,0,0,1,1
39065,90,5643,1700;4845,6205,0,0,0,2,2
39066,90,5651,10055,6205,0,0,0,1,1
39067,90,5657,3601,6205,0,0,0,1,1
39068,90,5665,10201,6205,0,0,0,1,1
39069,90,5674,10180,6205,0,0,0,1,1
39070,90,5676,2234,6205,0,0,0,1,1
39071,90,5680,4833,6205,0,0,0,1,1
39072,90,5685,5297,6205,0,0,0,1,1
39073,90,5699,5228,6205,0,0,0,1,1
39074,90,5717,4959,6205,0,0,0,1,1
39075,90,5720,2142,6205,0,0,0,1,1
39076,90,5724,14274;14445;18392,6205,0,0,3,0,3
39077,90,5729,9728,6570,0,0,0,1,1
39078,90,5732,10118,6570,0,0,0,1,1
39079,90,5734,14712,6570,0,0,1,0,1
39080,90,5739,10042,6570,0,0,0,1,1
39081,90,5751,10080,6570,0,0,0,1,1
39082,90,5776,6003;10167,6570,0,0,0,2,2
39083,90,5802,8051,6570,0,0,0,1,1
39084,90,5815,4704,6570,0,0,0,1,1
39085,90,5833,10048,6935,0,0,0,1,1
39086,90,5836,10223,6935,0,0,0,1,1
39087,90,5839,10145,6935,0,0,0,1,1
39088,90,5843,3375,6935,0,0,0,1,1
39089,90,5854,5301,6935,0,0,0,1,1
39090,90,5860,10017,6935,0,0,0,1,1
39091,90,5863,10158,6935,0,0,0,1,1
39092,90,5865,960,6935,0,0,0,1,1
39093,90,5867,7310,6935,0,0,0,1,1
39094,90,5871,10132,6935,0,0,0,1,1
39095,90,5873,169,6935,0,0,0,1,1
39096,90,5906,10206,6935,0,0,0,1,1
39097,90,5909,3820,6935,0,0,0,1,1
39098,90,5912,10056,6935,0,0,0,1,1
39099,90,5915,10108,6935,0,0,0,1,1
39100,90,5916,15304,6935,0,0,1,0,1
39101,90,5918,10183,7300,0,0,0,1,1
39102,90,5927,1452,7300,0,0,0,1,1
39103,90,5928,3337,7300,0,0,0,1,1
39104,90,5950,4851,7300,0,0,0,1,1
39105,90,5959,1682,7300,0,0,0,1,1
39106,90,5964,4677,7300,0,0,0,1,1
39107,90,5971,5436,7300,0,0,0,1,1
39108,90,5980,9749,7300,0,0,0,1,1
39109,90,5983,10320,7300,0,0,0,1,1
39110,90,5985,10519,7300,0,0,0,1,1
39111,90,5987,10142,7300,0,0,0,1,1
39112,90,5993,10160,7665,0,0,0,1,1
39113,90,5995,1623,7665,0,0,0,1,1
39114,90,6003,10217,7665,0,0,0,1,1
39115,90,6008,10280,7665,0,0,0,1,1
39116,90,6009,10306,7665,0,0,0,1,1
39117,90,6012,3591,7665,0,0,0,1,1
39118,90,6013,9227,7665,0,0,0,1,1
39119,90,6029,8698,7665,0,0,0,1,1
39120,90,6064,10141,7665,0,0,0,1,1
39121,90,6070,10254;10583,7665,0,0,0,2,2
39122,90,6071,10261;10440,7665,0,0,0,2,2
39123,90,6072,10483,7665,0,0,0,1,1
39124,90,6075,10505,7665,0,0,0,1,1
39125,90,6076,10197,7665,0,0,0,1,1
39126,90,6077,10298,7665,0,0,0,1,1
39127,90,6078,10307,7665,0,0,0,1,1
39128,90,6087,3246,8030,0,0,0,1,1
39129,90,6104,10557,8030,0,0,0,1,1
39130,90,6110,10003,8030,0,0,0,1,1
39131,90,6112,6309,8030,0,0,0,1,1
39132,90,6115,10093,8030,0,0,0,1,1
39133,90,6126,10545,8030,0,0,0,1,1
39134,90,6128,10053,8030,0,0,0,1,1
39135,90,6129,10246,8030,0,0,0,1,1
39136,90,6130,10302,8030,0,0,0,1,1
39137,90,6131,10119,8030,0,0,0,1,1
39138,90,6141,10679,8030,0,0,0,1,1
39139,90,6142,10653,8030,0,0,0,1,1
39140,90,6143,10278;10582,8030,0,0,0,2,2
39141,90,6144,10281,8030,0,0,0,1,1
39142,90,6145,10714,8030,0,0,0,1,1
39143,90,6146,10126,8030,0,0,0,1,1
39144,90,6148,10113,8030,0,0,0,1,1
39145,90,6149,15338,8030,0,0,1,0,1
39146,90,6150,10390,8030,0,0,0,1,1
39147,90,6151,10383,8030,0,0,0,1,1
39148,90,6154,10203,8030,0,0,0,1,1
39149,90,6159,10644,8395,0,0,0,1,1
39150,90,6160,1231,8395,0,0,0,1,1
39151,90,6167,5738,8395,0,0,0,1,1
39152,90,6171,3366,8395,0,0,0,1,1
39153,90,6182,10150,8395,0,0,0,1,1
39154,90,6206,10091;10314,8395,0,0,0,2,2
39155,90,6210,10258,8395,0,0,0,1,1
39156,90,6212,10272;10506,8395,0,0,0,2,2
39157,90,6216,10350,8395,0,0,0,1,1
39158,90,6218,10604,8395,0,0,0,1,1
39159,90,6220,10656,8395,0,0,0,1,1
39160,90,6221,10879,8395,0,0,0,1,1
39161,90,6223,10333;10455,8395,0,0,0,2,2
39162,90,6224,10291,8395,0,0,0,1,1
39163,90,6239,5459,8760,0,0,0,1,1
39164,90,6244,3055,8760,0,0,0,1,1
39165,90,6249,5047,8760,0,0,0,1,1
39166,90,6258,6159,8760,0,0,0,1,1
39167,90,6263,3735,8760,0,0,0,1,1
39168,90,6269,1360,8760,0,0,0,1,1
39169,90,6281,10422,8760,0,0,0,1,1
39170,90,6283,10587,8760,0,0,0,1,1
39171,90,6285,10096;10474,8760,0,0,0,2,2
39172,90,6286,10331;10374;15023,8760,0,0,1,2,3
39173,90,6288,10627,8760,0,0,0,1,1
39174,90,6290,10720,8760,0,0,0,1,1
39175,90,6291,10117,8760,0,0,0,1,1
39176,90,6293,3318;9764,8760,0,0,0,2,2
39177,90,6294,10522,8760,0,0,0,1,1
39178,90,6296,10299,8760,0,0,0,1,1
39179,90,6297,10338,8760,0,0,0,1,1
39180,90,6299,10341,8760,0,0,0,1,1
39181,90,6300,10052,8760,0,0,0,1,1
39182,90,6302,10241,8760,0,0,0,1,1
39183,90,6303,10377,8760,0,0,0,1,1
39184,90,6304,10408;10650,8760,0,0,0,2,2
39185,90,6305,10625,8760,0,0,0,1,1
39186,90,6306,10907,8760,0,0,0,1,1
39187,90,6307,10710,8760,0,0,0,1,1
39188,90,6312,10682;10694,8760,0,0,0,2,2
39189,90,6313,10336,8760,0,0,0,1,1
39190,90,6314,10572,8760,0,0,0,1,1
39191,90,6316,10602,8760,0,0,0,1,1
39192,90,6339,89;3118,9125,0,0,0,2,2
39193,90,6366,10586;10702,9125,0,0,0,2,2
39194,90,6369,10866,9125,0,0,0,1,1
39195,90,6371,10310,9125,0,0,0,1,1
39196,90,6373,10499;10717,9125,0,0,0,2,2
39197,90,6374,10300;10319,9125,0,0,0,2,2
39198,90,6376,10510,9125,0,0,0,1,1
39199,90,6377,10379,9125,0,0,0,1,1
39200,90,6378,10236,9125,0,0,0,1,1
39201,90,6379,10282,9125,0,0,0,1,1
39202,90,6380,10131;10356,9125,0,0,0,2,2
39203,90,6381,10873,9125,0,0,0,1,1
39204,90,6386,10360,9125,0,0,0,1,1
39205,90,6389,10511,9125,0,0,0,1,1
39206,90,6393,10466,9125,0,0,0,1,1
39207,90,6394,10690;10816,9125,0,0,0,2,2
39208,90,6395,10961,9125,0,0,0,1,1
39209,90,6396,10257,9125,0,0,0,1,1
39210,90,6397,10770,9125,0,0,0,1,1
39211,90,6398,10509,9125,0,0,0,1,1
39212,90,6399,10952,9125,0,0,0,1,1
39213,90,6401,10526,9125,0,0,0,1,1
39214,90,6402,10527,9125,0,0,0,1,1
39215,90,6405,10568,9125,0,0,0,1,1
39216,90,6406,10172,9125,0,0,0,1,1
39217,90,6409,10821,9125,0,0,0,1,1
39218,90,6410,10234,9125,0,0,0,1,1
39219,90,6411,10621,9125,0,0,0,1,1
39220,90,6413,10919,9125,0,0,0,1,1
39221,90,6414,10507,9125,0,0,0,1,1
39222,90,6415,10795,9125,0,0,0,1,1
39223,90,6416,10881,9125,0,0,0,1,1
39224,90,6417,10680;10743,9125,0,0,0,2,2
39225,90,6418,10681;10984,9125,0,0,0,2,2
39226,90,6419,10622;10730,9125,0,0,0,2,2
39227,90,6420,11011,9125,0,0,0,1,1
39228,90,6421,10727,9125,0,0,0,1,1
39229,90,6429,2396,9490,0,0,0,1,1
39230,90,6431,3058,9490,0,0,0,1,1
39231,90,6432,7197,9490,0,0,0,1,1
39232,90,6470,10496,9490,0,0,0,1,1
39233,90,6471,10607,9490,0,0,0,1,1
39234,90,6473,10502,9490,0,0,0,1,1
39235,90,6476,10590;10635,9490,0,0,0,2,2
39236,90,6477,10838,9490,0,0,0,1,1
39237,90,6479,10484,9490,0,0,0,1,1
39238,90,6480,10967,9490,0,0,0,1,1
39239,90,6481,11093,9490,0,0,0,1,1
39240,90,6482,10182,9490,0,0,0,1,1
39241,90,6483,10610,9490,0,0,0,1,1
39242,90,6485,10898,9490,0,0,0,1,1
39243,90,6486,10274;10944,9490,0,0,0,2,2
39244,90,6488,10673,9490,0,0,0,1,1
39245,90,6489,10642,9490,0,0,0,1,1
39246,90,6490,10692,9490,0,0,0,1,1
39247,90,6493,10737;10869,9490,0,0,0,2,2
39248,90,6494,10973;11202,9490,0,0,0,2,2
39249,90,6496,10456,9490,0,0,0,1,1
39250,90,6497,11077,9490,0,0,0,1,1
39251,90,6499,11113,9490,0,0,0,1,1
39252,90,6500,11175,9490,0,0,0,1,1
39253,90,6501,10913;11015,9490,0,0,0,2,2
39254,90,6502,11117,9490,0,0,0,1,1
39255,90,6511,3561,9855,0,0,0,1,1
39256,90,6532,10010,9855,0,0,0,1,1
39257,90,6535,10111,9855,0,0,0,1,1
39258,90,6541,10491,9855,0,0,0,1,1
39259,90,6553,10447,9855,0,0,0,1,1
39260,90,6554,2370,9855,0,0,0,1,1
39261,90,6556,10928;11115,9855,0,0,0,2,2
39262,90,6557,10247,9855,0,0,0,1,1
39263,90,6561,10159,9855,0,0,0,1,1
39264,90,6562,10451;10842,9855,0,0,0,2,2
39265,90,6564,10601,9855,0,0,0,1,1
39266,90,6566,1663;10624,9855,0,0,0,2,2
39267,90,6567,10699,9855,0,0,0,1,1
39268,90,6568,10825,9855,0,0,0,1,1
39269,90,6569,10742;11110,9855,0,0,0,2,2
39270,90,6570,10639,9855,0,0,0,1,1
39271,90,6572,11260;11263,9855,0,0,0,2,2
39272,90,6573,10809,9855,0,0,0,1,1
39273,90,6575,10834;11085,9855,0,0,0,2,2
39274,90,6577,10998,9855,0,0,0,1,1
39275,90,6578,15547,9855,0,0,1,0,1
39276,90,6579,10863,9855,0,0,0,1,1
39277,90,6580,10765,9855,0,0,0,1,1
39278,90,6581,11318,9855,0,0,0,1,1
39279,90,6582,10571;10703,9855,0,0,0,2,2
39280,90,6583,10927,9855,0,0,0,1,1
39281,90,6584,10805,9855,0,0,0,1,1
39282,90,6585,10940;11044,9855,0,0,0,2,2
39283,90,6586,11216,9855,0,0,0,1,1
39284,90,6588,10971;11252,9855,0,0,0,2,2
39285,90,6589,10975,9855,0,0,0,1,1
39286,90,6590,10988,9855,0,0,0,1,1
39287,90,6599,6336,10220,0,0,0,1,1
39288,90,6624,8840,10220,0,0,0,1,1
39289,90,6628,2729;10326,10220,0,0,0,2,2
39290,90,6634,10011,10220,0,0,0,1,1
39291,90,6636,10185,10220,0,0,0,1,1
39292,90,6637,11057,10220,0,0,0,1,1
39293,90,6639,13534,10220,0,0,1,0,1
39294,90,6647,10520,10220,0,0,0,1,1
39295,90,6650,10756,10220,0,0,0,1,1
39296,90,6652,10636,10220,0,0,0,1,1
39297,90,6656,10732;10912,10220,0,0,0,2,2
39298,90,6657,10766;10937,10220,0,0,0,2,2
39299,90,6658,10779,10220,0,0,0,1,1
39300,90,6659,10794,10220,0,0,0,1,1
39301,90,6660,10562,10220,0,0,0,1,1
39302,90,6662,10807,10220,0,0,0,1,1
39303,90,6663,10446;10810,10220,0,0,0,2,2
39304,90,6664,10876;10920,10220,0,0,0,2,2
39305,90,6665,10995;11410,10220,0,0,0,2,2
39306,90,6666,10942,10220,0,0,0,1,1
39307,90,6667,11062,10220,0,0,0,1,1
39308,90,6668,10405;10991,10220,0,0,0,2,2
39309,90,6669,11041,10220,0,0,0,1,1
39310,90,6670,11013,10220,0,0,0,1,1
39311,90,6673,11035;11122,10220,0,0,0,2,2
39312,90,6674,11058,10220,0,0,0,1,1
39313,90,6675,11073,10220,0,0,0,1,1
39314,90,6676,11081;11192,10220,0,0,0,2,2
39315,90,6677,10977;11253,10220,0,0,0,2,2
39316,90,6681,10041,10585,0,0,0,1,1
39317,90,6699,10139,10585,0,0,0,1,1
39318,90,6710,8057,10585,0,0,0,1,1
39319,90,6717,10443,10585,0,0,0,1,1
39320,90,6718,10177,10585,0,0,0,1,1
39321,90,6719,10225,10585,0,0,0,1,1
39322,90,6720,10317,10585,0,0,0,1,1
39323,90,6721,10231,10585,0,0,0,1,1
39324,90,6724,10316,10585,0,0,0,1,1
39325,90,6726,10402,10585,0,0,0,1,1
39326,90,6727,10504,10585,0,0,0,1,1
39327,90,6728,10410,10585,0,0,0,1,1
39328,90,6730,10152,10585,0,0,0,1,1
39329,90,6731,10462,10585,0,0,0,1,1
39330,90,6732,10068,10585,0,0,0,1,1
39331,90,6733,10354,10585,0,0,0,1,1
39332,90,6734,10515;10829,10585,0,0,0,2,2
39333,90,6735,10716,10585,0,0,0,1,1
39334,90,6736,10870,10585,0,0,0,1,1
39335,90,6737,10731;10828,10585,0,0,0,2,2
39336,90,6738,11191,10585,0,0,0,1,1
39337,90,6739,10733,10585,0,0,0,1,1
39338,90,6742,10888,10585,0,0,0,1,1
39339,90,6743,10530,10585,0,0,0,1,1
39340,90,6744,10917,10585,0,0,0,1,1
39341,90,6745,10970,10585,0,0,0,1,1
39342,90,6746,10985,10585,0,0,0,1,1
39343,90,6748,10762,10585,0,0,0,1,1
39344,90,6749,10931;11039,10585,0,0,0,2,2
39345,90,6750,11237,10585,0,0,0,1,1
39346,90,6751,11070,10585,0,0,0,1,1
39347,90,6752,10827;11141;15348,10585,0,0,1,2,3
39348,90,6753,11146,10585,0,0,0,1,1
39349,90,6754,11471;11497,10585,0,0,0,2,2
39350,90,6755,11055;11152,10585,0,0,0,2,2
39351,90,6756,11164;11411,10585,0,0,0,2,2
39352,90,6757,10901;11185,10585,0,0,0,2,2
39353,90,6758,11121;11206,10585,0,0,0,2,2
39354,90,6759,11156,10585,0,0,0,1,1
39355,90,6770,14352,10950,0,0,1,0,1
39356,90,6811,10429;10503,10950,0,0,0,2,2
39357,90,6812,10525;10904,10950,0,0,0,2,2
39358,90,6816,10597;11069,10950,0,0,0,2,2
39359,90,6817,10464,10950,0,0,0,1,1
39360,90,6819,10945;11061,10950,0,0,0,2,2
39361,90,6820,10712,10950,0,0,0,1,1
39362,90,6822,11276;11466,10950,0,0,0,2,2
39363,90,6825,10823,10950,0,0,0,1,1
39364,90,6827,10839,10950,0,0,0,1,1
39365,90,6828,11108,10950,0,0,0,1,1
39366,90,6830,11484,10950,0,0,0,1,1
39367,90,6831,11269,10950,0,0,0,1,1
39368,90,6833,11074,10950,0,0,0,1,1
39369,90,6835,11127,10950,0,0,0,1,1
39370,90,6837,11019;11047,10950,0,0,0,2,2
39371,90,6838,10662;11023,10950,0,0,0,2,2
39372,90,6839,10921;11135,10950,0,0,0,2,2
39373,90,6840,11059,10950,0,0,0,1,1
39374,90,6841,11566,10950,0,0,0,1,1
39375,90,6842,11083,10950,0,0,0,1,1
39376,90,6843,11100;11404,10950,0,0,0,2,2
39377,90,6844,11103,10950,0,0,0,1,1
39378,90,6845,11476,10950,0,0,0,1,1
39379,90,6846,11339,10950,0,0,0,1,1
39380,90,6848,11230;11328,10950,0,0,0,2,2
39381,90,6849,11265;11526,10950,0,0,0,2,2
39382,90,6850,11413,10950,0,0,0,1,1
39383,90,6851,11344;11798,10950,0,0,0,2,2
39384,90,6852,11266,10950,0,0,0,1,1
39385,90,6853,11196,10950,0,0,0,1,1
39386,90,6855,11377,10950,0,0,0,1,1
39387,90,6856,11228;11543,10950,0,0,0,2,2
39388,90,6857,11243,10950,0,0,0,1,1
39389,90,6858,11184,10950,0,0,0,1,1
39390,90,6859,11527,10950,0,0,0,1,1
39391,90,6860,11394;11401,10950,0,0,0,2,2
39392,90,6861,11233,10950,0,0,0,1,1
39393,90,6864,11025,10950,0,0,0,1,1
39394,90,6865,11277;11442,10950,0,0,0,2,2
39395,90,6866,11444,10950,0,0,0,1,1
39396,90,6867,11378,10950,0,0,0,1,1
39397,90,6868,11450,10950,0,0,0,1,1
39398,90,6869,11315,10950,0,0,0,1,1
39399,90,6895,10085,11315,0,0,0,1,1
39400,90,6909,10651,11315,0,0,0,1,1
39401,90,6913,10205,11315,0,0,0,1,1
39402,90,6916,10882,11315,0,0,0,1,1
39403,90,6917,10708;10824,11315,0,0,0,2,2
39404,90,6918,15489;19290;20078,11315,0,2,1,0,3
39405,90,6919,10235;10472,11315,0,0,0,2,2
39406,90,6920,10649,11315,0,0,0,1,1
39407,90,6921,10701,11315,0,0,0,1,1
39408,90,6922,11143,11315,0,0,0,1,1
39409,90,6924,10555,11315,0,0,0,1,1
39410,90,6927,10774;10918,11315,0,0,0,2,2
39411,90,6928,11003,11315,0,0,0,1,1
39412,90,6929,10857,11315,0,0,0,1,1
39413,90,6931,10811,11315,0,0,0,1,1
39414,90,6934,10981,11315,0,0,0,1,1
39415,90,6935,10855,11315,0,0,0,1,1
39416,90,6936,10963;11031,11315,0,0,0,2,2
39417,90,6938,10775,11315,0,0,0,1,1
39418,90,6940,11203;11295,11315,0,0,0,2,2
39419,90,6941,11049,11315,0,0,0,1,1
39420,90,6943,11053,11315,0,0,0,1,1
39421,90,6944,11086,11315,0,0,0,1,1
39422,90,6945,11098,11315,0,0,0,1,1
39423,90,6948,11026,11315,0,0,0,1,1
39424,90,6949,11224,11315,0,0,0,1,1
39425,90,6950,11582;11702,11315,0,0,0,2,2
39426,90,6952,10771;11236,11315,0,0,0,2,2
39427,90,6953,11167,11315,0,0,0,1,1
39428,90,6954,11181,11315,0,0,0,1,1
39429,90,6955,11040,11315,0,0,0,1,1
39430,90,6956,11207;11538,11315,0,0,0,2,2
39431,90,6960,10954;11268,11315,0,0,0,2,2
39432,90,6963,11125;11459,11315,0,0,0,2,2
39433,90,6964,11336,11315,0,0,0,1,1
39434,90,6965,11626;11697,11315,0,0,0,2,2
39435,90,6966,11174;11289,11315,0,0,0,2,2
39436,90,6968,11719;11749,11315,0,0,0,2,2
39437,90,6969,11359,11315,0,0,0,1,1
39438,90,6971,11195;11382,11315,0,0,0,2,2
39439,90,6972,11700,11315,0,0,0,1,1
39440,90,6973,11407;11432,11315,0,0,0,2,2
39441,90,6975,10026;10156,11680,0,0,0,2,2
39442,90,6993,1671,11680,0,0,0,1,1
39443,90,7008,10524,11680,0,0,0,1,1
39444,90,7009,10674;10750,11680,0,0,0,2,2
39445,90,7011,11180;11227,11680,0,0,0,2,2
39446,90,7014,10103,11680,0,0,0,1,1
39447,90,7016,10929,11680,0,0,0,1,1
39448,90,7017,10609,11680,0,0,0,1,1
39449,90,7018,11162,11680,0,0,0,1,1
39450,90,7020,10899,11680,0,0,0,1,1
39451,90,7021,10705;14504,11680,0,0,1,1,2
39452,90,7022,10646;10707,11680,0,0,0,2,2
39453,90,7023,10780,11680,0,0,0,1,1
39454,90,7025,11133;11248,11680,0,0,0,2,2
39455,90,7026,11140;11375,11680,0,0,0,2,2
39456,90,7027,11089,11680,0,0,0,1,1
39457,90,7028,11323,11680,0,0,0,1,1
39458,90,7030,11109;11172,11680,0,0,0,2,2
39459,90,7031,11575,11680,0,0,0,1,1
39460,90,7032,11415,11680,0,0,0,1,1
39461,90,7035,11229,11680,0,0,0,1,1
39462,90,7036,11807;11970,11680,0,0,0,2,2
39463,90,7037,11209;16063,11680,0,0,1,1,2
39464,90,7038,11242;11361,11680,0,0,0,2,2
39465,90,7039,11306;11615,11680,0,0,0,2,2
39466,90,7040,11657,11680,0,0,0,1,1
39467,90,7041,11348;11673,11680,0,0,0,2,2
39468,90,7042,10864;11370,11680,0,0,0,2,2
39469,90,7043,11704,11680,0,0,0,1,1
39470,90,7044,11387,11680,0,0,0,1,1
39471,90,7045,11421;11455,11680,0,0,0,2,2
39472,90,7046,11240;11468,11680,0,0,0,2,2
39473,90,7047,11489;11756,11680,0,0,0,2,2
39474,90,7048,11707,11680,0,0,0,1,1
39475,90,7049,11509;11740,11680,0,0,0,2,2
39476,90,7050,11650,11680,0,0,0,1,1
39477,90,7055,803,12045,0,0,0,1,1
39478,90,7097,10214,12045,0,0,0,1,1
39479,90,7099,10181,12045,0,0,0,1,1
39480,90,7100,10579,12045,0,0,0,1,1
39481,90,7102,10444,12045,0,0,0,1,1
39482,90,7103,10067,12045,0,0,0,1,1
39483,90,7104,10637,12045,0,0,0,1,1
39484,90,7107,10628,12045,0,0,0,1,1
39485,90,7108,10632;10905,12045,0,0,0,2,2
39486,90,7109,10222;10831,12045,0,0,0,2,2
39487,90,7110,10836,12045,0,0,0,1,1
39488,90,7111,11452,12045,0,0,0,1,1
39489,90,7115,11288,12045,0,0,0,1,1
39490,90,7116,11522,12045,0,0,0,1,1
39491,90,7117,11478,12045,0,0,0,1,1
39492,90,7119,11189,12045,0,0,0,1,1
39493,90,7120,11200;15197,12045,0,0,1,1,2
39494,90,7122,11743,12045,0,0,0,1,1
39495,90,7123,10802;11255,12045,0,0,0,2,2
39496,90,7124,11259,12045,0,0,0,1,1
39497,90,7125,11274;12125,12045,0,0,0,2,2
39498,90,7126,11280,12045,0,0,0,1,1
39499,90,7127,11338,12045,0,0,0,1,1
39500,90,7128,11317;14725,12045,0,0,1,1,2
39501,90,7129,11322,12045,0,0,0,1,1
39502,90,7130,11703,12045,0,0,0,1,1
39503,90,7131,11834,12045,0,0,0,1,1
39504,90,7132,11096;11393,12045,0,0,0,2,2
39505,90,7133,11065;11400,12045,0,0,0,2,2
39506,90,7134,11680;11821,12045,0,0,0,2,2
39507,90,7135,11221,12045,0,0,0,1,1
39508,90,7136,11464;11633,12045,0,0,0,2,2
39509,90,7138,11499,12045,0,0,0,1,1
39510,90,7139,11067;11523,12045,0,0,0,2,2
39511,90,7140,11112;11534,12045,0,0,0,2,2
39512,90,7141,11533;11786,12045,0,0,0,2,2
39513,90,7142,11583;11594,12045,0,0,0,2,2
39514,90,7146,11601,12045,0,0,0,1,1
39515,90,7176,7373,12410,0,0,0,1,1
39516,90,7192,11030,12410,0,0,0,1,1
39517,90,7193,10259,12410,0,0,0,1,1
39518,90,7196,14193;14808;17531;18765,12410,0,0,4,0,4
39519,90,7199,10334;10972,12410,0,0,0,2,2
39520,90,7202,11029,12410,0,0,0,1,1
39521,90,7205,10974,12410,0,0,0,1,1
39522,90,7207,11312,12410,0,0,0,1,1
39523,90,7208,10778,12410,0,0,0,1,1
39524,90,7209,10573;11022,12410,0,0,0,2,2
39525,90,7212,10822,12410,0,0,0,1,1
39526,90,7213,10850,12410,0,0,0,1,1
39527,90,7215,11002,12410,0,0,0,1,1
39528,90,7216,11291;11524,12410,0,0,0,2,2
39529,90,7217,11012;11488,12410,0,0,0,2,2
39530,90,7218,10969,12410,0,0,0,1,1
39531,90,7221,11349,12410,0,0,0,1,1
39532,90,7222,11360;11687,12410,0,0,0,2,2
39533,90,7223,11457,12410,0,0,0,1,1
39534,90,7225,11218;11342,12410,0,0,0,2,2
39535,90,7226,11270;11512;15286,12410,0,0,1,2,3
39536,90,7227,11267;11273,12410,0,0,0,2,2
39537,90,7228,11008;11279,12410,0,0,0,2,2
39538,90,7229,11298;11416,12410,0,0,0,2,2
39539,90,7230,11331,12410,0,0,0,1,1
39540,90,7231,11574,12410,0,0,0,1,1
39541,90,7232,11106;11341,12410,0,0,0,2,2
39542,90,7233,11358,12410,0,0,0,1,1
39543,90,7234,10957;11371,12410,0,0,0,2,2
39544,90,7235,11386;11420,12410,0,0,0,2,2
39545,90,7236,11235,12410,0,0,0,1,1
39546,90,7237,11438;12053,12410,0,0,0,2,2
39547,90,7240,11518;11780,12410,0,0,0,2,2
39548,90,7241,11537;11541,12410,0,0,0,2,2
39549,90,7242,11757;11782,12410,0,0,0,2,2
39550,90,7243,11553;11584,12410,0,0,0,2,2
39551,90,7245,11529;11567,12410,0,0,0,2,2
39552,90,7246,11577;11795,12410,0,0,0,2,2
39553,90,7247,11578,12410,0,0,0,1,1
39554,90,7249,11618,12410,0,0,0,1,1
39555,90,7251,11628,12410,0,0,0,1,1
39556,90,7252,11982,12410,0,0,0,1,1
39557,90,7253,11713,12410,0,0,0,1,1
39558,90,7254,11173;11722,12410,0,0,0,2,2
39559,90,7256,11663;11738,12410,0,0,0,2,2
39560,90,7257,11747;12098,12410,0,0,0,2,2
39561,90,7270,10501,12775,0,0,0,1,1
39562,90,7297,10400;10813,12775,0,0,0,2,2
39563,90,7298,10819;10989,12775,0,0,0,2,2
39564,90,7299,10938,12775,0,0,0,1,1
39565,90,7300,10848,12775,0,0,0,1,1
39566,90,7301,10698;10772,12775,0,0,0,2,2
39567,90,7304,10906;11095,12775,0,0,0,2,2
39568,90,7307,10844;11010,12775,0,0,0,2,2
39569,90,7308,11330;11479,12775,0,0,0,2,2
39570,90,7309,10512;10675,12775,0,0,0,2,2
39571,90,7310,10908,12775,0,0,0,1,1
39572,90,7311,11136;11462,12775,0,0,0,2,2
39573,90,7312,11153,12775,0,0,0,1,1
39574,90,7314,11283;11303,12775,0,0,0,2,2
39575,90,7315,11285;11458,12775,0,0,0,2,2
39576,90,7316,10987;11334,12775,0,0,0,2,2
39577,90,7317,11254;11340,12775,0,0,0,2,2
39578,90,7318,11494,12775,0,0,0,1,1
39579,90,7319,11731,12775,0,0,0,1,1
39580,90,7320,11978;12121,12775,0,0,0,2,2
39581,90,7321,11480,12775,0,0,0,1,1
39582,90,7322,11302;11495,12775,0,0,0,2,2
39583,90,7324,11742,12775,0,0,0,1,1
39584,90,7325,11056;11491;16696,12775,0,0,1,2,3
39585,90,7326,11530;11863,12775,0,0,0,2,2
39586,90,7327,11531,12775,0,0,0,1,1
39587,90,7329,12034,12775,0,0,0,1,1
39588,90,7330,11598;11616,12775,0,0,0,2,2
39589,90,7332,11653,12775,0,0,0,1,1
39590,90,7333,11674,12775,0,0,0,1,1
39591,90,7334,11699;11882,12775,0,0,0,2,2
39592,90,7336,11724,12775,0,0,0,1,1
39593,90,7337,11139;11151,12775,0,0,0,2,2
39594,90,7338,11759;12225,12775,0,0,0,2,2
39595,90,7339,11761,12775,0,0,0,1,1
39596,90,7340,11774,12775,0,0,0,1,1
39597,90,7341,11686;11790,12775,0,0,0,2,2
39598,90,7342,11805,12775,0,0,0,1,1
39599,90,7343,11417,12775,0,0,0,1,1
39600,90,7344,11837,12775,0,0,0,1,1
39601,90,7345,12228,12775,0,0,0,1,1
39602,90,7346,11640;11869,12775,0,0,0,2,2
39603,90,7376,10106;10363,13140,0,0,0,2,2
39604,90,7381,10413,13140,0,0,0,1,1
39605,90,7384,10543;10671,13140,0,0,0,2,2
39606,90,7386,10958,13140,0,0,0,1,1
39607,90,7389,10648;10875,13140,0,0,0,2,2
39608,90,7391,10933,13140,0,0,0,1,1
39609,90,7392,10925;11111,13140,0,0,0,2,2
39610,90,7394,11833,13140,0,0,0,1,1
39611,90,7396,11105;11551;15728,13140,0,0,1,2,3
39612,90,7397,10806;11107,13140,0,0,0,2,2
39613,90,7398,11046,13140,0,0,0,1,1
39614,90,7399,11326,13140,0,0,0,1,1
39615,90,7400,10891;11190,13140,0,0,0,2,2
39616,90,7401,11550;16184,13140,0,0,1,1,2
39617,90,7402,11677,13140,0,0,0,1,1
39618,90,7403,11486,13140,0,0,0,1,1
39619,90,7404,11436;11485,13140,0,0,0,2,2
39620,90,7406,11606,13140,0,0,0,1,1
39621,90,7407,11354,13140,0,0,0,1,1
39622,90,7408,11535,13140,0,0,0,1,1
39623,90,7409,11585;12096,13140,0,0,0,2,2
39624,90,7410,11614,13140,0,0,0,1,1
39625,90,7411,12246,13140,0,0,0,1,1
39626,90,7414,11984,13140,0,0,0,1,1
39627,90,7415,11542;12014;16051,13140,0,0,1,2,3
39628,90,7416,11602;11727,13140,0,0,0,2,2
39629,90,7417,11897,13140,0,0,0,1,1
39630,90,7420,11784;12371,13140,0,0,0,2,2
39631,90,7423,11822,13140,0,0,0,1,1
39632,90,7424,11734,13140,0,0,0,1,1
39633,90,7425,12101,13140,0,0,0,1,1
39634,90,7426,11847;12176,13140,0,0,0,2,2
39635,90,7427,12221,13140,0,0,0,1,1
39636,90,7428,12060,13140,0,0,0,1,1
39637,90,7429,11694;11889,13140,0,0,0,2,2
39638,90,7430,11817;11900;16398,13140,0,0,1,2,3
39639,90,7433,11851;11937,13140,0,0,0,2,2
39640,90,7434,11926,13140,0,0,0,1,1
39641,90,7435,11607;11932,13140,0,0,0,2,2
39642,90,7436,11901,13140,0,0,0,1,1
39643,90,7438,11971;12000,13140,0,0,0,2,2
39644,90,7481,10445;10498,13505,0,0,0,2,2
39645,90,7484,15390,13505,0,0,1,0,1
39646,90,7486,10939,13505,0,0,0,1,1
39647,90,7488,11064,13505,0,0,0,1,1
39648,90,7489,11477,13505,0,0,0,1,1
39649,90,7491,11126,13505,0,0,0,1,1
39650,90,7492,11138,13505,0,0,0,1,1
39651,90,7493,11332,13505,0,0,0,1,1
39652,90,7494,11142,13505,0,0,0,1,1
39653,90,7495,11439;11506,13505,0,0,0,2,2
39654,90,7497,11286,13505,0,0,0,1,1
39655,90,7498,10897,13505,0,0,0,1,1
39656,90,7499,10903;11528,13505,0,0,0,2,2
39657,90,7500,11357;12004,13505,0,0,0,2,2
39658,90,7501,11068;11408,13505,0,0,0,2,2
39659,90,7504,11246;11516,13505,0,0,0,2,2
39660,90,7505,11554;11979,13505,0,0,0,2,2
39661,90,7506,11581;16295,13505,0,0,1,1,2
39662,90,7507,11599;12181,13505,0,0,0,2,2
39663,90,7508,11397;11980,13505,0,0,0,2,2
39664,90,7509,11627,13505,0,0,0,1,1
39665,90,7510,11684,13505,0,0,0,1,1
39666,90,7511,11732,13505,0,0,0,1,1
39667,90,7512,12203,13505,0,0,0,1,1
39668,90,7513,11658;11672,13505,0,0,0,2,2
39669,90,7514,11427;11678,13505,0,0,0,2,2
39670,90,7515,11525;11766,13505,0,0,0,2,2
39671,90,7516,12657;13068,13505,0,0,0,2,2
39672,90,7518,12117;12219,13505,0,0,0,2,2
39673,90,7519,12342,13505,0,0,0,1,1
39674,90,7520,11880;11960,13505,0,0,0,2,2
39675,90,7521,12302,13505,0,0,0,1,1
39676,90,7522,12249,13505,0,0,0,1,1
39677,90,7523,11610;11896;17055,13505,0,0,1,2,3
39678,90,7524,12324,13505,0,0,0,1,1
39679,90,7525,11505;12167,13505,0,0,0,2,2
39680,90,7526,11927;12346,13505,0,0,0,2,2
39681,90,7527,12091;12403,13505,0,0,0,2,2
39682,90,7528,11955,13505,0,0,0,1,1
39683,90,7529,11961;11994,13505,0,0,0,2,2
39684,90,7530,11981,13505,0,0,0,1,1
39685,90,7531,11753;11987,13505,0,0,0,2,2
39686,90,7532,12376,13505,0,0,0,1,1
39687,90,7533,12204;12279,13505,0,0,0,2,2
39688,90,7534,11692;12065,13505,0,0,0,2,2
39689,90,7535,11925,13505,0,0,0,1,1
39690,90,7536,12392,13505,0,0,0,1,1
39691,90,7538,11996,13505,0,0,0,1,1
39692,90,7539,11769;12107,13505,0,0,0,2,2
39693,90,7540,12460,13505,0,0,0,1,1
39694,90,7541,12056;12529,13505,0,0,0,2,2
39695,90,7569,10399,13870,0,0,0,1,1
39696,90,7575,10841,13870,0,0,0,1,1
39697,90,7580,11021,13870,0,0,0,1,1
39698,90,7582,11118,13870,0,0,0,1,1
39699,90,7584,11250;11572,13870,0,0,0,2,2
39700,90,7586,11365,13870,0,0,0,1,1
39701,90,7587,11656,13870,0,0,0,1,1
39702,90,7588,11463;11720,13870,0,0,0,2,2
39703,90,7589,11579;11675,13870,0,0,0,2,2
39704,90,7590,11418;11639,13870,0,0,0,2,2
39705,90,7591,11128,13870,0,0,0,1,1
39706,90,7593,11510,13870,0,0,0,1,1
39707,90,7596,11733,13870,0,0,0,1,1
39708,90,7598,12434;17365,13870,0,0,1,1,2
39709,90,7599,11634;12062,13870,0,0,0,2,2
39710,90,7601,11748;12070,13870,0,0,0,2,2
39711,90,7602,11710;11933,13870,0,0,0,2,2
39712,90,7604,11345,13870,0,0,0,1,1
39713,90,7605,11789;12104,13870,0,0,0,2,2
39714,90,7607,11916,13870,0,0,0,1,1
39715,90,7608,11942;12092,13870,0,0,0,2,2
39716,90,7609,11924;11944,13870,0,0,0,2,2
39717,90,7610,11950,13870,0,0,0,1,1
39718,90,7611,12638;12639,13870,0,0,0,2,2
39719,90,7612,11962;12191,13870,0,0,0,2,2
39720,90,7613,11963,13870,0,0,0,1,1
39721,90,7614,12202;12267,13870,0,0,0,2,2
39722,90,7617,12413,13870,0,0,0,1,1
39723,90,7619,12026,13870,0,0,0,1,1
39724,90,7620,12265,13870,0,0,0,1,1
39725,90,7621,11320;12049,13870,0,0,0,2,2
39726,90,7622,12254,13870,0,0,0,1,1
39727,90,7623,12200;12329,13870,0,0,0,2,2
39728,90,7624,11865;12208,13870,0,0,0,2,2
39729,90,7625,12350,13870,0,0,0,1,1
39730,90,7626,12327;12580,13870,0,0,0,2,2
39731,90,7627,11953;12389,13870,0,0,0,2,2
39732,90,7628,12178,13870,0,0,0,1,1
39733,90,7629,12647,13870,0,0,0,1,1
39734,90,7630,12201;12207,13870,0,0,0,2,2
39735,90,7631,12210;12598,13870,0,0,0,2,2
39736,90,7632,12232,13870,0,0,0,1,1
39737,90,7633,12551,13870,0,0,0,1,1
39738,90,7634,12073;12454,13870,0,0,0,2,2
39739,90,7635,12130;12259,13870,0,0,0,2,2
39740,90,7646,2442,14235,0,0,0,1,1
39741,90,7671,11188,14235,0,0,0,1,1
39742,90,7672,11166;11296,14235,0,0,0,2,2
39743,90,7678,11042;11372,14235,0,0,0,2,2
39744,90,7680,11275;11500,14235,0,0,0,2,2
39745,90,7682,11325,14235,0,0,0,1,1
39746,90,7684,11691,14235,0,0,0,1,1
39747,90,7685,11521,14235,0,0,0,1,1
39748,90,7687,11472;11735,14235,0,0,0,2,2
39749,90,7688,11294,14235,0,0,0,1,1
39750,90,7689,11562;11636,14235,0,0,0,2,2
39751,90,7690,11568,14235,0,0,0,1,1
39752,90,7692,11647,14235,0,0,0,1,1
39753,90,7693,11919,14235,0,0,0,1,1
39754,90,7694,11576,14235,0,0,0,1,1
39755,90,7697,11272;11746,14235,0,0,0,2,2
39756,90,7699,11785;12366,14235,0,0,0,2,2
39757,90,7700,12407;12568,14235,0,0,0,2,2
39758,90,7701,11329;11850,14235,0,0,0,2,2
39759,90,7702,11556;11832,14235,0,0,0,2,2
39760,90,7703,11892;11983,14235,0,0,0,2,2
39761,90,7704,16786;17066;17309;17578;20542;20729;20748,14235,3,0,4,0,7
39762,90,7705,11751;11945,14235,0,0,0,2,2
39763,90,7706,11685;11952,14235,0,0,0,2,2
39764,90,7709,12298,14235,0,0,0,1,1
39765,90,7710,11659,14235,0,0,0,1,1
39766,90,7711,12111;12218,14235,0,0,0,2,2
39767,90,7712,11544,14235,0,0,0,1,1
39768,90,7713,12562,14235,0,0,0,1,1
39769,90,7714,11652;12059,14235,0,0,0,2,2
39770,90,7715,11976;12074,14235,0,0,0,2,2
39771,90,7716,11923;12075;16659,14235,0,0,1,2,3
39772,90,7717,12076;12592,14235,0,0,0,2,2
39773,90,7718,12087,14235,0,0,0,1,1
39774,90,7719,12229;12288,14235,0,0,0,2,2
39775,90,7720,12102;12124;16565,14235,0,0,1,2,3
39776,90,7721,12122,14235,0,0,0,1,1
39777,90,7722,12126,14235,0,0,0,1,1
39778,90,7723,12064;12143,14235,0,0,0,2,2
39779,90,7724,11899;12776,14235,0,0,0,2,2
39780,90,7725,16415;16475,14235,0,0,2,0,2
39781,90,7726,12728;17511,14235,0,0,1,1,2
39782,90,7727,12185;12603;17321,14235,0,0,1,2,3
39783,90,7728,12149;12199,14235,0,0,0,2,2
39784,90,7729,12697,14235,0,0,0,1,1
39785,90,7730,12673,14235,0,0,0,1,1
39786,90,7731,12239;12558;17600;19999,14235,0,1,1,2,4
39787,90,7732,12362,14235,0,0,0,1,1
39788,90,7735,11810;12336,14235,0,0,0,2,2
39789,90,7736,12173;12432,14235,0,0,0,2,2
39790,90,7737,12292;12374,14235,0,0,0,2,2
39791,90,7738,12729,14235,0,0,0,1,1
39792,90,7740,11858;12258,14235,0,0,0,2,2
39793,90,7772,10497,14600,0,0,0,1,1
39794,90,7773,11239,14600,0,0,0,1,1
39795,90,7776,10686,14600,0,0,0,1,1
39796,90,7778,10782,14600,0,0,0,1,1
39797,90,7781,10887,14600,0,0,0,1,1
39798,90,7785,11157,14600,0,0,0,1,1
39799,90,7786,11076,14600,0,0,0,1,1
39800,90,7788,11154,14600,0,0,0,1,1
39801,90,7789,11148,14600,0,0,0,1,1
39802,90,7790,10924;11131,14600,0,0,0,2,2
39803,90,7791,11213,14600,0,0,0,1,1
39804,90,7792,11220;11271,14600,0,0,0,2,2
39805,90,7793,11005;11278,14600,0,0,0,2,2
39806,90,7794,11781,14600,0,0,0,1,1
39807,90,7795,11353;11390;16924,14600,0,0,1,2,3
39808,90,7796,11304,14600,0,0,0,1,1
39809,90,7797,11580,14600,0,0,0,1,1
39810,90,7799,11532;11906,14600,0,0,0,2,2
39811,90,7800,11718;11951,14600,0,0,0,2,2
39812,90,7801,11557;11603,14600,0,0,0,2,2
39813,90,7802,11669,14600,0,0,0,1,1
39814,90,7804,11492;11768,14600,0,0,0,2,2
39815,90,7805,11549;11946,14600,0,0,0,2,2
39816,90,7806,11762,14600,0,0,0,1,1
39817,90,7807,12276;12481,14600,0,0,0,2,2
39818,90,7808,11423,14600,0,0,0,1,1
39819,90,7809,12420,14600,0,0,0,1,1
39820,90,7810,11846;12139,14600,0,0,0,2,2
39821,90,7811,11855;12401,14600,0,0,0,2,2
39822,90,7812,11791;11867,14600,0,0,0,2,2
39823,90,7813,11891,14600,0,0,0,1,1
39824,90,7814,11913;12323,14600,0,0,0,2,2
39825,90,7816,11991,14600,0,0,0,1,1
39826,90,7817,12008,14600,0,0,0,1,1
39827,90,7818,12023;12119,14600,0,0,0,2,2
39828,90,7820,12306,14600,0,0,0,1,1
39829,90,7821,12082;12347,14600,0,0,0,2,2
39830,90,7822,11835;12322,14600,0,0,0,2,2
39831,90,7823,11792;12106;17237,14600,0,0,1,2,3
39832,90,7824,12132;12572;16715,14600,0,0,1,2,3
39833,90,7825,11787,14600,0,0,0,1,1
39834,90,7826,12750,14600,0,0,0,1,1
39835,90,7827,11363;12177,14600,0,0,0,2,2
39836,90,7828,12186,14600,0,0,0,1,1
39837,90,7829,12190;12622,14600,0,0,0,2,2
39838,90,7830,12285,14600,0,0,0,1,1
39839,90,7831,12274;12331,14600,0,0,0,2,2
39840,90,7832,12172;12257,14600,0,0,0,2,2
39841,90,7833,12633;12775;16930,14600,0,0,1,2,3
39842,90,7834,12171;12294,14600,0,0,0,2,2
39843,90,7835,12311,14600,0,0,0,1,1
39844,90,7836,12367;17404,14600,0,0,1,1,2
39845,90,7837,12404,14600,0,0,0,1,1
39846,90,7838,11965;12332,14600,0,0,0,2,2
39847,90,7841,12706;12789,14600,0,0,0,2,2
39848,90,7842,12081;12359,14600,0,0,0,2,2
39849,90,7844,12280,14600,0,0,0,1,1
39850,90,7845,12390;12441,14600,0,0,0,2,2
39851,90,7846,11908;12290;15318,14600,0,0,1,2,3
39852,90,7847,12424;12594,14600,0,0,0,2,2
39853,90,7848,12303;12370,14600,0,0,0,2,2
39854,90,7849,12652,14600,0,0,0,1,1
39855,90,7879,10585,14965,0,0,0,1,1
39856,90,7883,11838,14965,0,0,0,1,1
39857,90,7884,10941,14965,0,0,0,1,1
39858,90,7885,11071,14965,0,0,0,1,1
39859,90,7886,11176,14965,0,0,0,1,1
39860,90,7887,11194;11261,14965,0,0,0,2,2
39861,90,7888,10965,14965,0,0,0,1,1
39862,90,7889,11373;11447,14965,0,0,0,2,2
39863,90,7890,11514,14965,0,0,0,1,1
39864,90,7892,11667,14965,0,0,0,1,1
39865,90,7893,11287,14965,0,0,0,1,1
39866,90,7894,11092,14965,0,0,0,1,1
39867,90,7895,11222;11545,14965,0,0,0,2,2
39868,90,7896,11635,14965,0,0,0,1,1
39869,90,7897,11827,14965,0,0,0,1,1
39870,90,7898,12495,14965,0,0,0,1,1
39871,90,7900,11776;12960;17314,14965,0,0,1,2,3
39872,90,7902,12085;12248,14965,0,0,0,2,2
39873,90,7903,11729;11824,14965,0,0,0,2,2
39874,90,7904,12057;12268,14965,0,0,0,2,2
39875,90,7905,11730;11886,14965,0,0,0,2,2
39876,90,7906,11943;11948,14965,0,0,0,2,2
39877,90,7907,11873;11947,14965,0,0,0,2,2
39878,90,7908,11954;12497,14965,0,0,0,2,2
39879,90,7909,12006;12732,14965,0,0,0,2,2
39880,90,7910,12011,14965,0,0,0,1,1
39881,90,7911,12870,14965,0,0,0,1,1
39882,90,7912,12025,14965,0,0,0,1,1
39883,90,7914,12068,14965,0,0,0,1,1
39884,90,7915,12378;12381,14965,0,0,0,2,2
39885,90,7916,12097,14965,0,0,0,1,1
39886,90,7917,12154;12299,14965,0,0,0,2,2
39887,90,7918,11936;12174,14965,0,0,0,2,2
39888,90,7919,12183;12287,14965,0,0,0,2,2
39889,90,7920,12240,14965,0,0,0,1,1
39890,90,7921,12260;12564;16845,14965,0,0,1,2,3
39891,90,7922,12031,14965,0,0,0,1,1
39892,90,7923,12296;12787;16896,14965,0,0,1,2,3
39893,90,7924,12593;12674,14965,0,0,0,2,2
39894,90,7926,12530,14965,0,0,0,1,1
39895,90,7927,12316,14965,0,0,0,1,1
39896,90,7928,11721;12295,14965,0,0,0,2,2
39897,90,7929,12344;12541,14965,0,0,0,2,2
39898,90,7930,12451,14965,0,0,0,1,1
39899,90,7931,12353,14965,0,0,0,1,1
39900,90,7932,12507;12521,14965,0,0,0,2,2
39901,90,7934,12553;12932,14965,0,0,0,2,2
39902,90,7935,12565;12946;18483,14965,0,0,1,2,3
39903,90,7936,12447;12501,14965,0,0,0,2,2
39904,90,7937,12402;12489;17563,14965,0,0,1,2,3
39905,90,7938,12241;12609,14965,0,0,0,2,2
39906,90,7939,12621,14965,0,0,0,1,1
39907,90,7940,12635;12690,14965,0,0,0,2,2
39908,90,7941,12317;12699,14965,0,0,0,2,2
39909,90,7942,12658,14965,0,0,0,1,1
39910,90,7943,12757,14965,0,0,0,1,1
39911,90,7967,10663,15330,0,0,0,1,1
39912,90,7968,11006,15330,0,0,0,1,1
39913,90,7973,10739;11284,15330,0,0,0,2,2
39914,90,7974,11966,15330,0,0,0,1,1
39915,90,7977,10449;10964,15330,0,0,0,2,2
39916,90,7979,11777,15330,0,0,0,1,1
39917,90,7981,11245;11883,15330,0,0,0,2,2
39918,90,7982,11313;11437,15330,0,0,0,2,2
39919,90,7984,11503;11638,15330,0,0,0,2,2
39920,90,7985,11376;12179,15330,0,0,0,2,2
39921,90,7989,12156,15330,0,0,0,1,1
39922,90,7990,11683,15330,0,0,0,1,1
39923,90,7991,11696,15330,0,0,0,1,1
39924,90,7992,11688;11783,15330,0,0,0,2,2
39925,90,7993,11801;12283,15330,0,0,0,2,2
39926,90,7994,12146,15330,0,0,0,1,1
39927,90,7995,11907,15330,0,0,0,1,1
39928,90,7996,11755;11911,15330,0,0,0,2,2
39929,90,7997,11842,15330,0,0,0,1,1
39930,90,7998,11990;12022,15330,0,0,0,2,2
39931,90,7999,12784,15330,0,0,0,1,1
39932,90,8000,12105;12702,15330,0,0,0,2,2
39933,90,8001,12409,15330,0,0,0,1,1
39934,90,8002,11788;12365,15330,0,0,0,2,2
39935,90,8003,12244,15330,0,0,0,1,1
39936,90,8005,12175,15330,0,0,0,1,1
39937,90,8006,12197,15330,0,0,0,1,1
39938,90,8007,12072;12589,15330,0,0,0,2,2
39939,90,8008,12018;12242,15330,0,0,0,2,2
39940,90,8009,12284,15330,0,0,0,1,1
39941,90,8010,11905;12245,15330,0,0,0,2,2
39942,90,8011,11922;12253,15330,0,0,0,2,2
39943,90,8012,12264,15330,0,0,0,1,1
39944,90,8013,12394;12821,15330,0,0,0,2,2
39945,90,8014,12310;12474,15330,0,0,0,2,2
39946,90,8015,12637;12858,15330,0,0,0,2,2
39947,90,8017,12709,15330,0,0,0,1,1
39948,90,8018,12379;12773,15330,0,0,0,2,2
39949,90,8019,12393,15330,0,0,0,1,1
39950,90,8020,12751;13281,15330,0,0,1,1,2
39951,90,8021,12426;12759;16804,15330,0,0,1,2,3
39952,90,8022,12443;12516,15330,0,0,0,2,2
39953,90,8024,12803,15330,0,0,0,1,1
39954,90,8025,12512,15330,0,0,0,1,1
39955,90,8027,12499;12545,15330,0,0,0,2,2
39956,90,8028,12949,15330,0,0,0,1,1
39957,90,8029,12584;12925,15330,0,0,0,2,2
39958,90,8030,12552;12982,15330,0,0,0,2,2
39959,90,8031,12573;12781,15330,0,0,0,2,2
39960,90,8032,12500;12770,15330,0,0,0,2,2
39961,90,8033,12596;12740;16867,15330,0,0,1,2,3
39962,90,8034,12711,15330,0,0,0,1,1
39963,90,8036,12879,15330,0,0,0,1,1
39964,90,8037,13195;13248,15330,0,0,1,1,2
39965,90,8038,12701;13041;16089,15330,0,0,1,2,3
39966,90,8039,12745;13074,15330,0,0,0,2,2
39967,90,8040,12417,15330,0,0,0,1,1
39968,90,8041,12981;13207,15330,0,0,0,2,2
39969,90,8042,12556;12788,15330,0,0,0,2,2
39970,90,8043,12801;12906,15330,0,0,0,2,2
39971,90,8075,11198,15695,0,0,0,1,1
39972,90,8076,11075,15695,0,0,0,1,1
39973,90,8080,11586;11711,15695,0,0,0,2,2
39974,90,8082,11443,15695,0,0,0,1,1
39975,90,8084,11570;12047,15695,0,0,0,2,2
39976,90,8085,11709;11974,15695,0,0,0,2,2
39977,90,8086,11959;12559,15695,0,0,0,2,2
39978,90,8087,11854;11992,15695,0,0,0,2,2
39979,90,8088,11705;11998;17331,15695,0,0,1,2,3
39980,90,8089,12335,15695,0,0,0,1,1
39981,90,8090,12198;12511,15695,0,0,0,2,2
39982,90,8094,12071;12319;17020,15695,0,0,1,2,3
39983,90,8095,12805;12916,15695,0,0,0,2,2
39984,90,8096,12155;12368,15695,0,0,0,2,2
39985,90,8097,12380;12391,15695,0,0,0,2,2
39986,90,8098,11800;12405,15695,0,0,0,2,2
39987,90,8099,12414;12561,15695,0,0,0,2,2
39988,90,8100,12483;12661,15695,0,0,0,2,2
39989,90,8101,12438;12527;16913,15695,0,0,1,2,3
39990,90,8102,12134,15695,0,0,0,1,1
39991,90,8103,12108,15695,0,0,0,1,1
39992,90,8104,12905,15695,0,0,0,1,1
39993,90,8105,12785,15695,0,0,0,1,1
39994,90,8106,12517;13365;16795,15695,0,0,2,1,3
39995,90,8107,12547;12892;15823,15695,0,0,1,2,3
39996,90,8108,12535;12571,15695,0,0,0,2,2
39997,90,8109,12586;16761,15695,0,0,1,1,2
39998,90,8110,13295,15695,0,0,1,0,1
39999,90,8111,12537;16928,15695,0,0,1,1,2
40000,90,8112,12484,15695,0,0,0,1,1
40001,90,8113,11934;11956,15695,0,0,0,2,2
40002,90,8114,12044;12650,15695,0,0,0,2,2
40003,90,8115,12468;12623,15695,0,0,0,2,2
40004,90,8116,12727;12962,15695,0,0,0,2,2
40005,90,8117,13093;13234,15695,0,0,0,2,2
40006,90,8118,12735;12799,15695,0,0,0,2,2
40007,90,8119,12692;12765,15695,0,0,0,2,2
40008,90,8120,13171,15695,0,0,0,1,1
40009,90,8121,12791;12900,15695,0,0,0,2,2
40010,90,8122,12804,15695,0,0,0,1,1
40011,90,8124,12938;13073,15695,0,0,0,2,2
40012,90,8126,12383;12829,15695,0,0,0,2,2
40013,90,8127,12917,15695,0,0,0,1,1
40014,90,8128,12677;12810,15695,0,0,0,2,2
40015,90,8129,12549;12855,15695,0,0,0,2,2
40016,90,8130,12864;13297;17509,15695,0,0,2,1,3
40017,90,8131,12515,15695,0,0,0,1,1
40018,90,8132,12462;12881,15695,0,0,0,2,2
40019,90,8133,12889;13095,15695,0,0,0,2,2
40020,90,8134,12418;12823,15695,0,0,0,2,2
40021,90,8135,13168;13311,15695,0,0,1,1,2
40022,90,8136,12543;12912,15695,0,0,0,2,2
40023,90,8137,13939;14030;18494,15695,0,0,3,0,3
40024,90,8156,10500,16060,0,0,0,1,1
40025,90,8163,10994,16060,0,0,0,1,1
40026,90,8172,11205,16060,0,0,0,1,1
40027,90,8175,11446,16060,0,0,0,1,1
40028,90,8176,11316;11843,16060,0,0,0,2,2
40029,90,8178,12235,16060,0,0,0,1,1
40030,90,8179,11812,16060,0,0,0,1,1
40031,90,8180,11604;11609,16060,0,0,0,2,2
40032,90,8182,11460;12061,16060,0,0,0,2,2
40033,90,8183,11758,16060,0,0,0,1,1
40034,90,8184,12003;12300,16060,0,0,0,2,2
40035,90,8186,11856,16060,0,0,0,1,1
40036,90,8187,11870;12281,16060,0,0,0,2,2
40037,90,8188,11917;12361,16060,0,0,0,2,2
40038,90,8189,11803;11949,16060,0,0,0,2,2
40039,90,8190,11977;12532,16060,0,0,0,2,2
40040,90,8192,11986;12005,16060,0,0,0,2,2
40041,90,8193,12020,16060,0,0,0,1,1
40042,90,8194,12492;16407,16060,0,0,1,1,2
40043,90,8195,11921,16060,0,0,0,1,1
40044,90,8196,12109;12887;17677,16060,0,0,1,2,3
40045,90,8197,12115;12195,16060,0,0,0,2,2
40046,90,8198,11841;12017,16060,0,0,0,2,2
40047,90,8199,12325;12372;17672,16060,0,0,1,2,3
40048,90,8200,12337;12458,16060,0,0,0,2,2
40049,90,8202,12419,16060,0,0,0,1,1
40050,90,8204,12446;13107,16060,0,0,0,2,2
40051,90,8206,12510;12832,16060,0,0,0,2,2
40052,90,8208,12590,16060,0,0,0,1,1
40053,90,8209,12560,16060,0,0,0,1,1
40054,90,8210,12486;12569,16060,0,0,0,2,2
40055,90,8211,12587;12678,16060,0,0,0,2,2
40056,90,8212,13089,16060,0,0,0,1,1
40057,90,8213,12705;13516,16060,0,0,1,1,2
40058,90,8214,12452;17665,16060,0,0,1,1,2
40059,90,8215,12643;12825,16060,0,0,0,2,2
40060,90,8216,12653,16060,0,0,0,1,1
40061,90,8217,12691;18070,16060,0,0,1,1,2
40062,90,8219,12716;13368,16060,0,0,1,1,2
40063,90,8220,12531;12731;16981,16060,0,0,1,2,3
40064,90,8221,12542;13143,16060,0,0,0,2,2
40065,90,8222,12931;13146,16060,0,0,0,2,2
40066,90,8224,12815,16060,0,0,0,1,1
40067,90,8225,12721;12878,16060,0,0,0,2,2
40068,90,8226,12904,16060,0,0,0,1,1
40069,90,8227,12715;12830,16060,0,0,0,2,2
40070,90,8228,12739;12817,16060,0,0,0,2,2
40071,90,8229,13255;16539,16060,0,0,2,0,2
40072,90,8230,12570;12945;16347,16060,0,0,1,2,3
40073,90,8231,12964;13185,16060,0,0,0,2,2
40074,90,8232,12978,16060,0,0,0,1,1
40075,90,8233,12600;12983,16060,0,0,0,2,2
40076,90,8234,12999;13376;17950,16060,0,0,2,1,3
40077,90,8235,13359,16060,0,0,1,0,1
40078,90,8237,13364;13391,16060,0,0,2,0,2
40079,90,8238,12597;13058;16320,16060,0,0,1,2,3
40080,90,8239,13446,16060,0,0,1,0,1
40081,90,8248,6233,16425,0,0,0,1,1
40082,90,8254,4304,16425,0,0,0,1,1
40083,90,8269,10175;10746,16425,0,0,0,2,2
40084,90,8271,10482;10861,16425,0,0,0,2,2
40085,90,8281,11231;11712,16425,0,0,0,2,2
40086,90,8284,11496;11723,16425,0,0,0,2,2
40087,90,8288,12263,16425,0,0,0,1,1
40088,90,8291,11737;11902,16425,0,0,0,2,2
40089,90,8292,12223;12563,16425,0,0,0,2,2
40090,90,8293,11967;12193,16425,0,0,0,2,2
40091,90,8294,12841;17083,16425,0,0,1,1,2
40092,90,8295,12680;12893,16425,0,0,0,2,2
40093,90,8296,11642,16425,0,0,0,1,1
40094,90,8297,12440;12610,16425,0,0,0,2,2
40095,90,8298,12234,16425,0,0,0,1,1
40096,90,8299,12743;17058,16425,0,0,1,1,2
40097,90,8300,12180,16425,0,0,0,1,1
40098,90,8301,12291,16425,0,0,0,1,1
40099,90,8303,12355;12736,16425,0,0,0,2,2
40100,90,8304,12269;12808,16425,0,0,0,2,2
40101,90,8305,12360,16425,0,0,0,1,1
40102,90,8306,12914,16425,0,0,0,1,1
40103,90,8308,12520,16425,0,0,0,1,1
40104,90,8309,12941;13028;17627,16425,0,0,1,2,3
40105,90,8310,12514;12730,16425,0,0,0,2,2
40106,90,8312,12490;12525,16425,0,0,0,2,2
40107,90,8314,13132;13286,16425,0,0,1,1,2
40108,90,8315,12554;12876;17592,16425,0,0,1,2,3
40109,90,8316,12848,16425,0,0,0,1,1
40110,90,8317,12582,16425,0,0,0,1,1
40111,90,8318,12585;13104,16425,0,0,0,2,2
40112,90,8321,12410;12933,16425,0,0,0,2,2
40113,90,8323,12320;13037;17457,16425,0,0,1,2,3
40114,90,8324,12694;13555,16425,0,0,1,1,2
40115,90,8325,12718,16425,0,0,0,1,1
40116,90,8326,12987,16425,0,0,0,1,1
40117,90,8327,13006;13586,16425,0,0,1,1,2
40118,90,8328,12754,16425,0,0,0,1,1
40119,90,8329,12326;13036,16425,0,0,0,2,2
40120,90,8330,12519;12847;17415,16425,0,0,1,2,3
40121,90,8331,12644;12907;17414,16425,0,0,1,2,3
40122,90,8332,12581;12910,16425,0,0,0,2,2
40123,90,8333,12919,16425,0,0,0,1,1
40124,90,8334,12885;12953,16425,0,0,0,2,2
40125,90,8335,12700;13501,16425,0,0,1,1,2
40126,90,8336,13024;13139,16425,0,0,0,2,2
40127,90,8337,12625;13181,16425,0,0,0,2,2
40128,90,8338,12671;13220;17481,16425,0,0,1,2,3
40129,90,8339,13091;13206,16425,0,0,0,2,2
40130,90,8340,13096,16425,0,0,0,1,1
40131,90,8342,13109,16425,0,0,0,1,1
40132,90,8343,13112;13344,16425,0,0,1,1,2
40133,90,8344,13115,16425,0,0,0,1,1
40134,90,8345,13489;13537,16425,0,0,2,0,2
40135,90,8346,12504;13377,16425,0,0,1,1,2
40136,90,8347,13007;13137,16425,0,0,0,2,2
40137,90,8348,12809;13604,16425,0,0,1,1,2
40138,90,8349,12863;13166,16425,0,0,0,2,2
40139,90,8350,12605;13167,16425,0,0,0,2,2
40140,90,8353,12634,16425,0,0,0,1,1
40141,90,8354,13051;13335,16425,0,0,1,1,2
40142,90,8355,13161,16425,0,0,0,1,1
40143,90,8386,10976,16790,0,0,0,1,1
40144,90,8391,11681;16608,16790,0,0,1,1,2
40145,90,8394,11631;12033,16790,0,0,0,2,2
40146,90,8395,12144,16790,0,0,0,1,1
40147,90,8400,12412;12772,16790,0,0,0,2,2
40148,90,8402,12675,16790,0,0,0,1,1
40149,90,8403,12209;12967,16790,0,0,0,2,2
40150,90,8404,12251;12278,16790,0,0,0,2,2
40151,90,8405,12918,16790,0,0,0,1,1
40152,90,8407,12406;12687;16642,16790,0,0,1,2,3
40153,90,8408,12430;12909,16790,0,0,0,2,2
40154,90,8411,12857;12888,16790,0,0,0,2,2
40155,90,8413,13019;13287,16790,0,0,1,1,2
40156,90,8415,12854;13165,16790,0,0,0,2,2
40157,90,8416,12480;12627,16790,0,0,0,2,2
40158,90,8417,12577;12628,16790,0,0,0,2,2
40159,90,8419,13103,16790,0,0,0,1,1
40160,90,8420,13120;13409,16790,0,0,1,1,2
40161,90,8421,12645;13510;17246,16790,0,0,2,1,3
40162,90,8422,12646;12850,16790,0,0,0,2,2
40163,90,8423,12681;13299;18420,16790,0,0,2,1,3
40164,90,8424,12685;13223;17537,16790,0,0,1,2,3
40165,90,8425,12665,16790,0,0,0,1,1
40166,90,8426,11546;12252,16790,0,0,0,2,2
40167,90,8427,12710;13318;18143,16790,0,0,2,1,3
40168,90,8428,13204;13423;17595,16790,0,0,2,1,3
40169,90,8429,12846,16790,0,0,0,1,1
40170,90,8430,12676;13209,16790,0,0,0,2,2
40171,90,8431,12293;12761,16790,0,0,0,2,2
40172,90,8432,12277,16790,0,0,0,1,1
40173,90,8434,13083,16790,0,0,0,1,1
40174,90,8435,12439;12827;16900,16790,0,0,1,2,3
40175,90,8436,12712;13031,16790,0,0,0,2,2
40176,90,8437,12619;13035,16790,0,0,0,2,2
40177,90,8438,13342;13619,16790,0,0,2,0,2
40178,90,8439,12980;13535,16790,0,0,1,1,2
40179,90,8440,13062;13194,16790,0,0,0,2,2
40180,90,8441,13043,16790,0,0,0,1,1
40181,90,8442,12939;13316,16790,0,0,1,1,2
40182,90,8443,13049;13564,16790,0,0,1,1,2
40183,90,8444,12523;13292,16790,0,0,1,1,2
40184,90,8445,13462;13610,16790,0,0,2,0,2
40185,90,8446,12806;13272,16790,0,0,1,1,2
40186,90,8447,13159;13227;16604;17422,16790,0,0,2,2,4
40187,90,8449,12550;13163,16790,0,0,0,2,2
40188,90,8450,13172;13416,16790,0,0,1,1,2
40189,90,8451,13189,16790,0,0,0,1,1
40190,90,8452,13198;13240;18229,16790,0,0,2,1,3
40191,90,8454,12956;13254,16790,0,0,1,1,2
40192,90,8455,13577;13793;18271,16790,0,0,3,0,3
40193,90,8456,13314,16790,0,0,1,0,1
40194,90,8457,13300,16790,0,0,1,0,1
40195,90,8458,12936;13361,16790,0,0,1,1,2
40196,90,8459,13018;13310,16790,0,0,1,1,2
40197,90,8460,13536,16790,0,0,1,0,1
40198,90,8461,13082;13323,16790,0,0,1,1,2
40199,90,8462,13151;13439;18150,16790,0,0,2,1,3
40200,90,8464,13427;13533,16790,0,0,2,0,2
40201,90,8466,316,17155,0,0,0,1,1
40202,90,8474,10164,17155,0,0,0,1,1
40203,90,8497,11249,17155,0,0,0,1,1
40204,90,8503,11548;11872,17155,0,0,0,2,2
40205,90,8505,11799;11874,17155,0,0,0,2,2
40206,90,8506,11912;12334,17155,0,0,0,2,2
40207,90,8507,11809;12141,17155,0,0,0,2,2
40208,90,8509,11940;12086,17155,0,0,0,2,2
40209,90,8511,12080,17155,0,0,0,1,1
40210,90,8512,11826,17155,0,0,0,1,1
40211,90,8514,16285;16466;16776;17100;20512;20679;20697;20767,17155,3,1,4,0,8
40212,90,8515,12844,17155,0,0,0,1,1
40213,90,8519,12719;13001,17155,0,0,0,2,2
40214,90,8520,12615,17155,0,0,0,1,1
40215,90,8521,12386;12544,17155,0,0,0,2,2
40216,90,8522,12189,17155,0,0,0,1,1
40217,90,8523,12672;13142;18360,17155,0,0,1,2,3
40218,90,8524,13328,17155,0,0,1,0,1
40219,90,8525,12243;12693,17155,0,0,0,2,2
40220,90,8526,12774;12963,17155,0,0,0,2,2
40221,90,8527,12738,17155,0,0,0,1,1
40222,90,8528,12524;18484,17155,0,0,1,1,2
40223,90,8530,12688;12707,17155,0,0,0,2,2
40224,90,8531,12840;17992,17155,0,0,1,1,2
40225,90,8532,12873;13500,17155,0,0,1,1,2
40226,90,8534,12778,17155,0,0,0,1,1
40227,90,8535,12867;12924,17155,0,0,0,2,2
40228,90,8536,12948,17155,0,0,0,1,1
40229,90,8537,13434;13438,17155,0,0,2,0,2
40230,90,8538,12988;13184,17155,0,0,0,2,2
40231,90,8539,13540;17347,17155,0,0,2,0,2
40232,90,8540,13067;13475,17155,0,0,1,1,2
40233,90,8542,12813,17155,0,0,0,1,1
40234,90,8543,12771;12834,17155,0,0,0,2,2
40235,90,8544,12654;13175,17155,0,0,0,2,2
40236,90,8545,12972;13126;17391,17155,0,0,1,2,3
40237,90,8546,13011;13131,17155,0,0,0,2,2
40238,90,8548,13022;13138,17155,0,0,0,2,2
40239,90,8549,13141,17155,0,0,0,1,1
40240,90,8550,12826;13150;17339,17155,0,0,1,2,3
40241,90,8551,13237;16820,17155,0,0,2,0,2
40242,90,8552,13178;17927,17155,0,0,1,1,2
40243,90,8553,13009;13200,17155,0,0,0,2,2
40244,90,8554,13449,17155,0,0,1,0,1
40245,90,8555,12959;13221,17155,0,0,0,2,2
40246,90,8557,12614;13087,17155,0,0,0,2,2
40247,90,8560,13188;13249,17155,0,0,1,1,2
40248,90,8561,13264,17155,0,0,1,0,1
40249,90,8562,12807;13289;17558,17155,0,0,2,1,3
40250,90,8563,13243;13594,17155,0,0,2,0,2
40251,90,8564,12968;13291,17155,0,0,1,1,2
40252,90,8565,13098;13388,17155,0,0,1,1,2
40253,90,8566,13331;13624,17155,0,0,2,0,2
40254,90,8567,13238;17503;18312,17155,0,0,3,0,3
40255,90,8568,13384,17155,0,0,1,0,1
40256,90,8569,13389,17155,0,0,1,0,1
40257,90,8570,13055;13392;17229,17155,0,0,2,1,3
40258,90,8571,13147;13492,17155,0,0,1,1,2
40259,90,8572,13217;13779;16581,17155,0,0,2,1,3
40260,90,8573,13039;13301,17155,0,0,1,1,2
40261,90,8574,13445,17155,0,0,1,0,1
40262,90,8575,12795;13450,17155,0,0,1,1,2
40263,90,8576,13581;13602,17155,0,0,2,0,2
40264,90,8577,13471;13909,17155,0,0,2,0,2
40265,90,8578,13390,17155,0,0,1,0,1
40266,90,8579,13655;13782;17960,17155,0,0,3,0,3
40267,90,8592,10452,17520,0,0,0,1,1
40268,90,8593,1747,17520,0,0,0,1,1
40269,90,8607,10643;11052,17520,0,0,0,2,2
40270,90,8610,11241,17520,0,0,0,1,1
40271,90,8612,11161;11299,17520,0,0,0,2,2
40272,90,8621,12255,17520,0,0,0,1,1
40273,90,8623,12028;12356,17520,0,0,0,2,2
40274,90,8624,12078;12136,17520,0,0,0,2,2
40275,90,8626,12828,17520,0,0,0,1,1
40276,90,8628,12453,17520,0,0,0,1,1
40277,90,8629,12457;12473,17520,0,0,0,2,2
40278,90,8630,12475,17520,0,0,0,1,1
40279,90,8635,13033,17520,0,0,0,1,1
40280,90,8636,13422;13455;17814,17520,0,0,3,0,3
40281,90,8637,12330,17520,0,0,0,1,1
40282,90,8638,12734;17379,17520,0,0,1,1,2
40283,90,8639,12423;12796,17520,0,0,0,2,2
40284,90,8640,12698;12818,17520,0,0,0,2,2
40285,90,8642,12769;12856,17520,0,0,0,2,2
40286,90,8643,12354;12862,17520,0,0,0,2,2
40287,90,8644,13415;13802,17520,0,0,2,0,2
40288,90,8645,12679;12977,17520,0,0,0,2,2
40289,90,8646,13278,17520,0,0,1,0,1
40290,90,8648,13084;13343,17520,0,0,1,1,2
40291,90,8649,13060;13100,17520,0,0,0,2,2
40292,90,8650,13155;13562,17520,0,0,1,1,2
40293,90,8651,12522;13158,17520,0,0,0,2,2
40294,90,8652,13435;13459,17520,0,0,2,0,2
40295,90,8653,12783;13199;18053;19013,17520,0,0,2,2,4
40296,90,8654,13233;13378,17520,0,0,1,1,2
40297,90,8655,12990;13259;17609,17520,0,0,2,1,3
40298,90,8656,13493;13603;17518,17520,0,0,3,0,3
40299,90,8657,12974;13277;16991,17520,0,0,2,1,3
40300,90,8659,13371;13676;18598,17520,0,0,3,0,3
40301,90,8661,13919;17226,17520,0,0,2,0,2
40302,90,8662,12877;13341,17520,0,0,1,1,2
40303,90,8663,12859;13367,17520,0,0,1,1,2
40304,90,8664,13975;18066;18470;19177,17520,0,1,3,0,4
40305,90,8667,12606;12668,17520,0,0,0,2,2
40306,90,8668,14025;14101,17520,0,0,2,0,2
40307,90,8669,13400;13635,17520,0,0,2,0,2
40308,90,8671,13525;13952,17520,0,0,2,0,2
40309,90,8673,13010;13496,17520,0,0,1,1,2
40310,90,8674,13021;13502,17520,0,0,1,1,2
40311,90,8675,13201;13511,17520,0,0,1,1,2
40312,90,8677,13241;13543;18672,17520,0,0,3,0,3
40313,90,8678,13118;13559,17520,0,0,1,1,2
40314,90,8679,13762;13799,17520,0,0,2,0,2
40315,90,8681,13567,17520,0,0,1,0,1
40316,90,8682,13296;13568,17520,0,0,2,0,2
40317,90,8683,13740;13847,17520,0,0,2,0,2
40318,90,8684,13532;17912,17520,0,0,2,0,2
40319,90,8685,13607;13805,17520,0,0,2,0,2
40320,90,8686,13622;13934;17857,17520,0,0,3,0,3
40321,90,8687,13640;13680;18508,17520,0,0,3,0,3
40322,90,8688,13653;13792,17520,0,0,2,0,2
40323,90,8689,12961;13664,17520,0,0,1,1,2
40324,90,8690,13491;13666;17826,17520,0,0,3,0,3
40325,90,8695,6071,17885,0,0,0,1,1
40326,90,8699,5572,17885,0,0,0,1,1
40327,90,8706,3247,17885,0,0,0,1,1
40328,90,8710,11045,17885,0,0,0,1,1
40329,90,8718,11624;11717,17885,0,0,0,2,2
40330,90,8719,11592;11682,17885,0,0,0,2,2
40331,90,8725,11662;11744;16749,17885,0,0,1,2,3
40332,90,8726,12760;16777,17885,0,0,1,1,2
40333,90,8727,12066,17885,0,0,0,1,1
40334,90,8728,12079;12145,17885,0,0,0,2,2
40335,90,8729,12138;12722,17885,0,0,0,2,2
40336,90,8730,13108,17885,0,0,0,1,1
40337,90,8731,12428;12744,17885,0,0,0,2,2
40338,90,8734,12396,17885,0,0,0,1,1
40339,90,8735,11763;12043,17885,0,0,0,2,2
40340,90,8736,11754;11820,17885,0,0,0,2,2
40341,90,8737,12464;12934,17885,0,0,0,2,2
40342,90,8738,11909;12479;17477,17885,0,0,1,2,3
40343,90,8739,12816;13472,17885,0,0,1,1,2
40344,90,8741,12583;12930,17885,0,0,0,2,2
40345,90,8742,12431;12662,17885,0,0,0,2,2
40346,90,8743,11885;12364,17885,0,0,0,2,2
40347,90,8744,12343;12649,17885,0,0,0,2,2
40348,90,8747,12494;12768,17885,0,0,0,2,2
40349,90,8748,13156;13403;18146,17885,0,0,2,1,3
40350,90,8749,12814,17885,0,0,0,1,1
40351,90,8751,12901;13149,17885,0,0,0,2,2
40352,90,8752,12416;13280,17885,0,0,1,1,2
40353,90,8753,12971;13503,17885,0,0,1,1,2
40354,90,8754,13247;13408,17885,0,0,2,0,2
40355,90,8755,13034,17885,0,0,0,1,1
40356,90,8756,12792;13047;17685,17885,0,0,1,2,3
40357,90,8757,12482;13053,17885,0,0,0,2,2
40358,90,8759,13186;13236;17846,17885,0,0,1,2,3
40359,90,8760,13214;13305,17885,0,0,1,1,2
40360,90,8761,13219;13544;18317,17885,0,0,2,1,3
40361,90,8762,13157;13657,17885,0,0,1,1,2
40362,90,8763,13421,17885,0,0,1,0,1
40363,90,8764,12713;13429,17885,0,0,1,1,2
40364,90,8765,13483;13519,17885,0,0,2,0,2
40365,90,8767,12766;13893;18091,17885,0,0,2,1,3
40366,90,8768,13079;13507,17885,0,0,1,1,2
40367,90,8769,13461,17885,0,0,1,0,1
40368,90,8770,13463;13481,17885,0,0,2,0,2
40369,90,8771,13048;13479,17885,0,0,1,1,2
40370,90,8772,12557;13485,17885,0,0,1,1,2
40371,90,8773,13937;14142;17169,17885,0,0,3,0,3
40372,90,8774,13759;13902,17885,0,0,2,0,2
40373,90,8775,14050;14143;17858,17885,0,0,3,0,3
40374,90,8776,13288;13560,17885,0,0,2,0,2
40375,90,8778,12842;13440,17885,0,0,1,1,2
40376,90,8780,13601;13701,17885,0,0,2,0,2
40377,90,8781,13407;13654;17174,17885,0,0,3,0,3
40378,90,8782,13252;13592;18134,17885,0,0,3,0,3
40379,90,8783,13636;13803,17885,0,0,2,0,2
40380,90,8784,13804,17885,0,0,1,0,1
40381,90,8785,13827;14165;17299,17885,0,0,3,0,3
40382,90,8786,13351;14183,17885,0,0,2,0,2
40383,90,8787,13714;14112,17885,0,0,2,0,2
40384,90,8788,13531;13863,17885,0,0,2,0,2
40385,90,8789,13720;13826;18473,17885,0,0,3,0,3
40386,90,8790,13210;13721;17740,17885,0,0,2,1,3
40387,90,8791,13285;14052;17382,17885,0,0,3,0,3
40388,90,8792,13767;14082,17885,0,0,2,0,2
40389,90,8794,13871;14059,17885,0,0,2,0,2
40390,90,8801,6261,18250,0,0,0,1,1
40391,90,8805,7324,18250,0,0,0,1,1
40392,90,8813,10007,18250,0,0,0,1,1
40393,90,8821,10514,18250,0,0,0,1,1
40394,90,8822,11796,18250,0,0,0,1,1
40395,90,8823,11741,18250,0,0,0,1,1
40396,90,8827,11920,18250,0,0,0,1,1
40397,90,8828,11895,18250,0,0,0,1,1
40398,90,8830,11816,18250,0,0,0,1,1
40399,90,8831,11890;11995,18250,0,0,0,2,2
40400,90,8832,11972;12425;17634,18250,0,0,1,2,3
40401,90,8835,12375;13008,18250,0,0,0,2,2
40402,90,8836,12385;13077,18250,0,0,0,2,2
40403,90,8837,13085;13125,18250,0,0,0,2,2
40404,90,8838,12411;16878,18250,0,0,1,1,2
40405,90,8839,12498;12540;17185,18250,0,0,1,2,3
40406,90,8840,12103;12617,18250,0,0,0,2,2
40407,90,8841,12940,18250,0,0,0,1,1
40408,90,8842,12656;17755,18250,0,0,1,1,2
40409,90,8843,12399;12794,18250,0,0,0,2,2
40410,90,8845,12720,18250,0,0,0,1,1
40411,90,8846,12742,18250,0,0,0,1,1
40412,90,8847,13119;13478,18250,0,0,1,1,2
40413,90,8848,12422,18250,0,0,0,1,1
40414,90,8849,12944;17957,18250,0,0,1,1,2
40415,90,8850,12955;13187,18250,0,0,0,2,2
40416,90,8851,12965;13154;17502,18250,0,0,1,2,3
40417,90,8852,13838,18250,0,0,1,0,1
40418,90,8853,13038;13153,18250,0,0,0,2,2
40419,90,8854,12891,18250,0,0,0,1,1
40420,90,8855,13315;13929,18250,0,0,2,0,2
40421,90,8856,12989,18250,0,0,0,1,1
40422,90,8857,13129;13242,18250,0,0,1,1,2
40423,90,8858,12363;12798,18250,0,0,0,2,2
40424,90,8859,13256;13695;18130,18250,0,0,3,0,3
40425,90,8860,13271,18250,0,0,1,0,1
40426,90,8861,13396;13515,18250,0,0,2,0,2
40427,90,8863,13349;13574,18250,0,0,2,0,2
40428,90,8864,13679;13860;17693;17885,18250,0,0,4,0,4
40429,90,8865,12882;13348,18250,0,0,1,1,2
40430,90,8867,14150;17150,18250,0,0,2,0,2
40431,90,8868,13486;13588;17214,18250,0,0,3,0,3
40432,90,8870,13106;13590,18250,0,0,1,1,2
40433,90,8871,14064,18250,0,0,1,0,1
40434,90,8872,13541;13811,18250,0,0,2,0,2
40435,90,8873,13698;17260;18815,18250,0,0,3,0,3
40436,90,8874,13339;13561,18250,0,0,2,0,2
40437,90,8876,13304;13761,18250,0,0,2,0,2
40438,90,8877,13593;18489,18250,0,0,2,0,2
40439,90,8879,13405;14047,18250,0,0,2,0,2
40440,90,8880,13078;13637,18250,0,0,1,1,2
40441,90,8882,13448;13889,18250,0,0,2,0,2
40442,90,8883,13631;13935;18544,18250,0,0,3,0,3
40443,90,8884,14017,18250,0,0,1,0,1
40444,90,8885,13646;14280,18250,0,0,2,0,2
40445,90,8886,13652;14190,18250,0,0,2,0,2
40446,90,8887,13659;13834;17876;18689,18250,0,0,4,0,4
40447,90,8888,13662;14080;17590,18250,0,0,3,0,3
40448,90,8889,13547;13755,18250,0,0,2,0,2
40449,90,8890,14065;14268;19097;19492,18250,0,1,3,0,4
40450,90,8891,13709;14121;18126,18250,0,0,3,0,3
40451,90,8892,13346;13712,18250,0,0,2,0,2
40452,90,8893,13728,18250,0,0,1,0,1
40453,90,8894,13723;14071;16833,18250,0,0,3,0,3
40454,90,8896,13529;13760,18250,0,0,2,0,2
40455,90,8897,13733,18250,0,0,1,0,1
40456,90,8898,14093;17908;18623,18250,0,0,3,0,3
40457,90,8899,13381;13996,18250,0,0,2,0,2
40458,90,8900,13980;14299,18250,0,0,2,0,2
40459,90,8901,13203;13888;17102;18965,18250,0,0,3,1,4
40460,90,8902,13512;14019;18137,18250,0,0,3,0,3
40461,90,8903,13453;13681,18250,0,0,2,0,2
40462,90,8904,14189;14310,18250,0,0,2,0,2
40463,90,8905,13915;13971,18250,0,0,2,0,2
40464,90,8906,13879;13941;17628,18250,0,0,3,0,3
40465,90,8907,13004;13946,18250,0,0,1,1,2
40466,90,8908,13556;13950,18250,0,0,2,0,2
40467,90,8940,11630,18615,0,0,0,1,1
40468,90,8943,11839;12002;16986,18615,0,0,1,2,3
40469,90,8946,11859;12262,18615,0,0,0,2,2
40470,90,8950,12444;12526,18615,0,0,0,2,2
40471,90,8952,12341;12749,18615,0,0,0,2,2
40472,90,8953,13262,18615,0,0,1,0,1
40473,90,8954,12206;12695,18615,0,0,0,2,2
40474,90,8955,17250;17352;19595,18615,0,1,2,0,3
40475,90,8956,12733;12837;16755,18615,0,0,1,2,3
40476,90,8957,12266;12741,18615,0,0,0,2,2
40477,90,8958,13128;13275,18615,0,0,1,1,2
40478,90,8962,12929,18615,0,0,0,1,1
40479,90,8963,12947;13110,18615,0,0,0,2,2
40480,90,8964,12957,18615,0,0,0,1,1
40481,90,8965,12970;13245,18615,0,0,1,1,2
40482,90,8966,12973,18615,0,0,0,1,1
40483,90,8967,13498;13575;17346,18615,0,0,3,0,3
40484,90,8968,13942;14132,18615,0,0,2,0,2
40485,90,8969,13164;13294,18615,0,0,1,1,2
40486,90,8970,13215,18615,0,0,0,1,1
40487,90,8971,13258;13508,18615,0,0,2,0,2
40488,90,8972,14033;14206;18649,18615,0,0,3,0,3
40489,90,8973,13441,18615,0,0,1,0,1
40490,90,8974,13587;13766;18848,18615,0,0,3,0,3
40491,90,8975,12926,18615,0,0,0,1,1
40492,90,8976,13546;13748;18138;18709,18615,0,0,4,0,4
40493,90,8977,13428;13749,18615,0,0,2,0,2
40494,90,8979,13538;18416,18615,0,0,2,0,2
40495,90,8981,13908;13968;18153,18615,0,0,3,0,3
40496,90,8982,17027,18615,0,0,1,0,1
40497,90,8983,13618;14210,18615,0,0,2,0,2
40498,90,8984,13705,18615,0,0,1,0,1
40499,90,8985,13393;13784,18615,0,0,2,0,2
40500,90,8986,13639,18615,0,0,1,0,1
40501,90,8987,13824,18615,0,0,1,0,1
40502,90,8988,13991,18615,0,0,1,0,1
40503,90,8989,13800;14155;17281,18615,0,0,3,0,3
40504,90,8990,13644;14285,18615,0,0,2,0,2
40505,90,8991,13693;13772,18615,0,0,2,0,2
40506,90,8992,13727;14291,18615,0,0,2,0,2
40507,90,8993,12942;13470,18615,0,0,1,1,2
40508,90,8994,14458;18568;19914,18615,0,1,2,0,3
40509,90,8995,13913;14502,18615,0,0,2,0,2
40510,90,8996,13951;14328;17512,18615,0,0,3,0,3
40511,90,8997,14048;14177,18615,0,0,2,0,2
40512,90,8998,14254,18615,0,0,1,0,1
40513,90,8999,14000;14349;18712,18615,0,0,3,0,3
40514,90,9000,13753;14021;18904,18615,0,0,3,0,3
40515,90,9001,14022,18615,0,0,1,0,1
40516,90,9002,14061;14315;18588,18615,0,0,3,0,3
40517,90,9003,14125,18615,0,0,1,0,1
40518,90,9004,14359,18615,0,0,1,0,1
40519,90,9005,13840;14067,18615,0,0,2,0,2
40520,90,9006,13810;14069;18635,18615,0,0,3,0,3
40521,90,9007,13615;14074,18615,0,0,2,0,2
40522,90,9008,13551;14075,18615,0,0,2,0,2
40523,90,9009,13787;14084,18615,0,0,2,0,2
40524,90,9034,11750;11999,18980,0,0,0,2,2
40525,90,9039,10468;11309,18980,0,0,0,2,2
40526,90,9042,11725;11868,18980,0,0,0,2,2
40527,90,9052,12215;12935,18980,0,0,0,2,2
40528,90,9054,12211;12442,18980,0,0,0,2,2
40529,90,9056,12491;12937,18980,0,0,0,2,2
40530,90,9058,12607;13231;18198,18980,0,0,1,2,3
40531,90,9060,12976;17974,18980,0,0,1,1,2
40532,90,9061,12509;12975,18980,0,0,0,2,2
40533,90,9062,12135;13090;17900;19674,18980,0,1,1,2,4
40534,90,9063,12845;13023,18980,0,0,0,2,2
40535,90,9064,12270;13094,18980,0,0,0,2,2
40536,90,9065,12400;12433,18980,0,0,0,2,2
40537,90,9066,12996;13642;17676;18344,18980,0,0,3,1,4
40538,90,9068,12979;13059,18980,0,0,0,2,2
40539,90,9069,13121,18980,0,0,0,1,1
40540,90,9070,13066;13122,18980,0,0,0,2,2
40541,90,9071,13708;13768;18338,18980,0,0,3,0,3
40542,90,9072,13208;13226,18980,0,0,0,2,2
40543,90,9075,12833,18980,0,0,0,1,1
40544,90,9076,12496;13266;17809,18980,0,0,2,1,3
40545,90,9077,13282;13313,18980,0,0,2,0,2
40546,90,9078,13352;13629,18980,0,0,2,0,2
40547,90,9079,13374;13807,18980,0,0,2,0,2
40548,90,9082,13387;13420,18980,0,0,2,0,2
40549,90,9083,13426;13771;18307,18980,0,0,3,0,3
40550,90,9084,13013;13432,18980,0,0,1,1,2
40551,90,9085,14284;14292;19427,18980,0,1,2,0,3
40552,90,9086,13386;13447,18980,0,0,2,0,2
40553,90,9087,13212;13480;17620;18394,18980,0,0,3,1,4
40554,90,9088,13177,18980,0,0,0,1,1
40555,90,9089,13672;14159;18833,18980,0,0,3,0,3
40556,90,9090,13989;14004;18399;18608,18980,0,0,4,0,4
40557,90,9091,13667;13979;18746,18980,0,0,3,0,3
40558,90,9092,12951;13669,18980,0,0,1,1,2
40559,90,9093,13703;13911,18980,0,0,2,0,2
40560,90,9094,13700;13707,18980,0,0,2,0,2
40561,90,9095,13517;14095,18980,0,0,2,0,2
40562,90,9096,14567,18980,0,0,1,0,1
40563,90,9097,13774,18980,0,0,1,0,1
40564,90,9098,13490;13814,18980,0,0,2,0,2
40565,90,9099,13820;14318,18980,0,0,2,0,2
40566,90,9100,13830;14494;18418,18980,0,0,3,0,3
40567,90,9102,13897;14327,18980,0,0,2,0,2
40568,90,9103,13758;14063,18980,0,0,2,0,2
40569,90,9104,13641;13890,18980,0,0,2,0,2
40570,90,9105,14341;14439,18980,0,0,2,0,2
40571,90,9106,14293,18980,0,0,1,0,1
40572,90,9107,13735;13920;18462,18980,0,0,3,0,3
40573,90,9108,14212,18980,0,0,1,0,1
40574,90,9109,13956,18980,0,0,1,0,1
40575,90,9110,13597;13958,18980,0,0,2,0,2
40576,90,9111,13279;13967,18980,0,0,2,0,2
40577,90,9112,13456;13981,18980,0,0,2,0,2
40578,90,9113,14478;18830,18980,0,0,2,0,2
40579,90,9114,13777;14008;18323,18980,0,0,3,0,3
40580,90,9115,14034;14113,18980,0,0,2,0,2
40581,90,9116,14215,18980,0,0,1,0,1
40582,90,9117,14358;14475,18980,0,0,2,0,2
40583,90,9118,13621;14153,18980,0,0,2,0,2
40584,90,9119,13643;14130,18980,0,0,2,0,2
40585,90,9120,14081;14496;18606,18980,0,0,3,0,3
40586,90,9121,14085;14102,18980,0,0,2,0,2
40587,90,9122,14110;19119,18980,0,1,1,0,2
40588,90,9123,14137;14590,18980,0,0,2,0,2
40589,90,9124,13837;14169,18980,0,0,2,0,2
40590,90,9125,14171;14530;17030,18980,0,0,3,0,3
40591,90,9149,11772;12036,19345,0,0,0,2,2
40592,90,9150,11508;11794;17248,19345,0,0,1,2,3
40593,90,9151,12427,19345,0,0,0,1,1
40594,90,9153,12050;17038,19345,0,0,1,1,2
40595,90,9154,12055,19345,0,0,0,1,1
40596,90,9156,11871,19345,0,0,0,1,1
40597,90,9160,11893;12315,19345,0,0,0,2,2
40598,90,9161,12664;13656,19345,0,0,1,1,2
40599,90,9165,13225,19345,0,0,0,1,1
40600,90,9166,12579;12843,19345,0,0,0,2,2
40601,90,9167,12275;12790;17637,19345,0,0,1,2,3
40602,90,9168,12682;13065,19345,0,0,0,2,2
40603,90,9169,13332,19345,0,0,1,0,1
40604,90,9170,12182;12747,19345,0,0,0,2,2
40605,90,9172,12896;13071,19345,0,0,0,2,2
40606,90,9174,12943;13930;17856,19345,0,0,2,1,3
40607,90,9175,12954;13648,19345,0,0,1,1,2
40608,90,9176,12312;13173,19345,0,0,0,2,2
40609,90,9177,12853;13072,19345,0,0,0,2,2
40610,90,9179,13487;14029,19345,0,0,2,0,2
40611,90,9180,13357,19345,0,0,1,0,1
40612,90,9181,13136;13831;18995,19345,0,0,2,1,3
40613,90,9182,13454;13718,19345,0,0,2,0,2
40614,90,9183,13193;13402,19345,0,0,1,1,2
40615,90,9186,13253;13477;17361,19345,0,0,3,0,3
40616,90,9188,13205;13322,19345,0,0,1,1,2
40617,90,9189,13056;13325,19345,0,0,1,1,2
40618,90,9190,13326;13861,19345,0,0,2,0,2
40619,90,9192,14174;14231;18299;18414,19345,0,0,4,0,4
40620,90,9193,13424;13818,19345,0,0,2,0,2
40621,90,9195,13474;13922,19345,0,0,2,0,2
40622,90,9196,13431;14168,19345,0,0,2,0,2
40623,90,9198,13433;13484,19345,0,0,2,0,2
40624,90,9199,14316,19345,0,0,1,0,1
40625,90,9200,13699;14009;18878,19345,0,0,3,0,3
40626,90,9202,13436;13677;17334;17917,19345,0,0,4,0,4
40627,90,9203,13306;13791;17053,19345,0,0,3,0,3
40628,90,9204,13452;13633,19345,0,0,2,0,2
40629,90,9205,13689;14107,19345,0,0,2,0,2
40630,90,9206,13356;13691,19345,0,0,2,0,2
40631,90,9207,13730;14374;18646,19345,0,0,3,0,3
40632,90,9208,13739;14164;17805,19345,0,0,3,0,3
40633,90,9209,13658;13973;18652,19345,0,0,3,0,3
40634,90,9210,13809,19345,0,0,1,0,1
40635,90,9211,14056;18554,19345,0,0,2,0,2
40636,90,9212,13466;13815,19345,0,0,2,0,2
40637,90,9213,13786;13823,19345,0,0,2,0,2
40638,90,9214,14580;18365,19345,0,0,2,0,2
40639,90,9215,14370,19345,0,0,1,0,1
40640,90,9216,13966,19345,0,0,1,0,1
40641,90,9217,14089,19345,0,0,1,0,1
40642,90,9218,14411;14606;17362;17664,19345,0,0,4,0,4
40643,90,9219,13754;13961;18275,19345,0,0,3,0,3
40644,90,9220,17146;17629;17782;17832;21046,19345,1,0,4,0,5
40645,90,9221,13866;13972,19345,0,0,2,0,2
40646,90,9223,14040;14499;18944,19345,0,0,3,0,3
40647,90,9225,14098;14789;17461,19345,0,0,3,0,3
40648,90,9227,14124;14413;19000,19345,0,0,3,0,3
40649,90,9228,13848;14126,19345,0,0,2,0,2
40650,90,9229,14133;14365,19345,0,0,2,0,2
40651,90,9230,13585;14134,19345,0,0,2,0,2
40652,90,9231,13687;14140,19345,0,0,2,0,2
40653,90,9232,14144;14605;18391,19345,0,0,3,0,3
40654,90,9233,14161;14464,19345,0,0,2,0,2
40655,90,9234,14180;14715;18837;19225,19345,0,1,3,0,4
40656,90,9235,14229;14811,19345,0,0,2,0,2
40657,90,9236,14259,19345,0,0,1,0,1
40658,90,9237,14099;14270;18597,19345,0,0,3,0,3
40659,90,9238,13790;14296;17799,19345,0,0,3,0,3
40660,90,9239,14282;14319,19345,0,0,2,0,2
40661,90,9240,14287;18564;19317,19345,0,1,2,0,3
40662,90,9241,13713;14305,19345,0,0,2,0,2
40663,90,9242,14675;14942;17533;18723,19345,0,0,4,0,4
40664,90,9243,13764;14615;18504,19345,0,0,3,0,3
40665,90,9244,14323;14364,19345,0,0,2,0,2
40666,90,9246,4476,19710,0,0,0,1,1
40667,90,9256,11414,19710,0,0,0,1,1
40668,90,9264,11818;11878,19710,0,0,0,2,2
40669,90,9271,12305;12369;17928,19710,0,0,1,2,3
40670,90,9273,12445;12903,19710,0,0,0,2,2
40671,90,9276,13333,19710,0,0,1,0,1
40672,90,9280,13284,19710,0,0,1,0,1
40673,90,9281,13081;13513,19710,0,0,1,1,2
40674,90,9282,13117;13494;18589,19710,0,0,2,1,3
40675,90,9284,13283;17716,19710,0,0,2,0,2
40676,90,9285,13032;13338;18017,19710,0,0,2,1,3
40677,90,9286,13399;13524,19710,0,0,2,0,2
40678,90,9288,12897;13430;18389,19710,0,0,2,1,3
40679,90,9289,13437;14006;17493,19710,0,0,3,0,3
40680,90,9290,13152;13465;17374,19710,0,0,2,1,3
40681,90,9291,12861;13015,19710,0,0,0,2,2
40682,90,9293,13645;13905;18244,19710,0,0,3,0,3
40683,90,9294,14149;14607,19710,0,0,2,0,2
40684,90,9295,13757;13808,19710,0,0,2,0,2
40685,90,9296,13661;13858,19710,0,0,2,0,2
40686,90,9297,13675;13682;17473,19710,0,0,3,0,3
40687,90,9298,13859;18660,19710,0,0,2,0,2
40688,90,9299,13566;14131;19060,19710,0,0,3,0,3
40689,90,9300,13499;13796;18432,19710,0,0,3,0,3
40690,90,9301,14072;14135;18122,19710,0,0,3,0,3
40691,90,9302,14073;18500;19544,19710,0,1,2,0,3
40692,90,9303,13855;13933;18407,19710,0,0,3,0,3
40693,90,9304,13634;14366;19171,19710,0,1,2,0,3
40694,90,9305,13750;13882,19710,0,0,2,0,2
40695,90,9306,13518;14224,19710,0,0,2,0,2
40696,90,9307,14344;14927;18343;18875,19710,0,0,4,0,4
40697,90,9308,14463;18849,19710,0,0,2,0,2
40698,90,9309,13770;13990,19710,0,0,2,0,2
40699,90,9310,14417,19710,0,0,1,0,1
40700,90,9311,13994;14311,19710,0,0,2,0,2
40701,90,9312,14028;14437,19710,0,0,2,0,2
40702,90,9313,13704;14077,19710,0,0,2,0,2
40703,90,9314,13628;14136,19710,0,0,2,0,2
40704,90,9316,14771;18737,19710,0,0,2,0,2
40705,90,9317,13457;14139,19710,0,0,2,0,2
40706,90,9318,14584;18254,19710,0,0,2,0,2
40707,90,9319,13715;14151,19710,0,0,2,0,2
40708,90,9320,14156;14866;18493;18725,19710,0,0,4,0,4
40709,90,9322,13892;14331;18909,19710,0,0,3,0,3
40710,90,9323,18511,19710,0,0,1,0,1
40711,90,9324,13726;14321,19710,0,0,2,0,2
40712,90,9325,13788;14333,19710,0,0,2,0,2
40713,90,9326,13816;14363;17449,19710,0,0,3,0,3
40714,90,9327,14381,19710,0,0,1,0,1
40715,90,9328,14201;14385;17375,19710,0,0,3,0,3
40716,90,9329,14398;19123,19710,0,1,1,0,2
40717,90,9330,14705;14718,19710,0,0,2,0,2
40718,90,9332,14407;14821;18402;19001,19710,0,0,4,0,4
40719,90,9333,14519;14897;18280,19710,0,0,3,0,3
40720,90,9334,14145;14457;19035,19710,0,0,3,0,3
40721,90,9335,14630;18906,19710,0,0,2,0,2
40722,90,9336,14481,19710,0,0,1,0,1
40723,90,9337,14036;14503,19710,0,0,2,0,2
40724,90,9338,14618;14727;18888,19710,0,0,3,0,3
40725,90,9339,14514;19382,19710,0,1,1,0,2
40726,90,9340,14241;14522,19710,0,0,2,0,2
40727,90,9341,9689,20075,0,0,0,1,1
40728,90,9349,10015,20075,0,0,0,1,1
40729,90,9364,11539;11764,20075,0,0,0,2,2
40730,90,9377,12388;12459,20075,0,0,0,2,2
40731,90,9379,12196,20075,0,0,0,1,1
40732,90,9382,12894,20075,0,0,0,1,1
40733,90,9384,13002,20075,0,0,0,1,1
40734,90,9388,13309,20075,0,0,1,0,1
40735,90,9390,13052;13337,20075,0,0,1,1,2
40736,90,9393,12487;13000,20075,0,0,0,2,2
40737,90,9394,13394;13565,20075,0,0,2,0,2
40738,90,9395,13373;13495,20075,0,0,2,0,2
40739,90,9396,13932;14042,20075,0,0,2,0,2
40740,90,9397,12966;13460,20075,0,0,1,1,2
40741,90,9398,13864,20075,0,0,1,0,1
40742,90,9399,13611;14194,20075,0,0,2,0,2
40743,90,9400,13660;13702,20075,0,0,2,0,2
40744,90,9401,13521;13668,20075,0,0,2,0,2
40745,90,9402,13276;13737;18371;18895,20075,0,0,4,0,4
40746,90,9403,14013,20075,0,0,1,0,1
40747,90,9405,13383;18170;18320,20075,0,0,3,0,3
40748,90,9406,14347;14578;17691,20075,0,0,3,0,3
40749,90,9407,13722;14123,20075,0,0,2,0,2
40750,90,9408,13725;13862,20075,0,0,2,0,2
40751,90,9409,14309;14474,20075,0,0,2,0,2
40752,90,9411,14281,20075,0,0,1,0,1
40753,90,9412,13616;13948,20075,0,0,2,0,2
40754,90,9413,14855;18762;19377,20075,0,1,2,0,3
40755,90,9414,14005,20075,0,0,1,0,1
40756,90,9415,14015;14204;18645;18901,20075,0,0,4,0,4
40757,90,9416,14087;14531,20075,0,0,2,0,2
40758,90,9418,14853;14891,20075,0,0,2,0,2
40759,90,9419,14060;14198,20075,0,0,2,0,2
40760,90,9421,14427;18839,20075,0,0,2,0,2
40761,90,9422,14007;14090,20075,0,0,2,0,2
40762,90,9423,14711;14741;18301;18531,20075,0,0,4,0,4
40763,90,9424,14039;14104;18728,20075,0,0,3,0,3
40764,90,9425,14154;14516,20075,0,0,2,0,2
40765,90,9426,14805;18345;19197,20075,0,1,2,0,3
40766,90,9428,13599;14179;18674,20075,0,0,3,0,3
40767,90,9429,14207;14255;18247;19328,20075,0,1,3,0,4
40768,90,9430,14202,20075,0,0,1,0,1
40769,90,9431,14220,20075,0,0,1,0,1
40770,90,9432,14058;14221,20075,0,0,2,0,2
40771,90,9433,14196;14226,20075,0,0,2,0,2
40772,90,9434,13710;14250,20075,0,0,2,0,2
40773,90,9435,14824;17355;18227;19231,20075,0,1,3,0,4
40774,90,9436,13883;14408;18558;19552,20075,0,1,3,0,4
40775,90,9437,13885;14419,20075,0,0,2,0,2
40776,90,9438,13873;18994,20075,0,0,2,0,2
40777,90,9439,13626;14454;18459,20075,0,0,3,0,3
40778,90,9440,14482,20075,0,0,1,0,1
40779,90,9441,14489;14585,20075,0,0,2,0,2
40780,90,9442,15063;18836;19067,20075,0,0,3,0,3
40781,90,9443,14480;14507,20075,0,0,2,0,2
40782,90,9444,14517,20075,0,0,1,0,1
40783,90,9445,14524,20075,0,0,1,0,1
40784,90,9446,14854;15039;18758,20075,0,0,3,0,3
40785,90,9447,14592;14684;19016,20075,0,0,3,0,3
40786,90,9448,14573;14747;18561,20075,0,0,3,0,3
40787,90,9449,14589;14765,20075,0,0,2,0,2
40788,90,9450,14863;19668,20075,0,1,1,0,2
40789,90,9451,14426;14609,20075,0,0,2,0,2
40790,90,9452,14157;14612;18835;19050,20075,0,0,4,0,4
40791,90,9453,14724,20075,0,0,1,0,1
40792,90,9454,14622,20075,0,0,1,0,1
40793,90,9455,14623,20075,0,0,1,0,1
40794,90,9456,14624;15027;18540,20075,0,0,3,0,3
40795,90,9457,14971,20075,0,0,1,0,1
40796,90,9458,14643;14759;18364,20075,0,0,3,0,3
40797,90,9459,14652;15086;20124,20075,0,1,2,0,3
40798,90,9461,10344,20440,0,0,0,1,1
40799,90,9463,10034,20440,0,0,0,1,1
40800,90,9466,10760,20440,0,0,0,1,1
40801,90,9475,11483;11848,20440,0,0,0,2,2
40802,90,9478,10996,20440,0,0,0,1,1
40803,90,9488,12217,20440,0,0,0,1,1
40804,90,9494,11596;12166,20440,0,0,0,2,2
40805,90,9496,12567;12922,20440,0,0,0,2,2
40806,90,9502,13101;13591,20440,0,0,1,1,2
40807,90,9503,13765,20440,0,0,1,0,1
40808,90,9504,13312;13329,20440,0,0,2,0,2
40809,90,9505,13244;13910,20440,0,0,2,0,2
40810,90,9509,13936;13947;18038,20440,0,0,3,0,3
40811,90,9510,13506;13694;17663,20440,0,0,3,0,3
40812,90,9511,13224;13545,20440,0,0,1,1,2
40813,90,9512,13945;17271,20440,0,0,2,0,2
40814,90,9513,13608;14297;18707,20440,0,0,3,0,3
40815,90,9516,13598;14390;19025,20440,0,0,3,0,3
40816,90,9517,13246;13706,20440,0,0,2,0,2
40817,90,9518,13717;13719,20440,0,0,2,0,2
40818,90,9521,13851;14298;18251,20440,0,0,3,0,3
40819,90,9522,14114;14345,20440,0,0,2,0,2
40820,90,9523,13482;13977;17895,20440,0,0,3,0,3
40821,90,9524,12875;13924,20440,0,0,1,1,2
40822,90,9525,13912;18626,20440,0,0,2,0,2
40823,90,9526,13783;13954;18539,20440,0,0,3,0,3
40824,90,9529,14014;14184,20440,0,0,2,0,2
40825,90,9530,14044;14513;17643,20440,0,0,3,0,3
40826,90,9531,14120;14754;18613,20440,0,0,3,0,3
40827,90,9532,13558;14117,20440,0,0,2,0,2
40828,90,9533,14162;14646,20440,0,0,2,0,2
40829,90,9534,14163;18240,20440,0,0,2,0,2
40830,90,9535,14175;14217;18157;19285,20440,0,1,3,0,4
40831,90,9536,14213;14655;18650,20440,0,0,3,0,3
40832,90,9537,14222;14232,20440,0,0,2,0,2
40833,90,9539,15017;15088;19326,20440,0,1,2,0,3
40834,90,9540,14278;14902,20440,0,0,2,0,2
40835,90,9541,14115;14424;18593,20440,0,0,3,0,3
40836,90,9542,14313;18863,20440,0,0,2,0,2
40837,90,9543,14314;18383;19116,20440,0,1,2,0,3
40838,90,9545,14248;14256,20440,0,0,2,0,2
40839,90,9546,14376;14533;18629,20440,0,0,3,0,3
40840,90,9547,13841;14451;18579,20440,0,0,3,0,3
40841,90,9548,14657;14877;18916;19105;19425,20440,0,1,4,0,5
40842,90,9549,14456,20440,0,0,1,0,1
40843,90,9550,14462;14958;18584;18759,20440,0,0,4,0,4
40844,90,9552,14105;18373,20440,0,0,2,0,2
40845,90,9553,14485,20440,0,0,1,0,1
40846,90,9554,14010;14487,20440,0,0,2,0,2
40847,90,9555,14492;18037;19042,20440,0,0,3,0,3
40848,90,9556,14371;14501;18451,20440,0,0,3,0,3
40849,90,9558,14068;14512;17883,20440,0,0,3,0,3
40850,90,9559,14535;14838;18805;19199,20440,0,1,3,0,4
40851,90,9560,15215;15393;19321,20440,0,1,2,0,3
40852,90,9561,14559;14847;18665;18818,20440,0,0,4,0,4
40853,90,9562,14661,20440,0,0,1,0,1
40854,90,9563,13741;13870;18476,20440,0,0,3,0,3
40855,90,9564,14568;14601,20440,0,0,2,0,2
40856,90,9565,14356;14600;19406,20440,0,1,2,0,3
40857,90,9567,14260;14639;17459,20440,0,0,3,0,3
40858,90,9568,14640;14687;18633,20440,0,0,3,0,3
40859,90,9569,14683;14998,20440,0,0,2,0,2
40860,90,9570,13963;14693,20440,0,0,2,0,2
40861,90,9571,14571;18736,20440,0,0,2,0,2
40862,90,9572,14596;14945;19470,20440,0,1,2,0,3
40863,90,9573,14399;14869;18881,20440,0,0,3,0,3
40864,90,9574,14830;15154;19008,20440,0,0,3,0,3
40865,90,9575,14889;15078;18118;18378,20440,0,0,4,0,4
40866,90,9576,14435;14843;18922,20440,0,0,3,0,3
40867,90,9577,14560;14779,20440,0,0,2,0,2
40868,90,9579,10023,20805,0,0,0,1,1
40869,90,9586,10856,20805,0,0,0,1,1
40870,90,9589,10677,20805,0,0,0,1,1
40871,90,9590,11063,20805,0,0,0,1,1
40872,90,9602,11346;11391,20805,0,0,0,2,2
40873,90,9611,12986;13045,20805,0,0,0,2,2
40874,90,9612,12599,20805,0,0,0,1,1
40875,90,9613,12058;12575,20805,0,0,0,2,2
40876,90,9618,12800;13099,20805,0,0,0,2,2
40877,90,9621,12408;12969,20805,0,0,0,2,2
40878,90,9622,12689;13017,20805,0,0,0,2,2
40879,90,9623,13613,20805,0,0,1,0,1
40880,90,9625,13269;14265;18612;18871,20805,0,0,4,0,4
40881,90,9626,13625;13776;17978;18258;18447,20805,0,0,5,0,5
40882,90,9628,13504,20805,0,0,1,0,1
40883,90,9629,13569;13949,20805,0,0,2,0,2
40884,90,9630,13497;13697,20805,0,0,2,0,2
40885,90,9631,13632;13746,20805,0,0,2,0,2
40886,90,9633,13957;17806;19020,20805,0,0,3,0,3
40887,90,9634,13578;13938;17849,20805,0,0,3,0,3
40888,90,9635,13853;14939;17852,20805,0,0,3,0,3
40889,90,9637,13336;13944;18873,20805,0,0,3,0,3
40890,90,9638,13552;14425,20805,0,0,2,0,2
40891,90,9639,13806;13976,20805,0,0,2,0,2
40892,90,9640,13549;14026,20805,0,0,2,0,2
40893,90,9641,14225;14520,20805,0,0,2,0,2
40894,90,9642,13993;14122,20805,0,0,2,0,2
40895,90,9643,14850;14894;19153,20805,0,1,2,0,3
40896,90,9644,14043;14236;17979;18471,20805,0,0,4,0,4
40897,90,9645,14158;14570;18631;19367,20805,0,1,3,0,4
40898,90,9646,14188;14468,20805,0,0,2,0,2
40899,90,9648,14317;14604;17877,20805,0,0,3,0,3
40900,90,9649,14275,20805,0,0,1,0,1
40901,90,9651,14384;14441;18664,20805,0,0,3,0,3
40902,90,9652,14396,20805,0,0,1,0,1
40903,90,9653,14245;14403,20805,0,0,2,0,2
40904,90,9654,14279;14443,20805,0,0,2,0,2
40905,90,9655,14420;15126;17604;18824,20805,0,0,4,0,4
40906,90,9656,14086;14536,20805,0,0,2,0,2
40907,90,9658,14465;14582,20805,0,0,2,0,2
40908,90,9659,14595;18008;18595;19082;19610,20805,0,1,4,0,5
40909,90,9660,14930,20805,0,0,1,0,1
40910,90,9661,14564;18977,20805,0,0,2,0,2
40911,90,9662,14740;14773,20805,0,0,2,0,2
40912,90,9663,14552;14658,20805,0,0,2,0,2
40913,90,9664,14266;14674,20805,0,0,2,0,2
40914,90,9665,14676;14825;18051;19098,20805,0,0,4,0,4
40915,90,9666,14704;15034;18856,20805,0,0,3,0,3
40916,90,9667,14548;14706,20805,0,0,2,0,2
40917,90,9670,14835;15135;19251,20805,0,1,2,0,3
40918,90,9672,15035,20805,0,0,1,0,1
40919,90,9673,14786;15260;18241,20805,0,0,3,0,3
40920,90,9675,14813;15240,20805,0,0,2,0,2
40921,90,9676,14849;15187,20805,0,0,2,0,2
40922,90,9677,14672;14951;18109,20805,0,0,3,0,3
40923,90,9678,14880;15176;19152,20805,0,1,2,0,3
40924,90,9679,14685;14873,20805,0,0,2,0,2
40925,90,9680,14875,20805,0,0,1,0,1
40926,90,9681,15364;17827;18997,20805,0,0,3,0,3
40927,90,9682,14633;15070;18387;18669,20805,0,0,4,0,4
40928,90,9683,15345,20805,0,0,1,0,1
40929,90,9684,14518;14916;19391,20805,0,1,2,0,3
40930,90,9685,14884;14917,20805,0,0,2,0,2
40931,90,9686,14924;17986;18481,20805,0,0,3,0,3
40932,90,9687,15394,20805,0,0,1,0,1
40933,90,9688,14719;14986;18987,20805,0,0,3,0,3
40934,90,9694,10528,21170,0,0,0,1,1
40935,90,9697,10025,21170,0,0,0,1,1
40936,90,9699,10423,21170,0,0,0,1,1
40937,90,9709,11563;11914,21170,0,0,0,2,2
40938,90,9714,11555;12013,21170,0,0,0,2,2
40939,90,9719,12753;12820,21170,0,0,0,2,2
40940,90,9722,13012;13070;18026,21170,0,0,1,2,3
40941,90,9723,13003;13358,21170,0,0,1,1,2
40942,90,9728,13522;13898,21170,0,0,2,0,2
40943,90,9730,13819;14784,21170,0,0,2,0,2
40944,90,9731,13369;14397,21170,0,0,2,0,2
40945,90,9732,13647;13904;18264;18429,21170,0,0,4,0,4
40946,90,9733,13542;13921,21170,0,0,2,0,2
40947,90,9735,13729;14012;18528,21170,0,0,3,0,3
40948,90,9736,14038;14197,21170,0,0,2,0,2
40949,90,9737,13528;14208,21170,0,0,2,0,2
40950,90,9738,14078;14372,21170,0,0,2,0,2
40951,90,9739,14088,21170,0,0,1,0,1
40952,90,9740,14103;14195;18618,21170,0,0,3,0,3
40953,90,9741,14138;14216;19246,21170,0,1,2,0,3
40954,90,9742,14152;14326;18695;19433,21170,0,1,3,0,4
40955,90,9743,14192;14557;18337;18431,21170,0,0,4,0,4
40956,90,9744,14746;15004;18814,21170,0,0,3,0,3
40957,90,9745,14227;15522;19242,21170,0,1,2,0,3
40958,90,9746,14361;14642;18700;18986,21170,0,0,4,0,4
40959,90,9747,14829;18390;19281,21170,0,1,2,0,3
40960,90,9750,13548;14404,21170,0,0,2,0,2
40961,90,9751,14542;14782;18557;19037,21170,0,0,4,0,4
40962,90,9753,14389;14460,21170,0,0,2,0,2
40963,90,9754,14203;14486,21170,0,0,2,0,2
40964,90,9755,14848;18450,21170,0,0,2,0,2
40965,90,9756,14861;14943;19642,21170,0,1,2,0,3
40966,90,9757,14865;19311,21170,0,1,1,0,2
40967,90,9758,14160;14532;18464,21170,0,0,3,0,3
40968,90,9759,14264;14549,21170,0,0,2,0,2
40969,90,9760,15252;15415;19296,21170,0,1,2,0,3
40970,90,9761,14447;14576,21170,0,0,2,0,2
40971,90,9762,14076;14579,21170,0,0,2,0,2
40972,90,9763,14591;15072;18809;19017,21170,0,0,4,0,4
40973,90,9764,14678;14837;19892,21170,0,1,2,0,3
40974,90,9765,14703;18738;19077,21170,0,0,3,0,3
40975,90,9766,14713;14722,21170,0,0,2,0,2
40976,90,9767,14735;14922;18621,21170,0,0,3,0,3
40977,90,9768,14751;14887;18057;19080,21170,0,0,4,0,4
40978,90,9769,15379;15412;18722;19091,21170,0,0,4,0,4
40979,90,9770,14790;14904,21170,0,0,2,0,2
40980,90,9771,14100;14793;18617,21170,0,0,3,0,3
40981,90,9772,14498;14802,21170,0,0,2,0,2
40982,90,9773,15417;15995;18718;18857;19599;19990,21170,0,2,4,0,6
40983,90,9774,15342;15411;18573;18747,21170,0,0,4,0,4
40984,90,9775,14852;15174;19239,21170,0,1,2,0,3
40985,90,9777,14664;14895;18546;19141,21170,0,1,3,0,4
40986,90,9778,14915;15121;18379;18673;19079,21170,0,0,5,0,5
40987,90,9779,14472;14872,21170,0,0,2,0,2
40988,90,9780,14749;14936,21170,0,0,2,0,2
40989,90,9781,15243;15289;19004,21170,0,0,3,0,3
40990,90,9782,15170;17575;18217;18889,21170,0,0,4,0,4
40991,90,9783,14976;15068;18498;18703;19051,21170,0,0,5,0,5
40992,90,9784,14977;15210;18183;18985,21170,0,0,4,0,4
40993,90,9785,14980;15000;19469,21170,0,1,2,0,3
40994,90,9786,14707;15047,21170,0,0,2,0,2
40995,90,9787,14967;15011;18748;19665,21170,0,1,3,0,4
40996,90,9788,15026;15044;18795,21170,0,0,3,0,3
40997,90,9789,15473;15636;19454;19750;20128,21170,0,3,2,0,5
40998,90,9790,14923;18324,21170,0,0,2,0,2
40999,90,9791,14954;15066,21170,0,0,2,0,2
41000,90,9792,14382;14815,21170,0,0,2,0,2
41001,90,9793,14586;14820;18398;18448,21170,0,0,4,0,4
41002,90,9794,15081;18293,21170,0,0,2,0,2
41003,90,9795,15195;17686;19081,21170,0,0,3,0,3
41004,90,9799,10371,21535,0,0,0,1,1
41005,90,9801,10351,21535,0,0,0,1,1
41006,90,9802,10781,21535,0,0,0,1,1
41007,90,9810,11307,21535,0,0,0,1,1
41008,90,9811,11258,21535,0,0,0,1,1
41009,90,9823,13319,21535,0,0,1,0,1
41010,90,9824,12824;12849,21535,0,0,0,2,2
41011,90,9828,13197;13795,21535,0,0,1,1,2
41012,90,9829,13268;13756;17617;18616,21535,0,0,4,0,4
41013,90,9830,12998;13382,21535,0,0,1,1,2
41014,90,9831,13530,21535,0,0,1,0,1
41015,90,9832,13609,21535,0,0,1,0,1
41016,90,9833,13828;13916;17970,21535,0,0,3,0,3
41017,90,9836,13906;14211;18690,21535,0,0,3,0,3
41018,90,9837,13176;13711,21535,0,0,1,1,2
41019,90,9838,13526;13738,21535,0,0,2,0,2
41020,90,9841,13927;14200,21535,0,0,2,0,2
41021,90,9844,13775;13928,21535,0,0,2,0,2
41022,90,9845,14035;14219,21535,0,0,2,0,2
41023,90,9846,13865;14394;19316,21535,0,1,2,0,3
41024,90,9847,14294;14587,21535,0,0,2,0,2
41025,90,9849,13982;14702;18729,21535,0,0,3,0,3
41026,90,9851,13274;14054;18958,21535,0,0,3,0,3
41027,90,9853,14679;14736;18487;18948,21535,0,0,4,0,4
41028,90,9854,14412,21535,0,0,1,0,1
41029,90,9856,13623;13789,21535,0,0,2,0,2
41030,90,9857,14252;18928,21535,0,0,2,0,2
41031,90,9858,14269;14272,21535,0,0,2,0,2
41032,90,9861,14041;14334,21535,0,0,2,0,2
41033,90,9863,14253;14354;19068,21535,0,0,3,0,3
41034,90,9864,14369;14721;18865;19361,21535,0,1,3,0,4
41035,90,9865,14405,21535,0,0,1,0,1
41036,90,9866,14602,21535,0,0,1,0,1
41037,90,9867,14450;14476,21535,0,0,2,0,2
41038,90,9868,14818;19065,21535,0,0,2,0,2
41039,90,9869,14776;14914;18681;19397,21535,0,1,3,0,4
41040,90,9870,15030,21535,0,0,1,0,1
41041,90,9872,14261;14556,21535,0,0,2,0,2
41042,90,9873,14984;18943;19522,21535,0,1,2,0,3
41043,90,9874,15647;19026,21535,0,0,2,0,2
41044,90,9875,15245;17838;18983,21535,0,0,3,0,3
41045,90,9876,14380;14796,21535,0,0,2,0,2
41046,90,9877,13844;14798,21535,0,0,2,0,2
41047,90,9878,14803;15071;18161;19030,21535,0,0,4,0,4
41048,90,9879,14882;15141,21535,0,0,2,0,2
41049,90,9880,14831;15171;18777;19162,21535,0,1,3,0,4
41050,90,9881,14141;14879;18184,21535,0,0,3,0,3
41051,90,9882,14920;15013,21535,0,0,2,0,2
41052,90,9883,15496;15506;18314;18976,21535,0,0,4,0,4
41053,90,9884,14972;15337,21535,0,0,2,0,2
41054,90,9885,14931;14985;19101;19331,21535,0,1,3,0,4
41055,90,9886,14418;14987;18449,21535,0,0,3,0,3
41056,90,9887,14997;15293;17793;18461,21535,0,0,4,0,4
41057,90,9888,15468;18934;20310,21535,0,1,2,0,3
41058,90,9889,15046;15481;18902,21535,0,0,3,0,3
41059,90,9890,15064;18128,21535,0,0,2,0,2
41060,90,9891,15075;15520;18961,21535,0,0,3,0,3
41061,90,9892,14448;14599;17828,21535,0,0,3,0,3
41062,90,9893,15209;15366;19022,21535,0,0,3,0,3
41063,90,9894,15103;15435,21535,0,0,2,0,2
41064,90,9895,14544;15113;18677,21535,0,0,3,0,3
41065,90,9896,15125;15785;18883;19243,21535,0,1,3,0,4
41066,90,9897,15107;15132;17807,21535,0,0,3,0,3
41067,90,9898,14729;15133,21535,0,0,2,0,2
41068,90,9900,14901;19325,21535,0,1,1,0,2
41069,90,9901,15052;15144;18785;19279,21535,0,1,3,0,4
41070,90,9902,14991;15001;18295;19058,21535,0,0,4,0,4
41071,90,9903,14957;15478;18304;18991,21535,0,0,4,0,4
41072,90,9904,14973;15202,21535,0,0,2,0,2
41073,90,9906,10045,21900,0,0,0,1,1
41074,90,9913,10892,21900,0,0,0,1,1
41075,90,9915,11695,21900,0,0,0,1,1
41076,90,9917,11668;11739,21900,0,0,0,2,2
41077,90,9918,11238,21900,0,0,0,1,1
41078,90,9921,11857;11910,21900,0,0,0,2,2
41079,90,9925,12088,21900,0,0,0,1,1
41080,90,9927,12163;12636,21900,0,0,0,2,2
41081,90,9928,12114,21900,0,0,0,1,1
41082,90,9929,12758,21900,0,0,0,1,1
41083,90,9943,13114;13417,21900,0,0,1,1,2
41084,90,9945,13353;13812,21900,0,0,2,0,2
41085,90,9948,13413;14049;18572,21900,0,0,3,0,3
41086,90,9950,13425;13845,21900,0,0,2,0,2
41087,90,9955,13557;13887;17822,21900,0,0,3,0,3
41088,90,9959,14016;14342,21900,0,0,2,0,2
41089,90,9961,14234;14271;18458;18767,21900,0,0,4,0,4
41090,90,9962,14178,21900,0,0,1,0,1
41091,90,9963,14668;15094;18308,21900,0,0,3,0,3
41092,90,9964,14239;14367;18754,21900,0,0,3,0,3
41093,90,9966,14355,21900,0,0,1,0,1
41094,90,9967,14379;14716,21900,0,0,2,0,2
41095,90,9968,14395;19163,21900,0,1,1,0,2
41096,90,9970,14597,21900,0,0,1,0,1
41097,90,9971,14378;14495,21900,0,0,2,0,2
41098,90,9972,14119;14525;19164,21900,0,1,2,0,3
41099,90,9973,14393;14528;18905,21900,0,0,3,0,3
41100,90,9974,14555;14982;18884;19374,21900,0,1,3,0,4
41101,90,9975,15106;19007,21900,0,0,2,0,2
41102,90,9976,14621;14665;18141;18488,21900,0,0,4,0,4
41103,90,9978,14598;14870;18532,21900,0,0,3,0,3
41104,90,9979,14662;15007;18333;18585;18651;18887;19265;19444,21900,0,2,6,0,8
41105,90,9980,14173;14690;17899;18872;19286,21900,0,1,4,0,5
41106,90,9982,14051;14762;18647;19095,21900,0,0,4,0,4
41107,90,9983,14515;15320;18717;19711;19952,21900,0,2,3,0,5
41108,90,9984,14561;14845;18267,21900,0,0,3,0,3
41109,90,9985,15380;19036;19379;20327,21900,0,2,2,0,4
41110,90,9986,14506;14903;18787,21900,0,0,3,0,3
41111,90,9987,15462;15474;19806,21900,0,1,2,0,3
41112,90,9988,14905;15253;18030,21900,0,0,3,0,3
41113,90,9990,14919;15032;19415,21900,0,1,2,0,3
41114,90,9991,14932;15418;19354,21900,0,1,2,0,3
41115,90,9993,14933;18123;19362,21900,0,1,2,0,3
41116,90,9994,14807;14975;19011,21900,0,0,3,0,3
41117,90,9995,14978;15186;19464,21900,0,1,2,0,3
41118,90,9996,14992;15134;18347;18812;19590,21900,0,1,4,0,5
41119,90,9998,15334;15605,21900,0,0,2,0,2
41120,90,9999,15024;15244,21900,0,0,2,0,2
41121,90,10000,15025,21900,0,0,1,0,1
41122,90,10001,15688;19466;20102,21900,0,2,1,0,3
41123,90,10002,14720;15116;19284,21900,0,1,2,0,3
41124,90,10003,14714;15128;19148;19530,21900,0,2,2,0,4
41125,90,10004,15110;15709;19303,21900,0,1,2,0,3
41126,90,10007,15155;15808;18388;18810;19340,21900,0,1,4,0,5
41127,90,10008,14247;15162;18637,21900,0,0,3,0,3
41128,90,10009,15149;15408;18401;19066,21900,0,0,4,0,4
41129,90,10010,15055;15181,21900,0,0,2,0,2
41130,90,10011,17932,21900,0,0,1,0,1
41131,90,10012,15016;15217,21900,0,0,2,0,2
41132,90,10013,14500;15220;18920,21900,0,0,3,0,3
41133,90,10014,15261;18090,21900,0,0,2,0,2
41134,90,10017,15357;15719;17854;18174;19330;19822,21900,0,2,4,0,6
41135,90,10018,15358;15377;19167,21900,0,1,2,0,3
41136,90,10019,15359;15512;18015;18535;19547,21900,0,1,4,0,5
41137,90,10020,14438;15361;18408;19766,21900,0,1,3,0,4
41138,90,10021,14608;15368;19096;19542,21900,0,1,3,0,4
41139,90,10023,15381;15516;18735;18918;19437,21900,0,1,4,0,5
41140,90,10024,15396;15451;19031,21900,0,0,3,0,3
41141,90,10030,11018,22265,0,0,0,1,1
41142,90,10031,10915,22265,0,0,0,1,1
41143,90,10036,12029,22265,0,0,0,1,1
41144,90,10038,11564,22265,0,0,0,1,1
41145,90,10040,12021;12148,22265,0,0,0,2,2
41146,90,10043,12923,22265,0,0,0,1,1
41147,90,10044,12872,22265,0,0,0,1,1
41148,90,10045,12616;12860,22265,0,0,0,2,2
41149,90,10049,13780;13857,22265,0,0,2,0,2
41150,90,10053,13355;13953;18456,22265,0,0,3,0,3
41151,90,10055,13550;14235,22265,0,0,2,0,2
41152,90,10056,13509;13995;19615,22265,0,1,2,0,3
41153,90,10058,13842;14273,22265,0,0,2,0,2
41154,90,10059,13464;13843;18327;18523,22265,0,0,4,0,4
41155,90,10060,13881;14020;18297,22265,0,0,3,0,3
41156,90,10061,14228;18957,22265,0,0,2,0,2
41157,90,10062,14018,22265,0,0,1,0,1
41158,90,10063,14066;14094;18424,22265,0,0,3,0,3
41159,90,10064,14302;14761,22265,0,0,2,0,2
41160,90,10065,13822;13974,22265,0,0,2,0,2
41161,90,10066,14540,22265,0,0,1,0,1
41162,90,10067,13595;14109;19227,22265,0,1,2,0,3
41163,90,10068,14023;14246,22265,0,0,2,0,2
41164,90,10070,14416;14583;19255,22265,0,1,2,0,3
41165,90,10071,14588;15206,22265,0,0,2,0,2
41166,90,10072,14909;18697;19287,22265,0,1,2,0,3
41167,90,10073,14770;15056;19212,22265,0,1,2,0,3
41168,90,10074,14329;14431;17796;18536,22265,0,0,4,0,4
41169,90,10076,14262;14841,22265,0,0,2,0,2
41170,90,10077,14526;15098,22265,0,0,2,0,2
41171,90,10078,14553;14653;18265;18622,22265,0,0,4,0,4
41172,90,10080,14493;14616;18509,22265,0,0,3,0,3
41173,90,10081,14656;15033;18880,22265,0,0,3,0,3
41174,90,10082,14663;15650;17862,22265,0,0,3,0,3
41175,90,10083,14699;15189,22265,0,0,2,0,2
41176,90,10084,14890;14970,22265,0,0,2,0,2
41177,90,10085,14214;14731;19142,22265,0,1,2,0,3
41178,90,10086,14752;15422;20089,22265,0,1,2,0,3
41179,90,10087,14757;18236,22265,0,0,2,0,2
41180,90,10088,14258;14422,22265,0,0,2,0,2
41181,90,10089,14792;15525;18442;18876;19350,22265,0,1,4,0,5
41182,90,10090,14691;15247;18966;19147,22265,0,1,3,0,4
41183,90,10093,15120,22265,0,0,1,0,1
41184,90,10094,14888;19289,22265,0,1,1,0,2
41185,90,10095,14816;14907;18499,22265,0,0,3,0,3
41186,90,10096,15413;15681;19202;19385,22265,0,2,2,0,4
41187,90,10097,14963,22265,0,0,1,0,1
41188,90,10098,15802;18807,22265,0,0,2,0,2
41189,90,10099,14574;14983,22265,0,0,2,0,2
41190,90,10101,15019;15029;19120,22265,0,1,2,0,3
41191,90,10102,15054;15131;18781,22265,0,0,3,0,3
41192,90,10103,15287,22265,0,0,1,0,1
41193,90,10104,15012;15285,22265,0,0,2,0,2
41194,90,10105,15142;18181,22265,0,0,2,0,2
41195,90,10106,14953,22265,0,0,1,0,1
41196,90,10107,15161;19268;19678,22265,0,2,1,0,3
41197,90,10108,15182;19587,22265,0,1,1,0,2
41198,90,10109,15188;15395,22265,0,0,2,0,2
41199,90,10110,15557;18801;18885,22265,0,0,3,0,3
41200,90,10111,15200;16031;19182;19548;20135,22265,0,3,2,0,5
41201,90,10112,14926;15203;18760;19178,22265,0,1,3,0,4
41202,90,10113,14191;15207,22265,0,0,2,0,2
41203,90,10114,15504;15806;19045;19254,22265,0,1,3,0,4
41204,90,10115,15228;15628;18330;18675;19314,22265,0,1,4,0,5
41205,90,10116,15229;15495;20136,22265,0,1,2,0,3
41206,90,10117,14940;15230;18926,22265,0,0,3,0,3
41207,90,10118,14836;15237;19941,22265,0,1,2,0,3
41208,90,10119,15239;15410;19558,22265,0,1,2,0,3
41209,90,10121,15884;19263,22265,0,1,1,0,2
41210,90,10122,15278;15826;18619;18908;20375,22265,0,1,4,0,5
41211,90,10123,15279;15751;19451,22265,0,1,2,0,3
41212,90,10124,15282;15682;19160,22265,0,1,2,0,3
41213,90,10125,15283;15457;19657,22265,0,1,2,0,3
41214,90,10126,15698;15819;19666;20302,22265,0,2,2,0,4
41215,90,10127,15002;15299;18376;19064,22265,0,0,4,0,4
41216,90,10128,15152;15327;19647,22265,0,1,2,0,3
41217,90,10129,15332;18003,22265,0,0,2,0,2
41218,90,10130,15146;15347;19192,22265,0,1,2,0,3
41219,90,10131,15351;15613;17907;19692,22265,0,1,3,0,4
41220,90,10133,15609;15641,22265,0,0,2,0,2
41221,90,10134,15407;15455;18771;19369;20482,22265,0,2,3,0,5
41222,90,10135,15401;15934;18222;18463,22265,0,0,4,0,4
41223,90,10136,15414;15769,22265,0,0,2,0,2
41224,90,10137,15437;15598;19250;20606,22265,1,1,2,0,4
41225,90,10138,15447;15938;18973,22265,0,0,3,0,3
41226,90,10139,14965;15454;20051,22265,0,1,2,0,3
41227,90,10141,15471;15477;19157,22265,0,1,2,0,3
41228,90,10142,15482;19626,22265,0,1,1,0,2
41229,90,10143,15430;15498;18782;18892,22265,0,0,4,0,4
41230,90,10144,15505;15556;18020;19103,22265,0,0,4,0,4
41231,90,10145,15509;15657;19495,22265,0,1,2,0,3
41232,90,10146,15416;19804,22265,0,1,1,0,2
41233,90,10156,11305,22630,0,0,0,1,1
41234,90,10158,11150;11392,22630,0,0,0,2,2
41235,90,10175,12866;12871,22630,0,0,0,2,2
41236,90,10178,13140,22630,0,0,0,1,1
41237,90,10183,12782;13020,22630,0,0,0,2,2
41238,90,10187,13579;13731;18357,22630,0,0,3,0,3
41239,90,10188,13458;13769,22630,0,0,2,0,2
41240,90,10192,13907;13997,22630,0,0,2,0,2
41241,90,10193,13959;14452,22630,0,0,2,0,2
41242,90,10196,14610;15259,22630,0,0,2,0,2
41243,90,10197,14558;14763;18701,22630,0,0,3,0,3
41244,90,10199,13600;14187,22630,0,0,2,0,2
41245,90,10200,14223;14479,22630,0,0,2,0,2
41246,90,10201,13835;14491,22630,0,0,2,0,2
41247,90,10203,14569;14859;19635,22630,0,1,2,0,3
41248,90,10204,14733,22630,0,0,1,0,1
41249,90,10205,13960;14554;19014,22630,0,0,3,0,3
41250,90,10207,15061;18716;18776,22630,0,0,3,0,3
41251,90,10208,13903;14628;18541,22630,0,0,3,0,3
41252,90,10209,14697;14840;18696;19214,22630,0,1,3,0,4
41253,90,10210,14449;14650,22630,0,0,2,0,2
41254,90,10211,14654;14952;17886,22630,0,0,3,0,3
41255,90,10212,14024;14659;17945;18789,22630,0,0,4,0,4
41256,90,10213,14681;15444,22630,0,0,2,0,2
41257,90,10215,14710;15465;19460,22630,0,1,2,0,3
41258,90,10216,14726;17955,22630,0,0,2,0,2
41259,90,10218,14748;15101;18105;19023,22630,0,0,4,0,4
41260,90,10219,14876;19052,22630,0,0,2,0,2
41261,90,10220,13849,22630,0,0,1,0,1
41262,90,10221,15272;15779;17925;19849,22630,0,1,3,0,4
41263,90,10223,14562;14833;18205,22630,0,0,3,0,3
41264,90,10224,15031;15623;18868;18894,22630,0,0,4,0,4
41265,90,10226,14948;15090;18845;19677,22630,0,1,3,0,4
41266,90,10227,15008;15460,22630,0,0,2,0,2
41267,90,10228,15458;20285,22630,0,1,1,0,2
41268,90,10229,15058;15544,22630,0,0,2,0,2
41269,90,10231,15296,22630,0,0,1,0,1
41270,90,10232,14937;15180;18024;19041;19132,22630,0,1,4,0,5
41271,90,10233,15201;15214,22630,0,0,2,0,2
41272,90,10234,14928;15213;18960,22630,0,0,3,0,3
41273,90,10235,15300;15607;18211,22630,0,0,3,0,3
41274,90,10236,15317;15517;18891;19339;19536,22630,0,2,3,0,5
41275,90,10237,14787;15319,22630,0,0,2,0,2
41276,90,10239,15123;15329;17997;18321;19341,22630,0,1,4,0,5
41277,90,10240,15371;15902;20298,22630,0,1,2,0,3
41278,90,10241,15067;15384;19293,22630,0,1,2,0,3
41279,90,10242,15093;15406;19364;19661,22630,0,2,2,0,4
41280,90,10243,15423;19270,22630,0,1,1,0,2
41281,90,10244,15448;18930,22630,0,0,2,0,2
41282,90,10245,15453;18778,22630,0,0,2,0,2
41283,90,10246,15713;18791,22630,0,0,2,0,2
41284,90,10247,15463;15790;19184;19368;19787,22630,0,3,2,0,5
41285,90,10248,15452;18741;19195,22630,0,1,2,0,3
41286,90,10249,15097;15497;18204,22630,0,0,3,0,3
41287,90,10250,15404;15788,22630,0,0,2,0,2
41288,90,10251,15538;15678;18234;18816,22630,0,0,4,0,4
41289,90,10252,15554;15935;17993;19021;20072,22630,0,1,4,0,5
41290,90,10253,15514;15558;19384;19638,22630,0,2,2,0,4
41291,90,10254,15568,22630,0,0,1,0,1
41292,90,10255,15433;15569;18813;19054;19979,22630,0,1,4,0,5
41293,90,10256,14886;15488;19181,22630,0,1,2,0,3
41294,90,10259,10618,22995,0,0,0,1,1
41295,90,10266,10860;11078,22995,0,0,0,2,2
41296,90,10267,11300;11487,22995,0,0,0,2,2
41297,90,10273,11297;11352,22995,0,0,0,2,2
41298,90,10276,11591;11862,22995,0,0,0,2,2
41299,90,10285,12150,22995,0,0,0,1,1
41300,90,10288,12012,22995,0,0,0,1,1
41301,90,10297,13630,22995,0,0,1,0,1
41302,90,10303,13444;14046;18268;18468,22995,0,0,4,0,4
41303,90,10307,14199;14242,22995,0,0,2,0,2
41304,90,10310,14337;18581,22995,0,0,2,0,2
41305,90,10311,14032;14767;18768,22995,0,0,3,0,3
41306,90,10313,14308;15042;18311;18864;19112,22995,0,1,4,0,5
41307,90,10314,14846;15043;18936;19209,22995,0,1,3,0,4
41308,90,10315,14288;14429,22995,0,0,2,0,2
41309,90,10317,14409;14577,22995,0,0,2,0,2
41310,90,10318,13943;14632;19069,22995,0,0,3,0,3
41311,90,10319,14637;18587,22995,0,0,2,0,2
41312,90,10320,14108;14638;18780;18923;19149,22995,0,1,4,0,5
41313,90,10321,15374;15507;18734,22995,0,0,3,0,3
41314,90,10322,13886;14375,22995,0,0,2,0,2
41315,90,10323,14415;14772;18552;18743;18834,22995,0,0,5,0,5
41316,90,10324,14817;14990;18397;18953,22995,0,0,4,0,4
41317,90,10325,14611;14961;18639,22995,0,0,3,0,3
41318,90,10326,15536;15754;19439;19526,22995,0,2,2,0,4
41319,90,10327,14842;15321,22995,0,0,2,0,2
41320,90,10328,15057;15548,22995,0,0,2,0,2
41321,90,10329,15649;15734;19282;19453;20273,22995,0,3,2,0,5
41322,90,10330,14466;14867;18927,22995,0,0,3,0,3
41323,90,10331,15196;15579;18430;18678;19158,22995,0,1,4,0,5
41324,90,10332,15159;15212;18942,22995,0,0,3,0,3
41325,90,10333,15160;15223;19702,22995,0,1,2,0,3
41326,90,10334,15227;15340;19457,22995,0,1,2,0,3
41327,90,10335,15576;15895;19408,22995,0,1,2,0,3
41328,90,10336,15104;15281;19550,22995,0,1,2,0,3
41329,90,10337,14421;15322;19210,22995,0,1,2,0,3
41330,90,10338,15333;15855;19630,22995,0,1,2,0,3
41331,90,10339,14775;15918;18065;19237;19419;19471;20220,22995,0,4,3,0,7
41332,90,10340,15356;15515;19063;19234,22995,0,1,3,0,4
41333,90,10341,14857;15363;19190,22995,0,1,2,0,3
41334,90,10342,15689;19402;19620,22995,0,2,1,0,3
41335,90,10343,15491;15887;19363;19562,22995,0,2,2,0,4
41336,90,10344,15494;18542,22995,0,0,2,0,2
41337,90,10345,15503;15842,22995,0,0,2,0,2
41338,90,10346,15814,22995,0,0,1,0,1
41339,90,10347,15518;15707;18900;19410,22995,0,1,3,0,4
41340,90,10348,15533;15829;18659;19256,22995,0,1,3,0,4
41341,90,10349,15638;15967;18085;19535;19655,22995,0,2,3,0,5
41342,90,10350,15392;15541;19143;19223,22995,0,2,2,0,4
41343,90,10351,15549;15667;19193;19333;20056,22995,0,3,2,0,5
41344,90,10352,15562;15964;18828,22995,0,0,3,0,3
41345,90,10353,15267;15575;18257;19528,22995,0,1,3,0,4
41346,90,10354,15310;15588;19248,22995,0,1,2,0,3
41347,90,10355,15611;15889;18521;18911,22995,0,0,4,0,4
41348,90,10356,15431;15626;18064,22995,0,0,3,0,3
41349,90,10357,15545;15629;19276,22995,0,1,2,0,3
41350,90,10358,15645;18316,22995,0,0,2,0,2
41351,90,10359,16155;18981;20560,22995,1,0,2,0,3
41352,90,10360,15530;16029;18687,22995,0,0,3,0,3
41353,90,10361,15441;15676;18666;19416,22995,0,1,3,0,4
41354,90,10362,15511;16179;18117;19084;19908,22995,0,1,4,0,5
41355,90,10363,15263;15973;18216;18480,22995,0,0,4,0,4
41356,90,10364,15949;16020;18663;19027;19561,22995,0,1,4,0,5
41357,90,10365,15959;16024;19329;19365,22995,0,2,2,0,4
41358,90,10366,16067;16076;20137;20898,22995,1,1,2,0,4
41359,90,10367,15758;18187;19782;19978,22995,0,2,2,0,4
41360,90,10368,15564;15761;20262,22995,0,1,2,0,3
41361,90,10369,15766;16041;18982;19124,22995,0,1,3,0,4
41362,90,10370,15254;15772,22995,0,0,2,0,2
41363,90,10371,14995;15782;19109;19729,22995,0,2,2,0,4
41364,90,10372,15122;15786;18970;19840,22995,0,1,3,0,4
41365,90,10373,15794;15888,22995,0,0,2,0,2
41366,90,10374,15527,22995,0,0,1,0,1
41367,90,10379,10951;11120,23360,0,0,0,2,2
41368,90,10380,10761,23360,0,0,0,1,1
41369,90,10383,11308,23360,0,0,0,1,1
41370,90,10384,11351,23360,0,0,0,1,1
41371,90,10386,10718,23360,0,0,0,1,1
41372,90,10389,10948,23360,0,0,0,1,1
41373,90,10392,11611,23360,0,0,0,1,1
41374,90,10397,12227,23360,0,0,0,1,1
41375,90,10403,12395,23360,0,0,0,1,1
41376,90,10406,13029;13527,23360,0,0,1,1,2
41377,90,10408,13111,23360,0,0,0,1,1
41378,90,10410,13360;13751,23360,0,0,2,0,2
41379,90,10412,13505;13692,23360,0,0,2,0,2
41380,90,10416,14619,23360,0,0,1,0,1
41381,90,10418,14617;19428,23360,0,1,1,0,2
41382,90,10420,14809;14871;18751,23360,0,0,3,0,3
41383,90,10421,14147;14336,23360,0,0,2,0,2
41384,90,10423,14181;14360;18946,23360,0,0,3,0,3
41385,90,10424,14523,23360,0,0,1,0,1
41386,90,10428,14335;14543;18749,23360,0,0,3,0,3
41387,90,10429,14510;14541;18783,23360,0,0,3,0,3
41388,90,10430,14810;15060;19139,23360,0,1,2,0,3
41389,90,10431,14529;14780,23360,0,0,2,0,2
41390,90,10432,14304;14921;18549,23360,0,0,3,0,3
41391,90,10433,14682,23360,0,0,1,0,1
41392,90,10434,14794;15091,23360,0,0,2,0,2
41393,90,10435,14892;15294;19486;19832,23360,0,2,2,0,4
41394,90,10437,14962;15021;18325;19292,23360,0,1,3,0,4
41395,90,10439,15365;18632;19200;19564,23360,0,2,2,0,4
41396,90,10440,15921;18410;18755;19334,23360,0,1,3,0,4
41397,90,10441,15421;18724;18959;20017,23360,0,1,3,0,4
41398,90,10442,15065;15112;18933;19009;20045,23360,0,1,4,0,5
41399,90,10443,15147;15403;18422;19353;19740,23360,0,2,3,0,5
41400,90,10444,15082;15119;18937;19144,23360,0,1,3,0,4
41401,90,10445,15130;15632;18292;18825;20006,23360,0,1,4,0,5
41402,90,10446,15309;15633,23360,0,0,2,0,2
41403,90,10447,15634;15901;19240;19436,23360,0,2,2,0,4
41404,90,10448,14929;15151;18799;19387,23360,0,1,3,0,4
41405,90,10450,14981;15175;18990,23360,0,0,3,0,3
41406,90,10451,14885;15211;18289;19775,23360,0,1,3,0,4
41407,90,10452,15219;15822;19203,23360,0,1,2,0,3
41408,90,10453,15443;18745;19680,23360,0,1,2,0,3
41409,90,10454,15637;15919;19087,23360,0,0,3,0,3
41410,90,10455,15014;15335;18465;18630;19505,23360,0,1,4,0,5
41411,90,10457,15705;15863;18526;18841,23360,0,0,4,0,4
41412,90,10458,15770;16008;18996;19736,23360,0,1,3,0,4
41413,90,10459,15499;15701;18454;19510,23360,0,1,3,0,4
41414,90,10460,14974;15439;18861;19633,23360,0,1,3,0,4
41415,90,10461,15177;15440,23360,0,0,2,0,2
41416,90,10462,14935;15750;18460;18607;18829;19758,23360,0,1,5,0,6
41417,90,10463,15521;15936;18556;18803,23360,0,0,4,0,4
41418,90,10464,14603;15566;19319;19438,23360,0,2,2,0,4
41419,90,10465,15979;19864,23360,0,1,1,0,2
41420,90,10466,15580;18455;18827,23360,0,0,3,0,3
41421,90,10467,15519;15583;18764,23360,0,0,3,0,3
41422,90,10468,15589;15939;19222;19728,23360,0,2,2,0,4
41423,90,10469,15593;16043;19860,23360,0,1,2,0,3
41424,90,10470,15606;18860;19093;19847;20286,23360,0,2,3,0,5
41425,90,10471,15811;15952;19089;19388,23360,0,1,3,0,4
41426,90,10472,15692;19538;19718,23360,0,2,1,0,3
41427,90,10473,15655;16288;19039;19252;19872,23360,0,2,3,0,5
41428,90,10474,15697;16026;19474;20014;20621,23360,1,2,2,0,5
41429,90,10475,15658;18534;18757;18978,23360,0,0,4,0,4
41430,90,10476,15360;16053;20245;20513,23360,0,2,2,0,4
41431,90,10477,15675,23360,0,0,1,0,1
41432,90,10478,15513;15686;18231,23360,0,0,3,0,3
41433,90,10479,15006;15718,23360,0,0,2,0,2
41434,90,10480,16134;18858;20221,23360,0,1,2,0,3
41435,90,10482,15183;15738,23360,0,0,2,0,2
41436,90,10483,15743;16057;19062;19529,23360,0,1,3,0,4
41437,90,10484,15534;15749,23360,0,0,2,0,2
41438,90,10485,15484;15784;18843;19168,23360,0,1,3,0,4
41439,90,10486,15984;19233;19593,23360,0,2,1,0,3
41440,90,10487,15812;16203;19125;19394,23360,0,2,2,0,4
41441,90,10488,15839;15968;19049;20986,23360,1,0,3,0,4
41442,90,10489,15570;16223;18178;19386;19713,23360,0,2,3,0,5
41443,90,10490,15752;15879;19220,23360,0,1,2,0,3
41444,90,10491,15850;16005;18938;19215,23360,0,1,3,0,4
41445,90,10492,15860;16168;18253;18907;20026,23360,0,1,4,0,5
41446,90,10493,15702;15876;20032;20167,23360,0,2,2,0,4
41447,90,10494,15914;16125;18954,23360,0,0,3,0,3
41448,90,10495,15735;18763;19308;19521,23360,0,2,2,0,4
41449,90,10496,15765;15925;18956;19228;20484,23360,0,2,3,0,5
41450,90,10499,10982,23725,0,0,0,1,1
41451,90,10504,11467,23725,0,0,0,1,1
41452,90,10519,13069,23725,0,0,0,1,1
41453,90,10520,12703,23725,0,0,0,1,1
41454,90,10531,13649;13869,23725,0,0,2,0,2
41455,90,10534,13745;14350,23725,0,0,2,0,2
41456,90,10536,14645;18335;18831,23725,0,0,3,0,3
41457,90,10541,14257;14388,23725,0,0,2,0,2
41458,90,10543,14484;14766;19085,23725,0,0,3,0,3
41459,90,10544,15290,23725,0,0,1,0,1
41460,90,10546,14750,23725,0,0,1,0,1
41461,90,10548,14625;14667;19170,23725,0,1,2,0,3
41462,90,10549,14814;14999;18654,23725,0,0,3,0,3
41463,90,10550,14899;15573,23725,0,0,2,0,2
41464,90,10551,15312;18349;19166;19685,23725,0,2,2,0,4
41465,90,10552,14955;15464,23725,0,0,2,0,2
41466,90,10554,14993,23725,0,0,1,0,1
41467,90,10556,14620;15148;19110;19716,23725,0,2,2,0,4
41468,90,10557,15190;16201;19048;19903,23725,0,1,3,0,4
41469,90,10558,15236;18624,23725,0,0,2,0,2
41470,90,10559,14959;15604;19913,23725,0,1,2,0,3
41471,90,10564,16070;18945,23725,0,0,2,0,2
41472,90,10565,15446;15797,23725,0,0,2,0,2
41473,90,10566,15469;16293;18914;20446,23725,0,1,3,0,4
41474,90,10567,15726;16055;19879,23725,0,1,2,0,3
41475,90,10568,15434;18719;18874;19216,23725,0,1,3,0,4
41476,90,10570,16182;16314;18688;19463;20300,23725,0,2,3,0,5
41477,90,10571,16114;20530;21029,23725,2,0,1,0,3
41478,90,10572,15584,23725,0,0,1,0,1
41479,90,10573,15591;18817;19113,23725,0,1,2,0,3
41480,90,10574,15666;19660;20517,23725,1,1,1,0,3
41481,90,10575,15757;16283;19342;19907,23725,0,2,2,0,4
41482,90,10576,15710;15795,23725,0,0,2,0,2
41483,90,10577,16036;16131;20228,23725,0,1,2,0,3
41484,90,10578,15774;16092;19797;20775,23725,1,1,2,0,4
41485,90,10581,15438;15900;19075,23725,0,0,3,0,3
41486,90,10582,15561;15903;19165;19412,23725,0,2,2,0,4
41487,90,10583,16376;18409;18559;19681,23725,0,1,3,0,4
41488,90,10584,15486;16163;18517;18560;20002;20168,23725,0,2,4,0,6
41489,90,10585,15238;15976;18931;20353,23725,0,1,3,0,4
41490,90,10586,15978;16229;19988,23725,0,1,2,0,3
41491,90,10587,16006;16159;18514;19005;19344;20923,23725,1,1,4,0,6
41492,90,10588,15156;16042;18820;20096,23725,0,1,3,0,4
41493,90,10589,16054;18826,23725,0,0,2,0,2
41494,90,10591,10852,24090,0,0,0,1,1
41495,90,10592,10886,24090,0,0,0,1,1
41496,90,10601,11641,24090,0,0,0,1,1
41497,90,10602,11381,24090,0,0,0,1,1
41498,90,10604,12089,24090,0,0,0,1,1
41499,90,10621,12952,24090,0,0,0,1,1
41500,90,10622,13127,24090,0,0,0,1,1
41501,90,10629,12995;13798,24090,0,0,1,1,2
41502,90,10638,13778;14386,24090,0,0,2,0,2
41503,90,10640,13854;14295,24090,0,0,2,0,2
41504,90,10642,14176;14739,24090,0,0,2,0,2
41505,90,10645,14563;14797,24090,0,0,2,0,2
41506,90,10647,14742,24090,0,0,1,0,1
41507,90,10648,14774;14834,24090,0,0,2,0,2
41508,90,10649,14357;14864;18440;18842,24090,0,0,4,0,4
41509,90,10650,14918;15274;18667,24090,0,0,3,0,3
41510,90,10651,15036,24090,0,0,1,0,1
41511,90,10653,14744;14966,24090,0,0,2,0,2
41512,90,10655,15117;15143;19628,24090,0,1,2,0,3
41513,90,10656,14944;15721;18798;19601,24090,0,1,3,0,4
41514,90,10657,14783;15163;19010,24090,0,0,3,0,3
41515,90,10659,15208;18545;18984,24090,0,0,3,0,3
41516,90,10661,15231;15502;19541,24090,0,1,2,0,3
41517,90,10662,14893;15233;18756;19512,24090,0,1,3,0,4
41518,90,10663,15585;16065;19825;20043,24090,0,2,2,0,4
41519,90,10664,15251;15639;19399;19586,24090,0,2,2,0,4
41520,90,10665,15592;15620;18855;19071;20038,24090,0,1,4,0,5
41521,90,10666,15362;15892;18790;19299;19422;19881,24090,0,3,3,0,6
41522,90,10667,14826;15316,24090,0,0,2,0,2
41523,90,10668,15827;19478;19857,24090,0,2,1,0,3
41524,90,10669,15945;16325;18788;19498;20140,24090,0,2,3,0,5
41525,90,10670,15601;15810;18444;18620,24090,0,0,4,0,4
41526,90,10671,15961;16077;18832;18992;19664,24090,0,1,4,0,5
41527,90,10672,16045;16238;20132,24090,0,1,2,0,3
41528,90,10673,15179;15565;19076;19300,24090,0,1,3,0,4
41529,90,10674,15668,24090,0,0,1,0,1
41530,90,10675,14994;15614;18415,24090,0,0,3,0,3
41531,90,10676,15166;15616;19417;19679,24090,0,2,2,0,4
41532,90,10677,15627;16004;20062,24090,0,1,2,0,3
41533,90,10678,15644;15764;19937,24090,0,1,2,0,3
41534,90,10679,15646;16183;19480;19965,24090,0,2,2,0,4
41535,90,10680,15652;16128;19301;19994,24090,0,2,2,0,4
41536,90,10681,15661;16232;19790;20464,24090,0,2,2,0,4
41537,90,10682,15733;15854;19643,24090,0,1,2,0,3
41538,90,10683,15729;15825;19400;19592,24090,0,2,2,0,4
41539,90,10684,15559;15771,24090,0,0,2,0,2
41540,90,10685,14856;15817,24090,0,0,2,0,2
41541,90,10686,15789;15970;19616;19823,24090,0,2,2,0,4
41542,90,10687,16028;19297;19434;19732,24090,0,3,1,0,4
41543,90,10688,15927;16071;18929;19420;19603,24090,0,2,3,0,5
41544,90,10689,15532;15831;19441,24090,0,1,2,0,3
41545,90,10690,15856;16171;20573;20745,24090,2,0,2,0,4
41546,90,10691,16021;19768;20040,24090,0,2,1,0,3
41547,90,10692,15911;16226;19440;20424,24090,0,2,2,0,4
41548,90,10693,15912;16393;18569,24090,0,0,3,0,3
41549,90,10694,15352;16186;18935;19186,24090,0,1,3,0,4
41550,90,10695,15924;16278;19607;20255,24090,0,2,2,0,4
41551,90,10696,15997;19310;19649;20009,24090,0,3,1,0,4
41552,90,10697,15796;16405;18516;18726;19448,24090,0,1,4,0,5
41553,90,10698,16471;18811;19002;19813;19995,24090,0,2,3,0,5
41554,90,10699,16147;20019;20189;21001,24090,1,2,1,0,4
41555,90,10700,15885;16022;18553;18882,24090,0,0,4,0,4
41556,90,10701,15198;16023;19462;19691,24090,0,2,2,0,4
41557,90,10702,15459;16030;18363;18548;18847,24090,0,0,5,0,5
41558,90,10703,15818;16236;19262;19648,24090,0,2,2,0,4
41559,90,10704,15690;16227;19572;19795,24090,0,2,2,0,4
41560,90,10705,16250;16438;19534;20086,24090,0,2,2,0,4
41561,90,10706,16050;16195;18711;19723,24090,0,1,3,0,4
41562,90,10707,16087;16129;18800;19189;20046,24090,0,2,3,0,5
41563,90,10708,16105;16309;19473;20169,24090,0,2,2,0,4
41564,90,10709,16121;16479;18318;18602;18731,24090,0,0,5,0,5
41565,90,10710,16122;16265;18661;18886,24090,0,0,4,0,4
41566,90,10711,15731;16140;20121;20756,24090,1,1,2,0,4
41567,90,10712,16440;18870;19861,24090,0,1,2,0,3
41568,90,10713,15896;16148;19204,24090,0,1,2,0,3
41569,90,10715,11403;12128,24455,0,0,0,2,2
41570,90,10719,11588,24455,0,0,0,1,1
41571,90,10724,12226,24455,0,0,0,1,1
41572,90,10726,12153;12338,24455,0,0,0,2,2
41573,90,10727,12578;12659,24455,0,0,0,2,2
41574,90,10728,13026;13086,24455,0,0,0,2,2
41575,90,10734,13744,24455,0,0,1,0,1
41576,90,10736,13612;14339,24455,0,0,2,0,2
41577,90,10739,14436,24455,0,0,1,0,1
41578,90,10745,14537;14546;19352,24455,0,1,2,0,3
41579,90,10749,15102;15326;19173,24455,0,1,2,0,3
41580,90,10750,14097;14806;18773,24455,0,0,3,0,3
41581,90,10752,14913;15015,24455,0,0,2,0,2
41582,90,10753,15157;15313;19106,24455,0,1,2,0,3
41583,90,10754,15708;18919;19278,24455,0,1,2,0,3
41584,90,10755,14673;15158;19581,24455,0,1,2,0,3
41585,90,10756,15193;15642,24455,0,0,2,0,2
41586,90,10758,15105;19043,24455,0,0,2,0,2
41587,90,10760,15759;15886;19829;20104,24455,0,2,2,0,4
41588,90,10761,15467;18844,24455,0,0,2,0,2
41589,90,10762,15080;15273;18423;18583,24455,0,0,4,0,4
41590,90,10763,14896;15292;18732,24455,0,0,3,0,3
41591,90,10764,15087;15581;19662;19841,24455,0,2,2,0,4
41592,90,10765,15062;15398;19288;19494,24455,0,2,2,0,4
41593,90,10766,15041;15419;18859;19375,24455,0,1,3,0,4
41594,90,10767,15270;15930;18419;18822;19135;19370;19977,24455,0,3,4,0,7
41595,90,10768,15624;15915;19003;19970,24455,0,1,3,0,4
41596,90,10769,15472;18668,24455,0,0,2,0,2
41597,90,10770,15673;15778,24455,0,0,2,0,2
41598,90,10771,15991;16118,24455,0,0,2,0,2
41599,90,10772,15553;15869;19183;19315,24455,0,2,2,0,4
41600,90,10773,15746;16037;19783;20054,24455,0,2,2,0,4
41601,90,10774,15756;15931;19539;20063,24455,0,2,2,0,4
41602,90,10776,16453;16455;19844;20070,24455,0,2,2,0,4
41603,90,10777,16199;18899;19305,24455,0,1,2,0,3
41604,90,10778,15791;16097;18752;19156;19553;19755;19848;20035,24455,0,5,3,0,8
41605,90,10779,15799;15838;19557;19985,24455,0,2,2,0,4
41606,90,10780,15241;16007;18993;19650,24455,0,1,3,0,4
41607,90,10781,15882;15926;18879;19320;19456,24455,0,2,3,0,5
41608,90,10782,15028;15883;19575;19798,24455,0,2,2,0,4
41609,90,10783,15897;16160;19749;20115,24455,0,2,2,0,4
41610,90,10784,15928;19309;19837,24455,0,2,1,0,3
41611,90,10785,15950;16101;19355;19886,24455,0,2,2,0,4
41612,90,10786,16274;16579;18998;20008;20975,24455,1,1,3,0,5
41613,90,10787,15987;16049;18913,24455,0,0,3,0,3
41614,90,10788,15996;16313;19411;19659,24455,0,2,2,0,4
41615,90,10789,15922;16033;20020;20486,24455,0,2,2,0,4
41616,90,10790,16200;16307;18610;20154,24455,0,1,3,0,4
41617,90,10791,15429;16069;18506;19131;19430,24455,0,2,3,0,5
41618,90,10792,16102;16637;18967;19447;20323;20466,24455,0,3,3,0,6
41619,90,10793,16116;16412;18609;19150;19663,24455,0,2,3,0,5
41620,90,10794,16164;16548;19322;19393;19919;20191,24455,0,4,2,0,6
41621,90,10795,15881;16255;19697,24455,0,1,2,0,3
41622,90,10796,16221;19306,24455,0,1,1,0,2
41623,90,10797,16225;16660;19244,24455,0,1,2,0,3
41624,90,10798,16241;16281;18974;19185,24455,0,1,3,0,4
41625,90,10799,16254;16643;18529;18693;19307,24455,0,1,4,0,5
41626,90,10800,15694;16272;19533,24455,0,1,2,0,3
41627,90,10801,11066,24820,0,0,0,1,1
41628,90,10803,11474,24820,0,0,0,1,1
41629,90,10804,11425;11629,24820,0,0,0,2,2
41630,90,10809,11201,24820,0,0,0,1,1
41631,90,10814,12205;12236,24820,0,0,0,2,2
41632,90,10821,12717,24820,0,0,0,1,1
41633,90,10822,12756,24820,0,0,0,1,1
41634,90,10825,13044;13211,24820,0,0,0,2,2
41635,90,10828,13987,24820,0,0,1,0,1
41636,90,10835,14170;14325,24820,0,0,2,0,2
41637,90,10836,14182;14440;19261,24820,0,1,2,0,3
41638,90,10838,15049;15242,24820,0,0,2,0,2
41639,90,10840,14459,24820,0,0,1,0,1
41640,90,10841,14488;15307,24820,0,0,2,0,2
41641,90,10844,13962;14635,24820,0,0,2,0,2
41642,90,10845,14686;15586,24820,0,0,2,0,2
41643,90,10846,14692;15129,24820,0,0,2,0,2
41644,90,10847,13832;14410,24820,0,0,2,0,2
41645,90,10848,14446;15009;19249;19348,24820,0,2,2,0,4
41646,90,10849,14392;14732;18999;19839,24820,0,1,3,0,4
41647,90,10850,14593;14614;19821,24820,0,1,2,0,3
41648,90,10854,14581;14912;18730;19191,24820,0,1,3,0,4
41649,90,10856,14738;15169,24820,0,0,2,0,2
41650,90,10858,14734;15184;18955;19019,24820,0,0,4,0,4
41651,90,10859,15172;15258,24820,0,0,2,0,2
41652,90,10860,15615;15820;18912;19044,24820,0,0,4,0,4
41653,90,10861,16174;20116;20364,24820,0,2,1,0,3
41654,90,10862,14680,24820,0,0,1,0,1
41655,90,10863,15343;18642;20101,24820,0,1,2,0,3
41656,90,10865,15108;15388,24820,0,0,2,0,2
41657,90,10866,15353;15483;20282,24820,0,1,2,0,3
41658,90,10868,15660;15993;18932;19086;19349,24820,0,1,4,0,5
41659,90,10869,15540;15834;18808,24820,0,0,3,0,3
41660,90,10870,15266;15424;18604;18898,24820,0,0,4,0,4
41661,90,10871,15696;15836;18684;19122,24820,0,1,3,0,4
41662,90,10872,16417,24820,0,0,1,0,1
41663,90,10874,16228;16370;19230;19566,24820,0,2,2,0,4
41664,90,10875,15712;16095,24820,0,0,2,0,2
41665,90,10876,16256;16386;18850;19040;19217,24820,0,1,4,0,5
41666,90,10877,15742;18869;19100,24820,0,0,3,0,3
41667,90,10878,16035;16107;19485;19709;20314,24820,0,3,2,0,5
41668,90,10879,15656;15804;20060;20257,24820,0,2,2,0,4
41669,90,10880,15594;15807,24820,0,0,2,0,2
41670,90,10881,16244;16392;19291;20001;20358,24820,0,3,2,0,5
41671,90,10882,15837;15843;18582;19271;19830,24820,0,2,3,0,5
41672,90,10883,15846;16126;19445;20153;20392,24820,0,3,2,0,5
41673,90,10884,16025;16181;19072;19272;20777,24820,1,1,3,0,5
41674,90,10885,15165;15891;20087;20175,24820,0,2,2,0,4
41675,90,10886,15929;16106;19423;19951,24820,0,2,2,0,4
41676,90,10887,15932;15969,24820,0,0,2,0,2
41677,90,10888,15983,24820,0,0,1,0,1
41678,90,10889,15986;16248;19715;20379,24820,0,2,2,0,4
41679,90,10890,15990;16109,24820,0,0,2,0,2
41680,90,10891,15999;16511;19047;19235;20025,24820,0,2,3,0,5
41681,90,10892,16012;19479,24820,0,1,1,0,2
41682,90,10893,15711;16286;18543;19651,24820,0,1,3,0,4
41683,90,10895,16117;16552;19188;19559;19741,24820,0,3,2,0,5
41684,90,10896,15943;16145;19577;19791;20540,24820,1,2,2,0,5
41685,90,10897,16151;19432;19449,24820,0,2,1,0,3
41686,90,10898,15524;16156;18786;20126,24820,0,1,3,0,4
41687,90,10899,16066;16196;19029;19570;20400,24820,0,2,3,0,5
41688,90,10900,16205;16754;18720;19483;19964,24820,0,2,3,0,5
41689,90,10902,15847;16501;19118,24820,0,1,2,0,3
41690,90,10903,15992;16243;18921,24820,0,0,3,0,3
41691,90,10904,16142;16246;18988;19694,24820,0,1,3,0,4
41692,90,10905,16264;16494;20065,24820,0,1,2,0,3
41693,90,10906,16483;16836;19757;19905;20549,24820,1,2,2,0,5
41694,90,10907,16345;16454;18939;19092;19395;20274,24820,0,2,4,0,6
41695,90,10908,16352;16570;18615;18852;19074;19161,24820,0,1,5,0,6
41696,90,10909,16048;16369;19960;20339,24820,0,2,2,0,4
41697,90,10910,15857;16373;19298;19686;20355,24820,0,3,2,0,5
41698,90,10912,16409;16535,24820,0,0,2,0,2
41699,90,10913,16739;18565;19588;19831,24820,0,2,2,0,4
41700,90,10914,16631;16771;19146;19401;19573;19855,24820,0,4,2,0,6
41701,90,10915,16467,24820,0,0,1,0,1
41702,90,10917,11282,25185,0,0,0,1,1
41703,90,10922,11621,25185,0,0,0,1,1
41704,90,10934,12890,25185,0,0,0,1,1
41705,90,10935,12984,25185,0,0,0,1,1
41706,90,10938,13133;13856,25185,0,0,1,1,2
41707,90,10942,13040,25185,0,0,0,1,1
41708,90,10950,14148;14627;19435,25185,0,1,2,0,3
41709,90,10951,14209;14701,25185,0,0,2,0,2
41710,90,10952,14785;14946;19219;19910,25185,0,2,2,0,4
41711,90,10956,14550;14860;19346,25185,0,1,2,0,3
41712,90,10957,14572,25185,0,0,1,0,1
41713,90,10962,14868;15040;19196,25185,0,1,2,0,3
41714,90,10965,14925;15367,25185,0,0,2,0,2
41715,90,10966,14414;14677,25185,0,0,2,0,2
41716,90,10968,15139;15355,25185,0,0,2,0,2
41717,90,10970,15109;15336,25185,0,0,2,0,2
41718,90,10971,14874;15344;18950;19046;19174,25185,0,1,4,0,5
41719,90,10972,15402,25185,0,0,1,0,1
41720,90,10973,15868;19207;19500,25185,0,2,1,0,3
41721,90,10974,15833;15870;19236;19513;20130,25185,0,3,2,0,5
41722,90,10975,15813;16185,25185,0,0,2,0,2
41723,90,10976,15563;16177;19347;19654,25185,0,2,2,0,4
41724,90,10977,15574;16016;19584,25185,0,1,2,0,3
41725,90,10978,15602;16032;19816,25185,0,1,2,0,3
41726,90,10979,15618,25185,0,0,1,0,1
41727,90,10980,15648;15871;19793,25185,0,1,2,0,3
41728,90,10981,15560;15651;18989;19053;19426,25185,0,1,4,0,5
41729,90,10982,15450;15662,25185,0,0,2,0,2
41730,90,10983,15714;16346,25185,0,0,2,0,2
41731,90,10984,15975;16216;19232;19591,25185,0,2,2,0,4
41732,90,10985,15801;16013;18969;19155;19621,25185,0,2,3,0,5
41733,90,10986,15965;19094;19275;20718,25185,1,1,2,0,4
41734,90,10987,15222;15865;19015;19175,25185,0,1,3,0,4
41735,90,10988,15470;15947;19211;19487;20057,25185,0,3,2,0,5
41736,90,10989,15955;16531;18804;19532;20716,25185,1,1,3,0,5
41737,90,10990,14819;15045,25185,0,0,2,0,2
41738,90,10991,15610;16014;19819;20229,25185,0,2,2,0,4
41739,90,10992,16078;16136,25185,0,0,2,0,2
41740,90,10993,15674;15971;19507,25185,0,1,2,0,3
41741,90,10994,15537;16027;18819;19056;19763,25185,0,1,4,0,5
41742,90,10995,15608;16059;19169;19515,25185,0,2,2,0,4
41743,90,10996,16068;16413;18924;19327,25185,0,1,3,0,4
41744,90,10997,16083;16692;19868,25185,0,1,2,0,3
41745,90,10999,16091;16709;20015,25185,0,1,2,0,3
41746,90,11000,16034;16093,25185,0,0,2,0,2
41747,90,11001,15577;16110;19404;19667,25185,0,2,2,0,4
41748,90,11002,16251;19527;20240,25185,0,2,1,0,3
41749,90,11003,16444,25185,0,0,1,0,1
41750,90,11004,15859;16627;19511;19640;20290,25185,0,3,2,0,5
41751,90,11006,16421;16498,25185,0,0,2,0,2
41752,90,11007,16240;16753;20010;20216,25185,0,2,2,0,4
41753,90,11008,16586;18670;18940;19690,25185,0,1,3,0,4
41754,90,11009,15830;16245;19489;20083,25185,0,2,2,0,4
41755,90,11010,15941;16263;19403;19645,25185,0,2,2,0,4
41756,90,11011,16269;19145;19503;19969,25185,0,3,1,0,4
41757,90,11012,16187;16298;18705;19136;19946,25185,0,2,3,0,5
41758,90,11013,16301,25185,0,0,1,0,1
41759,90,11014,16302;16772;19853;20344;20640,25185,1,2,2,0,5
41760,90,11015,16318;16599,25185,0,0,2,0,2
41761,90,11016,16336;16559;19865,25185,0,1,2,0,3
41762,90,11017,16340,25185,0,0,1,0,1
41763,90,11018,16349;16841;18653;19245;19571,25185,0,2,3,0,5
41764,90,11019,16384;16504;20011;20658,25185,1,1,2,0,4
41765,90,11020,16422;19945;20212;20689,25185,1,2,1,0,4
41766,90,11021,16085;16485;19302;19468;19629;19935;20910,25185,1,4,2,0,7
41767,90,11022,16115;16428;19221;19759;20233;20871,25185,1,3,2,0,6
41768,90,11023,16432;16536;19477;19771;20391,25185,0,3,2,0,5
41769,90,11024,16010;16437;20337,25185,0,1,2,0,3
41770,90,11025,16446;16560;18750;19523;19762,25185,0,2,3,0,5
41771,90,11026,16377;19154;19925,25185,0,2,1,0,3
41772,90,11027,16458;16477;20024;20485,25185,0,2,2,0,4
41773,90,11028,16480;16625;18796;19213;19605,25185,0,2,3,0,5
41774,90,11029,16327;16803;20570;20796,25185,2,0,2,0,4
41775,90,11030,16489;16493;18792;19083;20013,25185,0,1,4,0,5
41776,90,11031,16519;16601;19351;19609,25185,0,2,2,0,4
41777,90,11032,16549;19358;20142,25185,0,2,1,0,3
41778,90,11033,16439;16553;19336;19812,25185,0,2,2,0,4
41779,90,11034,11027,25550,0,0,0,1,1
41780,90,11035,11362,25550,0,0,0,1,1
41781,90,11036,11473,25550,0,0,0,1,1
41782,90,11037,11501,25550,0,0,0,1,1
41783,90,11039,11169,25550,0,0,0,1,1
41784,90,11041,11569;12093,25550,0,0,0,2,2
41785,90,11043,11775,25550,0,0,0,1,1
41786,90,11044,11964,25550,0,0,0,1,1
41787,90,11045,12455,25550,0,0,0,1,1
41788,90,11046,12038;12928,25550,0,0,0,2,2
41789,90,11048,12027,25550,0,0,0,1,1
41790,90,11049,11941;12493,25550,0,0,0,2,2
41791,90,11056,12642,25550,0,0,0,1,1
41792,90,11060,12793;13412,25550,0,0,1,1,2
41793,90,11068,13520,25550,0,0,1,0,1
41794,90,11070,13896,25550,0,0,1,0,1
41795,90,11077,13918,25550,0,0,1,0,1
41796,90,11082,13917;14401,25550,0,0,2,0,2
41797,90,11085,13940;14172,25550,0,0,2,0,2
41798,90,11087,14881;15828;18806;19266;19698,25550,0,2,3,0,5
41799,90,11090,15218,25550,0,0,1,0,1
41800,90,11091,14996;15405;19499,25550,0,1,2,0,3
41801,90,11092,15010;15037,25550,0,0,2,0,2
41802,90,11093,14434;15069;19549,25550,0,1,2,0,3
41803,90,11094,14728;15114,25550,0,0,2,0,2
41804,90,11095,15136;15324,25550,0,0,2,0,2
41805,90,11096,15150;18893;19176,25550,0,1,2,0,3
41806,90,11098,15232;15354,25550,0,0,2,0,2
41807,90,11099,14947;15257,25550,0,0,2,0,2
41808,90,11101,15400;16150,25550,0,0,2,0,2
41809,90,11104,15543;16002,25550,0,0,2,0,2
41810,90,11105,15018;15587;20177,25550,0,1,2,0,3
41811,90,11107,15723;15989;19313,25550,0,1,2,0,3
41812,90,11108,15730;16178,25550,0,0,2,0,2
41813,90,11109,15739;16287;19198;19324;19579,25550,0,3,2,0,5
41814,90,11110,15956;16108,25550,0,0,2,0,2
41815,90,11112,15977;15982;18775;20335,25550,0,1,3,0,4
41816,90,11114,16009;16096;19373;19714;20176,25550,0,3,2,0,5
41817,90,11115,16011;18867,25550,0,0,2,0,2
41818,90,11116,15372;16474,25550,0,0,2,0,2
41819,90,11117,15988;16197;19545;19904,25550,0,2,2,0,4
41820,90,11119,16410;16741;20332;20876,25550,1,1,2,0,4
41821,90,11120,15740;16162,25550,0,0,2,0,2
41822,90,11121,16169;16461;19870;20244;20476,25550,0,3,2,0,5
41823,90,11123,16366;16652;19567;19656,25550,0,2,2,0,4
41824,90,11124,15531;16204;18862;19778,25550,0,1,3,0,4
41825,90,11125,16619;19338;19618;20058,25550,0,3,1,0,4
41826,90,11126,16207;19516;20403,25550,0,2,1,0,3
41827,90,11127,16234;16634,25550,0,0,2,0,2
41828,90,11128,16170;16249;19614;19962,25550,0,2,2,0,4
41829,90,11129,16252;17062;19820;20079,25550,0,2,2,0,4
41830,90,11130,16610;18802;19383,25550,0,1,2,0,3
41831,90,11132,16294;16518;18866;19126;19634,25550,0,2,3,0,5
41832,90,11133,16303;17063;20236;20495,25550,0,2,2,0,4
41833,90,11134,16499;16683;19115;19843;20491,25550,0,3,2,0,5
41834,90,11135,16280;16337;19696;20362;20505,25550,0,3,2,0,5
41835,90,11136,15873;16339,25550,0,0,2,0,2
41836,90,11137,15851;16343;18917;19958;20352,25550,0,2,3,0,5
41837,90,11138,16161;16362,25550,0,0,2,0,2
41838,90,11139,16237;16375;19033;19356;19767,25550,0,2,3,0,5
41839,90,11140,16449;16644;19652;20246,25550,0,2,2,0,4
41840,90,11141,16822;19597;19998;20213,25550,0,3,1,0,4
41841,90,11142,16456;16472,25550,0,0,2,0,2
41842,90,11143,16512;16722;18851;19024;19455;19730,25550,0,2,4,0,6
41843,90,11144,16528;16612;20847,25550,1,0,2,0,3
41844,90,11145,16537;16818;20730,25550,1,0,2,0,3
41845,90,11146,16868;16888;19619;19971,25550,0,2,2,0,4
41846,90,11147,16424;16562;19555;19744;20501,25550,0,3,2,0,5
41847,90,11148,16576;16782;18753;19992;20340,25550,0,2,3,0,5
41848,90,11149,16584;18761;19283;20346,25550,0,2,2,0,4
41849,90,11150,16329;16603;18794;19264;20149,25550,0,2,3,0,5
41850,90,11151,16355;16931,25550,0,0,2,0,2
41851,90,11152,16074;16616;18947;19028;19939;20129;20308,25550,0,3,4,0,7
41852,90,11153,16533;16936;20275,25550,0,1,2,0,3
41853,90,11154,16389;16904,25550,0,0,2,0,2
41854,90,11155,16649;16791;19906;20055;20750,25550,1,2,2,0,5
41855,90,11156,16039;16650;19452;20471,25550,0,2,2,0,4
41856,90,11157,16317;16663;19134;19700;20693,25550,1,2,2,0,5
41857,90,11158,16673;17060;19138;19563,25550,0,2,2,0,4
41858,90,11159,16253;16675;19070;19241,25550,0,1,3,0,4
41859,90,11161,11661,25915,0,0,0,1,1
41860,90,11162,11456;11815,25915,0,0,0,2,2
41861,90,11164,11384,25915,0,0,0,1,1
41862,90,11167,11540,25915,0,0,0,1,1
41863,90,11172,12077,25915,0,0,0,1,1
41864,90,11174,12469;12602,25915,0,0,0,2,2
41865,90,11176,12576;13076,25915,0,0,0,2,2
41866,90,11177,12063;12212,25915,0,0,0,2,2
41867,90,11178,12630,25915,0,0,0,1,1
41868,90,11180,12683;13046,25915,0,0,0,2,2
41869,90,11182,12767;12950,25915,0,0,0,2,2
41870,90,11188,13232,25915,0,0,0,1,1
41871,90,11199,13270;13379,25915,0,0,2,0,2
41872,90,11200,13872,25915,0,0,1,0,1
41873,90,11206,13650,25915,0,0,1,0,1
41874,90,11214,15073;15153;19127;19159;19260,25915,0,3,2,0,5
41875,90,11215,15168,25915,0,0,1,0,1
41876,90,11216,14828;14988,25915,0,0,2,0,2
41877,90,11220,14839;15280,25915,0,0,2,0,2
41878,90,11221,15262,25915,0,0,1,0,1
41879,90,11223,14471;14900;19034;19258,25915,0,1,3,0,4
41880,90,11224,15331;16139;19836;20161,25915,0,2,2,0,4
41881,90,11227,15275;15436;19684;19928,25915,0,2,2,0,4
41882,90,11228,15755;16154,25915,0,0,2,0,2
41883,90,11230,15643;16334;19551;19898;20222,25915,0,3,2,0,5
41884,90,11231,15375;15653,25915,0,0,2,0,2
41885,90,11232,15706;15951;19774;19901;20012,25915,0,3,2,0,5
41886,90,11233,15745;16175,25915,0,0,2,0,2
41887,90,11234,16209;19788;20436,25915,0,2,1,0,3
41888,90,11235,15966;16284;19446;19675,25915,0,2,2,0,4
41889,90,11236,16690;20351,25915,0,1,1,0,2
41890,90,11237,15722;16380;20266;20684,25915,1,1,2,0,4
41891,90,11238,16103;16497;19777;20145;20261;20524,25915,1,3,2,0,6
41892,90,11239,15890;16214;19337;19899,25915,0,2,2,0,4
41893,90,11240,16144;16443,25915,0,0,2,0,2
41894,90,11241,16157,25915,0,0,1,0,1
41895,90,11242,16575;19646;20156,25915,0,2,1,0,3
41896,90,11243,16210;19717,25915,0,1,1,0,2
41897,90,11244,16554,25915,0,0,1,0,1
41898,90,11245,16273;16406;19859,25915,0,1,2,0,3
41899,90,11246,16299;16571;19247;19673;20589,25915,1,2,2,0,5
41900,90,11247,16618;20637;21047,25915,2,0,1,0,3
41901,90,11248,16296;16310;19429;19742;19809,25915,0,3,2,0,5
41902,90,11249,16947;20790;20965,25915,2,0,1,0,3
41903,90,11250,16365;19805;20904,25915,1,1,1,0,3
41904,90,11251,15880;16442,25915,0,0,2,0,2
41905,90,11252,16705;16860;19760;20317,25915,0,2,2,0,4
41906,90,11253,15906;16433,25915,0,0,2,0,2
41907,90,11255,16469;16768;18897;20380,25915,0,1,3,0,4
41908,90,11256,16081;16486;19695;20021,25915,0,2,2,0,4
41909,90,11257,16697;16798;19413;19636;20179;20347,25915,0,4,2,0,6
41910,90,11258,16941;20409;20711,25915,1,1,1,0,3
41911,90,11259,16503;16826;18949;19180;19372,25915,0,2,3,0,5
41912,90,11260,15877;16462;20324;20788;20914,25915,2,1,2,0,5
41913,90,11261,16508;16555;18972;19875,25915,0,1,3,0,4
41914,90,11262,16561;16984;20659;20928,25915,2,0,2,0,4
41915,90,11263,16425;16564;19765,25915,0,1,2,0,3
41916,90,11264,16262;16609;20211;20604,25915,1,1,2,0,4
41917,90,11265,16098;16617;19622;19803,25915,0,2,2,0,4
41918,90,11266,16832;17103;18975;19107;19712;20405,25915,0,3,3,0,6
41919,90,11267,16646;16785;19229;20067,25915,0,2,2,0,4
41920,90,11268,16651;16944;20597;20778;20984,25915,3,0,2,0,5
41921,90,11269,16654;16688;19371;20000,25915,0,2,2,0,4
41922,90,11270,16661;20044;20439;20838,25915,1,2,1,0,4
41923,90,11272,16719;16831;18979;19055;19827,25915,0,1,4,0,5
41924,90,11273,16732;17129;19088;19973;20264,25915,0,2,3,0,5
41925,90,11274,16516;16733;20588,25915,1,0,2,0,3
41926,90,11275,16762;20329,25915,0,1,1,0,2
41927,90,11276,16304;17095;18925;19727;21030,25915,1,1,3,0,5
41928,90,11277,16359;16770;19121;19852,25915,0,2,2,0,4
41929,90,11278,16703;16788;19546;19890;20319,25915,0,3,2,0,5
41930,90,11279,16793;16869;18896;20454,25915,0,1,3,0,4
41931,90,11280,16481;17135;20452,25915,0,1,2,0,3
41932,90,11281,16806;20272,25915,0,1,1,0,2
41933,90,11282,16813;16963;19754;20198,25915,0,2,2,0,4
41934,90,11288,11664;11860,26280,0,0,0,2,2
41935,90,11289,11715;12001,26280,0,0,0,2,2
41936,90,11294,12142;12162,26280,0,0,0,2,2
41937,90,11304,13102,26280,0,0,0,1,1
41938,90,11307,13442,26280,0,0,1,0,1
41939,90,11308,13571,26280,0,0,1,0,1
41940,90,11309,14373,26280,0,0,1,0,1
41941,90,11310,13985;14303,26280,0,0,2,0,2
41942,90,11318,14594,26280,0,0,1,0,1
41943,90,11322,14910;19461,26280,0,1,1,0,2
41944,90,11323,14832;14968;19484,26280,0,1,2,0,3
41945,90,11324,14743;15111;19061;19179,26280,0,1,3,0,4
41946,90,11326,14688;14989,26280,0,0,2,0,2
41947,90,11327,15204;15234,26280,0,0,2,0,2
41948,90,11329,15265;15276,26280,0,0,2,0,2
41949,90,11330,15277;15383,26280,0,0,2,0,2
41950,90,11332,15330;15475,26280,0,0,2,0,2
41951,90,11334,15550;15727;19137;19450,26280,0,2,2,0,4
41952,90,11335,15350;15552;20455,26280,0,1,2,0,3
41953,90,11336,15096;15582;19114;19376,26280,0,2,2,0,4
41954,90,11339,15546;20193,26280,0,1,1,0,2
41955,90,11340,14509;14822,26280,0,0,2,0,2
41956,90,11341,15815;16532;19699;19808;19917;20190,26280,0,4,2,0,6
41957,90,11342,15862;19641;19846,26280,0,2,1,0,3
41958,90,11343,15699;15798,26280,0,0,2,0,2
41959,90,11344,15904;16220;19269;19954,26280,0,2,2,0,4
41960,90,11346,16080;16641;20342;20518,26280,1,1,2,0,4
41961,90,11347,16019;16064;19506;19776,26280,0,2,2,0,4
41962,90,11348,16404;19726;19909;20584,26280,1,2,1,0,4
41963,90,11349,16149;16670;19323;19580;20338,26280,0,3,2,0,5
41964,90,11350,16819;19779;20696,26280,1,1,1,0,3
41965,90,11351,16700;19602;19894;20139,26280,0,3,1,0,4
41966,90,11352,16189;16194;19637;19710,26280,0,2,2,0,4
41967,90,11353,16681;19405;19658;20007,26280,0,3,1,0,4
41968,90,11354,16319;16357;19280;19576,26280,0,2,2,0,4
41969,90,11355,16358;16689;20360,26280,0,1,2,0,3
41970,90,11356,16268;16300;20691,26280,1,0,2,0,3
41971,90,11357,16525;16704;19378;19780;20306,26280,0,3,2,0,5
41972,90,11358,16312;19295;19332,26280,0,2,1,0,3
41973,90,11359,16192;16332;19059;19201;19929,26280,0,2,3,0,5
41974,90,11360,16735;16811;19318;19672;19924;20080,26280,0,4,2,0,6
41975,90,11361,15994;16364;20425;20868,26280,1,1,2,0,4
41976,90,11362,16387;16891;20305,26280,0,1,2,0,3
41977,90,11363,16158;16390;19108;19769;19885,26280,0,3,2,0,5
41978,90,11364,16399;16488;20107;20224,26280,0,2,2,0,4
41979,90,11366,16403;19111;19238;19537;19734,26280,0,4,1,0,5
41980,90,11367,16666;16903;19431;19509;19800,26280,0,3,2,0,5
41981,90,11368,16478;16573,26280,0,0,2,0,2
41982,90,11369,16510;16630;19099;19130;20109,26280,0,2,3,0,5
41983,90,11370,16514;19259;19676;19911;20003,26280,0,4,1,0,5
41984,90,11371,16557;17003,26280,0,0,2,0,2
41985,90,11372,16306;16563;20367,26280,0,1,2,0,3
41986,90,11373,16086;16569;19706;19854;19938,26280,0,3,2,0,5
41987,90,11374,17116;17240;19414;19671;20085;20571,26280,1,3,2,0,6
41988,90,11375,16669;16917;19984;20158,26280,0,2,2,0,4
41989,90,11376,16523;16665;20534;21022,26280,2,0,2,0,4
41990,90,11377,16679;16912;20165;20728;20862,26280,2,1,2,0,5
41991,90,11378,16452;16940;19531;19948;20068;20289,26280,0,4,2,0,6
41992,90,11379,16698;16897;19304;19520;19738;20248;20412,26280,0,5,2,0,7
41993,90,11380,16728;17306;20123;20657,26280,1,1,2,0,4
41994,90,11381,16751;17025,26280,0,0,2,0,2
41995,90,11382,16775;17122;20127;20288,26280,0,2,2,0,4
41996,90,11383,16694;16794;19104;20292;20800,26280,1,1,3,0,5
41997,90,11384,16677;16808;19396;19772;20047,26280,0,3,2,0,5
41998,90,11385,16828;20173;20715,26280,1,1,1,0,3
41999,90,11386,16873;17266;19257;20849,26280,1,1,2,0,4
42000,90,11387,17144;19018,26280,0,0,2,0,2
42001,90,11388,17180;19073;19226;20666,26280,1,1,2,0,4
42002,90,11389,16491;16905;19078;19274,26280,0,1,3,0,4
42003,90,11390,16496;16909;19871;20440,26280,0,2,2,0,4
42004,90,11391,16916;17154;20202;20815,26280,1,1,2,0,4
42005,90,11392,16645;17292;20297;20900,26280,1,1,2,0,4
42006,90,11393,16918;17077;19133;19764;20376,26280,0,3,2,0,5
42007,90,11394,16231;16919;20461;20945,26280,1,1,2,0,4
42008,90,11400,11587,26645,0,0,0,1,1
42009,90,11403,11888,26645,0,0,0,1,1
42010,90,11404,11814;12131,26645,0,0,0,2,2
42011,90,11406,12476;12626,26645,0,0,0,2,2
42012,90,11407,12032,26645,0,0,0,1,1
42013,90,11411,12723,26645,0,0,0,1,1
42014,90,11416,13265,26645,0,0,1,0,1
42015,90,11419,13327,26645,0,0,1,0,1
42016,90,11424,14695,26645,0,0,1,0,1
42017,90,11426,14343,26645,0,0,1,0,1
42018,90,11428,14669;14708,26645,0,0,2,0,2
42019,90,11429,14547;14698,26645,0,0,2,0,2
42020,90,11433,14911,26645,0,0,1,0,1
42021,90,11435,15022;15050;19421;19585,26645,0,2,2,0,4
42022,90,11436,14812;15391,26645,0,0,2,0,2
42023,90,11439,14647;15382,26645,0,0,2,0,2
42024,90,11441,15523;15551;19802;19950,26645,0,2,2,0,4
42025,90,11444,16427;20187,26645,0,1,1,0,2
42026,90,11445,15684;15773;19277;19390,26645,0,2,2,0,4
42027,90,11446,15763;19784,26645,0,1,1,0,2
42028,90,11447,15578;15781,26645,0,0,2,0,2
42029,90,11448,15298,26645,0,0,1,0,1
42030,90,11449,15920;16198;19194;19392,26645,0,2,2,0,4
42031,90,11450,15737;15953;19983,26645,0,1,2,0,3
42032,90,11451,15288;15861;19543;20113,26645,0,2,2,0,4
42033,90,11452,16111;16712;19343;20172,26645,0,2,2,0,4
42034,90,11453,16487;19631;19794;20118,26645,0,3,1,0,4
42035,90,11454,16138;16191;19129;19294;20182,26645,0,3,2,0,5
42036,90,11455,16242;16450;19140;19644,26645,0,2,2,0,4
42037,90,11456,16275;16448;19128;19589;19834,26645,0,3,2,0,5
42038,90,11457,16324;16333,26645,0,0,2,0,2
42039,90,11458,16420;19172;19357;20069,26645,0,3,1,0,4
42040,90,11459,16099;16338,26645,0,0,2,0,2
42041,90,11460,16342;16942;19884;20138,26645,0,2,2,0,4
42042,90,11461,16351;16816;20238,26645,0,1,2,0,3
42043,90,11462,16348;16736;19920;21058,26645,1,1,2,0,4
42044,90,11463,16381;17134;20801,26645,1,0,2,0,3
42045,90,11464,15974;16382;19504;19814;20201,26645,0,3,2,0,5
42046,90,11465,16356;16419;20514;20620,26645,1,1,2,0,4
42047,90,11466,16445;17178;19117;19502;20174;20527,26645,1,3,2,0,6
42048,90,11467,16315;16447;20438;20565,26645,1,1,2,0,4
42049,90,11468,16119;16674;19424;20143;20357,26645,0,3,2,0,5
42050,90,11469,16509;16693;19253;19653;20504,26645,0,3,2,0,5
42051,90,11470,16173;16538;19756;19923;20428,26645,0,3,2,0,5
42052,90,11471,16321;16543,26645,0,0,2,0,2
42053,90,11472,16152;16551;19963;20451,26645,0,2,2,0,4
42054,90,11473,16492;16588;19887;20408,26645,0,2,2,0,4
42055,90,11474,16167;16202,26645,0,0,2,0,2
42056,90,11476,16662;16971;20215,26645,0,1,2,0,3
42057,90,11477,16546;16671;20564,26645,1,0,2,0,3
42058,90,11478,16999,26645,0,0,1,0,1
42059,90,11479,15878;16684;19273;19880;20270,26645,0,3,2,0,5
42060,90,11480,16585;16699;20401;20791,26645,1,1,2,0,4
42061,90,11481,16556;16708;20581,26645,1,0,2,0,3
42062,90,11482,16388;16714;19639;19927;20232,26645,0,3,2,0,5
42063,90,11483,16720;17101,26645,0,0,2,0,2
42064,90,11484,17145;17168;20529,26645,1,0,2,0,3
42065,90,11485,16506;16734;19986;20243;20441,26645,0,3,2,0,5
42066,90,11486,16568;19312;19335;19703;20557,26645,1,3,1,0,5
42067,90,11487,16716;16758;20033,26645,0,1,2,0,3
42068,90,11488,16653;16765;20608;20734,26645,2,0,2,0,4
42069,90,11489,16911,26645,0,0,1,0,1
42070,90,11490,16814;16908;19467;19810;19932,26645,0,3,2,0,5
42071,90,11491,16879;17051,26645,0,0,2,0,2
42072,90,11492,16476;16825;19459;19746;20018,26645,0,3,2,0,5
42073,90,11493,16830;19817;20036;20509,26645,0,3,1,0,4
42074,90,11494,16842;16915;19688;20276;21033,26645,1,2,2,0,5
42075,90,11495,16851;20667,26645,1,0,1,0,2
42076,90,11496,16725;16926;20537,26645,1,0,2,0,3
42077,90,11497,17014;20061;20365,26645,0,2,1,0,3
42078,90,11498,16835;16876;20120;20654,26645,1,1,2,0,4
42079,90,11499,16889;17106;20467,26645,0,1,2,0,3
42080,90,11500,16907;19897;20247;20736,26645,1,2,1,0,4
42081,90,11501,16925;17117,26645,0,0,2,0,2
42082,90,11502,17024;17177;19205;19997;20231;21036,26645,1,3,2,0,6
42083,90,11504,16962;17221;19187;19442;20712,26645,1,2,2,0,5
42084,90,11505,16968;17068;19224;19476;19967,26645,0,3,2,0,5
42085,90,11506,16990;17128;19496,26645,0,1,2,0,3
42086,90,11507,16790;16992;19491;19724;20048;20539;20794,26645,2,3,2,0,7
42087,90,11508,17004;17032;19669;20195,26645,0,2,2,0,4
42088,90,11509,17227;19345;19556;19828;20824,26645,1,3,1,0,5
42089,90,11510,17019;17127;19267;19752;20713;20877,26645,2,2,2,0,6
42090,90,11511,17026;17155;19472;19582;19975,26645,0,3,2,0,5
42091,90,11512,16344;17029;19481;19624,26645,0,2,2,0,4
42092,90,11513,11679,27010,0,0,0,1,1
42093,90,11514,11671,27010,0,0,0,1,1
42094,90,11515,11808,27010,0,0,0,1,1
42095,90,11516,11625,27010,0,0,0,1,1
42096,90,11517,11559,27010,0,0,0,1,1
42097,90,11518,12216,27010,0,0,0,1,1
42098,90,11520,11343,27010,0,0,0,1,1
42099,90,11522,11958,27010,0,0,0,1,1
42100,90,11523,11957;11988,27010,0,0,0,2,2
42101,90,11524,12477;12895,27010,0,0,0,2,2
42102,90,11525,12307,27010,0,0,0,1,1
42103,90,11527,12152,27010,0,0,0,1,1
42104,90,11530,12884,27010,0,0,0,1,1
42105,90,11533,12618;12865,27010,0,0,0,2,2
42106,90,11536,11993,27010,0,0,0,1,1
42107,90,11539,13302,27010,0,0,1,0,1
42108,90,11543,13468;13476,27010,0,0,2,0,2
42109,90,11545,13742;13752,27010,0,0,2,0,2
42110,90,11549,14634;15297,27010,0,0,2,0,2
42111,90,11550,14700;14950,27010,0,0,2,0,2
42112,90,11552,15100,27010,0,0,1,0,1
42113,90,11553,14671;15225,27010,0,0,2,0,2
42114,90,11554,15373;15603,27010,0,0,2,0,2
42115,90,11555,15376;15760;19381;19611,27010,0,2,2,0,4
42116,90,11556,15428;15528,27010,0,0,2,0,2
42117,90,11558,15529;15942;19889,27010,0,1,2,0,3
42118,90,11562,15074;15508;19517,27010,0,1,2,0,3
42119,90,11563,15803,27010,0,0,1,0,1
42120,90,11564,15963,27010,0,0,1,0,1
42121,90,11565,15780;15852,27010,0,0,2,0,2
42122,90,11566,15874;16038;20627,27010,1,0,2,0,3
42123,90,11567,15268;15500;20387,27010,0,1,2,0,3
42124,90,11568,15908;16000;20052,27010,0,1,2,0,3
42125,90,11570,15923;15972;19514;19877,27010,0,2,2,0,4
42126,90,11571,16372;16400;20050;20241,27010,0,2,2,0,4
42127,90,11572,15669;16267;19560;19748;19856;20704,27010,1,3,2,0,6
42128,90,11573,15409;15599,27010,0,0,2,0,2
42129,90,11575,16230;16597;19458;19850;20328,27010,0,3,2,0,5
42130,90,11576,16172;16686;19443;19991,27010,0,2,2,0,4
42131,90,11577,16774;20496,27010,0,1,1,0,2
42132,90,11578,16276;16368,27010,0,0,2,0,2
42133,90,11580,17022;19465;19989;20660;20922,27010,2,2,1,0,5
42134,90,11581,16058;16513;19508;20378;20952,27010,1,2,2,0,5
42135,90,11582,16297;16530;20077;20296,27010,0,2,2,0,4
42136,90,11583,16541;16866;19972;20214,27010,0,2,2,0,4
42137,90,11584,16218;16594;20957,27010,1,0,2,0,3
42138,90,11585,16578;16718;19208;20082;20865,27010,1,2,2,0,5
42139,90,11586,16710;16857;19617;19733;19957;20739,27010,1,3,2,0,6
42140,90,11587,16621;16883;20029;20341;20752,27010,1,2,2,0,5
42141,90,11588,15909;16638,27010,0,0,2,0,2
42142,90,11589,16596;16707;20134;20171,27010,0,2,2,0,4
42143,90,11590,17170;20303;21032,27010,1,1,1,0,3
42144,90,11591,16766;16921;19896;20746,27010,1,1,2,0,4
42145,90,11592,16773;17028;19389;20108,27010,0,2,2,0,4
42146,90,11593,16988;19792;20252,27010,0,2,1,0,3
42147,90,11594,16737;16809;20268;20809,27010,1,1,2,0,4
42148,90,11595,16567;16846;20316;20766,27010,1,1,2,0,4
42149,90,11596,16856;17045;20595;20634,27010,2,0,2,0,4
42150,90,11597,16901;17393;19490;19900;20444;20784,27010,1,3,2,0,6
42151,90,11598,16932;17064;19789;20545,27010,1,1,2,0,4
42152,90,11599,16935;17327;20567,27010,1,0,2,0,3
42153,90,11601,16953;17253;19218;19407;20695,27010,1,2,2,0,5
42154,90,11602,16756;16954;20219;20602,27010,1,1,2,0,4
42155,90,11603,16959;17196;19366;20905,27010,1,1,2,0,4
42156,90,11604,16976;20071;20315,27010,0,2,1,0,3
42157,90,11605,16982;17006;20546;20656,27010,2,0,2,0,4
42158,90,11606,17031;17163;19781;20478,27010,0,2,2,0,4
42159,90,11607,17044;17257;19398;19497;20226,27010,0,3,2,0,5
42160,90,11608,17017;17061,27010,0,0,2,0,2
42161,90,11609,17114;17411;20474;20592;20843,27010,2,1,2,0,5
42162,90,11610,17079;17132;20105,27010,0,1,2,0,3
42163,90,11611,11898,27375,0,0,0,1,1
42164,90,11612,11608,27375,0,0,0,1,1
42165,90,11613,11760,27375,0,0,0,1,1
42166,90,11614,12168,27375,0,0,0,1,1
42167,90,11618,12397,27375,0,0,0,1,1
42168,90,11621,12640,27375,0,0,0,1,1
42169,90,11622,12714,27375,0,0,0,1,1
42170,90,11628,13169;13573,27375,0,0,1,1,2
42171,90,11631,13170,27375,0,0,0,1,1
42172,90,11641,14240;14800,27375,0,0,2,0,2
42173,90,11642,14941;15420;19568,27375,0,1,2,0,3
42174,90,11643,14497;14781,27375,0,0,2,0,2
42175,90,11644,15020;15301,27375,0,0,2,0,2
42176,90,11645,14758;15235,27375,0,0,2,0,2
42177,90,11646,14648,27375,0,0,1,0,1
42178,90,11650,14804;15256,27375,0,0,2,0,2
42179,90,11653,15346;15663,27375,0,0,2,0,2
42180,90,11657,15485;15596,27375,0,0,2,0,2
42181,90,11658,15617;15981;19966,27375,0,1,2,0,3
42182,90,11659,15687,27375,0,0,1,0,1
42183,90,11660,15704,27375,0,0,1,0,1
42184,90,11661,15747;15845,27375,0,0,2,0,2
42185,90,11662,16040;20095,27375,0,1,1,0,2
42186,90,11663,15960;16396,27375,0,0,2,0,2
42187,90,11664,15962;16213;19863;20117,27375,0,2,2,0,4
42188,90,11665,16792;20479;20810,27375,1,1,1,0,3
42189,90,11666,16289;16354,27375,0,0,2,0,2
42190,90,11667,16215;16550,27375,0,0,2,0,2
42191,90,11671,16084;16326;20147;20421,27375,0,2,2,0,4
42192,90,11672,16464,27375,0,0,1,0,1
42193,90,11674,15893;16416;19606;19773,27375,0,2,2,0,4
42194,90,11675,16153;16350;20042;20706,27375,1,1,2,0,4
42195,90,11676,16664;20034;20185,27375,0,2,1,0,3
42196,90,11677,16577;19565;20148;20875,27375,1,2,1,0,4
42197,90,11678,16429;16613;19955;20629,27375,1,1,2,0,4
42198,90,11679,16500;16623;20186;20833,27375,1,1,2,0,4
42199,90,11680,16629;19976;20170,27375,0,2,1,0,3
42200,90,11681,16624;16702;20111;20523,27375,1,1,2,0,4
42201,90,11682,16706;17210;20093,27375,0,1,2,0,3
42202,90,11683,16743;20348;20648;20873,27375,2,1,1,0,4
42203,90,11684,16744;17297;20515,27375,1,0,2,0,3
42204,90,11685,16769;16852;20632;21031,27375,2,0,2,0,4
42205,90,11686,16783;17480,27375,0,0,2,0,2
42206,90,11687,17239;17344;19518;20988,27375,1,1,2,0,4
42207,90,11688,16834;17076;20918,27375,1,0,2,0,3
42208,90,11689,16844;17136,27375,0,0,2,0,2
42209,90,11690,16853;17312;19418;19488;19632;20635;21066,27375,2,3,2,0,7
42210,90,11691,16435;16797;20218;20393,27375,0,2,2,0,4
42211,90,11692,16864;17160;20578,27375,1,0,2,0,3
42212,90,11693,16874;17286;20386,27375,0,1,2,0,3
42213,90,11694,16886;16972;20744;20893,27375,2,0,2,0,4
42214,90,11695,16894;17021;20125;20377;20663,27375,1,2,2,0,5
42215,90,11696,16711;16933;20207;20700,27375,1,1,2,0,4
42216,90,11697,16934;17194;19753;20587,27375,1,1,2,0,4
42217,90,11698,16938;16949,27375,0,0,2,0,2
42218,90,11699,16188;16945,27375,0,0,2,0,2
42219,90,11700,16960;17353;19360;19874;20209;20585,27375,1,3,2,0,6
42220,90,11701,16829;16965,27375,0,0,2,0,2
42221,90,11702,16526;16997,27375,0,0,2,0,2
42222,90,11703,17005;17057,27375,0,0,2,0,2
42223,90,11704,17015;17108;20094;20330,27375,0,2,2,0,4
42224,90,11705,16871;17039;19493;19721;20027,27375,0,3,2,0,5
42225,90,11706,16837;17065;19409;20088;20566,27375,1,2,2,0,5
42226,90,11707,17035;17070,27375,0,0,2,0,2
42227,90,11708,16740;17080;20144,27375,0,1,2,0,3
42228,90,11709,16824;17328;19862;20307;20989,27375,1,2,2,0,5
42229,90,11710,17090;17488;19380;20100;20267;20558,27375,1,3,2,0,6
42230,90,11711,17151;17201;20359,27375,0,1,2,0,3
42231,90,11712,17131;17156;20792,27375,1,0,2,0,3
42232,90,11713,16727;17118;19482;19623;20098;20223,27375,0,4,2,0,6
42233,90,11714,17562;19707;19987,27375,0,2,1,0,3
42234,90,11715,17206;17357;19625;20106;20199;20406;20774,27375,1,4,2,0,7
42235,90,11716,16840;17223;20503;20897,27375,1,1,2,0,4
42236,90,11717,17088;17241;20283;20959,27375,1,1,2,0,4
42237,90,11718,16899;16995;20030;20354,27375,0,2,2,0,4
42238,90,11719,12042,27740,0,0,0,1,1
42239,90,11720,11930;12045,27740,0,0,0,2,2
42240,90,11721,12213,27740,0,0,0,1,1
42241,90,11722,12161,27740,0,0,0,1,1
42242,90,11723,12120,27740,0,0,0,1,1
42243,90,11725,11645,27740,0,0,0,1,1
42244,90,11726,12608;12655,27740,0,0,0,2,2
42245,90,11731,12915,27740,0,0,0,1,1
42246,90,11734,13235;13411,27740,0,0,1,1,2
42247,90,11736,13404,27740,0,0,1,0,1
42248,90,11738,13397;13671,27740,0,0,2,0,2
42249,90,11741,13162,27740,0,0,0,1,1
42250,90,11748,13685;14322,27740,0,0,2,0,2
42251,90,11750,14539;15089;20178,27740,0,1,2,0,3
42252,90,11754,15092;15178,27740,0,0,2,0,2
42253,90,11755,14979;15590,27740,0,0,2,0,2
42254,90,11758,15226;15775;19867;20253,27740,0,2,2,0,4
42255,90,11762,16468;20371;20846,27740,1,1,1,0,3
42256,90,11764,16484;20119,27740,0,1,1,0,2
42257,90,11766,16291;16534;19613,27740,0,1,2,0,3
42258,90,11768,16676;16892;20028;20927,27740,1,1,2,0,4
42259,90,11769,16687;17012;20343;20599,27740,1,1,2,0,4
42260,90,11770,16742;20389,27740,0,1,1,0,2
42261,90,11771,16266;16589;19845;20902,27740,1,1,2,0,4
42262,90,11772,16460;16778;19943;20743,27740,1,1,2,0,4
42263,90,11773,16282;19745;19926,27740,0,2,1,0,3
42264,90,11774,16955;17437;20837,27740,1,0,2,0,3
42265,90,11775,16810;17243;19693;19807;20457,27740,0,3,2,0,5
42266,90,11776,17187;17251;19525,27740,0,1,2,0,3
42267,90,11777,16893;20418;20694,27740,1,1,1,0,3
42268,90,11778,16582;16614,27740,0,0,2,0,2
42269,90,11780,16592;16885;21061,27740,1,0,2,0,3
42270,90,11781,16902;17315;20531,27740,1,0,2,0,3
42271,90,11782,17188;17394;19627,27740,0,1,2,0,3
42272,90,11783,16802;16946;20823;21008,27740,2,0,2,0,4
42273,90,11784,16980;16985;20039;20554;20705;20954,27740,3,1,2,0,6
42274,90,11785,16964;16998;19893;20593,27740,1,1,2,0,4
42275,90,11786,17010;17092;19902;19982,27740,0,2,2,0,4
42276,90,11787,16817;17023,27740,0,0,2,0,2
42277,90,11788,17040;17059;19735;19916,27740,0,2,2,0,4
42278,90,11789,17048;17140;20489;20907,27740,1,1,2,0,4
42279,90,11790,17099;17410;19912;21070,27740,1,1,2,0,4
42280,90,11791,17104;17687;19501,27740,0,1,2,0,3
42281,90,11792,17121;17504,27740,0,0,2,0,2
42282,90,11793,17125;17655;20680,27740,1,0,2,0,3
42283,90,11794,17142;17235;19600;19953,27740,0,2,2,0,4
42284,90,11795,16701;17152;20309,27740,0,1,2,0,3
42285,90,11796,17164;19475;19743,27740,0,2,1,0,3
42286,90,11797,17093;17175;20707;20926,27740,2,0,2,0,4
42287,90,11798,17181;17507;21044,27740,1,0,2,0,3
42288,90,11799,17203;17420;20059;20996,27740,1,1,2,0,4
42289,90,11800,17209;17445;20552,27740,1,0,2,0,3
42290,90,11801,17183;17302;20325,27740,0,1,2,0,3
42291,90,11802,17182;17252;20628;20864,27740,2,0,2,0,4
42292,90,11803,17255;17644;19519;19873;20004;20460;20822,27740,1,4,2,0,7
42293,90,11804,17256;17278;20037,27740,0,1,2,0,3
42294,90,11805,17289;19569;19687;21060,27740,1,2,1,0,4
42295,90,11806,17295;17371;19554;20879,27740,1,1,2,0,4
42296,90,11807,17236;19524;19785;20016,27740,0,3,1,0,4
42297,90,11808,17285;17325;19574;20239;20839,27740,1,2,2,0,5
42298,90,11809,17333;17482;19540;20311,27740,0,2,2,0,4
42299,90,11810,17335;17403;19888,27740,0,1,2,0,3
42300,90,11811,12090,28105,0,0,0,1,1
42301,90,11812,12116,28105,0,0,0,1,1
42302,90,11814,12250;12339,28105,0,0,0,2,2
42303,90,11815,12340;12345,28105,0,0,0,2,2
42304,90,11816,12094,28105,0,0,0,1,1
42305,90,11817,12566,28105,0,0,0,1,1
42306,90,11819,12272;12620,28105,0,0,0,2,2
42307,90,11820,12624,28105,0,0,0,1,1
42308,90,11822,12684,28105,0,0,0,1,1
42309,90,11827,13148;13617,28105,0,0,1,1,2
42310,90,11828,12421,28105,0,0,0,1,1
42311,90,11829,12449,28105,0,0,0,1,1
42312,90,11833,13080,28105,0,0,0,1,1
42313,90,11837,13794;14300,28105,0,0,2,0,2
42314,90,11843,13670;13785,28105,0,0,2,0,2
42315,90,11844,14391;14696,28105,0,0,2,0,2
42316,90,11845,13992;14402,28105,0,0,2,0,2
42317,90,11848,14106;14641,28105,0,0,2,0,2
42318,90,11849,14249;14768,28105,0,0,2,0,2
42319,90,11852,15216;15305,28105,0,0,2,0,2
42320,90,11854,15205;15787;20110,28105,0,1,2,0,3
42321,90,11856,15445;15792,28105,0,0,2,0,2
42322,90,11858,15493;19670,28105,0,1,1,0,2
42323,90,11860,15567,28105,0,0,1,0,1
42324,90,11861,15378;15399,28105,0,0,2,0,2
42325,90,11863,15535,28105,0,0,1,0,1
42326,90,11865,16391,28105,0,0,1,0,1
42327,90,11866,16574;16682;20206;20751,28105,1,1,2,0,4
42328,90,11867,16094,28105,0,0,1,0,1
42329,90,11869,16212;16943;20714,28105,1,0,2,0,3
42330,90,11870,16615;16657;19747,28105,0,1,2,0,3
42331,90,11872,16082;16290;19708;20415;20672,28105,1,2,2,0,5
42332,90,11873,16394;16760;19751;20536;20812,28105,2,1,2,0,5
42333,90,11874,16166;16408;20074;20385,28105,0,2,2,0,4
42334,90,11876,16459;17139;20820,28105,1,0,2,0,3
42335,90,11877,16052;16633;19682;19947,28105,0,2,2,0,4
42336,90,11878,16441,28105,0,0,1,0,1
42337,90,11879,16502;16547;19882;20623,28105,1,1,2,0,4
42338,90,11880,16018;16520;20146;20456,28105,0,2,2,0,4
42339,90,11881,16521,28105,0,0,1,0,1
42340,90,11882,16527,28105,0,0,1,0,1
42341,90,11883,16451;16529;20157;20465,28105,0,2,2,0,4
42342,90,11884,16222;16587;19833;20459,28105,0,2,2,0,4
42343,90,11885,16090;16590;19598;19796,28105,0,2,2,0,4
42344,90,11886,16591;16658;20887,28105,1,0,2,0,3
42345,90,11887,16401;16598;20427,28105,0,1,2,0,3
42346,90,11888,16607;16910;20404;20575,28105,1,1,2,0,4
42347,90,11889,16411;16983;20053;20561;20779,28105,2,1,2,0,5
42348,90,11890,16655;16975;19731;19956;20786,28105,1,2,2,0,5
42349,90,11893,16882;16951,28105,0,0,2,0,2
42350,90,11894,17282;20763,28105,1,0,1,0,2
42351,90,11895,16887;16939;19612;19918;20488,28105,0,3,2,0,5
42352,90,11896,16890;17190;20769,28105,1,0,2,0,3
42353,90,11897,16922;17329;19949,28105,0,1,2,0,3
42354,90,11898,17067;19944;20291;21042,28105,1,2,1,0,4
42355,90,11899,17082;17216;19851;20653,28105,1,1,2,0,4
42356,90,11900,17054;17468;20586;20753,28105,2,0,2,0,4
42357,90,11901,16923;17073;19921;20184,28105,0,2,2,0,4
42358,90,11902,17097;17384;20453,28105,0,1,2,0,3
42359,90,11903,17111;17440;20449,28105,0,1,2,0,3
42360,90,11904,17124;17270;20092;20381,28105,0,2,2,0,4
42361,90,11905,16872;17264;20295,28105,0,1,2,0,3
42362,90,11906,17147;17298;19799;20031;20619,28105,1,2,2,0,5
42363,90,11907,17326;17453;19594;20131;20235;20612;20948,28105,2,3,2,0,7
42364,90,11908,17254;19683;19961;20374,28105,0,3,1,0,4
42365,90,11909,17259;17301;19786;20197,28105,0,2,2,0,4
42366,90,11911,17277;17683;19608;20217;20271;20535;20690,28105,2,3,2,0,7
42367,90,11912,17034;17284;19878;20345;20673,28105,1,2,2,0,5
42368,90,11913,17290;17336;20041;21072,28105,1,1,2,0,4
42369,90,11914,17308;17566;19604;19725,28105,0,2,2,0,4
42370,90,11915,17338;20434;20891,28105,1,1,1,0,3
42371,90,11916,17342;17417,28105,0,0,2,0,2
42372,90,11917,17348;17399;20841,28105,1,0,2,0,3
42373,90,11918,17354;17606;19578;20370,28105,0,2,2,0,4
42374,90,11919,17359;17545;19883;20084,28105,0,2,2,0,4
42375,90,11920,17133;17775;20845;21068,28105,2,0,2,0,4
42376,90,11921,17492;17692;19583;19801,28105,0,2,2,0,4
42377,90,11922,17549;17761,28105,0,0,2,0,2
42378,90,11923,17439;17486;20688;20973,28105,2,0,2,0,4
42379,90,11924,17456;17525;19596;19996;20789,28105,1,2,2,0,5
42380,90,11925,12461,28470,0,0,0,1,1
42381,90,11928,11660,28470,0,0,0,1,1
42382,90,11929,12256,28470,0,0,0,1,1
42383,90,11930,12448,28470,0,0,0,1,1
42384,90,11931,12436,28470,0,0,0,1,1
42385,90,11932,12546;13180,28470,0,0,0,2,2
42386,90,11933,12591,28470,0,0,0,1,1
42387,90,11935,12308;12357,28470,0,0,0,2,2
42388,90,11936,12921,28470,0,0,0,1,1
42389,90,11937,12831,28470,0,0,0,1,1
42390,90,11938,12958,28470,0,0,0,1,1
42391,90,11939,12992,28470,0,0,0,1,1
42392,90,11941,12777;12851,28470,0,0,0,2,2
42393,90,11942,13523,28470,0,0,1,0,1
42394,90,11950,15084,28470,0,0,1,0,1
42395,90,11952,14230;14801,28470,0,0,2,0,2
42396,90,11953,14286,28470,0,0,1,0,1
42397,90,11954,14477;14631,28470,0,0,2,0,2
42398,90,11955,14508;14511,28470,0,0,2,0,2
42399,90,11959,15038,28470,0,0,1,0,1
42400,90,11960,14312,28470,0,0,1,0,1
42401,90,11970,15680,28470,0,0,1,0,1
42402,90,11971,15323;15725,28470,0,0,2,0,2
42403,90,11972,15099;15311,28470,0,0,2,0,2
42404,90,11973,15083;15314,28470,0,0,2,0,2
42405,90,11975,15456;15635,28470,0,0,2,0,2
42406,90,11978,15264;15933;19719,28470,0,1,2,0,3
42407,90,11981,15572,28470,0,0,1,0,1
42408,90,11982,15246,28470,0,0,1,0,1
42409,90,11984,14938;15640,28470,0,0,2,0,2
42410,90,11986,15849;15998;19936,28470,0,1,2,0,3
42411,90,11987,14769;15224,28470,0,0,2,0,2
42412,90,11989,16060;16239;19869,28470,0,1,2,0,3
42413,90,11992,16395,28470,0,0,1,0,1
42414,90,11993,16331;16335;20411;20912,28470,1,1,2,0,4
42415,90,11994,15744;15899,28470,0,0,2,0,2
42416,90,11997,16323;16583;20388,28470,0,1,2,0,3
42417,90,11998,16572;16920;19818;20278,28470,0,2,2,0,4
42418,90,11999,16717;16914;20740;20764,28470,2,0,2,0,4
42419,90,12000,17217;17311;20397;20998,28470,1,1,2,0,4
42420,90,12001,16731;16780;20090;20407;20532,28470,1,2,2,0,5
42421,90,12002,16812;17119;20181;20426,28470,0,2,2,0,4
42422,90,12003,17112;17115;19981;20203;20500,28470,0,3,2,0,5
42423,90,12004,16838;17046,28470,0,0,2,0,2
42424,90,12005,16839;17527;20064;20287,28470,0,2,2,0,4
42425,90,12006,16730;17098;20372,28470,0,1,2,0,3
42426,90,12007,16969;17400;20770,28470,1,0,2,0,3
42427,90,12008,16987;17645;19761,28470,0,1,2,0,3
42428,90,12009,17330;20526;20970,28470,2,0,1,0,3
42429,90,12010,17018;17249,28470,0,0,2,0,2
42430,90,12011,17050,28470,0,0,1,0,1
42431,90,12012,17405;20265,28470,0,1,1,0,2
42432,90,12013,17049;17096;19940;20188;20462,28470,0,3,2,0,5
42433,90,12014,16635,28470,0,0,1,0,1
42434,90,12015,17107;17211;20356;20613;20692,28470,2,1,2,0,5
42435,90,12016,17161;17552,28470,0,0,2,0,2
42436,90,12017,17179;17275;19739;20294,28470,0,2,2,0,4
42437,90,12018,17184;17706;19858;20200,28470,0,2,2,0,4
42438,90,12019,17189;17704;19895;20242,28470,0,2,2,0,4
42439,90,12020,17199;17684;19722;21011,28470,1,1,2,0,4
42440,90,12021,17401;17536;19704,28470,0,1,2,0,3
42441,90,12022,17208;17528,28470,0,0,2,0,2
42442,90,12023,17233;19826;20384;20498,28470,0,3,1,0,4
42443,90,12024,17273;17538,28470,0,0,2,0,2
42444,90,12025,17276;20725,28470,1,0,1,0,2
42445,90,12026,17268;17304;20349;20437,28470,0,2,2,0,4
42446,90,12027,17313;17450;20614;20956,28470,2,0,2,0,4
42447,90,12028,17316;17646;20023;20234;20598,28470,1,2,2,0,5
42448,90,12029,17322;17729;19737;20331;20861,28470,1,2,2,0,5
42449,90,12030,17192;17323;20591;20940,28470,2,0,2,0,4
42450,90,12031,17165;17364;19701,28470,0,1,2,0,3
42451,90,12032,17337;17406;19866;20210;20825,28470,1,2,2,0,5
42452,90,12033,17419;20579;20895,28470,2,0,1,0,3
42453,90,12034,17319;17433;19876;20687;20888,28470,2,1,2,0,5
42454,90,12035,17016;17436;19815,28470,0,1,2,0,3
42455,90,12036,17162;17455;20410,28470,0,1,2,0,3
42456,90,12037,17294;17467;19824;20097,28470,0,2,2,0,4
42457,90,12038,17472,28470,0,0,1,0,1
42458,90,12039,17476;17565;20506;20583,28470,1,1,2,0,4
42459,90,12040,17484;17763;20499,28470,0,1,2,0,3
42460,90,12041,17489;17630;20993,28470,1,0,2,0,3
42461,90,12042,17494;17580,28470,0,0,2,0,2
42462,90,12043,17521;17712;20066;20469;21005,28470,1,2,2,0,5
42463,90,12044,17551;17874;19705;19922,28470,0,2,2,0,4
42464,90,12045,17969;19689;20076;20277;20747,28470,1,3,1,0,5
42465,90,12046,17570;20983,28470,1,0,1,0,2
42466,90,12048,12140,28835,0,0,0,1,1
42467,90,12049,12084,28835,0,0,0,1,1
42468,90,12050,12467,28835,0,0,0,1,1
42469,90,12051,12506,28835,0,0,0,1,1
42470,90,12052,12224,28835,0,0,0,1,1
42471,90,12054,12648,28835,0,0,0,1,1
42472,90,12057,12503,28835,0,0,0,1,1
42473,90,12058,13005,28835,0,0,0,1,1
42474,90,12060,13324;13347,28835,0,0,2,0,2
42475,90,12062,13308;13684,28835,0,0,2,0,2
42476,90,12068,13050,28835,0,0,0,1,1
42477,90,12069,13880,28835,0,0,1,0,1
42478,90,12072,13596;14332,28835,0,0,2,0,2
42479,90,12075,14362,28835,0,0,1,0,1
42480,90,12079,14626;15369,28835,0,0,2,0,2
42481,90,12083,15076;15315,28835,0,0,2,0,2
42482,90,12086,15079;15137,28835,0,0,2,0,2
42483,90,12093,15387,28835,0,0,1,0,1
42484,90,12095,14960,28835,0,0,1,0,1
42485,90,12099,15809,28835,0,0,1,0,1
42486,90,12100,16258;20373,28835,0,1,1,0,2
42487,90,12104,15571;16061,28835,0,0,2,0,2
42488,90,12105,15250,28835,0,0,1,0,1
42489,90,12106,16075;16271;19842;20103,28835,0,2,2,0,4
42490,90,12107,16079;16858,28835,0,0,2,0,2
42491,90,12110,16277,28835,0,0,1,0,1
42492,90,12111,16367;16861;21027,28835,1,0,2,0,3
42493,90,12112,16374;16680,28835,0,0,2,0,2
42494,90,12113,16378;16875;20544,28835,1,0,2,0,3
42495,90,12115,16752;17086;20645,28835,1,0,2,0,3
42496,90,12116,16767;17351;20473;20553,28835,1,1,2,0,4
42497,90,12117,16815,28835,0,0,1,0,1
42498,90,12118,16850;17305;20230;20269,28835,0,2,2,0,4
42499,90,12119,16855;17013;20917,28835,1,0,2,0,3
42500,90,12120,16898,28835,0,0,1,0,1
42501,90,12121,16640,28835,0,0,1,0,1
42502,90,12122,16950;17186;20180;20985,28835,1,1,2,0,4
42503,90,12123,16952;17204;20630,28835,1,0,2,0,3
42504,90,12124,17000;17228;20475,28835,0,1,2,0,3
42505,90,12126,16789;17213;20322;20883,28835,1,1,2,0,4
42506,90,12128,17269;20005;20091;20382,28835,0,3,1,0,4
42507,90,12129,17123;17341;20196;20551;21019,28835,2,1,2,0,5
42508,90,12130,17556;17788;20721,28835,1,0,2,0,3
42509,90,12131,17368;17385;20049;20808;20892;21014,28835,3,1,2,0,6
42510,90,12132,17539;20702,28835,1,0,1,0,2
42511,90,12133,16996;17435;20611,28835,1,0,2,0,3
42512,90,12134,17438;17701;19811;20601,28835,1,1,2,0,4
42513,90,12135,17395;17443;20662,28835,1,0,2,0,3
42514,90,12136,17485;17868;19993;20227;20414;20638,28835,1,3,2,0,6
42515,90,12137,17110;17497;20569;20818;21025,28835,3,0,2,0,5
42516,90,12138,17517;17613;20433;20776,28835,1,1,2,0,4
42517,90,12139,17544;17750;20947,28835,1,0,2,0,3
42518,90,12140,17520;17547;20419;20980,28835,1,1,2,0,4
42519,90,12141,17548;17779,28835,0,0,2,0,2
42520,90,12142,17557;17679,28835,0,0,2,0,2
42521,90,12143,17559;17585;19980;20163,28835,0,2,2,0,4
42522,90,12144,17245;17567,28835,0,0,2,0,2
42523,90,12145,17579;17982,28835,0,0,2,0,2
42524,90,12146,17597;17682;20122;20758,28835,1,1,2,0,4
42525,90,12147,17607;17944;19838,28835,0,1,2,0,3
42526,90,12148,17622;20901,28835,1,0,1,0,2
42527,90,12149,17423;17626;20494;20851,28835,1,1,2,0,4
42528,90,12150,17263;17639;20350,28835,0,1,2,0,3
42529,90,12151,17642;17847;19891;20880,28835,1,1,2,0,4
42530,90,12152,17648;17777;20256,28835,0,1,2,0,3
42531,90,12153,17272;17651;20313;20960,28835,1,1,2,0,4
42532,90,12154,17553;17652;19915;20555;20757,28835,2,1,2,0,5
42533,90,12155,17657;17947;20813;20953,28835,2,0,2,0,4
42534,90,12156,17505;17675;20445;20668,28835,1,1,2,0,4
42535,90,12157,17681;19835;20480,28835,0,2,1,0,3
42536,90,12158,12651;12908,29200,0,0,0,2,2
42537,90,12159,12686,29200,0,0,0,1,1
42538,90,12160,12165,29200,0,0,0,1,1
42539,90,12161,12748,29200,0,0,0,1,1
42540,90,12162,12273,29200,0,0,0,1,1
42541,90,12164,12601,29200,0,0,0,1,1
42542,90,12165,13239,29200,0,0,1,0,1
42543,90,12168,13330,29200,0,0,1,0,1
42544,90,12171,13781,29200,0,0,1,0,1
42545,90,12174,14083;14799,29200,0,0,2,0,2
42546,90,12178,14745,29200,0,0,1,0,1
42547,90,12186,14473,29200,0,0,1,0,1
42548,90,12189,15173,29200,0,0,1,0,1
42549,90,12191,15051;15539,29200,0,0,2,0,2
42550,90,12195,15271;15777,29200,0,0,2,0,2
42551,90,12196,14898,29200,0,0,1,0,1
42552,90,12197,15341;15683,29200,0,0,2,0,2
42553,90,12200,15526;15555,29200,0,0,2,0,2
42554,90,12201,15597,29200,0,0,1,0,1
42555,90,12203,15659,29200,0,0,1,0,1
42556,90,12204,15487;16235,29200,0,0,2,0,2
42557,90,12205,15724,29200,0,0,1,0,1
42558,90,12207,15957;16566;20417;20733,29200,1,1,2,0,4
42559,90,12208,15716;15720,29200,0,0,2,0,2
42560,90,12209,16046;16328;19930;20279;20931,29200,1,2,2,0,5
42561,90,12210,15476,29200,0,0,1,0,1
42562,90,12212,16100;16217;19933,29200,0,1,2,0,3
42563,90,12213,15875,29200,0,0,1,0,1
42564,90,12215,16224;16292;20932,29200,1,0,2,0,3
42565,90,12216,16383,29200,0,0,1,0,1
42566,90,12219,16524;16958;19931;20194,29200,0,2,2,0,4
42567,90,12220,16316;16595;20260,29200,0,1,2,0,3
42568,90,12222,16713;17071;20361;20717;20761,29200,2,1,2,0,5
42569,90,12223,16723;16970;21041,29200,1,0,2,0,3
42570,90,12224,16133;16414;20432,29200,0,1,2,0,3
42571,90,12225,16259;16750;20737;21021,29200,2,0,2,0,4
42572,90,12226,16757;17143;20225;20468,29200,0,2,2,0,4
42573,90,12227,17084;17398;20723,29200,1,0,2,0,3
42574,90,12228,16515;16801,29200,0,0,2,0,2
42575,90,12230,16622;16895;20112;20280;20934,29200,1,2,2,0,5
42576,90,12231,17469;20299;20577;20999,29200,2,1,1,0,4
42577,90,12232,17008,29200,0,0,1,0,1
42578,90,12233,17446;20600,29200,1,0,1,0,2
42579,90,12234,17056;17173;19942;20939,29200,1,1,2,0,4
42580,90,12235,16961;17078;20099;20183;20682,29200,1,2,2,0,5
42581,90,12236,17105;17697;20719;21037,29200,2,0,2,0,4
42582,90,12237,16994;17157;20450;20633,29200,1,1,2,0,4
42583,90,12238,17167;17224;19968;20369,29200,0,2,2,0,4
42584,90,12239,17225;17654,29200,0,0,2,0,2
42585,90,12240,17234;17535,29200,0,0,2,0,2
42586,90,12241,17267;17442;19974,29200,0,1,2,0,3
42587,90,12242,17283;17428;20022,29200,0,1,2,0,3
42588,90,12243,17447;20363,29200,0,1,1,0,2
42589,90,12246,16764;16948;20574;20854,29200,2,0,2,0,4
42590,90,12248,17430;20251,29200,0,1,1,0,2
42591,90,12249,17232;17444;20870,29200,1,0,2,0,3
42592,90,12250,17479;17717;19959;20497;20894,29200,1,2,2,0,5
42593,90,12251,17501,29200,0,0,1,0,1
42594,90,12252,17515;20548;20674;20972,29200,3,0,1,0,4
42595,90,12253,17577;17741;19934;20301,29200,0,2,2,0,4
42596,90,12254,17586;17808,29200,0,0,2,0,2
42597,90,12255,17462;17588,29200,0,0,2,0,2
42598,90,12256,17596;20911,29200,1,0,1,0,2
42599,90,12257,17632;17972;21064,29200,1,0,2,0,3
42600,90,12258,17532;17635;20708;21069,29200,2,0,2,0,4
42601,90,12259,17650;18084;20133;20470,29200,0,2,2,0,4
42602,90,12260,17387;17614;20855,29200,1,0,2,0,3
42603,90,12261,17715;17767;20798,29200,1,0,2,0,3
42604,90,12262,17460;17739;20709,29200,1,0,2,0,3
42605,90,12263,12231,29565,0,0,0,1,1
42606,90,12265,12696,29565,0,0,0,1,1
42607,90,12266,12632,29565,0,0,0,1,1
42608,90,12268,12669,29565,0,0,0,1,1
42609,90,12269,12874,29565,0,0,0,1,1
42610,90,12271,12886;13370,29565,0,0,1,1,2
42611,90,12272,12301,29565,0,0,0,1,1
42612,90,12274,13218,29565,0,0,0,1,1
42613,90,12276,13345,29565,0,0,1,0,1
42614,90,12277,13362;13514,29565,0,0,2,0,2
42615,90,12278,13192,29565,0,0,0,1,1
42616,90,12280,13580,29565,0,0,1,0,1
42617,90,12281,13372;13825,29565,0,0,2,0,2
42618,90,12282,13443,29565,0,0,1,0,1
42619,90,12283,13878,29565,0,0,1,0,1
42620,90,12286,14045;14244,29565,0,0,2,0,2
42621,90,12290,14116;14755,29565,0,0,2,0,2
42622,90,12293,14883;15248,29565,0,0,2,0,2
42623,90,12294,14538,29565,0,0,1,0,1
42624,90,12298,15492;15800,29565,0,0,2,0,2
42625,90,12299,15140;15145,29565,0,0,2,0,2
42626,90,12300,15303,29565,0,0,1,0,1
42627,90,12301,15670;15954,29565,0,0,2,0,2
42628,90,12304,15946;16426,29565,0,0,2,0,2
42629,90,12308,15767,29565,0,0,1,0,1
42630,90,12309,16072,29565,0,0,1,0,1
42631,90,12311,16522;16979;20075;20281,29565,0,2,2,0,4
42632,90,12314,16434;16746;20522,29565,1,0,2,0,3
42633,90,12316,16862,29565,0,0,1,0,1
42634,90,12317,16863,29565,0,0,1,0,1
42635,90,12318,17191,29565,0,0,1,0,1
42636,90,12320,17081;17171;21026,29565,1,0,2,0,3
42637,90,12321,16639;17138;20603;20646,29565,2,0,2,0,4
42638,90,12322,17126;17408;20483,29565,0,1,2,0,3
42639,90,12323,17172;20394;20649,29565,1,1,1,0,3
42640,90,12324,17200;17372;20336,29565,0,1,2,0,3
42641,90,12325,16978;17279;20304;20903,29565,1,1,2,0,4
42642,90,12326,17280;17360;20568,29565,1,0,2,0,3
42643,90,12327,16989;17324;20550;21055,29565,2,0,2,0,4
42644,90,12328,17373;17866;20114;21048,29565,1,1,2,0,4
42645,90,12329,17378;17498,29565,0,0,2,0,2
42646,90,12330,17212;17392;20443;20802,29565,1,1,2,0,4
42647,90,12331,17407;17829,29565,0,0,2,0,2
42648,90,12332,17432;17738;20507;20576,29565,1,1,2,0,4
42649,90,12333,17376;17458;20652,29565,1,0,2,0,3
42650,90,12334,17508;17939;20321;20964,29565,1,1,2,0,4
42651,90,12335,17513;17658;20525;21054,29565,2,0,2,0,4
42652,90,12336,17519;17542,29565,0,0,2,0,2
42653,90,12337,17412;17582;20780,29565,1,0,2,0,3
42654,90,12338,17464;17583;20259;21073,29565,1,1,2,0,4
42655,90,12339,17541;17584;20510,29565,0,1,2,0,3
42656,90,12340,17593;17667;20458;20997,29565,1,1,2,0,4
42657,90,12341,17001;17611,29565,0,0,2,0,2
42658,90,12342,17641;18186;20166;20326;20639,29565,1,2,2,0,5
42659,90,12343,17653;17872;21024,29565,1,0,2,0,3
42660,90,12344,17659;20664,29565,1,0,1,0,2
42661,90,12345,17668;17844;20250;20816;21067,29565,2,1,2,0,5
42662,90,12346,17159;17690;20508;20768,29565,1,1,2,0,4
42663,90,12347,17694;18196;20390;20858,29565,1,1,2,0,4
42664,90,12348,17751;17968;20141,29565,0,1,2,0,3
42665,90,12349,17753;17756;20519;20686;20941,29565,3,0,2,0,5
42666,90,12350,17769;17773;20872,29565,1,0,2,0,3
42667,90,12351,17780;17952,29565,0,0,2,0,2
42668,90,12352,17778;17802;20160;20967,29565,1,1,2,0,4
42669,90,12353,17636;17804;20159,29565,0,1,2,0,3
42670,90,12354,17491;17825;20073,29565,0,1,2,0,3
42671,90,12355,17748;17831;20616,29565,1,0,2,0,3
42672,90,12356,17835;17914;20413,29565,0,1,2,0,3
42673,90,12357,17589;17848;20333;20448,29565,0,2,2,0,4
42674,90,12358,17801;17861;20155;20710,29565,1,1,2,0,4
42675,90,12359,17792;17878,29565,0,0,2,0,2
42676,90,12360,17879;18048;20081;20615,29565,1,1,2,0,4
42677,90,12361,12352;12899,29930,0,0,0,2,2
42678,90,12362,12415,29930,0,0,0,1,1
42679,90,12363,12746,29930,0,0,0,1,1
42680,90,12364,13092,29930,0,0,0,1,1
42681,90,12366,12641,29930,0,0,0,1,1
42682,90,12370,13683;13955,29930,0,0,2,0,2
42683,90,12371,13817,29930,0,0,1,0,1
42684,90,12373,13983;14111,29930,0,0,2,0,2
42685,90,12374,14037,29930,0,0,1,0,1
42686,90,12376,13884,29930,0,0,1,0,1
42687,90,12377,14330,29930,0,0,1,0,1
42688,90,12389,15621,29930,0,0,1,0,1
42689,90,12392,15832,29930,0,0,1,0,1
42690,90,12393,15835,29930,0,0,1,0,1
42691,90,12395,16088;16363,29930,0,0,2,0,2
42692,90,12396,16137;16402,29930,0,0,2,0,2
42693,90,12397,15665;16279;20151,29930,0,1,2,0,3
42694,90,12398,15948;16257;20284,29930,0,1,2,0,3
42695,90,12399,16308;16418,29930,0,0,2,0,2
42696,90,12400,16211,29930,0,0,1,0,1
42697,90,12401,16602;17130,29930,0,0,2,0,2
42698,90,12402,16656;17218;20896,29930,1,0,2,0,3
42699,90,12403,16636;16763;20237;20749,29930,1,1,2,0,4
42700,90,12404,16647;16748;20463,29930,0,1,2,0,3
42701,90,12405,16691;17052;20164;20622,29930,1,1,2,0,4
42702,90,12406,16881;17094;20152;21010,29930,1,1,2,0,4
42703,90,12407,16937;17230;20834,29930,1,0,2,0,3
42704,90,12408,16628;16695;20742,29930,1,0,2,0,3
42705,90,12409,16956,29930,0,0,1,0,1
42706,90,12410,16967;17425;20162,29930,0,1,2,0,3
42707,90,12411,17041;20559,29930,1,0,1,0,2
42708,90,12412,17037;17427;20493,29930,0,1,2,0,3
42709,90,12413,17296;17495;20785,29930,1,0,2,0,3
42710,90,12414,17198;17696;20978,29930,1,0,2,0,3
42711,90,12415,17247;17514;20617,29930,1,0,2,0,3
42712,90,12416,17288;17616,29930,0,0,2,0,2
42713,90,12417,17089;17660,29930,0,0,2,0,2
42714,90,12418,17366;17500,29930,0,0,2,0,2
42715,90,12419,17074;17377;20538;20665,29930,2,0,2,0,4
42716,90,12420,17380;17758;20368;20399,29930,0,2,2,0,4
42717,90,12421,17202;20610,29930,1,0,1,0,2
42718,90,12422,17413;18096;20817,29930,1,0,2,0,3
42719,90,12423,17242;17426;20150,29930,0,1,2,0,3
42720,90,12424,17474;17496;20760,29930,1,0,2,0,3
42721,90,12425,17499;17841,29930,0,0,2,0,2
42722,90,12426,17707;17708;20254;20402;20963,29930,1,2,2,0,5
42723,90,12427,17550;18107;20208;20477,29930,0,2,2,0,4
42724,90,12428,17561;17711;20727,29930,1,0,2,0,3
42725,90,12429,17465;17598;20429;20795;21012,29930,2,1,2,0,5
42726,90,12430,18160,29930,0,0,1,0,1
42727,90,12431,17772;18036;20263;20828,29930,1,1,2,0,4
42728,90,12432,17781;18189;20192;20563,29930,1,1,2,0,4
42729,90,12433,17787,29930,0,0,1,0,1
42730,90,12434,17797;18125;20312;20607,29930,1,1,2,0,4
42731,90,12435,17434;17817;20490,29930,0,1,2,0,3
42732,90,12436,17818,29930,0,0,1,0,1
42733,90,12437,17795;17824;20249;20541;20842;21015,29930,3,1,2,0,6
42734,90,12438,17830;17880;20884,29930,1,0,2,0,3
42735,90,12439,17350;17845;20205,29930,0,1,2,0,3
42736,90,12440,17887,29930,0,0,1,0,1
42737,90,12441,17736;17853;20423;20949,29930,1,1,2,0,4
42738,90,12442,17963,29930,0,0,1,0,1
42739,90,12443,17864;17918;20669,29930,1,0,2,0,3
42740,90,12444,17466;17869;20889,29930,1,0,2,0,3
42741,90,12445,17441;17882,29930,0,0,2,0,2
42742,90,12446,17483;17884;20722;21053,29930,2,0,2,0,4
42743,90,12447,17888;18144,29930,0,0,2,0,2
42744,90,12448,17937;18101;20204;20582;20741;20765,29930,3,1,2,0,6
42745,90,12449,17991;18094,29930,0,0,2,0,2
42746,90,12450,17860;17999,29930,0,0,2,0,2
42747,90,12451,12398,30295,0,0,0,1,1
42748,90,12453,12435,30295,0,0,0,1,1
42749,90,12454,13174,30295,0,0,0,1,1
42750,90,12456,13334,30295,0,0,1,0,1
42751,90,12459,13614,30295,0,0,1,0,1
42752,90,12460,13674,30295,0,0,1,0,1
42753,90,12462,13716;13846,30295,0,0,2,0,2
42754,90,12464,13406,30295,0,0,1,0,1
42755,90,12465,13923,30295,0,0,1,0,1
42756,90,12469,14118;14324,30295,0,0,2,0,2
42757,90,12470,14289,30295,0,0,1,0,1
42758,90,12471,14307,30295,0,0,1,0,1
42759,90,12472,14002;14483,30295,0,0,2,0,2
42760,90,12474,14406;14455,30295,0,0,2,0,2
42761,90,12478,13850;14053,30295,0,0,2,0,2
42762,90,12479,14737;14823,30295,0,0,2,0,2
42763,90,12484,15077,30295,0,0,1,0,1
42764,90,12491,15691;15821,30295,0,0,2,0,2
42765,90,12495,15937;16379,30295,0,0,2,0,2
42766,90,12496,15985,30295,0,0,1,0,1
42767,90,12497,15619,30295,0,0,1,0,1
42768,90,12498,15695,30295,0,0,1,0,1
42769,90,12499,16127;16540;20431;20811,30295,1,1,2,0,4
42770,90,12501,15864;16233;20420,30295,0,1,2,0,3
42771,90,12503,16044;16465,30295,0,0,2,0,2
42772,90,12505,17244;20511,30295,0,1,1,0,2
42773,90,12506,16747;17197;20502,30295,0,1,2,0,3
42774,90,12507,16807,30295,0,0,1,0,1
42775,90,12508,16821;17120,30295,0,0,2,0,2
42776,90,12509,16360,30295,0,0,1,0,1
42777,90,12510,16847;17158;20832,30295,1,0,2,0,3
42778,90,12511,16877,30295,0,0,1,0,1
42779,90,12512,17011,30295,0,0,1,0,1
42780,90,12513,17109;17291;20516,30295,1,0,2,0,3
42781,90,12514,17238;17680;20814,30295,1,0,2,0,3
42782,90,12515,17205,30295,0,0,1,0,1
42783,90,12516,17332,30295,0,0,1,0,1
42784,90,12517,17421;17721;20320;20644,30295,1,1,2,0,4
42785,90,12518,17363;17564;20732;20929,30295,2,0,2,0,4
42786,90,12519,17572;18131,30295,0,0,2,0,2
42787,90,12520,17574;18004;20699;20908,30295,2,0,2,0,4
42788,90,12521,17624,30295,0,0,1,0,1
42789,90,12522,17820;20556;20805,30295,2,0,1,0,3
42790,90,12523,17409;17631;20383;20543,30295,1,1,2,0,4
42791,90,12524,17649;17727;20533,30295,1,0,2,0,3
42792,90,12525,17424;17666;20703,30295,1,0,2,0,3
42793,90,12526,17705;17746;20755,30295,1,0,2,0,3
42794,90,12527,17714;18210;20334,30295,0,1,2,0,3
42795,90,12528,17730;17735;20675;20885,30295,2,0,2,0,4
42796,90,12529,17699;17737;21006,30295,1,0,2,0,3
42797,90,12530,17840;20642;20831;20882,30295,3,0,1,0,4
42798,90,12531,17762;17794,30295,0,0,2,0,2
42799,90,12532,17774;17983,30295,0,0,2,0,2
42800,90,12533,17785;18169,30295,0,0,2,0,2
42801,90,12534,17789;17909,30295,0,0,2,0,2
42802,90,12535,17790,30295,0,0,1,0,1
42803,90,12536,17529;17842;20844,30295,1,0,2,0,3
42804,90,12537,17897;17902;20631,30295,1,0,2,0,3
42805,90,12538,17823;17906,30295,0,0,2,0,2
42806,90,12539,17703;18159;20472;20678;21017,30295,2,1,2,0,5
42807,90,12540,17913;17934,30295,0,0,2,0,2
42808,90,12541,17921;17998,30295,0,0,2,0,2
42809,90,12542,17870;17924;20416;20848,30295,1,1,2,0,4
42810,90,12543,17930;17935,30295,0,0,2,0,2
42811,90,12544,17733;17942,30295,0,0,2,0,2
42812,90,12545,17943;18162,30295,0,0,2,0,2
42813,90,12546,17803;17953,30295,0,0,2,0,2
42814,90,12547,17984;18368;20609;21039,30295,2,0,2,0,4
42815,90,12548,17916;17995;20366;20797,30295,1,1,2,0,4
42816,90,12549,17996;20726;21075,30295,2,0,1,0,3
42817,90,12550,17890;18002;20771;20955,30295,2,0,2,0,4
42818,90,12551,18010;18249,30295,0,0,2,0,2
42819,90,12552,18019;18353;20430;20618,30295,1,1,2,0,4
42820,90,12553,18044;18200,30295,0,0,2,0,2
42821,90,12554,18034;18092,30295,0,0,2,0,2
42822,90,12555,18063;18106,30295,0,0,2,0,2
42823,90,12557,18088;18103;20661;21063,30295,2,0,2,0,4
42824,90,12558,17867;18093;20293;20528;20643,30295,2,1,2,0,5
42825,90,12559,18058;18099;20492;20869,30295,1,1,2,0,4
42826,90,12560,13027,30660,0,0,0,1,1
42827,90,12561,12513,30660,0,0,0,1,1
42828,90,12562,13395;13570,30660,0,0,2,0,2
42829,90,12563,13113,30660,0,0,0,1,1
42830,90,12564,13267,30660,0,0,1,0,1
42831,90,12567,13260,30660,0,0,1,0,1
42832,90,12569,13736,30660,0,0,1,0,1
42833,90,12571,14263,30660,0,0,1,0,1
42834,90,12572,14423;14778,30660,0,0,2,0,2
42835,90,12573,14233;14383,30660,0,0,2,0,2
42836,90,12574,13836,30660,0,0,1,0,1
42837,90,12577,14906;15776,30660,0,0,2,0,2
42838,90,12584,15630;15664,30660,0,0,2,0,2
42839,90,12585,15741,30660,0,0,1,0,1
42840,90,12586,15805,30660,0,0,1,0,1
42841,90,12591,15672,30660,0,0,1,0,1
42842,90,12592,15703,30660,0,0,1,0,1
42843,90,12593,16305;16580,30660,0,0,2,0,2
42844,90,12594,16206,30660,0,0,1,0,1
42845,90,12595,16678;16865,30660,0,0,2,0,2
42846,90,12597,16724;17261;20422,30660,0,1,2,0,3
42847,90,12599,16823;17451;20398;20890;21065,30660,2,1,2,0,5
42848,90,12600,16843,30660,0,0,1,0,1
42849,90,12602,16542;17042,30660,0,0,2,0,2
42850,90,12603,16784;17141;20596,30660,1,0,2,0,3
42851,90,12604,16927,30660,0,0,1,0,1
42852,90,12605,16957;17215;20625;20803,30660,2,0,2,0,4
42853,90,12607,16859,30660,0,0,1,0,1
42854,90,12608,17523;20924,30660,1,0,1,0,2
42855,90,12610,17043;17222;20921,30660,1,0,2,0,3
42856,90,12611,17300;17429;20442,30660,0,1,2,0,3
42857,90,12612,17534,30660,0,0,1,0,1
42858,90,12613,17543;17771;20580;20735,30660,2,0,2,0,4
42859,90,12614,17554;18232,30660,0,0,2,0,2
42860,90,12615,17573;18381,30660,0,0,2,0,2
42861,90,12616,17599;18000;20562,30660,1,0,2,0,3
42862,90,12617,17343;17608;20992,30660,1,0,2,0,3
42863,90,12618,17985;20435,30660,0,1,1,0,2
42864,90,12619,17776;20925;21050,30660,2,0,1,0,3
42865,90,12620,17647;20937,30660,1,0,1,0,2
42866,90,12621,17656;18175;21003,30660,1,0,2,0,3
42867,90,12622,17560;17662;20685,30660,1,0,2,0,3
42868,90,12623,17722;17754;20852,30660,1,0,2,0,3
42869,90,12624,17702;18035;20829,30660,1,0,2,0,3
42870,90,12625,17709;17812;20481,30660,0,1,2,0,3
42871,90,12626,17612;17726;20909,30660,1,0,2,0,3
42872,90,12627,17728;18027;20899,30660,1,0,2,0,3
42873,90,12628,17732;18452;20762;20994,30660,2,0,2,0,4
42874,90,12629,17757;18050,30660,0,0,2,0,2
42875,90,12630,17759;17843,30660,0,0,2,0,2
42876,90,12631,18242;20396;20919,30660,1,1,1,0,3
42877,90,12632,17747;17988,30660,0,0,2,0,2
42878,90,12633,17863;18140;20991,30660,1,0,2,0,3
42879,90,12634,18120,30660,0,0,1,0,1
42880,90,12635,17904;18329;20626;20754,30660,2,0,2,0,4
42881,90,12636,17836;17910;20799;20979,30660,2,0,2,0,4
42882,90,12637,17933;18111;20920,30660,1,0,2,0,3
42883,90,12638,17962;18067;20806;21049,30660,2,0,2,0,4
42884,90,12639,18013;18023;20987,30660,1,0,2,0,3
42885,90,12640,18025;18041;20521;20671,30660,2,0,2,0,4
42886,90,12641,18074;18336;20520;20787,30660,2,0,2,0,4
42887,90,12642,18054;18313;20395,30660,0,1,2,0,3
42888,90,12643,18056;18213,30660,0,0,2,0,2
42889,90,12644,18068;20572,30660,1,0,1,0,2
42890,90,12645,18077;18287,30660,0,0,2,0,2
42891,90,12646,18087;20781,30660,1,0,1,0,2
42892,90,12647,18079;18102;20447;20981,30660,1,1,2,0,4
42893,90,12648,18104;18218;20605;20827,30660,2,0,2,0,4
42894,90,12649,18116,30660,0,0,1,0,1
42895,90,12650,18119;18375;20624;20651;20930,30660,3,0,2,0,5
42896,90,12651,18121;18132,30660,0,0,2,0,2
42897,90,12652,17961;18361,30660,0,0,2,0,2
42898,90,12653,18136;18475,30660,0,0,2,0,2
42899,90,12654,17936;18145;20487;20807,30660,1,1,2,0,4
42900,90,12655,17725;18151,30660,0,0,2,0,2
42901,90,12656,17911;17915,30660,0,0,2,0,2
42902,90,12657,18190,30660,0,0,1,0,1
42903,90,12658,18202;18224;20590,30660,1,0,2,0,3
42904,90,12659,13257,31025,0,0,1,0,1
42905,90,12661,13116,31025,0,0,0,1,1
42906,90,12662,13410,31025,0,0,1,0,1
42907,90,12663,13763,31025,0,0,1,0,1
42908,90,12665,12993,31025,0,0,0,1,1
42909,90,12669,14470,31025,0,0,1,0,1
42910,90,12673,14575,31025,0,0,1,0,1
42911,90,12679,14636,31025,0,0,1,0,1
42912,90,12680,15269,31025,0,0,1,0,1
42913,90,12682,15328,31025,0,0,1,0,1
42914,90,12684,15164;15732,31025,0,0,2,0,2
42915,90,12685,15389,31025,0,0,1,0,1
42916,90,12688,15858,31025,0,0,1,0,1
42917,90,12691,15622,31025,0,0,1,0,1
42918,90,12695,15824,31025,0,0,1,0,1
42919,90,12696,15284,31025,0,0,1,0,1
42920,90,12697,16208,31025,0,0,1,0,1
42921,90,12698,16260,31025,0,0,1,0,1
42922,90,12699,16397;16605,31025,0,0,2,0,2
42923,90,12701,16001,31025,0,0,1,0,1
42924,90,12704,16558;17069;20676,31025,1,0,2,0,3
42925,90,12706,16611;17149,31025,0,0,2,0,2
42926,90,12707,16544,31025,0,0,1,0,1
42927,90,12708,16180,31025,0,0,1,0,1
42928,90,12709,16729,31025,0,0,1,0,1
42929,90,12710,16800,31025,0,0,1,0,1
42930,90,12711,16805,31025,0,0,1,0,1
42931,90,12713,17113;17345;20853,31025,1,0,2,0,3
42932,90,12714,17265;17819;20783,31025,1,0,2,0,3
42933,90,12715,17176;17370;20866,31025,1,0,2,0,3
42934,90,12716,17381;17490;20698,31025,1,0,2,0,3
42935,90,12717,17418;17855,31025,0,0,2,0,2
42936,90,12718,17287;17463;20594;20836,31025,2,0,2,0,4
42937,90,12719,17470;18046,31025,0,0,2,0,2
42938,90,12720,17471;17839;20961,31025,1,0,2,0,3
42939,90,12721,18152,31025,0,0,1,0,1
42940,90,12722,17605;17929;20681,31025,1,0,2,0,3
42941,90,12723,17219;17640;20773;21002,31025,2,0,2,0,4
42942,90,12724,17674;18209,31025,0,0,2,0,2
42943,90,12725,17720;18277,31025,0,0,2,0,2
42944,90,12726,17940;20840,31025,1,0,1,0,2
42945,90,12727,17745;18100;20976,31025,1,0,2,0,3
42946,90,12728,17724;17948,31025,0,0,2,0,2
42947,90,12729,17768,31025,0,0,1,0,1
42948,90,12730,17367;17959,31025,0,0,2,0,2
42949,90,12731,17783;18147,31025,0,0,2,0,2
42950,90,12732,17821;17976,31025,0,0,2,0,2
42951,90,12733,17873;18009,31025,0,0,2,0,2
42952,90,12734,17898;18515,31025,0,0,2,0,2
42953,90,12735,17941,31025,0,0,1,0,1
42954,90,12736,17951;21051,31025,1,0,1,0,2
42955,90,12737,17956;18503;20933,31025,1,0,2,0,3
42956,90,12738,17859,31025,0,0,1,0,1
42957,90,12739,17718;17967;20670,31025,1,0,2,0,3
42958,90,12740,18005;18098;20804,31025,1,0,2,0,3
42959,90,12741,18049;20731;20971,31025,2,0,1,0,3
42960,90,12742,18086,31025,0,0,1,0,1
42961,90,12743,18081;18097;20856,31025,1,0,2,0,3
42962,90,12744,18114,31025,0,0,1,0,1
42963,90,12745,18156;18226;20650;21045,31025,2,0,2,0,4
42964,90,12746,17749;18167,31025,0,0,2,0,2
42965,90,12747,18177;18291;21040,31025,1,0,2,0,3
42966,90,12748,17990;18199,31025,0,0,2,0,2
42967,90,12749,17734;18221;20701,31025,1,0,2,0,3
42968,90,12750,18237;18592,31025,0,0,2,0,2
42969,90,12751,18112;18255,31025,0,0,2,0,2
42970,90,12752,18279;20547,31025,1,0,1,0,2
42971,90,12753,18142;18272;20677;20793,31025,2,0,2,0,4
42972,90,12754,18274;18445,31025,0,0,2,0,2
42973,90,12755,18256;18518;20974,31025,1,0,2,0,3
42974,90,12756,18294;18505;20759;20968,31025,2,0,2,0,4
42975,90,12757,18220;18302,31025,0,0,2,0,2
42976,90,12758,13317,31390,0,0,1,0,1
42977,90,12760,13014,31390,0,0,0,1,1
42978,90,12761,13385,31390,0,0,1,0,1
42979,90,12762,13375,31390,0,0,1,0,1
42980,90,12763,13582,31390,0,0,1,0,1
42981,90,12764,13627,31390,0,0,1,0,1
42982,90,12765,14079,31390,0,0,1,0,1
42983,90,12770,14348,31390,0,0,1,0,1
42984,90,12771,14353,31390,0,0,1,0,1
42985,90,12772,14301;14660,31390,0,0,2,0,2
42986,90,12773,14694;14709,31390,0,0,2,0,2
42987,90,12774,14430;14908,31390,0,0,2,0,2
42988,90,12775,15479,31390,0,0,1,0,1
42989,90,12776,14858,31390,0,0,1,0,1
42990,90,12779,14629,31390,0,0,1,0,1
42991,90,12783,15124,31390,0,0,1,0,1
42992,90,12784,15185,31390,0,0,1,0,1
42993,90,12786,15308,31390,0,0,1,0,1
42994,90,12787,15480,31390,0,0,1,0,1
42995,90,12789,15600,31390,0,0,1,0,1
42996,90,12791,15426,31390,0,0,1,0,1
42997,90,12792,15432;15449,31390,0,0,2,0,2
42998,90,12793,15762,31390,0,0,1,0,1
42999,90,12794,15958;16600,31390,0,0,2,0,2
43000,90,12796,15700,31390,0,0,1,0,1
43001,90,12797,16047,31390,0,0,1,0,1
43002,90,12799,16113;16721;20738,31390,1,0,2,0,3
43003,90,12800,16123;16482,31390,0,0,2,0,2
43004,90,12801,16193,31390,0,0,1,0,1
43005,90,12803,16361;16507;21009,31390,1,0,2,0,3
43006,90,12804,16341,31390,0,0,1,0,1
43007,90,12805,16620;17087,31390,0,0,2,0,2
43008,90,12806,16626;17166,31390,0,0,2,0,2
43009,90,12807,16247,31390,0,0,1,0,1
43010,90,12810,16781;17389;20683,31390,1,0,2,0,3
43011,90,12811,16827,31390,0,0,1,0,1
43012,90,12812,16854,31390,0,0,1,0,1
43013,90,12813,16993,31390,0,0,1,0,1
43014,90,12814,16463,31390,0,0,1,0,1
43015,90,12815,16685,31390,0,0,1,0,1
43016,90,12816,17091;17633;20977,31390,1,0,2,0,3
43017,90,12817,16849,31390,0,0,1,0,1
43018,90,12818,17688;18180,31390,0,0,2,0,2
43019,90,12819,17075;17307;21004,31390,1,0,2,0,3
43020,90,12820,17318,31390,0,0,1,0,1
43021,90,12821,17358;20724,31390,1,0,1,0,2
43022,90,12822,17369,31390,0,0,1,0,1
43023,90,12823,17293,31390,0,0,1,0,1
43024,90,12824,17695;20913,31390,1,0,1,0,2
43025,90,12825,17431;20938,31390,1,0,1,0,2
43026,90,12826,17540;17919,31390,0,0,2,0,2
43027,90,12827,17530;17546;20826,31390,1,0,2,0,3
43028,90,12828,17581;17834,31390,0,0,2,0,2
43029,90,12829,17623;18127,31390,0,0,2,0,2
43030,90,12830,17669;18164,31390,0,0,2,0,2
43031,90,12831,17742;18208,31390,0,0,2,0,2
43032,90,12832,17719;17786;20990,31390,1,0,2,0,3
43033,90,12833,17871;18171,31390,0,0,2,0,2
43034,90,12834,17875;18028,31390,0,0,2,0,2
43035,90,12835,17901;18110,31390,0,0,2,0,2
43036,90,12836,17397;17946,31390,0,0,2,0,2
43037,90,12837,18075;18194,31390,0,0,2,0,2
43038,90,12838,17891;17966,31390,0,0,2,0,2
43039,90,12839,17603;17977;20860,31390,1,0,2,0,3
43040,90,12840,18060;18656,31390,0,0,2,0,2
43041,90,12841,17510;18055;21023,31390,1,0,2,0,3
43042,90,12842,18059;18341,31390,0,0,2,0,2
43043,90,12843,18016;18089;20830;21057,31390,2,0,2,0,4
43044,90,12844,17744;18155;20641,31390,1,0,2,0,3
43045,90,12845,18165;18188,31390,0,0,2,0,2
43046,90,12846,18176,31390,0,0,1,0,1
43047,90,12847,18007;18179,31390,0,0,2,0,2
43048,90,12848,17274;17601;20859,31390,1,0,2,0,3
43049,90,12849,18225;18436;20655;20863,31390,2,0,2,0,4
43050,90,12850,18233,31390,0,0,1,0,1
43051,90,12851,18245;18566;20636,31390,1,0,2,0,3
43052,90,12852,18193;18246,31390,0,0,2,0,2
43053,90,12853,18192;18262,31390,0,0,2,0,2
43054,90,12854,18270;18351,31390,0,0,2,0,2
43055,90,12855,18281;18290;21007,31390,1,0,2,0,3
43056,90,12856,18283;18694,31390,0,0,2,0,2
43057,90,12857,18300;18367,31390,0,0,2,0,2
43058,90,12858,18322;18658;21038,31390,1,0,2,0,3
43059,90,12859,18230;18331,31390,0,0,2,0,2
43060,90,12860,18047,31390,0,0,1,0,1
43061,90,12861,18185;18339,31390,0,0,2,0,2
43062,90,12862,17865;18342;20720;21013,31390,2,0,2,0,4
43063,90,12863,17938;18346;20916,31390,1,0,2,0,3
43064,90,12864,18348;18733,31390,0,0,2,0,2
43065,90,12865,18219;18369;20821;21062,31390,2,0,2,0,4
43066,90,12866,17833;18374;20772;21000,31390,2,0,2,0,4
43067,90,12867,18082;18386;20647;20867,31390,2,0,2,0,4
43068,90,12868,13747,31755,0,0,1,0,1
43069,90,12870,13743,31755,0,0,1,0,1
43070,90,12871,13075,31755,0,0,0,1,1
43071,90,12872,14027,31755,0,0,1,0,1
43072,90,12875,13813,31755,0,0,1,0,1
43073,90,12877,13999,31755,0,0,1,0,1
43074,90,12878,13969,31755,0,0,1,0,1
43075,90,12879,13901,31755,0,0,1,0,1
43076,90,12880,14306,31755,0,0,1,0,1
43077,90,12883,14351,31755,0,0,1,0,1
43078,90,12887,14723,31755,0,0,1,0,1
43079,90,12888,14878,31755,0,0,1,0,1
43080,90,12889,14956,31755,0,0,1,0,1
43081,90,12890,15048;15053,31755,0,0,2,0,2
43082,90,12891,15127,31755,0,0,1,0,1
43083,90,12892,15199,31755,0,0,1,0,1
43084,90,12893,15249;15693,31755,0,0,2,0,2
43085,90,12895,15386,31755,0,0,1,0,1
43086,90,12896,15595,31755,0,0,1,0,1
43087,90,12899,15867,31755,0,0,1,0,1
43088,90,12900,15425,31755,0,0,1,0,1
43089,90,12901,15905,31755,0,0,1,0,1
43090,90,12902,15841,31755,0,0,1,0,1
43091,90,12903,16003,31755,0,0,1,0,1
43092,90,12904,16132,31755,0,0,1,0,1
43093,90,12906,16593,31755,0,0,1,0,1
43094,90,12907,16632,31755,0,0,1,0,1
43095,90,12908,16880,31755,0,0,1,0,1
43096,90,12909,16353,31755,0,0,1,0,1
43097,90,12910,16966,31755,0,0,1,0,1
43098,90,12911,16668,31755,0,0,1,0,1
43099,90,12912,16977,31755,0,0,1,0,1
43100,90,12913,17153;17522;20946,31755,1,0,2,0,3
43101,90,12914,16848,31755,0,0,1,0,1
43102,90,12915,17220,31755,0,0,1,0,1
43103,90,12916,17231;17610,31755,0,0,2,0,2
43104,90,12917,17262;17396,31755,0,0,2,0,2
43105,90,12918,17340;17576,31755,0,0,2,0,2
43106,90,12919,17085;17454;20881,31755,1,0,2,0,3
43107,90,12920,17506;17810;20942,31755,1,0,2,0,3
43108,90,12921,17390,31755,0,0,1,0,1
43109,90,12922,17555,31755,0,0,1,0,1
43110,90,12923,17356;17594;20886,31755,1,0,2,0,3
43111,90,12924,17615,31755,0,0,1,0,1
43112,90,12925,17526,31755,0,0,1,0,1
43113,90,12926,17760;17958,31755,0,0,2,0,2
43114,90,12927,17791,31755,0,0,1,0,1
43115,90,12928,17784;17798,31755,0,0,2,0,2
43116,90,12929,17903;18014;20915;20982,31755,2,0,2,0,4
43117,90,12930,17926;18235,31755,0,0,2,0,2
43118,90,12931,17981;18006;20935,31755,1,0,2,0,3
43119,90,12932,18012;18740;20906,31755,1,0,2,0,3
43120,90,12933,18018;18113,31755,0,0,2,0,2
43121,90,12934,18029;18710,31755,0,0,2,0,2
43122,90,12935,18073;18332,31755,0,0,2,0,2
43123,90,12936,18080;18563;20850,31755,1,0,2,0,3
43124,90,12937,18124;18457,31755,0,0,2,0,2
43125,90,12938,18154,31755,0,0,1,0,1
43126,90,12939,17713;18158,31755,0,0,2,0,2
43127,90,12940,17625;18173,31755,0,0,2,0,2
43128,90,12941,18250;18840;20835,31755,1,0,2,0,3
43129,90,12942,18207;18252;20874,31755,1,0,2,0,3
43130,90,12943,17766;18266,31755,0,0,2,0,2
43131,90,12944,18269;18305,31755,0,0,2,0,2
43132,90,12945,18273;18370,31755,0,0,2,0,2
43133,90,12946,17971;18276,31755,0,0,2,0,2
43134,90,12947,18285,31755,0,0,1,0,1
43135,90,12948,18288;18698,31755,0,0,2,0,2
43136,90,12949,18215;18303,31755,0,0,2,0,2
43137,90,12950,18395;20936,31755,1,0,1,0,2
43138,90,12951,18396,31755,0,0,1,0,1
43139,90,12952,18405;18486,31755,0,0,2,0,2
43140,90,12953,18214;18425;20944,31755,1,0,2,0,3
43141,90,12954,18385;18426,31755,0,0,2,0,2
43142,90,12955,18328;18427,31755,0,0,2,0,2
43143,90,12956,18223;18434,31755,0,0,2,0,2
43144,90,12957,18492;18577;20819;20950;20969,31755,3,0,2,0,5
43145,90,12958,18507;18636,31755,0,0,2,0,2
43146,90,12959,18149;18513;21052,31755,1,0,2,0,3
43147,90,12960,18495;18522,31755,0,0,2,0,2
43148,90,12961,18779;20782,31755,1,0,1,0,2
43149,90,12962,18437;18527,31755,0,0,2,0,2
43150,90,12963,13320,32120,0,0,1,0,1
43151,90,12965,13572,32120,0,0,1,0,1
43152,90,12966,13852,32120,0,0,1,0,1
43153,90,12967,13293,32120,0,0,1,0,1
43154,90,12968,13931,32120,0,0,1,0,1
43155,90,12969,13877,32120,0,0,1,0,1
43156,90,12970,14368,32120,0,0,1,0,1
43157,90,12971,14444,32120,0,0,1,0,1
43158,90,12975,14777,32120,0,0,1,0,1
43159,90,12976,14862,32120,0,0,1,0,1
43160,90,12977,14851,32120,0,0,1,0,1
43161,90,12979,14505,32120,0,0,1,0,1
43162,90,12980,15194,32120,0,0,1,0,1
43163,90,12981,15192,32120,0,0,1,0,1
43164,90,12983,15671,32120,0,0,1,0,1
43165,90,12984,15255,32120,0,0,1,0,1
43166,90,12985,15466,32120,0,0,1,0,1
43167,90,12986,15625,32120,0,0,1,0,1
43168,90,12987,15679,32120,0,0,1,0,1
43169,90,12988,15685,32120,0,0,1,0,1
43170,90,12989,15748;15980,32120,0,0,2,0,2
43171,90,12991,15916;16322,32120,0,0,2,0,2
43172,90,12993,16104,32120,0,0,1,0,1
43173,90,12994,15917,32120,0,0,1,0,1
43174,90,12995,16143,32120,0,0,1,0,1
43175,90,12996,15783,32120,0,0,1,0,1
43176,90,12997,15753,32120,0,0,1,0,1
43177,90,12998,15848,32120,0,0,1,0,1
43178,90,12999,16330,32120,0,0,1,0,1
43179,90,13000,16371,32120,0,0,1,0,1
43180,90,13002,16311;16495,32120,0,0,2,0,2
43181,90,13003,16490,32120,0,0,1,0,1
43182,90,13005,16423,32120,0,0,1,0,1
43183,90,13006,16726;16973,32120,0,0,2,0,2
43184,90,13007,16738;17137;20857,32120,1,0,2,0,3
43185,90,13008,16796,32120,0,0,1,0,1
43186,90,13009,16906,32120,0,0,1,0,1
43187,90,13010,16974,32120,0,0,1,0,1
43188,90,13011,17009,32120,0,0,1,0,1
43189,90,13012,17036,32120,0,0,1,0,1
43190,90,13013,17195,32120,0,0,1,0,1
43191,90,13015,17258;17475,32120,0,0,2,0,2
43192,90,13016,17386,32120,0,0,1,0,1
43193,90,13017,17516,32120,0,0,1,0,1
43194,90,13018,17317,32120,0,0,1,0,1
43195,90,13019,17689;18166,32120,0,0,2,0,2
43196,90,13020,17889;18129,32120,0,0,2,0,2
43197,90,13021,17448,32120,0,0,1,0,1
43198,90,13022,17850,32120,0,0,1,0,1
43199,90,13023,17922;18078,32120,0,0,2,0,2
43200,90,13024,17949;18083,32120,0,0,2,0,2
43201,90,13025,17671;17975,32120,0,0,2,0,2
43202,90,13026,17980;18148;20951;21043,32120,2,0,2,0,4
43203,90,13027,17619;17896,32120,0,0,2,0,2
43204,90,13028,17770;17987;20966,32120,1,0,2,0,3
43205,90,13029,18022;18263,32120,0,0,2,0,2
43206,90,13030,17591;18045;20878,32120,1,0,2,0,3
43207,90,13031,18043;18062,32120,0,0,2,0,2
43208,90,13032,18095;18359,32120,0,0,2,0,2
43209,90,13033,17881,32120,0,0,1,0,1
43210,90,13034,18203,32120,0,0,1,0,1
43211,90,13035,17700,32120,0,0,1,0,1
43212,90,13036,18284,32120,0,0,1,0,1
43213,90,13037,18195;18502,32120,0,0,2,0,2
43214,90,13038,18206;18784,32120,0,0,2,0,2
43215,90,13039,17723;18228,32120,0,0,2,0,2
43216,90,13040,18296;18702,32120,0,0,2,0,2
43217,90,13041,18298;18355,32120,0,0,2,0,2
43218,90,13042,18356;18380,32120,0,0,2,0,2
43219,90,13043,18135;18278,32120,0,0,2,0,2
43220,90,13044,18384;18634,32120,0,0,2,0,2
43221,90,13045,18139;18413,32120,0,0,2,0,2
43222,90,13046,18040;18421,32120,0,0,2,0,2
43223,90,13047,18428;18611,32120,0,0,2,0,2
43224,90,13048,18439;18821,32120,0,0,2,0,2
43225,90,13049,18441;18699,32120,0,0,2,0,2
43226,90,13050,18443;18640,32120,0,0,2,0,2
43227,90,13051,18453;18550;21020,32120,1,0,2,0,3
43228,90,13052,17710;18478;20958,32120,1,0,2,0,3
43229,90,13053,18497;18519,32120,0,0,2,0,2
43230,90,13054,18530;18797;21059,32120,1,0,2,0,3
43231,90,13055,17965;18533,32120,0,0,2,0,2
43232,90,13056,18547,32120,0,0,1,0,1
43233,90,13057,18562;18971;20943;21034,32120,2,0,2,0,4
43234,90,13058,18576;18685;21016,32120,1,0,2,0,3
43235,90,13059,18578;18686,32120,0,0,2,0,2
43236,90,13060,18306;18601;21028,32120,1,0,2,0,3
43237,90,13061,18614;18772;21035,32120,1,0,2,0,3
43238,90,13062,18594;18625,32120,0,0,2,0,2
43239,90,13063,13576,32485,0,0,1,0,1
43240,90,13064,13724,32485,0,0,1,0,1
43241,90,13065,13773,32485,0,0,1,0,1
43242,90,13066,13829,32485,0,0,1,0,1
43243,90,13067,12985,32485,0,0,0,1,1
43244,90,13068,13895,32485,0,0,1,0,1
43245,90,13070,13105,32485,0,0,0,1,1
43246,90,13071,14167,32485,0,0,1,0,1
43247,90,13072,14055;14185,32485,0,0,2,0,2
43248,90,13073,14753,32485,0,0,1,0,1
43249,90,13075,13914,32485,0,0,1,0,1
43250,90,13076,14551,32485,0,0,1,0,1
43251,90,13078,14791,32485,0,0,1,0,1
43252,90,13079,14795;15291,32485,0,0,2,0,2
43253,90,13080,15059,32485,0,0,1,0,1
43254,90,13081,14689,32485,0,0,1,0,1
43255,90,13082,15325,32485,0,0,1,0,1
43256,90,13083,15295,32485,0,0,1,0,1
43257,90,13085,14949,32485,0,0,1,0,1
43258,90,13086,15612,32485,0,0,1,0,1
43259,90,13087,15866,32485,0,0,1,0,1
43260,90,13088,15844,32485,0,0,1,0,1
43261,90,13089,15717,32485,0,0,1,0,1
43262,90,13090,14969,32485,0,0,1,0,1
43263,90,13091,15853,32485,0,0,1,0,1
43264,90,13092,16017,32485,0,0,1,0,1
43265,90,13093,16120,32485,0,0,1,0,1
43266,90,13094,15654,32485,0,0,1,0,1
43267,90,13095,16176,32485,0,0,1,0,1
43268,90,13096,16190,32485,0,0,1,0,1
43269,90,13097,16130,32485,0,0,1,0,1
43270,90,13098,15907,32485,0,0,1,0,1
43271,90,13099,16470,32485,0,0,1,0,1
43272,90,13100,16667,32485,0,0,1,0,1
43273,90,13101,16759,32485,0,0,1,0,1
43274,90,13102,16672,32485,0,0,1,0,1
43275,90,13103,16545,32485,0,0,1,0,1
43276,90,13104,16606,32485,0,0,1,0,1
43277,90,13105,16870,32485,0,0,1,0,1
43278,90,13107,16929,32485,0,0,1,0,1
43279,90,13108,17072;17452;20962,32485,1,0,2,0,3
43280,90,13109,17207,32485,0,0,1,0,1
43281,90,13110,17383;17661,32485,0,0,2,0,2
43282,90,13111,17402;17618;21074,32485,1,0,2,0,3
43283,90,13112,17416,32485,0,0,1,0,1
43284,90,13113,17487;18071,32485,0,0,2,0,2
43285,90,13114,17587,32485,0,0,1,0,1
43286,90,13115,17673,32485,0,0,1,0,1
43287,90,13116,17698;17851,32485,0,0,2,0,2
43288,90,13117,17743,32485,0,0,1,0,1
43289,90,13118,17764,32485,0,0,1,0,1
43290,90,13119,17621,32485,0,0,1,0,1
43291,90,13120,17811;18358,32485,0,0,2,0,2
43292,90,13121,17569;17813,32485,0,0,2,0,2
43293,90,13122,17602;18072,32485,0,0,2,0,2
43294,90,13123,17893;18212,32485,0,0,2,0,2
43295,90,13124,17905,32485,0,0,1,0,1
43296,90,13125,17964;18168,32485,0,0,2,0,2
43297,90,13126,18021,32485,0,0,1,0,1
43298,90,13127,18032;18039,32485,0,0,2,0,2
43299,90,13128,18115;18467,32485,0,0,2,0,2
43300,90,13129,18404,32485,0,0,1,0,1
43301,90,13130,18133;18744,32485,0,0,2,0,2
43302,90,13131,18248;18350,32485,0,0,2,0,2
43303,90,13132,18260,32485,0,0,1,0,1
43304,90,13133,18309;18628,32485,0,0,2,0,2
43305,90,13134,18163;18319,32485,0,0,2,0,2
43306,90,13135,18326;18400,32485,0,0,2,0,2
43307,90,13136,18011;18334,32485,0,0,2,0,2
43308,90,13137,18538;21056,32485,1,0,1,0,2
43309,90,13138,18372;18575;21071,32485,1,0,2,0,3
43310,90,13139,18417;18910,32485,0,0,2,0,2
43311,90,13140,18243;18438,32485,0,0,2,0,2
43312,90,13141,18477;18769,32485,0,0,2,0,2
43313,90,13142,18191;18479,32485,0,0,2,0,2
43314,90,13143,18485;18915,32485,0,0,2,0,2
43315,90,13144,18197;18491,32485,0,0,2,0,2
43316,90,13145,18496;18676,32485,0,0,2,0,2
43317,90,13146,18501;19012,32485,0,0,2,0,2
43318,90,13147,18510,32485,0,0,1,0,1
43319,90,13148,18382;18512;21018,32485,1,0,2,0,3
43320,90,13149,18259;18520,32485,0,0,2,0,2
43321,90,13150,18524,32485,0,0,1,0,1
43322,90,13151,18580;18951,32485,0,0,2,0,2
43323,90,13152,18393;18596,32485,0,0,2,0,2
43324,90,13153,18603;18968;20995,32485,1,0,2,0,3
43325,90,13154,18638;18941,32485,0,0,2,0,2
43326,90,13155,18641;18877,32485,0,0,2,0,2
43327,90,13156,18643;19102,32485,0,0,2,0,2
43328,90,13157,18555;18655,32485,0,0,2,0,2
43329,90,13158,18657,32485,0,0,1,0,1
43330,90,13159,18662;18706,32485,0,0,2,0,2
43331,90,13160,18683;18714,32485,0,0,2,0,2
43332,90,13161,18574;18721,32485,0,0,2,0,2
43333,90,13162,18727;19057,32485,0,0,2,0,2
43334,90,13163,18739;19090,32485,0,0,2,0,2
43335,90,13164,18742;18964,32485,0,0,2,0,2
43336,90,13165,13876,32850,0,0,1,0,1
43337,90,13166,13894,32850,0,0,1,0,1
43338,90,13167,13925,32850,0,0,1,0,1
43339,90,13168,14070,32850,0,0,1,0,1
43340,90,13169,14146;14428,32850,0,0,2,0,2
43341,90,13170,14290,32850,0,0,1,0,1
43342,90,13171,14461,32850,0,0,1,0,1
43343,90,13172,13469,32850,0,0,1,0,1
43344,90,13173,13984,32850,0,0,1,0,1
43345,90,13174,14490,32850,0,0,1,0,1
43346,90,13175,14237,32850,0,0,1,0,1
43347,90,13176,14565,32850,0,0,1,0,1
43348,90,13177,14666,32850,0,0,1,0,1
43349,90,13178,14764,32850,0,0,1,0,1
43350,90,13179,14788,32850,0,0,1,0,1
43351,90,13180,14964,32850,0,0,1,0,1
43352,90,13181,15095,32850,0,0,1,0,1
43353,90,13182,14545,32850,0,0,1,0,1
43354,90,13183,14534,32850,0,0,1,0,1
43355,90,13184,15306,32850,0,0,1,0,1
43356,90,13185,15715,32850,0,0,1,0,1
43357,90,13186,15302,32850,0,0,1,0,1
43358,90,13187,15840,32850,0,0,1,0,1
43359,90,13188,16056;16431,32850,0,0,2,0,2
43360,90,13189,15894,32850,0,0,1,0,1
43361,90,13190,16270,32850,0,0,1,0,1
43362,90,13191,16073,32850,0,0,1,0,1
43363,90,13192,16141,32850,0,0,1,0,1
43364,90,13193,16219,32850,0,0,1,0,1
43365,90,13194,15940,32850,0,0,1,0,1
43366,90,13195,15736,32850,0,0,1,0,1
43367,90,13196,15944,32850,0,0,1,0,1
43368,90,13197,16457,32850,0,0,1,0,1
43369,90,13198,16430,32850,0,0,1,0,1
43370,90,13199,16779,32850,0,0,1,0,1
43371,90,13201,16745,32850,0,0,1,0,1
43372,90,13202,16146,32850,0,0,1,0,1
43373,90,13203,16884;17002,32850,0,0,2,0,2
43374,90,13204,17007,32850,0,0,1,0,1
43375,90,13205,17047,32850,0,0,1,0,1
43376,90,13206,17148,32850,0,0,1,0,1
43377,90,13207,17303,32850,0,0,1,0,1
43378,90,13208,16799,32850,0,0,1,0,1
43379,90,13209,17193,32850,0,0,1,0,1
43380,90,13210,17349;17568,32850,0,0,2,0,2
43381,90,13211,17638,32850,0,0,1,0,1
43382,90,13212,17388,32850,0,0,1,0,1
43383,90,13213,17670,32850,0,0,1,0,1
43384,90,13214,17678,32850,0,0,1,0,1
43385,90,13215,17478,32850,0,0,1,0,1
43386,90,13216,17752,32850,0,0,1,0,1
43387,90,13217,17816;18315,32850,0,0,2,0,2
43388,90,13218,17892,32850,0,0,1,0,1
43389,90,13219,17800;17923,32850,0,0,2,0,2
43390,90,13220,17931,32850,0,0,1,0,1
43391,90,13221,17954,32850,0,0,1,0,1
43392,90,13222,17973;18403,32850,0,0,2,0,2
43393,90,13223,17989;18108,32850,0,0,2,0,2
43394,90,13224,18001,32850,0,0,1,0,1
43395,90,13225,18033;18042,32850,0,0,2,0,2
43396,90,13226,18052;18076,32850,0,0,2,0,2
43397,90,13227,18061;18238,32850,0,0,2,0,2
43398,90,13228,18069;18411,32850,0,0,2,0,2
43399,90,13229,18182;18644,32850,0,0,2,0,2
43400,90,13230,17815,32850,0,0,1,0,1
43401,90,13231,18261;18591,32850,0,0,2,0,2
43402,90,13232,17894;18282,32850,0,0,2,0,2
43403,90,13233,18031;18286,32850,0,0,2,0,2
43404,90,13234,18310;18340,32850,0,0,2,0,2
43405,90,13235,18354;18474,32850,0,0,2,0,2
43406,90,13236,18172;18362,32850,0,0,2,0,2
43407,90,13237,18366,32850,0,0,1,0,1
43408,90,13238,18412;18586,32850,0,0,2,0,2
43409,90,13239,18239;18433,32850,0,0,2,0,2
43410,90,13240,18466;19038,32850,0,0,2,0,2
43411,90,13241,18469;18567,32850,0,0,2,0,2
43412,90,13242,18472,32850,0,0,1,0,1
43413,90,13243,18490;19032,32850,0,0,2,0,2
43414,90,13244,18525,32850,0,0,1,0,1
43415,90,13245,18537;18962,32850,0,0,2,0,2
43416,90,13246,18201;18570,32850,0,0,2,0,2
43417,90,13247,18590;18903,32850,0,0,2,0,2
43418,90,13248,18352;18599,32850,0,0,2,0,2
43419,90,13249,18600;18793,32850,0,0,2,0,2
43420,90,13250,18627;18692,32850,0,0,2,0,2
43421,90,13251,18648;18890,32850,0,0,2,0,2
43422,90,13252,17994;18671,32850,0,0,2,0,2
43423,90,13253,18679;18952,32850,0,0,2,0,2
43424,90,13254,18482;18680,32850,0,0,2,0,2
43425,90,13255,18682;18691,32850,0,0,2,0,2
43426,90,13256,18571;18704,32850,0,0,2,0,2
43427,90,13257,18708;18963,32850,0,0,2,0,2
43428,90,13258,18713;19006,32850,0,0,2,0,2
43429,90,13259,18446;18715,32850,0,0,2,0,2
43430,90,13260,18766;18838,32850,0,0,2,0,2
43431,90,13261,18605;18770,32850,0,0,2,0,2
43432,90,13262,18774;19206,32850,0,1,1,0,2
43433,90,13263,18551;18823,32850,0,0,2,0,2
43434,90,13264,18846;18980,32850,0,0,2,0,2
43435,90,13265,18853;19151,32850,0,1,1,0,2
43436,90,13266,18854,32850,0,0,1,0,1
43437,100,991,12508,0,0,0,0,1,1
43438,100,1168,11210,0,0,0,0,1,1
43439,100,2399,11804,0,0,0,0,1,1
43440,100,2638,11894,0,0,0,0,1,1
43441,100,3646,10820,0,0,0,0,1,1
43442,100,3817,10983;11082,0,0,0,0,2,2
43443,100,4004,11904,365,0,0,0,1,1
43444,100,4067,12752,730,0,0,0,1,1
43445,100,4145,11617;11623,730,0,0,0,2,2
43446,100,4287,12083,1095,0,0,0,1,1
43447,100,4757,12349;15793,2555,0,0,1,1,2
43448,100,4770,12991,2920,0,0,0,1,1
43449,100,4772,12137,2920,0,0,0,1,1
43450,100,4998,14651;14730,3650,0,0,1,1,2
43451,100,5149,11429,4015,0,0,0,1,1
43452,100,5253,12548;13063,4380,0,0,0,2,2
43453,100,5363,12127;12880;12883;13414;13696,5110,0,0,0,5,5
43454,100,5429,13298;13665,5110,0,0,0,2,2
43455,100,5460,11823;13229,5475,0,0,0,2,2
43456,100,5665,10201,6205,0,0,0,1,1
43457,100,5724,14445,6205,0,0,0,1,1
43458,100,5734,14712,6570,0,0,1,0,1
43459,100,5987,10142,7300,0,0,0,1,1
43460,100,6077,10298,7665,0,0,0,1,1
43461,100,6078,10307,7665,0,0,0,1,1
43462,100,6110,10003,8030,0,0,0,1,1
43463,100,6126,10545,8030,0,0,0,1,1
43464,100,6142,10653,8030,0,0,0,1,1
43465,100,6144,10281,8030,0,0,0,1,1
43466,100,6149,15338,8030,0,0,1,0,1
43467,100,6150,10390,8030,0,0,0,1,1
43468,100,6182,10150,8395,0,0,0,1,1
43469,100,6216,10350,8395,0,0,0,1,1
43470,100,6220,10656,8395,0,0,0,1,1
43471,100,6281,10422,8760,0,0,0,1,1
43472,100,6286,14747;15023,8760,0,0,2,0,2
43473,100,6297,10338,8760,0,0,0,1,1
43474,100,6312,10694,8760,0,0,0,1,1
43475,100,6314,10572,8760,0,0,0,1,1
43476,100,6366,10586,9125,0,0,0,1,1
43477,100,6374,10319,9125,0,0,0,1,1
43478,100,6380,10356,9125,0,0,0,1,1
43479,100,6381,10873,9125,0,0,0,1,1
43480,100,6393,10466,9125,0,0,0,1,1
43481,100,6394,10690,9125,0,0,0,1,1
43482,100,6396,10257,9125,0,0,0,1,1
43483,100,6413,10919,9125,0,0,0,1,1
43484,100,6416,10881,9125,0,0,0,1,1
43485,100,6417,10743,9125,0,0,0,1,1
43486,100,6418,10984,9125,0,0,0,1,1
43487,100,6476,10635,9490,0,0,0,1,1
43488,100,6480,10967,9490,0,0,0,1,1
43489,100,6481,11093,9490,0,0,0,1,1
43490,100,6485,10898,9490,0,0,0,1,1
43491,100,6493,10869,9490,0,0,0,1,1
43492,100,6494,11202,9490,0,0,0,1,1
43493,100,6497,11077,9490,0,0,0,1,1
43494,100,6499,11113,9490,0,0,0,1,1
43495,100,6501,11015,9490,0,0,0,1,1
43496,100,6502,11117,9490,0,0,0,1,1
43497,100,6535,10111,9855,0,0,0,1,1
43498,100,6556,11115,9855,0,0,0,1,1
43499,100,6557,10247,9855,0,0,0,1,1
43500,100,6564,10601,9855,0,0,0,1,1
43501,100,6566,10624,9855,0,0,0,1,1
43502,100,6575,11085,9855,0,0,0,1,1
43503,100,6577,10998,9855,0,0,0,1,1
43504,100,6581,11318,9855,0,0,0,1,1
43505,100,6588,11252,9855,0,0,0,1,1
43506,100,6590,10988,9855,0,0,0,1,1
43507,100,6637,11057,10220,0,0,0,1,1
43508,100,6665,10995,10220,0,0,0,1,1
43509,100,6673,11035,10220,0,0,0,1,1
43510,100,6677,11253,10220,0,0,0,1,1
43511,100,6681,10041,10585,0,0,0,1,1
43512,100,6717,10443,10585,0,0,0,1,1
43513,100,6731,10462,10585,0,0,0,1,1
43514,100,6733,10354,10585,0,0,0,1,1
43515,100,6736,10870,10585,0,0,0,1,1
43516,100,6737,10731,10585,0,0,0,1,1
43517,100,6738,11191,10585,0,0,0,1,1
43518,100,6739,10733,10585,0,0,0,1,1
43519,100,6744,10917,10585,0,0,0,1,1
43520,100,6748,10762,10585,0,0,0,1,1
43521,100,6750,11237,10585,0,0,0,1,1
43522,100,6754,11497,10585,0,0,0,1,1
43523,100,6755,11152,10585,0,0,0,1,1
43524,100,6757,11185,10585,0,0,0,1,1
43525,100,6758,11206,10585,0,0,0,1,1
43526,100,6759,11156,10585,0,0,0,1,1
43527,100,6770,14352,10950,0,0,0,1,1
43528,100,6812,10904,10950,0,0,0,1,1
43529,100,6822,11276,10950,0,0,0,1,1
43530,100,6827,10839,10950,0,0,0,1,1
43531,100,6830,11484,10950,0,0,0,1,1
43532,100,6838,10662,10950,0,0,0,1,1
43533,100,6841,11566,10950,0,0,0,1,1
43534,100,6843,11100,10950,0,0,0,1,1
43535,100,6844,11103,10950,0,0,0,1,1
43536,100,6846,11339,10950,0,0,0,1,1
43537,100,6850,11413,10950,0,0,0,1,1
43538,100,6851,11798,10950,0,0,0,1,1
43539,100,6853,11196,10950,0,0,0,1,1
43540,100,6856,11543,10950,0,0,0,1,1
43541,100,6857,11243,10950,0,0,0,1,1
43542,100,6860,11394,10950,0,0,0,1,1
43543,100,6866,11444,10950,0,0,0,1,1
43544,100,6868,11450,10950,0,0,0,1,1
43545,100,6869,11315,10950,0,0,0,1,1
43546,100,6909,10651,11315,0,0,0,1,1
43547,100,6916,10882,11315,0,0,0,1,1
43548,100,6918,15489;20078,11315,0,0,2,0,2
43549,100,6927,10918,11315,0,0,0,1,1
43550,100,6934,10981,11315,0,0,0,1,1
43551,100,6940,11203;11295,11315,0,0,0,2,2
43552,100,6945,11098,11315,0,0,0,1,1
43553,100,6950,11582;11702,11315,0,0,0,2,2
43554,100,6954,11181,11315,0,0,0,1,1
43555,100,6955,11040,11315,0,0,0,1,1
43556,100,6960,11268,11315,0,0,0,1,1
43557,100,6963,11459,11315,0,0,0,1,1
43558,100,6964,11336,11315,0,0,0,1,1
43559,100,6965,11697,11315,0,0,0,1,1
43560,100,6968,11719;11749,11315,0,0,0,2,2
43561,100,6971,11195,11315,0,0,0,1,1
43562,100,6972,11700,11315,0,0,0,1,1
43563,100,6973,11407,11315,0,0,0,1,1
43564,100,7011,11227,11680,0,0,0,1,1
43565,100,7016,10929,11680,0,0,0,1,1
43566,100,7021,14504,11680,0,0,0,1,1
43567,100,7026,11140;11375,11680,0,0,0,2,2
43568,100,7027,11089,11680,0,0,0,1,1
43569,100,7030,11109;11172,11680,0,0,0,2,2
43570,100,7031,11575,11680,0,0,0,1,1
43571,100,7035,11229,11680,0,0,0,1,1
43572,100,7036,11807;11970,11680,0,0,0,2,2
43573,100,7037,11209,11680,0,0,0,1,1
43574,100,7039,11615,11680,0,0,0,1,1
43575,100,7040,11657,11680,0,0,0,1,1
43576,100,7041,11673,11680,0,0,0,1,1
43577,100,7042,11370,11680,0,0,0,1,1
43578,100,7043,11704,11680,0,0,0,1,1
43579,100,7044,11387,11680,0,0,0,1,1
43580,100,7045,11421;11455,11680,0,0,0,2,2
43581,100,7047,11489;11756,11680,0,0,0,2,2
43582,100,7048,11707,11680,0,0,0,1,1
43583,100,7049,11509,11680,0,0,0,1,1
43584,100,7050,11650,11680,0,0,0,1,1
43585,100,7109,10831,12045,0,0,0,1,1
43586,100,7110,10836,12045,0,0,0,1,1
43587,100,7111,11452,12045,0,0,0,1,1
43588,100,7115,11288,12045,0,0,0,1,1
43589,100,7116,11522,12045,0,0,0,1,1
43590,100,7120,15197,12045,0,0,1,0,1
43591,100,7126,11280,12045,0,0,0,1,1
43592,100,7128,11317,12045,0,0,0,1,1
43593,100,7129,11322,12045,0,0,0,1,1
43594,100,7130,11703,12045,0,0,0,1,1
43595,100,7132,11393,12045,0,0,0,1,1
43596,100,7134,11821,12045,0,0,0,1,1
43597,100,7135,11221,12045,0,0,0,1,1
43598,100,7136,11464;11633,12045,0,0,0,2,2
43599,100,7138,11499,12045,0,0,0,1,1
43600,100,7140,11112,12045,0,0,0,1,1
43601,100,7141,11533,12045,0,0,0,1,1
43602,100,7142,11583,12045,0,0,0,1,1
43603,100,7196,14193;14808,12410,0,0,1,1,2
43604,100,7216,11524,12410,0,0,0,1,1
43605,100,7217,11488,12410,0,0,0,1,1
43606,100,7222,11360,12410,0,0,0,1,1
43607,100,7225,11342,12410,0,0,0,1,1
43608,100,7228,11279,12410,0,0,0,1,1
43609,100,7229,11416,12410,0,0,0,1,1
43610,100,7230,11331,12410,0,0,0,1,1
43611,100,7231,11574,12410,0,0,0,1,1
43612,100,7233,11358,12410,0,0,0,1,1
43613,100,7237,12053,12410,0,0,0,1,1
43614,100,7240,11780,12410,0,0,0,1,1
43615,100,7241,11537,12410,0,0,0,1,1
43616,100,7242,11782,12410,0,0,0,1,1
43617,100,7243,11553,12410,0,0,0,1,1
43618,100,7245,11529;11567,12410,0,0,0,2,2
43619,100,7246,11577,12410,0,0,0,1,1
43620,100,7247,11578,12410,0,0,0,1,1
43621,100,7251,11628,12410,0,0,0,1,1
43622,100,7252,11982,12410,0,0,0,1,1
43623,100,7254,11722,12410,0,0,0,1,1
43624,100,7256,11663,12410,0,0,0,1,1
43625,100,7257,11747;12098,12410,0,0,0,2,2
43626,100,7297,10813,12775,0,0,0,1,1
43627,100,7300,10848,12775,0,0,0,1,1
43628,100,7304,10906;11095,12775,0,0,0,2,2
43629,100,7308,11330,12775,0,0,0,1,1
43630,100,7311,11462,12775,0,0,0,1,1
43631,100,7312,11153,12775,0,0,0,1,1
43632,100,7314,11283,12775,0,0,0,1,1
43633,100,7316,10987,12775,0,0,0,1,1
43634,100,7317,11340,12775,0,0,0,1,1
43635,100,7320,11978,12775,0,0,0,1,1
43636,100,7322,11302,12775,0,0,0,1,1
43637,100,7325,11491,12775,0,0,0,1,1
43638,100,7326,11530,12775,0,0,0,1,1
43639,100,7327,11531,12775,0,0,0,1,1
43640,100,7330,11598;11616,12775,0,0,0,2,2
43641,100,7334,11699;11882,12775,0,0,0,2,2
43642,100,7337,11151,12775,0,0,0,1,1
43643,100,7338,11759;12225,12775,0,0,0,2,2
43644,100,7339,11761,12775,0,0,0,1,1
43645,100,7340,11774,12775,0,0,0,1,1
43646,100,7341,11790,12775,0,0,0,1,1
43647,100,7343,11417,12775,0,0,0,1,1
43648,100,7344,11837,12775,0,0,0,1,1
43649,100,7345,12228,12775,0,0,0,1,1
43650,100,7346,11869,12775,0,0,0,1,1
43651,100,7381,10413,13140,0,0,0,1,1
43652,100,7391,10933,13140,0,0,0,1,1
43653,100,7392,10925;11111,13140,0,0,0,2,2
43654,100,7396,11551,13140,0,0,0,1,1
43655,100,7399,11326,13140,0,0,0,1,1
43656,100,7400,10891,13140,0,0,0,1,1
43657,100,7401,16184;16395,13140,0,0,2,0,2
43658,100,7403,11486,13140,0,0,0,1,1
43659,100,7406,11606,13140,0,0,0,1,1
43660,100,7409,11585;12096,13140,0,0,0,2,2
43661,100,7410,11614,13140,0,0,0,1,1
43662,100,7411,12246,13140,0,0,0,1,1
43663,100,7415,12014,13140,0,0,0,1,1
43664,100,7416,11602;11727,13140,0,0,0,2,2
43665,100,7417,11897,13140,0,0,0,1,1
43666,100,7420,11784;12371,13140,0,0,0,2,2
43667,100,7423,11822,13140,0,0,0,1,1
43668,100,7424,11734,13140,0,0,0,1,1
43669,100,7425,12101,13140,0,0,0,1,1
43670,100,7426,12176,13140,0,0,0,1,1
43671,100,7427,12221,13140,0,0,0,1,1
43672,100,7428,12060,13140,0,0,0,1,1
43673,100,7429,11694,13140,0,0,0,1,1
43674,100,7430,11900,13140,0,0,0,1,1
43675,100,7433,11851,13140,0,0,0,1,1
43676,100,7434,11926,13140,0,0,0,1,1
43677,100,7435,11607;11932,13140,0,0,0,2,2
43678,100,7436,11901,13140,0,0,0,1,1
43679,100,7438,11971,13140,0,0,0,1,1
43680,100,7486,10939,13505,0,0,0,1,1
43681,100,7489,11477,13505,0,0,0,1,1
43682,100,7491,11126,13505,0,0,0,1,1
43683,100,7492,11138,13505,0,0,0,1,1
43684,100,7495,11439;11506,13505,0,0,0,2,2
43685,100,7498,10897,13505,0,0,0,1,1
43686,100,7499,10903,13505,0,0,0,1,1
43687,100,7500,11357;12004,13505,0,0,0,2,2
43688,100,7504,11516,13505,0,0,0,1,1
43689,100,7505,11979,13505,0,0,0,1,1
43690,100,7506,11581,13505,0,0,0,1,1
43691,100,7507,11599,13505,0,0,0,1,1
43692,100,7508,11980,13505,0,0,0,1,1
43693,100,7509,11627,13505,0,0,0,1,1
43694,100,7511,11732,13505,0,0,0,1,1
43695,100,7512,12203,13505,0,0,0,1,1
43696,100,7513,11658;11672,13505,0,0,0,2,2
43697,100,7514,11427;11678,13505,0,0,0,2,2
43698,100,7515,11766,13505,0,0,0,1,1
43699,100,7516,13068,13505,0,0,0,1,1
43700,100,7518,12117,13505,0,0,0,1,1
43701,100,7520,11880,13505,0,0,0,1,1
43702,100,7522,12249,13505,0,0,0,1,1
43703,100,7523,11610;11896,13505,0,0,0,2,2
43704,100,7524,12324,13505,0,0,0,1,1
43705,100,7525,11505;12167,13505,0,0,0,2,2
43706,100,7526,12346,13505,0,0,0,1,1
43707,100,7527,12091,13505,0,0,0,1,1
43708,100,7528,11955,13505,0,0,0,1,1
43709,100,7529,11961;11994,13505,0,0,0,2,2
43710,100,7530,11981,13505,0,0,0,1,1
43711,100,7531,11987,13505,0,0,0,1,1
43712,100,7533,12204;12279,13505,0,0,0,2,2
43713,100,7534,12065,13505,0,0,0,1,1
43714,100,7535,11925,13505,0,0,0,1,1
43715,100,7536,12392,13505,0,0,0,1,1
43716,100,7539,11769;12107,13505,0,0,0,2,2
43717,100,7540,12460,13505,0,0,0,1,1
43718,100,7541,12056;12529,13505,0,0,0,2,2
43719,100,7580,11021,13870,0,0,0,1,1
43720,100,7582,11118,13870,0,0,0,1,1
43721,100,7584,11572,13870,0,0,0,1,1
43722,100,7588,11463;11720,13870,0,0,0,2,2
43723,100,7590,11418;11639,13870,0,0,0,2,2
43724,100,7598,16860;17365,13870,0,0,2,0,2
43725,100,7599,12062,13870,0,0,0,1,1
43726,100,7601,12070,13870,0,0,0,1,1
43727,100,7602,11933,13870,0,0,0,1,1
43728,100,7605,11789;12104,13870,0,0,0,2,2
43729,100,7608,11942;12092,13870,0,0,0,2,2
43730,100,7609,11944,13870,0,0,0,1,1
43731,100,7610,11950,13870,0,0,0,1,1
43732,100,7611,12638;12639,13870,0,0,0,2,2
43733,100,7612,11962;12191,13870,0,0,0,2,2
43734,100,7614,12267,13870,0,0,0,1,1
43735,100,7617,12413,13870,0,0,0,1,1
43736,100,7619,12026,13870,0,0,0,1,1
43737,100,7620,12265,13870,0,0,0,1,1
43738,100,7621,11320;12049,13870,0,0,0,2,2
43739,100,7622,12254,13870,0,0,0,1,1
43740,100,7623,12200;12329,13870,0,0,0,2,2
43741,100,7624,12208,13870,0,0,0,1,1
43742,100,7627,12389,13870,0,0,0,1,1
43743,100,7628,12178,13870,0,0,0,1,1
43744,100,7629,12647,13870,0,0,0,1,1
43745,100,7630,12201;12207,13870,0,0,0,2,2
43746,100,7632,12232,13870,0,0,0,1,1
43747,100,7633,12551,13870,0,0,0,1,1
43748,100,7634,12073;12454,13870,0,0,0,2,2
43749,100,7635,12130;12259,13870,0,0,0,2,2
43750,100,7680,11500,14235,0,0,0,1,1
43751,100,7684,11691,14235,0,0,0,1,1
43752,100,7687,11472,14235,0,0,0,1,1
43753,100,7689,11562,14235,0,0,0,1,1
43754,100,7693,11919,14235,0,0,0,1,1
43755,100,7694,11576,14235,0,0,0,1,1
43756,100,7699,11785,14235,0,0,0,1,1
43757,100,7701,11850,14235,0,0,0,1,1
43758,100,7702,11556;11832,14235,0,0,0,2,2
43759,100,7703,11892;11983,14235,0,0,0,2,2
43760,100,7704,16786;17066;17378;17578;20542;20729;20748;21126;21432,14235,0,5,4,0,9
43761,100,7705,11945,14235,0,0,0,1,1
43762,100,7709,12298,14235,0,0,0,1,1
43763,100,7710,11659,14235,0,0,0,1,1
43764,100,7711,12111,14235,0,0,0,1,1
43765,100,7713,12562,14235,0,0,0,1,1
43766,100,7715,11976;12074,14235,0,0,0,2,2
43767,100,7716,11923;12075;16659,14235,0,0,1,2,3
43768,100,7717,12076,14235,0,0,0,1,1
43769,100,7718,12087,14235,0,0,0,1,1
43770,100,7719,12288,14235,0,0,0,1,1
43771,100,7720,12102;12124,14235,0,0,0,2,2
43772,100,7721,12122,14235,0,0,0,1,1
43773,100,7723,12064,14235,0,0,0,1,1
43774,100,7724,11899;12776,14235,0,0,0,2,2
43775,100,7725,16745,14235,0,0,1,0,1
43776,100,7726,12728,14235,0,0,0,1,1
43777,100,7727,12185,14235,0,0,0,1,1
43778,100,7728,12149,14235,0,0,0,1,1
43779,100,7729,12697,14235,0,0,0,1,1
43780,100,7730,12673,14235,0,0,0,1,1
43781,100,7731,12239;12558;19999,14235,0,0,1,2,3
43782,100,7732,12362,14235,0,0,0,1,1
43783,100,7735,11810;12336,14235,0,0,0,2,2
43784,100,7736,12173;12432,14235,0,0,0,2,2
43785,100,7737,12292;12374,14235,0,0,0,2,2
43786,100,7738,12729,14235,0,0,0,1,1
43787,100,7740,11858;12258,14235,0,0,0,2,2
43788,100,7778,10782,14600,0,0,0,1,1
43789,100,7788,11154,14600,0,0,0,1,1
43790,100,7791,11213,14600,0,0,0,1,1
43791,100,7792,11271,14600,0,0,0,1,1
43792,100,7794,11781,14600,0,0,0,1,1
43793,100,7795,11390,14600,0,0,0,1,1
43794,100,7797,11580,14600,0,0,0,1,1
43795,100,7799,11906,14600,0,0,0,1,1
43796,100,7800,11718;11951,14600,0,0,0,2,2
43797,100,7801,11603,14600,0,0,0,1,1
43798,100,7802,11669,14600,0,0,0,1,1
43799,100,7804,11768,14600,0,0,0,1,1
43800,100,7805,11549;11946,14600,0,0,0,2,2
43801,100,7806,11762,14600,0,0,0,1,1
43802,100,7807,12276;12481,14600,0,0,0,2,2
43803,100,7809,12420,14600,0,0,0,1,1
43804,100,7810,11846;12139,14600,0,0,0,2,2
43805,100,7811,11855,14600,0,0,0,1,1
43806,100,7812,11791;11867,14600,0,0,0,2,2
43807,100,7813,11891,14600,0,0,0,1,1
43808,100,7814,12323,14600,0,0,0,1,1
43809,100,7816,11991,14600,0,0,0,1,1
43810,100,7817,12008,14600,0,0,0,1,1
43811,100,7818,12023;12119,14600,0,0,0,2,2
43812,100,7820,12306,14600,0,0,0,1,1
43813,100,7821,12082;12347,14600,0,0,0,2,2
43814,100,7823,12106,14600,0,0,0,1,1
43815,100,7824,12572;16715,14600,0,0,1,1,2
43816,100,7826,12750,14600,0,0,0,1,1
43817,100,7827,12177,14600,0,0,0,1,1
43818,100,7828,12186,14600,0,0,0,1,1
43819,100,7829,12622,14600,0,0,0,1,1
43820,100,7830,12285,14600,0,0,0,1,1
43821,100,7831,12331,14600,0,0,0,1,1
43822,100,7833,12633;12775,14600,0,0,0,2,2
43823,100,7834,12294,14600,0,0,0,1,1
43824,100,7835,12311,14600,0,0,0,1,1
43825,100,7836,12367,14600,0,0,0,1,1
43826,100,7837,12404,14600,0,0,0,1,1
43827,100,7838,12332,14600,0,0,0,1,1
43828,100,7841,12706;12789,14600,0,0,0,2,2
43829,100,7842,12081;12359,14600,0,0,0,2,2
43830,100,7844,12280,14600,0,0,0,1,1
43831,100,7845,12390;12441,14600,0,0,0,2,2
43832,100,7846,11908;12290,14600,0,0,0,2,2
43833,100,7847,12424;12594,14600,0,0,0,2,2
43834,100,7848,12303;12370,14600,0,0,0,2,2
43835,100,7849,12652,14600,0,0,0,1,1
43836,100,7883,11838,14965,0,0,0,1,1
43837,100,7884,10941,14965,0,0,0,1,1
43838,100,7885,11071,14965,0,0,0,1,1
43839,100,7887,11194,14965,0,0,0,1,1
43840,100,7889,11373;11447,14965,0,0,0,2,2
43841,100,7892,11667,14965,0,0,0,1,1
43842,100,7898,12495,14965,0,0,0,1,1
43843,100,7900,11776;12960,14965,0,0,0,2,2
43844,100,7902,12085;12248,14965,0,0,0,2,2
43845,100,7903,11824,14965,0,0,0,1,1
43846,100,7904,12057;12268,14965,0,0,0,2,2
43847,100,7906,11943,14965,0,0,0,1,1
43848,100,7907,11873;11947,14965,0,0,0,2,2
43849,100,7908,11954;12497,14965,0,0,0,2,2
43850,100,7909,12006;12732,14965,0,0,0,2,2
43851,100,7911,12870,14965,0,0,0,1,1
43852,100,7912,12025,14965,0,0,0,1,1
43853,100,7914,12068,14965,0,0,0,1,1
43854,100,7915,12378;12381,14965,0,0,0,2,2
43855,100,7916,12097,14965,0,0,0,1,1
43856,100,7917,12154;12299,14965,0,0,0,2,2
43857,100,7918,11936;12174,14965,0,0,0,2,2
43858,100,7919,12183;12287,14965,0,0,0,2,2
43859,100,7920,12240,14965,0,0,0,1,1
43860,100,7921,12260;12564,14965,0,0,0,2,2
43861,100,7922,12031,14965,0,0,0,1,1
43862,100,7923,12296;12787,14965,0,0,0,2,2
43863,100,7924,12593;12674,14965,0,0,0,2,2
43864,100,7927,12316,14965,0,0,0,1,1
43865,100,7928,11721;12295,14965,0,0,0,2,2
43866,100,7929,12344;12541,14965,0,0,0,2,2
43867,100,7930,12451,14965,0,0,0,1,1
43868,100,7931,12353,14965,0,0,0,1,1
43869,100,7932,12507,14965,0,0,0,1,1
43870,100,7934,12553;12932,14965,0,0,0,2,2
43871,100,7935,12565;12946;18483,14965,0,0,1,2,3
43872,100,7936,12447;12501,14965,0,0,0,2,2
43873,100,7937,12402;12489;17563,14965,0,0,1,2,3
43874,100,7938,12241;12609,14965,0,0,0,2,2
43875,100,7939,12621,14965,0,0,0,1,1
43876,100,7940,12635;12690,14965,0,0,0,2,2
43877,100,7941,12317,14965,0,0,0,1,1
43878,100,7942,12658,14965,0,0,0,1,1
43879,100,7943,12757,14965,0,0,0,1,1
43880,100,7968,11006,15330,0,0,0,1,1
43881,100,7973,11284,15330,0,0,0,1,1
43882,100,7974,11966,15330,0,0,0,1,1
43883,100,7979,11777,15330,0,0,0,1,1
43884,100,7981,11245;11883,15330,0,0,0,2,2
43885,100,7982,11313,15330,0,0,0,1,1
43886,100,7985,11376;12179,15330,0,0,0,2,2
43887,100,7989,12156,15330,0,0,0,1,1
43888,100,7990,11683,15330,0,0,0,1,1
43889,100,7991,11696,15330,0,0,0,1,1
43890,100,7992,11688;11783,15330,0,0,0,2,2
43891,100,7993,11801;12283,15330,0,0,0,2,2
43892,100,7994,12146,15330,0,0,0,1,1
43893,100,7995,11907,15330,0,0,0,1,1
43894,100,7996,11755,15330,0,0,0,1,1
43895,100,7997,11842,15330,0,0,0,1,1
43896,100,7998,11990,15330,0,0,0,1,1
43897,100,7999,12784,15330,0,0,0,1,1
43898,100,8000,12105,15330,0,0,0,1,1
43899,100,8001,12409,15330,0,0,0,1,1
43900,100,8002,12365,15330,0,0,0,1,1
43901,100,8003,12244,15330,0,0,0,1,1
43902,100,8005,12175,15330,0,0,0,1,1
43903,100,8007,12589,15330,0,0,0,1,1
43904,100,8008,12242,15330,0,0,0,1,1
43905,100,8009,12284,15330,0,0,0,1,1
43906,100,8010,11905,15330,0,0,0,1,1
43907,100,8011,12253,15330,0,0,0,1,1
43908,100,8012,12264,15330,0,0,0,1,1
43909,100,8013,12394;12821,15330,0,0,0,2,2
43910,100,8014,12474,15330,0,0,0,1,1
43911,100,8015,12637;12858,15330,0,0,0,2,2
43912,100,8018,12773,15330,0,0,0,1,1
43913,100,8019,12393,15330,0,0,0,1,1
43914,100,8020,12751;13281,15330,0,0,0,2,2
43915,100,8021,12426;16804,15330,0,0,1,1,2
43916,100,8022,12443;12516,15330,0,0,0,2,2
43917,100,8024,12803,15330,0,0,0,1,1
43918,100,8025,12512,15330,0,0,0,1,1
43919,100,8028,12949,15330,0,0,0,1,1
43920,100,8029,12584;12925,15330,0,0,0,2,2
43921,100,8030,12552;12982,15330,0,0,0,2,2
43922,100,8032,12500;12770,15330,0,0,0,2,2
43923,100,8033,12596;12740,15330,0,0,0,2,2
43924,100,8036,12879,15330,0,0,0,1,1
43925,100,8037,13248,15330,0,0,0,1,1
43926,100,8038,12701;13041,15330,0,0,0,2,2
43927,100,8039,12745;13074,15330,0,0,0,2,2
43928,100,8041,12981;13207,15330,0,0,0,2,2
43929,100,8042,12556;12788,15330,0,0,0,2,2
43930,100,8043,12801;12906,15330,0,0,0,2,2
43931,100,8075,11198,15695,0,0,0,1,1
43932,100,8080,11711,15695,0,0,0,1,1
43933,100,8084,11570,15695,0,0,0,1,1
43934,100,8085,11709,15695,0,0,0,1,1
43935,100,8086,12559,15695,0,0,0,1,1
43936,100,8087,11854;11992,15695,0,0,0,2,2
43937,100,8088,11998,15695,0,0,0,1,1
43938,100,8089,12335,15695,0,0,0,1,1
43939,100,8094,12071;12319,15695,0,0,0,2,2
43940,100,8095,12805;12916,15695,0,0,0,2,2
43941,100,8096,12155;12368,15695,0,0,0,2,2
43942,100,8097,12380;12391,15695,0,0,0,2,2
43943,100,8098,12405,15695,0,0,0,1,1
43944,100,8099,12414;12561,15695,0,0,0,2,2
43945,100,8100,12483;12661,15695,0,0,0,2,2
43946,100,8101,12438;12527,15695,0,0,0,2,2
43947,100,8102,12134,15695,0,0,0,1,1
43948,100,8103,12108,15695,0,0,0,1,1
43949,100,8104,12905,15695,0,0,0,1,1
43950,100,8105,12785,15695,0,0,0,1,1
43951,100,8106,13365;16795,15695,0,0,1,1,2
43952,100,8107,12547;12892;15823,15695,0,0,1,2,3
43953,100,8108,12535,15695,0,0,0,1,1
43954,100,8109,12586,15695,0,0,0,1,1
43955,100,8110,13295,15695,0,0,0,1,1
43956,100,8111,12537,15695,0,0,0,1,1
43957,100,8112,12484,15695,0,0,0,1,1
43958,100,8113,11934;11956,15695,0,0,0,2,2
43959,100,8114,12650,15695,0,0,0,1,1
43960,100,8115,12468;12623,15695,0,0,0,2,2
43961,100,8116,12727,15695,0,0,0,1,1
43962,100,8117,13234,15695,0,0,0,1,1
43963,100,8118,12735;12799,15695,0,0,0,2,2
43964,100,8119,12765,15695,0,0,0,1,1
43965,100,8120,13171,15695,0,0,0,1,1
43966,100,8121,12791;12900,15695,0,0,0,2,2
43967,100,8122,12804,15695,0,0,0,1,1
43968,100,8126,12383;12829,15695,0,0,0,2,2
43969,100,8127,12917,15695,0,0,0,1,1
43970,100,8128,12677;12810,15695,0,0,0,2,2
43971,100,8129,12549;12855,15695,0,0,0,2,2
43972,100,8130,12864;13297;17509,15695,0,0,1,2,3
43973,100,8131,12515,15695,0,0,0,1,1
43974,100,8132,12881,15695,0,0,0,1,1
43975,100,8133,13095,15695,0,0,0,1,1
43976,100,8134,12418;12823,15695,0,0,0,2,2
43977,100,8135,13168;13311,15695,0,0,0,2,2
43978,100,8136,12543;12912,15695,0,0,0,2,2
43979,100,8137,13939;14030,15695,0,0,0,2,2
43980,100,8163,10994,16060,0,0,0,1,1
43981,100,8176,11316;11843,16060,0,0,0,2,2
43982,100,8178,12235,16060,0,0,0,1,1
43983,100,8179,11812,16060,0,0,0,1,1
43984,100,8180,11604;11609,16060,0,0,0,2,2
43985,100,8182,11460;12061,16060,0,0,0,2,2
43986,100,8183,11758,16060,0,0,0,1,1
43987,100,8184,12003,16060,0,0,0,1,1
43988,100,8186,11856,16060,0,0,0,1,1
43989,100,8187,12281,16060,0,0,0,1,1
43990,100,8189,11949,16060,0,0,0,1,1
43991,100,8190,12532,16060,0,0,0,1,1
43992,100,8192,12005,16060,0,0,0,1,1
43993,100,8193,12020,16060,0,0,0,1,1
43994,100,8194,12492;16407,16060,0,0,1,1,2
43995,100,8195,11921,16060,0,0,0,1,1
43996,100,8196,12109;12887;17677,16060,0,0,1,2,3
43997,100,8197,12115,16060,0,0,0,1,1
43998,100,8198,11841,16060,0,0,0,1,1
43999,100,8199,12325;12372;17672,16060,0,0,1,2,3
44000,100,8200,12337;12458,16060,0,0,0,2,2
44001,100,8204,12446;13107,16060,0,0,0,2,2
44002,100,8206,12510;12832,16060,0,0,0,2,2
44003,100,8208,12590,16060,0,0,0,1,1
44004,100,8209,12560,16060,0,0,0,1,1
44005,100,8210,12486;12569,16060,0,0,0,2,2
44006,100,8211,12587;12678,16060,0,0,0,2,2
44007,100,8212,13089,16060,0,0,0,1,1
44008,100,8213,12705;13516,16060,0,0,0,2,2
44009,100,8215,12643;12825,16060,0,0,0,2,2
44010,100,8216,12653,16060,0,0,0,1,1
44011,100,8217,18070;22051;22185,16060,2,0,1,0,3
44012,100,8219,12716,16060,0,0,0,1,1
44013,100,8220,12731,16060,0,0,0,1,1
44014,100,8221,12542;13143,16060,0,0,0,2,2
44015,100,8222,12931;13146,16060,0,0,0,2,2
44016,100,8225,12721;12878,16060,0,0,0,2,2
44017,100,8226,12904,16060,0,0,0,1,1
44018,100,8227,12715;12830,16060,0,0,0,2,2
44019,100,8228,12739;12817,16060,0,0,0,2,2
44020,100,8229,13255,16060,0,0,0,1,1
44021,100,8230,12570;12945,16060,0,0,0,2,2
44022,100,8231,12964;13185,16060,0,0,0,2,2
44023,100,8232,12978,16060,0,0,0,1,1
44024,100,8233,12600;12983,16060,0,0,0,2,2
44025,100,8234,13376,16060,0,0,0,1,1
44026,100,8235,13359,16060,0,0,0,1,1
44027,100,8237,13364;13391,16060,0,0,0,2,2
44028,100,8238,12597;13058,16060,0,0,0,2,2
44029,100,8239,13446,16060,0,0,0,1,1
44030,100,8269,10175,16425,0,0,0,1,1
44031,100,8271,10861,16425,0,0,0,1,1
44032,100,8281,11712,16425,0,0,0,1,1
44033,100,8284,11496;11723,16425,0,0,0,2,2
44034,100,8288,12263,16425,0,0,0,1,1
44035,100,8291,11737;11902,16425,0,0,0,2,2
44036,100,8292,12563,16425,0,0,0,1,1
44037,100,8293,11967;12193,16425,0,0,0,2,2
44038,100,8294,12841,16425,0,0,0,1,1
44039,100,8295,12893,16425,0,0,0,1,1
44040,100,8297,12610,16425,0,0,0,1,1
44041,100,8299,12743;17058,16425,0,0,1,1,2
44042,100,8300,12180,16425,0,0,0,1,1
44043,100,8301,12291,16425,0,0,0,1,1
44044,100,8303,12355;12736,16425,0,0,0,2,2
44045,100,8304,12269;12808,16425,0,0,0,2,2
44046,100,8305,12360,16425,0,0,0,1,1
44047,100,8306,12914,16425,0,0,0,1,1
44048,100,8309,12941;13028,16425,0,0,0,2,2
44049,100,8312,12490;12525,16425,0,0,0,2,2
44050,100,8314,13132;13286,16425,0,0,0,2,2
44051,100,8315,12554;12876,16425,0,0,0,2,2
44052,100,8316,12848,16425,0,0,0,1,1
44053,100,8317,12582,16425,0,0,0,1,1
44054,100,8318,12585;13104,16425,0,0,0,2,2
44055,100,8321,12410;12933,16425,0,0,0,2,2
44056,100,8323,12320;13037,16425,0,0,0,2,2
44057,100,8324,12694;13555,16425,0,0,0,2,2
44058,100,8326,12987,16425,0,0,0,1,1
44059,100,8327,13006;13586,16425,0,0,0,2,2
44060,100,8328,12754,16425,0,0,0,1,1
44061,100,8329,12326;13036,16425,0,0,0,2,2
44062,100,8330,12519;12847,16425,0,0,0,2,2
44063,100,8331,12644;12907,16425,0,0,0,2,2
44064,100,8332,12581;12910,16425,0,0,0,2,2
44065,100,8333,12919,16425,0,0,0,1,1
44066,100,8334,12885;12953,16425,0,0,0,2,2
44067,100,8335,12700;13501,16425,0,0,0,2,2
44068,100,8336,13139,16425,0,0,0,1,1
44069,100,8337,12625;13181,16425,0,0,0,2,2
44070,100,8338,12671,16425,0,0,0,1,1
44071,100,8339,13091;13206,16425,0,0,0,2,2
44072,100,8340,13096,16425,0,0,0,1,1
44073,100,8342,13109,16425,0,0,0,1,1
44074,100,8343,13112,16425,0,0,0,1,1
44075,100,8344,13115,16425,0,0,0,1,1
44076,100,8345,13537,16425,0,0,0,1,1
44077,100,8346,12504;13377,16425,0,0,0,2,2
44078,100,8347,13137,16425,0,0,0,1,1
44079,100,8348,12809;13604,16425,0,0,0,2,2
44080,100,8349,12863;13166,16425,0,0,0,2,2
44081,100,8350,12605;13167,16425,0,0,0,2,2
44082,100,8353,12634,16425,0,0,0,1,1
44083,100,8354,13335,16425,0,0,0,1,1
44084,100,8355,13161,16425,0,0,0,1,1
44085,100,8391,11681,16790,0,0,0,1,1
44086,100,8394,11631;12033,16790,0,0,0,2,2
44087,100,8395,12144,16790,0,0,0,1,1
44088,100,8400,12412;12772,16790,0,0,0,2,2
44089,100,8402,12675,16790,0,0,0,1,1
44090,100,8403,12209;12967,16790,0,0,0,2,2
44091,100,8404,12278,16790,0,0,0,1,1
44092,100,8405,12918,16790,0,0,0,1,1
44093,100,8407,12406;12687,16790,0,0,0,2,2
44094,100,8408,12430;12909,16790,0,0,0,2,2
44095,100,8411,12857;12888,16790,0,0,0,2,2
44096,100,8413,13019;13287,16790,0,0,0,2,2
44097,100,8415,12854,16790,0,0,0,1,1
44098,100,8416,12480;12627,16790,0,0,0,2,2
44099,100,8417,12628,16790,0,0,0,1,1
44100,100,8420,13120;13409,16790,0,0,0,2,2
44101,100,8421,13510,16790,0,0,0,1,1
44102,100,8422,12850,16790,0,0,0,1,1
44103,100,8423,12681;13299,16790,0,0,0,2,2
44104,100,8424,12685;13223,16790,0,0,0,2,2
44105,100,8425,12665,16790,0,0,0,1,1
44106,100,8426,12252,16790,0,0,0,1,1
44107,100,8427,12710;13318,16790,0,0,0,2,2
44108,100,8428,13204;13423;17595,16790,0,0,1,2,3
44109,100,8429,12846,16790,0,0,0,1,1
44110,100,8430,12676,16790,0,0,0,1,1
44111,100,8431,12293;12761,16790,0,0,0,2,2
44112,100,8434,13083,16790,0,0,0,1,1
44113,100,8435,12439;12827;16900,16790,0,0,1,2,3
44114,100,8436,12712;13031,16790,0,0,0,2,2
44115,100,8437,13035,16790,0,0,0,1,1
44116,100,8438,13342;13619,16790,0,0,0,2,2
44117,100,8439,12980;13535,16790,0,0,0,2,2
44118,100,8440,13062;13194,16790,0,0,0,2,2
44119,100,8441,13043,16790,0,0,0,1,1
44120,100,8442,12939,16790,0,0,0,1,1
44121,100,8443,13049;13564,16790,0,0,0,2,2
44122,100,8444,13292,16790,0,0,0,1,1
44123,100,8445,13462;13610,16790,0,0,0,2,2
44124,100,8446,12806;13272,16790,0,0,0,2,2
44125,100,8447,13159;13227;16604,16790,0,0,1,2,3
44126,100,8449,12550;13163,16790,0,0,0,2,2
44127,100,8450,13172;13416,16790,0,0,0,2,2
44128,100,8451,13189,16790,0,0,0,1,1
44129,100,8452,13198;13240,16790,0,0,0,2,2
44130,100,8454,12956;13254,16790,0,0,0,2,2
44131,100,8455,13577;13793,16790,0,0,0,2,2
44132,100,8456,13314,16790,0,0,0,1,1
44133,100,8458,13361,16790,0,0,0,1,1
44134,100,8459,13018;13310,16790,0,0,0,2,2
44135,100,8460,13536,16790,0,0,0,1,1
44136,100,8461,13082;13323,16790,0,0,0,2,2
44137,100,8462,13151;13439,16790,0,0,0,2,2
44138,100,8464,13533,16790,0,0,0,1,1
44139,100,8503,11872,17155,0,0,0,1,1
44140,100,8505,11799;11874,17155,0,0,0,2,2
44141,100,8507,11809;12141,17155,0,0,0,2,2
44142,100,8509,12086,17155,0,0,0,1,1
44143,100,8511,12080,17155,0,0,0,1,1
44144,100,8512,11826,17155,0,0,0,1,1
44145,100,8514,16285;16466;16776;17100;20512;20679;20697;20767,17155,0,4,4,0,8
44146,100,8519,12719;13001,17155,0,0,0,2,2
44147,100,8520,12615,17155,0,0,0,1,1
44148,100,8521,12544,17155,0,0,0,1,1
44149,100,8522,12189,17155,0,0,0,1,1
44150,100,8523,12672,17155,0,0,0,1,1
44151,100,8524,13328,17155,0,0,0,1,1
44152,100,8525,12243,17155,0,0,0,1,1
44153,100,8526,12774;12963,17155,0,0,0,2,2
44154,100,8527,12738,17155,0,0,0,1,1
44155,100,8528,18548;22213,17155,1,0,1,0,2
44156,100,8530,12688;12707,17155,0,0,0,2,2
44157,100,8531,12840,17155,0,0,0,1,1
44158,100,8532,12873;13500,17155,0,0,0,2,2
44159,100,8534,12778,17155,0,0,0,1,1
44160,100,8535,12867;12924,17155,0,0,0,2,2
44161,100,8536,12948,17155,0,0,0,1,1
44162,100,8537,13434,17155,0,0,0,1,1
44163,100,8538,12988;13184,17155,0,0,0,2,2
44164,100,8539,13540,17155,0,0,0,1,1
44165,100,8540,13067;13475,17155,0,0,0,2,2
44166,100,8542,12813,17155,0,0,0,1,1
44167,100,8543,12771;12834,17155,0,0,0,2,2
44168,100,8544,13175,17155,0,0,0,1,1
44169,100,8545,12972;13126;17391,17155,0,0,1,2,3
44170,100,8546,13011;13131,17155,0,0,0,2,2
44171,100,8548,13022;13138,17155,0,0,0,2,2
44172,100,8550,12826;13150,17155,0,0,0,2,2
44173,100,8551,13237,17155,0,0,0,1,1
44174,100,8552,13178,17155,0,0,0,1,1
44175,100,8553,13009;13200,17155,0,0,0,2,2
44176,100,8554,13449,17155,0,0,0,1,1
44177,100,8555,12959;13221,17155,0,0,0,2,2
44178,100,8557,13087,17155,0,0,0,1,1
44179,100,8560,13188;13249,17155,0,0,0,2,2
44180,100,8561,13264,17155,0,0,0,1,1
44181,100,8562,12807;13289,17155,0,0,0,2,2
44182,100,8563,13243;13594,17155,0,0,0,2,2
44183,100,8564,12968;13291,17155,0,0,0,2,2
44184,100,8565,13098,17155,0,0,0,1,1
44185,100,8566,13331;13624,17155,0,0,0,2,2
44186,100,8567,13238,17155,0,0,0,1,1
44187,100,8568,13384,17155,0,0,0,1,1
44188,100,8569,13389,17155,0,0,0,1,1
44189,100,8570,13392,17155,0,0,0,1,1
44190,100,8571,13492,17155,0,0,0,1,1
44191,100,8572,13217;13779,17155,0,0,0,2,2
44192,100,8573,13039;13301,17155,0,0,0,2,2
44193,100,8574,13445,17155,0,0,0,1,1
44194,100,8575,12795;13450,17155,0,0,0,2,2
44195,100,8576,13581,17155,0,0,0,1,1
44196,100,8577,13471;13909,17155,0,0,0,2,2
44197,100,8578,13390,17155,0,0,0,1,1
44198,100,8579,13655;13782;17960,17155,0,0,1,2,3
44199,100,8623,12028;12356,17520,0,0,0,2,2
44200,100,8624,12136,17520,0,0,0,1,1
44201,100,8626,12828,17520,0,0,0,1,1
44202,100,8628,12453,17520,0,0,0,1,1
44203,100,8629,12457,17520,0,0,0,1,1
44204,100,8630,12475,17520,0,0,0,1,1
44205,100,8636,13422;13455;17814,17520,0,0,1,2,3
44206,100,8638,12734,17520,0,0,0,1,1
44207,100,8639,12423;12796,17520,0,0,0,2,2
44208,100,8640,12698;12818,17520,0,0,0,2,2
44209,100,8642,12856,17520,0,0,0,1,1
44210,100,8643,12862,17520,0,0,0,1,1
44211,100,8644,13415;13802,17520,0,0,0,2,2
44212,100,8645,12679;12977,17520,0,0,0,2,2
44213,100,8646,13278,17520,0,0,0,1,1
44214,100,8648,13084;13343,17520,0,0,0,2,2
44215,100,8649,13060;13100,17520,0,0,0,2,2
44216,100,8650,13155;13562,17520,0,0,0,2,2
44217,100,8651,12522;13158,17520,0,0,0,2,2
44218,100,8652,13435;13459,17520,0,0,0,2,2
44219,100,8653,12783;13199,17520,0,0,0,2,2
44220,100,8654,13233;13378,17520,0,0,0,2,2
44221,100,8655,13259,17520,0,0,0,1,1
44222,100,8656,13493;13603,17520,0,0,0,2,2
44223,100,8657,12974;13277,17520,0,0,0,2,2
44224,100,8659,13371,17520,0,0,0,1,1
44225,100,8661,13919,17520,0,0,0,1,1
44226,100,8662,13341,17520,0,0,0,1,1
44227,100,8663,13367,17520,0,0,0,1,1
44228,100,8664,13975;19177,17520,0,0,1,1,2
44229,100,8667,12606;12668,17520,0,0,0,2,2
44230,100,8668,14025,17520,0,0,0,1,1
44231,100,8669,13400;13635,17520,0,0,0,2,2
44232,100,8671,13525;13952,17520,0,0,0,2,2
44233,100,8673,13010;13496,17520,0,0,0,2,2
44234,100,8674,13021;13502,17520,0,0,0,2,2
44235,100,8675,13201;13511,17520,0,0,0,2,2
44236,100,8677,13241;13543;18672,17520,0,0,1,2,3
44237,100,8678,13118;13559,17520,0,0,0,2,2
44238,100,8679,13762;13799,17520,0,0,0,2,2
44239,100,8681,13567,17520,0,0,0,1,1
44240,100,8682,13296;13568,17520,0,0,0,2,2
44241,100,8683,13740;13847,17520,0,0,0,2,2
44242,100,8684,13532,17520,0,0,0,1,1
44243,100,8685,13607,17520,0,0,0,1,1
44244,100,8686,13622;13934,17520,0,0,0,2,2
44245,100,8687,13680;18508,17520,0,0,1,1,2
44246,100,8688,13653;13792,17520,0,0,0,2,2
44247,100,8689,12961;13664,17520,0,0,0,2,2
44248,100,8690,13491;13666,17520,0,0,0,2,2
44249,100,8718,11624;11717,17885,0,0,0,2,2
44250,100,8719,11592,17885,0,0,0,1,1
44251,100,8725,11662,17885,0,0,0,1,1
44252,100,8726,12760,17885,0,0,0,1,1
44253,100,8728,12079;12145,17885,0,0,0,2,2
44254,100,8729,12138;12722,17885,0,0,0,2,2
44255,100,8730,13108,17885,0,0,0,1,1
44256,100,8731,12428,17885,0,0,0,1,1
44257,100,8734,12396,17885,0,0,0,1,1
44258,100,8735,11763;12043,17885,0,0,0,2,2
44259,100,8737,12464;12934,17885,0,0,0,2,2
44260,100,8738,11909;12479;17477,17885,0,0,1,2,3
44261,100,8739,12816;13472,17885,0,0,0,2,2
44262,100,8741,12583;12930,17885,0,0,0,2,2
44263,100,8742,12662,17885,0,0,0,1,1
44264,100,8743,12364,17885,0,0,0,1,1
44265,100,8744,12343;12649,17885,0,0,0,2,2
44266,100,8747,12494;12768,17885,0,0,0,2,2
44267,100,8748,13156;13403,17885,0,0,0,2,2
44268,100,8751,12901,17885,0,0,0,1,1
44269,100,8752,12416;13280,17885,0,0,0,2,2
44270,100,8753,12971;13503,17885,0,0,0,2,2
44271,100,8754,13247;13408,17885,0,0,0,2,2
44272,100,8755,13034,17885,0,0,0,1,1
44273,100,8756,13047;17685,17885,0,0,1,1,2
44274,100,8757,12482,17885,0,0,0,1,1
44275,100,8760,13214,17885,0,0,0,1,1
44276,100,8761,13219;13544,17885,0,0,0,2,2
44277,100,8762,13157;13657,17885,0,0,0,2,2
44278,100,8763,13421,17885,0,0,0,1,1
44279,100,8764,13429,17885,0,0,0,1,1
44280,100,8765,13483;13519,17885,0,0,0,2,2
44281,100,8767,12766,17885,0,0,0,1,1
44282,100,8768,13079;13507,17885,0,0,0,2,2
44283,100,8769,13461,17885,0,0,0,1,1
44284,100,8770,13463,17885,0,0,0,1,1
44285,100,8771,13048,17885,0,0,0,1,1
44286,100,8772,12557;13485,17885,0,0,0,2,2
44287,100,8773,13937;14142,17885,0,0,0,2,2
44288,100,8774,13759;13902,17885,0,0,0,2,2
44289,100,8775,14050;14143,17885,0,0,0,2,2
44290,100,8776,13288;13560,17885,0,0,0,2,2
44291,100,8778,12842;13440,17885,0,0,0,2,2
44292,100,8780,13701,17885,0,0,0,1,1
44293,100,8781,13407;13654,17885,0,0,0,2,2
44294,100,8782,13252;13592,17885,0,0,0,2,2
44295,100,8783,13803,17885,0,0,0,1,1
44296,100,8784,13804;14089,17885,0,0,0,2,2
44297,100,8785,14165,17885,0,0,0,1,1
44298,100,8786,14183,17885,0,0,0,1,1
44299,100,8787,13714;14112,17885,0,0,0,2,2
44300,100,8788,13531;13863,17885,0,0,0,2,2
44301,100,8789,13720;13826;18473,17885,0,0,1,2,3
44302,100,8790,13210;13721,17885,0,0,0,2,2
44303,100,8791,13285;14052,17885,0,0,0,2,2
44304,100,8792,13767;14082,17885,0,0,0,2,2
44305,100,8794,13871;14059,17885,0,0,0,2,2
44306,100,8822,11796,18250,0,0,0,1,1
44307,100,8823,11741,18250,0,0,0,1,1
44308,100,8831,11890,18250,0,0,0,1,1
44309,100,8832,12425,18250,0,0,0,1,1
44310,100,8835,13008,18250,0,0,0,1,1
44311,100,8836,13077,18250,0,0,0,1,1
44312,100,8837,13085;13125,18250,0,0,0,2,2
44313,100,8838,12411,18250,0,0,0,1,1
44314,100,8839,12498,18250,0,0,0,1,1
44315,100,8840,12617,18250,0,0,0,1,1
44316,100,8841,12940,18250,0,0,0,1,1
44317,100,8842,12656,18250,0,0,0,1,1
44318,100,8843,12399;12794,18250,0,0,0,2,2
44319,100,8846,12742,18250,0,0,0,1,1
44320,100,8847,13478,18250,0,0,0,1,1
44321,100,8848,12422,18250,0,0,0,1,1
44322,100,8849,12944,18250,0,0,0,1,1
44323,100,8850,13187,18250,0,0,0,1,1
44324,100,8851,12965;13154;17502,18250,0,0,1,2,3
44325,100,8852,13838,18250,0,0,0,1,1
44326,100,8853,13038;13153,18250,0,0,0,2,2
44327,100,8854,12891,18250,0,0,0,1,1
44328,100,8855,13315;13929,18250,0,0,0,2,2
44329,100,8856,12989,18250,0,0,0,1,1
44330,100,8857,13129,18250,0,0,0,1,1
44331,100,8858,12363,18250,0,0,0,1,1
44332,100,8859,13695,18250,0,0,0,1,1
44333,100,8860,13271,18250,0,0,0,1,1
44334,100,8861,13396;13515,18250,0,0,0,2,2
44335,100,8863,13349;13574,18250,0,0,0,2,2
44336,100,8864,13679;13860;17693;17885,18250,0,0,2,2,4
44337,100,8865,12882;13348,18250,0,0,0,2,2
44338,100,8867,14150,18250,0,0,0,1,1
44339,100,8868,13486;13588,18250,0,0,0,2,2
44340,100,8870,13106;13590,18250,0,0,0,2,2
44341,100,8871,14064,18250,0,0,0,1,1
44342,100,8872,13811,18250,0,0,0,1,1
44343,100,8873,13698;17260;18815,18250,0,0,2,1,3
44344,100,8874,13339,18250,0,0,0,1,1
44345,100,8876,13304;13761,18250,0,0,0,2,2
44346,100,8877,13593,18250,0,0,0,1,1
44347,100,8879,13405;14047,18250,0,0,0,2,2
44348,100,8880,13078,18250,0,0,0,1,1
44349,100,8882,13448;13889,18250,0,0,0,2,2
44350,100,8883,13631;13935,18250,0,0,0,2,2
44351,100,8884,14017,18250,0,0,0,1,1
44352,100,8885,13646;14280,18250,0,0,0,2,2
44353,100,8886,14190,18250,0,0,0,1,1
44354,100,8887,13659;13834;17876;22175,18250,1,0,1,2,4
44355,100,8888,14080,18250,0,0,0,1,1
44356,100,8889,13547;13755,18250,0,0,0,2,2
44357,100,8890,14065;14268;19492,18250,0,0,1,2,3
44358,100,8891,13709;14121,18250,0,0,0,2,2
44359,100,8892,13346;13712,18250,0,0,0,2,2
44360,100,8893,13728,18250,0,0,0,1,1
44361,100,8894,13723;14071;16833,18250,0,0,1,2,3
44362,100,8896,13529;13760,18250,0,0,0,2,2
44363,100,8897,13733,18250,0,0,0,1,1
44364,100,8898,14093,18250,0,0,0,1,1
44365,100,8899,13381;13996,18250,0,0,0,2,2
44366,100,8900,13980;14299,18250,0,0,0,2,2
44367,100,8901,13203;13888,18250,0,0,0,2,2
44368,100,8902,13512;14019,18250,0,0,0,2,2
44369,100,8903,13453;13681,18250,0,0,0,2,2
44370,100,8904,14189;14310,18250,0,0,0,2,2
44371,100,8905,13915;13971,18250,0,0,0,2,2
44372,100,8906,13879;13941;17628,18250,0,0,1,2,3
44373,100,8907,13004;13946,18250,0,0,0,2,2
44374,100,8908,13556;13950,18250,0,0,0,2,2
44375,100,8940,11630,18615,0,0,0,1,1
44376,100,8943,11839;12002,18615,0,0,0,2,2
44377,100,8946,11859,18615,0,0,0,1,1
44378,100,8950,12444;12526,18615,0,0,0,2,2
44379,100,8952,12341,18615,0,0,0,1,1
44380,100,8954,12206;12695,18615,0,0,0,2,2
44381,100,8955,17250;17352,18615,0,0,2,0,2
44382,100,8956,12733;12837,18615,0,0,0,2,2
44383,100,8957,12266;12741,18615,0,0,0,2,2
44384,100,8958,13128;13275,18615,0,0,0,2,2
44385,100,8962,12929,18615,0,0,0,1,1
44386,100,8963,12947;13110,18615,0,0,0,2,2
44387,100,8964,12957,18615,0,0,0,1,1
44388,100,8965,12970;13245,18615,0,0,0,2,2
44389,100,8966,12973,18615,0,0,0,1,1
44390,100,8967,13498;13575,18615,0,0,0,2,2
44391,100,8968,13942;14132,18615,0,0,0,2,2
44392,100,8969,13164;13294,18615,0,0,0,2,2
44393,100,8970,13215,18615,0,0,0,1,1
44394,100,8971,13258;13508,18615,0,0,0,2,2
44395,100,8972,14033;14206;18649,18615,0,0,1,2,3
44396,100,8973,13441,18615,0,0,0,1,1
44397,100,8974,13587;13766,18615,0,0,0,2,2
44398,100,8975,12926,18615,0,0,0,1,1
44399,100,8976,13546;13748,18615,0,0,0,2,2
44400,100,8977,13428;13749,18615,0,0,0,2,2
44401,100,8979,13538,18615,0,0,0,1,1
44402,100,8981,13908;13968,18615,0,0,0,2,2
44403,100,8983,13618;14210,18615,0,0,0,2,2
44404,100,8984,13705,18615,0,0,0,1,1
44405,100,8985,13393;13784,18615,0,0,0,2,2
44406,100,8986,13639,18615,0,0,0,1,1
44407,100,8987,13824,18615,0,0,0,1,1
44408,100,8988,13991,18615,0,0,0,1,1
44409,100,8989,13800;14155,18615,0,0,0,2,2
44410,100,8990,13644;14285,18615,0,0,0,2,2
44411,100,8991,13693;13772,18615,0,0,0,2,2
44412,100,8992,13727;14291,18615,0,0,0,2,2
44413,100,8993,12942,18615,0,0,0,1,1
44414,100,8994,14368;14458,18615,0,0,0,2,2
44415,100,8995,13913;14502,18615,0,0,0,2,2
44416,100,8996,14097;14328,18615,0,0,0,2,2
44417,100,8997,14048;14177,18615,0,0,0,2,2
44418,100,8998,14254,18615,0,0,0,1,1
44419,100,8999,14000;14349;18712,18615,0,0,1,2,3
44420,100,9000,13753;14021,18615,0,0,0,2,2
44421,100,9001,14022,18615,0,0,0,1,1
44422,100,9002,14061;14315,18615,0,0,0,2,2
44423,100,9003,14125,18615,0,0,0,1,1
44424,100,9004,14359,18615,0,0,0,1,1
44425,100,9005,13840;14067,18615,0,0,0,2,2
44426,100,9006,13810;14069;18635,18615,0,0,1,2,3
44427,100,9007,13615;14074,18615,0,0,0,2,2
44428,100,9008,13551;14075,18615,0,0,0,2,2
44429,100,9009,13787;14084,18615,0,0,0,2,2
44430,100,9039,11309,18980,0,0,0,1,1
44431,100,9042,11868,18980,0,0,0,1,1
44432,100,9052,12215;12935,18980,0,0,0,2,2
44433,100,9054,12442,18980,0,0,0,1,1
44434,100,9056,12937,18980,0,0,0,1,1
44435,100,9058,12607,18980,0,0,0,1,1
44436,100,9060,12976,18980,0,0,0,1,1
44437,100,9062,12135;13090;17900;19674,18980,0,0,2,2,4
44438,100,9063,12845;13023,18980,0,0,0,2,2
44439,100,9064,13094,18980,0,0,0,1,1
44440,100,9065,12400;12433,18980,0,0,0,2,2
44441,100,9066,12996;13642,18980,0,0,0,2,2
44442,100,9068,12979;13059,18980,0,0,0,2,2
44443,100,9069,13121,18980,0,0,0,1,1
44444,100,9070,13066,18980,0,0,0,1,1
44445,100,9071,13708;13768;18338,18980,0,0,1,2,3
44446,100,9072,13208;13226,18980,0,0,0,2,2
44447,100,9075,12833,18980,0,0,0,1,1
44448,100,9076,12496;13266,18980,0,0,0,2,2
44449,100,9077,13282;13313,18980,0,0,0,2,2
44450,100,9078,13352;13629,18980,0,0,0,2,2
44451,100,9079,13374;13807,18980,0,0,0,2,2
44452,100,9082,13387;13420,18980,0,0,0,2,2
44453,100,9083,13426;13771,18980,0,0,0,2,2
44454,100,9084,13013;13432,18980,0,0,0,2,2
44455,100,9085,14284;14292,18980,0,0,0,2,2
44456,100,9086,13386,18980,0,0,0,1,1
44457,100,9087,13212;13480,18980,0,0,0,2,2
44458,100,9088,13177,18980,0,0,0,1,1
44459,100,9089,13672;14159,18980,0,0,0,2,2
44460,100,9090,13989;14004,18980,0,0,0,2,2
44461,100,9091,13667;13979,18980,0,0,0,2,2
44462,100,9092,12951;13669,18980,0,0,0,2,2
44463,100,9093,13703;13911,18980,0,0,0,2,2
44464,100,9094,13700;13707,18980,0,0,0,2,2
44465,100,9095,13517;14095,18980,0,0,0,2,2
44466,100,9096,14567,18980,0,0,0,1,1
44467,100,9097,13774,18980,0,0,0,1,1
44468,100,9098,13490;13814,18980,0,0,0,2,2
44469,100,9099,13820;14318,18980,0,0,0,2,2
44470,100,9100,13830;14494;18418,18980,0,0,1,2,3
44471,100,9102,13897;14327,18980,0,0,0,2,2
44472,100,9103,13758;14063,18980,0,0,0,2,2
44473,100,9104,13641;13890,18980,0,0,0,2,2
44474,100,9105,14439,18980,0,0,0,1,1
44475,100,9107,13735;13920,18980,0,0,0,2,2
44476,100,9108,14212,18980,0,0,0,1,1
44477,100,9109,13956,18980,0,0,0,1,1
44478,100,9110,13597;13958,18980,0,0,0,2,2
44479,100,9111,13279;13967,18980,0,0,0,2,2
44480,100,9112,13981,18980,0,0,0,1,1
44481,100,9113,13743;14478,18980,0,0,0,2,2
44482,100,9114,13777;14008,18980,0,0,0,2,2
44483,100,9115,14034;14113,18980,0,0,0,2,2
44484,100,9116,14215,18980,0,0,0,1,1
44485,100,9117,14358;14475,18980,0,0,0,2,2
44486,100,9118,13621;14153,18980,0,0,0,2,2
44487,100,9119,13643;14130,18980,0,0,0,2,2
44488,100,9120,14081;14496,18980,0,0,0,2,2
44489,100,9121,14085;14102,18980,0,0,0,2,2
44490,100,9122,14110;19119,18980,0,0,1,1,2
44491,100,9123,14137;14590,18980,0,0,0,2,2
44492,100,9124,13837;14169,18980,0,0,0,2,2
44493,100,9125,14171;14530,18980,0,0,0,2,2
44494,100,9150,11508;17248,19345,0,0,1,1,2
44495,100,9153,12050,19345,0,0,0,1,1
44496,100,9154,12055,19345,0,0,0,1,1
44497,100,9156,11871,19345,0,0,0,1,1
44498,100,9160,12315,19345,0,0,0,1,1
44499,100,9161,13656,19345,0,0,0,1,1
44500,100,9165,13225,19345,0,0,0,1,1
44501,100,9166,12579;12843,19345,0,0,0,2,2
44502,100,9167,12275;12790;17637,19345,0,0,1,2,3
44503,100,9168,12682;13065,19345,0,0,0,2,2
44504,100,9169,13332,19345,0,0,0,1,1
44505,100,9170,12182,19345,0,0,0,1,1
44506,100,9172,12896;13071,19345,0,0,0,2,2
44507,100,9174,12943;13930,19345,0,0,0,2,2
44508,100,9175,12954,19345,0,0,0,1,1
44509,100,9176,12312;13173,19345,0,0,0,2,2
44510,100,9177,12853;13072,19345,0,0,0,2,2
44511,100,9179,13487;14029,19345,0,0,0,2,2
44512,100,9180,13357,19345,0,0,0,1,1
44513,100,9181,13136;13831,19345,0,0,0,2,2
44514,100,9182,13454;13718,19345,0,0,0,2,2
44515,100,9183,13193;13402,19345,0,0,0,2,2
44516,100,9186,13253;13477,19345,0,0,0,2,2
44517,100,9188,13322,19345,0,0,0,1,1
44518,100,9189,13325,19345,0,0,0,1,1
44519,100,9190,13326,19345,0,0,0,1,1
44520,100,9192,14174;14231,19345,0,0,0,2,2
44521,100,9193,13424;13818,19345,0,0,0,2,2
44522,100,9195,13474;13922,19345,0,0,0,2,2
44523,100,9196,13431;14168,19345,0,0,0,2,2
44524,100,9198,13433;13484,19345,0,0,0,2,2
44525,100,9199,14316,19345,0,0,0,1,1
44526,100,9200,13699;18878,19345,0,0,1,1,2
44527,100,9202,13436;13677,19345,0,0,0,2,2
44528,100,9203,13791,19345,0,0,0,1,1
44529,100,9204,13452;13633,19345,0,0,0,2,2
44530,100,9205,13689;14107,19345,0,0,0,2,2
44531,100,9206,13356;13691,19345,0,0,0,2,2
44532,100,9207,13730;14374,19345,0,0,0,2,2
44533,100,9208,13739;14164,19345,0,0,0,2,2
44534,100,9209,13658;13973,19345,0,0,0,2,2
44535,100,9210,13809,19345,0,0,0,1,1
44536,100,9211,14056,19345,0,0,0,1,1
44537,100,9212,13466;13815,19345,0,0,0,2,2
44538,100,9213,13786;13823,19345,0,0,0,2,2
44539,100,9214,14526;14580;18365;22205,19345,1,0,1,2,4
44540,100,9215,14330;14370,19345,0,0,0,2,2
44541,100,9216,13966,19345,0,0,0,1,1
44542,100,9218,14411;14606;17362,19345,0,0,1,2,3
44543,100,9219,13754;13961;18275,19345,0,0,1,2,3
44544,100,9220,17146;17629;17782;17832;21046;21493;21557,19345,0,3,4,0,7
44545,100,9221,13866;13972,19345,0,0,0,2,2
44546,100,9223,14040;14499,19345,0,0,0,2,2
44547,100,9225,14672;14789;17461,19345,0,0,3,0,3
44548,100,9227,14413;19000,19345,0,0,1,1,2
44549,100,9228,13848;14126,19345,0,0,0,2,2
44550,100,9229,14133;14365,19345,0,0,0,2,2
44551,100,9230,13585;14134,19345,0,0,0,2,2
44552,100,9231,13687;14140,19345,0,0,0,2,2
44553,100,9233,14161;14464,19345,0,0,0,2,2
44554,100,9234,14180;14715;19225,19345,0,0,2,1,3
44555,100,9235,14229;14811,19345,0,0,1,1,2
44556,100,9236,14259,19345,0,0,0,1,1
44557,100,9237,14099;14270,19345,0,0,0,2,2
44558,100,9238,13790;14296,19345,0,0,0,2,2
44559,100,9239,14282;14319,19345,0,0,0,2,2
44560,100,9240,14287,19345,0,0,0,1,1
44561,100,9241,13713;14305,19345,0,0,0,2,2
44562,100,9242,14675,19345,0,0,1,0,1
44563,100,9243,14615;18504,19345,0,0,1,1,2
44564,100,9244,14323;14364,19345,0,0,0,2,2
44565,100,9273,12903,19710,0,0,0,1,1
44566,100,9276,13333,19710,0,0,0,1,1
44567,100,9280,13284,19710,0,0,0,1,1
44568,100,9281,13081;13513,19710,0,0,0,2,2
44569,100,9282,13494,19710,0,0,0,1,1
44570,100,9284,13283,19710,0,0,0,1,1
44571,100,9285,13338,19710,0,0,0,1,1
44572,100,9286,13399;13524,19710,0,0,0,2,2
44573,100,9288,12897;13430,19710,0,0,0,2,2
44574,100,9289,13437;14006,19710,0,0,0,2,2
44575,100,9290,13465,19710,0,0,0,1,1
44576,100,9291,12861;13015,19710,0,0,0,2,2
44577,100,9293,13645;13905,19710,0,0,0,2,2
44578,100,9294,14149;14607,19710,0,0,0,2,2
44579,100,9295,13757;13808,19710,0,0,0,2,2
44580,100,9296,13661;13858,19710,0,0,0,2,2
44581,100,9297,13675;13682,19710,0,0,0,2,2
44582,100,9298,13859,19710,0,0,0,1,1
44583,100,9299,13566;14131;19060,19710,0,0,1,2,3
44584,100,9300,13499;13796,19710,0,0,0,2,2
44585,100,9301,14072;14135,19710,0,0,0,2,2
44586,100,9302,14073;18500;19544,19710,0,0,2,1,3
44587,100,9303,13855;13933;18407,19710,0,0,1,2,3
44588,100,9304,13634;14366,19710,0,0,0,2,2
44589,100,9305,13750;13882,19710,0,0,0,2,2
44590,100,9306,14224,19710,0,0,0,1,1
44591,100,9307,14344;14927,19710,0,0,1,1,2
44592,100,9309,13770;13990,19710,0,0,0,2,2
44593,100,9310,14417,19710,0,0,0,1,1
44594,100,9311,14311,19710,0,0,0,1,1
44595,100,9312,14028;14437,19710,0,0,0,2,2
44596,100,9313,13704;14077,19710,0,0,0,2,2
44597,100,9314,13628;14136,19710,0,0,0,2,2
44598,100,9316,14771;18737;22225,19710,1,0,2,0,3
44599,100,9317,13457,19710,0,0,0,1,1
44600,100,9318,13984;14584,19710,0,0,0,2,2
44601,100,9319,14151,19710,0,0,0,1,1
44602,100,9320,14866;18725,19710,0,0,2,0,2
44603,100,9322,14331,19710,0,0,0,1,1
44604,100,9323,18511,19710,0,0,1,0,1
44605,100,9324,13726,19710,0,0,0,1,1
44606,100,9325,13788;14333,19710,0,0,0,2,2
44607,100,9326,13816;14363,19710,0,0,0,2,2
44608,100,9328,14201;14385,19710,0,0,0,2,2
44609,100,9329,14398,19710,0,0,0,1,1
44610,100,9330,14705;14718,19710,0,0,2,0,2
44611,100,9332,14821,19710,0,0,1,0,1
44612,100,9333,14519;14897;18280,19710,0,0,2,1,3
44613,100,9334,14457,19710,0,0,0,1,1
44614,100,9335,14630,19710,0,0,0,1,1
44615,100,9336,14481,19710,0,0,0,1,1
44616,100,9337,14036;14503,19710,0,0,0,2,2
44617,100,9338,14618;14727,19710,0,0,1,1,2
44618,100,9339,14514,19710,0,0,0,1,1
44619,100,9340,14522,19710,0,0,0,1,1
44620,100,9364,11764,20075,0,0,0,1,1
44621,100,9377,12388,20075,0,0,0,1,1
44622,100,9379,12196,20075,0,0,0,1,1
44623,100,9382,12894,20075,0,0,0,1,1
44624,100,9388,13309,20075,0,0,0,1,1
44625,100,9390,13052;13337,20075,0,0,0,2,2
44626,100,9393,13000,20075,0,0,0,1,1
44627,100,9394,13394;13565,20075,0,0,0,2,2
44628,100,9395,13373;13495,20075,0,0,0,2,2
44629,100,9396,13932;14042,20075,0,0,0,2,2
44630,100,9397,13460,20075,0,0,0,1,1
44631,100,9399,13611;14194,20075,0,0,0,2,2
44632,100,9400,13702,20075,0,0,0,1,1
44633,100,9401,13521;13668,20075,0,0,0,2,2
44634,100,9402,13276;13737;18895,20075,0,0,1,2,3
44635,100,9403,14013,20075,0,0,0,1,1
44636,100,9405,13383;18170,20075,0,0,1,1,2
44637,100,9406,14347;14578,20075,0,0,0,2,2
44638,100,9407,13722;14123,20075,0,0,0,2,2
44639,100,9408,13862,20075,0,0,0,1,1
44640,100,9409,14309;14474,20075,0,0,0,2,2
44641,100,9411,14281,20075,0,0,0,1,1
44642,100,9412,13616;13948,20075,0,0,0,2,2
44643,100,9413,14855;19377,20075,0,0,2,0,2
44644,100,9415,14015;14204,20075,0,0,0,2,2
44645,100,9416,14531,20075,0,0,0,1,1
44646,100,9418,14853;14891,20075,0,0,2,0,2
44647,100,9419,14060;14198,20075,0,0,0,2,2
44648,100,9421,14427;14444,20075,0,0,0,2,2
44649,100,9422,14090,20075,0,0,0,1,1
44650,100,9423,14741,20075,0,0,1,0,1
44651,100,9424,14039;14104,20075,0,0,0,2,2
44652,100,9425,14516,20075,0,0,0,1,1
44653,100,9426,14505;14805,20075,0,0,1,1,2
44654,100,9428,13599;14179;18674,20075,0,0,1,2,3
44655,100,9429,14207;14255;19328,20075,0,0,1,2,3
44656,100,9430,14202,20075,0,0,0,1,1
44657,100,9431,14220,20075,0,0,0,1,1
44658,100,9432,14058;14221,20075,0,0,0,2,2
44659,100,9433,14196;14226,20075,0,0,0,2,2
44660,100,9434,13710;14250,20075,0,0,0,2,2
44661,100,9435,14551;14824,20075,0,0,1,1,2
44662,100,9436,13883;14408;18558,20075,0,0,1,2,3
44663,100,9438,13873,20075,0,0,0,1,1
44664,100,9439,13626;14454,20075,0,0,0,2,2
44665,100,9440,14482,20075,0,0,0,1,1
44666,100,9441,14489;14585,20075,0,0,0,2,2
44667,100,9442,15063;18836,20075,0,0,2,0,2
44668,100,9443,14480;14507,20075,0,0,0,2,2
44669,100,9444,14517,20075,0,0,0,1,1
44670,100,9445,14524,20075,0,0,0,1,1
44671,100,9446,14854;15039,20075,0,0,2,0,2
44672,100,9447,14592;14684,20075,0,0,1,1,2
44673,100,9448,14573,20075,0,0,0,1,1
44674,100,9449,14589;14765,20075,0,0,1,1,2
44675,100,9450,14575;14863;19668,20075,0,0,2,1,3
44676,100,9451,14426;14609,20075,0,0,0,2,2
44677,100,9452,14612,20075,0,0,0,1,1
44678,100,9453,14724,20075,0,0,1,0,1
44679,100,9454,14622,20075,0,0,0,1,1
44680,100,9455,14623,20075,0,0,0,1,1
44681,100,9456,15027,20075,0,0,1,0,1
44682,100,9458,14643,20075,0,0,0,1,1
44683,100,9459,14817;15086;20124,20075,0,0,3,0,3
44684,100,9475,11848,20440,0,0,0,1,1
44685,100,9488,12217,20440,0,0,0,1,1
44686,100,9494,12166,20440,0,0,0,1,1
44687,100,9496,12567;12922,20440,0,0,0,2,2
44688,100,9502,13101;13591,20440,0,0,0,2,2
44689,100,9503,13765,20440,0,0,0,1,1
44690,100,9504,13312;13329,20440,0,0,0,2,2
44691,100,9505,13244;13910,20440,0,0,0,2,2
44692,100,9509,13936;13947,20440,0,0,0,2,2
44693,100,9510,13506;13694,20440,0,0,0,2,2
44694,100,9511,13224;13545,20440,0,0,0,2,2
44695,100,9512,13945,20440,0,0,0,1,1
44696,100,9513,13608;14297,20440,0,0,0,2,2
44697,100,9516,13598;14390,20440,0,0,0,2,2
44698,100,9517,13246;13706,20440,0,0,0,2,2
44699,100,9518,13717;13719,20440,0,0,0,2,2
44700,100,9521,13851;14298,20440,0,0,0,2,2
44701,100,9522,14114;14345,20440,0,0,0,2,2
44702,100,9523,13482;13977,20440,0,0,0,2,2
44703,100,9524,12875;13924,20440,0,0,0,2,2
44704,100,9525,13912;13969,20440,0,0,0,2,2
44705,100,9526,13783;13954;18539,20440,0,0,1,2,3
44706,100,9529,14014;14184,20440,0,0,0,2,2
44707,100,9530,14513;17643,20440,0,0,1,1,2
44708,100,9531,14120;14754,20440,0,0,1,1,2
44709,100,9532,13558;14117,20440,0,0,0,2,2
44710,100,9533,14162;14646,20440,0,0,0,2,2
44711,100,9534,13404;14163;18240,20440,0,0,1,2,3
44712,100,9535,14175;14217,20440,0,0,0,2,2
44713,100,9536,14213;14655,20440,0,0,0,2,2
44714,100,9537,14222;14232,20440,0,0,0,2,2
44715,100,9539,15017;19326,20440,0,0,2,0,2
44716,100,9540,14278;14902,20440,0,0,1,1,2
44717,100,9541,14115;14424,20440,0,0,0,2,2
44718,100,9542,14313,20440,0,0,0,1,1
44719,100,9543,14314,20440,0,0,0,1,1
44720,100,9545,14248;14256,20440,0,0,0,2,2
44721,100,9546,14376,20440,0,0,0,1,1
44722,100,9547,13841;14451,20440,0,0,0,2,2
44723,100,9548,14657;14877;18916;19105,20440,0,0,3,1,4
44724,100,9549,14456,20440,0,0,0,1,1
44725,100,9550,14958,20440,0,0,1,0,1
44726,100,9552,14105;18373,20440,0,0,1,1,2
44727,100,9553,14485,20440,0,0,0,1,1
44728,100,9554,14010;14487,20440,0,0,0,2,2
44729,100,9555,14492,20440,0,0,0,1,1
44730,100,9556,14371;14501,20440,0,0,0,2,2
44731,100,9558,14068;14512,20440,0,0,0,2,2
44732,100,9559,14535;14838;19199,20440,0,0,2,1,3
44733,100,9560,15215;15393;19321,20440,0,0,3,0,3
44734,100,9561,14559;14847,20440,0,0,1,1,2
44735,100,9562,14661,20440,0,0,1,0,1
44736,100,9563,13741;13870,20440,0,0,0,2,2
44737,100,9564,14568;14601,20440,0,0,0,2,2
44738,100,9565,14356;14600,20440,0,0,0,2,2
44739,100,9567,14260;14639,20440,0,0,0,2,2
44740,100,9568,14640,20440,0,0,0,1,1
44741,100,9569,14683;14998,20440,0,0,2,0,2
44742,100,9571,14571,20440,0,0,0,1,1
44743,100,9572,14596;14945;19470,20440,0,0,2,1,3
44744,100,9573,14869,20440,0,0,1,0,1
44745,100,9574,14830;15154;19008,20440,0,0,3,0,3
44746,100,9575,15078;18378,20440,0,0,2,0,2
44747,100,9576,14435;14843,20440,0,0,1,1,2
44748,100,9577,14560;14779,20440,0,0,1,1,2
44749,100,9586,10856,20805,0,0,0,1,1
44750,100,9589,10677,20805,0,0,0,1,1
44751,100,9611,12986;13045,20805,0,0,0,2,2
44752,100,9613,12058;12575,20805,0,0,0,2,2
44753,100,9618,13099,20805,0,0,0,1,1
44754,100,9621,12408,20805,0,0,0,1,1
44755,100,9622,13017,20805,0,0,0,1,1
44756,100,9623,13613,20805,0,0,0,1,1
44757,100,9625,13269;14265,20805,0,0,0,2,2
44758,100,9626,13625;13776;17978;18258,20805,0,0,2,2,4
44759,100,9628,13504,20805,0,0,0,1,1
44760,100,9629,13569;13949,20805,0,0,0,2,2
44761,100,9630,13497;13697,20805,0,0,0,2,2
44762,100,9631,13632;13746,20805,0,0,0,2,2
44763,100,9633,13957,20805,0,0,0,1,1
44764,100,9634,13578;13938,20805,0,0,0,2,2
44765,100,9635,13853;14939,20805,0,0,1,1,2
44766,100,9637,13336;13944,20805,0,0,0,2,2
44767,100,9638,13552;14425,20805,0,0,0,2,2
44768,100,9639,13806;13976,20805,0,0,0,2,2
44769,100,9640,13549;14026,20805,0,0,0,2,2
44770,100,9641,14225;14520,20805,0,0,0,2,2
44771,100,9642,13993;14122,20805,0,0,0,2,2
44772,100,9643,14894;15025;19153,20805,0,0,3,0,3
44773,100,9644,14043;14236,20805,0,0,0,2,2
44774,100,9645,14158;14570;19367,20805,0,0,1,2,3
44775,100,9646,14188;14468,20805,0,0,0,2,2
44776,100,9648,14317;14604;17877,20805,0,0,1,2,3
44777,100,9649,14275,20805,0,0,0,1,1
44778,100,9651,14384;14441,20805,0,0,0,2,2
44779,100,9653,14245;14403,20805,0,0,0,2,2
44780,100,9654,14279;14443,20805,0,0,0,2,2
44781,100,9655,14420;15126;17604;18824,20805,0,0,3,1,4
44782,100,9656,14086;14536,20805,0,0,0,2,2
44783,100,9658,14582,20805,0,0,0,1,1
44784,100,9659,14595;14671;18008,20805,0,0,2,1,3
44785,100,9661,14564,20805,0,0,0,1,1
44786,100,9662,14740;14773,20805,0,0,2,0,2
44787,100,9663,14552;14658,20805,0,0,0,2,2
44788,100,9664,14266;14674,20805,0,0,1,1,2
44789,100,9665,14676;14825,20805,0,0,2,0,2
44790,100,9666,14704,20805,0,0,1,0,1
44791,100,9667,14706,20805,0,0,1,0,1
44792,100,9670,14835;15135;19251,20805,0,0,3,0,3
44793,100,9672,15035,20805,0,0,1,0,1
44794,100,9673,14786;15260;18241,20805,0,0,3,0,3
44795,100,9675,14813;15240,20805,0,0,2,0,2
44796,100,9676,14849;15187,20805,0,0,2,0,2
44797,100,9678,14880;15176,20805,0,0,2,0,2
44798,100,9679,14873,20805,0,0,1,0,1
44799,100,9681,15364,20805,0,0,1,0,1
44800,100,9682,14633;15070;18669;22221,20805,1,0,2,1,4
44801,100,9684,14518;14916,20805,0,0,1,1,2
44802,100,9685,14884;14917,20805,0,0,2,0,2
44803,100,9686,14924;17986;22179,20805,1,0,2,0,3
44804,100,9688,14986,20805,0,0,1,0,1
44805,100,9709,11563;11914,21170,0,0,0,2,2
44806,100,9714,12013,21170,0,0,0,1,1
44807,100,9719,12753;12820,21170,0,0,0,2,2
44808,100,9722,13012;13070,21170,0,0,0,2,2
44809,100,9723,13003;13358,21170,0,0,0,2,2
44810,100,9728,13898,21170,0,0,0,1,1
44811,100,9730,13819;14784,21170,0,0,1,1,2
44812,100,9731,13369;14397,21170,0,0,0,2,2
44813,100,9732,13647;13904,21170,0,0,0,2,2
44814,100,9733,13921,21170,0,0,0,1,1
44815,100,9735,13729;14012,21170,0,0,0,2,2
44816,100,9736,14038;14197,21170,0,0,0,2,2
44817,100,9737,13528;14208,21170,0,0,0,2,2
44818,100,9738,14078;14372,21170,0,0,0,2,2
44819,100,9739,14088,21170,0,0,0,1,1
44820,100,9740,14103;14195,21170,0,0,0,2,2
44821,100,9741,14138;14216,21170,0,0,0,2,2
44822,100,9742,14152;14326,21170,0,0,0,2,2
44823,100,9743,14192;14557;18431,21170,0,0,1,2,3
44824,100,9744,14746;15004,21170,0,0,2,0,2
44825,100,9745,14227;15522,21170,0,0,1,1,2
44826,100,9746,14361;14642,21170,0,0,0,2,2
44827,100,9747,14829,21170,0,0,1,0,1
44828,100,9750,13548;14404,21170,0,0,0,2,2
44829,100,9751,14542;14782,21170,0,0,1,1,2
44830,100,9753,14389;14460,21170,0,0,0,2,2
44831,100,9754,14203;14486,21170,0,0,0,2,2
44832,100,9755,14848,21170,0,0,1,0,1
44833,100,9756,14861;14943;19642,21170,0,0,3,0,3
44834,100,9757,14851;14865;19311,21170,0,0,3,0,3
44835,100,9758,14160;14532,21170,0,0,0,2,2
44836,100,9759,14264;14549,21170,0,0,0,2,2
44837,100,9761,14447;14576,21170,0,0,0,2,2
44838,100,9762,14076;14579,21170,0,0,0,2,2
44839,100,9763,14591;15072,21170,0,0,1,1,2
44840,100,9764,14837;14951;18109;19892,21170,0,0,4,0,4
44841,100,9765,14703;15030,21170,0,0,2,0,2
44842,100,9766,14722,21170,0,0,1,0,1
44843,100,9767,14735;14922,21170,0,0,2,0,2
44844,100,9768,14751;14887,21170,0,0,2,0,2
44845,100,9770,14790;14904,21170,0,0,2,0,2
44846,100,9771,14100;14793,21170,0,0,1,1,2
44847,100,9772,14498;14802,21170,0,0,1,1,2
44848,100,9773,15601;15995;18857,21170,0,0,3,0,3
44849,100,9774,15342;15411;18573;18747,21170,0,0,4,0,4
44850,100,9775,14852;15174,21170,0,0,2,0,2
44851,100,9777,14664;14895,21170,0,0,2,0,2
44852,100,9778,14915;15121,21170,0,0,2,0,2
44853,100,9779,14472;14872,21170,0,0,1,1,2
44854,100,9780,14749;14936,21170,0,0,2,0,2
44855,100,9781,15289;19004,21170,0,0,2,0,2
44856,100,9782,15170;18217,21170,0,0,2,0,2
44857,100,9783,14976;15068,21170,0,0,2,0,2
44858,100,9784,14977,21170,0,0,1,0,1
44859,100,9785,14980;15000,21170,0,0,2,0,2
44860,100,9786,14707;15047,21170,0,0,2,0,2
44861,100,9787,15011;19665,21170,0,0,2,0,2
44862,100,9788,15026;15044,21170,0,0,2,0,2
44863,100,9789,15473;15636;19750;20128,21170,0,0,4,0,4
44864,100,9790,14594;14923,21170,0,0,1,1,2
44865,100,9791,14954;15066,21170,0,0,2,0,2
44866,100,9792,14382;14815,21170,0,0,1,1,2
44867,100,9793,14820;18448,21170,0,0,2,0,2
44868,100,9794,15081,21170,0,0,1,0,1
44869,100,9795,15192;15195;17686,21170,0,0,3,0,3
44870,100,9811,11258,21535,0,0,0,1,1
44871,100,9823,13319,21535,0,0,0,1,1
44872,100,9824,12824,21535,0,0,0,1,1
44873,100,9828,13197;13795,21535,0,0,0,2,2
44874,100,9829,13268;13756;17617,21535,0,0,1,2,3
44875,100,9830,12998;13382,21535,0,0,0,2,2
44876,100,9831,13530,21535,0,0,0,1,1
44877,100,9832,13609,21535,0,0,0,1,1
44878,100,9833,13828;13916,21535,0,0,0,2,2
44879,100,9836,13906;14211;18690,21535,0,0,1,2,3
44880,100,9837,13176;13711,21535,0,0,0,2,2
44881,100,9838,13526;13738,21535,0,0,0,2,2
44882,100,9841,13927;14200,21535,0,0,0,2,2
44883,100,9844,13775;13928,21535,0,0,0,2,2
44884,100,9845,14035;14219,21535,0,0,0,2,2
44885,100,9846,13865;14394,21535,0,0,0,2,2
44886,100,9847,14294;14587,21535,0,0,0,2,2
44887,100,9849,13982;14702,21535,0,0,1,1,2
44888,100,9851,13274;14054,21535,0,0,0,2,2
44889,100,9853,14679;14736;18487,21535,0,0,3,0,3
44890,100,9856,13623;13789,21535,0,0,0,2,2
44891,100,9857,14252,21535,0,0,0,1,1
44892,100,9858,14269;14272,21535,0,0,0,2,2
44893,100,9861,14041;14334,21535,0,0,0,2,2
44894,100,9863,14253;14354,21535,0,0,0,2,2
44895,100,9864,14369;14721,21535,0,0,1,1,2
44896,100,9865,14405,21535,0,0,0,1,1
44897,100,9866,14602,21535,0,0,0,1,1
44898,100,9867,14450,21535,0,0,0,1,1
44899,100,9868,19065,21535,0,0,1,0,1
44900,100,9869,14914;18681,21535,0,0,2,0,2
44901,100,9872,14261;14556,21535,0,0,0,2,2
44902,100,9873,14984,21535,0,0,1,0,1
44903,100,9874,15204;15647,21535,0,0,2,0,2
44904,100,9875,15245;18983,21535,0,0,2,0,2
44905,100,9876,14380;14796,21535,0,0,1,1,2
44906,100,9877,13844;14798,21535,0,0,1,1,2
44907,100,9878,14803;15071,21535,0,0,2,0,2
44908,100,9879,14882;15141,21535,0,0,2,0,2
44909,100,9880,14831;15171;19162,21535,0,0,3,0,3
44910,100,9881,14141;14879,21535,0,0,1,1,2
44911,100,9882,14920;15013,21535,0,0,2,0,2
44912,100,9883,15496;15506,21535,0,0,2,0,2
44913,100,9884,14972;15337,21535,0,0,2,0,2
44914,100,9885,14931;14985;19101,21535,0,0,3,0,3
44915,100,9886,14418;14987,21535,0,0,1,1,2
44916,100,9887,14997;15293,21535,0,0,2,0,2
44917,100,9888,15468;20310,21535,0,1,1,0,2
44918,100,9889,15046;15481;18902,21535,0,0,3,0,3
44919,100,9891,15075;15520,21535,0,0,2,0,2
44920,100,9892,14448;14599;17828,21535,0,0,1,2,3
44921,100,9893,15209;15366,21535,0,0,2,0,2
44922,100,9894,15103;15435,21535,0,0,2,0,2
44923,100,9895,14544;15113,21535,0,0,1,1,2
44924,100,9896,15125;15785;18883;19243;22250,21535,1,0,4,0,5
44925,100,9898,14729;15133,21535,0,0,2,0,2
44926,100,9901,15052;15144;19279,21535,0,0,3,0,3
44927,100,9902,14991;15001;19058,21535,0,0,3,0,3
44928,100,9904,14973;15202,21535,0,0,2,0,2
44929,100,9913,10892,21900,0,0,0,1,1
44930,100,9915,11695,21900,0,0,0,1,1
44931,100,9917,11668;11739,21900,0,0,0,2,2
44932,100,9918,11238,21900,0,0,0,1,1
44933,100,9927,12163;12636,21900,0,0,0,2,2
44934,100,9929,12758,21900,0,0,0,1,1
44935,100,9943,13114;13417,21900,0,0,0,2,2
44936,100,9945,13353;13812,21900,0,0,0,2,2
44937,100,9948,14049,21900,0,0,0,1,1
44938,100,9950,13425;13845,21900,0,0,0,2,2
44939,100,9955,13557;13887,21900,0,0,0,2,2
44940,100,9959,14342,21900,0,0,0,1,1
44941,100,9961,14234;18767,21900,0,0,1,1,2
44942,100,9962,14178,21900,0,0,0,1,1
44943,100,9963,15094;15379,21900,0,0,2,0,2
44944,100,9964,14239;14367;18754,21900,0,0,1,2,3
44945,100,9966,14355,21900,0,0,0,1,1
44946,100,9967,14379;14716,21900,0,0,1,1,2
44947,100,9968,14395,21900,0,0,0,1,1
44948,100,9971,14378;14495,21900,0,0,0,2,2
44949,100,9972,14525,21900,0,0,0,1,1
44950,100,9973,14393;14528;18905,21900,0,0,1,2,3
44951,100,9974,14555;14982,21900,0,0,1,1,2
44952,100,9975,15106,21900,0,0,1,0,1
44953,100,9976,14665,21900,0,0,1,0,1
44954,100,9978,14598;14870,21900,0,0,1,1,2
44955,100,9979,14662;15007;18651;19265;19444,21900,0,0,5,0,5
44956,100,9980,14173;14690;18872,21900,0,0,2,1,3
44957,100,9982,14762,21900,0,0,1,0,1
44958,100,9983,14515;15320;19711;19952,21900,0,0,3,1,4
44959,100,9984,14561;14845;18267,21900,0,0,2,1,3
44960,100,9985,15380;15466;20327,21900,0,1,2,0,3
44961,100,9986,14506;14903,21900,0,0,1,1,2
44962,100,9987,15462;15474;19806,21900,0,0,3,0,3
44963,100,9988,14905;15253,21900,0,0,2,0,2
44964,100,9990,14919;15032;19415,21900,0,0,3,0,3
44965,100,9993,14933;19362,21900,0,0,2,0,2
44966,100,9994,14975,21900,0,0,1,0,1
44967,100,9995,14978;15186,21900,0,0,2,0,2
44968,100,9996,14992;15134;19590,21900,0,0,3,0,3
44969,100,9998,15605,21900,0,0,1,0,1
44970,100,9999,15024;15244,21900,0,0,2,0,2
44971,100,10001,15688;15890;20102,21900,0,0,3,0,3
44972,100,10002,14720;15116;19284,21900,0,0,3,0,3
44973,100,10003,15128;19148;19530,21900,0,0,3,0,3
44974,100,10004,15110;15709,21900,0,0,2,0,2
44975,100,10007,15808,21900,0,0,1,0,1
44976,100,10008,15162,21900,0,0,1,0,1
44977,100,10009,15149;15408,21900,0,0,2,0,2
44978,100,10010,15055;15181,21900,0,0,2,0,2
44979,100,10011,17932,21900,0,0,1,0,1
44980,100,10012,15016;15217,21900,0,0,2,0,2
44981,100,10013,15220,21900,0,0,1,0,1
44982,100,10014,15261;18090,21900,0,0,2,0,2
44983,100,10017,15577;15719;19822,21900,0,0,3,0,3
44984,100,10018,15358;15377,21900,0,0,2,0,2
44985,100,10019,15359;15512;19547,21900,0,0,3,0,3
44986,100,10020,14438;15361;19766,21900,0,0,2,1,3
44987,100,10021,14608;15368;19542,21900,0,0,2,1,3
44988,100,10023,15516;19437,21900,0,0,2,0,2
44989,100,10024,15396;15451,21900,0,0,2,0,2
44990,100,10031,10915,22265,0,0,0,1,1
44991,100,10038,11564,22265,0,0,0,1,1
44992,100,10040,12021;12148,22265,0,0,0,2,2
44993,100,10043,12923,22265,0,0,0,1,1
44994,100,10044,12872,22265,0,0,0,1,1
44995,100,10045,12616;12860,22265,0,0,0,2,2
44996,100,10049,13780;13857,22265,0,0,0,2,2
44997,100,10053,13355;13953;18456,22265,0,0,1,2,3
44998,100,10055,13550;14235,22265,0,0,0,2,2
44999,100,10056,13509;13995,22265,0,0,0,2,2
45000,100,10058,13842;14273,22265,0,0,0,2,2
45001,100,10059,13464;13843,22265,0,0,0,2,2
45002,100,10060,13881;14020,22265,0,0,0,2,2
45003,100,10061,14228,22265,0,0,0,1,1
45004,100,10062,14018,22265,0,0,0,1,1
45005,100,10063,14066;14094;18424,22265,0,0,1,2,3
45006,100,10064,14761,22265,0,0,1,0,1
45007,100,10065,13822;13974,22265,0,0,0,2,2
45008,100,10066,14540;15394,22265,0,0,1,1,2
45009,100,10067,13595;14109,22265,0,0,0,2,2
45010,100,10068,14023;14246,22265,0,0,0,2,2
45011,100,10070,14583,22265,0,0,0,1,1
45012,100,10071,14588;15206,22265,0,0,1,1,2
45013,100,10072,14909,22265,0,0,1,0,1
45014,100,10073,14770;15056,22265,0,0,2,0,2
45015,100,10074,14329;14431;18536,22265,0,0,1,2,3
45016,100,10076,14262;14841,22265,0,0,1,1,2
45017,100,10077,15098;15325,22265,0,0,2,0,2
45018,100,10078,14553;14653,22265,0,0,0,2,2
45019,100,10080,14493;14616,22265,0,0,0,2,2
45020,100,10081,15033;18880,22265,0,0,2,0,2
45021,100,10082,14663;15650,22265,0,0,2,0,2
45022,100,10083,14699;15189,22265,0,0,2,0,2
45023,100,10084,14890;14970,22265,0,0,2,0,2
45024,100,10085,14214;14731,22265,0,0,1,1,2
45025,100,10086,14752;15422;20089,22265,0,0,3,0,3
45026,100,10087,14757,22265,0,0,1,0,1
45027,100,10088,14258;14422,22265,0,0,0,2,2
45028,100,10089,15250;15525,22265,0,0,2,0,2
45029,100,10090,14691;15247,22265,0,0,2,0,2
45030,100,10094,14888;15179,22265,0,0,2,0,2
45031,100,10095,14816;14907,22265,0,0,2,0,2
45032,100,10096,15413;15681,22265,0,0,2,0,2
45033,100,10097,14963,22265,0,0,1,0,1
45034,100,10099,14574,22265,0,0,0,1,1
45035,100,10101,15019;15029,22265,0,0,2,0,2
45036,100,10102,15131,22265,0,0,1,0,1
45037,100,10104,15012;15285,22265,0,0,2,0,2
45038,100,10107,15095;19678,22265,0,0,2,0,2
45039,100,10108,15182,22265,0,0,1,0,1
45040,100,10109,15188;15395,22265,0,0,2,0,2
45041,100,10110,15557,22265,0,0,1,0,1
45042,100,10111,15200;16031;19182;20135,22265,0,0,4,0,4
45043,100,10112,15203,22265,0,0,1,0,1
45044,100,10113,14191;15207,22265,0,0,1,1,2
45045,100,10114,15504;15806;19045,22265,0,0,3,0,3
45046,100,10115,15228;15628,22265,0,0,2,0,2
45047,100,10116,15229;15495,22265,0,0,2,0,2
45048,100,10117,14940;15230;18926,22265,0,0,3,0,3
45049,100,10118,14836;15237;19941,22265,0,0,3,0,3
45050,100,10119,15239;15410;19558,22265,0,0,3,0,3
45051,100,10121,15687;15884;19263,22265,0,0,3,0,3
45052,100,10122,15278;15826;20375,22265,0,1,2,0,3
45053,100,10123,15279;15751;19451,22265,0,0,3,0,3
45054,100,10124,15282;15682,22265,0,0,2,0,2
45055,100,10125,15457;19657,22265,0,0,2,0,2
45056,100,10126,15698;15819;20302,22265,0,1,2,0,3
45057,100,10127,15299;19064,22265,0,0,2,0,2
45058,100,10128,15255;15327;19647,22265,0,0,3,0,3
45059,100,10130,15146;15347,22265,0,0,2,0,2
45060,100,10131,15351;15613;17907;19692,22265,0,0,4,0,4
45061,100,10133,15609;15641,22265,0,0,2,0,2
45062,100,10134,15407;15455;19369;20482,22265,0,1,3,0,4
45063,100,10135,15401;15934;18463,22265,0,0,3,0,3
45064,100,10136,15414;15769,22265,0,0,2,0,2
45065,100,10137,15437;15598;19250;20606,22265,0,1,3,0,4
45066,100,10138,15447;15938,22265,0,0,2,0,2
45067,100,10139,15454;20051,22265,0,0,2,0,2
45068,100,10142,15482,22265,0,0,1,0,1
45069,100,10143,15430;15498;18782;18892,22265,0,0,4,0,4
45070,100,10144,15556;19103,22265,0,0,2,0,2
45071,100,10145,15509;15657,22265,0,0,2,0,2
45072,100,10146,15416;19804,22265,0,0,2,0,2
45073,100,10156,11305,22630,0,0,0,1,1
45074,100,10158,11150,22630,0,0,0,1,1
45075,100,10175,12866;12871,22630,0,0,0,2,2
45076,100,10178,13140,22630,0,0,0,1,1
45077,100,10183,12782;13020,22630,0,0,0,2,2
45078,100,10187,13579;13731,22630,0,0,0,2,2
45079,100,10188,13458;13769,22630,0,0,0,2,2
45080,100,10192,13997,22630,0,0,0,1,1
45081,100,10193,13959;14452,22630,0,0,0,2,2
45082,100,10196,15259,22630,0,0,1,0,1
45083,100,10197,14558;14763,22630,0,0,1,1,2
45084,100,10199,14187,22630,0,0,0,1,1
45085,100,10200,14223;14479,22630,0,0,0,2,2
45086,100,10201,13835;14491,22630,0,0,0,2,2
45087,100,10203,14569;14859,22630,0,0,1,1,2
45088,100,10205,13960;14554;19014,22630,0,0,1,2,3
45089,100,10207,15061,22630,0,0,1,0,1
45090,100,10208,13903;14628,22630,0,0,0,2,2
45091,100,10209,14697;14840,22630,0,0,2,0,2
45092,100,10210,14449;14650,22630,0,0,0,2,2
45093,100,10211,14629;14952;17886,22630,0,0,2,1,3
45094,100,10212,14024;14659,22630,0,0,1,1,2
45095,100,10213,14681;15444,22630,0,0,2,0,2
45096,100,10215,14710;15465;19460,22630,0,0,3,0,3
45097,100,10216,14726,22630,0,0,1,0,1
45098,100,10218,15101;19023,22630,0,0,2,0,2
45099,100,10219,14876,22630,0,0,1,0,1
45100,100,10220,13849,22630,0,0,0,1,1
45101,100,10221,15302;15779;19849,22630,0,0,3,0,3
45102,100,10223,14562;14833,22630,0,0,1,1,2
45103,100,10224,15623,22630,0,0,1,0,1
45104,100,10226,14948;15031;19677,22630,0,0,3,0,3
45105,100,10227,15008;15460,22630,0,0,2,0,2
45106,100,10228,14812;15458;20285,22630,0,1,2,0,3
45107,100,10229,15058;15544,22630,0,0,2,0,2
45108,100,10232,14937;15180,22630,0,0,2,0,2
45109,100,10233,15201;15214,22630,0,0,2,0,2
45110,100,10234,14928;15213,22630,0,0,2,0,2
45111,100,10235,15300;15607,22630,0,0,2,0,2
45112,100,10236,15317;15517;19339,22630,0,0,3,0,3
45113,100,10237,14787;15319,22630,0,0,2,0,2
45114,100,10239,15329;18321,22630,0,0,2,0,2
45115,100,10240,15902;20298,22630,0,1,1,0,2
45116,100,10241,15067;15384,22630,0,0,2,0,2
45117,100,10242,15406;19364;19661,22630,0,0,3,0,3
45118,100,10243,15423,22630,0,0,1,0,1
45119,100,10244,15308;15448,22630,0,0,2,0,2
45120,100,10245,14967;15453,22630,0,0,2,0,2
45121,100,10246,15537;15713,22630,0,0,2,0,2
45122,100,10247,15463;15790;19184;19787,22630,0,0,4,0,4
45123,100,10249,15497;18204,22630,0,0,2,0,2
45124,100,10251,15538;15678,22630,0,0,2,0,2
45125,100,10252,15554;15935;20072,22630,0,0,3,0,3
45126,100,10255,15433;15569;18813;19054,22630,0,0,4,0,4
45127,100,10256,15488,22630,0,0,1,0,1
45128,100,10266,11078,22995,0,0,0,1,1
45129,100,10276,11591;11862,22995,0,0,0,2,2
45130,100,10288,12012,22995,0,0,0,1,1
45131,100,10297,13630,22995,0,0,0,1,1
45132,100,10303,14046,22995,0,0,0,1,1
45133,100,10307,14199;14242,22995,0,0,0,2,2
45134,100,10310,14337;18581,22995,0,0,1,1,2
45135,100,10311,14032;14767;18768,22995,0,0,2,1,3
45136,100,10313,14911;15042;18311;18864,22995,0,0,4,0,4
45137,100,10314,14846;15043,22995,0,0,2,0,2
45138,100,10315,14288;14429,22995,0,0,0,2,2
45139,100,10317,14409,22995,0,0,0,1,1
45140,100,10318,13943;14632,22995,0,0,0,2,2
45141,100,10319,14637,22995,0,0,0,1,1
45142,100,10320,14108;14638;19149,22995,0,0,1,2,3
45143,100,10321,15374;15507,22995,0,0,2,0,2
45144,100,10322,13886;14375,22995,0,0,0,2,2
45145,100,10323,14415;14772,22995,0,0,1,1,2
45146,100,10324,18397,22995,0,0,1,0,1
45147,100,10325,14611;14961;18639,22995,0,0,2,1,3
45148,100,10326,15536;15754;19439;19526,22995,0,0,4,0,4
45149,100,10327,14842;15321,22995,0,0,2,0,2
45150,100,10328,15057;15548,22995,0,0,2,0,2
45151,100,10329,15649;15734;19453;20273,22995,0,1,3,0,4
45152,100,10330,14753;14867,22995,0,0,2,0,2
45153,100,10331,15196;15579,22995,0,0,2,0,2
45154,100,10332,15212,22995,0,0,1,0,1
45155,100,10333,15160;15223,22995,0,0,2,0,2
45156,100,10334,15340,22995,0,0,1,0,1
45157,100,10335,15576;15895,22995,0,0,2,0,2
45158,100,10336,15104;15281,22995,0,0,2,0,2
45159,100,10337,15322,22995,0,0,1,0,1
45160,100,10338,15333;19630,22995,0,0,2,0,2
45161,100,10339,15090;15918;19237;20220,22995,0,0,4,0,4
45162,100,10340,15356;15515,22995,0,0,2,0,2
45163,100,10341,15363;19190,22995,0,0,2,0,2
45164,100,10342,15689;15944;19402;19620,22995,0,0,4,0,4
45165,100,10343,15491;15887;19363;19562,22995,0,0,4,0,4
45166,100,10344,14714;15494,22995,0,0,2,0,2
45167,100,10345,15842,22995,0,0,1,0,1
45168,100,10347,15199;15707,22995,0,0,2,0,2
45169,100,10348,15533;15829,22995,0,0,2,0,2
45170,100,10349,15638;15967,22995,0,0,2,0,2
45171,100,10350,15392;15541;19143,22995,0,0,3,0,3
45172,100,10351,15549;19333;20056,22995,0,0,3,0,3
45173,100,10352,15562;15964,22995,0,0,2,0,2
45174,100,10353,15267;15575;19528,22995,0,0,3,0,3
45175,100,10354,15310;15588,22995,0,0,2,0,2
45176,100,10355,15611;15889,22995,0,0,2,0,2
45177,100,10356,15626;18064,22995,0,0,2,0,2
45178,100,10357,15545;15629,22995,0,0,2,0,2
45179,100,10358,15645,22995,0,0,1,0,1
45180,100,10359,15621;16155;20560,22995,0,1,2,0,3
45181,100,10360,15530;16029,22995,0,0,2,0,2
45182,100,10361,15441;15676;18666;19416,22995,0,0,4,0,4
45183,100,10362,16179;19908,22995,0,0,2,0,2
45184,100,10363,15263;15973,22995,0,0,2,0,2
45185,100,10364,15949;16020;18663,22995,0,0,3,0,3
45186,100,10365,15959;19329,22995,0,0,2,0,2
45187,100,10366,16076;20137;20898,22995,0,1,2,0,3
45188,100,10367,15758;16047;18187;19782;19978,22995,0,0,5,0,5
45189,100,10368,15564;15761;20262,22995,0,1,2,0,3
45190,100,10369,15766;16041,22995,0,0,2,0,2
45191,100,10371,14995;15782,22995,0,0,2,0,2
45192,100,10372,15122;15786;18970,22995,0,0,3,0,3
45193,100,10373,15794,22995,0,0,1,0,1
45194,100,10374,14791;15527,22995,0,0,2,0,2
45195,100,10379,11120,23360,0,0,0,1,1
45196,100,10383,11308,23360,0,0,0,1,1
45197,100,10384,11351,23360,0,0,0,1,1
45198,100,10389,10948,23360,0,0,0,1,1
45199,100,10392,11611,23360,0,0,0,1,1
45200,100,10397,12227,23360,0,0,0,1,1
45201,100,10403,12395,23360,0,0,0,1,1
45202,100,10406,13029;13527,23360,0,0,0,2,2
45203,100,10408,13111,23360,0,0,0,1,1
45204,100,10410,13360;13751,23360,0,0,0,2,2
45205,100,10412,13505;13692,23360,0,0,0,2,2
45206,100,10418,14617;19428,23360,0,0,1,1,2
45207,100,10420,14809,23360,0,0,1,0,1
45208,100,10421,14147;14336,23360,0,0,0,2,2
45209,100,10423,18946;18949,23360,0,0,2,0,2
45210,100,10424,14523,23360,0,0,0,1,1
45211,100,10428,14335;14543,23360,0,0,0,2,2
45212,100,10429,14510;14541,23360,0,0,0,2,2
45213,100,10430,14810;15060,23360,0,0,2,0,2
45214,100,10431,14780,23360,0,0,1,0,1
45215,100,10432,14304;14921,23360,0,0,1,1,2
45216,100,10433,14682,23360,0,0,1,0,1
45217,100,10434,14794,23360,0,0,1,0,1
45218,100,10435,14892;15294;19486,23360,0,0,3,0,3
45219,100,10437,14962;15021,23360,0,0,2,0,2
45220,100,10439,15365;15476;18632;19200,23360,0,0,4,0,4
45221,100,10440,15921;15958,23360,0,0,2,0,2
45222,100,10441,15065;15421;20017,23360,0,0,3,0,3
45223,100,10442,14647;15112;19009;20045,23360,0,0,3,1,4
45224,100,10443,15147;15403;18422;19740,23360,0,0,4,0,4
45225,100,10444,15082;15119,23360,0,0,2,0,2
45226,100,10445,15130;15632;20006,23360,0,0,3,0,3
45227,100,10446,15309;15633,23360,0,0,2,0,2
45228,100,10447,15634;15901;19240,23360,0,0,3,0,3
45229,100,10448,14929;15151;18799,23360,0,0,3,0,3
45230,100,10450,14981;15175;18990,23360,0,0,3,0,3
45231,100,10451,14885;15211;19775,23360,0,0,3,0,3
45232,100,10452,15219;15822;19203,23360,0,0,3,0,3
45233,100,10453,15443,23360,0,0,1,0,1
45234,100,10454,15919,23360,0,0,1,0,1
45235,100,10455,15014;15335;18630,23360,0,0,3,0,3
45236,100,10457,15863,23360,0,0,1,0,1
45237,100,10458,16008;16009;19736,23360,0,0,3,0,3
45238,100,10459,15701,23360,0,0,1,0,1
45239,100,10460,14974;15439,23360,0,0,2,0,2
45240,100,10461,15177;15440,23360,0,0,2,0,2
45241,100,10462,14935;15750;19758,23360,0,0,3,0,3
45242,100,10463,15521;15936,23360,0,0,2,0,2
45243,100,10464,14603;15566;19319,23360,0,0,2,1,3
45244,100,10465,15979;19864,23360,0,0,2,0,2
45245,100,10466,15543;15580;18827,23360,0,0,3,0,3
45246,100,10467,15519;15583,23360,0,0,2,0,2
45247,100,10468,15589;15939;19222;19728,23360,0,0,4,0,4
45248,100,10469,15593;16043;19860,23360,0,0,3,0,3
45249,100,10470,15606;19847;20286,23360,0,1,2,0,3
45250,100,10472,15692;15841;19538;19718,23360,0,0,4,0,4
45251,100,10473,16288,23360,0,0,1,0,1
45252,100,10474,15697;16026;20014;20621,23360,0,1,3,0,4
45253,100,10475,15658;15912,23360,0,0,2,0,2
45254,100,10476,15360;16053;20245;20513,23360,0,1,3,0,4
45255,100,10477,15675,23360,0,0,1,0,1
45256,100,10478,15513;15686,23360,0,0,2,0,2
45257,100,10479,15006;15718,23360,0,0,2,0,2
45258,100,10480,16134;16143;20221,23360,0,0,3,0,3
45259,100,10482,15738,23360,0,0,1,0,1
45260,100,10483,15743;16057;19062,23360,0,0,3,0,3
45261,100,10484,15534,23360,0,0,1,0,1
45262,100,10485,15484;15784,23360,0,0,2,0,2
45263,100,10486,15984;19593,23360,0,0,2,0,2
45264,100,10487,15848;16203;19394,23360,0,0,3,0,3
45265,100,10488,15839;15968;20986,23360,0,1,2,0,3
45266,100,10489,15570;16223;19386,23360,0,0,3,0,3
45267,100,10490,15875;15879,23360,0,0,2,0,2
45268,100,10491,15850;16005,23360,0,0,2,0,2
45269,100,10492,16168;20026,23360,0,0,2,0,2
45270,100,10493,15876;20032;20167,23360,0,0,3,0,3
45271,100,10494,15685;16125,23360,0,0,2,0,2
45272,100,10495,15735,23360,0,0,1,0,1
45273,100,10496,15765;15925;19228;20484,23360,0,1,3,0,4
45274,100,10504,11467,23725,0,0,0,1,1
45275,100,10519,13069,23725,0,0,0,1,1
45276,100,10520,12703,23725,0,0,0,1,1
45277,100,10531,13649;13869,23725,0,0,0,2,2
45278,100,10534,13745;14350,23725,0,0,0,2,2
45279,100,10536,14645,23725,0,0,0,1,1
45280,100,10541,14257;14388,23725,0,0,0,2,2
45281,100,10543,14484,23725,0,0,0,1,1
45282,100,10544,14666;15290,23725,0,0,2,0,2
45283,100,10546,14750,23725,0,0,1,0,1
45284,100,10548,14625;14667;19170,23725,0,0,2,1,3
45285,100,10549,14814;14999,23725,0,0,2,0,2
45286,100,10550,14899;15573,23725,0,0,2,0,2
45287,100,10551,15312;15757;19166,23725,0,0,3,0,3
45288,100,10552,14955;15464,23725,0,0,2,0,2
45289,100,10556,14620;15148;19110;19716,23725,0,0,3,1,4
45290,100,10557,15238;16201,23725,0,0,2,0,2
45291,100,10558,15236,23725,0,0,1,0,1
45292,100,10559,14959;15604,23725,0,0,2,0,2
45293,100,10564,15417;16070;18945,23725,0,0,3,0,3
45294,100,10565,15797,23725,0,0,1,0,1
45295,100,10566,16293;16371;20446,23725,0,1,2,0,3
45296,100,10567,15726;16055;19879,23725,0,0,3,0,3
45297,100,10568,15434;18874,23725,0,0,2,0,2
45298,100,10570,16314;18688;20300,23725,0,1,2,0,3
45299,100,10571,16114;20530;21029,23725,0,2,1,0,3
45300,100,10572,15584,23725,0,0,1,0,1
45301,100,10573,15591;19113,23725,0,0,2,0,2
45302,100,10574,15499;15666;19660;20517,23725,0,1,3,0,4
45303,100,10575,16003;16283;19342;19907;22263,23725,1,0,4,0,5
45304,100,10576,15710,23725,0,0,1,0,1
45305,100,10577,15503;16131;20228,23725,0,0,3,0,3
45306,100,10578,15853;16092;19797;20775,23725,0,1,3,0,4
45307,100,10581,15438;15900;19075,23725,0,0,3,0,3
45308,100,10582,15561;15903;19165,23725,0,0,3,0,3
45309,100,10583,18409;18559;18869;21793;21939,23725,2,0,3,0,5
45310,100,10584,15486;16163;20002;20168,23725,0,0,4,0,4
45311,100,10585,15976;20353,23725,0,1,1,0,2
45312,100,10586,15978;16229;19988,23725,0,0,3,0,3
45313,100,10587,16006;16159;19005;19344;20923,23725,0,1,4,0,5
45314,100,10588,15156;16042;18820;20096;22271,23725,1,0,4,0,5
45315,100,10589,15805;18826,23725,0,0,2,0,2
45316,100,10601,11641,24090,0,0,0,1,1
45317,100,10621,12952,24090,0,0,0,1,1
45318,100,10629,12995;13798,24090,0,0,0,2,2
45319,100,10638,13778;14386,24090,0,0,0,2,2
45320,100,10640,14295,24090,0,0,0,1,1
45321,100,10642,14176;14739,24090,0,0,1,1,2
45322,100,10645,14563;14797,24090,0,0,1,1,2
45323,100,10647,14742,24090,0,0,1,0,1
45324,100,10648,14774;14834,24090,0,0,2,0,2
45325,100,10649,14357;14864,24090,0,0,1,1,2
45326,100,10650,15274,24090,0,0,1,0,1
45327,100,10651,14960;15036,24090,0,0,2,0,2
45328,100,10653,14744;14966,24090,0,0,2,0,2
45329,100,10655,15117;15143,24090,0,0,2,0,2
45330,100,10656,15631;15721;18798;19601,24090,0,0,4,0,4
45331,100,10657,15163,24090,0,0,1,0,1
45332,100,10659,15208;18984,24090,0,0,2,0,2
45333,100,10661,15231;15502,24090,0,0,2,0,2
45334,100,10662,14893;15233,24090,0,0,2,0,2
45335,100,10663,15585;16065;20043,24090,0,0,3,0,3
45336,100,10664,15251;15639;19586,24090,0,0,3,0,3
45337,100,10665,15620;18855;20038,24090,0,0,3,0,3
45338,100,10666,15362;15892,24090,0,0,2,0,2
45339,100,10667,14826;15316,24090,0,0,2,0,2
45340,100,10668,15827;16270;19857,24090,0,0,3,0,3
45341,100,10669,15724;16325;20140;22274,24090,1,0,3,0,4
45342,100,10670,15303;15810;18620,24090,0,0,3,0,3
45343,100,10671,15961,24090,0,0,1,0,1
45344,100,10672,16045;20132,24090,0,0,2,0,2
45345,100,10673,15565;15730;19300,24090,0,0,3,0,3
45346,100,10675,14994;15614,24090,0,0,2,0,2
45347,100,10676,15166;15616,24090,0,0,2,0,2
45348,100,10677,15627;16004;20062;22270,24090,1,0,3,0,4
45349,100,10678,15644;15764;19937,24090,0,0,3,0,3
45350,100,10679,15646;16183;19480;19965,24090,0,0,4,0,4
45351,100,10680,15652;16128;19301;19994,24090,0,0,4,0,4
45352,100,10681,15661;16232;19790;20464,24090,0,1,3,0,4
45353,100,10682,15733;15854,24090,0,0,2,0,2
45354,100,10683,15729;15999,24090,0,0,2,0,2
45355,100,10684,15559;15771,24090,0,0,2,0,2
45356,100,10685,14856;15817,24090,0,0,2,0,2
45357,100,10686,15789;15970;19616;19823,24090,0,0,4,0,4
45358,100,10687,16028;19297,24090,0,0,2,0,2
45359,100,10688,15927;16071,24090,0,0,2,0,2
45360,100,10689,15532;15831;19441,24090,0,0,3,0,3
45361,100,10690,15856;16171;20573;20745,24090,0,2,2,0,4
45362,100,10691,15736;16021;20040,24090,0,0,3,0,3
45363,100,10692,16081;16226;20424,24090,0,1,2,0,3
45364,100,10694,15352;16186,24090,0,0,2,0,2
45365,100,10695,16017;16278;19607;20255,24090,0,0,4,0,4
45366,100,10696,15997;19310;20009,24090,0,0,3,0,3
45367,100,10697,15796;16405;18516,24090,0,0,3,0,3
45368,100,10698,15940;16471;18811;19995,24090,0,0,4,0,4
45369,100,10699,16147;16176;20019;20189;21001,24090,0,1,4,0,5
45370,100,10700,16022,24090,0,0,1,0,1
45371,100,10701,15198;16023;19462,24090,0,0,3,0,3
45372,100,10702,15459;16030,24090,0,0,2,0,2
45373,100,10703,15704;16236;19648,24090,0,0,3,0,3
45374,100,10704,15690;16227;19572;19795,24090,0,0,4,0,4
45375,100,10705,16438;19534;20086,24090,0,0,3,0,3
45376,100,10706,16050;16195;19723,24090,0,0,3,0,3
45377,100,10707,16087;19189;20046,24090,0,0,3,0,3
45378,100,10708,16105;16309;19473;20169,24090,0,0,4,0,4
45379,100,10709,16479;18318;18731;21497,24090,0,1,3,0,4
45380,100,10710,16122;16265;18661,24090,0,0,3,0,3
45381,100,10711,16140;20121;20756,24090,0,1,2,0,3
45382,100,10712,16440;19861,24090,0,0,2,0,2
45383,100,10719,11588,24455,0,0,0,1,1
45384,100,10724,12226,24455,0,0,0,1,1
45385,100,10726,12153;12338,24455,0,0,0,2,2
45386,100,10727,12578;12659,24455,0,0,0,2,2
45387,100,10728,13026;13086,24455,0,0,0,2,2
45388,100,10734,13744,24455,0,0,0,1,1
45389,100,10736,14339,24455,0,0,0,1,1
45390,100,10739,14436,24455,0,0,0,1,1
45391,100,10745,14537;14546,24455,0,0,0,2,2
45392,100,10749,15102;15326,24455,0,0,2,0,2
45393,100,10750,14806,24455,0,0,1,0,1
45394,100,10752,14913;15015,24455,0,0,2,0,2
45395,100,10754,15567;15708,24455,0,0,2,0,2
45396,100,10755,15158,24455,0,0,1,0,1
45397,100,10756,15193;15642,24455,0,0,2,0,2
45398,100,10758,15105;15425,24455,0,0,2,0,2
45399,100,10760,15886;19829;20104,24455,0,0,3,0,3
45400,100,10761,15467;18844,24455,0,0,2,0,2
45401,100,10762,15080;15273,24455,0,0,2,0,2
45402,100,10763,14896;15292;18732,24455,0,0,3,0,3
45403,100,10764,15087;15581;19841,24455,0,0,3,0,3
45404,100,10765,15398,24455,0,0,1,0,1
45405,100,10766,15041;15419;19375,24455,0,0,3,0,3
45406,100,10767,15270;15930;18419;18822;19135;19370;19977,24455,0,0,7,0,7
45407,100,10768,15624;15915;19003,24455,0,0,3,0,3
45408,100,10769,15097;15472;18668,24455,0,0,3,0,3
45409,100,10770,15673;15778,24455,0,0,2,0,2
45410,100,10771,15991;16118,24455,0,0,2,0,2
45411,100,10772,15553;19183,24455,0,0,2,0,2
45412,100,10773,16037;19783;20054,24455,0,0,3,0,3
45413,100,10774,15756;15931;19539;20063,24455,0,0,4,0,4
45414,100,10776,16193;16455;20070,24455,0,0,3,0,3
45415,100,10777,16199;16706;18899;19305,24455,0,0,4,0,4
45416,100,10778,15791;16097;19755;19848;20035,24455,0,0,5,0,5
45417,100,10779,15799;15838;19557;19985,24455,0,0,4,0,4
45418,100,10780,15241;16007;18993,24455,0,0,3,0,3
45419,100,10781,15107;15882;18879;19320;19456,24455,0,0,5,0,5
45420,100,10782,15028;15883,24455,0,0,2,0,2
45421,100,10783,15897;16160;20115,24455,0,0,3,0,3
45422,100,10784,15480;15928;19309,24455,0,0,3,0,3
45423,100,10785,15950;16101;19355;19886,24455,0,0,4,0,4
45424,100,10786,16579;20008;20975,24455,0,1,2,0,3
45425,100,10787,15987;16049,24455,0,0,2,0,2
45426,100,10788,15996;16313,24455,0,0,2,0,2
45427,100,10789,15922;16033;20020;20486;22269,24455,1,1,3,0,5
45428,100,10790,16200;16307,24455,0,0,2,0,2
45429,100,10791,15429;16069;19430,24455,0,0,3,0,3
45430,100,10792,16410;16637;18967;20323;20466,24455,0,2,3,0,5
45431,100,10793,16412;19663,24455,0,0,2,0,2
45432,100,10794,16164;16548;19919;20191,24455,0,0,4,0,4
45433,100,10795,16255;19697,24455,0,0,2,0,2
45434,100,10796,15717;16221;19306,24455,0,0,3,0,3
45435,100,10797,16225;16660,24455,0,0,2,0,2
45436,100,10798,16241;16281;18974,24455,0,0,3,0,3
45437,100,10799,16254;16643,24455,0,0,2,0,2
45438,100,10800,16272,24455,0,0,1,0,1
45439,100,10801,11066,24820,0,0,0,1,1
45440,100,10804,11425;11629,24820,0,0,0,2,2
45441,100,10814,12205;12236,24820,0,0,0,2,2
45442,100,10821,12717,24820,0,0,0,1,1
45443,100,10822,12756,24820,0,0,0,1,1
45444,100,10825,13044;13211,24820,0,0,0,2,2
45445,100,10828,13987,24820,0,0,0,1,1
45446,100,10835,14170;14325,24820,0,0,0,2,2
45447,100,10836,14182;14440,24820,0,0,0,2,2
45448,100,10838,15049,24820,0,0,1,0,1
45449,100,10840,14459,24820,0,0,0,1,1
45450,100,10841,14488;15307,24820,0,0,1,1,2
45451,100,10844,13962;14635,24820,0,0,0,2,2
45452,100,10845,14686;15586,24820,0,0,2,0,2
45453,100,10846,14692;15129,24820,0,0,2,0,2
45454,100,10847,13832;14410,24820,0,0,0,2,2
45455,100,10848,14446;15009;19348,24820,0,0,2,1,3
45456,100,10849,14732,24820,0,0,1,0,1
45457,100,10850,14593;14614;19821,24820,0,0,1,2,3
45458,100,10854,14581;14912;19191,24820,0,0,2,1,3
45459,100,10856,14738;15169,24820,0,0,2,0,2
45460,100,10858,14734;15184;18955,24820,0,0,3,0,3
45461,100,10859,15172;15258,24820,0,0,2,0,2
45462,100,10860,15615;15820;18912,24820,0,0,3,0,3
45463,100,10861,15469;16174;20116;20364,24820,0,1,3,0,4
45464,100,10862,14680,24820,0,0,1,0,1
45465,100,10863,14858;15343;20101,24820,0,0,3,0,3
45466,100,10865,15108;15388,24820,0,0,2,0,2
45467,100,10866,15353;15483;20282,24820,0,1,2,0,3
45468,100,10868,15660;15993,24820,0,0,2,0,2
45469,100,10869,15540;15834,24820,0,0,2,0,2
45470,100,10870,15266;15424;18898,24820,0,0,3,0,3
45471,100,10871,15696;15836;19122,24820,0,0,3,0,3
45472,100,10872,15983;16417,24820,0,0,2,0,2
45473,100,10874,16228;16370;19566,24820,0,0,3,0,3
45474,100,10875,15712;16095,24820,0,0,2,0,2
45475,100,10876,16386;18850,24820,0,0,2,0,2
45476,100,10877,15742,24820,0,0,1,0,1
45477,100,10878,16035;16107;20314,24820,0,1,2,0,3
45478,100,10879,15431;20060;20257,24820,0,0,3,0,3
45479,100,10880,15594;15807,24820,0,0,2,0,2
45480,100,10881,16244;16392;19291;20001;20358,24820,0,1,4,0,5
45481,100,10882,15837;15843;19271;19830,24820,0,0,4,0,4
45482,100,10883,15846;16126;20153;20392,24820,0,1,3,0,4
45483,100,10884,16063;16181;20777,24820,0,1,2,0,3
45484,100,10885,15165;15891;20087;20175,24820,0,0,4,0,4
45485,100,10886,15929;16106;19951,24820,0,0,3,0,3
45486,100,10887,15969,24820,0,0,1,0,1
45487,100,10889,15986;16248;19715;20379,24820,0,1,3,0,4
45488,100,10890,15990;16109,24820,0,0,2,0,2
45489,100,10891,16320;16511;20025;21159,24820,0,1,3,0,4
45490,100,10892,16012,24820,0,0,1,0,1
45491,100,10893,16286,24820,0,0,1,0,1
45492,100,10895,16117;16552;19188;19741,24820,0,0,4,0,4
45493,100,10896,15943;16145;19791;20540,24820,0,1,3,0,4
45494,100,10897,15824;16151,24820,0,0,2,0,2
45495,100,10898,16156;20126,24820,0,0,2,0,2
45496,100,10899,16066;16196;19029;19570;20400;22240,24820,1,1,4,0,6
45497,100,10900,16205;16754,24820,0,0,2,0,2
45498,100,10902,16277;16501;19118;21127,24820,0,1,3,0,4
45499,100,10903,15992;16243,24820,0,0,2,0,2
45500,100,10904,16142;16246,24820,0,0,2,0,2
45501,100,10905,16383;16494;20065,24820,0,0,3,0,3
45502,100,10906,16483;16836;20549,24820,0,1,2,0,3
45503,100,10907,16345;16454;20274,24820,0,1,2,0,3
45504,100,10908,16570;16880;18852,24820,0,0,3,0,3
45505,100,10909,16048;16369;19960;20339,24820,0,1,3,0,4
45506,100,10910,15857;16373;19686;20355,24820,0,1,3,0,4
45507,100,10912,16409;16535;21165,24820,0,1,2,0,3
45508,100,10913,16739;19588;19831,24820,0,0,3,0,3
45509,100,10914,16631;16771;19146;19401;19573,24820,0,0,5,0,5
45510,100,10915,15917;16467,24820,0,0,2,0,2
45511,100,10922,11621,25185,0,0,0,1,1
45512,100,10934,12890,25185,0,0,0,1,1
45513,100,10935,12984,25185,0,0,0,1,1
45514,100,10938,13133;13856,25185,0,0,0,2,2
45515,100,10942,13040,25185,0,0,0,1,1
45516,100,10950,14148;14627,25185,0,0,0,2,2
45517,100,10951,14209;14701,25185,0,0,1,1,2
45518,100,10952,14785;14946,25185,0,0,2,0,2
45519,100,10956,14713;14860;19346,25185,0,0,3,0,3
45520,100,10957,14572;14636,25185,0,0,0,2,2
45521,100,10962,14868;15040,25185,0,0,2,0,2
45522,100,10965,14925;15367,25185,0,0,2,0,2
45523,100,10966,14414;14677,25185,0,0,1,1,2
45524,100,10968,15139;15355,25185,0,0,2,0,2
45525,100,10970,15336,25185,0,0,1,0,1
45526,100,10971,15020;15344;19046;19174;22242,25185,1,0,4,0,5
45527,100,10973,15868,25185,0,0,1,0,1
45528,100,10974,15833;15870;20130,25185,0,0,3,0,3
45529,100,10975,15813;16185,25185,0,0,2,0,2
45530,100,10976,15563;16177;19347;19654,25185,0,0,4,0,4
45531,100,10977,16016;19584,25185,0,0,2,0,2
45532,100,10978,15722;16032;19816,25185,0,0,3,0,3
45533,100,10979,15618,25185,0,0,1,0,1
45534,100,10980,15648;15871;19793,25185,0,0,3,0,3
45535,100,10981,15560;15651;19426,25185,0,0,3,0,3
45536,100,10982,15662,25185,0,0,1,0,1
45537,100,10983,15714;16346,25185,0,0,2,0,2
45538,100,10984,15975;16216;19591,25185,0,0,3,0,3
45539,100,10985,15801;16013;19621,25185,0,0,3,0,3
45540,100,10986,15965;20718,25185,0,1,1,0,2
45541,100,10987,15865,25185,0,0,1,0,1
45542,100,10988,15947;19211,25185,0,0,2,0,2
45543,100,10989,15955;16531;18804;19532;20716,25185,0,1,4,0,5
45544,100,10990,14819;15045,25185,0,0,2,0,2
45545,100,10991,15610;16014;19819;20229,25185,0,0,4,0,4
45546,100,10992,15404;16136,25185,0,0,2,0,2
45547,100,10993,15674;15971,25185,0,0,2,0,2
45548,100,10994,16027,25185,0,0,1,0,1
45549,100,10995,15608;16059,25185,0,0,2,0,2
45550,100,10996,16068;16413,25185,0,0,2,0,2
45551,100,10997,16083;16692,25185,0,0,2,0,2
45552,100,10999,16091;16709,25185,0,0,2,0,2
45553,100,11000,15700;16093,25185,0,0,2,0,2
45554,100,11001,16110;19404,25185,0,0,2,0,2
45555,100,11002,15844;16251;20240,25185,0,0,3,0,3
45556,100,11004,15859;16627;20290,25185,0,1,2,0,3
45557,100,11006,16421;16498,25185,0,0,2,0,2
45558,100,11007,16240;16753;20010;20216,25185,0,0,4,0,4
45559,100,11008,16586,25185,0,0,1,0,1
45560,100,11009,15830;16245;20083,25185,0,0,3,0,3
45561,100,11010,15941;16263;19645,25185,0,0,3,0,3
45562,100,11011,16269;16796;19969,25185,0,0,3,0,3
45563,100,11012,16187;16298;19946,25185,0,0,3,0,3
45564,100,11013,16301,25185,0,0,1,0,1
45565,100,11014,16302;16772;20344;20640,25185,0,2,2,0,4
45566,100,11015,16318;16599,25185,0,0,2,0,2
45567,100,11016,16336;16559,25185,0,0,2,0,2
45568,100,11017,16340,25185,0,0,1,0,1
45569,100,11018,16349;16841;19245,25185,0,0,3,0,3
45570,100,11019,16384;16504;20011;20658,25185,0,1,3,0,4
45571,100,11020,16259;16422;19945;20212;20689,25185,0,1,4,0,5
45572,100,11021,16085;16485;19468;19629;19935;20910,25185,0,1,5,0,6
45573,100,11022,16115;16428;20233;20871,25185,0,1,3,0,4
45574,100,11023,16432;16536;19477;20391,25185,0,1,3,0,4
45575,100,11024,16010;16437;20337,25185,0,1,2,0,3
45576,100,11025,16560,25185,0,0,1,0,1
45577,100,11026,16377;19154;19925,25185,0,0,3,0,3
45578,100,11027,15818;16458;20485,25185,0,1,2,0,3
45579,100,11028,16480;16625,25185,0,0,2,0,2
45580,100,11029,16327;16803;20570;20796,25185,0,2,2,0,4
45581,100,11030,16493;18792;20013,25185,0,0,3,0,3
45582,100,11031,16519,25185,0,0,1,0,1
45583,100,11032,16549;20142,25185,0,0,2,0,2
45584,100,11033,16439;16553;19812,25185,0,0,3,0,3
45585,100,11035,11362,25550,0,0,0,1,1
45586,100,11036,11473,25550,0,0,0,1,1
45587,100,11041,11569;12093,25550,0,0,0,2,2
45588,100,11043,11775,25550,0,0,0,1,1
45589,100,11044,11964,25550,0,0,0,1,1
45590,100,11045,12455,25550,0,0,0,1,1
45591,100,11046,12038;12928,25550,0,0,0,2,2
45592,100,11049,11941;12493,25550,0,0,0,2,2
45593,100,11056,12642,25550,0,0,0,1,1
45594,100,11060,12793;13412,25550,0,0,0,2,2
45595,100,11068,13520,25550,0,0,0,1,1
45596,100,11070,13896,25550,0,0,0,1,1
45597,100,11077,13918,25550,0,0,0,1,1
45598,100,11082,14401,25550,0,0,0,1,1
45599,100,11085,13940;14172,25550,0,0,0,2,2
45600,100,11087,15728;15828,25550,0,0,2,0,2
45601,100,11091,14996;15405,25550,0,0,2,0,2
45602,100,11092,15010;15037,25550,0,0,2,0,2
45603,100,11093,14434;15069;19549,25550,0,0,2,1,3
45604,100,11094,14728;15114,25550,0,0,2,0,2
45605,100,11095,15136;15324,25550,0,0,2,0,2
45606,100,11096,15150;15183,25550,0,0,2,0,2
45607,100,11098,15232;15354,25550,0,0,2,0,2
45608,100,11099,15257,25550,0,0,1,0,1
45609,100,11101,15400;16150,25550,0,0,2,0,2
45610,100,11104,16002,25550,0,0,1,0,1
45611,100,11105,15018;15587;20177,25550,0,0,3,0,3
45612,100,11107,15723;15989,25550,0,0,2,0,2
45613,100,11108,16178,25550,0,0,1,0,1
45614,100,11109,16287;19579,25550,0,0,2,0,2
45615,100,11110,16108,25550,0,0,1,0,1
45616,100,11112,15977;15982;20335,25550,0,1,2,0,3
45617,100,11114,15746;16096;19373;20176,25550,0,0,4,0,4
45618,100,11116,15372;16474,25550,0,0,2,0,2
45619,100,11117,15988;16197;19545;19904,25550,0,0,4,0,4
45620,100,11119,16741;16805;20332;20876,25550,0,2,2,0,4
45621,100,11120,15740;16162,25550,0,0,2,0,2
45622,100,11121,16169;16461;19870;20244;20476,25550,0,1,4,0,5
45623,100,11123,16366;16652;19567,25550,0,0,3,0,3
45624,100,11124,15531;16204,25550,0,0,2,0,2
45625,100,11125,16619;19618;20058,25550,0,0,3,0,3
45626,100,11126,16129;16207;20403,25550,0,1,2,0,3
45627,100,11127,16234;16634,25550,0,0,2,0,2
45628,100,11128,15386;16170;19614;19962,25550,0,0,4,0,4
45629,100,11129,16252;17062;19820;20079,25550,0,0,4,0,4
45630,100,11130,16297;16610;18802,25550,0,0,3,0,3
45631,100,11132,16294;16518;18866,25550,0,0,3,0,3
45632,100,11133,16528;17063;20236;20495,25550,0,1,3,0,4
45633,100,11134,16683;19843;20491,25550,0,1,2,0,3
45634,100,11135,16337;19696;20362;20505,25550,0,2,2,0,4
45635,100,11136,15873;16339,25550,0,0,2,0,2
45636,100,11137,15851;16343;19958;20352,25550,0,1,3,0,4
45637,100,11139,16375;19033;19356,25550,0,0,3,0,3
45638,100,11140,16449;16644;19652;20246,25550,0,0,4,0,4
45639,100,11141,16822;19998;20213,25550,0,0,3,0,3
45640,100,11142,16456;16472;21115,25550,0,1,2,0,3
45641,100,11143,16512;16722;19455;19730,25550,0,0,4,0,4
45642,100,11144,16612;20847,25550,0,1,1,0,2
45643,100,11145,16537;16818;20730,25550,0,1,2,0,3
45644,100,11146,16888;16913;19971,25550,0,0,3,0,3
45645,100,11147,16424;16562;20501,25550,0,1,2,0,3
45646,100,11148,16576;16782;18753;19992;20340,25550,0,1,4,0,5
45647,100,11149,16584;20346,25550,0,1,1,0,2
45648,100,11150,16329;16603;20149,25550,0,0,3,0,3
45649,100,11151,16355;16931,25550,0,0,2,0,2
45650,100,11152,16616;19939;20129;20308,25550,0,1,3,0,4
45651,100,11153,16533;16936;20275;21122,25550,0,2,2,0,4
45652,100,11154,16389;16904,25550,0,0,2,0,2
45653,100,11155,16649;16791;19906;20055;20750,25550,0,1,4,0,5
45654,100,11156,16039;16650;19452;20471,25550,0,1,3,0,4
45655,100,11157,16317;16663;19134;19700;20693,25550,0,1,4,0,5
45656,100,11158,16673;17060;19563,25550,0,0,3,0,3
45657,100,11159,16253;16675,25550,0,0,2,0,2
45658,100,11162,11456,25915,0,0,0,1,1
45659,100,11164,11384,25915,0,0,0,1,1
45660,100,11167,11540,25915,0,0,0,1,1
45661,100,11172,12077,25915,0,0,0,1,1
45662,100,11174,12469;12602,25915,0,0,0,2,2
45663,100,11176,12576,25915,0,0,0,1,1
45664,100,11177,12063;12212,25915,0,0,0,2,2
45665,100,11180,12683;13046,25915,0,0,0,2,2
45666,100,11182,12767;12950,25915,0,0,0,2,2
45667,100,11188,13232,25915,0,0,0,1,1
45668,100,11199,13270;13379,25915,0,0,0,2,2
45669,100,11200,13872,25915,0,0,0,1,1
45670,100,11206,13650,25915,0,0,0,1,1
45671,100,11214,15073;15153;19127,25915,0,0,3,0,3
45672,100,11215,15168,25915,0,0,1,0,1
45673,100,11216,14828;14988,25915,0,0,2,0,2
45674,100,11220,14839;15280,25915,0,0,2,0,2
45675,100,11223,14471;14900,25915,0,0,1,1,2
45676,100,11224,15331;16139;19836;20161,25915,0,0,4,0,4
45677,100,11227,15436;19928,25915,0,0,2,0,2
45678,100,11228,15755;16154,25915,0,0,2,0,2
45679,100,11230,15643;16334;19551;19898;20222,25915,0,0,5,0,5
45680,100,11231,15375;15653,25915,0,0,2,0,2
45681,100,11232,15706;15951;19774;19901;20012,25915,0,0,5,0,5
45682,100,11233,15745;16175,25915,0,0,2,0,2
45683,100,11234,15881;16209;20436,25915,0,1,2,0,3
45684,100,11235,15966;16284;19446,25915,0,0,3,0,3
45685,100,11236,16690;20351,25915,0,1,1,0,2
45686,100,11237,16380;20266;20684,25915,0,2,1,0,3
45687,100,11238,16103;16497;19777;20145;20261;20524,25915,0,2,4,0,6
45688,100,11239,15945;16214;19899,25915,0,0,3,0,3
45689,100,11240,16144;16443,25915,0,0,2,0,2
45690,100,11241,16157;16441,25915,0,0,2,0,2
45691,100,11242,16575;20156,25915,0,0,2,0,2
45692,100,11243,15753;16210,25915,0,0,2,0,2
45693,100,11244,16280;16554,25915,0,0,2,0,2
45694,100,11245,16273;16406,25915,0,0,2,0,2
45695,100,11246,16299;16571;19673;20589,25915,0,1,3,0,4
45696,100,11247,16618;16779;20637;21047,25915,0,2,2,0,4
45697,100,11248,16296;16310;19742;19809,25915,0,0,4,0,4
45698,100,11249,16561;16947;20790;20965,25915,0,2,2,0,4
45699,100,11250,16365;19805;20904,25915,0,1,2,0,3
45700,100,11251,15880;16442,25915,0,0,2,0,2
45701,100,11252,16072;16705;20317,25915,0,1,2,0,3
45702,100,11253,15906;16433,25915,0,0,2,0,2
45703,100,11255,16469;16768;18897;20380,25915,0,1,3,0,4
45704,100,11256,16486;20021,25915,0,0,2,0,2
45705,100,11257,16798;17009;19636;20179;20347,25915,0,1,4,0,5
45706,100,11258,16544;16941;20409;20711,25915,0,2,2,0,4
45707,100,11259,16826;19372;22255,25915,1,0,2,0,3
45708,100,11260,16462;20324;20788;20914,25915,0,3,1,0,4
45709,100,11261,16508;16555;18972;19875,25915,0,0,4,0,4
45710,100,11262,16984;20659;20928,25915,0,2,1,0,3
45711,100,11263,16425;16564;19765;21383,25915,0,1,3,0,4
45712,100,11264,16262;16609;20211;20604,25915,0,1,3,0,4
45713,100,11265,16617;19622,25915,0,0,2,0,2
45714,100,11266,16832;17103;20405;21520,25915,0,2,2,0,4
45715,100,11267,16646;16785;20067,25915,0,0,3,0,3
45716,100,11268,16651;20597;20778;20984,25915,0,3,1,0,4
45717,100,11269,16654;16688;19371;20000,25915,0,0,4,0,4
45718,100,11270,16661;20044;20439;20838,25915,0,2,2,0,4
45719,100,11272,16719;16831;19827,25915,0,0,3,0,3
45720,100,11273,16732;17129;19088;19973;20264,25915,0,1,4,0,5
45721,100,11274,16733;16817;20588;21290,25915,0,2,2,0,4
45722,100,11275,16152;16762;20329,25915,0,1,2,0,3
45723,100,11276,16304;17095;21030,25915,0,1,2,0,3
45724,100,11277,16359;16770,25915,0,0,2,0,2
45725,100,11278,16703;16788;19546;20319,25915,0,1,3,0,4
45726,100,11279,16793;16869;20454,25915,0,1,2,0,3
45727,100,11280,16481;17135;20452,25915,0,1,2,0,3
45728,100,11281,16237;16806;20272,25915,0,1,2,0,3
45729,100,11282,16963;20198;21346,25915,0,1,2,0,3
45730,100,11288,11860,26280,0,0,0,1,1
45731,100,11294,12142;12162,26280,0,0,0,2,2
45732,100,11304,13102,26280,0,0,0,1,1
45733,100,11307,13442,26280,0,0,0,1,1
45734,100,11309,14373,26280,0,0,0,1,1
45735,100,11310,13985;14303,26280,0,0,0,2,2
45736,100,11322,14586;14910,26280,0,0,1,1,2
45737,100,11323,14832,26280,0,0,1,0,1
45738,100,11324,15111,26280,0,0,1,0,1
45739,100,11326,14688;14989,26280,0,0,2,0,2
45740,100,11329,15276,26280,0,0,1,0,1
45741,100,11332,15330;15475,26280,0,0,2,0,2
45742,100,11334,15550;15727;19450,26280,0,0,3,0,3
45743,100,11335,15350;15552;20455,26280,0,1,2,0,3
45744,100,11336,15096;15582,26280,0,0,2,0,2
45745,100,11339,15546;20193,26280,0,0,2,0,2
45746,100,11340,14509;14822,26280,0,0,1,1,2
45747,100,11341,16532;19699;19808;19917;20190,26280,0,0,5,0,5
45748,100,11342,14874;15862,26280,0,0,2,0,2
45749,100,11343,15699;15798,26280,0,0,2,0,2
45750,100,11344,15904;16220;19954,26280,0,0,3,0,3
45751,100,11346,16080;16641;20342;20518,26280,0,2,2,0,4
45752,100,11347,16019;16064;19506;19776,26280,0,0,4,0,4
45753,100,11348,16130;16404;19909;20584,26280,0,1,3,0,4
45754,100,11349,16149;16670;20338,26280,0,1,2,0,3
45755,100,11350,16445;16819;19779;20696,26280,0,1,3,0,4
45756,100,11351,16602;16700;19602;19894;20139,26280,0,0,5,0,5
45757,100,11352,16189;16194;19637,26280,0,0,3,0,3
45758,100,11353,16681;19405;19658;20007,26280,0,0,4,0,4
45759,100,11354,16319;16357;19576,26280,0,0,3,0,3
45760,100,11355,16689;20360,26280,0,1,1,0,2
45761,100,11356,16268;16300;20691,26280,0,1,2,0,3
45762,100,11357,16704;20306,26280,0,1,1,0,2
45763,100,11358,16312,26280,0,0,1,0,1
45764,100,11359,16192;16332;19059;19929,26280,0,0,4,0,4
45765,100,11360,16735;16811;20080,26280,0,0,3,0,3
45766,100,11361,15994;16364;20425;20868,26280,0,2,2,0,4
45767,100,11362,16635;16891;20305,26280,0,1,2,0,3
45768,100,11363,16158;16390;19769,26280,0,0,3,0,3
45769,100,11364,16399;16488;20107;20224,26280,0,0,4,0,4
45770,100,11366,15679;16403,26280,0,0,2,0,2
45771,100,11367,16903;19509,26280,0,0,2,0,2
45772,100,11368,16539;16573,26280,0,0,2,0,2
45773,100,11369,16510;16630;20109,26280,0,0,3,0,3
45774,100,11370,16001;16514;19676;20003,26280,0,0,4,0,4
45775,100,11371,17003;21177;21423;21582,26280,0,3,1,0,4
45776,100,11372,16306;16563;20367,26280,0,1,2,0,3
45777,100,11373,16569;19706;19854;19938,26280,0,0,4,0,4
45778,100,11374,17116;17240;19414;20085;20571,26280,0,1,4,0,5
45779,100,11375,16669;16917;19984;20158,26280,0,0,4,0,4
45780,100,11376,16523;16665;20534;21022,26280,0,2,2,0,4
45781,100,11377,16679;16912;20165;20728;20862,26280,0,2,3,0,5
45782,100,11378,16452;16940;19531;20068;20289,26280,0,1,4,0,5
45783,100,11379,16698;16897;19738;20248;20412;21180,26280,0,2,4,0,6
45784,100,11380,17306;17309;20123;20657,26280,0,1,3,0,4
45785,100,11381,17025,26280,0,0,1,0,1
45786,100,11382,16775;17122;20127;20288;21660,26280,0,2,3,0,5
45787,100,11383,16694;16794;20292;20800,26280,0,2,2,0,4
45788,100,11384,16677;16808;19772,26280,0,0,3,0,3
45789,100,11385,16477;16828;20173;20715,26280,0,1,3,0,4
45790,100,11386,17266;20849;21341,26280,0,2,1,0,3
45791,100,11387,17144,26280,0,0,1,0,1
45792,100,11388,17001;17180;19226;20666,26280,0,1,3,0,4
45793,100,11389,16491;16905,26280,0,0,2,0,2
45794,100,11390,16496;16909;20440;21227,26280,0,2,2,0,4
45795,100,11391,16728;17154;20202;20815,26280,0,1,3,0,4
45796,100,11392,16645;17292;20297;20900,26280,0,2,2,0,4
45797,100,11393,16918;17077;19133;20376,26280,0,1,3,0,4
45798,100,11394,16231;16919;20461;20945,26280,0,2,2,0,4
45799,100,11400,11587,26645,0,0,0,1,1
45800,100,11404,12131,26645,0,0,0,1,1
45801,100,11406,12476;12626,26645,0,0,0,2,2
45802,100,11407,12032,26645,0,0,0,1,1
45803,100,11411,12723,26645,0,0,0,1,1
45804,100,11416,13265,26645,0,0,0,1,1
45805,100,11419,13327,26645,0,0,0,1,1
45806,100,11426,14343,26645,0,0,0,1,1
45807,100,11428,14669;14708,26645,0,0,2,0,2
45808,100,11429,14547;14698,26645,0,0,1,1,2
45809,100,11435,15022;15050;19421;19585,26645,0,0,4,0,4
45810,100,11436,15391,26645,0,0,1,0,1
45811,100,11439,15382,26645,0,0,1,0,1
45812,100,11441,15535;15551;19802;19950,26645,0,0,4,0,4
45813,100,11444,16024;16427;20187,26645,0,0,3,0,3
45814,100,11445,15684;15773;19390,26645,0,0,3,0,3
45815,100,11446,15450;15763,26645,0,0,2,0,2
45816,100,11448,15788,26645,0,0,1,0,1
45817,100,11449,15920;16198,26645,0,0,2,0,2
45818,100,11450,15737;15953;19983,26645,0,0,3,0,3
45819,100,11451,15288;15861;19543;20113,26645,0,0,4,0,4
45820,100,11452,16111;16712;19343,26645,0,0,3,0,3
45821,100,11453,16487;16521;19631;19794,26645,0,0,4,0,4
45822,100,11454,16138;16191;20182,26645,0,0,3,0,3
45823,100,11455,16242;16450;19140;19644,26645,0,0,4,0,4
45824,100,11456,16275;16448;19128;19589;19834,26645,0,0,5,0,5
45825,100,11457,16324;16333,26645,0,0,2,0,2
45826,100,11458,16420;20069,26645,0,0,2,0,2
45827,100,11459,16099;16338,26645,0,0,2,0,2
45828,100,11460,16342;16942;19884,26645,0,0,3,0,3
45829,100,11461,16678;16816;20238,26645,0,0,3,0,3
45830,100,11462,16736;19920;21058;22265,26645,1,1,2,0,4
45831,100,11463,16381;17134;20801,26645,0,1,2,0,3
45832,100,11464,15974;16382;19504;19814;20201,26645,0,0,5,0,5
45833,100,11465,16356;20514;20620,26645,0,2,1,0,3
45834,100,11466,17178;17220;19502;20174;20527,26645,0,1,4,0,5
45835,100,11467,16315;16447;20438;20565,26645,0,2,2,0,4
45836,100,11468,16119;16674;20357,26645,0,1,2,0,3
45837,100,11469,15858;16509;20504,26645,0,1,2,0,3
45838,100,11470,16173;16538;20428,26645,0,1,2,0,3
45839,100,11471,16321;16543,26645,0,0,2,0,2
45840,100,11472,16551;16653;20451;21106,26645,0,2,2,0,4
45841,100,11473,16492;16588;19887;20408,26645,0,1,3,0,4
45842,100,11474,16167;16202,26645,0,0,2,0,2
45843,100,11476,16662;16971;20215,26645,0,0,3,0,3
45844,100,11477,16546;16671;20564;21295,26645,0,2,2,0,4
45845,100,11478,16999,26645,0,0,1,0,1
45846,100,11479,16684;19880;20270,26645,0,1,2,0,3
45847,100,11480,16585;16699;20401;20791;21173,26645,0,3,2,0,5
45848,100,11481,16708;20581,26645,0,1,1,0,2
45849,100,11482,16388;16714;19639;19927;20232,26645,0,0,5,0,5
45850,100,11483,17101;21267;21633,26645,0,2,1,0,3
45851,100,11484,17145;17168;20529;21283,26645,0,2,2,0,4
45852,100,11485,16506;16734;19986;20243;20441,26645,0,1,4,0,5
45853,100,11486,16568;19335;19703;20557,26645,0,1,3,0,4
45854,100,11487,16693;16716,26645,0,0,2,0,2
45855,100,11488,16067;16765;20608;20734,26645,0,2,2,0,4
45856,100,11489,16911,26645,0,0,1,0,1
45857,100,11490,16908;19810;19932,26645,0,0,3,0,3
45858,100,11491,16879;17051,26645,0,0,2,0,2
45859,100,11492,16825;19459;20018,26645,0,0,3,0,3
45860,100,11493,16208;16830;19817;20036;20509,26645,0,1,4,0,5
45861,100,11494,16842;16915;19688;20276;21033,26645,0,2,3,0,5
45862,100,11495,16851;20667;21200,26645,0,2,1,0,3
45863,100,11496,16926;20537,26645,0,1,1,0,2
45864,100,11497,17014;20061;20365;21237,26645,0,2,2,0,4
45865,100,11498,16835;16876;20120;20654;22272,26645,1,1,3,0,5
45866,100,11499,16889;17106;20467,26645,0,1,2,0,3
45867,100,11500,16490;16907;19897;20247;20736,26645,0,1,4,0,5
45868,100,11501,17007;17117,26645,0,0,2,0,2
45869,100,11502,17024;17177;19997;20231;21036,26645,0,1,4,0,5
45870,100,11504,16962;17221;20712,26645,0,1,2,0,3
45871,100,11505,16968;17068;19476;19967,26645,0,0,4,0,4
45872,100,11506,16990;17128;21339;21431,26645,0,2,2,0,4
45873,100,11507,16992;19724;20048;20539;20794;21974,26645,1,2,3,0,6
45874,100,11508,17004;17032;19669;20195,26645,0,0,4,0,4
45875,100,11509,16906;17227;19556;20824;21780,26645,1,1,3,0,5
45876,100,11510,17019;17127;19267;19752;20713;20877,26645,0,2,4,0,6
45877,100,11511,17026;17155;19582,26645,0,0,3,0,3
45878,100,11512,16344;17029;19481;19624,26645,0,0,4,0,4
45879,100,11515,11808,27010,0,0,0,1,1
45880,100,11517,11559,27010,0,0,0,1,1
45881,100,11518,12216,27010,0,0,0,1,1
45882,100,11522,11958,27010,0,0,0,1,1
45883,100,11523,11957;11988,27010,0,0,0,2,2
45884,100,11524,12477;12895,27010,0,0,0,2,2
45885,100,11530,12884,27010,0,0,0,1,1
45886,100,11533,12865,27010,0,0,0,1,1
45887,100,11539,13302,27010,0,0,0,1,1
45888,100,11545,13742;13752,27010,0,0,0,2,2
45889,100,11549,14634;15297,27010,0,0,1,1,2
45890,100,11550,14700;14950,27010,0,0,2,0,2
45891,100,11552,15100,27010,0,0,1,0,1
45892,100,11554,15373;15603,27010,0,0,2,0,2
45893,100,11555,15376;15760,27010,0,0,2,0,2
45894,100,11556,15428;15528,27010,0,0,2,0,2
45895,100,11558,15529;15942,27010,0,0,2,0,2
45896,100,11562,15074;15508,27010,0,0,2,0,2
45897,100,11563,15668;15803,27010,0,0,2,0,2
45898,100,11565,15780;15852,27010,0,0,2,0,2
45899,100,11566,16038;20627,27010,0,1,1,0,2
45900,100,11567,15500;20387,27010,0,1,1,0,2
45901,100,11568,15908;16000;20052,27010,0,0,3,0,3
45902,100,11570,15923;15972;19877,27010,0,0,3,0,3
45903,100,11571,16372;20050;20241,27010,0,0,3,0,3
45904,100,11572,15669;16267;19748;20704,27010,0,1,3,0,4
45905,100,11573,15409;15599,27010,0,0,2,0,2
45906,100,11575,16230;16597;19458;19850;20328,27010,0,1,4,0,5
45907,100,11576,16172;16686;19443;19991,27010,0,0,4,0,4
45908,100,11577,16606;16774;20496,27010,0,1,2,0,3
45909,100,11578,16276;16368,27010,0,0,2,0,2
45910,100,11580,16593;17022;19465;19989;20660;20922,27010,0,2,4,0,6
45911,100,11581,16513;16572;19508;20378;20952,27010,0,2,3,0,5
45912,100,11582,16530;20296,27010,0,1,1,0,2
45913,100,11583,16446;16866;19972;20214,27010,0,0,4,0,4
45914,100,11584,16218;16594;20957,27010,0,1,2,0,3
45915,100,11585,16578;20082;20865,27010,0,1,2,0,3
45916,100,11586,16799;16857;19617;19733;19957;20739,27010,0,1,5,0,6
45917,100,11587,16883;20029;20341;20752,27010,0,2,2,0,4
45918,100,11588,15909;16638,27010,0,0,2,0,2
45919,100,11589,16596;16707;20134;20171,27010,0,0,4,0,4
45920,100,11590,16862;17170;20303;21032;22036,27010,1,2,2,0,5
45921,100,11591,16766;16921;19896;20746;21260,27010,0,2,3,0,5
45922,100,11592,17028;20108,27010,0,0,2,0,2
45923,100,11593,16820;16988;19792;20252;21179,27010,0,1,4,0,5
45924,100,11594,16737;16809;20268;20809,27010,0,2,2,0,4
45925,100,11595,16567;16846;20316;20766,27010,0,2,2,0,4
45926,100,11596,16856;17045;20595;20634,27010,0,2,2,0,4
45927,100,11597,16901;17393;20444;20784,27010,0,2,2,0,4
45928,100,11598,16932;17064;19789;20545,27010,0,1,3,0,4
45929,100,11599,17229;17327;20567;21084,27010,0,2,2,0,4
45930,100,11601,17253;20695,27010,0,1,1,0,2
45931,100,11602,16756;16954;20219;20602,27010,0,1,3,0,4
45932,100,11603,16878;17196;20905,27010,0,1,2,0,3
45933,100,11604,16976;20071;20315,27010,0,1,2,0,3
45934,100,11605,16982;17006;20546;20656,27010,0,2,2,0,4
45935,100,11606,17031;17163;20478,27010,0,1,2,0,3
45936,100,11607,17044;17257;20226;21268,27010,0,1,3,0,4
45937,100,11608,17017;17061,27010,0,0,2,0,2
45938,100,11609,17114;17411;20474;20592;20843;21666,27010,0,4,2,0,6
45939,100,11610,17079;17132;20105;21245,27010,0,1,3,0,4
45940,100,11611,11898,27375,0,0,0,1,1
45941,100,11613,11760,27375,0,0,0,1,1
45942,100,11621,12640,27375,0,0,0,1,1
45943,100,11622,12714,27375,0,0,0,1,1
45944,100,11628,13169;13573,27375,0,0,0,2,2
45945,100,11641,14240;14800,27375,0,0,1,1,2
45946,100,11642,14941;15420,27375,0,0,2,0,2
45947,100,11643,14497;14781,27375,0,0,1,1,2
45948,100,11644,15301,27375,0,0,1,0,1
45949,100,11645,14758;15235,27375,0,0,2,0,2
45950,100,11650,14804;15256,27375,0,0,2,0,2
45951,100,11657,15485;15596,27375,0,0,2,0,2
45952,100,11658,15617;15981;19966,27375,0,0,3,0,3
45953,100,11661,15747;15845,27375,0,0,2,0,2
45954,100,11662,15595;16040;20095,27375,0,0,3,0,3
45955,100,11664,15962;16213;19863;20117,27375,0,0,4,0,4
45956,100,11665,16430;16792;20479;20810;21139,27375,0,3,2,0,5
45957,100,11666,16289;16354,27375,0,0,2,0,2
45958,100,11667,16215;16550,27375,0,0,2,0,2
45959,100,11671,16084;16326;20147;20421,27375,0,1,3,0,4
45960,100,11672,16464;21637,27375,0,1,1,0,2
45961,100,11674,15893;16416;19773,27375,0,0,3,0,3
45962,100,11675,16153;16350;20042;20706;21171,27375,0,2,3,0,5
45963,100,11676,16664;16668;20034;20185,27375,0,0,4,0,4
45964,100,11677,16478;16577;20148;20875,27375,0,1,3,0,4
45965,100,11678,16516;16613;19955;20629,27375,0,1,3,0,4
45966,100,11679,16500;16623;20186;20833,27375,0,1,3,0,4
45967,100,11680,16629;19976;20170,27375,0,0,3,0,3
45968,100,11681,16624;16702;20111;20523,27375,0,1,3,0,4
45969,100,11682,16666;17210;20093,27375,0,0,3,0,3
45970,100,11683,16120;16743;20348;20648;20873,27375,0,3,2,0,5
45971,100,11684,16744;17297;20515;21629,27375,0,2,2,0,4
45972,100,11685,16769;16852;20632;21031;21369,27375,0,3,2,0,5
45973,100,11686,16783;17480;21936,27375,1,0,2,0,3
45974,100,11687,17239;17344;20988,27375,0,1,2,0,3
45975,100,11688,16834;17076;20918;21351,27375,0,2,2,0,4
45976,100,11689,16844;17136;21195,27375,0,1,2,0,3
45977,100,11690,16853;17312;20635;21066,27375,0,2,2,0,4
45978,100,11691,16435;16797;20218;20393,27375,0,1,3,0,4
45979,100,11692,16864;17160;20578;21371,27375,0,2,2,0,4
45980,100,11693,17286;20386;22123,27375,1,1,1,0,3
45981,100,11694,16886;16972;20744;20893,27375,0,2,2,0,4
45982,100,11695,16894;17021;20125;20377;20663,27375,0,2,3,0,5
45983,100,11696,16711;16933;20207;20700,27375,0,1,3,0,4
45984,100,11697,16934;17194;19753;20587,27375,0,1,3,0,4
45985,100,11698,16938;16949;21377,27375,0,1,2,0,3
45986,100,11699,16188;16945,27375,0,0,2,0,2
45987,100,11700,16960;17353;20209;20585,27375,0,1,3,0,4
45988,100,11701,16829;16965,27375,0,0,2,0,2
45989,100,11702,16526;16997,27375,0,0,2,0,2
45990,100,11704,17108;20094;20330;21420,27375,0,2,2,0,4
45991,100,11705,16871;17039;19493,27375,0,0,3,0,3
45992,100,11706,17065;17293;19409;20088;20566,27375,0,1,4,0,5
45993,100,11707,16499;17070;21996,27375,1,0,2,0,3
45994,100,11708,16740;17080;20144,27375,0,0,3,0,3
45995,100,11709,16824;17328;20307;20989,27375,0,2,2,0,4
45996,100,11710,17090;17488;20100;20267;20558,27375,0,2,3,0,5
45997,100,11711,17151;17201;20359;21871,27375,1,1,2,0,4
45998,100,11712,16759;17156;20792,27375,0,1,2,0,3
45999,100,11713,16727;17118;19482;20098;20223;21223,27375,0,1,5,0,6
46000,100,11714,17457;17562;19707;19987,27375,0,0,4,0,4
46001,100,11715,17206;17357;19625;20106;20199;20406;20774,27375,0,2,5,0,7
46002,100,11716,16581;17223;20503;20897;21184,27375,0,3,2,0,5
46003,100,11717,17088;17241;20283;20959,27375,0,2,2,0,4
46004,100,11718,16899;16995;20030;20354,27375,0,1,3,0,4
46005,100,11719,12042,27740,0,0,0,1,1
46006,100,11720,12045,27740,0,0,0,1,1
46007,100,11721,12213,27740,0,0,0,1,1
46008,100,11722,12161,27740,0,0,0,1,1
46009,100,11723,12120,27740,0,0,0,1,1
46010,100,11725,11645,27740,0,0,0,1,1
46011,100,11726,12608;12655,27740,0,0,0,2,2
46012,100,11734,13411,27740,0,0,0,1,1
46013,100,11738,13397;13671,27740,0,0,0,2,2
46014,100,11741,13162,27740,0,0,0,1,1
46015,100,11748,13685;14322,27740,0,0,0,2,2
46016,100,11750,14539;15089;20178,27740,0,0,2,1,3
46017,100,11754,15092;15178,27740,0,0,2,0,2
46018,100,11755,14979;15811,27740,0,0,2,0,2
46019,100,11758,15775;19867;20253,27740,0,0,3,0,3
46020,100,11762,16351;16468;20371;20846,27740,0,2,2,0,4
46021,100,11764,16484;16525;20119,27740,0,0,3,0,3
46022,100,11766,16291;19613,27740,0,0,2,0,2
46023,100,11768,16676;16892;20028;20927,27740,0,1,3,0,4
46024,100,11769,16687;17012;20343;20599,27740,0,2,2,0,4
46025,100,11770,16685;16742;20389,27740,0,1,2,0,3
46026,100,11771,16330;16589;19845;20902,27740,0,1,3,0,4
46027,100,11772,16778;20743,27740,0,1,1,0,2
46028,100,11773,16282;16470;19745;19926,27740,0,0,4,0,4
46029,100,11774,16955;17437;20837;21167,27740,0,2,2,0,4
46030,100,11775,16848;17243;19693;19807;20457,27740,0,1,4,0,5
46031,100,11776,17187,27740,0,0,1,0,1
46032,100,11777,16893;17011;20418;20694,27740,0,2,2,0,4
46033,100,11778,16582;16614,27740,0,0,2,0,2
46034,100,11780,16592;16885;21061;21275,27740,0,2,2,0,4
46035,100,11781,16902;17315;20531,27740,0,1,2,0,3
46036,100,11782,17188;17394;19627;21083,27740,0,1,3,0,4
46037,100,11783,16802;16946;20823;21008,27740,0,2,2,0,4
46038,100,11784,16980;16985;20039;20554;20705;20954,27740,0,3,3,0,6
46039,100,11785,16964;16998;19893;20593,27740,0,1,3,0,4
46040,100,11786,17010;17092;19982,27740,0,0,3,0,3
46041,100,11787,17023,27740,0,0,1,0,1
46042,100,11788,16868;17059;19735;19916;22264,27740,1,0,4,0,5
46043,100,11789,17048;17140;20489;20907,27740,0,2,2,0,4
46044,100,11790,17099;19912;21070,27740,0,1,2,0,3
46045,100,11791,17104;17687;19501;21262,27740,0,1,3,0,4
46046,100,11792,17504;21164;21323,27740,0,2,1,0,3
46047,100,11793,17655;20680,27740,0,1,1,0,2
46048,100,11794,17142;17235;19953,27740,0,0,3,0,3
46049,100,11795,16701;17152;20309;21101;21243,27740,0,3,2,0,5
46050,100,11796,16632;17164;19475;19743;21336,27740,0,1,4,0,5
46051,100,11797,16755;17175;20707;20926,27740,0,2,2,0,4
46052,100,11798,17181;17507;21044;21296,27740,0,2,2,0,4
46053,100,11799,17203;17420;20059;20996;21451;21806,27740,1,2,3,0,6
46054,100,11800,16986;17445;20552;22116,27740,1,1,2,0,4
46055,100,11801,17302;20325;21175,27740,0,2,1,0,3
46056,100,11802,17182;17252;20628;20864,27740,0,2,2,0,4
46057,100,11803,17255;17644;20004;20460;20822,27740,0,2,3,0,5
46058,100,11804,17256;17278;20037;21878,27740,1,0,3,0,4
46059,100,11805,17289;17448;19569;19687;21060;21730,27740,1,1,4,0,6
46060,100,11806,17295;17371;20879,27740,0,1,2,0,3
46061,100,11807,17236;19524;20016,27740,0,0,3,0,3
46062,100,11808,17285;17390;19574;20239;20839;21124;21452,27740,0,3,4,0,7
46063,100,11809,17333;17482;20311;21699,27740,1,1,2,0,4
46064,100,11810,16925;17403;19888,27740,0,0,3,0,3
46065,100,11812,12116,28105,0,0,0,1,1
46066,100,11814,12250;12339,28105,0,0,0,2,2
46067,100,11815,12340;12345,28105,0,0,0,2,2
46068,100,11816,12094,28105,0,0,0,1,1
46069,100,11819,12272;12620,28105,0,0,0,2,2
46070,100,11820,12624,28105,0,0,0,1,1
46071,100,11822,12684,28105,0,0,0,1,1
46072,100,11827,13148;13617,28105,0,0,0,2,2
46073,100,11828,12421,28105,0,0,0,1,1
46074,100,11829,12449,28105,0,0,0,1,1
46075,100,11833,13080,28105,0,0,0,1,1
46076,100,11837,14300,28105,0,0,0,1,1
46077,100,11843,13670;13785,28105,0,0,0,2,2
46078,100,11844,14391;14696,28105,0,0,1,1,2
46079,100,11845,13992;14402,28105,0,0,0,2,2
46080,100,11848,14641,28105,0,0,0,1,1
46081,100,11849,14249;14768,28105,0,0,1,1,2
46082,100,11852,15216;15305,28105,0,0,2,0,2
46083,100,11854,15205;15787;20110,28105,0,0,3,0,3
46084,100,11858,14964;15493;19670,28105,0,0,3,0,3
46085,100,11861,15378;15399,28105,0,0,2,0,2
46086,100,11865,16391,28105,0,0,1,0,1
46087,100,11866,16574;16682;20206;20751,28105,0,1,3,0,4
46088,100,11869,16212;16943;20714;21533,28105,0,2,2,0,4
46089,100,11870,16615,28105,0,0,1,0,1
46090,100,11872,16082;16290;20415;20672,28105,0,2,2,0,4
46091,100,11873,16394;16760;20536;20812,28105,0,2,2,0,4
46092,100,11874,16166;16408;20074;20385,28105,0,1,3,0,4
46093,100,11876,16459;17139;20820,28105,0,1,2,0,3
46094,100,11877,16633;19947,28105,0,0,2,0,2
46095,100,11879,16502;16547;20623,28105,0,1,2,0,3
46096,100,11880,16018;16520;20146;20456,28105,0,1,3,0,4
46097,100,11883,16451;16529;20157;20465,28105,0,1,3,0,4
46098,100,11884,16222;16587;20459,28105,0,1,2,0,3
46099,100,11885,16590;19598;19796,28105,0,0,3,0,3
46100,100,11886,16591;16658;20887;21133,28105,0,2,2,0,4
46101,100,11887,16401;16598;20427,28105,0,1,2,0,3
46102,100,11888,16607;16910;20404;20575,28105,0,2,2,0,4
46103,100,11889,16411;16983;20053;20561;20779,28105,0,2,3,0,5
46104,100,11890,16655;16975;19731;19956;20786;21148,28105,0,2,4,0,6
46105,100,11893,16882;16951;21387,28105,0,1,2,0,3
46106,100,11894,17093;17282;20763,28105,0,1,2,0,3
46107,100,11895,16887;16939;19918;20488,28105,0,1,3,0,4
46108,100,11896,16890;17190;20769,28105,0,1,2,0,3
46109,100,11897,16922;17329;19949;21566,28105,0,1,3,0,4
46110,100,11898,17067;17102;19944;20291;21042;22268,28105,1,2,3,0,6
46111,100,11899,17082;17216;19851;20653,28105,0,1,3,0,4
46112,100,11900,17054;17468;20586;20753;21288;21565;22053,28105,1,4,2,0,7
46113,100,11901,16360;17073;19921;20184,28105,0,0,4,0,4
46114,100,11902,17097;17384;20453,28105,0,1,2,0,3
46115,100,11903,17111;17440;20449;21638,28105,0,2,2,0,4
46116,100,11904,17038;17270;20381;21249,28105,0,2,2,0,4
46117,100,11905,16872;17264;20295,28105,0,1,2,0,3
46118,100,11906,17147;17298;19799;20619;21326;21609,28105,0,3,3,0,6
46119,100,11907,17326;17453;19594;20131;20235;20612;20948,28105,0,2,5,0,7
46120,100,11908,17254;19683;19961;20374,28105,0,1,3,0,4
46121,100,11909,17259;17301;19786;20197;21513,28105,0,1,4,0,5
46122,100,11911,17533;17683;19608;20217;20271;20535;20690,28105,0,3,4,0,7
46123,100,11912,19878,28105,0,0,1,0,1
46124,100,11913,17290;17336;20041;21072,28105,0,1,3,0,4
46125,100,11914,17566;19725,28105,0,0,2,0,2
46126,100,11915,17338;20434;20891,28105,0,2,1,0,3
46127,100,11916,17342;17417;21078,28105,0,1,2,0,3
46128,100,11917,17348;17399;20841;21168,28105,0,2,2,0,4
46129,100,11918,17606;20370,28105,0,1,1,0,2
46130,100,11919,17359;17545;19883;20084;21528,28105,0,1,4,0,5
46131,100,11920,17133;17775;20845;21068;21157;21263,28105,0,4,2,0,6
46132,100,11921,17237;17692;19583;19801;21952,28105,1,0,4,0,5
46133,100,11922,17549;17761;22078,28105,1,0,2,0,3
46134,100,11923,17486;20688;20973,28105,0,2,1,0,3
46135,100,11924,17525;19596;20789;22166,28105,1,1,2,0,4
46136,100,11925,12461,28470,0,0,0,1,1
46137,100,11930,12448,28470,0,0,0,1,1
46138,100,11932,13180,28470,0,0,0,1,1
46139,100,11933,12591,28470,0,0,0,1,1
46140,100,11935,12308,28470,0,0,0,1,1
46141,100,11936,12921,28470,0,0,0,1,1
46142,100,11937,12831,28470,0,0,0,1,1
46143,100,11938,12958,28470,0,0,0,1,1
46144,100,11939,12992,28470,0,0,0,1,1
46145,100,11942,13523,28470,0,0,0,1,1
46146,100,11950,15084,28470,0,0,1,0,1
46147,100,11952,14230;14801,28470,0,0,1,1,2
46148,100,11953,14286,28470,0,0,0,1,1
46149,100,11954,14477;14631,28470,0,0,0,2,2
46150,100,11955,14508;14511,28470,0,0,0,2,2
46151,100,11959,15038,28470,0,0,1,0,1
46152,100,11971,15725,28470,0,0,1,0,1
46153,100,11972,15099;15311,28470,0,0,2,0,2
46154,100,11973,15083;15314,28470,0,0,2,0,2
46155,100,11978,15264;15933;19719;22260,28470,1,0,3,0,4
46156,100,11982,15246,28470,0,0,1,0,1
46157,100,11984,14938;15640,28470,0,0,2,0,2
46158,100,11986,15911;15998;19936,28470,0,0,3,0,3
46159,100,11987,14769;15224,28470,0,0,2,0,2
46160,100,11989,16060;16239;19869,28470,0,0,3,0,3
46161,100,11993,16331;16335;20411;20912,28470,0,2,2,0,4
46162,100,11994,15744;15899,28470,0,0,2,0,2
46163,100,11997,16323;16583;20388,28470,0,1,2,0,3
46164,100,11998,16920;16928;19818;20278,28470,0,1,3,0,4
46165,100,11999,16717;16914;20740;20764,28470,0,2,2,0,4
46166,100,12000,17217;17311;20397;20998,28470,0,2,2,0,4
46167,100,12001,16731;16780;20090;20407;20532,28470,0,2,3,0,5
46168,100,12002,16812;17119;20181;20426,28470,0,1,3,0,4
46169,100,12003,17112;17115;19981;20203;20500,28470,0,1,4,0,5
46170,100,12004,16838;17046,28470,0,0,2,0,2
46171,100,12005,16839;17527;20064;20287,28470,0,1,3,0,4
46172,100,12006,16730;17098;20372;21221,28470,0,2,2,0,4
46173,100,12007,16969;17400;20770,28470,0,1,2,0,3
46174,100,12008,16987;17645;19761;21224;21560,28470,0,2,3,0,5
46175,100,12009,17020;17330;20526;20970,28470,0,2,2,0,4
46176,100,12010,16777;17249;21183;21746,28470,1,1,2,0,4
46177,100,12012,17091;17405;20265,28470,0,1,2,0,3
46178,100,12013,17049;17096;19940;20188;20462,28470,0,1,4,0,5
46179,100,12015,17211;17294;20356;20613;20692;21235,28470,0,4,2,0,6
46180,100,12016,17161;17552;21186;21365,28470,0,2,2,0,4
46181,100,12017,17179;17275;20294,28470,0,1,2,0,3
46182,100,12018,17184;17706;19858;20200,28470,0,0,4,0,4
46183,100,12019,17189;17704;20242;22170,28470,1,0,3,0,4
46184,100,12020,17199;17684;19722;21011,28470,0,1,3,0,4
46185,100,12021,17401;17536,28470,0,0,2,0,2
46186,100,12022,17208;17528;21111;21327;22155;22167,28470,2,2,2,0,6
46187,100,12023,16930;17233;19826;20384;20498;21208,28470,0,3,3,0,6
46188,100,12024,17386;17538;21150;21289,28470,0,2,2,0,4
46189,100,12025,17276;17485;20725;21225,28470,0,2,2,0,4
46190,100,12026,17268;17304;20349;20437,28470,0,2,2,0,4
46191,100,12027,17313;17450;20614;20956;22164,28470,1,2,2,0,5
46192,100,12028,17316;17646;20234;20598,28470,0,1,3,0,4
46193,100,12029,17322;17729;19737;20331;20861;21347,28470,0,3,3,0,6
46194,100,12030,17192;17323;20591;20940,28470,0,2,2,0,4
46195,100,12031,17165;17364;19701;21269,28470,0,1,3,0,4
46196,100,12032,17337;19866;20825,28470,0,1,2,0,3
46197,100,12033,17317;17419;20579;20895;21172,28470,0,3,2,0,5
46198,100,12034,17319;17433;19876;20687;20888;21464,28470,0,3,3,0,6
46199,100,12035,16896;17436;19815;21673,28470,1,0,3,0,4
46200,100,12036,17162;17455;20410,28470,0,1,2,0,3
46201,100,12037,17467;17512;20097,28470,0,0,3,0,3
46202,100,12038,17354;17472;21250;21390;21692,28470,1,2,2,0,5
46203,100,12039,17476;17565;20506;20583,28470,0,2,2,0,4
46204,100,12040,17484;17763;20499;21620,28470,0,2,2,0,4
46205,100,12041,17489;17630;20993;21160,28470,0,2,2,0,4
46206,100,12042,17494;17580;21277;21505,28470,0,2,2,0,4
46207,100,12043,16845;17521;20066;20469;21005,28470,0,2,3,0,5
46208,100,12044,17551;17874;19922,28470,0,0,3,0,3
46209,100,12045,17787;17969;19689;20076;20277;20747;21454,28470,0,3,4,0,7
46210,100,12046,17036;17570;20983;21308,28470,0,2,2,0,4
46211,100,12048,12140,28835,0,0,0,1,1
46212,100,12049,12084,28835,0,0,0,1,1
46213,100,12050,12467,28835,0,0,0,1,1
46214,100,12052,12224,28835,0,0,0,1,1
46215,100,12054,12648,28835,0,0,0,1,1
46216,100,12057,12503,28835,0,0,0,1,1
46217,100,12058,13005,28835,0,0,0,1,1
46218,100,12060,13324;13347,28835,0,0,0,2,2
46219,100,12062,13308;13684,28835,0,0,0,2,2
46220,100,12068,13050,28835,0,0,0,1,1
46221,100,12069,13880,28835,0,0,0,1,1
46222,100,12072,13596;14332,28835,0,0,0,2,2
46223,100,12075,14362;14396,28835,0,0,0,2,2
46224,100,12079,14626;15369,28835,0,0,1,1,2
46225,100,12083,15076;15315,28835,0,0,2,0,2
46226,100,12086,15079;15137,28835,0,0,2,0,2
46227,100,12093,15387,28835,0,0,1,0,1
46228,100,12099,15809,28835,0,0,1,0,1
46229,100,12100,15847;16258;20373,28835,0,1,2,0,3
46230,100,12104,15547;15571,28835,0,0,2,0,2
46231,100,12106,15888;16271;19842;20103,28835,0,0,4,0,4
46232,100,12107,16079;16858,28835,0,0,2,0,2
46233,100,12111,16367;16861;21027;21251,28835,0,2,2,0,4
46234,100,12112,16374;16680,28835,0,0,2,0,2
46235,100,12113,16378;16875;20544;21398,28835,0,2,2,0,4
46236,100,12115,16752;17086;20645;21162,28835,0,2,2,0,4
46237,100,12116,16767;17351;20473;20553,28835,0,2,2,0,4
46238,100,12118,16850;17305;20230;20269;21255;21491,28835,0,3,3,0,6
46239,100,12119,16855;17013;20917;21105,28835,0,2,2,0,4
46240,100,12120,16503;17150,28835,0,0,2,0,2
46241,100,12121,16640;17050,28835,0,0,2,0,2
46242,100,12122,16718;17186;20180;20985,28835,0,1,3,0,4
46243,100,12123,16952;17204;20630,28835,0,1,2,0,3
46244,100,12124,17000;17228;20475,28835,0,1,2,0,3
46245,100,12126,16789;17213;20322;20883,28835,0,2,2,0,4
46246,100,12128,17269;20005;20091;20382,28835,0,1,3,0,4
46247,100,12129,17334;17341;20196;20551;21019;21282;21355,28835,0,4,3,0,7
46248,100,12130,17193;17556;20721;21098;21571;22109,28835,1,3,2,0,6
46249,100,12131,17214;17385;20049;20808;20892;21014,28835,0,3,3,0,6
46250,100,12132,17539;20702;21191,28835,0,2,1,0,3
46251,100,12133,16996;17435;20611,28835,0,1,2,0,3
46252,100,12134,17674;17701;19811;20601;21093,28835,0,2,3,0,5
46253,100,12135,17395;17443;20662,28835,0,1,2,0,3
46254,100,12136,17868;20227;20414;20638,28835,0,2,2,0,4
46255,100,12137,17110;17497;20569;20818;21025;21753,28835,1,3,2,0,6
46256,100,12138,17517;17613;20433;20776,28835,0,2,2,0,4
46257,100,12139,17544;17750;20947;21145,28835,0,2,2,0,4
46258,100,12140,17205;17520;20419;20980,28835,0,2,2,0,4
46259,100,12141,17779;21476;21688;22172,28835,2,1,1,0,4
46260,100,12142,17557;17679;21137,28835,0,1,2,0,3
46261,100,12143,17559;17585;19980;20163;21312;21718,28835,1,1,4,0,6
46262,100,12144,17245;17567;21381;21484,28835,0,2,2,0,4
46263,100,12145,17579;17982;21623,28835,0,1,2,0,3
46264,100,12146,17597;17682;20122;20758,28835,0,1,3,0,4
46265,100,12147,17607;17944;19838;21479,28835,0,1,3,0,4
46266,100,12148,17478;17622;20901;21217;21634,28835,0,3,2,0,5
46267,100,12149,17423;17626;20494;20851,28835,0,2,2,0,4
46268,100,12150,17263;17639;20350,28835,0,1,2,0,3
46269,100,12151,17642;17847;19891;20880;21548,28835,0,2,3,0,5
46270,100,12152,17648;17777;20256,28835,0,0,3,0,3
46271,100,12153,17651;20313;20960;21185,28835,0,3,1,0,4
46272,100,12154,17251;17652;19915;20555;20757;21163,28835,0,3,3,0,6
46273,100,12155,17657;17947;20813;20953,28835,0,2,2,0,4
46274,100,12156,17505;17675;20445;20668,28835,0,2,2,0,4
46275,100,12157,17492;17681;20480,28835,0,1,2,0,3
46276,100,12158,12651;12908,29200,0,0,0,2,2
46277,100,12159,12686,29200,0,0,0,1,1
46278,100,12160,12165,29200,0,0,0,1,1
46279,100,12162,12273,29200,0,0,0,1,1
46280,100,12164,12601,29200,0,0,0,1,1
46281,100,12165,13239,29200,0,0,0,1,1
46282,100,12168,13330,29200,0,0,0,1,1
46283,100,12171,13781,29200,0,0,0,1,1
46284,100,12174,14083;14799,29200,0,0,1,1,2
46285,100,12178,14745,29200,0,0,1,0,1
46286,100,12189,15109;15173,29200,0,0,2,0,2
46287,100,12191,15051;15539,29200,0,0,2,0,2
46288,100,12195,15271;15777,29200,0,0,2,0,2
46289,100,12196,14898,29200,0,0,1,0,1
46290,100,12197,15389;15683,29200,0,0,2,0,2
46291,100,12200,15526;15555,29200,0,0,2,0,2
46292,100,12201,15034;15597,29200,0,0,2,0,2
46293,100,12204,15318;16235;21422,29200,0,1,2,0,3
46294,100,12207,15957;16566;20417;20733,29200,0,2,2,0,4
46295,100,12208,15716;15720,29200,0,0,2,0,2
46296,100,12209,16046;16328;19930;20279;20931,29200,0,2,3,0,5
46297,100,12212,16100;16217;19933,29200,0,0,3,0,3
46298,100,12215,16224;16292;20932,29200,0,1,2,0,3
46299,100,12219,16524;16958;19931;20194,29200,0,0,4,0,4
46300,100,12220,16316;16595;20260,29200,0,1,2,0,3
46301,100,12222,16713;17071;20361;20717;20761,29200,0,3,2,0,5
46302,100,12223,16723;16970;21041;21202,29200,0,2,2,0,4
46303,100,12224,16133;16414;20432,29200,0,1,2,0,3
46304,100,12225,16667;16750;20737;21021,29200,0,2,2,0,4
46305,100,12226,16757;17143;20225;20468;21913,29200,1,1,3,0,5
46306,100,12227,17084;17398;20723,29200,0,1,2,0,3
46307,100,12228,16515;16801,29200,0,0,2,0,2
46308,100,12230,16622;16895;20112;20280;20934,29200,0,2,3,0,5
46309,100,12231,17209;17469;20299;20577;20999;21123,29200,0,4,2,0,6
46310,100,12232,17185;17634;21370,29200,0,1,2,0,3
46311,100,12233,16929;17446;20600,29200,0,1,2,0,3
46312,100,12234,17056;17173;19942;20939,29200,0,1,3,0,4
46313,100,12235,16961;17078;20099;20183;20682;21292,29200,0,2,4,0,6
46314,100,12236,17105;17697;20719;21037;21314;21450,29200,0,4,2,0,6
46315,100,12237,16994;17157;20450;20633;21085,29200,0,3,2,0,5
46316,100,12238,17167;17224;20369,29200,0,1,2,0,3
46317,100,12239,17654;21094,29200,0,1,1,0,2
46318,100,12240,17535;17548;21435;21715,29200,1,1,2,0,4
46319,100,12241,17267;19974;22032,29200,1,0,2,0,3
46320,100,12242,17283;17428;20022,29200,0,0,3,0,3
46321,100,12243,17325;17447;20363;21324;21594,29200,0,3,2,0,5
46322,100,12246,16764;16948;20574;20854;21161,29200,0,3,2,0,5
46323,100,12248,16981;17430;20251,29200,0,0,3,0,3
46324,100,12249,17232;17444;20870;21585,29200,0,2,2,0,4
46325,100,12250,17479;17717;19959;20497;20894;21206;21467;21745,29200,1,4,3,0,8
46326,100,12251,17501,29200,0,0,1,0,1
46327,100,12252,17225;17515;20548;20674;20972,29200,0,3,2,0,5
46328,100,12253,17577;17741;20301,29200,0,1,2,0,3
46329,100,12254,17586;17808;21741;21967,29200,2,0,2,0,4
46330,100,12255,17462;17588,29200,0,0,2,0,2
46331,100,12256,17511;17596;20911,29200,0,1,2,0,3
46332,100,12257,17632;17972;21064;21232,29200,0,2,2,0,4
46333,100,12258,17532;20708;21069;21818,29200,1,2,1,0,4
46334,100,12259,17650;18084;20133;20470,29200,0,1,3,0,4
46335,100,12260,17387;17614;20855;21539,29200,0,2,2,0,4
46336,100,12261,17715;17767;20798;21182,29200,0,2,2,0,4
46337,100,12262,17460;17739;20709;21496,29200,0,2,2,0,4
46338,100,12263,12231,29565,0,0,0,1,1
46339,100,12265,12696,29565,0,0,0,1,1
46340,100,12266,12632,29565,0,0,0,1,1
46341,100,12268,12669,29565,0,0,0,1,1
46342,100,12269,12874,29565,0,0,0,1,1
46343,100,12271,12886;13370,29565,0,0,0,2,2
46344,100,12272,12301,29565,0,0,0,1,1
46345,100,12274,13218,29565,0,0,0,1,1
46346,100,12277,13362;13514,29565,0,0,0,2,2
46347,100,12278,13192,29565,0,0,0,1,1
46348,100,12280,13580,29565,0,0,0,1,1
46349,100,12281,13372;13825,29565,0,0,0,2,2
46350,100,12283,13878,29565,0,0,0,1,1
46351,100,12286,14045;14244,29565,0,0,0,2,2
46352,100,12290,14116;14755,29565,0,0,1,1,2
46353,100,12293,14883;15248,29565,0,0,2,0,2
46354,100,12294,14538,29565,0,0,0,1,1
46355,100,12299,15140;15145,29565,0,0,2,0,2
46356,100,12301,15670;15954,29565,0,0,2,0,2
46357,100,12304,15874;16426,29565,0,0,2,0,2
46358,100,12311,16522;16979;20075;20281,29565,0,1,3,0,4
46359,100,12314,16746;20522,29565,0,1,1,0,2
46360,100,12317,16863,29565,0,0,1,0,1
46361,100,12318,17191;17422;21443,29565,0,1,2,0,3
46362,100,12320,17081;17171;21026;21982,29565,1,1,2,0,4
46363,100,12321,16639;17138;20603;20646,29565,0,2,2,0,4
46364,100,12322,17126;17408;20483;21134,29565,0,2,2,0,4
46365,100,12323,17035;17172;20394;20649;21199,29565,0,3,2,0,5
46366,100,12324,17200;17372;20336,29565,0,1,2,0,3
46367,100,12325,16978;17279;20304;20903;22275,29565,1,2,2,0,5
46368,100,12326,17280;17360;20568;21302;21385;22165,29565,1,3,2,0,6
46369,100,12327,17324;17449;20550;21055;21597,29565,0,3,2,0,5
46370,100,12328,17373;17866;20114;21048,29565,0,1,3,0,4
46371,100,12330,17212;17392;20443;20802;21408,29565,0,3,2,0,5
46372,100,12331,17829;21580,29565,0,1,1,0,2
46373,100,12332,17432;18087;20507;20576;20781;21264;21837,29565,1,4,2,0,7
46374,100,12333,17376;17458;20652,29565,0,1,2,0,3
46375,100,12334,17508;17939;20321;20964;21833;22043,29565,2,2,2,0,6
46376,100,12335,17513;20525;21054,29565,0,2,1,0,3
46377,100,12336,17519;17542;21253;21651,29565,0,2,2,0,4
46378,100,12337,17582;20780;21914,29565,1,1,1,0,3
46379,100,12338,17464;17583;20259;21073;21953,29565,1,1,3,0,5
46380,100,12339,17541;17584;20510,29565,0,1,2,0,3
46381,100,12340,17593;17667;20458;20997;21519;21622,29565,0,4,2,0,6
46382,100,12341,17611;17620;21156;21524,29565,0,2,2,0,4
46383,100,12342,17641;18186;20166;20326;20639;21247,29565,0,3,3,0,6
46384,100,12343,17653;17872;21024;21190;21350,29565,0,3,2,0,5
46385,100,12344,17659;17950;20664;21338,29565,0,2,2,0,4
46386,100,12345,17668;17844;20250;20816;21067,29565,0,2,3,0,5
46387,100,12346,17690;20508;20768;21146;21776,29565,1,3,1,0,5
46388,100,12347,18196;18391;20390;20858;21901,29565,1,2,2,0,5
46389,100,12348,17968;20141;22178,29565,1,0,2,0,3
46390,100,12349,17753;17756;20519;20686;20941;21319,29565,0,4,2,0,6
46391,100,12350,17769;17773;20872;21418;21890;22117;22171,29565,3,2,2,0,7
46392,100,12351,17780;17952;21506,29565,0,1,2,0,3
46393,100,12352,17778;17802;20160;20967;21646,29565,0,2,3,0,5
46394,100,12353,17636;17804;20159;21832,29565,1,0,3,0,4
46395,100,12354,17491;17825;20073;21239;21785,29565,1,1,3,0,5
46396,100,12355,17748;17831;20616;21739,29565,1,1,2,0,4
46397,100,12356,17835;17914;20413;21102;21764,29565,1,2,2,0,5
46398,100,12357,17589;17848;20333;20448,29565,0,2,2,0,4
46399,100,12358,17801;17861;20155;20710;21335,29565,0,2,3,0,5
46400,100,12359,17537;17878;21349;21600;22176,29565,1,2,2,0,5
46401,100,12360,17879;18048;20081;20615,29565,0,1,3,0,4
46402,100,12361,12899,29930,0,0,0,1,1
46403,100,12363,12746,29930,0,0,0,1,1
46404,100,12364,13092,29930,0,0,0,1,1
46405,100,12370,13683;13955,29930,0,0,0,2,2
46406,100,12371,13817,29930,0,0,0,1,1
46407,100,12373,13983;14111,29930,0,0,0,2,2
46408,100,12374,14037;14619,29930,0,0,0,2,2
46409,100,12376,13884,29930,0,0,0,1,1
46410,100,12395,16088;16363,29930,0,0,2,0,2
46411,100,12396,16090;16402,29930,0,0,2,0,2
46412,100,12397,15665;16279;20151,29930,0,0,3,0,3
46413,100,12398,15948;16257;20284,29930,0,1,2,0,3
46414,100,12399,16308;16418,29930,0,0,2,0,2
46415,100,12400,15963;16211,29930,0,0,2,0,2
46416,100,12401,16977;17130;21138,29930,0,1,2,0,3
46417,100,12402,16656;17218;20896,29930,0,1,2,0,3
46418,100,12403,16636;16763;20237;20749,29930,0,1,3,0,4
46419,100,12404,16647;16748;20463,29930,0,1,2,0,3
46420,100,12405,17052;20164;20622,29930,0,1,2,0,3
46421,100,12406,16800;17094;20152;21010;21515,29930,0,2,3,0,5
46422,100,12407,16937;17230;20834;21119;21554,29930,0,3,2,0,5
46423,100,12408,16628;16695;20742;21110,29930,0,2,2,0,4
46424,100,12410,16967;17425;20162,29930,0,0,3,0,3
46425,100,12411,16761;17041;20559,29930,0,1,2,0,3
46426,100,12412,17037;17427;20493,29930,0,1,2,0,3
46427,100,12413,17296;17495;20785;21096;21466,29930,0,3,2,0,5
46428,100,12414,17198;17696;20978;21536,29930,0,2,2,0,4
46429,100,12415,17247;17514;20617;21087,29930,0,2,2,0,4
46430,100,12416,17288;17616;21261;21858;22061,29930,2,1,2,0,5
46431,100,12417,17089;17660;21114,29930,0,1,2,0,3
46432,100,12418,17366;17500;21481;21550,29930,0,2,2,0,4
46433,100,12419,17074;17377;20538;20665;21158,29930,0,3,2,0,5
46434,100,12420,17380;17758;20368;20399;21691,29930,1,2,2,0,5
46435,100,12421,16815;17202;20610,29930,0,1,2,0,3
46436,100,12422,17413;18096;20817;21228;21474,29930,0,3,2,0,5
46437,100,12423,17242;17426;20150;21461,29930,0,1,3,0,4
46438,100,12424,17474;17496;20760;21117;21884;22021,29930,2,2,2,0,6
46439,100,12425,17499;17841;21333;21731,29930,1,1,2,0,4
46440,100,12426,17707;17708;20254;20402;20963;21415,29930,0,3,3,0,6
46441,100,12427,17550;18107;20208;20477;22049,29930,1,1,3,0,5
46442,100,12428,17624;17711;20727;21213,29930,0,2,2,0,4
46443,100,12429,17465;17598;20429;20795;21012;21293;21751,29930,1,4,2,0,7
46444,100,12430,18160;18178;21414,29930,0,1,2,0,3
46445,100,12431,18036;20263;20828;21342,29930,0,3,1,0,4
46446,100,12432,17781;18189;20192;20563;21397,29930,0,2,3,0,5
46447,100,12434,18125;20312;20607;21631,29930,0,3,1,0,4
46448,100,12435,17817;20490;21174;22068,29930,1,2,1,0,4
46449,100,12436,17274;17818;21672,29930,1,0,2,0,3
46450,100,12437,17795;17824;20249;20541;20842;21015,29930,0,3,3,0,6
46451,100,12438,17830;20884;21413;21720,29930,1,2,1,0,4
46452,100,12439,17845;20205,29930,0,0,2,0,2
46453,100,12440,17481;17887;21178;21259,29930,0,2,2,0,4
46454,100,12441,17736;17853;20423;20949;21352,29930,0,3,2,0,5
46455,100,12442,17963,29930,0,0,1,0,1
46456,100,12443,17864;20669,29930,0,1,1,0,2
46457,100,12444,17339;17869;20889,29930,0,1,2,0,3
46458,100,12445,17882;21612,29930,0,1,1,0,2
46459,100,12446,17884;20722;21053;21883,29930,1,2,1,0,4
46460,100,12447,17888;18144;21756,29930,1,0,2,0,3
46461,100,12448,17937;18101;20204;20582;20741;20765,29930,0,3,3,0,6
46462,100,12449,17991;18094;21082;21273;21868,29930,1,2,2,0,5
46463,100,12450,17860;17999;21214;21667,29930,1,1,2,0,4
46464,100,12451,12398,30295,0,0,0,1,1
46465,100,12456,13334,30295,0,0,0,1,1
46466,100,12459,13614,30295,0,0,0,1,1
46467,100,12460,13674,30295,0,0,0,1,1
46468,100,12464,13406;14005,30295,0,0,0,2,2
46469,100,12465,13923,30295,0,0,0,1,1
46470,100,12469,14118;14324,30295,0,0,0,2,2
46471,100,12471,14307;14381,30295,0,0,0,2,2
46472,100,12472,14002;14483,30295,0,0,0,2,2
46473,100,12474,14406;14455,30295,0,0,0,2,2
46474,100,12478,13850;14053,30295,0,0,0,2,2
46475,100,12479,14737;14823,30295,0,0,2,0,2
46476,100,12484,15077;15277,30295,0,0,2,0,2
46477,100,12491,15691;15821,30295,0,0,2,0,2
46478,100,12495,15937;16379,30295,0,0,2,0,2
46479,100,12496,15985,30295,0,0,1,0,1
46480,100,12499,16127;16540;20431;20811,30295,0,2,2,0,4
46481,100,12501,15864;16233;20420,30295,0,1,2,0,3
46482,100,12503,16044;16465,30295,0,0,2,0,2
46483,100,12505,16608;17244;20511;21152,30295,0,2,2,0,4
46484,100,12506,16747;17197;20502,30295,0,1,2,0,3
46485,100,12507,16807,30295,0,0,1,0,1
46486,100,12508,17107;17120;21334,30295,0,1,2,0,3
46487,100,12510,16104;17158;20832,30295,0,1,2,0,3
46488,100,12511,16877,30295,0,0,1,0,1
46489,100,12513,17109;17291;20516;21729,30295,1,1,2,0,4
46490,100,12514,17238;17680;20814;21194,30295,0,2,2,0,4
46491,100,12516,17332;17346;21830;22092,30295,2,0,2,0,4
46492,100,12517,17421;17721;20320;20644;21908;22103,30295,2,2,2,0,6
46493,100,12518,17369;17564;20732;20929,30295,0,2,2,0,4
46494,100,12519,17572;18131;21211,30295,0,1,2,0,3
46495,100,12520,17574;18004;20699;20908;21258;21754,30295,1,3,2,0,6
46496,100,12522,17807;17820;20556;20805;21166,30295,0,3,2,0,5
46497,100,12523,17409;17631;20383;20543;21222,30295,0,3,2,0,5
46498,100,12524,17649;17727;20533;21642,30295,0,2,2,0,4
46499,100,12525,17424;17666;20703;21521,30295,0,2,2,0,4
46500,100,12526,17705;17746;20755;21230,30295,0,2,2,0,4
46501,100,12527,17714;18210;20334;21607;21826,30295,1,2,2,0,5
46502,100,12528,17730;17735;20675;20885;22097,30295,1,2,2,0,5
46503,100,12529,17699;17737;21006;21561;21949,30295,1,2,2,0,5
46504,100,12530,17195;17840;20642;20831;20882;21099,30295,0,4,2,0,6
46505,100,12531,17762;17794;21284;21640;22113,30295,1,2,2,0,5
46506,100,12532,17774;17983;21549,30295,0,1,2,0,3
46507,100,12533,17785;18169,30295,0,0,2,0,2
46508,100,12534,17789;17909;21898;22137,30295,2,0,2,0,4
46509,100,12535,17670;17790;21482,30295,0,1,2,0,3
46510,100,12536,17529;17842;20844;21628;21698;22173,30295,2,2,2,0,6
46511,100,12537,17897;20631,30295,0,1,1,0,2
46512,100,12538,17823;17906,30295,0,0,2,0,2
46513,100,12539,17703;18159;20472;20678;21017;21240,30295,0,4,2,0,6
46514,100,12540,17913;17934;21717,30295,1,0,2,0,3
46515,100,12541,17921;17998;21103;21399,30295,0,2,2,0,4
46516,100,12542,17870;17924;20416;20848;22037,30295,1,2,2,0,5
46517,100,12543,17930;17935;21778,30295,1,0,2,0,3
46518,100,12544,17733;17942;21948,30295,1,0,2,0,3
46519,100,12545,18112;18162;21140;21795,30295,1,1,2,0,4
46520,100,12546,17803;17953;21107,30295,0,1,2,0,3
46521,100,12547,17984;18368;20609;21039;21791,30295,1,2,2,0,5
46522,100,12548,17916;17995;20366;20797;21189;21842,30295,1,3,2,0,6
46523,100,12549,17838;17996;20726;21075,30295,0,2,2,0,4
46524,100,12550,17890;18002;20771;20955,30295,0,2,2,0,4
46525,100,12551,18010;18249;21125;21344,30295,0,2,2,0,4
46526,100,12552,18019;18353;20430;20618;21737,30295,1,2,2,0,5
46527,100,12553,18044;18200;22065;22189,30295,2,0,2,0,4
46528,100,12554,18034;18092;21544,30295,0,1,2,0,3
46529,100,12555,18106;21373;21442;22187,30295,1,2,1,0,4
46530,100,12557,18103;20661;21063,30295,0,2,1,0,3
46531,100,12558,18093;20293;20528;20643;21144;22027,30295,1,4,1,0,6
46532,100,12559,17895;18058;20492;20869;21170,30295,0,3,2,0,5
46533,100,12560,13027,30660,0,0,0,1,1
46534,100,12561,12513,30660,0,0,0,1,1
46535,100,12562,13395;13570,30660,0,0,0,2,2
46536,100,12563,13113,30660,0,0,0,1,1
46537,100,12564,13267,30660,0,0,0,1,1
46538,100,12567,13260,30660,0,0,0,1,1
46539,100,12571,14263,30660,0,0,0,1,1
46540,100,12572,14423;14778,30660,0,0,1,1,2
46541,100,12573,14383,30660,0,0,0,1,1
46542,100,12574,13836,30660,0,0,0,1,1
46543,100,12577,14906;15776,30660,0,0,2,0,2
46544,100,12584,15630;15664,30660,0,0,2,0,2
46545,100,12585,15741,30660,0,0,1,0,1
46546,100,12591,15672,30660,0,0,1,0,1
46547,100,12592,15703,30660,0,0,1,0,1
46548,100,12593,16305;16580,30660,0,0,2,0,2
46549,100,12594,16206;16565,30660,0,0,2,0,2
46550,100,12595,16726;16865,30660,0,0,2,0,2
46551,100,12597,16724;17261;20422;21463,30660,0,2,2,0,4
46552,100,12599,16823;17451;20398;20890;21065;21108;21537,30660,0,5,2,0,7
46553,100,12600,16843;17347,30660,0,0,2,0,2
46554,100,12602,16542;17042,30660,0,0,2,0,2
46555,100,12603,17141;20596,30660,0,1,1,0,2
46556,100,12605,16957;17215;20625;20803,30660,0,2,2,0,4
46557,100,12607,16859,30660,0,0,1,0,1
46558,100,12608,17523;20924;21135,30660,0,2,1,0,3
46559,100,12610,17222;20921;21563;21882,30660,1,2,1,0,4
46560,100,12611,17300;17429;20442,30660,0,1,2,0,3
46561,100,12612,17534;18057;21896,30660,1,0,2,0,3
46562,100,12613,17543;17771;20580;20735;21462;21819,30660,1,3,2,0,6
46563,100,12614,17554;18232;21786,30660,1,0,2,0,3
46564,100,12615,17573;18381;21742;22138,30660,2,0,2,0,4
46565,100,12616,17599;18000;20562;21305;21581,30660,0,3,2,0,5
46566,100,12617,17343;17608;20992;21441,30660,0,2,2,0,4
46567,100,12618,17985;20435,30660,0,1,1,0,2
46568,100,12619,17402;17776;20925;21050;21299;21760,30660,1,3,2,0,6
46569,100,12620,17407;17647;20937;21229,30660,0,2,2,0,4
46570,100,12621,17656;18175;21003;21624,30660,0,2,2,0,4
46571,100,12622,17560;17662;20685;21403,30660,0,2,2,0,4
46572,100,12623,17722;17754;20852;21089;21478;21610,30660,0,4,2,0,6
46573,100,12624,18035;20829;21835,30660,1,1,1,0,3
46574,100,12625,17709;17812;20481;21147;21656;21815,30660,1,3,2,0,6
46575,100,12626,17612;17726;20909,30660,0,1,2,0,3
46576,100,12627,18027;20899;21471,30660,0,2,1,0,3
46577,100,12628,17732;18452;20762;20994;21721,30660,1,2,2,0,5
46578,100,12629,17757;18050;21392;21873,30660,1,1,2,0,4
46579,100,12630,17759;17843;21318;21621;22042,30660,1,2,2,0,5
46580,100,12631,18242;20396;20919;21517;21579;22014,30660,1,4,1,0,6
46581,100,12632,17747;17988;21775,30660,1,0,2,0,3
46582,100,12633,17863;18140;20991;21488;21562,30660,0,3,2,0,5
46583,100,12634,18120;18161;21340;22124,30660,1,1,2,0,4
46584,100,12635,17904;18329;20626;20754;21895;22009,30660,2,2,2,0,6
46585,100,12636,17836;17910;20799;20979;21388;21849,30660,1,3,2,0,6
46586,100,12637,18111;20920;21743;22018,30660,2,1,1,0,4
46587,100,12638,17962;18067;20806;21049;21509,30660,0,3,2,0,5
46588,100,12639,18013;18023;20987;21712;22180,30660,2,1,2,0,5
46589,100,12640,18041;20521;20671,30660,0,2,1,0,3
46590,100,12641,18074;18336;20520;20787;21337,30660,0,3,2,0,5
46591,100,12642,18054;18313;20395;21294,30660,0,2,2,0,4
46592,100,12643,17875;18056;21567,30660,0,1,2,0,3
46593,100,12644,18068;20572;21732,30660,1,1,1,0,3
46594,100,12645,18077;18287;21246;21523,30660,0,2,2,0,4
46595,100,12647,18079;18102;20447;20981;21626,30660,0,3,2,0,5
46596,100,12648,17609;18218;20605;20827,30660,0,2,2,0,4
46597,100,12649,18116;21307,30660,0,1,1,0,2
46598,100,12650,18375;20624;20651;20930;22206,30660,1,3,1,0,5
46599,100,12651,18121;18132;21188;21595;21679,30660,1,2,2,0,5
46600,100,12652,17961;18361;21487;21542;22204,30660,1,2,2,0,5
46601,100,12653,18136;18475;21315,30660,0,1,2,0,3
46602,100,12654,17936;18145;20487;20807;21366;21724,30660,1,3,2,0,6
46603,100,12655,17725;18151;22035,30660,1,0,2,0,3
46604,100,12656,17911;17915;21209,30660,0,1,2,0,3
46605,100,12658,17788;18224;20590;21271;21846;22191,30660,2,2,2,0,6
46606,100,12659,13257,31025,0,0,0,1,1
46607,100,12661,13116,31025,0,0,0,1,1
46608,100,12662,13410,31025,0,0,0,1,1
46609,100,12665,12993,31025,0,0,0,1,1
46610,100,12669,14470,31025,0,0,0,1,1
46611,100,12680,15269;15304,31025,0,0,2,0,2
46612,100,12684,15164;15732,31025,0,0,2,0,2
46613,100,12691,15622;15663,31025,0,0,2,0,2
46614,100,12696,15284,31025,0,0,1,0,1
46615,100,12699,16397;16605,31025,0,0,2,0,2
46616,100,12704,16558;17069;20676;21306,31025,0,2,2,0,4
46617,100,12706,16611;17149;21683,31025,1,0,2,0,3
46618,100,12708,16180,31025,0,0,1,0,1
46619,100,12709,17053,31025,0,0,1,0,1
46620,100,12713,17113;17345;20853;21918,31025,1,1,2,0,4
46621,100,12714,17265;17819;20783,31025,0,1,2,0,3
46622,100,12715,17176;17370;20866,31025,0,1,2,0,3
46623,100,12716,17381;17490;20698,31025,0,1,2,0,3
46624,100,12717,17418;17855;21276,31025,0,1,2,0,3
46625,100,12718,17287;17463;20594;20836,31025,0,2,2,0,4
46626,100,12719,17470;18046;21526,31025,0,1,2,0,3
46627,100,12720,17839;20961;21570,31025,0,2,1,0,3
46628,100,12721,17503;18152;21700,31025,1,0,2,0,3
46629,100,12722,17929;20681;21894,31025,1,1,1,0,3
46630,100,12723,17219;17640;20773;21002;21216;21757;22169,31025,2,3,2,0,7
46631,100,12724,18209;22085,31025,1,0,1,0,2
46632,100,12725,17720;18277;21572;22197,31025,1,1,2,0,4
46633,100,12726,17940;20840;21143;21396;21477,31025,0,4,1,0,5
46634,100,12727,17745;18100;20976;21531,31025,0,2,2,0,4
46635,100,12728,17724;17948;21711,31025,1,0,2,0,3
46636,100,12729,17561;18091;21972,31025,1,0,2,0,3
46637,100,12730,17367;17959;21455;21808,31025,1,1,2,0,4
46638,100,12731,17783;18147;21867,31025,1,0,2,0,3
46639,100,12732,17821;17976;21129;21363;22121,31025,1,2,2,0,5
46640,100,12733,17873;18009;21303,31025,0,1,2,0,3
46641,100,12734,17898;18515;21664;21850;22005;22212,31025,3,1,2,0,6
46642,100,12735,17941;21118;21863,31025,1,1,1,0,3
46643,100,12736,17355;17951;21051;21905,31025,1,1,2,0,4
46644,100,12737,18157;18503;20933;21113;21529;21603;22210,31025,1,4,2,0,7
46645,100,12738,17859;18216;22118,31025,1,0,2,0,3
46646,100,12739,17718;17967;20670;21203,31025,0,2,2,0,4
46647,100,12740,18005;18098;20804;21653,31025,0,2,2,0,4
46648,100,12741,17716;18049;20731;20971;21955,31025,1,2,2,0,5
46649,100,12742,18126;22082,31025,1,0,1,0,2
46650,100,12743,18081;18097;20856;21116;21910,31025,1,2,2,0,5
46651,100,12744,18114;18357;21828;21932,31025,2,0,2,0,4
46652,100,12745,18156;18226;20650;21045;21360;21576;21886,31025,1,4,2,0,7
46653,100,12746,17749;18167,31025,0,0,2,0,2
46654,100,12747,18177;18291;21040;21719;22200,31025,2,1,2,0,5
46655,100,12748,17990;18199;21465;22031,31025,1,1,2,0,4
46656,100,12749,17734;18221;20701;21486,31025,0,2,2,0,4
46657,100,12750,18237;18592;21728;21956,31025,2,0,2,0,4
46658,100,12751,18047;18255;21382,31025,0,1,2,0,3
46659,100,12752,18279;20547;21112;21510;21874;22062,31025,2,3,1,0,6
46660,100,12753,18142;18272;20677;20793,31025,0,2,2,0,4
46661,100,12754,18274;18445;21794,31025,1,0,2,0,3
46662,100,12755,18256;18518;20974;21238;21401,31025,0,3,2,0,5
46663,100,12756,18294;18505;20759;20968;21927,31025,1,2,2,0,5
46664,100,12757,18220;18302;21095;21559;21843,31025,1,2,2,0,5
46665,100,12758,13317,31390,0,0,0,1,1
46666,100,12760,13014,31390,0,0,0,1,1
46667,100,12761,13385,31390,0,0,0,1,1
46668,100,12762,13375,31390,0,0,0,1,1
46669,100,12763,13582,31390,0,0,0,1,1
46670,100,12764,13627,31390,0,0,0,1,1
46671,100,12770,14348;14971,31390,0,0,1,1,2
46672,100,12771,14353,31390,0,0,0,1,1
46673,100,12773,14694;14709,31390,0,0,2,0,2
46674,100,12774,14430;14908,31390,0,0,1,1,2
46675,100,12784,15185;15415,31390,0,0,2,0,2
46676,100,12789,15600;16011,31390,0,0,2,0,2
46677,100,12791,15426,31390,0,0,1,0,1
46678,100,12792,15449,31390,0,0,1,0,1
46679,100,12793,15762;15802,31390,0,0,2,0,2
46680,100,12794,16600;21241,31390,0,1,1,0,2
46681,100,12799,16113;16721;20738,31390,0,1,2,0,3
46682,100,12800,16123;16482,31390,0,0,2,0,2
46683,100,12803,16361;16507;21009,31390,0,1,2,0,3
46684,100,12805,17087;21343,31390,0,1,1,0,2
46685,100,12806,16784;17166,31390,0,0,2,0,2
46686,100,12807,16247,31390,0,0,1,0,1
46687,100,12810,16781;17389;20683,31390,0,1,2,0,3
46688,100,12811,16827,31390,0,0,1,0,1
46689,100,12812,16854;16867,31390,0,0,2,0,2
46690,100,12813,16993;17299;21256;21527;21919,31390,1,2,2,0,5
46691,100,12816,17633;20977;22016,31390,1,1,1,0,3
46692,100,12818,17688;18180;21658,31390,0,1,2,0,3
46693,100,12819,17075;17307;21004,31390,0,1,2,0,3
46694,100,12820,17318;17957;21800;22067,31390,2,0,2,0,4
46695,100,12821,16959;17358;20724,31390,0,1,2,0,3
46696,100,12824,17695;17857;20913;21310,31390,0,2,2,0,4
46697,100,12825,16956;17431;20938;21412;21870,31390,1,2,2,0,5
46698,100,12826,17540;17919,31390,0,0,2,0,2
46699,100,12827,17303;17546;20826;21128;21329,31390,0,3,2,0,5
46700,100,12828,17581;17834;21130;21421;21534,31390,0,3,2,0,5
46701,100,12829,17623;18127;21681,31390,1,0,2,0,3
46702,100,12830,18025;18164;21212;21713,31390,1,1,2,0,4
46703,100,12831,17742;18208;21196;21512;22190,31390,1,2,2,0,5
46704,100,12832,17719;17786;20990;21433;21782,31390,1,2,2,0,5
46705,100,12833,17871;18171;21280;21532;21727,31390,1,2,2,0,5
46706,100,12834,18028;21899;21986,31390,2,0,1,0,3
46707,100,12835,17901;18110;21132;21772,31390,1,1,2,0,4
46708,100,12836,17946;21142;21997,31390,1,1,1,0,3
46709,100,12837,18075;18194;21141;21281;21722,31390,1,2,2,0,5
46710,100,12838,17891;17966;21885,31390,1,0,2,0,3
46711,100,12839,17977;20860,31390,0,1,1,0,2
46712,100,12840,18060;18656,31390,0,0,2,0,2
46713,100,12841,17510;18055;21023;21864;22184,31390,2,1,2,0,5
46714,100,12842,18059;18341;21990,31390,1,0,2,0,3
46715,100,12843,18016;20830;21057,31390,0,2,1,0,3
46716,100,12844,17744;18155;20641;21847,31390,1,1,2,0,4
46717,100,12845,18165;21859,31390,1,0,1,0,2
46718,100,12846,18390;21545;21857,31390,1,1,1,0,3
46719,100,12847,18007;18179;21657,31390,0,1,2,0,3
46720,100,12848,17601;17766;20859;21514;21809;22168,31390,2,2,2,0,6
46721,100,12849,18436;18465;20655;20863;21984,31390,1,2,2,0,5
46722,100,12850,18233;18265;21445;22195,31390,1,1,2,0,4
46723,100,12851,18245;18566;20636,31390,0,1,2,0,3
46724,100,12852,18193;18246;21682;22192,31390,2,0,2,0,4
46725,100,12853,18192;18262;21518;21750,31390,1,1,2,0,4
46726,100,12854,18270;18351;21543;22196,31390,1,1,2,0,4
46727,100,12855,18290;21007;21285,31390,0,2,1,0,3
46728,100,12856,18415;18694;21994,31390,1,0,2,0,3
46729,100,12857,18300;18367;21353;21437;21807;22105,31390,2,2,2,0,6
46730,100,12858,18322;18658;21038;21153;21957,31390,1,2,2,0,5
46731,100,12859,18331;22007,31390,1,0,1,0,2
46732,100,12861,18339;21881,31390,1,0,1,0,2
46733,100,12862,17865;18342;20720;21013;21272,31390,0,3,2,0,5
46734,100,12863,18346;20916;21131,31390,0,2,1,0,3
46735,100,12864,18733;21771;21820,31390,2,0,1,0,3
46736,100,12865,18088;18369;20821;21062;21824,31390,1,2,2,0,5
46737,100,12866,17833;18374;20772;21000,31390,0,2,2,0,4
46738,100,12867,18386;18389;20647;20867,31390,0,2,2,0,4
46739,100,12868,13747,31755,0,0,0,1,1
46740,100,12871,13075,31755,0,0,0,1,1
46741,100,12872,14027;14473,31755,0,0,0,2,2
46742,100,12875,13813,31755,0,0,0,1,1
46743,100,12877,13999;14412,31755,0,0,0,2,2
46744,100,12879,13901;14605,31755,0,0,0,2,2
46745,100,12887,14723,31755,0,0,1,0,1
46746,100,12888,14878;15390,31755,0,0,2,0,2
46747,100,12889,14956;15348,31755,0,0,2,0,2
46748,100,12890,14687;15053,31755,0,0,2,0,2
46749,100,12891,15127;15296,31755,0,0,2,0,2
46750,100,12893,15249;15693,31755,0,0,2,0,2
46751,100,12899,15867;16398,31755,0,0,2,0,2
46752,100,12901,15905,31755,0,0,1,0,1
46753,100,12904,16132,31755,0,0,1,0,1
46754,100,12909,16353;16924,31755,0,0,2,0,2
46755,100,12910,16966;17030,31755,0,0,2,0,2
46756,100,12913,17522;20946;21081;21458,31755,0,3,1,0,4
46757,100,12916,17231;17610;21376;21988;22069,31755,2,1,2,0,5
46758,100,12917,17262;17396;21080,31755,0,1,2,0,3
46759,100,12918,17340;17576;21092;21648,31755,0,2,2,0,4
46760,100,12919,17085;17454;20881;21384,31755,0,2,2,0,4
46761,100,12920,17506;17810;20942;21169,31755,0,2,2,0,4
46762,100,12922,17555,31755,0,0,1,0,1
46763,100,12923,17356;17594;20886,31755,0,1,2,0,3
46764,100,12924,17615,31755,0,0,1,0,1
46765,100,12925,17526,31755,0,0,1,0,1
46766,100,12926,17760;17958;21677;22177,31755,2,0,2,0,4
46767,100,12927,17791;18323;21328;21617,31755,0,2,2,0,4
46768,100,12928,17784;17798;21694,31755,1,0,2,0,3
46769,100,12929,18014;20915;20982;22041,31755,1,2,1,0,4
46770,100,12930,17926;18235;21635;22073,31755,1,1,2,0,4
46771,100,12931,18006;20935;21402,31755,0,2,1,0,3
46772,100,12932,18012;18740;20906;21374;21705;22226,31755,2,2,2,0,6
46773,100,12933,18018;18113;21411,31755,0,1,2,0,3
46774,100,12934,18029;18710;22224,31755,1,0,2,0,3
46775,100,12935,18332;21304;21419;21827;22202,31755,2,2,1,0,5
46776,100,12936,18086;18563;20850,31755,0,1,2,0,3
46777,100,12937,18124;18457;21404,31755,0,1,2,0,3
46778,100,12938,18154;18621;21668,31755,1,0,2,0,3
46779,100,12939,17713;18158;21097;21687;21838,31755,2,1,2,0,5
46780,100,12940,17625;18173;21710,31755,1,0,2,0,3
46781,100,12941,18250;18840;20835,31755,0,1,2,0,3
46782,100,12942,18207;18252;20874;21220,31755,0,2,2,0,4
46783,100,12943,18266;21448;21599,31755,0,2,1,0,3
46784,100,12944,18305;21407,31755,0,1,1,0,2
46785,100,12945,18273;18370;21875,31755,1,0,2,0,3
46786,100,12946,18276;21801,31755,1,0,1,0,2
46787,100,12947,18285,31755,0,0,1,0,1
46788,100,12948,18698,31755,0,0,1,0,1
46789,100,12949,18215;18303;21297;21645;21708,31755,1,2,2,0,5
46790,100,12950,18395;20936;21226;22059,31755,1,2,1,0,4
46791,100,12951,18396;18717,31755,0,0,2,0,2
46792,100,12952,18486;21416;21702;22011,31755,2,1,1,0,4
46793,100,12953,18214;18425;20944;21929,31755,1,1,2,0,4
46794,100,12954,18385;18426;21946,31755,1,0,2,0,3
46795,100,12955,18328;18427;21405;21434,31755,0,2,2,0,4
46796,100,12956,18223;18434;21768,31755,1,0,2,0,3
46797,100,12957,18492;18577;20819;20950;20969,31755,0,3,2,0,5
46798,100,12958,18507;18636;21375,31755,0,1,2,0,3
46799,100,12959,18149;18513;21052;21504,31755,0,2,2,0,4
46800,100,12960,18495;18522;21706,31755,1,0,2,0,3
46801,100,12961,18779;18861;20782;22063,31755,1,1,2,0,4
46802,100,12962,18437;18527,31755,0,0,2,0,2
46803,100,12963,13320,32120,0,0,0,1,1
46804,100,12965,13572,32120,0,0,0,1,1
46805,100,12966,13852,32120,0,0,0,1,1
46806,100,12968,13931,32120,0,0,0,1,1
46807,100,12969,13877,32120,0,0,0,1,1
46808,100,12975,14597,32120,0,0,0,1,1
46809,100,12976,14953,32120,0,0,1,0,1
46810,100,12980,15194,32120,0,0,1,0,1
46811,100,12983,15671,32120,0,0,1,0,1
46812,100,12989,15748;15980,32120,0,0,2,0,2
46813,100,12991,16322,32120,0,0,1,0,1
46814,100,12996,15783;15814,32120,0,0,2,0,2
46815,100,13002,16311;16495,32120,0,0,2,0,2
46816,100,13005,16423,32120,0,0,1,0,1
46817,100,13006,16973,32120,0,0,1,0,1
46818,100,13007,16738;17137;20857,32120,0,1,2,0,3
46819,100,13008,17226;21205,32120,0,1,1,0,2
46820,100,13010,16974,32120,0,0,1,0,1
46821,100,13015,17258;17475,32120,0,0,2,0,2
46822,100,13017,17516,32120,0,0,1,0,1
46823,100,13019,18150;18166,32120,0,0,2,0,2
46824,100,13020,18129;21149,32120,0,1,1,0,2
46825,100,13023,17922,32120,0,0,1,0,1
46826,100,13024,17949;18083;21410;22033,32120,1,1,2,0,4
46827,100,13025,17671;17975;21187;22002,32120,1,1,2,0,4
46828,100,13026,17980;18148;20951;21043;21233,32120,0,3,2,0,5
46829,100,13027,17619;17896,32120,0,0,2,0,2
46830,100,13028,17770;17987;20966;21109,32120,0,2,2,0,4
46831,100,13029,18022;18263;21522,32120,0,1,2,0,3
46832,100,13030,17591;18045;20878;21154,32120,0,2,2,0,4
46833,100,13031,18043;18062;21079;21906,32120,1,1,2,0,4
46834,100,13032,18095;18359;21136;21378;21916,32120,1,2,2,0,5
46835,100,13033,17850;18257;22012;22194,32120,2,0,2,0,4
46836,100,13034,18203,32120,0,0,1,0,1
46837,100,13036,18284;18746,32120,0,0,2,0,2
46838,100,13037,18195;18502;21181;21551;21747;22047,32120,2,2,2,0,6
46839,100,13038,18206;18784;21121;21322;21735,32120,1,2,2,0,5
46840,100,13039,17723;18228;21424,32120,0,1,2,0,3
46841,100,13040,18296;18702;22223,32120,1,0,2,0,3
46842,100,13041,18298;18355;21926,32120,1,0,2,0,3
46843,100,13042,18356;18380;21584;21788,32120,1,1,2,0,4
46844,100,13043,18135;18278;21670;21981,32120,2,0,2,0,4
46845,100,13044,18634;21086;21596;21945,32120,1,2,1,0,4
46846,100,13045,18139;18413;21553,32120,0,1,2,0,3
46847,100,13046,18040;18421;21593;21903;22089,32120,2,1,2,0,5
46848,100,13047,18428;18611;21077;22217,32120,1,1,2,0,4
46849,100,13048,18439;18821;22107,32120,1,0,2,0,3
46850,100,13049,18441;18699,32120,0,0,2,0,2
46851,100,13050,18443;21671,32120,1,0,1,0,2
46852,100,13051,18453;18550;21020;21236;21389;21821;22151,32120,2,3,2,0,7
46853,100,13052,17710;18478;20958;22208,32120,1,1,2,0,4
46854,100,13053,18497;18519;21357;21975,32120,1,1,2,0,4
46855,100,13054,18530;18797;21059;22100;22232,32120,2,1,2,0,5
46856,100,13055,17965;18533;21332;21632;21851,32120,1,2,2,0,5
46857,100,13056,18547;18560;21995,32120,1,0,2,0,3
46858,100,13057,18562;18971;20943;21034;22238,32120,1,2,2,0,5
46859,100,13058,17918;18685;21016;21300;22147,32120,1,2,2,0,5
46860,100,13059,18578;18686;22222,32120,1,0,2,0,3
46861,100,13060,18306;18601;21028,32120,0,1,2,0,3
46862,100,13061,18614;18772;21035;22028,32120,1,1,2,0,4
46863,100,13062,18594;18625;21278;21540;21887,32120,1,2,2,0,5
46864,100,13063,13576,32485,0,0,0,1,1
46865,100,13065,13773,32485,0,0,0,1,1
46866,100,13067,12985,32485,0,0,0,1,1
46867,100,13068,13895,32485,0,0,0,1,1
46868,100,13070,13105,32485,0,0,0,1,1
46869,100,13071,14167,32485,0,0,0,1,1
46870,100,13072,14055;14185,32485,0,0,0,2,2
46871,100,13075,13914,32485,0,0,0,1,1
46872,100,13079,14795;15291,32485,0,0,2,0,2
46873,100,13080,14733;15059,32485,0,0,2,0,2
46874,100,13081,14689,32485,0,0,1,0,1
46875,100,13083,15295;15772,32485,0,0,2,0,2
46876,100,13085,14949,32485,0,0,1,0,1
46877,100,13087,15866;16393,32485,0,0,2,0,2
46878,100,13090,14969;15262,32485,0,0,2,0,2
46879,100,13096,16190,32485,0,0,1,0,1
46880,100,13098,15907,32485,0,0,1,0,1
46881,100,13102,16672,32485,0,0,1,0,1
46882,100,13103,16545;16696,32485,0,0,2,0,2
46883,100,13105,16870,32485,0,0,1,0,1
46884,100,13108,17072;17452;20962,32485,0,1,2,0,3
46885,100,13110,17442;17661;21298;21625;21879,32485,1,2,2,0,5
46886,100,13111,17034;17618;21074,32485,0,1,2,0,3
46887,100,13112,17416;17590;21460,32485,0,1,2,0,3
46888,100,13113,17792;18071;21494;21616;22186,32485,1,2,2,0,5
46889,100,13114,17414;17587;21362,32485,0,1,2,0,3
46890,100,13115,17673,32485,0,0,1,0,1
46891,100,13116,17698;17851;21120,32485,0,1,2,0,3
46892,100,13117,17743,32485,0,0,1,0,1
46893,100,13118,17764,32485,0,0,1,0,1
46894,100,13120,17811;18358;21725;21973;22203,32485,3,0,2,0,5
46895,100,13121,17569;17813;21395,32485,0,1,2,0,3
46896,100,13122,17602;18072;21088,32485,0,1,2,0,3
46897,100,13123,17893;18212;21613;22040,32485,1,1,2,0,4
46898,100,13124,17905;21356,32485,0,1,1,0,2
46899,100,13125,17964;18168;21978,32485,1,0,2,0,3
46900,100,13126,18021;18410;21266;21904,32485,1,1,2,0,4
46901,100,13127,18032;18039;21286;21661;22183,32485,1,2,2,0,5
46902,100,13128,18467;21472,32485,0,1,1,0,2
46903,100,13129,18404,32485,0,0,1,0,1
46904,100,13130,18133;18744;22039;22227,32485,2,0,2,0,4
46905,100,13131,18248;18350;22023;22114,32485,2,0,2,0,4
46906,100,13132,18260,32485,0,0,1,0,1
46907,100,13133,18309;18628;21252;22058,32485,1,1,2,0,4
46908,100,13134,18163;21198,32485,0,1,1,0,2
46909,100,13135,18400;21714,32485,1,0,1,0,2
46910,100,13136,18011;18334;21345;21695,32485,1,1,2,0,4
46911,100,13137,18269;18538;21056;21933;22091,32485,2,1,2,0,5
46912,100,13138,18575;21071;21331;21810,32485,1,2,1,0,4
46913,100,13139,18417;18910;21100;21386;21813,32485,1,2,2,0,5
46914,100,13140,18243;18438;21709,32485,1,0,2,0,3
46915,100,13141,18477;18769;21394;21787,32485,1,1,2,0,4
46916,100,13142,18191;18479;21911,32485,1,0,2,0,3
46917,100,13143,18485;18915;21192;21430,32485,0,2,2,0,4
46918,100,13144,18491;21861,32485,1,0,1,0,2
46919,100,13145,18496;18676;21316;21627,32485,0,2,2,0,4
46920,100,13146,18501;19012,32485,0,0,2,0,2
46921,100,13147,18510;18720;21417;21769;22211,32485,2,1,2,0,5
46922,100,13148,18382;18512;21018;21436,32485,0,2,2,0,4
46923,100,13149,18259;18520;21265;21499;21773,32485,1,2,2,0,5
46924,100,13150,18524,32485,0,0,1,0,1
46925,100,13151,18580;18951;21649;21790;22236,32485,2,1,2,0,5
46926,100,13152,18393;21279;21348,32485,0,2,1,0,3
46927,100,13153,18723;18968;20995;21379;21900,32485,1,2,2,0,5
46928,100,13154,18638;18941;20673;21176;21291;21426,32485,0,4,2,0,6
46929,100,13155,18641;18877;22081,32485,1,0,2,0,3
46930,100,13156,18615;18643,32485,0,0,2,0,2
46931,100,13157,18555;18655;21439;21598;21920,32485,1,2,2,0,5
46932,100,13158,18657;18778;21959;22231,32485,2,0,2,0,4
46933,100,13159,18662;18706;21853;22106,32485,2,0,2,0,4
46934,100,13160,18683;18714;21446;21839,32485,1,1,2,0,4
46935,100,13161,18574;18721,32485,0,0,2,0,2
46936,100,13162,18727;19057;21207,32485,0,1,2,0,3
46937,100,13163,18739;19090;21155;21313,32485,0,2,2,0,4
46938,100,13164,18964;22095,32485,1,0,1,0,2
46939,100,13165,13876,32850,0,0,0,1,1
46940,100,13166,13894,32850,0,0,0,1,1
46941,100,13167,13925,32850,0,0,0,1,1
46942,100,13168,14070,32850,0,0,0,1,1
46943,100,13169,14146;14428,32850,0,0,0,2,2
46944,100,13170,14290,32850,0,0,0,1,1
46945,100,13171,14461,32850,0,0,0,1,1
46946,100,13172,13469,32850,0,0,0,1,1
46947,100,13174,14490,32850,0,0,0,1,1
46948,100,13175,14237,32850,0,0,0,1,1
46949,100,13178,15287,32850,0,0,1,0,1
46950,100,13179,14788;14875,32850,0,0,2,0,2
46951,100,13182,14419;14545,32850,0,0,0,2,2
46952,100,13183,14534,32850,0,0,0,1,1
46953,100,13184,15306,32850,0,0,1,0,1
46954,100,13185,15715,32850,0,0,1,0,1
46955,100,13187,15840;16148,32850,0,0,2,0,2
46956,100,13188,16056;16431,32850,0,0,2,0,2
46957,100,13189,15894,32850,0,0,1,0,1
46958,100,13191,16073;16295,32850,0,0,2,0,2
46959,100,13192,16527,32850,0,0,1,0,1
46960,100,13193,16219,32850,0,0,1,0,1
46961,100,13203,17002,32850,0,0,1,0,1
46962,100,13205,17047,32850,0,0,1,0,1
46963,100,13206,17148;17379;21218;21547,32850,0,2,2,0,4
46964,100,13210,17349;17568;21538;21834,32850,1,1,2,0,4
46965,100,13211,17638;18026;22084,32850,1,0,2,0,3
46966,100,13214,17678;18205;21836,32850,1,0,2,0,3
46967,100,13216,17752;18198;21792,32850,1,0,2,0,3
46968,100,13217,17816;18315;22060,32850,1,0,2,0,3
46969,100,13218,17892;18211;22119,32850,1,0,2,0,3
46970,100,13219,17800;17923;21254;21573,32850,0,2,2,0,4
46971,100,13220,18104;18498;21909;22209,32850,2,0,2,0,4
46972,100,13222,17973;18403;21931,32850,1,0,2,0,3
46973,100,13223,17989;18108;21090;21680;22188,32850,2,1,2,0,5
46974,100,13224,17621;18001;21483;21716;22108,32850,2,1,2,0,5
46975,100,13225,18033;18042;21409;21663,32850,0,2,2,0,4
46976,100,13226,18052;18076;21500;21964,32850,1,1,2,0,4
46977,100,13227,18238;21641,32850,0,1,1,0,2
46978,100,13228,18069;21459;21676,32850,1,1,1,0,3
46979,100,13229,18182;18644,32850,0,0,2,0,2
46980,100,13230,18234;21525;21822,32850,1,1,1,0,3
46981,100,13231,18591;18684,32850,0,0,2,0,2
46982,100,13232,17894;18282;21406;21630;22008;22198,32850,2,2,2,0,6
46983,100,13233,18031;18286;21391;22199,32850,1,1,2,0,4
46984,100,13234,17917;18310;21923,32850,1,0,2,0,3
46985,100,13235,18354;22030,32850,1,0,1,0,2
46986,100,13236,18330;18362;21516;21690,32850,1,1,2,0,4
46987,100,13237,18366,32850,0,0,1,0,1
46988,100,13238,18586;21204;21511;21876;22214,32850,2,2,1,0,5
46989,100,13239,18239;18433;21891,32850,1,0,2,0,3
46990,100,13240,18466;19038;21197;22093;22241,32850,2,1,2,0,5
46991,100,13241,18320;18567,32850,0,0,2,0,2
46992,100,13242,18472;21669,32850,1,0,1,0,2
46993,100,13243,18490;19032;21274;21689,32850,1,1,2,0,4
46994,100,13244,18525;21869;22102,32850,2,0,1,0,3
46995,100,13245,18292;18962,32850,0,0,2,0,2
46996,100,13246,18201;18570;21897,32850,1,0,2,0,3
46997,100,13247,18590;18903,32850,0,0,2,0,2
46998,100,13248,18352;18599;21330;21921,32850,1,1,2,0,4
46999,100,13249,18600;18793;22126,32850,1,0,2,0,3
47000,100,13250,18627;18692;21231;21589,32850,0,2,2,0,4
47001,100,13251,18648;18890,32850,0,0,2,0,2
47002,100,13252,17994;18671;22057,32850,1,0,2,0,3
47003,100,13253,18923;18952;21210;21457,32850,0,2,2,0,4
47004,100,13254,18680;21248;21723;21902,32850,2,1,1,0,4
47005,100,13255,18682;18691;21219;21766,32850,1,1,2,0,4
47006,100,13256,18571;18704,32850,0,0,2,0,2
47007,100,13257,18963,32850,0,0,1,0,1
47008,100,13258,18713;19006;21104,32850,0,1,2,0,3
47009,100,13259,18482;18715;21201;21393;22157,32850,1,2,2,0,5
47010,100,13260,18766;18838;21076,32850,0,1,2,0,3
47011,100,13261,18770;21151;22229,32850,1,1,1,0,3
47012,100,13262,18774;19206;21244,32850,0,1,2,0,3
47013,100,13263,18551;18823;21091;21812;21942,32850,2,1,2,0,5
47014,100,13264,18846;18980,32850,0,0,2,0,2
47015,100,13265,18853;19151;21309;22044,32850,1,1,2,0,4
47016,100,13266,18849;21802,32850,1,0,1,0,2
47017,100,13267,13994,33215,0,0,0,1,1
47018,100,13268,14145,33215,0,0,0,1,1
47019,100,13269,13827,33215,0,0,0,1,1
47020,100,13270,14533;14693,33215,0,0,1,1,2
47021,100,13271,14241,33215,0,0,0,1,1
47022,100,13273,14930,33215,0,0,1,0,1
47023,100,13275,14711,33215,0,0,1,0,1
47024,100,13276,14550;14660,33215,0,0,1,1,2
47025,100,13277,14654,33215,0,0,0,1,1
47026,100,13278,15218,33215,0,0,1,0,1
47027,100,13280,15190,33215,0,0,1,0,1
47028,100,13283,15383,33215,0,0,1,0,1
47029,100,13284,15505,33215,0,0,1,0,1
47030,100,13288,15849,33215,0,0,1,0,1
47031,100,13292,15602;16051,33215,0,0,2,0,2
47032,100,13293,16078;16396,33215,0,0,2,0,2
47033,100,13301,16697,33215,0,0,1,0,1
47034,100,13304,16463;17083,33215,0,0,2,0,2
47035,100,13305,16953;17321;21215;21604,33215,0,2,2,0,4
47036,100,13306,16751,33215,0,0,1,0,1
47037,100,13308,17547;18231;21502;22145,33215,1,1,2,0,4
47038,100,13309,17531;17854;21325;21797,33215,1,1,2,0,4
47039,100,13310,17575,33215,0,0,1,0,1
47040,100,13311,17856;18344;19681;21311;21608;21779,33215,1,2,3,0,6
47041,100,13312,17728,33215,0,0,1,0,1
47042,100,13313,17797;18371;21789,33215,1,0,2,0,3
47043,100,13314,18134;18545;21564,33215,0,1,2,0,3
47044,100,13315,18247;18345;21485,33215,0,1,2,0,3
47045,100,13316,18253;18398;21636;22193,33215,1,1,2,0,4
47046,100,13317,18143;18264;21492,33215,0,1,2,0,3
47047,100,13318,18316;18564;22143,33215,1,0,2,0,3
47048,100,13319,18337;18604;21257,33215,0,1,2,0,3
47049,100,13320,18340;18788;21652;21954,33215,1,1,2,0,4
47050,100,13322,18596;19010,33215,0,0,2,0,2
47051,100,13323,18416;18557;21367;21770,33215,1,1,2,0,4
47052,100,13324,18449;19021;21242;21951,33215,1,1,2,0,4
47053,100,13325,18446;18451;21654;21844,33215,1,1,2,0,4
47054,100,13326,18552;18654;21888;21969,33215,2,0,2,0,4
47055,100,13327,17956,33215,0,0,1,0,1
47056,100,13328,18299;18617;21726,33215,1,0,2,0,3
47057,100,13329,18906;21438;21590,33215,0,2,1,0,3
47058,100,13331,18645;21270;21575;22130,33215,1,2,1,0,4
47059,100,13332,19125;19201;21301;21320;21675;22146;22247,33215,3,2,2,0,7
47060,100,13333,18707;18848;21740;21976,33215,2,0,2,0,4
47061,100,13334,18726;19275,33215,0,0,2,0,2
47062,100,13335,18935;21578;21816,33215,1,1,1,0,3
47063,100,13336,18750;18929;22160,33215,1,0,2,0,3
47064,100,13337,18756;19315;21321;21762,33215,1,1,2,0,4
47065,100,13338,18764;19121,33215,0,0,2,0,2
47066,100,13339,18914;21427;21991,33215,1,1,1,0,3
47067,100,13340,18780;18896;22090;22234,33215,2,0,2,0,4
47068,100,13341,18786;19205;22129,33215,1,0,2,0,3
47069,100,13342,18794;18922;21615,33215,0,1,2,0,3
47070,100,13343,19027,33215,0,0,1,0,1
47071,100,13344,18831;19233;21287;21541,33215,0,2,2,0,4
47072,100,13345,18835;19087;22026,33215,1,0,2,0,3
47073,100,13346,19168;21234;21761;22140,33215,2,1,1,0,4
47074,100,13347,18875,33215,0,0,1,0,1
47075,100,13348,18387;18886;21193;21535;22020,33215,1,2,2,0,5
47076,100,13349,18785;18928;22163,33215,1,0,2,0,3
47077,100,13350,18913;18965;21748;21950,33215,2,0,2,0,4
47078,100,13351,18957;22101,33215,1,0,1,0,2
47079,100,13352,18981;19299;21400;21440,33215,0,2,2,0,4
47080,100,13354,14154,33580,0,0,0,1,1
47081,100,13355,13854,33580,0,0,0,1,1
47082,100,13356,14301,33580,0,0,0,1,1
47083,100,13357,14124,33580,0,0,0,1,1
47084,100,13358,14465;15514,33580,0,0,1,1,2
47085,100,13361,14306;14695,33580,0,0,1,1,2
47086,100,13362,14302,33580,0,0,0,1,1
47087,100,13367,14308,33580,0,0,0,1,1
47088,100,13368,15265,33580,0,0,1,0,1
47089,100,13374,15578;15635,33580,0,0,2,0,2
47090,100,13375,15795,33580,0,0,1,0,1
47091,100,13376,14944,33580,0,0,1,0,1
47092,100,13379,15770,33580,0,0,1,0,1
47093,100,13382,16061;16347,33580,0,0,2,0,2
47094,100,13384,15812,33580,0,0,1,0,1
47095,100,13386,15924,33580,0,0,1,0,1
47096,100,13387,15739,33580,0,0,1,0,1
47097,100,13389,16453,33580,0,0,1,0,1
47098,100,13391,16556,33580,0,0,1,0,1
47099,100,13395,16387;17055,33580,0,0,2,0,2
47100,100,13398,16837,33580,0,0,1,0,1
47101,100,13401,17273,33580,0,0,1,0,1
47102,100,13403,16989;17057,33580,0,0,2,0,2
47103,100,13404,16935,33580,0,0,1,0,1
47104,100,13405,17406,33580,0,0,1,0,1
47105,100,13407,18015;21552;22181,33580,1,1,1,0,3
47106,100,13408,17314;17363,33580,0,0,2,0,2
47107,100,13410,17627;18312;21380;21798;22142,33580,2,1,2,0,5
47108,100,13412,17694,33580,0,0,1,0,1
47109,100,13413,18020;21765;22112,33580,2,0,1,0,3
47110,100,13415,17880;17945,33580,0,0,2,0,2
47111,100,13416,17483;17908,33580,0,0,2,0,2
47112,100,13417,17603,33580,0,0,1,0,1
47113,100,13418,17665;18038;21508;22154,33580,1,1,2,0,4
47114,100,13419,18130;18430;22048,33580,1,0,2,0,3
47115,100,13420,17943;18146,33580,0,0,2,0,2
47116,100,13421,17689,33580,0,0,1,0,1
47117,100,13422,17889;18183;21503;21799,33580,1,1,2,0,4
47118,100,13423,18174;18202;21568,33580,0,1,2,0,3
47119,100,13424,18225,33580,0,0,1,0,1
47120,100,13425,17822;18229;21987;22148,33580,2,0,2,0,4
47121,100,13426,17997;18304;21490;21947,33580,1,1,2,0,4
47122,100,13427,18308;18379;22136,33580,1,0,2,0,3
47123,100,13428,17796;18314;21684,33580,1,0,2,0,3
47124,100,13429,18474;18565;21588,33580,0,1,2,0,3
47125,100,13430,18082,33580,0,0,1,0,1
47126,100,13431,18053;18440;22132,33580,1,0,2,0,3
47127,100,13432,18870,33580,0,0,1,0,1
47128,100,13433,18506;18868;21744,33580,1,0,2,0,3
47129,100,13434,18514;18588;21359;21449;21655;22216,33580,1,3,2,0,6
47130,100,13435,18531;18834;21364,33580,0,1,2,0,3
47131,100,13436,18561;18606,33580,0,0,2,0,2
47132,100,13437,18569;19392,33580,0,0,2,0,2
47133,100,13438,19109,33580,0,0,1,0,1
47134,100,13439,18607;19041;21358;21855,33580,1,1,2,0,4
47135,100,13440,18748;18812;21468;21912,33580,1,1,2,0,4
47136,100,13441,18761;19124;21372;21583;22131,33580,1,2,2,0,5
47137,100,13442,18783;19354;21361,33580,0,1,2,0,3
47138,100,13443,18810;19269,33580,0,0,2,0,2
47139,100,13444,18609;18833;22046;22233,33580,2,0,2,0,4
47140,100,13445,18819;18867;21814;22110,33580,2,0,2,0,4
47141,100,13446,18893;18954;22237,33580,1,0,2,0,3
47142,100,13447,18904;19282;21428;21665,33580,0,2,2,0,4
47143,100,13448,18759;18907;21960;22228,33580,2,0,2,0,4
47144,100,13449,18392;18918,33580,0,0,2,0,2
47145,100,13450,18934;19185;21601;22098,33580,1,1,2,0,4
47146,100,13451,18939;18988;21697;21852,33580,2,0,2,0,4
47147,100,13452,18943;19298,33580,0,0,2,0,2
47148,100,13453,18958;19325;21943,33580,1,0,2,0,3
47149,100,13454,18537;19070;21447,33580,0,1,2,0,3
47150,100,13455,18693;18995;22070,33580,1,0,2,0,3
47151,100,13456,18773;19013,33580,0,0,2,0,2
47152,100,13457,19242,33580,0,0,1,0,1
47153,100,13458,18818;19017;22111;22239,33580,2,0,2,0,4
47154,100,13459,18660;19035;21618;22128,33580,1,1,2,0,4
47155,100,13460,18402;19040;21368;21643,33580,0,2,2,0,4
47156,100,13461,19093;19366,33580,0,0,2,0,2
47157,100,13462,19104;19435;21354;21444;21591;21963,33580,1,3,2,0,6
47158,100,13464,14407,33945,0,0,0,1,1
47159,100,13465,14341,33945,0,0,0,1,1
47160,100,13467,14577,33945,0,0,0,1,1
47161,100,13468,14157,33945,0,0,0,1,1
47162,100,13470,14648,33945,0,0,0,1,1
47163,100,13471,14399,33945,0,0,0,1,1
47164,100,13472,14652,33945,0,0,0,1,1
47165,100,13476,15142;15381,33945,0,0,2,0,2
47166,100,13477,15612,33945,0,0,1,0,1
47167,100,13478,15804,33945,0,0,1,0,1
47168,100,13479,15825,33945,0,0,1,0,1
47169,100,13482,15885,33945,0,0,1,0,1
47170,100,13486,16249,33945,0,0,1,0,1
47171,100,13487,15946,33945,0,0,1,0,1
47172,100,13490,15815,33945,0,0,1,0,1
47173,100,13492,16348;16444,33945,0,0,2,0,2
47174,100,13493,16916,33945,0,0,1,0,1
47175,100,13495,17131,33945,0,0,1,0,1
47176,100,13496,17174;17281;21498,33945,0,1,2,0,3
47177,100,13498,16840,33945,0,0,1,0,1
47178,100,13499,17308;17415,33945,0,0,2,0,2
47179,100,13500,17123,33945,0,0,1,0,1
47180,100,13502,17459;17676;21489;21977,33945,1,1,2,0,4
47181,100,13505,17530,33945,0,0,1,0,1
47182,100,13506,17600;21425;22094,33945,1,1,1,0,3
47183,100,13508,17809;21558,33945,0,1,1,0,2
47184,100,13509,17928;18493,33945,0,0,2,0,2
47185,100,13510,17691;21577,33945,0,1,1,0,2
47186,100,13511,17751,33945,0,0,1,0,1
47187,100,13512,18065;18454,33945,0,0,2,0,2
47188,100,13514,18115;18327;21937,33945,1,0,2,0,3
47189,100,13515,18138;18724,33945,0,0,2,0,2
47190,100,13516,17979;18181;21854,33945,1,0,2,0,3
47191,100,13517,18319;18447,33945,0,0,2,0,2
47192,100,13518,18324;18488;21602;21940,33945,1,1,2,0,4
47193,100,13519,18325;21619;21738;22201,33945,2,1,1,0,4
47194,100,13520,18085;18401;21736;22207,33945,2,0,2,0,4
47195,100,13521,18190;18414;22038,33945,1,0,2,0,3
47196,100,13522,18455;18805;21614,33945,0,1,2,0,3
47197,100,13523,18254;18460,33945,0,0,2,0,2
47198,100,13524,18461;18665;21586,33945,0,1,2,0,3
47199,100,13526,18399;18521;21803;22139,33945,2,0,2,0,4
47200,100,13527,18544,33945,0,0,1,0,1
47201,100,13528,18268;18554,33945,0,0,2,0,2
47202,100,13529,17849;18080;21983;22174,33945,2,0,2,0,4
47203,100,13530,18122;18585,33945,0,0,2,0,2
47204,100,13531,18295;18589,33945,0,0,2,0,2
47205,100,13532,18481;18595,33945,0,0,2,0,2
47206,100,13533,18489;18608,33945,0,0,2,0,2
47207,100,13534,18037;18623;21429;22218,33945,1,1,2,0,4
47208,100,13535,18701,33945,0,0,1,0,1
47209,100,13536,18956,33945,0,0,1,0,1
47210,100,13537,18716;18950;21456;21831,33945,1,1,2,0,4
47211,100,13539,18471;18758;21893,33945,1,0,2,0,3
47212,100,13540,18347;18775;21475;21685;22230,33945,2,1,2,0,5
47213,100,13541,18789;19318;21556;21845,33945,1,1,2,0,4
47214,100,13542,18556;18795;21587,33945,0,1,2,0,3
47215,100,13543,18771;18801;21480;22158,33945,1,1,2,0,4
47216,100,13544,18806;19195;21574;21804,33945,1,1,2,0,4
47217,100,13545,18837,33945,0,0,1,0,1
47218,100,13546,18842;18917;22066,33945,1,0,2,0,3
47219,100,13547,18587;18858;21866;22215,33945,2,0,2,0,4
47220,100,13548,18860;19073;21469;22133,33945,1,1,2,0,4
47221,100,13549,18888;19172;21734,33945,1,0,2,0,3
47222,100,13550,18889;19400,33945,0,0,2,0,2
47223,100,13551,19050;21501,33945,0,1,1,0,2
47224,100,13552,18921;19111;21696;21922,33945,2,0,2,0,4
47225,100,13553,18924;20345;21530;21941;22235,33945,2,2,1,0,5
47226,100,13554,18541;18944,33945,0,0,2,0,2
47227,100,13555,19164;21966,33945,1,0,1,0,2
47228,100,13556,18966;18978;22156,33945,1,0,2,0,3
47229,100,13557,18700;19002,33945,0,0,2,0,2
47230,100,13558,19019;19193,33945,0,0,2,0,2
47231,100,13559,19024;19100,33945,0,0,2,0,2
47232,100,13560,19552,33945,0,0,1,0,1
47233,100,13561,19376;21999,33945,1,0,1,0,2
47234,100,13562,18719;18982;21889;21944,33945,2,0,2,0,4
47235,100,13563,19080;19391,33945,0,0,2,0,2
47236,100,13564,19084;21453;21662,33945,0,2,1,0,3
47237,100,13565,18933;19086,33945,0,0,2,0,2
47238,100,13566,18664;19096,33945,0,0,2,0,2
47239,100,13567,18997;19098;21507,33945,0,1,2,0,3
47240,100,13568,18809;19099;22074,33945,1,0,2,0,3
47241,100,13569,19102;19427,33945,0,0,2,0,2
47242,100,13570,19067;19115;22243,33945,1,0,2,0,3
47243,100,13571,19141;19464,33945,0,0,2,0,2
47244,100,13572,19142;19378;21470;22072,33945,1,1,2,0,4
47245,100,13573,19173;21495;21767;22249,33945,2,1,1,0,4
47246,100,13574,19175;19434;21783;22024,33945,2,0,2,0,4
47247,100,13575,19550;19798;21755,33945,1,0,2,0,3
47248,100,13576,14466,34310,0,0,0,1,1
47249,100,13577,14087,34310,0,0,0,1,1
47250,100,13581,14942,34310,0,0,1,0,1
47251,100,13585,15152,34310,0,0,1,0,1
47252,100,13586,15412,34310,0,0,1,0,1
47253,100,13588,15252,34310,0,0,1,0,1
47254,100,13589,15487,34310,0,0,1,0,1
47255,100,13591,15702,34310,0,0,1,0,1
47256,100,13595,15896,34310,0,0,1,0,1
47257,100,13596,15860,34310,0,0,1,0,1
47258,100,13597,16075,34310,0,0,1,0,1
47259,100,13598,16419,34310,0,0,1,0,1
47260,100,13599,16086,34310,0,0,1,0,1
47261,100,13601,16725,34310,0,0,1,0,1
47262,100,13604,17008,34310,0,0,1,0,1
47263,100,13605,17040,34310,0,0,1,0,1
47264,100,13608,16898,34310,0,0,1,0,1
47265,100,13609,16626,34310,0,0,1,0,1
47266,100,13610,17246;17993,34310,0,0,2,0,2
47267,100,13611,17018;17169;22004,34310,1,0,2,0,3
47268,100,13612,17027;17404;21592,34310,0,1,2,0,3
47269,100,13613,17487,34310,0,0,1,0,1
47270,100,13614,17153,34310,0,0,1,0,1
47271,100,13616,17473,34310,0,0,1,0,1
47272,100,13617,17755;18526;21678,34310,1,0,2,0,3
47273,100,13618,17592;17805;21639;22045,34310,1,1,2,0,4
47274,100,13619,17883;18137,34310,0,0,2,0,2
47275,100,13621,17899;18030;21644;21781,34310,1,1,2,0,4
47276,100,13622,17974;18153,34310,0,0,2,0,2
47277,100,13623,17846;17955;22153,34310,1,0,2,0,3
47278,100,13624,17826;17992;21606,34310,0,1,2,0,3
47279,100,13625,17793;18003,34310,0,0,2,0,2
47280,100,13626,17740,34310,0,0,1,0,1
47281,100,13627,17806;18051;21733;22022,34310,2,0,2,0,4
47282,100,13628,18099;18534;21774;22080,34310,2,0,2,0,4
47283,100,13629,18363;21569;21749,34310,1,1,1,0,3
47284,100,13630,17700,34310,0,0,1,0,1
47285,100,13631,18293;18528;21701,34310,1,0,2,0,3
47286,100,13632,17912;18297;21707,34310,1,0,2,0,3
47287,100,13633,18073,34310,0,0,1,0,1
47288,100,13634,18462;18670;22077,34310,1,0,2,0,3
47289,100,13635,18376;18464;22025,34310,1,0,2,0,3
47290,100,13637,18584;18687,34310,0,0,2,0,2
47291,100,13638,18642;21555,34310,0,1,1,0,2
47292,100,13639,18612;18647;22141,34310,1,0,2,0,3
47293,100,13640,18659;18807;21862,34310,1,0,2,0,3
47294,100,13641,18689,34310,0,0,1,0,1
47295,100,13642,18679;19030,34310,0,0,2,0,2
47296,100,13643,18697,34310,0,0,1,0,1
47297,100,13644,18405;18741;21998,34310,1,0,2,0,3
47298,100,13645,18763;19083,34310,0,0,2,0,2
47299,100,13646,18653;18790;22122,34310,1,0,2,0,3
47300,100,13647,18808;18830;22144,34310,1,0,2,0,3
47301,100,13648,18745;18814,34310,0,0,2,0,2
47302,100,13649,18871;19230,34310,0,0,2,0,2
47303,100,13650,18891,34310,0,0,1,0,1
47304,100,13651,18839;18911,34310,0,0,2,0,2
47305,100,13652,18936;19280;22034,34310,1,0,2,0,3
47306,100,13653,18948;19129;21971,34310,1,0,2,0,3
47307,100,13654,18953,34310,0,0,1,0,1
47308,100,13655,18960;19537;21605,34310,0,1,2,0,3
47309,100,13656,18708;19036,34310,0,0,2,0,2
47310,100,13657,19069,34310,0,0,1,0,1
47311,100,13658,18985;19053;21924,34310,1,0,2,0,3
47312,100,13659,19016;19117;21758,34310,1,0,2,0,3
47313,100,13660,18829;19039;21777;22017,34310,2,0,2,0,4
47314,100,13661,18909,34310,0,0,1,0,1
47315,100,13662,18776;19051;22000,34310,1,0,2,0,3
47316,100,13663,19055;19163,34310,0,0,2,0,2
47317,100,13664,18991;19061;21693,34310,1,0,2,0,3
47318,100,13665,19089;19131;21823,34310,1,0,2,0,3
47319,100,13666,19107;19500;21546,34310,0,1,2,0,3
47320,100,13667,19108;19398,34310,0,0,2,0,2
47321,100,13669,19138;19145;21686;22125,34310,2,0,2,0,4
47322,100,13670,19159;19221,34310,0,0,2,0,2
47323,100,13671,19043;19169,34310,0,0,2,0,2
47324,100,13672,19180;19425;21650,34310,0,1,2,0,3
47325,100,13673,19202;19411;21611,34310,0,1,2,0,3
47326,100,13674,18885;19209;21703,34310,1,0,2,0,3
47327,100,13675,19120;19216;21840,34310,1,0,2,0,3
47328,100,13676,19219;19667;21752;22013,34310,2,0,2,0,4
47329,100,13677,19255;19448;21659;21989,34310,1,1,2,0,4
47330,100,13678,19178;19261;21985,34310,1,0,2,0,3
47331,100,13679,19518;21647,34310,0,1,1,0,2
47332,100,13680,19167;19272,34310,0,0,2,0,2
47333,100,13681,14725;14759,34675,0,0,2,0,2
47334,100,13682,14968,34675,0,0,1,0,1
47335,100,13683,14862,34675,0,0,1,0,1
47336,100,13684,14957,34675,0,0,1,0,1
47337,100,13685,15048,34675,0,0,1,0,1
47338,100,13686,15518,34675,0,0,1,0,1
47339,100,13688,15492,34675,0,0,1,0,1
47340,100,13690,15952,34675,0,0,1,0,1
47341,100,13692,16036;16161,34675,0,0,2,0,2
47342,100,13693,16256,34675,0,0,1,0,1
47343,100,13695,16141,34675,0,0,1,0,1
47344,100,13697,16266,34675,0,0,1,0,1
47345,100,13699,16710,34675,0,0,1,0,1
47346,100,13701,17043,34675,0,0,1,0,1
47347,100,13704,17271,34675,0,0,1,0,1
47348,100,13708,17712,34675,0,0,1,0,1
47349,100,13709,18089;18480;22096,34675,1,0,2,0,3
47350,100,13710,17669,34675,0,0,1,0,1
47351,100,13711,18301;18543;21763,34675,1,0,2,0,3
47352,100,13712,18317;18408;21674;21825,34675,2,0,2,0,4
47353,100,13713,18326,34675,0,0,1,0,1
47354,100,13714,18176,34675,0,0,1,0,1
47355,100,13716,18568;18876,34675,0,0,2,0,2
47356,100,13717,18476;18582,34675,0,0,2,0,2
47357,100,13718,18598,34675,0,0,1,0,1
47358,100,13719,18631;18919,34675,0,0,2,0,2
47359,100,13720,18384,34675,0,0,1,0,1
47360,100,13721,18695;18938,34675,0,0,2,0,2
47361,100,13722,18394;18703;21817,34675,1,0,2,0,3
47362,100,13723,18729;18736,34675,0,0,2,0,2
47363,100,13724,18742,34675,0,0,1,0,1
47364,100,13725,18751;19374;21925,34675,1,0,2,0,3
47365,100,13726,18752;19365,34675,0,0,2,0,2
47366,100,13727,19018;19258,34675,0,0,2,0,2
47367,100,13728,19247,34675,0,0,1,0,1
47368,100,13729,18856;18930;21759,34675,1,0,2,0,3
47369,100,13730,18593;18862;22134,34675,1,0,2,0,3
47370,100,13731,18884;19126;22248,34675,1,0,2,0,3
47371,100,13732,18961;18975;22006,34675,1,0,2,0,3
47372,100,13733,18973;18986,34675,0,0,2,0,2
47373,100,13734,18677;18992,34675,0,0,2,0,2
47374,100,13735,19068;19220,34675,0,0,2,0,2
47375,100,13736,19071;19503;22055,34675,1,0,2,0,3
47376,100,13737,18927;19114,34675,0,0,2,0,2
47377,100,13738,19147;19379,34675,0,0,2,0,2
47378,100,13739,19158;19436;21992,34675,1,0,2,0,3
47379,100,13740,19215;19438;21704;21917,34675,2,0,2,0,4
47380,100,13741,19232;19507,34675,0,0,2,0,2
47381,100,13742,19512;21811,34675,1,0,1,0,2
47382,100,13743,19082;19278,34675,0,0,2,0,2
47383,100,13744,19296;19419,34675,0,0,2,0,2
47384,100,13745,19307;19457,34675,0,0,2,0,2
47385,100,13746,19332;22019,34675,1,0,1,0,2
47386,100,13747,19353;19554,34675,0,0,2,0,2
47387,100,13748,19384,34675,0,0,1,0,1
47388,100,13749,19429;19433,34675,0,0,2,0,2
47389,100,13750,14673;15064,35040,0,0,2,0,2
47390,100,13751,14548,35040,0,0,0,1,1
47391,100,13753,14156,35040,0,0,0,1,1
47392,100,13754,14776,35040,0,0,1,0,1
47393,100,13755,15159,35040,0,0,1,0,1
47394,100,13756,14764,35040,0,0,1,0,1
47395,100,13757,15346,35040,0,0,1,0,1
47396,100,13758,15371,35040,0,0,1,0,1
47397,100,13760,15402;15523,35040,0,0,2,0,2
47398,100,13761,15558;15781,35040,0,0,2,0,2
47399,100,13763,15155,35040,0,0,1,0,1
47400,100,13764,15470;15568,35040,0,0,2,0,2
47401,100,13766,14775,35040,0,0,1,0,1
47402,100,13767,15695,35040,0,0,1,0,1
47403,100,13769,16089,35040,0,0,1,0,1
47404,100,13770,15774,35040,0,0,1,0,1
47405,100,13771,16182,35040,0,0,1,0,1
47406,100,13772,16264,35040,0,0,1,0,1
47407,100,13777,16691,35040,0,0,1,0,1
47408,100,13781,16810,35040,0,0,1,0,1
47409,100,13782,16821,35040,0,0,1,0,1
47410,100,13783,16874,35040,0,0,1,0,1
47411,100,13784,16790,35040,0,0,1,0,1
47412,100,13788,17368,35040,0,0,1,0,1
47413,100,13789,17397;17498,35040,0,0,2,0,2
47414,100,13790,16991,35040,0,0,1,0,1
47415,100,13793,17663;18066;21860;22050,35040,2,0,2,0,4
47416,100,13796,17881,35040,0,0,1,0,1
47417,100,13797,17925;18343;21915,35040,1,0,2,0,3
47418,100,13798,17971,35040,0,0,1,0,1
47419,100,13799,18213,35040,0,0,1,0,1
47420,100,13803,18123;18523;22135,35040,1,0,2,0,3
47421,100,13804,18184;18458;21880,35040,1,0,2,0,3
47422,100,13805,18219;18406,35040,0,0,2,0,2
47423,100,13806,18222;18432;21796,35040,1,0,2,0,3
47424,100,13807,18271;18622,35040,0,0,2,0,2
47425,100,13809,18172;18633,35040,0,0,2,0,2
47426,100,13811,18364;18470;21892;22010,35040,2,0,2,0,4
47427,100,13812,18484;18529,35040,0,0,2,0,2
47428,100,13814,18546;18610,35040,0,0,2,0,2
47429,100,13815,18618;19229;21993,35040,1,0,2,0,3
47430,100,13816,18925;19197;21872;22052,35040,2,0,2,0,4
47431,100,13817,18602;18667;22220,35040,1,0,2,0,3
47432,100,13818,18722,35040,0,0,1,0,1
47433,100,13819,18755;19091,35040,0,0,2,0,2
47434,100,13820,18787;19077;22083,35040,1,0,2,0,3
47435,100,13821,18845;19160,35040,0,0,2,0,2
47436,100,13822,18881;18901,35040,0,0,2,0,2
47437,100,13823,18613;18920,35040,0,0,2,0,2
47438,100,13824,19155;19521,35040,0,0,2,0,2
47439,100,13825,18979;19246,35040,0,0,2,0,2
47440,100,13826,18989,35040,0,0,1,0,1
47441,100,13827,18616;19011;21980,35040,1,0,2,0,3
47442,100,13828,19026;19360,35040,0,0,2,0,2
47443,100,13829,18976;19042;21841,35040,1,0,2,0,3
47444,100,13830,19494,35040,0,0,1,0,1
47445,100,13831,19049;19130,35040,0,0,2,0,2
47446,100,13832,19074;19157;22245,35040,1,0,2,0,3
47447,100,13833,18535;19112;22246,35040,1,0,2,0,3
47448,100,13834,19144;19638,35040,0,0,2,0,2
47449,100,13835,19152;19612;21805;22088,35040,2,0,2,0,4
47450,100,13836,18847;19196,35040,0,0,2,0,2
47451,100,13837,19210;19388,35040,0,0,2,0,2
47452,100,13838,19213,35040,0,0,1,0,1
47453,100,13839,19244;19406,35040,0,0,2,0,2
47454,100,13840,19273;19865,35040,0,0,2,0,2
47455,100,13841,19277;19495;21784,35040,1,0,2,0,3
47456,100,13842,19286;19382;21856;22104,35040,2,0,2,0,4
47457,100,13843,19288;19698,35040,0,0,2,0,2
47458,100,13844,19293;19424;22251,35040,1,0,2,0,3
47459,100,13845,18832;19303,35040,0,0,2,0,2
47460,100,13846,19123;19313;21829,35040,1,0,2,0,3
47461,100,13847,19317;21965;22079,35040,2,0,1,0,3
47462,100,13848,19785,35040,0,0,1,0,1
47463,100,13849,19294;19350,35040,0,0,2,0,2
47464,100,13850,19352;22254,35040,1,0,1,0,2
47465,100,13851,19214;19380,35040,0,0,2,0,2
47466,100,13852,19610;19853;22029,35040,1,0,2,0,3
47467,100,13853,19410;19561;21958,35040,1,0,2,0,3
47468,100,13854,19431;19781;21968;22064;22261,35040,3,0,2,0,5
47469,100,13855,19442;19837,35040,0,0,2,0,2
47470,100,13856,19449;19603,35040,0,0,2,0,2
47471,100,13857,19600,35040,0,0,1,0,1
47472,100,13858,19463;19675,35040,0,0,2,0,2
47473,100,13859,19472;19757,35040,0,0,2,0,2
47474,100,13860,19396;19474,35040,0,0,2,0,2
47475,100,13861,19767,35040,0,0,1,0,1
47476,100,13862,19483;19846;21907,35040,1,0,2,0,3
47477,100,13863,19407;19491;21877,35040,1,0,2,0,3
47478,100,13864,19529;21865,35040,1,0,1,0,2
47479,100,13865,19535;19619;21938,35040,1,0,2,0,3
47480,100,13866,19541;19708,35040,0,0,2,0,2
47481,100,13867,19467;19560;21848,35040,1,0,2,0,3
47482,100,13868,14932,35405,0,0,1,0,1
47483,100,13869,14947,35405,0,0,1,0,1
47484,100,13870,14748;15120,35405,0,0,2,0,2
47485,100,13871,14743;15452,35405,0,0,2,0,2
47486,100,13872,15272,35405,0,0,1,0,1
47487,100,13873,15157,35405,0,0,1,0,1
47488,100,13874,14421,35405,0,0,0,1,1
47489,100,13875,15283,35405,0,0,1,0,1
47490,100,13876,15477;15478,35405,0,0,2,0,2
47491,100,13877,15667,35405,0,0,1,0,1
47492,100,13878,15445;15792,35405,0,0,2,0,2
47493,100,13879,15926,35405,0,0,1,0,1
47494,100,13881,16102,35405,0,0,1,0,1
47495,100,13882,15956,35405,0,0,1,0,1
47496,100,13883,16137,35405,0,0,1,0,1
47497,100,13884,15418;15655,35405,0,0,2,0,2
47498,100,13885,16352,35405,0,0,1,0,1
47499,100,13886,16601,35405,0,0,1,0,1
47500,100,13887,16098,35405,0,0,1,0,1
47501,100,13888,15878,35405,0,0,1,0,1
47502,100,13890,16923,35405,0,0,1,0,1
47503,100,13891,16927,35405,0,0,1,0,1
47504,100,13893,16720,35405,0,0,1,0,1
47505,100,13894,17124,35405,0,0,1,0,1
47506,100,13895,17125,35405,0,0,1,0,1
47507,100,13896,17234,35405,0,0,1,0,1
47508,100,13897,17382,35405,0,0,1,0,1
47509,100,13898,17335;17375;22161,35405,1,0,2,0,3
47510,100,13899,17438,35405,0,0,1,0,1
47511,100,13901,17768,35405,0,0,1,0,1
47512,100,13902,17434,35405,0,0,1,0,1
47513,100,13903,17862,35405,0,0,1,0,1
47514,100,13905,17466;17970,35405,0,0,2,0,2
47515,100,13907,17441,35405,0,0,1,0,1
47516,100,13908,18017;21970;22182,35405,2,0,1,0,3
47517,100,13909,17799,35405,0,0,1,0,1
47518,100,13910,18236;21979,35405,1,0,1,0,2
47519,100,13911,18244,35405,0,0,1,0,1
47520,100,13912,18251;18619,35405,0,0,2,0,2
47521,100,13913,18281,35405,0,0,1,0,1
47522,100,13914,18185,35405,0,0,1,0,1
47523,100,13915,18117,35405,0,0,1,0,1
47524,100,13916,18412,35405,0,0,1,0,1
47525,100,13917,18459,35405,0,0,1,0,1
47526,100,13918,18388;18468,35405,0,0,2,0,2
47527,100,13919,18349;18517;22054,35405,1,0,2,0,3
47528,100,13920,18532;18757;22015,35405,1,0,2,0,3
47529,100,13921,18553;19044,35405,0,0,2,0,2
47530,100,13922,18579;19094,35405,0,0,2,0,2
47531,100,13923,18128,35405,0,0,1,0,1
47532,100,13924,18624;18718;21962,35405,1,0,2,0,3
47533,100,13925,18227;18626;21930;22219,35405,2,0,2,0,4
47534,100,13926,18629;19223,35405,0,0,2,0,2
47535,100,13927,18597;18735,35405,0,0,2,0,2
47536,100,13928,18796;19287,35405,0,0,2,0,2
47537,100,13929,18816;18882;22149,35405,1,0,2,0,3
47538,100,13930,18828,35405,0,0,1,0,1
47539,100,13931,18851,35405,0,0,1,0,1
47540,100,13932,18549;18652,35405,0,0,2,0,2
47541,100,13933,18728;19156,35405,0,0,2,0,2
47542,100,13934,18705,35405,0,0,1,0,1
47543,100,13935,19031,35405,0,0,1,0,1
47544,100,13936,18333;19037,35405,0,0,2,0,2
47545,100,13937,19047;19533,35405,0,0,2,0,2
47546,100,13938,19204;19327;21961,35405,1,0,2,0,3
47547,100,13939,19076,35405,0,0,1,0,1
47548,100,13940,18854;19194;22003,35405,1,0,2,0,3
47549,100,13941,19132;19662,35405,0,0,2,0,2
47550,100,13942,19161;19283,35405,0,0,2,0,2
47551,100,13943,18637;19192;22099,35405,1,0,2,0,3
47552,100,13944,19048,35405,0,0,1,0,1
47553,100,13945,19052;19231,35405,0,0,2,0,2
47554,100,13946,19063;19254,35405,0,0,2,0,2
47555,100,13947,19025;19285,35405,0,0,2,0,2
47556,100,13948,19292;19656,35405,0,0,2,0,2
47557,100,13949,19308;19422,35405,0,0,2,0,2
47558,100,13950,19266;19351;22075,35405,1,0,2,0,3
47559,100,13951,19137;19368,35405,0,0,2,0,2
47560,100,13952,19383;19578,35405,0,0,2,0,2
47561,100,13953,19882;21935,35405,1,0,1,0,2
47562,100,13954,19397;19990;22001,35405,1,0,2,0,3
47563,100,13955,18803;19417;22087,35405,1,0,2,0,3
47564,100,13956,19454,35405,0,0,1,0,1
47565,100,13957,19238;19498,35405,0,0,2,0,2
47566,100,13958,19510;19679,35405,0,0,2,0,2
47567,100,13959,19274,35405,0,0,1,0,1
47568,100,13960,19559;19684,35405,0,0,2,0,2
47569,100,13961,19253;19568,35405,0,0,2,0,2
47570,100,13962,19514;19577,35405,0,0,2,0,2
47571,100,13963,19540;19581,35405,0,0,2,0,2
47572,100,13964,18762;19611,35405,0,0,2,0,2
47573,100,13965,19548;19641,35405,0,0,2,0,2
47574,100,13966,19634;19655;21928,35405,1,0,2,0,3
47575,100,13967,19671;19993;21934,35405,1,0,2,0,3
47576,100,13968,19680;19889,35405,0,0,2,0,2
47577,100,13969,14624,35770,0,0,0,1,1
47578,100,13970,15062,35770,0,0,1,0,1
47579,100,13971,15088,35770,0,0,1,0,1
47580,100,13972,14926,35770,0,0,1,0,1
47581,100,13973,15242,35770,0,0,1,0,1
47582,100,13974,15254,35770,0,0,1,0,1
47583,100,13975,14610,35770,0,0,0,1,1
47584,100,13976,15328,35770,0,0,1,0,1
47585,100,13977,15124,35770,0,0,1,0,1
47586,100,13978,14886;15313,35770,0,0,2,0,2
47587,100,13980,15446,35770,0,0,1,0,1
47588,100,13981,15835,35770,0,0,1,0,1
47589,100,13983,16077,35770,0,0,1,0,1
47590,100,13984,16058,35770,0,0,1,0,1
47591,100,13986,16034,35770,0,0,1,0,1
47592,100,13988,15511,35770,0,0,1,0,1
47593,100,13989,15960,35770,0,0,1,0,1
47594,100,13990,16303,35770,0,0,1,0,1
47595,100,13992,16400,35770,0,0,1,0,1
47596,100,13993,16541,35770,0,0,1,0,1
47597,100,13996,16476;16749,35770,0,0,2,0,2
47598,100,13997,16881,35770,0,0,1,0,1
47599,100,13998,16950,35770,0,0,1,0,1
47600,100,13999,17121,35770,0,0,1,0,1
47601,100,14000,17183,35770,0,0,1,0,1
47602,100,14001,17207,35770,0,0,1,0,1
47603,100,14002,16758,35770,0,0,1,0,1
47604,100,14003,17383,35770,0,0,1,0,1
47605,100,14004,17277;17374,35770,0,0,2,0,2
47606,100,14006,17493,35770,0,0,1,0,1
47607,100,14007,17456,35770,0,0,1,0,1
47608,100,14008,17635,35770,0,0,1,0,1
47609,100,14009,17553,35770,0,0,1,0,1
47610,100,14011,17852,35770,0,0,1,0,1
47611,100,14012,17931;18335;22056,35770,1,0,2,0,3
47612,100,14013,17933,35770,0,0,1,0,1
47613,100,14015,18119,35770,0,0,1,0,1
47614,100,14017,17815,35770,0,0,1,0,1
47615,100,14018,18261,35770,0,0,1,0,1
47616,100,14019,18283,35770,0,0,1,0,1
47617,100,14020,18230,35770,0,0,1,0,1
47618,100,14021,18383;18444;22127,35770,1,0,2,0,3
47619,100,14022,17954,35770,0,0,1,0,1
47620,100,14023,18450,35770,0,0,1,0,1
47621,100,14024,18307;18494;22152,35770,1,0,2,0,3
47622,100,14025,18640,35770,0,0,1,0,1
47623,100,14026,18696,35770,0,0,1,0,1
47624,100,14027,18711;19072;22244,35770,1,0,2,0,3
47625,100,14028,18540;18781;22086,35770,1,0,2,0,3
47626,100,14029,18791;19264,35770,0,0,2,0,2
47627,100,14030,18800;19186,35770,0,0,2,0,2
47628,100,14031,18289,35770,0,0,1,0,1
47629,100,14032,18937;19095,35770,0,0,2,0,2
47630,100,14033,18996;19881;22120,35770,1,0,2,0,3
47631,100,14034,18999;19268,35770,0,0,2,0,2
47632,100,14035,19028;19358;22162,35770,1,0,2,0,3
47633,100,14036,18959,35770,0,0,1,0,1
47634,100,14037,19007,35770,0,0,1,0,1
47635,100,14038,19176;19295;22252,35770,1,0,2,0,3
47636,100,14039,18908;19179,35770,0,0,2,0,2
47637,100,14040,19187;19527,35770,0,0,2,0,2
47638,100,14042,19217;19324;22071,35770,1,0,2,0,3
47639,100,14043,19224;19754,35770,0,0,2,0,2
47640,100,14044,19248,35770,0,0,1,0,1
47641,100,14045,19256;19413,35770,0,0,2,0,2
47642,100,14046,19198;19259;22159,35770,1,0,2,0,3
47643,100,14047,19106;19260,35770,0,0,2,0,2
47644,100,14048,19276;19511,35770,0,0,2,0,2
47645,100,14049,19281;19824,35770,0,0,2,0,2
47646,100,14050,19304;19609,35770,0,0,2,0,2
47647,100,14051,19316;19489;22257,35770,1,0,2,0,3
47648,100,14052,18932;19361,35770,0,0,2,0,2
47649,100,14053,19056,35770,0,0,1,0,1
47650,100,14054,19257,35770,0,0,1,0,1
47651,100,14055,19487;19828,35770,0,0,2,0,2
47652,100,14056,19499,35770,0,0,1,0,1
47653,100,14057,19517;19902,35770,0,0,2,0,2
47654,100,14058,19520;19778,35770,0,0,2,0,2
47655,100,14059,19525;19832,35770,0,0,2,0,2
47656,100,14060,19181,35770,0,0,1,0,1
47657,100,14061,19236;19565,35770,0,0,2,0,2
47658,100,14062,19587;22076,35770,1,0,1,0,2
47659,100,14063,19241;19615,35770,0,0,2,0,2
47660,100,14064,19632;19943;22150,35770,1,0,2,0,3
47661,100,14065,19691;20077;22115,35770,1,0,2,0,3
47662,100,14066,19249;19702,35770,0,0,2,0,2
47663,100,14067,19330;19704,35770,0,0,2,0,2
47664,100,14068,19207;19710,35770,0,0,2,0,2
47665,100,14069,19633;19712,35770,0,0,2,0,2
47666,100,14070,19564;19726,35770,0,0,2,0,2
47667,100,14071,19739;19746,35770,0,0,2,0,2
47668,100,14072,19505;19744,35770,0,0,2,0,2
47669,100,14073,19749;20143,35770,0,0,2,0,2
47670,100,14074,19759;19970,35770,0,0,2,0,2
47671,100,14075,19763,35770,0,0,1,0,1
47672,100,14076,19471;19780,35770,0,0,2,0,2
47673,100,14077,19334,35770,0,0,1,0,1
47674,100,14078,15832,36135,0,0,1,0,1
47675,100,14079,15654,36135,0,0,1,0,1
47676,100,14080,15357,36135,0,0,1,0,1
47677,100,14081,15731,36135,0,0,1,0,1
47678,100,14083,15572;15800,36135,0,0,2,0,2
47679,100,14084,15759,36135,0,0,1,0,1
47680,100,14085,15767,36135,0,0,1,0,1
47681,100,14086,16146,36135,0,0,1,0,1
47682,100,14087,15916,36135,0,0,1,0,1
47683,100,14088,16116,36135,0,0,1,0,1
47684,100,14089,16434,36135,0,0,1,0,1
47685,100,14090,15877,36135,0,0,1,0,1
47686,100,14093,16341,36135,0,0,1,0,1
47687,100,14094,16274,36135,0,0,1,0,1
47688,100,14096,16773,36135,0,0,1,0,1
47689,100,14101,17388,36135,0,0,1,0,1
47690,100,14102,17410,36135,0,0,1,0,1
47691,100,14103,17439,36135,0,0,1,0,1
47692,100,14104,17658,36135,0,0,1,0,1
47693,100,14105,17605,36135,0,0,1,0,1
47694,100,14106,17702,36135,0,0,1,0,1
47695,100,14108,17902,36135,0,0,1,0,1
47696,100,14109,17981,36135,0,0,1,0,1
47697,100,14110,17903,36135,0,0,1,0,1
47698,100,14111,17558,36135,0,0,1,0,1
47699,100,14112,18063,36135,0,0,1,0,1
47700,100,14113,17867,36135,0,0,1,0,1
47701,100,14114,18118;18499,36135,0,0,2,0,2
47702,100,14115,18197,36135,0,0,1,0,1
47703,100,14116,18061,36135,0,0,1,0,1
47704,100,14117,18141,36135,0,0,1,0,1
47705,100,14118,18288,36135,0,0,1,0,1
47706,100,14119,18105,36135,0,0,1,0,1
47707,100,14120,17938,36135,0,0,1,0,1
47708,100,14121,18024;18420,36135,0,0,2,0,2
47709,100,14123,18429;18998,36135,0,0,2,0,2
47710,100,14124,18442,36135,0,0,1,0,1
47711,100,14125,18542,36135,0,0,1,0,1
47712,100,14126,18605,36135,0,0,1,0,1
47713,100,14127,18650;19290,36135,0,0,2,0,2
47714,100,14128,18675,36135,0,0,1,0,1
47715,100,14129,18709,36135,0,0,1,0,1
47716,100,14130,18749;18777,36135,0,0,2,0,2
47717,100,14132,18859;18931,36135,0,0,2,0,2
47718,100,14133,18900,36135,0,0,1,0,1
47719,100,14134,18765,36135,0,0,1,0,1
47720,100,14135,18817;18940,36135,0,0,2,0,2
47721,100,14136,18894;18947,36135,0,0,2,0,2
47722,100,14137,18977;19136,36135,0,0,2,0,2
47723,100,14138,18730,36135,0,0,1,0,1
47724,100,14139,19001,36135,0,0,1,0,1
47725,100,14140,19034,36135,0,0,1,0,1
47726,100,14141,19079,36135,0,0,1,0,1
47727,100,14142,19085;19606,36135,0,0,2,0,2
47728,100,14143,19150;19478,36135,0,0,2,0,2
47729,100,14144,19212;19447,36135,0,0,2,0,2
47730,100,14145,19078;19239,36135,0,0,2,0,2
47731,100,14147,19252;19934;22267,36135,1,0,2,0,3
47732,100,14148,18760,36135,0,0,1,0,1
47733,100,14149,19262,36135,0,0,1,0,1
47734,100,14150,19289;19729,36135,0,0,2,0,2
47735,100,14151,19302;19488,36135,0,0,2,0,2
47736,100,14152,19208;19337;22253,36135,1,0,2,0,3
47737,100,14153,19340;19485,36135,0,0,2,0,2
47738,100,14154,18673;19357,36135,0,0,2,0,2
47739,100,14155,19387;19913,36135,0,0,2,0,2
47740,100,14156,19227;19403,36135,0,0,2,0,2
47741,100,14157,19139;19408,36135,0,0,2,0,2
47742,100,14158,19418,36135,0,0,1,0,1
47743,100,14159,19235;19423,36135,0,0,2,0,2
47744,100,14160,19466;19768,36135,0,0,2,0,2
47745,100,14161,19484;19771,36135,0,0,2,0,2
47746,100,14162,19513;20024,36135,0,0,2,0,2
47747,100,14163,19349;19516,36135,0,0,2,0,2
47748,100,14164,19522,36135,0,0,1,0,1
47749,100,14165,18987;19536;22258,36135,1,0,2,0,3
47750,100,14166,19555;19756,36135,0,0,2,0,2
47751,100,14167,19571;19871,36135,0,0,2,0,2
47752,100,14168,19592;19840,36135,0,0,2,0,2
47753,100,14169,19628,36135,0,0,1,0,1
47754,100,14170,19635;19685,36135,0,0,2,0,2
47755,100,14171,19903,36135,0,0,1,0,1
47756,100,14172,19270;19646,36135,0,0,2,0,2
47757,100,14173,19659;19895,36135,0,0,2,0,2
47758,100,14174,19381;19672,36135,0,0,2,0,2
47759,100,14175,19640;19690,36135,0,0,2,0,2
47760,100,14176,19580;19695,36135,0,0,2,0,2
47761,100,14177,19709;20154,36135,0,0,2,0,2
47762,100,14178,19751;20210,36135,0,0,2,0,2
47763,100,14179,19788,36135,0,0,1,0,1
47764,100,14180,19605;19800,36135,0,0,2,0,2
47765,100,14181,19747;19839,36135,0,0,2,0,2
47766,100,14182,19852;19905,36135,0,0,2,0,2
47767,100,14183,19855;19856,36135,0,0,2,0,2
47768,100,14184,19813;19874,36135,0,0,2,0,2
47769,100,14185,19649;19885,36135,0,0,2,0,2
47770,100,14186,19890;19948,36135,0,0,2,0,2
47771,100,14187,19599;19900;22259,36135,1,0,2,0,3
47772,100,14188,19911;20047,36135,0,0,2,0,2
47773,100,14189,19914;20031,36135,0,0,2,0,2
47774,100,14190,14918,36500,0,0,1,0,1
47775,100,14191,15002,36500,0,0,1,0,1
47776,100,14192,15334;15345,36500,0,0,2,0,2
47777,100,14193,14857,36500,0,0,1,0,1
47778,100,14194,15479,36500,0,0,1,0,1
47779,100,14195,15592,36500,0,0,1,0,1
47780,100,14196,15637,36500,0,0,1,0,1
47781,100,14197,15711,36500,0,0,1,0,1
47782,100,14198,15932,36500,0,0,1,0,1
47783,100,14199,15574,36500,0,0,1,0,1
47784,100,14200,16094,36500,0,0,1,0,1
47785,100,14201,16121,36500,0,0,1,0,1
47786,100,14202,15524,36500,0,0,1,0,1
47787,100,14203,16238,36500,0,0,1,0,1
47788,100,14204,15694,36500,0,0,1,0,1
47789,100,14206,16429,36500,0,0,1,0,1
47790,100,14207,16457,36500,0,0,1,0,1
47791,100,14208,16489,36500,0,0,1,0,1
47792,100,14209,16557,36500,0,0,1,0,1
47793,100,14210,16074,36500,0,0,1,0,1
47794,100,14211,16642,36500,0,0,1,0,1
47795,100,14212,16657,36500,0,0,1,0,1
47796,100,14213,16358,36500,0,0,1,0,1
47797,100,14214,16621,36500,0,0,1,0,1
47798,100,14215,16814,36500,0,0,1,0,1
47799,100,14216,16944,36500,0,0,1,0,1
47800,100,14217,16729,36500,0,0,1,0,1
47801,100,14218,17015,36500,0,0,1,0,1
47802,100,14219,17361;17518,36500,0,0,2,0,2
47803,100,14220,17412,36500,0,0,1,0,1
47804,100,14221,17272,36500,0,0,1,0,1
47805,100,14222,17664;17927,36500,0,0,2,0,2
47806,100,14223,17159,36500,0,0,1,0,1
47807,100,14224,17471,36500,0,0,1,0,1
47808,100,14225,17350,36500,0,0,1,0,1
47809,100,14226,17772,36500,0,0,1,0,1
47810,100,14227,18188;18423,36500,0,0,2,0,2
47811,100,14228,18348,36500,0,0,1,0,1
47812,100,14229,18372,36500,0,0,1,0,1
47813,100,14230,18469,36500,0,0,1,0,1
47814,100,14232,18509;18738,36500,0,0,2,0,2
47815,100,14233,18572,36500,0,0,1,0,1
47816,100,14234,18576,36500,0,0,1,0,1
47817,100,14235,18583,36500,0,0,1,0,1
47818,100,14236,18646;19097,36500,0,0,2,0,2
47819,100,14237,18734,36500,0,0,1,0,1
47820,100,14238,18743;19116,36500,0,0,2,0,2
47821,100,14239,18865;19218,36500,0,0,2,0,2
47822,100,14240,18841;18887,36500,0,0,2,0,2
47823,100,14241,18942,36500,0,0,1,0,1
47824,100,14242,18603,36500,0,0,1,0,1
47825,100,14243,19015,36500,0,0,1,0,1
47826,100,14244,19020,36500,0,0,1,0,1
47827,100,14245,19022;19682,36500,0,0,2,0,2
47828,100,14246,19092,36500,0,0,1,0,1
47829,100,14247,19171;19717,36500,0,0,2,0,2
47830,100,14248,19234;19963,36500,0,0,2,0,2
47831,100,14249,19312,36500,0,0,1,0,1
47832,100,14250,19314;19322,36500,0,0,2,0,2
47833,100,14251,19323;19420;22256,36500,1,0,2,0,3
47834,100,14252,19331;19395,36500,0,0,2,0,2
47835,100,14253,19338;19924;22266,36500,1,0,2,0,3
47836,100,14254,19081;19341,36500,0,0,2,0,2
47837,100,14255,19345;19713,36500,0,0,2,0,2
47838,100,14256,19385;19575,36500,0,0,2,0,2
47839,100,14257,19389,36500,0,0,1,0,1
47840,100,14258,19393,36500,0,0,1,0,1
47841,100,14259,18994;19399,36500,0,0,2,0,2
47842,100,14260,19432;19844,36500,0,0,2,0,2
47843,100,14261,19440;19553,36500,0,0,2,0,2
47844,100,14262,19445;19515,36500,0,0,2,0,2
47845,100,14263,19412;19461,36500,0,0,2,0,2
47846,100,14264,18873;19469,36500,0,0,2,0,2
47847,100,14265,19496;19604,36500,0,0,2,0,2
47848,100,14266,19497;19825;22262,36500,1,0,2,0,3
47849,100,14267,19519;19664,36500,0,0,2,0,2
47850,100,14268,19705,36500,0,0,1,0,1
47851,100,14269,19595;19597,36500,0,0,2,0,2
47852,100,14270,19623;19873,36500,0,0,2,0,2
47853,100,14271,19626;19650,36500,0,0,2,0,2
47854,100,14272,19643,36500,0,0,1,0,1
47855,100,14273,19651;20027,36500,0,0,2,0,2
47856,100,14274,18863;19653,36500,0,0,2,0,2
47857,100,14275,19066;19666,36500,0,0,2,0,2
47858,100,14276,19714;19732,36500,0,0,2,0,2
47859,100,14277,19721;19835,36500,0,0,2,0,2
47860,100,14278,19694;19734,36500,0,0,2,0,2
47861,100,14279,19760;19979,36500,0,0,2,0,2
47862,100,14280,19490;19762,36500,0,0,2,0,2
47863,100,14281,19479,36500,0,0,1,0,1
47864,100,14282,19784;20118,36500,0,0,2,0,2
47865,100,14283,19803,36500,0,0,1,0,1
47866,100,14284,19833;20092,36500,0,0,2,0,2
47867,100,14285,19859,36500,0,0,1,0,1
47868,100,14286,19862;20057,36500,0,0,2,0,2
47869,100,14287,19868;20015,36500,0,0,2,0,2
47870,100,14288,19872;19968,36500,0,0,2,0,2
47871,100,14289,19910;20138;22273,36500,1,0,2,0,3
47872,100,14290,19923;20136,36500,0,0,2,0,2
47873,100,14291,19523;19975,36500,0,0,2,0,2
47874,100,14292,19996;20033,36500,0,0,2,0,2
47875,100,14293,20023;20172,36500,0,0,2,0,2
47876,110,2399,11804,0,0,0,0,1,1
47877,110,4067,12752,730,0,0,0,1,1
47878,110,4757,12349,2555,0,0,0,1,1
47879,110,4770,12991,2920,0,0,0,1,1
47880,110,4772,12137,2920,0,0,0,1,1
47881,110,4998,14651;14730,3650,0,0,0,2,2
47882,110,5363,12883;13696,5110,0,0,0,2,2
47883,110,5429,13298;13665,5110,0,0,0,2,2
47884,110,5724,14445,6205,0,0,0,1,1
47885,110,5734,14712,6570,0,0,0,1,1
47886,110,6149,15338,8030,0,0,0,1,1
47887,110,6286,14747;15023,8760,0,0,0,2,2
47888,110,6494,11202,9490,0,0,0,1,1
47889,110,6754,11497,10585,0,0,0,1,1
47890,110,6770,14352,10950,0,0,0,1,1
47891,110,6843,11100,10950,0,0,0,1,1
47892,110,6851,11798,10950,0,0,0,1,1
47893,110,6869,11315,10950,0,0,0,1,1
47894,110,6918,15489,11315,0,0,0,1,1
47895,110,6940,11295,11315,0,0,0,1,1
47896,110,6950,11702,11315,0,0,0,1,1
47897,110,6954,11181,11315,0,0,0,1,1
47898,110,6972,11700,11315,0,0,0,1,1
47899,110,7021,14504,11680,0,0,0,1,1
47900,110,7040,11657,11680,0,0,0,1,1
47901,110,7041,11673,11680,0,0,0,1,1
47902,110,7047,11489,11680,0,0,0,1,1
47903,110,7116,11522,12045,0,0,0,1,1
47904,110,7120,15197,12045,0,0,0,1,1
47905,110,7130,11703,12045,0,0,0,1,1
47906,110,7134,11821,12045,0,0,0,1,1
47907,110,7196,14193,12410,0,0,0,1,1
47908,110,7229,11416,12410,0,0,0,1,1
47909,110,7251,11628,12410,0,0,0,1,1
47910,110,7254,11722,12410,0,0,0,1,1
47911,110,7338,12225,12775,0,0,0,1,1
47912,110,7343,11417,12775,0,0,0,1,1
47913,110,7345,12228,12775,0,0,0,1,1
47914,110,7392,11111,13140,0,0,0,1,1
47915,110,7406,11606,13140,0,0,0,1,1
47916,110,7409,12096,13140,0,0,0,1,1
47917,110,7410,11614,13140,0,0,0,1,1
47918,110,7427,12221,13140,0,0,0,1,1
47919,110,7435,11607,13140,0,0,0,1,1
47920,110,7492,11138,13505,0,0,0,1,1
47921,110,7495,11439;11506,13505,0,0,0,2,2
47922,110,7509,11627,13505,0,0,0,1,1
47923,110,7516,13068,13505,0,0,0,1,1
47924,110,7523,11896,13505,0,0,0,1,1
47925,110,7525,11505,13505,0,0,0,1,1
47926,110,7526,12346,13505,0,0,0,1,1
47927,110,7527,12091,13505,0,0,0,1,1
47928,110,7529,11961;11994,13505,0,0,0,2,2
47929,110,7539,11769,13505,0,0,0,1,1
47930,110,7541,12056;12529,13505,0,0,0,2,2
47931,110,7598,17058;17365,13870,0,0,2,0,2
47932,110,7605,12104,13870,0,0,0,1,1
47933,110,7611,12639,13870,0,0,0,1,1
47934,110,7614,12267,13870,0,0,0,1,1
47935,110,7623,12329,13870,0,0,0,1,1
47936,110,7628,12178,13870,0,0,0,1,1
47937,110,7632,12232,13870,0,0,0,1,1
47938,110,7635,12259,13870,0,0,0,1,1
47939,110,7687,11472,14235,0,0,0,1,1
47940,110,7704,17066;17126;17378;17578;20729;20748;21126;21432;23136,14235,1,1,7,0,9
47941,110,7705,11945,14235,0,0,0,1,1
47942,110,7713,12562,14235,0,0,0,1,1
47943,110,7715,12074,14235,0,0,0,1,1
47944,110,7726,12728,14235,0,0,0,1,1
47945,110,7728,12149,14235,0,0,0,1,1
47946,110,7729,12697,14235,0,0,0,1,1
47947,110,7730,12673,14235,0,0,0,1,1
47948,110,7731,19999,14235,0,0,1,0,1
47949,110,7737,12374,14235,0,0,0,1,1
47950,110,7738,12729,14235,0,0,0,1,1
47951,110,7740,12258,14235,0,0,0,1,1
47952,110,7797,11580,14600,0,0,0,1,1
47953,110,7799,11906,14600,0,0,0,1,1
47954,110,7807,12276,14600,0,0,0,1,1
47955,110,7810,12139,14600,0,0,0,1,1
47956,110,7813,11891,14600,0,0,0,1,1
47957,110,7814,12323,14600,0,0,0,1,1
47958,110,7817,12008,14600,0,0,0,1,1
47959,110,7820,12306,14600,0,0,0,1,1
47960,110,7824,16715,14600,0,0,1,0,1
47961,110,7827,12177,14600,0,0,0,1,1
47962,110,7828,12186,14600,0,0,0,1,1
47963,110,7829,12622,14600,0,0,0,1,1
47964,110,7831,12331,14600,0,0,0,1,1
47965,110,7833,12633;12775,14600,0,0,0,2,2
47966,110,7834,12294,14600,0,0,0,1,1
47967,110,7835,12311,14600,0,0,0,1,1
47968,110,7841,12706,14600,0,0,0,1,1
47969,110,7842,12081;12359,14600,0,0,0,2,2
47970,110,7844,12280,14600,0,0,0,1,1
47971,110,7846,12290,14600,0,0,0,1,1
47972,110,7848,12303,14600,0,0,0,1,1
47973,110,7849,12652,14600,0,0,0,1,1
47974,110,7883,11838,14965,0,0,0,1,1
47975,110,7900,12960,14965,0,0,0,1,1
47976,110,7902,12085,14965,0,0,0,1,1
47977,110,7908,12497,14965,0,0,0,1,1
47978,110,7909,12732,14965,0,0,0,1,1
47979,110,7911,12870,14965,0,0,0,1,1
47980,110,7915,12378,14965,0,0,0,1,1
47981,110,7916,12097,14965,0,0,0,1,1
47982,110,7918,12174,14965,0,0,0,1,1
47983,110,7920,12240,14965,0,0,0,1,1
47984,110,7921,12564,14965,0,0,0,1,1
47985,110,7923,12787,14965,0,0,0,1,1
47986,110,7924,12593;12674,14965,0,0,0,2,2
47987,110,7927,12316,14965,0,0,0,1,1
47988,110,7930,12451,14965,0,0,0,1,1
47989,110,7931,12353,14965,0,0,0,1,1
47990,110,7932,12507,14965,0,0,0,1,1
47991,110,7935,12565;12946,14965,0,0,0,2,2
47992,110,7937,12489,14965,0,0,0,1,1
47993,110,7938,12241;12609,14965,0,0,0,2,2
47994,110,7940,12635,14965,0,0,0,1,1
47995,110,7941,12317,14965,0,0,0,1,1
47996,110,7942,12658,14965,0,0,0,1,1
47997,110,7981,11245,15330,0,0,0,1,1
47998,110,7989,12156,15330,0,0,0,1,1
47999,110,7991,11696,15330,0,0,0,1,1
48000,110,7992,11688,15330,0,0,0,1,1
48001,110,7993,12283,15330,0,0,0,1,1
48002,110,7996,11755,15330,0,0,0,1,1
48003,110,7999,12784,15330,0,0,0,1,1
48004,110,8000,12105,15330,0,0,0,1,1
48005,110,8002,12365,15330,0,0,0,1,1
48006,110,8007,12589,15330,0,0,0,1,1
48007,110,8008,12242,15330,0,0,0,1,1
48008,110,8009,12284,15330,0,0,0,1,1
48009,110,8011,12253,15330,0,0,0,1,1
48010,110,8012,12264,15330,0,0,0,1,1
48011,110,8013,12394,15330,0,0,0,1,1
48012,110,8015,12637;12858,15330,0,0,0,2,2
48013,110,8018,12773,15330,0,0,0,1,1
48014,110,8020,13281,15330,0,0,0,1,1
48015,110,8022,12443,15330,0,0,0,1,1
48016,110,8029,12925,15330,0,0,0,1,1
48017,110,8032,12770,15330,0,0,0,1,1
48018,110,8037,13248,15330,0,0,0,1,1
48019,110,8038,12701,15330,0,0,0,1,1
48020,110,8039,13074,15330,0,0,0,1,1
48021,110,8041,12981,15330,0,0,0,1,1
48022,110,8043,12906,15330,0,0,0,1,1
48023,110,8087,11854,15695,0,0,0,1,1
48024,110,8088,11998,15695,0,0,0,1,1
48025,110,8089,12335,15695,0,0,0,1,1
48026,110,8094,12071;12319,15695,0,0,0,2,2
48027,110,8095,12916,15695,0,0,0,1,1
48028,110,8096,12155,15695,0,0,0,1,1
48029,110,8097,12380;12391,15695,0,0,0,2,2
48030,110,8098,12405,15695,0,0,0,1,1
48031,110,8101,12438,15695,0,0,0,1,1
48032,110,8103,12108,15695,0,0,0,1,1
48033,110,8105,12785,15695,0,0,0,1,1
48034,110,8106,13365,15695,0,0,0,1,1
48035,110,8107,12892,15695,0,0,0,1,1
48036,110,8110,13295,15695,0,0,0,1,1
48037,110,8111,12537,15695,0,0,0,1,1
48038,110,8113,11934,15695,0,0,0,1,1
48039,110,8115,12623,15695,0,0,0,1,1
48040,110,8116,12727,15695,0,0,0,1,1
48041,110,8117,13234,15695,0,0,0,1,1
48042,110,8121,12791,15695,0,0,0,1,1
48043,110,8122,12804,15695,0,0,0,1,1
48044,110,8126,12383;12829,15695,0,0,0,2,2
48045,110,8127,12917,15695,0,0,0,1,1
48046,110,8128,12677,15695,0,0,0,1,1
48047,110,8129,12855,15695,0,0,0,1,1
48048,110,8130,12864;13297,15695,0,0,0,2,2
48049,110,8132,12881,15695,0,0,0,1,1
48050,110,8133,13095,15695,0,0,0,1,1
48051,110,8134,12823,15695,0,0,0,1,1
48052,110,8135,13168,15695,0,0,0,1,1
48053,110,8136,12912,15695,0,0,0,1,1
48054,110,8137,13939;14030,15695,0,0,0,2,2
48055,110,8178,12235,16060,0,0,0,1,1
48056,110,8180,11609,16060,0,0,0,1,1
48057,110,8187,12281,16060,0,0,0,1,1
48058,110,8193,12020,16060,0,0,0,1,1
48059,110,8194,12492,16060,0,0,0,1,1
48060,110,8196,17189;17677,16060,0,0,2,0,2
48061,110,8197,12115,16060,0,0,0,1,1
48062,110,8199,12325;12372;17672,16060,0,0,1,2,3
48063,110,8200,12458,16060,0,0,0,1,1
48064,110,8204,13107,16060,0,0,0,1,1
48065,110,8206,12510;12832,16060,0,0,0,2,2
48066,110,8208,12590,16060,0,0,0,1,1
48067,110,8209,12560,16060,0,0,0,1,1
48068,110,8211,12678,16060,0,0,0,1,1
48069,110,8212,13089,16060,0,0,0,1,1
48070,110,8213,12705;13516,16060,0,0,0,2,2
48071,110,8215,12825,16060,0,0,0,1,1
48072,110,8216,12653,16060,0,0,0,1,1
48073,110,8217,18070;22051;22185;22290,16060,0,3,1,0,4
48074,110,8219,12716,16060,0,0,0,1,1
48075,110,8221,13143,16060,0,0,0,1,1
48076,110,8222,12931,16060,0,0,0,1,1
48077,110,8225,12878,16060,0,0,0,1,1
48078,110,8226,12904,16060,0,0,0,1,1
48079,110,8227,12830,16060,0,0,0,1,1
48080,110,8229,13255,16060,0,0,0,1,1
48081,110,8230,12945,16060,0,0,0,1,1
48082,110,8231,12964;13185,16060,0,0,0,2,2
48083,110,8232,12978,16060,0,0,0,1,1
48084,110,8233,12600;12983,16060,0,0,0,2,2
48085,110,8234,13376,16060,0,0,0,1,1
48086,110,8235,13359,16060,0,0,0,1,1
48087,110,8237,13364;13391,16060,0,0,0,2,2
48088,110,8238,12597;13058,16060,0,0,0,2,2
48089,110,8281,11712,16425,0,0,0,1,1
48090,110,8288,12263,16425,0,0,0,1,1
48091,110,8297,12610,16425,0,0,0,1,1
48092,110,8299,12743,16425,0,0,0,1,1
48093,110,8300,12180,16425,0,0,0,1,1
48094,110,8301,12291,16425,0,0,0,1,1
48095,110,8304,12269,16425,0,0,0,1,1
48096,110,8305,12360,16425,0,0,0,1,1
48097,110,8312,12490;12525,16425,0,0,0,2,2
48098,110,8314,13132;13286,16425,0,0,0,2,2
48099,110,8315,12876,16425,0,0,0,1,1
48100,110,8316,12848,16425,0,0,0,1,1
48101,110,8318,13104,16425,0,0,0,1,1
48102,110,8323,13037,16425,0,0,0,1,1
48103,110,8324,13555,16425,0,0,0,1,1
48104,110,8326,12987,16425,0,0,0,1,1
48105,110,8327,13586,16425,0,0,0,1,1
48106,110,8329,13036,16425,0,0,0,1,1
48107,110,8330,12519,16425,0,0,0,1,1
48108,110,8331,12907,16425,0,0,0,1,1
48109,110,8332,12581,16425,0,0,0,1,1
48110,110,8334,12885,16425,0,0,0,1,1
48111,110,8335,13501,16425,0,0,0,1,1
48112,110,8336,13139,16425,0,0,0,1,1
48113,110,8337,13181,16425,0,0,0,1,1
48114,110,8339,13091;13206,16425,0,0,0,2,2
48115,110,8340,13096,16425,0,0,0,1,1
48116,110,8342,13109,16425,0,0,0,1,1
48117,110,8343,13112,16425,0,0,0,1,1
48118,110,8346,13377,16425,0,0,0,1,1
48119,110,8347,13137,16425,0,0,0,1,1
48120,110,8350,13167,16425,0,0,0,1,1
48121,110,8354,13335,16425,0,0,0,1,1
48122,110,8394,11631,16790,0,0,0,1,1
48123,110,8400,12772,16790,0,0,0,1,1
48124,110,8402,12675,16790,0,0,0,1,1
48125,110,8403,12967,16790,0,0,0,1,1
48126,110,8407,12406;12687,16790,0,0,0,2,2
48127,110,8408,12909,16790,0,0,0,1,1
48128,110,8411,12857;12888,16790,0,0,0,2,2
48129,110,8413,13287,16790,0,0,0,1,1
48130,110,8415,12854,16790,0,0,0,1,1
48131,110,8416,12480,16790,0,0,0,1,1
48132,110,8417,12628,16790,0,0,0,1,1
48133,110,8420,13409,16790,0,0,0,1,1
48134,110,8421,13510,16790,0,0,0,1,1
48135,110,8422,12850,16790,0,0,0,1,1
48136,110,8423,12681;13299,16790,0,0,0,2,2
48137,110,8424,12685,16790,0,0,0,1,1
48138,110,8425,12665,16790,0,0,0,1,1
48139,110,8427,13318,16790,0,0,0,1,1
48140,110,8428,13204;13423,16790,0,0,0,2,2
48141,110,8429,12846,16790,0,0,0,1,1
48142,110,8430,12676,16790,0,0,0,1,1
48143,110,8431,12293;12761,16790,0,0,0,2,2
48144,110,8435,12827,16790,0,0,0,1,1
48145,110,8436,12712;13031,16790,0,0,0,2,2
48146,110,8438,13342,16790,0,0,0,1,1
48147,110,8439,13535,16790,0,0,0,1,1
48148,110,8440,13194,16790,0,0,0,1,1
48149,110,8441,13043,16790,0,0,0,1,1
48150,110,8443,13049;13564,16790,0,0,0,2,2
48151,110,8444,13292,16790,0,0,0,1,1
48152,110,8445,13462;13610,16790,0,0,0,2,2
48153,110,8446,12806;13272,16790,0,0,0,2,2
48154,110,8447,13159,16790,0,0,0,1,1
48155,110,8449,13163,16790,0,0,0,1,1
48156,110,8450,13416,16790,0,0,0,1,1
48157,110,8451,13189,16790,0,0,0,1,1
48158,110,8452,13198;13240,16790,0,0,0,2,2
48159,110,8455,13577,16790,0,0,0,1,1
48160,110,8456,13314,16790,0,0,0,1,1
48161,110,8458,13361,16790,0,0,0,1,1
48162,110,8459,13018;13310,16790,0,0,0,2,2
48163,110,8460,13536,16790,0,0,0,1,1
48164,110,8461,13082;13323,16790,0,0,0,2,2
48165,110,8462,13151;13439,16790,0,0,0,2,2
48166,110,8464,13533,16790,0,0,0,1,1
48167,110,8505,11799,17155,0,0,0,1,1
48168,110,8509,12086,17155,0,0,0,1,1
48169,110,8514,16466;16776;17100;20512;20679;20767;22606;23138;23245,17155,2,1,6,0,9
48170,110,8519,12719,17155,0,0,0,1,1
48171,110,8520,12615,17155,0,0,0,1,1
48172,110,8521,12544,17155,0,0,0,1,1
48173,110,8525,12243,17155,0,0,0,1,1
48174,110,8526,12774;12963,17155,0,0,0,2,2
48175,110,8528,17880;18548;22213,17155,0,1,2,0,3
48176,110,8530,12688;12707,17155,0,0,0,2,2
48177,110,8531,12840,17155,0,0,0,1,1
48178,110,8532,13500,17155,0,0,0,1,1
48179,110,8534,12778,17155,0,0,0,1,1
48180,110,8535,12924,17155,0,0,0,1,1
48181,110,8537,13434,17155,0,0,0,1,1
48182,110,8538,13184,17155,0,0,0,1,1
48183,110,8539,13540,17155,0,0,0,1,1
48184,110,8540,13067,17155,0,0,0,1,1
48185,110,8542,12813,17155,0,0,0,1,1
48186,110,8543,12834,17155,0,0,0,1,1
48187,110,8544,13175,17155,0,0,0,1,1
48188,110,8545,12972;17391,17155,0,0,1,1,2
48189,110,8546,13131,17155,0,0,0,1,1
48190,110,8550,13150,17155,0,0,0,1,1
48191,110,8551,13237,17155,0,0,0,1,1
48192,110,8552,13178,17155,0,0,0,1,1
48193,110,8553,13009;13200,17155,0,0,0,2,2
48194,110,8554,13449,17155,0,0,0,1,1
48195,110,8555,12959;13221,17155,0,0,0,2,2
48196,110,8557,13087,17155,0,0,0,1,1
48197,110,8562,13289,17155,0,0,0,1,1
48198,110,8563,13243;13594,17155,0,0,0,2,2
48199,110,8564,13291,17155,0,0,0,1,1
48200,110,8565,13098,17155,0,0,0,1,1
48201,110,8566,13331,17155,0,0,0,1,1
48202,110,8568,13384,17155,0,0,0,1,1
48203,110,8569,13389,17155,0,0,0,1,1
48204,110,8570,13392,17155,0,0,0,1,1
48205,110,8571,13492,17155,0,0,0,1,1
48206,110,8572,13217;13779,17155,0,0,0,2,2
48207,110,8573,13301,17155,0,0,0,1,1
48208,110,8575,12795,17155,0,0,0,1,1
48209,110,8576,13581,17155,0,0,0,1,1
48210,110,8577,13909,17155,0,0,0,1,1
48211,110,8578,13390,17155,0,0,0,1,1
48212,110,8579,13655;13782,17155,0,0,0,2,2
48213,110,8623,12028,17520,0,0,0,1,1
48214,110,8624,12136,17520,0,0,0,1,1
48215,110,8626,12828,17520,0,0,0,1,1
48216,110,8628,12453,17520,0,0,0,1,1
48217,110,8636,13422;13455;17814,17520,0,0,1,2,3
48218,110,8638,12734,17520,0,0,0,1,1
48219,110,8639,12423;12796,17520,0,0,0,2,2
48220,110,8640,12698,17520,0,0,0,1,1
48221,110,8642,12856,17520,0,0,0,1,1
48222,110,8644,13415,17520,0,0,0,1,1
48223,110,8645,12977,17520,0,0,0,1,1
48224,110,8646,13278,17520,0,0,0,1,1
48225,110,8648,13084;13343,17520,0,0,0,2,2
48226,110,8649,13060;13100,17520,0,0,0,2,2
48227,110,8650,13155;13562,17520,0,0,0,2,2
48228,110,8653,13199,17520,0,0,0,1,1
48229,110,8654,13233;13378,17520,0,0,0,2,2
48230,110,8655,13259,17520,0,0,0,1,1
48231,110,8656,13493;13603,17520,0,0,0,2,2
48232,110,8657,12974;13277,17520,0,0,0,2,2
48233,110,8661,13919,17520,0,0,0,1,1
48234,110,8663,13367,17520,0,0,0,1,1
48235,110,8664,19015;19177,17520,0,0,2,0,2
48236,110,8667,12606,17520,0,0,0,1,1
48237,110,8668,14025,17520,0,0,0,1,1
48238,110,8671,13952,17520,0,0,0,1,1
48239,110,8673,13010;13496,17520,0,0,0,2,2
48240,110,8674,13502,17520,0,0,0,1,1
48241,110,8675,13201;13511,17520,0,0,0,2,2
48242,110,8677,13543,17520,0,0,0,1,1
48243,110,8678,13118;13559,17520,0,0,0,2,2
48244,110,8679,13799,17520,0,0,0,1,1
48245,110,8681,13567,17520,0,0,0,1,1
48246,110,8683,13740;13847,17520,0,0,0,2,2
48247,110,8684,13532,17520,0,0,0,1,1
48248,110,8685,13607,17520,0,0,0,1,1
48249,110,8687,18475;18508;22936,17520,1,0,2,0,3
48250,110,8688,13653;13792,17520,0,0,0,2,2
48251,110,8689,13664,17520,0,0,0,1,1
48252,110,8690,13491;13666,17520,0,0,0,2,2
48253,110,8726,12760,17885,0,0,0,1,1
48254,110,8730,13108,17885,0,0,0,1,1
48255,110,8737,12934,17885,0,0,0,1,1
48256,110,8739,13472,17885,0,0,0,1,1
48257,110,8741,12583;12930,17885,0,0,0,2,2
48258,110,8743,12364,17885,0,0,0,1,1
48259,110,8744,12649,17885,0,0,0,1,1
48260,110,8748,13403,17885,0,0,0,1,1
48261,110,8751,12901,17885,0,0,0,1,1
48262,110,8752,13280,17885,0,0,0,1,1
48263,110,8754,13247;13408,17885,0,0,0,2,2
48264,110,8755,13034,17885,0,0,0,1,1
48265,110,8756,17685,17885,0,0,1,0,1
48266,110,8760,13214,17885,0,0,0,1,1
48267,110,8761,13219;13544,17885,0,0,0,2,2
48268,110,8762,13157;13657,17885,0,0,0,2,2
48269,110,8763,13421,17885,0,0,0,1,1
48270,110,8764,13429,17885,0,0,0,1,1
48271,110,8765,13483;13519,17885,0,0,0,2,2
48272,110,8767,12766,17885,0,0,0,1,1
48273,110,8768,13507,17885,0,0,0,1,1
48274,110,8770,13463,17885,0,0,0,1,1
48275,110,8771,13048,17885,0,0,0,1,1
48276,110,8772,12557;13485,17885,0,0,0,2,2
48277,110,8774,13902,17885,0,0,0,1,1
48278,110,8775,14050;14143,17885,0,0,0,2,2
48279,110,8776,13560,17885,0,0,0,1,1
48280,110,8778,13440,17885,0,0,0,1,1
48281,110,8781,13407;13654,17885,0,0,0,2,2
48282,110,8782,13592,17885,0,0,0,1,1
48283,110,8783,13803,17885,0,0,0,1,1
48284,110,8784,13804;14089,17885,0,0,0,2,2
48285,110,8785,14165,17885,0,0,0,1,1
48286,110,8787,13714;14112,17885,0,0,0,2,2
48287,110,8790,13721,17885,0,0,0,1,1
48288,110,8791,14052,17885,0,0,0,1,1
48289,110,8792,14082,17885,0,0,0,1,1
48290,110,8794,13871;14059,17885,0,0,0,2,2
48291,110,8835,13008,18250,0,0,0,1,1
48292,110,8836,13077,18250,0,0,0,1,1
48293,110,8843,12399;12794,18250,0,0,0,2,2
48294,110,8847,13478,18250,0,0,0,1,1
48295,110,8848,12422,18250,0,0,0,1,1
48296,110,8849,12944,18250,0,0,0,1,1
48297,110,8850,13187,18250,0,0,0,1,1
48298,110,8851,12965;13154,18250,0,0,0,2,2
48299,110,8852,13838,18250,0,0,0,1,1
48300,110,8853,13153,18250,0,0,0,1,1
48301,110,8854,12891,18250,0,0,0,1,1
48302,110,8855,13315;13929,18250,0,0,0,2,2
48303,110,8856,12989,18250,0,0,0,1,1
48304,110,8857,13129,18250,0,0,0,1,1
48305,110,8859,13695,18250,0,0,0,1,1
48306,110,8860,13271,18250,0,0,0,1,1
48307,110,8861,13396;13515,18250,0,0,0,2,2
48308,110,8863,13349;13574,18250,0,0,0,2,2
48309,110,8864,13860,18250,0,0,0,1,1
48310,110,8867,14150,18250,0,0,0,1,1
48311,110,8868,13588,18250,0,0,0,1,1
48312,110,8870,13106;13590,18250,0,0,0,2,2
48313,110,8871,14064,18250,0,0,0,1,1
48314,110,8872,13811,18250,0,0,0,1,1
48315,110,8873,13698,18250,0,0,0,1,1
48316,110,8874,13339,18250,0,0,0,1,1
48317,110,8876,13304;13761,18250,0,0,0,2,2
48318,110,8877,13593,18250,0,0,0,1,1
48319,110,8879,13405;14047,18250,0,0,0,2,2
48320,110,8880,13078,18250,0,0,0,1,1
48321,110,8882,13448;13889,18250,0,0,0,2,2
48322,110,8883,13631,18250,0,0,0,1,1
48323,110,8884,14017,18250,0,0,0,1,1
48324,110,8885,14280,18250,0,0,0,1,1
48325,110,8886,14190,18250,0,0,0,1,1
48326,110,8887,13659;13834,18250,0,0,0,2,2
48327,110,8888,14080,18250,0,0,0,1,1
48328,110,8889,13547;13755,18250,0,0,0,2,2
48329,110,8890,14065;14268,18250,0,0,0,2,2
48330,110,8891,14121,18250,0,0,0,1,1
48331,110,8892,13712,18250,0,0,0,1,1
48332,110,8893,13728,18250,0,0,0,1,1
48333,110,8894,13723,18250,0,0,0,1,1
48334,110,8896,13529;13760,18250,0,0,0,2,2
48335,110,8897,13733,18250,0,0,0,1,1
48336,110,8898,14093,18250,0,0,0,1,1
48337,110,8899,13996,18250,0,0,0,1,1
48338,110,8900,13980;14299,18250,0,0,0,2,2
48339,110,8901,13203;13888,18250,0,0,0,2,2
48340,110,8902,13512;14019,18250,0,0,0,2,2
48341,110,8903,13453;13681,18250,0,0,0,2,2
48342,110,8904,14189;14310,18250,0,0,0,2,2
48343,110,8905,13915;13971,18250,0,0,0,2,2
48344,110,8906,13941,18250,0,0,0,1,1
48345,110,8907,13004,18250,0,0,0,1,1
48346,110,8908,13556;13950,18250,0,0,0,2,2
48347,110,8950,12444,18615,0,0,0,1,1
48348,110,8954,12206;12695,18615,0,0,0,2,2
48349,110,8955,17250;17352,18615,0,0,2,0,2
48350,110,8957,12266;12741,18615,0,0,0,2,2
48351,110,8962,12929,18615,0,0,0,1,1
48352,110,8964,12957,18615,0,0,0,1,1
48353,110,8967,13575,18615,0,0,0,1,1
48354,110,8968,13942;14132,18615,0,0,0,2,2
48355,110,8969,13294,18615,0,0,0,1,1
48356,110,8971,13508,18615,0,0,0,1,1
48357,110,8972,14033;14206,18615,0,0,0,2,2
48358,110,8974,13587;13766,18615,0,0,0,2,2
48359,110,8975,12926,18615,0,0,0,1,1
48360,110,8976,13748,18615,0,0,0,1,1
48361,110,8977,13428;13749,18615,0,0,0,2,2
48362,110,8979,13538,18615,0,0,0,1,1
48363,110,8981,13908;13968,18615,0,0,0,2,2
48364,110,8983,13618,18615,0,0,0,1,1
48365,110,8984,13705,18615,0,0,0,1,1
48366,110,8985,13393,18615,0,0,0,1,1
48367,110,8986,13639,18615,0,0,0,1,1
48368,110,8987,13824,18615,0,0,0,1,1
48369,110,8988,13991,18615,0,0,0,1,1
48370,110,8989,13800;14155,18615,0,0,0,2,2
48371,110,8990,13644;14285,18615,0,0,0,2,2
48372,110,8991,13693,18615,0,0,0,1,1
48373,110,8992,13727;14291,18615,0,0,0,2,2
48374,110,8993,12942,18615,0,0,0,1,1
48375,110,8994,14368;14458,18615,0,0,0,2,2
48376,110,8995,13913;14502,18615,0,0,0,2,2
48377,110,8996,14097;14328,18615,0,0,0,2,2
48378,110,8997,14048,18615,0,0,0,1,1
48379,110,8998,14254,18615,0,0,0,1,1
48380,110,8999,14349;18712,18615,0,0,1,1,2
48381,110,9000,13753;14021,18615,0,0,0,2,2
48382,110,9001,14022,18615,0,0,0,1,1
48383,110,9002,14061;14315,18615,0,0,0,2,2
48384,110,9003,14125,18615,0,0,0,1,1
48385,110,9004,14359,18615,0,0,0,1,1
48386,110,9005,13840;14067,18615,0,0,0,2,2
48387,110,9006,13810;14069,18615,0,0,0,2,2
48388,110,9007,14074,18615,0,0,0,1,1
48389,110,9008,13551;14075,18615,0,0,0,2,2
48390,110,9009,13787;14084,18615,0,0,0,2,2
48391,110,9042,11868,18980,0,0,0,1,1
48392,110,9056,12937,18980,0,0,0,1,1
48393,110,9062,13090,18980,0,0,0,1,1
48394,110,9063,13023,18980,0,0,0,1,1
48395,110,9065,12400;12433,18980,0,0,0,2,2
48396,110,9066,12996;13642,18980,0,0,0,2,2
48397,110,9069,13121,18980,0,0,0,1,1
48398,110,9071,13708;13768,18980,0,0,0,2,2
48399,110,9072,13208;13226,18980,0,0,0,2,2
48400,110,9075,12833,18980,0,0,0,1,1
48401,110,9076,12496;13266,18980,0,0,0,2,2
48402,110,9077,13282;13313,18980,0,0,0,2,2
48403,110,9078,13352,18980,0,0,0,1,1
48404,110,9079,13374;13807,18980,0,0,0,2,2
48405,110,9082,13387;13420,18980,0,0,0,2,2
48406,110,9083,13426;13771,18980,0,0,0,2,2
48407,110,9085,14284;14292,18980,0,0,0,2,2
48408,110,9087,13212;13480,18980,0,0,0,2,2
48409,110,9089,13672;14159,18980,0,0,0,2,2
48410,110,9090,13989;14004,18980,0,0,0,2,2
48411,110,9091,13667;13979,18980,0,0,0,2,2
48412,110,9093,13703,18980,0,0,0,1,1
48413,110,9094,13700;13707,18980,0,0,0,2,2
48414,110,9095,13517;14095,18980,0,0,0,2,2
48415,110,9096,14567,18980,0,0,0,1,1
48416,110,9098,13490,18980,0,0,0,1,1
48417,110,9099,14318,18980,0,0,0,1,1
48418,110,9100,14494,18980,0,0,0,1,1
48419,110,9102,13897;14327,18980,0,0,0,2,2
48420,110,9103,14063,18980,0,0,0,1,1
48421,110,9104,13641;13890,18980,0,0,0,2,2
48422,110,9105,14439,18980,0,0,0,1,1
48423,110,9107,13735;13920,18980,0,0,0,2,2
48424,110,9109,13956,18980,0,0,0,1,1
48425,110,9110,13597;13958,18980,0,0,0,2,2
48426,110,9111,13279;13967,18980,0,0,0,2,2
48427,110,9112,13981,18980,0,0,0,1,1
48428,110,9113,13743;14478,18980,0,0,0,2,2
48429,110,9114,13777;14008,18980,0,0,0,2,2
48430,110,9115,14034,18980,0,0,0,1,1
48431,110,9116,14215,18980,0,0,0,1,1
48432,110,9117,14475,18980,0,0,0,1,1
48433,110,9118,13621;14153,18980,0,0,0,2,2
48434,110,9119,13643;14130,18980,0,0,0,2,2
48435,110,9120,14081;14496,18980,0,0,0,2,2
48436,110,9121,14102,18980,0,0,0,1,1
48437,110,9122,14110,18980,0,0,0,1,1
48438,110,9123,14590,18980,0,0,0,1,1
48439,110,9124,13837;14169,18980,0,0,0,2,2
48440,110,9125,14171;14530,18980,0,0,0,2,2
48441,110,9153,12050,19345,0,0,0,1,1
48442,110,9154,12055,19345,0,0,0,1,1
48443,110,9161,13656,19345,0,0,0,1,1
48444,110,9165,13225,19345,0,0,0,1,1
48445,110,9166,12843,19345,0,0,0,1,1
48446,110,9167,12275;12790,19345,0,0,0,2,2
48447,110,9168,12682;13065,19345,0,0,0,2,2
48448,110,9169,13332,19345,0,0,0,1,1
48449,110,9170,12182,19345,0,0,0,1,1
48450,110,9172,12896,19345,0,0,0,1,1
48451,110,9174,12943;13930,19345,0,0,0,2,2
48452,110,9175,12954,19345,0,0,0,1,1
48453,110,9176,12312;13173,19345,0,0,0,2,2
48454,110,9177,13072,19345,0,0,0,1,1
48455,110,9179,14029,19345,0,0,0,1,1
48456,110,9180,13357,19345,0,0,0,1,1
48457,110,9181,13831,19345,0,0,0,1,1
48458,110,9182,13718,19345,0,0,0,1,1
48459,110,9183,13193,19345,0,0,0,1,1
48460,110,9186,13253;13477,19345,0,0,0,2,2
48461,110,9188,13322,19345,0,0,0,1,1
48462,110,9189,13325,19345,0,0,0,1,1
48463,110,9192,14174;14231,19345,0,0,0,2,2
48464,110,9193,13424,19345,0,0,0,1,1
48465,110,9195,13474;13922,19345,0,0,0,2,2
48466,110,9196,13431;14168,19345,0,0,0,2,2
48467,110,9198,13484,19345,0,0,0,1,1
48468,110,9199,14316,19345,0,0,0,1,1
48469,110,9200,13699,19345,0,0,0,1,1
48470,110,9202,13436;13677,19345,0,0,0,2,2
48471,110,9203,13791,19345,0,0,0,1,1
48472,110,9204,13633,19345,0,0,0,1,1
48473,110,9205,13689;14107,19345,0,0,0,2,2
48474,110,9206,13691,19345,0,0,0,1,1
48475,110,9207,13730;14374,19345,0,0,0,2,2
48476,110,9208,14164,19345,0,0,0,1,1
48477,110,9209,13658,19345,0,0,0,1,1
48478,110,9210,13809,19345,0,0,0,1,1
48479,110,9211,14056,19345,0,0,0,1,1
48480,110,9212,13466;13815,19345,0,0,0,2,2
48481,110,9213,13786;13823,19345,0,0,0,2,2
48482,110,9214,14526;14580,19345,0,0,0,2,2
48483,110,9215,14330;14370,19345,0,0,0,2,2
48484,110,9216,13966,19345,0,0,0,1,1
48485,110,9218,14411;14606,19345,0,0,0,2,2
48486,110,9219,13754,19345,0,0,0,1,1
48487,110,9220,17629;17743;17782;17832;21046;21557,19345,0,1,5,0,6
48488,110,9221,13866;13972,19345,0,0,0,2,2
48489,110,9223,14499,19345,0,0,0,1,1
48490,110,9225,14672;14789;17461,19345,0,0,1,2,3
48491,110,9227,14413;19000,19345,0,0,1,1,2
48492,110,9228,14126,19345,0,0,0,1,1
48493,110,9229,14365,19345,0,0,0,1,1
48494,110,9230,13585;14134,19345,0,0,0,2,2
48495,110,9231,13687;14140,19345,0,0,0,2,2
48496,110,9233,14464,19345,0,0,0,1,1
48497,110,9234,14715,19345,0,0,0,1,1
48498,110,9235,14229;14811,19345,0,0,0,2,2
48499,110,9236,14259,19345,0,0,0,1,1
48500,110,9237,14099;14270,19345,0,0,0,2,2
48501,110,9238,14296,19345,0,0,0,1,1
48502,110,9239,14282,19345,0,0,0,1,1
48503,110,9240,14287,19345,0,0,0,1,1
48504,110,9241,13713;14305,19345,0,0,0,2,2
48505,110,9242,14675,19345,0,0,0,1,1
48506,110,9243,14615;18504,19345,0,0,1,1,2
48507,110,9244,14323,19345,0,0,0,1,1
48508,110,9280,13284,19710,0,0,0,1,1
48509,110,9281,13513,19710,0,0,0,1,1
48510,110,9282,13494,19710,0,0,0,1,1
48511,110,9284,13283,19710,0,0,0,1,1
48512,110,9286,13399;13524,19710,0,0,0,2,2
48513,110,9288,12897;13430,19710,0,0,0,2,2
48514,110,9289,13437;14006,19710,0,0,0,2,2
48515,110,9291,12861,19710,0,0,0,1,1
48516,110,9293,13645,19710,0,0,0,1,1
48517,110,9294,14149,19710,0,0,0,1,1
48518,110,9295,13757,19710,0,0,0,1,1
48519,110,9297,13675;13682,19710,0,0,0,2,2
48520,110,9298,13859,19710,0,0,0,1,1
48521,110,9299,13566;14131,19710,0,0,0,2,2
48522,110,9300,13499;13796,19710,0,0,0,2,2
48523,110,9301,14072;14135,19710,0,0,0,2,2
48524,110,9302,14073,19710,0,0,0,1,1
48525,110,9303,13855;13933,19710,0,0,0,2,2
48526,110,9304,13634;14366,19710,0,0,0,2,2
48527,110,9305,13750,19710,0,0,0,1,1
48528,110,9306,14224,19710,0,0,0,1,1
48529,110,9307,14344;14927,19710,0,0,0,2,2
48530,110,9309,13770;13990,19710,0,0,0,2,2
48531,110,9310,14417,19710,0,0,0,1,1
48532,110,9311,14311,19710,0,0,0,1,1
48533,110,9312,14437,19710,0,0,0,1,1
48534,110,9313,14077,19710,0,0,0,1,1
48535,110,9314,13628;14136,19710,0,0,0,2,2
48536,110,9316,14771;18737;22225,19710,0,1,1,1,3
48537,110,9318,14584,19710,0,0,0,1,1
48538,110,9319,14151,19710,0,0,0,1,1
48539,110,9320,14866;18725,19710,0,0,1,1,2
48540,110,9322,14331,19710,0,0,0,1,1
48541,110,9324,13726,19710,0,0,0,1,1
48542,110,9325,13788;14333,19710,0,0,0,2,2
48543,110,9326,13816;14363,19710,0,0,0,2,2
48544,110,9328,14385,19710,0,0,0,1,1
48545,110,9329,14398,19710,0,0,0,1,1
48546,110,9330,14705,19710,0,0,0,1,1
48547,110,9332,14821,19710,0,0,0,1,1
48548,110,9333,14519;14897;18280,19710,0,0,1,2,3
48549,110,9334,14457,19710,0,0,0,1,1
48550,110,9337,14503,19710,0,0,0,1,1
48551,110,9338,14618,19710,0,0,0,1,1
48552,110,9339,14514,19710,0,0,0,1,1
48553,110,9340,14522,19710,0,0,0,1,1
48554,110,9382,12894,20075,0,0,0,1,1
48555,110,9388,13309,20075,0,0,0,1,1
48556,110,9390,13052,20075,0,0,0,1,1
48557,110,9393,13000,20075,0,0,0,1,1
48558,110,9395,13495,20075,0,0,0,1,1
48559,110,9396,13932;14042,20075,0,0,0,2,2
48560,110,9397,13460,20075,0,0,0,1,1
48561,110,9399,13611;14194,20075,0,0,0,2,2
48562,110,9400,13702,20075,0,0,0,1,1
48563,110,9401,13521;13668,20075,0,0,0,2,2
48564,110,9402,13737,20075,0,0,0,1,1
48565,110,9403,14013,20075,0,0,0,1,1
48566,110,9405,13383,20075,0,0,0,1,1
48567,110,9406,14347;14578,20075,0,0,0,2,2
48568,110,9407,14123,20075,0,0,0,1,1
48569,110,9409,14309;14474,20075,0,0,0,2,2
48570,110,9411,14281,20075,0,0,0,1,1
48571,110,9412,13948,20075,0,0,0,1,1
48572,110,9413,14855,20075,0,0,0,1,1
48573,110,9415,14015;14204,20075,0,0,0,2,2
48574,110,9416,14531,20075,0,0,0,1,1
48575,110,9418,14853;14891,20075,0,0,0,2,2
48576,110,9419,14060;14198,20075,0,0,0,2,2
48577,110,9421,14427;14444,20075,0,0,0,2,2
48578,110,9422,14090,20075,0,0,0,1,1
48579,110,9423,14741,20075,0,0,0,1,1
48580,110,9424,14039;14104,20075,0,0,0,2,2
48581,110,9425,14516,20075,0,0,0,1,1
48582,110,9426,14505;14805,20075,0,0,0,2,2
48583,110,9428,13599;14179,20075,0,0,0,2,2
48584,110,9429,14207;14255,20075,0,0,0,2,2
48585,110,9430,14202,20075,0,0,0,1,1
48586,110,9431,14220,20075,0,0,0,1,1
48587,110,9432,14058;14221,20075,0,0,0,2,2
48588,110,9433,14196,20075,0,0,0,1,1
48589,110,9434,14250,20075,0,0,0,1,1
48590,110,9435,14551;14824,20075,0,0,0,2,2
48591,110,9436,14408;18558;22314;22626;23043;23262,20075,2,2,1,1,6
48592,110,9438,13873,20075,0,0,0,1,1
48593,110,9439,13626;14454,20075,0,0,0,2,2
48594,110,9440,14482,20075,0,0,0,1,1
48595,110,9441,14489,20075,0,0,0,1,1
48596,110,9442,15063,20075,0,0,0,1,1
48597,110,9443,14480;14507,20075,0,0,0,2,2
48598,110,9445,14524,20075,0,0,0,1,1
48599,110,9446,14854;15039,20075,0,0,0,2,2
48600,110,9447,14592;14684,20075,0,0,0,2,2
48601,110,9448,14573,20075,0,0,0,1,1
48602,110,9449,14765,20075,0,0,0,1,1
48603,110,9451,14426;14609,20075,0,0,0,2,2
48604,110,9452,14612,20075,0,0,0,1,1
48605,110,9453,14724,20075,0,0,0,1,1
48606,110,9455,14623,20075,0,0,0,1,1
48607,110,9456,15027,20075,0,0,0,1,1
48608,110,9458,14643,20075,0,0,0,1,1
48609,110,9459,14817;15086,20075,0,0,0,2,2
48610,110,9494,12166,20440,0,0,0,1,1
48611,110,9496,12567,20440,0,0,0,1,1
48612,110,9502,13101;13591,20440,0,0,0,2,2
48613,110,9505,13910,20440,0,0,0,1,1
48614,110,9509,13936;13947,20440,0,0,0,2,2
48615,110,9510,13506;13694,20440,0,0,0,2,2
48616,110,9511,13224;13545,20440,0,0,0,2,2
48617,110,9512,13945,20440,0,0,0,1,1
48618,110,9513,14297,20440,0,0,0,1,1
48619,110,9516,13598;14390,20440,0,0,0,2,2
48620,110,9517,13246,20440,0,0,0,1,1
48621,110,9518,13717;13719,20440,0,0,0,2,2
48622,110,9521,13851;14298,20440,0,0,0,2,2
48623,110,9522,14114;14345,20440,0,0,0,2,2
48624,110,9523,13977,20440,0,0,0,1,1
48625,110,9524,13924,20440,0,0,0,1,1
48626,110,9525,13912;13969,20440,0,0,0,2,2
48627,110,9526,13783;13954,20440,0,0,0,2,2
48628,110,9529,14014;14184,20440,0,0,0,2,2
48629,110,9530,14513;17643,20440,0,0,1,1,2
48630,110,9531,14120;14754,20440,0,0,0,2,2
48631,110,9532,14117,20440,0,0,0,1,1
48632,110,9533,14162;14646,20440,0,0,0,2,2
48633,110,9534,13404;14163;18240,20440,0,0,1,2,3
48634,110,9535,14175;14217,20440,0,0,0,2,2
48635,110,9536,14213,20440,0,0,0,1,1
48636,110,9537,14222;14232,20440,0,0,0,2,2
48637,110,9540,14278;14902,20440,0,0,0,2,2
48638,110,9541,14115;14424,20440,0,0,0,2,2
48639,110,9542,14313,20440,0,0,0,1,1
48640,110,9545,14248;14256,20440,0,0,0,2,2
48641,110,9546,14376,20440,0,0,0,1,1
48642,110,9547,13841;14451,20440,0,0,0,2,2
48643,110,9548,14657;14877,20440,0,0,0,2,2
48644,110,9549,14456,20440,0,0,0,1,1
48645,110,9550,14958,20440,0,0,0,1,1
48646,110,9552,14105,20440,0,0,0,1,1
48647,110,9553,14485,20440,0,0,0,1,1
48648,110,9554,14010;14487,20440,0,0,0,2,2
48649,110,9555,14492,20440,0,0,0,1,1
48650,110,9556,14371;14501,20440,0,0,0,2,2
48651,110,9558,14068;14512,20440,0,0,0,2,2
48652,110,9559,14535;14838,20440,0,0,0,2,2
48653,110,9560,15215;15393,20440,0,0,0,2,2
48654,110,9561,14559;14847,20440,0,0,0,2,2
48655,110,9562,14661,20440,0,0,0,1,1
48656,110,9563,13741;13870,20440,0,0,0,2,2
48657,110,9564,14601,20440,0,0,0,1,1
48658,110,9565,14356;14600,20440,0,0,0,2,2
48659,110,9568,14640,20440,0,0,0,1,1
48660,110,9569,14683;14998,20440,0,0,0,2,2
48661,110,9571,14571,20440,0,0,0,1,1
48662,110,9572,14596;14945,20440,0,0,0,2,2
48663,110,9573,14869,20440,0,0,0,1,1
48664,110,9574,14830;15154,20440,0,0,0,2,2
48665,110,9575,15078,20440,0,0,0,1,1
48666,110,9576,14435;14843,20440,0,0,0,2,2
48667,110,9577,14560;14779,20440,0,0,0,2,2
48668,110,9618,13099,20805,0,0,0,1,1
48669,110,9622,13017,20805,0,0,0,1,1
48670,110,9625,13269;14265,20805,0,0,0,2,2
48671,110,9626,13625;18258,20805,0,0,1,1,2
48672,110,9628,13504,20805,0,0,0,1,1
48673,110,9629,13569;13949,20805,0,0,0,2,2
48674,110,9630,13497;13697,20805,0,0,0,2,2
48675,110,9631,13632;13746,20805,0,0,0,2,2
48676,110,9634,13578;13938,20805,0,0,0,2,2
48677,110,9635,13853;14939,20805,0,0,0,2,2
48678,110,9637,13944,20805,0,0,0,1,1
48679,110,9638,13552;14425,20805,0,0,0,2,2
48680,110,9639,13806;13976,20805,0,0,0,2,2
48681,110,9640,14026,20805,0,0,0,1,1
48682,110,9641,14225;14520,20805,0,0,0,2,2
48683,110,9642,13993,20805,0,0,0,1,1
48684,110,9643,14894;15025,20805,0,0,0,2,2
48685,110,9644,14043,20805,0,0,0,1,1
48686,110,9645,14570,20805,0,0,0,1,1
48687,110,9646,14188;14468,20805,0,0,0,2,2
48688,110,9648,14604,20805,0,0,0,1,1
48689,110,9649,14275,20805,0,0,0,1,1
48690,110,9651,14384;14441,20805,0,0,0,2,2
48691,110,9653,14245;14403,20805,0,0,0,2,2
48692,110,9654,14279;14443,20805,0,0,0,2,2
48693,110,9655,14420;15126,20805,0,0,0,2,2
48694,110,9656,14086;14536,20805,0,0,0,2,2
48695,110,9658,14582,20805,0,0,0,1,1
48696,110,9659,14595;14671,20805,0,0,0,2,2
48697,110,9661,14564,20805,0,0,0,1,1
48698,110,9662,14740,20805,0,0,0,1,1
48699,110,9663,14552;14658,20805,0,0,0,2,2
48700,110,9664,14674,20805,0,0,0,1,1
48701,110,9665,14825,20805,0,0,0,1,1
48702,110,9666,14704,20805,0,0,0,1,1
48703,110,9667,14706,20805,0,0,0,1,1
48704,110,9670,14835;15135;19251,20805,0,0,1,2,3
48705,110,9672,15035,20805,0,0,0,1,1
48706,110,9673,14786;15260,20805,0,0,0,2,2
48707,110,9675,14813;15240,20805,0,0,0,2,2
48708,110,9676,14849;15187,20805,0,0,0,2,2
48709,110,9678,15176,20805,0,0,0,1,1
48710,110,9679,14873,20805,0,0,0,1,1
48711,110,9681,15364,20805,0,0,0,1,1
48712,110,9682,14633;15070,20805,0,0,0,2,2
48713,110,9684,14916,20805,0,0,0,1,1
48714,110,9685,14884;14917,20805,0,0,0,2,2
48715,110,9686,14924,20805,0,0,0,1,1
48716,110,9688,14986,20805,0,0,0,1,1
48717,110,9709,11914,21170,0,0,0,1,1
48718,110,9722,13012;13070,21170,0,0,0,2,2
48719,110,9723,13003;13358,21170,0,0,0,2,2
48720,110,9730,13819,21170,0,0,0,1,1
48721,110,9731,13369;14397,21170,0,0,0,2,2
48722,110,9732,13647;13904,21170,0,0,0,2,2
48723,110,9733,13921,21170,0,0,0,1,1
48724,110,9735,13729;14012,21170,0,0,0,2,2
48725,110,9736,14038;14197,21170,0,0,0,2,2
48726,110,9737,14208,21170,0,0,0,1,1
48727,110,9738,14078;14372,21170,0,0,0,2,2
48728,110,9740,14103,21170,0,0,0,1,1
48729,110,9741,14138;14216,21170,0,0,0,2,2
48730,110,9742,14326,21170,0,0,0,1,1
48731,110,9743,14192;14557;18431;22413;22514,21170,0,2,1,2,5
48732,110,9744,14746;15004,21170,0,0,0,2,2
48733,110,9745,14227;15522,21170,0,0,0,2,2
48734,110,9746,14361;14642,21170,0,0,0,2,2
48735,110,9747,14829,21170,0,0,0,1,1
48736,110,9750,14404,21170,0,0,0,1,1
48737,110,9751,14542;14782,21170,0,0,0,2,2
48738,110,9753,14460,21170,0,0,0,1,1
48739,110,9754,14203;14486,21170,0,0,0,2,2
48740,110,9755,14848,21170,0,0,0,1,1
48741,110,9756,14861;14943,21170,0,0,0,2,2
48742,110,9757,14851;14865;19311,21170,0,0,1,2,3
48743,110,9758,14160;14532,21170,0,0,0,2,2
48744,110,9759,14549,21170,0,0,0,1,1
48745,110,9761,14447;14576,21170,0,0,0,2,2
48746,110,9762,14076;14579,21170,0,0,0,2,2
48747,110,9763,14591;15072,21170,0,0,0,2,2
48748,110,9764,14837;14951,21170,0,0,0,2,2
48749,110,9765,14703;15030,21170,0,0,0,2,2
48750,110,9766,14722,21170,0,0,0,1,1
48751,110,9767,14735;14922,21170,0,0,0,2,2
48752,110,9768,14751;14887,21170,0,0,0,2,2
48753,110,9770,14904,21170,0,0,0,1,1
48754,110,9771,14100;14793,21170,0,0,0,2,2
48755,110,9772,14498;14802,21170,0,0,0,2,2
48756,110,9773,15601;15995,21170,0,0,0,2,2
48757,110,9774,15411;18747,21170,0,0,1,1,2
48758,110,9775,14852;15174,21170,0,0,0,2,2
48759,110,9777,14664;14895,21170,0,0,0,2,2
48760,110,9778,14915;15121,21170,0,0,0,2,2
48761,110,9779,14472;14872,21170,0,0,0,2,2
48762,110,9780,14749;14936,21170,0,0,0,2,2
48763,110,9781,15289,21170,0,0,0,1,1
48764,110,9782,15170,21170,0,0,0,1,1
48765,110,9783,14976;15068,21170,0,0,0,2,2
48766,110,9784,14977,21170,0,0,0,1,1
48767,110,9785,14980,21170,0,0,0,1,1
48768,110,9786,15047,21170,0,0,0,1,1
48769,110,9787,15011;19665,21170,0,0,1,1,2
48770,110,9788,15026;15044,21170,0,0,0,2,2
48771,110,9789,15636,21170,0,0,0,1,1
48772,110,9790,14923,21170,0,0,0,1,1
48773,110,9791,14954;15066,21170,0,0,0,2,2
48774,110,9792,14382;14815,21170,0,0,0,2,2
48775,110,9793,14820,21170,0,0,0,1,1
48776,110,9794,15081,21170,0,0,0,1,1
48777,110,9795,15192;15195,21170,0,0,0,2,2
48778,110,9811,11258,21535,0,0,0,1,1
48779,110,9823,13319,21535,0,0,0,1,1
48780,110,9824,12824,21535,0,0,0,1,1
48781,110,9828,13795,21535,0,0,0,1,1
48782,110,9829,13756;17617,21535,0,0,1,1,2
48783,110,9830,12998;13382,21535,0,0,0,2,2
48784,110,9832,13609,21535,0,0,0,1,1
48785,110,9833,13828,21535,0,0,0,1,1
48786,110,9836,14211;18690,21535,0,0,1,1,2
48787,110,9837,13176;13711,21535,0,0,0,2,2
48788,110,9838,13526;13738,21535,0,0,0,2,2
48789,110,9841,13927;14200,21535,0,0,0,2,2
48790,110,9844,13775;13928,21535,0,0,0,2,2
48791,110,9845,14035;14219,21535,0,0,0,2,2
48792,110,9846,13865,21535,0,0,0,1,1
48793,110,9847,14294;14587,21535,0,0,0,2,2
48794,110,9849,13982,21535,0,0,0,1,1
48795,110,9851,14054,21535,0,0,0,1,1
48796,110,9853,14736,21535,0,0,0,1,1
48797,110,9856,13623;13789,21535,0,0,0,2,2
48798,110,9857,14252,21535,0,0,0,1,1
48799,110,9858,14269;14272,21535,0,0,0,2,2
48800,110,9861,14334,21535,0,0,0,1,1
48801,110,9863,14354,21535,0,0,0,1,1
48802,110,9864,14369;14721,21535,0,0,0,2,2
48803,110,9865,14405,21535,0,0,0,1,1
48804,110,9866,14602,21535,0,0,0,1,1
48805,110,9867,14450,21535,0,0,0,1,1
48806,110,9868,19065,21535,0,0,1,0,1
48807,110,9869,14914,21535,0,0,0,1,1
48808,110,9872,14261;14556,21535,0,0,0,2,2
48809,110,9873,14984,21535,0,0,0,1,1
48810,110,9874,15204;15647,21535,0,0,0,2,2
48811,110,9875,15245,21535,0,0,0,1,1
48812,110,9877,13844;14798,21535,0,0,0,2,2
48813,110,9878,14803;15071,21535,0,0,0,2,2
48814,110,9879,14882;15141,21535,0,0,0,2,2
48815,110,9880,14831;15171,21535,0,0,0,2,2
48816,110,9881,14141;14879,21535,0,0,0,2,2
48817,110,9882,14920;15013,21535,0,0,0,2,2
48818,110,9883,15496;15506,21535,0,0,0,2,2
48819,110,9884,14972;15337,21535,0,0,0,2,2
48820,110,9885,14931;14985;19101,21535,0,0,1,2,3
48821,110,9886,14418,21535,0,0,0,1,1
48822,110,9887,14997;15293,21535,0,0,0,2,2
48823,110,9888,15468,21535,0,0,0,1,1
48824,110,9889,15046;15481,21535,0,0,0,2,2
48825,110,9891,15075;15520,21535,0,0,0,2,2
48826,110,9892,14448,21535,0,0,0,1,1
48827,110,9893,15209;15366,21535,0,0,0,2,2
48828,110,9894,15103;15435,21535,0,0,0,2,2
48829,110,9895,14544;15113,21535,0,0,0,2,2
48830,110,9896,15125;15785,21535,0,0,0,2,2
48831,110,9898,14729;15133,21535,0,0,0,2,2
48832,110,9901,15052;15144,21535,0,0,0,2,2
48833,110,9902,14991;15001,21535,0,0,0,2,2
48834,110,9904,14973;15202,21535,0,0,0,2,2
48835,110,9917,11668;11739,21900,0,0,0,2,2
48836,110,9927,12636,21900,0,0,0,1,1
48837,110,9929,12758,21900,0,0,0,1,1
48838,110,9943,13417,21900,0,0,0,1,1
48839,110,9945,13353;13812,21900,0,0,0,2,2
48840,110,9948,14049,21900,0,0,0,1,1
48841,110,9950,13845,21900,0,0,0,1,1
48842,110,9955,13557,21900,0,0,0,1,1
48843,110,9959,14342,21900,0,0,0,1,1
48844,110,9961,14234,21900,0,0,0,1,1
48845,110,9962,14178,21900,0,0,0,1,1
48846,110,9963,15094;15379,21900,0,0,0,2,2
48847,110,9964,14239;14367,21900,0,0,0,2,2
48848,110,9966,14355,21900,0,0,0,1,1
48849,110,9967,14379;14716,21900,0,0,0,2,2
48850,110,9968,14395,21900,0,0,0,1,1
48851,110,9971,14378;14495,21900,0,0,0,2,2
48852,110,9973,14528,21900,0,0,0,1,1
48853,110,9974,14555;14982,21900,0,0,0,2,2
48854,110,9975,15106,21900,0,0,0,1,1
48855,110,9976,14665,21900,0,0,0,1,1
48856,110,9978,14598;14870,21900,0,0,0,2,2
48857,110,9979,14662;15007,21900,0,0,0,2,2
48858,110,9980,14690;18872,21900,0,0,1,1,2
48859,110,9982,14762,21900,0,0,0,1,1
48860,110,9983,14515,21900,0,0,0,1,1
48861,110,9984,14561,21900,0,0,0,1,1
48862,110,9985,15466,21900,0,0,0,1,1
48863,110,9986,14506;14903,21900,0,0,0,2,2
48864,110,9987,15462;15474,21900,0,0,0,2,2
48865,110,9988,14905;15253,21900,0,0,0,2,2
48866,110,9990,14919;15032;19415,21900,0,0,1,2,3
48867,110,9993,14933,21900,0,0,0,1,1
48868,110,9994,14975,21900,0,0,0,1,1
48869,110,9995,14978;15186,21900,0,0,0,2,2
48870,110,9996,14992;15134,21900,0,0,0,2,2
48871,110,9998,15605,21900,0,0,0,1,1
48872,110,9999,15024;15244,21900,0,0,0,2,2
48873,110,10001,15688;15890,21900,0,0,0,2,2
48874,110,10002,14720;15116,21900,0,0,0,2,2
48875,110,10003,15128,21900,0,0,0,1,1
48876,110,10004,15110;15709,21900,0,0,0,2,2
48877,110,10007,15808,21900,0,0,0,1,1
48878,110,10008,15162,21900,0,0,0,1,1
48879,110,10009,15149;15408,21900,0,0,0,2,2
48880,110,10010,15181,21900,0,0,0,1,1
48881,110,10012,15016;15217,21900,0,0,0,2,2
48882,110,10013,15220,21900,0,0,0,1,1
48883,110,10014,15261,21900,0,0,0,1,1
48884,110,10017,15719;19822,21900,0,0,1,1,2
48885,110,10018,15358;15377,21900,0,0,0,2,2
48886,110,10019,15359;15512,21900,0,0,0,2,2
48887,110,10020,14438;15361,21900,0,0,0,2,2
48888,110,10021,14608;15368;19542,21900,0,0,1,2,3
48889,110,10023,15516,21900,0,0,0,1,1
48890,110,10024,15396;15451,21900,0,0,0,2,2
48891,110,10043,12923,22265,0,0,0,1,1
48892,110,10045,12860,22265,0,0,0,1,1
48893,110,10049,13780;13857,22265,0,0,0,2,2
48894,110,10053,13953;18456,22265,0,0,1,1,2
48895,110,10055,14235,22265,0,0,0,1,1
48896,110,10056,13509,22265,0,0,0,1,1
48897,110,10058,14273,22265,0,0,0,1,1
48898,110,10059,13464;13843,22265,0,0,0,2,2
48899,110,10060,14020,22265,0,0,0,1,1
48900,110,10061,14228,22265,0,0,0,1,1
48901,110,10062,14018,22265,0,0,0,1,1
48902,110,10063,14066;14094,22265,0,0,0,2,2
48903,110,10064,14761,22265,0,0,0,1,1
48904,110,10065,13974,22265,0,0,0,1,1
48905,110,10066,14540;15394,22265,0,0,0,2,2
48906,110,10067,13595;14109,22265,0,0,0,2,2
48907,110,10068,14246,22265,0,0,0,1,1
48908,110,10070,14583,22265,0,0,0,1,1
48909,110,10072,14909,22265,0,0,0,1,1
48910,110,10073,14770,22265,0,0,0,1,1
48911,110,10074,14431,22265,0,0,0,1,1
48912,110,10076,14262;14841,22265,0,0,0,2,2
48913,110,10077,15098;15325,22265,0,0,0,2,2
48914,110,10078,14553;14653,22265,0,0,0,2,2
48915,110,10080,14616,22265,0,0,0,1,1
48916,110,10081,15033,22265,0,0,0,1,1
48917,110,10082,14663;15650,22265,0,0,0,2,2
48918,110,10083,14699;15189,22265,0,0,0,2,2
48919,110,10084,14890;14970,22265,0,0,0,2,2
48920,110,10085,14731,22265,0,0,0,1,1
48921,110,10086,14752;15422,22265,0,0,0,2,2
48922,110,10087,14757,22265,0,0,0,1,1
48923,110,10088,14258;14422,22265,0,0,0,2,2
48924,110,10089,15250;15525,22265,0,0,0,2,2
48925,110,10090,15247,22265,0,0,0,1,1
48926,110,10094,14888;15179,22265,0,0,0,2,2
48927,110,10095,14816;14907,22265,0,0,0,2,2
48928,110,10096,15413,22265,0,0,0,1,1
48929,110,10097,14963,22265,0,0,0,1,1
48930,110,10101,15019;15029,22265,0,0,0,2,2
48931,110,10102,15131,22265,0,0,0,1,1
48932,110,10104,15012;15285,22265,0,0,0,2,2
48933,110,10107,15095,22265,0,0,0,1,1
48934,110,10108,15182,22265,0,0,0,1,1
48935,110,10109,15188;15395,22265,0,0,0,2,2
48936,110,10110,15557,22265,0,0,0,1,1
48937,110,10111,15200;16031;20135,22265,0,0,1,2,3
48938,110,10112,15203,22265,0,0,0,1,1
48939,110,10113,14191;15207,22265,0,0,0,2,2
48940,110,10114,15504;15806,22265,0,0,0,2,2
48941,110,10115,15228;15628,22265,0,0,0,2,2
48942,110,10116,15229;15495,22265,0,0,0,2,2
48943,110,10117,14940;15230,22265,0,0,0,2,2
48944,110,10118,15237,22265,0,0,0,1,1
48945,110,10119,15239;15410;19558,22265,0,0,1,2,3
48946,110,10121,15687;15884,22265,0,0,0,2,2
48947,110,10122,15278,22265,0,0,0,1,1
48948,110,10123,15279;15751,22265,0,0,0,2,2
48949,110,10124,15282;15682,22265,0,0,0,2,2
48950,110,10125,15457,22265,0,0,0,1,1
48951,110,10126,15698;15819;20302,22265,0,0,1,2,3
48952,110,10127,15299,22265,0,0,0,1,1
48953,110,10128,15255;15327,22265,0,0,0,2,2
48954,110,10130,15146;15347,22265,0,0,0,2,2
48955,110,10131,15613;19692,22265,0,0,1,1,2
48956,110,10133,15641,22265,0,0,0,1,1
48957,110,10134,15407;15455;20482,22265,0,0,1,2,3
48958,110,10135,15401;15934,22265,0,0,0,2,2
48959,110,10136,15414;15769,22265,0,0,0,2,2
48960,110,10137,15437;15598,22265,0,0,0,2,2
48961,110,10138,15447;15938,22265,0,0,0,2,2
48962,110,10139,15454,22265,0,0,0,1,1
48963,110,10142,15482,22265,0,0,0,1,1
48964,110,10143,15430;15498,22265,0,0,0,2,2
48965,110,10144,15556;19103,22265,0,0,1,1,2
48966,110,10145,15509;15657,22265,0,0,0,2,2
48967,110,10146,15416,22265,0,0,0,1,1
48968,110,10175,12866;12871,22630,0,0,0,2,2
48969,110,10178,13140,22630,0,0,0,1,1
48970,110,10183,12782,22630,0,0,0,1,1
48971,110,10187,13579,22630,0,0,0,1,1
48972,110,10188,13458,22630,0,0,0,1,1
48973,110,10192,13997,22630,0,0,0,1,1
48974,110,10193,13959;14452,22630,0,0,0,2,2
48975,110,10196,15259,22630,0,0,0,1,1
48976,110,10197,14558;14763,22630,0,0,0,2,2
48977,110,10199,14187,22630,0,0,0,1,1
48978,110,10200,14479,22630,0,0,0,1,1
48979,110,10201,14491,22630,0,0,0,1,1
48980,110,10203,14569;14859,22630,0,0,0,2,2
48981,110,10205,13960,22630,0,0,0,1,1
48982,110,10207,15061,22630,0,0,0,1,1
48983,110,10208,13903;14628,22630,0,0,0,2,2
48984,110,10209,14697;14840,22630,0,0,0,2,2
48985,110,10210,14449;14650,22630,0,0,0,2,2
48986,110,10211,14629;14952,22630,0,0,0,2,2
48987,110,10212,14024;14659,22630,0,0,0,2,2
48988,110,10213,14681;15444,22630,0,0,0,2,2
48989,110,10215,14710;15465,22630,0,0,0,2,2
48990,110,10216,14726,22630,0,0,0,1,1
48991,110,10218,15101,22630,0,0,0,1,1
48992,110,10219,14876,22630,0,0,0,1,1
48993,110,10220,13849,22630,0,0,0,1,1
48994,110,10221,15302,22630,0,0,0,1,1
48995,110,10223,14562;14833,22630,0,0,0,2,2
48996,110,10226,14948;15031;19677;22696,22630,0,1,1,2,4
48997,110,10227,15008,22630,0,0,0,1,1
48998,110,10228,14812;15458,22630,0,0,0,2,2
48999,110,10229,15058;15544,22630,0,0,0,2,2
49000,110,10232,15180,22630,0,0,0,1,1
49001,110,10233,15201;15214,22630,0,0,0,2,2
49002,110,10234,14928;15213,22630,0,0,0,2,2
49003,110,10235,15300;15607,22630,0,0,0,2,2
49004,110,10236,15317;15517,22630,0,0,0,2,2
49005,110,10237,14787;15319,22630,0,0,0,2,2
49006,110,10239,15329;18321,22630,0,0,1,1,2
49007,110,10240,15902,22630,0,0,0,1,1
49008,110,10241,15067;15384,22630,0,0,0,2,2
49009,110,10242,15406,22630,0,0,0,1,1
49010,110,10243,15423,22630,0,0,0,1,1
49011,110,10244,15308;15448,22630,0,0,0,2,2
49012,110,10245,14967;15453,22630,0,0,0,2,2
49013,110,10246,15713,22630,0,0,0,1,1
49014,110,10247,15463;15790,22630,0,0,0,2,2
49015,110,10249,15497,22630,0,0,0,1,1
49016,110,10251,15538,22630,0,0,0,1,1
49017,110,10252,15554;15935,22630,0,0,0,2,2
49018,110,10255,15433;15569,22630,0,0,0,2,2
49019,110,10256,15488,22630,0,0,0,1,1
49020,110,10297,13630,22995,0,0,0,1,1
49021,110,10303,14046,22995,0,0,0,1,1
49022,110,10307,14199;14242,22995,0,0,0,2,2
49023,110,10310,14337,22995,0,0,0,1,1
49024,110,10311,14767,22995,0,0,0,1,1
49025,110,10313,15042,22995,0,0,0,1,1
49026,110,10314,14846;15043,22995,0,0,0,2,2
49027,110,10315,14288;14429,22995,0,0,0,2,2
49028,110,10317,14409,22995,0,0,0,1,1
49029,110,10318,14632,22995,0,0,0,1,1
49030,110,10319,14637,22995,0,0,0,1,1
49031,110,10320,14108;14638,22995,0,0,0,2,2
49032,110,10321,15374;15507,22995,0,0,0,2,2
49033,110,10322,13886;14375,22995,0,0,0,2,2
49034,110,10323,14415;14772,22995,0,0,0,2,2
49035,110,10324,18953;22749;22949;23056,22995,2,1,1,0,4
49036,110,10325,14611;14961;18639;23047,22995,1,0,1,2,4
49037,110,10326,15536;15754,22995,0,0,0,2,2
49038,110,10327,14842;15321,22995,0,0,0,2,2
49039,110,10328,15057;15548,22995,0,0,0,2,2
49040,110,10329,15649;15734;20273,22995,0,0,1,2,3
49041,110,10330,14753;14867,22995,0,0,0,2,2
49042,110,10331,15196;15579,22995,0,0,0,2,2
49043,110,10332,15212,22995,0,0,0,1,1
49044,110,10333,15160;15223,22995,0,0,0,2,2
49045,110,10334,15340,22995,0,0,0,1,1
49046,110,10335,15895,22995,0,0,0,1,1
49047,110,10336,15104;15281,22995,0,0,0,2,2
49048,110,10337,15322,22995,0,0,0,1,1
49049,110,10339,15090;15918,22995,0,0,0,2,2
49050,110,10340,15356;15515,22995,0,0,0,2,2
49051,110,10341,15363,22995,0,0,0,1,1
49052,110,10342,15944,22995,0,0,0,1,1
49053,110,10343,15491;15887;19363,22995,0,0,1,2,3
49054,110,10344,14714;15494,22995,0,0,0,2,2
49055,110,10345,15842,22995,0,0,0,1,1
49056,110,10347,15199,22995,0,0,0,1,1
49057,110,10348,15533;15829,22995,0,0,0,2,2
49058,110,10349,15638;15967,22995,0,0,0,2,2
49059,110,10350,15392;15541,22995,0,0,0,2,2
49060,110,10351,15549;19333,22995,0,0,1,1,2
49061,110,10352,15562;15964,22995,0,0,0,2,2
49062,110,10353,15267;15575,22995,0,0,0,2,2
49063,110,10354,15310;15588,22995,0,0,0,2,2
49064,110,10355,15611;15889,22995,0,0,0,2,2
49065,110,10356,15626,22995,0,0,0,1,1
49066,110,10357,15545;15629,22995,0,0,0,2,2
49067,110,10358,15645,22995,0,0,0,1,1
49068,110,10359,15621;16155,22995,0,0,1,1,2
49069,110,10360,15530;16029,22995,0,0,0,2,2
49070,110,10361,15441;15676,22995,0,0,0,2,2
49071,110,10362,16179,22995,0,0,1,0,1
49072,110,10363,15263;15973,22995,0,0,0,2,2
49073,110,10364,15949;16020,22995,0,0,0,2,2
49074,110,10365,15959,22995,0,0,0,1,1
49075,110,10366,16076;16193;20137;20898;23227,22995,1,0,4,0,5
49076,110,10367,15758;16047;19978;23211,22995,1,0,1,2,4
49077,110,10368,15761,22995,0,0,0,1,1
49078,110,10369,15766;16041,22995,0,0,0,2,2
49079,110,10371,14995;15782,22995,0,0,0,2,2
49080,110,10372,15122;15786;18970;22348;22648,22995,0,2,1,2,5
49081,110,10374,14791;15527,22995,0,0,0,2,2
49082,110,10397,12227,23360,0,0,0,1,1
49083,110,10408,13111,23360,0,0,0,1,1
49084,110,10410,13360,23360,0,0,0,1,1
49085,110,10412,13505;13692,23360,0,0,0,2,2
49086,110,10418,14617;19428,23360,0,0,1,1,2
49087,110,10420,14809,23360,0,0,0,1,1
49088,110,10421,14147;14336,23360,0,0,0,2,2
49089,110,10423,18946;22541,23360,0,1,1,0,2
49090,110,10424,14523,23360,0,0,0,1,1
49091,110,10428,14335;14543,23360,0,0,0,2,2
49092,110,10429,14510;14541,23360,0,0,0,2,2
49093,110,10430,14810;15060,23360,0,0,0,2,2
49094,110,10431,14780,23360,0,0,0,1,1
49095,110,10432,14304;14921,23360,0,0,0,2,2
49096,110,10433,14682,23360,0,0,0,1,1
49097,110,10434,14794,23360,0,0,0,1,1
49098,110,10435,14892,23360,0,0,0,1,1
49099,110,10437,14962;15021,23360,0,0,0,2,2
49100,110,10439,15365;15476,23360,0,0,0,2,2
49101,110,10440,15921;15958,23360,0,0,0,2,2
49102,110,10441,15065;15421,23360,0,0,0,2,2
49103,110,10442,15112;20045,23360,0,0,1,1,2
49104,110,10443,15147;15403,23360,0,0,0,2,2
49105,110,10444,15082;15119,23360,0,0,0,2,2
49106,110,10445,15130;15632;20006,23360,0,0,1,2,3
49107,110,10446,15309;15633,23360,0,0,0,2,2
49108,110,10447,15901;16061;19240,23360,0,0,1,2,3
49109,110,10448,14929;15151,23360,0,0,0,2,2
49110,110,10450,14981;15175,23360,0,0,0,2,2
49111,110,10451,14885;15211,23360,0,0,0,2,2
49112,110,10452,15219;15822;19203,23360,0,0,1,2,3
49113,110,10453,15443,23360,0,0,0,1,1
49114,110,10454,15919,23360,0,0,0,1,1
49115,110,10455,15014;15335,23360,0,0,0,2,2
49116,110,10457,15863,23360,0,0,0,1,1
49117,110,10458,16008;16009,23360,0,0,0,2,2
49118,110,10459,15701,23360,0,0,0,1,1
49119,110,10460,14974;15439,23360,0,0,0,2,2
49120,110,10461,15177;15440,23360,0,0,0,2,2
49121,110,10462,15750,23360,0,0,0,1,1
49122,110,10463,15521,23360,0,0,0,1,1
49123,110,10464,14603;15566;19319,23360,0,0,1,2,3
49124,110,10465,15979,23360,0,0,0,1,1
49125,110,10466,15543;15580;18827;23150,23360,1,0,1,2,4
49126,110,10467,15583,23360,0,0,0,1,1
49127,110,10468,15589,23360,0,0,0,1,1
49128,110,10469,16043,23360,0,0,0,1,1
49129,110,10470,15606,23360,0,0,0,1,1
49130,110,10472,15692,23360,0,0,0,1,1
49131,110,10474,15697;16026,23360,0,0,0,2,2
49132,110,10475,15658,23360,0,0,0,1,1
49133,110,10476,15360;16053,23360,0,0,0,2,2
49134,110,10477,15675,23360,0,0,0,1,1
49135,110,10478,15513;15686,23360,0,0,0,2,2
49136,110,10479,15006;15718,23360,0,0,0,2,2
49137,110,10480,16134;16143;20221,23360,0,0,3,0,3
49138,110,10482,15738,23360,0,0,0,1,1
49139,110,10483,15743,23360,0,0,0,1,1
49140,110,10484,15534,23360,0,0,0,1,1
49141,110,10485,15484;15784,23360,0,0,0,2,2
49142,110,10486,15984;19593,23360,0,0,1,1,2
49143,110,10487,15848;16203,23360,0,0,1,1,2
49144,110,10488,15839;15968;20986,23360,0,0,1,2,3
49145,110,10489,15570;16223,23360,0,0,1,1,2
49146,110,10490,15875;15879,23360,0,0,0,2,2
49147,110,10491,15850,23360,0,0,0,1,1
49148,110,10492,16168,23360,0,0,1,0,1
49149,110,10493,15876,23360,0,0,0,1,1
49150,110,10494,16125,23360,0,0,1,0,1
49151,110,10495,15735,23360,0,0,0,1,1
49152,110,10496,15765;15925;20484,23360,0,0,1,2,3
49153,110,10519,13069,23725,0,0,0,1,1
49154,110,10531,13649;13869,23725,0,0,0,2,2
49155,110,10534,14350,23725,0,0,0,1,1
49156,110,10536,14645,23725,0,0,0,1,1
49157,110,10541,14257;14388,23725,0,0,0,2,2
49158,110,10544,14666;15290,23725,0,0,0,2,2
49159,110,10546,14750,23725,0,0,0,1,1
49160,110,10548,14625;14667,23725,0,0,0,2,2
49161,110,10549,14814;14999,23725,0,0,0,2,2
49162,110,10550,14899;15573,23725,0,0,0,2,2
49163,110,10551,15312;15757,23725,0,0,0,2,2
49164,110,10552,14955;15464,23725,0,0,0,2,2
49165,110,10556,14620;15148;19110,23725,0,0,1,2,3
49166,110,10557,15238;16201,23725,0,0,1,1,2
49167,110,10558,15236,23725,0,0,0,1,1
49168,110,10559,14959;15604,23725,0,0,0,2,2
49169,110,10564,15417;16070,23725,0,0,0,2,2
49170,110,10565,15797,23725,0,0,0,1,1
49171,110,10566,16293;16371;20446,23725,0,0,3,0,3
49172,110,10567,15726;16055,23725,0,0,0,2,2
49173,110,10568,15434;18874;22440,23725,0,1,1,1,3
49174,110,10570,16314;20300,23725,0,0,2,0,2
49175,110,10571,16114;20530;21029,23725,0,0,3,0,3
49176,110,10572,15584,23725,0,0,0,1,1
49177,110,10573,15591,23725,0,0,0,1,1
49178,110,10574,15499;15666,23725,0,0,0,2,2
49179,110,10575,16003;16283,23725,0,0,1,1,2
49180,110,10576,15710,23725,0,0,0,1,1
49181,110,10577,15503;16131;20228,23725,0,0,2,1,3
49182,110,10578,16092,23725,0,0,1,0,1
49183,110,10581,15438;15900,23725,0,0,0,2,2
49184,110,10582,15561;15903,23725,0,0,0,2,2
49185,110,10583,18409;18559;18869;21793;21939;22728;22744;22834;23041,23725,2,4,3,0,9
49186,110,10584,16163;20002,23725,0,0,2,0,2
49187,110,10585,15695;15976,23725,0,0,0,2,2
49188,110,10586,15978;16229,23725,0,0,1,1,2
49189,110,10587,16006;16159;19344;20923,23725,0,0,3,1,4
49190,110,10588,15156;16042,23725,0,0,0,2,2
49191,110,10621,12952,24090,0,0,0,1,1
49192,110,10629,13798,24090,0,0,0,1,1
49193,110,10638,13778;14386,24090,0,0,0,2,2
49194,110,10642,14176;14739,24090,0,0,0,2,2
49195,110,10645,14563;14797,24090,0,0,0,2,2
49196,110,10648,14774;14834,24090,0,0,0,2,2
49197,110,10649,14357;14864,24090,0,0,0,2,2
49198,110,10650,15274,24090,0,0,0,1,1
49199,110,10651,14960;15036,24090,0,0,0,2,2
49200,110,10653,14744;14966,24090,0,0,0,2,2
49201,110,10655,15117;15143,24090,0,0,0,2,2
49202,110,10656,15721;18798;22636;22945,24090,1,1,1,1,4
49203,110,10657,15163,24090,0,0,0,1,1
49204,110,10661,15231;15502,24090,0,0,0,2,2
49205,110,10662,14893;15233,24090,0,0,0,2,2
49206,110,10663,16065;20043;23109,24090,1,0,1,1,3
49207,110,10664,15251;15639;19586;22689;23293,24090,1,1,1,2,5
49208,110,10665,15620,24090,0,0,0,1,1
49209,110,10666,15892,24090,0,0,0,1,1
49210,110,10668,15827,24090,0,0,0,1,1
49211,110,10669,15724;16325,24090,0,0,1,1,2
49212,110,10670,15303;15810,24090,0,0,0,2,2
49213,110,10671,15835;15961,24090,0,0,0,2,2
49214,110,10672,15815;16045,24090,0,0,0,2,2
49215,110,10673,15565;15730,24090,0,0,0,2,2
49216,110,10675,14994,24090,0,0,0,1,1
49217,110,10676,15166;15616,24090,0,0,0,2,2
49218,110,10677,15627;16004,24090,0,0,0,2,2
49219,110,10678,15644,24090,0,0,0,1,1
49220,110,10679,16183;19965,24090,0,0,2,0,2
49221,110,10680,15652;16128,24090,0,0,1,1,2
49222,110,10681,15661;16232,24090,0,0,1,1,2
49223,110,10682,15733;15854,24090,0,0,0,2,2
49224,110,10683,15729;15999,24090,0,0,0,2,2
49225,110,10684,15559;15771,24090,0,0,0,2,2
49226,110,10685,14856;15817,24090,0,0,0,2,2
49227,110,10686,15789;15970,24090,0,0,0,2,2
49228,110,10687,15511;16028,24090,0,0,0,2,2
49229,110,10688,15927;16071,24090,0,0,0,2,2
49230,110,10689,15532;15831,24090,0,0,0,2,2
49231,110,10690,15856;16171;20573,24090,0,0,2,1,3
49232,110,10691,15736;16021;20040,24090,0,0,1,2,3
49233,110,10692,16081;16226,24090,0,0,2,0,2
49234,110,10694,15352;16186,24090,0,0,1,1,2
49235,110,10695,16017;16278;20255,24090,0,0,2,1,3
49236,110,10696,15997,24090,0,0,0,1,1
49237,110,10697,15796;16405;18516,24090,0,0,2,1,3
49238,110,10698,15940;16471;18811,24090,0,0,2,1,3
49239,110,10699,16147;16176;21001,24090,0,0,3,0,3
49240,110,10701,16023,24090,0,0,0,1,1
49241,110,10702,15459;16030,24090,0,0,0,2,2
49242,110,10703,15704;16236,24090,0,0,1,1,2
49243,110,10704,15690;16227,24090,0,0,1,1,2
49244,110,10705,16438,24090,0,0,1,0,1
49245,110,10706,16050;16195,24090,0,0,1,1,2
49246,110,10707,16058;16087,24090,0,0,1,1,2
49247,110,10708,16105,24090,0,0,1,0,1
49248,110,10709,18318;18731;19012;22757;22954;23058,24090,2,1,3,0,6
49249,110,10710,16122;16265,24090,0,0,2,0,2
49250,110,10711,16140;20756,24090,0,0,2,0,2
49251,110,10712,16440,24090,0,0,1,0,1
49252,110,10719,11588,24455,0,0,0,1,1
49253,110,10724,12226,24455,0,0,0,1,1
49254,110,10727,12659,24455,0,0,0,1,1
49255,110,10728,13026,24455,0,0,0,1,1
49256,110,10736,14339,24455,0,0,0,1,1
49257,110,10745,14537;14546,24455,0,0,0,2,2
49258,110,10749,15102;15326,24455,0,0,0,2,2
49259,110,10750,14806,24455,0,0,0,1,1
49260,110,10752,14913;15015,24455,0,0,0,2,2
49261,110,10754,15567;15708,24455,0,0,0,2,2
49262,110,10755,15158,24455,0,0,0,1,1
49263,110,10756,15193;15642,24455,0,0,0,2,2
49264,110,10758,15105;15425,24455,0,0,0,2,2
49265,110,10760,15333;15886;20104;23018,24455,1,0,1,2,4
49266,110,10761,18791;18844;22856;23053;23151,24455,3,0,2,0,5
49267,110,10762,15273,24455,0,0,0,1,1
49268,110,10763,14896;15292,24455,0,0,0,2,2
49269,110,10764,15087;15581;19841,24455,0,0,1,2,3
49270,110,10765,15398,24455,0,0,0,1,1
49271,110,10766,15041;15419,24455,0,0,0,2,2
49272,110,10767,15270;15930;18822;22640;22947,24455,1,1,1,2,5
49273,110,10768,15624;15915,24455,0,0,0,2,2
49274,110,10769,15097,24455,0,0,0,1,1
49275,110,10770,15673;15778,24455,0,0,0,2,2
49276,110,10771,16118,24455,0,0,1,0,1
49277,110,10772,15553,24455,0,0,0,1,1
49278,110,10773,16037,24455,0,0,0,1,1
49279,110,10774,15756;15931;20063,24455,0,0,1,2,3
49280,110,10776,16330;16455;20070;23220,24455,1,0,3,0,4
49281,110,10777,16199;16706;18899,24455,0,0,3,0,3
49282,110,10778,15791;16097,24455,0,0,1,1,2
49283,110,10779,15799;15838;19557,24455,0,0,1,2,3
49284,110,10780,15241;16007;18993,24455,0,0,1,2,3
49285,110,10781,15107,24455,0,0,0,1,1
49286,110,10782,15028;15883,24455,0,0,0,2,2
49287,110,10783,15897;16160;20115,24455,0,0,2,1,3
49288,110,10784,15480;15928,24455,0,0,0,2,2
49289,110,10785,15950;16101;19355,24455,0,0,2,1,3
49290,110,10786,16579;20008;20975,24455,0,0,3,0,3
49291,110,10787,15987;16049,24455,0,0,0,2,2
49292,110,10789,15922;16033,24455,0,0,0,2,2
49293,110,10790,16200;16307,24455,0,0,2,0,2
49294,110,10791,15429;16069,24455,0,0,0,2,2
49295,110,10792,16324;16637,24455,0,0,2,0,2
49296,110,10793,16412,24455,0,0,1,0,1
49297,110,10794,16164,24455,0,0,1,0,1
49298,110,10795,15956;16255,24455,0,0,1,1,2
49299,110,10796,15717;16221,24455,0,0,1,1,2
49300,110,10798,16241;16281,24455,0,0,2,0,2
49301,110,10799,16254;16643,24455,0,0,2,0,2
49302,110,10800,16272,24455,0,0,1,0,1
49303,110,10814,12205;12236,24820,0,0,0,2,2
49304,110,10821,12717,24820,0,0,0,1,1
49305,110,10825,13211,24820,0,0,0,1,1
49306,110,10828,13987,24820,0,0,0,1,1
49307,110,10835,14170;14325,24820,0,0,0,2,2
49308,110,10836,14182;14440,24820,0,0,0,2,2
49309,110,10838,15049,24820,0,0,0,1,1
49310,110,10840,14459,24820,0,0,0,1,1
49311,110,10841,14488;15307,24820,0,0,0,2,2
49312,110,10844,13962;14635,24820,0,0,0,2,2
49313,110,10845,14686;15586,24820,0,0,0,2,2
49314,110,10846,14692;15129,24820,0,0,0,2,2
49315,110,10847,13832;14410,24820,0,0,0,2,2
49316,110,10848,15009,24820,0,0,0,1,1
49317,110,10849,14732,24820,0,0,0,1,1
49318,110,10850,14593;19821,24820,0,0,1,1,2
49319,110,10854,14581;14912,24820,0,0,0,2,2
49320,110,10856,15169,24820,0,0,0,1,1
49321,110,10858,14734;15184,24820,0,0,0,2,2
49322,110,10859,15172;15258,24820,0,0,0,2,2
49323,110,10860,15615;15820,24820,0,0,0,2,2
49324,110,10861,15469;16174,24820,0,0,1,1,2
49325,110,10862,14680,24820,0,0,0,1,1
49326,110,10863,14858;15343,24820,0,0,0,2,2
49327,110,10865,15108;15388,24820,0,0,0,2,2
49328,110,10866,15353;15483,24820,0,0,0,2,2
49329,110,10868,15660;15993,24820,0,0,0,2,2
49330,110,10869,15540;15834,24820,0,0,0,2,2
49331,110,10870,15266;15424,24820,0,0,0,2,2
49332,110,10871,15696;15836,24820,0,0,0,2,2
49333,110,10872,15983;16417,24820,0,0,1,1,2
49334,110,10874,16228;16370,24820,0,0,2,0,2
49335,110,10875,15712;16095,24820,0,0,1,1,2
49336,110,10876,15805;16386;18826,24820,0,0,2,1,3
49337,110,10877,15742,24820,0,0,0,1,1
49338,110,10878,16035;16107,24820,0,0,1,1,2
49339,110,10879,19787;20060,24820,0,0,2,0,2
49340,110,10880,15594;15807,24820,0,0,0,2,2
49341,110,10881,16244;16392;19291;20358,24820,0,0,4,0,4
49342,110,10882,15837;15843;19271,24820,0,0,1,2,3
49343,110,10883,15846;16126;20392,24820,0,0,2,1,3
49344,110,10884,16063;16181;20777,24820,0,0,2,1,3
49345,110,10885,15165;15891;20087,24820,0,0,1,2,3
49346,110,10886,15929;16106,24820,0,0,1,1,2
49347,110,10887,15969,24820,0,0,0,1,1
49348,110,10889,15986;16248;20379,24820,0,0,2,1,3
49349,110,10890,15990;16109,24820,0,0,1,1,2
49350,110,10891,16320;16511;20025;21159;23319,24820,1,0,4,0,5
49351,110,10892,16012,24820,0,0,0,1,1
49352,110,10893,16074;16286,24820,0,0,2,0,2
49353,110,10895,16117;16552,24820,0,0,2,0,2
49354,110,10896,15943;16145,24820,0,0,1,1,2
49355,110,10897,15824;16151,24820,0,0,1,1,2
49356,110,10898,15823;16156,24820,0,0,1,1,2
49357,110,10899,16066;16196;19570,24820,0,0,2,1,3
49358,110,10900,16205;16754,24820,0,0,2,0,2
49359,110,10902,16277;16501;21127,24820,0,0,3,0,3
49360,110,10903,15992;16243,24820,0,0,1,1,2
49361,110,10904,16246,24820,0,0,1,0,1
49362,110,10905,16383;16494,24820,0,0,2,0,2
49363,110,10906,16483;16836,24820,0,0,2,0,2
49364,110,10907,16345;20274,24820,0,0,2,0,2
49365,110,10908,16570;16880;18852,24820,0,0,3,0,3
49366,110,10909,16048;16369;19960,24820,0,0,2,1,3
49367,110,10910,15857;16373,24820,0,0,1,1,2
49368,110,10912,16409;16535;21165,24820,0,0,3,0,3
49369,110,10913,16691;16739,24820,0,0,2,0,2
49370,110,10914,16344;16771;19146,24820,0,0,3,0,3
49371,110,10915,15917;16467,24820,0,0,1,1,2
49372,110,10935,12984,25185,0,0,0,1,1
49373,110,10938,13133;13856,25185,0,0,0,2,2
49374,110,10950,14627,25185,0,0,0,1,1
49375,110,10952,14785;14946,25185,0,0,0,2,2
49376,110,10956,14713;14860,25185,0,0,0,2,2
49377,110,10957,14572;14636,25185,0,0,0,2,2
49378,110,10962,14868;15040,25185,0,0,0,2,2
49379,110,10965,14925;15367,25185,0,0,0,2,2
49380,110,10966,14414;14677,25185,0,0,0,2,2
49381,110,10968,15139;15355,25185,0,0,0,2,2
49382,110,10970,15336,25185,0,0,0,1,1
49383,110,10971,15020;15344;19174,25185,0,0,1,2,3
49384,110,10973,15868,25185,0,0,0,1,1
49385,110,10974,15833;15870,25185,0,0,0,2,2
49386,110,10975,15813;16185,25185,0,0,1,1,2
49387,110,10976,15563;16177,25185,0,0,1,1,2
49388,110,10977,15877;16016,25185,0,0,0,2,2
49389,110,10978,15722;16032,25185,0,0,0,2,2
49390,110,10979,15618,25185,0,0,0,1,1
49391,110,10980,15871;19793,25185,0,0,1,1,2
49392,110,10981,15560;15651,25185,0,0,0,2,2
49393,110,10983,16346,25185,0,0,1,0,1
49394,110,10984,16216,25185,0,0,1,0,1
49395,110,10985,15801;16013,25185,0,0,0,2,2
49396,110,10986,15965,25185,0,0,0,1,1
49397,110,10987,15865,25185,0,0,0,1,1
49398,110,10988,15947,25185,0,0,0,1,1
49399,110,10989,15955;16531;20716,25185,0,0,2,1,3
49400,110,10990,14819;15045,25185,0,0,0,2,2
49401,110,10991,16014,25185,0,0,0,1,1
49402,110,10992,16136,25185,0,0,1,0,1
49403,110,10993,15971,25185,0,0,0,1,1
49404,110,10994,16027;16075,25185,0,0,1,1,2
49405,110,10995,15608;16059,25185,0,0,0,2,2
49406,110,10996,16068;16413,25185,0,0,1,1,2
49407,110,10997,16083;16692,25185,0,0,2,0,2
49408,110,10999,16091;16709,25185,0,0,2,0,2
49409,110,11000,16093,25185,0,0,1,0,1
49410,110,11001,16110;19404,25185,0,0,2,0,2
49411,110,11002,15844;16251,25185,0,0,1,1,2
49412,110,11004,15859;16627;20290,25185,0,0,2,1,3
49413,110,11006,16421;16498,25185,0,0,2,0,2
49414,110,11007,16240;16753,25185,0,0,2,0,2
49415,110,11009,15830;16245;20083,25185,0,0,2,1,3
49416,110,11010,15941;16263,25185,0,0,1,1,2
49417,110,11011,16269;16796,25185,0,0,2,0,2
49418,110,11012,16187;16298,25185,0,0,2,0,2
49419,110,11013,16301,25185,0,0,1,0,1
49420,110,11014,16116;16772;20640,25185,0,0,3,0,3
49421,110,11015,16318,25185,0,0,1,0,1
49422,110,11016,16336;16559,25185,0,0,2,0,2
49423,110,11017,16340,25185,0,0,1,0,1
49424,110,11018,16349;16841,25185,0,0,2,0,2
49425,110,11019,16504;20658,25185,0,0,2,0,2
49426,110,11020,16259;16422,25185,0,0,2,0,2
49427,110,11021,16085;16485;19468;20910,25185,0,0,4,0,4
49428,110,11022,16115;16428;20871,25185,0,0,3,0,3
49429,110,11023,16432;16536;20391,25185,0,0,3,0,3
49430,110,11024,16010;16437;20337,25185,0,0,2,1,3
49431,110,11025,16146;16560,25185,0,0,2,0,2
49432,110,11026,15946;16377;19925;23009,25185,1,0,2,1,4
49433,110,11027,15818;16458,25185,0,0,1,1,2
49434,110,11028,16480;16625,25185,0,0,2,0,2
49435,110,11029,16745;16803;20796;22928,25185,1,0,3,0,4
49436,110,11030,16493,25185,0,0,1,0,1
49437,110,11031,16519,25185,0,0,1,0,1
49438,110,11032,16549,25185,0,0,1,0,1
49439,110,11033,16439;16553,25185,0,0,2,0,2
49440,110,11041,12093,25550,0,0,0,1,1
49441,110,11046,12038,25550,0,0,0,1,1
49442,110,11049,11941;12493,25550,0,0,0,2,2
49443,110,11056,12642,25550,0,0,0,1,1
49444,110,11060,13412,25550,0,0,0,1,1
49445,110,11068,13520,25550,0,0,0,1,1
49446,110,11070,13896,25550,0,0,0,1,1
49447,110,11077,13918,25550,0,0,0,1,1
49448,110,11082,14401,25550,0,0,0,1,1
49449,110,11085,14172,25550,0,0,0,1,1
49450,110,11087,15728;15828,25550,0,0,0,2,2
49451,110,11091,15405,25550,0,0,0,1,1
49452,110,11092,15037,25550,0,0,0,1,1
49453,110,11093,15069,25550,0,0,0,1,1
49454,110,11094,14728;15114,25550,0,0,0,2,2
49455,110,11095,15136;15324,25550,0,0,0,2,2
49456,110,11096,15150,25550,0,0,0,1,1
49457,110,11098,15232;15354,25550,0,0,0,2,2
49458,110,11099,15257,25550,0,0,0,1,1
49459,110,11101,15400;16150,25550,0,0,1,1,2
49460,110,11105,15018;15587,25550,0,0,0,2,2
49461,110,11107,15723;15989,25550,0,0,0,2,2
49462,110,11108,16178;16358,25550,0,0,2,0,2
49463,110,11109,16287;16407,25550,0,0,2,0,2
49464,110,11110,16108,25550,0,0,1,0,1
49465,110,11112,15977,25550,0,0,0,1,1
49466,110,11114,15746;16096;19373,25550,0,0,2,1,3
49467,110,11116,15372;16474,25550,0,0,1,1,2
49468,110,11117,15988;16197,25550,0,0,1,1,2
49469,110,11119,16741;20876;23256,25550,1,0,2,0,3
49470,110,11120,15740;16162,25550,0,0,1,1,2
49471,110,11121,16169;16461,25550,0,0,2,0,2
49472,110,11123,16652,25550,0,0,1,0,1
49473,110,11124,15531;16204,25550,0,0,1,1,2
49474,110,11126,16129;16207,25550,0,0,2,0,2
49475,110,11127,16634,25550,0,0,1,0,1
49476,110,11128,15386;16170;19962,25550,0,0,2,1,3
49477,110,11129,16252;17062;19820,25550,0,0,3,0,3
49478,110,11130,16297;16610,25550,0,0,2,0,2
49479,110,11132,16294;16518,25550,0,0,2,0,2
49480,110,11133,16526;17063;20236,25550,0,0,3,0,3
49481,110,11134,16683;16786,25550,0,0,2,0,2
49482,110,11135,15849;16337;20362;22822;22919;23023,25550,2,1,2,1,6
49483,110,11136,15873;16339,25550,0,0,1,1,2
49484,110,11137,16343,25550,0,0,1,0,1
49485,110,11139,15524;16375,25550,0,0,1,1,2
49486,110,11140,19405;19652;20246;20845;22886;22931;23083,25550,3,0,4,0,7
49487,110,11141,16656;16822,25550,0,0,2,0,2
49488,110,11142,16456;16472;21115,25550,0,0,3,0,3
49489,110,11143,16512;16722,25550,0,0,2,0,2
49490,110,11144,16612;20847,25550,0,0,2,0,2
49491,110,11145,16537;16818;20730,25550,0,0,3,0,3
49492,110,11146,16888;16913,25550,0,0,2,0,2
49493,110,11147,16424;16562,25550,0,0,2,0,2
49494,110,11148,16576;16782;19992,25550,0,0,3,0,3
49495,110,11149,16584;20346,25550,0,0,2,0,2
49496,110,11150,16329;16603,25550,0,0,2,0,2
49497,110,11152,16616,25550,0,0,1,0,1
49498,110,11153,16936,25550,0,0,1,0,1
49499,110,11154,16389;16904,25550,0,0,2,0,2
49500,110,11155,16302;16791;20750,25550,0,0,3,0,3
49501,110,11156,16039;16650,25550,0,0,1,1,2
49502,110,11157,16663;19700;22897,25550,1,0,2,0,3
49503,110,11158,16673;17060,25550,0,0,2,0,2
49504,110,11159,16253;16675,25550,0,0,2,0,2
49505,110,11174,12602,25915,0,0,0,1,1
49506,110,11176,12576,25915,0,0,0,1,1
49507,110,11180,13046,25915,0,0,0,1,1
49508,110,11182,12950,25915,0,0,0,1,1
49509,110,11188,13232,25915,0,0,0,1,1
49510,110,11200,13872,25915,0,0,0,1,1
49511,110,11206,13650,25915,0,0,0,1,1
49512,110,11214,15073;15153,25915,0,0,0,2,2
49513,110,11215,15168,25915,0,0,0,1,1
49514,110,11216,14988,25915,0,0,0,1,1
49515,110,11220,14839;15280,25915,0,0,0,2,2
49516,110,11223,14471;14900,25915,0,0,0,2,2
49517,110,11224,16139,25915,0,0,1,0,1
49518,110,11227,15436;15774,25915,0,0,0,2,2
49519,110,11228,15755;16154,25915,0,0,1,1,2
49520,110,11230,16334;19551;19898;22994;23182,25915,2,0,3,0,5
49521,110,11231,15375;15653,25915,0,0,0,2,2
49522,110,11232,15706;15951,25915,0,0,0,2,2
49523,110,11233,15745;16175,25915,0,0,1,1,2
49524,110,11234,15881;16209,25915,0,0,1,1,2
49525,110,11235,15966;16284;19446;22889;22985,25915,2,0,2,1,5
49526,110,11236,16266;16690,25915,0,0,2,0,2
49527,110,11237,16380;20266,25915,0,0,2,0,2
49528,110,11238,16497;20261,25915,0,0,2,0,2
49529,110,11239,15945;16214,25915,0,0,1,1,2
49530,110,11240,16144,25915,0,0,1,0,1
49531,110,11241,16157;16441,25915,0,0,2,0,2
49532,110,11242,16575;16593,25915,0,0,2,0,2
49533,110,11243,15753;16210,25915,0,0,1,1,2
49534,110,11245,16406,25915,0,0,1,0,1
49535,110,11246,16299,25915,0,0,1,0,1
49536,110,11247,16618;16779;20637;21047,25915,0,0,4,0,4
49537,110,11249,16561;16947,25915,0,0,2,0,2
49538,110,11250,16365;20904,25915,0,0,2,0,2
49539,110,11251,15880;16442,25915,0,0,1,1,2
49540,110,11252,16705,25915,0,0,1,0,1
49541,110,11253,15906;16433,25915,0,0,1,1,2
49542,110,11255,16469;16768;18897,25915,0,0,3,0,3
49543,110,11257,16798;20347;23021;23119,25915,2,0,2,0,4
49544,110,11258,16941,25915,0,0,1,0,1
49545,110,11260,16462;20914,25915,0,0,2,0,2
49546,110,11261,16508;16555,25915,0,0,2,0,2
49547,110,11262,16766;16984;20659;20928,25915,0,0,4,0,4
49548,110,11263,16425;16564;21383,25915,0,0,3,0,3
49549,110,11264,16609,25915,0,0,1,0,1
49550,110,11265,16617,25915,0,0,1,0,1
49551,110,11266,16832;17103;20405;21520;22920,25915,1,1,3,0,5
49552,110,11267,16646;16785,25915,0,0,2,0,2
49553,110,11268,16342;16651;20597;20984,25915,0,0,4,0,4
49554,110,11270,16661;20439,25915,0,0,2,0,2
49555,110,11272,16719;16831,25915,0,0,2,0,2
49556,110,11273,16732;17129;19088;19973,25915,0,0,4,0,4
49557,110,11274,16733;16817;20588;21290,25915,0,0,4,0,4
49558,110,11275,16762,25915,0,0,1,0,1
49559,110,11276,16304;17095,25915,0,0,2,0,2
49560,110,11277,16359;16770,25915,0,0,2,0,2
49561,110,11278,16703;16788;19546,25915,0,0,3,0,3
49562,110,11279,16793;16869;20454,25915,0,0,3,0,3
49563,110,11280,17135,25915,0,0,1,0,1
49564,110,11281,16237;16806,25915,0,0,2,0,2
49565,110,11282,16556;16963;21346,25915,0,0,3,0,3
49566,110,11294,12142,26280,0,0,0,1,1
49567,110,11304,13102,26280,0,0,0,1,1
49568,110,11307,13442,26280,0,0,0,1,1
49569,110,11309,14373,26280,0,0,0,1,1
49570,110,11310,13985;14303,26280,0,0,0,2,2
49571,110,11322,14910,26280,0,0,0,1,1
49572,110,11323,14832,26280,0,0,0,1,1
49573,110,11324,15111,26280,0,0,0,1,1
49574,110,11326,14688;14989,26280,0,0,0,2,2
49575,110,11329,15276,26280,0,0,0,1,1
49576,110,11332,15330;15475,26280,0,0,0,2,2
49577,110,11334,15550;15727,26280,0,0,0,2,2
49578,110,11335,15350;15552,26280,0,0,0,2,2
49579,110,11336,15096;15582,26280,0,0,0,2,2
49580,110,11339,15546,26280,0,0,0,1,1
49581,110,11340,14509;14822,26280,0,0,0,2,2
49582,110,11341,16532;16541,26280,0,0,2,0,2
49583,110,11342,14874;15862,26280,0,0,0,2,2
49584,110,11343,15699;15798,26280,0,0,0,2,2
49585,110,11344,15904;16220;19954;22811,26280,0,1,2,1,4
49586,110,11346,16080;16641;20518,26280,0,0,3,0,3
49587,110,11347,16019;16064,26280,0,0,0,2,2
49588,110,11348,16130;16404;19909,26280,0,0,3,0,3
49589,110,11349,16149;16670,26280,0,0,2,0,2
49590,110,11350,16445;16819;20696,26280,0,0,3,0,3
49591,110,11351,15991;16700;20139;23229,26280,1,0,2,1,4
49592,110,11352,16189;16194,26280,0,0,2,0,2
49593,110,11353,16681;16859,26280,0,0,2,0,2
49594,110,11354,16319,26280,0,0,1,0,1
49595,110,11355,16689,26280,0,0,1,0,1
49596,110,11356,16268;16300;20691,26280,0,0,3,0,3
49597,110,11357,16704;16833,26280,0,0,2,0,2
49598,110,11359,16192;16332;19929,26280,0,0,3,0,3
49599,110,11360,16735;16811,26280,0,0,2,0,2
49600,110,11361,15994;16364;20425;20868,26280,0,0,3,1,4
49601,110,11362,16635;16891;20305;23020;23234,26280,2,0,3,0,5
49602,110,11363,16158;16390;19769,26280,0,0,3,0,3
49603,110,11364,16103;16399,26280,0,0,2,0,2
49604,110,11366,15679;16403,26280,0,0,1,1,2
49605,110,11367,16903;19509,26280,0,0,2,0,2
49606,110,11368,16539;16573,26280,0,0,2,0,2
49607,110,11369,16510;16630,26280,0,0,2,0,2
49608,110,11370,16001;16514;20003,26280,0,0,2,1,3
49609,110,11371,16877;17003;21177;21423;21582,26280,0,1,4,0,5
49610,110,11372,16306;16563,26280,0,0,2,0,2
49611,110,11373,16569;19706;23094;23194,26280,2,0,2,0,4
49612,110,11374,17116;17240,26280,0,0,2,0,2
49613,110,11375,16669;16917,26280,0,0,2,0,2
49614,110,11376,16523;16665;20534,26280,0,0,3,0,3
49615,110,11377,16679;16912;20862,26280,0,0,3,0,3
49616,110,11378,16452;16940;20289,26280,0,0,3,0,3
49617,110,11379,16698;16897;21180;23356,26280,1,0,3,0,4
49618,110,11380,17306;17309;20123;22819;23225,26280,1,1,3,0,5
49619,110,11381,16270;17025,26280,0,0,2,0,2
49620,110,11382,16672;17122;21660,26280,0,1,2,0,3
49621,110,11383,16794;20800,26280,0,0,2,0,2
49622,110,11385,16477;16828,26280,0,0,2,0,2
49623,110,11386,16795;17266;20849;21341,26280,0,0,4,0,4
49624,110,11387,16874;17144,26280,0,0,2,0,2
49625,110,11388,17001;17180;19226;20666,26280,0,0,4,0,4
49626,110,11389,16491;16905,26280,0,0,2,0,2
49627,110,11390,16496;16909,26280,0,0,2,0,2
49628,110,11391,16631;17154;20815,26280,0,0,3,0,3
49629,110,11392,16645;17292;20900,26280,0,0,3,0,3
49630,110,11393,16918;17077,26280,0,0,2,0,2
49631,110,11394,16231;16919;20461,26280,0,0,3,0,3
49632,110,11404,12131,26645,0,0,0,1,1
49633,110,11406,12476,26645,0,0,0,1,1
49634,110,11419,13327,26645,0,0,0,1,1
49635,110,11426,14343,26645,0,0,0,1,1
49636,110,11429,14547;14698,26645,0,0,0,2,2
49637,110,11435,15022;15050,26645,0,0,0,2,2
49638,110,11436,15391,26645,0,0,0,1,1
49639,110,11439,15382,26645,0,0,0,1,1
49640,110,11441,15535;15551,26645,0,0,0,2,2
49641,110,11444,16427,26645,0,0,1,0,1
49642,110,11445,15684;15773,26645,0,0,0,2,2
49643,110,11446,15763,26645,0,0,0,1,1
49644,110,11448,15788,26645,0,0,0,1,1
49645,110,11449,15920;16198,26645,0,0,1,1,2
49646,110,11450,15737;15953,26645,0,0,0,2,2
49647,110,11451,15288;15861;19543,26645,0,0,1,2,3
49648,110,11452,16111;16712,26645,0,0,2,0,2
49649,110,11453,16487;16521,26645,0,0,2,0,2
49650,110,11454,16138;16191;20182,26645,0,0,3,0,3
49651,110,11455,16242;16450,26645,0,0,2,0,2
49652,110,11456,16275;16448;19834,26645,0,0,3,0,3
49653,110,11457,16088;16333,26645,0,0,2,0,2
49654,110,11458,16420,26645,0,0,1,0,1
49655,110,11459,16099;16338,26645,0,0,2,0,2
49656,110,11460,16942;16974;19884,26645,0,0,3,0,3
49657,110,11461,16678;16816,26645,0,0,2,0,2
49658,110,11462,16736;16789;21058,26645,0,0,3,0,3
49659,110,11463,16381;17134,26645,0,0,2,0,2
49660,110,11464,15974;16382,26645,0,0,1,1,2
49661,110,11465,16024;16356;20514,26645,0,0,2,1,3
49662,110,11466,17178;17220,26645,0,0,2,0,2
49663,110,11467,16315;16447;20438;20565,26645,0,0,4,0,4
49664,110,11468,16674;20357,26645,0,0,2,0,2
49665,110,11469,15858;16509,26645,0,0,1,1,2
49666,110,11470,16173;16538;20428,26645,0,0,3,0,3
49667,110,11472,16551;20451;21106;23335,26645,1,0,3,0,4
49668,110,11473,16492;16588;20408;22601,26645,0,1,3,0,4
49669,110,11474,16167;16202,26645,0,0,2,0,2
49670,110,11476,16971;20215,26645,0,0,2,0,2
49671,110,11477,16546;16671;20564;21295,26645,0,0,4,0,4
49672,110,11479,16132;16684,26645,0,0,2,0,2
49673,110,11480,16699,26645,0,0,1,0,1
49674,110,11481,16708,26645,0,0,1,0,1
49675,110,11482,16388;16714,26645,0,0,2,0,2
49676,110,11483,16184;17101;21267;21633,26645,0,1,3,0,4
49677,110,11484,17145;17168;21283,26645,0,0,3,0,3
49678,110,11485,16481;16734;20243;20441,26645,0,0,4,0,4
49679,110,11486,16568,26645,0,0,1,0,1
49680,110,11487,16693;16716,26645,0,0,2,0,2
49681,110,11488,16765;16953;20608,26645,0,0,3,0,3
49682,110,11490,16908,26645,0,0,1,0,1
49683,110,11491,16879;17051,26645,0,0,2,0,2
49684,110,11492,16810;16825;20018,26645,0,0,3,0,3
49685,110,11493,16208;16830,26645,0,0,2,0,2
49686,110,11494,16842;17187,26645,0,0,2,0,2
49687,110,11495,16851;21200,26645,0,0,2,0,2
49688,110,11496,16926;20537,26645,0,0,2,0,2
49689,110,11497,16725;17014;21237,26645,0,0,3,0,3
49690,110,11498,16835;16876;20120;22272,26645,0,1,3,0,4
49691,110,11499,16889;17106,26645,0,0,2,0,2
49692,110,11500,16490;16907,26645,0,0,2,0,2
49693,110,11501,17117,26645,0,0,1,0,1
49694,110,11502,17024;17177,26645,0,0,2,0,2
49695,110,11504,16962;17221;20712;23135,26645,1,0,3,0,4
49696,110,11505,16968;17068,26645,0,0,2,0,2
49697,110,11506,16990;17128;21339;21431,26645,0,1,3,0,4
49698,110,11507,16758;16992;20539;20794;21974,26645,0,1,4,0,5
49699,110,11509,16906;17227;19556;20824;21780,26645,0,1,4,0,5
49700,110,11510,17019;17127;19267;20713;20877,26645,0,0,5,0,5
49701,110,11511,17026;17155,26645,0,0,2,0,2
49702,110,11512,16916;17029,26645,0,0,2,0,2
49703,110,11517,11559,27010,0,0,0,1,1
49704,110,11523,11957;11988,27010,0,0,0,2,2
49705,110,11524,12895,27010,0,0,0,1,1
49706,110,11533,12865,27010,0,0,0,1,1
49707,110,11545,13742;13752,27010,0,0,0,2,2
49708,110,11549,14634;15297,27010,0,0,0,2,2
49709,110,11550,14700;14950,27010,0,0,0,2,2
49710,110,11552,15100,27010,0,0,0,1,1
49711,110,11554,15373;15603,27010,0,0,0,2,2
49712,110,11555,15376;15760,27010,0,0,0,2,2
49713,110,11556,15428;15528,27010,0,0,0,2,2
49714,110,11558,15529;15942,27010,0,0,0,2,2
49715,110,11562,15074,27010,0,0,0,1,1
49716,110,11563,15668;15803,27010,0,0,0,2,2
49717,110,11565,15780;15852,27010,0,0,0,2,2
49718,110,11566,16038,27010,0,0,0,1,1
49719,110,11567,15500,27010,0,0,0,1,1
49720,110,11568,15908;16000,27010,0,0,0,2,2
49721,110,11570,15923;15972,27010,0,0,0,2,2
49722,110,11571,16372;20241,27010,0,0,2,0,2
49723,110,11572,15669;16267;20704,27010,0,0,2,1,3
49724,110,11573,15409;15599,27010,0,0,0,2,2
49725,110,11575,16230;16597,27010,0,0,2,0,2
49726,110,11576,16172;16686,27010,0,0,2,0,2
49727,110,11577,16606;16774,27010,0,0,2,0,2
49728,110,11578,16368,27010,0,0,1,0,1
49729,110,11580,17022,27010,0,0,1,0,1
49730,110,11581,16513;19508;20952,27010,0,0,3,0,3
49731,110,11583,16446;16866,27010,0,0,2,0,2
49732,110,11584,16218;16594;20957,27010,0,0,3,0,3
49733,110,11585,16533;16578;20082,27010,0,0,3,0,3
49734,110,11586,16799;16857;19617,27010,0,0,3,0,3
49735,110,11587,16602;16883;20752,27010,0,0,3,0,3
49736,110,11588,15909;16638,27010,0,0,1,1,2
49737,110,11589,16596;20171,27010,0,0,2,0,2
49738,110,11590,16862;17170;20303;21032;22036,27010,0,1,4,0,5
49739,110,11591,16249;16921;21260,27010,0,0,3,0,3
49740,110,11592,16929;17028,27010,0,0,2,0,2
49741,110,11593,16820;16988;21179;23259,27010,1,0,3,0,4
49742,110,11594,16737;20809,27010,0,0,2,0,2
49743,110,11595,16567;16846;20766,27010,0,0,3,0,3
49744,110,11596,16856;17045,27010,0,0,2,0,2
49745,110,11597,16901;17393;20784,27010,0,0,3,0,3
49746,110,11598,16932;17064;20545,27010,0,0,3,0,3
49747,110,11599,17229;17327;21084,27010,0,0,3,0,3
49748,110,11601,16697;17253;20695,27010,0,0,3,0,3
49749,110,11602,16756;16954,27010,0,0,2,0,2
49750,110,11603,16878;17196;20905,27010,0,0,3,0,3
49751,110,11605,16982;17006;20656,27010,0,0,3,0,3
49752,110,11606,17031;17163;20478,27010,0,0,3,0,3
49753,110,11607,17206;17257;21268,27010,0,0,3,0,3
49754,110,11608,17017;17061,27010,0,0,2,0,2
49755,110,11609,17114;17411;20843;21666,27010,0,1,3,0,4
49756,110,11610,17079;17132;21245,27010,0,0,3,0,3
49757,110,11621,12640,27375,0,0,0,1,1
49758,110,11622,12714,27375,0,0,0,1,1
49759,110,11628,13169;13573,27375,0,0,0,2,2
49760,110,11641,14240;14800,27375,0,0,0,2,2
49761,110,11642,14941;15420,27375,0,0,0,2,2
49762,110,11643,14497;14781,27375,0,0,0,2,2
49763,110,11644,15301,27375,0,0,0,1,1
49764,110,11645,14758;15235,27375,0,0,0,2,2
49765,110,11650,14804;15256,27375,0,0,0,2,2
49766,110,11657,15485;15596,27375,0,0,0,2,2
49767,110,11658,15617;15981,27375,0,0,0,2,2
49768,110,11661,15747;15845,27375,0,0,0,2,2
49769,110,11662,15595;16040;20095;22715;23016,27375,1,1,1,2,5
49770,110,11664,15962;16213,27375,0,0,1,1,2
49771,110,11665,16430;16792;20479;21139,27375,0,0,4,0,4
49772,110,11666,16289;16354,27375,0,0,2,0,2
49773,110,11667,16215;16550,27375,0,0,2,0,2
49774,110,11671,16084;16326,27375,0,0,2,0,2
49775,110,11672,16464;21637,27375,0,1,1,0,2
49776,110,11674,16416,27375,0,0,1,0,1
49777,110,11675,16153;16350;20706;21171,27375,0,0,4,0,4
49778,110,11676,16668,27375,0,0,1,0,1
49779,110,11677,16577;20148;20875,27375,0,0,3,0,3
49780,110,11678,16516;16613;20629,27375,0,0,3,0,3
49781,110,11679,16500;16623;20833,27375,0,0,3,0,3
49782,110,11680,16629,27375,0,0,1,0,1
49783,110,11681,16624;16702,27375,0,0,2,0,2
49784,110,11682,16666;17210,27375,0,0,2,0,2
49785,110,11683,16120;16743;20648;20873,27375,0,0,4,0,4
49786,110,11684,16804;17297;21629,27375,0,1,2,0,3
49787,110,11685,16769;16852;20632;21369,27375,0,0,4,0,4
49788,110,11686,16783;17480;21936,27375,0,1,2,0,3
49789,110,11687,17239;17344;20988,27375,0,0,3,0,3
49790,110,11688,16834;17076;21351,27375,0,0,3,0,3
49791,110,11689,16844;17136;21195,27375,0,0,3,0,3
49792,110,11690,16853;17312;21066,27375,0,0,3,0,3
49793,110,11691,16435;16797,27375,0,0,2,0,2
49794,110,11692,16352;16864;20578;21371,27375,0,0,4,0,4
49795,110,11693,16870;17286;20386;22123,27375,0,1,3,0,4
49796,110,11694,16886;16972;20744,27375,0,0,3,0,3
49797,110,11695,16894;17021;20377,27375,0,0,3,0,3
49798,110,11696,16933;20700;23033,27375,1,0,2,0,3
49799,110,11697,17194,27375,0,0,1,0,1
49800,110,11698,16938;16949;21377,27375,0,0,3,0,3
49801,110,11699,16188;16945,27375,0,0,2,0,2
49802,110,11700,16960;17353,27375,0,0,2,0,2
49803,110,11701,16829;16965,27375,0,0,2,0,2
49804,110,11702,16720;16997,27375,0,0,2,0,2
49805,110,11704,17108;20094;21420,27375,0,0,3,0,3
49806,110,11705,16871;17039,27375,0,0,2,0,2
49807,110,11706,17065;17293;20088,27375,0,0,3,0,3
49808,110,11707,16499;17070;21996,27375,0,1,2,0,3
49809,110,11708,16740;17080,27375,0,0,2,0,2
49810,110,11709,16824;17328,27375,0,0,2,0,2
49811,110,11710,17090;17488;20100;20558,27375,0,0,4,0,4
49812,110,11711,17151;17201;20359;21871;22718;23121,27375,1,2,3,0,6
49813,110,11712,16759;17156,27375,0,0,2,0,2
49814,110,11713,17118;19482;20098;21223,27375,0,0,4,0,4
49815,110,11714,17562,27375,0,0,1,0,1
49816,110,11715,16934;17357;20774,27375,0,0,3,0,3
49817,110,11716,16581;17223;20897,27375,0,0,3,0,3
49818,110,11717,17088;17241;20283;20959,27375,0,0,4,0,4
49819,110,11718,16899;16995,27375,0,0,2,0,2
49820,110,11721,12213,27740,0,0,0,1,1
49821,110,11722,12161,27740,0,0,0,1,1
49822,110,11726,12608,27740,0,0,0,1,1
49823,110,11734,13411,27740,0,0,0,1,1
49824,110,11738,13397;13671,27740,0,0,0,2,2
49825,110,11741,13162,27740,0,0,0,1,1
49826,110,11748,13685;14322,27740,0,0,0,2,2
49827,110,11750,15089,27740,0,0,0,1,1
49828,110,11754,15178,27740,0,0,0,1,1
49829,110,11755,14979;15811,27740,0,0,0,2,2
49830,110,11758,15775;20253,27740,0,0,1,1,2
49831,110,11762,16351;16468;20371,27740,0,0,3,0,3
49832,110,11764,16484;16525,27740,0,0,2,0,2
49833,110,11766,16939,27740,0,0,1,0,1
49834,110,11768,16676;16892,27740,0,0,2,0,2
49835,110,11769,16687;17012;20599,27740,0,0,3,0,3
49836,110,11770,16685;16742;20389,27740,0,0,3,0,3
49837,110,11771,16589;19845;20902,27740,0,0,3,0,3
49838,110,11772,16238;16778;20743,27740,0,0,3,0,3
49839,110,11773,16282;16470;19745,27740,0,0,3,0,3
49840,110,11774,16955;17437;20837;21167,27740,0,0,4,0,4
49841,110,11775,17243,27740,0,0,1,0,1
49842,110,11777,16893;17011;20418;22720;23239,27740,1,1,3,0,5
49843,110,11778,16582;16614,27740,0,0,2,0,2
49844,110,11780,16885;21061;21275,27740,0,0,3,0,3
49845,110,11781,16902;17315,27740,0,0,2,0,2
49846,110,11782,17188;17394;19627;21083,27740,0,0,4,0,4
49847,110,11783,16802;16946,27740,0,0,2,0,2
49848,110,11784,16980;16985;20705,27740,0,0,3,0,3
49849,110,11785,16964;16998;20593,27740,0,0,3,0,3
49850,110,11786,17010;17092,27740,0,0,2,0,2
49851,110,11788,16868;17059;19735,27740,0,0,3,0,3
49852,110,11789,17048;17140;20907,27740,0,0,3,0,3
49853,110,11790,17099,27740,0,0,1,0,1
49854,110,11791,17283;17687;19501,27740,0,0,3,0,3
49855,110,11792,17248;17504;21164;21323,27740,0,0,4,0,4
49856,110,11793,17388;17655;20680,27740,0,0,3,0,3
49857,110,11794,17142;17235,27740,0,0,2,0,2
49858,110,11795,16701;17152;21101;21243,27740,0,0,4,0,4
49859,110,11796,16632;17164;21336,27740,0,0,3,0,3
49860,110,11797,16755;17175;20707;20926,27740,0,0,4,0,4
49861,110,11798,17181;17507;21296,27740,0,0,3,0,3
49862,110,11799,17203;17420;20996;21451;21806,27740,0,2,3,0,5
49863,110,11800,16986;17445;20552;22116,27740,0,1,3,0,4
49864,110,11801,17125;17302,27740,0,0,2,0,2
49865,110,11802,17182;17252;20864,27740,0,0,3,0,3
49866,110,11803,17255;17644;20822,27740,0,0,3,0,3
49867,110,11804,17256;17278;21878,27740,0,1,2,0,3
49868,110,11805,17289;17448;19569;21730,27740,0,1,3,0,4
49869,110,11806,17295;17371,27740,0,0,2,0,2
49870,110,11807,17236;17684;19524;20016;22574;22791,27740,0,2,4,0,6
49871,110,11808,16718;17285;20839;21124;21452,27740,0,1,4,0,5
49872,110,11809,17333;17482;20311;21699,27740,0,1,3,0,4
49873,110,11810,16925;17403;19888,27740,0,0,3,0,3
49874,110,11815,12345,28105,0,0,0,1,1
49875,110,11816,12094,28105,0,0,0,1,1
49876,110,11819,12620,28105,0,0,0,1,1
49877,110,11827,13148;13617,28105,0,0,0,2,2
49878,110,11833,13080,28105,0,0,0,1,1
49879,110,11843,13670,28105,0,0,0,1,1
49880,110,11844,14391,28105,0,0,0,1,1
49881,110,11845,14402,28105,0,0,0,1,1
49882,110,11848,14641,28105,0,0,0,1,1
49883,110,11849,14249;14768,28105,0,0,0,2,2
49884,110,11852,15216;15305,28105,0,0,0,2,2
49885,110,11854,15205;15787,28105,0,0,0,2,2
49886,110,11858,14964;15493,28105,0,0,0,2,2
49887,110,11861,15399,28105,0,0,0,1,1
49888,110,11866,16574;16682;20751,28105,0,0,3,0,3
49889,110,11869,16212;16943;20714;21533,28105,0,1,3,0,4
49890,110,11870,16615,28105,0,0,1,0,1
49891,110,11872,16290,28105,0,0,1,0,1
49892,110,11873,16394;16760;20536;20812;22829;23139,28105,1,1,4,0,6
49893,110,11874,16166;16408;20385,28105,0,0,3,0,3
49894,110,11876,17139;20820;23253,28105,1,0,2,0,3
49895,110,11877,16633,28105,0,0,1,0,1
49896,110,11879,16502;16860;20623,28105,0,0,3,0,3
49897,110,11880,16018;16520,28105,0,0,1,1,2
49898,110,11883,16451;16529;20157,28105,0,0,3,0,3
49899,110,11884,16222;16587,28105,0,0,2,0,2
49900,110,11885,16590,28105,0,0,1,0,1
49901,110,11886,16591;16658;21133,28105,0,0,3,0,3
49902,110,11887,16401;16598,28105,0,0,2,0,2
49903,110,11888,16607;16910,28105,0,0,2,0,2
49904,110,11889,16411;16983;20561;20779,28105,0,0,4,0,4
49905,110,11890,16975;20786;21148,28105,0,0,3,0,3
49906,110,11893,16882;16951;21387,28105,0,0,3,0,3
49907,110,11894,17093;17282;20763,28105,0,0,3,0,3
49908,110,11896,16890;17190;20769;23252,28105,1,0,3,0,4
49909,110,11897,16922;17329;19949;21566,28105,0,1,3,0,4
49910,110,11898,17067;17102;21042,28105,0,0,3,0,3
49911,110,11899,17082;17216,28105,0,0,2,0,2
49912,110,11900,17468;21288;21565;22053,28105,0,2,2,0,4
49913,110,11901,16360;17073;19921,28105,0,0,3,0,3
49914,110,11902,17097;17384,28105,0,0,2,0,2
49915,110,11903,17111;17440;20449;21638;22495,28105,0,2,3,0,5
49916,110,11904,17038;17270;21249,28105,0,0,3,0,3
49917,110,11905,16872;17264,28105,0,0,2,0,2
49918,110,11906,17147;17298;20619;21326;21609,28105,0,1,4,0,5
49919,110,11907,17326;17453;19594;22796;22995,28105,1,1,3,0,5
49920,110,11908,16935;17254,28105,0,0,2,0,2
49921,110,11909,17301;17740;20197;21513,28105,0,1,3,0,4
49922,110,11911,17121;17683;20535,28105,0,0,3,0,3
49923,110,11912,19661;19878;23310,28105,1,0,2,0,3
49924,110,11914,17131;17566,28105,0,0,2,0,2
49925,110,11915,17260;17338;22276,28105,0,1,2,0,3
49926,110,11916,17342;17417;21078,28105,0,0,3,0,3
49927,110,11917,17348;17399;21168,28105,0,0,3,0,3
49928,110,11918,17606;20370,28105,0,0,2,0,2
49929,110,11919,17359;17545;19883;21528,28105,0,1,3,0,4
49930,110,11920,17133;17775;21157;21263,28105,0,0,4,0,4
49931,110,11921,17237;17692;19801;21952,28105,0,1,3,0,4
49932,110,11922,17549;17761;22078,28105,0,1,2,0,3
49933,110,11923,17486;20973,28105,0,0,2,0,2
49934,110,11924,17525;17575;20789;22166,28105,0,1,3,0,4
49935,110,11925,12461,28470,0,0,0,1,1
49936,110,11930,12448,28470,0,0,0,1,1
49937,110,11932,13180,28470,0,0,0,1,1
49938,110,11933,12591,28470,0,0,0,1,1
49939,110,11935,12308,28470,0,0,0,1,1
49940,110,11936,12921,28470,0,0,0,1,1
49941,110,11938,12958,28470,0,0,0,1,1
49942,110,11939,12992,28470,0,0,0,1,1
49943,110,11942,13523,28470,0,0,0,1,1
49944,110,11950,15084,28470,0,0,0,1,1
49945,110,11952,14230;14801,28470,0,0,0,2,2
49946,110,11953,14286,28470,0,0,0,1,1
49947,110,11954,14477;14631,28470,0,0,0,2,2
49948,110,11955,14508;14511,28470,0,0,0,2,2
49949,110,11959,15038,28470,0,0,0,1,1
49950,110,11971,15725,28470,0,0,0,1,1
49951,110,11972,15099;15311,28470,0,0,0,2,2
49952,110,11973,15083;15314,28470,0,0,0,2,2
49953,110,11978,15933,28470,0,0,0,1,1
49954,110,11982,15246,28470,0,0,0,1,1
49955,110,11984,14938;15640,28470,0,0,0,2,2
49956,110,11986,15911;15998;19936,28470,0,0,1,2,3
49957,110,11987,14769;15224,28470,0,0,0,2,2
49958,110,11989,16060;16239,28470,0,0,1,1,2
49959,110,11993,16331;16335;20411,28470,0,0,3,0,3
49960,110,11994,15744;15899,28470,0,0,0,2,2
49961,110,11997,16323;16583,28470,0,0,2,0,2
49962,110,11998,16920;16928,28470,0,0,2,0,2
49963,110,11999,16717;16914;20764;23036,28470,1,0,3,0,4
49964,110,12000,17217;17311;20998,28470,0,0,3,0,3
49965,110,12001,16731;16780,28470,0,0,2,0,2
49966,110,12002,17119;20426,28470,0,0,2,0,2
49967,110,12003,17115,28470,0,0,1,0,1
49968,110,12004,16814;17046,28470,0,0,2,0,2
49969,110,12005,16839;17527,28470,0,0,2,0,2
49970,110,12006,17098;20372;21221,28470,0,0,3,0,3
49971,110,12007,17207;17400,28470,0,0,2,0,2
49972,110,12008,16987;17645;21224;21560;23360,28470,1,1,3,0,5
49973,110,12009,17020;17330;20526;20970,28470,0,0,4,0,4
49974,110,12010,16777;17249;21183;21746,28470,0,1,3,0,4
49975,110,12012,17091;17405,28470,0,0,2,0,2
49976,110,12013,17049;17096;20188,28470,0,0,3,0,3
49977,110,12015,17211;17294;20356;21235,28470,0,0,4,0,4
49978,110,12016,17161;17552;21186;21365,28470,0,0,4,0,4
49979,110,12017,17179;17275;20294,28470,0,0,3,0,3
49980,110,12018,17184;17706,28470,0,0,2,0,2
49981,110,12019,17362;17704;22170,28470,0,1,2,0,3
49982,110,12021,17401;17536,28470,0,0,2,0,2
49983,110,12022,17208;17528;21111;21327;22155;22167,28470,0,2,4,0,6
49984,110,12023,16930;17233;21208,28470,0,0,3,0,3
49985,110,12024,17538;21289,28470,0,0,2,0,2
49986,110,12025,17276;17485;21225,28470,0,0,3,0,3
49987,110,12026,17268;17304;20349,28470,0,0,3,0,3
49988,110,12027,17313;17450;20614;22164;23347,28470,1,1,3,0,5
49989,110,12028,17316;17646,28470,0,0,2,0,2
49990,110,12029,17322;17729;20331;20861;21347;22392;22717;23236;23330,28470,2,2,5,0,9
49991,110,12030,17192;17323;20591,28470,0,0,3,0,3
49992,110,12031,17165;17364;21269,28470,0,0,3,0,3
49993,110,12032,17337;17377,28470,0,0,2,0,2
49994,110,12033,17317;17419;20895;21172,28470,0,0,4,0,4
49995,110,12034,17319;17433;21464,28470,0,1,2,0,3
49996,110,12035,16896;17436;19815;21673,28470,0,1,3,0,4
49997,110,12036,17162;17455,28470,0,0,2,0,2
49998,110,12037,17467;17512,28470,0,0,2,0,2
49999,110,12038,17354;17472;21390;21692,28470,0,1,3,0,4
50000,110,12039,17476;17565;20583,28470,0,0,3,0,3
50001,110,12040,17484;17763;21620,28470,0,1,2,0,3
50002,110,12041,17489;17630,28470,0,0,2,0,2
50003,110,12042,17494;17580;21277;21505,28470,0,1,3,0,4
50004,110,12043,16845;17521;20469;21005,28470,0,0,4,0,4
50005,110,12044,17551;17874,28470,0,0,2,0,2
50006,110,12045,17787;17969;20076;20747;21454;22281,28470,0,2,4,0,6
50007,110,12046,17036;17570;20983;21308,28470,0,0,4,0,4
50008,110,12050,12467,28835,0,0,0,1,1
50009,110,12057,12503,28835,0,0,0,1,1
50010,110,12058,13005,28835,0,0,0,1,1
50011,110,12060,13324;13347,28835,0,0,0,2,2
50012,110,12062,13308;13684,28835,0,0,0,2,2
50013,110,12068,13050,28835,0,0,0,1,1
50014,110,12069,13880,28835,0,0,0,1,1
50015,110,12072,14332,28835,0,0,0,1,1
50016,110,12075,14362;14396,28835,0,0,0,2,2
50017,110,12079,14626;15369,28835,0,0,0,2,2
50018,110,12083,15076,28835,0,0,0,1,1
50019,110,12086,15079;15137,28835,0,0,0,2,2
50020,110,12093,15387,28835,0,0,0,1,1
50021,110,12100,15847;16258,28835,0,0,1,1,2
50022,110,12104,15571,28835,0,0,0,1,1
50023,110,12106,15860;16271,28835,0,0,1,1,2
50024,110,12107,16079;16858,28835,0,0,2,0,2
50025,110,12111,16367;16861;21027;21251,28835,0,0,4,0,4
50026,110,12112,16374,28835,0,0,1,0,1
50027,110,12113,16875;21398,28835,0,0,2,0,2
50028,110,12115,16752;17086;20645;21162,28835,0,0,4,0,4
50029,110,12116,17351;20473,28835,0,0,2,0,2
50030,110,12118,16850;17305;21255;21491,28835,0,1,3,0,4
50031,110,12119,16855;17013;20917;21105,28835,0,0,4,0,4
50032,110,12120,17150,28835,0,0,1,0,1
50033,110,12121,16640;17050,28835,0,0,2,0,2
50034,110,12122,17186;20985,28835,0,0,2,0,2
50035,110,12123,16952;17204;20630,28835,0,0,3,0,3
50036,110,12124,17000;17228,28835,0,0,2,0,2
50037,110,12126,17213,28835,0,0,1,0,1
50038,110,12128,17183;17269;20091;20382;22818;22912;23015,28835,2,1,4,0,7
50039,110,12129,17334;17341;20551;21019;21282;21355,28835,0,0,6,0,6
50040,110,12130,17193;17556;20721;21098;21571;22109,28835,0,2,4,0,6
50041,110,12131,17214;17385;20049;21014;23014,28835,1,0,4,0,5
50042,110,12132,17539;17635,28835,0,0,2,0,2
50043,110,12133,16996;17435,28835,0,0,2,0,2
50044,110,12134,17701;17954;20601;21093;23132,28835,1,0,4,0,5
50045,110,12135,17395;17443;20662,28835,0,0,3,0,3
50046,110,12136,17477;17868,28835,0,0,2,0,2
50047,110,12137,17110;17497;20569;20818;21753,28835,0,1,4,0,5
50048,110,12138,17560;17613;20776,28835,0,0,3,0,3
50049,110,12139,17544;17750;20947,28835,0,0,3,0,3
50050,110,12140,17520;20419;23026,28835,1,0,2,0,3
50051,110,12141,17563;17779;21476;21688;22172,28835,0,3,2,0,5
50052,110,12142,17557;17679,28835,0,0,2,0,2
50053,110,12143,17559;17585;21312;21718,28835,0,1,3,0,4
50054,110,12144,17245;17567;21381;21484;23362,28835,1,1,3,0,5
50055,110,12145,17579;17982;21623;22397,28835,0,2,2,0,4
50056,110,12146,17597;17682;20758,28835,0,0,3,0,3
50057,110,12147,17607;17944;21479,28835,0,1,2,0,3
50058,110,12148,17478;17622;20901;21217;21634,28835,0,1,4,0,5
50059,110,12149,17423;17626;20851,28835,0,0,3,0,3
50060,110,12150,17263;17639,28835,0,0,2,0,2
50061,110,12151,17642;17847;20880;21548;22723,28835,0,2,3,0,5
50062,110,12152,17648;17777,28835,0,0,2,0,2
50063,110,12153,17406;17651;20960;21185;22501,28835,0,1,4,0,5
50064,110,12154,17251;17652;20555;20757;21163,28835,0,0,5,0,5
50065,110,12155,17657;17947,28835,0,0,2,0,2
50066,110,12157,17153;17681,28835,0,0,2,0,2
50067,110,12158,12908,29200,0,0,0,1,1
50068,110,12159,12686,29200,0,0,0,1,1
50069,110,12162,12273,29200,0,0,0,1,1
50070,110,12165,13239,29200,0,0,0,1,1
50071,110,12168,13330,29200,0,0,0,1,1
50072,110,12174,14083,29200,0,0,0,1,1
50073,110,12178,14745,29200,0,0,0,1,1
50074,110,12189,15109;15173,29200,0,0,0,2,2
50075,110,12191,15051;15539,29200,0,0,0,2,2
50076,110,12195,15271;15777,29200,0,0,0,2,2
50077,110,12196,14898,29200,0,0,0,1,1
50078,110,12197,15389;15683,29200,0,0,0,2,2
50079,110,12200,15526;15555,29200,0,0,0,2,2
50080,110,12201,15034;15597,29200,0,0,0,2,2
50081,110,12204,16235;21422,29200,0,0,2,0,2
50082,110,12207,15957;16566;20733,29200,0,0,2,1,3
50083,110,12208,15716;15720,29200,0,0,0,2,2
50084,110,12209,16046;16328;19930;20931,29200,0,0,3,1,4
50085,110,12212,16100;16217;19933,29200,0,0,3,0,3
50086,110,12215,16224;16292;20932,29200,0,0,3,0,3
50087,110,12219,16524;16958,29200,0,0,2,0,2
50088,110,12220,16316;16595,29200,0,0,2,0,2
50089,110,12222,16713;17071,29200,0,0,2,0,2
50090,110,12223,16723;16970;21202,29200,0,0,3,0,3
50091,110,12224,16133;16414,29200,0,0,2,0,2
50092,110,12225,16750;20737;21021;23249,29200,1,0,3,0,4
50093,110,12226,16757;17143;20225;20468;21913,29200,0,1,4,0,5
50094,110,12227,17034;17398,29200,0,0,2,0,2
50095,110,12228,16515;16801,29200,0,0,2,0,2
50096,110,12230,16622;16895,29200,0,0,2,0,2
50097,110,12231,17209;17469,29200,0,0,2,0,2
50098,110,12232,17634;21370,29200,0,0,2,0,2
50099,110,12233,17446;20600;23131,29200,1,0,2,0,3
50100,110,12234,17056;17173;20939,29200,0,0,3,0,3
50101,110,12235,16961;21292,29200,0,0,2,0,2
50102,110,12236,17105;17697;21314;21450,29200,0,1,3,0,4
50103,110,12237,16994;17157;21085,29200,0,0,3,0,3
50104,110,12238,17167;17224,29200,0,0,2,0,2
50105,110,12239,17654;21094,29200,0,0,2,0,2
50106,110,12240,17535;17548;21435;21715,29200,0,2,2,0,4
50107,110,12241,17267;17349;19974;22032,29200,0,1,3,0,4
50108,110,12242,16944;17428,29200,0,0,2,0,2
50109,110,12243,17447;21324;21594,29200,0,1,2,0,3
50110,110,12246,16764;16948;20854;21161,29200,0,0,4,0,4
50111,110,12248,16981;17430,29200,0,0,2,0,2
50112,110,12249,17265;17444;21585;22499,29200,0,2,2,0,4
50113,110,12250,17479;17717;21206;21467;21745,29200,0,2,3,0,5
50114,110,12251,17501,29200,0,0,1,0,1
50115,110,12252,17195;17515;20548,29200,0,0,3,0,3
50116,110,12253,17577;17741,29200,0,0,2,0,2
50117,110,12254,17586;17808;21741;21967,29200,0,2,2,0,4
50118,110,12255,17462;17588,29200,0,0,2,0,2
50119,110,12256,17596,29200,0,0,1,0,1
50120,110,12257,17972;21064;21232,29200,0,0,3,0,3
50121,110,12258,17232;17532;21818,29200,0,1,2,0,3
50122,110,12259,17650;18084;20470,29200,0,0,3,0,3
50123,110,12260,17361;17387;20855;21539,29200,0,1,3,0,4
50124,110,12261,17715;17767;21182,29200,0,0,3,0,3
50125,110,12262,17460;17739;21496,29200,0,1,2,0,3
50126,110,12263,12231,29565,0,0,0,1,1
50127,110,12265,12696,29565,0,0,0,1,1
50128,110,12268,12669,29565,0,0,0,1,1
50129,110,12269,12874,29565,0,0,0,1,1
50130,110,12271,13370,29565,0,0,0,1,1
50131,110,12274,13218,29565,0,0,0,1,1
50132,110,12277,13362;13514,29565,0,0,0,2,2
50133,110,12280,13580,29565,0,0,0,1,1
50134,110,12281,13372;13825,29565,0,0,0,2,2
50135,110,12283,13878,29565,0,0,0,1,1
50136,110,12286,14045;14244,29565,0,0,0,2,2
50137,110,12290,14116;14755,29565,0,0,0,2,2
50138,110,12293,14883,29565,0,0,0,1,1
50139,110,12294,14538,29565,0,0,0,1,1
50140,110,12299,15140;15145,29565,0,0,0,2,2
50141,110,12301,15670;15954,29565,0,0,0,2,2
50142,110,12304,15874;16426,29565,0,0,1,1,2
50143,110,12311,16522;16979,29565,0,0,2,0,2
50144,110,12314,16489;16746;20522,29565,0,0,3,0,3
50145,110,12317,16863;17023,29565,0,0,2,0,2
50146,110,12318,17191;17422;21443,29565,0,1,2,0,3
50147,110,12320,17081;17171;21026;21982,29565,0,1,3,0,4
50148,110,12321,16639;17138,29565,0,0,2,0,2
50149,110,12322,17408;20483;21134,29565,0,0,3,0,3
50150,110,12323,17172;21199,29565,0,0,2,0,2
50151,110,12324,17200;17372,29565,0,0,2,0,2
50152,110,12325,17272;17279,29565,0,0,2,0,2
50153,110,12326,17280;17360;20568;21302;21385;22165,29565,0,1,5,0,6
50154,110,12327,17324;17449;21055;21597,29565,0,1,3,0,4
50155,110,12328,17866;22282,29565,0,1,1,0,2
50156,110,12330,17212;17392;20802;21408,29565,0,0,4,0,4
50157,110,12331,17336;17829;21580;22394,29565,0,2,2,0,4
50158,110,12332,17432;18087;20507;20576;20781;21264;21837,29565,0,1,6,0,7
50159,110,12333,17376,29565,0,0,1,0,1
50160,110,12334,17508;17939;21833;22043,29565,0,2,2,0,4
50161,110,12335,17513;17994;20525;21054,29565,0,0,4,0,4
50162,110,12336,17463;17519;21651,29565,0,1,2,0,3
50163,110,12337,17215;17582;21914;22500,29565,0,2,2,0,4
50164,110,12338,17464;17583;21073;21953,29565,0,1,3,0,4
50165,110,12339,17541;17584;20510,29565,0,0,3,0,3
50166,110,12340,17593;17667;20458;20997;21519;21622,29565,0,2,4,0,6
50167,110,12341,17611;17620;21156;21524,29565,0,1,3,0,4
50168,110,12342,17505;20166;20639;21247,29565,0,0,4,0,4
50169,110,12343,17653;17872;21024;21190;21350,29565,0,0,5,0,5
50170,110,12344,17659;17950;20664;21338,29565,0,0,4,0,4
50171,110,12345,17714;17844;20250;20816;21067,29565,0,0,5,0,5
50172,110,12346,17690;20508;20768;21146;21776;22828,29565,0,2,4,0,6
50173,110,12347,18196;18391;20390;20858;21901;22293;22506;23122;23333,29565,2,3,4,0,9
50174,110,12348,17797;17968;20141;22178;22820,29565,0,2,3,0,5
50175,110,12349,17753;17756;20941;21319,29565,0,0,4,0,4
50176,110,12350,17259;17769;20872;21418;21890;22117;22171,29565,0,3,4,0,7
50177,110,12351,17434;17952;21506;22284,29565,0,2,2,0,4
50178,110,12352,17802;17828;20967;21646,29565,0,1,3,0,4
50179,110,12353,17804;21832;22393,29565,0,2,1,0,3
50180,110,12354,17491;17825;21239;21785,29565,0,1,3,0,4
50181,110,12355,17748;17831;21739,29565,0,1,2,0,3
50182,110,12356,17914;21764;22832,29565,1,1,1,0,3
50183,110,12357,17589;17848,29565,0,0,2,0,2
50184,110,12358,17801;17861;21335,29565,0,0,3,0,3
50185,110,12359,17537;17878;21349;21600;22176,29565,0,2,3,0,5
50186,110,12360,17481;18048,29565,0,0,2,0,2
50187,110,12363,12746,29930,0,0,0,1,1
50188,110,12364,13092,29930,0,0,0,1,1
50189,110,12370,13683;13955,29930,0,0,0,2,2
50190,110,12373,14111,29930,0,0,0,1,1
50191,110,12374,14619,29930,0,0,0,1,1
50192,110,12376,13884,29930,0,0,0,1,1
50193,110,12395,16363,29930,0,0,1,0,1
50194,110,12396,16090;16402,29930,0,0,2,0,2
50195,110,12397,15665;16279,29930,0,0,1,1,2
50196,110,12398,15948;16257;21497,29930,0,1,1,1,3
50197,110,12399,16308;16418,29930,0,0,2,0,2
50198,110,12400,16211,29930,0,0,1,0,1
50199,110,12401,16977;17130,29930,0,0,2,0,2
50200,110,12402,17218;20896,29930,0,0,2,0,2
50201,110,12403,16636;16763;20749,29930,0,0,3,0,3
50202,110,12404,16604;16647,29930,0,0,2,0,2
50203,110,12405,17052,29930,0,0,1,0,1
50204,110,12406,16800;21010;21515,29930,0,1,2,0,3
50205,110,12407,16937;17230;20834;21119;21554,29930,0,1,4,0,5
50206,110,12408,16628;16695,29930,0,0,2,0,2
50207,110,12410,16967;17425;20162,29930,0,0,3,0,3
50208,110,12411,16761;17041,29930,0,0,2,0,2
50209,110,12412,17037;17427,29930,0,0,2,0,2
50210,110,12413,17296;17495;20785;21096;21466,29930,0,1,4,0,5
50211,110,12414,17198;17696;20978;21536;23141,29930,1,1,3,0,5
50212,110,12415,17247;17514;21087,29930,0,0,3,0,3
50213,110,12416,17288;17616;21261;21858;22061,29930,0,2,3,0,5
50214,110,12417,17660;21114,29930,0,0,2,0,2
50215,110,12418,17366;17500;21481;21550,29930,0,2,2,0,4
50216,110,12419,16898;17074;20665;21158,29930,0,0,4,0,4
50217,110,12420,17558;17758;20399;21691,29930,0,1,3,0,4
50218,110,12421,16815;17202,29930,0,0,2,0,2
50219,110,12422,17971;18096;20817;21228;21474,29930,0,1,4,0,5
50220,110,12423,17242;17426;21461,29930,0,1,2,0,3
50221,110,12424,17474;17496;21117;21884;22021,29930,0,2,3,0,5
50222,110,12425,17499;17841;21333;21731,29930,0,1,3,0,4
50223,110,12426,17707;17708;20963;21415,29930,0,0,4,0,4
50224,110,12427,17550;18107;22049,29930,0,1,2,0,3
50225,110,12428,17700;17711;21213;23359,29930,1,0,3,0,4
50226,110,12429,17465;17598;20795;21012;21751,29930,0,1,4,0,5
50227,110,12430,18160;18178,29930,0,0,2,0,2
50228,110,12431,18036;18581;20828;21342,29930,0,0,4,0,4
50229,110,12432,17886;18189;20192;21397;22402,29930,0,1,4,0,5
50230,110,12434,17859;18125;20312;20607;21631,29930,0,1,4,0,5
50231,110,12435,17817;21174;22068;22609,29930,0,2,2,0,4
50232,110,12436,17274;17818;21672,29930,0,1,2,0,3
50233,110,12437,17795;17824;20842,29930,0,0,3,0,3
50234,110,12438,17628;17830;21413;21720,29930,0,1,3,0,4
50235,110,12440,17887;18110;21178,29930,0,0,3,0,3
50236,110,12441,17736;17853;20949;21352,29930,0,0,4,0,4
50237,110,12442,17963,29930,0,0,1,0,1
50238,110,12443,17509;17864;20669,29930,0,0,3,0,3
50239,110,12444,17339,29930,0,0,1,0,1
50240,110,12445,17673;17882;21612,29930,0,1,2,0,3
50241,110,12446,17768;17884;20722;21883,29930,0,1,3,0,4
50242,110,12447,17888;18144;21756,29930,0,1,2,0,3
50243,110,12448,17937;18101;20741,29930,0,0,3,0,3
50244,110,12449,17991;18094;21082;21273;21868,29930,0,1,4,0,5
50245,110,12450,17860;17999;21214;21667,29930,0,1,3,0,4
50246,110,12451,12398,30295,0,0,0,1,1
50247,110,12456,13334,30295,0,0,0,1,1
50248,110,12459,13614,30295,0,0,0,1,1
50249,110,12460,13674,30295,0,0,0,1,1
50250,110,12464,13406;14005,30295,0,0,0,2,2
50251,110,12465,13923,30295,0,0,0,1,1
50252,110,12469,14324,30295,0,0,0,1,1
50253,110,12471,14307;14381,30295,0,0,0,2,2
50254,110,12472,14002;14483,30295,0,0,0,2,2
50255,110,12474,14406,30295,0,0,0,1,1
50256,110,12478,13850;14053,30295,0,0,0,2,2
50257,110,12479,14737;14823,30295,0,0,0,2,2
50258,110,12484,15077;15277,30295,0,0,0,2,2
50259,110,12491,15691;15821,30295,0,0,0,2,2
50260,110,12495,15937;16379,30295,0,0,1,1,2
50261,110,12496,15985;16296,30295,0,0,1,1,2
50262,110,12499,16127;16540;20811,30295,0,0,3,0,3
50263,110,12501,15864;16233;20420;22721;23125,30295,1,1,2,1,5
50264,110,12503,16044;16465,30295,0,0,1,1,2
50265,110,12505,16608;17244;21152,30295,0,0,3,0,3
50266,110,12506,16747;17197;20502,30295,0,0,3,0,3
50267,110,12507,16807,30295,0,0,1,0,1
50268,110,12508,17120;21334,30295,0,0,2,0,2
50269,110,12510,16104;17158,30295,0,0,2,0,2
50270,110,12513,17109;17291;20516;21729,30295,0,1,3,0,4
50271,110,12514,17238;17680;21194,30295,0,0,3,0,3
50272,110,12516,17332;17346;21830;22092,30295,0,2,2,0,4
50273,110,12517,17421;17721;20644;21908;22103;22279,30295,0,3,3,0,6
50274,110,12518,17369;17564,30295,0,0,2,0,2
50275,110,12519,17572;18131;21211,30295,0,0,3,0,3
50276,110,12520,17574;21258;21754,30295,0,1,2,0,3
50277,110,12522,17807;17820,30295,0,0,2,0,2
50278,110,12523,17631;21222,30295,0,0,2,0,2
50279,110,12524,17649;17727;20533;21642,30295,0,1,3,0,4
50280,110,12525,17487;17666;20703;21521,30295,0,1,3,0,4
50281,110,12526,17705;17746;20755;21230,30295,0,0,4,0,4
50282,110,12527,18210;21607;21826,30295,0,2,1,0,3
50283,110,12528,17382;17735;20675;22097,30295,0,1,3,0,4
50284,110,12529,17699;17737;21006;21561;21949,30295,0,2,3,0,5
50285,110,12530,17840;20831;20882;21099,30295,0,0,4,0,4
50286,110,12531,17764;17794;21284;21640;22113,30295,0,2,3,0,5
50287,110,12532,17983;21549;22286,30295,0,2,1,0,3
50288,110,12533,17785;18169,30295,0,0,2,0,2
50289,110,12534,17789;17909;21898;22137,30295,0,2,2,0,4
50290,110,12535,17670;17790;21482,30295,0,1,2,0,3
50291,110,12536,17842;20844;21628;21698;22173,30295,0,3,2,0,5
50292,110,12537,17897;17922;20631;22605,30295,0,1,3,0,4
50293,110,12538,17823;17906,30295,0,0,2,0,2
50294,110,12539,17703;18159;21240,30295,0,0,3,0,3
50295,110,12540,17913;17934;21717,30295,0,1,2,0,3
50296,110,12541,17921;17998;21103;21399,30295,0,0,4,0,4
50297,110,12542,17870;17924;20848;22037,30295,0,1,3,0,4
50298,110,12543,17930;21778;22502,30295,0,2,1,0,3
50299,110,12544,17733;17942;21948,30295,0,1,2,0,3
50300,110,12545,18112;18162;21140;21795,30295,0,1,3,0,4
50301,110,12546,17803;17953;21107,30295,0,0,3,0,3
50302,110,12547,18368;20609;21039;21791,30295,0,1,3,0,4
50303,110,12548,17916;17995;20366;20797;21189;21842;22599,30295,0,2,5,0,7
50304,110,12549,17838;17996,30295,0,0,2,0,2
50305,110,12550,17918;18002;20771,30295,0,0,3,0,3
50306,110,12551,18099;18249;21125;21344,30295,0,0,4,0,4
50307,110,12552,18019;18353;21737,30295,0,1,2,0,3
50308,110,12553,18044;18200;22065;22189,30295,0,2,2,0,4
50309,110,12554,18034;18092;21544,30295,0,1,2,0,3
50310,110,12555,17890;18106;21373;21442;22187,30295,0,2,3,0,5
50311,110,12557,17900;18103;21063,30295,0,0,3,0,3
50312,110,12558,17949;18093;21144;22027;22505,30295,0,2,3,0,5
50313,110,12559,17895;18058;20869,30295,0,0,3,0,3
50314,110,12560,13027,30660,0,0,0,1,1
50315,110,12562,13395;13570,30660,0,0,0,2,2
50316,110,12564,13267,30660,0,0,0,1,1
50317,110,12567,13260,30660,0,0,0,1,1
50318,110,12571,14263,30660,0,0,0,1,1
50319,110,12572,14423;14778,30660,0,0,0,2,2
50320,110,12573,14383,30660,0,0,0,1,1
50321,110,12574,13836,30660,0,0,0,1,1
50322,110,12577,14906;15776,30660,0,0,0,2,2
50323,110,12584,15630;15664,30660,0,0,0,2,2
50324,110,12585,15741,30660,0,0,0,1,1
50325,110,12591,15672;16022,30660,0,0,0,2,2
50326,110,12592,15703,30660,0,0,0,1,1
50327,110,12593,16305;16580,30660,0,0,2,0,2
50328,110,12595,16865,30660,0,0,1,0,1
50329,110,12597,17044;17261;20422;21463,30660,0,1,3,0,4
50330,110,12599,16823;17451;20398;21065;21108;21537;23024,30660,1,1,5,0,7
50331,110,12600,16843;17347,30660,0,0,2,0,2
50332,110,12602,16542;17042,30660,0,0,2,0,2
50333,110,12603,16854;17141,30660,0,0,2,0,2
50334,110,12605,16662;16957;20625;20803,30660,0,0,4,0,4
50335,110,12608,17523;17604,30660,0,0,2,0,2
50336,110,12610,17222;20921;21563;21882,30660,0,2,2,0,4
50337,110,12611,17300;17429;20442,30660,0,0,3,0,3
50338,110,12612,17534;18057;21896,30660,0,1,2,0,3
50339,110,12613,17543;17771;20580;20735;21462;21819,30660,0,2,4,0,6
50340,110,12614,17554;18232;21786,30660,0,1,2,0,3
50341,110,12615,17573;18381;21742;22138;22410,30660,0,3,2,0,5
50342,110,12616,17599;18000;21305;21581,30660,0,1,3,0,4
50343,110,12617,17343;17608;20992;21441,30660,0,1,3,0,4
50344,110,12618,17985;18061,30660,0,0,2,0,2
50345,110,12619,17402;17776;20925;21050;21299;21760;22280,30660,0,2,5,0,7
50346,110,12620,17641;17647;21229,30660,0,0,3,0,3
50347,110,12621,17656;18175;21624,30660,0,1,2,0,3
50348,110,12622,17662;20685;21403,30660,0,0,3,0,3
50349,110,12623,17722;17754;20852;21089;21478;21610;22932,30660,1,2,4,0,7
50350,110,12624,17516;18035;21835,30660,0,1,2,0,3
50351,110,12625,17709;17812;21147;21656;21815,30660,0,2,3,0,5
50352,110,12626,17612;17726,30660,0,0,2,0,2
50353,110,12627,18027;20899;21471;22288;22399,30660,0,3,2,0,5
50354,110,12628,17732;18452;20762;20994;21721,30660,0,1,4,0,5
50355,110,12629,17815;18050;21392;21873;22504,30660,0,2,3,0,5
50356,110,12630,17843;21318;21621;22042,30660,0,2,2,0,4
50357,110,12631,17862;18242;20919;21517;21579;22014,30660,0,3,3,0,6
50358,110,12632,17747;17988;21775,30660,0,1,2,0,3
50359,110,12633,17863;18140;20991;21488;21562;22400,30660,0,3,3,0,6
50360,110,12634,18120;18161;21340;22124,30660,0,1,3,0,4
50361,110,12635,17904;18329;20754;21895;22009;22301;22405,30660,0,4,3,0,7
50362,110,12636,17836;17910;20799;20979;21388;21849,30660,0,1,5,0,6
50363,110,12637,17938;18111;20920;21743;22018,30660,0,2,3,0,5
50364,110,12638,17962;18067;20806;21049;21509,30660,0,1,4,0,5
50365,110,12639,18013;20987;21712;22180,30660,0,2,2,0,4
50366,110,12641,18074;18336;20787;21337,30660,0,0,4,0,4
50367,110,12642,17881;18313;20395;21294;23144,30660,1,0,4,0,5
50368,110,12643,17875;18056;21567;22289,30660,0,2,2,0,4
50369,110,12644,18068;21732,30660,0,1,1,0,2
50370,110,12645,18077;18287;21246;21523,30660,0,1,3,0,4
50371,110,12647,18079;18102;20981;21626;22611,30660,0,2,3,0,5
50372,110,12648,17609;18218,30660,0,0,2,0,2
50373,110,12649,17605;18116;21307,30660,0,0,3,0,3
50374,110,12650,18375;22206;22303,30660,0,2,1,0,3
50375,110,12651,18121;18132;21188;21595;21679;22613;23357,30660,1,3,3,0,7
50376,110,12652,17961;18361;21487;21542;22204,30660,0,3,2,0,5
50377,110,12653,18136;21315,30660,0,0,2,0,2
50378,110,12654,18145;20487;20807;21366;21724;22725,30660,0,2,4,0,6
50379,110,12655,18151;22035,30660,0,1,1,0,2
50380,110,12656,17911;17915;21209;22283,30660,0,1,3,0,4
50381,110,12658,17788;18224;21271;21846;22191,30660,0,2,3,0,5
50382,110,12659,13257,31025,0,0,0,1,1
50383,110,12661,13116,31025,0,0,0,1,1
50384,110,12665,12993,31025,0,0,0,1,1
50385,110,12669,14470,31025,0,0,0,1,1
50386,110,12680,15269;15304,31025,0,0,0,2,2
50387,110,12684,15164;15732,31025,0,0,0,2,2
50388,110,12691,15622;15663,31025,0,0,0,2,2
50389,110,12696,15284,31025,0,0,0,1,1
50390,110,12699,16397;16605,31025,0,0,2,0,2
50391,110,12704,16558;17069;20676;21306,31025,0,0,4,0,4
50392,110,12706,17104;17149;21683,31025,0,1,2,0,3
50393,110,12708,16180,31025,0,0,1,0,1
50394,110,12713,16659;17345;20853;21918;23255,31025,1,1,3,0,5
50395,110,12714,17819,31025,0,0,1,0,1
50396,110,12715,17176;17370;20866;23140,31025,1,0,3,0,4
50397,110,12716,17381;17490;20698,31025,0,0,3,0,3
50398,110,12717,17686;17855;21276,31025,0,0,3,0,3
50399,110,12718,17287,31025,0,0,1,0,1
50400,110,12719,17734;18046;21526,31025,0,1,2,0,3
50401,110,12720,17839;17984;20961;21570,31025,0,1,3,0,4
50402,110,12721,17503;18152;21700,31025,0,1,2,0,3
50403,110,12722,17929;17956;20681;21894,31025,0,1,3,0,4
50404,110,12723,17219;17640;21002;21216;21757;22169,31025,0,2,4,0,6
50405,110,12724,18209;18384;22085;22615,31025,0,2,2,0,4
50406,110,12725,17720;18277;21572;22197,31025,0,2,2,0,4
50407,110,12726,17471;17940;21143;21396;21477,31025,0,1,4,0,5
50408,110,12727,17745;18100;20976;21531,31025,0,1,3,0,4
50409,110,12728,17948;21711,31025,0,1,1,0,2
50410,110,12729,17561;18091;21972,31025,0,1,2,0,3
50411,110,12730,17778;17959;21455;21808,31025,0,2,2,0,4
50412,110,12731,18147;21867,31025,0,1,1,0,2
50413,110,12732,17976;21129;21363;22121;22396,31025,0,2,3,0,5
50414,110,12733,17873;18009;21303,31025,0,0,3,0,3
50415,110,12734,18260;18515;21664;21850;22005;22212;22842;22937,31025,2,4,2,0,8
50416,110,12735,17941;21118;21863,31025,0,1,2,0,3
50417,110,12736,17355;17951;21051;21905,31025,0,1,3,0,4
50418,110,12737,18157;18503;20933;21113;21529;21603;22210;22306,31025,0,4,4,0,8
50419,110,12738,18216;22118,31025,0,1,1,0,2
50420,110,12739,17718;17967;20670;21203;22607;23358,31025,1,1,4,0,6
50421,110,12740,18005;18098;20804;21653,31025,0,1,3,0,4
50422,110,12741,17716;18049;20731;20971;21955;23247,31025,1,1,4,0,6
50423,110,12742,17728;18126;22082,31025,0,1,2,0,3
50424,110,12743,18081;18097;21116;21910,31025,0,1,3,0,4
50425,110,12744,18114;18357;21828;21932,31025,0,2,2,0,4
50426,110,12745,18156;18226;20650;21045;21360;21576;21886,31025,0,2,5,0,7
50427,110,12746,17749;18167;22401,31025,0,1,2,0,3
50428,110,12747,18177;18291;21719;22200,31025,0,2,2,0,4
50429,110,12748,17990;18199;21465;22031,31025,0,2,2,0,4
50430,110,12749,18221;20701;21486;22404;22508,31025,0,3,2,0,5
50431,110,12750,18237;18592;21728;21956;22317,31025,0,3,2,0,5
50432,110,12751,18047;18255;21382;22617,31025,0,1,3,0,4
50433,110,12752,17981;18279;20547;21510;21874;22062,31025,0,3,3,0,6
50434,110,12753,18142;18272;20677;20793,31025,0,0,4,0,4
50435,110,12754,18274;18445;21794;22415;22836,31025,1,2,2,0,5
50436,110,12755,18518;21238;21401;22309,31025,0,1,3,0,4
50437,110,12756,18294;18505;20968;21927,31025,0,1,3,0,4
50438,110,12757,18220;18302;21095;21559;21843,31025,0,2,3,0,5
50439,110,12760,13014,31390,0,0,0,1,1
50440,110,12761,13385,31390,0,0,0,1,1
50441,110,12763,13582,31390,0,0,0,1,1
50442,110,12764,13627,31390,0,0,0,1,1
50443,110,12770,14348;14971,31390,0,0,0,2,2
50444,110,12771,14353,31390,0,0,0,1,1
50445,110,12773,14709,31390,0,0,0,1,1
50446,110,12774,14430;14908,31390,0,0,0,2,2
50447,110,12784,15415,31390,0,0,0,1,1
50448,110,12789,16011,31390,0,0,0,1,1
50449,110,12791,15426,31390,0,0,0,1,1
50450,110,12792,15449,31390,0,0,0,1,1
50451,110,12793,15762,31390,0,0,0,1,1
50452,110,12794,16600,31390,0,0,1,0,1
50453,110,12799,16113;16721,31390,0,0,2,0,2
50454,110,12800,16123;16482,31390,0,0,2,0,2
50455,110,12803,16361;16507;21009,31390,0,0,3,0,3
50456,110,12805,16729;17087;21343,31390,0,0,3,0,3
50457,110,12806,16784;17166,31390,0,0,2,0,2
50458,110,12807,16288,31390,0,0,1,0,1
50459,110,12810,16781;17389,31390,0,0,2,0,2
50460,110,12811,16827,31390,0,0,1,0,1
50461,110,12812,16867,31390,0,0,1,0,1
50462,110,12813,16993;17299;21256;21527;21919,31390,0,2,3,0,5
50463,110,12816,17633;20977;22016,31390,0,1,2,0,3
50464,110,12818,17688;18180;21658,31390,0,1,2,0,3
50465,110,12819,17075,31390,0,0,1,0,1
50466,110,12820,17318;17957;21800;22067;22285,31390,0,3,2,0,5
50467,110,12821,16959;17358,31390,0,0,2,0,2
50468,110,12824,17695;17857;20913;21310,31390,0,0,4,0,4
50469,110,12825,16956;17431;21412;21870,31390,0,1,3,0,4
50470,110,12826,17540;17919;22610,31390,0,1,2,0,3
50471,110,12827,17303;17546;21128;21329,31390,0,0,4,0,4
50472,110,12828,17390;17834;21130;21421;21534,31390,0,1,4,0,5
50473,110,12829,17623;18127;21681;22612,31390,0,2,2,0,4
50474,110,12830,18025;18164;21212;21713,31390,0,1,3,0,4
50475,110,12831,17742;18208;21196;21512;22190;22294,31390,0,3,3,0,6
50476,110,12832,17719;17786;20990;21433;21782;22278;22608,31390,0,4,3,0,7
50477,110,12833,17871;18171;21280;21532;21727,31390,0,2,3,0,5
50478,110,12834,18028;21899;21986,31390,0,2,1,0,3
50479,110,12835,17901;18010;21132;21772,31390,0,1,3,0,4
50480,110,12836,17702;17946;21997,31390,0,1,2,0,3
50481,110,12837,18075;18194;21141;21281;21722,31390,0,1,4,0,5
50482,110,12838,17891;17966;21885,31390,0,1,2,0,3
50483,110,12839,17977;18188,31390,0,0,2,0,2
50484,110,12840,18326;18656;22526,31390,0,1,2,0,3
50485,110,12841,17510;18055;21023;21864;22184;22933,31390,1,2,3,0,6
50486,110,12842,18064;18341;21990;22406,31390,0,2,2,0,4
50487,110,12843,18016;21057;22287,31390,0,1,2,0,3
50488,110,12844,18155;20641;21847,31390,0,1,2,0,3
50489,110,12845,17883;18165;21859,31390,0,1,2,0,3
50490,110,12846,18390;18511;21545;21857,31390,0,2,2,0,4
50491,110,12847,18007;18179;21657,31390,0,1,2,0,3
50492,110,12848,17601;17766;21514;21809;22168,31390,0,3,2,0,5
50493,110,12849,18436;18465;20655;21984,31390,0,1,3,0,4
50494,110,12850,18233;18265;21445;22195,31390,0,2,2,0,4
50495,110,12851,18245;18566;22315,31390,0,1,2,0,3
50496,110,12852,18193;18246;21682;22192;22297,31390,0,3,2,0,5
50497,110,12853,18192;18262;21518;21750;22299;22618,31390,0,4,2,0,6
50498,110,12854,18270;18351;21543;22196,31390,0,2,2,0,4
50499,110,12855,17780;18290;21285;22619,31390,0,1,3,0,4
50500,110,12856,18694;21994;22322,31390,0,2,1,0,3
50501,110,12857,18367;21353;21437;21807;22105;23040,31390,1,3,2,0,6
50502,110,12858,18322;18658;21957;22428,31390,0,2,2,0,4
50503,110,12859,18331;22007,31390,0,1,1,0,2
50504,110,12861,17978;18339;21881,31390,0,1,2,0,3
50505,110,12862,17865;18342;21013;21272,31390,0,0,4,0,4
50506,110,12863,18185;18346;20916;21131;22407,31390,0,1,4,0,5
50507,110,12864,18267;18733;21771;21820;22329,31390,0,3,2,0,5
50508,110,12865,18088;18369;21062;21824,31390,0,1,3,0,4
50509,110,12866,18374;20772,31390,0,0,2,0,2
50510,110,12867,18386;20647;20867;22833,31390,1,0,3,0,4
50511,110,12868,13747,31755,0,0,0,1,1
50512,110,12872,14473,31755,0,0,0,1,1
50513,110,12875,13813,31755,0,0,0,1,1
50514,110,12877,13999;14412,31755,0,0,0,2,2
50515,110,12879,13901;14605,31755,0,0,0,2,2
50516,110,12887,14723,31755,0,0,0,1,1
50517,110,12888,14878;15390,31755,0,0,0,2,2
50518,110,12889,14956;15348,31755,0,0,0,2,2
50519,110,12890,14687;15053,31755,0,0,0,2,2
50520,110,12891,15127;15296,31755,0,0,0,2,2
50521,110,12893,15249;15693,31755,0,0,0,2,2
50522,110,12899,15867;16398,31755,0,0,1,1,2
50523,110,12901,15905,31755,0,0,0,1,1
50524,110,12909,16353;16924,31755,0,0,2,0,2
50525,110,12910,16966;17030,31755,0,0,2,0,2
50526,110,12913,17412;17522;21081;21458,31755,0,1,3,0,4
50527,110,12916,17231;17610;21376;21988;22069,31755,0,2,3,0,5
50528,110,12917,17262;17396;21080;22277,31755,0,1,3,0,4
50529,110,12918,17340;17576;21092;21648,31755,0,1,3,0,4
50530,110,12919,17085;17454;21384,31755,0,0,3,0,3
50531,110,12920,17506;17810;21169,31755,0,0,3,0,3
50532,110,12922,17555;17595,31755,0,0,2,0,2
50533,110,12923,17356;17594,31755,0,0,2,0,2
50534,110,12924,17615;17960,31755,0,0,2,0,2
50535,110,12925,17526,31755,0,0,1,0,1
50536,110,12926,17760;17958;21677;22177,31755,0,2,2,0,4
50537,110,12927,17791;18323;21328;21617,31755,0,1,3,0,4
50538,110,12928,17784;17798;21694,31755,0,1,2,0,3
50539,110,12929,18014;18023;20982;22041,31755,0,1,3,0,4
50540,110,12930,17926;18235;21635;22073,31755,0,2,2,0,4
50541,110,12931,18006;18105;20935;21402;22503,31755,0,1,4,0,5
50542,110,12932,18012;18740;21374;21705;22226;22633,31755,0,3,3,0,6
50543,110,12933,18018;18113;21411,31755,0,0,3,0,3
50544,110,12934,18029;18710;22224;22325;23265,31755,1,2,2,0,5
50545,110,12935,18332;21304;21419;21827;22202,31755,0,2,3,0,5
50546,110,12936,18563;22941,31755,1,0,1,0,2
50547,110,12937,18457;21404;22837,31755,1,0,2,0,3
50548,110,12938,18154;18621;21668;22847,31755,1,1,2,0,4
50549,110,12939,17713;18158;21097;21687;21838,31755,0,2,3,0,5
50550,110,12940,17625;18173;21710;22614,31755,0,2,2,0,4
50551,110,12941,18250;18840;20835;22535;22643;22929,31755,1,2,3,0,6
50552,110,12942,18207;18252;21220;22298;23143,31755,1,1,3,0,5
50553,110,12943,18128;18266;21448;21599,31755,0,2,2,0,4
50554,110,12944,17932;18305;21407,31755,0,0,3,0,3
50555,110,12945,18273;18370;21875,31755,0,1,2,0,3
50556,110,12946,18276;18300;21801,31755,0,1,2,0,3
50557,110,12947,18285;18802;22438;22534;22637;22741;22946,31755,1,4,2,0,7
50558,110,12948,18698,31755,0,0,1,0,1
50559,110,12949,18215;18303;21645;21708;22616,31755,0,3,2,0,5
50560,110,12950,17693;18395;20936;21226;22059,31755,0,1,4,0,5
50561,110,12951,18396;18717,31755,0,0,2,0,2
50562,110,12952,18486;21416;21702;22011,31755,0,2,2,0,4
50563,110,12953,18214;18425;20944;21929;22835,31755,1,1,3,0,5
50564,110,12954,18385;18426;21946,31755,0,1,2,0,3
50565,110,12955,18328;18427;21405;21434;22620,31755,0,2,3,0,5
50566,110,12956,18223;18434;21768,31755,0,1,2,0,3
50567,110,12957,18577;20819;20950;20969;23352,31755,1,0,4,0,5
50568,110,12958,18636;21375,31755,0,0,2,0,2
50569,110,12959,18149;18513;21052;21504,31755,0,1,3,0,4
50570,110,12960,18495;18522;21706,31755,0,1,2,0,3
50571,110,12961,18779;18861;20782;22063,31755,0,1,3,0,4
50572,110,12962,18437;18527;22311,31755,0,1,2,0,3
50573,110,12965,13572,32120,0,0,0,1,1
50574,110,12966,13852,32120,0,0,0,1,1
50575,110,12968,13931,32120,0,0,0,1,1
50576,110,12975,14597,32120,0,0,0,1,1
50577,110,12976,14953,32120,0,0,0,1,1
50578,110,12980,15194,32120,0,0,0,1,1
50579,110,12983,15671,32120,0,0,0,1,1
50580,110,12989,15748;15980,32120,0,0,0,2,2
50581,110,12991,16322,32120,0,0,1,0,1
50582,110,12996,15814,32120,0,0,0,1,1
50583,110,13006,16973,32120,0,0,1,0,1
50584,110,13007,16738;17137;20857,32120,0,0,3,0,3
50585,110,13008,16923;17226;21205,32120,0,0,3,0,3
50586,110,13015,17258;17475,32120,0,0,2,0,2
50587,110,13019,18150;18166;22292,32120,0,1,2,0,3
50588,110,13020,18129;21149;22291,32120,0,1,2,0,3
50589,110,13024,18083;21410;22033,32120,0,1,2,0,3
50590,110,13025,17671;17975;21187;22002,32120,0,1,3,0,4
50591,110,13026,17980;18148;20951;21043;21233,32120,0,0,5,0,5
50592,110,13027,17896;22395,32120,0,1,1,0,2
50593,110,13028,17770;17987;20966;21109,32120,0,0,4,0,4
50594,110,13029,18263;21522,32120,0,1,1,0,2
50595,110,13030,17591;18045;20878;21154,32120,0,0,4,0,4
50596,110,13031,18062;21079;21906,32120,0,1,2,0,3
50597,110,13032,18095;18359;21136;21378;21916,32120,0,1,4,0,5
50598,110,13033,18257;22012;22194,32120,0,2,1,0,3
50599,110,13034,18203;18338;22510,32120,0,1,2,0,3
50600,110,13036,18284;18746;22852,32120,1,0,2,0,3
50601,110,13037,18195;18502;21181;21551;21747;22047,32120,0,3,3,0,6
50602,110,13038,18745;18784;21121;21322;21735,32120,0,1,4,0,5
50603,110,13039,17762;18228;21424;22295,32120,0,1,3,0,4
50604,110,13040,18296;18702;22223;22324;22631,32120,0,3,2,0,5
50605,110,13041,18298;18355;21926,32120,0,1,2,0,3
50606,110,13042,18356;18380;21584;21788,32120,0,2,2,0,4
50607,110,13043,18135;18278;21670;21981,32120,0,2,2,0,4
50608,110,13044,18288;18634;21086;21596;21945;22524;23046,32120,1,3,3,0,7
50609,110,13045,18281;18413;21553,32120,0,1,2,0,3
50610,110,13046,18040;18421;21593;21903;22089;22412,32120,0,4,2,0,6
50611,110,13047,18428;18611;21077;22217;22424,32120,0,2,3,0,5
50612,110,13048,18439;18821;22107,32120,0,1,2,0,3
50613,110,13049,18441;18699;22323,32120,0,1,2,0,3
50614,110,13050,18443;21671;22414,32120,0,2,1,0,3
50615,110,13051,18453;18550;21020;21236;21389;21821;22151;22313;22939,32120,1,3,5,0,9
50616,110,13052,17710;18478;20958;22208;22730;23145,32120,1,2,3,0,6
50617,110,13053,18497;18519;21357;21975,32120,0,1,3,0,4
50618,110,13055,17965;18533;21332;21632;21851;22516;22843,32120,1,3,3,0,7
50619,110,13056,18560;21995,32120,0,1,1,0,2
50620,110,13057,18562;18971;20943;22238;22349;22649;22951,32120,1,3,3,0,7
50621,110,13058,18685;21016;21300;22147,32120,0,1,3,0,4
50622,110,13059,18578;18686;22222;22737,32120,0,2,2,0,4
50623,110,13060,18306;18601,32120,0,0,2,0,2
50624,110,13061,18614;18772;21035;22028;23050;23266,32120,2,1,3,0,6
50625,110,13062,18594;21278;21540;21887,32120,0,2,2,0,4
50626,110,13063,13576,32485,0,0,0,1,1
50627,110,13065,13773,32485,0,0,0,1,1
50628,110,13068,13895,32485,0,0,0,1,1
50629,110,13070,13105,32485,0,0,0,1,1
50630,110,13072,14185,32485,0,0,0,1,1
50631,110,13075,13914,32485,0,0,0,1,1
50632,110,13079,14795;15291,32485,0,0,0,2,2
50633,110,13080,14733;15059,32485,0,0,0,2,2
50634,110,13081,14689,32485,0,0,0,1,1
50635,110,13083,15772,32485,0,0,0,1,1
50636,110,13085,14949,32485,0,0,0,1,1
50637,110,13087,15866;16393,32485,0,0,1,1,2
50638,110,13090,14969;15262,32485,0,0,0,2,2
50639,110,13096,16190,32485,0,0,1,0,1
50640,110,13103,16545;16696,32485,0,0,2,0,2
50641,110,13108,17047;17452;20962,32485,0,0,3,0,3
50642,110,13110,17442;17661;21625;21879,32485,0,2,2,0,4
50643,110,13111,17618,32485,0,0,1,0,1
50644,110,13112,17416;17590;21460,32485,0,1,2,0,3
50645,110,13113,18071;21494;21616;22186,32485,0,3,1,0,4
50646,110,13114,17414;17587;21362,32485,0,0,3,0,3
50647,110,13116,17698;17851;21120,32485,0,0,3,0,3
50648,110,13120,18358;21725;21973;22203,32485,0,3,1,0,4
50649,110,13121,17569;21395,32485,0,0,2,0,2
50650,110,13122,17602;18072;21088,32485,0,0,3,0,3
50651,110,13123,18054;18212;21613;22040,32485,0,2,2,0,4
50652,110,13124,17905;18022;21356,32485,0,0,3,0,3
50653,110,13125,17730;17964;21978,32485,0,1,2,0,3
50654,110,13126,18021;18410;21266;21904,32485,0,1,3,0,4
50655,110,13127,18032;18039;21286;21661;22183,32485,0,2,3,0,5
50656,110,13128,18467;21472,32485,0,1,1,0,2
50657,110,13129,18404;18898;22442,32485,0,1,2,0,3
50658,110,13130,18133;18744;22039;22227,32485,0,2,2,0,4
50659,110,13131,18248;18350;22023;22114,32485,0,2,2,0,4
50660,110,13133,18309;18628;21252;22058,32485,0,1,3,0,4
50661,110,13134,17757;18163;21198,32485,0,0,3,0,3
50662,110,13135,18400;21714,32485,0,1,1,0,2
50663,110,13136,18011;18334;21345;21695,32485,0,1,3,0,4
50664,110,13137,18269;18538;21056;21933;22091,32485,0,2,3,0,5
50665,110,13138,18442;18575;21071;21331;21810;22627;23045,32485,1,2,4,0,7
50666,110,13139,18630;18910;21100;21386;21813;22538,32485,0,2,4,0,6
50667,110,13140,18119;18438;21709,32485,0,1,2,0,3
50668,110,13141,18477;18769;21787;22333;22531;22740,32485,0,4,2,0,6
50669,110,13142,18479;21911;22839,32485,1,1,1,0,3
50670,110,13143,18915;21192;21430;22344;22444;22748;23142,32485,1,4,2,0,7
50671,110,13144,17856;18491;21861,32485,0,1,2,0,3
50672,110,13145,18496;18676;21316;21627;23149,32485,1,1,3,0,5
50673,110,13147,18510;18720;21417;21769;22211;22307,32485,0,3,3,0,6
50674,110,13148,18086;18512;21018;21436;22308,32485,0,2,3,0,5
50675,110,13149,18259;18520;21265;21499;21773,32485,0,2,3,0,5
50676,110,13151,18580;18951;21649;21790;22236;22859,32485,1,3,2,0,6
50677,110,13152,18393;21279;21348,32485,0,0,3,0,3
50678,110,13153,18723;18968;20995;21379;21900;22542,32485,0,2,4,0,6
50679,110,13154,18638;18941;21176;21291;21426,32485,0,1,4,0,5
50680,110,13155,18877;22081;22644;22746,32485,0,3,1,0,4
50681,110,13156,18615;18643,32485,0,0,2,0,2
50682,110,13157,18655;21439;21598;21920;22943,32485,1,3,1,0,5
50683,110,13158,18657;18778;21959;22231;23267,32485,1,2,2,0,5
50684,110,13159,18662;18706;21853;22106;22429;22849,32485,1,3,2,0,6
50685,110,13160,18683;18714;21446;21839;22326;22739,32485,0,4,2,0,6
50686,110,13161,18187;18574;22733,32485,0,1,2,0,3
50687,110,13162,18727;19057;21207,32485,0,0,3,0,3
50688,110,13163,18739;19090;22453,32485,0,1,2,0,3
50689,110,13164,18964;19128;22095;22862,32485,1,1,2,0,4
50690,110,13165,13876,32850,0,0,0,1,1
50691,110,13166,13894,32850,0,0,0,1,1
50692,110,13167,13925,32850,0,0,0,1,1
50693,110,13168,14070,32850,0,0,0,1,1
50694,110,13169,14428,32850,0,0,0,1,1
50695,110,13170,14290,32850,0,0,0,1,1
50696,110,13171,14461,32850,0,0,0,1,1
50697,110,13172,13469,32850,0,0,0,1,1
50698,110,13175,14237,32850,0,0,0,1,1
50699,110,13178,15287,32850,0,0,0,1,1
50700,110,13179,14788;14875,32850,0,0,0,2,2
50701,110,13182,14545,32850,0,0,0,1,1
50702,110,13183,14534,32850,0,0,0,1,1
50703,110,13184,15306,32850,0,0,0,1,1
50704,110,13187,15840;16148,32850,0,0,1,1,2
50705,110,13188,16431,32850,0,0,1,0,1
50706,110,13191,16295,32850,0,0,1,0,1
50707,110,13192,16527,32850,0,0,1,0,1
50708,110,13193,16219;16321,32850,0,0,2,0,2
50709,110,13203,16790;17002,32850,0,0,2,0,2
50710,110,13206,17148;17379;21218;21547,32850,0,1,3,0,4
50711,110,13210,17493;17568;21538;21834,32850,0,2,2,0,4
50712,110,13211,18026;22084,32850,0,1,1,0,2
50713,110,13214,17678;18205;21836,32850,0,1,2,0,3
50714,110,13216,17752;18198;21792,32850,0,1,2,0,3
50715,110,13217,17816;18315;22060,32850,0,1,2,0,3
50716,110,13218,17892;18211;22119;22507,32850,0,2,2,0,4
50717,110,13219,17923;21254;21573;23361,32850,1,1,2,0,4
50718,110,13220,18104;18498;21909;22209;22841;23261,32850,2,2,2,0,6
50719,110,13222,17973;18403;21931;22934,32850,1,1,2,0,4
50720,110,13223,17989;18108;21680;22188,32850,0,2,2,0,4
50721,110,13224,17621;18001;21483;21716;22108;22398;23364,32850,1,4,2,0,7
50722,110,13225,18033;18042;21409;21663,32850,0,1,3,0,4
50723,110,13226,18076;21500;21964,32850,0,2,1,0,3
50724,110,13227,18238;18275;21641;22509;23039,32850,1,2,2,0,5
50725,110,13228,18069;21459;21676,32850,0,2,1,0,3
50726,110,13229,18644,32850,0,0,1,0,1
50727,110,13230,18139;18234;21525;21822;22296,32850,0,3,2,0,5
50728,110,13231,18591;18684;22422;22520,32850,0,2,2,0,4
50729,110,13232,17894;18282;21406;21630;22008;22198;22726,32850,0,4,3,0,7
50730,110,13233,18031;18286;21391;22199,32850,0,1,3,0,4
50731,110,13234,17917;18310;21923,32850,0,1,2,0,3
50732,110,13235,17781;18354;22030;22511;22621,32850,0,3,2,0,5
50733,110,13236,18362;21516;21690,32850,0,2,1,0,3
50734,110,13237,18366;18483;23042,32850,1,0,2,0,3
50735,110,13238,18586;21204;21511;21876;22214,32850,0,3,2,0,5
50736,110,13239,18239;18433;21891,32850,0,1,2,0,3
50737,110,13240,18415;19038;21197;22093;22241,32850,0,2,3,0,5
50738,110,13241,18449;18567;22419,32850,0,1,2,0,3
50739,110,13242,18219;18472;21669,32850,0,1,2,0,3
50740,110,13243,18490;19032;21274;21689;22450;22869,32850,1,2,3,0,6
50741,110,13244,18525;21869;22102,32850,0,2,1,0,3
50742,110,13245,18292;18962;22750;22861,32850,1,1,2,0,4
50743,110,13246,18492;18570;21897;22420;22518,32850,0,3,2,0,5
50744,110,13247,18903;18987,32850,0,0,2,0,2
50745,110,13248,18352;18599;21330;21921;22423,32850,0,2,3,0,5
50746,110,13249,18793;22126;22337;22437;22533;23051,32850,1,4,1,0,6
50747,110,13250,18627;18692;21231;21589;22321;22432;22528;22738,32850,0,5,3,0,8
50748,110,13251,18648;18890;22645,32850,0,1,2,0,3
50749,110,13252,18671;22057;22527;22630,32850,0,3,1,0,4
50750,110,13253,18923;18952;21210;21457,32850,0,1,3,0,4
50751,110,13254,18680;21248;21723;21902;22431;22736,32850,0,4,2,0,6
50752,110,13255,18682;21219;21766,32850,0,1,2,0,3
50753,110,13256,18571;18704,32850,0,0,2,0,2
50754,110,13257,18556;18963;22950,32850,1,0,2,0,3
50755,110,13258,18713;19006;21104;23153,32850,1,0,3,0,4
50756,110,13259,18715;18883;21201;21393;22157;22944;23363,32850,2,1,4,0,7
50757,110,13260,18766;18838;21076,32850,0,0,3,0,3
50758,110,13261,18424;18770;21151;22229;22334,32850,0,2,3,0,5
50759,110,13262,18774;19206;21244,32850,0,0,3,0,3
50760,110,13263,18551;18823;21091;21812;21942,32850,0,2,3,0,5
50761,110,13264,18846;18980;22448,32850,0,1,2,0,3
50762,110,13265,18853;19151;21309;22044;22365;22965,32850,1,2,3,0,6
50763,110,13266,18849;19034;21802,32850,0,1,2,0,3
50764,110,13267,13994,33215,0,0,0,1,1
50765,110,13268,14145,33215,0,0,0,1,1
50766,110,13270,14533;14693,33215,0,0,0,2,2
50767,110,13271,14241,33215,0,0,0,1,1
50768,110,13273,14930,33215,0,0,0,1,1
50769,110,13275,14711,33215,0,0,0,1,1
50770,110,13277,14654,33215,0,0,0,1,1
50771,110,13278,15218,33215,0,0,0,1,1
50772,110,13280,15190,33215,0,0,0,1,1
50773,110,13283,15383,33215,0,0,0,1,1
50774,110,13284,15505,33215,0,0,0,1,1
50775,110,13292,15602;16051,33215,0,0,0,2,2
50776,110,13293,16078;16396,33215,0,0,2,0,2
50777,110,13304,16463;17083,33215,0,0,2,0,2
50778,110,13305,17199;17321;21215;21604,33215,0,1,3,0,4
50779,110,13306,16751;16931,33215,0,0,2,0,2
50780,110,13308,17547;18231;21502;22145;23260,33215,1,2,2,0,5
50781,110,13309,17531;17854;21325;21797,33215,0,1,3,0,4
50782,110,13311,18344;21311;21608;21779,33215,0,2,2,0,4
50783,110,13313,18371;18524;21789,33215,0,1,2,0,3
50784,110,13314,18134;18545;21564,33215,0,1,2,0,3
50785,110,13315,18060;18247;21485,33215,0,1,2,0,3
50786,110,13316,18253;21636;22193,33215,0,2,1,0,3
50787,110,13317,18143;18264;21492,33215,0,1,2,0,3
50788,110,13318,18316;18564;22143;23263,33215,1,1,2,0,4
50789,110,13319,18337;18604;21257;22846,33215,1,0,3,0,4
50790,110,13320,18340;18788;21652;21954;22336;22436,33215,0,4,2,0,6
50791,110,13322,18596;19010;22355;22953,33215,1,1,2,0,4
50792,110,13323,18416;21367;21770;22512,33215,0,2,2,0,4
50793,110,13324,19021;21242;21951;22868;22956,33215,2,1,2,0,5
50794,110,13325,18451;18625;21654;21844;22729,33215,0,3,2,0,5
50795,110,13326,18552;18654;21888;21969;22427;22525,33215,0,4,2,0,6
50796,110,13328,18299;18617;21726;22425,33215,0,2,2,0,4
50797,110,13329,18701;18906;21438;21590;22537,33215,0,3,2,0,5
50798,110,13331,18645;21270;21575;22130;23264,33215,1,2,2,0,5
50799,110,13332,19125;19201;21301;21320;21675;22146;22247;22767;22875,33215,1,4,4,0,9
50800,110,13333,18707;18848;21740;21976,33215,0,2,2,0,4
50801,110,13334,18742;19275;22778,33215,0,1,2,0,3
50802,110,13335,18902;18935;21578;21816,33215,0,2,2,0,4
50803,110,13336,18750;18929;22160,33215,0,1,2,0,3
50804,110,13337,18756;19315;21321;21762,33215,0,1,3,0,4
50805,110,13338,18764;19121;22552;23069;23157,33215,2,1,2,0,5
50806,110,13339,18914;21427;21991;22747,33215,0,3,1,0,4
50807,110,13340,18780;18896;22090;22234,33215,0,2,2,0,4
50808,110,13341,19048;19205;22129,33215,0,1,2,0,3
50809,110,13342,18794;18922;21615;23052,33215,1,1,2,0,4
50810,110,13343,19009;19027;22358;22759,33215,0,2,2,0,4
50811,110,13344,18831;19233;21287;21541,33215,0,1,3,0,4
50812,110,13345,18835;19087;22026;22764,33215,0,2,2,0,4
50813,110,13346,19168;19369;21234;21761;22140;22876,33215,1,2,3,0,6
50814,110,13347,18875;18972;23268,33215,1,0,2,0,3
50815,110,13348,18886;21193;21535;22020;23269,33215,1,2,2,0,5
50816,110,13349,18900;18928;22163,33215,0,1,2,0,3
50817,110,13350,18913;18965;21748;21950;22443,33215,0,3,2,0,5
50818,110,13351,18957;22101;23152;23270,33215,2,1,1,0,4
50819,110,13352,18981;19299;21400;21440;22566,33215,0,2,3,0,5
50820,110,13356,14301,33580,0,0,0,1,1
50821,110,13357,14124,33580,0,0,0,1,1
50822,110,13358,14465;15514,33580,0,0,0,2,2
50823,110,13361,14306;14695,33580,0,0,0,2,2
50824,110,13367,14308,33580,0,0,0,1,1
50825,110,13368,15265,33580,0,0,0,1,1
50826,110,13374,15578;15635,33580,0,0,0,2,2
50827,110,13375,15795,33580,0,0,0,1,1
50828,110,13376,14944,33580,0,0,0,1,1
50829,110,13379,15770,33580,0,0,0,1,1
50830,110,13382,16347,33580,0,0,1,0,1
50831,110,13386,15924,33580,0,0,0,1,1
50832,110,13387,15739,33580,0,0,0,1,1
50833,110,13389,16724;17053,33580,0,0,2,0,2
50834,110,13395,16387;17055,33580,0,0,2,0,2
50835,110,13398,16619;16837,33580,0,0,2,0,2
50836,110,13403,16989;17057,33580,0,0,2,0,2
50837,110,13407,18015;18261;21552;22181,33580,0,2,2,0,4
50838,110,13408,17314;17363,33580,0,0,2,0,2
50839,110,13410,17627;18312;21798;22142;22300,33580,0,3,2,0,5
50840,110,13412,17694,33580,0,0,1,0,1
50841,110,13413,17933;18020;21765;22112,33580,0,2,2,0,4
50842,110,13416,17483;17908,33580,0,0,2,0,2
50843,110,13417,17603,33580,0,0,1,0,1
50844,110,13418,18038;18043;21508;22154,33580,0,2,2,0,4
50845,110,13419,18109;18430;22048,33580,0,1,2,0,3
50846,110,13420,17902;18146,33580,0,0,2,0,2
50847,110,13421,17689;17845,33580,0,0,2,0,2
50848,110,13422,17889;18183;21503;21799,33580,0,2,2,0,4
50849,110,13423,18174;18202;21568,33580,0,1,2,0,3
50850,110,13424,18225,33580,0,0,1,0,1
50851,110,13425,17822;18229;21987;22148,33580,0,2,2,0,4
50852,110,13426,17997;18304;21490;21947,33580,0,2,2,0,4
50853,110,13427,18308;18379;22136,33580,0,1,2,0,3
50854,110,13428,18314;21684,33580,0,1,1,0,2
50855,110,13429,18474;18565;21588,33580,0,1,2,0,3
50856,110,13430,18082;18373,33580,0,0,2,0,2
50857,110,13431,18053;18440;22132,33580,0,1,2,0,3
50858,110,13432,18870;22745,33580,0,1,1,0,2
50859,110,13433,18506;18868;21744;22342,33580,0,2,2,0,4
50860,110,13434,18514;18588;21449;21655;22216,33580,0,3,2,0,5
50861,110,13435,18531;18834;21364;22642;22855,33580,1,1,3,0,5
50862,110,13436,18561;18606;22844;23044,33580,2,0,2,0,4
50863,110,13437,18569;19392;23283,33580,1,0,2,0,3
50864,110,13438,18892;19109;22766,33580,0,1,2,0,3
50865,110,13439,18607;19041;21358;21855,33580,0,1,3,0,4
50866,110,13440,18748;18812;21468;21912;22634;22853,33580,1,3,2,0,6
50867,110,13441,19124;21372;21583;22131;22657,33580,0,3,2,0,5
50868,110,13442,18783;19354;21361;22884,33580,1,0,3,0,4
50869,110,13443,18810;19269,33580,0,0,2,0,2
50870,110,13444,18696;18833;22046;22233;22339;22641,33580,0,4,2,0,6
50871,110,13445,18819;18867;21814;22110;22341;22536,33580,0,4,2,0,6
50872,110,13446,18893;18954;22237;22860,33580,1,1,2,0,4
50873,110,13447,18904;19282;21428;21665;22974,33580,1,2,2,0,5
50874,110,13448,18759;18907;21960;22228;22435;22530,33580,0,4,2,0,6
50875,110,13449,18392;18918;22539,33580,0,1,2,0,3
50876,110,13450,18934;19185;21601;22098;22773,33580,0,3,2,0,5
50877,110,13451,18939;18988;21697;21852,33580,0,2,2,0,4
50878,110,13452,18943;19298;22881,33580,1,0,2,0,3
50879,110,13453,18958;19325;21943;22882;23278,33580,2,1,2,0,5
50880,110,13454,18537;19070;21447,33580,0,1,2,0,3
50881,110,13455,18693;18995;22070;22652;22865;22952,33580,2,2,2,0,6
50882,110,13456,18773;19013;22356;22758;22955,33580,1,2,2,0,5
50883,110,13457,19092;19242;23275,33580,1,0,2,0,3
50884,110,13458,18818;19017;22111;22239;22546,33580,0,3,2,0,5
50885,110,13459,18660;19035;21618;22128,33580,0,2,2,0,4
50886,110,13460,18785;19040;21368;21643;23062;23271,33580,2,1,3,0,6
50887,110,13461,19093;19366,33580,0,0,2,0,2
50888,110,13462,19104;19435;21354;21444;21591;21963;23173,33580,1,3,3,0,7
50889,110,13464,14407,33945,0,0,0,1,1
50890,110,13465,14341,33945,0,0,0,1,1
50891,110,13467,14577,33945,0,0,0,1,1
50892,110,13468,14157,33945,0,0,0,1,1
50893,110,13471,14399,33945,0,0,0,1,1
50894,110,13472,14652,33945,0,0,0,1,1
50895,110,13476,15142,33945,0,0,0,1,1
50896,110,13477,15612,33945,0,0,0,1,1
50897,110,13478,15804,33945,0,0,0,1,1
50898,110,13479,15825,33945,0,0,0,1,1
50899,110,13482,15885,33945,0,0,0,1,1
50900,110,13492,16348;16444,33945,0,0,2,0,2
50901,110,13496,17174;17281;21498,33945,0,1,2,0,3
50902,110,13499,17308;17415,33945,0,0,2,0,2
50903,110,13500,17123,33945,0,0,1,0,1
50904,110,13502,17459;17676;21489;21977,33945,0,2,2,0,4
50905,110,13505,17530;17876;22175,33945,0,1,2,0,3
50906,110,13506,17502;17600;21425;22094,33945,0,1,3,0,4
50907,110,13508,17658;17809;21558,33945,0,1,2,0,3
50908,110,13509,17928;18493,33945,0,0,2,0,2
50909,110,13510,17273;17691;21577,33945,0,1,2,0,3
50910,110,13511,17751,33945,0,0,1,0,1
50911,110,13512,18065;18454;22304,33945,0,1,2,0,3
50912,110,13514,18115;18327;21937,33945,0,1,2,0,3
50913,110,13515,18724;22328;22529;23048,33945,1,2,1,0,4
50914,110,13516,17979;18181;21854,33945,0,1,2,0,3
50915,110,13517,18319;18447;22623,33945,0,1,2,0,3
50916,110,13518,18324;18488;21602;21940;22840,33945,1,2,2,0,5
50917,110,13519,18325;18721;21619;21738;22201,33945,0,3,2,0,5
50918,110,13520,18085;18401;21736;22207,33945,0,2,2,0,4
50919,110,13521,18190;18414;22038;22403,33945,0,2,2,0,4
50920,110,13522,18455;18767;21614;22332,33945,0,2,2,0,4
50921,110,13523,18254;18460,33945,0,0,2,0,2
50922,110,13524,18461;18665;21586,33945,0,1,2,0,3
50923,110,13526,18283;18521;21803;22139;22310,33945,0,3,2,0,5
50924,110,13527,18542;18544,33945,0,0,2,0,2
50925,110,13528,18268;18554;22940,33945,1,0,2,0,3
50926,110,13529,17849;18080;21983;22174,33945,0,2,2,0,4
50927,110,13530,18122;18585,33945,0,0,2,0,2
50928,110,13531,18295;18589;22316;22421;22519;22734,33945,0,4,2,0,6
50929,110,13532,18481;18595;22521,33945,0,1,2,0,3
50930,110,13533,18489;18608;22318,33945,0,1,2,0,3
50931,110,13534,18037;18623;21429;22218;22523,33945,0,3,2,0,5
50932,110,13536,18600;18956;22347,33945,0,1,2,0,3
50933,110,13537,18530;18950;21456;21831;22100;22232;22647,33945,0,5,2,0,7
50934,110,13539,17903;18758;21893,33945,0,1,2,0,3
50935,110,13540,18347;18775;21475;21685;22230,33945,0,3,2,0,5
50936,110,13541,19318;21556;21845,33945,0,2,1,0,3
50937,110,13542,18795;21587,33945,0,1,1,0,2
50938,110,13543,18771;18801;22158,33945,0,1,2,0,3
50939,110,13544,18806;19195;21574;21804;22660;22877,33945,1,3,2,0,6
50940,110,13545,18837,33945,0,0,1,0,1
50941,110,13546,18842;18917;22066,33945,0,1,2,0,3
50942,110,13547,18587;18858;21866;22215;22942,33945,1,2,2,0,5
50943,110,13548,18860;19073;21469;22133;22362,33945,0,3,2,0,5
50944,110,13549,19172;21734;22460;22772,33945,0,3,1,0,4
50945,110,13550,19279;19400;22980;23169,33945,2,0,2,0,4
50946,110,13551,18640;19050;21501;23063,33945,1,1,2,0,4
50947,110,13552,18921;19111;21696;21922,33945,0,2,2,0,4
50948,110,13553,18924;21530;21941;22235;22646,33945,0,4,1,0,5
50949,110,13554,18541;18944;22540;22858,33945,1,1,2,0,4
50950,110,13555,18672;19164;21966;22554;22967,33945,1,2,2,0,5
50951,110,13556,18688;18978;22156;22350;22752,33945,0,3,2,0,5
50952,110,13557,19002;22755,33945,0,1,1,0,2
50953,110,13558,18501;19019,33945,0,0,2,0,2
50954,110,13559,19024;22957,33945,1,0,1,0,2
50955,110,13561,19228;19376;21999;22375,33945,0,2,2,0,4
50956,110,13562,18719;18982;21889;21944;22351;22651;22753;22863,33945,1,5,2,0,8
50957,110,13563,19080;19391;22779;23082,33945,1,1,2,0,4
50958,110,13564,19084;21453;21662;22762;22872,33945,1,3,1,0,5
50959,110,13565,18933;19086;22763,33945,0,1,2,0,3
50960,110,13566,18664;19096;22655;22765;22963,33945,1,2,2,0,5
50961,110,13567,18997;19098;21507,33945,0,1,2,0,3
50962,110,13568,18809;19099;22074;23156,33945,1,1,2,0,4
50963,110,13569,19102;19427,33945,0,0,2,0,2
50964,110,13570,19067;19115;22243;23065,33945,1,1,2,0,4
50965,110,13571,19141;19464;22679;23287,33945,1,1,2,0,4
50966,110,13572,19142;19378;21470;22072;23168,33945,1,2,2,0,5
50967,110,13573,18813;19173;21495;21767;22249;22366,33945,0,4,2,0,6
50968,110,13574,19113;19434;21783;22024;23172,33945,1,2,2,0,5
50969,110,13575,19550;21755;23089,33945,1,1,1,0,3
50970,110,13576,14466,34310,0,0,0,1,1
50971,110,13577,14087,34310,0,0,0,1,1
50972,110,13581,14942,34310,0,0,0,1,1
50973,110,13585,15152,34310,0,0,0,1,1
50974,110,13586,15412,34310,0,0,0,1,1
50975,110,13588,15252,34310,0,0,0,1,1
50976,110,13589,15487,34310,0,0,0,1,1
50977,110,13595,15896,34310,0,0,0,1,1
50978,110,13599,16086;16313,34310,0,0,2,0,2
50979,110,13604,16911;17008,34310,0,0,2,0,2
50980,110,13605,17040,34310,0,0,1,0,1
50981,110,13609,16626,34310,0,0,1,0,1
50982,110,13610,17246;17993,34310,0,0,2,0,2
50983,110,13611,17018;17169;22004,34310,0,1,2,0,3
50984,110,13612,17027;17404;21592,34310,0,1,2,0,3
50985,110,13616,17473,34310,0,0,1,0,1
50986,110,13617,17755;18526;21678;22625,34310,0,2,2,0,4
50987,110,13618,17592;17805;21639;22045,34310,0,2,2,0,4
50988,110,13619,18137,34310,0,0,1,0,1
50989,110,13621,17899;18030;21644;21781,34310,0,2,2,0,4
50990,110,13622,17974;18153,34310,0,0,2,0,2
50991,110,13623,17846;17955;22153,34310,0,1,2,0,3
50992,110,13624,17826;17992;21606,34310,0,1,2,0,3
50993,110,13627,17806;18051;21733;22022;22724,34310,0,3,2,0,5
50994,110,13628,18534;21774;22080;22517,34310,0,3,1,0,4
50995,110,13629,18363;18412;21569;21749,34310,0,2,2,0,4
50996,110,13631,18293;18528;21701;22418;22731,34310,0,3,2,0,5
50997,110,13632,17912;18297;21707,34310,0,1,2,0,3
50998,110,13633,17885;18073,34310,0,0,2,0,2
50999,110,13634,18462;18670;22077;22430,34310,0,2,2,0,4
51000,110,13635,17783;18376;22025,34310,0,1,2,0,3
51001,110,13637,18687,34310,0,0,1,0,1
51002,110,13638,18642;21555;22848;23148,34310,2,1,1,0,4
51003,110,13639,18647;22141;22628,34310,0,2,1,0,3
51004,110,13640,18540;18659;21862,34310,0,1,2,0,3
51005,110,13642,19030;22547;22654;22960;23061,34310,2,2,1,0,5
51006,110,13643,18697,34310,0,0,1,0,1
51007,110,13644,18405;18741;21998;22434,34310,0,2,2,0,4
51008,110,13645,19083,34310,0,0,1,0,1
51009,110,13646,18653;18790;22122;22320,34310,0,2,2,0,4
51010,110,13647,18830;22144;22743,34310,0,2,1,0,3
51011,110,13648,18464;18814;22338;22638;22742;22854,34310,1,3,2,0,6
51012,110,13649,18871;19230,34310,0,0,2,0,2
51013,110,13650,18891,34310,0,0,1,0,1
51014,110,13651,18839;18911,34310,0,0,2,0,2
51015,110,13652,18936;19280;22034;22371;22463;22663,34310,0,4,2,0,6
51016,110,13653,19129;19582;21971,34310,0,1,2,0,3
51017,110,13655,18960;19537;21605;22685,34310,0,2,2,0,4
51018,110,13656,18708;19036;22451;22870,34310,1,1,2,0,4
51019,110,13658,18985;19053;21924;23064;23155,34310,2,1,2,0,5
51020,110,13659,19016;19117;21758;22551,34310,0,2,2,0,4
51021,110,13660,18829;19039;21777;22017,34310,0,2,2,0,4
51022,110,13662,18776;19051;22000;22361;22961,34310,1,2,2,0,5
51023,110,13663,19055;19163;22457;23159,34310,1,1,2,0,4
51024,110,13664,18991;19061;21693,34310,0,1,2,0,3
51025,110,13665,19089;19131;21823;22768,34310,0,2,2,0,4
51026,110,13666,19500;21546;22790;23177,34310,1,2,1,0,4
51027,110,13667,19108;19398,34310,0,0,2,0,2
51028,110,13669,19138;19145;21686;22125,34310,0,2,2,0,4
51029,110,13670,19159;19221;22558;23075;23161,34310,2,1,2,0,5
51030,110,13671,19004;19169;22771,34310,0,1,2,0,3
51031,110,13672,19180;19425;21650;22473;22675,34310,0,3,2,0,5
51032,110,13673,19200;19411;21611;22570;22674;22887,34310,1,3,2,0,6
51033,110,13674,18885;19209;21703,34310,0,1,2,0,3
51034,110,13675,19120;19216;21840;23068,34310,1,1,2,0,4
51035,110,13676,19219;19667;21752;22013;23296,34310,1,2,2,0,5
51036,110,13677,19255;19448;21659;21989;22784,34310,0,3,2,0,5
51037,110,13678,19178;19261;21985;22562;22973,34310,1,2,2,0,5
51038,110,13679,19518;21647;22377;22684;23180,34310,1,3,1,0,5
51039,110,13680,19167;19272;22458;22770;22968,34310,1,2,2,0,5
51040,110,13681,14725;14759,34675,0,0,0,2,2
51041,110,13684,14957,34675,0,0,0,1,1
51042,110,13685,15048,34675,0,0,0,1,1
51043,110,13686,15662,34675,0,0,0,1,1
51044,110,13688,15492,34675,0,0,0,1,1
51045,110,13690,15952,34675,0,0,0,1,1
51046,110,13692,16036;16161,34675,0,0,1,1,2
51047,110,13693,16256,34675,0,0,1,0,1
51048,110,13695,16141,34675,0,0,1,0,1
51049,110,13708,17712,34675,0,0,1,0,1
51050,110,13709,18089;18480;22096,34675,0,1,2,0,3
51051,110,13710,17669,34675,0,0,1,0,1
51052,110,13711,18543;21763,34675,0,1,1,0,2
51053,110,13712,18317;18408;21674;21825,34675,0,2,2,0,4
51054,110,13714,18176,34675,0,0,1,0,1
51055,110,13716,18568;18876,34675,0,0,2,0,2
51056,110,13717,18476;18582,34675,0,0,2,0,2
51057,110,13718,18598;22845,34675,1,0,1,0,2
51058,110,13719,18631;18919;22857;23054,34675,2,0,2,0,4
51059,110,13721,18695;18938,34675,0,0,2,0,2
51060,110,13722,18394;18703;21817;22632,34675,0,2,2,0,4
51061,110,13723,18729;18736,34675,0,0,2,0,2
51062,110,13725,18820;19374;21925;22671;22978,34675,1,2,2,0,5
51063,110,13726,18752;19365;23167,34675,1,0,2,0,3
51064,110,13727,19258;23276,34675,1,0,1,0,2
51065,110,13728,18948;19247,34675,0,0,2,0,2
51066,110,13729,18856;18930;21759;22439,34675,0,2,2,0,4
51067,110,13730,18593;18862;22134;22948,34675,1,1,2,0,4
51068,110,13731,19126;19348;22248;22553;22658;23070,34675,1,3,2,0,6
51069,110,13732,18961;18975;22006;22543;23057,34675,1,2,2,0,5
51070,110,13733,18973;18986,34675,0,0,2,0,2
51071,110,13734,18901;18992;22352;22449;22864,34675,1,2,2,0,5
51072,110,13735,19068;19220;22775,34675,0,1,2,0,3
51073,110,13736,19069;19503;22055;23178,34675,1,1,2,0,4
51074,110,13737,18927;19114;22455;22656,34675,0,2,2,0,4
51075,110,13738,19147;19379;23282,34675,1,0,2,0,3
51076,110,13739,19158;19436;21992;23072,34675,1,1,2,0,4
51077,110,13740,19176;19438;21704;21917;22677;22783;22984,34675,1,4,2,0,7
51078,110,13741,19232;19507,34675,0,0,2,0,2
51079,110,13742,19182;19512;21811;22683;23087,34675,1,2,2,0,5
51080,110,13743,19082;19278;22564;23162,34675,1,1,2,0,4
51081,110,13744,19419;22571;23284,34675,1,1,1,0,3
51082,110,13745,19307;22975,34675,1,0,1,0,2
51083,110,13746,18649;19332;22019;23078;23164,34675,2,1,2,0,5
51084,110,13747,19353;19554;23289,34675,1,0,2,0,3
51085,110,13748,19384,34675,0,0,1,0,1
51086,110,13749,19429;19433;22572,34675,0,1,2,0,3
51087,110,13750,14673;15064,35040,0,0,0,2,2
51088,110,13753,14156,35040,0,0,0,1,1
51089,110,13754,14776,35040,0,0,0,1,1
51090,110,13755,15159,35040,0,0,0,1,1
51091,110,13756,14764,35040,0,0,0,1,1
51092,110,13757,15346,35040,0,0,0,1,1
51093,110,13760,15402;15523,35040,0,0,0,2,2
51094,110,13761,15558;15781,35040,0,0,0,2,2
51095,110,13763,15155,35040,0,0,0,1,1
51096,110,13764,15470;15568,35040,0,0,0,2,2
51097,110,13766,14775,35040,0,0,0,1,1
51098,110,13769,16089,35040,0,0,1,0,1
51099,110,13771,16182,35040,0,0,1,0,1
51100,110,13788,17368,35040,0,0,1,0,1
51101,110,13789,17397;17498,35040,0,0,2,0,2
51102,110,13793,17663;18066;21860;22050,35040,0,2,2,0,4
51103,110,13797,17925;18343;21915;22302,35040,0,2,2,0,4
51104,110,13799,18213;18311,35040,0,0,2,0,2
51105,110,13803,18123;18523;22135;23146,35040,1,1,2,0,4
51106,110,13804,18184;18458;21880,35040,0,1,2,0,3
51107,110,13805,18191;18406;22411,35040,0,1,2,0,3
51108,110,13806,18222;18432;21796,35040,0,1,2,0,3
51109,110,13807,18271;18622,35040,0,0,2,0,2
51110,110,13809,18172;18633,35040,0,0,2,0,2
51111,110,13811,18470;21892;22010;22305;22838;22935,35040,2,3,1,0,6
51112,110,13812,18529;22938,35040,1,0,1,0,2
51113,110,13814,18345;18546;22312,35040,0,1,2,0,3
51114,110,13815,19199;19229;21993;22559;22776,35040,0,3,2,0,5
51115,110,13816,18925;19197;21872;22052;23055,35040,1,2,2,0,5
51116,110,13817,18602;18667;22220;22850,35040,1,1,2,0,4
51117,110,13818,18469;18722;22327,35040,0,1,2,0,3
51118,110,13819,18755;19091;22364,35040,0,1,2,0,3
51119,110,13820,18787;19077;22083;22363;22962,35040,1,2,2,0,5
51120,110,13821,18845;19160;22966,35040,1,0,2,0,3
51121,110,13822,18881;22343,35040,0,1,1,0,2
51122,110,13823,18613;18920,35040,0,0,2,0,2
51123,110,13824,19155;19521,35040,0,0,2,0,2
51124,110,13825,18979;19246;22561;22879,35040,1,1,2,0,4
51125,110,13826,18989;19154;22545,35040,0,1,2,0,3
51126,110,13827,18616;19011;21980,35040,0,1,2,0,3
51127,110,13828,19026;19360;22470,35040,0,1,2,0,3
51128,110,13829,18976;19042;21841,35040,0,1,2,0,3
51129,110,13830,19494,35040,0,0,1,0,1
51130,110,13831,19049;19130;22548,35040,0,1,2,0,3
51131,110,13832,19074;19157;22245;22761;23066,35040,1,2,2,0,5
51132,110,13833,18535;19112;22246;22550,35040,0,2,2,0,4
51133,110,13834,19144;19638;22480,35040,0,1,2,0,3
51134,110,13835,19152;19612;21805;22088,35040,0,2,2,0,4
51135,110,13836,18847;19196,35040,0,0,2,0,2
51136,110,13837,19316;19388,35040,0,0,2,0,2
51137,110,13838,18603;19213;22557,35040,0,1,2,0,3
51138,110,13839,19244;19406;22560;22972,35040,1,1,2,0,4
51139,110,13840,19273;19865,35040,0,0,2,0,2
51140,110,13841,19277;19495;21784;22789,35040,0,2,2,0,4
51141,110,13842,19286;19382;21856;22104,35040,0,2,2,0,4
51142,110,13843,19288;19698,35040,0,0,2,0,2
51143,110,13844,19293;22251;22880;23077,35040,2,1,1,0,4
51144,110,13845,18832;19303;22567,35040,0,1,2,0,3
51145,110,13846,18632;19123;21829,35040,0,1,2,0,3
51146,110,13847,19211;19317;21965;22079;22667,35040,0,3,2,0,5
51147,110,13848,19257;19785;23303,35040,1,0,2,0,3
51148,110,13849,19294;19350,35040,0,0,2,0,2
51149,110,13850,19165;19352;22254;22976;23280,35040,2,1,2,0,5
51150,110,13851,19214;19237;22369,35040,0,1,2,0,3
51151,110,13852,19803;19853;22029,35040,0,1,2,0,3
51152,110,13853,19262;19561;21958;22687,35040,0,2,2,0,4
51153,110,13854,19492;19781;21968;22064;22261,35040,0,3,2,0,5
51154,110,13855,19442;19837;22810,35040,0,1,2,0,3
51155,110,13857,19600,35040,0,0,1,0,1
51156,110,13858,19675,35040,0,0,1,0,1
51157,110,13859,19472;19757;22581;22808,35040,0,2,2,0,4
51158,110,13860,19474;19564;22681;22988;23175,35040,2,1,2,0,5
51159,110,13861,19767,35040,0,0,1,0,1
51160,110,13862,19734;19846;21907;23309,35040,1,1,2,0,4
51161,110,13863,19407;19491;21877;22476;23288,35040,1,2,2,0,5
51162,110,13864,19529;21865;22378;22575;23088,35040,1,3,1,0,5
51163,110,13865,19535;19619;21938;22992,35040,1,1,2,0,4
51164,110,13866,19541;19708;22899;22999;23095,35040,3,0,2,0,5
51165,110,13867,19467;19560;21848;22680,35040,0,2,2,0,4
51166,110,13868,14932,35405,0,0,0,1,1
51167,110,13871,14743;15452,35405,0,0,0,2,2
51168,110,13872,15272;15623,35405,0,0,0,2,2
51169,110,13873,15157,35405,0,0,0,1,1
51170,110,13874,14421,35405,0,0,0,1,1
51171,110,13875,15283,35405,0,0,0,1,1
51172,110,13876,15477;15478,35405,0,0,0,2,2
51173,110,13877,15667,35405,0,0,0,1,1
51174,110,13878,15445;15792,35405,0,0,0,2,2
51175,110,13879,15926,35405,0,0,0,1,1
51176,110,13881,16102,35405,0,0,1,0,1
51177,110,13883,16137,35405,0,0,1,0,1
51178,110,13884,15418;15655,35405,0,0,0,2,2
51179,110,13886,16601;16826,35405,0,0,2,0,2
51180,110,13888,15878,35405,0,0,0,1,1
51181,110,13894,17124,35405,0,0,1,0,1
51182,110,13896,17234,35405,0,0,1,0,1
51183,110,13898,17335;17375;22161,35405,0,1,2,0,3
51184,110,13899,17438,35405,0,0,1,0,1
51185,110,13905,17466;17970,35405,0,0,2,0,2
51186,110,13907,17441,35405,0,0,1,0,1
51187,110,13908,18008;18017;21970;22182,35405,0,2,2,0,4
51188,110,13909,17799,35405,0,0,1,0,1
51189,110,13910,18236;21979,35405,0,1,1,0,2
51190,110,13911,18244,35405,0,0,1,0,1
51191,110,13912,18251;18619;22522,35405,0,1,2,0,3
51192,110,13915,18117,35405,0,0,1,0,1
51193,110,13917,18459;18620;22319;22426,35405,0,2,2,0,4
51194,110,13918,18388;18468;22416,35405,0,1,2,0,3
51195,110,13919,18349;18517;22054;22417,35405,0,2,2,0,4
51196,110,13920,18532;18757;22015;23049,35405,1,1,2,0,4
51197,110,13921,18553;19044,35405,0,0,2,0,2
51198,110,13922,18579;19094,35405,0,0,2,0,2
51199,110,13924,18624;18718;21962;22851,35405,1,1,2,0,4
51200,110,13925,18227;18626;21930;22219;22735,35405,0,3,2,0,5
51201,110,13926,18629;19223;22971,35405,1,0,2,0,3
51202,110,13927,18597;18735;22330,35405,0,1,2,0,3
51203,110,13928,18796;19287;22565;22665,35405,0,2,2,0,4
51204,110,13929,18816;18882;22149,35405,0,1,2,0,3
51205,110,13931,18851,35405,0,0,1,0,1
51206,110,13932,18549;18652;22732,35405,0,1,2,0,3
51207,110,13933,18728;19156;22769,35405,0,1,2,0,3
51208,110,13934,18705;18880;22441,35405,0,1,2,0,3
51209,110,13935,19031;19444;22888,35405,1,0,2,0,3
51210,110,13936,18333;19037;22452,35405,0,1,2,0,3
51211,110,13937,19047;19533;23181,35405,1,0,2,0,3
51212,110,13938,19204;19327;21961;22368,35405,0,2,2,0,4
51213,110,13939,19076;19654;22695;23189,35405,1,1,2,0,4
51214,110,13940,19008;19194;22003,35405,0,1,2,0,3
51215,110,13941,19132;19662,35405,0,0,2,0,2
51216,110,13942,18732;19283;22372;22464;22664;23163,35405,1,3,2,0,6
51217,110,13943,18637;19192;22099;22556,35405,0,2,2,0,4
51218,110,13945,19014;19231,35405,0,0,2,0,2
51219,110,13946,19100;19254,35405,0,0,2,0,2
51220,110,13947,19025;19285;22373,35405,0,1,2,0,3
51221,110,13948,19656,35405,0,0,1,0,1
51222,110,13949,19308;19422;22472,35405,0,1,2,0,3
51223,110,13950,19266;19351;22075;22370;22563;22662,35405,0,4,2,0,6
51224,110,13951,19166;19368;22568;22885,35405,1,1,2,0,4
51225,110,13952,19383;19578;22477;22795,35405,0,2,2,0,4
51226,110,13953,19431;19882;21935,35405,0,1,2,0,3
51227,110,13954,19397;19990;22001,35405,0,1,2,0,3
51228,110,13955,18763;19417;22087,35405,0,1,2,0,3
51229,110,13957,18909;19238;22878,35405,1,0,2,0,3
51230,110,13958,19306;19679,35405,0,0,2,0,2
51231,110,13959,19274,35405,0,0,1,0,1
51232,110,13960,19684;19753;22579,35405,0,1,2,0,3
51233,110,13961,19253;19568;23290,35405,1,0,2,0,3
51234,110,13962,19225;19577;23292,35405,1,0,2,0,3
51235,110,13963,19581;23184,35405,1,0,1,0,2
51236,110,13964,18762;19611,35405,0,0,2,0,2
51237,110,13965,19548;19641;22993,35405,1,0,2,0,3
51238,110,13966,19634;21928;22692,35405,0,2,1,0,3
51239,110,13967,19993;21934;22812;22910,35405,1,2,1,0,4
51240,110,13968,19680;19889,35405,0,0,2,0,2
51241,110,13969,14624,35770,0,0,0,1,1
51242,110,13970,15062,35770,0,0,0,1,1
51243,110,13971,15088,35770,0,0,0,1,1
51244,110,13972,14926,35770,0,0,0,1,1
51245,110,13973,15242,35770,0,0,0,1,1
51246,110,13974,15254,35770,0,0,0,1,1
51247,110,13976,15328,35770,0,0,0,1,1
51248,110,13977,15124,35770,0,0,0,1,1
51249,110,13978,15313,35770,0,0,0,1,1
51250,110,13980,15446,35770,0,0,0,1,1
51251,110,13983,16077,35770,0,0,1,0,1
51252,110,13989,15960,35770,0,0,0,1,1
51253,110,13992,16400;16586,35770,0,0,2,0,2
51254,110,13996,16476;16749,35770,0,0,2,0,2
51255,110,14003,17383,35770,0,0,1,0,1
51256,110,14004,17277;17374,35770,0,0,2,0,2
51257,110,14007,17456,35770,0,0,1,0,1
51258,110,14009,17553,35770,0,0,1,0,1
51259,110,14011,17852;18487;22624,35770,0,1,2,0,3
51260,110,14012,17931;18335;22056,35770,0,1,2,0,3
51261,110,14017,18407,35770,0,0,1,0,1
51262,110,14020,18230,35770,0,0,1,0,1
51263,110,14021,18383;18444;22127,35770,0,1,2,0,3
51264,110,14023,18241;18450,35770,0,0,2,0,2
51265,110,14024,18307;18494;22152,35770,0,1,2,0,3
51266,110,14027,18711;19072;22244;23272,35770,1,1,2,0,4
51267,110,14028,18661;18781;22086;22635,35770,0,2,2,0,4
51268,110,14029,19045;19264;22462;23277,35770,1,1,2,0,4
51269,110,14030,18800;19186;22367;22555;22659,35770,0,3,2,0,5
51270,110,14031,18289,35770,0,0,1,0,1
51271,110,14032,18937;19095;23273,35770,1,0,2,0,3
51272,110,14033,18996;19881;22120;23007,35770,1,1,2,0,4
51273,110,14034,18999;19268,35770,0,0,2,0,2
51274,110,14035,19028;19358;22162;22359;22958,35770,1,2,2,0,5
51275,110,14036,18959,35770,0,0,1,0,1
51276,110,14037,19007,35770,0,0,1,0,1
51277,110,14038,18967;19295;22252;22465,35770,0,2,2,0,4
51278,110,14039,18908;19179;23160,35770,1,0,2,0,3
51279,110,14040,19187;19527;22890,35770,1,0,2,0,3
51280,110,14042,19217;19324;22071;22467,35770,0,2,2,0,4
51281,110,14043,19224;19754;23301,35770,1,0,2,0,3
51282,110,14044,19248,35770,0,0,1,0,1
51283,110,14045,19256;19413;22982,35770,1,0,2,0,3
51284,110,14046,19198;19259;22159,35770,0,1,2,0,3
51285,110,14047,19106;19260;22454,35770,0,1,2,0,3
51286,110,14048,19511;23086;23179,35770,2,0,1,0,3
51287,110,14049,19281;19824,35770,0,0,2,0,2
51288,110,14050,19304;19609;22893;23185,35770,2,0,2,0,4
51289,110,14051,19135;19489;22257;23085,35770,1,1,2,0,4
51290,110,14052,19361,35770,0,0,1,0,1
51291,110,14053,19056;19552;23183,35770,1,0,2,0,3
51292,110,14055,19530;19828;22583,35770,0,1,2,0,3
51293,110,14056,19454;19499;22682,35770,0,1,2,0,3
51294,110,14057,19517;19902,35770,0,0,2,0,2
51295,110,14058,19520;19778,35770,0,0,2,0,2
51296,110,14059,19566;19832;22902,35770,1,0,2,0,3
51297,110,14060,19181,35770,0,0,1,0,1
51298,110,14061,19236;19565;22379,35770,0,1,2,0,3
51299,110,14062,19587;19705;22076;22690,35770,0,2,2,0,4
51300,110,14063,19241;19615;22894,35770,1,0,2,0,3
51301,110,14064,19632;19943;22150,35770,0,1,2,0,3
51302,110,14065,19691;20077;22115;23110,35770,1,1,2,0,4
51303,110,14066,19249;19702;22380;22804;22898;22998,35770,2,2,2,0,6
51304,110,14067,19330;19704,35770,0,0,2,0,2
51305,110,14068,19207;19710;22580;23000;23096,35770,2,1,2,0,5
51306,110,14069,19633;19712;22486,35770,0,1,2,0,3
51307,110,14070,19726;22488;23299,35770,1,1,1,0,3
51308,110,14071,19486;19739;22806,35770,0,1,2,0,3
51309,110,14072,19505;19744,35770,0,0,2,0,2
51310,110,14073,19847;20143,35770,0,0,2,0,2
51311,110,14074,19759;19970,35770,0,0,2,0,2
51312,110,14075,20099;20134,35770,0,0,2,0,2
51313,110,14076,19471;19780;22383,35770,0,1,2,0,3
51314,110,14077,19364;22471,35770,0,1,1,0,2
51315,110,14078,15832,36135,0,0,0,1,1
51316,110,14079,15654,36135,0,0,0,1,1
51317,110,14080,15357,36135,0,0,0,1,1
51318,110,14081,15731,36135,0,0,0,1,1
51319,110,14083,15572;15800,36135,0,0,0,2,2
51320,110,14084,15759,36135,0,0,0,1,1
51321,110,14085,15767,36135,0,0,0,1,1
51322,110,14087,15916,36135,0,0,0,1,1
51323,110,14089,16434,36135,0,0,1,0,1
51324,110,14094,16274,36135,0,0,1,0,1
51325,110,14102,17410,36135,0,0,1,0,1
51326,110,14103,17439,36135,0,0,1,0,1
51327,110,14112,18063;18473;22515,36135,0,1,2,0,3
51328,110,14113,17867,36135,0,0,1,0,1
51329,110,14114,18118;18499,36135,0,0,2,0,2
51330,110,14115,18197,36135,0,0,1,0,1
51331,110,14117,18141;18824,36135,0,0,2,0,2
51332,110,14121,18024;18420;22513,36135,0,1,2,0,3
51333,110,14123,18429;18998;22353;22754;22866,36135,1,2,2,0,5
51334,110,14126,18605;18857,36135,0,0,2,0,2
51335,110,14127,18650;19290;23076,36135,1,0,2,0,3
51336,110,14128,18675,36135,0,0,1,0,1
51337,110,14129,18709,36135,0,0,1,0,1
51338,110,14130,18749;18777,36135,0,0,2,0,2
51339,110,14132,18931,36135,0,0,1,0,1
51340,110,14134,18573;18765,36135,0,0,2,0,2
51341,110,14135,18817;18940;22345,36135,0,1,2,0,3
51342,110,14136,18894;18947;22346,36135,0,1,2,0,3
51343,110,14137,18977;19136;22544,36135,0,1,2,0,3
51344,110,14138,18730;18974;22447;22650;22751,36135,0,3,2,0,5
51345,110,14141,19079;19539;22793,36135,0,1,2,0,3
51346,110,14142,19085;19606;22892,36135,1,0,2,0,3
51347,110,14143,19150;19478,36135,0,0,2,0,2
51348,110,14144,19212;19447,36135,0,0,2,0,2
51349,110,14145,19078;19239,36135,0,0,2,0,2
51350,110,14147,19252;19934;22267,36135,0,1,2,0,3
51351,110,14148,18760,36135,0,0,1,0,1
51352,110,14150,19289;19729;23198,36135,1,0,2,0,3
51353,110,14151,19054;19488,36135,0,0,2,0,2
51354,110,14152,19208;19337;22253,36135,0,1,2,0,3
51355,110,14153,19340;19485;22990,36135,1,0,2,0,3
51356,110,14154,18673;19357;23081;23166,36135,2,0,2,0,4
51357,110,14155,19387;19913,36135,0,0,2,0,2
51358,110,14156,19227;19403;23170,36135,1,0,2,0,3
51359,110,14157,19139;19408;22981;23171,36135,2,0,2,0,4
51360,110,14159,19235;19423,36135,0,0,2,0,2
51361,110,14160,19466;19768;23098,36135,1,0,2,0,3
51362,110,14161,19484;19771,36135,0,0,2,0,2
51363,110,14162,20024;23214,36135,1,0,1,0,2
51364,110,14163,19349;19516;22374;22469;23080,36135,1,2,2,0,5
51365,110,14165,19377;19536;22258,36135,0,1,2,0,3
51366,110,14166,19555;19756;22382;22807,36135,0,2,2,0,4
51367,110,14167,19871;22585,36135,0,1,1,0,2
51368,110,14168,19592;19840;23203,36135,1,0,2,0,3
51369,110,14169,19628,36135,0,0,1,0,1
51370,110,14170,19635;19685;22895;23193,36135,2,0,2,0,4
51371,110,14171,19819;19903,36135,0,0,2,0,2
51372,110,14172,19270;19646;22482;22693,36135,0,2,2,0,4
51373,110,14173,19659;19895,36135,0,0,2,0,2
51374,110,14174,19672,36135,0,0,1,0,1
51375,110,14175,19640;19690,36135,0,0,2,0,2
51376,110,14176,19580;19695,36135,0,0,2,0,2
51377,110,14177,19709;20154,36135,0,0,2,0,2
51378,110,14178,19751;20210,36135,0,0,2,0,2
51379,110,14179,19788,36135,0,0,1,0,1
51380,110,14180,19605;22798,36135,0,1,1,0,2
51381,110,14181,19747;19839,36135,0,0,2,0,2
51382,110,14182,19852;19905;23206,36135,1,0,2,0,3
51383,110,14183,19855;19856;23204,36135,1,0,2,0,3
51384,110,14184,19761;19874,36135,0,0,2,0,2
51385,110,14185,19649;19885,36135,0,0,2,0,2
51386,110,14186,19890;19948;23106,36135,1,0,2,0,3
51387,110,14187,19599;22259;22576;22797,36135,0,3,1,0,4
51388,110,14188,19911;20047,36135,0,0,2,0,2
51389,110,14189,19914;20031;22706;23103,36135,1,1,2,0,4
51390,110,14190,14918,36500,0,0,0,1,1
51391,110,14192,15345,36500,0,0,0,1,1
51392,110,14193,14857,36500,0,0,0,1,1
51393,110,14194,15479,36500,0,0,0,1,1
51394,110,14195,15592,36500,0,0,0,1,1
51395,110,14196,15637,36500,0,0,0,1,1
51396,110,14197,15711,36500,0,0,0,1,1
51397,110,14198,15932,36500,0,0,0,1,1
51398,110,14199,15574,36500,0,0,0,1,1
51399,110,14200,16094,36500,0,0,1,0,1
51400,110,14206,16429,36500,0,0,1,0,1
51401,110,14207,16495,36500,0,0,1,0,1
51402,110,14209,16530;16557,36500,0,0,2,0,2
51403,110,14212,16657,36500,0,0,1,0,1
51404,110,14214,16621;16660,36500,0,0,2,0,2
51405,110,14218,17015,36500,0,0,1,0,1
51406,110,14222,17664;17927,36500,0,0,2,0,2
51407,110,14223,17159,36500,0,0,1,0,1
51408,110,14225,17350,36500,0,0,1,0,1
51409,110,14228,18348;18866;22340,36500,0,1,2,0,3
51410,110,14229,18372;18463,36500,0,0,2,0,2
51411,110,14232,18509;18738;22433,36500,0,1,2,0,3
51412,110,14233,18423;18572,36500,0,0,2,0,2
51413,110,14234,18576;18815;22639,36500,0,1,2,0,3
51414,110,14235,18583,36500,0,0,1,0,1
51415,110,14236,19097;19305,36500,0,0,2,0,2
51416,110,14237,18734,36500,0,0,1,0,1
51417,110,14238,18743;19116;23067;23274,36500,2,0,2,0,4
51418,110,14239,18865;19218;22461;22661;22774,36500,0,3,2,0,5
51419,110,14240,18841;18887,36500,0,0,2,0,2
51420,110,14241,18942,36500,0,0,1,0,1
51421,110,14244,18674;19020;22867,36500,1,0,2,0,3
51422,110,14245,19022;19682;22485;22697;22802;23191;23297,36500,2,3,2,0,7
51423,110,14247,19171;19717;22900,36500,1,0,2,0,3
51424,110,14248,19234;19963,36500,0,0,2,0,2
51425,110,14249,19143;19312;22466;22666,36500,0,2,2,0,4
51426,110,14250,19314;19322,36500,0,0,2,0,2
51427,110,14251,19323;19420;22256;22781,36500,0,2,2,0,4
51428,110,14252,19331;19395,36500,0,0,2,0,2
51429,110,14253,19699;19924;22266;22906,36500,1,1,2,0,4
51430,110,14254,19081;19341;23079,36500,1,0,2,0,3
51431,110,14255,19713,36500,0,0,1,0,1
51432,110,14256,19385;19575,36500,0,0,2,0,2
51433,110,14257,19389;19854,36500,0,0,2,0,2
51434,110,14258,19393;19583,36500,0,0,2,0,2
51435,110,14259,18984;19399,36500,0,0,2,0,2
51436,110,14260,19432;19844;22584;23308,36500,1,1,2,0,4
51437,110,14261,19440;19553;22686,36500,0,1,2,0,3
51438,110,14262,18916;19515;22991,36500,1,0,2,0,3
51439,110,14263,19461;19644;22787;23286,36500,1,1,2,0,4
51440,110,14264,18873;19469;22475;22987,36500,1,1,2,0,4
51441,110,14265,19496;19604,36500,0,0,2,0,2
51442,110,14266,19497;19825;22262,36500,0,1,2,0,3
51443,110,14267,19519;19664;22483;23295,36500,1,1,2,0,4
51444,110,14269,19595;19597,36500,0,0,2,0,2
51445,110,14270,19873,36500,0,0,1,0,1
51446,110,14271,19626;19650;22694;23294,36500,1,1,2,0,4
51447,110,14273,19651;20027,36500,0,0,2,0,2
51448,110,14274,18863;19653,36500,0,0,2,0,2
51449,110,14275,19066;19666;22801,36500,0,1,2,0,3
51450,110,14276,19483;19714;22487;23195,36500,1,1,2,0,4
51451,110,14277,19309;19835,36500,0,0,2,0,2
51452,110,14278,19694;22803,36500,0,1,1,0,2
51453,110,14279,19760;19979;23108,36500,1,0,2,0,3
51454,110,14280,19430;19762,36500,0,0,2,0,2
51455,110,14281,19479;19814;22385;23004;23306,36500,2,1,2,0,5
51456,110,14282,19784;20118;22591,36500,0,1,2,0,3
51457,110,14284,19833;20092;22492,36500,0,1,2,0,3
51458,110,14285,19602;19859,36500,0,0,2,0,2
51459,110,14286,19862;20057,36500,0,0,2,0,2
51460,110,14287,19868;20015;22709,36500,0,1,2,0,3
51461,110,14288,19872;19968;22588;23010,36500,1,1,2,0,4
51462,110,14289,19910;20138;22273;23228,36500,1,1,2,0,4
51463,110,14290,19923;20136;22491;23208,36500,1,1,2,0,4
51464,110,14291,19523;19975,36500,0,0,2,0,2
51465,110,14292,19996;20033;22814;23215,36500,1,1,2,0,4
51466,110,14293,20023;20172,36500,0,0,2,0,2
51467,110,14294,15547,36865,0,0,0,1,1
51468,110,14296,15631,36865,0,0,0,1,1
51469,110,14297,15450,36865,0,0,0,1,1
51470,110,14300,15404,36865,0,0,0,1,1
51471,110,14303,16571,36865,0,0,1,0,1
51472,110,14308,16486;16812,36865,0,0,2,0,2
51473,110,14309,17113,36865,0,0,1,0,1
51474,110,14312,17084,36865,0,0,1,0,1
51475,110,14314,17072,36865,0,0,1,0,1
51476,110,14319,17632,36865,0,0,1,0,1
51477,110,14326,18536,36865,0,0,1,0,1
51478,110,14327,18666;19105,36865,0,0,2,0,2
51479,110,14328,18753;19122;22874,36865,1,0,2,0,3
51480,110,14329,18828;19265,36865,0,0,2,0,2
51481,110,14330,18782;18905;22335;22532,36865,0,2,2,0,4
51482,110,14331,18966;19191;23074,36865,1,0,2,0,3
51483,110,14332,18983;19465,36865,0,0,2,0,2
51484,110,14333,19033;19062;22549,36865,0,1,2,0,3
51485,110,14334,19005;22354;22756,36865,0,2,1,0,3
51486,110,14335,19245;19394;22672,36865,0,1,2,0,3
51487,110,14337,19134;19642;22481,36865,0,1,2,0,3
51488,110,14338,19046;19140;22242;22360;22871,36865,1,2,2,0,5
51489,110,14339,19149;19462;22456;23071;23158,36865,2,1,2,0,5
51490,110,14341,19161,36865,0,0,1,0,1
51491,110,14342,19284;19802;23100,36865,1,0,2,0,3
51492,110,14343,19338;19590,36865,0,0,2,0,2
51493,110,14344,19328;19372;22255;22670,36865,0,2,2,0,4
51494,110,14345,18889,36865,0,0,1,0,1
51495,110,14346,19426;19452;22676;22782,36865,0,2,2,0,4
51496,110,14347,19453;19480;23174,36865,1,0,2,0,3
51497,110,14348,19463;19980;23316,36865,1,0,2,0,3
51498,110,14350,19071,36865,0,0,1,0,1
51499,110,14351,19506;20193;22821,36865,0,1,2,0,3
51500,110,14352,19445,36865,0,0,1,0,1
51501,110,14354,19643;19920;22265;22586,36865,0,2,2,0,4
51502,110,14355,19598;22478,36865,0,1,1,0,2
51503,110,14356,20152,36865,0,0,1,0,1
51504,110,14357,19263;19613;22691;22799;23090,36865,1,2,2,0,5
51505,110,14358,19525;19658;22578;23092;23190,36865,2,1,2,0,5
51506,110,14359,19688;20270;23233,36865,1,0,2,0,3
51507,110,14360,19701;20114,36865,0,0,2,0,2
51508,110,14361,19818;20373,36865,0,0,2,0,2
51509,110,14362,19668;19827;23005,36865,1,0,2,0,3
51510,110,14363,19829;20433,36865,0,0,2,0,2
51511,110,14364,19860;19957;22908,36865,1,0,2,0,3
51512,110,14365,19866;20249,36865,0,0,2,0,2
51513,110,14366,19752;19887;22489,36865,0,1,2,0,3
51514,110,14367,19904;20365,36865,0,0,2,0,2
51515,110,14368,19676;19917,36865,0,0,2,0,2
51516,110,14369,19940;20011;23104,36865,1,0,2,0,3
51517,110,14370,20054;20205,36865,0,0,2,0,2
51518,110,14371,20058;20268,36865,0,0,2,0,2
51519,110,14372,20059;20119,36865,0,0,2,0,2
51520,110,14373,20074,36865,0,0,1,0,1
51521,110,14374,20093;20486;23240,36865,1,0,2,0,3
51522,110,14375,20028;20103,36865,0,0,2,0,2
51523,110,14376,20105;20149;23224,36865,1,0,2,0,3
51524,110,14377,20121;20567;22924;23130,36865,2,0,2,0,4
51525,110,14378,20126;20260,36865,0,0,2,0,2
51526,110,14379,15537,37230,0,0,0,1,1
51527,110,14380,16057,37230,0,0,0,1,1
51528,110,14381,15809,37230,0,0,0,1,1
51529,110,14382,15851,37230,0,0,0,1,1
51530,110,14383,15888,37230,0,0,0,1,1
51531,110,14384,15894,37230,0,0,0,1,1
51532,110,14385,15853,37230,0,0,0,1,1
51533,110,14387,15975,37230,0,0,0,1,1
51534,110,14388,16317,37230,0,0,1,0,1
51535,110,14389,16488,37230,0,0,1,0,1
51536,110,14390,16528,37230,0,0,1,0,1
51537,110,14398,17107,37230,0,0,1,0,1
51538,110,14400,17424,37230,0,0,1,0,1
51539,110,14402,17624,37230,0,0,1,0,1
51540,110,14403,17636,37230,0,0,1,0,1
51541,110,14408,18052;18539;23147,37230,1,0,2,0,3
51542,110,14413,18382,37230,0,0,1,0,1
51543,110,14414,18243,37230,0,0,1,0,1
51544,110,14415,18466,37230,0,0,1,0,1
51545,110,14416,18610;18754;22331,37230,0,1,2,0,3
51546,110,14417,18399;18422;22622,37230,0,1,2,0,3
51547,110,14419,18668;19342;22468;22883;23279,37230,2,1,2,0,5
51548,110,14420,18170;18669;22221,37230,0,1,2,0,3
51549,110,14422,18471,37230,0,0,1,0,1
51550,110,14423,18854,37230,0,0,1,0,1
51551,110,14427,18590,37230,0,0,1,0,1
51552,110,14428,19003;19127,37230,0,0,2,0,2
51553,110,14429,19075;19390;22569;22979,37230,1,1,2,0,4
51554,110,14430,19148;19621,37230,0,0,2,0,2
51555,110,14431,19162;19375,37230,0,0,2,0,2
51556,110,14432,19189;19502,37230,0,0,2,0,2
51557,110,14433,19052;19118;22873;22964,37230,2,0,2,0,4
51558,110,14435,19897;23102;23311,37230,2,0,1,0,3
51559,110,14436,19367;22977,37230,1,0,1,0,2
51560,110,14437,19805;23304,37230,1,0,1,0,2
51561,110,14438,19455;19473,37230,0,0,2,0,2
51562,110,14439,19477;19620;23084,37230,1,0,2,0,3
51563,110,14440,18895;19531;22792;22891,37230,1,1,2,0,4
51564,110,14442,19493;22573,37230,0,1,1,0,2
51565,110,14443,19573;20329,37230,0,0,2,0,2
51566,110,14445,19449;20102;22493,37230,0,1,2,0,3
51567,110,14446,19800,37230,0,0,1,0,1
51568,110,14447,19622;20026;22479;22800;23186,37230,1,2,2,0,5
51569,110,14448,19645;19750;22901,37230,1,0,2,0,3
51570,110,14449,19689;20222,37230,0,0,2,0,2
51571,110,14450,19310;19696;22896,37230,1,0,2,0,3
51572,110,14451,19742;20509;22603,37230,0,1,2,0,3
51573,110,14452,19783;20380,37230,0,0,2,0,2
51574,110,14453,19808;20208;23232,37230,1,0,2,0,3
51575,110,14454,19544;19830;23101,37230,1,0,2,0,3
51576,110,14455,19343;19831;23202;23307,37230,2,0,2,0,4
51577,110,14456,19721;19879,37230,0,0,2,0,2
51578,110,14457,19823;19858;23205,37230,1,0,2,0,3
51579,110,14458,19715;19861;22698;23001;23196,37230,2,1,2,0,5
51580,110,14459,19876;20010,37230,0,0,2,0,2
51581,110,14460,20036;22710,37230,0,1,1,0,2
51582,110,14461,19908;20500;23029,37230,1,0,2,0,3
51583,110,14462,19826;19912;22905;23207,37230,2,0,2,0,4
51584,110,14463,19915;20492;23337,37230,1,0,2,0,3
51585,110,14464,20081;22816;23222,37230,1,1,1,0,3
51586,110,14465,20174,37230,0,0,1,0,1
51587,110,14466,19300;19952;23107,37230,1,0,2,0,3
51588,110,14467,19985;20304;22275,37230,0,1,2,0,3
51589,110,14468,19663;19989,37230,0,0,2,0,2
51590,110,14470,20472,37230,0,0,1,0,1
51591,110,14471,20005;20067;22712,37230,0,1,2,0,3
51592,110,14472,19838;20075;22815;23221;23321,37230,2,1,2,0,5
51593,110,14473,20041;20079;22714,37230,0,1,2,0,3
51594,110,14474,19532;20101;23017,37230,1,0,2,0,3
51595,110,14475,19779;20140;22274,37230,0,1,2,0,3
51596,110,14476,20330;20369,37230,0,0,2,0,2
51597,110,14477,20150;20574,37230,0,0,2,0,2
51598,110,14478,20155;20217;22915;23230,37230,2,0,2,0,4
51599,110,14479,19869;20163,37230,0,0,2,0,2
51600,110,14480,20414;20506,37230,0,0,2,0,2
51601,110,14481,20177;20257;23328,37230,1,0,2,0,3
51602,110,14482,20090;20179,37230,0,0,2,0,2
51603,110,14483,20199;20440,37230,0,0,2,0,2
51604,110,14484,20523;20612;23340,37230,1,0,2,0,3
51605,110,14485,15783,37595,0,0,0,1,1
51606,110,14486,15648,37595,0,0,0,1,1
51607,110,14487,15362,37595,0,0,0,1,1
51608,110,14489,15634,37595,0,0,0,1,1
51609,110,14490,15264,37595,0,0,0,1,1
51610,110,14492,15610,37595,0,0,0,1,1
51611,110,14494,16206,37595,0,0,1,0,1
51612,110,14495,16073,37595,0,0,0,1,1
51613,110,14496,16653,37595,0,0,1,0,1
51614,110,14497,16225,37595,0,0,1,0,1
51615,110,14498,16667,37595,0,0,1,0,1
51616,110,14503,17225;17637,37595,0,0,2,0,2
51617,110,14507,17386,37595,0,0,1,0,1
51618,110,14508,17511;17877,37595,0,0,2,0,2
51619,110,14512,17793;22179,37595,0,1,1,0,2
51620,110,14514,17893;18365;22205;22408;22727,37595,0,3,2,0,5
51621,110,14516,17821,37595,0,0,1,0,1
51622,110,14521,18387,37595,0,0,1,0,1
51623,110,14522,18912,37595,0,0,1,0,1
51624,110,14523,18507,37595,0,0,1,0,1
51625,110,14525,18807;18945;22445,37595,0,1,2,0,3
51626,110,14526,18799;19243;22250;22777,37595,0,2,2,0,4
51627,110,14527,18804;19058,37595,0,0,2,0,2
51628,110,14528,18879;19184;22969;23073,37595,2,0,2,0,4
51629,110,14529,19064,37595,0,0,1,0,1
51630,110,14530,19175;19401;22673;22780,37595,0,2,2,0,4
51631,110,14531,19450;20020;22269,37595,0,1,2,0,3
51632,110,14532,18850;19459;22785;22986,37595,1,1,2,0,4
51633,110,14533,19396,37595,0,0,1,0,1
51634,110,14534,19562;19737;22805,37595,0,1,2,0,3
51635,110,14535,19574;19886,37595,0,0,2,0,2
51636,110,14536,20089;23223,37595,1,0,1,0,2
51637,110,14537,19457;19683;23192,37595,1,0,2,0,3
51638,110,14538,19673;19867,37595,0,0,2,0,2
51639,110,14539,19510,37595,0,0,1,0,1
51640,110,14540,19589;19893,37595,0,0,2,0,2
51641,110,14542,19456;19711;22381;23298,37595,1,1,2,0,4
51642,110,14543,19743;19782;23097,37595,1,0,2,0,3
51643,110,14544,19851;19981;23011,37595,1,0,2,0,3
51644,110,14545,19674;19736;23300,37595,1,0,2,0,3
51645,110,14548,19799;20056,37595,0,0,2,0,2
51646,110,14549,19813;20068,37595,0,0,2,0,2
51647,110,14550,19610;19892,37595,0,0,2,0,2
51648,110,14551,19937;20086,37595,0,0,2,0,2
51649,110,14552,19942;20191,37595,0,0,2,0,2
51650,110,14553,19362;19946;22587;23105;23210,37595,2,1,2,0,5
51651,110,14554,19748;19950;22707;22907,37595,1,1,2,0,4
51652,110,14555,19758;19953,37595,0,0,2,0,2
51653,110,14556,20429,37595,0,0,1,0,1
51654,110,14557,20000;20029;23013,37595,1,0,2,0,3
51655,110,14558,20495;23028;23128,37595,2,0,1,0,3
51656,110,14559,20116;22913;23323,37595,2,0,1,0,3
51657,110,14560,19899;20127;22592,37595,0,1,2,0,3
51658,110,14561,19749;19843;22903;23006,37595,2,0,2,0,4
51659,110,14562,20145;20480;22922,37595,1,0,2,0,3
51660,110,14563,20175,37595,0,0,1,0,1
51661,110,14564,20180;20204,37595,0,0,2,0,2
51662,110,14565,20107;20186,37595,0,0,2,0,2
51663,110,14566,20189;20501;23129,37595,1,0,2,0,3
51664,110,14567,20201;20307,37595,0,0,2,0,2
51665,110,14568,20030;20202;22916,37595,1,0,2,0,3
51666,110,14569,20156;20203,37595,0,0,2,0,2
51667,110,14570,20218;20404;22600;23123,37595,1,1,2,0,4
51668,110,14571,20113;20242,37595,0,0,2,0,2
51669,110,14572,20244;22596;22716,37595,0,2,1,0,3
51670,110,14573,20220;20264;22594,37595,0,1,2,0,3
51671,110,14574,20269;20361,37595,0,0,2,0,2
51672,110,14575,20196;20275,37595,0,0,2,0,2
51673,110,14576,20296;20308,37595,0,0,2,0,2
51674,110,14577,20315;20652,37595,0,0,2,0,2
51675,110,14578,20321;20728,37595,0,0,2,0,2
51676,110,14579,20328;20711,37595,0,0,2,0,2
51677,110,14580,20334;22918,37595,1,0,1,0,2
51678,110,14581,20194;20376,37595,0,0,2,0,2
51679,110,14582,20340;20542;23343,37595,1,0,2,0,3
51680,110,14583,20341;20394,37595,0,0,2,0,2
51681,110,14584,20350;20715,37595,0,0,2,0,2
51682,110,14585,15793,37960,0,0,0,1,1
51683,110,14586,15700,37960,0,0,0,1,1
51684,110,14588,16142,37960,0,0,1,0,1
51685,110,14589,15318,37960,0,0,0,1,1
51686,110,14590,16565;16599,37960,0,0,2,0,2
51687,110,14594,16543,37960,0,0,1,0,1
51688,110,14597,16649;16808,37960,0,0,2,0,2
51689,110,14599,16655,37960,0,0,1,0,1
51690,110,14600,16976;17035,37960,0,0,2,0,2
51691,110,14601,16727,37960,0,0,1,0,1
51692,110,14603,17675,37960,0,0,1,0,1
51693,110,14604,17674,37960,0,0,1,0,1
51694,110,14607,17811,37960,0,0,1,0,1
51695,110,14610,17665,37960,0,0,1,0,1
51696,110,14616,17796;18090,37960,0,0,2,0,2
51697,110,14617,18330,37960,0,0,1,0,1
51698,110,14619,18217;18378;22409,37960,0,1,2,0,3
51699,110,14620,18418,37960,0,0,1,0,1
51700,110,14621,18364,37960,0,0,1,0,1
51701,110,14622,18484,37960,0,0,1,0,1
51702,110,14626,18859,37960,0,0,1,0,1
51703,110,14627,18878;19023;22357;22653;23059;23154,37960,2,2,2,0,6
51704,110,14628,18677,37960,0,0,1,0,1
51705,110,14630,19183;19416;22983,37960,1,0,2,0,3
51706,110,14631,18716;19029;22240;22760;22959;23060,37960,2,2,2,0,6
51707,110,14632,19202,37960,0,0,1,0,1
51708,110,14633,18726;18792,37960,0,0,2,0,2
51709,110,14634,19313,37960,0,0,1,0,1
51710,110,14635,19210,37960,0,0,1,0,1
51711,110,14636,19119;19563,37960,0,0,2,0,2
51712,110,14637,19437;19966;22909,37960,1,0,2,0,3
51713,110,14638,19443;19678;22484;23093,37960,1,1,2,0,4
51714,110,14639,19460;19670;22786;23285,37960,1,1,2,0,4
51715,110,14640,19475;22376;22788;22989;23176,37960,2,2,1,0,5
51716,110,14641,19487,37960,0,0,1,0,1
51717,110,14642,19302,37960,0,0,1,0,1
51718,110,14643,19276;19371;22669;23281,37960,1,1,2,0,4
51719,110,14644,19596;19918,37960,0,0,2,0,2
51720,110,14645,19647;19863;23188,37960,1,0,2,0,3
51721,110,14646,19614,37960,0,0,1,0,1
51722,110,14647,19630;22577,37960,0,1,1,0,2
51723,110,14648,19631;20146,37960,0,0,2,0,2
51724,110,14649,19439;19636,37960,0,0,2,0,2
51725,110,14650,19441;19648;22996,37960,1,0,2,0,3
51726,110,14651,19657;20013;22708,37960,0,1,2,0,3
51727,110,14652,19807,37960,0,0,1,0,1
51728,110,14653,19773;22582;22700;23199,37960,1,2,1,0,4
51729,110,14654,19718,37960,0,0,1,0,1
51730,110,14655,19725;19794,37960,0,0,2,0,2
51731,110,14656,19765;19944;22268;23314,37960,1,1,2,0,4
51732,110,14657,19777;20111;23112,37960,1,0,2,0,3
51733,110,14658,19547;19791,37960,0,0,2,0,2
51734,110,14659,19795;20531,37960,0,0,2,0,2
51735,110,14660,19421;19797;22704;22809,37960,0,2,2,0,4
51736,110,14661,19409;20032,37960,0,0,2,0,2
51737,110,14662,19639;19810;23091;23187,37960,2,0,2,0,4
51738,110,14663,19817;19922,37960,0,0,2,0,2
51739,110,14664,19864;20223;22595,37960,0,1,2,0,3
51740,110,14665,19928;23209,37960,1,0,1,0,2
51741,110,14666,19938;20603;23133,37960,1,0,2,0,3
51742,110,14667,19945;19998;23012,37960,1,0,2,0,3
51743,110,14668,19955;20528;23031;23341,37960,2,0,2,0,4
51744,110,14669,19723;20187,37960,0,0,2,0,2
51745,110,14670,19451;20017,37960,0,0,2,0,2
51746,110,14671,20463;23127,37960,1,0,1,0,2
51747,110,14672,20078;20489,37960,0,0,2,0,2
51748,110,14673,19896;20096;22271,37960,0,1,2,0,3
51749,110,14674,20109,37960,0,0,1,0,1
51750,110,14675,20582;23243,37960,1,0,1,0,2
51751,110,14676,20001;20122;22914,37960,1,0,2,0,3
51752,110,14677,20124;20761,37960,0,0,2,0,2
51753,110,14678,19763;20310;22597,37960,0,1,2,0,3
51754,110,14679,20147;20374;22823,37960,0,1,2,0,3
51755,110,14680,20159;20393,37960,0,0,2,0,2
51756,110,14681,20336;20421,37960,0,0,2,0,2
51757,110,14682,20212;20248,37960,0,0,2,0,2
51758,110,14683,20245,37960,0,0,1,0,1
51759,110,14684,20254;20415;23124,37960,1,0,2,0,3
51760,110,14685,19971;20316,37960,0,0,2,0,2
51761,110,14686,19976;20263,37960,0,0,2,0,2
51762,110,14687,20293;20401;22494,37960,0,1,2,0,3
51763,110,14688,20317;20319;23117,37960,1,0,2,0,3
51764,110,14689,20211;20342,37960,0,0,2,0,2
51765,110,14690,20355;20595;22604;22926,37960,1,1,2,0,4
51766,110,14691,20775,37960,0,0,1,0,1
51767,110,14692,20384;20424,37960,0,0,2,0,2
51768,110,14693,20410;23334,37960,1,0,1,0,2
51769,110,14694,20007;20413;22921,37960,1,0,2,0,3
51770,110,14695,20226;20427;22388,37960,0,1,2,0,3
51771,110,14696,20436;20544,37960,0,0,2,0,2
51772,110,14697,20229;20447,37960,0,0,2,0,2
51773,110,14698,20125;20448,37960,0,0,2,0,2
51774,110,14699,20870;21112,37960,0,0,2,0,2
51775,110,14700,20485;20550;23344,37960,1,0,2,0,3
51776,110,14701,20745;23035;23251,37960,2,0,1,0,3
51777,110,14702,20496;20646,37960,0,0,2,0,2
51778,110,14703,20430;20497;22827;23338,37960,1,1,2,0,4
51779,110,14704,16034,38325,0,0,0,1,1
51780,110,14705,16419,38325,0,0,1,0,1
51781,110,14706,15996,38325,0,0,0,1,1
51782,110,14712,16611,38325,0,0,1,0,1
51783,110,14713,16711,38325,0,0,1,0,1
51784,110,14714,16775;16999,38325,0,0,2,0,2
51785,110,14715,16838,38325,0,0,1,0,1
51786,110,14716,16726,38325,0,0,1,0,1
51787,110,14718,16887,38325,0,0,1,0,1
51788,110,14719,16572,38325,0,0,1,0,1
51789,110,14722,17373,38325,0,0,1,0,1
51790,110,14724,17492,38325,0,0,1,0,1
51791,110,14725,17542;18003,38325,0,0,2,0,2
51792,110,14726,17668,38325,0,0,1,0,1
51793,110,14727,17744,38325,0,0,1,0,1
51794,110,14729,17774,38325,0,0,1,0,1
51795,110,14731,17943,38325,0,0,1,0,1
51796,110,14734,17907,38325,0,0,1,0,1
51797,110,14735,18206;18419,38325,0,0,2,0,2
51798,110,14738,18320,38325,0,0,1,0,1
51799,110,14740,18635;18681,38325,0,0,2,0,2
51800,110,14742,18855;18955;22446,38325,0,1,2,0,3
51801,110,14743,19001;19222;22970,38325,1,0,2,0,3
51802,110,14744,19059;19153,38325,0,0,2,0,2
51803,110,14745,18888;19133,38325,0,0,2,0,2
51804,110,14746,19190;19347;22668,38325,0,1,2,0,3
51805,110,14747,19297;19567;22688;22794,38325,0,2,2,0,4
51806,110,14748,19321;19660,38325,0,0,2,0,2
51807,110,14749,19301;19326,38325,0,0,2,0,2
51808,110,14750,19572;19991,38325,0,0,2,0,2
51809,110,14751,19476;19809;23003;23305,38325,2,0,2,0,4
51810,110,14752,19522,38325,0,0,1,0,1
51811,110,14753,19538;19786;22384;23099,38325,1,1,2,0,4
51812,110,14754,19514;19848;22904,38325,1,0,2,0,3
51813,110,14755,19579;19772;22699,38325,0,1,2,0,3
51814,110,14756,19722;23197,38325,1,0,1,0,2
51815,110,14757,19339;19637,38325,0,0,2,0,2
51816,110,14759,19591;19796;22703;23201,38325,1,1,2,0,4
51817,110,14760,19681;20021;23213;23318,38325,2,0,2,0,4
51818,110,14761,19724;20297,38325,0,0,2,0,2
51819,110,14762,19329;19733,38325,0,0,2,0,2
51820,110,14763,19766;19958;23315,38325,1,0,2,0,3
51821,110,14764,19812;19959,38325,0,0,2,0,2
51822,110,14765,19798,38325,0,0,1,0,1
51823,110,14766,19857;19875;22490,38325,0,1,2,0,3
51824,110,14767,20181,38325,0,0,1,0,1
51825,110,14768,19877;20375;23332,38325,1,0,2,0,3
51826,110,14769,19900;20128;23226,38325,1,0,2,0,3
51827,110,14770,19935;20235;23116,38325,1,0,2,0,3
51828,110,14771,19982,38325,0,0,1,0,1
51829,110,14772,20019;20064,38325,0,0,2,0,2
51830,110,14773,20042;20071;23218,38325,1,0,2,0,3
51831,110,14774,19607,38325,0,0,1,0,1
51832,110,14775,20106;20351,38325,0,0,2,0,2
51833,110,14776,20110;20823,38325,0,0,2,0,2
51834,110,14777,20112;20190,38325,0,0,2,0,2
51835,110,14778,20160;20517;23030;23339,38325,2,0,2,0,4
51836,110,14779,20168;20884,38325,0,0,2,0,2
51837,110,14780,20184;20541,38325,0,0,2,0,2
51838,110,14781,20206;20353;23022,38325,1,0,2,0,3
51839,110,14782,20237;20554,38325,0,0,2,0,2
51840,110,14783,20277;20383;22390,38325,0,1,2,0,3
51841,110,14784,20278;20456;23336,38325,1,0,2,0,3
51842,110,14785,20306;20671,38325,0,0,2,0,2
51843,110,14786,20153,38325,0,0,1,0,1
51844,110,14787,20314,38325,0,0,1,0,1
51845,110,14788,20323;20570;22925,38325,1,0,2,0,3
51846,110,14789,20326;20511,38325,0,0,2,0,2
51847,110,14790,20214;20332,38325,0,0,2,0,2
51848,110,14791,20345,38325,0,0,1,0,1
51849,110,14792,20164;20352,38325,0,0,2,0,2
51850,110,14793,20381;20906,38325,0,0,2,0,2
51851,110,14794,19972;20388;23237,38325,1,0,2,0,3
51852,110,14795,20012;20403;23025;23238,38325,2,0,2,0,4
51853,110,14796,20291;20409;22917,38325,1,0,2,0,3
51854,110,14797,20053;20452,38325,0,0,2,0,2
51855,110,14798,20459;20460;22824,38325,0,1,2,0,3
51856,110,14799,20505,38325,0,0,1,0,1
51857,110,14800,20515;20924;23257,38325,1,0,2,0,3
51858,110,14801,19977;20571;23345,38325,1,0,2,0,3
51859,110,14802,20594;20780,38325,0,0,2,0,2
51860,110,14803,20596;20653,38325,0,0,2,0,2
51861,110,14804,16082,38690,0,0,1,0,1
51862,110,14805,16457,38690,0,0,1,0,1
51863,110,14806,16547;17032,38690,0,0,2,0,2
51864,110,14807,16280,38690,0,0,1,0,1
51865,110,14808,16744,38690,0,0,1,0,1
51866,110,14809,16152,38690,0,0,1,0,1
51867,110,14810,17009,38690,0,0,1,0,1
51868,110,14814,17112,38690,0,0,1,0,1
51869,110,14815,17271,38690,0,0,1,0,1
51870,110,14816,17380,38690,0,0,1,0,1
51871,110,14817,17418,38690,0,0,1,0,1
51872,110,14818,17533,38690,0,0,1,0,1
51873,110,14819,17089,38690,0,0,1,0,1
51874,110,14820,17581,38690,0,0,1,0,1
51875,110,14822,17835;18041,38690,0,0,2,0,2
51876,110,14824,18138;18689,38690,0,0,2,0,2
51877,110,14826,18417,38690,0,0,1,0,1
51878,110,14827,18446,38690,0,0,1,0,1
51879,110,14830,18609,38690,0,0,1,0,1
51880,110,14831,18990;19603,38690,0,0,2,0,2
51881,110,14832,19193;19584,38690,0,0,2,0,2
51882,110,14833,18836,38690,0,0,1,0,1
51883,110,14834,18864;19043,38690,0,0,2,0,2
51884,110,14835,18646,38690,0,0,1,0,1
51885,110,14836,18884,38690,0,0,1,0,1
51886,110,14837,19188,38690,0,0,1,0,1
51887,110,14839,19335;19346;23165,38690,1,0,2,0,3
51888,110,14840,19402;19774;23302,38690,1,0,2,0,3
51889,110,14841,19412,38690,0,0,1,0,1
51890,110,14842,19414;19907;22263;22705;23312,38690,1,2,2,0,5
51891,110,14843,19481;19792;23002;23200,38690,2,0,2,0,4
51892,110,14846,19693;20097,38690,0,0,2,0,2
51893,110,14847,19732;20069;22713,38690,0,1,2,0,3
51894,110,14848,20587,38690,0,0,1,0,1
51895,110,14849,19559,38690,0,0,1,0,1
51896,110,14850,20247,38690,0,0,1,0,1
51897,110,14851,19571;19776;22702,38690,0,1,2,0,3
51898,110,14852,19891;20396,38690,0,0,2,0,2
51899,110,14854,20481;22826,38690,0,1,1,0,2
51900,110,14855,19984;20198;23231,38690,1,0,2,0,3
51901,110,14856,19994;20185,38690,0,0,2,0,2
51902,110,14857,19806;20004,38690,0,0,2,0,2
51903,110,14858,20009;20227;22386;23212,38690,1,1,2,0,4
51904,110,14859,19740;20044;23219,38690,1,0,2,0,3
51905,110,14860,19906;20085;22590;22817;23111;23322,38690,2,2,2,0,6
51906,110,14861,20051;20129,38690,0,0,2,0,2
51907,110,14862,20131;20635,38690,0,0,2,0,2
51908,110,14863,20158;20207,38690,0,0,2,0,2
51909,110,14864,19995;20231;23019,38690,1,0,2,0,3
51910,110,14865,20232;20948,38690,0,0,2,0,2
51911,110,14866,20286;20367,38690,0,0,2,0,2
51912,110,14867,20287;20339,38690,0,0,2,0,2
51913,110,14868,20324;20400,38690,0,0,2,0,2
51914,110,14869,20335;21015,38690,0,0,2,0,2
51915,110,14870,20348,38690,0,0,1,0,1
51916,110,14871,20364;20832,38690,0,0,2,0,2
51917,110,14872,20132;20412,38690,0,0,2,0,2
51918,110,14873,20417;20736,38690,0,0,2,0,2
51919,110,14874,20423,38690,0,0,1,0,1
51920,110,14875,20035;20354;23120;23331,38690,2,0,2,0,4
51921,110,14876,19939;20161,38690,0,0,2,0,2
51922,110,14877,20732,38690,0,0,1,0,1
51923,110,14878,20490,38690,0,0,1,0,1
51924,110,14879,20176;20499;22497,38690,0,1,2,0,3
51925,110,14880,20504;20739;23250,38690,1,0,2,0,3
51926,110,14881,20527;21003,38690,0,0,2,0,2
51927,110,14882,20682;22927,38690,1,0,1,0,2
51928,110,14883,20521;20579;23032,38690,1,0,2,0,3
51929,110,14884,20618;21008;23353,38690,1,0,2,0,3
51930,110,14885,20589;20621,38690,0,0,2,0,2
51931,110,14886,20628;20634,38690,0,0,2,0,2
51932,110,14887,20642;20929,38690,0,0,2,0,2
51933,110,14888,20667;21025,38690,0,0,2,0,2
51934,110,14889,20577;20688,38690,0,0,2,0,2
51935,110,14890,20717;20742;23034,38690,1,0,2,0,3
51936,110,14891,20397;20724,38690,0,0,2,0,2
51937,110,14892,20633;20740,38690,0,0,2,0,2
51938,110,14893,16276,39055,0,0,1,0,1
51939,110,14894,16680;16688,39055,0,0,2,0,2
51940,110,14895,16391,39055,0,0,1,0,1
51941,110,14896,16423,39055,0,0,1,0,1
51942,110,14897,16544;16554,39055,0,0,2,0,2
51943,110,14898,16366,39055,0,0,1,0,1
51944,110,14899,16805,39055,0,0,1,0,1
51945,110,14900,16592,39055,0,0,1,0,1
51946,110,14901,17004,39055,0,0,1,0,1
51947,110,14902,17043,39055,0,0,1,0,1
51948,110,14905,17518,39055,0,0,1,0,1
51949,110,14908,17409,39055,0,0,1,0,1
51950,110,14909,17800,39055,0,0,1,0,1
51951,110,14910,17759,39055,0,0,1,0,1
51952,110,14912,17792,39055,0,0,1,0,1
51953,110,14916,18402,39055,0,0,1,0,1
51954,110,14917,18182,39055,0,0,1,0,1
51955,110,14918,18448;19458;22474;22678,39055,0,2,2,0,4
51956,110,14919,18555,39055,0,0,1,0,1
51957,110,14920,18584,39055,0,0,1,0,1
51958,110,14923,18612,39055,0,0,1,0,1
51959,110,14924,18651,39055,0,0,1,0,1
51960,110,14927,18751;19170;22459,39055,0,1,2,0,3
51961,110,14928,18485,39055,0,0,1,0,1
51962,110,14929,18761,39055,0,0,1,0,1
51963,110,14930,19498,39055,0,0,1,0,1
51964,110,14931,19504;19932,39055,0,0,2,0,2
51965,110,14932,19526;19894,39055,0,0,2,0,2
51966,110,14933,19545;20233,39055,0,0,2,0,2
51967,110,14934,19540,39055,0,0,1,0,1
51968,110,14935,19588;20450,39055,0,0,2,0,2
51969,110,14936,19618;19686,39055,0,0,2,0,2
51970,110,14937,19669;19986,39055,0,0,2,0,2
51971,110,14938,19624;20259,39055,0,0,2,0,2
51972,110,14939,19687;19811;22997,39055,1,0,2,0,3
51973,110,14940,19716;19961,39055,0,0,2,0,2
51974,110,14941,19728;20209,39055,0,0,2,0,2
51975,110,14942,19731;19997;22911;23317,39055,2,0,2,0,4
51976,110,14943,19741,39055,0,0,1,0,1
51977,110,14944,19804,39055,0,0,1,0,1
51978,110,14945,19849;20022;22589,39055,0,1,2,0,3
51979,110,14946,19585;19916;22264;23313,39055,1,1,2,0,4
51980,110,14947,19926;20219;23114;23326,39055,2,0,2,0,4
51981,110,14948,20790,39055,0,0,1,0,1
51982,110,14949,19967;20038;22711,39055,0,1,2,0,3
51983,110,14950,19730;20039;23217,39055,1,0,2,0,3
51984,110,14951,20046;20062;22270,39055,0,1,2,0,3
51985,110,14952,20061;20142,39055,0,0,2,0,2
51986,110,14953,20080;20368;22719,39055,0,1,2,0,3
51987,110,14954,20183;20520;22498,39055,0,1,2,0,3
51988,110,14955,20216;20606,39055,0,0,2,0,2
51989,110,14956,20052;20224,39055,0,0,2,0,2
51990,110,14957,20240;20689,39055,0,0,2,0,2
51991,110,14958,20251;20513,39055,0,0,2,0,2
51992,110,14959,20320;20841,39055,0,0,2,0,2
51993,110,14960,20636;20911,39055,0,0,2,0,2
51994,110,14961,20327;20893,39055,0,0,2,0,2
51995,110,14962,20167;20338;22598,39055,0,1,2,0,3
51996,110,14963,20322;20360;23118;23235,39055,2,0,2,0,4
51997,110,14964,20406;20814,39055,0,0,2,0,2
51998,110,14965,20169;20416,39055,0,0,2,0,2
51999,110,14966,20117;20453;22602;23126,39055,1,1,2,0,4
52000,110,14967,20252;20462;22825,39055,0,1,2,0,3
52001,110,14968,20464;20927,39055,0,0,2,0,2
52002,110,14969,20288;20477,39055,0,0,2,0,2
52003,110,14970,20493;20710,39055,0,0,2,0,2
52004,110,14971,20529;20538;23342,39055,1,0,2,0,3
52005,110,14972,20284;20540;22830,39055,0,1,2,0,3
52006,110,14973,20543;20829,39055,0,0,2,0,2
52007,110,14974,20557;20836;23037,39055,1,0,2,0,3
52008,110,14975,20566;20909,39055,0,0,2,0,2
52009,110,14976,20524;20575,39055,0,0,2,0,2
52010,110,14977,20661,39055,0,0,1,0,1
52011,110,14978,20615,39055,0,0,1,0,1
52012,110,14979,20562;20627,39055,0,0,2,0,2
52013,110,14980,20651;21155,39055,0,0,2,0,2
52014,110,14981,20668;20821,39055,0,0,2,0,2
52015,110,14982,20687;20937;23258,39055,1,0,2,0,3
52016,110,14983,20694;20765;22831;23137,39055,1,1,2,0,4
52017,110,14984,20720;20846;23254,39055,1,0,2,0,3
52018,110,14985,20491;20725,39055,0,0,2,0,2
52019,110,14986,20746;20892,39055,0,0,2,0,2
52020,110,14987,20616;20778,39055,0,0,2,0,2
52021,110,14988,20783;20980,39055,0,0,2,0,2
52022,110,14989,20590;20792,39055,0,0,2,0,2
52023,110,14990,20519;20810;23241,39055,1,0,2,0,3
52024,110,14991,20827;21122,39055,0,0,2,0,2
52025,110,14992,15714,39420,0,0,0,1,1
52026,110,14993,16355,39420,0,0,1,0,1
52027,110,14994,16378,39420,0,0,1,0,1
52028,110,14995,16384,39420,0,0,1,0,1
52029,110,14996,16262,39420,0,0,1,0,1
52030,110,14998,16119,39420,0,0,1,0,1
52031,110,14999,16677,39420,0,0,1,0,1
52032,110,15001,16067,39420,0,0,0,1,1
52033,110,15002,16285,39420,0,0,1,0,1
52034,110,15003,16809,39420,0,0,1,0,1
52035,110,15004,16291,39420,0,0,1,0,1
52036,110,15005,17054,39420,0,0,1,0,1
52037,110,15006,16978,39420,0,0,1,0,1
52038,110,15009,17325,39420,0,0,1,0,1
52039,110,15011,17185,39420,0,0,1,0,1
52040,110,15012,17773,39420,0,0,1,0,1
52041,110,15013,17850,39420,0,0,1,0,1
52042,110,15015,17638,39420,0,0,1,0,1
52043,110,15016,18124,39420,0,0,1,0,1
52044,110,15017,18301,39420,0,0,1,0,1
52045,110,15018,18389,39420,0,0,1,0,1
52046,110,15019,18547,39420,0,0,1,0,1
52047,110,15020,18663;18926;22629,39420,0,1,2,0,3
52048,110,15021,18679,39420,0,0,1,0,1
52049,110,15022,18482,39420,0,0,1,0,1
52050,110,15024,18700,39420,0,0,1,0,1
52051,110,15026,18803,39420,0,0,1,0,1
52052,110,15027,18641,39420,0,0,1,0,1
52053,110,15028,19063,39420,0,0,1,0,1
52054,110,15029,19380,39420,0,0,1,0,1
52055,110,15030,19215,39420,0,0,1,0,1
52056,110,15032,19470;19528,39420,0,0,2,0,2
52057,110,15033,19490,39420,0,0,1,0,1
52058,110,15034,19292,39420,0,0,1,0,1
52059,110,15035,19790;20130;22387,39420,0,1,2,0,3
52060,110,15036,19816,39420,0,0,1,0,1
52061,110,15037,19616;19901;23008,39420,1,0,2,0,3
52062,110,15038,19927;20387;22391,39420,0,1,2,0,3
52063,110,15039,19988;20299,39420,0,0,2,0,2
52064,110,15040,20048;20465;22496,39420,0,1,2,0,3
52065,110,15041,20073,39420,0,0,1,0,1
52066,110,15042,20144;20643;23348,39420,1,0,2,0,3
52067,110,15043,20165;20654,39420,0,0,2,0,2
52068,110,15044,20238;20602,39420,0,0,2,0,2
52069,110,15045,19842,39420,0,0,1,0,1
52070,110,15046,20271;20620,39420,0,0,2,0,2
52071,110,15047,20292;20874,39420,0,0,2,0,2
52072,110,15048,20151;20301;22593;23113,39420,1,1,2,0,4
52073,110,15049,19836,39420,0,0,1,0,1
52074,110,15050,20402;21041,39420,0,0,2,0,2
52075,110,15051,20407;20859,39420,0,0,2,0,2
52076,110,15052,20457,39420,0,0,1,0,1
52077,110,15053,20466,39420,0,0,1,0,1
52078,110,15054,20133;20467,39420,0,0,2,0,2
52079,110,15055,20471;22722,39420,0,1,1,0,2
52080,110,15056,19850;20474,39420,0,0,2,0,2
52081,110,15057,20435;20494;23027,39420,1,0,2,0,3
52082,110,15058,20050;20234;22389;23115,39420,1,1,2,0,4
52083,110,15059,20503;20683,39420,0,0,2,0,2
52084,110,15060,20173;20584,39420,0,0,2,0,2
52085,110,15061,20592;21166,39420,0,0,2,0,2
52086,110,15062,20343;20604,39420,0,0,2,0,2
52087,110,15063,20660;21028,39420,0,0,2,0,2
52088,110,15064,20611,39420,0,0,1,0,1
52089,110,15065,20610;20663,39420,0,0,2,0,2
52090,110,15066,20673;21036,39420,0,0,2,0,2
52091,110,15067,20313;20684,39420,0,0,2,0,2
52092,110,15068,20686;21102,39420,0,0,2,0,2
52093,110,15069,20697;20709,39420,0,0,2,0,2
52094,110,15070,20726;21184,39420,0,0,2,0,2
52095,110,15071,20622,39420,0,0,1,0,1
52096,110,15072,20753;21037,39420,0,0,2,0,2
52097,110,15073,20759;20934,39420,0,0,2,0,2
52098,110,15074,20798;21175,39420,0,0,2,0,2
52099,110,15075,20805;21241,39420,0,0,2,0,2
52100,110,15076,20813;21048,39420,0,0,2,0,2
52101,110,15077,20825;21017,39420,0,0,2,0,2
52102,110,15078,20863;20891,39420,0,0,2,0,2
52103,110,15079,20885;21170,39420,0,0,2,0,2
52104,110,15080,20886;21030,39420,0,0,2,0,2
52105,110,15081,20437;20912,39420,0,0,2,0,2
52106,110,15082,20915;21059,39420,0,0,2,0,2
52107,110,15083,20918;21297,39420,0,0,2,0,2
52108,110,15084,20586;20922;23351,39420,1,0,2,0,3
52109,110,15085,20865;20945,39420,0,0,2,0,2
52110,110,15086,16121,39785,0,0,1,0,1
52111,110,15087,16730,39785,0,0,1,0,1
52112,110,15088,16881,39785,0,0,1,0,1
52113,110,15089,16927,39785,0,0,1,0,1
52114,110,15091,16821,39785,0,0,1,0,1
52115,110,15093,16840,39785,0,0,1,0,1
52116,110,15094,17307,39785,0,0,1,0,1
52117,110,15095,16767,39785,0,0,1,0,1
52118,110,15097,17517,39785,0,0,1,0,1
52119,110,15098,17407,39785,0,0,1,0,1
52120,110,15099,17723,39785,0,0,1,0,1
52121,110,15100,17772,39785,0,0,1,0,1
52122,110,15101,17529,39785,0,0,1,0,1
52123,110,15102,17879,39785,0,0,1,0,1
52124,110,15103,17936,39785,0,0,1,0,1
52125,110,15104,17724,39785,0,0,1,0,1
52126,110,15106,18256,39785,0,0,1,0,1
52127,110,15107,17945;18130,39785,0,0,2,0,2
52128,110,15110,18618,39785,0,0,1,0,1
52129,110,15112,18768,39785,0,0,1,0,1
52130,110,15113,18808,39785,0,0,1,0,1
52131,110,15114,18397,39785,0,0,1,0,1
52132,110,15115,18994,39785,0,0,1,0,1
52133,110,15117,19018,39785,0,0,1,0,1
52134,110,15118,19320;19576;23291,39785,1,0,2,0,3
52135,110,15119,19345,39785,0,0,1,0,1
52136,110,15120,19137;19549,39785,0,0,2,0,2
52137,110,15121,19513,39785,0,0,1,0,1
52138,110,15122,19534,39785,0,0,1,0,1
52139,110,15124,19608;19719;22260,39785,0,1,2,0,3
52140,110,15125,19623;20108,39785,0,0,2,0,2
52141,110,15126,19381,39785,0,0,1,0,1
52142,110,15127,19697;20170;23324,39785,1,0,2,0,3
52143,110,15128,19703,39785,0,0,1,0,1
52144,110,15129,19707,39785,0,0,1,0,1
52145,110,15130,19629,39785,0,0,1,0,1
52146,110,15131,19755,39785,0,0,1,0,1
52147,110,15132,19880,39785,0,0,1,0,1
52148,110,15133,19919,39785,0,0,1,0,1
52149,110,15134,19931,39785,0,0,1,0,1
52150,110,15135,19941,39785,0,0,1,0,1
52151,110,15136,19951;20282,39785,0,0,2,0,2
52152,110,15137,20037;20279;23216,39785,1,0,2,0,3
52153,110,15138,20072;20239;23320,39785,1,0,2,0,3
52154,110,15139,20309,39785,0,0,1,0,1
52155,110,15140,20055,39785,0,0,1,0,1
52156,110,15141,20262;20559,39785,0,0,2,0,2
52157,110,15142,20265;20617,39785,0,0,2,0,2
52158,110,15143,20267,39785,0,0,1,0,1
52159,110,15144,20272;20953,39785,0,0,2,0,2
52160,110,15145,20276,39785,0,0,1,0,1
52161,110,15146,20256;20434,39785,0,0,2,0,2
52162,110,15147,20014;20285;23329,39785,1,0,2,0,3
52163,110,15148,20344;20363,39785,0,0,2,0,2
52164,110,15149,20378;20556;23242,39785,1,0,2,0,3
52165,110,15150,20066;20498,39785,0,0,2,0,2
52166,110,15151,20549;20708,39785,0,0,2,0,2
52167,110,15152,20532;20560;22923,39785,1,0,2,0,3
52168,110,15153,20638;20903,39785,0,0,2,0,2
52169,110,15154,20649;21298,39785,0,0,2,0,2
52170,110,15155,20657;21038,39785,0,0,2,0,2
52171,110,15156,20690,39785,0,0,1,0,1
52172,110,15157,20693;20734;23248,39785,1,0,2,0,3
52173,110,15158,20702;20946,39785,0,0,2,0,2
52174,110,15159,20718;20791;23246,39785,1,0,2,0,3
52175,110,15160,20788;23349,39785,1,0,1,0,2
52176,110,15161,20826,39785,0,0,1,0,1
52177,110,15162,20830;20850,39785,0,0,2,0,2
52178,110,15163,20860;21022,39785,0,0,2,0,2
52179,110,15164,20881;21253,39785,0,0,2,0,2
52180,110,15165,20887;21227,39785,0,0,2,0,2
52181,110,15166,20889;20989,39785,0,0,2,0,2
52182,110,15167,20890;21394,39785,0,0,2,0,2
52183,110,15168,20908;21031,39785,0,0,2,0,2
52184,110,15169,20938;21150,39785,0,0,2,0,2
52185,110,15170,20940;21414,39785,0,0,2,0,2
52186,110,15171,20624;20942,39785,0,0,2,0,2
52187,110,15172,20964;21380,39785,0,0,2,0,2
52188,110,15173,20965;21075,39785,0,0,2,0,2
52189,110,15174,21040;21259,39785,0,0,2,0,2
52190,110,15175,20431;21053,39785,0,0,2,0,2
52191,110,15176,21074;21313,39785,0,0,2,0,2
52192,110,15177,16478,40150,0,0,1,0,1
52193,110,15178,16585,40150,0,0,1,0,1
52194,110,15179,16234,40150,0,0,1,0,1
52195,110,15180,16654,40150,0,0,1,0,1
52196,110,15181,16694,40150,0,0,1,0,1
52197,110,15182,16341,40150,0,0,1,0,1
52198,110,15183,16950,40150,0,0,1,0,1
52199,110,15184,16459,40150,0,0,1,0,1
52200,110,15185,17457,40150,0,0,1,0,1
52201,110,15186,17458,40150,0,0,1,0,1
52202,110,15187,17619,40150,0,0,1,0,1
52203,110,15188,17725,40150,0,0,1,0,1
52204,110,15189,17833,40150,0,0,1,0,1
52205,110,15190,17935,40150,0,0,1,0,1
52206,110,15191,18201,40150,0,0,1,0,1
52207,110,15192,18398,40150,0,0,1,0,1
52208,110,15193,18557,40150,0,0,1,0,1
52209,110,15194,18500,40150,0,0,1,0,1
52210,110,15195,18691,40150,0,0,1,0,1
52211,110,15196,18949,40150,0,0,1,0,1
52212,110,15198,19250,40150,0,0,1,0,1
52213,110,15199,18789,40150,0,0,1,0,1
52214,110,15200,18932,40150,0,0,1,0,1
52215,110,15201,19334,40150,0,0,1,0,1
52216,110,15202,19356,40150,0,0,1,0,1
52217,110,15203,19370,40150,0,0,1,0,1
52218,110,15204,19418,40150,0,0,1,0,1
52219,110,15205,19296,40150,0,0,1,0,1
52220,110,15206,19410,40150,0,0,1,0,1
52221,110,15207,19107,40150,0,0,1,0,1
52222,110,15208,19655,40150,0,0,1,0,1
52223,110,15209,19671,40150,0,0,1,0,1
52224,110,15210,19775;19789;22701,40150,0,1,2,0,3
52225,110,15211,19386,40150,0,0,1,0,1
52226,110,15212,19987;20213;23325,40150,1,0,2,0,3
52227,110,15213,20034;20613,40150,0,0,2,0,2
52228,110,15214,19625;20065,40150,0,0,2,0,2
52229,110,15215,20084,40150,0,0,1,0,1
52230,110,15216,19956,40150,0,0,1,0,1
52231,110,15217,20178;20692,40150,0,0,2,0,2
52232,110,15218,20200,40150,0,0,1,0,1
52233,110,15219,19738;20230;23327,40150,1,0,2,0,3
52234,110,15220,20298;20598;23244;23346,40150,2,0,2,0,4
52235,110,15221,20325,40150,0,0,1,0,1
52236,110,15222,19983,40150,0,0,1,0,1
52237,110,15223,19947;20432,40150,0,0,2,0,2
52238,110,15224,20444;20930,40150,0,0,2,0,2
52239,110,15225,19870;20445,40150,0,0,2,0,2
52240,110,15226,20455,40150,0,0,1,0,1
52241,110,15227,20195,40150,0,0,1,0,1
52242,110,15228,20553;20838,40150,0,0,2,0,2
52243,110,15229,20563,40150,0,0,1,0,1
52244,110,15230,20572,40150,0,0,1,0,1
52245,110,15231,20280;20581,40150,0,0,2,0,2
52246,110,15232,20585;20626,40150,0,0,2,0,2
52247,110,15233,19746,40150,0,0,1,0,1
52248,110,15234,20674;20954,40150,0,0,2,0,2
52249,110,15235,20678;21068,40150,0,0,2,0,2
52250,110,15236,20476;20699;23134,40150,1,0,2,0,3
52251,110,15237,20723;21145,40150,0,0,2,0,2
52252,110,15238,20281;20727,40150,0,0,2,0,2
52253,110,15239,20488,40150,0,0,1,0,1
52254,110,15240,20738;20999,40150,0,0,2,0,2
52255,110,15241,20770;20888,40150,0,0,2,0,2
52256,110,15242,19969,40150,0,0,1,0,1
52257,110,15243,20801,40150,0,0,1,0,1
52258,110,15244,20546;20840;22930;23350,40150,2,0,2,0,4
52259,110,15245,20719;20856,40150,0,0,2,0,2
52260,110,15246,20879;21138,40150,0,0,2,0,2
52261,110,15247,20883;21060,40150,0,0,2,0,2
52262,110,15248,20894,40150,0,0,1,0,1
52263,110,15249,20773;20955,40150,0,0,2,0,2
52264,110,15250,20956;21359,40150,0,0,2,0,2
52265,110,15251,20760;20972,40150,0,0,2,0,2
52266,110,15252,20974,40150,0,0,1,0,1
52267,110,15253,20475;21004,40150,0,0,2,0,2
52268,110,15254,21007;21153;23355,40150,1,0,2,0,3
52269,110,15255,21000;21033,40150,0,0,2,0,2
52270,110,15256,20672;21034,40150,0,0,2,0,2
52271,110,15257,21011;21044,40150,0,0,2,0,2
52272,110,15258,21069;21250,40150,0,0,2,0,2
52273,110,15259,20443;21070,40150,0,0,2,0,2
52274,110,15260,21072;21123;23354,40150,1,0,2,0,3
52275,110,15261,21090;21293,40150,0,0,2,0,2
52276,110,15262,21110;21262,40150,0,0,2,0,2
52277,110,15263,20993;21137,40150,0,0,2,0,2
52278,110,15264,21142;21480,40150,0,1,1,0,2
52279,110,15265,21160;21173;23038,40150,1,0,2,0,3
52280,110,15266,21191;21493,40150,0,1,1,0,2
52281,120,4998,14730,3650,0,0,0,1,1
52282,120,5429,13665,5110,0,0,0,1,1
52283,120,5724,14445,6205,0,0,0,1,1
52284,120,6149,15338,8030,0,0,0,1,1
52285,120,6770,14352,10950,0,0,0,1,1
52286,120,6918,15489,11315,0,0,0,1,1
52287,120,7120,15197,12045,0,0,0,1,1
52288,120,7196,14193,12410,0,0,0,1,1
52289,120,7598,17058;17365,13870,0,0,1,1,2
52290,120,7704,17066;17126;17378;17578,14235,0,0,2,2,4
52291,120,7726,12728,14235,0,0,0,1,1
52292,120,7729,12697,14235,0,0,0,1,1
52293,120,7731,19822;19999;23416,14235,0,1,2,0,3
52294,120,7737,12374,14235,0,0,0,1,1
52295,120,7738,12729,14235,0,0,0,1,1
52296,120,7807,12276,14600,0,0,0,1,1
52297,120,7814,12323,14600,0,0,0,1,1
52298,120,7824,16715,14600,0,0,0,1,1
52299,120,7835,12311,14600,0,0,0,1,1
52300,120,7911,12870,14965,0,0,0,1,1
52301,120,7935,12946,14965,0,0,0,1,1
52302,120,8098,12405,15695,0,0,0,1,1
52303,120,8106,13365,15695,0,0,0,1,1
52304,120,8126,12383;12829,15695,0,0,0,2,2
52305,120,8130,12864,15695,0,0,0,1,1
52306,120,8135,13168,15695,0,0,0,1,1
52307,120,8137,13939;14030,15695,0,0,0,2,2
52308,120,8196,17189;17677,16060,0,0,1,1,2
52309,120,8199,12325,16060,0,0,0,1,1
52310,120,8204,13107,16060,0,0,0,1,1
52311,120,8209,12560,16060,0,0,0,1,1
52312,120,8211,12678,16060,0,0,0,1,1
52313,120,8212,13089,16060,0,0,0,1,1
52314,120,8217,18070;22051;22185;22290,16060,0,0,4,0,4
52315,120,8227,12830,16060,0,0,0,1,1
52316,120,8237,13391,16060,0,0,0,1,1
52317,120,8312,12490,16425,0,0,0,1,1
52318,120,8314,13286,16425,0,0,0,1,1
52319,120,8318,13104,16425,0,0,0,1,1
52320,120,8323,13037,16425,0,0,0,1,1
52321,120,8330,12519,16425,0,0,0,1,1
52322,120,8334,12885,16425,0,0,0,1,1
52323,120,8337,13181,16425,0,0,0,1,1
52324,120,8340,13096,16425,0,0,0,1,1
52325,120,8346,13377,16425,0,0,0,1,1
52326,120,8347,13137,16425,0,0,0,1,1
52327,120,8354,13335,16425,0,0,0,1,1
52328,120,8413,13287,16790,0,0,0,1,1
52329,120,8428,13204,16790,0,0,0,1,1
52330,120,8429,12846,16790,0,0,0,1,1
52331,120,8431,12293,16790,0,0,0,1,1
52332,120,8435,12827,16790,0,0,0,1,1
52333,120,8440,13194,16790,0,0,0,1,1
52334,120,8445,13610,16790,0,0,0,1,1
52335,120,8447,13159,16790,0,0,0,1,1
52336,120,8449,13163,16790,0,0,0,1,1
52337,120,8452,13240,16790,0,0,0,1,1
52338,120,8455,13577,16790,0,0,0,1,1
52339,120,8462,13439,16790,0,0,0,1,1
52340,120,8514,16466;16776;17100,17155,0,0,0,3,3
52341,120,8528,18548;22213,17155,0,0,2,0,2
52342,120,8537,13434,17155,0,0,0,1,1
52343,120,8540,13067,17155,0,0,0,1,1
52344,120,8552,13178,17155,0,0,0,1,1
52345,120,8553,13200,17155,0,0,0,1,1
52346,120,8554,13449,17155,0,0,0,1,1
52347,120,8565,13098,17155,0,0,0,1,1
52348,120,8571,13492,17155,0,0,0,1,1
52349,120,8572,13779,17155,0,0,0,1,1
52350,120,8575,12795,17155,0,0,0,1,1
52351,120,8577,13909,17155,0,0,0,1,1
52352,120,8578,13390,17155,0,0,0,1,1
52353,120,8579,13655;13782,17155,0,0,0,2,2
52354,120,8626,12828,17520,0,0,0,1,1
52355,120,8636,13422;13455,17520,0,0,0,2,2
52356,120,8644,13415,17520,0,0,0,1,1
52357,120,8649,13100,17520,0,0,0,1,1
52358,120,8654,13233;13378,17520,0,0,0,2,2
52359,120,8655,13259,17520,0,0,0,1,1
52360,120,8664,19177;19271;23582,17520,0,1,2,0,3
52361,120,8668,14025,17520,0,0,0,1,1
52362,120,8673,13496,17520,0,0,0,1,1
52363,120,8675,13511,17520,0,0,0,1,1
52364,120,8677,13543,17520,0,0,0,1,1
52365,120,8679,13799,17520,0,0,0,1,1
52366,120,8681,13567,17520,0,0,0,1,1
52367,120,8684,13532,17520,0,0,0,1,1
52368,120,8685,13607,17520,0,0,0,1,1
52369,120,8687,18475;18508;22936,17520,0,1,2,0,3
52370,120,8688,13653;13792,17520,0,0,0,2,2
52371,120,8737,12934,17885,0,0,0,1,1
52372,120,8751,12901,17885,0,0,0,1,1
52373,120,8752,13280,17885,0,0,0,1,1
52374,120,8756,17685,17885,0,0,1,0,1
52375,120,8760,13214,17885,0,0,0,1,1
52376,120,8761,13219,17885,0,0,0,1,1
52377,120,8762,13157;13657,17885,0,0,0,2,2
52378,120,8763,13421,17885,0,0,0,1,1
52379,120,8764,13429,17885,0,0,0,1,1
52380,120,8768,13507,17885,0,0,0,1,1
52381,120,8772,13485,17885,0,0,0,1,1
52382,120,8775,14050,17885,0,0,0,1,1
52383,120,8781,13654,17885,0,0,0,1,1
52384,120,8783,13803,17885,0,0,0,1,1
52385,120,8784,14089,17885,0,0,0,1,1
52386,120,8785,14165,17885,0,0,0,1,1
52387,120,8787,13714,17885,0,0,0,1,1
52388,120,8792,14082,17885,0,0,0,1,1
52389,120,8794,14059,17885,0,0,0,1,1
52390,120,8843,12794,18250,0,0,0,1,1
52391,120,8855,13315,18250,0,0,0,1,1
52392,120,8857,13129,18250,0,0,0,1,1
52393,120,8859,13695,18250,0,0,0,1,1
52394,120,8861,13515,18250,0,0,0,1,1
52395,120,8863,13574,18250,0,0,0,1,1
52396,120,8867,14150,18250,0,0,0,1,1
52397,120,8870,13106;13590,18250,0,0,0,2,2
52398,120,8871,14064,18250,0,0,0,1,1
52399,120,8874,13339,18250,0,0,0,1,1
52400,120,8876,13304,18250,0,0,0,1,1
52401,120,8882,13448,18250,0,0,0,1,1
52402,120,8883,13631,18250,0,0,0,1,1
52403,120,8885,14280,18250,0,0,0,1,1
52404,120,8886,14190,18250,0,0,0,1,1
52405,120,8889,13755,18250,0,0,0,1,1
52406,120,8890,14065;14268,18250,0,0,0,2,2
52407,120,8891,14121,18250,0,0,0,1,1
52408,120,8900,13980,18250,0,0,0,1,1
52409,120,8904,14310,18250,0,0,0,1,1
52410,120,8906,13941,18250,0,0,0,1,1
52411,120,8908,13950,18250,0,0,0,1,1
52412,120,8955,17250,18615,0,0,0,1,1
52413,120,8967,13575,18615,0,0,0,1,1
52414,120,8971,13508,18615,0,0,0,1,1
52415,120,8972,14206,18615,0,0,0,1,1
52416,120,8974,13766,18615,0,0,0,1,1
52417,120,8975,12926,18615,0,0,0,1,1
52418,120,8979,13538,18615,0,0,0,1,1
52419,120,8984,13705,18615,0,0,0,1,1
52420,120,8985,13393,18615,0,0,0,1,1
52421,120,8988,13991,18615,0,0,0,1,1
52422,120,8989,13800;14155,18615,0,0,0,2,2
52423,120,8990,14285,18615,0,0,0,1,1
52424,120,8992,13727,18615,0,0,0,1,1
52425,120,8994,14368;14458,18615,0,0,0,2,2
52426,120,8996,14328,18615,0,0,0,1,1
52427,120,8997,14048,18615,0,0,0,1,1
52428,120,8998,14254,18615,0,0,0,1,1
52429,120,9000,14021,18615,0,0,0,1,1
52430,120,9001,14022,18615,0,0,0,1,1
52431,120,9002,14315,18615,0,0,0,1,1
52432,120,9003,14125,18615,0,0,0,1,1
52433,120,9004,14359,18615,0,0,0,1,1
52434,120,9005,14067,18615,0,0,0,1,1
52435,120,9008,14075,18615,0,0,0,1,1
52436,120,9009,13787,18615,0,0,0,1,1
52437,120,9062,13090,18980,0,0,0,1,1
52438,120,9069,13121,18980,0,0,0,1,1
52439,120,9071,13708,18980,0,0,0,1,1
52440,120,9072,13208,18980,0,0,0,1,1
52441,120,9083,13426,18980,0,0,0,1,1
52442,120,9085,14284,18980,0,0,0,1,1
52443,120,9087,13480,18980,0,0,0,1,1
52444,120,9089,14159,18980,0,0,0,1,1
52445,120,9090,14004,18980,0,0,0,1,1
52446,120,9093,13703,18980,0,0,0,1,1
52447,120,9096,14567,18980,0,0,0,1,1
52448,120,9098,13490,18980,0,0,0,1,1
52449,120,9103,14063,18980,0,0,0,1,1
52450,120,9104,13641,18980,0,0,0,1,1
52451,120,9105,14439,18980,0,0,0,1,1
52452,120,9109,13956,18980,0,0,0,1,1
52453,120,9112,13981,18980,0,0,0,1,1
52454,120,9113,14478,18980,0,0,0,1,1
52455,120,9114,14008,18980,0,0,0,1,1
52456,120,9115,14034,18980,0,0,0,1,1
52457,120,9116,14215,18980,0,0,0,1,1
52458,120,9120,14081;14496,18980,0,0,0,2,2
52459,120,9121,14102,18980,0,0,0,1,1
52460,120,9123,14590,18980,0,0,0,1,1
52461,120,9124,13837,18980,0,0,0,1,1
52462,120,9172,12896,19345,0,0,0,1,1
52463,120,9175,12954,19345,0,0,0,1,1
52464,120,9181,13831,19345,0,0,0,1,1
52465,120,9183,13193,19345,0,0,0,1,1
52466,120,9186,13477,19345,0,0,0,1,1
52467,120,9189,13325,19345,0,0,0,1,1
52468,120,9192,14231,19345,0,0,0,1,1
52469,120,9196,14168,19345,0,0,0,1,1
52470,120,9199,14316,19345,0,0,0,1,1
52471,120,9200,13699,19345,0,0,0,1,1
52472,120,9203,13791,19345,0,0,0,1,1
52473,120,9205,14107,19345,0,0,0,1,1
52474,120,9210,13809,19345,0,0,0,1,1
52475,120,9211,14056,19345,0,0,0,1,1
52476,120,9214,14526;14580,19345,0,0,0,2,2
52477,120,9215,14370,19345,0,0,0,1,1
52478,120,9216,13966,19345,0,0,0,1,1
52479,120,9218,14411,19345,0,0,0,1,1
52480,120,9219,13754,19345,0,0,0,1,1
52481,120,9220,17629;17743;17782;17832;21557;24397,19345,1,0,5,0,6
52482,120,9221,13972,19345,0,0,0,1,1
52483,120,9223,14499,19345,0,0,0,1,1
52484,120,9225,14672;14789;17461,19345,0,0,1,2,3
52485,120,9227,14413;19000,19345,0,0,1,1,2
52486,120,9230,13585;14134,19345,0,0,0,2,2
52487,120,9231,14140,19345,0,0,0,1,1
52488,120,9233,14464,19345,0,0,0,1,1
52489,120,9234,14715,19345,0,0,0,1,1
52490,120,9237,14270,19345,0,0,0,1,1
52491,120,9238,14296,19345,0,0,0,1,1
52492,120,9240,14287,19345,0,0,0,1,1
52493,120,9241,14305,19345,0,0,0,1,1
52494,120,9242,14675,19345,0,0,0,1,1
52495,120,9243,14615;18504,19345,0,0,1,1,2
52496,120,9281,13513,19710,0,0,0,1,1
52497,120,9282,13494,19710,0,0,0,1,1
52498,120,9286,13399,19710,0,0,0,1,1
52499,120,9295,13757,19710,0,0,0,1,1
52500,120,9297,13675,19710,0,0,0,1,1
52501,120,9299,13566,19710,0,0,0,1,1
52502,120,9300,13499,19710,0,0,0,1,1
52503,120,9301,14135,19710,0,0,0,1,1
52504,120,9302,14073,19710,0,0,0,1,1
52505,120,9303,13855;13933,19710,0,0,0,2,2
52506,120,9304,14366,19710,0,0,0,1,1
52507,120,9306,14224,19710,0,0,0,1,1
52508,120,9307,14927,19710,0,0,0,1,1
52509,120,9309,13770;13990,19710,0,0,0,2,2
52510,120,9310,14417,19710,0,0,0,1,1
52511,120,9311,14311,19710,0,0,0,1,1
52512,120,9312,14437,19710,0,0,0,1,1
52513,120,9316,18737;22225,19710,0,0,2,0,2
52514,120,9318,14584,19710,0,0,0,1,1
52515,120,9319,14151,19710,0,0,0,1,1
52516,120,9320,14866,19710,0,0,0,1,1
52517,120,9322,14331,19710,0,0,0,1,1
52518,120,9325,14333,19710,0,0,0,1,1
52519,120,9326,14363,19710,0,0,0,1,1
52520,120,9329,14398,19710,0,0,0,1,1
52521,120,9332,14821,19710,0,0,0,1,1
52522,120,9333,14897,19710,0,0,0,1,1
52523,120,9334,14457,19710,0,0,0,1,1
52524,120,9337,14503,19710,0,0,0,1,1
52525,120,9339,14514,19710,0,0,0,1,1
52526,120,9340,14522,19710,0,0,0,1,1
52527,120,9382,12894,20075,0,0,0,1,1
52528,120,9396,13932;14042,20075,0,0,0,2,2
52529,120,9397,13460,20075,0,0,0,1,1
52530,120,9399,14194,20075,0,0,0,1,1
52531,120,9403,14013,20075,0,0,0,1,1
52532,120,9411,14281,20075,0,0,0,1,1
52533,120,9412,13948,20075,0,0,0,1,1
52534,120,9418,14853;14891,20075,0,0,0,2,2
52535,120,9419,14060;14198,20075,0,0,0,2,2
52536,120,9421,14427,20075,0,0,0,1,1
52537,120,9423,14741,20075,0,0,0,1,1
52538,120,9424,14104,20075,0,0,0,1,1
52539,120,9425,14516,20075,0,0,0,1,1
52540,120,9426,14505;14805,20075,0,0,0,2,2
52541,120,9430,14202,20075,0,0,0,1,1
52542,120,9431,14220,20075,0,0,0,1,1
52543,120,9432,14058,20075,0,0,0,1,1
52544,120,9433,14196,20075,0,0,0,1,1
52545,120,9435,14551;14824,20075,0,0,0,2,2
52546,120,9436,14408,20075,0,0,0,1,1
52547,120,9438,13873,20075,0,0,0,1,1
52548,120,9439,14454,20075,0,0,0,1,1
52549,120,9440,14482,20075,0,0,0,1,1
52550,120,9442,15063,20075,0,0,0,1,1
52551,120,9443,14480,20075,0,0,0,1,1
52552,120,9446,14854,20075,0,0,0,1,1
52553,120,9447,14684,20075,0,0,0,1,1
52554,120,9448,14573,20075,0,0,0,1,1
52555,120,9451,14426,20075,0,0,0,1,1
52556,120,9452,14612,20075,0,0,0,1,1
52557,120,9453,14724,20075,0,0,0,1,1
52558,120,9455,14623,20075,0,0,0,1,1
52559,120,9456,15027,20075,0,0,0,1,1
52560,120,9458,14643,20075,0,0,0,1,1
52561,120,9459,14817;15086,20075,0,0,0,2,2
52562,120,9509,13936;13947,20440,0,0,0,2,2
52563,120,9510,13694,20440,0,0,0,1,1
52564,120,9511,13545,20440,0,0,0,1,1
52565,120,9513,14297,20440,0,0,0,1,1
52566,120,9516,14390,20440,0,0,0,1,1
52567,120,9518,13717,20440,0,0,0,1,1
52568,120,9521,13851;14298,20440,0,0,0,2,2
52569,120,9522,14114,20440,0,0,0,1,1
52570,120,9523,13977,20440,0,0,0,1,1
52571,120,9526,13783,20440,0,0,0,1,1
52572,120,9529,14184,20440,0,0,0,1,1
52573,120,9530,14513;17643,20440,0,0,1,1,2
52574,120,9531,14120,20440,0,0,0,1,1
52575,120,9532,14117,20440,0,0,0,1,1
52576,120,9533,14162;14646,20440,0,0,0,2,2
52577,120,9534,13404;14163;18240,20440,0,0,1,2,3
52578,120,9535,14175,20440,0,0,0,1,1
52579,120,9537,14232,20440,0,0,0,1,1
52580,120,9540,14278;14902,20440,0,0,0,2,2
52581,120,9541,14424,20440,0,0,0,1,1
52582,120,9545,14256,20440,0,0,0,1,1
52583,120,9546,14376,20440,0,0,0,1,1
52584,120,9547,13841;14451,20440,0,0,0,2,2
52585,120,9548,14657;14877,20440,0,0,0,2,2
52586,120,9550,14958,20440,0,0,0,1,1
52587,120,9556,14501,20440,0,0,0,1,1
52588,120,9559,14535;14838,20440,0,0,0,2,2
52589,120,9560,15215,20440,0,0,0,1,1
52590,120,9562,14661,20440,0,0,0,1,1
52591,120,9563,13870,20440,0,0,0,1,1
52592,120,9564,14601,20440,0,0,0,1,1
52593,120,9565,14600,20440,0,0,0,1,1
52594,120,9568,14640,20440,0,0,0,1,1
52595,120,9571,14571,20440,0,0,0,1,1
52596,120,9572,14945,20440,0,0,0,1,1
52597,120,9573,14869,20440,0,0,0,1,1
52598,120,9574,14830;15154,20440,0,0,0,2,2
52599,120,9575,15078,20440,0,0,0,1,1
52600,120,9576,14843,20440,0,0,0,1,1
52601,120,9577,14560,20440,0,0,0,1,1
52602,120,9622,13017,20805,0,0,0,1,1
52603,120,9625,14265,20805,0,0,0,1,1
52604,120,9628,13504,20805,0,0,0,1,1
52605,120,9631,13632;13746,20805,0,0,0,2,2
52606,120,9638,14425,20805,0,0,0,1,1
52607,120,9639,13806,20805,0,0,0,1,1
52608,120,9641,14520,20805,0,0,0,1,1
52609,120,9642,13993,20805,0,0,0,1,1
52610,120,9643,15025,20805,0,0,0,1,1
52611,120,9645,14570,20805,0,0,0,1,1
52612,120,9648,14604,20805,0,0,0,1,1
52613,120,9651,14384,20805,0,0,0,1,1
52614,120,9653,14403,20805,0,0,0,1,1
52615,120,9654,14279;14443,20805,0,0,0,2,2
52616,120,9655,14420;15126,20805,0,0,0,2,2
52617,120,9656,14536,20805,0,0,0,1,1
52618,120,9658,14582,20805,0,0,0,1,1
52619,120,9659,14595,20805,0,0,0,1,1
52620,120,9661,14564,20805,0,0,0,1,1
52621,120,9662,14740,20805,0,0,0,1,1
52622,120,9663,14552;14658,20805,0,0,0,2,2
52623,120,9664,14674,20805,0,0,0,1,1
52624,120,9665,14825,20805,0,0,0,1,1
52625,120,9667,14706,20805,0,0,0,1,1
52626,120,9670,14835;15135;19251,20805,0,0,1,2,3
52627,120,9673,14786;15260,20805,0,0,0,2,2
52628,120,9675,15240,20805,0,0,0,1,1
52629,120,9676,14849;15187,20805,0,0,0,2,2
52630,120,9678,15176,20805,0,0,0,1,1
52631,120,9681,15364,20805,0,0,0,1,1
52632,120,9682,14633;15070,20805,0,0,0,2,2
52633,120,9684,14916,20805,0,0,0,1,1
52634,120,9685,14884;14917,20805,0,0,0,2,2
52635,120,9686,14924,20805,0,0,0,1,1
52636,120,9688,14986,20805,0,0,0,1,1
52637,120,9731,14397,21170,0,0,0,1,1
52638,120,9732,13647;13904,21170,0,0,0,2,2
52639,120,9733,13921,21170,0,0,0,1,1
52640,120,9735,13729,21170,0,0,0,1,1
52641,120,9736,14038;14197,21170,0,0,0,2,2
52642,120,9737,14208,21170,0,0,0,1,1
52643,120,9738,14372,21170,0,0,0,1,1
52644,120,9740,14103,21170,0,0,0,1,1
52645,120,9741,14138;14216,21170,0,0,0,2,2
52646,120,9742,14326,21170,0,0,0,1,1
52647,120,9743,14557,21170,0,0,0,1,1
52648,120,9744,14746;15004,21170,0,0,0,2,2
52649,120,9745,14227;15522,21170,0,0,0,2,2
52650,120,9746,14361,21170,0,0,0,1,1
52651,120,9747,14829,21170,0,0,0,1,1
52652,120,9750,14404,21170,0,0,0,1,1
52653,120,9751,14542,21170,0,0,0,1,1
52654,120,9753,14460,21170,0,0,0,1,1
52655,120,9754,14203;14486,21170,0,0,0,2,2
52656,120,9755,14848,21170,0,0,0,1,1
52657,120,9756,14861;14943,21170,0,0,0,2,2
52658,120,9757,14851;19311,21170,0,0,1,1,2
52659,120,9758,14160,21170,0,0,0,1,1
52660,120,9759,14549,21170,0,0,0,1,1
52661,120,9761,14447;14576,21170,0,0,0,2,2
52662,120,9762,14076,21170,0,0,0,1,1
52663,120,9763,14591;15072,21170,0,0,0,2,2
52664,120,9764,14837,21170,0,0,0,1,1
52665,120,9765,14703;15030,21170,0,0,0,2,2
52666,120,9766,14722,21170,0,0,0,1,1
52667,120,9767,14735;14922,21170,0,0,0,2,2
52668,120,9768,14751;14887,21170,0,0,0,2,2
52669,120,9770,14904,21170,0,0,0,1,1
52670,120,9771,14100,21170,0,0,0,1,1
52671,120,9772,14498;14802,21170,0,0,0,2,2
52672,120,9773,15601;15995,21170,0,0,0,2,2
52673,120,9774,15411;18747,21170,0,0,1,1,2
52674,120,9775,14852,21170,0,0,0,1,1
52675,120,9777,14895,21170,0,0,0,1,1
52676,120,9778,14915;15121,21170,0,0,0,2,2
52677,120,9779,14872,21170,0,0,0,1,1
52678,120,9780,14749;14936,21170,0,0,0,2,2
52679,120,9781,15289,21170,0,0,0,1,1
52680,120,9783,14976;15068,21170,0,0,0,2,2
52681,120,9784,14977,21170,0,0,0,1,1
52682,120,9785,14980,21170,0,0,0,1,1
52683,120,9786,15047,21170,0,0,0,1,1
52684,120,9787,15011,21170,0,0,0,1,1
52685,120,9789,15636,21170,0,0,0,1,1
52686,120,9790,14923,21170,0,0,0,1,1
52687,120,9791,15066,21170,0,0,0,1,1
52688,120,9792,14382;14815,21170,0,0,0,2,2
52689,120,9793,14820,21170,0,0,0,1,1
52690,120,9794,15081,21170,0,0,0,1,1
52691,120,9795,15192,21170,0,0,0,1,1
52692,120,9824,12824,21535,0,0,0,1,1
52693,120,9828,13795,21535,0,0,0,1,1
52694,120,9829,17617,21535,0,0,1,0,1
52695,120,9830,13382,21535,0,0,0,1,1
52696,120,9841,13927;14200,21535,0,0,0,2,2
52697,120,9844,13775;13928,21535,0,0,0,2,2
52698,120,9847,14294;14587,21535,0,0,0,2,2
52699,120,9849,13982,21535,0,0,0,1,1
52700,120,9851,14054,21535,0,0,0,1,1
52701,120,9853,14736,21535,0,0,0,1,1
52702,120,9856,13789,21535,0,0,0,1,1
52703,120,9861,14334,21535,0,0,0,1,1
52704,120,9863,14354,21535,0,0,0,1,1
52705,120,9864,14369;14721,21535,0,0,0,2,2
52706,120,9865,14405,21535,0,0,0,1,1
52707,120,9866,14602,21535,0,0,0,1,1
52708,120,9869,14914,21535,0,0,0,1,1
52709,120,9872,14261,21535,0,0,0,1,1
52710,120,9873,14984,21535,0,0,0,1,1
52711,120,9875,15245,21535,0,0,0,1,1
52712,120,9877,14798,21535,0,0,0,1,1
52713,120,9878,14803;15071,21535,0,0,0,2,2
52714,120,9879,14882;15141,21535,0,0,0,2,2
52715,120,9880,15171,21535,0,0,0,1,1
52716,120,9881,14141;14879,21535,0,0,0,2,2
52717,120,9882,14920;15013,21535,0,0,0,2,2
52718,120,9883,15496;15506,21535,0,0,0,2,2
52719,120,9884,14972;15337,21535,0,0,0,2,2
52720,120,9885,14985,21535,0,0,0,1,1
52721,120,9887,15293,21535,0,0,0,1,1
52722,120,9888,15468,21535,0,0,0,1,1
52723,120,9889,15046;15481,21535,0,0,0,2,2
52724,120,9891,15520,21535,0,0,0,1,1
52725,120,9892,14448,21535,0,0,0,1,1
52726,120,9893,15209;15366,21535,0,0,0,2,2
52727,120,9894,15103;15435,21535,0,0,0,2,2
52728,120,9896,15125,21535,0,0,0,1,1
52729,120,9898,14729;15133,21535,0,0,0,2,2
52730,120,9901,15052,21535,0,0,0,1,1
52731,120,9902,15001,21535,0,0,0,1,1
52732,120,9904,15202,21535,0,0,0,1,1
52733,120,9943,13417,21900,0,0,0,1,1
52734,120,9948,14049,21900,0,0,0,1,1
52735,120,9950,13845,21900,0,0,0,1,1
52736,120,9961,14234,21900,0,0,0,1,1
52737,120,9963,15379,21900,0,0,0,1,1
52738,120,9964,14367,21900,0,0,0,1,1
52739,120,9966,14355,21900,0,0,0,1,1
52740,120,9967,14716,21900,0,0,0,1,1
52741,120,9968,14395,21900,0,0,0,1,1
52742,120,9973,14528,21900,0,0,0,1,1
52743,120,9974,14982,21900,0,0,0,1,1
52744,120,9975,15106,21900,0,0,0,1,1
52745,120,9976,14665,21900,0,0,0,1,1
52746,120,9978,14870,21900,0,0,0,1,1
52747,120,9980,14690,21900,0,0,0,1,1
52748,120,9982,14762,21900,0,0,0,1,1
52749,120,9986,14506,21900,0,0,0,1,1
52750,120,9987,15462;15474,21900,0,0,0,2,2
52751,120,9988,14905;15253,21900,0,0,0,2,2
52752,120,9990,15032;19415,21900,0,0,1,1,2
52753,120,9993,14933,21900,0,0,0,1,1
52754,120,9995,14978;15186,21900,0,0,0,2,2
52755,120,9996,14992,21900,0,0,0,1,1
52756,120,9999,15024;15244,21900,0,0,0,2,2
52757,120,10001,15688;15890,21900,0,0,0,2,2
52758,120,10002,14720;15116,21900,0,0,0,2,2
52759,120,10003,15128,21900,0,0,0,1,1
52760,120,10004,15110;15709,21900,0,0,0,2,2
52761,120,10008,15162,21900,0,0,0,1,1
52762,120,10009,15149;15408,21900,0,0,0,2,2
52763,120,10010,15181,21900,0,0,0,1,1
52764,120,10012,15217,21900,0,0,0,1,1
52765,120,10013,15220,21900,0,0,0,1,1
52766,120,10014,15261,21900,0,0,0,1,1
52767,120,10017,15719,21900,0,0,0,1,1
52768,120,10018,15358;15377,21900,0,0,0,2,2
52769,120,10019,15359;15512,21900,0,0,0,2,2
52770,120,10020,15361,21900,0,0,0,1,1
52771,120,10021,14608;15368,21900,0,0,0,2,2
52772,120,10023,15516,21900,0,0,0,1,1
52773,120,10024,15451,21900,0,0,0,1,1
52774,120,10049,13857,22265,0,0,0,1,1
52775,120,10055,14235,22265,0,0,0,1,1
52776,120,10059,13843,22265,0,0,0,1,1
52777,120,10060,14020,22265,0,0,0,1,1
52778,120,10062,14018,22265,0,0,0,1,1
52779,120,10063,14066,22265,0,0,0,1,1
52780,120,10065,13974,22265,0,0,0,1,1
52781,120,10066,15394,22265,0,0,0,1,1
52782,120,10068,14246,22265,0,0,0,1,1
52783,120,10072,14909,22265,0,0,0,1,1
52784,120,10073,14770,22265,0,0,0,1,1
52785,120,10076,14841,22265,0,0,0,1,1
52786,120,10077,15098,22265,0,0,0,1,1
52787,120,10081,15033,22265,0,0,0,1,1
52788,120,10082,14663;15650,22265,0,0,0,2,2
52789,120,10083,14699,22265,0,0,0,1,1
52790,120,10084,14890;14970,22265,0,0,0,2,2
52791,120,10087,14757,22265,0,0,0,1,1
52792,120,10088,14258;14422,22265,0,0,0,2,2
52793,120,10089,15250;15525,22265,0,0,0,2,2
52794,120,10090,15247,22265,0,0,0,1,1
52795,120,10094,14888,22265,0,0,0,1,1
52796,120,10095,14816;14907,22265,0,0,0,2,2
52797,120,10096,15413,22265,0,0,0,1,1
52798,120,10097,14963,22265,0,0,0,1,1
52799,120,10101,15029,22265,0,0,0,1,1
52800,120,10102,15131,22265,0,0,0,1,1
52801,120,10104,15012,22265,0,0,0,1,1
52802,120,10107,15095,22265,0,0,0,1,1
52803,120,10108,15182,22265,0,0,0,1,1
52804,120,10109,15188;15395,22265,0,0,0,2,2
52805,120,10110,15557,22265,0,0,0,1,1
52806,120,10111,15200;16031,22265,0,0,0,2,2
52807,120,10112,15203,22265,0,0,0,1,1
52808,120,10113,14191;15207,22265,0,0,0,2,2
52809,120,10114,15504;15806,22265,0,0,0,2,2
52810,120,10115,15228;15628,22265,0,0,0,2,2
52811,120,10116,15229;15495,22265,0,0,0,2,2
52812,120,10117,14940,22265,0,0,0,1,1
52813,120,10118,15237,22265,0,0,0,1,1
52814,120,10119,15239;15410,22265,0,0,0,2,2
52815,120,10121,15884,22265,0,0,0,1,1
52816,120,10122,15278,22265,0,0,0,1,1
52817,120,10123,15279;15751,22265,0,0,0,2,2
52818,120,10124,15682,22265,0,0,0,1,1
52819,120,10125,15457,22265,0,0,0,1,1
52820,120,10126,15698;15819,22265,0,0,0,2,2
52821,120,10127,15299,22265,0,0,0,1,1
52822,120,10128,15255;15327,22265,0,0,0,2,2
52823,120,10130,15347,22265,0,0,0,1,1
52824,120,10133,15641,22265,0,0,0,1,1
52825,120,10134,15407,22265,0,0,0,1,1
52826,120,10136,15414;15769,22265,0,0,0,2,2
52827,120,10137,15437;15598,22265,0,0,0,2,2
52828,120,10139,15454,22265,0,0,0,1,1
52829,120,10142,15482,22265,0,0,0,1,1
52830,120,10143,15498,22265,0,0,0,1,1
52831,120,10144,15556,22265,0,0,0,1,1
52832,120,10145,15657,22265,0,0,0,1,1
52833,120,10146,15416,22265,0,0,0,1,1
52834,120,10192,13997,22630,0,0,0,1,1
52835,120,10193,14452,22630,0,0,0,1,1
52836,120,10199,14187,22630,0,0,0,1,1
52837,120,10200,14479,22630,0,0,0,1,1
52838,120,10201,14491,22630,0,0,0,1,1
52839,120,10203,14859,22630,0,0,0,1,1
52840,120,10205,13960,22630,0,0,0,1,1
52841,120,10207,15061,22630,0,0,0,1,1
52842,120,10210,14449;14650,22630,0,0,0,2,2
52843,120,10211,14629,22630,0,0,0,1,1
52844,120,10212,14024;14659,22630,0,0,0,2,2
52845,120,10213,14681;15444,22630,0,0,0,2,2
52846,120,10215,15465,22630,0,0,0,1,1
52847,120,10216,14726,22630,0,0,0,1,1
52848,120,10219,14876,22630,0,0,0,1,1
52849,120,10220,13849,22630,0,0,0,1,1
52850,120,10221,15302,22630,0,0,0,1,1
52851,120,10223,14562;14833,22630,0,0,0,2,2
52852,120,10226,14948;15031,22630,0,0,0,2,2
52853,120,10227,15008,22630,0,0,0,1,1
52854,120,10228,15458,22630,0,0,0,1,1
52855,120,10229,15058;15544,22630,0,0,0,2,2
52856,120,10232,15180,22630,0,0,0,1,1
52857,120,10233,15201;15214,22630,0,0,0,2,2
52858,120,10234,14928;15213,22630,0,0,0,2,2
52859,120,10235,15300,22630,0,0,0,1,1
52860,120,10236,15317;15517,22630,0,0,0,2,2
52861,120,10237,14787;15319,22630,0,0,0,2,2
52862,120,10239,15329,22630,0,0,0,1,1
52863,120,10240,15902,22630,0,0,0,1,1
52864,120,10241,15067;15384,22630,0,0,0,2,2
52865,120,10243,15423,22630,0,0,0,1,1
52866,120,10244,15308;15448,22630,0,0,0,2,2
52867,120,10245,15453,22630,0,0,0,1,1
52868,120,10246,15713,22630,0,0,0,1,1
52869,120,10247,15463;15790,22630,0,0,0,2,2
52870,120,10249,15497,22630,0,0,0,1,1
52871,120,10251,15538,22630,0,0,0,1,1
52872,120,10252,15935,22630,0,0,0,1,1
52873,120,10255,15433;15569,22630,0,0,0,2,2
52874,120,10297,13630,22995,0,0,0,1,1
52875,120,10303,14046,22995,0,0,0,1,1
52876,120,10307,14199,22995,0,0,0,1,1
52877,120,10311,14767,22995,0,0,0,1,1
52878,120,10313,15042,22995,0,0,0,1,1
52879,120,10314,14846;15043,22995,0,0,0,2,2
52880,120,10315,14288,22995,0,0,0,1,1
52881,120,10318,14632,22995,0,0,0,1,1
52882,120,10319,14637,22995,0,0,0,1,1
52883,120,10320,14108;14638,22995,0,0,0,2,2
52884,120,10321,15374;15507,22995,0,0,0,2,2
52885,120,10322,13886,22995,0,0,0,1,1
52886,120,10323,14415,22995,0,0,0,1,1
52887,120,10324,18721;18953;22749;22949;23056,22995,0,3,2,0,5
52888,120,10325,14611;14961;18639;23047,22995,0,1,1,2,4
52889,120,10326,15754,22995,0,0,0,1,1
52890,120,10327,14842;15321,22995,0,0,0,2,2
52891,120,10328,15548,22995,0,0,0,1,1
52892,120,10329,15649;15734,22995,0,0,0,2,2
52893,120,10330,14867,22995,0,0,0,1,1
52894,120,10331,15196;15579,22995,0,0,0,2,2
52895,120,10333,15160;15223,22995,0,0,0,2,2
52896,120,10334,15340,22995,0,0,0,1,1
52897,120,10335,15895,22995,0,0,0,1,1
52898,120,10336,15281,22995,0,0,0,1,1
52899,120,10337,15322,22995,0,0,0,1,1
52900,120,10339,15918,22995,0,0,0,1,1
52901,120,10340,15356;15515,22995,0,0,0,2,2
52902,120,10341,15363,22995,0,0,0,1,1
52903,120,10342,15944,22995,0,0,0,1,1
52904,120,10343,15491;15887,22995,0,0,0,2,2
52905,120,10344,14714;15494,22995,0,0,0,2,2
52906,120,10345,15842,22995,0,0,0,1,1
52907,120,10348,15533;15829,22995,0,0,0,2,2
52908,120,10349,15638;15967,22995,0,0,0,2,2
52909,120,10350,15392;15541,22995,0,0,0,2,2
52910,120,10352,15562;15964,22995,0,0,0,2,2
52911,120,10353,15267,22995,0,0,0,1,1
52912,120,10354,15310;15588,22995,0,0,0,2,2
52913,120,10355,15611;15889,22995,0,0,0,2,2
52914,120,10356,15626,22995,0,0,0,1,1
52915,120,10357,15545;15629,22995,0,0,0,2,2
52916,120,10358,15645,22995,0,0,0,1,1
52917,120,10359,16155,22995,0,0,0,1,1
52918,120,10360,15530;16029,22995,0,0,0,2,2
52919,120,10361,15676,22995,0,0,0,1,1
52920,120,10362,16179,22995,0,0,0,1,1
52921,120,10363,15973,22995,0,0,0,1,1
52922,120,10364,15949;16020,22995,0,0,0,2,2
52923,120,10365,15959,22995,0,0,0,1,1
52924,120,10366,16076;16193;20898,22995,0,0,1,2,3
52925,120,10367,15758;16047,22995,0,0,0,2,2
52926,120,10369,15766;16041,22995,0,0,0,2,2
52927,120,10371,14995;15782,22995,0,0,0,2,2
52928,120,10372,15786,22995,0,0,0,1,1
52929,120,10374,15527,22995,0,0,0,1,1
52930,120,10410,13360,23360,0,0,0,1,1
52931,120,10412,13692,23360,0,0,0,1,1
52932,120,10418,14617,23360,0,0,0,1,1
52933,120,10420,14809,23360,0,0,0,1,1
52934,120,10421,14147,23360,0,0,0,1,1
52935,120,10423,18946;18993;22541,23360,0,0,3,0,3
52936,120,10424,14523,23360,0,0,0,1,1
52937,120,10428,14543,23360,0,0,0,1,1
52938,120,10429,14510;14541,23360,0,0,0,2,2
52939,120,10430,14810,23360,0,0,0,1,1
52940,120,10431,14780,23360,0,0,0,1,1
52941,120,10432,14304;14921,23360,0,0,0,2,2
52942,120,10433,14682,23360,0,0,0,1,1
52943,120,10434,14794,23360,0,0,0,1,1
52944,120,10437,14962,23360,0,0,0,1,1
52945,120,10439,15365;15476,23360,0,0,0,2,2
52946,120,10440,15921;15958,23360,0,0,0,2,2
52947,120,10441,15065;15421,23360,0,0,0,2,2
52948,120,10442,15112,23360,0,0,0,1,1
52949,120,10443,15403,23360,0,0,0,1,1
52950,120,10444,15119,23360,0,0,0,1,1
52951,120,10445,15130;15632,23360,0,0,0,2,2
52952,120,10446,15309,23360,0,0,0,1,1
52953,120,10447,15901;16061,23360,0,0,0,2,2
52954,120,10448,14929;15151,23360,0,0,0,2,2
52955,120,10450,15175,23360,0,0,0,1,1
52956,120,10452,15822;19203,23360,0,0,1,1,2
52957,120,10453,15443,23360,0,0,0,1,1
52958,120,10454,15919,23360,0,0,0,1,1
52959,120,10457,16708,23360,0,0,0,1,1
52960,120,10458,16008;16009,23360,0,0,0,2,2
52961,120,10460,14974;15439,23360,0,0,0,2,2
52962,120,10461,15177;15440,23360,0,0,0,2,2
52963,120,10462,15750,23360,0,0,0,1,1
52964,120,10463,15521,23360,0,0,0,1,1
52965,120,10464,15566,23360,0,0,0,1,1
52966,120,10466,15543;15580,23360,0,0,0,2,2
52967,120,10467,15583,23360,0,0,0,1,1
52968,120,10468,15589,23360,0,0,0,1,1
52969,120,10469,16043,23360,0,0,0,1,1
52970,120,10470,15606,23360,0,0,0,1,1
52971,120,10472,15692,23360,0,0,0,1,1
52972,120,10474,15697;16026,23360,0,0,0,2,2
52973,120,10475,15658,23360,0,0,0,1,1
52974,120,10476,15360;16053,23360,0,0,0,2,2
52975,120,10477,15675,23360,0,0,0,1,1
52976,120,10478,15513;15686,23360,0,0,0,2,2
52977,120,10479,15006;15718,23360,0,0,0,2,2
52978,120,10480,16134;16143,23360,0,0,0,2,2
52979,120,10482,15738,23360,0,0,0,1,1
52980,120,10483,15743,23360,0,0,0,1,1
52981,120,10484,15534,23360,0,0,0,1,1
52982,120,10485,15484;15784,23360,0,0,0,2,2
52983,120,10486,15984,23360,0,0,0,1,1
52984,120,10487,15848;16203,23360,0,0,0,2,2
52985,120,10488,15839;15968;20986;23757;24369,23360,1,1,1,2,5
52986,120,10490,15879,23360,0,0,0,1,1
52987,120,10491,15850,23360,0,0,0,1,1
52988,120,10493,15876,23360,0,0,0,1,1
52989,120,10494,16125,23360,0,0,0,1,1
52990,120,10495,15735,23360,0,0,0,1,1
52991,120,10496,15765;15925;20484,23360,0,0,1,2,3
52992,120,10531,13869,23725,0,0,0,1,1
52993,120,10534,14350,23725,0,0,0,1,1
52994,120,10536,14645,23725,0,0,0,1,1
52995,120,10541,14257,23725,0,0,0,1,1
52996,120,10546,14750,23725,0,0,0,1,1
52997,120,10548,14625;14667,23725,0,0,0,2,2
52998,120,10549,14814,23725,0,0,0,1,1
52999,120,10550,14899;15573,23725,0,0,0,2,2
53000,120,10551,15312;15757,23725,0,0,0,2,2
53001,120,10552,15464,23725,0,0,0,1,1
53002,120,10556,14620,23725,0,0,0,1,1
53003,120,10557,15238;16201,23725,0,0,0,2,2
53004,120,10558,15236,23725,0,0,0,1,1
53005,120,10559,14959;15604,23725,0,0,0,2,2
53006,120,10564,15417;16070,23725,0,0,0,2,2
53007,120,10565,15797,23725,0,0,0,1,1
53008,120,10566,16293;16371,23725,0,0,0,2,2
53009,120,10567,15726;16055,23725,0,0,0,2,2
53010,120,10568,15434,23725,0,0,0,1,1
53011,120,10570,16314,23725,0,0,0,1,1
53012,120,10571,16114,23725,0,0,0,1,1
53013,120,10572,15584,23725,0,0,0,1,1
53014,120,10574,15499;15666,23725,0,0,0,2,2
53015,120,10575,16003;16283,23725,0,0,0,2,2
53016,120,10576,15710,23725,0,0,0,1,1
53017,120,10577,15503;16131,23725,0,0,0,2,2
53018,120,10578,16092,23725,0,0,0,1,1
53019,120,10581,15900,23725,0,0,0,1,1
53020,120,10582,15561;15903,23725,0,0,0,2,2
53021,120,10583,18318;18409;18869;21793;22728;22744;22834;23041,23725,0,4,4,0,8
53022,120,10584,20002,23725,0,0,1,0,1
53023,120,10585,15695,23725,0,0,0,1,1
53024,120,10586,16229,23725,0,0,0,1,1
53025,120,10587,16006;16159,23725,0,0,0,2,2
53026,120,10588,16042,23725,0,0,0,1,1
53027,120,10638,14386,24090,0,0,0,1,1
53028,120,10642,14176;14739,24090,0,0,0,2,2
53029,120,10645,14797,24090,0,0,0,1,1
53030,120,10648,14774;14834,24090,0,0,0,2,2
53031,120,10649,14864,24090,0,0,0,1,1
53032,120,10650,15274,24090,0,0,0,1,1
53033,120,10651,14960;15036,24090,0,0,0,2,2
53034,120,10653,14744;14966,24090,0,0,0,2,2
53035,120,10655,15117;15143,24090,0,0,0,2,2
53036,120,10656,15721,24090,0,0,0,1,1
53037,120,10657,15163,24090,0,0,0,1,1
53038,120,10661,15231;15502,24090,0,0,0,2,2
53039,120,10662,14893;15233,24090,0,0,0,2,2
53040,120,10663,16065,24090,0,0,0,1,1
53041,120,10665,15620,24090,0,0,0,1,1
53042,120,10666,15892,24090,0,0,0,1,1
53043,120,10668,15827,24090,0,0,0,1,1
53044,120,10669,15724;16325,24090,0,0,0,2,2
53045,120,10671,15835;15961,24090,0,0,0,2,2
53046,120,10672,15815;16045,24090,0,0,0,2,2
53047,120,10673,15730,24090,0,0,0,1,1
53048,120,10675,14994,24090,0,0,0,1,1
53049,120,10676,15166;15616,24090,0,0,0,2,2
53050,120,10677,15627;16004,24090,0,0,0,2,2
53051,120,10679,16183,24090,0,0,0,1,1
53052,120,10680,15652;16128,24090,0,0,0,2,2
53053,120,10681,15661,24090,0,0,0,1,1
53054,120,10682,15733;15854,24090,0,0,0,2,2
53055,120,10683,15729;15999,24090,0,0,0,2,2
53056,120,10684,15559;15771,24090,0,0,0,2,2
53057,120,10685,15817,24090,0,0,0,1,1
53058,120,10686,15789;15970,24090,0,0,0,2,2
53059,120,10687,15511;16028,24090,0,0,0,2,2
53060,120,10688,15927;16071,24090,0,0,0,2,2
53061,120,10689,15532;15831,24090,0,0,0,2,2
53062,120,10690,15856;16171;20573;23956,24090,1,0,1,2,4
53063,120,10691,16021;20040,24090,0,0,1,1,2
53064,120,10692,16081;16226,24090,0,0,0,2,2
53065,120,10694,15352;16186,24090,0,0,0,2,2
53066,120,10695,16017;16278,24090,0,0,0,2,2
53067,120,10696,15997,24090,0,0,0,1,1
53068,120,10697,16405,24090,0,0,0,1,1
53069,120,10698,15940;16471,24090,0,0,0,2,2
53070,120,10699,16147;16176,24090,0,0,0,2,2
53071,120,10701,16023,24090,0,0,0,1,1
53072,120,10702,16030,24090,0,0,0,1,1
53073,120,10703,15704;16236,24090,0,0,0,2,2
53074,120,10704,15690;16227,24090,0,0,0,2,2
53075,120,10705,16438,24090,0,0,0,1,1
53076,120,10706,16195,24090,0,0,0,1,1
53077,120,10707,16058;16087,24090,0,0,0,2,2
53078,120,10708,16105,24090,0,0,0,1,1
53079,120,10709,19012;22757;22954;23058,24090,0,3,1,0,4
53080,120,10710,16122;16265,24090,0,0,0,2,2
53081,120,10711,16140,24090,0,0,0,1,1
53082,120,10712,16440,24090,0,0,0,1,1
53083,120,10736,14339,24455,0,0,0,1,1
53084,120,10745,14537,24455,0,0,0,1,1
53085,120,10749,15102;15326,24455,0,0,0,2,2
53086,120,10750,14806,24455,0,0,0,1,1
53087,120,10752,15015,24455,0,0,0,1,1
53088,120,10754,15567;15708,24455,0,0,0,2,2
53089,120,10755,15158,24455,0,0,0,1,1
53090,120,10756,15642,24455,0,0,0,1,1
53091,120,10758,15105;15425,24455,0,0,0,2,2
53092,120,10760,15333;15886,24455,0,0,0,2,2
53093,120,10761,18791;18844;22856;23053;23151,24455,0,3,2,0,5
53094,120,10762,15273,24455,0,0,0,1,1
53095,120,10763,14896;15292,24455,0,0,0,2,2
53096,120,10764,15581,24455,0,0,0,1,1
53097,120,10765,15398,24455,0,0,0,1,1
53098,120,10766,15419,24455,0,0,0,1,1
53099,120,10767,15270;15930,24455,0,0,0,2,2
53100,120,10768,15624;15915,24455,0,0,0,2,2
53101,120,10769,15097,24455,0,0,0,1,1
53102,120,10770,15673;15778,24455,0,0,0,2,2
53103,120,10771,16118,24455,0,0,0,1,1
53104,120,10772,15553,24455,0,0,0,1,1
53105,120,10773,16037,24455,0,0,0,1,1
53106,120,10774,15756;15931,24455,0,0,0,2,2
53107,120,10776,16330;16455,24455,0,0,0,2,2
53108,120,10777,16199;16706,24455,0,0,0,2,2
53109,120,10778,15791;16097,24455,0,0,0,2,2
53110,120,10779,15799;15838,24455,0,0,0,2,2
53111,120,10780,15241;16007,24455,0,0,0,2,2
53112,120,10783,16160,24455,0,0,0,1,1
53113,120,10784,15480;15928,24455,0,0,0,2,2
53114,120,10785,15950;16101,24455,0,0,0,2,2
53115,120,10786,16579,24455,0,0,0,1,1
53116,120,10787,15987;16049,24455,0,0,0,2,2
53117,120,10789,15922;16033,24455,0,0,0,2,2
53118,120,10790,16200;16307,24455,0,0,0,2,2
53119,120,10791,15429;16069,24455,0,0,0,2,2
53120,120,10792,16324;16637,24455,0,0,0,2,2
53121,120,10793,16412,24455,0,0,0,1,1
53122,120,10794,16164,24455,0,0,0,1,1
53123,120,10795,15956;16255,24455,0,0,0,2,2
53124,120,10796,15717;16221,24455,0,0,0,2,2
53125,120,10798,16281,24455,0,0,0,1,1
53126,120,10799,16254;16643,24455,0,0,0,2,2
53127,120,10800,16272,24455,0,0,0,1,1
53128,120,10828,13987,24820,0,0,0,1,1
53129,120,10835,14325,24820,0,0,0,1,1
53130,120,10838,15049,24820,0,0,0,1,1
53131,120,10844,13962;14635,24820,0,0,0,2,2
53132,120,10845,15586,24820,0,0,0,1,1
53133,120,10846,14692;15129,24820,0,0,0,2,2
53134,120,10847,14410,24820,0,0,0,1,1
53135,120,10848,15009,24820,0,0,0,1,1
53136,120,10849,14732,24820,0,0,0,1,1
53137,120,10850,14593,24820,0,0,0,1,1
53138,120,10854,14581,24820,0,0,0,1,1
53139,120,10858,15184,24820,0,0,0,1,1
53140,120,10859,15258,24820,0,0,0,1,1
53141,120,10860,15615;15820,24820,0,0,0,2,2
53142,120,10861,15469;16174,24820,0,0,0,2,2
53143,120,10862,14680,24820,0,0,0,1,1
53144,120,10863,14858;15343,24820,0,0,0,2,2
53145,120,10865,15108;15388,24820,0,0,0,2,2
53146,120,10866,15353;15483,24820,0,0,0,2,2
53147,120,10868,15993,24820,0,0,0,1,1
53148,120,10869,15540;15834,24820,0,0,0,2,2
53149,120,10870,15266;15424,24820,0,0,0,2,2
53150,120,10871,15836,24820,0,0,0,1,1
53151,120,10872,15983;16417,24820,0,0,0,2,2
53152,120,10874,16370,24820,0,0,0,1,1
53153,120,10875,15712;16095,24820,0,0,0,2,2
53154,120,10876,15805;16386,24820,0,0,0,2,2
53155,120,10878,16035;16107,24820,0,0,0,2,2
53156,120,10879,20060;23421;23520,24820,0,2,1,0,3
53157,120,10880,15807,24820,0,0,0,1,1
53158,120,10881,16244;16392,24820,0,0,0,2,2
53159,120,10882,15837;15843,24820,0,0,0,2,2
53160,120,10883,15846;16126,24820,0,0,0,2,2
53161,120,10884,16063;16181;20777,24820,0,0,1,2,3
53162,120,10885,15165;15891,24820,0,0,0,2,2
53163,120,10886,15929;16106,24820,0,0,0,2,2
53164,120,10887,15969,24820,0,0,0,1,1
53165,120,10889,16248,24820,0,0,0,1,1
53166,120,10890,15990;16109,24820,0,0,0,2,2
53167,120,10891,16320;16511,24820,0,0,0,2,2
53168,120,10892,16012,24820,0,0,0,1,1
53169,120,10893,16074;16286,24820,0,0,0,2,2
53170,120,10895,16117;16552,24820,0,0,0,2,2
53171,120,10896,15943;16145,24820,0,0,0,2,2
53172,120,10897,16151,24820,0,0,0,1,1
53173,120,10898,15823;16156,24820,0,0,0,2,2
53174,120,10899,16066;16196;19570,24820,0,0,1,2,3
53175,120,10900,16205;16754,24820,0,0,0,2,2
53176,120,10902,16277,24820,0,0,0,1,1
53177,120,10903,15992,24820,0,0,0,1,1
53178,120,10904,16246,24820,0,0,0,1,1
53179,120,10905,16383;16494,24820,0,0,0,2,2
53180,120,10906,16483;16836,24820,0,0,0,2,2
53181,120,10907,16345,24820,0,0,0,1,1
53182,120,10908,16880,24820,0,0,0,1,1
53183,120,10909,16048;16369,24820,0,0,0,2,2
53184,120,10910,15857;16373,24820,0,0,0,2,2
53185,120,10912,16409;16535,24820,0,0,0,2,2
53186,120,10913,16691;16739,24820,0,0,0,2,2
53187,120,10914,16344;16771,24820,0,0,0,2,2
53188,120,10915,15917;16467,24820,0,0,0,2,2
53189,120,10935,12984,25185,0,0,0,1,1
53190,120,10938,13856,25185,0,0,0,1,1
53191,120,10950,14627,25185,0,0,0,1,1
53192,120,10952,14785;14946,25185,0,0,0,2,2
53193,120,10956,14860,25185,0,0,0,1,1
53194,120,10957,14572;14636,25185,0,0,0,2,2
53195,120,10962,14868;15040,25185,0,0,0,2,2
53196,120,10965,15367,25185,0,0,0,1,1
53197,120,10966,14414,25185,0,0,0,1,1
53198,120,10968,15139,25185,0,0,0,1,1
53199,120,10970,15336,25185,0,0,0,1,1
53200,120,10971,15020;15344;19174,25185,0,0,1,2,3
53201,120,10973,15868,25185,0,0,0,1,1
53202,120,10974,15833;15870,25185,0,0,0,2,2
53203,120,10975,15813;16185,25185,0,0,0,2,2
53204,120,10976,15563;16177,25185,0,0,0,2,2
53205,120,10977,15877;16016,25185,0,0,0,2,2
53206,120,10978,15722;16032,25185,0,0,0,2,2
53207,120,10980,15871,25185,0,0,0,1,1
53208,120,10981,15560;15651,25185,0,0,0,2,2
53209,120,10983,16346,25185,0,0,0,1,1
53210,120,10984,16216,25185,0,0,0,1,1
53211,120,10985,15801;16013,25185,0,0,0,2,2
53212,120,10986,15965,25185,0,0,0,1,1
53213,120,10987,15865,25185,0,0,0,1,1
53214,120,10989,15955;16531,25185,0,0,0,2,2
53215,120,10990,14819;15045,25185,0,0,0,2,2
53216,120,10991,16014,25185,0,0,0,1,1
53217,120,10992,16136,25185,0,0,0,1,1
53218,120,10993,15971,25185,0,0,0,1,1
53219,120,10994,16027;16075,25185,0,0,0,2,2
53220,120,10995,15608;16059,25185,0,0,0,2,2
53221,120,10996,16413,25185,0,0,0,1,1
53222,120,10997,16692,25185,0,0,0,1,1
53223,120,10999,16091;16709,25185,0,0,0,2,2
53224,120,11000,16093,25185,0,0,0,1,1
53225,120,11001,16110,25185,0,0,0,1,1
53226,120,11002,15844,25185,0,0,0,1,1
53227,120,11004,15859;16627,25185,0,0,0,2,2
53228,120,11006,16421;16498,25185,0,0,0,2,2
53229,120,11007,16753,25185,0,0,0,1,1
53230,120,11009,16245,25185,0,0,0,1,1
53231,120,11010,15941;16263,25185,0,0,0,2,2
53232,120,11011,16269;16796,25185,0,0,0,2,2
53233,120,11012,16187,25185,0,0,0,1,1
53234,120,11013,16301,25185,0,0,0,1,1
53235,120,11014,16116;16772,25185,0,0,0,2,2
53236,120,11015,16318,25185,0,0,0,1,1
53237,120,11016,16336;16559,25185,0,0,0,2,2
53238,120,11017,16340,25185,0,0,0,1,1
53239,120,11018,16349;16841,25185,0,0,0,2,2
53240,120,11019,16504,25185,0,0,0,1,1
53241,120,11020,16259;16422,25185,0,0,0,2,2
53242,120,11021,16085;16485;19468;20910;23661;24071;24166,25185,2,1,2,2,7
53243,120,11022,16115;16428,25185,0,0,0,2,2
53244,120,11023,16432;16536,25185,0,0,0,2,2
53245,120,11024,16437,25185,0,0,0,1,1
53246,120,11025,16560,25185,0,0,0,1,1
53247,120,11026,15946;16377,25185,0,0,0,2,2
53248,120,11027,15818;16458,25185,0,0,0,2,2
53249,120,11028,16480;16625,25185,0,0,0,2,2
53250,120,11029,16745;16803,25185,0,0,0,2,2
53251,120,11031,16519,25185,0,0,0,1,1
53252,120,11032,16549,25185,0,0,0,1,1
53253,120,11033,16439;16553,25185,0,0,0,2,2
53254,120,11068,13520,25550,0,0,0,1,1
53255,120,11070,13896,25550,0,0,0,1,1
53256,120,11087,15728;15828,25550,0,0,0,2,2
53257,120,11091,15405,25550,0,0,0,1,1
53258,120,11093,15069,25550,0,0,0,1,1
53259,120,11094,15114,25550,0,0,0,1,1
53260,120,11095,15136;15324,25550,0,0,0,2,2
53261,120,11096,15150,25550,0,0,0,1,1
53262,120,11098,15232;15354,25550,0,0,0,2,2
53263,120,11099,15257,25550,0,0,0,1,1
53264,120,11101,15400;16150,25550,0,0,0,2,2
53265,120,11107,15989,25550,0,0,0,1,1
53266,120,11108,16178;16358,25550,0,0,0,2,2
53267,120,11109,16287,25550,0,0,0,1,1
53268,120,11110,16108,25550,0,0,0,1,1
53269,120,11112,15977,25550,0,0,0,1,1
53270,120,11114,15746;16096;19373,25550,0,0,1,2,3
53271,120,11116,15372;16474,25550,0,0,0,2,2
53272,120,11117,15988;16197,25550,0,0,0,2,2
53273,120,11119,16741;16767,25550,0,0,0,2,2
53274,120,11120,15740,25550,0,0,0,1,1
53275,120,11121,16169;16461,25550,0,0,0,2,2
53276,120,11123,16652,25550,0,0,0,1,1
53277,120,11124,15531;16204,25550,0,0,0,2,2
53278,120,11126,16129;16207,25550,0,0,0,2,2
53279,120,11127,16634,25550,0,0,0,1,1
53280,120,11128,15386;16170,25550,0,0,0,2,2
53281,120,11129,16252;17062,25550,0,0,0,2,2
53282,120,11130,16297;16610,25550,0,0,0,2,2
53283,120,11132,16294;16518,25550,0,0,0,2,2
53284,120,11133,16526;17063;20236,25550,0,0,1,2,3
53285,120,11134,16683;16786,25550,0,0,0,2,2
53286,120,11135,15849;16337,25550,0,0,0,2,2
53287,120,11136,15873;16339,25550,0,0,0,2,2
53288,120,11137,16343,25550,0,0,0,1,1
53289,120,11139,15524;16375,25550,0,0,0,2,2
53290,120,11140,19405;19652;20246;20845;22886;22931;23083;23683,25550,0,4,4,0,8
53291,120,11141,16822,25550,0,0,0,1,1
53292,120,11142,16456;16472,25550,0,0,0,2,2
53293,120,11143,16512;16722,25550,0,0,0,2,2
53294,120,11144,16612,25550,0,0,0,1,1
53295,120,11145,16537;16818,25550,0,0,0,2,2
53296,120,11146,16888;16913,25550,0,0,0,2,2
53297,120,11147,16424;16562,25550,0,0,0,2,2
53298,120,11148,16576;16782,25550,0,0,0,2,2
53299,120,11149,16584;20346,25550,0,0,1,1,2
53300,120,11150,16329;16603,25550,0,0,0,2,2
53301,120,11152,16616,25550,0,0,0,1,1
53302,120,11153,16936,25550,0,0,0,1,1
53303,120,11154,16389;16904,25550,0,0,0,2,2
53304,120,11155,16791,25550,0,0,0,1,1
53305,120,11156,16039;16650,25550,0,0,0,2,2
53306,120,11157,16727,25550,0,0,0,1,1
53307,120,11158,16673;17060,25550,0,0,0,2,2
53308,120,11159,16253;16675,25550,0,0,0,2,2
53309,120,11214,15153,25915,0,0,0,1,1
53310,120,11215,15168,25915,0,0,0,1,1
53311,120,11216,14988,25915,0,0,0,1,1
53312,120,11220,14839;15280,25915,0,0,0,2,2
53313,120,11223,14471;14900,25915,0,0,0,2,2
53314,120,11224,16139,25915,0,0,0,1,1
53315,120,11227,15436,25915,0,0,0,1,1
53316,120,11228,15755;16154,25915,0,0,0,2,2
53317,120,11230,16334;19898,25915,0,0,1,1,2
53318,120,11231,15375,25915,0,0,0,1,1
53319,120,11232,15706;15951,25915,0,0,0,2,2
53320,120,11233,15745;16175,25915,0,0,0,2,2
53321,120,11234,15881;16209,25915,0,0,0,2,2
53322,120,11235,15966;16284,25915,0,0,0,2,2
53323,120,11236,16266;16690,25915,0,0,0,2,2
53324,120,11237,16380,25915,0,0,0,1,1
53325,120,11238,16497,25915,0,0,0,1,1
53326,120,11239,15945;16214,25915,0,0,0,2,2
53327,120,11240,16144,25915,0,0,0,1,1
53328,120,11241,16157;16441,25915,0,0,0,2,2
53329,120,11242,16575;16593,25915,0,0,0,2,2
53330,120,11243,15753;16210,25915,0,0,0,2,2
53331,120,11245,16406,25915,0,0,0,1,1
53332,120,11246,16299,25915,0,0,0,1,1
53333,120,11247,16618;16779,25915,0,0,0,2,2
53334,120,11249,16561;16947,25915,0,0,0,2,2
53335,120,11250,16365,25915,0,0,0,1,1
53336,120,11251,15880;16442,25915,0,0,0,2,2
53337,120,11252,16705,25915,0,0,0,1,1
53338,120,11253,15906,25915,0,0,0,1,1
53339,120,11255,16469;16768,25915,0,0,0,2,2
53340,120,11257,16798;16840,25915,0,0,0,2,2
53341,120,11258,16941,25915,0,0,0,1,1
53342,120,11260,16462,25915,0,0,0,1,1
53343,120,11261,16508;16555,25915,0,0,0,2,2
53344,120,11262,16984,25915,0,0,0,1,1
53345,120,11263,16425;16564,25915,0,0,0,2,2
53346,120,11264,16609,25915,0,0,0,1,1
53347,120,11265,16617,25915,0,0,0,1,1
53348,120,11266,16832;17103,25915,0,0,0,2,2
53349,120,11267,16646;16785,25915,0,0,0,2,2
53350,120,11268,16342,25915,0,0,0,1,1
53351,120,11270,16661,25915,0,0,0,1,1
53352,120,11272,16719;16831,25915,0,0,0,2,2
53353,120,11273,16732;17129,25915,0,0,0,2,2
53354,120,11274,16733;16817,25915,0,0,0,2,2
53355,120,11275,16762,25915,0,0,0,1,1
53356,120,11276,17095,25915,0,0,0,1,1
53357,120,11277,16359;16770,25915,0,0,0,2,2
53358,120,11278,16703;16788,25915,0,0,0,2,2
53359,120,11279,16793;16869;20454,25915,0,0,1,2,3
53360,120,11280,17135,25915,0,0,0,1,1
53361,120,11281,16237;16806,25915,0,0,0,2,2
53362,120,11282,16556;16963,25915,0,0,0,2,2
53363,120,11307,13442,26280,0,0,0,1,1
53364,120,11309,14373,26280,0,0,0,1,1
53365,120,11310,13985;14303,26280,0,0,0,2,2
53366,120,11322,14910,26280,0,0,0,1,1
53367,120,11323,14832,26280,0,0,0,1,1
53368,120,11324,15111,26280,0,0,0,1,1
53369,120,11326,14688,26280,0,0,0,1,1
53370,120,11332,15330;15475,26280,0,0,0,2,2
53371,120,11334,15550;15727,26280,0,0,0,2,2
53372,120,11335,15552,26280,0,0,0,1,1
53373,120,11336,15582,26280,0,0,0,1,1
53374,120,11339,15546,26280,0,0,0,1,1
53375,120,11340,14509;14822,26280,0,0,0,2,2
53376,120,11341,16532;16541,26280,0,0,0,2,2
53377,120,11342,14874;15862,26280,0,0,0,2,2
53378,120,11343,15798,26280,0,0,0,1,1
53379,120,11344,15904,26280,0,0,0,1,1
53380,120,11346,16080;16641;20518;24233,26280,1,0,1,2,4
53381,120,11347,16019;16064,26280,0,0,0,2,2
53382,120,11348,16130;16404;19909,26280,0,0,1,2,3
53383,120,11349,16670,26280,0,0,0,1,1
53384,120,11350,16445;16819,26280,0,0,0,2,2
53385,120,11351,15991;16700,26280,0,0,0,2,2
53386,120,11352,16189;16194,26280,0,0,0,2,2
53387,120,11353,16681;16859,26280,0,0,0,2,2
53388,120,11354,16319,26280,0,0,0,1,1
53389,120,11355,16689,26280,0,0,0,1,1
53390,120,11356,16300,26280,0,0,0,1,1
53391,120,11357,16704;16833,26280,0,0,0,2,2
53392,120,11359,16192;16332,26280,0,0,0,2,2
53393,120,11360,16735;16811,26280,0,0,0,2,2
53394,120,11361,15994;16364,26280,0,0,0,2,2
53395,120,11362,16635;16891,26280,0,0,0,2,2
53396,120,11363,16158;16390,26280,0,0,0,2,2
53397,120,11364,16103;16399,26280,0,0,0,2,2
53398,120,11366,15679;16403,26280,0,0,0,2,2
53399,120,11367,16903;19509,26280,0,0,1,1,2
53400,120,11368,16539;16573,26280,0,0,0,2,2
53401,120,11369,16510;16630,26280,0,0,0,2,2
53402,120,11370,16514,26280,0,0,0,1,1
53403,120,11371,16877;17003;21423,26280,0,0,1,2,3
53404,120,11372,16306;16563,26280,0,0,0,2,2
53405,120,11373,16569,26280,0,0,0,1,1
53406,120,11375,16669;16917,26280,0,0,0,2,2
53407,120,11376,16523;16665,26280,0,0,0,2,2
53408,120,11377,16912,26280,0,0,0,1,1
53409,120,11378,16452;16940;20289,26280,0,0,1,2,3
53410,120,11379,16698;16897,26280,0,0,0,2,2
53411,120,11380,17306,26280,0,0,1,0,1
53412,120,11381,16270;17025,26280,0,0,0,2,2
53413,120,11382,16672;17122,26280,0,0,0,2,2
53414,120,11383,16794,26280,0,0,0,1,1
53415,120,11385,16477;16828,26280,0,0,0,2,2
53416,120,11386,17266;21341,26280,0,0,1,1,2
53417,120,11387,16874;17144,26280,0,0,0,2,2
53418,120,11388,17001;17180,26280,0,0,0,2,2
53419,120,11389,16491;16905,26280,0,0,0,2,2
53420,120,11390,16496;16909,26280,0,0,0,2,2
53421,120,11391,16631;17154,26280,0,0,0,2,2
53422,120,11392,16645;17292,26280,0,0,1,1,2
53423,120,11393,16918;17077,26280,0,0,0,2,2
53424,120,11394,16231;16919,26280,0,0,0,2,2
53425,120,11426,14343,26645,0,0,0,1,1
53426,120,11429,14547;14698,26645,0,0,0,2,2
53427,120,11436,15391,26645,0,0,0,1,1
53428,120,11439,15382,26645,0,0,0,1,1
53429,120,11441,15551,26645,0,0,0,1,1
53430,120,11444,16427,26645,0,0,0,1,1
53431,120,11445,15684;15773,26645,0,0,0,2,2
53432,120,11446,15763,26645,0,0,0,1,1
53433,120,11448,15788,26645,0,0,0,1,1
53434,120,11449,15920;16198,26645,0,0,0,2,2
53435,120,11450,15737;15953,26645,0,0,0,2,2
53436,120,11451,15288,26645,0,0,0,1,1
53437,120,11452,16111;16712,26645,0,0,0,2,2
53438,120,11453,16487;16521,26645,0,0,0,2,2
53439,120,11454,16138;16191,26645,0,0,0,2,2
53440,120,11455,16242;16450,26645,0,0,0,2,2
53441,120,11456,16275;16448,26645,0,0,0,2,2
53442,120,11457,16088;16333,26645,0,0,0,2,2
53443,120,11458,16420,26645,0,0,0,1,1
53444,120,11459,16099;16338,26645,0,0,0,2,2
53445,120,11460,16942;16974,26645,0,0,0,2,2
53446,120,11461,16678;16816,26645,0,0,0,2,2
53447,120,11462,16736;16789,26645,0,0,0,2,2
53448,120,11463,16381;17134,26645,0,0,0,2,2
53449,120,11464,15974;16382,26645,0,0,0,2,2
53450,120,11465,16024;16356,26645,0,0,0,2,2
53451,120,11466,17178;17220,26645,0,0,0,2,2
53452,120,11467,16315;16447;20565,26645,0,0,1,2,3
53453,120,11468,16674,26645,0,0,0,1,1
53454,120,11469,15858;16509,26645,0,0,0,2,2
53455,120,11470,16173;16538,26645,0,0,0,2,2
53456,120,11472,16551,26645,0,0,0,1,1
53457,120,11473,16492;16588,26645,0,0,0,2,2
53458,120,11474,16167;16202,26645,0,0,0,2,2
53459,120,11476,16971,26645,0,0,0,1,1
53460,120,11477,16546;16671,26645,0,0,0,2,2
53461,120,11479,16132;16684,26645,0,0,0,2,2
53462,120,11480,16699,26645,0,0,0,1,1
53463,120,11482,16714,26645,0,0,0,1,1
53464,120,11483,17101,26645,0,0,0,1,1
53465,120,11484,17168,26645,0,0,0,1,1
53466,120,11485,16734,26645,0,0,0,1,1
53467,120,11486,16568,26645,0,0,0,1,1
53468,120,11487,16693;16716,26645,0,0,0,2,2
53469,120,11488,16765;16953,26645,0,0,0,2,2
53470,120,11490,16908,26645,0,0,0,1,1
53471,120,11491,17051,26645,0,0,0,1,1
53472,120,11492,16825;20018,26645,0,0,1,1,2
53473,120,11493,16208;16830,26645,0,0,0,2,2
53474,120,11494,16842;17187,26645,0,0,0,2,2
53475,120,11495,16809;16851;21200,26645,0,0,1,2,3
53476,120,11496,16926,26645,0,0,0,1,1
53477,120,11497,16725;17014,26645,0,0,0,2,2
53478,120,11498,16835;16876,26645,0,0,0,2,2
53479,120,11499,16889;17106,26645,0,0,0,2,2
53480,120,11500,16490;16907,26645,0,0,0,2,2
53481,120,11501,17117,26645,0,0,0,1,1
53482,120,11502,17177,26645,0,0,0,1,1
53483,120,11504,16962;17221;20712;23135,26645,0,1,1,2,4
53484,120,11505,16968;17068,26645,0,0,0,2,2
53485,120,11506,17128,26645,0,0,0,1,1
53486,120,11507,16758;16992;20539;21974;24305,26645,1,0,2,2,5
53487,120,11509,16906;17227,26645,0,0,0,2,2
53488,120,11510,17019;17127,26645,0,0,0,2,2
53489,120,11511,17155,26645,0,0,0,1,1
53490,120,11512,16916;17029,26645,0,0,0,2,2
53491,120,11545,13742,27010,0,0,0,1,1
53492,120,11549,14634;15297,27010,0,0,0,2,2
53493,120,11550,14950,27010,0,0,0,1,1
53494,120,11552,15100,27010,0,0,0,1,1
53495,120,11554,15373;15603,27010,0,0,0,2,2
53496,120,11555,15760,27010,0,0,0,1,1
53497,120,11556,15428;15528,27010,0,0,0,2,2
53498,120,11558,15529;15942,27010,0,0,0,2,2
53499,120,11562,15074,27010,0,0,0,1,1
53500,120,11563,15668;15803,27010,0,0,0,2,2
53501,120,11565,15780;15852,27010,0,0,0,2,2
53502,120,11566,16038,27010,0,0,0,1,1
53503,120,11567,15500,27010,0,0,0,1,1
53504,120,11568,16000,27010,0,0,0,1,1
53505,120,11570,15923,27010,0,0,0,1,1
53506,120,11571,16372,27010,0,0,0,1,1
53507,120,11572,16267,27010,0,0,0,1,1
53508,120,11573,15409;15599,27010,0,0,0,2,2
53509,120,11575,16230;16597,27010,0,0,0,2,2
53510,120,11576,16172;16686,27010,0,0,0,2,2
53511,120,11577,16606;16774,27010,0,0,0,2,2
53512,120,11578,16368,27010,0,0,0,1,1
53513,120,11581,16513,27010,0,0,0,1,1
53514,120,11583,16446;16866,27010,0,0,0,2,2
53515,120,11584,16218;16594,27010,0,0,0,2,2
53516,120,11585,16533;16578,27010,0,0,0,2,2
53517,120,11586,16799;16857;19617,27010,0,0,1,2,3
53518,120,11587,16602;16883,27010,0,0,0,2,2
53519,120,11588,15909;16638,27010,0,0,0,2,2
53520,120,11590,16862;20303;21032,27010,0,0,2,1,3
53521,120,11591,16249;16921,27010,0,0,0,2,2
53522,120,11592,17028,27010,0,0,0,1,1
53523,120,11593,16820;16988,27010,0,0,0,2,2
53524,120,11594,16737,27010,0,0,0,1,1
53525,120,11595,16846;20766,27010,0,0,1,1,2
53526,120,11596,17045,27010,0,0,0,1,1
53527,120,11597,16901;17393,27010,0,0,1,1,2
53528,120,11598,17064,27010,0,0,0,1,1
53529,120,11599,17229;17327,27010,0,0,1,1,2
53530,120,11601,16697;17253,27010,0,0,0,2,2
53531,120,11602,16756;16954,27010,0,0,0,2,2
53532,120,11603,16878;17196,27010,0,0,0,2,2
53533,120,11605,16982,27010,0,0,0,1,1
53534,120,11606,17031;17163,27010,0,0,0,2,2
53535,120,11607,17206;17257,27010,0,0,0,2,2
53536,120,11608,17017;17061,27010,0,0,0,2,2
53537,120,11609,17114;17411;21666;24197,27010,1,0,2,1,4
53538,120,11610,17079;21245;23665,27010,0,1,1,1,3
53539,120,11622,12714,27375,0,0,0,1,1
53540,120,11628,13169,27375,0,0,0,1,1
53541,120,11641,14240;14800,27375,0,0,0,2,2
53542,120,11642,14941;15420,27375,0,0,0,2,2
53543,120,11643,14781,27375,0,0,0,1,1
53544,120,11644,15301,27375,0,0,0,1,1
53545,120,11645,14758;15235,27375,0,0,0,2,2
53546,120,11650,14804;15256,27375,0,0,0,2,2
53547,120,11657,15485;15596,27375,0,0,0,2,2
53548,120,11658,15617,27375,0,0,0,1,1
53549,120,11661,15747,27375,0,0,0,1,1
53550,120,11662,15595;16040,27375,0,0,0,2,2
53551,120,11664,15962;16213,27375,0,0,0,2,2
53552,120,11665,16430;16792,27375,0,0,0,2,2
53553,120,11666,16289;16354,27375,0,0,0,2,2
53554,120,11667,16215;16550,27375,0,0,0,2,2
53555,120,11671,16084;16326,27375,0,0,0,2,2
53556,120,11672,16464;21637,27375,0,0,1,1,2
53557,120,11674,16416,27375,0,0,0,1,1
53558,120,11675,16350,27375,0,0,0,1,1
53559,120,11676,16668,27375,0,0,0,1,1
53560,120,11677,16577;20148;24021,27375,1,0,1,1,3
53561,120,11678,16613,27375,0,0,0,1,1
53562,120,11679,16623,27375,0,0,0,1,1
53563,120,11680,16629,27375,0,0,0,1,1
53564,120,11681,16624;16702,27375,0,0,0,2,2
53565,120,11682,16666;17210,27375,0,0,0,2,2
53566,120,11683,16120;16743;20648,27375,0,0,1,2,3
53567,120,11684,16804;17297;21629,27375,0,0,2,1,3
53568,120,11685,16769;16852,27375,0,0,0,2,2
53569,120,11686,16783;17480;21936,27375,0,0,2,1,3
53570,120,11687,17239;17344,27375,0,0,1,1,2
53571,120,11688,16834;17076,27375,0,0,0,2,2
53572,120,11689,16844;17136,27375,0,0,0,2,2
53573,120,11690,17312,27375,0,0,1,0,1
53574,120,11691,16435;16797,27375,0,0,0,2,2
53575,120,11692,16352;16864,27375,0,0,0,2,2
53576,120,11693,16870;17286;22123,27375,0,0,2,1,3
53577,120,11694,16886;16972;20744;24058,27375,1,0,1,2,4
53578,120,11695,16894;17021,27375,0,0,0,2,2
53579,120,11696,16933,27375,0,0,0,1,1
53580,120,11697,16827;17194,27375,0,0,0,2,2
53581,120,11698,16938;16949,27375,0,0,0,2,2
53582,120,11699,16188;16945,27375,0,0,0,2,2
53583,120,11700,16960;17353,27375,0,0,1,1,2
53584,120,11701,16829;16965,27375,0,0,0,2,2
53585,120,11702,16720;16997,27375,0,0,0,2,2
53586,120,11704,17108,27375,0,0,0,1,1
53587,120,11705,16871;17039,27375,0,0,0,2,2
53588,120,11706,17065;17293,27375,0,0,1,1,2
53589,120,11707,16499;17070;21996;24207,27375,1,0,1,2,4
53590,120,11708,16740;17080,27375,0,0,0,2,2
53591,120,11709,16824;17328,27375,0,0,1,1,2
53592,120,11710,17090;17488,27375,0,0,1,1,2
53593,120,11711,17151;17201;21871;24204,27375,1,0,1,2,4
53594,120,11712,16759,27375,0,0,0,1,1
53595,120,11713,17118,27375,0,0,0,1,1
53596,120,11715,16934;17357,27375,0,0,1,1,2
53597,120,11716,16581;17223,27375,0,0,0,2,2
53598,120,11717,17088;17241,27375,0,0,0,2,2
53599,120,11718,16899;16995,27375,0,0,0,2,2
53600,120,11748,13685;14322,27740,0,0,0,2,2
53601,120,11754,15178,27740,0,0,0,1,1
53602,120,11755,14979;15811,27740,0,0,0,2,2
53603,120,11758,15775;20253,27740,0,0,1,1,2
53604,120,11762,16468,27740,0,0,0,1,1
53605,120,11764,16484;16525,27740,0,0,0,2,2
53606,120,11768,16676;16892,27740,0,0,0,2,2
53607,120,11769,16687;17012,27740,0,0,0,2,2
53608,120,11770,16685;16742,27740,0,0,0,2,2
53609,120,11771,16589;19845,27740,0,0,1,1,2
53610,120,11772,16778,27740,0,0,0,1,1
53611,120,11773,16282;16470,27740,0,0,0,2,2
53612,120,11774,17437,27740,0,0,1,0,1
53613,120,11775,17243,27740,0,0,0,1,1
53614,120,11777,16893;17011;20418;22720;23239;23725;24330,27740,1,3,1,2,7
53615,120,11778,16582;16614,27740,0,0,0,2,2
53616,120,11780,16885,27740,0,0,0,1,1
53617,120,11781,16902;17315,27740,0,0,1,1,2
53618,120,11782,17188;17394,27740,0,0,1,1,2
53619,120,11783,16802;16946,27740,0,0,0,2,2
53620,120,11784,16980;16985,27740,0,0,0,2,2
53621,120,11785,16964;16998,27740,0,0,0,2,2
53622,120,11786,17010;17092,27740,0,0,0,2,2
53623,120,11788,16868;17059;19735,27740,0,0,1,2,3
53624,120,11789,17048;17140,27740,0,0,0,2,2
53625,120,11790,17099,27740,0,0,0,1,1
53626,120,11791,17283;17687,27740,0,0,2,0,2
53627,120,11792,17504;21323,27740,0,0,2,0,2
53628,120,11794,17142,27740,0,0,0,1,1
53629,120,11795,16701;17152,27740,0,0,0,2,2
53630,120,11796,17164;21336,27740,0,0,1,1,2
53631,120,11797,16755;17175,27740,0,0,0,2,2
53632,120,11798,17507,27740,0,0,1,0,1
53633,120,11799,17248;17420;21451;21806;23670,27740,0,1,3,1,5
53634,120,11800,16986;17445;22116,27740,0,0,2,1,3
53635,120,11801,17125;17302,27740,0,0,1,1,2
53636,120,11802,17182;17252,27740,0,0,0,2,2
53637,120,11803,17255;17644,27740,0,0,1,1,2
53638,120,11804,17256;17278,27740,0,0,1,1,2
53639,120,11805,17289;17448;21730,27740,0,0,3,0,3
53640,120,11806,17295;17371,27740,0,0,2,0,2
53641,120,11807,17236;17684;19524;22574;22791,27740,0,1,3,1,5
53642,120,11808,16718;17285;21124,27740,0,0,2,1,3
53643,120,11809,17333;17482;21699,27740,0,0,3,0,3
53644,120,11810,17403;19888,27740,0,0,2,0,2
53645,120,11827,13148,28105,0,0,0,1,1
53646,120,11843,13670,28105,0,0,0,1,1
53647,120,11848,14641,28105,0,0,0,1,1
53648,120,11852,15216,28105,0,0,0,1,1
53649,120,11854,15787,28105,0,0,0,1,1
53650,120,11861,15399,28105,0,0,0,1,1
53651,120,11866,16574;16682,28105,0,0,0,2,2
53652,120,11869,16943,28105,0,0,0,1,1
53653,120,11870,16615,28105,0,0,0,1,1
53654,120,11872,16290,28105,0,0,0,1,1
53655,120,11873,16760,28105,0,0,0,1,1
53656,120,11874,16166;16408;20385;23631;23720,28105,0,2,1,2,5
53657,120,11876,17139,28105,0,0,0,1,1
53658,120,11877,16633,28105,0,0,0,1,1
53659,120,11879,16502;16860;20623,28105,0,0,1,2,3
53660,120,11880,16520,28105,0,0,0,1,1
53661,120,11883,16451;16529,28105,0,0,0,2,2
53662,120,11884,16222;16587,28105,0,0,0,2,2
53663,120,11885,16590,28105,0,0,0,1,1
53664,120,11886,16591;16658;21133,28105,0,0,1,2,3
53665,120,11887,16401;16598,28105,0,0,0,2,2
53666,120,11888,16607;16910,28105,0,0,0,2,2
53667,120,11889,16983,28105,0,0,0,1,1
53668,120,11890,16975,28105,0,0,0,1,1
53669,120,11893,16882;16951,28105,0,0,0,2,2
53670,120,11894,17093;17282,28105,0,0,1,1,2
53671,120,11896,16890;17190,28105,0,0,0,2,2
53672,120,11897,16922;17329;21566,28105,0,0,2,1,3
53673,120,11898,17067,28105,0,0,0,1,1
53674,120,11899,17216,28105,0,0,0,1,1
53675,120,11900,17468;22053,28105,0,0,2,0,2
53676,120,11901,16360;17073,28105,0,0,0,2,2
53677,120,11902,17097;17384,28105,0,0,1,1,2
53678,120,11903,17440;17547;21638,28105,0,0,3,0,3
53679,120,11904,17038;17270,28105,0,0,1,1,2
53680,120,11905,16872;17264,28105,0,0,0,2,2
53681,120,11906,17147;17298,28105,0,0,1,1,2
53682,120,11907,17326;17453,28105,0,0,2,0,2
53683,120,11908,16935,28105,0,0,0,1,1
53684,120,11909,17301;17740,28105,0,0,2,0,2
53685,120,11911,17380;17683,28105,0,0,2,0,2
53686,120,11912,19661;19878;23310,28105,0,1,2,0,3
53687,120,11914,17325;17566,28105,0,0,2,0,2
53688,120,11915,17260;17338,28105,0,0,1,1,2
53689,120,11916,17417,28105,0,0,1,0,1
53690,120,11917,17348;17399,28105,0,0,2,0,2
53691,120,11918,17606;17674;20370,28105,0,0,3,0,3
53692,120,11919,17359;17545;19883;23700;24217,28105,1,1,3,0,5
53693,120,11920,17133;17775,28105,0,0,1,1,2
53694,120,11921,17692;21952;24001,28105,1,0,2,0,3
53695,120,11922,17549;17761,28105,0,0,2,0,2
53696,120,11924,17525;17575;20789;22166,28105,0,0,4,0,4
53697,120,11932,13180,28470,0,0,0,1,1
53698,120,11942,13523,28470,0,0,0,1,1
53699,120,11952,14230;14801,28470,0,0,0,2,2
53700,120,11954,14477,28470,0,0,0,1,1
53701,120,11955,14508;14511,28470,0,0,0,2,2
53702,120,11959,15038,28470,0,0,0,1,1
53703,120,11971,15725,28470,0,0,0,1,1
53704,120,11972,15099;15311,28470,0,0,0,2,2
53705,120,11973,15314,28470,0,0,0,1,1
53706,120,11978,15933,28470,0,0,0,1,1
53707,120,11982,15246,28470,0,0,0,1,1
53708,120,11984,14938;15640,28470,0,0,0,2,2
53709,120,11986,15998,28470,0,0,0,1,1
53710,120,11987,14769;15224,28470,0,0,0,2,2
53711,120,11989,16239,28470,0,0,0,1,1
53712,120,11993,16331;16335;20411,28470,0,0,1,2,3
53713,120,11994,15744;15899,28470,0,0,0,2,2
53714,120,11997,16323;16583,28470,0,0,0,2,2
53715,120,11998,16920;16928,28470,0,0,0,2,2
53716,120,11999,16717;16914,28470,0,0,0,2,2
53717,120,12000,17217;17311,28470,0,0,1,1,2
53718,120,12001,16731;16780,28470,0,0,0,2,2
53719,120,12002,17119,28470,0,0,0,1,1
53720,120,12004,16814;17046,28470,0,0,0,2,2
53721,120,12005,16839;17527,28470,0,0,1,1,2
53722,120,12006,17098;21221,28470,0,0,1,1,2
53723,120,12007,17207;17400,28470,0,0,1,1,2
53724,120,12008,16987;17645;21224;23360;23457,28470,0,2,2,1,5
53725,120,12009,17020;17330,28470,0,0,1,1,2
53726,120,12010,16777;17249;21746,28470,0,0,1,2,3
53727,120,12012,17405,28470,0,0,1,0,1
53728,120,12013,17049;17096,28470,0,0,0,2,2
53729,120,12015,17211;17294;20356,28470,0,0,2,1,3
53730,120,12016,17161;17552,28470,0,0,1,1,2
53731,120,12017,17179;17275,28470,0,0,1,1,2
53732,120,12019,17362;17486;20973;22170,28470,0,0,4,0,4
53733,120,12021,17401;17536,28470,0,0,2,0,2
53734,120,12022,17208;17528;22155;22167,28470,0,0,3,1,4
53735,120,12023,16930;17233,28470,0,0,0,2,2
53736,120,12024,17538,28470,0,0,1,0,1
53737,120,12025,17276;17485,28470,0,0,2,0,2
53738,120,12026,17304;20349,28470,0,0,2,0,2
53739,120,12027,17313;17450,28470,0,0,2,0,2
53740,120,12028,17646,28470,0,0,1,0,1
53741,120,12029,17322;17729;21347;22392,28470,0,0,4,0,4
53742,120,12030,16805;17323;20591,28470,0,0,2,1,3
53743,120,12031,17165;17364,28470,0,0,1,1,2
53744,120,12032,17337;17377,28470,0,0,2,0,2
53745,120,12033,17317;17419,28470,0,0,2,0,2
53746,120,12034,17319;17433,28470,0,0,2,0,2
53747,120,12035,16896;17436;21673,28470,0,0,2,1,3
53748,120,12036,17162,28470,0,0,0,1,1
53749,120,12037,17467,28470,0,0,1,0,1
53750,120,12038,17354;17472,28470,0,0,2,0,2
53751,120,12039,17476;17565,28470,0,0,2,0,2
53752,120,12040,17763;21620,28470,0,0,2,0,2
53753,120,12041,17489;17630,28470,0,0,2,0,2
53754,120,12042,17494;17580;21505;23576,28470,0,1,3,0,4
53755,120,12043,16845;17521;21005,28470,0,0,2,1,3
53756,120,12044,17551,28470,0,0,1,0,1
53757,120,12045,17787;17969;20076;21454;22281,28470,0,0,5,0,5
53758,120,12046,17036;17570;20983,28470,0,0,2,1,3
53759,120,12060,13324,28835,0,0,0,1,1
53760,120,12062,13684,28835,0,0,0,1,1
53761,120,12072,14332,28835,0,0,0,1,1
53762,120,12079,14626,28835,0,0,0,1,1
53763,120,12093,15387,28835,0,0,0,1,1
53764,120,12100,15847;16258,28835,0,0,0,2,2
53765,120,12104,15571,28835,0,0,0,1,1
53766,120,12106,16271,28835,0,0,0,1,1
53767,120,12107,16079;16858,28835,0,0,0,2,2
53768,120,12111,16367;16861,28835,0,0,0,2,2
53769,120,12112,16374,28835,0,0,0,1,1
53770,120,12113,16875;21398,28835,0,0,1,1,2
53771,120,12116,17351,28835,0,0,1,0,1
53772,120,12118,16850;17305;21491,28835,0,0,2,1,3
53773,120,12119,16855;17013,28835,0,0,0,2,2
53774,120,12120,17150,28835,0,0,0,1,1
53775,120,12121,16640;17050,28835,0,0,0,2,2
53776,120,12122,17186,28835,0,0,0,1,1
53777,120,12123,17204;20630,28835,0,0,1,1,2
53778,120,12124,17228,28835,0,0,0,1,1
53779,120,12126,17123;17213,28835,0,0,0,2,2
53780,120,12128,17183;17269,28835,0,0,1,1,2
53781,120,12129,17334;17341,28835,0,0,2,0,2
53782,120,12130,17193;17556,28835,0,0,1,1,2
53783,120,12131,17385,28835,0,0,1,0,1
53784,120,12132,17539;17635,28835,0,0,2,0,2
53785,120,12133,16996;17435,28835,0,0,1,1,2
53786,120,12135,17395;17443,28835,0,0,2,0,2
53787,120,12136,17477;17868,28835,0,0,2,0,2
53788,120,12137,17110;17497;21753;24298,28835,1,0,2,1,4
53789,120,12138,17613;20776;23861,28835,0,1,2,0,3
53790,120,12139,17352;17750,28835,0,0,2,0,2
53791,120,12140,17520,28835,0,0,1,0,1
53792,120,12141,17563;17779;22172,28835,0,0,3,0,3
53793,120,12142,17557;17679,28835,0,0,2,0,2
53794,120,12143,17559;17585,28835,0,0,2,0,2
53795,120,12144,17245;17567,28835,0,0,1,1,2
53796,120,12145,17579;17982;22397,28835,0,0,3,0,3
53797,120,12146,17682,28835,0,0,1,0,1
53798,120,12147,17723;17944,28835,0,0,2,0,2
53799,120,12148,17577;17622;20901;21634;24258,28835,1,0,4,0,5
53800,120,12149,17423;17626,28835,0,0,2,0,2
53801,120,12150,17263;17639,28835,0,0,1,1,2
53802,120,12151,17838;17847;21548;22723;24396,28835,1,1,3,0,5
53803,120,12152,17648;17777,28835,0,0,2,0,2
53804,120,12153,17406;17651;22501,28835,0,0,3,0,3
53805,120,12154,17251;17652;20757,28835,0,0,2,1,3
53806,120,12155,17657;17947,28835,0,0,2,0,2
53807,120,12157,17153;17681,28835,0,0,1,1,2
53808,120,12165,13239,29200,0,0,0,1,1
53809,120,12174,14083,29200,0,0,0,1,1
53810,120,12178,14745,29200,0,0,0,1,1
53811,120,12189,15173,29200,0,0,0,1,1
53812,120,12191,15051;15539,29200,0,0,0,2,2
53813,120,12195,15777,29200,0,0,0,1,1
53814,120,12196,14898,29200,0,0,0,1,1
53815,120,12197,15389;15683,29200,0,0,0,2,2
53816,120,12200,15526;15555,29200,0,0,0,2,2
53817,120,12201,15034;15597,29200,0,0,0,2,2
53818,120,12204,16235,29200,0,0,0,1,1
53819,120,12207,15957;16566,29200,0,0,0,2,2
53820,120,12208,15720,29200,0,0,0,1,1
53821,120,12209,16046;16328,29200,0,0,0,2,2
53822,120,12212,16100;16217;19933,29200,0,0,1,2,3
53823,120,12215,16224;16292,29200,0,0,0,2,2
53824,120,12219,16524;16958,29200,0,0,0,2,2
53825,120,12220,16316;16595,29200,0,0,0,2,2
53826,120,12222,16713;17071,29200,0,0,0,2,2
53827,120,12223,16970,29200,0,0,0,1,1
53828,120,12224,16133;16414,29200,0,0,0,2,2
53829,120,12225,16750;20737;23249;23559;23743;23859;24151,29200,1,4,1,1,7
53830,120,12226,17143;21913,29200,0,0,1,1,2
53831,120,12227,17034;17398,29200,0,0,1,1,2
53832,120,12228,16515;16801,29200,0,0,0,2,2
53833,120,12230,16622,29200,0,0,0,1,1
53834,120,12231,17209;17469,29200,0,0,1,1,2
53835,120,12232,17410;17634,29200,0,0,2,0,2
53836,120,12233,17418;17446,29200,0,0,2,0,2
53837,120,12234,17056;17173,29200,0,0,0,2,2
53838,120,12235,16961,29200,0,0,0,1,1
53839,120,12236,17697;21314,29200,0,0,2,0,2
53840,120,12237,17157,29200,0,0,0,1,1
53841,120,12240,17535;17548;21715,29200,0,0,3,0,3
53842,120,12241,17267;17349;22032,29200,0,0,2,1,3
53843,120,12242,16944;17428,29200,0,0,1,1,2
53844,120,12243,17447;21324,29200,0,0,2,0,2
53845,120,12246,16948;20854;23865,29200,0,1,1,1,3
53846,120,12248,17430,29200,0,0,1,0,1
53847,120,12249,17265;17444;21585;22499,29200,0,0,3,1,4
53848,120,12250,17479;17717,29200,0,0,2,0,2
53849,120,12252,17515,29200,0,0,1,0,1
53850,120,12253,17619;17741,29200,0,0,2,0,2
53851,120,12254,17586;21967,29200,0,0,2,0,2
53852,120,12255,17462,29200,0,0,1,0,1
53853,120,12257,17972,29200,0,0,1,0,1
53854,120,12258,17232;17532;21818,29200,0,0,2,1,3
53855,120,12259,18084;20470,29200,0,0,2,0,2
53856,120,12261,17715,29200,0,0,1,0,1
53857,120,12262,17460;17739,29200,0,0,2,0,2
53858,120,12281,13825,29565,0,0,0,1,1
53859,120,12283,13878,29565,0,0,0,1,1
53860,120,12286,14244,29565,0,0,0,1,1
53861,120,12290,14755,29565,0,0,0,1,1
53862,120,12293,14883,29565,0,0,0,1,1
53863,120,12294,14538,29565,0,0,0,1,1
53864,120,12299,15140;15145,29565,0,0,0,2,2
53865,120,12301,15670;15954,29565,0,0,0,2,2
53866,120,12304,15874;16426,29565,0,0,0,2,2
53867,120,12311,16522;16979,29565,0,0,0,2,2
53868,120,12314,16489;16746,29565,0,0,0,2,2
53869,120,12318,17191;17422,29565,0,0,1,1,2
53870,120,12320,17081;17171;21026;21982,29565,0,0,2,2,4
53871,120,12321,16639;17138,29565,0,0,0,2,2
53872,120,12323,17172,29565,0,0,0,1,1
53873,120,12324,17200;17372,29565,0,0,1,1,2
53874,120,12325,17279,29565,0,0,1,0,1
53875,120,12326,17280;17360;21385;22165,29565,0,0,4,0,4
53876,120,12327,17324,29565,0,0,1,0,1
53877,120,12328,17490;17866;22282,29565,0,0,3,0,3
53878,120,12330,17392;21408,29565,0,0,2,0,2
53879,120,12331,17336;17829;21580;22394,29565,0,0,4,0,4
53880,120,12332,17432;18087;20507;20781;21837,29565,0,0,5,0,5
53881,120,12334,17508;17939,29565,0,0,2,0,2
53882,120,12335,17513;20525,29565,0,0,2,0,2
53883,120,12336,17463;17519;21651,29565,0,0,3,0,3
53884,120,12337,17215;17582;21914;22500,29565,0,0,3,1,4
53885,120,12338,17464;17583,29565,0,0,2,0,2
53886,120,12339,17541,29565,0,0,1,0,1
53887,120,12340,17593;17667;20458;20997;24370,29565,1,0,4,0,5
53888,120,12341,17611;17620,29565,0,0,2,0,2
53889,120,12342,17505;21247;24179;24385,29565,2,0,2,0,4
53890,120,12343,17653;17872;21024,29565,0,0,3,0,3
53891,120,12344,17659;17759;21338,29565,0,0,3,0,3
53892,120,12345,17714;17844,29565,0,0,2,0,2
53893,120,12346,17383;17690;20508;22828,29565,0,1,3,0,4
53894,120,12347,17997;18196;20858;21901,29565,0,0,4,0,4
53895,120,12348,17797;17968;20141;22820;23823,29565,0,2,3,0,5
53896,120,12349,17753;17756;21319,29565,0,0,3,0,3
53897,120,12350,17501;17769;21890;22117;22171;24003,29565,1,0,5,0,6
53898,120,12351,17434;17952;22284,29565,0,0,3,0,3
53899,120,12352,17802;21646,29565,0,0,2,0,2
53900,120,12353,17804;21832;22393,29565,0,0,3,0,3
53901,120,12354,17825,29565,0,0,1,0,1
53902,120,12355,17748;17831;21739,29565,0,0,3,0,3
53903,120,12356,17914;17936;21764;22832;24407,29565,1,1,3,0,5
53904,120,12357,17589;17848,29565,0,0,2,0,2
53905,120,12358,17801;17861,29565,0,0,2,0,2
53906,120,12359,17391;17878;22176,29565,0,0,3,0,3
53907,120,12360,18048,29565,0,0,1,0,1
53908,120,12370,13955,29930,0,0,0,1,1
53909,120,12373,14111,29930,0,0,0,1,1
53910,120,12374,14619,29930,0,0,0,1,1
53911,120,12376,13884,29930,0,0,0,1,1
53912,120,12395,16363,29930,0,0,0,1,1
53913,120,12396,16402,29930,0,0,0,1,1
53914,120,12397,15665;16279,29930,0,0,0,2,2
53915,120,12398,16257;21497;24194,29930,1,0,1,1,3
53916,120,12399,16308;16418,29930,0,0,0,2,2
53917,120,12400,16211,29930,0,0,0,1,1
53918,120,12401,17130,29930,0,0,0,1,1
53919,120,12402,17218,29930,0,0,0,1,1
53920,120,12403,16636;16763,29930,0,0,0,2,2
53921,120,12404,16604;16647,29930,0,0,0,2,2
53922,120,12405,17052,29930,0,0,0,1,1
53923,120,12406,16800,29930,0,0,0,1,1
53924,120,12407,16937;17230,29930,0,0,0,2,2
53925,120,12408,16628;16695,29930,0,0,0,2,2
53926,120,12410,17425,29930,0,0,1,0,1
53927,120,12411,17041,29930,0,0,0,1,1
53928,120,12412,17037;17427,29930,0,0,1,1,2
53929,120,12413,17296;17495;21096,29930,0,0,3,0,3
53930,120,12414,17198;17696;21536,29930,0,0,2,1,3
53931,120,12415,17247;17514,29930,0,0,1,1,2
53932,120,12416,17288;17616;21858,29930,0,0,3,0,3
53933,120,12417,17492;17660,29930,0,0,2,0,2
53934,120,12418,17366;17500,29930,0,0,2,0,2
53935,120,12419,16898;17074;21158,29930,0,0,1,2,3
53936,120,12420,17758;20399;21691;24327,29930,1,0,3,0,4
53937,120,12421,16815;17202,29930,0,0,0,2,2
53938,120,12422,17971;18096;21474;23668,29930,0,1,3,0,4
53939,120,12423,17242;17426,29930,0,0,1,1,2
53940,120,12424,17474,29930,0,0,1,0,1
53941,120,12425,17841;21333;21731;24185,29930,1,0,3,0,4
53942,120,12426,17707;20963;24168,29930,1,0,2,0,3
53943,120,12427,17663;18107;22049,29930,0,0,3,0,3
53944,120,12428,17700;17711,29930,0,0,2,0,2
53945,120,12429,17465;17598,29930,0,0,2,0,2
53946,120,12430,18160;18178,29930,0,0,2,0,2
53947,120,12431,18036;18581,29930,0,0,2,0,2
53948,120,12432,18189;22402,29930,0,0,2,0,2
53949,120,12434,18125;21631,29930,0,0,2,0,2
53950,120,12435,17817;22068;22609,29930,0,1,2,0,3
53951,120,12436,17604;17818,29930,0,0,2,0,2
53952,120,12437,17795;17824,29930,0,0,2,0,2
53953,120,12438,17628;17830,29930,0,0,2,0,2
53954,120,12440,17638;17887,29930,0,0,2,0,2
53955,120,12441,17736;17853,29930,0,0,2,0,2
53956,120,12442,17963,29930,0,0,1,0,1
53957,120,12443,17509;17864,29930,0,0,2,0,2
53958,120,12444,17339,29930,0,0,1,0,1
53959,120,12445,17673;17882,29930,0,0,2,0,2
53960,120,12446,17768;17884;20722,29930,0,0,3,0,3
53961,120,12447,17888;18144,29930,0,0,2,0,2
53962,120,12448,17937;18101,29930,0,0,2,0,2
53963,120,12449,17991;18094;21868,29930,0,0,3,0,3
53964,120,12450,17860;17999,29930,0,0,2,0,2
53965,120,12464,13406,30295,0,0,0,1,1
53966,120,12469,14324,30295,0,0,0,1,1
53967,120,12471,14307,30295,0,0,0,1,1
53968,120,12478,13850;14053,30295,0,0,0,2,2
53969,120,12479,14737,30295,0,0,0,1,1
53970,120,12484,15077,30295,0,0,0,1,1
53971,120,12491,15691;15821,30295,0,0,0,2,2
53972,120,12495,16379,30295,0,0,0,1,1
53973,120,12496,16296,30295,0,0,0,1,1
53974,120,12499,16127;16540,30295,0,0,0,2,2
53975,120,12501,15864;16233;20420;22721;23125;23541;23726;23939,30295,1,4,1,2,8
53976,120,12503,16044;16465,30295,0,0,0,2,2
53977,120,12505,16608;17244,30295,0,0,0,2,2
53978,120,12506,16747;17197,30295,0,0,0,2,2
53979,120,12507,16807,30295,0,0,0,1,1
53980,120,12508,16657;17120,30295,0,0,0,2,2
53981,120,12510,16104;17158,30295,0,0,0,2,2
53982,120,12513,17109;17291;20516,30295,0,0,2,1,3
53983,120,12514,17238;17680,30295,0,0,1,1,2
53984,120,12516,17332;17346,30295,0,0,2,0,2
53985,120,12517,17421;17721;22103;22279,30295,0,0,4,0,4
53986,120,12518,17369;17564,30295,0,0,2,0,2
53987,120,12519,17572;18131,30295,0,0,2,0,2
53988,120,12520,17574;17701;21754,30295,0,0,3,0,3
53989,120,12522,17807;17820,30295,0,0,2,0,2
53990,120,12523,17631,30295,0,0,1,0,1
53991,120,12524,17649;17727;20533;23733,30295,0,1,3,0,4
53992,120,12525,17487;17666;20703;21521,30295,0,0,4,0,4
53993,120,12526,17705;17746,30295,0,0,2,0,2
53994,120,12527,17879;18210;21826;24203,30295,1,0,3,0,4
53995,120,12528,17382;17735;22097,30295,0,0,3,0,3
53996,120,12529,17699;17737;21949,30295,0,0,3,0,3
53997,120,12530,17840,30295,0,0,1,0,1
53998,120,12531,17794,30295,0,0,1,0,1
53999,120,12532,17745;17983;21549,30295,0,0,3,0,3
54000,120,12533,17785;18169,30295,0,0,2,0,2
54001,120,12534,17789;17909;22137;24100;24312,30295,2,0,3,0,5
54002,120,12535,17670;17790,30295,0,0,2,0,2
54003,120,12536,17842;21698;22173,30295,0,0,3,0,3
54004,120,12537,17897;17922,30295,0,0,2,0,2
54005,120,12538,17823;17906,30295,0,0,2,0,2
54006,120,12539,17703;18159;21240,30295,0,0,3,0,3
54007,120,12540,17774,30295,0,0,1,0,1
54008,120,12541,17921;17998;21399,30295,0,0,3,0,3
54009,120,12542,17870;17924;22037,30295,0,0,3,0,3
54010,120,12543,17900;17930;21778;22502,30295,0,0,4,0,4
54011,120,12544,17733;17942,30295,0,0,2,0,2
54012,120,12545,18112;18162,30295,0,0,2,0,2
54013,120,12546,17803,30295,0,0,1,0,1
54014,120,12547,18368;21039;21791,30295,0,0,3,0,3
54015,120,12548,17409;17995;20797,30295,0,0,3,0,3
54016,120,12549,17996,30295,0,0,1,0,1
54017,120,12550,17918;18002,30295,0,0,2,0,2
54018,120,12551,17694;18249,30295,0,0,2,0,2
54019,120,12552,18019;18353;21737;24095,30295,1,0,3,0,4
54020,120,12553,17368;18200;22189,30295,0,0,3,0,3
54021,120,12554,18034;18092;21544,30295,0,0,3,0,3
54022,120,12555,17890;18106;21442;22187,30295,0,0,4,0,4
54023,120,12557,17533;18103,30295,0,0,2,0,2
54024,120,12558,18093;22027;22505,30295,0,0,3,0,3
54025,120,12559,17895;18058,30295,0,0,2,0,2
54026,120,12562,13570,30660,0,0,0,1,1
54027,120,12571,14263,30660,0,0,0,1,1
54028,120,12577,15776,30660,0,0,0,1,1
54029,120,12584,15664,30660,0,0,0,1,1
54030,120,12585,15741,30660,0,0,0,1,1
54031,120,12591,15672;16022,30660,0,0,0,2,2
54032,120,12592,15703,30660,0,0,0,1,1
54033,120,12593,16580,30660,0,0,0,1,1
54034,120,12595,16865,30660,0,0,0,1,1
54035,120,12597,17044;17261;21463,30660,0,0,1,2,3
54036,120,12599,16823;17451,30660,0,0,1,1,2
54037,120,12600,16843;17347,30660,0,0,1,1,2
54038,120,12602,16542;17042,30660,0,0,0,2,2
54039,120,12603,16854;17141,30660,0,0,0,2,2
54040,120,12605,16662;16957;20803;24156,30660,1,0,1,2,4
54041,120,12610,17107;17222;21882,30660,0,0,1,2,3
54042,120,12611,17300;17429,30660,0,0,2,0,2
54043,120,12612,17534;18057;21896,30660,0,0,3,0,3
54044,120,12613,17543;17771;21819,30660,0,0,3,0,3
54045,120,12614,17554;18232;21786,30660,0,0,3,0,3
54046,120,12615,17573;18381;22138,30660,0,0,3,0,3
54047,120,12616,17599;18000;21581,30660,0,0,3,0,3
54048,120,12617,17343;17608,30660,0,0,2,0,2
54049,120,12618,17985;18061,30660,0,0,2,0,2
54050,120,12619,17402;17776;22280,30660,0,0,3,0,3
54051,120,12620,17641;17647,30660,0,0,2,0,2
54052,120,12621,17656;18175;21624;24295,30660,1,0,3,0,4
54053,120,12622,17015;17662,30660,0,0,1,1,2
54054,120,12623,17722;17754;21610;24294,30660,1,0,3,0,4
54055,120,12624,17516;18035;21835,30660,0,0,3,0,3
54056,120,12625,17709;17812;21656,30660,0,0,3,0,3
54057,120,12626,17612,30660,0,0,1,0,1
54058,120,12627,18027;22288;22399,30660,0,0,3,0,3
54059,120,12628,18330;18452;21721;23578,30660,0,1,3,0,4
54060,120,12629,17815;18050;22504,30660,0,0,3,0,3
54061,120,12630,17843;21318,30660,0,0,2,0,2
54062,120,12631,18242;21579;22014,30660,0,0,3,0,3
54063,120,12632,17926;17988,30660,0,0,2,0,2
54064,120,12633,17863;18140;21562;22400,30660,0,0,4,0,4
54065,120,12634,18120;18161;22124,30660,0,0,3,0,3
54066,120,12635,18329;22009;22301;22405,30660,0,0,4,0,4
54067,120,12636,17836;17910;21388,30660,0,0,3,0,3
54068,120,12637,17938;18111;21743;22018,30660,0,0,4,0,4
54069,120,12638,17962;18067,30660,0,0,2,0,2
54070,120,12639,18013;18099;21712,30660,0,0,3,0,3
54071,120,12641,18336,30660,0,0,1,0,1
54072,120,12642,17881;18313;20395;23144,30660,0,1,3,0,4
54073,120,12643,17875;18056;22289,30660,0,0,3,0,3
54074,120,12644,18068,30660,0,0,1,0,1
54075,120,12647,18102;22611,30660,0,1,1,0,2
54076,120,12648,17609;18218,30660,0,0,2,0,2
54077,120,12649,17605;18116,30660,0,0,2,0,2
54078,120,12650,18375;22206,30660,0,0,2,0,2
54079,120,12651,18121;18132,30660,0,0,2,0,2
54080,120,12652,17961;18361;21487;21542;22204,30660,0,0,5,0,5
54081,120,12653,17800;18136;21315;24390,30660,1,0,3,0,4
54082,120,12654,18145;21724;22725,30660,0,1,2,0,3
54083,120,12655,18151;18182;22035,30660,0,0,3,0,3
54084,120,12656,17911;17915;22283;24210,30660,1,0,3,0,4
54085,120,12658,17788;18224;21846;22191,30660,0,0,4,0,4
54086,120,12661,13116,31025,0,0,0,1,1
54087,120,12665,12993,31025,0,0,0,1,1
54088,120,12680,15269;15304,31025,0,0,0,2,2
54089,120,12684,15164;15732,31025,0,0,0,2,2
54090,120,12691,15622;15663,31025,0,0,0,2,2
54091,120,12696,15284,31025,0,0,0,1,1
54092,120,12699,16397;16605,31025,0,0,0,2,2
54093,120,12704,16558;17069;21306,31025,0,0,1,2,3
54094,120,12706,17104;17149;21683,31025,0,0,1,2,3
54095,120,12713,16659;17345;21918,31025,0,0,2,1,3
54096,120,12715,17176,31025,0,0,0,1,1
54097,120,12716,17185;17381,31025,0,0,1,1,2
54098,120,12717,17855,31025,0,0,1,0,1
54099,120,12719,17734;18046,31025,0,0,2,0,2
54100,120,12720,17839;17984;21570,31025,0,0,3,0,3
54101,120,12721,17503;18152;21700,31025,0,0,3,0,3
54102,120,12722,17929,31025,0,0,1,0,1
54103,120,12723,17219;17640,31025,0,0,1,1,2
54104,120,12724,18209;22615,31025,0,1,1,0,2
54105,120,12725,17720;18277;21572;22197;24293,31025,1,0,4,0,5
54106,120,12726,17940;21477,31025,0,0,2,0,2
54107,120,12727,18100,31025,0,0,1,0,1
54108,120,12728,17948,31025,0,0,1,0,1
54109,120,12729,17561;18091;21972,31025,0,0,3,0,3
54110,120,12730,17778;17959,31025,0,0,2,0,2
54111,120,12732,17850;17976;22396,31025,0,0,3,0,3
54112,120,12733,17873;18009,31025,0,0,2,0,2
54113,120,12734,18260;18515;21850;22842;22937,31025,0,2,3,0,5
54114,120,12735,17792;17941,31025,0,0,2,0,2
54115,120,12736,17355;17951,31025,0,0,2,0,2
54116,120,12737,18157;21603;22210,31025,0,0,3,0,3
54117,120,12738,18216,31025,0,0,1,0,1
54118,120,12739,17718;17967;22607,31025,0,1,2,0,3
54119,120,12740,18098;18197;20804;21653,31025,0,0,4,0,4
54120,120,12741,17716;18049,31025,0,0,2,0,2
54121,120,12742,17728;18126;22082,31025,0,0,3,0,3
54122,120,12743,18081;18097,31025,0,0,2,0,2
54123,120,12744,18114;18357;21828,31025,0,0,3,0,3
54124,120,12745,18156;18226;21360;21576;24085;24186,31025,2,0,4,0,6
54125,120,12746,17749;18167;22401,31025,0,0,3,0,3
54126,120,12747,18195;18291,31025,0,0,2,0,2
54127,120,12748,17990;18199;21465;22031,31025,0,0,4,0,4
54128,120,12749,18221;21486;22404;22508,31025,0,0,4,0,4
54129,120,12750,18237;18592;21728;22317,31025,0,0,4,0,4
54130,120,12751,18047;18255;21382;22617;24189,31025,1,1,3,0,5
54131,120,12752,17981;18279;20547,31025,0,0,3,0,3
54132,120,12753,18272,31025,0,0,1,0,1
54133,120,12754,18274;18445;21794;22415;22836,31025,0,1,4,0,5
54134,120,12755,18351;18518;21238;21401;22309,31025,0,0,5,0,5
54135,120,12756,18294;18505;21927,31025,0,0,3,0,3
54136,120,12757,18302;21095,31025,0,0,2,0,2
54137,120,12761,13385,31390,0,0,0,1,1
54138,120,12771,14353,31390,0,0,0,1,1
54139,120,12773,14709,31390,0,0,0,1,1
54140,120,12774,14430;14908,31390,0,0,0,2,2
54141,120,12784,15415,31390,0,0,0,1,1
54142,120,12789,16011,31390,0,0,0,1,1
54143,120,12792,15449,31390,0,0,0,1,1
54144,120,12793,15762,31390,0,0,0,1,1
54145,120,12799,16113;16721,31390,0,0,0,2,2
54146,120,12800,16482,31390,0,0,0,1,1
54147,120,12803,16361,31390,0,0,0,1,1
54148,120,12805,16729;17087;21343,31390,0,0,1,2,3
54149,120,12806,16784;17166,31390,0,0,0,2,2
54150,120,12807,16288,31390,0,0,0,1,1
54151,120,12810,16781;17389,31390,0,0,1,1,2
54152,120,12812,16867,31390,0,0,0,1,1
54153,120,12813,16993;17299;21527,31390,0,0,2,1,3
54154,120,12816,17633,31390,0,0,1,0,1
54155,120,12818,17688;18180,31390,0,0,2,0,2
54156,120,12819,17075,31390,0,0,0,1,1
54157,120,12820,17796;17957;22067;22285,31390,0,0,4,0,4
54158,120,12821,16959;17358,31390,0,0,1,1,2
54159,120,12824,17695;17857,31390,0,0,2,0,2
54160,120,12825,16956;17431,31390,0,0,1,1,2
54161,120,12826,17540;17919;22610,31390,0,1,2,0,3
54162,120,12827,17546,31390,0,0,1,0,1
54163,120,12828,17390;17834;21130,31390,0,0,3,0,3
54164,120,12829,17623;18127;22612,31390,0,1,2,0,3
54165,120,12830,18025;18164;21713,31390,0,0,3,0,3
54166,120,12831,18208;22190;22294,31390,0,0,3,0,3
54167,120,12832,17719;17786;21782;22278;22608;24315,31390,1,1,4,0,6
54168,120,12833,17871;18171;21727,31390,0,0,3,0,3
54169,120,12834,17441;18028;21899;21986,31390,0,0,4,0,4
54170,120,12835,17901,31390,0,0,1,0,1
54171,120,12836,17702;17946,31390,0,0,2,0,2
54172,120,12837,18194,31390,0,0,1,0,1
54173,120,12838,17891;17966,31390,0,0,2,0,2
54174,120,12839,17977;18188,31390,0,0,2,0,2
54175,120,12840,18326;18656;22526,31390,0,0,3,0,3
54176,120,12841,18055;21864;22184;22933,31390,0,1,3,0,4
54177,120,12842,18064;18341;21990;22406,31390,0,0,4,0,4
54178,120,12843,17581;18016,31390,0,0,2,0,2
54179,120,12844,17665;18155;20641,31390,0,0,3,0,3
54180,120,12845,18165,31390,0,0,1,0,1
54181,120,12846,18390;21857,31390,0,0,2,0,2
54182,120,12847,18007;18179,31390,0,0,2,0,2
54183,120,12848,17601;17766;21514;22168,31390,0,0,4,0,4
54184,120,12849,18436;18465;21984,31390,0,0,3,0,3
54185,120,12850,18233;18265;21445;22195,31390,0,0,4,0,4
54186,120,12851,18566;22315,31390,0,0,2,0,2
54187,120,12852,18193;18246;21682;22192;22297;24092;24200,31390,2,0,5,0,7
54188,120,12853,18147;18192;21750;22618,31390,0,1,3,0,4
54189,120,12854,18270,31390,0,0,1,0,1
54190,120,12855,17780;18290;22619,31390,0,1,2,0,3
54191,120,12856,18446;18694;22322,31390,0,0,3,0,3
54192,120,12857,18367;18391;22105;23040;23365,31390,0,2,3,0,5
54193,120,12858,18658;18712;22428,31390,0,0,3,0,3
54194,120,12859,18331,31390,0,0,1,0,1
54195,120,12862,17865;18342,31390,0,0,2,0,2
54196,120,12863,18185;18346;22407,31390,0,0,3,0,3
54197,120,12864,18267;18733;22329,31390,0,0,3,0,3
54198,120,12865,18088;18369;21824;23892,31390,0,1,3,0,4
54199,120,12867,18258;18386;22833,31390,0,1,2,0,3
54200,120,12872,14473,31755,0,0,0,1,1
54201,120,12879,14605,31755,0,0,0,1,1
54202,120,12887,14723,31755,0,0,0,1,1
54203,120,12888,15390,31755,0,0,0,1,1
54204,120,12889,15348,31755,0,0,0,1,1
54205,120,12890,14687;15053,31755,0,0,0,2,2
54206,120,12891,15127;15296,31755,0,0,0,2,2
54207,120,12893,15249,31755,0,0,0,1,1
54208,120,12899,15867,31755,0,0,0,1,1
54209,120,12901,15905,31755,0,0,0,1,1
54210,120,12909,16353;16924,31755,0,0,0,2,2
54211,120,12910,16966;17030,31755,0,0,0,2,2
54212,120,12913,17412;17522,31755,0,0,2,0,2
54213,120,12916,17231;17610,31755,0,0,1,1,2
54214,120,12917,17262;17396,31755,0,0,1,1,2
54215,120,12918,17340;17576;21092,31755,0,0,3,0,3
54216,120,12919,17192;17454,31755,0,0,1,1,2
54217,120,12920,17506;17810,31755,0,0,2,0,2
54218,120,12922,17555;17595,31755,0,0,2,0,2
54219,120,12923,17356;17594,31755,0,0,2,0,2
54220,120,12924,17811,31755,0,0,1,0,1
54221,120,12925,17526,31755,0,0,1,0,1
54222,120,12926,17760;17958;21677,31755,0,0,3,0,3
54223,120,12927,17956;18323;21328;21617;24089,31755,1,0,4,0,5
54224,120,12928,17784;17798,31755,0,0,2,0,2
54225,120,12929,18014;18023;22041,31755,0,0,3,0,3
54226,120,12931,18006;18105;22503,31755,0,0,3,0,3
54227,120,12932,18012;18740;21374;22226;22633,31755,0,1,4,0,5
54228,120,12933,18018;18113,31755,0,0,2,0,2
54229,120,12934,18029;18710;22224;22325;23265,31755,0,1,4,0,5
54230,120,12935,18245;18332;22202,31755,0,0,3,0,3
54231,120,12936,18563;18808;22941,31755,0,1,2,0,3
54232,120,12937,18456;18457;22837,31755,0,1,2,0,3
54233,120,12938,18154;18621;22847,31755,0,1,2,0,3
54234,120,12939,17713;18158;21097;24273,31755,1,0,3,0,4
54235,120,12940,17625;18173;22614,31755,0,1,2,0,3
54236,120,12941,18840;22535;22643,31755,0,1,2,0,3
54237,120,12942,18252;22298;23143,31755,0,1,2,0,3
54238,120,12943,18128;18266;21448,31755,0,0,3,0,3
54239,120,12944,17932;18305,31755,0,0,2,0,2
54240,120,12945,18273,31755,0,0,1,0,1
54241,120,12946,18276;18300,31755,0,0,2,0,2
54242,120,12947,18285;18802;22534;22637;22741;22946,31755,0,3,3,0,6
54243,120,12948,18225;18698,31755,0,0,2,0,2
54244,120,12949,18215;18303;21645;22616;24296,31755,1,1,3,0,5
54245,120,12950,17693;18395;21226;23664;24383,31755,1,1,3,0,5
54246,120,12951,18396;18717,31755,0,0,2,0,2
54247,120,12952,17889;18486;22011,31755,0,0,3,0,3
54248,120,12953,18214;18425;21929;22835,31755,0,1,3,0,4
54249,120,12954,18385;18426;23577,31755,0,1,2,0,3
54250,120,12955,18328;22620,31755,0,1,1,0,2
54251,120,12956,18223;18434;21768,31755,0,0,3,0,3
54252,120,12957,17935;18577;20950,31755,0,0,3,0,3
54253,120,12958,18636,31755,0,0,1,0,1
54254,120,12959,18149;18513,31755,0,0,2,0,2
54255,120,12961,18779;18861;22063;23371,31755,0,1,3,0,4
54256,120,12962,18437;18527;22311,31755,0,0,3,0,3
54257,120,12965,13572,32120,0,0,0,1,1
54258,120,12968,13931,32120,0,0,0,1,1
54259,120,12976,14953,32120,0,0,0,1,1
54260,120,12980,15194,32120,0,0,0,1,1
54261,120,12983,15671,32120,0,0,0,1,1
54262,120,12989,15748;15980,32120,0,0,0,2,2
54263,120,12996,15814,32120,0,0,0,1,1
54264,120,13006,16973,32120,0,0,0,1,1
54265,120,13007,16738;17137,32120,0,0,0,2,2
54266,120,13008,17226,32120,0,0,0,1,1
54267,120,13015,17258;17475,32120,0,0,1,1,2
54268,120,13019,18150;18166;22292,32120,0,0,3,0,3
54269,120,13020,18129;22291,32120,0,0,2,0,2
54270,120,13024,18083;22033;24418,32120,1,0,2,0,3
54271,120,13025,17671;17975;22002,32120,0,0,3,0,3
54272,120,13026,17883;18148,32120,0,0,2,0,2
54273,120,13027,17615;17896;22395,32120,0,0,3,0,3
54274,120,13028,17770;17987,32120,0,0,2,0,2
54275,120,13029,18263;18301,32120,0,0,2,0,2
54276,120,13030,17591;18045,32120,0,0,2,0,2
54277,120,13032,18095;18359,32120,0,0,2,0,2
54278,120,13033,17833;18257;22012;22194,32120,0,0,4,0,4
54279,120,13034,18338;22510,32120,0,0,2,0,2
54280,120,13036,18284;18746;22852,32120,0,1,2,0,3
54281,120,13037,17708;18502;21747;22047,32120,0,0,4,0,4
54282,120,13038,18784;21735,32120,0,0,2,0,2
54283,120,13039,17762;18228;22295,32120,0,0,3,0,3
54284,120,13040,18296;18702;22223;22324;22631,32120,0,1,4,0,5
54285,120,13041,18355;21926,32120,0,0,2,0,2
54286,120,13042,18356;18380;21584;21788,32120,0,0,4,0,4
54287,120,13043,18135;18278;21670;21981,32120,0,0,4,0,4
54288,120,13044,18288;18634;21596;21945;22524;23046;24097,32120,1,1,5,0,7
54289,120,13045,18281;18413;21553;23463,32120,0,1,3,0,4
54290,120,13046,18040;18421;22412,32120,0,0,3,0,3
54291,120,13047,18428;18611;22217;22424;24004,32120,1,0,4,0,5
54292,120,13048,18821;22107;23579,32120,0,1,2,0,3
54293,120,13049,18364;18699;22323,32120,0,0,3,0,3
54294,120,13050,18177;18443;21671;22414,32120,0,0,4,0,4
54295,120,13051,18453;18550;21389;21821;22151;22313;22939,32120,0,1,6,0,7
54296,120,13052,17710;18478;22730;23145,32120,0,2,2,0,4
54297,120,13053,18497;18519,32120,0,0,2,0,2
54298,120,13055,18533;22516;22843,32120,0,1,2,0,3
54299,120,13056,18405;18560;23366,32120,0,1,2,0,3
54300,120,13057,18971;22238;22349;22649;22951,32120,0,2,3,0,5
54301,120,13058,18685;21016,32120,0,0,2,0,2
54302,120,13059,18578;18686;22222;22737,32120,0,1,3,0,4
54303,120,13060,18306;18601,32120,0,0,2,0,2
54304,120,13061,18614;18772;21035;23050;23266,32120,0,2,3,0,5
54305,120,13062,18201;18594,32120,0,0,2,0,2
54306,120,13068,13895,32485,0,0,0,1,1
54307,120,13072,14185,32485,0,0,0,1,1
54308,120,13079,14795;15291,32485,0,0,0,2,2
54309,120,13080,14733;15059,32485,0,0,0,2,2
54310,120,13083,15772,32485,0,0,0,1,1
54311,120,13087,15866;16393,32485,0,0,0,2,2
54312,120,13103,16545;16696,32485,0,0,0,2,2
54313,120,13108,17452,32485,0,0,1,0,1
54314,120,13110,17442;17661;21879,32485,0,0,3,0,3
54315,120,13112,17416;17590,32485,0,0,2,0,2
54316,120,13113,17732;18071;21494;22186,32485,0,0,4,0,4
54317,120,13114,17414;17587,32485,0,0,2,0,2
54318,120,13116,17698;17851,32485,0,0,2,0,2
54319,120,13120,18358;22203,32485,0,0,2,0,2
54320,120,13121,17498,32485,0,0,1,0,1
54321,120,13122,18072,32485,0,0,1,0,1
54322,120,13123,18054;18212;21613;22040,32485,0,0,4,0,4
54323,120,13124,17905;18022,32485,0,0,2,0,2
54324,120,13125,17730;17964;21978,32485,0,0,3,0,3
54325,120,13126,18021,32485,0,0,1,0,1
54326,120,13127,18032;18039;21661;22183,32485,0,0,4,0,4
54327,120,13128,18467;18789,32485,0,0,2,0,2
54328,120,13129,18404;18898;22442,32485,0,0,3,0,3
54329,120,13130,18133;18744;22039;23778,32485,0,1,3,0,4
54330,120,13131,18248;18350;22023;22114,32485,0,0,4,0,4
54331,120,13133,18309;18628;22058,32485,0,0,3,0,3
54332,120,13134,17757;18163;21198,32485,0,0,3,0,3
54333,120,13135,18400,32485,0,0,1,0,1
54334,120,13136,18011;18334,32485,0,0,2,0,2
54335,120,13137,18538,32485,0,0,1,0,1
54336,120,13138,18397;18575;22627;23045,32485,0,2,2,0,4
54337,120,13139,18910;21386;22538;23779,32485,0,1,3,0,4
54338,120,13140,18438,32485,0,0,1,0,1
54339,120,13141,18477;18769;22333;22531;22740,32485,0,1,4,0,5
54340,120,13142,18219;18479;22839,32485,0,1,2,0,3
54341,120,13143,18915;21430;22344;22444;22748,32485,0,1,4,0,5
54342,120,13144,17856;18491,32485,0,0,2,0,2
54343,120,13145,18676;21316;21627;23149,32485,0,1,3,0,4
54344,120,13147,18510;18720;22307,32485,0,0,3,0,3
54345,120,13148,18512;22308,32485,0,0,2,0,2
54346,120,13149,18259;18520;21773,32485,0,0,3,0,3
54347,120,13151,18580;18951;22859,32485,0,1,2,0,3
54348,120,13152,18393;21348,32485,0,0,2,0,2
54349,120,13153,18723;18968;21900;22542;23373,32485,0,1,4,0,5
54350,120,13154,18941,32485,0,0,1,0,1
54351,120,13155,18877;22644;22746,32485,0,2,1,0,3
54352,120,13156,18615;18643,32485,0,0,2,0,2
54353,120,13157,18646;18655;21920;22943,32485,0,1,3,0,4
54354,120,13158,18778;19101;21959;22231;23267;23672;24205,32485,1,2,4,0,7
54355,120,13159,18439;18662;22429;22849;24314,32485,1,1,3,0,5
54356,120,13160,18683;18714;22326;22739,32485,0,1,3,0,4
54357,120,13161,18187;18574;22733,32485,0,1,2,0,3
54358,120,13162,18727;19057,32485,0,0,2,0,2
54359,120,13163,18739;19090;22453,32485,0,0,3,0,3
54360,120,13164,18964;22862,32485,0,1,1,0,2
54361,120,13166,13894,32850,0,0,0,1,1
54362,120,13167,13925,32850,0,0,0,1,1
54363,120,13168,14070,32850,0,0,0,1,1
54364,120,13169,14428,32850,0,0,0,1,1
54365,120,13170,14290,32850,0,0,0,1,1
54366,120,13175,14237,32850,0,0,0,1,1
54367,120,13178,15287,32850,0,0,0,1,1
54368,120,13179,14788;14875,32850,0,0,0,2,2
54369,120,13182,14545,32850,0,0,0,1,1
54370,120,13183,14534,32850,0,0,0,1,1
54371,120,13187,15840;16148,32850,0,0,0,2,2
54372,120,13188,16431,32850,0,0,0,1,1
54373,120,13192,16527,32850,0,0,0,1,1
54374,120,13193,16219;16321,32850,0,0,0,2,2
54375,120,13203,16790;17002,32850,0,0,0,2,2
54376,120,13206,17148;17379,32850,0,0,1,1,2
54377,120,13210,17493;17568;21538,32850,0,0,3,0,3
54378,120,13211,18026;22084,32850,0,0,2,0,2
54379,120,13214,17678;18205,32850,0,0,2,0,2
54380,120,13216,18198;18320,32850,0,0,2,0,2
54381,120,13217,17816;18315;22060,32850,0,0,3,0,3
54382,120,13218,17892;18211;22119;22507,32850,0,0,4,0,4
54383,120,13219,17518;17923,32850,0,0,2,0,2
54384,120,13220,18104;18498;22209;22841;23261,32850,0,2,3,0,5
54385,120,13222,17973;18403;22934,32850,0,1,2,0,3
54386,120,13223,18108,32850,0,0,1,0,1
54387,120,13224,17621;18001;22108;22398,32850,0,0,4,0,4
54388,120,13225,18033;21409,32850,0,0,2,0,2
54389,120,13226,17772;18076,32850,0,0,2,0,2
54390,120,13227,18238;18275;21641;22509;23039,32850,0,1,4,0,5
54391,120,13228,18069;18074;21676,32850,0,0,3,0,3
54392,120,13229,18289;18644,32850,0,0,2,0,2
54393,120,13230,18234;21822;22296,32850,0,0,3,0,3
54394,120,13231,18591;18684;22422;22520,32850,0,0,4,0,4
54395,120,13232,17894;18282;21630;22198;22726,32850,0,1,4,0,5
54396,120,13233,18286;22199,32850,0,0,2,0,2
54397,120,13234,17917;18310;21923,32850,0,0,3,0,3
54398,120,13235,17793;18354;22030;22179;22511;24417,32850,1,0,5,0,6
54399,120,13236,18362,32850,0,0,1,0,1
54400,120,13237,18366;18483;23042,32850,0,1,2,0,3
54401,120,13238,18516;18586;21876,32850,0,0,3,0,3
54402,120,13239,18239;18433,32850,0,0,2,0,2
54403,120,13240,18415;19038;22093,32850,0,0,3,0,3
54404,120,13241,18567;18811;22419,32850,0,0,3,0,3
54405,120,13242,18472,32850,0,0,1,0,1
54406,120,13243,18490;19032;21689;22450;22869;23471,32850,0,2,4,0,6
54407,120,13244,18254;18525;21869;22102,32850,0,0,4,0,4
54408,120,13245,18292;18962;22750;22861,32850,0,2,2,0,4
54409,120,13246,18492;18570;22420;22518,32850,0,0,4,0,4
54410,120,13247,18903;18987,32850,0,0,2,0,2
54411,120,13248,18352;18599,32850,0,0,2,0,2
54412,120,13249,18677;18793;22126;22437;22533;23051,32850,0,1,5,0,6
54413,120,13250,18627;18692;22432;22528;22738,32850,0,1,4,0,5
54414,120,13251,18648;18890;22645,32850,0,1,2,0,3
54415,120,13252,18500;18671;22057;22527;22630;24209;24309,32850,2,1,4,0,7
54416,120,13253,18638;18952;21210;24278,32850,1,0,3,0,4
54417,120,13254,18345;18680;22431;22736,32850,0,1,3,0,4
54418,120,13255,18682;21766,32850,0,0,2,0,2
54419,120,13256,18571;18651,32850,0,0,2,0,2
54420,120,13257,18556;18963;22950;23469,32850,0,2,2,0,4
54421,120,13258,18690;19006;23153,32850,0,1,2,0,3
54422,120,13259,18715;18883;22944,32850,0,1,2,0,3
54423,120,13260,18766;18838,32850,0,0,2,0,2
54424,120,13261,18770;22229;22334,32850,0,0,3,0,3
54425,120,13262,18774;19206,32850,0,0,2,0,2
54426,120,13263,18823,32850,0,0,1,0,1
54427,120,13264,18846;18980;22448,32850,0,0,3,0,3
54428,120,13265,18853;19151;22044;22365;22965,32850,0,1,4,0,5
54429,120,13266,18507;18849;21802,32850,0,0,3,0,3
54430,120,13268,14145,33215,0,0,0,1,1
54431,120,13270,14693,33215,0,0,0,1,1
54432,120,13273,14930,33215,0,0,0,1,1
54433,120,13280,15190,33215,0,0,0,1,1
54434,120,13284,15505,33215,0,0,0,1,1
54435,120,13292,15602;16051,33215,0,0,0,2,2
54436,120,13293,16078;16396,33215,0,0,0,2,2
54437,120,13304,16463;17083,33215,0,0,0,2,2
54438,120,13305,17199;17321,33215,0,0,1,1,2
54439,120,13306,16931,33215,0,0,0,1,1
54440,120,13308,17821;18231;21502;23260,33215,0,1,3,0,4
54441,120,13309,17531;17854;21325;21797,33215,0,0,4,0,4
54442,120,13311,18344;18410,33215,0,0,2,0,2
54443,120,13313,18371;21789,33215,0,0,2,0,2
54444,120,13314,18134;18545,33215,0,0,2,0,2
54445,120,13315,18060;18247,33215,0,0,2,0,2
54446,120,13316,18243;18253;22193,33215,0,0,3,0,3
54447,120,13317,18143;18264;21492,33215,0,0,3,0,3
54448,120,13318,18316;18564;22143;23263,33215,0,1,3,0,4
54449,120,13319,18337;18604;21257;22846,33215,0,1,3,0,4
54450,120,13320,18340;18788;21954;22336;22436,33215,0,0,5,0,5
54451,120,13322,18927;19010;22953,33215,0,1,2,0,3
54452,120,13323,18416;18418;21367;21770;22512,33215,0,0,5,0,5
54453,120,13324,18547;19021;21951;22868;22956,33215,0,2,3,0,5
54454,120,13325,18451;18625;21844;22729,33215,0,1,3,0,4
54455,120,13326,18552;18654;22427;22525,33215,0,0,4,0,4
54456,120,13328,18299;18617;22425,33215,0,0,3,0,3
54457,120,13329,18906;22537,33215,0,0,2,0,2
54458,120,13331,18645;18836;22130;23264,33215,0,1,3,0,4
54459,120,13332,19125;19161;22146;22247;22767;22875;23676,33215,0,3,4,0,7
54460,120,13333,18707;18848;21976;24414,33215,1,0,3,0,4
54461,120,13334,18742;19275;22778,33215,0,1,2,0,3
54462,120,13335,18902;18935;21816,33215,0,0,3,0,3
54463,120,13336,18750;18929;22160,33215,0,0,3,0,3
54464,120,13337,19315;21762,33215,0,0,2,0,2
54465,120,13338,18764;19121;22552;23069;23157,33215,0,2,3,0,5
54466,120,13339,18630;18914;21991;22747;24306,33215,1,1,3,0,5
54467,120,13340,18780;18896;22090;22234,33215,0,0,4,0,4
54468,120,13341,19048;19205,33215,0,0,2,0,2
54469,120,13342,18794;18922;23052,33215,0,1,2,0,3
54470,120,13343,19009;19027;22358;22759,33215,0,1,3,0,4
54471,120,13344,18831;19233,33215,0,0,2,0,2
54472,120,13345,18923;19087;22026;22764,33215,0,1,3,0,4
54473,120,13346,19168;19369;22876,33215,0,1,2,0,3
54474,120,13347,18875;18972;23268;23467,33215,0,2,2,0,4
54475,120,13348,18618;18886;21535;22020;23269;23468,33215,0,2,4,0,6
54476,120,13349,18900;18928,33215,0,0,2,0,2
54477,120,13350,18913;18965;21950;22443,33215,0,0,4,0,4
54478,120,13351,18891;18957;23152;23270,33215,0,2,2,0,4
54479,120,13352,18981;19299;21400;22566,33215,0,0,4,0,4
54480,120,13357,14124,33580,0,0,0,1,1
54481,120,13358,14465;15514,33580,0,0,0,2,2
54482,120,13361,14306,33580,0,0,0,1,1
54483,120,13374,15578,33580,0,0,0,1,1
54484,120,13376,14944,33580,0,0,0,1,1
54485,120,13379,15770,33580,0,0,0,1,1
54486,120,13382,16347,33580,0,0,0,1,1
54487,120,13386,15924,33580,0,0,0,1,1
54488,120,13387,15739,33580,0,0,0,1,1
54489,120,13389,17053,33580,0,0,0,1,1
54490,120,13395,16387;17055,33580,0,0,0,2,2
54491,120,13398,16837,33580,0,0,0,1,1
54492,120,13403,16989,33580,0,0,0,1,1
54493,120,13407,18015;18261,33580,0,0,2,0,2
54494,120,13408,17314,33580,0,0,1,0,1
54495,120,13410,17627;18312;22142,33580,0,0,3,0,3
54496,120,13413,17933;18020;21765;22112,33580,0,0,4,0,4
54497,120,13416,17908,33580,0,0,1,0,1
54498,120,13418,18038;18043,33580,0,0,2,0,2
54499,120,13419,18430,33580,0,0,1,0,1
54500,120,13420,17902;18146,33580,0,0,2,0,2
54501,120,13421,17439;17845,33580,0,0,2,0,2
54502,120,13422,18183,33580,0,0,1,0,1
54503,120,13423,18174;18202;21568,33580,0,0,3,0,3
54504,120,13425,17822;18229,33580,0,0,2,0,2
54505,120,13426,18304;21490;21947,33580,0,0,3,0,3
54506,120,13427,18308,33580,0,0,1,0,1
54507,120,13428,18314,33580,0,0,1,0,1
54508,120,13429,18474;18565,33580,0,0,2,0,2
54509,120,13430,18082;18373,33580,0,0,2,0,2
54510,120,13431,18053;18440,33580,0,0,2,0,2
54511,120,13432,18870;18897;22745,33580,0,1,2,0,3
54512,120,13433,18506;18868;21744;22342,33580,0,0,4,0,4
54513,120,13434,18514;18588;21655;22216;23465,33580,0,1,4,0,5
54514,120,13435,18531;18834;22642;22855,33580,0,2,2,0,4
54515,120,13436,18561;18606;22844;23044,33580,0,2,2,0,4
54516,120,13437,18569;19392;23283,33580,0,1,2,0,3
54517,120,13438,18892;19109;22766,33580,0,1,2,0,3
54518,120,13439,18607;19041;21358;21855,33580,0,0,4,0,4
54519,120,13440,18748;18812;22634;22853,33580,0,2,2,0,4
54520,120,13441,18398;19124;22131;22657,33580,0,1,3,0,4
54521,120,13442,18783;19354;22884,33580,0,1,2,0,3
54522,120,13443,18810;19269,33580,0,0,2,0,2
54523,120,13444,18696;18833;22046;22233;22339;22641,33580,0,1,5,0,6
54524,120,13445,18220;18867;21814;22110;22341;22536,33580,0,0,6,0,6
54525,120,13446,18893;18954;22860,33580,0,1,2,0,3
54526,120,13447,18904;19282;21665;22974,33580,0,1,3,0,4
54527,120,13448,18759;18907;22228;22435;22530;23370,33580,0,1,5,0,6
54528,120,13449,18918;22539,33580,0,0,2,0,2
54529,120,13450,18934;19185;21601;22773,33580,0,1,3,0,4
54530,120,13451,18939;18988;21697,33580,0,0,3,0,3
54531,120,13452,18943;19298;22881,33580,0,1,2,0,3
54532,120,13453,18958;19325;21943;22882;23278,33580,0,2,3,0,5
54533,120,13454,18537;19070,33580,0,0,2,0,2
54534,120,13455,18693;18995;22070;22652;22865;22952,33580,0,3,3,0,6
54535,120,13456,18773;19013;22356;22758;22955;23470,33580,0,3,3,0,6
54536,120,13457,19092;19242;23275,33580,0,1,2,0,3
54537,120,13458,18818;19017;22546,33580,0,0,3,0,3
54538,120,13459,19035;21618;22128,33580,0,0,3,0,3
54539,120,13460,18785;21368;23062;23271,33580,0,2,2,0,4
54540,120,13461,19093;19366,33580,0,0,2,0,2
54541,120,13462,19104;19435;21354;21444;21963;23173;23883,33580,0,2,5,0,7
54542,120,13464,14407,33945,0,0,0,1,1
54543,120,13465,14341,33945,0,0,0,1,1
54544,120,13468,14157,33945,0,0,0,1,1
54545,120,13471,14399,33945,0,0,0,1,1
54546,120,13472,14652,33945,0,0,0,1,1
54547,120,13477,15612,33945,0,0,0,1,1
54548,120,13478,15804,33945,0,0,0,1,1
54549,120,13479,15825,33945,0,0,0,1,1
54550,120,13492,16348;16444,33945,0,0,0,2,2
54551,120,13496,17174;17281,33945,0,0,1,1,2
54552,120,13499,17415,33945,0,0,1,0,1
54553,120,13502,17459;17676,33945,0,0,2,0,2
54554,120,13505,17530;17876,33945,0,0,2,0,2
54555,120,13506,17502;17600,33945,0,0,2,0,2
54556,120,13508,17809,33945,0,0,1,0,1
54557,120,13509,18493,33945,0,0,1,0,1
54558,120,13510,17273;17691,33945,0,0,2,0,2
54559,120,13511,17751;17814,33945,0,0,2,0,2
54560,120,13512,18065;18454;22304,33945,0,0,3,0,3
54561,120,13514,18115;18327,33945,0,0,2,0,2
54562,120,13515,18417;18724;22529;23048,33945,0,1,3,0,4
54563,120,13516,17979;18181,33945,0,0,2,0,2
54564,120,13517,18319;18447;22623,33945,0,1,2,0,3
54565,120,13518,18488;22840,33945,0,1,1,0,2
54566,120,13519,18325;22201,33945,0,0,2,0,2
54567,120,13520,18085;18401;22207,33945,0,0,3,0,3
54568,120,13521,18190;18414;22038;22403,33945,0,0,4,0,4
54569,120,13522,18455;18767;21614,33945,0,0,3,0,3
54570,120,13526,18283;18521;22139;22310,33945,0,0,4,0,4
54571,120,13527,18542;18544,33945,0,0,2,0,2
54572,120,13528,18268;18554;22940,33945,0,1,2,0,3
54573,120,13529,17849;18080;21983;22174;24206,33945,1,0,4,0,5
54574,120,13530,18585,33945,0,0,1,0,1
54575,120,13531,18295;18589;22421;22519;22734,33945,0,1,4,0,5
54576,120,13532,18481;18595;22521,33945,0,0,3,0,3
54577,120,13533,18489;18608;22318,33945,0,0,3,0,3
54578,120,13534,18037;18623;22523,33945,0,0,3,0,3
54579,120,13536,18600;18956,33945,0,0,2,0,2
54580,120,13537,18530;18950;21456;22232;22647,33945,0,1,4,0,5
54581,120,13539,17903;18758;21893;23466,33945,0,1,3,0,4
54582,120,13540,18347;18775;21685;22230,33945,0,0,4,0,4
54583,120,13541,19302;19318;21556,33945,0,0,3,0,3
54584,120,13542,18379;18795,33945,0,0,2,0,2
54585,120,13543,18555;18771;22158,33945,0,0,3,0,3
54586,120,13544,18806;19195;22660;22877;24316,33945,1,2,2,0,5
54587,120,13545,18466;18970;22348;22648,33945,0,1,3,0,4
54588,120,13546,18842;18917;22066,33945,0,0,3,0,3
54589,120,13547,18587;18858;22215;22942,33945,0,1,3,0,4
54590,120,13548,18860;19073;21469;22362,33945,0,0,4,0,4
54591,120,13549,19054;19172;22460;22772,33945,0,1,3,0,4
54592,120,13550,19279;19400;22980;23169,33945,0,2,2,0,4
54593,120,13551,18640;19050;23063,33945,0,1,2,0,3
54594,120,13552,18921;19111;21696,33945,0,0,3,0,3
54595,120,13553,18924;19007;21941;22235;22646,33945,0,1,4,0,5
54596,120,13554,18541;18944;22540;22858,33945,0,1,3,0,4
54597,120,13555,18672;21966;22554;22967,33945,0,1,3,0,4
54598,120,13556,18688;18978;22156;22350;22752,33945,0,1,4,0,5
54599,120,13557,18899;19002;22755,33945,0,1,2,0,3
54600,120,13558,19019;19065,33945,0,0,2,0,2
54601,120,13559,18756;19024;22957,33945,0,1,2,0,3
54602,120,13561,19228;19376;21999;22375,33945,0,0,4,0,4
54603,120,13562,18854;18982;21889;21944;22351;22651;22753;22863,33945,0,3,5,0,8
54604,120,13563,19080;19391;22779;23082;23681,33945,0,3,2,0,5
54605,120,13564,18584;19084;22762;22872,33945,0,2,2,0,4
54606,120,13565,18933;19086;22763,33945,0,1,2,0,3
54607,120,13566,18679;19096;22655;22765;22963;23674,33945,0,4,2,0,6
54608,120,13567,18997;19098,33945,0,0,2,0,2
54609,120,13568,18809;19099;23156,33945,0,1,2,0,3
54610,120,13569,18730;19427;23387,33945,0,1,2,0,3
54611,120,13570,19067;19115;22243;23065,33945,0,1,3,0,4
54612,120,13571,19141;19464;22679;23287,33945,0,2,2,0,4
54613,120,13572,19142;19378;22072;23168;23384;23477;23680,33945,0,4,3,0,7
54614,120,13573,18813;19173;22366,33945,0,0,3,0,3
54615,120,13574,18731;19434;21783;22024;23172,33945,0,1,4,0,5
54616,120,13575,19310;19550;21755;23089;23482,33945,0,2,3,0,5
54617,120,13585,15152,34310,0,0,0,1,1
54618,120,13586,15412,34310,0,0,0,1,1
54619,120,13588,15252,34310,0,0,0,1,1
54620,120,13595,15896,34310,0,0,0,1,1
54621,120,13599,16086;16313,34310,0,0,0,2,2
54622,120,13604,16911;17008,34310,0,0,0,2,2
54623,120,13605,17040,34310,0,0,0,1,1
54624,120,13609,16626,34310,0,0,0,1,1
54625,120,13610,17246;17993,34310,0,0,1,1,2
54626,120,13611,17169;22004,34310,0,0,1,1,2
54627,120,13612,17027;17404,34310,0,0,1,1,2
54628,120,13616,17473,34310,0,0,1,0,1
54629,120,13617,18526;21678;22625,34310,0,1,2,0,3
54630,120,13618,17799;17805;21639,34310,0,0,3,0,3
54631,120,13619,18137,34310,0,0,1,0,1
54632,120,13621,17899;21781,34310,0,0,2,0,2
54633,120,13622,17974;18153,34310,0,0,2,0,2
54634,120,13623,17632;17955;22153,34310,0,0,3,0,3
54635,120,13624,17826;17992,34310,0,0,2,0,2
54636,120,13627,17806;18051;22724,34310,0,1,2,0,3
54637,120,13628,18124;18534;22517,34310,0,0,3,0,3
54638,120,13629,18363;18412;21569;21749,34310,0,0,4,0,4
54639,120,13631,18528;22418;22731,34310,0,1,2,0,3
54640,120,13632,17912;18297,34310,0,0,2,0,2
54641,120,13633,17885;18073,34310,0,0,2,0,2
54642,120,13634,18462;18670;22077;22430;23368,34310,0,1,4,0,5
54643,120,13635,17783;18376,34310,0,0,2,0,2
54644,120,13638,18557;18642;21555;22848;23148,34310,0,2,3,0,5
54645,120,13639,18647;22141;22628;24422,34310,1,1,2,0,4
54646,120,13640,18540;18659;21862,34310,0,0,3,0,3
54647,120,13642,18942;19030;22547;22654;22960;23061,34310,0,3,3,0,6
54648,120,13644,18741;21998;22434,34310,0,0,3,0,3
54649,120,13645,19083;19103,34310,0,0,2,0,2
54650,120,13646,18653;22122;22320,34310,0,0,3,0,3
54651,120,13647,18830;22743,34310,0,1,1,0,2
54652,120,13648,18464;18814;22338;22638;22742;22854,34310,0,3,3,0,6
54653,120,13649,18871;19230,34310,0,0,2,0,2
54654,120,13651,18839;18911,34310,0,0,2,0,2
54655,120,13652,19280;22371;22463;22663,34310,0,1,3,0,4
54656,120,13653,19129;19582;21971,34310,0,0,3,0,3
54657,120,13655,18960;19537;21605;22685,34310,0,1,3,0,4
54658,120,13656,18708;19036;22451;22870,34310,0,1,3,0,4
54659,120,13658,18985;19053;21924;23064;23155,34310,0,2,3,0,5
54660,120,13659,19016;19117;22551,34310,0,0,3,0,3
54661,120,13660,18760;19039,34310,0,0,2,0,2
54662,120,13662,18776;19051;22000;22361;22961,34310,0,1,4,0,5
54663,120,13663,19055;19163;22457;23159;23377,34310,0,2,3,0,5
54664,120,13664,18991;19061;21693,34310,0,0,3,0,3
54665,120,13665,18932;19131;22768,34310,0,1,2,0,3
54666,120,13666,19381;19500;21546;22790;23177,34310,0,2,3,0,5
54667,120,13667,19108;19398;23682,34310,0,1,2,0,3
54668,120,13669,19138;19145;21686;24401,34310,1,0,3,0,4
54669,120,13670,19159;19221;22558;23075;23161,34310,0,2,3,0,5
54670,120,13671,19004;19169;22771;23378;23894,34310,1,2,2,0,5
54671,120,13672,19180;19425;21650;22473;22675;23585,34310,0,2,4,0,6
54672,120,13673,19200;19411;21611;22570;22887;23774,34310,0,2,4,0,6
54673,120,13674,18885;19209,34310,0,0,2,0,2
54674,120,13675,19120;19216;23068,34310,0,1,2,0,3
54675,120,13676,19219;19667;21752;23296,34310,0,1,3,0,4
54676,120,13677,19255;19448;22784;23685,34310,0,2,2,0,4
54677,120,13678,19178;19261;21985;22562;22973,34310,0,1,4,0,5
54678,120,13679,19518;19522;22377;22684;23180,34310,0,2,3,0,5
54679,120,13680,19167;19272;22458;22770;22968,34310,0,2,3,0,5
54680,120,13681,14725;14759,34675,0,0,0,2,2
54681,120,13685,15048,34675,0,0,0,1,1
54682,120,13686,15662,34675,0,0,0,1,1
54683,120,13690,15952,34675,0,0,0,1,1
54684,120,13692,16036;16161,34675,0,0,0,2,2
54685,120,13693,16256,34675,0,0,0,1,1
54686,120,13695,16141,34675,0,0,0,1,1
54687,120,13708,17712,34675,0,0,1,0,1
54688,120,13709,18089;18480;22096,34675,0,0,3,0,3
54689,120,13710,17669,34675,0,0,1,0,1
54690,120,13711,18543,34675,0,0,1,0,1
54691,120,13712,18317;18408,34675,0,0,2,0,2
54692,120,13717,18476;18582,34675,0,0,2,0,2
54693,120,13718,18598;18701;22845,34675,0,1,2,0,3
54694,120,13719,18631;18919;22857;23054,34675,0,2,2,0,4
54695,120,13721,18695;18938,34675,0,0,2,0,2
54696,120,13722,18449;18703;22632,34675,0,1,2,0,3
54697,120,13723,18729;18736,34675,0,0,2,0,2
54698,120,13725,18820;19374;21925;22671;22978,34675,0,2,3,0,5
54699,120,13726,19365;23167,34675,0,1,1,0,2
54700,120,13727,19258;19718;23276,34675,0,1,2,0,3
54701,120,13728,18948;19247,34675,0,0,2,0,2
54702,120,13729,18856;18930;22439,34675,0,0,3,0,3
54703,120,13730,18593;18862;22948,34675,0,1,2,0,3
54704,120,13731,19126;19270;22248;22553;22658;23070,34675,0,2,4,0,6
54705,120,13732,18961;18975;22006;22543;23057,34675,0,1,4,0,5
54706,120,13733,18973;18986,34675,0,0,2,0,2
54707,120,13734,18901;18992;22352;22449;22864;23374,34675,0,2,4,0,6
54708,120,13735,19068;19220;22775,34675,0,1,2,0,3
54709,120,13736,19069;19503;23178,34675,0,1,2,0,3
54710,120,13737,19114;22455;22656;23472,34675,0,2,2,0,4
54711,120,13738,19147;19379;23282;23385,34675,0,2,2,0,4
54712,120,13739,19088;19158;23072,34675,0,1,2,0,3
54713,120,13740,18879;19438;22677;22783;22984,34675,0,3,2,0,5
54714,120,13741,19232;19507;23785,34675,0,1,2,0,3
54715,120,13742,19182;19512;21811;22683;23087,34675,0,2,3,0,5
54716,120,13743,19082;19278;22564;23162,34675,0,1,3,0,4
54717,120,13744,19419;22571;23284,34675,0,1,2,0,3
54718,120,13745,19307;19436;22975,34675,0,1,2,0,3
54719,120,13746,18649;19332;22019;23078;23164,34675,0,2,3,0,5
54720,120,13747,19353;19554;23289;23687,34675,0,2,2,0,4
54721,120,13748,18878;19384;23386,34675,0,1,2,0,3
54722,120,13749,19429;19433;22572,34675,0,0,3,0,3
54723,120,13750,14673,35040,0,0,0,1,1
54724,120,13754,14776,35040,0,0,0,1,1
54725,120,13756,14764,35040,0,0,0,1,1
54726,120,13757,15346,35040,0,0,0,1,1
54727,120,13760,15402;15523,35040,0,0,0,2,2
54728,120,13761,15558;15781,35040,0,0,0,2,2
54729,120,13764,15470;15568,35040,0,0,0,2,2
54730,120,13769,16089,35040,0,0,0,1,1
54731,120,13771,16182,35040,0,0,0,1,1
54732,120,13793,18066;21860;22050;24419,35040,1,0,3,0,4
54733,120,13797,17925;18343,35040,0,0,2,0,2
54734,120,13799,18213;18311,35040,0,0,2,0,2
54735,120,13803,18523;22135;23146,35040,0,1,2,0,3
54736,120,13804,18184;18458;21880,35040,0,0,3,0,3
54737,120,13805,18191;22411,35040,0,0,2,0,2
54738,120,13806,18222;18432,35040,0,0,2,0,2
54739,120,13807,18271;18622,35040,0,0,2,0,2
54740,120,13809,18633,35040,0,0,1,0,1
54741,120,13811,18470;22838;22935,35040,0,2,1,0,3
54742,120,13812,18529;22938,35040,0,1,1,0,2
54743,120,13814,18546;18916,35040,0,0,2,0,2
54744,120,13815,19199;19229;21993;22559;22776,35040,0,1,4,0,5
54745,120,13816,18925;19197;22052;23055,35040,0,1,3,0,4
54746,120,13817,18602;18667;22220;22850,35040,0,1,3,0,4
54747,120,13818,18722;18835;22327,35040,0,0,3,0,3
54748,120,13819,18763;19091;22364,35040,0,0,3,0,3
54749,120,13820,18787;19077;22363;22962;23376,35040,0,2,3,0,5
54750,120,13821,18845;19160;22966;23677,35040,0,2,2,0,4
54751,120,13822,18711;18881,35040,0,0,2,0,2
54752,120,13823,18613;18920,35040,0,0,2,0,2
54753,120,13824,19155;19521,35040,0,0,2,0,2
54754,120,13825,18979;19246;22561;22879,35040,0,1,3,0,4
54755,120,13826,18989;19154;22545,35040,0,0,3,0,3
54756,120,13827,18616;19011,35040,0,0,2,0,2
54757,120,13828,19288;19360;22470,35040,0,0,3,0,3
54758,120,13829,18976;19042,35040,0,0,2,0,2
54759,120,13830,19226;19494;23898,35040,1,0,2,0,3
54760,120,13831,19049;19130;22548,35040,0,0,3,0,3
54761,120,13832,19074;19157;22245;22761;23066,35040,0,2,3,0,5
54762,120,13833,18535;19112;22246;22550,35040,0,0,4,0,4
54763,120,13834,19638;22480,35040,0,0,2,0,2
54764,120,13835,19152;19612;22088,35040,0,0,3,0,3
54765,120,13836,18847;19196;23380,35040,0,1,2,0,3
54766,120,13837,19316;19388,35040,0,0,2,0,2
54767,120,13838,18603;19213;22557;23381,35040,0,1,3,0,4
54768,120,13839,19181;19244;22560;22972,35040,0,1,3,0,4
54769,120,13840,19273;19865;23410,35040,0,1,2,0,3
54770,120,13841,19277;19495;22789,35040,0,1,2,0,3
54771,120,13842,19286;19382;23783,35040,0,1,2,0,3
54772,120,13843,19698,35040,0,0,1,0,1
54773,120,13844,19293;22251;22880;23077,35040,0,2,2,0,4
54774,120,13845,18832;19303;22567,35040,0,0,3,0,3
54775,120,13846,18632;19123,35040,0,0,2,0,2
54776,120,13847,18837;19317;21965;22667;23781,35040,0,2,3,0,5
54777,120,13848,19257;19785;23303,35040,0,1,2,0,3
54778,120,13849,19294;19350,35040,0,0,2,0,2
54779,120,13850,19165;19352;22254;22976;23280;23679;23782;23897,35040,1,4,3,0,8
54780,120,13851,19214;19313;22369,35040,0,0,3,0,3
54781,120,13852,19803;19853;22029;23598,35040,0,1,3,0,4
54782,120,13853,19262;19561;21958;22687;23392,35040,0,2,3,0,5
54783,120,13854,19492;19781;23595,35040,0,1,2,0,3
54784,120,13855,19442;19837;22810;24105,35040,1,1,2,0,4
54785,120,13858,19675;23400,35040,0,1,1,0,2
54786,120,13859,19472;19757;22581;22808;23594;23694;23792,35040,0,4,3,0,7
54787,120,13860,19331;19474;22681;22988;23175,35040,0,3,2,0,5
54788,120,13861,19767,35040,0,0,1,0,1
54789,120,13862,19734;19846;23309;23798;24015,35040,1,2,2,0,5
54790,120,13863,19407;19491;21877;22476;23288;23390;23481,35040,0,3,4,0,7
54791,120,13864,19396;19529;22575;23088,35040,0,1,3,0,4
54792,120,13865,19535;19619;21938;22992;23786,35040,0,2,3,0,5
54793,120,13866,19708;22899;22999;23095;24013,35040,1,3,1,0,5
54794,120,13867,19467;19560;21848,35040,0,0,3,0,3
54795,120,13871,15452,35405,0,0,0,1,1
54796,120,13872,15272;15623,35405,0,0,0,2,2
54797,120,13873,15157,35405,0,0,0,1,1
54798,120,13875,15283,35405,0,0,0,1,1
54799,120,13876,15477;15478,35405,0,0,0,2,2
54800,120,13878,15445;15792,35405,0,0,0,2,2
54801,120,13879,15926,35405,0,0,0,1,1
54802,120,13881,16102,35405,0,0,0,1,1
54803,120,13884,15418;15655,35405,0,0,0,2,2
54804,120,13886,16601;16826,35405,0,0,0,2,2
54805,120,13888,15878,35405,0,0,0,1,1
54806,120,13896,17234,35405,0,0,0,1,1
54807,120,13898,17335;17375;22161,35405,0,0,3,0,3
54808,120,13899,17438,35405,0,0,1,0,1
54809,120,13905,17466;17970,35405,0,0,2,0,2
54810,120,13908,17668;18017;22182,35405,0,0,3,0,3
54811,120,13910,18230;18236;21979,35405,0,0,3,0,3
54812,120,13911,18244;18374,35405,0,0,2,0,2
54813,120,13912,18619;22522,35405,0,0,2,0,2
54814,120,13915,18117;18827;23150,35405,0,1,2,0,3
54815,120,13917,18620,35405,0,0,1,0,1
54816,120,13918,18388;22416,35405,0,0,2,0,2
54817,120,13919,18349;18517;22417,35405,0,0,3,0,3
54818,120,13920,18532;18757;22015;23049,35405,0,1,3,0,4
54819,120,13921,18553;19044;23375,35405,0,1,2,0,3
54820,120,13922,18579;19094,35405,0,0,2,0,2
54821,120,13924,18624;18718;21962;22851;23369,35405,0,2,3,0,5
54822,120,13925,18626;21930;22219;22735,35405,0,1,3,0,4
54823,120,13926,18629;19223;22971,35405,0,1,2,0,3
54824,120,13927,18597;18735,35405,0,0,2,0,2
54825,120,13928,18796;19287;22565;22665;23583,35405,0,2,3,0,5
54826,120,13929,18816,35405,0,0,1,0,1
54827,120,13931,18851,35405,0,0,1,0,1
54828,120,13932,18549;22732,35405,0,1,1,0,2
54829,120,13933,18728;19156;22769,35405,0,1,2,0,3
54830,120,13934,18880;22441,35405,0,0,2,0,2
54831,120,13935,19031;19444;22888,35405,0,1,2,0,3
54832,120,13936,18333;19037;22452;23580,35405,0,1,3,0,4
54833,120,13937,19162;19533;23181,35405,0,1,2,0,3
54834,120,13938,19204;19356;21961;22368;23474;24303,35405,1,1,4,0,6
54835,120,13939,19412;19654;22695;23189,35405,0,2,2,0,4
54836,120,13940,18863;19194;23473,35405,0,1,2,0,3
54837,120,13941,19132;19662,35405,0,0,2,0,2
54838,120,13942,18732;19283;22372;22464;22664;23163;23780;24005,35405,1,3,4,0,8
54839,120,13943,18637;19192;22099;22556;24310,35405,1,0,4,0,5
54840,120,13945,19231;23382,35405,0,1,1,0,2
54841,120,13946,19100;19254,35405,0,0,2,0,2
54842,120,13947,19025;19285;22373,35405,0,0,3,0,3
54843,120,13948,19656;23690;24011,35405,1,1,1,0,3
54844,120,13949,19308;19422;22472,35405,0,0,3,0,3
54845,120,13950,19266;19351;22370;22563;22662,35405,0,1,4,0,5
54846,120,13951,19166;19368;22568;22885,35405,0,1,3,0,4
54847,120,13952,19578;22477;22795,35405,0,1,2,0,3
54848,120,13953,19431;19882;23601,35405,0,1,2,0,3
54849,120,13954,19397;19990;22001;23517;23705,35405,0,2,3,0,5
54850,120,13955,19212;19417;22087,35405,0,0,3,0,3
54851,120,13957,18909;19238;22878,35405,0,1,2,0,3
54852,120,13958,19306;19679;23901,35405,1,0,2,0,3
54853,120,13959,19274,35405,0,0,1,0,1
54854,120,13960,19684;19753;22579;23790,35405,0,1,3,0,4
54855,120,13961,19253;19568;23290,35405,0,1,2,0,3
54856,120,13962,19225;19577;23292,35405,0,1,2,0,3
54857,120,13963,19320;19581;23184;23689,35405,0,2,2,0,4
54858,120,13964,19611;23396,35405,0,1,1,0,2
54859,120,13965,19548;19641;22993,35405,0,1,2,0,3
54860,120,13966,19215;19634;21928;22692,35405,0,1,3,0,4
54861,120,13967,19513;19993;22812;22910;23518;23706,35405,0,4,2,0,6
54862,120,13968,19680;19889,35405,0,0,2,0,2
54863,120,13969,14624,35770,0,0,0,1,1
54864,120,13970,15062,35770,0,0,0,1,1
54865,120,13971,15088,35770,0,0,0,1,1
54866,120,13972,14926,35770,0,0,0,1,1
54867,120,13973,15242,35770,0,0,0,1,1
54868,120,13974,15254,35770,0,0,0,1,1
54869,120,13978,15313,35770,0,0,0,1,1
54870,120,13980,15446,35770,0,0,0,1,1
54871,120,13983,16077,35770,0,0,0,1,1
54872,120,13989,15960,35770,0,0,0,1,1
54873,120,13992,16400;16586,35770,0,0,0,2,2
54874,120,13996,16476;16749,35770,0,0,0,2,2
54875,120,14004,17277;17374,35770,0,0,2,0,2
54876,120,14007,17456;17672,35770,0,0,2,0,2
54877,120,14009,17553,35770,0,0,1,0,1
54878,120,14011,17852;18487;22624,35770,0,1,2,0,3
54879,120,14012,17931;18335,35770,0,0,2,0,2
54880,120,14021,18383;18444;22127;24311,35770,1,0,3,0,4
54881,120,14023,18241;18450,35770,0,0,2,0,2
54882,120,14024,18307;18494;22152,35770,0,0,3,0,3
54883,120,14027,18734;19072;22244;23272,35770,0,1,3,0,4
54884,120,14028,18661;18781;22086;22635,35770,0,1,3,0,4
54885,120,14029,19045;19264;22462;23277,35770,0,1,3,0,4
54886,120,14030,18657;19186;22367;22555;22659,35770,0,1,4,0,5
54887,120,14032,18937;19095;23273,35770,0,1,2,0,3
54888,120,14033,19881;22120;23007;23699,35770,0,2,2,0,4
54889,120,14034,18999;19268,35770,0,0,2,0,2
54890,120,14035,19028;19358;22958,35770,0,1,2,0,3
54891,120,14036,18931;18959,35770,0,0,2,0,2
54892,120,14038,19295;22465,35770,0,0,2,0,2
54893,120,14039,18908;19179;23160,35770,0,1,2,0,3
54894,120,14040,19187;19527;22890,35770,0,1,2,0,3
54895,120,14042,19217;19324;22467,35770,0,0,3,0,3
54896,120,14043,19754;23301,35770,0,1,1,0,2
54897,120,14045,19256;19413;22982,35770,0,1,2,0,3
54898,120,14046,19202;19259,35770,0,0,2,0,2
54899,120,14047,19106;19260;22454;23581,35770,0,1,3,0,4
54900,120,14048,19511;19627;23086;23179,35770,0,2,2,0,4
54901,120,14049,19281;19824;23507,35770,0,1,2,0,3
54902,120,14050,19304;19609;22893;23185;23395,35770,0,3,2,0,5
54903,120,14051,19135;19489;22257;23085;23480,35770,0,2,3,0,5
54904,120,14052,19289;19361,35770,0,0,2,0,2
54905,120,14053,19319;19552;23183,35770,0,1,2,0,3
54906,120,14055,19530;19828;22583;23795,35770,0,1,3,0,4
54907,120,14056,19454;19499;22682,35770,0,1,2,0,3
54908,120,14057,19517;19902;23513,35770,0,1,2,0,3
54909,120,14058,19520;19778;23504,35770,0,1,2,0,3
54910,120,14059,19832;22902;23409;23906,35770,1,2,1,0,4
54911,120,14061,19534;19565,35770,0,0,2,0,2
54912,120,14062,19587;19705;22690;23590,35770,0,2,2,0,4
54913,120,14063,19615;22894,35770,0,1,1,0,2
54914,120,14064,19632;19943;22150,35770,0,0,3,0,3
54915,120,14065,19691;20077;22115;23110,35770,0,1,3,0,4
54916,120,14066,19249;19702;22804;22898;22998;23493,35770,0,4,2,0,6
54917,120,14067,19330;19704,35770,0,0,2,0,2
54918,120,14068,19207;19710;22580;23000;23096,35770,0,2,3,0,5
54919,120,14069,19712;22486,35770,0,0,2,0,2
54920,120,14070,18697;19726;22488;23299;23497,35770,0,2,3,0,5
54921,120,14071,19739;22806;23499,35770,0,2,1,0,3
54922,120,14072,18949;19505,35770,0,0,2,0,2
54923,120,14073,19847;20143;23825,35770,0,1,2,0,3
54924,120,14074,19759;19970,35770,0,0,2,0,2
54925,120,14075,20099;20134;23425,35770,0,1,2,0,3
54926,120,14076,19471;19780;22383,35770,0,0,3,0,3
54927,120,14077,19364;19380;22471,35770,0,0,3,0,3
54928,120,14080,15357,36135,0,0,0,1,1
54929,120,14081,15731,36135,0,0,0,1,1
54930,120,14083,15800,36135,0,0,0,1,1
54931,120,14084,15759,36135,0,0,0,1,1
54932,120,14085,15767,36135,0,0,0,1,1
54933,120,14089,16434,36135,0,0,0,1,1
54934,120,14094,16274,36135,0,0,0,1,1
54935,120,14112,18063;18473;22515,36135,0,0,3,0,3
54936,120,14113,17867,36135,0,0,1,0,1
54937,120,14114,18118;18499,36135,0,0,2,0,2
54938,120,14117,18141;18824,36135,0,0,2,0,2
54939,120,14121,18024;18420;22513,36135,0,0,3,0,3
54940,120,14123,18803;18998;22353;22754;22866,36135,0,2,3,0,5
54941,120,14126,18605;18857,36135,0,0,2,0,2
54942,120,14127,18650;19290;23076,36135,0,1,2,0,3
54943,120,14128,18665;18675,36135,0,0,2,0,2
54944,120,14129,18709,36135,0,0,1,0,1
54945,120,14130,18777,36135,0,0,1,0,1
54946,120,14134,18573;18765,36135,0,0,2,0,2
54947,120,14135,18817;18940;22345,36135,0,0,3,0,3
54948,120,14136,18894;18947;22346,36135,0,0,3,0,3
54949,120,14137,18977;19136;22544,36135,0,0,3,0,3
54950,120,14138,18819;18974;22447;22650;22751,36135,0,2,3,0,5
54951,120,14141,19428;19539;22793,36135,0,1,2,0,3
54952,120,14142,19085;19606;22892;23394,36135,0,2,2,0,4
54953,120,14143,19150;19478,36135,0,0,2,0,2
54954,120,14145,19078;19239;23678,36135,0,1,2,0,3
54955,120,14147,19252;19934,36135,0,0,2,0,2
54956,120,14150,19729;23198,36135,0,1,1,0,2
54957,120,14151,19488,36135,0,0,1,0,1
54958,120,14152,19208;19337;22253;23896,36135,1,0,3,0,4
54959,120,14153,19485;22990;24006,36135,1,1,1,0,3
54960,120,14154,18673;19357;23081;23166,36135,0,2,2,0,4
54961,120,14156,19227;19403;23170,36135,0,1,2,0,3
54962,120,14157,19291;19408;22981;23171;23784,36135,0,3,2,0,5
54963,120,14159,19235;19423,36135,0,0,2,0,2
54964,120,14160,19768;23098,36135,0,1,1,0,2
54965,120,14161,19484;19771,36135,0,0,2,0,2
54966,120,14162,19250;20024;23214;23519;23707;24317,36135,1,3,2,0,6
54967,120,14163,19349;19516;22374;22469;23080,36135,0,1,4,0,5
54968,120,14165,18882;19536;22258,36135,0,0,3,0,3
54969,120,14166,19555;19756;22382;22807;23904,36135,1,1,3,0,5
54970,120,14167,19816;19871;22585;23511,36135,0,1,3,0,4
54971,120,14168,19333;19840;23203;23695;23796,36135,0,3,2,0,5
54972,120,14170,19635;19685;22895;23193,36135,0,2,2,0,4
54973,120,14171,19819;19903,36135,0,0,2,0,2
54974,120,14172,19404;19646;22482;22693;24009,36135,1,1,3,0,5
54975,120,14173,19659;19895;23412;23512,36135,0,2,2,0,4
54976,120,14175,19690,36135,0,0,1,0,1
54977,120,14176,19580;19695,36135,0,0,2,0,2
54978,120,14177,19927;20154,36135,0,0,2,0,2
54979,120,14178,19751;20210;23620,36135,0,1,2,0,3
54980,120,14179,19788,36135,0,0,1,0,1
54981,120,14180,19263;19605;22798,36135,0,1,2,0,3
54982,120,14181,19747;19839,36135,0,0,2,0,2
54983,120,14182,19852;19905;23206,36135,0,1,2,0,3
54984,120,14183,19855;19856;23204;23799,36135,0,2,2,0,4
54985,120,14184,19761;19874;23600;23698,36135,0,2,2,0,4
54986,120,14185,19649;19885;23411;23602,36135,0,2,2,0,4
54987,120,14186,19890;19948;23106,36135,0,1,2,0,3
54988,120,14187,19599;22259;22576;22797,36135,0,1,3,0,4
54989,120,14188,19911;20047,36135,0,0,2,0,2
54990,120,14189,19914;20031;22706;23103,36135,0,2,2,0,4
54991,120,14190,14918,36500,0,0,0,1,1
54992,120,14192,15345,36500,0,0,0,1,1
54993,120,14193,14857,36500,0,0,0,1,1
54994,120,14194,15479,36500,0,0,0,1,1
54995,120,14195,15592,36500,0,0,0,1,1
54996,120,14196,15637,36500,0,0,0,1,1
54997,120,14197,15711,36500,0,0,0,1,1
54998,120,14198,15932,36500,0,0,0,1,1
54999,120,14199,15574,36500,0,0,0,1,1
55000,120,14200,16094,36500,0,0,0,1,1
55001,120,14206,16429,36500,0,0,0,1,1
55002,120,14207,16495,36500,0,0,0,1,1
55003,120,14209,16530;16557,36500,0,0,0,2,2
55004,120,14214,16621;16660,36500,0,0,0,2,2
55005,120,14222,17927,36500,0,0,1,0,1
55006,120,14223,17159;17408,36500,0,0,1,1,2
55007,120,14225,17350,36500,0,0,1,0,1
55008,120,14228,18348;18866;22340,36500,0,0,3,0,3
55009,120,14229,18372;18463,36500,0,0,2,0,2
55010,120,14232,18509;18738;22433,36500,0,0,3,0,3
55011,120,14233,18423;18572,36500,0,0,2,0,2
55012,120,14234,18815;22639,36500,0,1,1,0,2
55013,120,14236,18704;19097,36500,0,0,2,0,2
55014,120,14238,18743;19116;23067;23274,36500,0,2,2,0,4
55015,120,14239,18865;19218;22461;22774,36500,0,1,3,0,4
55016,120,14240,18841;18887,36500,0,0,2,0,2
55017,120,14244,19020;22867;23673,36500,0,2,1,0,3
55018,120,14245,19022;19682;22485;22697;22802;23191;23297;23489,36500,0,5,3,0,8
55019,120,14247,19693;19717;22900,36500,0,1,2,0,3
55020,120,14248,19234;19963;23608,36500,0,1,2,0,3
55021,120,14249,19143;19312;22466;22666,36500,0,1,3,0,4
55022,120,14250,19314;19322,36500,0,0,2,0,2
55023,120,14251,19323;19420;22256;22781,36500,0,1,3,0,4
55024,120,14252,18660;19395;24101,36500,1,0,2,0,3
55025,120,14253,19924;22906,36500,0,1,1,0,2
55026,120,14254,19341;19556;23079;23383;23475;23584,36500,0,4,2,0,6
55027,120,14255,19345;19713;23404,36500,0,1,2,0,3
55028,120,14256,19385;19575,36500,0,0,2,0,2
55029,120,14257,19389;19854,36500,0,0,2,0,2
55030,120,14258,19393;19583;24007,36500,1,0,2,0,3
55031,120,14259,18984;19399,36500,0,0,2,0,2
55032,120,14260,19844;22584;23308,36500,0,1,2,0,3
55033,120,14261,19440;19553;22686,36500,0,1,2,0,3
55034,120,14262,19515;22991;23588;23686,36500,0,3,1,0,4
55035,120,14263,19461;19644;22787;23286;23388,36500,0,3,2,0,5
55036,120,14264,19056;19469;22987;23479,36500,0,2,2,0,4
55037,120,14265,19496;19604,36500,0,0,2,0,2
55038,120,14266,19497;19825;22262;23408;23508;23794,36500,0,3,3,0,6
55039,120,14267,19628;19664;22483;23295;23789,36500,0,2,3,0,5
55040,120,14269,19595;19597,36500,0,0,2,0,2
55041,120,14270,19873;23599;24216,36500,1,1,1,0,3
55042,120,14271,19432;19650;22694;23294;24010,36500,1,2,2,0,5
55043,120,14273,20027,36500,0,0,1,0,1
55044,120,14274,19377;19653;23486;24104,36500,1,1,2,0,4
55045,120,14275,19066;19666;22801;23399;23487,36500,0,3,2,0,5
55046,120,14276,19483;19714;22487;23195;23405;23791,36500,0,3,3,0,6
55047,120,14277,19309;19835,36500,0,0,2,0,2
55048,120,14278,19071;19694;22803;23402;23490,36500,0,3,2,0,5
55049,120,14279,19292;19979;23108;23415,36500,0,2,2,0,4
55050,120,14280,19762,36500,0,0,1,0,1
55051,120,14281,19479;19814;23004;23306;23407;23506;23905,36500,1,4,2,0,7
55052,120,14282,19784;20118;22591;23922,36500,1,0,3,0,4
55053,120,14284,19833;20092,36500,0,0,2,0,2
55054,120,14286,19862;20057;23697,36500,0,1,2,0,3
55055,120,14287,19868;20015;22709,36500,0,1,2,0,3
55056,120,14288,19557;19968;22588;23010,36500,0,1,3,0,4
55057,120,14289,19910;20138;22273;23228;23426;23822,36500,0,3,3,0,6
55058,120,14290,19923;20136;22491;23208,36500,0,1,3,0,4
55059,120,14291,19975;23806;23913,36500,1,1,1,0,3
55060,120,14292,19996;20033;22814;23215,36500,0,2,2,0,4
55061,120,14293,20023;20172;23610,36500,0,1,2,0,3
55062,120,14294,15547,36865,0,0,0,1,1
55063,120,14297,15450,36865,0,0,0,1,1
55064,120,14300,15404,36865,0,0,0,1,1
55065,120,14303,16571,36865,0,0,0,1,1
55066,120,14308,16486,36865,0,0,0,1,1
55067,120,14309,17113,36865,0,0,0,1,1
55068,120,14314,17072;17224,36865,0,0,0,2,2
55069,120,14326,18536,36865,0,0,1,0,1
55070,120,14327,18666;19105,36865,0,0,2,0,2
55071,120,14328,18753;19122;22874;23675,36865,0,2,2,0,4
55072,120,14329,18828;19265,36865,0,0,2,0,2
55073,120,14330,18782;18905;22335;22532,36865,0,0,4,0,4
55074,120,14331,18966;19191;23074,36865,0,1,2,0,3
55075,120,14332,18983;19465,36865,0,0,2,0,2
55076,120,14333,19033;19062;22549,36865,0,0,3,0,3
55077,120,14334,18855;19005;22756,36865,0,1,2,0,3
55078,120,14335,19267;19394;22672,36865,0,1,2,0,3
55079,120,14337,19134;19642;22481;23485,36865,0,1,3,0,4
55080,120,14338,19046;19140;22242;22360;22871,36865,0,1,4,0,5
55081,120,14339,19149;19462;22456;23071;23158,36865,0,2,3,0,5
55082,120,14342,19802;23100,36865,0,1,1,0,2
55083,120,14343,19338;19590,36865,0,0,2,0,2
55084,120,14344,19328;19372;22255;22670,36865,0,1,3,0,4
55085,120,14345,18889,36865,0,0,1,0,1
55086,120,14346,19426;19452;22676;22782;23586,36865,0,3,2,0,5
55087,120,14347,19453;19480;23174,36865,0,1,2,0,3
55088,120,14348,19463;19980;23316,36865,0,1,2,0,3
55089,120,14351,19506;20193;22821,36865,0,1,2,0,3
55090,120,14352,19445;19446;22889;22985;23684,36865,0,3,2,0,5
55091,120,14354,19643;19920;22265;22586,36865,0,0,4,0,4
55092,120,14355,19498;19598;22478;23591,36865,0,1,3,0,4
55093,120,14356,20152;24118;24224,36865,2,0,1,0,3
55094,120,14357,19613;22691;22799;23090;23397;24212,36865,1,4,1,0,6
55095,120,14358,19525;19658;22578;23092;23190;24213,36865,1,2,3,0,6
55096,120,14359,19688;20270;23233,36865,0,1,2,0,3
55097,120,14360,19701;20114;23820,36865,0,1,2,0,3
55098,120,14361,20373,36865,0,0,1,0,1
55099,120,14362,19655;19827;23005;23509,36865,0,2,2,0,4
55100,120,14363,19829;20433,36865,0,0,2,0,2
55101,120,14364,19860;19957;22908;23414;23607,36865,0,3,2,0,5
55102,120,14365,20201;20249;23930;24323,36865,2,0,2,0,4
55103,120,14366,19752;19887;22489;23501,36865,0,1,3,0,4
55104,120,14367,19904;20365,36865,0,0,2,0,2
55105,120,14368,19676;19917;23802,36865,0,1,2,0,3
55106,120,14369,19940;20011;23104;23910,36865,1,1,2,0,4
55107,120,14370,20054;20205;23813,36865,0,1,2,0,3
55108,120,14371,20058;20268,36865,0,0,2,0,2
55109,120,14372,20028;20059;23815;23917;24111,36865,2,1,2,0,5
55110,120,14373,19974;20074;23614,36865,0,1,2,0,3
55111,120,14374,20093;20486;23240,36865,0,1,2,0,3
55112,120,14375,20045;20103;23527,36865,0,1,2,0,3
55113,120,14376,20105;23224;23528,36865,0,2,1,0,3
55114,120,14377,20121;20567;22924;23130,36865,0,2,2,0,4
55115,120,14378,20126;20260;23832,36865,0,1,2,0,3
55116,120,14379,15537,37230,0,0,0,1,1
55117,120,14380,16057,37230,0,0,0,1,1
55118,120,14381,15809,37230,0,0,0,1,1
55119,120,14382,15851,37230,0,0,0,1,1
55120,120,14383,15888,37230,0,0,0,1,1
55121,120,14385,15853,37230,0,0,0,1,1
55122,120,14387,15975,37230,0,0,0,1,1
55123,120,14388,16317,37230,0,0,0,1,1
55124,120,14389,16488,37230,0,0,0,1,1
55125,120,14390,16528,37230,0,0,0,1,1
55126,120,14400,17424,37230,0,0,1,0,1
55127,120,14402,17624,37230,0,0,1,0,1
55128,120,14408,18052;18539;23147,37230,0,1,2,0,3
55129,120,14413,18382,37230,0,0,1,0,1
55130,120,14416,18610;18754,37230,0,0,2,0,2
55131,120,14417,18399;18422;22622,37230,0,1,2,0,3
55132,120,14419,18668;19342;22468;22883;23279,37230,0,2,3,0,5
55133,120,14420,18170;18669;23367,37230,0,1,2,0,3
55134,120,14422,18471,37230,0,0,1,0,1
55135,120,14427,18590;18822;22640;22947,37230,0,2,2,0,4
55136,120,14428,19003;19127,37230,0,0,2,0,2
55137,120,14429,19075;19390;22569;22979,37230,0,1,3,0,4
55138,120,14430,19148;19621;23398,37230,0,1,2,0,3
55139,120,14431,19015;19375,37230,0,0,2,0,2
55140,120,14432,19189;19502,37230,0,0,2,0,2
55141,120,14433,19052;19118;22873;22964,37230,0,2,2,0,4
55142,120,14435,19897;19992;23102;23311;23908,37230,1,2,2,0,5
55143,120,14436,19367;22977,37230,0,1,1,0,2
55144,120,14437,19593;19805;23304,37230,0,1,2,0,3
55145,120,14438,18872;19455,37230,0,0,2,0,2
55146,120,14439,19477;19620;23084,37230,0,1,2,0,3
55147,120,14440,18895;19531;22792;22891;23589,37230,0,3,2,0,5
55148,120,14442,19493;19623;22573;23391,37230,0,1,3,0,4
55149,120,14445,19449;20102;22493;23526;24117,37230,1,1,3,0,5
55150,120,14446,19800,37230,0,0,1,0,1
55151,120,14447,19622;20026;22479;22800;23186;23484;24008,37230,1,3,3,0,7
55152,120,14448,19689;19750;22901,37230,0,1,2,0,3
55153,120,14449,19487;20222;24024,37230,1,0,2,0,3
55154,120,14450,19696;22896;23491;23692,37230,0,3,1,0,4
55155,120,14451,19742;20509;22603;23547;23947;24136,37230,2,1,3,0,6
55156,120,14452,19783;20380;24029,37230,1,0,2,0,3
55157,120,14453,20055;20208;23232;23533,37230,0,2,2,0,4
55158,120,14454,19673;19830;23101,37230,0,1,2,0,3
55159,120,14455,19343;19831;23202;23307;23596,37230,0,3,2,0,5
55160,120,14456,19721;19879,37230,0,0,2,0,2
55161,120,14457,19823;19858;23205,37230,0,1,2,0,3
55162,120,14458,19715;19861;22698;23001;23196;23495;23693,37230,0,5,2,0,7
55163,120,14459,19876;20010,37230,0,0,2,0,2
55164,120,14460,20036;20664;22710;23419;24220,37230,1,2,2,0,5
55165,120,14461,19908;20500;23029;23437,37230,0,2,2,0,4
55166,120,14462,19826;19912;22905;23207;23801,37230,0,3,2,0,5
55167,120,14463,19915;20492;23337;23544;24041,37230,1,2,2,0,5
55168,120,14464,20081;20098;22816;23222;24318,37230,1,2,2,0,5
55169,120,14465,19808;20174;23712;23828,37230,0,2,2,0,4
55170,120,14466,19300;19952;23107,37230,0,1,2,0,3
55171,120,14467,19985;20304;22275,37230,0,0,3,0,3
55172,120,14468,19663;19989;23704,37230,0,1,2,0,3
55173,120,14470,20472;23634,37230,0,1,1,0,2
55174,120,14471,20067;22712;23613,37230,0,2,1,0,3
55175,120,14472,20075;22815;23221;23321;23521;24113,37230,1,4,1,0,6
55176,120,14473,20079;22714;23522;23816,37230,0,3,1,0,4
55177,120,14474,19877;20101;23017,37230,0,1,2,0,3
55178,120,14475,19779;20140,37230,0,0,2,0,2
55179,120,14476,20330;20369,37230,0,0,2,0,2
55180,120,14477,20150;20574;23549;23639;23957,37230,1,2,2,0,5
55181,120,14478,20155;20217;22915;23230;24321,37230,1,2,2,0,5
55182,120,14479,20163;23531,37230,0,1,1,0,2
55183,120,14480,20414;20506;24035,37230,1,0,2,0,3
55184,120,14481,20177;20257;23328;23431;24025,37230,1,2,2,0,5
55185,120,14482,20145;20179;23532,37230,0,1,2,0,3
55186,120,14483,20199;20440,37230,0,0,2,0,2
55187,120,14484,20523;20612;23340;23548,37230,0,2,2,0,4
55188,120,14486,15648,37595,0,0,0,1,1
55189,120,14487,15362,37595,0,0,0,1,1
55190,120,14489,15634,37595,0,0,0,1,1
55191,120,14490,15264,37595,0,0,0,1,1
55192,120,14494,16206,37595,0,0,0,1,1
55193,120,14495,16073,37595,0,0,0,1,1
55194,120,14496,16653,37595,0,0,0,1,1
55195,120,14497,16225,37595,0,0,0,1,1
55196,120,14498,16667,37595,0,0,0,1,1
55197,120,14503,17225;17637,37595,0,0,1,1,2
55198,120,14507,17361;17386,37595,0,0,2,0,2
55199,120,14508,17511;17877,37595,0,0,2,0,2
55200,120,14514,17893;18365;22205;22408;22727,37595,0,1,4,0,5
55201,120,14521,18387,37595,0,0,1,0,1
55202,120,14522,18826;18912,37595,0,0,2,0,2
55203,120,14525,18807;18945;22445,37595,0,0,3,0,3
55204,120,14526,18799;19243;22250;22777,37595,0,1,3,0,4
55205,120,14527,18804;19058,37595,0,0,2,0,2
55206,120,14528,19184;22969;23073;23379,37595,0,3,1,0,4
55207,120,14530,19175;19401;22673;22780;24102,37595,1,2,2,0,5
55208,120,14531,19450;20020;23417;23915,37595,1,1,2,0,4
55209,120,14532,18850;19459;22785;22986;24103,37595,1,2,2,0,5
55210,120,14534,19562;19737;22805;23498,37595,0,2,2,0,4
55211,120,14535,19574;19886,37595,0,0,2,0,2
55212,120,14536,19745;20089;23223,37595,0,1,2,0,3
55213,120,14537,19457;19683;23192,37595,0,1,2,0,3
55214,120,14538,19867;19884;24016,37595,1,0,2,0,3
55215,120,14539,19793;23505,37595,0,1,1,0,2
55216,120,14540,19589;19893,37595,0,0,2,0,2
55217,120,14542,19456;19711;22381;23298;23494;23903,37595,1,2,3,0,6
55218,120,14543,19743;19782;23097;23500;24014,37595,1,2,2,0,5
55219,120,14544,19546;19981;23011;23703,37595,0,2,2,0,4
55220,120,14545,19736;23300;24215,37595,1,1,1,0,3
55221,120,14548,19799;20056;23814,37595,0,1,2,0,3
55222,120,14549,19813;20068;23422;23918,37595,1,1,2,0,4
55223,120,14550,19610;19892,37595,0,0,2,0,2
55224,120,14551,19937;20086;23604;23909,37595,1,1,2,0,4
55225,120,14552,20191;23619;24022,37595,1,1,1,0,3
55226,120,14553,19801;19946;22587;23105;23210,37595,0,2,3,0,5
55227,120,14554,19950;22707;22907;23804;23911;24108,37595,2,3,1,0,6
55228,120,14555,19758;19953;23805,37595,0,1,2,0,3
55229,120,14556,20348;20429;24331,37595,1,0,2,0,3
55230,120,14557,20000;20029;23013;23808;24219,37595,1,2,2,0,5
55231,120,14558,20495;20558;23028;23128;24333,37595,1,2,2,0,5
55232,120,14559,20008;20116;22913;23323;23711;23821;24223,37595,1,4,2,0,7
55233,120,14560,19899;20127;22592;23529,37595,0,1,3,0,4
55234,120,14561,19749;19843;22903;23006;23510;23797,37595,0,4,2,0,6
55235,120,14562,20480;22922;24232,37595,1,1,1,0,3
55236,120,14565,19995;20186;23618;24119,37595,1,1,2,0,4
55237,120,14566,20501;23129;23546;23730;24334,37595,1,3,1,0,5
55238,120,14567,20307,37595,0,0,1,0,1
55239,120,14568,20030;20202;22916;24023,37595,1,1,2,0,4
55240,120,14569,20156;20203;23428;23615,37595,0,2,2,0,4
55241,120,14570,20404;22600;23123;23722,37595,0,2,2,0,4
55242,120,14571,19962;20242,37595,0,0,2,0,2
55243,120,14572,19821;20244;22596;22716;23535,37595,0,2,3,0,5
55244,120,14573,20220;20264;22594;23926,37595,1,0,3,0,4
55245,120,14574,20269;20361;23626,37595,0,1,2,0,3
55246,120,14575,20196;20275,37595,0,0,2,0,2
55247,120,14576,20117;20296;23715;24125;24226,37595,2,1,2,0,5
55248,120,14577,20315;20652;23644;24050,37595,1,1,2,0,4
55249,120,14578,20321;20728;23742,37595,0,1,2,0,3
55250,120,14579,20328;20711;24342,37595,1,0,2,0,3
55251,120,14580,19872;20334;22918;23537;23624,37595,0,3,2,0,5
55252,120,14581,20194;20376;23925;24120,37595,2,0,2,0,4
55253,120,14582,20340;20542;23343;23637,37595,0,2,2,0,4
55254,120,14583,20394,37595,0,0,1,0,1
55255,120,14584,20715;23652,37595,0,1,1,0,2
55256,120,14585,15793,37960,0,0,0,1,1
55257,120,14588,16142,37960,0,0,0,1,1
55258,120,14589,15318,37960,0,0,0,1,1
55259,120,14590,16565;16599,37960,0,0,0,2,2
55260,120,14594,16543,37960,0,0,0,1,1
55261,120,14597,16649;16808,37960,0,0,0,2,2
55262,120,14599,16655,37960,0,0,0,1,1
55263,120,14600,16976;17035,37960,0,0,0,2,2
55264,120,14616,18090,37960,0,0,1,0,1
55265,120,14619,18217;18378;22409,37960,0,0,3,0,3
55266,120,14622,18484,37960,0,0,1,0,1
55267,120,14627,19023;22357;22653;23059;23154,37960,0,3,2,0,5
55268,120,14630,19416;22983;23478,37960,0,2,1,0,3
55269,120,14631,18716;19029;22760;22959;23060,37960,0,3,2,0,5
55270,120,14633,18726;18792,37960,0,0,2,0,2
55271,120,14634,19677;19707;22696;23401;23488,37960,0,3,2,0,5
55272,120,14636,19119;19563,37960,0,0,2,0,2
55273,120,14637,19437;19966;22909,37960,0,1,2,0,3
55274,120,14638,19443;19678;22484;23093,37960,0,1,3,0,4
55275,120,14639,19460;19670;22786;23285,37960,0,2,2,0,4
55276,120,14640,18994;19475;22376;22788;22989;23176;23389,37960,0,4,3,0,7
55277,120,14643,19276;19371;22669;23281;23476,37960,0,3,2,0,5
55278,120,14644,19596;19918;23515,37960,0,1,2,0,3
55279,120,14645,19430;19647;23188;23900,37960,1,1,2,0,4
55280,120,14646,19614;19949;23606,37960,0,1,2,0,3
55281,120,14647,19370;19630;22577;23592,37960,0,1,3,0,4
55282,120,14648,20146,37960,0,0,1,0,1
55283,120,14649,19439;19636,37960,0,0,2,0,2
55284,120,14650,19441;19648;22996,37960,0,1,2,0,3
55285,120,14651,19657;20013;22708;23609;23914,37960,1,2,2,0,5
55286,120,14652,19542;19807,37960,0,0,2,0,2
55287,120,14653,19773;19866;22582;22700;23199,37960,0,2,3,0,5
55288,120,14655,19725;19794;23593,37960,0,1,2,0,3
55289,120,14656,19944;22268;23314;23605;24107,37960,1,2,2,0,5
55290,120,14657,19777;20111;23112,37960,0,1,2,0,3
55291,120,14658,19547;19791,37960,0,0,2,0,2
55292,120,14659,19795;20531;23732,37960,0,1,2,0,3
55293,120,14660,19421;19797;22704;22809,37960,0,2,2,0,4
55294,120,14661,19409;20032,37960,0,0,2,0,2
55295,120,14662,19639;19810;23091;23187,37960,0,2,2,0,4
55296,120,14663,19817;19922;23701,37960,0,1,2,0,3
55297,120,14664,20223;22595;23430;23621,37960,0,2,2,0,4
55298,120,14665,19692;19928;23209;23516;23603;23803;24106,37960,1,4,2,0,7
55299,120,14666,20488;20603;23133,37960,0,1,2,0,3
55300,120,14667,19945;19998;23012,37960,0,1,2,0,3
55301,120,14668,19955;20528;23031;23341,37960,0,2,2,0,4
55302,120,14669,19723;20187,37960,0,0,2,0,2
55303,120,14670,19451;20017,37960,0,0,2,0,2
55304,120,14671,20463;23127;23945,37960,1,1,1,0,3
55305,120,14672,20078;20489,37960,0,0,2,0,2
55306,120,14673,19896;20096;22271;23424;23524,37960,0,2,3,0,5
55307,120,14674,19501;20109;23819,37960,0,1,2,0,3
55308,120,14675,20582;21058;23243,37960,0,1,2,0,3
55309,120,14676,20001;20122;22914,37960,0,1,2,0,3
55310,120,14677,20124;20761;23655;24061,37960,1,1,2,0,4
55311,120,14678,19763;20310;22597;23932,37960,1,0,3,0,4
55312,120,14679,20374;22823;23629,37960,0,2,1,0,3
55313,120,14680,20159;20393;23530,37960,0,1,2,0,3
55314,120,14681,20336;20421,37960,0,0,2,0,2
55315,120,14682,20212;20248;24121;24225,37960,2,0,2,0,4
55316,120,14683,20245,37960,0,0,1,0,1
55317,120,14684,20415;23124;23724;24036,37960,1,2,1,0,4
55318,120,14685,19971;20316;23536;24026,37960,1,1,2,0,4
55319,120,14686,19976;20263,37960,0,0,2,0,2
55320,120,14687,20293;20401;22494;24324,37960,1,0,3,0,4
55321,120,14688,20317;20319;23117;23433,37960,0,2,2,0,4
55322,120,14689,20211;20342;23933;24325,37960,2,0,2,0,4
55323,120,14690,20355;20595;22604;22926;23958,37960,1,1,3,0,5
55324,120,14691,20568;20775;23747,37960,0,1,2,0,3
55325,120,14692,20384;20424;23842;23941,37960,1,1,2,0,4
55326,120,14693,20325;20410;23334,37960,0,1,2,0,3
55327,120,14694,20007;20413;22921,37960,0,1,2,0,3
55328,120,14695,20226;20427;24123;24322,37960,2,0,2,0,4
55329,120,14696,20436;20544;23734;23952,37960,1,1,2,0,4
55330,120,14697,20229;20447;23944,37960,1,0,2,0,3
55331,120,14698,20448,37960,0,0,1,0,1
55332,120,14699,20870;21112;23566;23659;24163,37960,1,2,2,0,5
55333,120,14700,20550;23344;23953;24044,37960,2,1,1,0,4
55334,120,14701,20745;23035;23251;24059,37960,1,2,1,0,4
55335,120,14702,20496;20646,37960,0,0,2,0,2
55336,120,14703,20430;20497;22827;23338;23545;23844;23946,37960,1,4,2,0,7
55337,120,14705,16419,38325,0,0,0,1,1
55338,120,14713,16711;17022,38325,0,0,0,2,2
55339,120,14714,16999,38325,0,0,0,1,1
55340,120,14715,16838,38325,0,0,0,1,1
55341,120,14716,16726,38325,0,0,0,1,1
55342,120,14718,16887,38325,0,0,0,1,1
55343,120,14719,16572,38325,0,0,0,1,1
55344,120,14722,17373,38325,0,0,1,0,1
55345,120,14725,17542;18003,38325,0,0,2,0,2
55346,120,14727,17744,38325,0,0,1,0,1
55347,120,14731,17943,38325,0,0,1,0,1
55348,120,14735,18206;18419,38325,0,0,2,0,2
55349,120,14740,18635;18681,38325,0,0,2,0,2
55350,120,14742,18955;22446,38325,0,0,2,0,2
55351,120,14743,18967;19222;22970,38325,0,1,2,0,3
55352,120,14744,19059;19153,38325,0,0,2,0,2
55353,120,14745,18888;19133,38325,0,0,2,0,2
55354,120,14746,19190;19347;22668,38325,0,1,2,0,3
55355,120,14747,19344;19567;22688;22794;23393;23483,38325,0,4,2,0,6
55356,120,14748,19321;19660,38325,0,0,2,0,2
55357,120,14749,19301;19326;23895,38325,1,0,2,0,3
55358,120,14750,19572;19991,38325,0,0,2,0,2
55359,120,14751,19476;19809;23003;23305,38325,0,2,2,0,4
55360,120,14753,19538;19786;22384;23099,38325,0,1,3,0,4
55361,120,14754,19514;19848;22904;23696,38325,0,2,2,0,4
55362,120,14755,19579;19772;22699;23502,38325,0,2,2,0,4
55363,120,14756,19482;19722;23197;23496,38325,0,2,2,0,4
55364,120,14757,19339;19637,38325,0,0,2,0,2
55365,120,14759,19591;19796;22703;23201,38325,0,2,2,0,4
55366,120,14760,19681;20021;23213;23318;23418;24018,38325,1,3,2,0,6
55367,120,14761,20297;24126,38325,1,0,1,0,2
55368,120,14762,19329;19733,38325,0,0,2,0,2
55369,120,14763,19766;19958;23315;23912,38325,1,1,2,0,4
55370,120,14764,19812;19959;24017,38325,1,0,2,0,3
55371,120,14765,19798;19978;23211;24109,38325,1,1,2,0,4
55372,120,14766,19857;19875;22490;23800,38325,0,1,3,0,4
55373,120,14767,20181;20842;23658,38325,0,1,2,0,3
55374,120,14768,20375;23332;23630;23838;24229,38325,1,3,1,0,5
55375,120,14769,20128;23226,38325,0,1,1,0,2
55376,120,14770,20235;20251;23116;23831;23929,38325,1,2,2,0,5
55377,120,14771,19982;20600;23131;23643;24048,38325,1,2,2,0,5
55378,120,14772,20019;20064,38325,0,0,2,0,2
55379,120,14773,20042;20071;23218;23810,38325,0,2,2,0,4
55380,120,14774,19600,38325,0,0,1,0,1
55381,120,14775,20106;20351;23716;24129,38325,1,1,2,0,4
55382,120,14776,20110;20823,38325,0,0,2,0,2
55383,120,14777,19665;20112;23710,38325,0,1,2,0,3
55384,120,14778,20160;20517;23030;23339;24137,38325,1,2,2,0,5
55385,120,14779,20168;20884,38325,0,0,2,0,2
55386,120,14780,20184;20541;23848,38325,0,1,2,0,3
55387,120,14781,20206;20353;23022;23717;23934,38325,1,2,2,0,5
55388,120,14782,20237;20554;23735;24045,38325,1,1,2,0,4
55389,120,14784,20278;20456;23336;24039,38325,1,1,2,0,4
55390,120,14785,20306;20671;23962,38325,1,0,2,0,3
55391,120,14786,20153;20188,38325,0,0,2,0,2
55392,120,14787,20314;20537,38325,0,0,2,0,2
55393,120,14788,20323;20570;22925,38325,0,1,2,0,3
55394,120,14790,20190;20332;23623,38325,0,1,2,0,3
55395,120,14791,20398;23024;23539;24032,38325,1,2,1,0,4
55396,120,14792,20164,38325,0,0,1,0,1
55397,120,14793,20381;20906;24069;24359,38325,2,0,2,0,4
55398,120,14794,19972;20388;23237;23538;23721;24030;24130,38325,2,3,2,0,7
55399,120,14795,20012;20403;23025;23238;24328,38325,1,2,2,0,5
55400,120,14796,20291;20409;22917,38325,0,1,2,0,3
55401,120,14797,20053;20452,38325,0,0,2,0,2
55402,120,14798,20459;20460;22824;24135,38325,1,1,2,0,4
55403,120,14799,20225;20505;23438;23731;24042,38325,1,2,2,0,5
55404,120,14800,20515;20924;23257;24361,38325,1,1,2,0,4
55405,120,14801,20571;23345;23440;24139,38325,1,2,1,0,4
55406,120,14802,20780;20806;24063;24154,38325,2,0,2,0,4
55407,120,14803,20596;20653;23642,38325,0,1,2,0,3
55408,120,14806,17032,38690,0,0,0,1,1
55409,120,14807,16280,38690,0,0,0,1,1
55410,120,14808,16744,38690,0,0,0,1,1
55411,120,14810,17009,38690,0,0,0,1,1
55412,120,14814,17112,38690,0,0,0,1,1
55413,120,14815,17271,38690,0,0,1,0,1
55414,120,14819,17089,38690,0,0,0,1,1
55415,120,14822,17835;18041,38690,0,0,2,0,2
55416,120,14824,18689,38690,0,0,1,0,1
55417,120,14830,18609;18687,38690,0,0,2,0,2
55418,120,14831,19603,38690,0,0,1,0,1
55419,120,14832,19193;19584;23787,38690,0,1,2,0,3
55420,120,14834,18864;19043,38690,0,0,2,0,2
55421,120,14836,18884,38690,0,0,1,0,1
55422,120,14839,19335;19346;23165,38690,0,1,2,0,3
55423,120,14840,19402;19774;23302,38690,0,1,2,0,3
55424,120,14842,19414;19907;22263;22705;23312;23514,38690,0,3,3,0,6
55425,120,14843,19792;23002;23200,38690,0,2,1,0,3
55426,120,14846,20097;23525;23818,38690,0,2,1,0,3
55427,120,14847,19732;20069;22713;23919;24112,38690,2,1,2,0,5
55428,120,14849,19559,38690,0,0,1,0,1
55429,120,14850,20247;20312;24124,38690,1,0,2,0,3
55430,120,14851,19776;22702;23503,38690,0,2,1,0,3
55431,120,14852,19891;20396;23839;23937;24326,38690,2,1,2,0,5
55432,120,14854,20481;22826;24423,38690,1,1,1,0,3
55433,120,14855,19984;20198;23231,38690,0,1,2,0,3
55434,120,14856,19960;20185;23617,38690,0,1,2,0,3
55435,120,14857,19806;20004,38690,0,0,2,0,2
55436,120,14858,20009;20227;22386;23212,38690,0,1,3,0,4
55437,120,14859,19740;20044;23219;23811,38690,0,2,2,0,4
55438,120,14860,19906;20085;22590;22817;23111;23322,38690,0,3,3,0,6
55439,120,14861,20051;20129;24110;24221,38690,2,0,2,0,4
55440,120,14862,20131;20635,38690,0,0,2,0,2
55441,120,14863,20158;20207;23826,38690,0,1,2,0,3
55442,120,14864,19967;20231;23019;23830,38690,0,2,2,0,4
55443,120,14865,20232;20948,38690,0,0,2,0,2
55444,120,14866,20286;20367;24028,38690,1,0,2,0,3
55445,120,14867,20287;20339,38690,0,0,2,0,2
55446,120,14868,20324;20400;23938;24033,38690,2,0,2,0,4
55447,120,14869,20335;21015;24170,38690,1,0,2,0,3
55448,120,14871,20832;24160,38690,1,0,1,0,2
55449,120,14872,20132;20412;23633;23723;24230,38690,1,2,2,0,5
55450,120,14873,20417;20736;24057;24150;24344,38690,3,0,2,0,5
55451,120,14874,19994;20423;23940;24131,38690,2,0,2,0,4
55452,120,14875,20354;20382;23120;23331;23718;23836,38690,0,4,2,0,6
55453,120,14876,19939;20161;23616;23827,38690,0,2,2,0,4
55454,120,14877,20732,38690,0,0,1,0,1
55455,120,14878,20490;23843;24040,38690,1,1,1,0,3
55456,120,14879,20499;22497,38690,0,0,2,0,2
55457,120,14880,20504;20739;23250;23560;24248,38690,1,2,2,0,5
55458,120,14881,20527;21003,38690,0,0,2,0,2
55459,120,14882,20261;20682;22927,38690,0,1,2,0,3
55460,120,14883,20521;20579;23032;23641,38690,0,2,2,0,4
55461,120,14884,21008;23353;23982,38690,1,1,1,0,3
55462,120,14885,20555;20589;23550;24047,38690,1,1,2,0,4
55463,120,14886,20634,38690,0,0,1,0,1
55464,120,14887,20642;20929;23450;24364,38690,1,1,2,0,4
55465,120,14888,20667;21025,38690,0,0,2,0,2
55466,120,14889,20577;20688;23649;23964;24052;24245,38690,3,1,2,0,6
55467,120,14890,20717;20742;23034,38690,0,1,2,0,3
55468,120,14891,20397;20724;23443;23653;24147,38690,1,2,2,0,5
55469,120,14892,20633;20740;23561;24345,38690,1,1,2,0,4
55470,120,14893,16276,39055,0,0,0,1,1
55471,120,14894,16680;16688,39055,0,0,0,2,2
55472,120,14897,16544;16554,39055,0,0,0,2,2
55473,120,14898,16366,39055,0,0,0,1,1
55474,120,14900,16592,39055,0,0,0,1,1
55475,120,14901,17004,39055,0,0,0,1,1
55476,120,14916,18402,39055,0,0,1,0,1
55477,120,14918,18448;19458;22678,39055,0,1,2,0,3
55478,120,14923,18612,39055,0,0,1,0,1
55479,120,14927,18751;19170;22459,39055,0,0,3,0,3
55480,120,14928,18485,39055,0,0,1,0,1
55481,120,14929,18761,39055,0,0,1,0,1
55482,120,14931,19504;19932;23702;24218,39055,1,1,2,0,4
55483,120,14932,19526;19894,39055,0,0,2,0,2
55484,120,14933,19545;20233,39055,0,0,2,0,2
55485,120,14935,20450;20485,39055,0,0,2,0,2
55486,120,14936,19618;19686;24214,39055,1,0,2,0,3
55487,120,14937,19669;19986,39055,0,0,2,0,2
55488,120,14938,20259,39055,0,0,1,0,1
55489,120,14939,19687;19811;22997;23691,39055,0,2,2,0,4
55490,120,14940,19961,39055,0,0,1,0,1
55491,120,14941,19728;20209;23534,39055,0,1,2,0,3
55492,120,14942,19731;19997;22911;23317;23807,39055,0,3,2,0,5
55493,120,14943,19741,39055,0,0,1,0,1
55494,120,14945,19849;20022;22589;24019,39055,1,0,3,0,4
55495,120,14946,19585;19916;22264;23313;23413,39055,0,2,3,0,5
55496,120,14947,19926;20219;23114;23326,39055,0,2,2,0,4
55497,120,14948,20685;20790;24155,39055,1,0,2,0,3
55498,120,14949,19870;20038;22711;24020,39055,1,1,2,0,4
55499,120,14950,20035;20039;23217;23708,39055,0,2,2,0,4
55500,120,14951,20046;20062;22270,39055,0,0,3,0,3
55501,120,14952,20061;20142;23824,39055,0,1,2,0,3
55502,120,14953,20080;20368;22719;23628,39055,0,2,2,0,4
55503,120,14954,20183;20520;22498;23950,39055,1,0,3,0,4
55504,120,14955,20216;20606,39055,0,0,2,0,2
55505,120,14956,20224;23927,39055,1,0,1,0,2
55506,120,14957,20283;20689;24146,39055,1,0,2,0,3
55507,120,14958,20513;23948,39055,1,0,1,0,2
55508,120,14959,20841;23657,39055,0,1,1,0,2
55509,120,14960,20636;20911;23978;24072,39055,2,0,2,0,4
55510,120,14961,20327;20893;24356,39055,1,0,2,0,3
55511,120,14962,20167;20338;22598;24127,39055,1,0,3,0,4
55512,120,14963,20322;20360;23118;23235,39055,0,2,2,0,4
55513,120,14964,20175;20814;24064;24250,39055,2,0,2,0,4
55514,120,14965,20169;20416;23435;24037;24329,39055,2,1,2,0,5
55515,120,14966,20453;22602;23126,39055,0,1,2,0,3
55516,120,14967,20462;22825;23542,39055,0,2,1,0,3
55517,120,14968,20464;20927;24262;24363,39055,2,0,2,0,4
55518,120,14969,20182;20288;23714,39055,0,1,2,0,3
55519,120,14970,20493;20710;23858;23967,39055,1,1,2,0,4
55520,120,14971,20538;23342;23847;24043,39055,1,2,1,0,4
55521,120,14972,20284;20540;22830;23951,39055,1,1,2,0,4
55522,120,14973,20829;24065;24159,39055,2,0,1,0,3
55523,120,14974,20557;20836;23037;24066,39055,1,1,2,0,4
55524,120,14975,20566;20909,39055,0,0,2,0,2
55525,120,14976,20524;20575;23640,39055,0,1,2,0,3
55526,120,14978,20090;20615;23551;23738;23851;24239,39055,1,3,2,0,6
55527,120,14979,20562;20627;23439;23955;24046;24236,39055,3,1,2,0,6
55528,120,14980,20651;21155,39055,0,0,2,0,2
55529,120,14981,20668;20821;23740,39055,0,1,2,0,3
55530,120,14982,20687;20937;23258;24365,39055,1,1,2,0,4
55531,120,14983,20694;20765;22831;23137;24152,39055,1,2,2,0,5
55532,120,14984,20720;20846;23254;24254,39055,1,1,2,0,4
55533,120,14985,20491;20725,39055,0,0,2,0,2
55534,120,14986,20746;20892;24347,39055,1,0,2,0,3
55535,120,14987,20616;20778,39055,0,0,2,0,2
55536,120,14988,20783;20980;23981,39055,1,0,2,0,3
55537,120,14989,20792;23749,39055,0,1,1,0,2
55538,120,14990,20519;20810;23241;23845,39055,0,2,2,0,4
55539,120,14991,20827;21122;23989,39055,1,0,2,0,3
55540,120,14993,16355,39420,0,0,0,1,1
55541,120,14994,16378,39420,0,0,0,1,1
55542,120,14995,16384,39420,0,0,0,1,1
55543,120,14996,16262,39420,0,0,0,1,1
55544,120,14998,16119,39420,0,0,0,1,1
55545,120,14999,16677,39420,0,0,0,1,1
55546,120,15001,16067,39420,0,0,0,1,1
55547,120,15002,16285,39420,0,0,0,1,1
55548,120,15004,16291,39420,0,0,0,1,1
55549,120,15005,17054,39420,0,0,0,1,1
55550,120,15006,16978,39420,0,0,0,1,1
55551,120,15012,17773,39420,0,0,1,0,1
55552,120,15018,18389,39420,0,0,1,0,1
55553,120,15020,18663;18926;22629,39420,0,1,2,0,3
55554,120,15024,18700,39420,0,0,1,0,1
55555,120,15028,19063,39420,0,0,1,0,1
55556,120,15032,19470;19528,39420,0,0,2,0,2
55557,120,15035,19790;20130;22387,39420,0,0,3,0,3
55558,120,15037,19616;19901;23008,39420,0,1,2,0,3
55559,120,15038,20387;22391;23936,39420,1,0,2,0,3
55560,120,15039,19988;20299,39420,0,0,2,0,2
55561,120,15040,20048;20465;22496;24332,39420,1,0,3,0,4
55562,120,15041,20073,39420,0,0,1,0,1
55563,120,15042,20144;20643;23348,39420,0,1,2,0,3
55564,120,15043,20165;20654,39420,0,0,2,0,2
55565,120,15044,20238;20602;23441;23959,39420,1,1,2,0,4
55566,120,15045,19842;20347;23021;23119;23835;24027;24128;24227,39420,3,3,2,0,8
55567,120,15046,20271;20620;23739;24049;24240;24337,39420,3,1,2,0,6
55568,120,15047,20874,39420,0,0,1,0,1
55569,120,15048,20151;20301;22593;23113;23427,39420,0,2,3,0,5
55570,120,15049,19836,39420,0,0,1,0,1
55571,120,15050,20828;21041;23759;24078,39420,1,1,2,0,4
55572,120,15051,20859;24353,39420,1,0,1,0,2
55573,120,15052,20457,39420,0,0,1,0,1
55574,120,15053,20779;23971;24153,39420,2,0,1,0,3
55575,120,15054,20133;20467;23543,39420,0,1,2,0,3
55576,120,15055,20471;22722,39420,0,1,1,0,2
55577,120,15056,19850;20474;23436,39420,0,1,2,0,3
55578,120,15057,20435;20494;23027,39420,0,1,2,0,3
55579,120,15058,20050;20234;22389;23115;23928,39420,1,1,3,0,5
55580,120,15059,20215;20683;23556;24341,39420,1,1,2,0,4
55581,120,15060,20173;20584;23849,39420,0,1,2,0,3
55582,120,15061,20592;21166,39420,0,0,2,0,2
55583,120,15062,20343;20604;23737,39420,0,1,2,0,3
55584,120,15063,21028;23662,39420,0,1,1,0,2
55585,120,15065,20610;20663,39420,0,0,2,0,2
55586,120,15066,20673;21036;23454;23663;23758,39420,0,3,2,0,5
55587,120,15067,20313;20684;23648,39420,0,1,2,0,3
55588,120,15068,20772;21102;23988;24175,39420,2,0,2,0,4
55589,120,15069,20697;20709;24247,39420,1,0,2,0,3
55590,120,15070,20611;21184;24277;24380,39420,2,0,2,0,4
55591,120,15071,20622;20794,39420,0,0,2,0,2
55592,120,15072,20753;21037;23986;24171,39420,2,0,2,0,4
55593,120,15073,20759;20934;23870,39420,0,1,2,0,3
55594,120,15074,20798;21175,39420,0,0,2,0,2
55595,120,15075,21241,39420,0,0,1,0,1
55596,120,15076,21048,39420,0,0,1,0,1
55597,120,15077,20825;21017;23984,39420,1,0,2,0,3
55598,120,15078,20863;20891;23867,39420,0,1,2,0,3
55599,120,15079,20885;21170;24164;24255;24355,39420,3,0,2,0,5
55600,120,15080,20886;21030,39420,0,0,2,0,2
55601,120,15081,20563;20912;23449;24261,39420,1,1,2,0,4
55602,120,15082,20915;21059,39420,0,0,2,0,2
55603,120,15083,20918;21297;24285,39420,1,0,2,0,3
55604,120,15084,20586;20922;23351,39420,0,1,2,0,3
55605,120,15085,20865;20945,39420,0,0,2,0,2
55606,120,15086,16121,39785,0,0,0,1,1
55607,120,15088,16881,39785,0,0,0,1,1
55608,120,15089,16927,39785,0,0,0,1,1
55609,120,15091,16821,39785,0,0,0,1,1
55610,120,15094,17307,39785,0,0,1,0,1
55611,120,15097,17517;17819,39785,0,0,2,0,2
55612,120,15098,17407,39785,0,0,1,0,1
55613,120,15101,17529,39785,0,0,1,0,1
55614,120,15104,17724,39785,0,0,1,0,1
55615,120,15107,17945,39785,0,0,1,0,1
55616,120,15112,18768,39785,0,0,1,0,1
55617,120,15117,19018,39785,0,0,1,0,1
55618,120,15118,19176;19576;23291;24211,39785,1,1,2,0,4
55619,120,15120,19137;19549,39785,0,0,2,0,2
55620,120,15124,19608;19719,39785,0,0,2,0,2
55621,120,15127,20170;23324,39785,0,1,1,0,2
55622,120,15128,19703;20120;23923,39785,1,0,2,0,3
55623,120,15130,19629,39785,0,0,1,0,1
55624,120,15131,19755;20135,39785,0,0,2,0,2
55625,120,15132,19880,39785,0,0,1,0,1
55626,120,15133,19919;20083;23817;24319,39785,1,1,2,0,4
55627,120,15134,20294,39785,0,0,1,0,1
55628,120,15135,20274;23432,39785,0,1,1,0,2
55629,120,15136,19951;20282;23713,39785,0,1,2,0,3
55630,120,15137,20037;20228;23216;23809;23916,39785,1,2,2,0,5
55631,120,15138,20072;20239;23320;23423;23920,39785,1,2,2,0,5
55632,120,15139,20309,39785,0,0,1,0,1
55633,120,15141,20262;20559;24138,39785,1,0,2,0,3
55634,120,15142,20265;20617;23552;24141,39785,1,1,2,0,4
55635,120,15143,20267;20941,39785,0,0,2,0,2
55636,120,15144,20272;20953;23871,39785,0,1,2,0,3
55637,120,15145,20276;20764;23036,39785,0,1,2,0,3
55638,120,15146,20256;20434;24132;24231,39785,2,0,2,0,4
55639,120,15147,20014;20285;23329;23833,39785,0,2,2,0,4
55640,120,15148,20344;23625,39785,0,1,1,0,2
55641,120,15149,20378;20556;23242;23954,39785,1,1,2,0,4
55642,120,15150,20066;20498;23635,39785,0,1,2,0,3
55643,120,15151,20549;20708,39785,0,0,2,0,2
55644,120,15152,20532;20560;22923;23638;24235,39785,1,2,2,0,5
55645,120,15153,20733;20903;23753;23977;24068;24259;24358,39785,4,1,2,0,7
55646,120,15154,20649;21298,39785,0,0,2,0,2
55647,120,15155,21038;23568;24375,39785,1,1,1,0,3
55648,120,15156,20690;21415;24287,39785,1,0,2,0,3
55649,120,15157,20693;20734;23248;24056;24343,39785,2,1,2,0,5
55650,120,15158,20702;20946;23651;23856,39785,0,2,2,0,4
55651,120,15159,20718;20791;23246,39785,0,1,2,0,3
55652,120,15160,20478;20788;23349,39785,0,1,2,0,3
55653,120,15161,20784;20826;23656;23748;24349,39785,1,2,2,0,5
55654,120,15162,20850;23751;24067,39785,1,1,1,0,3
55655,120,15163,20860;21022;24077,39785,1,0,2,0,3
55656,120,15164,20881;21253,39785,0,0,2,0,2
55657,120,15165,20887;21227;24384,39785,1,0,2,0,3
55658,120,15166,20889;20989,39785,0,0,2,0,2
55659,120,15167,20890;21394;24086,39785,1,0,2,0,3
55660,120,15168,20908,39785,0,0,1,0,1
55661,120,15169,20938;21150;24274,39785,1,0,2,0,3
55662,120,15170,20940;21414,39785,0,0,2,0,2
55663,120,15171,20624;20942,39785,0,0,2,0,2
55664,120,15172,20964;21380;23872,39785,0,1,2,0,3
55665,120,15173,20965,39785,0,0,1,0,1
55666,120,15174,21259;23880,39785,0,1,1,0,2
55667,120,15175,20431;21053;24270,39785,1,0,2,0,3
55668,120,15176,21074;21313;23994,39785,1,0,2,0,3
55669,120,15177,16478,40150,0,0,0,1,1
55670,120,15179,16234,40150,0,0,0,1,1
55671,120,15180,16654,40150,0,0,0,1,1
55672,120,15181,16694,40150,0,0,0,1,1
55673,120,15182,16341,40150,0,0,0,1,1
55674,120,15183,16950,40150,0,0,0,1,1
55675,120,15186,17458,40150,0,0,1,0,1
55676,120,15188,17725,40150,0,0,1,0,1
55677,120,15195,18691,40150,0,0,1,0,1
55678,120,15201,19334,40150,0,0,1,0,1
55679,120,15204,19418,40150,0,0,1,0,1
55680,120,15205,19296;19508,40150,0,0,2,0,2
55681,120,15206,19410,40150,0,0,1,0,1
55682,120,15207,19107,40150,0,0,1,0,1
55683,120,15209,19586;22689;23293;23788,40150,0,3,1,0,4
55684,120,15210,19775;19789;22701;23406;23793,40150,0,3,2,0,5
55685,120,15211,19386;19447;23587,40150,0,1,2,0,3
55686,120,15212,19987;20213;23325;23429;23829;24122,40150,1,3,2,0,6
55687,120,15213,20034;20613;23850,40150,0,1,2,0,3
55688,120,15214,19625;20065,40150,0,0,2,0,2
55689,120,15215,20084;23709;24114,40150,1,1,1,0,3
55690,120,15216,19956;20451;23335;23729,40150,0,2,2,0,4
55691,120,15217,20178;20692;23965,40150,1,0,2,0,3
55692,120,15218,20200;20329,40150,0,0,2,0,2
55693,120,15219,19738;20230;23327,40150,0,1,2,0,3
55694,120,15220,20298;20598;23244;23346;24336,40150,1,2,2,0,5
55695,120,15222,19983,40150,0,0,1,0,1
55696,120,15223,19947;20432;23943,40150,1,0,2,0,3
55697,120,15224,20444;20930;23979;24073;24263,40150,3,0,2,0,5
55698,120,15225,20094;20445;23728;24133,40150,1,1,2,0,4
55699,120,15226,20455;20967;24264,40150,1,0,2,0,3
55700,120,15227,20108;20195,40150,0,0,2,0,2
55701,120,15228,20838;24351,40150,1,0,1,0,2
55702,120,15230,20552;20572,40150,0,0,2,0,2
55703,120,15231,20280;20581;24237,40150,1,0,2,0,3
55704,120,15232,20626;20880,40150,0,0,2,0,2
55705,120,15233,19746;20070;23220,40150,0,1,2,0,3
55706,120,15234,20674;20954;24074,40150,1,0,2,0,3
55707,120,15235,20678;21068;23761,40150,0,1,2,0,3
55708,120,15236,20699;23134,40150,0,1,1,0,2
55709,120,15237,20723;21145;23571,40150,0,1,2,0,3
55710,120,15238,20727;23558,40150,0,1,1,0,2
55711,120,15240,20738;20999;24169,40150,1,0,2,0,3
55712,120,15241,20770;20888;23752;23976,40150,1,1,2,0,4
55713,120,15242,19969,40150,0,0,1,0,1
55714,120,15243,20801;20932,40150,0,0,2,0,2
55715,120,15244,20546;20840;22930;23350;23447;24253,40150,1,3,2,0,6
55716,120,15245,20719;20856;23866;24162,40150,1,1,2,0,4
55717,120,15246,20879;21138,40150,0,0,2,0,2
55718,120,15247,20704;21060;23760,40150,0,1,2,0,3
55719,120,15248,20894;21098;23448;23869;24165;24357,40150,2,2,2,0,6
55720,120,15249,20254;20773;23860;23970,40150,1,1,2,0,4
55721,120,15250,20956;21359,40150,0,0,2,0,2
55722,120,15251,20760;20972;23452,40150,0,1,2,0,3
55723,120,15252,20974;20979;24368,40150,1,0,2,0,3
55724,120,15253,20475;21004,40150,0,0,2,0,2
55725,120,15254,21007;21153;23355,40150,0,1,2,0,3
55726,120,15255,21000;21033,40150,0,0,2,0,2
55727,120,15256,20672;21034,40150,0,0,2,0,2
55728,120,15257,21011;21044;23873;23983,40150,1,1,2,0,4
55729,120,15258,21069;21250,40150,0,0,2,0,2
55730,120,15259,20443;21070,40150,0,0,2,0,2
55731,120,15260,21072;23354;24271,40150,1,1,1,0,3
55732,120,15261,21090;21293,40150,0,0,2,0,2
55733,120,15262,21110;21262;24386,40150,1,0,2,0,3
55734,120,15263,20993;21137,40150,0,0,2,0,2
55735,120,15264,21142;21480,40150,0,0,2,0,2
55736,120,15265,21160;21173;23038,40150,0,1,2,0,3
55737,120,15266,21191;21493;24395,40150,1,0,2,0,3
55738,120,15267,16751;17115,40515,0,0,0,2,2
55739,120,15268,16932,40515,0,0,0,1,1
55740,120,15269,16994,40515,0,0,0,1,1
55741,120,15270,16761,40515,0,0,0,1,1
55742,120,15271,17240;17287,40515,0,0,1,1,2
55743,120,15272,17145,40515,0,0,0,1,1
55744,120,15274,17167,40515,0,0,0,1,1
55745,120,15275,16923;17116,40515,0,0,0,2,2
55746,120,15276,17043,40515,0,0,0,1,1
55747,120,15278,17602,40515,0,0,1,0,1
55748,120,15280,17767;17907,40515,0,0,2,0,2
55749,120,15282,17828,40515,0,0,1,0,1
55750,120,15283,17747,40515,0,0,1,0,1
55751,120,15287,18203;18558;22626;23043;23262,40515,0,3,2,0,5
55752,120,15289,18431;22514,40515,0,0,2,0,2
55753,120,15290,18442,40515,0,0,1,0,1
55754,120,15293,18251,40515,0,0,1,0,1
55755,120,15297,18501;18522,40515,0,0,2,0,2
55756,120,15302,19297;19913,40515,0,0,2,0,2
55757,120,15307,19668,40515,0,0,1,0,1
55758,120,15308,19851;20311,40515,0,0,2,0,2
55759,120,15309,19841;19921;23597;23907,40515,1,1,2,0,4
55760,120,15310,19709;20025;23319;23611,40515,0,2,2,0,4
55761,120,15312,19973;20305;23020;23234;23622;23834,40515,0,4,2,0,6
55762,120,15313,19760;20139;23229,40515,0,1,2,0,3
55763,120,15314,20006;20422,40515,0,0,2,0,2
55764,120,15316,19730;20266;23931,40515,1,0,2,0,3
55765,120,15317,20041;20408;22601;23632;23840,40515,0,2,3,0,5
55766,120,15318,20189;20359;22718;23121;24228,40515,1,2,2,0,5
55767,120,15320,20107;20614;23347,40515,0,1,2,0,3
55768,120,15322,20292,40515,0,0,1,0,1
55769,120,15323,20363;20917;24360,40515,1,0,2,0,3
55770,120,15324,20362;20438;22822;22919;23023,40515,0,3,2,0,5
55771,120,15326,20461;20843;23564,40515,0,1,2,0,3
55772,120,15327,20877,40515,0,0,1,0,1
55773,120,15328,20426,40515,0,0,1,0,1
55774,120,15329,20551;21080;24272,40515,1,0,2,0,3
55775,120,15330,20580;20786;23563;24350,40515,1,1,2,0,4
55776,120,15331,20621;20701,40515,0,0,2,0,2
55777,120,15332,20593;21162,40515,0,0,2,0,2
55778,120,15333,20599;21278;23460,40515,0,1,2,0,3
55779,120,15334,20597;20608,40515,0,0,2,0,2
55780,120,15335,20609;20824;24158;24252,40515,2,0,2,0,4
55781,120,15336,20638;21356,40515,0,0,2,0,2
55782,120,15337,20650;20716;23852;24243,40515,1,1,2,0,4
55783,120,15338,20675;21049;23455,40515,0,1,2,0,3
55784,120,15339,20569;20677;24145,40515,1,0,2,0,3
55785,120,15340,21217;21392;23575,40515,0,1,2,0,3
55786,120,15342,20758;20944;24060,40515,1,0,2,0,3
55787,120,15343,20955;21047;24376,40515,1,0,2,0,3
55788,120,15344,21214;24178,40515,1,0,1,0,2
55789,120,15345,20553,40515,0,0,1,0,1
55790,120,15346,20852;23863;23973,40515,1,1,1,0,3
55791,120,15347,20819;20866;23140,40515,0,1,2,0,3
55792,120,15348,20896;24256,40515,1,0,1,0,2
55793,120,15349,20899;20936;23754;23980,40515,1,1,2,0,4
55794,120,15350,20647;20914,40515,0,0,2,0,2
55795,120,15351,20919;21304;23881,40515,0,1,2,0,3
55796,120,15352,20935;21525,40515,0,0,2,0,2
55797,120,15353,20939;21156;23762,40515,0,1,2,0,3
55798,120,15354,20820;20959;23253;24251,40515,1,1,2,0,4
55799,120,15355,21441,40515,0,0,1,0,1
55800,120,15356,20976;21052;24172,40515,1,0,2,0,3
55801,120,15357,20913;20977,40515,0,0,2,0,2
55802,120,15358,20984;21364;24187,40515,1,0,2,0,3
55803,120,15359,21290,40515,0,0,1,0,1
55804,120,15360,21040,40515,0,0,1,0,1
55805,120,15361,21073;21159,40515,0,0,2,0,2
55806,120,15362,21243;21295;23767;24083,40515,1,1,2,0,4
55807,120,15363,20995;21086,40515,0,0,2,0,2
55808,120,15364,21023;24268,40515,1,0,1,0,2
55809,120,15365,21208,40515,0,0,1,0,1
55810,120,15366,21014;21180;23356;23878;24276,40515,1,2,2,0,5
55811,120,15367,21186,40515,0,0,1,0,1
55812,120,15368,21169;21189;24177;24381,40515,2,0,2,0,4
55813,120,15369,20864;21203;23358,40515,0,1,2,0,3
55814,120,15370,21209;21252;24281,40515,1,0,2,0,3
55815,120,15371,20691;21254;23361;24180,40515,1,1,2,0,4
55816,120,15372,21449;21460;24288,40515,1,0,2,0,3
55817,120,15373,21280;21550,40515,0,0,2,0,2
55818,120,15374,21289;21387,40515,0,0,2,0,2
55819,120,15375,21281;21291,40515,0,0,2,0,2
55820,120,15376,21220;21294;24279,40515,1,0,2,0,3
55821,120,15377,20994;21307;23573,40515,0,1,2,0,3
55822,120,15378,16856,40880,0,0,0,1,1
55823,120,15379,16929;17086,40880,0,0,0,2,2
55824,120,15380,16879,40880,0,0,0,1,1
55825,120,15382,17203,40880,0,0,0,1,1
55826,120,15383,16952,40880,0,0,0,1,1
55827,120,15384,17274;17706,40880,0,0,2,0,2
55828,120,15385,17268,40880,0,0,0,1,1
55829,120,15386,17214,40880,0,0,0,1,1
55830,120,15387,16967,40880,0,0,0,1,1
55831,120,15389,17544;17596,40880,0,0,2,0,2
55832,120,15390,17558,40880,0,0,1,0,1
55833,120,15391,17131,40880,0,0,0,1,1
55834,120,15395,17752,40880,0,0,1,0,1
55835,120,15398,18176,40880,0,0,1,0,1
55836,120,15402,18725;18798;22636;22945,40880,0,2,2,0,4
55837,120,15406,18852;19569;23688,40880,0,1,2,0,3
55838,120,15409,19008,40880,0,0,1,0,1
55839,120,15411,19305,40880,0,0,1,0,1
55840,120,15412,19363;19954;22811,40880,0,1,2,0,3
55841,120,15413,19245,40880,0,0,1,0,1
55842,120,15415,19519;19769,40880,0,0,2,0,2
55843,120,15417,19241;19706;23094;23194;23403,40880,0,3,2,0,5
55844,120,15418,19834;20162,40880,0,0,2,0,2
55845,120,15420,20005;20104;23018;24222,40880,1,1,2,0,4
55846,120,15421,20279,40880,0,0,1,0,1
55847,120,15423,20157;20405;22920;24034,40880,1,1,2,0,4
55848,120,15425,20837;20971;23451,40880,0,1,2,0,3
55849,120,15426,20389;20631;22605;24241,40880,1,0,3,0,4
55850,120,15427,20402;20811;23862,40880,0,1,2,0,3
55851,120,15428,21001;24076,40880,1,0,1,0,2
55852,120,15430,20522;20578,40880,0,0,2,0,2
55853,120,15431,20625;20867;23975,40880,1,0,2,0,3
55854,120,15432,20576;20666;23961,40880,1,0,2,0,3
55855,120,15433,20503,40880,0,0,1,0,1
55856,120,15434,20750;21506;23888,40880,0,1,2,0,3
55857,120,15435,20594;20835;22929;24161,40880,1,1,2,0,4
55858,120,15436,20391;21114,40880,0,0,2,0,2
55859,120,15437,21537;23772;24087,40880,1,1,1,0,3
55860,120,15438,20883,40880,0,0,1,0,1
55861,120,15439,20548;20900;23567,40880,0,1,2,0,3
55862,120,15440,20960;21134;23756;24367,40880,1,1,2,0,4
55863,120,15441,20962;21471,40880,0,0,2,0,2
55864,120,15442,21021;21081,40880,0,0,2,0,2
55865,120,15443,21064;21372,40880,0,0,2,0,2
55866,120,15444,21123;21236,40880,0,0,2,0,2
55867,120,15445,20645;21077;24377,40880,1,0,2,0,3
55868,120,15446,21094;21201,40880,0,0,2,0,2
55869,120,15447,21105;21340;23996,40880,1,0,2,0,3
55870,120,15448,21120;21633,40880,0,0,2,0,2
55871,120,15449,21140;21206;23877;23990,40880,1,1,2,0,4
55872,120,15450,21171;21453,40880,0,0,2,0,2
55873,120,15451,21174;21310,40880,0,0,2,0,2
55874,120,15452,20755;21188;23357;23764,40880,0,2,2,0,4
55875,120,15453,21187;21193,40880,0,0,2,0,2
55876,120,15454,21202;21554,40880,0,0,2,0,2
55877,120,15455,21207;21286,40880,0,0,2,0,2
55878,120,15456,21126;21258,40880,0,0,2,0,2
55879,120,15457,21271;21571,40880,0,0,2,0,2
55880,120,15458,21277;21488;24193,40880,1,0,2,0,3
55881,120,15459,20751;21288,40880,0,0,2,0,2
55882,120,15460,21308;21642,40880,0,0,2,0,2
55883,120,15461,21878,40880,0,0,1,0,1
55884,120,15462,21396;21734,40880,0,0,2,0,2
55885,120,15463,21403;21519,40880,0,0,2,0,2
55886,120,15464,21411;23667;23886,40880,0,2,1,0,3
55887,120,15465,16723,41245,0,0,0,1,1
55888,120,15466,16752,41245,0,0,0,1,1
55889,120,15467,17102,41245,0,0,0,1,1
55890,120,15468,16757,41245,0,0,0,1,1
55891,120,15469,17124,41245,0,0,0,1,1
55892,120,15470,17181;17562,41245,0,0,1,1,2
55893,120,15472,17309;17618,41245,0,0,2,0,2
55894,120,15473,17318,41245,0,0,1,0,1
55895,120,15474,17397;17654,41245,0,0,2,0,2
55896,120,15477,17954,41245,0,0,1,0,1
55897,120,15479,17689;18062,41245,0,0,2,0,2
55898,120,15480,17550,41245,0,0,1,0,1
55899,120,15481,18110,41245,0,0,1,0,1
55900,120,15483,18298;18339,41245,0,0,2,0,2
55901,120,15485,18495,41245,0,0,1,0,1
55902,120,15492,18829,41245,0,0,1,0,1
55903,120,15493,19079,41245,0,0,1,0,1
55904,120,15494,19089,41245,0,0,1,0,1
55905,120,15495,19201,41245,0,0,1,0,1
55906,120,15496,19237,41245,0,0,1,0,1
55907,120,15497,19551;22994;23182;23899,41245,1,2,1,0,4
55908,120,15501,19348,41245,0,0,1,0,1
55909,120,15504,19564;19700;22897;23492;23902;24012,41245,2,2,2,0,6
55910,120,15505,19935;20534,41245,0,0,2,0,2
55911,120,15506,20629;23553;24142,41245,1,1,1,0,3
55912,120,15507,20016;20091;22818;22912;23015;23523;24116;24320,41245,2,4,2,0,8
55913,120,15508,20149,41245,0,0,1,0,1
55914,120,15511,20218,41245,0,0,1,0,1
55915,120,15513,20241;20449;22495;24038;24134,41245,2,0,3,0,5
55916,120,15515,20273;20601;23132,41245,0,1,2,0,3
55917,120,15516,20221;20372,41245,0,0,2,0,2
55918,120,15518,20502;20561,41245,0,0,2,0,2
55919,120,15519,20350;20656;23645;24244,41245,1,1,2,0,4
55920,120,15521,20197;20632;24242,41245,1,0,2,0,3
55921,120,15522,20441;20679;23245;23555;23647,41245,0,3,2,0,5
55922,120,15523,20665;20698,41245,0,0,2,0,2
55923,120,15524,20705;21066;23857;23966;24246,41245,2,1,2,0,5
55924,120,15525,20713;20897;23660;24257,41245,1,1,2,0,4
55925,120,15526,20785;21196,41245,0,0,2,0,2
55926,120,15527,20487;20796;22928;23972,41245,1,1,2,0,4
55927,120,15528,20662;20834,41245,0,0,2,0,2
55928,120,15530,20868;20920;23565,41245,0,1,2,0,3
55929,120,15531,20871;21509,41245,0,0,2,0,2
55930,120,15532,20407;20925;24362,41245,1,0,2,0,3
55931,120,15533,21101;23875;23987;24174,41245,2,1,1,0,4
55932,120,15534,20943;21115;23456,41245,0,1,2,0,3
55933,120,15535,20982;21042;24265,41245,1,0,2,0,3
55934,120,15536,20990;21499,41245,0,0,2,0,2
55935,120,15537,21002;21109,41245,0,0,2,0,2
55936,120,15538,21045;21087;24269,41245,1,0,2,0,3
55937,120,15539,21051,41245,0,0,1,0,1
55938,120,15540,21083,41245,0,0,1,0,1
55939,120,15541,20904;21089;22932,41245,0,1,2,0,3
55940,120,15542,21057;21093,41245,0,0,2,0,2
55941,120,15543,20686;20721,41245,0,0,2,0,2
55942,120,15544,21760;24299,41245,1,0,1,0,2
55943,120,15545,21393;23363;23769;24190,41245,1,2,1,0,4
55944,120,15546,21119;21176,41245,0,0,2,0,2
55945,120,15547,21020;21121;24079,41245,1,0,2,0,3
55946,120,15548,21141;24176,41245,1,0,1,0,2
55947,120,15549,21168;21565;24292,41245,1,0,2,0,3
55948,120,15550,21213;21231;23359;23991,41245,1,1,2,0,4
55949,120,15551,21219;21235,41245,0,0,2,0,2
55950,120,15552,21248;21273,41245,0,0,2,0,2
55951,120,15553,20848;21296;24387,41245,1,0,2,0,3
55952,120,15554,21351;21865,41245,0,0,2,0,2
55953,120,15555,21352;21903,41245,0,0,2,0,2
55954,120,15556,21362;21594;24088,41245,1,0,2,0,3
55955,120,15557,21366;21523;23889,41245,0,1,2,0,3
55956,120,15558,21369;21701;24093,41245,1,0,2,0,3
55957,120,15559,21370;21577,41245,0,0,2,0,2
55958,120,15560,21391;21439,41245,0,0,2,0,2
55959,120,15561,21435,41245,0,0,1,0,1
55960,120,15562,21455;21545;23773,41245,0,1,2,0,3
55961,120,15563,21457;21543,41245,0,0,2,0,2
55962,120,15564,21476;21873,41245,0,0,2,0,2
55963,120,15565,21500;21801,41245,0,0,2,0,2
55964,120,15566,21379;21508,41245,0,0,2,0,2
55965,120,15567,21302;21513,41245,0,0,2,0,2
55966,120,15568,21516;21714;24297,41245,1,0,2,0,3
55967,120,15569,21526;21833,41245,0,0,2,0,2
55968,120,15570,17132,41610,0,0,0,1,1
55969,120,15571,17455,41610,0,0,1,0,1
55970,120,15572,17082,41610,0,0,0,1,1
55971,120,15573,17111,41610,0,0,0,1,1
55972,120,15574,17085,41610,0,0,0,1,1
55973,120,15576,17607,41610,0,0,1,0,1
55974,120,15577,17388,41610,0,0,1,0,1
55975,120,15578,17880,41610,0,0,1,0,1
55976,120,15580,17483;17523,41610,0,0,2,0,2
55977,120,15582,18139,41610,0,0,1,0,1
55978,120,15584,17862,41610,0,0,1,0,1
55979,120,15587,18394,41610,0,0,1,0,1
55980,120,15589,17755,41610,0,0,1,0,1
55981,120,15592,18674,41610,0,0,1,0,1
55982,120,15593,18719,41610,0,0,1,0,1
55983,120,15596,19211,41610,0,0,1,0,1
55984,120,15598,18859;18874;22440,41610,0,0,3,0,3
55985,120,15600,19481,41610,0,0,1,0,1
55986,120,15602,19544,41610,0,0,1,0,1
55987,120,15603,19566,41610,0,0,1,0,1
55988,120,15604,19864,41610,0,0,1,0,1
55989,120,15605,20277;20526;22390;23434;23636;23846;24335,41610,1,3,3,0,7
55990,120,15606,19362,41610,0,0,1,0,1
55991,120,15608,19929;20087,41610,0,0,2,0,2
55992,120,15609,20049;20147;23014;23420;23812,41610,0,3,2,0,5
55993,120,15611,20243;20659;23554;23854;24339,41610,1,2,2,0,5
55994,120,15612,20302;20809,41610,0,0,2,0,2
55995,120,15613,19573,41610,0,0,1,0,1
55996,120,15615,20358;20619;23719;23935,41610,1,1,2,0,4
55997,120,15616,20377;20637;23442;24143,41610,1,1,2,0,4
55998,120,15617,20345,41610,0,0,1,0,1
55999,120,15618,20082;20419;23026;23540;23841,41610,0,3,2,0,5
56000,120,15619,19936;20180,41610,0,0,2,0,2
56001,120,15620,20529,41610,0,0,1,0,1
56002,120,15621,20386;20588;23736;24140;24238,41610,2,1,2,0,5
56003,120,15622,20695;20988,41610,0,0,2,0,2
56004,120,15623,20730;21107;23876,41610,0,1,2,0,3
56005,120,15624,20731;20855;23247;23444;24149,41610,1,2,2,0,5
56006,120,15625,20787;20921,41610,0,0,2,0,2
56007,120,15626,20802;21268;24082,41610,1,0,2,0,3
56008,120,15627,20875;21320;24084;24391,41610,2,0,2,0,4
56009,120,15628,20878;21447,41610,0,0,2,0,2
56010,120,15629,20895;21276,41610,0,0,2,0,2
56011,120,15630,20640;20902,41610,0,0,2,0,2
56012,120,15631,20958;24075,41610,1,0,1,0,2
56013,120,15632,20978;21063;23141,41610,0,1,2,0,3
56014,120,15633,20696;20992;24053,41610,1,0,2,0,3
56015,120,15634,20680;21012,41610,0,0,2,0,2
56016,120,15635,20923;21019;23453;23985;24267;24374,41610,3,1,2,0,6
56017,120,15636,21043;21478,41610,0,0,2,0,2
56018,120,15637,20585;21046;23874,41610,0,1,2,0,3
56019,120,15638,21050;21622;24090,41610,1,0,2,0,3
56020,120,15639,20756;21065;24173,41610,1,0,2,0,3
56021,120,15640,21103;21405,41610,0,0,2,0,2
56022,120,15641,21111,41610,0,0,1,0,1
56023,120,15642,21113;21404;23885,41610,0,1,2,0,3
56024,120,15643,21608,41610,0,0,1,0,1
56025,120,15644,21151;21371;23461;23768,41610,0,2,2,0,4
56026,120,15645,21076;21157;24275,41610,1,0,2,0,3
56027,120,15646,21167;21706,41610,0,0,2,0,2
56028,120,15647,21172;21412,41610,0,0,2,0,2
56029,120,15648,20714;21185,41610,0,0,2,0,2
56030,120,15649,20968;21192;23142,41610,0,1,2,0,3
56031,120,15650,20961,41610,0,0,1,0,1
56032,120,15651,21270,41610,0,0,1,0,1
56033,120,15652,21299;21337;23993;24184,41610,2,0,2,0,4
56034,120,15653,21301;21420,41610,0,0,2,0,2
56035,120,15654,21326;21482;24394,41610,1,0,2,0,3
56036,120,15655,21263;21342,41610,0,0,2,0,2
56037,120,15656,21344;21485,41610,0,0,2,0,2
56038,120,15657,21376;21528;23574,41610,0,1,2,0,3
56039,120,15658,21397;21421;24191,41610,1,0,2,0,3
56040,120,15659,21197;21419,41610,0,0,2,0,2
56041,120,15660,21434;22036,41610,0,0,2,0,2
56042,120,15661,21479;21785,41610,0,0,2,0,2
56043,120,15662,21249;21483;23364;24290,41610,1,1,2,0,4
56044,120,15663,21524,41610,0,0,1,0,1
56045,120,15664,21327;21540,41610,0,0,2,0,2
56046,120,15665,21578;21674,41610,0,0,2,0,2
56047,120,15666,21772,41610,0,0,1,0,1
56048,120,15667,21599;21973,41610,0,0,2,0,2
56049,120,15668,21504;21621,41610,0,0,2,0,2
56050,120,15669,21467,41610,0,0,1,0,1
56051,120,15670,21261;21660,41610,0,0,2,0,2
56052,120,15671,17018;17376,41975,0,0,1,1,2
56053,120,15673,17496,41975,0,0,1,0,1
56054,120,15674,17303,41975,0,0,1,0,1
56055,120,15675,17664,41975,0,0,1,0,1
56056,120,15676,17859,41975,0,0,1,0,1
56057,120,15677,17846,41975,0,0,1,0,1
56058,120,15678,17978,41975,0,0,1,0,1
56059,120,15681,18269;18407,41975,0,0,2,0,2
56060,120,15682,18524,41975,0,0,1,0,1
56061,120,15683,18429,41975,0,0,1,0,1
56062,120,15684,18280,41975,0,0,1,0,1
56063,120,15686,18706,41975,0,0,1,0,1
56064,120,15687,18713,41975,0,0,1,0,1
56065,120,15688,18801,41975,0,0,1,0,1
56066,120,15695,19113,41975,0,0,1,0,1
56067,120,15696,19473,41975,0,0,1,0,1
56068,120,15697,19510,41975,0,0,1,0,1
56069,120,15698,19248,41975,0,0,1,0,1
56070,120,15699,19592,41975,0,0,1,0,1
56071,120,15700,19863;19925;23009,41975,0,1,2,0,3
56072,120,15701,19626,41975,0,0,1,0,1
56073,120,15704,18996,41975,0,0,1,0,1
56074,120,15706,19965,41975,0,0,1,0,1
56075,120,15707,19532,41975,0,0,1,0,1
56076,120,15708,20192;21132,41975,0,0,2,0,2
56077,120,15709,19941;20658;23853;23960,41975,1,1,2,0,4
56078,120,15710,19931;20095;22715;23016,41975,0,2,2,0,4
56079,120,15711,20308;20706;23557,41975,0,1,2,0,3
56080,120,15712,20442;20743;24346,41975,1,0,2,0,3
56081,120,15714,20767;22606;23138;24062,41975,1,1,2,0,4
56082,120,15715,19930,41975,0,0,1,0,1
56083,120,15717,20735;21218,41975,0,0,2,0,2
56084,120,15718,20670;20762;23746;23969;24249,41975,2,1,2,0,5
56085,120,15719,20482;20769;23252,41975,0,1,2,0,3
56086,120,15720,20771;20799,41975,0,0,2,0,2
56087,120,15721,20831;20907;24070;24260,41975,2,0,2,0,4
56088,120,15722,20851,41975,0,0,1,0,1
56089,120,15723,20833;20905;23446,41975,0,1,2,0,3
56090,120,15724,20928;21129;23569,41975,0,1,2,0,3
56091,120,15725,20947;21179;23259,41975,0,1,2,0,3
56092,120,15726,20957;21006;24371,41975,1,0,2,0,3
56093,120,15727,21606;23890,41975,0,1,1,0,2
56094,120,15728,21054;21436,41975,0,0,2,0,2
56095,120,15729,21055;21165;23763;24379,41975,1,1,2,0,4
56096,120,15730,21062;21223,41975,0,0,2,0,2
56097,120,15731,21335,41975,0,0,1,0,1
56098,120,15732,21085;21260,41975,0,0,2,0,2
56099,120,15733,21116;21443,41975,0,0,2,0,2
56100,120,15734,21149;21662,41975,0,0,2,0,2
56101,120,15735,21152;21181,41975,0,0,2,0,2
56102,120,15737,20931;21228,41975,0,0,2,0,2
56103,120,15739,21233;23766,41975,0,1,1,0,2
56104,120,15740,21237;21590,41975,0,0,2,0,2
56105,120,15741,21239;21266;24280,41975,1,0,2,0,3
56106,120,15742,21269;21707,41975,0,0,2,0,2
56107,120,15743,21267;21284;24182;24284,41975,2,0,2,0,4
56108,120,15744,21139;21303;24388,41975,1,0,2,0,3
56109,120,15745,21331;21450,41975,0,0,2,0,2
56110,120,15746,21242;21375,41975,0,0,2,0,2
56111,120,15747,21071;21381;23362;23997,41975,1,1,2,0,4
56112,120,15748,21431;21757,41975,0,0,2,0,2
56113,120,15749,21464;21953;24302,41975,1,0,2,0,3
56114,120,15750,20872;20952;24167,41975,1,0,2,0,3
56115,120,15751,21539;21738,41975,0,0,2,0,2
56116,120,15752,21541;22089,41975,0,0,2,0,2
56117,120,15753,21551;21964,41975,0,0,2,0,2
56118,120,15754,21559;22106,41975,0,0,2,0,2
56119,120,15755,21692;21970,41975,0,0,2,0,2
56120,120,15756,21592,41975,0,0,1,0,1
56121,120,15757,21534;21593,41975,0,0,2,0,2
56122,120,15758,21598;21829,41975,0,0,2,0,2
56123,120,15759,21600;21800,41975,0,0,2,0,2
56124,120,15760,21604;22081,41975,0,0,2,0,2
56125,120,15761,20975,41975,0,0,1,0,1
56126,120,15762,21616;22042,41975,0,0,2,0,2
56127,120,15763,21640,41975,0,0,1,0,1
56128,120,15764,21644;21895;24411,41975,1,0,2,0,3
56129,120,15765,21647;21845,41975,0,0,2,0,2
56130,120,15766,21649,41975,0,0,1,0,1
56131,120,15767,21667;21808,41975,0,0,2,0,2
56132,120,15768,21726,41975,0,0,1,0,1
56133,120,15769,21777,41975,0,0,1,0,1
56134,120,15770,21719;22021;24002;24208,41975,2,0,2,0,4
56135,120,15771,21357;21723;23999,41975,1,0,2,0,3
56136,120,15772,21758;21870,41975,0,0,2,0,2
56137,120,15773,17363,42340,0,0,1,0,1
56138,120,15774,17449,42340,0,0,1,0,1
56139,120,15775,17316,42340,0,0,1,0,1
56140,120,15776,17675,42340,0,0,1,0,1
56141,120,15778,17916,42340,0,0,1,0,1
56142,120,15780,18042;18235,42340,0,0,2,0,2
56143,120,15781,18109,42340,0,0,1,0,1
56144,120,15782,18031;18287,42340,0,0,2,0,2
56145,120,15784,18762;18876,42340,0,0,2,0,2
56146,120,15786,19001,42340,0,0,1,0,1
56147,120,15787,19076,42340,0,0,1,0,1
56148,120,15788,19144,42340,0,0,1,0,1
56149,120,15790,19198;19672,42340,0,0,2,0,2
56150,120,15791,19284,42340,0,0,1,0,1
56151,120,15792,19064,42340,0,0,1,0,1
56152,120,15793,19026,42340,0,0,1,0,1
56153,120,15795,18873,42340,0,0,1,0,1
56154,120,15797,19674,42340,0,0,1,0,1
56155,120,15798,19744,42340,0,0,1,0,1
56156,120,15799,19804;20137;23227,42340,0,1,2,0,3
56157,120,15800,19699,42340,0,0,1,0,1
56158,120,15801,19859;19938,42340,0,0,2,0,2
56159,120,15802,20043;23109;23612,42340,0,2,1,0,3
56160,120,15803,20063;20337,42340,0,0,2,0,2
56161,120,15804,19820;20088;23921;24115,42340,2,0,2,0,4
56162,120,15805,20113;20511,42340,0,0,2,0,2
56163,120,15808,20214,42340,0,0,1,0,1
56164,120,15809,20439;21178,42340,0,0,2,0,2
56165,120,15810,20371;20536;22829;24234,42340,1,1,2,0,4
56166,120,15811,20583,42340,0,0,1,0,1
56167,120,15812,20763;20876;23256;23868;24354,42340,1,2,2,0,5
56168,120,15813,20749;20774,42340,0,0,2,0,2
56169,120,15814,20793;20981,42340,0,0,2,0,2
56170,120,15815,20813,42340,0,0,1,0,1
56171,120,15816,20853;23255;23864;24352,42340,1,2,1,0,4
56172,120,15817,20707;20869,42340,0,0,2,0,2
56173,120,15818,20873;20969;23352,42340,0,1,2,0,3
56174,120,15819,20844;20951;23755;24366,42340,1,1,2,0,4
56175,120,15820,20639;20966,42340,0,0,2,0,2
56176,120,15821,20991;21010;24373,42340,1,0,2,0,3
56177,120,15822,21009;21031;24266;24372,42340,2,0,2,0,4
56178,120,15823,21027;21623,42340,0,0,2,0,2
56179,120,15824,21079;21164,42340,0,0,2,0,2
56180,120,15825,21125;21496;24291,42340,1,0,2,0,3
56181,120,15826,21144;21705;24404,42340,1,0,2,0,3
56182,120,15827,21146,42340,0,0,1,0,1
56183,120,15828,21148;24080;24378,42340,2,0,1,0,3
56184,120,15829,21182;21183,42340,0,0,2,0,2
56185,120,15830,21212;21736,42340,0,0,2,0,2
56186,120,15831,21910;23671,42340,0,1,1,0,2
56187,120,15832,20818;21225;23458,42340,0,1,2,0,3
56188,120,15833,20805,42340,0,0,1,0,1
56189,120,15834,20882;21246;23459,42340,0,1,2,0,3
56190,120,15835,21264;21830,42340,0,0,2,0,2
56191,120,15836,21136;21334,42340,0,0,2,0,2
56192,120,15837,21346;21365;23882;24392,42340,1,1,2,0,4
56193,120,15838,21763,42340,0,0,1,0,1
56194,120,15839,21472;21635,42340,0,0,2,0,2
56195,120,15840,21427;21503;23887,42340,0,1,2,0,3
56196,120,15841,21108;21522,42340,0,0,2,0,2
56197,120,15842,21292;21529,42340,0,0,2,0,2
56198,120,15843,21552;21575;23464;24398,42340,1,1,2,0,4
56199,120,15844,21561,42340,0,0,1,0,1
56200,120,15845,21489;21591,42340,0,0,2,0,2
56201,120,15846,21517;21595;24196,42340,1,0,2,0,3
56202,120,15847,21680;24091;24198,42340,2,0,1,0,3
56203,120,15848,21872,42340,0,0,1,0,1
56204,120,15849,21669;22059,42340,0,0,2,0,2
56205,120,15850,21694;24403,42340,1,0,1,0,2
56206,120,15851,21100;21722,42340,0,0,2,0,2
56207,120,15852,21725;21790,42340,0,0,2,0,2
56208,120,15853,21729;22181,42340,0,0,2,0,2
56209,120,15854,21759;22260,42340,0,0,2,0,2
56210,120,15855,21515;21769,42340,0,0,2,0,2
56211,120,15856,21532;21779,42340,0,0,2,0,2
56212,120,15857,21792;21852,42340,0,0,2,0,2
56213,120,15858,21425;21799,42340,0,0,2,0,2
56214,120,15859,21636;21804,42340,0,0,2,0,2
56215,120,15860,21817;22121,42340,0,0,2,0,2
56216,120,15861,21820;21886;24408,42340,1,0,2,0,3
56217,120,15862,21861;24409,42340,1,0,1,0,2
56218,120,15863,21866;22055;24000,42340,1,0,2,0,3
56219,120,15864,21909;21994;24307,42340,1,0,2,0,3
56220,120,15865,17308;17655,42705,0,0,2,0,2
56221,120,15866,17478,42705,0,0,1,0,1
56222,120,15868,17886,42705,0,0,1,0,1
56223,120,15872,18077,42705,0,0,1,0,1
56224,120,15873,18293,42705,0,0,1,0,1
56225,120,15875,18511,42705,0,0,1,0,1
56226,120,15876,18482,42705,0,0,1,0,1
56227,120,15877,18460;18568,42705,0,0,2,0,2
56228,120,15878,18322,42705,0,0,1,0,1
56229,120,15879,18250,42705,0,0,1,0,1
56230,120,15880,18392,42705,0,0,1,0,1
56231,120,15881,19034,42705,0,0,1,0,1
56232,120,15883,19188,42705,0,0,1,0,1
56233,120,15884,19210,42705,0,0,1,0,1
56234,120,15887,19588,42705,0,0,1,0,1
56235,120,15888,19631,42705,0,0,1,0,1
56236,120,15890,19558,42705,0,0,1,0,1
56237,120,15891,19645,42705,0,0,1,0,1
56238,120,15892,19765,42705,0,0,1,0,1
56239,120,15893,19571,42705,0,0,1,0,1
56240,120,15895,19602,42705,0,0,1,0,1
56241,120,15899,20176,42705,0,0,1,0,1
56242,120,15900,19942,42705,0,0,1,0,1
56243,120,15901,20204;20644;24144;24338,42705,2,0,2,0,4
56244,120,15903,20446;20839,42705,0,0,2,0,2
56245,120,15904,20466,42705,0,0,1,0,1
56246,120,15905,20473,42705,0,0,1,0,1
56247,120,15906,20390;20477;23122;23333;24031,42705,1,2,2,0,5
56248,120,15907,20510,42705,0,0,1,0,1
56249,120,15908,20379;20514;23949,42705,1,0,2,0,3
56250,120,15909,20543,42705,0,0,1,0,1
56251,120,15910,20726;21285;24183,42705,1,0,2,0,3
56252,120,15911,20741;23562;23744,42705,0,2,1,0,3
56253,120,15912,20782;21255,42705,0,0,2,0,2
56254,120,15913,20807;20916;23445,42705,0,1,2,0,3
56255,120,15914,20857;21084;23974,42705,1,0,2,0,3
56256,120,15915,21154;21194;23572,42705,0,1,2,0,3
56257,120,15916,21177;21265;24181;24282,42705,2,0,2,0,4
56258,120,15917,21305;21885,42705,0,0,2,0,2
56259,120,15918,21309;24389,42705,1,0,1,0,2
56260,120,15919,21353;21416,42705,0,0,2,0,2
56261,120,15920,21232;21377;23666;23884;24188,42705,1,2,2,0,5
56262,120,15921,21395,42705,0,0,1,0,1
56263,120,15922,21216;21410,42705,0,0,2,0,2
56264,120,15924,21417;21688;24402,42705,1,0,2,0,3
56265,120,15925,21418,42705,0,0,1,0,1
56266,120,15926,21422;21874,42705,0,0,2,0,2
56267,120,15927,21424;22175,42705,0,0,2,0,2
56268,120,15928,21428;21574,42705,0,0,2,0,2
56269,120,15929,21440,42705,0,0,1,0,1
56270,120,15931,21452;22157,42705,0,0,2,0,2
56271,120,15932,21462;21619,42705,0,0,2,0,2
56272,120,15933,21468;21740;24406,42705,1,0,2,0,3
56273,120,15934,21475;21859;23776,42705,0,1,2,0,3
56274,120,15935,21484;21751,42705,0,0,2,0,2
56275,120,15936,21898,42705,0,0,1,0,1
56276,120,15937,21531;21675;23462;23669,42705,0,2,2,0,4
56277,120,15938,22013;24416,42705,1,0,1,0,2
56278,120,15939,21205;21567,42705,0,0,2,0,2
56279,120,15940,21582;21784,42705,0,0,2,0,2
56280,120,15941,21597,42705,0,0,1,0,1
56281,120,15942,21612;22188,42705,0,0,2,0,2
56282,120,15943,21384;21625;24399,42705,1,0,2,0,3
56283,120,15944,21632;21957,42705,0,0,2,0,2
56284,120,15945,21466;21654;24192,42705,1,0,2,0,3
56285,120,15946,21690,42705,0,0,1,0,1
56286,120,15947,21718;22312,42705,0,0,2,0,2
56287,120,15948,21741;21911,42705,0,0,2,0,2
56288,120,15949,21742;21849;23775,42705,0,1,2,0,3
56289,120,15950,21761;22237,42705,0,0,2,0,2
56290,120,15951,21803;21921;23777,42705,0,1,2,0,3
56291,120,15952,21807,42705,0,0,1,0,1
56292,120,15953,21810;21935,42705,0,0,2,0,2
56293,120,15954,21812;21847;24202,42705,1,0,2,0,3
56294,120,15955,22196,42705,0,0,1,0,1
56295,120,15956,21834;22104;24421,42705,1,0,2,0,3
56296,120,15957,21838;22286,42705,0,0,2,0,2
56297,120,15958,21851;22025;24308,42705,1,0,2,0,3
56298,120,15959,21658;22149,42705,0,0,2,0,2
56299,120,15960,21843;21875;24301,42705,1,0,2,0,3
56300,120,15961,21881;21892,42705,0,0,2,0,2
56301,120,15962,21888;22302,42705,0,0,2,0,2
56302,120,15963,21648;21894,42705,0,0,2,0,2
56303,120,15964,21704;21906,42705,0,0,2,0,2
56304,120,15965,21946;22147,42705,0,0,2,0,2
56305,120,15966,21977;22065,42705,0,0,2,0,2
56306,120,15967,21989,42705,0,0,1,0,1
56307,120,15968,21815;22008,42705,0,0,2,0,2
56308,120,15969,21560,42705,0,0,1,0,1
56309,120,15970,17588,43070,0,0,1,0,1
56310,120,15971,17471,43070,0,0,1,0,1
56311,120,15972,17569,43070,0,0,1,0,1
56312,120,15973,17658,43070,0,0,1,0,1
56313,120,15974,17950;18321,43070,0,0,2,0,2
56314,120,15975,17491,43070,0,0,1,0,1
56315,120,15976,17642,43070,0,0,1,0,1
56316,120,15977,17949,43070,0,0,1,0,1
56317,120,15978,18130,43070,0,0,1,0,1
56318,120,15979,18086,43070,0,0,1,0,1
56319,120,15980,18652,43070,0,0,1,0,1
56320,120,15981,18596,43070,0,0,1,0,1
56321,120,15982,18496,43070,0,0,1,0,1
56322,120,15983,18800,43070,0,0,1,0,1
56323,120,15986,19014,43070,0,0,1,0,1
56324,120,15987,19110;19594;22796;22995,43070,0,2,2,0,4
56325,120,15989,19327,43070,0,0,1,0,1
56326,120,15992,19541,43070,0,0,1,0,1
56327,120,15993,19607,43070,0,0,1,0,1
56328,120,15994,19224,43070,0,0,1,0,1
56329,120,15995,19787,43070,0,0,1,0,1
56330,120,15996,19869;20729;23136;24055;24148,43070,2,1,2,0,5
56331,120,15997,19716,43070,0,0,1,0,1
56332,120,15998,19977,43070,0,0,1,0,1
56333,120,15999,20123;20392;22819;23225;23924,43070,1,2,2,0,5
56334,120,16000,20352;20700;23033;23650;23741;23855;24054,43070,1,4,2,0,7
56335,120,16001,20171;20428;23727;23942,43070,1,1,2,0,4
56336,120,16002,20250,43070,0,0,1,0,1
56337,120,16003,20252,43070,0,0,1,0,1
56338,120,16004,20300;20747;23745;24348,43070,1,1,2,0,4
56339,120,16006,20166;20366;22599;23627,43070,0,1,3,0,4
56340,120,16007,19818,43070,0,0,1,0,1
56341,120,16008,20425;20768,43070,0,0,2,0,2
56342,120,16009,20125;20587,43070,0,0,2,0,2
56343,120,16010,20326,43070,0,0,1,0,1
56344,120,16011,20512;20676;23646;23963;24051,43070,2,1,2,0,5
56345,120,16013,20628,43070,0,0,1,0,1
56346,120,16014,20681;20752,43070,0,0,2,0,2
56347,120,16015,20469,43070,0,0,1,0,1
56348,120,16016,20816,43070,0,0,1,0,1
56349,120,16017,20817;21390,43070,0,0,2,0,2
56350,120,16018,20822,43070,0,0,1,0,1
56351,120,16020,20933;21501;24195,43070,1,0,2,0,3
56352,120,16021,20987;21518,43070,0,0,2,0,2
56353,120,16022,21075;21350,43070,0,0,2,0,2
56354,120,16023,21104,43070,0,0,1,0,1
56355,120,16024,20669,43070,0,0,1,0,1
56356,120,16025,21195,43070,0,0,1,0,1
56357,120,16026,21163,43070,0,0,1,0,1
56358,120,16027,21229;21836;23893,43070,0,1,2,0,3
56359,120,16028,21234;21716,43070,0,0,2,0,2
56360,120,16029,21215;21282;23765;23879;24382,43070,1,2,2,0,5
56361,120,16030,21287;21512,43070,0,0,2,0,2
56362,120,16031,21099;21321;23995,43070,1,0,2,0,3
56363,120,16032,21018;21329,43070,0,0,2,0,2
56364,120,16033,21349;21607,43070,0,0,2,0,2
56365,120,16034,21363,43070,0,0,1,0,1
56366,120,16035,21127;21402;24393,43070,1,0,2,0,3
56367,120,16036,21426;21839,43070,0,0,2,0,2
56368,120,16037,21437;21657,43070,0,0,2,0,2
56369,120,16038,21311;21510,43070,0,0,2,0,2
56370,120,16039,21446,43070,0,0,1,0,1
56371,120,16040,21659;21988,43070,0,0,2,0,2
56372,120,16041,21106;21664;24400,43070,1,0,2,0,3
56373,120,16042,21602,43070,0,0,1,0,1
56374,120,16043,21563;21702,43070,0,0,2,0,2
56375,120,16044,21703;21908,43070,0,0,2,0,2
56376,120,16045,21708;22236,43070,0,0,2,0,2
56377,120,16047,21720;22003,43070,0,0,2,0,2
56378,120,16048,21530;21767,43070,0,0,2,0,2
56379,120,16049,21461;21771,43070,0,0,2,0,2
56380,120,16050,21775,43070,0,0,1,0,1
56381,120,16051,21798;22354,43070,0,0,2,0,2
56382,120,16052,21458;21809,43070,0,0,2,0,2
56383,120,16053,21825;21841,43070,0,0,2,0,2
56384,120,16054,21853,43070,0,0,1,0,1
56385,120,16055,21883;22241,43070,0,0,2,0,2
56386,120,16056,21904;21968;24304,43070,1,0,2,0,3
56387,120,16057,22080,43070,0,0,1,0,1
56388,120,16058,21919;21969,43070,0,0,2,0,2
56389,120,16059,21917;21942,43070,0,0,2,0,2
56390,120,16060,21948;22178,43070,0,0,2,0,2
56391,120,16061,21588,43070,0,0,1,0,1
56392,120,16062,22010;22249,43070,0,0,2,0,2
56393,120,16063,22022;22287,43070,0,0,2,0,2
56394,120,16064,22043;22045,43070,0,0,2,0,2
56395,120,16065,22054;22073,43070,0,0,2,0,2
56396,120,16066,21916,43070,0,0,1,0,1
56397,120,16067,22083;22109,43070,0,0,2,0,2
56398,120,16068,21796;22094,43070,0,0,2,0,2
56399,120,16069,22092;22111,43070,0,0,2,0,2
56400,120,16070,22113;22133,43070,0,0,2,0,2
56401,120,16071,22134;22240,43070,0,0,2,0,2
56402,120,16072,21955;22140,43070,0,0,2,0,2
56403,120,16073,22034;22148,43070,0,0,2,0,2
56404,120,16074,17597,43435,0,0,1,0,1
56405,120,16075,17105,43435,0,0,0,1,1
56406,120,16076,17636,43435,0,0,1,0,1
56407,120,16077,17764,43435,0,0,1,0,1
56408,120,16078,17499,43435,0,0,1,0,1
56409,120,16080,18044,43435,0,0,1,0,1
56410,120,16081,18172,43435,0,0,1,0,1
56411,120,16083,18370,43435,0,0,1,0,1
56412,120,16084,18427,43435,0,0,1,0,1
56413,120,16085,18459,43435,0,0,1,0,1
56414,120,16086,17965,43435,0,0,1,0,1
56415,120,16087,18583,43435,0,0,1,0,1
56416,120,16088,18562,43435,0,0,1,0,1
56417,120,16090,18745,43435,0,0,1,0,1
56418,120,16091,18576,43435,0,0,1,0,1
56419,120,16093,19383,43435,0,0,1,0,1
56420,120,16094,19102,43435,0,0,1,0,1
56421,120,16095,19340,43435,0,0,1,0,1
56422,120,16096,19047,43435,0,0,1,0,1
56423,120,16098,19486,43435,0,0,1,0,1
56424,120,16099,19523,43435,0,0,1,0,1
56425,120,16100,19651,43435,0,0,1,0,1
56426,120,16102,20052,43435,0,0,1,0,1
56427,120,16103,20119,43435,0,0,1,0,1
56428,120,16104,19624,43435,0,0,1,0,1
56429,120,16105,20607;20812;23139;23750;24157,43435,1,2,2,0,5
56430,120,16106,20341,43435,0,0,1,0,1
56431,120,16107,20530;21056,43435,0,0,2,0,2
56432,120,16108,20800,43435,0,0,1,0,1
56433,120,16109,20815,43435,0,0,1,0,1
56434,120,16110,20847;21091,43435,0,0,2,0,2
56435,120,16111,20849,43435,0,0,1,0,1
56436,120,16112,21029,43435,0,0,1,0,1
56437,120,16113,20861;21339,43435,0,0,2,0,2
56438,120,16114,20926,43435,0,0,1,0,1
56439,120,16115,20970;21067,43435,0,0,2,0,2
56440,120,16116,20985,43435,0,0,1,0,1
56441,120,16117,21061;21558,43435,0,0,2,0,2
56442,120,16118,20949;21131;23570,43435,0,1,2,0,3
56443,120,16119,21147;21407;23770;23998;24286,43435,2,1,2,0,5
56444,120,16120,21256,43435,0,0,1,0,1
56445,120,16121,21128;21211;24081,43435,1,0,2,0,3
56446,120,16122,21279;21300,43435,0,0,2,0,2
56447,120,16123,21283;21709;24094;24405,43435,2,0,2,0,4
56448,120,16124,20998;21322,43435,0,0,2,0,2
56449,120,16125,21355;21987,43435,0,0,2,0,2
56450,120,16126,21275;21361,43435,0,0,2,0,2
56451,120,16127,21373;21459;24289,43435,1,0,2,0,3
56452,120,16128,21378;21695,43435,0,0,2,0,2
56453,120,16129,21413;21481,43435,0,0,2,0,2
56454,120,16130,21433;21980;24415,43435,1,0,2,0,3
56455,120,16131,21438;21547,43435,0,0,2,0,2
56456,120,16132,21470,43435,0,0,1,0,1
56457,120,16133,21312;21589,43435,0,0,2,0,2
56458,120,16134,21609;21975,43435,0,0,2,0,2
56459,120,16135,21626;21902;24412,43435,1,0,2,0,3
56460,120,16136,21628;21897,43435,0,0,2,0,2
56461,120,16137,21583;21663;23891,43435,0,1,2,0,3
56462,120,16138,21684;21939,43435,0,0,2,0,2
56463,120,16139,21732;22061;24420,43435,1,0,2,0,3
56464,120,16140,21733;22492,43435,0,0,2,0,2
56465,120,16141,21748;24201,43435,1,0,1,0,2
56466,120,16142,21710,43435,0,0,1,0,1
56467,120,16143,21274;21780,43435,0,0,2,0,2
56468,120,16144,21813;22214,43435,0,0,2,0,2
56469,120,16145,21854;21931,43435,0,0,2,0,2
56470,120,16146,21190;21863;24410,43435,1,0,2,0,3
56471,120,16147,21884;22378,43435,0,0,2,0,2
56472,120,16148,21827;21907,43435,0,0,2,0,2
56473,120,16149,21222,43435,0,0,1,0,1
56474,120,16150,21088;21912,43435,0,0,2,0,2
56475,120,16151,21922;22261,43435,0,0,2,0,2
56476,120,16152,21774;21933;24413,43435,1,0,2,0,3
56477,120,16153,21429;21934,43435,0,0,2,0,2
56478,120,16154,21937;22091,43435,0,0,2,0,2
56479,120,16155,21960;22306,43435,0,0,2,0,2
56480,120,16156,21997;22098,43435,0,0,2,0,2
56481,120,16157,22017;22410,43435,0,0,2,0,2
56482,120,16158,21586;22056;24099,43435,1,0,2,0,3
56483,120,16159,22064;22125,43435,0,0,2,0,2
56484,120,16160,22074;22438,43435,0,0,2,0,2
56485,120,16161,22075;22305,43435,0,0,2,0,2
56486,120,16162,22076;22299,43435,0,0,2,0,2
56487,120,16163,22078,43435,0,0,1,0,1
56488,120,16164,22079;22314,43435,0,0,2,0,2
56489,120,16165,22095;22359,43435,0,0,2,0,2
56490,120,16166,22101;22276,43435,0,0,2,0,2
56491,120,16167,22132;22293,43435,0,0,2,0,2
56492,120,16168,22145;22162,43435,0,0,2,0,2
56493,120,16169,22163;22330,43435,0,0,2,0,2
56494,120,16170,22177;22423,43435,0,0,2,0,2
56495,120,16171,22180;22316,43435,0,0,2,0,2
56496,120,16172,22211;22475,43435,0,0,2,0,2
56497,120,16173,22218;22321,43435,0,0,2,0,2
56498,120,16174,21776;22267,43435,0,0,2,0,2
56499,120,16175,22274;22385,43435,0,0,2,0,2
56500,120,16176,17537,43800,0,0,1,0,1
56501,120,16177,17953,43800,0,0,1,0,1
56502,120,16178,18030,43800,0,0,1,0,1
56503,120,16179,17989,43800,0,0,1,0,1
56504,120,16180,17994,43800,0,0,1,0,1
56505,120,16181,18079,43800,0,0,1,0,1
56506,120,16182,18227,43800,0,0,1,0,1
56507,120,16183,18384,43800,0,0,1,0,1
56508,120,16184,18256,43800,0,0,1,0,1
56509,120,16185,18119,43800,0,0,1,0,1
56510,120,16186,18123,43800,0,0,1,0,1
56511,120,16187,18559,43800,0,0,1,0,1
56512,120,16188,18138,43800,0,0,1,0,1
56513,120,16189,18705,43800,0,0,1,0,1
56514,120,16190,18749,43800,0,0,1,0,1
56515,120,16191,18790,43800,0,0,1,0,1
56516,120,16192,19128,43800,0,0,1,0,1
56517,120,16193,19240,43800,0,0,1,0,1
56518,120,16194,18936,43800,0,0,1,0,1
56519,120,16195,19081,43800,0,0,1,0,1
56520,120,16196,18752,43800,0,0,1,0,1
56521,120,16197,19183,43800,0,0,1,0,1
56522,120,16199,19543,43800,0,0,1,0,1
56523,120,16200,19671,43800,0,0,1,0,1
56524,120,16201,19236,43800,0,0,1,0,1
56525,120,16202,19406,43800,0,0,1,0,1
56526,120,16203,19697,43800,0,0,1,0,1
56527,120,16204,19540,43800,0,0,1,0,1
56528,120,16205,19466,43800,0,0,1,0,1
56529,120,16206,19900,43800,0,0,1,0,1
56530,120,16207,19748,43800,0,0,1,0,1
56531,120,16209,19815;20115,43800,0,0,2,0,2
56532,120,16210,20255;20331;22717;23236;23330,43800,0,3,2,0,5
56533,120,16211,20406,43800,0,0,1,0,1
56534,120,16212,20437,43800,0,0,1,0,1
56535,120,16213,20476,43800,0,0,1,0,1
56536,120,16214,20290;20479,43800,0,0,2,0,2
56537,120,16215,20535,43800,0,0,1,0,1
56538,120,16216,20545,43800,0,0,1,0,1
56539,120,16217,20590,43800,0,0,1,0,1
56540,120,16218,20003,43800,0,0,1,0,1
56541,120,16219,20655;20661;24340,43800,1,0,2,0,3
56542,120,16220,20657,43800,0,0,1,0,1
56543,120,16221,20660,43800,0,0,1,0,1
56544,120,16222,20281,43800,0,0,1,0,1
56545,120,16223,20357,43800,0,0,1,0,1
56546,120,16224,20748;21204,43800,0,0,2,0,2
56547,120,16225,20564;20754;23654;23968,43800,1,1,2,0,4
56548,120,16226,20795;21199,43800,0,0,2,0,2
56549,120,16227,20364,43800,0,0,1,0,1
56550,120,16228,20320,43800,0,0,1,0,1
56551,120,16229,20483,43800,0,0,1,0,1
56552,120,16230,20468;21013,43800,0,0,2,0,2
56553,120,16231,21117;21615,43800,0,0,2,0,2
56554,120,16232,21118;21687,43800,0,0,2,0,2
56555,120,16233,21143,43800,0,0,1,0,1
56556,120,16234,21161,43800,0,0,1,0,1
56557,120,16235,21230;21332,43800,0,0,2,0,2
56558,120,16236,21082;21251,43800,0,0,2,0,2
56559,120,16237,20996;21272;23992;24283,43800,2,0,2,0,4
56560,120,16238,21078,43800,0,0,1,0,1
56561,120,16239,21345;22028;24098,43800,1,0,2,0,3
56562,120,16240,21432;22212,43800,0,0,2,0,2
56563,120,16241,21643,43800,0,0,1,0,1
56564,120,16242,21330;21511;23771,43800,0,1,2,0,3
56565,120,16243,21520;21652,43800,0,0,2,0,2
56566,120,16244,21587,43800,0,0,1,0,1
56567,120,16245,21383;21564,43800,0,0,2,0,2
56568,120,16246,21573;21711,43800,0,0,2,0,2
56569,120,16247,21668;22085,43800,0,0,2,0,2
56570,120,16248,21533;21681;24199,43800,1,0,2,0,3
56571,120,16249,20862,43800,0,0,1,0,1
56572,120,16250,21672,43800,0,0,1,0,1
56573,120,16251,21745;21932,43800,0,0,2,0,2
56574,120,16252,21756;21856,43800,0,0,2,0,2
56575,120,16253,21787;22413,43800,0,0,2,0,2
56576,120,16254,21795,43800,0,0,1,0,1
56577,120,16255,21823,43800,0,0,1,0,1
56578,120,16256,21842;22100,43800,0,0,2,0,2
56579,120,16257,21507;21867;24096,43800,1,0,2,0,3
56580,120,16258,21887;22266,43800,0,0,2,0,2
56581,120,16259,21679;21891,43800,0,0,2,0,2
56582,120,16260,21940;22426;24313,43800,1,0,2,0,3
56583,120,16261,21956;22661,43800,0,1,1,0,2
56584,120,16262,21831;21992;24300,43800,1,0,2,0,3
56585,120,16263,21995;22016,43800,0,0,2,0,2
56586,120,16264,21244;22005,43800,0,0,2,0,2
56587,120,16265,22007;22474,43800,0,0,2,0,2
56588,120,16266,21498;22062,43800,0,0,2,0,2
56589,120,16267,22071;22303,43800,0,0,2,0,2
56590,120,16268,22118;22169,43800,0,0,2,0,2
56591,120,16269,21915;22129,43800,0,0,2,0,2
56592,120,16270,22144;22208,43800,0,0,2,0,2
56593,120,16271,22154,43800,0,0,1,0,1
56594,120,16272,21805;22159,43800,0,0,2,0,2
56595,120,16273,22164,43800,0,0,1,0,1
56596,120,16274,22200;22332,43800,0,0,2,0,2
56597,120,16275,22048;22221,43800,0,0,2,0,2
56598,120,16276,22227;22680,43800,0,1,1,0,2
56599,120,16277,22239;22621,43800,0,1,1,0,2
56600,120,16278,22252;22331,43800,0,0,2,0,2
56601,120,16279,22269,43800,0,0,1,0,1
56602,120,16280,22337,43800,0,0,1,0,1
56603,120,16281,22300;22506,43800,0,0,2,0,2
56604,120,16282,21840;22319,43800,0,0,2,0,2
56605,120,16283,22328;22613,43800,0,1,1,0,2
56606,120,16284,22272,43800,0,0,1,0,1
56607,120,16285,22136;22347,43800,0,0,2,0,2
56608,120,16286,22277;22379,43800,0,0,2,0,2
56609,120,16287,22343;22380,43800,0,0,2,0,2
56610,120,16288,22388;22674,43800,0,1,1,0,2
56611,130,6149,15338,8030,0,0,0,1,1
56612,130,6918,15489,11315,0,0,0,1,1
56613,130,7120,15197,12045,0,0,0,1,1
56614,130,7598,17365,13870,0,0,0,1,1
56615,130,7704,17066;17126;17378;17578,14235,0,0,0,4,4
56616,130,7731,19822;19999;23416,14235,0,0,3,0,3
56617,130,7824,16715,14600,0,0,0,1,1
56618,130,8196,17189;17677,16060,0,0,0,2,2
56619,130,8217,17857;18070,16060,0,0,0,2,2
56620,130,8514,16466;16776;17100,17155,0,0,0,3,3
56621,130,8528,18548,17155,0,0,1,0,1
56622,130,8664,18831;19177;23582,17520,0,0,3,0,3
56623,130,8687,18109;18508,17520,0,0,1,1,2
56624,130,8783,13803,17885,0,0,0,1,1
56625,130,8885,14280,18250,0,0,0,1,1
56626,130,8890,14268,18250,0,0,0,1,1
56627,130,8955,17250,18615,0,0,0,1,1
56628,130,8988,13991,18615,0,0,0,1,1
56629,130,8990,14285,18615,0,0,0,1,1
56630,130,8992,13727,18615,0,0,0,1,1
56631,130,8994,14368,18615,0,0,0,1,1
56632,130,8996,14328,18615,0,0,0,1,1
56633,130,9001,14022,18615,0,0,0,1,1
56634,130,9085,14284,18980,0,0,0,1,1
56635,130,9113,14478,18980,0,0,0,1,1
56636,130,9116,14215,18980,0,0,0,1,1
56637,130,9121,14102,18980,0,0,0,1,1
56638,130,9192,14231,19345,0,0,0,1,1
56639,130,9199,14316,19345,0,0,0,1,1
56640,130,9205,14107,19345,0,0,0,1,1
56641,130,9219,13754,19345,0,0,0,1,1
56642,130,9220,17629;17743;17782;17832,19345,0,0,0,4,4
56643,130,9223,14499,19345,0,0,0,1,1
56644,130,9225,14789;17461,19345,0,0,0,2,2
56645,130,9237,14270,19345,0,0,0,1,1
56646,130,9303,13933,19710,0,0,0,1,1
56647,130,9307,14927,19710,0,0,0,1,1
56648,130,9310,14417,19710,0,0,0,1,1
56649,130,9316,18737,19710,0,0,1,0,1
56650,130,9322,14331,19710,0,0,0,1,1
56651,130,9326,14363,19710,0,0,0,1,1
56652,130,9333,14897,19710,0,0,0,1,1
56653,130,9396,14042,20075,0,0,0,1,1
56654,130,9419,14198,20075,0,0,0,1,1
56655,130,9447,14684,20075,0,0,0,1,1
56656,130,9448,14573,20075,0,0,0,1,1
56657,130,9456,15027,20075,0,0,0,1,1
56658,130,9513,14297,20440,0,0,0,1,1
56659,130,9523,13977,20440,0,0,0,1,1
56660,130,9530,14513;17643,20440,0,0,0,2,2
56661,130,9533,14646,20440,0,0,0,1,1
56662,130,9534,14163,20440,0,0,0,1,1
56663,130,9535,14175,20440,0,0,0,1,1
56664,130,9540,14278,20440,0,0,0,1,1
56665,130,9546,14376,20440,0,0,0,1,1
56666,130,9547,13841,20440,0,0,0,1,1
56667,130,9548,14877,20440,0,0,0,1,1
56668,130,9550,14958,20440,0,0,0,1,1
56669,130,9638,14425,20805,0,0,0,1,1
56670,130,9651,14384,20805,0,0,0,1,1
56671,130,9667,14706,20805,0,0,0,1,1
56672,130,9670,15135,20805,0,0,0,1,1
56673,130,9673,15260,20805,0,0,0,1,1
56674,130,9678,15176,20805,0,0,0,1,1
56675,130,9681,15364,20805,0,0,0,1,1
56676,130,9682,14633,20805,0,0,0,1,1
56677,130,9744,14746;15004,21170,0,0,0,2,2
56678,130,9745,14227,21170,0,0,0,1,1
56679,130,9747,14829,21170,0,0,0,1,1
56680,130,9750,14404,21170,0,0,0,1,1
56681,130,9751,14542,21170,0,0,0,1,1
56682,130,9755,14848,21170,0,0,0,1,1
56683,130,9756,14943,21170,0,0,0,1,1
56684,130,9759,14549,21170,0,0,0,1,1
56685,130,9763,15072,21170,0,0,0,1,1
56686,130,9767,14735,21170,0,0,0,1,1
56687,130,9773,15601,21170,0,0,0,1,1
56688,130,9780,14749;14936,21170,0,0,0,2,2
56689,130,9783,14976;15068,21170,0,0,0,2,2
56690,130,9793,14820,21170,0,0,0,1,1
56691,130,9829,17617,21535,0,0,0,1,1
56692,130,9853,14736,21535,0,0,0,1,1
56693,130,9864,14721,21535,0,0,0,1,1
56694,130,9873,14984,21535,0,0,0,1,1
56695,130,9878,14803,21535,0,0,0,1,1
56696,130,9879,14882;15141,21535,0,0,0,2,2
56697,130,9880,15171,21535,0,0,0,1,1
56698,130,9881,14879,21535,0,0,0,1,1
56699,130,9882,15013,21535,0,0,0,1,1
56700,130,9889,15046,21535,0,0,0,1,1
56701,130,9893,15366,21535,0,0,0,1,1
56702,130,9894,15103;15435,21535,0,0,0,2,2
56703,130,9896,15125,21535,0,0,0,1,1
56704,130,9898,14729,21535,0,0,0,1,1
56705,130,9902,15001,21535,0,0,0,1,1
56706,130,9963,15379,21900,0,0,0,1,1
56707,130,9967,14716,21900,0,0,0,1,1
56708,130,9974,14982,21900,0,0,0,1,1
56709,130,9976,14665,21900,0,0,0,1,1
56710,130,9982,14762,21900,0,0,0,1,1
56711,130,9987,15462;15474,21900,0,0,0,2,2
56712,130,9988,14905;15253,21900,0,0,0,2,2
56713,130,9990,15032,21900,0,0,0,1,1
56714,130,9993,14933,21900,0,0,0,1,1
56715,130,9995,15186,21900,0,0,0,1,1
56716,130,9999,15244,21900,0,0,0,1,1
56717,130,10001,15890,21900,0,0,0,1,1
56718,130,10002,14720,21900,0,0,0,1,1
56719,130,10003,15128,21900,0,0,0,1,1
56720,130,10004,15709,21900,0,0,0,1,1
56721,130,10009,15149,21900,0,0,0,1,1
56722,130,10010,15181,21900,0,0,0,1,1
56723,130,10013,15220,21900,0,0,0,1,1
56724,130,10014,15261,21900,0,0,0,1,1
56725,130,10017,15719,21900,0,0,0,1,1
56726,130,10018,15377,21900,0,0,0,1,1
56727,130,10019,15512,21900,0,0,0,1,1
56728,130,10021,14608,21900,0,0,0,1,1
56729,130,10024,15451,21900,0,0,0,1,1
56730,130,10055,14235,22265,0,0,0,1,1
56731,130,10066,15394,22265,0,0,0,1,1
56732,130,10068,14246,22265,0,0,0,1,1
56733,130,10073,14770,22265,0,0,0,1,1
56734,130,10082,15650,22265,0,0,0,1,1
56735,130,10087,14757,22265,0,0,0,1,1
56736,130,10089,15525,22265,0,0,0,1,1
56737,130,10094,14888,22265,0,0,0,1,1
56738,130,10096,15413,22265,0,0,0,1,1
56739,130,10102,15131,22265,0,0,0,1,1
56740,130,10104,15012,22265,0,0,0,1,1
56741,130,10107,15095,22265,0,0,0,1,1
56742,130,10109,15188,22265,0,0,0,1,1
56743,130,10110,15557,22265,0,0,0,1,1
56744,130,10112,15203,22265,0,0,0,1,1
56745,130,10113,14191,22265,0,0,0,1,1
56746,130,10116,15229;15495,22265,0,0,0,2,2
56747,130,10121,15884,22265,0,0,0,1,1
56748,130,10123,15279,22265,0,0,0,1,1
56749,130,10126,15698;15819,22265,0,0,0,2,2
56750,130,10127,15299,22265,0,0,0,1,1
56751,130,10128,15255,22265,0,0,0,1,1
56752,130,10130,15347,22265,0,0,0,1,1
56753,130,10134,15407,22265,0,0,0,1,1
56754,130,10136,15414;15769,22265,0,0,0,2,2
56755,130,10142,15482,22265,0,0,0,1,1
56756,130,10199,14187,22630,0,0,0,1,1
56757,130,10201,14491,22630,0,0,0,1,1
56758,130,10207,15061,22630,0,0,0,1,1
56759,130,10210,14449,22630,0,0,0,1,1
56760,130,10213,15444,22630,0,0,0,1,1
56761,130,10226,14948;15031,22630,0,0,0,2,2
56762,130,10228,15458,22630,0,0,0,1,1
56763,130,10233,15201,22630,0,0,0,1,1
56764,130,10235,15300,22630,0,0,0,1,1
56765,130,10236,15517,22630,0,0,0,1,1
56766,130,10237,14787;15319,22630,0,0,0,2,2
56767,130,10240,15902,22630,0,0,0,1,1
56768,130,10241,15384,22630,0,0,0,1,1
56769,130,10243,15423,22630,0,0,0,1,1
56770,130,10244,15308,22630,0,0,0,1,1
56771,130,10245,15453,22630,0,0,0,1,1
56772,130,10247,15463;15790,22630,0,0,0,2,2
56773,130,10249,15497,22630,0,0,0,1,1
56774,130,10252,15935,22630,0,0,0,1,1
56775,130,10314,15043,22995,0,0,0,1,1
56776,130,10318,14632,22995,0,0,0,1,1
56777,130,10320,14108,22995,0,0,0,1,1
56778,130,10321,15374;15507,22995,0,0,0,2,2
56779,130,10324,18884;18953;22749;22949,22995,0,0,4,0,4
56780,130,10325,14611,22995,0,0,0,1,1
56781,130,10327,15321,22995,0,0,0,1,1
56782,130,10328,15548,22995,0,0,0,1,1
56783,130,10329,15734,22995,0,0,0,1,1
56784,130,10331,15579,22995,0,0,0,1,1
56785,130,10334,15340,22995,0,0,0,1,1
56786,130,10336,15281,22995,0,0,0,1,1
56787,130,10340,15356;15515,22995,0,0,0,2,2
56788,130,10342,15944,22995,0,0,0,1,1
56789,130,10343,15491,22995,0,0,0,1,1
56790,130,10344,15494,22995,0,0,0,1,1
56791,130,10345,15842,22995,0,0,0,1,1
56792,130,10348,15533;15829,22995,0,0,0,2,2
56793,130,10349,15638;15967,22995,0,0,0,2,2
56794,130,10350,15541,22995,0,0,0,1,1
56795,130,10353,15267,22995,0,0,0,1,1
56796,130,10354,15588,22995,0,0,0,1,1
56797,130,10355,15611;15889,22995,0,0,0,2,2
56798,130,10356,15626,22995,0,0,0,1,1
56799,130,10357,15545,22995,0,0,0,1,1
56800,130,10359,16155,22995,0,0,0,1,1
56801,130,10361,15676,22995,0,0,0,1,1
56802,130,10362,16179,22995,0,0,0,1,1
56803,130,10364,15949;16020,22995,0,0,0,2,2
56804,130,10365,15959,22995,0,0,0,1,1
56805,130,10366,16076;16193,22995,0,0,0,2,2
56806,130,10367,15758;16047,22995,0,0,0,2,2
56807,130,10369,15766,22995,0,0,0,1,1
56808,130,10372,15786,22995,0,0,0,1,1
56809,130,10420,14809,23360,0,0,0,1,1
56810,130,10423,18946;18993,23360,0,0,2,0,2
56811,130,10424,14523,23360,0,0,0,1,1
56812,130,10428,14543,23360,0,0,0,1,1
56813,130,10433,14682,23360,0,0,0,1,1
56814,130,10434,14794,23360,0,0,0,1,1
56815,130,10439,15365,23360,0,0,0,1,1
56816,130,10441,15065,23360,0,0,0,1,1
56817,130,10444,15119,23360,0,0,0,1,1
56818,130,10447,15901,23360,0,0,0,1,1
56819,130,10448,14929,23360,0,0,0,1,1
56820,130,10450,15175,23360,0,0,0,1,1
56821,130,10452,15822,23360,0,0,0,1,1
56822,130,10453,15443,23360,0,0,0,1,1
56823,130,10457,16708,23360,0,0,0,1,1
56824,130,10460,15439,23360,0,0,0,1,1
56825,130,10462,15750,23360,0,0,0,1,1
56826,130,10468,15589,23360,0,0,0,1,1
56827,130,10469,16043,23360,0,0,0,1,1
56828,130,10474,15697,23360,0,0,0,1,1
56829,130,10475,15658,23360,0,0,0,1,1
56830,130,10476,16053,23360,0,0,0,1,1
56831,130,10478,15686,23360,0,0,0,1,1
56832,130,10480,16134;16143,23360,0,0,0,2,2
56833,130,10482,15738,23360,0,0,0,1,1
56834,130,10484,15534,23360,0,0,0,1,1
56835,130,10485,15484,23360,0,0,0,1,1
56836,130,10487,15848;16203,23360,0,0,0,2,2
56837,130,10488,15968,23360,0,0,0,1,1
56838,130,10490,15879,23360,0,0,0,1,1
56839,130,10491,15850,23360,0,0,0,1,1
56840,130,10493,15876,23360,0,0,0,1,1
56841,130,10496,15765,23360,0,0,0,1,1
56842,130,10550,15573,23725,0,0,0,1,1
56843,130,10551,15312,23725,0,0,0,1,1
56844,130,10557,15238,23725,0,0,0,1,1
56845,130,10558,15236,23725,0,0,0,1,1
56846,130,10559,14959;15604,23725,0,0,0,2,2
56847,130,10564,15417;16070,23725,0,0,0,2,2
56848,130,10565,15797,23725,0,0,0,1,1
56849,130,10566,16371,23725,0,0,0,1,1
56850,130,10571,16114,23725,0,0,0,1,1
56851,130,10572,15584,23725,0,0,0,1,1
56852,130,10575,16003;16283,23725,0,0,0,2,2
56853,130,10576,15710,23725,0,0,0,1,1
56854,130,10578,16092,23725,0,0,0,1,1
56855,130,10581,15900,23725,0,0,0,1,1
56856,130,10582,15903,23725,0,0,0,1,1
56857,130,10583,18318;18409;18841;18869;22744;22834,23725,0,0,6,0,6
56858,130,10585,15695,23725,0,0,0,1,1
56859,130,10586,16229,23725,0,0,0,1,1
56860,130,10587,16159,23725,0,0,0,1,1
56861,130,10588,16042,23725,0,0,0,1,1
56862,130,10638,14386,24090,0,0,0,1,1
56863,130,10642,14739,24090,0,0,0,1,1
56864,130,10645,14797,24090,0,0,0,1,1
56865,130,10651,14960,24090,0,0,0,1,1
56866,130,10656,15721,24090,0,0,0,1,1
56867,130,10661,15231,24090,0,0,0,1,1
56868,130,10662,14893,24090,0,0,0,1,1
56869,130,10663,16065,24090,0,0,0,1,1
56870,130,10665,15620,24090,0,0,0,1,1
56871,130,10669,15724;16325,24090,0,0,0,2,2
56872,130,10671,15961,24090,0,0,0,1,1
56873,130,10673,15730,24090,0,0,0,1,1
56874,130,10677,16004,24090,0,0,0,1,1
56875,130,10679,16183,24090,0,0,0,1,1
56876,130,10680,16128,24090,0,0,0,1,1
56877,130,10682,15733;15854,24090,0,0,0,2,2
56878,130,10683,15729;15999,24090,0,0,0,2,2
56879,130,10684,15559,24090,0,0,0,1,1
56880,130,10685,15817,24090,0,0,0,1,1
56881,130,10686,15789,24090,0,0,0,1,1
56882,130,10687,15511;16028,24090,0,0,0,2,2
56883,130,10689,15532;15831,24090,0,0,0,2,2
56884,130,10690,15856,24090,0,0,0,1,1
56885,130,10691,16021,24090,0,0,0,1,1
56886,130,10692,16081,24090,0,0,0,1,1
56887,130,10694,15352;16186,24090,0,0,0,2,2
56888,130,10695,16017;16278,24090,0,0,0,2,2
56889,130,10697,16405,24090,0,0,0,1,1
56890,130,10698,16471,24090,0,0,0,1,1
56891,130,10701,16023,24090,0,0,0,1,1
56892,130,10702,16030,24090,0,0,0,1,1
56893,130,10703,16236,24090,0,0,0,1,1
56894,130,10704,16227,24090,0,0,0,1,1
56895,130,10707,16058;16087,24090,0,0,0,2,2
56896,130,10708,16105,24090,0,0,0,1,1
56897,130,10709,19012;23058,24090,0,0,2,0,2
56898,130,10710,16122;16265,24090,0,0,0,2,2
56899,130,10711,16140,24090,0,0,0,1,1
56900,130,10749,15102,24455,0,0,0,1,1
56901,130,10752,15015,24455,0,0,0,1,1
56902,130,10754,15708,24455,0,0,0,1,1
56903,130,10755,15158,24455,0,0,0,1,1
56904,130,10756,15642,24455,0,0,0,1,1
56905,130,10760,15333;15886,24455,0,0,0,2,2
56906,130,10761,18791;18844;22856;23053;23151,24455,0,0,5,0,5
56907,130,10762,15273,24455,0,0,0,1,1
56908,130,10763,14896;15292,24455,0,0,0,2,2
56909,130,10766,15419,24455,0,0,0,1,1
56910,130,10767,15930,24455,0,0,0,1,1
56911,130,10768,15624;15915,24455,0,0,0,2,2
56912,130,10770,15778,24455,0,0,0,1,1
56913,130,10774,15756,24455,0,0,0,1,1
56914,130,10776,16330,24455,0,0,0,1,1
56915,130,10777,16706,24455,0,0,0,1,1
56916,130,10778,15791,24455,0,0,0,1,1
56917,130,10780,15241;16007,24455,0,0,0,2,2
56918,130,10783,16160,24455,0,0,0,1,1
56919,130,10784,15480,24455,0,0,0,1,1
56920,130,10785,15950;16101,24455,0,0,0,2,2
56921,130,10786,16579,24455,0,0,0,1,1
56922,130,10787,16049,24455,0,0,0,1,1
56923,130,10789,15922;16033,24455,0,0,0,2,2
56924,130,10790,16200;16307,24455,0,0,0,2,2
56925,130,10791,15429;16069,24455,0,0,0,2,2
56926,130,10792,16324;16637,24455,0,0,0,2,2
56927,130,10793,16412,24455,0,0,0,1,1
56928,130,10794,16164,24455,0,0,0,1,1
56929,130,10795,15956,24455,0,0,0,1,1
56930,130,10796,16221,24455,0,0,0,1,1
56931,130,10798,16281,24455,0,0,0,1,1
56932,130,10799,16254;16643,24455,0,0,0,2,2
56933,130,10800,16272,24455,0,0,0,1,1
56934,130,10828,13987,24820,0,0,0,1,1
56935,130,10844,14635,24820,0,0,0,1,1
56936,130,10845,15586,24820,0,0,0,1,1
56937,130,10846,14692;15129,24820,0,0,0,2,2
56938,130,10850,14593,24820,0,0,0,1,1
56939,130,10858,15184,24820,0,0,0,1,1
56940,130,10861,16174,24820,0,0,0,1,1
56941,130,10862,14680,24820,0,0,0,1,1
56942,130,10863,15343,24820,0,0,0,1,1
56943,130,10866,15353,24820,0,0,0,1,1
56944,130,10870,15424,24820,0,0,0,1,1
56945,130,10871,15836,24820,0,0,0,1,1
56946,130,10875,15712;16095,24820,0,0,0,2,2
56947,130,10876,15805;16386,24820,0,0,0,2,2
56948,130,10878,16107,24820,0,0,0,1,1
56949,130,10879,19592;20060;23421;23520,24820,0,0,4,0,4
56950,130,10880,15807,24820,0,0,0,1,1
56951,130,10881,16244;16392,24820,0,0,0,2,2
56952,130,10882,15837,24820,0,0,0,1,1
56953,130,10883,15846;16126,24820,0,0,0,2,2
56954,130,10884,16181,24820,0,0,0,1,1
56955,130,10885,15165,24820,0,0,0,1,1
56956,130,10886,15929,24820,0,0,0,1,1
56957,130,10887,15969,24820,0,0,0,1,1
56958,130,10889,16248,24820,0,0,0,1,1
56959,130,10890,16109,24820,0,0,0,1,1
56960,130,10891,16320,24820,0,0,0,1,1
56961,130,10892,16012,24820,0,0,0,1,1
56962,130,10893,16074;16286,24820,0,0,0,2,2
56963,130,10895,16552,24820,0,0,0,1,1
56964,130,10896,15943;16145,24820,0,0,0,2,2
56965,130,10898,15823;16156,24820,0,0,0,2,2
56966,130,10899,16196,24820,0,0,0,1,1
56967,130,10900,16205;16754,24820,0,0,0,2,2
56968,130,10902,16277,24820,0,0,0,1,1
56969,130,10905,16494,24820,0,0,0,1,1
56970,130,10906,16483;16836,24820,0,0,0,2,2
56971,130,10910,16373,24820,0,0,0,1,1
56972,130,10912,16535,24820,0,0,0,1,1
56973,130,10913,16691;16739,24820,0,0,0,2,2
56974,130,10914,16344;16771,24820,0,0,0,2,2
56975,130,10915,15917;16467,24820,0,0,0,2,2
56976,130,10965,15367,25185,0,0,0,1,1
56977,130,10968,15139,25185,0,0,0,1,1
56978,130,10971,15020,25185,0,0,0,1,1
56979,130,10973,15868,25185,0,0,0,1,1
56980,130,10974,15833,25185,0,0,0,1,1
56981,130,10975,15813;16185,25185,0,0,0,2,2
56982,130,10976,15563;16177,25185,0,0,0,2,2
56983,130,10977,16016,25185,0,0,0,1,1
56984,130,10978,15722;16032,25185,0,0,0,2,2
56985,130,10981,15651,25185,0,0,0,1,1
56986,130,10985,15801,25185,0,0,0,1,1
56987,130,10986,15965,25185,0,0,0,1,1
56988,130,10989,15955;16531,25185,0,0,0,2,2
56989,130,10990,15045,25185,0,0,0,1,1
56990,130,10991,16014,25185,0,0,0,1,1
56991,130,10992,16136,25185,0,0,0,1,1
56992,130,10993,15971,25185,0,0,0,1,1
56993,130,10994,16027,25185,0,0,0,1,1
56994,130,10995,15608;16059,25185,0,0,0,2,2
56995,130,10996,16413,25185,0,0,0,1,1
56996,130,10997,16692,25185,0,0,0,1,1
56997,130,10999,16709,25185,0,0,0,1,1
56998,130,11001,16110,25185,0,0,0,1,1
56999,130,11004,15859;16627,25185,0,0,0,2,2
57000,130,11006,16421,25185,0,0,0,1,1
57001,130,11009,16245,25185,0,0,0,1,1
57002,130,11010,16263,25185,0,0,0,1,1
57003,130,11011,16269;16796,25185,0,0,0,2,2
57004,130,11012,16187,25185,0,0,0,1,1
57005,130,11013,16301,25185,0,0,0,1,1
57006,130,11014,16772,25185,0,0,0,1,1
57007,130,11015,16318,25185,0,0,0,1,1
57008,130,11016,16336;16559,25185,0,0,0,2,2
57009,130,11018,16349;16841,25185,0,0,0,2,2
57010,130,11019,16504,25185,0,0,0,1,1
57011,130,11020,16259;16422,25185,0,0,0,2,2
57012,130,11021,16085;16485,25185,0,0,0,2,2
57013,130,11022,16428,25185,0,0,0,1,1
57014,130,11023,16432,25185,0,0,0,1,1
57015,130,11024,16437,25185,0,0,0,1,1
57016,130,11025,16560,25185,0,0,0,1,1
57017,130,11026,15946;16377,25185,0,0,0,2,2
57018,130,11027,16458,25185,0,0,0,1,1
57019,130,11028,16480,25185,0,0,0,1,1
57020,130,11029,16745;16803,25185,0,0,0,2,2
57021,130,11031,16519,25185,0,0,0,1,1
57022,130,11032,16549,25185,0,0,0,1,1
57023,130,11033,16439,25185,0,0,0,1,1
57024,130,11087,15728;15828,25550,0,0,0,2,2
57025,130,11094,15114,25550,0,0,0,1,1
57026,130,11095,15324,25550,0,0,0,1,1
57027,130,11096,15150,25550,0,0,0,1,1
57028,130,11098,15354,25550,0,0,0,1,1
57029,130,11101,15400,25550,0,0,0,1,1
57030,130,11107,15989,25550,0,0,0,1,1
57031,130,11108,16178;16358,25550,0,0,0,2,2
57032,130,11109,16287,25550,0,0,0,1,1
57033,130,11110,16108,25550,0,0,0,1,1
57034,130,11112,15977,25550,0,0,0,1,1
57035,130,11114,16096,25550,0,0,0,1,1
57036,130,11117,15988;16197,25550,0,0,0,2,2
57037,130,11119,16741;16767,25550,0,0,0,2,2
57038,130,11120,15740,25550,0,0,0,1,1
57039,130,11121,16169;16461,25550,0,0,0,2,2
57040,130,11124,15531;16204,25550,0,0,0,2,2
57041,130,11126,16129;16207,25550,0,0,0,2,2
57042,130,11127,16634,25550,0,0,0,1,1
57043,130,11128,15386;16170,25550,0,0,0,2,2
57044,130,11129,16252,25550,0,0,0,1,1
57045,130,11130,16297,25550,0,0,0,1,1
57046,130,11132,16294;16518,25550,0,0,0,2,2
57047,130,11133,16526;17063,25550,0,0,0,2,2
57048,130,11134,16683;16786,25550,0,0,0,2,2
57049,130,11135,16337,25550,0,0,0,1,1
57050,130,11136,15873;16339,25550,0,0,0,2,2
57051,130,11137,16343,25550,0,0,0,1,1
57052,130,11139,16375,25550,0,0,0,1,1
57053,130,11140,19405;20246;20845;22886;22931;23083;23683;25304,25550,1,1,6,0,8
57054,130,11142,16456;16472,25550,0,0,0,2,2
57055,130,11143,16512;16722,25550,0,0,0,2,2
57056,130,11145,16537;16818,25550,0,0,0,2,2
57057,130,11146,16888;16913,25550,0,0,0,2,2
57058,130,11147,16424;16562,25550,0,0,0,2,2
57059,130,11148,16576;16782,25550,0,0,0,2,2
57060,130,11149,16584,25550,0,0,0,1,1
57061,130,11150,16329;16603,25550,0,0,0,2,2
57062,130,11153,16936,25550,0,0,0,1,1
57063,130,11154,16389,25550,0,0,0,1,1
57064,130,11155,16791,25550,0,0,0,1,1
57065,130,11156,16650,25550,0,0,0,1,1
57066,130,11157,16727,25550,0,0,0,1,1
57067,130,11158,16673;17060,25550,0,0,0,2,2
57068,130,11159,16675,25550,0,0,0,1,1
57069,130,11215,15168,25915,0,0,0,1,1
57070,130,11216,14988,25915,0,0,0,1,1
57071,130,11220,15280,25915,0,0,0,1,1
57072,130,11224,16139,25915,0,0,0,1,1
57073,130,11228,15755;16154,25915,0,0,0,2,2
57074,130,11230,16334,25915,0,0,0,1,1
57075,130,11232,15951,25915,0,0,0,1,1
57076,130,11233,15745;16175,25915,0,0,0,2,2
57077,130,11234,16209,25915,0,0,0,1,1
57078,130,11235,15966,25915,0,0,0,1,1
57079,130,11236,16690,25915,0,0,0,1,1
57080,130,11237,16380,25915,0,0,0,1,1
57081,130,11238,16497,25915,0,0,0,1,1
57082,130,11239,15945;16214,25915,0,0,0,2,2
57083,130,11240,16144,25915,0,0,0,1,1
57084,130,11241,16157;16441,25915,0,0,0,2,2
57085,130,11242,16575;16593,25915,0,0,0,2,2
57086,130,11246,16299,25915,0,0,0,1,1
57087,130,11247,16618;16779,25915,0,0,0,2,2
57088,130,11249,16561;16947,25915,0,0,0,2,2
57089,130,11250,16365,25915,0,0,0,1,1
57090,130,11251,15880;16442,25915,0,0,0,2,2
57091,130,11252,16705,25915,0,0,0,1,1
57092,130,11255,16469;16768,25915,0,0,0,2,2
57093,130,11257,16840,25915,0,0,0,1,1
57094,130,11258,16941,25915,0,0,0,1,1
57095,130,11260,16462,25915,0,0,0,1,1
57096,130,11262,16984,25915,0,0,0,1,1
57097,130,11263,16425;16564,25915,0,0,0,2,2
57098,130,11264,16609,25915,0,0,0,1,1
57099,130,11265,16617,25915,0,0,0,1,1
57100,130,11266,17103,25915,0,0,0,1,1
57101,130,11267,16646,25915,0,0,0,1,1
57102,130,11268,16342,25915,0,0,0,1,1
57103,130,11270,16661,25915,0,0,0,1,1
57104,130,11272,16719;16831,25915,0,0,0,2,2
57105,130,11273,16732;17129,25915,0,0,0,2,2
57106,130,11274,16733;16817,25915,0,0,0,2,2
57107,130,11275,16762,25915,0,0,0,1,1
57108,130,11276,17095,25915,0,0,0,1,1
57109,130,11277,16359;16770,25915,0,0,0,2,2
57110,130,11278,16703;16788,25915,0,0,0,2,2
57111,130,11279,16793;16869,25915,0,0,0,2,2
57112,130,11281,16806,25915,0,0,0,1,1
57113,130,11282,16556;16963,25915,0,0,0,2,2
57114,130,11322,14910,26280,0,0,0,1,1
57115,130,11323,14832,26280,0,0,0,1,1
57116,130,11326,14688,26280,0,0,0,1,1
57117,130,11332,15330;15475,26280,0,0,0,2,2
57118,130,11341,16532;16541,26280,0,0,0,2,2
57119,130,11342,14874;15862,26280,0,0,0,2,2
57120,130,11343,15798,26280,0,0,0,1,1
57121,130,11346,16080;16641,26280,0,0,0,2,2
57122,130,11347,16019;16064,26280,0,0,0,2,2
57123,130,11348,16130;16404;19909,26280,0,0,1,2,3
57124,130,11349,16670,26280,0,0,0,1,1
57125,130,11350,16445;16819,26280,0,0,0,2,2
57126,130,11351,15991;16700,26280,0,0,0,2,2
57127,130,11353,16681;16859,26280,0,0,0,2,2
57128,130,11355,16689,26280,0,0,0,1,1
57129,130,11356,16300,26280,0,0,0,1,1
57130,130,11357,16833,26280,0,0,0,1,1
57131,130,11359,16192;16332,26280,0,0,0,2,2
57132,130,11360,16735;16811,26280,0,0,0,2,2
57133,130,11361,15994;16364,26280,0,0,0,2,2
57134,130,11362,16635;16891,26280,0,0,0,2,2
57135,130,11364,16103;16399,26280,0,0,0,2,2
57136,130,11366,15679,26280,0,0,0,1,1
57137,130,11367,16903,26280,0,0,0,1,1
57138,130,11368,16539;16573,26280,0,0,0,2,2
57139,130,11369,16510;16630,26280,0,0,0,2,2
57140,130,11370,16514,26280,0,0,0,1,1
57141,130,11371,17003,26280,0,0,0,1,1
57142,130,11373,16569,26280,0,0,0,1,1
57143,130,11375,16669;16917,26280,0,0,0,2,2
57144,130,11376,16523;16665,26280,0,0,0,2,2
57145,130,11377,16912,26280,0,0,0,1,1
57146,130,11378,16940;20289,26280,0,0,1,1,2
57147,130,11379,16698;16897,26280,0,0,0,2,2
57148,130,11380,17306,26280,0,0,0,1,1
57149,130,11381,16270;17025,26280,0,0,0,2,2
57150,130,11382,16672;17122,26280,0,0,0,2,2
57151,130,11383,16794,26280,0,0,0,1,1
57152,130,11385,16828,26280,0,0,0,1,1
57153,130,11386,17266,26280,0,0,0,1,1
57154,130,11387,16874;17144,26280,0,0,0,2,2
57155,130,11388,17180,26280,0,0,0,1,1
57156,130,11389,16491;16905,26280,0,0,0,2,2
57157,130,11390,16909,26280,0,0,0,1,1
57158,130,11391,16631;17154,26280,0,0,0,2,2
57159,130,11392,16645;17292,26280,0,0,0,2,2
57160,130,11393,16918,26280,0,0,0,1,1
57161,130,11394,16231;16919,26280,0,0,0,2,2
57162,130,11429,14547;14698,26645,0,0,0,2,2
57163,130,11439,15382,26645,0,0,0,1,1
57164,130,11444,16427,26645,0,0,0,1,1
57165,130,11445,15684,26645,0,0,0,1,1
57166,130,11448,15788,26645,0,0,0,1,1
57167,130,11449,15920,26645,0,0,0,1,1
57168,130,11450,15953,26645,0,0,0,1,1
57169,130,11452,16712,26645,0,0,0,1,1
57170,130,11453,16487,26645,0,0,0,1,1
57171,130,11454,16138,26645,0,0,0,1,1
57172,130,11455,16242;16450,26645,0,0,0,2,2
57173,130,11456,16275;16448,26645,0,0,0,2,2
57174,130,11457,16088;16333,26645,0,0,0,2,2
57175,130,11458,16420,26645,0,0,0,1,1
57176,130,11459,16099;16338,26645,0,0,0,2,2
57177,130,11460,16942;16974,26645,0,0,0,2,2
57178,130,11461,16816,26645,0,0,0,1,1
57179,130,11462,16789,26645,0,0,0,1,1
57180,130,11463,16381;17134,26645,0,0,0,2,2
57181,130,11464,15974;16382,26645,0,0,0,2,2
57182,130,11465,16024;16356,26645,0,0,0,2,2
57183,130,11466,17178,26645,0,0,0,1,1
57184,130,11467,16315;16447,26645,0,0,0,2,2
57185,130,11468,16674,26645,0,0,0,1,1
57186,130,11469,15858;16509,26645,0,0,0,2,2
57187,130,11470,16173;16538,26645,0,0,0,2,2
57188,130,11472,16551,26645,0,0,0,1,1
57189,130,11473,16492;16588,26645,0,0,0,2,2
57190,130,11474,16167;16202,26645,0,0,0,2,2
57191,130,11477,16546;16671,26645,0,0,0,2,2
57192,130,11479,16684,26645,0,0,0,1,1
57193,130,11482,16714,26645,0,0,0,1,1
57194,130,11483,17101,26645,0,0,0,1,1
57195,130,11485,16734,26645,0,0,0,1,1
57196,130,11486,16568,26645,0,0,0,1,1
57197,130,11487,16716,26645,0,0,0,1,1
57198,130,11488,16765;16953,26645,0,0,0,2,2
57199,130,11491,17051,26645,0,0,0,1,1
57200,130,11492,16825,26645,0,0,0,1,1
57201,130,11493,16830,26645,0,0,0,1,1
57202,130,11494,17187,26645,0,0,0,1,1
57203,130,11495,16809;16851,26645,0,0,0,2,2
57204,130,11496,16926,26645,0,0,0,1,1
57205,130,11497,16725;17014,26645,0,0,0,2,2
57206,130,11498,16835,26645,0,0,0,1,1
57207,130,11499,16889;17106,26645,0,0,0,2,2
57208,130,11500,16490;16907,26645,0,0,0,2,2
57209,130,11501,17117,26645,0,0,0,1,1
57210,130,11502,17177,26645,0,0,0,1,1
57211,130,11504,16962,26645,0,0,0,1,1
57212,130,11505,16968;17068,26645,0,0,0,2,2
57213,130,11506,17128,26645,0,0,0,1,1
57214,130,11507,16758;16992,26645,0,0,0,2,2
57215,130,11510,17019,26645,0,0,0,1,1
57216,130,11511,17155,26645,0,0,0,1,1
57217,130,11512,16916,26645,0,0,0,1,1
57218,130,11549,15297,27010,0,0,0,1,1
57219,130,11552,15100,27010,0,0,0,1,1
57220,130,11555,15760,27010,0,0,0,1,1
57221,130,11556,15528,27010,0,0,0,1,1
57222,130,11558,15529;15942,27010,0,0,0,2,2
57223,130,11563,15668;15803,27010,0,0,0,2,2
57224,130,11565,15780,27010,0,0,0,1,1
57225,130,11566,16038,27010,0,0,0,1,1
57226,130,11567,15500,27010,0,0,0,1,1
57227,130,11570,15923,27010,0,0,0,1,1
57228,130,11571,16372,27010,0,0,0,1,1
57229,130,11572,16267,27010,0,0,0,1,1
57230,130,11575,16597,27010,0,0,0,1,1
57231,130,11576,16172;16686,27010,0,0,0,2,2
57232,130,11577,16606,27010,0,0,0,1,1
57233,130,11578,16368,27010,0,0,0,1,1
57234,130,11581,16513,27010,0,0,0,1,1
57235,130,11583,16446;16866,27010,0,0,0,2,2
57236,130,11584,16218,27010,0,0,0,1,1
57237,130,11585,16533;16578,27010,0,0,0,2,2
57238,130,11586,16857;19617,27010,0,0,1,1,2
57239,130,11587,16602;16883,27010,0,0,0,2,2
57240,130,11588,15909;16638,27010,0,0,0,2,2
57241,130,11590,16862,27010,0,0,0,1,1
57242,130,11591,16921,27010,0,0,0,1,1
57243,130,11592,17028,27010,0,0,0,1,1
57244,130,11593,16820;16988,27010,0,0,0,2,2
57245,130,11594,16737,27010,0,0,0,1,1
57246,130,11595,16846,27010,0,0,0,1,1
57247,130,11596,17045,27010,0,0,0,1,1
57248,130,11597,16901;17393,27010,0,0,0,2,2
57249,130,11598,17064,27010,0,0,0,1,1
57250,130,11599,17229;17327,27010,0,0,0,2,2
57251,130,11601,16697;17253,27010,0,0,0,2,2
57252,130,11602,16756;16954,27010,0,0,0,2,2
57253,130,11603,16878;17196,27010,0,0,0,2,2
57254,130,11605,16982,27010,0,0,0,1,1
57255,130,11606,17031;17163,27010,0,0,0,2,2
57256,130,11607,17206;17257,27010,0,0,0,2,2
57257,130,11608,17061,27010,0,0,0,1,1
57258,130,11609,17114;17411;21666;24197;24835;25358,27010,1,2,1,2,6
57259,130,11610,17079,27010,0,0,0,1,1
57260,130,11641,14800,27375,0,0,0,1,1
57261,130,11642,14941,27375,0,0,0,1,1
57262,130,11650,15256,27375,0,0,0,1,1
57263,130,11657,15596,27375,0,0,0,1,1
57264,130,11658,15617,27375,0,0,0,1,1
57265,130,11661,15747,27375,0,0,0,1,1
57266,130,11662,15595;16040,27375,0,0,0,2,2
57267,130,11664,15962;16213,27375,0,0,0,2,2
57268,130,11665,16430;16792,27375,0,0,0,2,2
57269,130,11666,16289;16354,27375,0,0,0,2,2
57270,130,11667,16550,27375,0,0,0,1,1
57271,130,11671,16084;16326,27375,0,0,0,2,2
57272,130,11672,16464,27375,0,0,0,1,1
57273,130,11674,16416,27375,0,0,0,1,1
57274,130,11675,16350,27375,0,0,0,1,1
57275,130,11677,16577,27375,0,0,0,1,1
57276,130,11678,16613,27375,0,0,0,1,1
57277,130,11679,16623,27375,0,0,0,1,1
57278,130,11681,16624,27375,0,0,0,1,1
57279,130,11682,16666;17210,27375,0,0,0,2,2
57280,130,11683,16120;16743,27375,0,0,0,2,2
57281,130,11684,16804;17297,27375,0,0,0,2,2
57282,130,11685,16852,27375,0,0,0,1,1
57283,130,11686,17480,27375,0,0,0,1,1
57284,130,11687,17239,27375,0,0,0,1,1
57285,130,11688,16834;17076,27375,0,0,0,2,2
57286,130,11689,17136,27375,0,0,0,1,1
57287,130,11690,17312,27375,0,0,0,1,1
57288,130,11691,16435;16797,27375,0,0,0,2,2
57289,130,11692,16352;16864,27375,0,0,0,2,2
57290,130,11693,16870;17286,27375,0,0,0,2,2
57291,130,11694,16886;16972,27375,0,0,0,2,2
57292,130,11695,16894,27375,0,0,0,1,1
57293,130,11696,16933,27375,0,0,0,1,1
57294,130,11698,16938;16949,27375,0,0,0,2,2
57295,130,11699,16188;16945,27375,0,0,0,2,2
57296,130,11700,16960;17353,27375,0,0,0,2,2
57297,130,11701,16829;16965,27375,0,0,0,2,2
57298,130,11702,16720;16997,27375,0,0,0,2,2
57299,130,11704,17108,27375,0,0,0,1,1
57300,130,11705,16871;17039,27375,0,0,0,2,2
57301,130,11706,17065;17293,27375,0,0,0,2,2
57302,130,11707,16499;17070;21996;24207;24962,27375,0,2,1,2,5
57303,130,11708,16740;17080,27375,0,0,0,2,2
57304,130,11709,17328,27375,0,0,0,1,1
57305,130,11710,17090;17488,27375,0,0,0,2,2
57306,130,11711,17151;17201,27375,0,0,0,2,2
57307,130,11712,16759,27375,0,0,0,1,1
57308,130,11713,17118,27375,0,0,0,1,1
57309,130,11715,16934;17357,27375,0,0,0,2,2
57310,130,11717,17088,27375,0,0,0,1,1
57311,130,11718,16899;16995,27375,0,0,0,2,2
57312,130,11754,15178,27740,0,0,0,1,1
57313,130,11755,14979;15811,27740,0,0,0,2,2
57314,130,11762,16468,27740,0,0,0,1,1
57315,130,11764,16484;16525,27740,0,0,0,2,2
57316,130,11768,16676;16892,27740,0,0,0,2,2
57317,130,11769,16687;17012,27740,0,0,0,2,2
57318,130,11770,16685;16742,27740,0,0,0,2,2
57319,130,11771,16589,27740,0,0,0,1,1
57320,130,11773,16282;16470,27740,0,0,0,2,2
57321,130,11774,17437,27740,0,0,0,1,1
57322,130,11777,16893;17011;20418;23725;24330;24540,27740,0,3,1,2,6
57323,130,11778,16582;16614,27740,0,0,0,2,2
57324,130,11780,16885,27740,0,0,0,1,1
57325,130,11781,16902;17315,27740,0,0,0,2,2
57326,130,11782,17188;17394,27740,0,0,0,2,2
57327,130,11783,16946,27740,0,0,0,1,1
57328,130,11784,16980;16985,27740,0,0,0,2,2
57329,130,11785,16964;16998,27740,0,0,0,2,2
57330,130,11786,17092,27740,0,0,0,1,1
57331,130,11788,16868;17059,27740,0,0,0,2,2
57332,130,11789,17048;17140,27740,0,0,0,2,2
57333,130,11790,17099,27740,0,0,0,1,1
57334,130,11791,17283;17687,27740,0,0,0,2,2
57335,130,11792,17504;21323,27740,0,0,1,1,2
57336,130,11794,17142,27740,0,0,0,1,1
57337,130,11795,16701;17152,27740,0,0,0,2,2
57338,130,11796,17164,27740,0,0,0,1,1
57339,130,11797,16755;17175,27740,0,0,0,2,2
57340,130,11798,17507,27740,0,0,0,1,1
57341,130,11799,17248;17420;21806;23670;24945,27740,0,1,2,2,5
57342,130,11800,16986;17445;22116;24631;24748,27740,0,2,1,2,5
57343,130,11801,17125;17302,27740,0,0,0,2,2
57344,130,11802,17182,27740,0,0,0,1,1
57345,130,11803,17255;17644,27740,0,0,0,2,2
57346,130,11804,17256;17278,27740,0,0,0,2,2
57347,130,11805,17289;17448,27740,0,0,0,2,2
57348,130,11806,17371,27740,0,0,0,1,1
57349,130,11807,17236;17684,27740,0,0,0,2,2
57350,130,11809,17333;17482;21699,27740,0,0,1,2,3
57351,130,11810,17403,27740,0,0,0,1,1
57352,130,11866,16574;16682,28105,0,0,0,2,2
57353,130,11870,16615,28105,0,0,0,1,1
57354,130,11872,16290,28105,0,0,0,1,1
57355,130,11873,16760,28105,0,0,0,1,1
57356,130,11874,16408,28105,0,0,0,1,1
57357,130,11876,17139,28105,0,0,0,1,1
57358,130,11877,16633,28105,0,0,0,1,1
57359,130,11879,16502;16860,28105,0,0,0,2,2
57360,130,11880,16520,28105,0,0,0,1,1
57361,130,11883,16451;16529,28105,0,0,0,2,2
57362,130,11884,16222,28105,0,0,0,1,1
57363,130,11885,16590,28105,0,0,0,1,1
57364,130,11886,16591;16658,28105,0,0,0,2,2
57365,130,11887,16401;16598,28105,0,0,0,2,2
57366,130,11888,16607;16910,28105,0,0,0,2,2
57367,130,11889,16983,28105,0,0,0,1,1
57368,130,11890,16975,28105,0,0,0,1,1
57369,130,11893,16882;16951,28105,0,0,0,2,2
57370,130,11894,17093;17282,28105,0,0,0,2,2
57371,130,11896,16890;17190,28105,0,0,0,2,2
57372,130,11897,17329,28105,0,0,0,1,1
57373,130,11898,17067,28105,0,0,0,1,1
57374,130,11899,17216,28105,0,0,0,1,1
57375,130,11900,17468,28105,0,0,0,1,1
57376,130,11901,17073,28105,0,0,0,1,1
57377,130,11902,17097;17384,28105,0,0,0,2,2
57378,130,11903,17440;17547,28105,0,0,0,2,2
57379,130,11904,17038;17270,28105,0,0,0,2,2
57380,130,11905,16872;17264,28105,0,0,0,2,2
57381,130,11906,17147;17298,28105,0,0,0,2,2
57382,130,11907,17326;17453,28105,0,0,0,2,2
57383,130,11908,16935,28105,0,0,0,1,1
57384,130,11909,17301;17740,28105,0,0,0,2,2
57385,130,11911,17380,28105,0,0,0,1,1
57386,130,11912,19787;19878;23310,28105,0,0,3,0,3
57387,130,11914,17325;17566,28105,0,0,0,2,2
57388,130,11915,17260;17338,28105,0,0,0,2,2
57389,130,11916,17417,28105,0,0,0,1,1
57390,130,11917,17348;17399,28105,0,0,0,2,2
57391,130,11918,17606,28105,0,0,0,1,1
57392,130,11919,17545,28105,0,0,0,1,1
57393,130,11920,17775,28105,0,0,0,1,1
57394,130,11921,17692,28105,0,0,0,1,1
57395,130,11922,17549;17761,28105,0,0,0,2,2
57396,130,11924,17525;17575;20789;22166,28105,0,0,2,2,4
57397,130,11952,14801,28470,0,0,0,1,1
57398,130,11955,14508,28470,0,0,0,1,1
57399,130,11959,15038,28470,0,0,0,1,1
57400,130,11972,15311,28470,0,0,0,1,1
57401,130,11978,15933,28470,0,0,0,1,1
57402,130,11982,15246,28470,0,0,0,1,1
57403,130,11984,15640,28470,0,0,0,1,1
57404,130,11986,15998,28470,0,0,0,1,1
57405,130,11987,15224,28470,0,0,0,1,1
57406,130,11989,16239,28470,0,0,0,1,1
57407,130,11993,16331;16335,28470,0,0,0,2,2
57408,130,11994,15899,28470,0,0,0,1,1
57409,130,11997,16323;16583,28470,0,0,0,2,2
57410,130,11998,16920;16928,28470,0,0,0,2,2
57411,130,12000,17217;17311,28470,0,0,0,2,2
57412,130,12001,16731;16780,28470,0,0,0,2,2
57413,130,12002,17119,28470,0,0,0,1,1
57414,130,12004,17046,28470,0,0,0,1,1
57415,130,12005,16839;17527,28470,0,0,0,2,2
57416,130,12006,17098,28470,0,0,0,1,1
57417,130,12007,17400,28470,0,0,0,1,1
57418,130,12008,16987;17645;21224;23360;23457,28470,0,0,3,2,5
57419,130,12009,17330,28470,0,0,0,1,1
57420,130,12010,16777,28470,0,0,0,1,1
57421,130,12012,17405,28470,0,0,0,1,1
57422,130,12013,17049;17096,28470,0,0,0,2,2
57423,130,12015,17211;17294,28470,0,0,0,2,2
57424,130,12016,17161;17552,28470,0,0,0,2,2
57425,130,12017,17179;17275,28470,0,0,0,2,2
57426,130,12019,17362;17486,28470,0,0,0,2,2
57427,130,12021,17401;17536,28470,0,0,0,2,2
57428,130,12022,17528,28470,0,0,0,1,1
57429,130,12023,16930;17233,28470,0,0,0,2,2
57430,130,12024,17538,28470,0,0,0,1,1
57431,130,12025,17276;17485,28470,0,0,0,2,2
57432,130,12026,17304,28470,0,0,0,1,1
57433,130,12027,17313;17450,28470,0,0,0,2,2
57434,130,12028,17646,28470,0,0,0,1,1
57435,130,12029,17322;17729,28470,0,0,0,2,2
57436,130,12030,16805;17323,28470,0,0,0,2,2
57437,130,12031,17165;17364,28470,0,0,0,2,2
57438,130,12032,17337;17377,28470,0,0,0,2,2
57439,130,12033,17317;17419,28470,0,0,0,2,2
57440,130,12034,17319;17433,28470,0,0,0,2,2
57441,130,12035,16896;17436,28470,0,0,0,2,2
57442,130,12036,17162,28470,0,0,0,1,1
57443,130,12037,17467,28470,0,0,0,1,1
57444,130,12038,17354;17472,28470,0,0,0,2,2
57445,130,12039,17476;17565,28470,0,0,0,2,2
57446,130,12040,17763,28470,0,0,0,1,1
57447,130,12041,17489;17630,28470,0,0,0,2,2
57448,130,12042,17494;17580,28470,0,0,0,2,2
57449,130,12043,16845;17521,28470,0,0,0,2,2
57450,130,12044,17551,28470,0,0,0,1,1
57451,130,12045,17787;17969;20076,28470,0,0,1,2,3
57452,130,12046,17036;17570;20983,28470,0,0,1,2,3
57453,130,12072,14332,28835,0,0,0,1,1
57454,130,12100,15847;16258,28835,0,0,0,2,2
57455,130,12104,15571,28835,0,0,0,1,1
57456,130,12106,16271,28835,0,0,0,1,1
57457,130,12107,16079;16858,28835,0,0,0,2,2
57458,130,12111,16861,28835,0,0,0,1,1
57459,130,12112,16374,28835,0,0,0,1,1
57460,130,12113,16875,28835,0,0,0,1,1
57461,130,12116,17351,28835,0,0,0,1,1
57462,130,12118,16850;17305,28835,0,0,0,2,2
57463,130,12119,16855;17013,28835,0,0,0,2,2
57464,130,12120,17150,28835,0,0,0,1,1
57465,130,12121,16640;17050,28835,0,0,0,2,2
57466,130,12122,17186,28835,0,0,0,1,1
57467,130,12123,17204,28835,0,0,0,1,1
57468,130,12124,17228,28835,0,0,0,1,1
57469,130,12126,17123;17213,28835,0,0,0,2,2
57470,130,12128,17183;17269,28835,0,0,0,2,2
57471,130,12129,17334;17341,28835,0,0,0,2,2
57472,130,12130,17193;17556,28835,0,0,0,2,2
57473,130,12131,17385,28835,0,0,0,1,1
57474,130,12132,17539;17635,28835,0,0,0,2,2
57475,130,12133,17435,28835,0,0,0,1,1
57476,130,12135,17443,28835,0,0,0,1,1
57477,130,12136,17477;17868,28835,0,0,0,2,2
57478,130,12137,17497;21753;24298;24940;25460,28835,1,2,1,1,5
57479,130,12138,17613,28835,0,0,0,1,1
57480,130,12139,17352;17750,28835,0,0,0,2,2
57481,130,12140,17520,28835,0,0,0,1,1
57482,130,12141,17563;17779;22172,28835,0,0,1,2,3
57483,130,12142,17679,28835,0,0,0,1,1
57484,130,12143,17559;17585,28835,0,0,0,2,2
57485,130,12144,17245;17567,28835,0,0,0,2,2
57486,130,12145,17579;17982;22397,28835,0,0,1,2,3
57487,130,12146,17682,28835,0,0,0,1,1
57488,130,12147,17723;17944,28835,0,0,0,2,2
57489,130,12148,17622,28835,0,0,0,1,1
57490,130,12149,17423;17626,28835,0,0,0,2,2
57491,130,12150,17263;17639,28835,0,0,0,2,2
57492,130,12151,17838;17847,28835,0,0,0,2,2
57493,130,12152,17648;17777,28835,0,0,0,2,2
57494,130,12153,17406;17651,28835,0,0,0,2,2
57495,130,12154,17251;17652,28835,0,0,0,2,2
57496,130,12155,17657;17947,28835,0,0,0,2,2
57497,130,12157,17153;17681,28835,0,0,0,2,2
57498,130,12178,14745,29200,0,0,0,1,1
57499,130,12189,15173,29200,0,0,0,1,1
57500,130,12191,15539,29200,0,0,0,1,1
57501,130,12195,15777,29200,0,0,0,1,1
57502,130,12196,14898,29200,0,0,0,1,1
57503,130,12201,15597,29200,0,0,0,1,1
57504,130,12204,16235,29200,0,0,0,1,1
57505,130,12208,15720,29200,0,0,0,1,1
57506,130,12209,16328,29200,0,0,0,1,1
57507,130,12212,16100;16217,29200,0,0,0,2,2
57508,130,12215,16224;16292,29200,0,0,0,2,2
57509,130,12219,16524;16958,29200,0,0,0,2,2
57510,130,12220,16595,29200,0,0,0,1,1
57511,130,12222,16713;17071,29200,0,0,0,2,2
57512,130,12223,16970,29200,0,0,0,1,1
57513,130,12224,16133;16414,29200,0,0,0,2,2
57514,130,12225,16750,29200,0,0,0,1,1
57515,130,12226,17143;21913,29200,0,0,1,1,2
57516,130,12227,17034;17398,29200,0,0,0,2,2
57517,130,12228,16515;16801,29200,0,0,0,2,2
57518,130,12230,16622,29200,0,0,0,1,1
57519,130,12231,17209;17469,29200,0,0,0,2,2
57520,130,12232,17410;17634,29200,0,0,0,2,2
57521,130,12233,17418;17446,29200,0,0,0,2,2
57522,130,12234,17056;17173,29200,0,0,0,2,2
57523,130,12235,16961,29200,0,0,0,1,1
57524,130,12236,17697,29200,0,0,0,1,1
57525,130,12237,17157,29200,0,0,0,1,1
57526,130,12240,17548,29200,0,0,0,1,1
57527,130,12241,17267,29200,0,0,0,1,1
57528,130,12242,16944;17428,29200,0,0,0,2,2
57529,130,12243,17447,29200,0,0,0,1,1
57530,130,12246,16948,29200,0,0,0,1,1
57531,130,12248,17430,29200,0,0,0,1,1
57532,130,12249,17265;17444;22499,29200,0,0,1,2,3
57533,130,12250,17479;17717,29200,0,0,0,2,2
57534,130,12252,17515,29200,0,0,0,1,1
57535,130,12253,17619;17741,29200,0,0,0,2,2
57536,130,12254,17586;21967,29200,0,0,1,1,2
57537,130,12255,17462,29200,0,0,0,1,1
57538,130,12257,17972,29200,0,0,0,1,1
57539,130,12258,17232;17532,29200,0,0,0,2,2
57540,130,12259,18084,29200,0,0,0,1,1
57541,130,12261,17715,29200,0,0,0,1,1
57542,130,12262,17460;17739,29200,0,0,0,2,2
57543,130,12281,13825,29565,0,0,0,1,1
57544,130,12301,15670;15954,29565,0,0,0,2,2
57545,130,12304,16426,29565,0,0,0,1,1
57546,130,12314,16489;16746,29565,0,0,0,2,2
57547,130,12318,17422,29565,0,0,0,1,1
57548,130,12320,17081;17171;21026,29565,0,0,1,2,3
57549,130,12321,17138,29565,0,0,0,1,1
57550,130,12323,17172,29565,0,0,0,1,1
57551,130,12324,17200;17372,29565,0,0,0,2,2
57552,130,12325,17279,29565,0,0,0,1,1
57553,130,12326,17280;17360,29565,0,0,0,2,2
57554,130,12328,17866,29565,0,0,0,1,1
57555,130,12330,17392,29565,0,0,0,1,1
57556,130,12331,17336;17829;21580;22394;24607;24713;25451,29565,1,2,2,2,7
57557,130,12332,17432;18087;20781;21837;24617;24732;24950;25249;25466,29565,2,3,2,2,9
57558,130,12334,17508;17939,29565,0,0,0,2,2
57559,130,12335,17513,29565,0,0,0,1,1
57560,130,12336,17463;17519,29565,0,0,0,2,2
57561,130,12337,17215;17582,29565,0,0,0,2,2
57562,130,12338,17464;17583,29565,0,0,0,2,2
57563,130,12339,17541,29565,0,0,0,1,1
57564,130,12340,17593;20997;24370;24891;25324,29565,1,2,1,1,5
57565,130,12341,17611;17620,29565,0,0,0,2,2
57566,130,12342,17505,29565,0,0,0,1,1
57567,130,12343,17653;17872,29565,0,0,0,2,2
57568,130,12344,17659;17759,29565,0,0,0,2,2
57569,130,12345,17844,29565,0,0,0,1,1
57570,130,12346,17383;17690,29565,0,0,0,2,2
57571,130,12347,17997;18196,29565,0,0,0,2,2
57572,130,12348,17797;17968,29565,0,0,0,2,2
57573,130,12349,17753;17756,29565,0,0,0,2,2
57574,130,12350,17501;17769,29565,0,0,0,2,2
57575,130,12351,17434;17952,29565,0,0,0,2,2
57576,130,12352,17802,29565,0,0,0,1,1
57577,130,12353,22333;22393;25177,29565,1,0,2,0,3
57578,130,12355,17748;17831,29565,0,0,0,2,2
57579,130,12356,17914;17936,29565,0,0,0,2,2
57580,130,12357,17589;17848,29565,0,0,0,2,2
57581,130,12358,17801;17861,29565,0,0,0,2,2
57582,130,12359,17391;17878,29565,0,0,0,2,2
57583,130,12360,18048,29565,0,0,0,1,1
57584,130,12395,16363,29930,0,0,0,1,1
57585,130,12396,16402,29930,0,0,0,1,1
57586,130,12397,16279,29930,0,0,0,1,1
57587,130,12398,21395;21497;24194;24818,29930,0,2,2,0,4
57588,130,12399,16308;16418,29930,0,0,0,2,2
57589,130,12400,16211,29930,0,0,0,1,1
57590,130,12401,17130,29930,0,0,0,1,1
57591,130,12402,17218,29930,0,0,0,1,1
57592,130,12403,16636;16763,29930,0,0,0,2,2
57593,130,12404,16647,29930,0,0,0,1,1
57594,130,12405,17052,29930,0,0,0,1,1
57595,130,12406,16800,29930,0,0,0,1,1
57596,130,12407,17230,29930,0,0,0,1,1
57597,130,12408,16628;16695,29930,0,0,0,2,2
57598,130,12410,17425,29930,0,0,0,1,1
57599,130,12411,17041,29930,0,0,0,1,1
57600,130,12412,17037;17427,29930,0,0,0,2,2
57601,130,12413,17296,29930,0,0,0,1,1
57602,130,12414,17198;17696,29930,0,0,0,2,2
57603,130,12415,17247;17514,29930,0,0,0,2,2
57604,130,12416,17288;17616,29930,0,0,0,2,2
57605,130,12417,17492;17660,29930,0,0,0,2,2
57606,130,12418,17366;17500,29930,0,0,0,2,2
57607,130,12419,17074,29930,0,0,0,1,1
57608,130,12420,17758,29930,0,0,0,1,1
57609,130,12421,16815;17202,29930,0,0,0,2,2
57610,130,12422,17971,29930,0,0,0,1,1
57611,130,12423,17242;17426,29930,0,0,0,2,2
57612,130,12424,17474,29930,0,0,0,1,1
57613,130,12425,17841,29930,0,0,0,1,1
57614,130,12426,17707,29930,0,0,0,1,1
57615,130,12427,17663;18107,29930,0,0,0,2,2
57616,130,12428,17700;17711,29930,0,0,0,2,2
57617,130,12429,17598,29930,0,0,0,1,1
57618,130,12430,18160;18178,29930,0,0,0,2,2
57619,130,12431,18036;18581,29930,0,0,1,1,2
57620,130,12432,18139;18189,29930,0,0,0,2,2
57621,130,12435,17817,29930,0,0,0,1,1
57622,130,12436,17604;17818,29930,0,0,0,2,2
57623,130,12437,17795;17824,29930,0,0,0,2,2
57624,130,12438,17628;17830,29930,0,0,0,2,2
57625,130,12440,17638;17887,29930,0,0,0,2,2
57626,130,12441,17736;17853,29930,0,0,0,2,2
57627,130,12443,17509;17864,29930,0,0,0,2,2
57628,130,12444,17339,29930,0,0,0,1,1
57629,130,12445,17673;17882,29930,0,0,0,2,2
57630,130,12446,17768;17884,29930,0,0,0,2,2
57631,130,12447,17888;18144,29930,0,0,0,2,2
57632,130,12448,17937;18101,29930,0,0,0,2,2
57633,130,12449,17991;18094,29930,0,0,0,2,2
57634,130,12450,17860;17999,29930,0,0,0,2,2
57635,130,12469,14324,30295,0,0,0,1,1
57636,130,12471,14307,30295,0,0,0,1,1
57637,130,12478,13850,30295,0,0,0,1,1
57638,130,12479,14737,30295,0,0,0,1,1
57639,130,12491,15691,30295,0,0,0,1,1
57640,130,12495,16379,30295,0,0,0,1,1
57641,130,12496,16296,30295,0,0,0,1,1
57642,130,12499,16540,30295,0,0,0,1,1
57643,130,12501,15864;16233;20420;23726;23939,30295,0,2,1,2,5
57644,130,12503,16044;16465,30295,0,0,0,2,2
57645,130,12505,17244,30295,0,0,0,1,1
57646,130,12507,16807,30295,0,0,0,1,1
57647,130,12508,16657,30295,0,0,0,1,1
57648,130,12510,16104;17158,30295,0,0,0,2,2
57649,130,12513,17109,30295,0,0,0,1,1
57650,130,12514,17238;17680,30295,0,0,0,2,2
57651,130,12516,17332;17346,30295,0,0,0,2,2
57652,130,12517,17421;17721;22279,30295,0,0,1,2,3
57653,130,12518,17369;17564,30295,0,0,0,2,2
57654,130,12519,17572;18131,30295,0,0,0,2,2
57655,130,12520,17574;17701,30295,0,0,0,2,2
57656,130,12522,17807;17820,30295,0,0,0,2,2
57657,130,12523,17631,30295,0,0,0,1,1
57658,130,12524,17649;17727,30295,0,0,0,2,2
57659,130,12525,17487;17666,30295,0,0,0,2,2
57660,130,12526,17705;17746,30295,0,0,0,2,2
57661,130,12527,17879;18210;21826;24203;24519;24616;24843,30295,0,4,1,2,7
57662,130,12528,17735;22097,30295,0,0,1,1,2
57663,130,12529,17737,30295,0,0,0,1,1
57664,130,12530,17840,30295,0,0,0,1,1
57665,130,12531,17794,30295,0,0,0,1,1
57666,130,12532,17745;17983;21549,30295,0,0,1,2,3
57667,130,12533,17785;18169,30295,0,0,0,2,2
57668,130,12534,17789;17909,30295,0,0,0,2,2
57669,130,12535,17670;17790,30295,0,0,0,2,2
57670,130,12536,17842;21698;25361,30295,1,0,1,1,3
57671,130,12537,17897;17922,30295,0,0,0,2,2
57672,130,12538,17823;17906,30295,0,0,0,2,2
57673,130,12539,18159,30295,0,0,0,1,1
57674,130,12540,17774,30295,0,0,0,1,1
57675,130,12541,17921;17998,30295,0,0,0,2,2
57676,130,12542,17870;17924,30295,0,0,0,2,2
57677,130,12543,17900,30295,0,0,0,1,1
57678,130,12544,17942,30295,0,0,0,1,1
57679,130,12545,18112;18162,30295,0,0,0,2,2
57680,130,12547,18368;21791,30295,0,0,2,0,2
57681,130,12548,17409;17995,30295,0,0,0,2,2
57682,130,12549,17996,30295,0,0,0,1,1
57683,130,12550,17918;18002,30295,0,0,0,2,2
57684,130,12551,17694;18249,30295,0,0,0,2,2
57685,130,12552,18019;18353,30295,0,0,1,1,2
57686,130,12553,17368;18200,30295,0,0,0,2,2
57687,130,12554,18034;18092;21544,30295,0,0,1,2,3
57688,130,12555,17890;18106,30295,0,0,0,2,2
57689,130,12557,17533;18103,30295,0,0,0,2,2
57690,130,12558,17712;18093;22505,30295,0,0,1,2,3
57691,130,12559,17895;18058,30295,0,0,0,2,2
57692,130,12577,15776,30660,0,0,0,1,1
57693,130,12584,15664,30660,0,0,0,1,1
57694,130,12585,15741,30660,0,0,0,1,1
57695,130,12591,16022,30660,0,0,0,1,1
57696,130,12592,15703,30660,0,0,0,1,1
57697,130,12593,16580,30660,0,0,0,1,1
57698,130,12595,16865,30660,0,0,0,1,1
57699,130,12597,17044;17261,30660,0,0,0,2,2
57700,130,12599,16823,30660,0,0,0,1,1
57701,130,12600,16843;17347,30660,0,0,0,2,2
57702,130,12602,16542;17042,30660,0,0,0,2,2
57703,130,12603,16854;17141,30660,0,0,0,2,2
57704,130,12605,16662;16957,30660,0,0,0,2,2
57705,130,12610,17107;17222;21882,30660,0,0,1,2,3
57706,130,12611,17300,30660,0,0,0,1,1
57707,130,12612,17534;18057;21896,30660,0,0,1,2,3
57708,130,12613,17543;17771;21819,30660,0,0,1,2,3
57709,130,12614,17554;18232,30660,0,0,0,2,2
57710,130,12615,18381,30660,0,0,1,0,1
57711,130,12616,17599;18000,30660,0,0,0,2,2
57712,130,12617,17343;17608,30660,0,0,0,2,2
57713,130,12618,17985;18061,30660,0,0,0,2,2
57714,130,12619,17402,30660,0,0,0,1,1
57715,130,12620,17641;17647,30660,0,0,0,2,2
57716,130,12621,18175,30660,0,0,0,1,1
57717,130,12622,17015;17662,30660,0,0,0,2,2
57718,130,12623,17722;17754;21610;24294;24714;24832;25140,30660,1,3,1,2,7
57719,130,12624,17516;18035;21835;24731;25053,30660,1,1,1,2,5
57720,130,12625,17709;17812,30660,0,0,0,2,2
57721,130,12626,17612,30660,0,0,0,1,1
57722,130,12627,18027;22288,30660,0,0,1,1,2
57723,130,12628,18330;23578,30660,0,0,2,0,2
57724,130,12629,17815,30660,0,0,0,1,1
57725,130,12630,17843,30660,0,0,0,1,1
57726,130,12631,18242;22014;24624,30660,0,1,1,1,3
57727,130,12632,17988,30660,0,0,0,1,1
57728,130,12633,17863;18140,30660,0,0,0,2,2
57729,130,12634,18120;18161;22124,30660,0,0,1,2,3
57730,130,12635,18329;22009;22301,30660,0,0,3,0,3
57731,130,12636,17836;17910,30660,0,0,0,2,2
57732,130,12637,18111,30660,0,0,0,1,1
57733,130,12638,17962;18067,30660,0,0,0,2,2
57734,130,12639,18013;18099,30660,0,0,0,2,2
57735,130,12642,17881;18313;23144,30660,0,0,1,2,3
57736,130,12643,17875;18056,30660,0,0,0,2,2
57737,130,12644,18068,30660,0,0,0,1,1
57738,130,12647,18102,30660,0,0,0,1,1
57739,130,12648,17609;18218,30660,0,0,0,2,2
57740,130,12649,17605;18116,30660,0,0,0,2,2
57741,130,12650,18030;18375,30660,0,0,1,1,2
57742,130,12651,18121;18132,30660,0,0,0,2,2
57743,130,12652,17961;18361;22204,30660,0,0,2,1,3
57744,130,12653,18136,30660,0,0,0,1,1
57745,130,12654,18145,30660,0,0,0,1,1
57746,130,12655,18151;18182,30660,0,0,0,2,2
57747,130,12656,17911;17915,30660,0,0,0,2,2
57748,130,12658,17788;18224,30660,0,0,0,2,2
57749,130,12680,15269;15304,31025,0,0,0,2,2
57750,130,12684,15732,31025,0,0,0,1,1
57751,130,12699,16397;16605,31025,0,0,0,2,2
57752,130,12704,16558,31025,0,0,0,1,1
57753,130,12706,17104;17149;21683,31025,0,0,1,2,3
57754,130,12713,16659;17345,31025,0,0,0,2,2
57755,130,12715,17176,31025,0,0,0,1,1
57756,130,12716,17185;17381,31025,0,0,0,2,2
57757,130,12717,17855,31025,0,0,0,1,1
57758,130,12719,17734;18046,31025,0,0,0,2,2
57759,130,12720,17839;17984;21570,31025,0,0,1,2,3
57760,130,12721,17503;18152;21700,31025,0,0,1,2,3
57761,130,12722,17929,31025,0,0,0,1,1
57762,130,12723,17219;17640,31025,0,0,0,2,2
57763,130,12724,18209;18713,31025,0,0,1,1,2
57764,130,12725,17720;18277;22197,31025,0,0,1,2,3
57765,130,12726,17940,31025,0,0,0,1,1
57766,130,12727,17978;18100,31025,0,0,0,2,2
57767,130,12728,17948,31025,0,0,0,1,1
57768,130,12729,17561;18091;21972,31025,0,0,1,2,3
57769,130,12730,17778;17959,31025,0,0,0,2,2
57770,130,12732,17850;17976,31025,0,0,0,2,2
57771,130,12733,17873;18009,31025,0,0,0,2,2
57772,130,12734,18260;18515;22842;22937,31025,0,0,3,1,4
57773,130,12735,17792;17941,31025,0,0,0,2,2
57774,130,12736,17355;17951,31025,0,0,0,2,2
57775,130,12737,18157,31025,0,0,0,1,1
57776,130,12739,17718;17967,31025,0,0,0,2,2
57777,130,12740,18098;18197,31025,0,0,0,2,2
57778,130,12741,17716,31025,0,0,0,1,1
57779,130,12742,17728;18126,31025,0,0,0,2,2
57780,130,12743,18081;18097,31025,0,0,0,2,2
57781,130,12744,18114;18357,31025,0,0,1,1,2
57782,130,12745,18156;18226;21576;24828,31025,0,1,1,2,4
57783,130,12746,18167,31025,0,0,0,1,1
57784,130,12747,18195;18291,31025,0,0,0,2,2
57785,130,12748,17990;18199,31025,0,0,0,2,2
57786,130,12749,18221;18250;21486,31025,0,0,1,2,3
57787,130,12750,18237;18592;21728;22317,31025,0,0,3,1,4
57788,130,12751,18047;18255,31025,0,0,0,2,2
57789,130,12752,17981;18279,31025,0,0,0,2,2
57790,130,12753,18272,31025,0,0,0,1,1
57791,130,12754,18274;18445,31025,0,0,1,1,2
57792,130,12755,18518;18576,31025,0,0,2,0,2
57793,130,12756,18294;18505,31025,0,0,1,1,2
57794,130,12757,18086;18302;21095,31025,0,0,1,2,3
57795,130,12774,14430,31390,0,0,0,1,1
57796,130,12789,16011,31390,0,0,0,1,1
57797,130,12793,15762,31390,0,0,0,1,1
57798,130,12799,16113;16721,31390,0,0,0,2,2
57799,130,12800,16482,31390,0,0,0,1,1
57800,130,12803,16361,31390,0,0,0,1,1
57801,130,12805,16729;17087,31390,0,0,0,2,2
57802,130,12806,16784;17166,31390,0,0,0,2,2
57803,130,12807,16288,31390,0,0,0,1,1
57804,130,12810,16781;17389,31390,0,0,0,2,2
57805,130,12813,16993;17299,31390,0,0,0,2,2
57806,130,12816,17633,31390,0,0,0,1,1
57807,130,12818,17688;18180,31390,0,0,0,2,2
57808,130,12820,17796;17957,31390,0,0,0,2,2
57809,130,12821,16959;17358,31390,0,0,0,2,2
57810,130,12824,17695,31390,0,0,0,1,1
57811,130,12825,16956;17431,31390,0,0,0,2,2
57812,130,12826,17540;17919;22610,31390,0,0,1,2,3
57813,130,12828,17390;17834,31390,0,0,0,2,2
57814,130,12829,17623;18127,31390,0,0,0,2,2
57815,130,12830,18025;18164;21713,31390,0,0,1,2,3
57816,130,12831,18208,31390,0,0,0,1,1
57817,130,12832,17719;17786;22278,31390,0,0,1,2,3
57818,130,12833,17871;18171,31390,0,0,0,2,2
57819,130,12834,17441;18028;21986,31390,0,0,1,2,3
57820,130,12836,17946,31390,0,0,0,1,1
57821,130,12837,18194;18392,31390,0,0,1,1,2
57822,130,12838,17891,31390,0,0,0,1,1
57823,130,12839,18188,31390,0,0,0,1,1
57824,130,12840,18326;18656,31390,0,0,2,0,2
57825,130,12841,18055;22184;22933;25389;25419,31390,2,0,2,1,5
57826,130,12842,18064;18341,31390,0,0,1,1,2
57827,130,12843,17581;18016,31390,0,0,0,2,2
57828,130,12844,17665;18155,31390,0,0,0,2,2
57829,130,12846,18130;18390,31390,0,0,1,1,2
57830,130,12847,18007;18179,31390,0,0,0,2,2
57831,130,12848,17601;17766;22168,31390,0,0,1,2,3
57832,130,12849,18436;18465,31390,0,0,2,0,2
57833,130,12850,18265;22195,31390,0,0,1,1,2
57834,130,12851,18566;18605,31390,0,0,2,0,2
57835,130,12852,18193;18246;22192,31390,0,0,1,2,3
57836,130,12853,18147;18192,31390,0,0,0,2,2
57837,130,12854,18270,31390,0,0,0,1,1
57838,130,12855,17780;18290,31390,0,0,0,2,2
57839,130,12856,18446;18694,31390,0,0,2,0,2
57840,130,12857,18367;18391;23365,31390,0,0,3,0,3
57841,130,12858,18658;18712,31390,0,0,2,0,2
57842,130,12859,18331,31390,0,0,1,0,1
57843,130,12862,17865;18342,31390,0,0,1,1,2
57844,130,12863,18346,31390,0,0,1,0,1
57845,130,12865,18088;18369,31390,0,0,1,1,2
57846,130,12867,18258;18386,31390,0,0,1,1,2
57847,130,12872,14473,31755,0,0,0,1,1
57848,130,12887,14723,31755,0,0,0,1,1
57849,130,12890,15053,31755,0,0,0,1,1
57850,130,12891,15296,31755,0,0,0,1,1
57851,130,12899,15867,31755,0,0,0,1,1
57852,130,12901,15905,31755,0,0,0,1,1
57853,130,12909,16353;16924,31755,0,0,0,2,2
57854,130,12910,17030,31755,0,0,0,1,1
57855,130,12913,17412;17522,31755,0,0,0,2,2
57856,130,12916,17610,31755,0,0,0,1,1
57857,130,12917,17262;17396,31755,0,0,0,2,2
57858,130,12918,17340;17576,31755,0,0,0,2,2
57859,130,12919,17192;17454,31755,0,0,0,2,2
57860,130,12920,17506;17810,31755,0,0,0,2,2
57861,130,12922,17555;17595,31755,0,0,0,2,2
57862,130,12923,17356;17594,31755,0,0,0,2,2
57863,130,12924,17811,31755,0,0,0,1,1
57864,130,12925,17526,31755,0,0,0,1,1
57865,130,12926,17760;17958,31755,0,0,0,2,2
57866,130,12927,17956;18323;21617;24089;25353,31755,1,1,2,1,5
57867,130,12928,17784;17798,31755,0,0,0,2,2
57868,130,12929,18014;18023;22041;24627;25379,31755,1,1,1,2,5
57869,130,12931,18006;18105,31755,0,0,0,2,2
57870,130,12932,18012;18740,31755,0,0,1,1,2
57871,130,12933,18018;18113,31755,0,0,0,2,2
57872,130,12934,18172;18710;23265,31755,0,0,2,1,3
57873,130,12935,18245;18332,31755,0,0,1,1,2
57874,130,12936,18563,31755,0,0,1,0,1
57875,130,12937,18456;18457,31755,0,0,2,0,2
57876,130,12938,18154;18621;22847,31755,0,0,2,1,3
57877,130,12939,17713;18158;21097;24273;25328,31755,1,1,1,2,5
57878,130,12940,17625;18173,31755,0,0,0,2,2
57879,130,12941,18118;18840,31755,0,0,1,1,2
57880,130,12942,18252,31755,0,0,0,1,1
57881,130,12943,18128;18266,31755,0,0,0,2,2
57882,130,12944,18305,31755,0,0,0,1,1
57883,130,12945,18256;18273,31755,0,0,0,2,2
57884,130,12946,18276;18300,31755,0,0,0,2,2
57885,130,12947,18285;18802;22534;22637;22946;25190;25422;25508,31755,3,0,4,1,8
57886,130,12948,18225;18698,31755,0,0,1,1,2
57887,130,12949,18303,31755,0,0,0,1,1
57888,130,12950,17693;18395,31755,0,0,1,1,2
57889,130,12951,18396;18717,31755,0,0,2,0,2
57890,130,12952,17889;18486;22011,31755,0,0,2,1,3
57891,130,12953,18425;21929,31755,0,0,2,0,2
57892,130,12954,18385;18426;23577,31755,0,0,3,0,3
57893,130,12955,18328,31755,0,0,1,0,1
57894,130,12956,18223;18434,31755,0,0,1,1,2
57895,130,12957,18577,31755,0,0,1,0,1
57896,130,12959,18149;18513,31755,0,0,1,1,2
57897,130,12961,18779;18861;23371,31755,0,0,3,0,3
57898,130,12962,18437;18527,31755,0,0,2,0,2
57899,130,12980,15194,32120,0,0,0,1,1
57900,130,12989,15748;15980,32120,0,0,0,2,2
57901,130,12996,15814,32120,0,0,0,1,1
57902,130,13007,16738;17137,32120,0,0,0,2,2
57903,130,13008,17226,32120,0,0,0,1,1
57904,130,13015,17475,32120,0,0,0,1,1
57905,130,13019,18150;18166,32120,0,0,0,2,2
57906,130,13020,18129,32120,0,0,0,1,1
57907,130,13024,18083,32120,0,0,0,1,1
57908,130,13025,17671;17975,32120,0,0,0,2,2
57909,130,13026,18148,32120,0,0,0,1,1
57910,130,13027,17615;17896,32120,0,0,0,2,2
57911,130,13028,17770;17987,32120,0,0,0,2,2
57912,130,13029,18263,32120,0,0,0,1,1
57913,130,13030,18045,32120,0,0,0,1,1
57914,130,13032,18095;18359,32120,0,0,1,1,2
57915,130,13033,17833;18257;22012,32120,0,0,1,2,3
57916,130,13036,18284;18746,32120,0,0,1,1,2
57917,130,13037,17708;18502;21747,32120,0,0,2,1,3
57918,130,13038,18562;18784,32120,0,0,2,0,2
57919,130,13039,17762;18228,32120,0,0,0,2,2
57920,130,13040,18702;18829;22631,32120,0,0,3,0,3
57921,130,13041,18355;21926;25060,32120,1,0,2,0,3
57922,130,13042,18356;18380,32120,0,0,2,0,2
57923,130,13043,18135;18278;21670;24610;24720;24935;25455,32120,1,3,1,2,7
57924,130,13044,18288;18634;21596;23046;25308;25425,32120,2,0,3,1,6
57925,130,13045,18281;18413;21553;23463,32120,0,0,3,1,4
57926,130,13046,18040;18421;22412,32120,0,0,2,1,3
57927,130,13047,18428;18611;24004,32120,0,1,2,0,3
57928,130,13048,18347;18821;23579,32120,0,0,3,0,3
57929,130,13049,18364;18699,32120,0,0,2,0,2
57930,130,13050,18177;18443;22414,32120,0,0,2,1,3
57931,130,13051,18453;18550;22939,32120,0,0,3,0,3
57932,130,13052,17710;18478,32120,0,0,1,1,2
57933,130,13053,18519,32120,0,0,1,0,1
57934,130,13055,18533;18583,32120,0,0,2,0,2
57935,130,13056,18405;18560;23366,32120,0,0,3,0,3
57936,130,13057,18785;18971;23271,32120,0,0,3,0,3
57937,130,13058,18685;18790;21016,32120,0,0,3,0,3
57938,130,13059,18578;18686,32120,0,0,2,0,2
57939,130,13061,18614;18772;23266,32120,0,0,3,0,3
57940,130,13062,18201;18594,32120,0,0,1,1,2
57941,130,13072,14185,32485,0,0,0,1,1
57942,130,13079,14795;15291,32485,0,0,0,2,2
57943,130,13083,15772,32485,0,0,0,1,1
57944,130,13087,16393,32485,0,0,0,1,1
57945,130,13103,16545,32485,0,0,0,1,1
57946,130,13108,17452,32485,0,0,0,1,1
57947,130,13110,17661,32485,0,0,0,1,1
57948,130,13112,17416;17590,32485,0,0,0,2,2
57949,130,13113,17732;22186,32485,0,0,1,1,2
57950,130,13114,17587,32485,0,0,0,1,1
57951,130,13116,17698;17851,32485,0,0,0,2,2
57952,130,13121,17498,32485,0,0,0,1,1
57953,130,13122,18072,32485,0,0,0,1,1
57954,130,13123,18054;18212;21613,32485,0,0,1,2,3
57955,130,13124,17905;18022,32485,0,0,0,2,2
57956,130,13125,17730;17964;21978,32485,0,0,1,2,3
57957,130,13126,18021,32485,0,0,0,1,1
57958,130,13127,18032;18039;21661;22183,32485,0,0,2,2,4
57959,130,13128,18467;18789,32485,0,0,2,0,2
57960,130,13129,18404;18898;22442,32485,0,0,3,0,3
57961,130,13130,18133;18744;22039;23778,32485,0,1,2,1,4
57962,130,13131,18248,32485,0,0,0,1,1
57963,130,13133,18309;18628,32485,0,0,1,1,2
57964,130,13134,18163,32485,0,0,0,1,1
57965,130,13136,18011;18334,32485,0,0,1,1,2
57966,130,13138,18575,32485,0,0,1,0,1
57967,130,13139,18910;19260;23779,32485,0,1,2,0,3
57968,130,13140,18438,32485,0,0,1,0,1
57969,130,13141,18477;18769,32485,0,0,2,0,2
57970,130,13142,18219;18479,32485,0,0,1,1,2
57971,130,13143,18915;22748,32485,0,0,2,0,2
57972,130,13144,17856;18491,32485,0,0,1,1,2
57973,130,13145,18370;18676,32485,0,0,2,0,2
57974,130,13147,18510;18720,32485,0,0,2,0,2
57975,130,13149,18481;18520;21773,32485,0,0,3,0,3
57976,130,13151,18951,32485,0,0,1,0,1
57977,130,13152,18393,32485,0,0,1,0,1
57978,130,13153,18723;18968,32485,0,0,2,0,2
57979,130,13154,18941,32485,0,0,1,0,1
57980,130,13155,18747;18877;22746;25522,32485,1,0,3,0,4
57981,130,13157,18655,32485,0,0,1,0,1
57982,130,13158,18778;19101;23267;25431,32485,1,0,3,0,4
57983,130,13159,18662,32485,0,0,1,0,1
57984,130,13160,18683;18714;22739;25521,32485,1,0,3,0,4
57985,130,13161,18187;18574,32485,0,0,1,1,2
57986,130,13162,18727;19057,32485,0,0,2,0,2
57987,130,13163,18739;19090,32485,0,0,2,0,2
57988,130,13164,18964;19201;22862,32485,0,0,3,0,3
57989,130,13178,15287,32850,0,0,0,1,1
57990,130,13187,15840;16148,32850,0,0,0,2,2
57991,130,13192,16527,32850,0,0,0,1,1
57992,130,13193,16219,32850,0,0,0,1,1
57993,130,13203,16790;17002,32850,0,0,0,2,2
57994,130,13206,17148;17379,32850,0,0,0,2,2
57995,130,13210,17493,32850,0,0,0,1,1
57996,130,13211,17886;18026,32850,0,0,0,2,2
57997,130,13214,17678;18205,32850,0,0,0,2,2
57998,130,13216,18198;18320,32850,0,0,1,1,2
57999,130,13217,17816;18315,32850,0,0,0,2,2
58000,130,13218,17892;18211;22507,32850,0,0,1,2,3
58001,130,13219,17923,32850,0,0,0,1,1
58002,130,13220,18104;18498;22209,32850,0,0,2,1,3
58003,130,13222,17973;18403,32850,0,0,1,1,2
58004,130,13224,17621;18001,32850,0,0,0,2,2
58005,130,13225,17954;18033,32850,0,0,0,2,2
58006,130,13226,17772;18076,32850,0,0,0,2,2
58007,130,13227,18238;18275;22509;23039,32850,0,0,2,2,4
58008,130,13228,18069;18074,32850,0,0,0,2,2
58009,130,13229,18289;18644,32850,0,0,1,1,2
58010,130,13231,18591;22422,32850,0,0,2,0,2
58011,130,13232,17894;18282;22726,32850,0,0,1,2,3
58012,130,13233,18286,32850,0,0,0,1,1
58013,130,13234,18310,32850,0,0,0,1,1
58014,130,13235,17793;18354,32850,0,0,1,1,2
58015,130,13236,18362,32850,0,0,1,0,1
58016,130,13237,18366;18483;23042,32850,0,0,3,0,3
58017,130,13238,18516;18586;21876,32850,0,0,3,0,3
58018,130,13239,18239;18433,32850,0,0,1,1,2
58019,130,13240,18415;19038,32850,0,0,2,0,2
58020,130,13241,18567;18811;22419,32850,0,0,3,0,3
58021,130,13243,18490;19032;22450;22869;23471,32850,0,0,5,0,5
58022,130,13244,18254;18525,32850,0,0,1,1,2
58023,130,13245,18292;18962,32850,0,0,1,1,2
58024,130,13246,18492;18570,32850,0,0,2,0,2
58025,130,13248,18352;18599,32850,0,0,2,0,2
58026,130,13249,18677;18793;23051,32850,0,0,3,0,3
58027,130,13250,18627;18692,32850,0,0,2,0,2
58028,130,13251,18648;18890,32850,0,0,2,0,2
58029,130,13252,18500;18671;22630;25410,32850,1,0,3,0,4
58030,130,13253,18638;18952,32850,0,0,2,0,2
58031,130,13254,18345;18680,32850,0,0,2,0,2
58032,130,13255,18682,32850,0,0,1,0,1
58033,130,13256,18571;18651,32850,0,0,2,0,2
58034,130,13257,18556;18963;22950;23469,32850,0,0,4,0,4
58035,130,13258,18690;19006;23153,32850,0,0,3,0,3
58036,130,13259,18715;22944,32850,0,0,2,0,2
58037,130,13260,18766,32850,0,0,1,0,1
58038,130,13261,18770,32850,0,0,1,0,1
58039,130,13262,18774;19206,32850,0,0,2,0,2
58040,130,13263,18745;18823,32850,0,0,2,0,2
58041,130,13264,18846;18980,32850,0,0,2,0,2
58042,130,13265,18853;19151,32850,0,0,2,0,2
58043,130,13266,18507;18849,32850,0,0,2,0,2
58044,130,13280,15190,33215,0,0,0,1,1
58045,130,13293,16078,33215,0,0,0,1,1
58046,130,13304,16463;17083,33215,0,0,0,2,2
58047,130,13305,17199;17321,33215,0,0,0,2,2
58048,130,13306,16931,33215,0,0,0,1,1
58049,130,13308,18231,33215,0,0,0,1,1
58050,130,13309,17531;17854;21325;24498;24588;25215,33215,1,2,1,2,6
58051,130,13311,18344;18410,33215,0,0,2,0,2
58052,130,13313,18044;18371,33215,0,0,1,1,2
58053,130,13315,18060;18247,33215,0,0,0,2,2
58054,130,13316,18243;18253,33215,0,0,0,2,2
58055,130,13317,18143;18264;21492,33215,0,0,1,2,3
58056,130,13318,18283;18564;23263,33215,0,0,2,1,3
58057,130,13319,18337;18604,33215,0,0,2,0,2
58058,130,13320,18340;18788;21954,33215,0,0,3,0,3
58059,130,13322,18927;19010;22953,33215,0,0,3,0,3
58060,130,13323,18416;18418,33215,0,0,2,0,2
58061,130,13324,18547;19021,33215,0,0,2,0,2
58062,130,13325,18451;18625,33215,0,0,2,0,2
58063,130,13326,18654,33215,0,0,1,0,1
58064,130,13328,18524;18617;22425,33215,0,0,3,0,3
58065,130,13331,18645;18836,33215,0,0,2,0,2
58066,130,13332,19125;19161;22875;23676,33215,0,1,3,0,4
58067,130,13333,18707;18848,33215,0,0,2,0,2
58068,130,13334,18873;19275;22778,33215,0,0,3,0,3
58069,130,13335,18902;18935;21816,33215,0,0,3,0,3
58070,130,13336,18750;18929,33215,0,0,2,0,2
58071,130,13337,19315,33215,0,0,1,0,1
58072,130,13338,18764;19121;23069,33215,0,0,3,0,3
58073,130,13339,18630;18914,33215,0,0,2,0,2
58074,130,13340,18780;18896,33215,0,0,2,0,2
58075,130,13341,19205,33215,0,0,1,0,1
58076,130,13342,18794;23052,33215,0,0,2,0,2
58077,130,13343,19009;19027,33215,0,0,2,0,2
58078,130,13344,19233,33215,0,0,1,0,1
58079,130,13345,18923;19087;22026;24965,33215,0,1,3,0,4
58080,130,13346,19168;19369,33215,0,0,2,0,2
58081,130,13347,18875;23268;23467,33215,0,0,3,0,3
58082,130,13348,18886;22020;23468,33215,0,0,3,0,3
58083,130,13349,18900;18928,33215,0,0,2,0,2
58084,130,13350,18913;18965;21950;24739,33215,0,1,3,0,4
58085,130,13351,18891;18957;23152,33215,0,0,3,0,3
58086,130,13352,18981;19299,33215,0,0,2,0,2
58087,130,13374,15578,33580,0,0,0,1,1
58088,130,13382,16347,33580,0,0,0,1,1
58089,130,13386,15924,33580,0,0,0,1,1
58090,130,13387,15739,33580,0,0,0,1,1
58091,130,13395,17055,33580,0,0,0,1,1
58092,130,13403,16989,33580,0,0,0,1,1
58093,130,13407,18015;18261,33580,0,0,0,2,2
58094,130,13408,17314,33580,0,0,0,1,1
58095,130,13410,17627;18312,33580,0,0,0,2,2
58096,130,13413,17933;18020;21765,33580,0,0,1,2,3
58097,130,13418,18038;18043,33580,0,0,0,2,2
58098,130,13420,17902,33580,0,0,0,1,1
58099,130,13421,17845,33580,0,0,0,1,1
58100,130,13422,18183,33580,0,0,0,1,1
58101,130,13423,18174;18202,33580,0,0,0,2,2
58102,130,13425,17822;18229,33580,0,0,0,2,2
58103,130,13426,18304;21947;25063;25475,33580,2,0,1,1,4
58104,130,13428,18314,33580,0,0,0,1,1
58105,130,13429,18474;18565,33580,0,0,2,0,2
58106,130,13430,18082;18373,33580,0,0,1,1,2
58107,130,13431,18053;18440,33580,0,0,1,1,2
58108,130,13432,18870;18897,33580,0,0,2,0,2
58109,130,13433,18506;18868;22342,33580,0,0,3,0,3
58110,130,13434,18514;18588;23465;25539,33580,1,0,3,0,4
58111,130,13435,18531;18834;22642,33580,0,0,3,0,3
58112,130,13436,18561;18606;23044,33580,0,0,3,0,3
58113,130,13437,18569;19392,33580,0,0,2,0,2
58114,130,13438,18892;19109,33580,0,0,2,0,2
58115,130,13439,18607;19041;21358,33580,0,0,3,0,3
58116,130,13440,18748;18812,33580,0,0,2,0,2
58117,130,13441,19124;22657,33580,0,0,2,0,2
58118,130,13442,18783;19354;22884;25088,33580,1,0,3,0,4
58119,130,13443,18810;19269,33580,0,0,2,0,2
58120,130,13444,18833;19188;22641,33580,0,0,3,0,3
58121,130,13445,18220;18867,33580,0,0,1,1,2
58122,130,13446,18893;18954,33580,0,0,2,0,2
58123,130,13447,18904;19282;22974,33580,0,0,3,0,3
58124,130,13448,18759;18907;22530;23370,33580,0,0,4,0,4
58125,130,13449,18504;18918,33580,0,0,2,0,2
58126,130,13450,18934;19185,33580,0,0,2,0,2
58127,130,13451,18939;18988,33580,0,0,2,0,2
58128,130,13452,18943;19298;22881,33580,0,0,3,0,3
58129,130,13453,19217;19325,33580,0,0,2,0,2
58130,130,13454,19070,33580,0,0,1,0,1
58131,130,13455,18995,33580,0,0,1,0,1
58132,130,13456,18773;19013;22955;23470,33580,0,0,4,0,4
58133,130,13457,19092;19242;23275,33580,0,0,3,0,3
58134,130,13458,18818;19017,33580,0,0,2,0,2
58135,130,13459,19035,33580,0,0,1,0,1
58136,130,13461,19093;19366,33580,0,0,2,0,2
58137,130,13462,19104;19435;21354;21963;23883;24592,33580,0,2,4,0,6
58138,130,13464,14407,33945,0,0,0,1,1
58139,130,13477,15612,33945,0,0,0,1,1
58140,130,13479,15825,33945,0,0,0,1,1
58141,130,13492,16444,33945,0,0,0,1,1
58142,130,13496,17174;17281,33945,0,0,0,2,2
58143,130,13499,17415,33945,0,0,0,1,1
58144,130,13502,17459;17676,33945,0,0,0,2,2
58145,130,13505,17530;17876,33945,0,0,0,2,2
58146,130,13506,17502;17600,33945,0,0,0,2,2
58147,130,13508,17809,33945,0,0,0,1,1
58148,130,13509,18493,33945,0,0,1,0,1
58149,130,13510,17273;17691,33945,0,0,0,2,2
58150,130,13511,17751;17814,33945,0,0,0,2,2
58151,130,13512,18065;18454,33945,0,0,1,1,2
58152,130,13514,18115;18327,33945,0,0,1,1,2
58153,130,13515,18724;23048,33945,0,0,2,0,2
58154,130,13516,17979,33945,0,0,0,1,1
58155,130,13517,18319;18447,33945,0,0,2,0,2
58156,130,13518,18488;22840,33945,0,0,2,0,2
58157,130,13519,18325;22201,33945,0,0,2,0,2
58158,130,13520,18085;18401,33945,0,0,1,1,2
58159,130,13521,18190;18414,33945,0,0,1,1,2
58160,130,13522,18455;18767;21614,33945,0,0,3,0,3
58161,130,13526,18280;18521,33945,0,0,1,1,2
58162,130,13527,18542;18544,33945,0,0,2,0,2
58163,130,13528,18554,33945,0,0,1,0,1
58164,130,13529,17849;18080,33945,0,0,0,2,2
58165,130,13530,18537;18585,33945,0,0,2,0,2
58166,130,13531,18031;18589;22519;22734;25084;25186;25297,33945,3,0,3,1,7
58167,130,13533,18489;18608,33945,0,0,2,0,2
58168,130,13534,18037;18623,33945,0,0,1,1,2
58169,130,13536,18600;18956,33945,0,0,2,0,2
58170,130,13537,18530;18950;21456,33945,0,0,3,0,3
58171,130,13539,17903;18758;23466,33945,0,0,2,1,3
58172,130,13540,18775,33945,0,0,1,0,1
58173,130,13541,19302;19318;21556,33945,0,0,3,0,3
58174,130,13542,18795,33945,0,0,1,0,1
58175,130,13543,18555;18771;22158,33945,0,0,3,0,3
58176,130,13544,18806;19195;24316,33945,0,1,2,0,3
58177,130,13545,18466;18970,33945,0,0,2,0,2
58178,130,13546,18842;18917,33945,0,0,2,0,2
58179,130,13547,18587;18858,33945,0,0,2,0,2
58180,130,13548,18860;19073,33945,0,0,2,0,2
58181,130,13549,19054;19172;22772,33945,0,0,3,0,3
58182,130,13550,19279;19400;22980,33945,0,0,3,0,3
58183,130,13551,19050;23063,33945,0,0,2,0,2
58184,130,13552,19018;19111;21696;24837;25360,33945,1,1,3,0,5
58185,130,13553,18924;19007,33945,0,0,2,0,2
58186,130,13554,18541;18944,33945,0,0,2,0,2
58187,130,13556,18978,33945,0,0,1,0,1
58188,130,13557,19002;22755,33945,0,0,2,0,2
58189,130,13558,19019;19065,33945,0,0,2,0,2
58190,130,13559,18756;19024;22957,33945,0,0,3,0,3
58191,130,13561,19228;19376;21999,33945,0,0,3,0,3
58192,130,13562,18854;18982;22753,33945,0,0,3,0,3
58193,130,13563,19080;19391;23082;23681,33945,0,1,3,0,4
58194,130,13564,19084;19089,33945,0,0,2,0,2
58195,130,13565,18933;19086;22763,33945,0,0,3,0,3
58196,130,13566,18679;19096;22655;23674,33945,0,1,3,0,4
58197,130,13567,18997;19098,33945,0,0,2,0,2
58198,130,13568,18809;19099;23156,33945,0,0,3,0,3
58199,130,13569,18730;19427;23387,33945,0,0,3,0,3
58200,130,13570,19067;19115;23065;24013,33945,0,1,3,0,4
58201,130,13571,19141;19464;22679;23287,33945,0,0,4,0,4
58202,130,13572,19142;19378;23384;23477;23680,33945,0,1,4,0,5
58203,130,13573,18813;19173,33945,0,0,2,0,2
58204,130,13574,18731;19434,33945,0,0,2,0,2
58205,130,13575,19550;23089;23482;25192,33945,1,0,3,0,4
58206,130,13585,15152,34310,0,0,0,1,1
58207,130,13588,15252,34310,0,0,0,1,1
58208,130,13595,15896,34310,0,0,0,1,1
58209,130,13599,16313,34310,0,0,0,1,1
58210,130,13604,16911;17008,34310,0,0,0,2,2
58211,130,13605,17040,34310,0,0,0,1,1
58212,130,13609,16626,34310,0,0,0,1,1
58213,130,13610,17246;17993,34310,0,0,0,2,2
58214,130,13611,17169,34310,0,0,0,1,1
58215,130,13612,17027;17404,34310,0,0,0,2,2
58216,130,13616,17473,34310,0,0,0,1,1
58217,130,13618,17799;17805;21639,34310,0,0,1,2,3
58218,130,13619,18137,34310,0,0,0,1,1
58219,130,13621,17899;18079,34310,0,0,0,2,2
58220,130,13622,17974;18153,34310,0,0,0,2,2
58221,130,13623,17955,34310,0,0,0,1,1
58222,130,13624,17826;17992,34310,0,0,0,2,2
58223,130,13627,17806;18051,34310,0,0,0,2,2
58224,130,13628,18402;18534,34310,0,0,2,0,2
58225,130,13629,18363,34310,0,0,1,0,1
58226,130,13631,18528,34310,0,0,1,0,1
58227,130,13632,17912;18297,34310,0,0,0,2,2
58228,130,13633,17885;18073,34310,0,0,0,2,2
58229,130,13634,18462;18670;22077;22430;23368;25287;25402;25503,34310,3,0,5,0,8
58230,130,13635,18376,34310,0,0,1,0,1
58231,130,13638,18642;18673;23148,34310,0,0,3,0,3
58232,130,13639,18647,34310,0,0,1,0,1
58233,130,13640,18540;18659,34310,0,0,2,0,2
58234,130,13642,18942;19030;22960,34310,0,0,3,0,3
58235,130,13644,18372;18741;21998,34310,0,0,3,0,3
58236,130,13645,19083;19103,34310,0,0,2,0,2
58237,130,13647,18830;18889,34310,0,0,2,0,2
58238,130,13648,18464;18814;22742;22854,34310,0,0,4,0,4
58239,130,13649,19230,34310,0,0,1,0,1
58240,130,13651,18839;18911,34310,0,0,2,0,2
58241,130,13652,19211;19280;22371;22463,34310,0,0,4,0,4
58242,130,13653,19129,34310,0,0,1,0,1
58243,130,13655,18960;19537;22685,34310,0,0,3,0,3
58244,130,13656,18708;19036,34310,0,0,2,0,2
58245,130,13658,18985;19053,34310,0,0,2,0,2
58246,130,13659,19016;19117,34310,0,0,2,0,2
58247,130,13660,18760;19039,34310,0,0,2,0,2
58248,130,13662,19051;19289;22361;22961,34310,0,0,4,0,4
58249,130,13663,19163;23377,34310,0,0,2,0,2
58250,130,13664,18991;19061,34310,0,0,2,0,2
58251,130,13665,18932;19131,34310,0,0,2,0,2
58252,130,13666,19381;19500;22790,34310,0,0,3,0,3
58253,130,13667,19108;19398;23682,34310,0,1,2,0,3
58254,130,13669,19138;19145;21686;24401;24836;25239,34310,1,2,3,0,6
58255,130,13670,19159;19221;23075;23161,34310,0,0,4,0,4
58256,130,13671,19004;19169;23894,34310,0,1,2,0,3
58257,130,13672,19425;23585,34310,0,0,2,0,2
58258,130,13673,19411;21611;22570;23774,34310,0,1,3,0,4
58259,130,13674,18885;19209,34310,0,0,2,0,2
58260,130,13675,19120;19216,34310,0,0,2,0,2
58261,130,13676,19667;24644,34310,0,1,1,0,2
58262,130,13677,19448;22784;23685,34310,0,1,2,0,3
58263,130,13678,18936;19261,34310,0,0,2,0,2
58264,130,13679,19518;19522;22684;23180,34310,0,0,4,0,4
58265,130,13680,19167;22968,34310,0,0,2,0,2
58266,130,13681,14759,34675,0,0,0,1,1
58267,130,13690,15952,34675,0,0,0,1,1
58268,130,13692,16161,34675,0,0,0,1,1
58269,130,13693,16256,34675,0,0,0,1,1
58270,130,13709,18089;18480;22096;24747;25385,34675,1,1,2,1,5
58271,130,13710,17669,34675,0,0,0,1,1
58272,130,13711,18543,34675,0,0,1,0,1
58273,130,13712,18317;18408,34675,0,0,2,0,2
58274,130,13717,18476;18582,34675,0,0,2,0,2
58275,130,13718,18598;22845,34675,0,0,2,0,2
58276,130,13719,18631;22857;23054;24989,34675,0,1,3,0,4
58277,130,13721,18695;18938,34675,0,0,2,0,2
58278,130,13722,18449;18703;22632,34675,0,0,3,0,3
58279,130,13723,18729;18736,34675,0,0,2,0,2
58280,130,13725,18820;19374;21925,34675,0,0,3,0,3
58281,130,13726,19365;23167,34675,0,0,2,0,2
58282,130,13727,19258;19718;23276,34675,0,0,3,0,3
58283,130,13729,18856,34675,0,0,1,0,1
58284,130,13730,18593;18862,34675,0,0,2,0,2
58285,130,13731,19126;19270;22248;22553;22658;23070;25293;25512,34675,2,0,6,0,8
58286,130,13732,18961;18975;23057,34675,0,0,3,0,3
58287,130,13733,18973;18986,34675,0,0,2,0,2
58288,130,13734,18901;18992;23374,34675,0,0,3,0,3
58289,130,13735,19068;19220;22775,34675,0,0,3,0,3
58290,130,13736,19503,34675,0,0,1,0,1
58291,130,13737,19114;23472,34675,0,0,2,0,2
58292,130,13738,19147;19379;23282;23385,34675,0,0,4,0,4
58293,130,13739,19088;19158;23072,34675,0,0,3,0,3
58294,130,13740,19438;19900;22783;22984,34675,0,0,4,0,4
58295,130,13741,19397;19507;23785,34675,0,1,2,0,3
58296,130,13742,19512;21811;22683;23087;24948,34675,0,1,4,0,5
58297,130,13743,19082;19278,34675,0,0,2,0,2
58298,130,13745,19113;19307;22975,34675,0,0,3,0,3
58299,130,13746,18649;19332;22019;23164,34675,0,0,4,0,4
58300,130,13747,19353;19554;23687,34675,0,1,2,0,3
58301,130,13748,18878;19384,34675,0,0,2,0,2
58302,130,13749,19429;19433,34675,0,0,2,0,2
58303,130,13760,15523,35040,0,0,0,1,1
58304,130,13761,15558;15781,35040,0,0,0,2,2
58305,130,13769,16089,35040,0,0,0,1,1
58306,130,13771,16182,35040,0,0,0,1,1
58307,130,13793,18066,35040,0,0,0,1,1
58308,130,13797,18343,35040,0,0,1,0,1
58309,130,13799,18213;18311,35040,0,0,0,2,2
58310,130,13803,22135;22947;23146,35040,0,0,3,0,3
58311,130,13804,18458,35040,0,0,1,0,1
58312,130,13805,18191;18620,35040,0,0,1,1,2
58313,130,13806,18222;18432,35040,0,0,1,1,2
58314,130,13807,18271;18622,35040,0,0,1,1,2
58315,130,13811,18322;18470;22935;25420,35040,1,0,3,0,4
58316,130,13812,18077;18529;22938,35040,0,0,2,1,3
58317,130,13814,18546,35040,0,0,1,0,1
58318,130,13815,19199;19229;21993;22776,35040,0,0,4,0,4
58319,130,13816,18925;23055,35040,0,0,2,0,2
58320,130,13817,18602;18667;22220;22850;24988,35040,0,1,4,0,5
58321,130,13818,18722;22327,35040,0,0,2,0,2
58322,130,13819,18763;19091,35040,0,0,2,0,2
58323,130,13820,18787;19077;22962;23376,35040,0,0,4,0,4
58324,130,13821,18845;19160;23677,35040,0,1,2,0,3
58325,130,13823,18613;18920,35040,0,0,2,0,2
58326,130,13824,19521,35040,0,0,1,0,1
58327,130,13825,18979;19246,35040,0,0,2,0,2
58328,130,13826,18989;19154,35040,0,0,2,0,2
58329,130,13827,18616;19011,35040,0,0,2,0,2
58330,130,13828,19288;19360,35040,0,0,2,0,2
58331,130,13829,18976;19042,35040,0,0,2,0,2
58332,130,13830,19226;19494;23898,35040,0,1,2,0,3
58333,130,13831,18872;19049,35040,0,0,2,0,2
58334,130,13832,19074;19157;22245;22761;23066,35040,0,0,5,0,5
58335,130,13833,18535;19112,35040,0,0,2,0,2
58336,130,13834,19063;19638,35040,0,0,2,0,2
58337,130,13835,19152;19612,35040,0,0,2,0,2
58338,130,13836,18847;19196;23380,35040,0,0,3,0,3
58339,130,13837,19388,35040,0,0,1,0,1
58340,130,13838,18603;19213;22557;23381,35040,0,0,4,0,4
58341,130,13839,19181;19244;22972,35040,0,0,3,0,3
58342,130,13840,19273;19865;23410,35040,0,0,3,0,3
58343,130,13841,19277;19495;22789,35040,0,0,3,0,3
58344,130,13842,19286;19382;23783,35040,0,1,2,0,3
58345,130,13844,19224;19293,35040,0,0,2,0,2
58346,130,13845,18832;19303,35040,0,0,2,0,2
58347,130,13846,19107;19123,35040,0,0,2,0,2
58348,130,13847,18837;19317;23781,35040,0,1,2,0,3
58349,130,13849,19294;19350,35040,0,0,2,0,2
58350,130,13850,19165;19352;22976;23679;23782;23897;25435,35040,1,3,3,0,7
58351,130,13851,19214;19313,35040,0,0,2,0,2
58352,130,13852,19803;19853;22029;23598,35040,0,0,4,0,4
58353,130,13853,18999;19561;21966;22554;23392,35040,0,0,5,0,5
58354,130,13854,19492;19781;23595,35040,0,0,3,0,3
58355,130,13855,19652;19837;24105,35040,0,1,2,0,3
58356,130,13858,19540;19675;23400,35040,0,0,3,0,3
58357,130,13859,19472;19757;22808;23594;23694;23792;24986;25189,35040,1,3,4,0,8
58358,130,13860,19474;19748;22988;23175,35040,0,0,4,0,4
58359,130,13861,19767,35040,0,0,1,0,1
58360,130,13862,19846;23798;24015,35040,0,2,1,0,3
58361,130,13863,19407;19491;22476;23390;23481;24979;25405,35040,1,1,5,0,7
58362,130,13864,19396;19529,35040,0,0,2,0,2
58363,130,13865,19535;19619;23786,35040,0,1,2,0,3
58364,130,13871,15452,35405,0,0,0,1,1
58365,130,13872,15623,35405,0,0,0,1,1
58366,130,13876,15478,35405,0,0,0,1,1
58367,130,13878,15445;15792,35405,0,0,0,2,2
58368,130,13879,15926,35405,0,0,0,1,1
58369,130,13881,16102,35405,0,0,0,1,1
58370,130,13884,15655,35405,0,0,0,1,1
58371,130,13886,16601;16826,35405,0,0,0,2,2
58372,130,13888,15878,35405,0,0,0,1,1
58373,130,13896,17234,35405,0,0,0,1,1
58374,130,13898,17335;17375,35405,0,0,0,2,2
58375,130,13905,17466;17970,35405,0,0,0,2,2
58376,130,13908,18017,35405,0,0,0,1,1
58377,130,13910,18230;18236,35405,0,0,0,2,2
58378,130,13911,18244;18374,35405,0,0,1,1,2
58379,130,13912,18398;18619;22522;25183;25507,35405,2,0,3,0,5
58380,130,13915,18117;18827;23150,35405,0,0,2,1,3
58381,130,13918,18388;18538,35405,0,0,2,0,2
58382,130,13919,18517;22417;25502,35405,1,0,2,0,3
58383,130,13920,18532;18757,35405,0,0,2,0,2
58384,130,13921,18553;19044;23375,35405,0,0,3,0,3
58385,130,13922,18579;19094,35405,0,0,2,0,2
58386,130,13924,18624;18718;21962;23369,35405,0,0,4,0,4
58387,130,13925,18626;18657;22735,35405,0,0,3,0,3
58388,130,13926,18629;19223,35405,0,0,2,0,2
58389,130,13927,18735,35405,0,0,1,0,1
58390,130,13928,18796;19287;22565;22665;23583,35405,0,0,5,0,5
58391,130,13932,18549,35405,0,0,1,0,1
58392,130,13933,18958;19156,35405,0,0,2,0,2
58393,130,13935,19031;19444;22888,35405,0,0,3,0,3
58394,130,13936,18851;19037;23580,35405,0,0,3,0,3
58395,130,13937,19533;19620,35405,0,0,2,0,2
58396,130,13938,19204;19356;23474,35405,0,0,3,0,3
58397,130,13939,19412;19654;23189,35405,0,0,3,0,3
58398,130,13940,18863;19194;23473,35405,0,0,3,0,3
58399,130,13941,19132;19662,35405,0,0,2,0,2
58400,130,13942,18732;19283;23163;23780;24005,35405,0,2,3,0,5
58401,130,13943,18637;19192;22556,35405,0,0,3,0,3
58402,130,13945,18987;19231;23382,35405,0,0,3,0,3
58403,130,13946,19100;19254,35405,0,0,2,0,2
58404,130,13947,19025;19285,35405,0,0,2,0,2
58405,130,13948,19558;19656;23690;24011,35405,0,2,2,0,4
58406,130,13949,19422,35405,0,0,1,0,1
58407,130,13950,19251;19266,35405,0,0,2,0,2
58408,130,13951,19166;19368,35405,0,0,2,0,2
58409,130,13952,19203;19578,35405,0,0,2,0,2
58410,130,13953,19431;19882;23601,35405,0,0,3,0,3
58411,130,13954,19588;19990;23517;23705,35405,0,1,3,0,4
58412,130,13955,19417,35405,0,0,1,0,1
58413,130,13957,18909;19238,35405,0,0,2,0,2
58414,130,13958,19306;19679;23901,35405,0,1,2,0,3
58415,130,13960,19684;19753;22579;23790,35405,0,1,3,0,4
58416,130,13961,19326;19568,35405,0,0,2,0,2
58417,130,13962,19225;19577;23292,35405,0,0,3,0,3
58418,130,13963,19064;19581;23689,35405,0,1,2,0,3
58419,130,13964,19611;20119,35405,0,0,2,0,2
58420,130,13965,19548;19641,35405,0,0,2,0,2
58421,130,13966,19215;19634;22692,35405,0,0,3,0,3
58422,130,13967,19836;19993;23706;24428;24531,35405,0,3,2,0,5
58423,130,13968,19680;19889,35405,0,0,2,0,2
58424,130,13992,16400;16586,35770,0,0,0,2,2
58425,130,13996,16476,35770,0,0,0,1,1
58426,130,14004,17277;17374,35770,0,0,0,2,2
58427,130,14009,17553,35770,0,0,0,1,1
58428,130,14011,17852;18487,35770,0,0,1,1,2
58429,130,14012,17931;18335,35770,0,0,1,1,2
58430,130,14021,18383;18444,35770,0,0,2,0,2
58431,130,14023,18241;18450,35770,0,0,1,1,2
58432,130,14024,18307;18494,35770,0,0,1,1,2
58433,130,14027,18612;19072,35770,0,0,2,0,2
58434,130,14028,18293;18781,35770,0,0,1,1,2
58435,130,14029,19045;19264;23277,35770,0,0,3,0,3
58436,130,14030,19047;19186;22555;22659;24863;24980,35770,0,2,4,0,6
58437,130,14032,18937;19095;23273,35770,0,0,3,0,3
58438,130,14033,19608;19881;22120;23699,35770,0,1,3,0,4
58439,130,14034,19268,35770,0,0,1,0,1
58440,130,14035,19028,35770,0,0,1,0,1
58441,130,14036,18931,35770,0,0,1,0,1
58442,130,14038,19144;19295,35770,0,0,2,0,2
58443,130,14039,18908;19179;23160,35770,0,0,3,0,3
58444,130,14040,19187;19527,35770,0,0,2,0,2
58445,130,14045,19256;19413,35770,0,0,2,0,2
58446,130,14046,19202;19259,35770,0,0,2,0,2
58447,130,14047,18926;19106;23581,35770,0,0,3,0,3
58448,130,14048,19511;23086;23179,35770,0,0,3,0,3
58449,130,14049,19281;19824;23507,35770,0,0,3,0,3
58450,130,14050,19609;23185;23395,35770,0,0,3,0,3
58451,130,14051,19135;19489;23480,35770,0,0,3,0,3
58452,130,14053,19319;19552;23183;25427,35770,1,0,3,0,4
58453,130,14055,19530;19828;22583;23795,35770,0,1,3,0,4
58454,130,14056,19304;19499,35770,0,0,2,0,2
58455,130,14057,19902;23513,35770,0,0,2,0,2
58456,130,14058,19373;19778;23504,35770,0,0,3,0,3
58457,130,14059,19110;19832;23409;23906,35770,0,1,3,0,4
58458,130,14061,19534;19565,35770,0,0,2,0,2
58459,130,14062,19034;19587;22690;23590,35770,0,0,4,0,4
58460,130,14063,19532;19615,35770,0,0,2,0,2
58461,130,14064,19632;19943,35770,0,0,2,0,2
58462,130,14065,19691;20077;23110,35770,0,0,3,0,3
58463,130,14066,19249;19702;22804;22998;23493;25414,35770,1,0,5,0,6
58464,130,14067,19330;19704,35770,0,0,2,0,2
58465,130,14068,19207;19710,35770,0,0,2,0,2
58466,130,14069,19274;19712,35770,0,0,2,0,2
58467,130,14070,18697;19726;23299;23497,35770,0,0,4,0,4
58468,130,14071,19348;19739;23499,35770,0,0,3,0,3
58469,130,14072,18949;19505,35770,0,0,2,0,2
58470,130,14073,19847;20143;23825,35770,0,1,2,0,3
58471,130,14074,19759;19970,35770,0,0,2,0,2
58472,130,14075,20099;20134;23425,35770,0,0,3,0,3
58473,130,14076,19780,35770,0,0,1,0,1
58474,130,14077,19364;19380,35770,0,0,2,0,2
58475,130,14081,15731,36135,0,0,0,1,1
58476,130,14084,15759,36135,0,0,0,1,1
58477,130,14089,16434,36135,0,0,0,1,1
58478,130,14112,18063;18473,36135,0,0,1,1,2
58479,130,14113,17867;17901,36135,0,0,0,2,2
58480,130,14114,18499,36135,0,0,1,0,1
58481,130,14121,18024;18420;22513;25506,36135,1,0,2,1,4
58482,130,14123,18803;18998,36135,0,0,2,0,2
58483,130,14127,19290;23076,36135,0,0,2,0,2
58484,130,14128,18665,36135,0,0,1,0,1
58485,130,14129,18709,36135,0,0,1,0,1
58486,130,14130,18777,36135,0,0,1,0,1
58487,130,14134,18573;18765,36135,0,0,2,0,2
58488,130,14135,18940,36135,0,0,1,0,1
58489,130,14136,18894;18947,36135,0,0,2,0,2
58490,130,14137,18977;22544,36135,0,0,2,0,2
58491,130,14138,18819;18974;22447,36135,0,0,3,0,3
58492,130,14141,19428;19539;22793,36135,0,0,3,0,3
58493,130,14142,19085;19606;23394,36135,0,0,3,0,3
58494,130,14143,19478,36135,0,0,1,0,1
58495,130,14145,19078;19239;23678,36135,0,1,2,0,3
58496,130,14147,19252;19934,36135,0,0,2,0,2
58497,130,14150,19585;19729;23198,36135,0,0,3,0,3
58498,130,14151,19488,36135,0,0,1,0,1
58499,130,14152,19180;19337;23896,36135,0,1,2,0,3
58500,130,14153,19485;22990;24006,36135,0,1,2,0,3
58501,130,14154,18930;19357;23081;23166,36135,0,0,4,0,4
58502,130,14156,19227;19403;23170;25535,36135,1,0,3,0,4
58503,130,14157,19134;19408;22981;23784,36135,0,1,3,0,4
58504,130,14159,19235;19423,36135,0,0,2,0,2
58505,130,14160,19768;20003,36135,0,0,2,0,2
58506,130,14161,19484;19771,36135,0,0,2,0,2
58507,130,14162,19250;20024;23519;23707;24317,36135,0,2,3,0,5
58508,130,14163,19349;19516;22469,36135,0,0,3,0,3
58509,130,14165,18882;19536,36135,0,0,2,0,2
58510,130,14166,19393;19756;22807;23904,36135,0,1,3,0,4
58511,130,14167,19816;19871;23511,36135,0,0,3,0,3
58512,130,14168,19333;19840;23203;23695;23796,36135,0,2,3,0,5
58513,130,14170,19685;23193;24424;25312,36135,1,1,2,0,4
58514,130,14171,19903,36135,0,0,1,0,1
58515,130,14172,19404;19646;22482;24009,36135,0,1,3,0,4
58516,130,14173,19659;19895;23412;23512,36135,0,0,4,0,4
58517,130,14176,19580;19695,36135,0,0,2,0,2
58518,130,14177,19927;20154,36135,0,0,2,0,2
58519,130,14178,19751;20210;23620,36135,0,0,3,0,3
58520,130,14180,19263;19605,36135,0,0,2,0,2
58521,130,14181,19747,36135,0,0,1,0,1
58522,130,14182,19852;19905,36135,0,0,2,0,2
58523,130,14183,19855;19856;23799,36135,0,1,2,0,3
58524,130,14184,19761;19874;23600;23698,36135,0,1,3,0,4
58525,130,14185,19649;19885;23411;23602,36135,0,0,4,0,4
58526,130,14186,19948;24764,36135,0,1,1,0,2
58527,130,14187,19599;22797,36135,0,0,2,0,2
58528,130,14188,19911;20047,36135,0,0,2,0,2
58529,130,14189,19914;20031;22706,36135,0,0,3,0,3
58530,130,14190,14918,36500,0,0,0,1,1
58531,130,14192,15345,36500,0,0,0,1,1
58532,130,14194,15479,36500,0,0,0,1,1
58533,130,14197,15711,36500,0,0,0,1,1
58534,130,14199,15574,36500,0,0,0,1,1
58535,130,14200,16094,36500,0,0,0,1,1
58536,130,14209,16530;16557,36500,0,0,0,2,2
58537,130,14214,16621;16660,36500,0,0,0,2,2
58538,130,14222,17927,36500,0,0,0,1,1
58539,130,14223,17159;17408,36500,0,0,0,2,2
58540,130,14228,18348;18866,36500,0,0,2,0,2
58541,130,14229,18463,36500,0,0,1,0,1
58542,130,14232,18738,36500,0,0,1,0,1
58543,130,14233,18423;18572,36500,0,0,2,0,2
58544,130,14234,18815;18879,36500,0,0,2,0,2
58545,130,14236,18704;19097,36500,0,0,2,0,2
58546,130,14238,19116;23274,36500,0,0,2,0,2
58547,130,14239,18865;19218;22774,36500,0,0,3,0,3
58548,130,14240,18887;19000,36500,0,0,2,0,2
58549,130,14244,18693;19020,36500,0,0,2,0,2
58550,130,14245,19022;19682;22697;22802;23191;23297;23489;25432;25519;25525,36500,3,0,7,0,10
58551,130,14247,19693;19717,36500,0,0,2,0,2
58552,130,14248,19234;19963;23608,36500,0,0,3,0,3
58553,130,14249,19143;19312;22666;24864,36500,0,1,3,0,4
58554,130,14250,19314;19322,36500,0,0,2,0,2
58555,130,14251,19323,36500,0,0,1,0,1
58556,130,14252,19395;24101,36500,0,1,1,0,2
58557,130,14253,19924;22906,36500,0,0,2,0,2
58558,130,14254,19341;19556;23383;23475;23584,36500,0,0,5,0,5
58559,130,14255,19345;19713;23404,36500,0,0,3,0,3
58560,130,14256,19385;19575,36500,0,0,2,0,2
58561,130,14257,19389;19854,36500,0,0,2,0,2
58562,130,14258,19583;24007,36500,0,1,1,0,2
58563,130,14259,18984;19399,36500,0,0,2,0,2
58564,130,14260,19571;19844;23308,36500,0,0,3,0,3
58565,130,14261,19440;19553,36500,0,0,2,0,2
58566,130,14262,19515;23588;23686,36500,0,1,2,0,3
58567,130,14263,19461;19644;23286,36500,0,0,3,0,3
58568,130,14264,19056;19469;23479,36500,0,0,3,0,3
58569,130,14265,19496;19604,36500,0,0,2,0,2
58570,130,14266,19497;19825;22262;23408;23508;23794,36500,0,1,5,0,6
58571,130,14267,19628;19664;22483;23295;23789,36500,0,1,4,0,5
58572,130,14269,19595;19597,36500,0,0,2,0,2
58573,130,14270,19305;19873;23599;24216,36500,0,1,3,0,4
58574,130,14271,19432;19650;22694;23294;24010,36500,0,1,4,0,5
58575,130,14273,20027,36500,0,0,1,0,1
58576,130,14274,19377;19653;24104,36500,0,1,2,0,3
58577,130,14275,19066;19666;22801;23399;23487,36500,0,0,5,0,5
58578,130,14276,19483;19714;23405;23791,36500,0,1,3,0,4
58579,130,14277,19309;19835,36500,0,0,2,0,2
58580,130,14278,19071;19694;22803;23402;23490,36500,0,0,5,0,5
58581,130,14279,19292;19979;23415,36500,0,0,3,0,3
58582,130,14280,19174;19762,36500,0,0,2,0,2
58583,130,14281,19479;19814;23004;23306;23407;23506;23905;24991,36500,0,2,6,0,8
58584,130,14282,19784;20118;23922,36500,0,1,2,0,3
58585,130,14284,20092,36500,0,0,1,0,1
58586,130,14286,19862;23697,36500,0,1,1,0,2
58587,130,14287,19868;20015,36500,0,0,2,0,2
58588,130,14288,19968;23010,36500,0,0,2,0,2
58589,130,14289,19935;20138;23228;23426;23822,36500,0,1,4,0,5
58590,130,14290,19923;20136;22491,36500,0,0,3,0,3
58591,130,14291,19624;19975;23806;23913,36500,0,2,2,0,4
58592,130,14292,19996;20033;22814;23215;24867,36500,0,1,4,0,5
58593,130,14293,20023;20172;23610,36500,0,0,3,0,3
58594,130,14294,15547,36865,0,0,0,1,1
58595,130,14297,15450,36865,0,0,0,1,1
58596,130,14300,15404,36865,0,0,0,1,1
58597,130,14303,16571,36865,0,0,0,1,1
58598,130,14308,16486,36865,0,0,0,1,1
58599,130,14309,17113,36865,0,0,0,1,1
58600,130,14314,17072;17224,36865,0,0,0,2,2
58601,130,14326,18536,36865,0,0,1,0,1
58602,130,14327,18666;19105,36865,0,0,2,0,2
58603,130,14328,18753;19122;23675,36865,0,1,2,0,3
58604,130,14329,18828;19265,36865,0,0,2,0,2
58605,130,14330,18596;22335;25174;25280,36865,2,0,2,0,4
58606,130,14331,19014;19191,36865,0,0,2,0,2
58607,130,14332,18983;19465,36865,0,0,2,0,2
58608,130,14333,19033;19062;22549,36865,0,0,3,0,3
58609,130,14334,18855;19419;23284,36865,0,0,3,0,3
58610,130,14335,19267;19394,36865,0,0,2,0,2
58611,130,14337,19642;19674;22481;23485,36865,0,0,4,0,4
58612,130,14338,19046;19140;22242;22360,36865,0,0,4,0,4
58613,130,14339,19149;19462;23158,36865,0,0,3,0,3
58614,130,14342,19802,36865,0,0,1,0,1
58615,130,14344,19328;19372,36865,0,0,2,0,2
58616,130,14346,19426;23586,36865,0,0,2,0,2
58617,130,14347,19453;19480;23174,36865,0,0,3,0,3
58618,130,14348,19463;19980;23316,36865,0,0,3,0,3
58619,130,14351,19506;20193;22821,36865,0,0,3,0,3
58620,130,14352,19445;19446,36865,0,0,2,0,2
58621,130,14354,19643;19920;22586;25513,36865,1,0,3,0,4
58622,130,14355,19498;19598;23591,36865,0,0,3,0,3
58623,130,14356,20152;24118;24224,36865,0,2,1,0,3
58624,130,14357,19351;19613;23090;23397;24212,36865,0,1,4,0,5
58625,130,14358,19525;19658;23092;23190;24213,36865,0,1,4,0,5
58626,130,14359,20048;20270;23233,36865,0,0,3,0,3
58627,130,14360,19701;20114;23820,36865,0,1,2,0,3
58628,130,14362,19827;23509,36865,0,0,2,0,2
58629,130,14364,19860;19957;23414;23607,36865,0,0,4,0,4
58630,130,14365,20201;20249;23930;24323,36865,0,2,2,0,4
58631,130,14366,19752;19887;23501;24872,36865,0,1,3,0,4
58632,130,14367,19904;20365;24439,36865,0,1,2,0,3
58633,130,14368,19676;19917;23802;25195,36865,1,1,2,0,4
58634,130,14369,19940;20011;23104;23910,36865,0,1,3,0,4
58635,130,14370,20054;20205;23813,36865,0,1,2,0,3
58636,130,14371,20058;20268,36865,0,0,2,0,2
58637,130,14372,20028;20153;23815;23917;24111,36865,0,3,2,0,5
58638,130,14373,19974;20074;23614,36865,0,0,3,0,3
58639,130,14374,20093;20486;23240,36865,0,0,3,0,3
58640,130,14375,20103,36865,0,0,1,0,1
58641,130,14376,20105;23224,36865,0,0,2,0,2
58642,130,14377,20121;20567;22924;23130;24869;25418;25529,36865,2,1,4,0,7
58643,130,14378,20126;20260;23832,36865,0,1,2,0,3
58644,130,14381,15809,37230,0,0,0,1,1
58645,130,14383,15888,37230,0,0,0,1,1
58646,130,14385,15853,37230,0,0,0,1,1
58647,130,14400,17424,37230,0,0,0,1,1
58648,130,14402,17624,37230,0,0,0,1,1
58649,130,14408,18052;18539,37230,0,0,1,1,2
58650,130,14413,18382;18512,37230,0,0,2,0,2
58651,130,14416,18610;18754,37230,0,0,2,0,2
58652,130,14417,18399;18422,37230,0,0,2,0,2
58653,130,14419,18668;19342;23279,37230,0,0,3,0,3
58654,130,14420,18170;18669;23367,37230,0,0,2,1,3
58655,130,14422,18471,37230,0,0,1,0,1
58656,130,14427,18590;18822;22640,37230,0,0,3,0,3
58657,130,14428,19003;19127,37230,0,0,2,0,2
58658,130,14429,19075;19390,37230,0,0,2,0,2
58659,130,14430,19148;19621;23398,37230,0,0,3,0,3
58660,130,14431,19375;19410,37230,0,0,2,0,2
58661,130,14432,19189;19502,37230,0,0,2,0,2
58662,130,14433,19052;19118;22873,37230,0,0,3,0,3
58663,130,14435,19602;19897;23908,37230,0,1,2,0,3
58664,130,14436,19248;19367,37230,0,0,2,0,2
58665,130,14437,19593;19805;23304,37230,0,0,3,0,3
58666,130,14438,19455,37230,0,0,1,0,1
58667,130,14439,19311;19477;23084,37230,0,0,3,0,3
58668,130,14440,18895;19531;22792;23589,37230,0,0,4,0,4
58669,130,14442,19493;19623;23391,37230,0,0,3,0,3
58670,130,14445,19449;20102;22493;23526;24117;24533,37230,0,2,4,0,6
58671,130,14447,19415;19622;23186;23484;24008,37230,0,1,4,0,5
58672,130,14448,19689;19750,37230,0,0,2,0,2
58673,130,14449,19487;20222;24024,37230,0,1,2,0,3
58674,130,14450,19236;19696;23692,37230,0,1,2,0,3
58675,130,14451,19742;20509;23547;23947;24136,37230,0,2,3,0,5
58676,130,14452,19783;20380;24029,37230,0,1,2,0,3
58677,130,14453,20055;20208;23533,37230,0,0,3,0,3
58678,130,14454,19830;23101,37230,0,0,2,0,2
58679,130,14455,19343;19831;23307;23596,37230,0,0,4,0,4
58680,130,14456,19721;19879,37230,0,0,2,0,2
58681,130,14457,19823;19858;23205,37230,0,0,3,0,3
58682,130,14458,19715;19861;23001;23495;23693,37230,0,1,4,0,5
58683,130,14459,19735;20010;24532,37230,0,1,2,0,3
58684,130,14460,20036;20664;23419;24220;25537,37230,1,1,3,0,5
58685,130,14461,19688;20500;23437,37230,0,0,3,0,3
58686,130,14462,19826;19912;22905;23207;23801,37230,0,1,4,0,5
58687,130,14464,20081;20098;22816;23222;24318,37230,0,1,4,0,5
58688,130,14465,19808;20174;23712;23828;24434,37230,0,3,2,0,5
58689,130,14466,19300;19952;23107,37230,0,0,3,0,3
58690,130,14467,19645;20304;24438,37230,0,1,2,0,3
58691,130,14468,19663;19989;23704,37230,0,1,2,0,3
58692,130,14470,20472;20473;23634,37230,0,0,3,0,3
58693,130,14471,20067;23613,37230,0,0,2,0,2
58694,130,14472,19476;20075;22815;23221;23521;24113;25313,37230,1,1,5,0,7
58695,130,14473,19559;20079;22714;23522;23816,37230,0,1,4,0,5
58696,130,14474,20101,37230,0,0,1,0,1
58697,130,14475,19779;20140,37230,0,0,2,0,2
58698,130,14476,20330;20369;24440,37230,0,1,2,0,3
58699,130,14477,20574;23549;23957,37230,0,1,2,0,3
58700,130,14478,20155;20357;23230;24321;24534,37230,0,2,3,0,5
58701,130,14479,20163;23531,37230,0,0,2,0,2
58702,130,14480,20414;20506;24035;24539,37230,0,2,2,0,4
58703,130,14481,20177;20257;23431;24025,37230,0,1,3,0,4
58704,130,14482,20145;20179;23532,37230,0,0,3,0,3
58705,130,14483,20199;20440,37230,0,0,2,0,2
58706,130,14484,20523;20612;23340;23548,37230,0,0,4,0,4
58707,130,14495,16073,37595,0,0,0,1,1
58708,130,14497,16225,37595,0,0,0,1,1
58709,130,14498,16667,37595,0,0,0,1,1
58710,130,14503,17225;17637,37595,0,0,0,2,2
58711,130,14507,17361;17386,37595,0,0,0,2,2
58712,130,14508,17511;17877,37595,0,0,0,2,2
58713,130,14514,17893;18365,37595,0,0,1,1,2
58714,130,14521,18338;18387,37595,0,0,2,0,2
58715,130,14522,18826;18912,37595,0,0,2,0,2
58716,130,14525,18807;18945,37595,0,0,2,0,2
58717,130,14526,18799;19243,37595,0,0,2,0,2
58718,130,14527,18804;19058,37595,0,0,2,0,2
58719,130,14528,18652;19184;23073;23379,37595,0,0,4,0,4
58720,130,14530,19175;19401;24102,37595,0,1,2,0,3
58721,130,14531,20020;23417;23915,37595,0,1,2,0,3
58722,130,14532,18850;19459;24103,37595,0,1,2,0,3
58723,130,14534,19737;23498,37595,0,0,2,0,2
58724,130,14535,19574;19886,37595,0,0,2,0,2
58725,130,14536,19745,37595,0,0,1,0,1
58726,130,14537,19457;19683;23192,37595,0,0,3,0,3
58727,130,14538,19867;24016,37595,0,1,1,0,2
58728,130,14539,19793;23505,37595,0,0,2,0,2
58729,130,14540,19589;19893,37595,0,0,2,0,2
58730,130,14542,19456;23494;23903,37595,0,1,2,0,3
58731,130,14543,19743;19782;23097;23500;24014,37595,0,1,4,0,5
58732,130,14544,19546;19981;23703;24427,37595,0,2,2,0,4
58733,130,14545,19736;23300;24215,37595,0,1,2,0,3
58734,130,14548,20056;23814,37595,0,1,1,0,2
58735,130,14549,19813;20068;23422;23918,37595,0,1,3,0,4
58736,130,14550,19610;19892,37595,0,0,2,0,2
58737,130,14551,19937;20086;23604;23909,37595,0,1,3,0,4
58738,130,14552,20191;20364;23619;24022,37595,0,1,3,0,4
58739,130,14553,19801;19946,37595,0,0,2,0,2
58740,130,14554,19950;19977;23804;23911;24108,37595,0,3,2,0,5
58741,130,14555,19953;23805,37595,0,1,1,0,2
58742,130,14556,20348;20429;24331,37595,0,1,2,0,3
58743,130,14557,19338;23013;23808;24219,37595,0,2,2,0,4
58744,130,14558,20495;20558;23128;24333;24542,37595,0,2,3,0,5
58745,130,14559,20008;20116;23711;23821;24223,37595,0,3,2,0,5
58746,130,14560,19899;20127;23529,37595,0,0,3,0,3
58747,130,14561,19749;19843;22903;23510;23797,37595,0,1,4,0,5
58748,130,14562,20389;20480;24232;24446,37595,0,2,2,0,4
58749,130,14565,19995;20186;23618;24119,37595,0,1,3,0,4
58750,130,14566,20352;20501;23546;23730;24334,37595,0,2,3,0,5
58751,130,14567,20052;20307,37595,0,0,2,0,2
58752,130,14568,20202;20236;24023,37595,0,1,2,0,3
58753,130,14569,20156;20535;23428;23615,37595,0,0,4,0,4
58754,130,14570,20404;20565;23722,37595,0,1,2,0,3
58755,130,14571,19962;20242,37595,0,0,2,0,2
58756,130,14572,19821;20244;22596;22716;23535;24435,37595,0,1,5,0,6
58757,130,14573,20220;20264;22594;23926,37595,0,1,3,0,4
58758,130,14574,20269;20361;23626;24768,37595,0,1,3,0,4
58759,130,14575,20196,37595,0,0,1,0,1
58760,130,14576,20117;20296;23715;24125;24226;24536,37595,0,4,2,0,6
58761,130,14577,20315;20652;23644;24050,37595,0,1,3,0,4
58762,130,14578,20321;20728;23742;24552;24658,37595,0,3,2,0,5
58763,130,14579,20328;20711;24342;24879,37595,0,2,2,0,4
58764,130,14580,19872;20334;23537;23624,37595,0,0,4,0,4
58765,130,14581,20194;20376;23925;24120;24994,37595,1,2,2,0,5
58766,130,14582,20340;20542;23343;23637;24041;24875,37595,0,2,4,0,6
58767,130,14583,20292;20394,37595,0,0,2,0,2
58768,130,14584,20391;20715;23652,37595,0,0,3,0,3
58769,130,14590,16565,37960,0,0,0,1,1
58770,130,14594,16543,37960,0,0,0,1,1
58771,130,14597,16649;16808,37960,0,0,0,2,2
58772,130,14599,16655,37960,0,0,0,1,1
58773,130,14600,16976;17035,37960,0,0,0,2,2
58774,130,14616,18090,37960,0,0,0,1,1
58775,130,14619,18217;18378,37960,0,0,1,1,2
58776,130,14622,18484,37960,0,0,1,0,1
58777,130,14627,19023;22653;23154,37960,0,0,3,0,3
58778,130,14630,18584;19416;22983;23478,37960,0,0,4,0,4
58779,130,14631,18716;19029;22959;23060,37960,0,0,4,0,4
58780,130,14633,18726;18792,37960,0,0,2,0,2
58781,130,14634,19677;19707;23401;23488,37960,0,0,4,0,4
58782,130,14636,19563;19880,37960,0,0,2,0,2
58783,130,14637,19437;19966,37960,0,0,2,0,2
58784,130,14638,19443;19678,37960,0,0,2,0,2
58785,130,14639,19460;19670;23285,37960,0,0,3,0,3
58786,130,14640,18994;19475;22989;23176;23389,37960,0,0,5,0,5
58787,130,14643,19371;23281;23476,37960,0,0,3,0,3
58788,130,14644,19596;19918;23515,37960,0,0,3,0,3
58789,130,14645,19430;19647;23188;23900,37960,0,1,3,0,4
58790,130,14646,19614;19949;23606;24645,37960,0,1,3,0,4
58791,130,14647,19630;22577,37960,0,0,2,0,2
58792,130,14648,19800;20146;24433,37960,0,1,2,0,3
58793,130,14649,19439;19636,37960,0,0,2,0,2
58794,130,14650,19136;19648,37960,0,0,2,0,2
58795,130,14651,19657;20013;23609;23914,37960,0,1,3,0,4
58796,130,14652,19542;19807,37960,0,0,2,0,2
58797,130,14653,19509;19773;22582;22700;23199,37960,0,0,5,0,5
58798,130,14655,19725;19794;23593,37960,0,0,3,0,3
58799,130,14656,19744;19944;23605;24107,37960,0,1,3,0,4
58800,130,14657,19777;20111,37960,0,0,2,0,2
58801,130,14658,19791;19849;24425,37960,0,1,2,0,3
58802,130,14659,19795;20531;23732,37960,0,1,2,0,3
58803,130,14660,19421;19797;22809,37960,0,0,3,0,3
58804,130,14661,20032,37960,0,0,1,0,1
58805,130,14662,19639;19810;23091;23187;25534,37960,1,0,4,0,5
58806,130,14663,19817;19922;23701,37960,0,1,2,0,3
58807,130,14664,20223;22595;23430;23621,37960,0,0,4,0,4
58808,130,14665,19692;19928;23516;23603;23803;24106,37960,0,2,4,0,6
58809,130,14666,20488;20603;23133;24653,37960,0,1,3,0,4
58810,130,14667,19945;19998;23012;24871,37960,0,1,3,0,4
58811,130,14668,19955;20528;23031;23341,37960,0,0,4,0,4
58812,130,14669,19723;20187,37960,0,0,2,0,2
58813,130,14670,19451;20017,37960,0,0,2,0,2
58814,130,14671,20463;23945;24648,37960,0,2,1,0,3
58815,130,14672,20078;20489,37960,0,0,2,0,2
58816,130,14673,19896;20096;22271;23524,37960,0,0,4,0,4
58817,130,14674,19501;20109;23819,37960,0,1,2,0,3
58818,130,14675,20582;21058;23243,37960,0,0,3,0,3
58819,130,14677,20761;23655;24061,37960,0,1,2,0,3
58820,130,14678,20310;20341;22597;23932;24981,37960,0,2,3,0,5
58821,130,14679,20356;20374;23629;24537,37960,0,1,3,0,4
58822,130,14680,20159;23530,37960,0,0,2,0,2
58823,130,14681,20336;20421;24443,37960,0,1,2,0,3
58824,130,14682,20212;24121;24225,37960,0,2,1,0,3
58825,130,14683,20245;20533;23733,37960,0,1,2,0,3
58826,130,14684,20415;24036,37960,0,1,1,0,2
58827,130,14685,19971;20316;23536;24026,37960,0,1,3,0,4
58828,130,14686,19976;20263,37960,0,0,2,0,2
58829,130,14687,20293;20401;24324;24436,37960,0,2,2,0,4
58830,130,14688,20317;20319;23117;23433,37960,0,0,4,0,4
58831,130,14689,20211;20342;23933;24325,37960,0,2,2,0,4
58832,130,14690,20355;20595;22926;23958,37960,0,1,3,0,4
58833,130,14691,20568;20775;23747;24558,37960,0,2,2,0,4
58834,130,14692,20384;20424;23842;23941,37960,0,2,2,0,4
58835,130,14693,20410,37960,0,0,1,0,1
58836,130,14694,20007;20413;24770,37960,0,1,2,0,3
58837,130,14695,20226;20427;24123;24322,37960,0,2,2,0,4
58838,130,14696,20107;20544;23734;23952,37960,0,2,2,0,4
58839,130,14697,20229;20447;23944,37960,0,1,2,0,3
58840,130,14698,20448;24541,37960,0,1,1,0,2
58841,130,14699,20870;21112;23566;23659;24163,37960,0,1,4,0,5
58842,130,14700,20550;23344;23953;24044,37960,0,2,2,0,4
58843,130,14701,20745;24059;24555,37960,0,2,1,0,3
58844,130,14702,20646,37960,0,0,1,0,1
58845,130,14703,20497;23338;23545;23844;23946,37960,0,2,3,0,5
58846,130,14713,17022,38325,0,0,0,1,1
58847,130,14714,16999,38325,0,0,0,1,1
58848,130,14715,16838,38325,0,0,0,1,1
58849,130,14719,16572,38325,0,0,0,1,1
58850,130,14722,17373,38325,0,0,0,1,1
58851,130,14725,17542;18003,38325,0,0,0,2,2
58852,130,14727,17744,38325,0,0,0,1,1
58853,130,14731,17943;18733,38325,0,0,1,1,2
58854,130,14735,18206;18419,38325,0,0,1,1,2
58855,130,14742,18955,38325,0,0,1,0,1
58856,130,14743,18967;19222,38325,0,0,2,0,2
58857,130,14744,19059;19153,38325,0,0,2,0,2
58858,130,14745,18888;19133,38325,0,0,2,0,2
58859,130,14746,19190;19347;22668,38325,0,0,3,0,3
58860,130,14747,19344;19567;22794;23393;23483,38325,0,0,5,0,5
58861,130,14748,19321;19660,38325,0,0,2,0,2
58862,130,14749,19301;23895,38325,0,1,1,0,2
58863,130,14750,19572;19991,38325,0,0,2,0,2
58864,130,14751,19809;23003,38325,0,0,2,0,2
58865,130,14753,19538;19786;23099,38325,0,0,3,0,3
58866,130,14754,19514;19848;23696,38325,0,1,2,0,3
58867,130,14755,19579;19772;22699;23502;25520,38325,1,0,4,0,5
58868,130,14756,19482;19722;23197;23496,38325,0,0,4,0,4
58869,130,14757,19339;19637,38325,0,0,2,0,2
58870,130,14759,19591;19796;22703;23201,38325,0,0,4,0,4
58871,130,14760,19681;20021;23213;23318;23418;24018,38325,0,1,5,0,6
58872,130,14761,20297;20430;24126,38325,0,1,2,0,3
58873,130,14762,19329;19733,38325,0,0,2,0,2
58874,130,14763,19766;19958;23912,38325,0,1,2,0,3
58875,130,14764,19812;19959;24017;24426,38325,0,2,2,0,4
58876,130,14765,19798;19978;24109,38325,0,1,2,0,3
58877,130,14766,19857;19875;23800,38325,0,1,2,0,3
58878,130,14767,20181;20842;23658;24884,38325,0,1,3,0,4
58879,130,14768,20375;23332;23630;23838;24229;24995,38325,1,2,3,0,6
58880,130,14769,19842;20128,38325,0,0,2,0,2
58881,130,14770,20235;20250;23116;23831;23929,38325,0,2,3,0,5
58882,130,14771,19982;20600;23131;23643;24048,38325,0,1,4,0,5
58883,130,14772,19898;20064;24431,38325,0,1,2,0,3
58884,130,14773,20042;20071;23810,38325,0,1,2,0,3
58885,130,14774,19541;19600,38325,0,0,2,0,2
58886,130,14775,20106;20351;23716;24129,38325,0,2,2,0,4
58887,130,14776,20110;20823;24460;25002;25322;25436,38325,3,1,2,0,6
58888,130,14777,19665;20112;23710,38325,0,1,2,0,3
58889,130,14778,20160;20517;24137,38325,0,1,2,0,3
58890,130,14779,20168;20884;24887,38325,0,1,2,0,3
58891,130,14780,20184;20541;23848;24996,38325,1,1,2,0,4
58892,130,14781,20206;20353;23717;23934,38325,0,2,2,0,4
58893,130,14782,20237;20554;23735;24045,38325,0,2,2,0,4
58894,130,14784,20278;20456;23336;24039,38325,0,1,3,0,4
58895,130,14785,20306;20671;23962;24775,38325,0,2,2,0,4
58896,130,14787,20314;20537,38325,0,0,2,0,2
58897,130,14788,20323;20570;24773,38325,0,1,2,0,3
58898,130,14790,20332;23623,38325,0,0,2,0,2
58899,130,14791,19994;20398;23024;23539;24032;24643;25530,38325,1,2,4,0,7
58900,130,14792,20040;20164,38325,0,0,2,0,2
58901,130,14793,20529;20906;24069;24359;25099,38325,1,2,2,0,5
58902,130,14794,19972;20388;23538;23721;24030;24130,38325,0,3,3,0,6
58903,130,14795,20403;24328,38325,0,1,1,0,2
58904,130,14796,20291;20409,38325,0,0,2,0,2
58905,130,14797,20253;20452;24874,38325,0,1,2,0,3
58906,130,14798,20459;20460;22824;24135,38325,0,1,3,0,4
58907,130,14799,20225;20505;23438;23731;24042,38325,0,2,3,0,5
58908,130,14800,20515;20924;23257;24361,38325,0,1,3,0,4
58909,130,14801,19983;20571;23345;23440;24139,38325,0,1,4,0,5
58910,130,14802,20780;20806;24063;24154,38325,0,2,2,0,4
58911,130,14803,20596;20653;23642,38325,0,0,3,0,3
58912,130,14806,17032,38690,0,0,0,1,1
58913,130,14808,16744,38690,0,0,0,1,1
58914,130,14810,17009,38690,0,0,0,1,1
58915,130,14815,17271,38690,0,0,0,1,1
58916,130,14822,17835;18041,38690,0,0,0,2,2
58917,130,14824,18689,38690,0,0,1,0,1
58918,130,14830,18609;18687,38690,0,0,2,0,2
58919,130,14831,19603,38690,0,0,1,0,1
58920,130,14832,19584;23787,38690,0,1,1,0,2
58921,130,14839,19346;19454;23165,38690,0,0,3,0,3
58922,130,14840,19402;19774,38690,0,0,2,0,2
58923,130,14842,19414;19907;23312;23514,38690,0,0,4,0,4
58924,130,14843,19284;19792;23200;25194,38690,1,0,3,0,4
58925,130,14846,20097;23525;23818,38690,0,1,2,0,3
58926,130,14847,19732;20069;23919;24112,38690,0,2,2,0,4
58927,130,14850,20247;20312;24124,38690,0,1,2,0,3
58928,130,14851,19776;19866;22702;23503,38690,0,0,4,0,4
58929,130,14852,20053;20396;23839;23937;24326;24538,38690,0,4,2,0,6
58930,130,14854,20481;20545,38690,0,0,2,0,2
58931,130,14855,19984;20198;23231,38690,0,0,3,0,3
58932,130,14856,19960;20185;23617;24766,38690,0,1,3,0,4
58933,130,14858,20009;20227,38690,0,0,2,0,2
58934,130,14859,19740;20044;23219;23811,38690,0,1,3,0,4
58935,130,14860,19906;20085;22590,38690,0,0,3,0,3
58936,130,14861,20051;20129;24110;24221,38690,0,2,2,0,4
58937,130,14862,20635;24546,38690,0,1,1,0,2
58938,130,14863,20158;20207;23826,38690,0,1,2,0,3
58939,130,14864,19967;20231;22999;23830,38690,0,1,3,0,4
58940,130,14865,20232;20948;24567,38690,0,1,2,0,3
58941,130,14866,20286;20367;24028,38690,0,1,2,0,3
58942,130,14867,20287;20339,38690,0,0,2,0,2
58943,130,14868,20346;20400;23938;24033,38690,0,2,2,0,4
58944,130,14869,20303;21015;24170;24479;25010,38690,1,2,2,0,5
58945,130,14871,20832;24160,38690,0,1,1,0,2
58946,130,14872,20412;23633;23723;24230,38690,0,2,2,0,4
58947,130,14873,20736;24057;24150;24344;24456,38690,0,4,1,0,5
58948,130,14874,20423;20457;23940;24131;24771,38690,0,3,2,0,5
58949,130,14875,20354;20382;23120;23331;23718;23836;25433,38690,1,2,4,0,7
58950,130,14876,19629;20161;23616;23827,38690,0,1,3,0,4
58951,130,14877,20732,38690,0,0,1,0,1
58952,130,14878,20490;23843;24040,38690,0,2,1,0,3
58953,130,14879,20499;20704,38690,0,0,2,0,2
58954,130,14880,20504;20739;23250;23560;24248;24778,38690,0,2,4,0,6
58955,130,14881,20527;21003;25439,38690,1,0,2,0,3
58956,130,14882,20261;20682;24454;24657,38690,0,2,2,0,4
58957,130,14883,20521;20579;23032;23641,38690,0,0,4,0,4
58958,130,14884,21008;23353;23982;24570,38690,0,2,2,0,4
58959,130,14885,20555;20589;23550;24047;24997,38690,1,1,3,0,5
58960,130,14886,20080;20634,38690,0,0,2,0,2
58961,130,14887,20642;20929;23450;24364,38690,0,1,3,0,4
58962,130,14888,20667;21025;24793;25325,38690,1,1,2,0,4
58963,130,14889,20688;23649;23964;24052;24245,38690,0,3,2,0,5
58964,130,14890,20717;20742,38690,0,0,2,0,2
58965,130,14891,20397;20724;23443;23653;24147,38690,0,1,4,0,5
58966,130,14892,20633;20740;23561;24345,38690,0,1,3,0,4
58967,130,14893,16276,39055,0,0,0,1,1
58968,130,14897,16544;16554,39055,0,0,0,2,2
58969,130,14898,16366,39055,0,0,0,1,1
58970,130,14900,16592,39055,0,0,0,1,1
58971,130,14901,17004,39055,0,0,0,1,1
58972,130,14918,18448;19458,39055,0,0,2,0,2
58973,130,14927,19170,39055,0,0,1,0,1
58974,130,14928,18485,39055,0,0,1,0,1
58975,130,14929,18761;19324,39055,0,0,2,0,2
58976,130,14931,19504;19932;23702;24218,39055,0,2,2,0,4
58977,130,14932,19526;19894,39055,0,0,2,0,2
58978,130,14933,19545;20233,39055,0,0,2,0,2
58979,130,14935,20450;20485,39055,0,0,2,0,2
58980,130,14936,19618;19686;24214,39055,0,1,2,0,3
58981,130,14937,19669;19986,39055,0,0,2,0,2
58982,130,14938,19938;20259,39055,0,0,2,0,2
58983,130,14939,19687;19811;22997;23691,39055,0,1,3,0,4
58984,130,14940,19468;19961,39055,0,0,2,0,2
58985,130,14941,19728;20209;23534,39055,0,0,3,0,3
58986,130,14942,19731;19997;23807,39055,0,1,2,0,3
58987,130,14945,19877;20022;24019,39055,0,1,2,0,3
58988,130,14946,19340;19916;23313;23413,39055,0,0,4,0,4
58989,130,14947,19926;20219;23114;23326,39055,0,0,4,0,4
58990,130,14948,20790;24155;24881,39055,0,2,1,0,3
58991,130,14949,20038;24020,39055,0,1,1,0,2
58992,130,14950,20035;20039;23217;23708,39055,0,1,3,0,4
58993,130,14951,20062,39055,0,0,1,0,1
58994,130,14952,20061;20142;23824,39055,0,1,2,0,3
58995,130,14953,19933;20368;23628,39055,0,0,3,0,3
58996,130,14954,20520;23950,39055,0,1,1,0,2
58997,130,14955,20216;20606;24998,39055,1,0,2,0,3
58998,130,14956,19544;20224;23927,39055,0,1,2,0,3
58999,130,14957,20437;20689;24146;25094,39055,1,1,2,0,4
59000,130,14958,20026;20513;23948,39055,0,1,2,0,3
59001,130,14959,20326;20841;23657,39055,0,0,3,0,3
59002,130,14960,20345;20911;23978;24072;24785,39055,0,3,2,0,5
59003,130,14961,20327;20893;24356,39055,0,1,2,0,3
59004,130,14962,20167;20338;24127,39055,0,1,2,0,3
59005,130,14963,20322;20360;23118,39055,0,0,3,0,3
59006,130,14964,20175;20814;24064;24250;24561,39055,0,3,2,0,5
59007,130,14965,20169;20416;23435;24037;24329,39055,0,2,3,0,5
59008,130,14966,20189;20453;22602;23126,39055,0,0,4,0,4
59009,130,14967,20462;23542,39055,0,0,2,0,2
59010,130,14968,20464;20927;24262;24363,39055,0,2,2,0,4
59011,130,14969,20182;20288;23714,39055,0,1,2,0,3
59012,130,14970,20494;20710;23858;23967,39055,0,2,2,0,4
59013,130,14971,20029;20538;23342;23847;24043;24652,39055,0,3,3,0,6
59014,130,14972,20284;20540;23951;24772,39055,0,2,2,0,4
59015,130,14973,20829;24065;24159;24782,39055,0,3,1,0,4
59016,130,14974,20557;20836;23037;24066;24461,39055,0,2,3,0,5
59017,130,14975,20566;20909;24888,39055,0,1,2,0,3
59018,130,14976,20524;20575;23640,39055,0,0,3,0,3
59019,130,14978,20090;20615;23551;23738;23851;24239;24545;24654,39055,0,5,3,0,8
59020,130,14979,20562;20627;23439;23955;24046;24236,39055,0,3,3,0,6
59021,130,14980,20985;21155;24799,39055,0,1,2,0,3
59022,130,14981,20668;20821;23740,39055,0,1,2,0,3
59023,130,14982,20687;20937;24365;24470;24786,39055,0,3,2,0,5
59024,130,14983,20694;20765;24152;24556;24779,39055,0,3,2,0,5
59025,130,14984,20720;20846;23254;24254;24462,39055,0,2,3,0,5
59026,130,14985,20645;20725;25000,39055,1,0,2,0,3
59027,130,14986,20746;20892,39055,0,0,2,0,2
59028,130,14987,20616;20778;24780,39055,0,1,2,0,3
59029,130,14988,20783;20980;23981,39055,0,1,2,0,3
59030,130,14989,20792;23749;24882,39055,0,2,1,0,3
59031,130,14990,20519;20810;23845,39055,0,1,2,0,3
59032,130,14991,20827;21122;23989;24675;25108,39055,1,2,2,0,5
59033,130,14993,16355,39420,0,0,0,1,1
59034,130,14995,16384,39420,0,0,0,1,1
59035,130,14996,16262,39420,0,0,0,1,1
59036,130,15001,16067,39420,0,0,0,1,1
59037,130,15002,16285,39420,0,0,0,1,1
59038,130,15004,16291,39420,0,0,0,1,1
59039,130,15006,16978,39420,0,0,0,1,1
59040,130,15012,17773,39420,0,0,0,1,1
59041,130,15018,18389,39420,0,0,1,0,1
59042,130,15020,18663,39420,0,0,1,0,1
59043,130,15032,19470;19528,39420,0,0,2,0,2
59044,130,15035,20130;22387,39420,0,0,2,0,2
59045,130,15037,19616;19901;23008,39420,0,0,3,0,3
59046,130,15038,20387;23936;24441,39420,0,2,1,0,3
59047,130,15039,19988;20299,39420,0,0,2,0,2
59048,130,15040,20046;20465;24332,39420,0,1,2,0,3
59049,130,15041,20073,39420,0,0,1,0,1
59050,130,15042,20144;20643;23348,39420,0,0,3,0,3
59051,130,15044,20238;20602;23441;23959;24449;25538,39420,1,2,3,0,6
59052,130,15045,20347;23119;23835;24027;24128;24227,39420,0,4,2,0,6
59053,130,15046,20271;20620;23739;24049;24240;24337;24876;25318,39420,1,5,2,0,8
59054,130,15047,20395;20874;24563,39420,0,1,2,0,3
59055,130,15048,20151;20301;22593;23113,39420,0,0,4,0,4
59056,130,15050,20828;21041;23759;24078;24794,39420,0,3,2,0,5
59057,130,15051,20496;20859;24353;24661;25003,39420,1,2,2,0,5
59058,130,15053,20779;23971;24153;24559,39420,0,3,1,0,4
59059,130,15054,20133;20467;23543;24445,39420,0,1,3,0,4
59060,130,15055,20309;20471,39420,0,0,2,0,2
59061,130,15056,19850;20474;23436,39420,0,0,3,0,3
59062,130,15057,20435;23027,39420,0,0,2,0,2
59063,130,15058,20234;23115;23928,39420,0,1,2,0,3
59064,130,15059,20215;20683;23556;24341,39420,0,1,3,0,4
59065,130,15060,20173;20584;23849,39420,0,1,2,0,3
59066,130,15061,20592;21166;24678,39420,0,1,2,0,3
59067,130,15062,20131;20604;23737,39420,0,1,2,0,3
59068,130,15063,20805;21028;23662,39420,0,0,3,0,3
59069,130,15065,20610;20663;24548,39420,0,1,2,0,3
59070,130,15066,20673;21036;23454;23663;23758;24482,39420,0,2,4,0,6
59071,130,15067,20313;20684;23648;24776,39420,0,1,3,0,4
59072,130,15068,20772;21102;23988;24175,39420,0,2,2,0,4
59073,130,15069,20697;20709;24247,39420,0,1,2,0,3
59074,130,15070,20611;21184;24277;24380,39420,0,2,2,0,4
59075,130,15071,20622;20794,39420,0,0,2,0,2
59076,130,15072,21037;23986;24171;24483,39420,0,3,1,0,4
59077,130,15073,20759;20934;23870,39420,0,1,2,0,3
59078,130,15074,20608;21175,39420,0,0,2,0,2
59079,130,15075,20757;21241,39420,0,0,2,0,2
59080,130,15076,20797;21048,39420,0,0,2,0,2
59081,130,15077,21017;23984;24670;25103,39420,1,2,1,0,4
59082,130,15078,20863;20891;23867;24464;25437,39420,1,2,2,0,5
59083,130,15079,20885;21170;24164;24255;24355,39420,0,3,2,0,5
59084,130,15080,21030;24894;25326,39420,1,1,1,0,3
59085,130,15081,20782;20912;24261;24469;25101,39420,1,2,2,0,5
59086,130,15082,20915;21059,39420,0,0,2,0,2
59087,130,15083,21158;21297;24285;25022,39420,1,1,2,0,4
59088,130,15084,20586;20922;23351;24889,39420,0,1,3,0,4
59089,130,15085,20865;20945;24662,39420,0,1,2,0,3
59090,130,15088,16881,39785,0,0,0,1,1
59091,130,15089,16927,39785,0,0,0,1,1
59092,130,15091,16821,39785,0,0,0,1,1
59093,130,15094,17307,39785,0,0,0,1,1
59094,130,15097,17517;17819,39785,0,0,0,2,2
59095,130,15098,17407,39785,0,0,0,1,1
59096,130,15101,17529,39785,0,0,0,1,1
59097,130,15104,17724;17803,39785,0,0,0,2,2
59098,130,15107,17945,39785,0,0,0,1,1
59099,130,15112,18768,39785,0,0,1,0,1
59100,130,15118,19257;19576;23291;23303;24211,39785,0,1,4,0,5
59101,130,15120,19137;19549,39785,0,0,2,0,2
59102,130,15124,19573;19719,39785,0,0,2,0,2
59103,130,15127,19969;20170;24535,39785,0,1,2,0,3
59104,130,15128,19703;20120;23923,39785,0,1,2,0,3
59105,130,15131,20135;24432,39785,0,1,1,0,2
59106,130,15133,19919;20083;23817;24319,39785,0,2,2,0,4
59107,130,15134,19910;20294;24437,39785,0,1,2,0,3
59108,130,15135,20274;23432,39785,0,0,2,0,2
59109,130,15136,19951;20282;23713,39785,0,1,2,0,3
59110,130,15137,20037;20228;23216;23809;23916;25091,39785,1,2,3,0,6
59111,130,15138,20072;20239;23423;23920,39785,0,1,3,0,4
59112,130,15141,20262;20559;24138,39785,0,1,2,0,3
59113,130,15142,20265;20617;23552;24141,39785,0,1,3,0,4
59114,130,15143,20267;20941,39785,0,0,2,0,2
59115,130,15144,20272;20953;23871;24568,39785,0,2,2,0,4
59116,130,15145,20276;20764;23036,39785,0,0,3,0,3
59117,130,15146,20251;20434;24132;24231,39785,0,2,2,0,4
59118,130,15147,20150;20285;23329;23833,39785,0,1,3,0,4
59119,130,15148,20344;20370;23625,39785,0,0,3,0,3
59120,130,15149,20378;20556;23242;23954,39785,0,1,3,0,4
59121,130,15150,20498;23635;25196,39785,1,0,2,0,3
59122,130,15151,20549,39785,0,0,1,0,1
59123,130,15152,20532;20560;23638;24235,39785,0,1,3,0,4
59124,130,15153,20733;20903;23753;23977;24068;24259;24358;24664;24784,39785,0,7,2,0,9
59125,130,15154,21298,39785,0,0,1,0,1
59126,130,15155,21038;23568;24375,39785,0,1,2,0,3
59127,130,15156,21415;24287;24503;25031,39785,1,2,1,0,4
59128,130,15157,20693;20734;23248;24056;24343,39785,0,2,3,0,5
59129,130,15158,20702;20946;23651;23856;24999;25095,39785,2,1,3,0,6
59130,130,15159,20718;23246,39785,0,0,2,0,2
59131,130,15160,20478;20788,39785,0,0,2,0,2
59132,130,15161,20784;20826;23748;24349,39785,0,2,2,0,4
59133,130,15162,20850;20913;23751;24067,39785,0,2,2,0,4
59134,130,15163,20860;21022;24077,39785,0,1,2,0,3
59135,130,15164,20881;21253,39785,0,0,2,0,2
59136,130,15165,20887;21227;24384,39785,0,1,2,0,3
59137,130,15166,20889;20989,39785,0,0,2,0,2
59138,130,15167,20890;21394;24086;24810;24918;25218,39785,1,3,2,0,6
59139,130,15168,20639;20908;24468;24665,39785,0,2,2,0,4
59140,130,15169,21150;24274,39785,0,1,1,0,2
59141,130,15170,20940;21414,39785,0,0,2,0,2
59142,130,15171,20624;20942;24471,39785,0,1,2,0,3
59143,130,15172,20964;21380;23872,39785,0,1,2,0,3
59144,130,15173,20690;20965;24569,39785,0,1,2,0,3
59145,130,15174,21259;23880;24496;25116;25210,39785,2,2,1,0,5
59146,130,15175,20431;21053;24270;24485;24797,39785,0,3,2,0,5
59147,130,15176,21074;21313;23994;25024,39785,1,1,2,0,4
59148,130,15177,16478,40150,0,0,0,1,1
59149,130,15179,16234,40150,0,0,0,1,1
59150,130,15181,16694,40150,0,0,0,1,1
59151,130,15183,16950,40150,0,0,0,1,1
59152,130,15186,17458,40150,0,0,0,1,1
59153,130,15195,18691,40150,0,0,1,0,1
59154,130,15204,19418,40150,0,0,1,0,1
59155,130,15205,19296;19508,40150,0,0,2,0,2
59156,130,15209,19383;19586;23788,40150,0,1,2,0,3
59157,130,15210,19775;19789;23406;23793,40150,0,1,3,0,4
59158,130,15211,19386;19447;23587,40150,0,0,3,0,3
59159,130,15212,19864;20213;23325;23429;23829;24122,40150,0,2,4,0,6
59160,130,15213,20034;20613;23850,40150,0,1,2,0,3
59161,130,15214,19625;20065,40150,0,0,2,0,2
59162,130,15215,19829;20084;23709;24114,40150,0,2,2,0,4
59163,130,15216,19956;20451;23335;23729,40150,0,1,3,0,4
59164,130,15217,20178;20692;23965;25197,40150,1,1,2,0,4
59165,130,15218,20200;20329;24767,40150,0,1,2,0,3
59166,130,15219,19738;20230,40150,0,0,2,0,2
59167,130,15220,20298;20598;23346;24336,40150,0,1,3,0,4
59168,130,15223,19947;20432;23943,40150,0,1,2,0,3
59169,130,15224,20444;20930;23979;24073;24263,40150,0,3,2,0,5
59170,130,15225,20094;20445;23728;24133,40150,0,2,2,0,4
59171,130,15226,20455;20967;24264;24787;25008,40150,1,2,2,0,5
59172,130,15227,20108;20195,40150,0,0,2,0,2
59173,130,15228,20838;24351;24783;24883,40150,0,3,1,0,4
59174,130,15230,20552;20572,40150,0,0,2,0,2
59175,130,15231,20280;20581;22899;24237,40150,0,1,3,0,4
59176,130,15232,20626;20880,40150,0,0,2,0,2
59177,130,15233,19697;20070;23220;24993,40150,1,0,3,0,4
59178,130,15234,20954;24074,40150,0,1,1,0,2
59179,130,15235,20678;21068;23761,40150,0,1,2,0,3
59180,130,15236,20699;23134,40150,0,0,2,0,2
59181,130,15237,21145;23571;24491,40150,0,1,2,0,3
59182,130,15238,20727;20898;23558,40150,0,0,3,0,3
59183,130,15240,20999;24169,40150,0,1,1,0,2
59184,130,15241,20770;20888;23752;23976;25438,40150,1,2,2,0,5
59185,130,15243,20801;20932,40150,0,0,2,0,2
59186,130,15244,20553;20840;22930;23350;23447;24253,40150,0,1,5,0,6
59187,130,15245,20844;20856;23866;24162,40150,0,2,2,0,4
59188,130,15246,20879;21138;24578,40150,0,1,2,0,3
59189,130,15247,21060;23760;24486;24672,40150,0,3,1,0,4
59190,130,15248,20165;20894;23448;23869;24165;24357,40150,0,3,3,0,6
59191,130,15249,20773;23860;23970,40150,0,2,1,0,3
59192,130,15250,20956;21359,40150,0,0,2,0,2
59193,130,15251,20760;20972;23452;24474;25200,40150,1,1,3,0,5
59194,130,15252,20974;20979;24368;24790,40150,0,2,2,0,4
59195,130,15253,21004,40150,0,0,1,0,1
59196,130,15254,21007;21153;23355,40150,0,0,3,0,3
59197,130,15255,21000;21033,40150,0,0,2,0,2
59198,130,15256,20590;21034;24481,40150,0,1,2,0,3
59199,130,15257,21011;21044;23873;23983;24791,40150,0,3,2,0,5
59200,130,15258,21069;21250,40150,0,0,2,0,2
59201,130,15259,20443;21070,40150,0,0,2,0,2
59202,130,15260,21072;24271,40150,0,1,1,0,2
59203,130,15261,21090;21293,40150,0,0,2,0,2
59204,130,15262,21110;21262;23301;24386;24585;24909;25117,40150,1,3,3,0,7
59205,130,15263,20993;21137;24577,40150,0,1,2,0,3
59206,130,15264,21142;21480,40150,0,0,2,0,2
59207,130,15265,21160;21173;24800;25111,40150,1,1,2,0,4
59208,130,15266,21191;21493;24395,40150,0,1,2,0,3
59209,130,15267,16751;17115,40515,0,0,0,2,2
59210,130,15268,16932,40515,0,0,0,1,1
59211,130,15269,16994,40515,0,0,0,1,1
59212,130,15270,16761,40515,0,0,0,1,1
59213,130,15271,17240;17287,40515,0,0,0,2,2
59214,130,15272,17145,40515,0,0,0,1,1
59215,130,15274,17167,40515,0,0,0,1,1
59216,130,15275,16923,40515,0,0,0,1,1
59217,130,15276,17043,40515,0,0,0,1,1
59218,130,15278,17602,40515,0,0,0,1,1
59219,130,15280,17907,40515,0,0,0,1,1
59220,130,15282,17828;18165,40515,0,0,0,2,2
59221,130,15283,17747,40515,0,0,0,1,1
59222,130,15287,18203;22626;23043;23262;24761,40515,0,1,3,1,5
59223,130,15289,18316;18431,40515,0,0,2,0,2
59224,130,15290,18442,40515,0,0,1,0,1
59225,130,15293,18251;18400,40515,0,0,1,1,2
59226,130,15297,18501;18522,40515,0,0,2,0,2
59227,130,15302,19297;19913,40515,0,0,2,0,2
59228,130,15307,19668,40515,0,0,1,0,1
59229,130,15308,19851;20311,40515,0,0,2,0,2
59230,130,15309,19841;19921;23597;23907,40515,0,1,3,0,4
59231,130,15310,19709;20025;23319;23611,40515,0,0,4,0,4
59232,130,15312,20305;23234;23622;23834,40515,0,1,3,0,4
59233,130,15313,20139,40515,0,0,1,0,1
59234,130,15314,20422,40515,0,0,1,0,1
59235,130,15316,19730;20266;23931,40515,0,1,2,0,3
59236,130,15317,20041;20408;23632;23840;24442;24873,40515,0,3,3,0,6
59237,130,15318,20359;23121;24228,40515,0,1,2,0,3
59238,130,15320,20045;20614;23347;24544,40515,0,1,3,0,4
59239,130,15323,20363;20917;24360,40515,0,1,2,0,3
59240,130,15324,20362;20438,40515,0,0,2,0,2
59241,130,15326,20843;23564,40515,0,0,2,0,2
59242,130,15327,20525;20877;24564,40515,0,1,2,0,3
59243,130,15328,20426;20563;24444,40515,0,1,2,0,3
59244,130,15329,20551;21080;24272,40515,0,1,2,0,3
59245,130,15330,20300;20786;23563;24350;25319,40515,1,1,3,0,5
59246,130,15331,20701;24549,40515,0,1,1,0,2
59247,130,15332,20593;21162;24897,40515,0,1,2,0,3
59248,130,15333,20599;21278;23460,40515,0,0,3,0,3
59249,130,15335,20458;20824;24158;24252;24562,40515,0,3,2,0,5
59250,130,15336,20638;21356,40515,0,0,2,0,2
59251,130,15337,20650;20716;23852;24243;24452,40515,0,3,2,0,5
59252,130,15338,20675;21049;23455;24795,40515,0,1,3,0,4
59253,130,15339,20569;20677;24145;24878,40515,0,2,2,0,4
59254,130,15340,21217;21392;23575;25029;25128,40515,2,0,3,0,5
59255,130,15342,20758;24060;25001,40515,1,1,1,0,3
59256,130,15343,20955;21047;24376;24671,40515,0,2,2,0,4
59257,130,15344,21214;24178;24686,40515,0,2,1,0,3
59258,130,15346,20510;20852;23863;23973,40515,0,2,2,0,4
59259,130,15347,20819;20866;23140;24465;24663;24886;25004,40515,1,3,3,0,7
59260,130,15348,20748;20896;24256,40515,0,1,2,0,3
59261,130,15349,20343;20936;23754;23980;25006,40515,1,2,2,0,5
59262,130,15350,20647;20914;25005,40515,1,0,2,0,3
59263,130,15351,20895;21304;23881,40515,0,1,2,0,3
59264,130,15352,21525;24925;25346,40515,1,1,1,0,3
59265,130,15353,20939;21156;23762,40515,0,1,2,0,3
59266,130,15354,20820;23253;24251;25321,40515,1,1,2,0,4
59267,130,15355,21219;21441;25134,40515,1,0,2,0,3
59268,130,15356,20976;21052;24172,40515,0,1,2,0,3
59269,130,15357,20919;20977;24669,40515,0,1,2,0,3
59270,130,15358,21364;24187,40515,0,1,1,0,2
59271,130,15359,21290;25335,40515,1,0,1,0,2
59272,130,15360,21474;23668,40515,0,0,2,0,2
59273,130,15361,21159,40515,0,0,1,0,1
59274,130,15362,21243;21295;23767;24083;24497;24586;25120,40515,1,4,2,0,7
59275,130,15363,20995;21086;24488;25327,40515,1,1,2,0,4
59276,130,15364,20547;21023;24268;25104,40515,1,1,2,0,4
59277,130,15365,21208;25113,40515,1,0,1,0,2
59278,130,15366,20655;21180;23356;23878;24276,40515,0,2,3,0,5
59279,130,15367,20804;21186;24493;25016,40515,1,1,2,0,4
59280,130,15368,20904;21189;24177;24381;24580,40515,0,3,2,0,5
59281,130,15369,20864;21203;24902,40515,0,1,2,0,3
59282,130,15370,21209;21252;24281;24584;24804,40515,0,3,2,0,5
59283,130,15371,20691;21254;23361;24180;24805,40515,0,2,3,0,5
59284,130,15372,21449;24288;24596;25222,40515,1,2,1,0,4
59285,130,15373,21280;24691;25212,40515,1,1,1,0,3
59286,130,15374,21289;21387;24693,40515,0,1,2,0,3
59287,130,15375,21281;21291,40515,0,0,2,0,2
59288,130,15376,21220;21294;24279;24904,40515,0,2,2,0,4
59289,130,15377,21104;21307;23573,40515,0,0,3,0,3
59290,130,15378,16856,40880,0,0,0,1,1
59291,130,15379,16929,40880,0,0,0,1,1
59292,130,15380,16879,40880,0,0,0,1,1
59293,130,15382,17203,40880,0,0,0,1,1
59294,130,15383,16952,40880,0,0,0,1,1
59295,130,15384,17274;17706,40880,0,0,0,2,2
59296,130,15385,17268,40880,0,0,0,1,1
59297,130,15386,17214,40880,0,0,0,1,1
59298,130,15387,16967,40880,0,0,0,1,1
59299,130,15389,17544;17596,40880,0,0,0,2,2
59300,130,15390,17558,40880,0,0,0,1,1
59301,130,15391,17131,40880,0,0,0,1,1
59302,130,15395,17752,40880,0,0,0,1,1
59303,130,15398,18176,40880,0,0,0,1,1
59304,130,15402,18725;22945,40880,0,0,2,0,2
59305,130,15406,19569;23688,40880,0,1,1,0,2
59306,130,15409,19008,40880,0,0,1,0,1
59307,130,15412,19363;19954,40880,0,0,2,0,2
59308,130,15415,19519;19769,40880,0,0,2,0,2
59309,130,15417,19241;19706;23403,40880,0,0,3,0,3
59310,130,15418,19834;20162;24646;24765,40880,0,2,2,0,4
59311,130,15420,20104;23018;24222,40880,0,1,2,0,3
59312,130,15423,20157;20405;24034,40880,0,1,2,0,3
59313,130,15425,20837;20971;23451;24473;24668;24789,40880,0,3,3,0,6
59314,130,15426,20631;22605;24241,40880,0,1,2,0,3
59315,130,15427,20503;20811;23862;24459,40880,0,2,2,0,4
59316,130,15428,20973;21001;24076;25202,40880,1,1,2,0,4
59317,130,15430,20522;20578,40880,0,0,2,0,2
59318,130,15431,20625;20867;23975;24466,40880,0,2,2,0,4
59319,130,15432,20576;20666;23961,40880,0,1,2,0,3
59320,130,15434,20750;21506;23888;24820,40880,0,2,2,0,4
59321,130,15435,20594;20835;24161,40880,0,1,2,0,3
59322,130,15436,20777;21114;24798,40880,0,1,2,0,3
59323,130,15437,21064;21537;23772;24087;24710;24926;25138,40880,1,4,2,0,7
59324,130,15438,20883;21257;24690;25441,40880,1,1,2,0,4
59325,130,15439,20816;20900;23567;25323,40880,1,0,3,0,4
59326,130,15440,20960;21134;23756;24367,40880,0,2,2,0,4
59327,130,15441,20962;21471,40880,0,0,2,0,2
59328,130,15442,21021;21081;24480,40880,0,1,2,0,3
59329,130,15443,21372;25339;25444,40880,2,0,1,0,3
59330,130,15444,21123;21236,40880,0,0,2,0,2
59331,130,15445,20628;21077;24377;24673;24895,40880,0,3,2,0,5
59332,130,15446,21094;21201;24685;24801,40880,0,2,2,0,4
59333,130,15447,21105;21340;23996,40880,0,1,2,0,3
59334,130,15448,21120;21633;24932,40880,0,1,2,0,3
59335,130,15449,20636;21140;23877;23990;25013;25331,40880,2,2,2,0,6
59336,130,15450,21171;21453;24816;25135,40880,1,1,2,0,4
59337,130,15451,21174;21645;24296;24933,40880,0,2,2,0,4
59338,130,15452,20755;21188;23764;24900;25017,40880,1,2,2,0,5
59339,130,15453,21187;21193;24683;24901,40880,0,2,2,0,4
59340,130,15454,21202;21554;24824;25034,40880,1,1,2,0,4
59341,130,15455,21207;21286;25213,40880,1,0,2,0,3
59342,130,15456,21126;21258;24489;25206,40880,1,1,2,0,4
59343,130,15458,21488;24193;24704,40880,0,2,1,0,3
59344,130,15459,20751;21288,40880,0,0,2,0,2
59345,130,15460,21308;21642,40880,0,0,2,0,2
59346,130,15461,21818;21878;25056,40880,1,0,2,0,3
59347,130,15462,21734;24513;24613;24723,40880,0,3,1,0,4
59348,130,15463,21403;24501;24593,40880,0,2,1,0,3
59349,130,15464,20994;21411;23667;23886;25343;25446,40880,2,1,3,0,6
59350,130,15465,16723,41245,0,0,0,1,1
59351,130,15466,16752,41245,0,0,0,1,1
59352,130,15467,17102,41245,0,0,0,1,1
59353,130,15468,16757,41245,0,0,0,1,1
59354,130,15470,17181;17562,41245,0,0,0,2,2
59355,130,15472,17309;17618,41245,0,0,0,2,2
59356,130,15474,17397;17654,41245,0,0,0,2,2
59357,130,15479,17689;18062,41245,0,0,0,2,2
59358,130,15480,17550,41245,0,0,0,1,1
59359,130,15481,18110;18336,41245,0,0,1,1,2
59360,130,15483,18298;18339,41245,0,0,1,1,2
59361,130,15485,18430;18495,41245,0,0,2,0,2
59362,130,15493,19079,41245,0,0,1,0,1
59363,130,15497,19026;19551;23182;23899,41245,0,1,3,0,4
59364,130,15504,19700;22897;23492;23902;24012,41245,0,2,3,0,5
59365,130,15505,20534;20591;24651,41245,0,1,2,0,3
59366,130,15506,20629;23553;24142;24450,41245,0,2,2,0,4
59367,130,15507,20016;20091;23523;24116;24320,41245,0,2,3,0,5
59368,130,15513,20281;20449;24038;24134,41245,0,2,2,0,4
59369,130,15515,20273;20601;23132;24543,41245,0,1,3,0,4
59370,130,15516,20221;20372,41245,0,0,2,0,2
59371,130,15518,20502;20561,41245,0,0,2,0,2
59372,130,15519,20350;20656;23645;24244,41245,0,1,3,0,4
59373,130,15521,20197;20632;24242,41245,0,1,2,0,3
59374,130,15522,20441;20679;23245;23555;23647,41245,0,0,5,0,5
59375,130,15523,20665;20698,41245,0,0,2,0,2
59376,130,15524,20705;23857;23966;24246,41245,0,3,1,0,4
59377,130,15525,20897;23660;24257;24565,41245,0,2,2,0,4
59378,130,15526,20785;21196,41245,0,0,2,0,2
59379,130,15527,20796;23972,41245,0,1,1,0,2
59380,130,15528,20834;25198,41245,1,0,1,0,2
59381,130,15530,20868;20920;23565;24467;25098,41245,1,1,3,0,5
59382,130,15531,20871;21509;24601;25137;25225,41245,2,1,2,0,5
59383,130,15532,20407;20925;24362,41245,0,1,2,0,3
59384,130,15533,21101;23875;23987;24174;25011;25329,41245,2,3,1,0,6
59385,130,15534,20943;21115;23456,41245,0,0,3,0,3
59386,130,15535,20982;21042;24265;25201,41245,1,1,2,0,4
59387,130,15536,20990;21499;24706,41245,0,1,2,0,3
59388,130,15537,21002;21109;24574,41245,0,1,2,0,3
59389,130,15538,21045;21087;24269;24484;24571,41245,0,3,2,0,5
59390,130,15539,21051;24796,41245,0,1,1,0,2
59391,130,15541,21089;21133;24573;24674;25106,41245,1,2,2,0,5
59392,130,15542,21057;21093,41245,0,0,2,0,2
59393,130,15543,20686;20721,41245,0,0,2,0,2
59394,130,15544,21760;22006;24299,41245,0,1,2,0,3
59395,130,15545,21018;21393;23363;23769;24190;24917;25129,41245,1,3,3,0,7
59396,130,15546,21119;21176;24898,41245,0,1,2,0,3
59397,130,15547,21020;21121;24079;25012,41245,1,1,2,0,4
59398,130,15548,20858;21141;24176;25332,41245,1,1,2,0,4
59399,130,15549,21168;21565;24292;24827,41245,0,2,2,0,4
59400,130,15550,21213;21231;23359;23991,41245,0,1,3,0,4
59401,130,15551,21235;24803;25115,41245,1,1,1,0,3
59402,130,15552,21248;21273,41245,0,0,2,0,2
59403,130,15553,20848;21296;24387,41245,0,1,2,0,3
59404,130,15554,21351;21865;25154;25471,41245,2,0,2,0,4
59405,130,15555,21352;21903,41245,0,0,2,0,2
59406,130,15556,21594;24088;24831,41245,0,2,1,0,3
59407,130,15557,21366;21523;23889,41245,0,1,2,0,3
59408,130,15558,21369;21701;24093,41245,0,1,2,0,3
59409,130,15559,21370;21577;25037,41245,1,0,2,0,3
59410,130,15560,21130;21439;24815;25221,41245,1,1,2,0,4
59411,130,15561,21435;21794;25365,41245,1,0,2,0,3
59412,130,15562,21455;21545;23773;24711;25033;25229,41245,2,2,2,0,6
59413,130,15563,21457;21543,41245,0,0,2,0,2
59414,130,15564,21873;25055,41245,1,0,1,0,2
59415,130,15565,21500;21801;24517;24944;25051,41245,1,2,2,0,5
59416,130,15566,21379;21508,41245,0,0,2,0,2
59417,130,15567,21302;21513;24602,41245,0,1,2,0,3
59418,130,15568,21516;21714;24297;24936;25046,41245,1,2,2,0,5
59419,130,15569,21833;24520,41245,0,1,1,0,2
59420,130,15570,17132,41610,0,0,0,1,1
59421,130,15571,17455,41610,0,0,0,1,1
59422,130,15573,17111,41610,0,0,0,1,1
59423,130,15576,17607,41610,0,0,0,1,1
59424,130,15577,17388,41610,0,0,0,1,1
59425,130,15578,17880,41610,0,0,0,1,1
59426,130,15580,17483;17523,41610,0,0,0,2,2
59427,130,15584,17862,41610,0,0,0,1,1
59428,130,15587,18394;18880,41610,0,0,2,0,2
59429,130,15589,17755,41610,0,0,0,1,1
59430,130,15593,18719,41610,0,0,1,0,1
59431,130,15598,18859;18874,41610,0,0,2,0,2
59432,130,15600,19481,41610,0,0,1,0,1
59433,130,15605,20277;20526;23434;23636;23846;24335,41610,0,2,4,0,6
59434,130,15606,19362,41610,0,0,1,0,1
59435,130,15608,19929;20087,41610,0,0,2,0,2
59436,130,15609,20049;20147;23420;23812;24430,41610,0,2,3,0,5
59437,130,15611,20243;20659;23554;23854;24339,41610,0,2,3,0,5
59438,130,15612,20809,41610,0,0,1,0,1
59439,130,15615,20358;20619;23719;23935,41610,0,2,2,0,4
59440,130,15616,20377;20637;23442;24143,41610,0,1,3,0,4
59441,130,15617,20713;20737;23249;23559;23743;23859;24151,41610,0,3,4,0,7
59442,130,15618,20082;20419;23026;23540;23841,41610,0,1,4,0,5
59443,130,15619,19936;20180,41610,0,0,2,0,2
59444,130,15621,20386;20588;23736;24140;24238,41610,0,3,2,0,5
59445,130,15622,20695;20988,41610,0,0,2,0,2
59446,130,15623,20730;21107;23876;25330,41610,1,1,2,0,4
59447,130,15624,20203;20731;24149;24777,41610,0,2,2,0,4
59448,130,15625,20787;20921,41610,0,0,2,0,2
59449,130,15626,21268;24082;24910,41610,0,2,1,0,3
59450,130,15627,20875;21320;24084;24391,41610,0,2,2,0,4
59451,130,15628,20878;21447;24595,41610,0,1,2,0,3
59452,130,15629,21276,41610,0,0,1,0,1
59453,130,15630,20640;20902,41610,0,0,2,0,2
59454,130,15631,20958;21124;24075;25007,41610,1,1,2,0,4
59455,130,15632,20674;20978;24475,41610,0,1,2,0,3
59456,130,15633,20696;20992;24053,41610,0,1,2,0,3
59457,130,15634,20680;21012;24477;24792;24893,41610,0,3,2,0,5
59458,130,15635,20923;21019;23453;23985;24267;24374,41610,0,3,3,0,6
59459,130,15636,21043;21478,41610,0,0,2,0,2
59460,130,15637,20585;21046;23874,41610,0,1,2,0,3
59461,130,15638,21622;24090,41610,0,1,1,0,2
59462,130,15639,20756;21065;24173;25105,41610,1,1,2,0,4
59463,130,15640,21103;21405,41610,0,0,2,0,2
59464,130,15641,21111,41610,0,0,1,0,1
59465,130,15642,21404;23885;24813,41610,0,2,1,0,3
59466,130,15643,21608;21750;25041,41610,1,0,2,0,3
59467,130,15644,21151;21371;23461;23768;24698;24914,41610,0,3,3,0,6
59468,130,15645,21076;21157;24275;24492;24896;25014;25110,41610,2,3,2,0,7
59469,130,15646,21167;21706,41610,0,0,2,0,2
59470,130,15647,21172;21412;24814,41610,0,1,2,0,3
59471,130,15648,20714;21185;24681,41610,0,1,2,0,3
59472,130,15649,20968;21192;23142;24682,41610,0,1,3,0,4
59473,130,15650,20961;21423;25131,41610,1,0,2,0,3
59474,130,15651,21270,41610,0,0,1,0,1
59475,130,15652,21299;21337;23993;24184;25023,41610,1,2,2,0,5
59476,130,15653,21301;21420;24920;25220,41610,1,1,2,0,4
59477,130,15654,20815;21482;24394,41610,0,1,2,0,3
59478,130,15655,21263;21342;25025,41610,1,0,2,0,3
59479,130,15656,21347;21485;24599,41610,0,1,2,0,3
59480,130,15657,21376;21528;23574,41610,0,0,3,0,3
59481,130,15658,21397;21421;24191;24700;25130;25445,41610,2,2,2,0,6
59482,130,15660,21434;22036;24744,41610,0,1,2,0,3
59483,130,15661,21479;21785,41610,0,0,2,0,2
59484,130,15662,21249;21483;23364;24290;24598,41610,0,2,3,0,5
59485,130,15664,21327;21540;24589,41610,0,1,2,0,3
59486,130,15665,21578;21674;25456,41610,1,0,2,0,3
59487,130,15666,21579;21772;25247,41610,1,0,2,0,3
59488,130,15667,21973;24742;24959;25476,41610,1,2,1,0,4
59489,130,15668,20938;21504;24819,41610,0,1,2,0,3
59490,130,15669,21467;24922;25345,41610,1,1,1,0,3
59491,130,15670,21261;21660,41610,0,0,2,0,2
59492,130,15671,17018;17376,41975,0,0,0,2,2
59493,130,15674,17303,41975,0,0,0,1,1
59494,130,15675,17664,41975,0,0,0,1,1
59495,130,15676,17859;17963,41975,0,0,0,2,2
59496,130,15677,17846,41975,0,0,0,1,1
59497,130,15681,18269;18407,41975,0,0,1,1,2
59498,130,15683,18429,41975,0,0,1,0,1
59499,130,15686,18706,41975,0,0,1,0,1
59500,130,15688,18801,41975,0,0,1,0,1
59501,130,15697,19510;19883;23700;24217,41975,0,2,2,0,4
59502,130,15700,19863;19925;23009,41975,0,0,3,0,3
59503,130,15708,20192;21132;24576;25109,41975,1,1,2,0,4
59504,130,15709,19941;20658;23853;23960;24453,41975,0,3,2,0,5
59505,130,15710,19931;20095,41975,0,0,2,0,2
59506,130,15711,20308;20706;23557;24455,41975,0,1,3,0,4
59507,130,15712,20442;20743;24346,41975,0,1,2,0,3
59508,130,15714,20669;20767;22606;24062;24557;24660,41975,0,3,3,0,6
59509,130,15715,19930,41975,0,0,1,0,1
59510,130,15717,20735;21218;24582,41975,0,1,2,0,3
59511,130,15718,20670;20762;23746;23969;24249,41975,0,3,2,0,5
59512,130,15719,20482;20769;23252;25092,41975,1,0,3,0,4
59513,130,15720,20771;20799;24458,41975,0,1,2,0,3
59514,130,15721,20831;20907;24070;24260,41975,0,2,2,0,4
59515,130,15722,20851;20901;24258;24566,41975,0,2,2,0,4
59516,130,15723,20833;20905;23446,41975,0,0,3,0,3
59517,130,15724,20928;21129;23569,41975,0,0,3,0,3
59518,130,15725,20947;21179,41975,0,0,2,0,2
59519,130,15726,21006;24371;25204,41975,1,1,1,0,3
59520,130,15727,21566;21606;23890;24509,41975,0,2,2,0,4
59521,130,15728,21054;21436,41975,0,0,2,0,2
59522,130,15729,21055;21165;23763;24379;24579;24677,41975,0,4,2,0,6
59523,130,15730,21062;21223;25333,41975,1,0,2,0,3
59524,130,15732,21085;21260;24908;25334,41975,1,1,2,0,4
59525,130,15733,21116;21443;24702,41975,0,1,2,0,3
59526,130,15734,21149;21662;24510,41975,0,1,2,0,3
59527,130,15735,20791;21181;24680;24899,41975,0,2,2,0,4
59528,130,15737,20766;21228,41975,0,0,2,0,2
59529,130,15739,21073;21233;23766;24906;25114,41975,1,2,2,0,5
59530,130,15740,21237;21590;24929,41975,0,1,2,0,3
59531,130,15741,21239;24280;24688;25020,41975,1,2,1,0,4
59532,130,15742,21269;21707;24911;25118,41975,1,1,2,0,4
59533,130,15743,21267;21284;24182;24284;24692;25119,41975,1,3,2,0,6
59534,130,15744,21139;21303;24388,41975,0,1,2,0,3
59535,130,15745,21331;21450;24921,41975,0,1,2,0,3
59536,130,15746,21242;21375;24809,41975,0,1,2,0,3
59537,130,15747,21071;21381;23997;24699;25340,41975,1,2,2,0,5
59538,130,15748,21431;21757;25244,41975,1,0,2,0,3
59539,130,15749,21464;21953;24302,41975,0,1,2,0,3
59540,130,15750,20872;20952;24167,41975,0,1,2,0,3
59541,130,15751,21539;21738;24927,41975,0,1,2,0,3
59542,130,15752,21541;22089,41975,0,0,2,0,2
59543,130,15753,21551,41975,0,0,1,0,1
59544,130,15754,21559;22106,41975,0,0,2,0,2
59545,130,15755,21692;21970,41975,0,0,2,0,2
59546,130,15756,21592,41975,0,0,1,0,1
59547,130,15758,21598;21829;24844;25366,41975,1,1,2,0,4
59548,130,15759,21600;21800;25039,41975,1,0,2,0,3
59549,130,15760,22081;24745,41975,0,1,1,0,2
59550,130,15761,20975,41975,0,0,1,0,1
59551,130,15762,22042,41975,0,0,1,0,1
59552,130,15763,21640,41975,0,0,1,0,1
59553,130,15764,21895;24411;24738;25155,41975,1,2,1,0,4
59554,130,15765,21646;21845;25054;25152,41975,2,0,2,0,4
59555,130,15767,21667;21808,41975,0,0,2,0,2
59556,130,15768,21726;24838,41975,0,1,1,0,2
59557,130,15769,21569;21777;25248,41975,1,0,2,0,3
59558,130,15770,21719;22021;24002;24208,41975,0,2,2,0,4
59559,130,15771,21723;23999;24937,41975,0,2,1,0,3
59560,130,15772,21758;21870;24952,41975,0,1,2,0,3
59561,130,15773,17363,42340,0,0,0,1,1
59562,130,15774,17449,42340,0,0,0,1,1
59563,130,15775,17316,42340,0,0,0,1,1
59564,130,15778,17916,42340,0,0,0,1,1
59565,130,15780,18042;18235,42340,0,0,0,2,2
59566,130,15782,18287,42340,0,0,0,1,1
59567,130,15784,18876,42340,0,0,1,0,1
59568,130,15786,18681;19001,42340,0,0,2,0,2
59569,130,15787,19076,42340,0,0,1,0,1
59570,130,15790,19198;19672,42340,0,0,2,0,2
59571,130,15799,19804;20137;23227,42340,0,0,3,0,3
59572,130,15800,19698;19699,42340,0,0,2,0,2
59573,130,15801,19859,42340,0,0,1,0,1
59574,130,15802,20012;20043;23612;24429,42340,0,1,3,0,4
59575,130,15803,20063;20337,42340,0,0,2,0,2
59576,130,15804,19820;20088;23921;24115,42340,0,2,2,0,4
59577,130,15805,20113;20511;24447,42340,0,1,2,0,3
59578,130,15808,20214;20508,42340,0,0,2,0,2
59579,130,15809,20439;21178;24679;25015;25207,42340,2,1,2,0,5
59580,130,15810,20371;20536;24234,42340,0,1,2,0,3
59581,130,15811,20583;20641;24547;24877,42340,0,2,2,0,4
59582,130,15812,20763;20876;23868;24354,42340,0,2,2,0,4
59583,130,15813,20749;20774,42340,0,0,2,0,2
59584,130,15814,20793;20981,42340,0,0,2,0,2
59585,130,15815,20813;21527,42340,0,0,2,0,2
59586,130,15816,20672;20853;23255;23864;24352;24463,42340,0,3,3,0,6
59587,130,15817,20707;20869,42340,0,0,2,0,2
59588,130,15818,20873;20969;24788;25199,42340,1,1,2,0,4
59589,130,15819,20283;20951;23755;24366;24472,42340,0,3,2,0,5
59590,130,15820,20966;24667;25102,42340,1,1,1,0,3
59591,130,15821,20991;21010;24373;24476,42340,0,2,2,0,4
59592,130,15822,21009;21031;24266;24372;25009,42340,1,2,2,0,5
59593,130,15823,21027;21623;25355,42340,1,0,2,0,3
59594,130,15824,21079;21164,42340,0,0,2,0,2
59595,130,15825,21125;21496;24291;24817,42340,0,2,2,0,4
59596,130,15826,21144;21705;24404,42340,0,1,2,0,3
59597,130,15827,21146;21197;25018,42340,1,0,2,0,3
59598,130,15828,20657;21148;24080;24378,42340,0,2,2,0,4
59599,130,15829,21182;21183,42340,0,0,2,0,2
59600,130,15830,21212;21736;24840,42340,0,1,2,0,3
59601,130,15831,21899;21910;23671;25254,42340,1,0,3,0,4
59602,130,15832,21225;23458;24494;24687;24905;25316,42340,1,3,2,0,6
59603,130,15834,21246;24583,42340,0,1,1,0,2
59604,130,15835,21264;21830;25150;25465,42340,2,0,2,0,4
59605,130,15836,21334;24499;25337,42340,1,1,1,0,3
59606,130,15837,21346;23882;24392;24808;25123,42340,1,3,1,0,5
59607,130,15838,21546;21763,42340,0,0,2,0,2
59608,130,15839,21472;21635;24717,42340,0,1,2,0,3
59609,130,15840,21063;21427;23887;24701;25132,42340,1,2,2,0,5
59610,130,15841,21336;21522,42340,0,0,2,0,2
59611,130,15842,21292;21529;24604;24822;25032,42340,1,2,2,0,5
59612,130,15843,21552;21575;23464;24398;24507,42340,0,2,3,0,5
59613,130,15844,21561;25350;25450,42340,2,0,1,0,3
59614,130,15845,21591;24508;25231,42340,1,1,1,0,3
59615,130,15846,21517;21595;24196;25452,42340,1,1,2,0,4
59616,130,15847,21652;21680;24091;24198;25237,42340,1,2,2,0,5
59617,130,15848,21502;21872;25252,42340,1,0,2,0,3
59618,130,15849,21669;22059,42340,0,0,2,0,2
59619,130,15850,21161;21694;24403;25457,42340,1,1,2,0,4
59620,130,15851,21100;21722;25362,42340,1,0,2,0,3
59621,130,15852,21725,42340,0,0,1,0,1
59622,130,15853,21729;22181,42340,0,0,2,0,2
59623,130,15854,21759;22260;25171;25490,42340,2,0,2,0,4
59624,130,15855,21515;21769;25246,42340,1,0,2,0,3
59625,130,15856,21099;21532;24709;24823,42340,0,2,2,0,4
59626,130,15857,21792;21852,42340,0,0,2,0,2
59627,130,15858,21425;21799;25148,42340,1,0,2,0,3
59628,130,15859,21636;21804;24518;25463,42340,1,1,2,0,4
59629,130,15860,21817;22121,42340,0,0,2,0,2
59630,130,15861,21820;21886;24408;24949;25464,42340,1,2,2,0,5
59631,130,15862,21802;21861;24409;25153,42340,1,1,2,0,4
59632,130,15863,21866;22055;24000;24522;25472,42340,1,2,2,0,5
59633,130,15864,21994;22066;24307;24961,42340,0,2,2,0,4
59634,130,15865,17308;17655,42705,0,0,0,2,2
59635,130,15866,17478,42705,0,0,0,1,1
59636,130,15875,18511,42705,0,0,1,0,1
59637,130,15876,18482,42705,0,0,1,0,1
59638,130,15877,18460;18568,42705,0,0,2,0,2
59639,130,15884,19210,42705,0,0,1,0,1
59640,130,15888,19631,42705,0,0,1,0,1
59641,130,15892,19765;19888,42705,0,0,2,0,2
59642,130,15899,20176,42705,0,0,1,0,1
59643,130,15900,19942,42705,0,0,1,0,1
59644,130,15901,20644;24144;24338;24451,42705,0,3,1,0,4
59645,130,15903,20446;20839,42705,0,0,2,0,2
59646,130,15904,20466,42705,0,0,1,0,1
59647,130,15906,20390;20477;23333;24031,42705,0,1,3,0,4
59648,130,15908,20514;23949;24650,42705,0,2,1,0,3
59649,130,15909,20543;20597,42705,0,0,2,0,2
59650,130,15910,20726;21285;24183;24806,42705,0,2,2,0,4
59651,130,15911,20484;20741;23562;23744;24457;24880,42705,0,3,3,0,6
59652,130,15912,21024;21255;24689;25209,42705,1,1,2,0,4
59653,130,15913,20807;20916;23445,42705,0,0,3,0,3
59654,130,15914,20393;20857;23974,42705,0,1,2,0,3
59655,130,15915,21154;21194;23572;24676,42705,0,1,3,0,4
59656,130,15916,21265;24181;24282;25211,42705,1,2,1,0,4
59657,130,15917,21305;21885;25253;25473,42705,2,0,2,0,4
59658,130,15918,20926;21309;24389,42705,0,1,2,0,3
59659,130,15919,21353;21416;24697;25027;25124,42705,2,1,2,0,5
59660,130,15920,21232;21377;23666;23884;24188,42705,0,2,3,0,5
59661,130,15922,21216;21410;25219;25342,42705,2,0,2,0,4
59662,130,15924,21417;21688;24402,42705,0,1,2,0,3
59663,130,15926,21422;21874;24737;24953;25369,42705,1,2,2,0,5
59664,130,15927,21424;22175;25168,42705,1,0,2,0,3
59665,130,15929,21440;21571;25351,42705,1,0,2,0,3
59666,130,15931,21452;22157,42705,0,0,2,0,2
59667,130,15932,21462;21619;24833;25354,42705,1,1,2,0,4
59668,130,15933,21740;24406;25242,42705,1,1,1,0,3
59669,130,15934,21587;21859;23776,42705,0,1,2,0,3
59670,130,15935,21484;21751;25143,42705,1,0,2,0,3
59671,130,15936,21898;22356;25498,42705,1,0,2,0,3
59672,130,15937,21531;21675;23462;23669,42705,0,0,4,0,4
59673,130,15938,21766;22013;24416;24963,42705,0,2,2,0,4
59674,130,15939,21205;21567;25036,42705,1,0,2,0,3
59675,130,15940,21784;24515;24727;24942;25049;25363,42705,2,3,1,0,6
59676,130,15941,21597;25038;25233,42705,2,0,1,0,3
59677,130,15942,21612;22188;25073,42705,1,0,2,0,3
59678,130,15943,21384;21625;24399;24931;25234,42705,1,2,2,0,5
59679,130,15944,21957;24741;25064;25373,42705,2,1,1,0,4
59680,130,15945,21466;21654;24192;24597;24703,42705,0,3,2,0,5
59681,130,15946,21690,42705,0,0,1,0,1
59682,130,15947,21718;22312;24857,42705,0,1,2,0,3
59683,130,15948,21911;24955;25157,42705,1,1,1,0,3
59684,130,15949,21742;21849;23775;24521;25250,42705,1,2,2,0,5
59685,130,15950,22237;22265,42705,0,0,2,0,2
59686,130,15951,21803;21921;23777;25059;25371;25474,42705,3,1,2,0,6
59687,130,15952,21240;21807;24728;24842;24946;25052,42705,1,3,2,0,6
59688,130,15953,21810;21935;24947,42705,0,1,2,0,3
59689,130,15954,21812;21847;24202,42705,0,1,2,0,3
59690,130,15955,22031;22196;25269,42705,1,0,2,0,3
59691,130,15956,21834;22104;24421;25263,42705,1,1,2,0,4
59692,130,15957,21838;22286;24973;25494,42705,1,1,2,0,4
59693,130,15958,22025;24308;24964;25479,42705,1,2,1,0,4
59694,130,15959,21658;22149,42705,0,0,2,0,2
59695,130,15960,21524;21843;24301,42705,0,1,2,0,3
59696,130,15961,21881;21892,42705,0,0,2,0,2
59697,130,15962,21888;22302,42705,0,0,2,0,2
59698,130,15963,21648;21894;24524;24622;24847,42705,0,3,2,0,5
59699,130,15964,21704;21906;25370,42705,1,0,2,0,3
59700,130,15965,21946;22147,42705,0,0,2,0,2
59701,130,15966,21555;21977,42705,0,0,2,0,2
59702,130,15967,22023;24625;25161,42705,1,1,1,0,3
59703,130,15968,21979;22008,42705,0,0,2,0,2
59704,130,15969,21560,42705,0,0,1,0,1
59705,130,15970,17588,43070,0,0,0,1,1
59706,130,15971,17471,43070,0,0,0,1,1
59707,130,15972,17569,43070,0,0,0,1,1
59708,130,15973,17658,43070,0,0,0,1,1
59709,130,15974,17950;18321,43070,0,0,1,1,2
59710,130,15975,17491,43070,0,0,0,1,1
59711,130,15976,17642,43070,0,0,0,1,1
59712,130,15977,17949,43070,0,0,0,1,1
59713,130,15982,18496;18643,43070,0,0,2,0,2
59714,130,15987,18996;19594;22796,43070,0,0,3,0,3
59715,130,15989,19327;19524,43070,0,0,2,0,2
59716,130,15993,19607,43070,0,0,1,0,1
59717,130,15996,19869;20729;23136;24055;24148;24553,43070,0,3,3,0,6
59718,130,15999,20006;20123;23924,43070,0,1,2,0,3
59719,130,16000,20700;23033;23650;23741;23855;24054,43070,0,3,3,0,6
59720,130,16001,20171;20428;23727;23942,43070,0,2,2,0,4
59721,130,16003,20252;20373,43070,0,0,2,0,2
59722,130,16004,20747;23745;24348;24659;25541,43070,1,3,1,0,5
59723,130,16006,20166;20366;23627;24769,43070,0,1,3,0,4
59724,130,16008,20425;20768,43070,0,0,2,0,2
59725,130,16009,20125;20587,43070,0,0,2,0,2
59726,130,16011,20512;20676;23646;23963;24051;24656,43070,0,3,3,0,6
59727,130,16014,20752,43070,0,0,1,0,1
59728,130,16017,20817;21390,43070,0,0,2,0,2
59729,130,16018,20822;20910;23661;24071;24166;25100,43070,1,2,3,0,6
59730,130,16020,20933;21501;24195,43070,0,1,2,0,3
59731,130,16021,20987;21518;24603;24821;25227,43070,1,2,2,0,5
59732,130,16022,21075;21350;25026;25338,43070,2,0,2,0,4
59733,130,16026,21163,43070,0,0,1,0,1
59734,130,16027,21836;23893,43070,0,1,1,0,2
59735,130,16028,21234;21716,43070,0,0,2,0,2
59736,130,16029,21215;21282;23765;23879;24382,43070,0,3,2,0,5
59737,130,16030,21287;21512;24506;24708,43070,0,2,2,0,4
59738,130,16031,21083;21321;23995;24913;25442,43070,1,2,2,0,5
59739,130,16032,21329;24695,43070,0,1,1,0,2
59740,130,16033,21607;24930;25352,43070,1,1,1,0,3
59741,130,16034,21245;23665;24495;25208,43070,1,1,2,0,4
59742,130,16035,21127;21402;24393;24812,43070,0,2,2,0,4
59743,130,16036,21426;21839;25151;25467,43070,2,0,2,0,4
59744,130,16037,20719;21437;25133,43070,1,0,2,0,3
59745,130,16038,21311;21510;25226;25447,43070,2,0,2,0,4
59746,130,16039,21446;21629;24716;25043;25235,43070,2,1,2,0,5
59747,130,16040,21659;21988,43070,0,0,2,0,2
59748,130,16041,21118;21664;24400;24719;24934;25357,43070,1,3,2,0,6
59749,130,16042,21602;21768;25145;25461,43070,2,0,2,0,4
59750,130,16043,21563;21702;24712;24826;25230,43070,1,2,2,0,5
59751,130,16044,21703;21908;25241,43070,1,0,2,0,3
59752,130,16045,22236;25392,43070,1,0,1,0,2
59753,130,16047,21720;22003;25065;25159,43070,2,0,2,0,4
59754,130,16048,21530;21767;24605,43070,0,1,2,0,3
59755,130,16049,21461;21771,43070,0,0,2,0,2
59756,130,16050,21775;22391;24755,43070,0,1,2,0,3
59757,130,16051,21798;22354,43070,0,0,2,0,2
59758,130,16052,21809;24729;25149,43070,1,1,1,0,3
59759,130,16053,21825;21841,43070,0,0,2,0,2
59760,130,16054,21853;21923,43070,0,0,2,0,2
59761,130,16055,21883;22241;25270,43070,1,0,2,0,3
59762,130,16056,21904;21968;24304;25158,43070,1,1,2,0,4
59763,130,16057,22080;22155;25384,43070,1,0,2,0,3
59764,130,16058,21969,43070,0,0,1,0,1
59765,130,16059,21942,43070,0,0,1,0,1
59766,130,16060,21948;22178;25388,43070,1,0,2,0,3
59767,130,16061,21588,43070,0,0,1,0,1
59768,130,16062,22010;22249;25160;25378,43070,2,0,2,0,4
59769,130,16063,22022;22287;25274,43070,1,0,2,0,3
59770,130,16064,22043;22045;25259,43070,1,0,2,0,3
59771,130,16065,22054;22073;24966;25163,43070,1,1,2,0,4
59772,130,16066,21916;22584,43070,0,0,2,0,2
59773,130,16067,22109;24526;24630,43070,0,2,1,0,3
59774,130,16068,21796;22094;25070,43070,1,0,2,0,3
59775,130,16069,22092;22111;24746;24855;25165,43070,1,2,2,0,5
59776,130,16070,22113;22133,43070,0,0,2,0,2
59777,130,16071,21930;22240;24635,43070,0,1,2,0,3
59778,130,16072,21955;22140;24632;25266,43070,1,1,2,0,4
59779,130,16073,22148,43070,0,0,1,0,1
59780,130,16074,17597,43435,0,0,0,1,1
59781,130,16075,17105,43435,0,0,0,1,1
59782,130,16076,17636,43435,0,0,0,1,1
59783,130,16077,17764,43435,0,0,0,1,1
59784,130,16078,17499,43435,0,0,0,1,1
59785,130,16084,18427;18601,43435,0,0,2,0,2
59786,130,16085,18459,43435,0,0,1,0,1
59787,130,16086,17965,43435,0,0,0,1,1
59788,130,16094,19102,43435,0,0,1,0,1
59789,130,16098,19486,43435,0,0,1,0,1
59790,130,16100,19651,43435,0,0,1,0,1
59791,130,16105,20607;20812;23139;23750;24157;24781,43435,0,3,3,0,6
59792,130,16107,20530;21056;24572,43435,0,1,2,0,3
59793,130,16108,20712;20800;23135;24550,43435,0,1,3,0,4
59794,130,16110,20847;21091;25107,43435,1,0,2,0,3
59795,130,16111,20849,43435,0,0,1,0,1
59796,130,16112,21029,43435,0,0,1,0,1
59797,130,16113,20861;21339;24807;25216,43435,1,1,2,0,4
59798,130,16115,20970;21067;24487,43435,0,1,2,0,3
59799,130,16118,20949;21131;23570;24490;24575,43435,0,2,3,0,5
59800,130,16119,21147;21407;23770;23998;24286;24919;25030,43435,1,4,2,0,7
59801,130,16120,20986;23757;24369;24890,43435,0,3,1,0,4
59802,130,16121,21128;21211;24081;24581;24903,43435,0,3,2,0,5
59803,130,16122,21300,43435,0,0,1,0,1
59804,130,16123,21283;21709;24094;24405;25458,43435,1,2,2,0,5
59805,130,16124,21322;25122;25336,43435,2,0,1,0,3
59806,130,16125,21987;24849;25377,43435,1,1,1,0,3
59807,130,16126,21275;21361;24500;25126,43435,1,1,2,0,4
59808,130,16127,21459;24289;25223,43435,1,1,1,0,3
59809,130,16128,21378;21695;25028,43435,1,0,2,0,3
59810,130,16129,21413;21481;25136,43435,1,0,2,0,3
59811,130,16130,21980;24415,43435,0,1,1,0,2
59812,130,16131,21438;21547,43435,0,0,2,0,2
59813,130,16133,21312;21589;24928,43435,0,1,2,0,3
59814,130,16134,21609;21975;25477,43435,1,0,2,0,3
59815,130,16135,21626;21902;24412,43435,0,1,2,0,3
59816,130,16136,21628;21897;25156,43435,1,0,2,0,3
59817,130,16137,21583;21663;23891,43435,0,1,2,0,3
59818,130,16138,21684;21939;25238,43435,1,0,2,0,3
59819,130,16139,22061;24420,43435,0,1,1,0,2
59820,130,16140,21733;22492;25181,43435,1,0,2,0,3
59821,130,16141,21271;21748;24201;24939,43435,0,2,2,0,4
59822,130,16142,21710;21958;25257,43435,1,0,2,0,3
59823,130,16143,21314;21780;24615,43435,0,1,2,0,3
59824,130,16144,21813;22214,43435,0,0,2,0,2
59825,130,16145,21931;24958,43435,0,1,1,0,2
59826,130,16146,21190;21863;24410;24736;25251,43435,1,2,2,0,5
59827,130,16147,21884;22378;25284,43435,1,0,2,0,3
59828,130,16148,21827;21907;24730,43435,0,1,2,0,3
59829,130,16149,21222,43435,0,0,1,0,1
59830,130,16150,21088;21912;25057;25255,43435,2,0,2,0,4
59831,130,16151,21922;22261;25271,43435,1,0,2,0,3
59832,130,16152,21774;21933;24413,43435,0,1,2,0,3
59833,130,16153,21429;21934,43435,0,0,2,0,2
59834,130,16154,21937;22091;24854,43435,0,1,2,0,3
59835,130,16155,21960;22306;25077;25277,43435,2,0,2,0,4
59836,130,16156,21997;22098;24629;25484,43435,1,1,2,0,4
59837,130,16157,22017;22410;24528;25501,43435,1,1,2,0,4
59838,130,16158,21797;22056;24099;25164;25382,43435,2,1,2,0,5
59839,130,16159,22064;22125;24852;25068;25262,43435,2,1,2,0,5
59840,130,16160,22074;22438,43435,0,0,2,0,2
59841,130,16161,22305;25276;25496,43435,2,0,1,0,3
59842,130,16162,22076;22299,43435,0,0,2,0,2
59843,130,16163,22078;22502;24862;25182,43435,1,1,2,0,4
59844,130,16164,22047;22314,43435,0,0,2,0,2
59845,130,16165,22359,43435,0,0,1,0,1
59846,130,16166,22276;24972,43435,0,1,1,0,2
59847,130,16167,22293;25495,43435,1,0,1,0,2
59848,130,16168,22145;22162,43435,0,0,2,0,2
59849,130,16169,22163;22330;25396,43435,1,0,2,0,3
59850,130,16170,22177;22423,43435,0,0,2,0,2
59851,130,16171,22180;22316,43435,0,0,2,0,2
59852,130,16172,22211;22475,43435,0,0,2,0,2
59853,130,16173,22218;22321,43435,0,0,2,0,2
59854,130,16174,21776;22267,43435,0,0,2,0,2
59855,130,16175,22274;22385;25400,43435,1,0,2,0,3
59856,130,16176,17537,43800,0,0,0,1,1
59857,130,16177,17953,43800,0,0,0,1,1
59858,130,16179,17989,43800,0,0,0,1,1
59859,130,16180,17994,43800,0,0,0,1,1
59860,130,16182,18216;18227,43800,0,0,0,2,2
59861,130,16183,18384,43800,0,0,1,0,1
59862,130,16185,18119,43800,0,0,0,1,1
59863,130,16186,18123,43800,0,0,0,1,1
59864,130,16188,18138,43800,0,0,0,1,1
59865,130,16189,18705,43800,0,0,1,0,1
59866,130,16190,18749;18881,43800,0,0,2,0,2
59867,130,16192,19128,43800,0,0,1,0,1
59868,130,16196,18752,43800,0,0,1,0,1
59869,130,16197,19183,43800,0,0,1,0,1
59870,130,16199,19543,43800,0,0,1,0,1
59871,130,16200,19671,43800,0,0,1,0,1
59872,130,16202,19406,43800,0,0,1,0,1
59873,130,16209,19815;20115,43800,0,0,2,0,2
59874,130,16210,20331;20548;23236;23330,43800,0,0,4,0,4
59875,130,16211,20406;20722;24551,43800,0,1,2,0,3
59876,130,16213,20433;20476,43800,0,0,2,0,2
59877,130,16214,20290;20479;24649,43800,0,1,2,0,3
59878,130,16219,20661;24340,43800,0,1,1,0,2
59879,130,16221,20660;21210;24278;25440,43800,1,1,2,0,4
59880,130,16223,20436;20518;24233,43800,0,1,2,0,3
59881,130,16225,20564;20754;23654;23968;25096,43800,1,1,3,0,5
59882,130,16226,20795;21199;25019,43800,1,0,2,0,3
59883,130,16228,20320;20630;24655;24774,43800,0,2,2,0,4
59884,130,16229,20483,43800,0,0,1,0,1
59885,130,16230,20468;21013;24478;25205,43800,1,1,2,0,4
59886,130,16231,21615;24609;25453,43800,1,1,1,0,3
59887,130,16232,21433;21687,43800,0,0,2,0,2
59888,130,16235,21332,43800,0,0,1,0,1
59889,130,16236,21082;21251;24907,43800,0,1,2,0,3
59890,130,16237,20996;21272;23992;24283;25021,43800,1,2,2,0,5
59891,130,16238,21078,43800,0,0,1,0,1
59892,130,16239,21345;22028;24098;24626,43800,0,2,2,0,4
59893,130,16240,21432;22212,43800,0,0,2,0,2
59894,130,16241,21643;22050;24419;25066,43800,1,1,2,0,4
59895,130,16242,21330;21511;23771;24505;24924;25448,43800,1,3,2,0,6
59896,130,16243,21520;25449,43800,1,0,1,0,2
59897,130,16245,21383;21564;25035,43800,1,0,2,0,3
59898,130,16246,21573;21711;24612;24721,43800,0,2,2,0,4
59899,130,16247,21668;22085;24628;24967,43800,0,2,2,0,4
59900,130,16248,21533;21681;24199;24511,43800,0,2,2,0,4
59901,130,16249,20854;20862;23865;24885;25097,43800,1,2,2,0,5
59902,130,16250,21631;21672;25454,43800,1,0,2,0,3
59903,130,16251,21745;21932;25256,43800,1,0,2,0,3
59904,130,16252,21856;25468,43800,1,0,1,0,2
59905,130,16253,21938;22413,43800,0,0,2,0,2
59906,130,16254,21795,43800,0,0,1,0,1
59907,130,16255,21823;22099;24310,43800,0,1,2,0,3
59908,130,16256,21842;22100,43800,0,0,2,0,2
59909,130,16257,21507;21867;24096;24523;24620;25367,43800,1,3,2,0,6
59910,130,16258,21887;22266;24752;25491,43800,1,1,2,0,4
59911,130,16259,21732;21891;24846;24954,43800,0,2,2,0,4
59912,130,16260,22426;24313;25286,43800,1,1,1,0,3
59913,130,16261,21956;22661,43800,0,0,2,0,2
59914,130,16262,21831;21992;24300,43800,0,1,2,0,3
59915,130,16263,21995;22016,43800,0,0,2,0,2
59916,130,16264,21244;22005;25258,43800,1,0,2,0,3
59917,130,16265,22007;22474,43800,0,0,2,0,2
59918,130,16266,21498;22062,43800,0,0,2,0,2
59919,130,16267,22071;22303,43800,0,0,2,0,2
59920,130,16268,22118;22169;24969,43800,0,1,2,0,3
59921,130,16269,21915;22129;25264;25486,43800,2,0,2,0,4
59922,130,16270,22144;22208;24970,43800,0,1,2,0,3
59923,130,16271,21779;22154;24751;25072,43800,1,1,2,0,4
59924,130,16272,22159;25268,43800,1,0,1,0,2
59925,130,16273,22164,43800,0,0,1,0,1
59926,130,16274,22200;22332,43800,0,0,2,0,2
59927,130,16275,22048;22221;25380,43800,1,0,2,0,3
59928,130,16276,22227;22680,43800,0,0,2,0,2
59929,130,16277,22621;22646,43800,0,0,2,0,2
59930,130,16278,22252;22331;25170;25488,43800,2,0,2,0,4
59931,130,16279,22269;22542,43800,0,0,2,0,2
59932,130,16280,22337;24974,43800,0,1,1,0,2
59933,130,16281,22300;22506,43800,0,0,2,0,2
59934,130,16282,21840;22319;25278,43800,1,0,2,0,3
59935,130,16283,22613;25082,43800,1,0,1,0,2
59936,130,16284,22272;22471,43800,0,0,2,0,2
59937,130,16285,22344;22347;24975;25282,43800,1,1,2,0,4
59938,130,16286,22277;22379;24976,43800,0,1,2,0,3
59939,130,16287,22343;22380,43800,0,0,2,0,2
59940,130,16288,22388;22674,43800,0,0,2,0,2
59941,130,16290,17966,44165,0,0,0,1,1
59942,130,16291,17656,44165,0,0,0,1,1
59943,130,16294,18475;18857,44165,0,0,2,0,2
59944,130,16295,18295;18595,44165,0,0,1,1,2
59945,130,16297,18029;18234,44165,0,0,0,2,2
59946,130,16298,18734,44165,0,0,1,0,1
59947,130,16299,18141,44165,0,0,0,1,1
59948,130,16301,18905,44165,0,0,1,0,1
59949,130,16302,18824;18921,44165,0,0,2,0,2
59950,130,16308,19262,44165,0,0,1,0,1
59951,130,16314,20050;20385;23631;23720;24647,44165,0,2,3,0,5
59952,130,16316,19985,44165,0,0,1,0,1
59953,130,16317,20402,44165,0,0,1,0,1
59954,130,16318,20623;20703,44165,0,0,2,0,2
59955,130,16319,20648;20803;24156;24560;25320,44165,1,2,2,0,5
59956,130,16320,20963;21035;24168;24666,44165,0,2,2,0,4
59957,130,16322,21084;21618;25141,44165,1,0,2,0,3
59958,130,16323,21092;22284,44165,0,0,2,0,2
59959,130,16325,20950;21221;24802,44165,0,1,2,0,3
59960,130,16327,21341;21451;24591,44165,0,1,2,0,3
59961,130,16328,21391;21731;24512;24722,44165,0,2,2,0,4
59962,130,16329,21788;21981;24943,44165,0,1,2,0,3
59963,130,16330,21419;22117;24003,44165,0,1,2,0,3
59964,130,16332,21637;22112;25386,44165,1,0,2,0,3
59965,130,16333,22015;25478,44165,1,0,1,0,2
59966,130,16334,21274;21685,44165,0,0,2,0,2
59967,130,16335,21781;24725;24941;25048;25462,44165,2,2,1,0,5
59968,130,16336,21786;25147,44165,1,0,1,0,2
59969,130,16337,21755;21789;25050,44165,1,0,2,0,3
59970,130,16338,21824;23892,44165,0,1,1,0,2
59971,130,16339,21454;21860;24735;25470,44165,1,1,2,0,4
59972,130,16340,21943;24848;25061,44165,1,1,1,0,3
59973,130,16341,21538;21951;24606;25228,44165,1,1,2,0,4
59974,130,16342,21952;22044;24001;24740,44165,0,2,2,0,4
59975,130,16343,21689;21974;24305,44165,0,1,2,0,3
59976,130,16344,22040,44165,0,0,1,0,1
59977,130,16345,21650;22060;25067;25481,44165,2,0,2,0,4
59978,130,16346,21743;22093,44165,0,0,2,0,2
59979,130,16347,22282,44165,0,0,1,0,1
59980,130,16348,22070;22107;24853,44165,0,1,2,0,3
59981,130,16349,21869;22270;24753,44165,0,1,2,0,3
59982,130,16350,22165;22543;25509,44165,1,0,2,0,3
59983,130,16351,22176;22662,44165,0,0,2,0,2
59984,130,16352,22216;22592,44165,0,0,2,0,2
59985,130,16353,22224;22233,44165,0,0,2,0,2
59986,130,16354,22443;22560,44165,0,0,2,0,2
59987,130,16355,22433;22547;25292;25510,44165,2,0,2,0,4
59988,130,16357,22326;22370;25398;25500,44165,2,0,2,0,4
59989,130,16358,22341;22574,44165,0,0,2,0,2
59990,130,16359,22251;22446,44165,0,0,2,0,2
59991,130,16360,22489;22598,44165,0,0,2,0,2
59992,130,16361,22498;25291,44165,1,0,1,0,2
59993,130,16363,18240;18296,44530,0,0,0,2,2
59994,130,16365,18615;18864,44530,0,0,2,0,2
59995,130,16366,18688,44530,0,0,1,0,1
59996,130,16371,19255;19590,44530,0,0,2,0,2
59997,130,16372,19331,44530,0,0,1,0,1
59998,130,16373,19436,44530,0,0,1,0,1
59999,130,16374,19467;19517,44530,0,0,2,0,2
60000,130,16375,19627;20148;24021,44530,0,1,2,0,3
60001,130,16376,19555,44530,0,0,1,0,1
60002,130,16381,20392,44530,0,0,1,0,1
60003,130,16382,19939,44530,0,0,1,0,1
60004,130,16383,20141;20188;22820;23823,44530,0,1,3,0,4
60005,130,16384,20256,44530,0,0,1,0,1
60006,130,16386,19891;20349,44530,0,0,2,0,2
60007,130,16387,20018;20399;24327,44530,0,1,2,0,3
60008,130,16391,20798,44530,0,0,1,0,1
60009,130,16393,20899;21620;24834,44530,0,1,2,0,3
60010,130,16395,21005;21445;24892;25203,44530,1,1,2,0,4
60011,130,16396,21655;24718,44530,0,1,1,0,2
60012,130,16397,21014,44530,0,0,1,0,1
60013,130,16399,21226;21465;23664;24383,44530,0,1,3,0,4
60014,130,16400,21238;21535,44530,0,0,2,0,2
60015,130,16402,21328;21338,44530,0,0,2,0,2
60016,130,16403,21061;21382;24189;24915;25127;25217,44530,2,2,2,0,6
60017,130,16404,21385;21494;24916;25341,44530,1,1,2,0,4
60018,130,16405,21386;21762;24514;24841;25245,44530,1,2,2,0,5
60019,130,16406,21400;21624;24295;24715;25042;25356,44530,2,2,2,0,6
60020,130,16407,21627;22230;24527,44530,0,1,2,0,3
60021,130,16408,21638;22142,44530,0,0,2,0,2
60022,130,16409,21584;21651;25142,44530,1,0,2,0,3
60023,130,16410,21653;22150;25166,44530,1,0,2,0,3
60024,130,16411,21634;21730,44530,0,0,2,0,2
60025,130,16412,21739;21793;24516;25364,44530,1,1,2,0,4
60026,130,16413,21409;21749;24724,44530,0,1,2,0,3
60027,130,16414,21401,44530,0,0,1,0,1
60028,130,16415,21875;22273;25075;25492,44530,2,0,2,0,4
60029,130,16416,21647,44530,0,0,1,0,1
60030,130,16418,21641;21920;25058,44530,1,0,2,0,3
60031,130,16419,22131;24749;25265,44530,1,1,1,0,3
60032,130,16420,21991;22223;24306,44530,0,1,2,0,3
60033,130,16421,21850,44530,0,0,1,0,1
60034,130,16422,22053;22090;25483,44530,1,0,2,0,3
60035,130,16423,22894;24763;24868,44530,0,2,1,0,3
60036,130,16424,22119;22307;25173;25497,44530,2,0,2,0,4
60037,130,16425,22198;22779;25085;25413,44530,2,0,2,0,4
60038,130,16426,22280;22340;25493,44530,1,0,2,0,3
60039,130,16427,22170;22281;25273;25393,44530,2,0,2,0,4
60040,130,16428,22285;22548;24638;25511,44530,1,1,2,0,4
60041,130,16429,22137;24100;24312,44530,0,2,1,0,3
60042,130,16430,22161;22358;24859;25283;25499,44530,2,1,2,0,5
60043,130,16431,22115;22372,44530,0,0,2,0,2
60044,130,16432,22406;22477;25179;25406,44530,2,0,2,0,4
60045,130,16433,22416;22510,44530,0,0,2,0,2
60046,130,16434,22470;22914,44530,0,0,2,0,2
60047,130,16435,22478;22718,44530,0,0,2,0,2
60048,130,16436,22199;22527;25080,44530,1,0,2,0,3
60049,130,16437,22529;22717,44530,0,0,2,0,2
60050,130,16438,22225;22531,44530,0,0,2,0,2
60051,130,16439,22291;22550,44530,0,0,2,0,2
60052,130,16440,22559;22799,44530,0,0,2,0,2
60053,130,16441,21936;22561,44530,0,0,2,0,2
60054,130,16442,22571;22870,44530,0,0,2,0,2
60055,130,16443,22325;22588,44530,0,0,2,0,2
60056,130,16444,22567;22599;24757;25081,44530,1,1,2,0,4
60057,130,16445,17938,44895,0,0,0,1,1
60058,130,16446,17800,44895,0,0,0,1,1
60059,130,16447,18267;18472,44895,0,0,1,1,2
60060,130,16449,18351;18653,44895,0,0,2,0,2
60061,130,16452,18497,44895,0,0,1,0,1
60062,130,16453,18509,44895,0,0,1,0,1
60063,130,16454,18124,44895,0,0,0,1,1
60064,130,16455,18134,44895,0,0,0,1,1
60065,130,16456,18268,44895,0,0,0,1,1
60066,130,16457,18545;18559,44895,0,0,2,0,2
60067,130,16458,18299,44895,0,0,0,1,1
60068,130,16460,18808,44895,0,0,1,0,1
60069,130,16461,18906;19043,44895,0,0,2,0,2
60070,130,16464,19178,44895,0,0,1,0,1
60071,130,16466,18660,44895,0,0,1,0,1
60072,130,16468,19566,44895,0,0,1,0,1
60073,130,16470,19673,44895,0,0,1,0,1
60074,130,16471,19992,44895,0,0,1,0,1
60075,130,16473,19987,44895,0,0,1,0,1
60076,130,16475,20001,44895,0,0,1,0,1
60077,130,16482,20454,44895,0,0,1,0,1
60078,130,16483,20491,44895,0,0,1,0,1
60079,130,16485,20649;20744;24058;24554,44895,0,2,2,0,4
60080,130,16487,20886,44895,0,0,1,0,1
60081,130,16488,21136;21360;24085;24186;25125,44895,1,2,2,0,5
60082,130,16489,21152;21247;24179;24385,44895,0,2,2,0,4
60083,130,16490,21198;21266,44895,0,0,2,0,2
60084,130,16492,21319;22004,44895,0,0,2,0,2
60085,130,16493,22087,44895,0,0,1,0,1
60086,130,16494,21490;21844;24733,44895,0,1,2,0,3
60087,130,16495,21428,44895,0,0,1,0,1
60088,130,16496,21581;21603;24608;24829,44895,0,2,2,0,4
60089,130,16497,21585;21630;24830;25139,44895,1,1,2,0,4
60090,130,16500,21721;22324;24858,44895,0,1,2,0,3
60091,130,16501,21396;21558,44895,0,0,2,0,2
60092,130,16502,21430;21737;24095,44895,0,1,2,0,3
60093,130,16503,22057;24209;24309;25383,44895,1,2,1,0,4
60094,130,16504,21848;22283;24210;25076;25394,44895,2,1,2,0,5
60095,130,16505,21348;22018,44895,0,0,2,0,2
60096,130,16506,22428;24977,44895,0,1,1,0,2
60097,130,16507,21846;21928;24957,44895,0,1,2,0,3
60098,130,16508,22001;22268;24971;25172;25272,44895,2,1,2,0,5
60099,130,16510,22024;24743;24850,44895,0,2,1,0,3
60100,130,16511,22072;22424,44895,0,0,2,0,2
60101,130,16512,21941;22127;24311,44895,0,1,2,0,3
60102,130,16514,22105;22152;25071,44895,1,0,2,0,3
60103,130,16515,22167;22458,44895,0,0,2,0,2
60104,130,16516,22174;22373,44895,0,0,2,0,2
60105,130,16517,22194;22516,44895,0,0,2,0,2
60106,130,16518,22202;22620;25517,44895,1,0,2,0,3
60107,130,16519,22238;22243,44895,0,0,2,0,2
60108,130,16520,22246;22496;24636,44895,0,1,2,0,3
60109,130,16521,21671;22289,44895,0,0,2,0,2
60110,130,16522,22329;22732,44895,0,0,2,0,2
60111,130,16523,22339;22671;24865,44895,0,1,2,0,3
60112,130,16524,22349;22392,44895,0,0,2,0,2
60113,130,16525,22046;22352,44895,0,0,2,0,2
60114,130,16526,22357;22765,44895,0,0,2,0,2
60115,130,16527,22365;22566;24530,44895,0,1,2,0,3
60116,130,16528,22401,44895,0,0,1,0,1
60117,130,16529,22403;22785;25188,44895,1,0,2,0,3
60118,130,16530,21787;21990;24960,44895,0,1,2,0,3
60119,130,16531,22415;22838,44895,0,0,2,0,2
60120,130,16532,22386;22420,44895,0,0,2,0,2
60121,130,16533,22348;22421,44895,0,0,2,0,2
60122,130,16534,22941,44895,0,0,1,0,1
60123,130,16535,22451;23007,44895,0,0,2,0,2
60124,130,16536,22323;22452;25279,44895,1,0,2,0,3
60125,130,16537,22453,44895,0,0,1,0,1
60126,130,16538,22448;22866,44895,0,0,2,0,2
60127,130,16540,22459;22461,44895,0,0,2,0,2
60128,130,16541,22479;22537;25290;25407,44895,2,0,2,0,4
60129,130,16542,22485,44895,0,0,1,0,1
60130,130,16543,22334;22490;25180,44895,1,0,2,0,3
60131,130,16544,22521;22612,44895,0,0,2,0,2
60132,130,16545,22304,44895,0,0,1,0,1
60133,130,16546,22601;23011,44895,0,0,2,0,2
60134,130,16547,22609;24759,44895,0,1,1,0,2
60135,130,16548,22435;22614;25184,44895,1,0,2,0,3
60136,130,16549,22367;22615,44895,0,0,2,0,2
60137,130,16550,22563;22618,44895,0,0,2,0,2
60138,130,16551,22625;22719,44895,0,0,2,0,2
60139,130,16552,22396;22929;24870,44895,0,1,2,0,3
60140,130,16553,22682;22839;25415,44895,1,0,2,0,3
60141,130,16554,22398;22695,44895,0,0,2,0,2
60142,130,16555,22494;22712,44895,0,0,2,0,2
60143,130,16556,22720,44895,0,0,1,0,1
60144,130,16558,17749,45260,0,0,0,1,1
60145,130,16559,18301,45260,0,0,0,1,1
60146,130,16560,17917,45260,0,0,0,1,1
60147,130,16561,18696,45260,0,0,1,0,1
60148,130,16563,19015;19361,45260,0,0,2,0,2
60149,130,16566,19560,45260,0,0,1,0,1
60150,130,16567,18672,45260,0,0,1,0,1
60151,130,16571,20019,45260,0,0,1,0,1
60152,130,16573,20217,45260,0,0,1,0,1
60153,130,16574,19973,45260,0,0,1,0,1
60154,130,16575,20324,45260,0,0,1,0,1
60155,130,16577,20066,45260,0,0,1,0,1
60156,130,16578,20507,45260,0,0,1,0,1
60157,130,16579,20539;20776;23861,45260,0,1,2,0,3
60158,130,16584,20124,45260,0,0,1,0,1
60159,130,16585,20959,45260,0,0,1,0,1
60160,130,16589,20573;20651;23956;24448,45260,0,2,2,0,4
60161,130,16592,20984,45260,0,0,1,0,1
60162,130,16593,20855;21200;24684;25112,45260,1,1,2,0,4
60163,130,16594,21388;21746,45260,0,0,2,0,2
60164,130,16595,21442;21693;24611,45260,0,1,2,0,3
60165,130,16596,21399;21727;24839;24938,45260,0,2,2,0,4
60166,130,16597,21469;21965;25375,45260,1,0,2,0,3
60167,130,16598,21326;21961;24303;25374,45260,1,1,2,0,4
60168,130,16599,21032;21491;24705,45260,0,1,2,0,3
60169,130,16600,21534,45260,0,0,1,0,1
60170,130,16601,21316;24587,45260,0,1,1,0,2
60171,130,16602,21621,45260,0,0,1,0,1
60172,130,16603,21673;22258;25074;25489,45260,2,0,2,0,4
60173,130,16604,21679;22189;24856,45260,0,1,2,0,3
60174,130,16606,22052;25162,45260,1,0,1,0,2
60175,130,16607,21536;21871;24204;24621;25368,45260,1,2,2,0,5
60176,130,16608,21832;22063;25261,45260,1,0,2,0,3
60177,130,16609,21741;21959;23672;24205,45260,0,1,3,0,4
60178,130,16610,21879;21949;24845,45260,0,1,2,0,3
60179,130,16611,21971;22591;25514,45260,1,0,2,0,3
60180,130,16612,21470;21976;24414;24525,45260,0,2,2,0,4
60181,130,16613,21805;21983;24206;25376,45260,1,1,2,0,4
60182,130,16614,21715;22226;25390,45260,1,0,2,0,3
60183,130,16615,22032;22384;23544;24860;25399,45260,1,1,3,0,5
60184,130,16616,22051;22322;25260;25381,45260,2,0,2,0,4
60185,130,16617,21828;22058,45260,0,0,2,0,2
60186,130,16618,22088;22619;25296,45260,1,0,2,0,3
60187,130,16619,22126;22634,45260,0,0,2,0,2
60188,130,16620,22153;22395;24756;24861,45260,0,2,2,0,4
60189,130,16621,21735;22173;25167,45260,1,0,2,0,3
60190,130,16622,22185;22817,45260,0,0,2,0,2
60191,130,16623,22190;22688,45260,0,0,2,0,2
60192,130,16624,21568;22206,45260,0,0,2,0,2
60193,130,16625,22207;22336,45260,0,0,2,0,2
60194,130,16626,22222;22456,45260,0,0,2,0,2
60195,130,16627,22296;22437;25275,45260,1,0,2,0,3
60196,130,16628,22346;22645,45260,0,0,2,0,2
60197,130,16629,22295;22350;25176,45260,1,0,2,0,3
60198,130,16630,22382;22741;25187,45260,1,0,2,0,3
60199,130,16631,22399;22752,45260,0,0,2,0,2
60200,130,16632,22310;22434;25403,45260,1,0,2,0,3
60201,130,16633,22468;23015,45260,0,0,2,0,2
60202,130,16634,21868;22484,45260,0,0,2,0,2
60203,130,16635,22541;22707;24762,45260,0,1,2,0,3
60204,130,16636,22235;22575,45260,0,0,2,0,2
60205,130,16637,22600;22651,45260,0,0,2,0,2
60206,130,16638,22465;22603,45260,0,0,2,0,2
60207,130,16639,22627;22833;24987,45260,0,1,2,0,3
60208,130,16640,22652;23062;25532,45260,1,0,2,0,3
60209,130,16641,22705;22823;25300;25526,45260,2,0,2,0,4
60210,130,16642,22754;22918,45260,0,0,2,0,2
60211,130,16643,22759;23016,45260,0,0,2,0,2
60212,130,16644,22768;25523,45260,1,0,1,0,2
60213,130,16645,22725;22773,45260,0,0,2,0,2
60214,130,16646,22782;22973,45260,0,0,2,0,2
60215,130,16647,22440;22811,45260,0,0,2,0,2
60216,130,16648,22829;23034,45260,0,0,2,0,2
60217,130,16649,18233,45625,0,0,0,1,1
60218,130,16651,18350,45625,0,0,1,0,1
60219,130,16652,17783,45625,0,0,0,1,1
60220,130,16654,18684,45625,0,0,1,0,1
60221,130,16655,18711,45625,0,0,1,0,1
60222,130,16656,18751,45625,0,0,1,0,1
60223,130,16657,18916,45625,0,0,1,0,1
60224,130,16663,19212,45625,0,0,1,0,1
60225,130,16665,19291,45625,0,0,1,0,1
60226,130,16666,19409,45625,0,0,1,0,1
60227,130,16669,19253,45625,0,0,1,0,1
60228,130,16670,19176,45625,0,0,1,0,1
60229,130,16671,19758,45625,0,0,1,0,1
60230,130,16677,19746,45625,0,0,1,0,1
60231,130,16678,19790,45625,0,0,1,0,1
60232,130,16680,20204,45625,0,0,1,0,1
60233,130,16682,20335,45625,0,0,1,0,1
60234,130,16684,19690;19915,45625,0,0,2,0,2
60235,130,16685,20493,45625,0,0,1,0,1
60236,130,16686,20577,45625,0,0,1,0,1
60237,130,16687,20469,45625,0,0,1,0,1
60238,130,16688,20662,45625,0,0,1,0,1
60239,130,16689,21204,45625,0,0,1,0,1
60240,130,16690,20381,45625,0,0,1,0,1
60241,130,16692,21039,45625,0,0,1,0,1
60242,130,16694,21206;21682;24092;24200;25044,45625,1,2,2,0,5
60243,130,16695,21324;21343,45625,0,0,2,0,2
60244,130,16697,21444,45625,0,0,1,0,1
60245,130,16698,21373;21557;24397;24825;25349,45625,1,2,2,0,5
60246,130,16699,21562;21985,45625,0,0,2,0,2
60247,130,16700,21548;21678;24396;25348,45625,1,1,2,0,4
60248,130,16701,21691;21858,45625,0,0,2,0,2
60249,130,16702,21521,45625,0,0,1,0,1
60250,130,16703,21815,45625,0,0,1,0,1
60251,130,16704,22027;24851,45625,0,1,1,0,2
60252,130,16705,21854,45625,0,0,1,0,1
60253,130,16706,21754;21893,45625,0,0,2,0,2
60254,130,16707,21901,45625,0,0,1,0,1
60255,130,16708,21909,45625,0,0,1,0,1
60256,130,16709,21918,45625,0,0,1,0,1
60257,130,16710,21599,45625,0,0,1,0,1
60258,130,16711,21984;22518;25408,45625,1,0,2,0,3
60259,130,16712,21890,45625,0,0,1,0,1
60260,130,16713,21989,45625,0,0,1,0,1
60261,130,16714,22035;22407;25079,45625,1,0,2,0,3
60262,130,16715,21880,45625,0,0,1,0,1
60263,130,16716,22083,45625,0,0,1,0,1
60264,130,16717,22086;22309,45625,0,0,2,0,2
60265,130,16718,22134,45625,0,0,1,0,1
60266,130,16719,22139;22160;25387,45625,1,0,2,0,3
60267,130,16720,22068;22191;25069;25482,45625,2,0,2,0,4
60268,130,16721,22210;22369,45625,0,0,2,0,2
60269,130,16722,22229;22622,45625,0,0,2,0,2
60270,130,16723,22234;22623,45625,0,0,2,0,2
60271,130,16724,21761,45625,0,0,1,0,1
60272,130,16725,22203;22254,45625,0,0,2,0,2
60273,130,16727,22353;22441,45625,0,0,2,0,2
60274,130,16728,22366;22648,45625,0,0,2,0,2
60275,130,16729,22374;22429;24314,45625,0,1,2,0,3
60276,130,16730,22193;22409;25285,45625,1,0,2,0,3
60277,130,16731,22122;22431,45625,0,0,2,0,2
60278,130,16732,22445;22449;24978;25404,45625,1,1,2,0,4
60279,130,16733,22503;22853,45625,0,0,2,0,2
60280,130,16734,22514,45625,0,0,1,0,1
60281,130,16735,22540;22686,45625,0,0,2,0,2
60282,130,16736,22545;22669,45625,0,0,2,0,2
60283,130,16737,22558;22616,45625,0,0,2,0,2
60284,130,16738,22383;22604;24758;25515,45625,1,1,2,0,4
60285,130,16739,22624;24760;25518,45625,1,1,1,0,3
60286,130,16740,22636;22967;25424,45625,1,0,2,0,3
60287,130,16741,22660;22733;24984;25083,45625,1,1,2,0,4
60288,130,16742,22667;22920,45625,0,0,2,0,2
60289,130,16743,22678,45625,0,0,1,0,1
60290,130,16744,22495;22701;25505,45625,1,0,2,0,3
60291,130,16745,22704;23068,45625,0,0,2,0,2
60292,130,16746,22404;22708,45625,0,0,2,0,2
60293,130,16747,22713;23021,45625,0,0,2,0,2
60294,130,16748,22675;22767;24983;25411,45625,1,1,2,0,4
60295,130,16749,22473;22826;24423,45625,0,1,2,0,3
60296,130,16750,22830;22986,45625,0,0,2,0,2
60297,130,16751,22832;22911,45625,0,0,2,0,2
60298,130,16752,22836;23178,45625,0,0,2,0,2
60299,130,16753,22673;22848,45625,0,0,2,0,2
60300,130,16755,22858;22925,45625,0,0,2,0,2
60301,130,16756,22871;22958,45625,0,0,2,0,2
60302,130,16757,22880;23169,45625,0,0,2,0,2
60303,130,16758,22893,45625,0,0,1,0,1
60304,130,16759,22520;22909,45625,0,0,2,0,2
60305,130,16760,22638;22912,45625,0,0,2,0,2
60306,130,16761,22915;23098,45625,0,0,2,0,2
60307,130,16762,22927;23080;25533,45625,1,0,2,0,3
60308,130,16763,18379,45990,0,0,1,0,1
60309,130,16764,18675,45990,0,0,1,0,1
60310,130,16765,18417,45990,0,0,1,0,1
60311,130,16766,18838,45990,0,0,1,0,1
60312,130,16768,18333,45990,0,0,1,0,1
60313,130,16769,18640,45990,0,0,1,0,1
60314,130,16771,18948,45990,0,0,1,0,1
60315,130,16772,19276,45990,0,0,1,0,1
60316,130,16773,18650,45990,0,0,1,0,1
60317,130,16774,19320,45990,0,0,1,0,1
60318,130,16777,19310,45990,0,0,1,0,1
60319,130,16778,19564,45990,0,0,1,0,1
60320,130,16780,19232,45990,0,0,1,0,1
60321,130,16781,19788,45990,0,0,1,0,1
60322,130,16782,19547,45990,0,0,1,0,1
60323,130,16784,19716,45990,0,0,1,0,1
60324,130,16785,20002,45990,0,0,1,0,1
60325,130,16786,19870,45990,0,0,1,0,1
60326,130,16787,19799,45990,0,0,1,0,1
60327,130,16790,20609,45990,0,0,1,0,1
60328,130,16794,20957,45990,0,0,1,0,1
60329,130,16795,20654;20753,45990,0,0,2,0,2
60330,130,16796,21050,45990,0,0,1,0,1
60331,130,16799,21098;21315;24390;24694;24912;25121;25214,45990,2,3,2,0,7
60332,130,16802,21230,45990,0,0,1,0,1
60333,130,16803,21306;21593;25232,45990,1,0,2,0,3
60334,130,16804,21503,45990,0,0,1,0,1
60335,130,16805,21477;21782;24726;25146,45990,1,1,2,0,4
60336,130,16806,21108,45990,0,0,1,0,1
60337,130,16807,21752;21914;24956,45990,0,1,2,0,3
60338,130,16808,21665;21783,45990,0,0,2,0,2
60339,130,16809,21862,45990,0,0,1,0,1
60340,130,16810,21900;22141;24422;24750;24968;25267,45990,1,3,2,0,6
60341,130,16811,22065,45990,0,0,1,0,1
60342,130,16812,21355,45990,0,0,1,0,1
60343,130,16813,22000;22114;25485,45990,1,0,2,0,3
60344,130,16814,21526;21649,45990,0,0,2,0,2
60345,130,16815,21877;22033;24418,45990,0,1,2,0,3
60346,130,16817,22067,45990,0,0,1,0,1
60347,130,16818,22102;22664,45990,0,0,2,0,2
60348,130,16819,22143;22524,45990,0,0,2,0,2
60349,130,16820,22171;22758,45990,0,0,2,0,2
60350,130,16821,22205;22715;24641,45990,0,1,2,0,3
60351,130,16822,22146;22217;25169,45990,1,0,2,0,3
60352,130,16823,22255;22863,45990,0,0,2,0,2
60353,130,16824,22263;22585,45990,0,0,2,0,2
60354,130,16825,22328,45990,0,0,1,0,1
60355,130,16826,22562;22812;24639,45990,0,1,2,0,3
60356,130,16827,22082;22377,45990,0,0,2,0,2
60357,130,16828,22432;22874,45990,0,0,2,0,2
60358,130,16829,22318;22467,45990,0,0,2,0,2
60359,130,16830,22487;23067,45990,0,0,2,0,2
60360,130,16831,22462;22497;25504,45990,1,0,2,0,3
60361,130,16832,22500;22738,45990,0,0,2,0,2
60362,130,16833,22501;22709,45990,0,0,2,0,2
60363,130,16834,22488;22523,45990,0,0,2,0,2
60364,130,16835,22525;22536;25409,45990,1,0,2,0,3
60365,130,16836,22215;22551,45990,0,0,2,0,2
60366,130,16837,22564;22587,45990,0,0,2,0,2
60367,130,16838,23125;24992,45990,0,1,1,0,2
60368,130,16839,22578;22728;24642,45990,0,1,2,0,3
60369,130,16840,22187;22608;24315;24982;25295;25516,45990,2,2,2,0,6
60370,130,16841,22466;22649,45990,0,0,2,0,2
60371,130,16842,22979;22994,45990,0,0,2,0,2
60372,130,16843,22727;22757;25299,45990,1,0,2,0,3
60373,130,16844,22743,45990,0,0,1,0,1
60374,130,16845,23019,45990,0,0,1,0,1
60375,130,16846,22766;22846;25086,45990,1,0,2,0,3
60376,130,16847,22822;23129;25090,45990,1,0,2,0,3
60377,130,16848,22607;22825,45990,0,0,2,0,2
60378,130,16849,22827,45990,0,0,1,0,1
60379,130,16850,22849,45990,0,0,1,0,1
60380,130,16851,22868;23324,45990,0,0,2,0,2
60381,130,16852,22878;23296,45990,0,0,2,0,2
60382,130,16853,22576;22891,45990,0,0,2,0,2
60383,130,16854,22910;23103,45990,0,0,2,0,2
60384,130,16855,22919;23047;25531,45990,1,0,2,0,3
60385,130,16856,22951;23315,45990,0,0,2,0,2
60386,130,16857,22843;22952,45990,0,0,2,0,2
60387,130,16858,23247,45990,0,0,1,0,1
60388,130,16859,22611;22965,45990,0,0,2,0,2
60389,130,16860,22993;23314,45990,0,0,2,0,2
60390,130,16861,22663;22769,45990,0,0,2,0,2
60391,130,16862,23023;25089,45990,1,0,1,0,2
60392,130,16863,23025,45990,0,0,1,0,1
60393,130,16864,22855;23028,45990,0,0,2,0,2
60394,130,16866,18701,46355,0,0,1,0,1
60395,130,16867,18883,46355,0,0,1,0,1
60396,130,16868,18674,46355,0,0,1,0,1
60397,130,16869,18800;18816,46355,0,0,2,0,2
60398,130,16872,19055,46355,0,0,1,0,1
60399,130,16873,19048,46355,0,0,1,0,1
60400,130,16874,19316,46355,0,0,1,0,1
60401,130,16876,19150,46355,0,0,1,0,1
60402,130,16877,19520,46355,0,0,1,0,1
60403,130,16878,19119,46355,0,0,1,0,1
60404,130,16879,19193,46355,0,0,1,0,1
60405,130,16880,19734,46355,0,0,1,0,1
60406,130,16881,19806;20004,46355,0,0,2,0,2
60407,130,16882,20005,46355,0,0,1,0,1
60408,130,16884,19845,46355,0,0,1,0,1
60409,130,16885,20279,46355,0,0,1,0,1
60410,130,16887,19818,46355,0,0,1,0,1
60411,130,16888,20470,46355,0,0,1,0,1
60412,130,16889,20149,46355,0,0,1,0,1
60413,130,16893,21143,46355,0,0,1,0,1
60414,130,16895,20475,46355,0,0,1,0,1
60415,130,16896,21256;21574,46355,0,0,2,0,2
60416,130,16898,21349;21855;24618;24734;24951,46355,0,3,2,0,5
60417,130,16900,21357;21572;24293,46355,0,1,2,0,3
60418,130,16901,21344;21505;23576;24504;24707;24923,46355,0,3,3,0,6
60419,130,16902,21601;21656,46355,0,0,2,0,2
60420,130,16903,21604,46355,0,0,1,0,1
60421,130,16904,21195;21676;25236;25359,46355,2,0,2,0,4
60422,130,16905,21778;22244,46355,0,0,2,0,2
60423,130,16907,21458;21697;25045;25240,46355,2,0,2,0,4
60424,130,16908,21945;22123;24097;25062;25372,46355,2,1,2,0,5
60425,130,16909,21919,46355,0,0,1,0,1
60426,130,16910,21487;21616;24600;25224,46355,1,1,2,0,4
60427,130,16911,22049;22460,46355,0,0,2,0,2
60428,130,16912,22075,46355,0,0,1,0,1
60429,130,16914,22108;22290,46355,0,0,2,0,2
60430,130,16915,22151,46355,0,0,1,0,1
60431,130,16917,22239;22533,46355,0,0,2,0,2
60432,130,16918,22259;22724;25185,46355,1,0,2,0,3
60433,130,16919,22079,46355,0,0,1,0,1
60434,130,16920,22439;22777;25412,46355,1,0,2,0,3
60435,130,16921,22454;25288,46355,1,0,1,0,2
60436,130,16922,22250;22480,46355,0,0,2,0,2
60437,130,16923,22526;23111;25310,46355,1,0,2,0,3
60438,130,16924,22504;22528,46355,0,0,2,0,2
60439,130,16925,22698;23444,46355,0,0,2,0,2
60440,130,16926,22710;22736;24985;25298,46355,1,1,2,0,4
60441,130,16927,22538;22711,46355,0,0,2,0,2
60442,130,16928,22731;22942;25305,46355,1,0,2,0,3
60443,130,16929,22751;22762,46355,0,0,2,0,2
60444,130,16930,22771;22852;25087,46355,1,0,2,0,3
60445,130,16931,22745;22780,46355,0,0,2,0,2
60446,130,16932,22787;23195,46355,0,0,2,0,2
60447,130,16933,22389;22828,46355,0,0,2,0,2
60448,130,16934,22831;22966;25191;25306,46355,2,0,2,0,4
60449,130,16935,22841;23085,46355,0,0,2,0,2
60450,130,16936,22864;23202,46355,0,0,2,0,2
60451,130,16937,22589;22867,46355,0,0,2,0,2
60452,130,16938,22898;23149;25311,46355,1,0,2,0,3
60453,130,16939,22900;23181,46355,0,0,2,0,2
60454,130,16940,22922,46355,0,0,1,0,1
60455,130,16941,22936;23000;25421,46355,1,0,2,0,3
60456,130,16942,22956;23278,46355,0,0,2,0,2
60457,130,16943,22786;22970;24990;25307,46355,1,1,2,0,4
60458,130,16944,23002;23040,46355,0,0,2,0,2
60459,130,16945,22517;23006,46355,0,0,2,0,2
60460,130,16946,22747;23269,46355,0,0,2,0,2
60461,130,16947,22978;23022,46355,0,0,2,0,2
60462,130,16948,23059;23298,46355,0,0,2,0,2
60463,130,16949,23061;23095,46355,0,0,2,0,2
60464,130,16950,23017;23077,46355,0,0,2,0,2
60465,130,16951,23056;23093,46355,0,0,2,0,2
60466,130,16952,23096;23241,46355,0,0,2,0,2
60467,130,16953,23106;23145;25426,46355,1,0,2,0,3
60468,130,16954,23122;23321,46355,0,0,2,0,2
60469,130,16955,23123;23162,46355,0,0,2,0,2
60470,130,16956,22895;23138,46355,0,0,2,0,2
60471,130,16957,18557,46720,0,0,1,0,1
60472,130,16958,18632,46720,0,0,1,0,1
60473,130,16960,18597,46720,0,0,1,0,1
60474,130,16961,18835,46720,0,0,1,0,1
60475,130,16962,18959,46720,0,0,1,0,1
60476,130,16963,18639;18700,46720,0,0,2,0,2
60477,130,16964,18743,46720,0,0,1,0,1
60478,130,16967,19308,46720,0,0,1,0,1
60479,130,16968,19155,46720,0,0,1,0,1
60480,130,16969,19219,46720,0,0,1,0,1
60481,130,16971,19655,46720,0,0,1,0,1
60482,130,16972,19245,46720,0,0,1,0,1
60483,130,16973,19965,46720,0,0,1,0,1
60484,130,16974,20014,46720,0,0,1,0,1
60485,130,16975,19760,46720,0,0,1,0,1
60486,130,16976,19661,46720,0,0,1,0,1
60487,130,16978,20248,46720,0,0,1,0,1
60488,130,16979,20190,46720,0,0,1,0,1
60489,130,16983,20218,46720,0,0,1,0,1
60490,130,16984,20411,46720,0,0,1,0,1
60491,130,16987,19908,46720,0,0,1,0,1
60492,130,16988,20516,46720,0,0,1,0,1
60493,130,16991,20685,46720,0,0,1,0,1
60494,130,16992,20621,46720,0,0,1,0,1
60495,130,16993,20302,46720,0,0,1,0,1
60496,130,16994,20825,46720,0,0,1,0,1
60497,130,16997,21106;21724;25047,46720,1,0,2,0,3
60498,130,16998,21374;22030;24417;25480,46720,1,1,2,0,4
60499,130,16999,21333;21367;24185;24590;24696;25443,46720,1,3,2,0,6
60500,130,17000,21365;21764;24407;25144,46720,1,1,2,0,4
60501,130,17001,21096;21408;24502;24594,46720,0,2,2,0,4
60502,130,17002,21657;22315;25078,46720,1,0,2,0,3
60503,130,17003,21418;25344,46720,1,0,1,0,2
60504,130,17004,21117,46720,0,0,1,0,1
60505,130,17006,21712,46720,0,0,1,0,1
60506,130,17007,21468,46720,0,0,1,0,1
60507,130,17008,21770,46720,0,0,1,0,1
60508,130,17009,21790,46720,0,0,1,0,1
60509,130,17010,21476,46720,0,0,1,0,1
60510,130,17011,21924,46720,0,0,1,0,1
60511,130,17012,21944;22362;25397,46720,1,0,2,0,3
60512,130,17013,22130;22298,46720,0,0,2,0,2
60513,130,17014,22138;22294;25395,46720,1,0,2,0,3
60514,130,17015,21814;22156,46720,0,0,2,0,2
60515,130,17016,22213;22512;24637,46720,0,1,2,0,3
60516,130,17017,22264;22275,46720,0,0,2,0,2
60517,130,17018,22308,46720,0,0,1,0,1
60518,130,17019,22311;22552,46720,0,0,2,0,2
60519,130,17020,22345;22644;25175;25281,46720,2,0,2,0,4
60520,130,17021,22408;22887;25301,46720,1,0,2,0,3
60521,130,17022,22297;22418;25401,46720,1,0,2,0,3
60522,130,17023,22457,46720,0,0,1,0,1
60523,130,17024,22313,46720,0,0,1,0,1
60524,130,17025,22247;22569;24640;25294,46720,1,1,2,0,4
60525,130,17026,22253;22572,46720,0,0,2,0,2
60526,130,17027,22629;23225,46720,0,0,2,0,2
60527,130,17028,22643;23038,46720,0,0,2,0,2
60528,130,17029,22427;22656;24529;25178,46720,1,1,2,0,4
60529,130,17030,22670;23226;25314;25429,46720,2,0,2,0,4
60530,130,17031,22681;23235,46720,0,0,2,0,2
60531,130,17032,22693;23173,46720,0,0,2,0,2
60532,130,17033,22756;22892;25302,46720,1,0,2,0,3
60533,130,17034,22770;23005,46720,0,0,2,0,2
60534,130,17035,22635;22791,46720,0,0,2,0,2
60535,130,17036,22800;23261,46720,0,0,2,0,2
60536,130,17037,22368;22851,46720,0,0,2,0,2
60537,130,17038,22844;22948;25423,46720,1,0,2,0,3
60538,130,17039,23171;25193,46720,1,0,1,0,2
60539,130,17040,22901;23238,46720,0,0,2,0,2
60540,130,17041,22904;23094;25309,46720,1,0,2,0,3
60541,130,17042,22885;22913,46720,0,0,2,0,2
60542,130,17043,22934;23491,46720,0,0,2,0,2
60543,130,17044,22940;23147,46720,0,0,2,0,2
60544,130,17045,22696;22954,46720,0,0,2,0,2
60545,130,17046,22650;22977,46720,0,0,2,0,2
60546,130,17047,22995;23184,46720,0,0,2,0,2
60547,130,17048,22917;22996,46720,0,0,2,0,2
60548,130,17049,23050;23141,46720,0,0,2,0,2
60549,130,17050,23078;23459;25317,46720,1,0,2,0,3
60550,130,17051,23079;23311;25093,46720,1,0,2,0,3
60551,130,17052,22921;23100,46720,0,0,2,0,2
60552,130,17053,23109;23260,46720,0,0,2,0,2
60553,130,17054,22879;23112,46720,0,0,2,0,2
60554,130,17055,23124;23528;25540,46720,1,0,2,0,3
60555,130,17056,23293,46720,0,0,1,0,1
60556,130,17057,23155;23290,46720,0,0,2,0,2
60557,130,17058,23196;23237;25536,46720,1,0,2,0,3
60558,130,17059,23210,46720,0,0,1,0,1
60559,130,17060,23157;23218,46720,0,0,2,0,2
60560,130,17061,22805;23232,46720,0,0,2,0,2
60561,130,17062,23244,46720,0,0,1,0,1
60562,130,17064,18618;19247,47085,0,0,2,0,2
60563,130,17065,18580,47085,0,0,1,0,1
60564,130,17066,19582,47085,0,0,1,0,1
60565,130,17068,19272,47085,0,0,1,0,1
60566,130,17069,18871,47085,0,0,1,0,1
60567,130,17070,18966,47085,0,0,1,0,1
60568,130,17071,19200,47085,0,0,1,0,1
60569,130,17073,19635,47085,0,0,1,0,1
60570,130,17074,19441,47085,0,0,1,0,1
60571,130,17075,19471,47085,0,0,1,0,1
60572,130,17077,19890,47085,0,0,1,0,1
60573,130,17079,20254,47085,0,0,1,0,1
60574,130,17080,20255,47085,0,0,1,0,1
60575,130,17081,20325,47085,0,0,1,0,1
60576,130,17082,20461,47085,0,0,1,0,1
60577,130,17083,20183,47085,0,0,1,0,1
60578,130,17085,20417,47085,0,0,1,0,1
60579,130,17086,20882,47085,0,0,1,0,1
60580,130,17087,20723,47085,0,0,1,0,1
60581,130,17088,21169,47085,0,0,1,0,1
60582,130,17090,21363,47085,0,0,1,0,1
60583,130,17091,21177,47085,0,0,1,0,1
60584,130,17092,21318,47085,0,0,1,0,1
60585,130,17093,21113,47085,0,0,1,0,1
60586,130,17095,21398;21463;24811,47085,0,1,2,0,3
60587,130,17096,21514;22231;24634;25391,47085,1,1,2,0,4
60588,130,17097,21550,47085,0,0,1,0,1
60589,130,17098,21586,47085,0,0,1,0,1
60590,130,17099,21362,47085,0,0,1,0,1
60591,130,17100,21368;21605;25040,47085,1,0,2,0,3
60592,130,17101,21864;21982;24619,47085,0,1,2,0,3
60593,130,17102,21927,47085,0,0,1,0,1
60594,130,17103,22002;22110;24623,47085,0,1,2,0,3
60595,130,17104,21889,47085,0,0,1,0,1
60596,130,17105,22103,47085,0,0,1,0,1
60597,130,17106,22038;22179;25487,47085,1,0,2,0,3
60598,130,17107,22232;22788;25524,47085,1,0,2,0,3
60599,130,17108,22219;22257,47085,0,0,2,0,2
60600,130,17109,22292;22375,47085,0,0,2,0,2
60601,130,17110,22132,47085,0,0,1,0,1
60602,130,17111,21822,47085,0,0,1,0,1
60603,130,17112,22136,47085,0,0,1,0,1
60604,130,17113,22363;22390,47085,0,0,2,0,2
60605,130,17114,22400;22806,47085,0,0,2,0,2
60606,130,17115,22402,47085,0,0,1,0,1
60607,130,17116,22182;22455;25289,47085,1,0,2,0,3
60608,130,17117,22464;22511,47085,0,0,2,0,2
60609,130,17118,22256;22472,47085,0,0,2,0,2
60610,130,17119,22515;22740,47085,0,0,2,0,2
60611,130,17120,22810,47085,0,0,1,0,1
60612,130,17121,22364;22795,47085,0,0,2,0,2
60613,130,17122,22573,47085,0,0,1,0,1
60614,130,17123,22672;22872,47085,0,0,2,0,2
60615,130,17124,22677,47085,0,0,1,0,1
60616,130,17125,22687;22883;25528,47085,1,0,2,0,3
60617,130,17126,22486;22691,47085,0,0,2,0,2
60618,130,17127,22376;22721;24866,47085,0,1,2,0,3
60619,130,17128,22722,47085,0,0,1,0,1
60620,130,17129,22737,47085,0,0,1,0,1
60621,130,17130,22750;23159,47085,0,0,2,0,2
60622,130,17131,22539;22798,47085,0,0,2,0,2
60623,130,17132,22859;23137;25416,47085,1,0,2,0,3
60624,130,17133,22860;23239,47085,0,0,2,0,2
60625,130,17134,22877;22889,47085,0,0,2,0,2
60626,130,17135,22902;23527,47085,0,0,2,0,2
60627,130,17136,22963;22969,47085,0,0,2,0,2
60628,130,17137,23029;23334,47085,0,0,2,0,2
60629,130,17138,22729;23049,47085,0,0,2,0,2
60630,130,17139,22923;23064,47085,0,0,2,0,2
60631,130,17140,22907;23074,47085,0,0,2,0,2
60632,130,17141,23108;23354;25434,47085,1,0,2,0,3
60633,130,17142,23168;23486,47085,0,0,2,0,2
60634,130,17143,23172;23427,47085,0,0,2,0,2
60635,130,17144,23204;23449,47085,0,0,2,0,2
60636,130,17145,23208,47085,0,0,1,0,1
60637,130,17146,22932;23209,47085,0,0,2,0,2
60638,130,17147,23030;23211,47085,0,0,2,0,2
60639,130,17148,23212;23223,47085,0,0,2,0,2
60640,130,17149,22837;23229,47085,0,0,2,0,2
60641,130,17150,23251;23309,47085,0,0,2,0,2
60642,130,17151,22991;23283,47085,0,0,2,0,2
60643,130,17152,23105;23289,47085,0,0,2,0,2
60644,130,17153,23302,47085,0,0,1,0,1
60645,130,17154,23020;23305,47085,0,0,2,0,2
60646,130,17155,23317;23541,47085,0,0,2,0,2
60647,130,17156,23327;23352,47085,0,0,2,0,2
60648,130,17157,23337;23639,47085,0,0,2,0,2
60649,130,17158,23339;23396,47085,0,0,2,0,2
60650,130,17159,23349;23362,47085,0,0,2,0,2
60651,130,17160,23358;23656,47085,0,0,2,0,2
60652,130,17161,18817,47450,0,0,1,0,1
60653,130,17162,18922,47450,0,0,1,0,1
60654,130,17163,18899,47450,0,0,1,0,1
60655,130,17164,19197,47450,0,0,1,0,1
60656,130,17165,19240,47450,0,0,1,0,1
60657,130,17166,19370,47450,0,0,1,0,1
60658,130,17167,19473,47450,0,0,1,0,1
60659,130,17168,19081,47450,0,0,1,0,1
60660,130,17169,19182,47450,0,0,1,0,1
60661,130,17170,19562,47450,0,0,1,0,1
60662,130,17171,19741,47450,0,0,1,0,1
60663,130,17172,19833,47450,0,0,1,0,1
60664,130,17173,19839,47450,0,0,1,0,1
60665,130,17174,20057,47450,0,0,1,0,1
60666,130,17175,19557,47450,0,0,1,0,1
60667,130,17176,19450,47450,0,0,1,0,1
60668,130,17177,19570,47450,0,0,1,0,1
60669,130,17178,19876,47450,0,0,1,0,1
60670,130,17180,20379,47450,0,0,1,0,1
60671,130,17181,20681,47450,0,0,1,0,1
60672,130,17182,20818,47450,0,0,1,0,1
60673,130,17184,20918;21335,47450,0,0,2,0,2
60674,130,17185,21066,47450,0,0,1,0,1
60675,130,17186,21229,47450,0,0,1,0,1
60676,130,17188,21277,47450,0,0,1,0,1
60677,130,17189,21279,47450,0,0,1,0,1
60678,130,17190,20998,47450,0,0,1,0,1
60679,130,17191,20935,47450,0,0,1,0,1
60680,130,17192,21040,47450,0,0,1,0,1
60681,130,17193,21389;21542;25347,47450,1,0,2,0,3
60682,130,17194,21644,47450,0,0,1,0,1
60683,130,17195,21677;22084,47450,0,0,2,0,2
60684,130,17196,21744;24614;25243;25459,47450,2,1,1,0,4
60685,130,17197,21756,47450,0,0,1,0,1
60686,130,17198,21582,47450,0,0,1,0,1
60687,130,17199,21448,47450,0,0,1,0,1
60688,130,17200,21857;22351;25469,47450,1,0,2,0,3
60689,130,17201,21917,47450,0,0,1,0,1
60690,130,17202,21940,47450,0,0,1,0,1
60691,130,17203,21632,47450,0,0,1,0,1
60692,130,17204,21851,47450,0,0,1,0,1
60693,130,17205,22037,47450,0,0,1,0,1
60694,130,17206,22128;22633,47450,0,0,2,0,2
60695,130,17207,22228;24633,47450,0,1,1,0,2
60696,130,17208,21708,47450,0,0,1,0,1
60697,130,17209,22101,47450,0,0,1,0,1
60698,130,17210,22338;22411,47450,0,0,2,0,2
60699,130,17211,22095,47450,0,0,1,0,1
60700,130,17212,22381;24754,47450,0,1,1,0,2
60701,130,17213,22405,47450,0,0,1,0,1
60702,130,17214,22436,47450,0,0,1,0,1
60703,130,17215,22034,47450,0,0,1,0,1
60704,130,17216,22508,47450,0,0,1,0,1
60705,130,17217,22535,47450,0,0,1,0,1
60706,130,17218,22580,47450,0,0,1,0,1
60707,130,17219,22532;22971,47450,0,0,2,0,2
60708,130,17220,22546,47450,0,0,1,0,1
60709,130,17221,22654;23143,47450,0,0,2,0,2
60710,130,17222,22676;22760,47450,0,0,2,0,2
60711,130,17223,22689;22781,47450,0,0,2,0,2
60712,130,17224,22764;22890,47450,0,0,2,0,2
60713,130,17225,22819;23177,47450,0,0,2,0,2
60714,130,17226,22835;25527,47450,1,0,1,0,2
60715,130,17227,22865;23357,47450,0,0,2,0,2
60716,130,17228,22628;22876;25417,47450,1,0,2,0,3
60717,130,17229,22882,47450,0,0,1,0,1
60718,130,17230,22639;22896;25303,47450,1,0,2,0,3
60719,130,17231,22617;22908,47450,0,0,2,0,2
60720,130,17232,22916;22928,47450,0,0,2,0,2
60721,130,17233,22964,47450,0,0,1,0,1
60722,130,17234,22647;22982,47450,0,0,2,0,2
60723,130,17235,22985;23258,47450,0,0,2,0,2
60724,130,17236,22987;23280,47450,0,0,2,0,2
60725,130,17237,22992;23388,47450,0,0,2,0,2
60726,130,17238,23045;23518,47450,0,0,2,0,2
60727,130,17239,23088;23256;25430,47450,1,0,2,0,3
60728,130,17240,23102,47450,0,0,1,0,1
60729,130,17241,22568,47450,0,0,1,0,1
60730,130,17242,22861;23206,47450,0,0,2,0,2
60731,130,17243,23035,47450,0,0,1,0,1
60732,130,17244,23071;23270,47450,0,0,2,0,2
60733,130,17245,23014;23272;25315,47450,1,0,2,0,3
60734,130,17246,22943;23288,47450,0,0,2,0,2
60735,130,17247,23127,47450,0,0,1,0,1
60736,130,17248,23214;23322;25428,47450,1,0,2,0,3
60737,130,17249,22730;23323,47450,0,0,2,0,2
60738,130,17250,23041;23328,47450,0,0,2,0,2
60739,130,17251,23373;23592,47450,0,0,2,0,2
60740,130,17252,23378;23684,47450,0,1,1,0,2
60741,130,17253,23194;23386,47450,0,0,2,0,2
60742,130,17254,23264;23424,47450,0,0,2,0,2
60743,140,7598,17365,13870,0,0,0,1,1
60744,140,7704,17378;17578,14235,0,0,0,2,2
60745,140,7731,19822;19999,14235,0,0,2,0,2
60746,140,8217,18070,16060,0,0,0,1,1
60747,140,8514,16466;16776;17100,17155,0,0,0,3,3
60748,140,8528,18548,17155,0,0,0,1,1
60749,140,8664,18831;19177,17520,0,0,0,2,2
60750,140,8687,18109;18508,17520,0,0,0,2,2
60751,140,8955,17250,18615,0,0,0,1,1
60752,140,9220,17629;17743;17782;17832,19345,0,0,0,4,4
60753,140,9316,18737,19710,0,0,0,1,1
60754,140,9829,17617,21535,0,0,0,1,1
60755,140,9894,15103,21535,0,0,0,1,1
60756,140,10013,15220,21900,0,0,0,1,1
60757,140,10017,15719,21900,0,0,0,1,1
60758,140,10024,15451,21900,0,0,0,1,1
60759,140,10136,15769,22265,0,0,0,1,1
60760,140,10235,15300,22630,0,0,0,1,1
60761,140,10236,15517,22630,0,0,0,1,1
60762,140,10237,15319,22630,0,0,0,1,1
60763,140,10247,15790,22630,0,0,0,1,1
60764,140,10324,18884;18953,22995,0,0,0,2,2
60765,140,10329,15734,22995,0,0,0,1,1
60766,140,10331,15579,22995,0,0,0,1,1
60767,140,10345,15842,22995,0,0,0,1,1
60768,140,10348,15829,22995,0,0,0,1,1
60769,140,10349,15967,22995,0,0,0,1,1
60770,140,10359,16155,22995,0,0,0,1,1
60771,140,10365,15959,22995,0,0,0,1,1
60772,140,10366,16193,22995,0,0,0,1,1
60773,140,10367,15758;16047,22995,0,0,0,2,2
60774,140,10423,18946;18993,23360,0,0,0,2,2
60775,140,10452,15822,23360,0,0,0,1,1
60776,140,10453,15443,23360,0,0,0,1,1
60777,140,10457,16708,23360,0,0,0,1,1
60778,140,10478,15686,23360,0,0,0,1,1
60779,140,10480,16143,23360,0,0,0,1,1
60780,140,10482,15738,23360,0,0,0,1,1
60781,140,10485,15484,23360,0,0,0,1,1
60782,140,10488,15968,23360,0,0,0,1,1
60783,140,10496,15765,23360,0,0,0,1,1
60784,140,10564,16070,23725,0,0,0,1,1
60785,140,10575,16003;16283,23725,0,0,0,2,2
60786,140,10583,18409;18841;18869,23725,0,0,0,3,3
60787,140,10585,15695,23725,0,0,0,1,1
60788,140,10588,16042,23725,0,0,0,1,1
60789,140,10665,15620,24090,0,0,0,1,1
60790,140,10669,16325,24090,0,0,0,1,1
60791,140,10673,15730,24090,0,0,0,1,1
60792,140,10680,16128,24090,0,0,0,1,1
60793,140,10685,15817,24090,0,0,0,1,1
60794,140,10686,15789,24090,0,0,0,1,1
60795,140,10690,15856,24090,0,0,0,1,1
60796,140,10695,16017;16278,24090,0,0,0,2,2
60797,140,10701,16023,24090,0,0,0,1,1
60798,140,10703,16236,24090,0,0,0,1,1
60799,140,10704,16227,24090,0,0,0,1,1
60800,140,10709,19012,24090,0,0,0,1,1
60801,140,10761,18791;18844,24455,0,0,0,2,2
60802,140,10776,16330,24455,0,0,0,1,1
60803,140,10780,16007,24455,0,0,0,1,1
60804,140,10785,16101,24455,0,0,0,1,1
60805,140,10786,16579,24455,0,0,0,1,1
60806,140,10787,16049,24455,0,0,0,1,1
60807,140,10790,16200,24455,0,0,0,1,1
60808,140,10792,16637,24455,0,0,0,1,1
60809,140,10800,16272,24455,0,0,0,1,1
60810,140,10870,15424,24820,0,0,0,1,1
60811,140,10875,16095,24820,0,0,0,1,1
60812,140,10876,15805,24820,0,0,0,1,1
60813,140,10879,19592;20060;23421,24820,0,0,3,0,3
60814,140,10881,16244,24820,0,0,0,1,1
60815,140,10883,15846;16126,24820,0,0,0,2,2
60816,140,10885,15165,24820,0,0,0,1,1
60817,140,10892,16012,24820,0,0,0,1,1
60818,140,10896,16145,24820,0,0,0,1,1
60819,140,10898,15823,24820,0,0,0,1,1
60820,140,10900,16205;16754,24820,0,0,0,2,2
60821,140,10905,16494,24820,0,0,0,1,1
60822,140,10915,16467,24820,0,0,0,1,1
60823,140,10976,16177,25185,0,0,0,1,1
60824,140,10986,15965,25185,0,0,0,1,1
60825,140,10989,16531,25185,0,0,0,1,1
60826,140,10991,16014,25185,0,0,0,1,1
60827,140,10993,15971,25185,0,0,0,1,1
60828,140,10994,16027,25185,0,0,0,1,1
60829,140,10997,16692,25185,0,0,0,1,1
60830,140,10999,16709,25185,0,0,0,1,1
60831,140,11004,16627,25185,0,0,0,1,1
60832,140,11006,16421,25185,0,0,0,1,1
60833,140,11010,16263,25185,0,0,0,1,1
60834,140,11011,16796,25185,0,0,0,1,1
60835,140,11014,16772,25185,0,0,0,1,1
60836,140,11018,16349,25185,0,0,0,1,1
60837,140,11019,16504,25185,0,0,0,1,1
60838,140,11020,16259,25185,0,0,0,1,1
60839,140,11024,16437,25185,0,0,0,1,1
60840,140,11025,16560,25185,0,0,0,1,1
60841,140,11026,15946;16377,25185,0,0,0,2,2
60842,140,11029,16803,25185,0,0,0,1,1
60843,140,11031,16519,25185,0,0,0,1,1
60844,140,11032,16549,25185,0,0,0,1,1
60845,140,11087,15828,25550,0,0,0,1,1
60846,140,11107,15989,25550,0,0,0,1,1
60847,140,11108,16358,25550,0,0,0,1,1
60848,140,11110,16108,25550,0,0,0,1,1
60849,140,11117,15988;16197,25550,0,0,0,2,2
60850,140,11119,16767,25550,0,0,0,1,1
60851,140,11121,16461,25550,0,0,0,1,1
60852,140,11126,16129,25550,0,0,0,1,1
60853,140,11127,16634,25550,0,0,0,1,1
60854,140,11128,16170,25550,0,0,0,1,1
60855,140,11132,16518,25550,0,0,0,1,1
60856,140,11133,17063,25550,0,0,0,1,1
60857,140,11134,16786,25550,0,0,0,1,1
60858,140,11137,16343,25550,0,0,0,1,1
60859,140,11139,16375,25550,0,0,0,1,1
60860,140,11140,19405;20246;20845;23083,25550,0,0,3,1,4
60861,140,11143,16512;16722,25550,0,0,0,2,2
60862,140,11145,16537;16818,25550,0,0,0,2,2
60863,140,11150,16329;16603,25550,0,0,0,2,2
60864,140,11158,17060,25550,0,0,0,1,1
60865,140,11230,16334,25915,0,0,0,1,1
60866,140,11233,16175,25915,0,0,0,1,1
60867,140,11234,16209,25915,0,0,0,1,1
60868,140,11236,16690,25915,0,0,0,1,1
60869,140,11238,16497,25915,0,0,0,1,1
60870,140,11240,16144,25915,0,0,0,1,1
60871,140,11241,16157;16441,25915,0,0,0,2,2
60872,140,11242,16593,25915,0,0,0,1,1
60873,140,11246,16299,25915,0,0,0,1,1
60874,140,11247,16779,25915,0,0,0,1,1
60875,140,11249,16561;16947,25915,0,0,0,2,2
60876,140,11250,16365,25915,0,0,0,1,1
60877,140,11251,16442,25915,0,0,0,1,1
60878,140,11255,16469,25915,0,0,0,1,1
60879,140,11260,16462,25915,0,0,0,1,1
60880,140,11262,16984,25915,0,0,0,1,1
60881,140,11263,16564,25915,0,0,0,1,1
60882,140,11264,16609,25915,0,0,0,1,1
60883,140,11272,16719,25915,0,0,0,1,1
60884,140,11273,17129,25915,0,0,0,1,1
60885,140,11274,16733;16817,25915,0,0,0,2,2
60886,140,11276,17095,25915,0,0,0,1,1
60887,140,11277,16770,25915,0,0,0,1,1
60888,140,11278,16703,25915,0,0,0,1,1
60889,140,11279,16869,25915,0,0,0,1,1
60890,140,11282,16556;16963,25915,0,0,0,2,2
60891,140,11332,15475,26280,0,0,0,1,1
60892,140,11341,16541,26280,0,0,0,1,1
60893,140,11347,16064,26280,0,0,0,1,1
60894,140,11350,16445;16819,26280,0,0,0,2,2
60895,140,11351,16700,26280,0,0,0,1,1
60896,140,11353,16859,26280,0,0,0,1,1
60897,140,11357,16833,26280,0,0,0,1,1
60898,140,11360,16735,26280,0,0,0,1,1
60899,140,11362,16891,26280,0,0,0,1,1
60900,140,11364,16399,26280,0,0,0,1,1
60901,140,11367,16903,26280,0,0,0,1,1
60902,140,11371,17003,26280,0,0,0,1,1
60903,140,11373,16569,26280,0,0,0,1,1
60904,140,11375,16669,26280,0,0,0,1,1
60905,140,11376,16665,26280,0,0,0,1,1
60906,140,11377,16912,26280,0,0,0,1,1
60907,140,11378,16940,26280,0,0,0,1,1
60908,140,11379,16897,26280,0,0,0,1,1
60909,140,11380,17306,26280,0,0,0,1,1
60910,140,11381,16270,26280,0,0,0,1,1
60911,140,11382,16672;17122,26280,0,0,0,2,2
60912,140,11383,16794,26280,0,0,0,1,1
60913,140,11386,17266,26280,0,0,0,1,1
60914,140,11388,17180,26280,0,0,0,1,1
60915,140,11389,16905,26280,0,0,0,1,1
60916,140,11390,16909,26280,0,0,0,1,1
60917,140,11391,17154,26280,0,0,0,1,1
60918,140,11392,17292,26280,0,0,0,1,1
60919,140,11393,16918,26280,0,0,0,1,1
60920,140,11452,16712,26645,0,0,0,1,1
60921,140,11454,16138,26645,0,0,0,1,1
60922,140,11455,16450,26645,0,0,0,1,1
60923,140,11456,16275,26645,0,0,0,1,1
60924,140,11457,16088,26645,0,0,0,1,1
60925,140,11459,16338,26645,0,0,0,1,1
60926,140,11460,16942,26645,0,0,0,1,1
60927,140,11461,16816,26645,0,0,0,1,1
60928,140,11462,16789,26645,0,0,0,1,1
60929,140,11463,16381,26645,0,0,0,1,1
60930,140,11464,16382,26645,0,0,0,1,1
60931,140,11465,16024,26645,0,0,0,1,1
60932,140,11466,17178,26645,0,0,0,1,1
60933,140,11467,16315;16447,26645,0,0,0,2,2
60934,140,11468,16674,26645,0,0,0,1,1
60935,140,11470,16173,26645,0,0,0,1,1
60936,140,11477,16671,26645,0,0,0,1,1
60937,140,11482,16714,26645,0,0,0,1,1
60938,140,11483,17101,26645,0,0,0,1,1
60939,140,11486,16568,26645,0,0,0,1,1
60940,140,11487,16716,26645,0,0,0,1,1
60941,140,11488,16765;16953,26645,0,0,0,2,2
60942,140,11491,17051,26645,0,0,0,1,1
60943,140,11496,16926,26645,0,0,0,1,1
60944,140,11497,16725;17014,26645,0,0,0,2,2
60945,140,11499,17106,26645,0,0,0,1,1
60946,140,11500,16490,26645,0,0,0,1,1
60947,140,11502,17177,26645,0,0,0,1,1
60948,140,11505,16968;17068,26645,0,0,0,2,2
60949,140,11506,17128,26645,0,0,0,1,1
60950,140,11507,16992,26645,0,0,0,1,1
60951,140,11510,17019,26645,0,0,0,1,1
60952,140,11511,17155,26645,0,0,0,1,1
60953,140,11549,15297,27010,0,0,0,1,1
60954,140,11565,15780,27010,0,0,0,1,1
60955,140,11567,15500,27010,0,0,0,1,1
60956,140,11575,16597,27010,0,0,0,1,1
60957,140,11576,16172,27010,0,0,0,1,1
60958,140,11583,16446,27010,0,0,0,1,1
60959,140,11585,16578,27010,0,0,0,1,1
60960,140,11586,16857;19617,27010,0,0,1,1,2
60961,140,11587,16883,27010,0,0,0,1,1
60962,140,11588,15909;16638,27010,0,0,0,2,2
60963,140,11590,16862,27010,0,0,0,1,1
60964,140,11592,17028,27010,0,0,0,1,1
60965,140,11593,16820;16988,27010,0,0,0,2,2
60966,140,11594,16737,27010,0,0,0,1,1
60967,140,11595,16846,27010,0,0,0,1,1
60968,140,11596,17045,27010,0,0,0,1,1
60969,140,11597,16901;17393,27010,0,0,0,2,2
60970,140,11598,17064,27010,0,0,0,1,1
60971,140,11599,17327,27010,0,0,0,1,1
60972,140,11603,16878;17196,27010,0,0,0,2,2
60973,140,11605,16982,27010,0,0,0,1,1
60974,140,11606,17031;17163,27010,0,0,0,2,2
60975,140,11607,17206;17257,27010,0,0,0,2,2
60976,140,11609,17411;21666;24835;25358,27010,0,2,1,1,4
60977,140,11610,17079,27010,0,0,0,1,1
60978,140,11658,15617,27375,0,0,0,1,1
60979,140,11664,15962,27375,0,0,0,1,1
60980,140,11665,16430;16792,27375,0,0,0,2,2
60981,140,11667,16550,27375,0,0,0,1,1
60982,140,11672,16464,27375,0,0,0,1,1
60983,140,11678,16613,27375,0,0,0,1,1
60984,140,11679,16623,27375,0,0,0,1,1
60985,140,11681,16624,27375,0,0,0,1,1
60986,140,11683,16120,27375,0,0,0,1,1
60987,140,11684,16804;17297,27375,0,0,0,2,2
60988,140,11685,16852,27375,0,0,0,1,1
60989,140,11686,17480,27375,0,0,0,1,1
60990,140,11687,17239,27375,0,0,0,1,1
60991,140,11688,16834;17076,27375,0,0,0,2,2
60992,140,11691,16797,27375,0,0,0,1,1
60993,140,11692,16864,27375,0,0,0,1,1
60994,140,11693,16870;17286,27375,0,0,0,2,2
60995,140,11694,16886;16972,27375,0,0,0,2,2
60996,140,11698,16938,27375,0,0,0,1,1
60997,140,11699,16188,27375,0,0,0,1,1
60998,140,11700,16960,27375,0,0,0,1,1
60999,140,11702,16720;16997,27375,0,0,0,2,2
61000,140,11706,17065;17293,27375,0,0,0,2,2
61001,140,11707,17070;21996;24207;24962;26109;26405,27375,2,1,2,1,6
61002,140,11708,16740;17080,27375,0,0,0,2,2
61003,140,11709,17328,27375,0,0,0,1,1
61004,140,11710,17488,27375,0,0,0,1,1
61005,140,11711,17201,27375,0,0,0,1,1
61006,140,11715,16934,27375,0,0,0,1,1
61007,140,11718,16995,27375,0,0,0,1,1
61008,140,11762,16468,27740,0,0,0,1,1
61009,140,11764,16484,27740,0,0,0,1,1
61010,140,11769,17012,27740,0,0,0,1,1
61011,140,11771,16589,27740,0,0,0,1,1
61012,140,11773,16470,27740,0,0,0,1,1
61013,140,11774,17437,27740,0,0,0,1,1
61014,140,11777,16893;17011,27740,0,0,0,2,2
61015,140,11778,16614,27740,0,0,0,1,1
61016,140,11780,16885,27740,0,0,0,1,1
61017,140,11781,16902,27740,0,0,0,1,1
61018,140,11782,17394,27740,0,0,0,1,1
61019,140,11783,16946,27740,0,0,0,1,1
61020,140,11784,16980;16985,27740,0,0,0,2,2
61021,140,11785,16964;16998,27740,0,0,0,2,2
61022,140,11786,17092,27740,0,0,0,1,1
61023,140,11788,17059,27740,0,0,0,1,1
61024,140,11789,17140,27740,0,0,0,1,1
61025,140,11791,17687,27740,0,0,0,1,1
61026,140,11796,17164,27740,0,0,0,1,1
61027,140,11797,16755;17175,27740,0,0,0,2,2
61028,140,11799,17420,27740,0,0,0,1,1
61029,140,11800,17445,27740,0,0,0,1,1
61030,140,11801,17302,27740,0,0,0,1,1
61031,140,11802,17182,27740,0,0,0,1,1
61032,140,11803,17644,27740,0,0,0,1,1
61033,140,11804,17256,27740,0,0,0,1,1
61034,140,11805,17289;17448,27740,0,0,0,2,2
61035,140,11806,17371,27740,0,0,0,1,1
61036,140,11807,17236;17684,27740,0,0,0,2,2
61037,140,11809,17333;17482,27740,0,0,0,2,2
61038,140,11810,17403,27740,0,0,0,1,1
61039,140,11872,16290,28105,0,0,0,1,1
61040,140,11873,16760,28105,0,0,0,1,1
61041,140,11874,16408,28105,0,0,0,1,1
61042,140,11884,16222,28105,0,0,0,1,1
61043,140,11886,16658,28105,0,0,0,1,1
61044,140,11887,16598,28105,0,0,0,1,1
61045,140,11888,16607;16910,28105,0,0,0,2,2
61046,140,11889,16983,28105,0,0,0,1,1
61047,140,11890,16975,28105,0,0,0,1,1
61048,140,11894,17093;17282,28105,0,0,0,2,2
61049,140,11896,16890,28105,0,0,0,1,1
61050,140,11897,17329,28105,0,0,0,1,1
61051,140,11898,17067,28105,0,0,0,1,1
61052,140,11899,17216,28105,0,0,0,1,1
61053,140,11900,17468,28105,0,0,0,1,1
61054,140,11902,17384,28105,0,0,0,1,1
61055,140,11903,17440,28105,0,0,0,1,1
61056,140,11904,17038,28105,0,0,0,1,1
61057,140,11905,16872;17264,28105,0,0,0,2,2
61058,140,11906,17147;17298,28105,0,0,0,2,2
61059,140,11907,17453,28105,0,0,0,1,1
61060,140,11909,17740,28105,0,0,0,1,1
61061,140,11912,19787;19878;23310;26376,28105,1,0,3,0,4
61062,140,11914,17566,28105,0,0,0,1,1
61063,140,11915,17260;17338,28105,0,0,0,2,2
61064,140,11917,17348;17399,28105,0,0,0,2,2
61065,140,11918,17606,28105,0,0,0,1,1
61066,140,11919,17545,28105,0,0,0,1,1
61067,140,11921,17692,28105,0,0,0,1,1
61068,140,11922,17549;17761,28105,0,0,0,2,2
61069,140,11924,17525;17575;20789,28105,0,0,1,2,3
61070,140,11972,15311,28470,0,0,0,1,1
61071,140,11982,15246,28470,0,0,0,1,1
61072,140,11989,16239,28470,0,0,0,1,1
61073,140,11993,16335,28470,0,0,0,1,1
61074,140,11998,16920,28470,0,0,0,1,1
61075,140,12000,17217;17311,28470,0,0,0,2,2
61076,140,12004,17046,28470,0,0,0,1,1
61077,140,12005,17527,28470,0,0,0,1,1
61078,140,12006,17098,28470,0,0,0,1,1
61079,140,12007,17400,28470,0,0,0,1,1
61080,140,12008,16987;17645;21224,28470,0,0,1,2,3
61081,140,12012,17405,28470,0,0,0,1,1
61082,140,12013,17049;17096,28470,0,0,0,2,2
61083,140,12015,17211,28470,0,0,0,1,1
61084,140,12017,17179,28470,0,0,0,1,1
61085,140,12019,17362;17486,28470,0,0,0,2,2
61086,140,12021,17401,28470,0,0,0,1,1
61087,140,12023,16930,28470,0,0,0,1,1
61088,140,12024,17538,28470,0,0,0,1,1
61089,140,12025,17276,28470,0,0,0,1,1
61090,140,12028,17646,28470,0,0,0,1,1
61091,140,12030,17323,28470,0,0,0,1,1
61092,140,12032,17377,28470,0,0,0,1,1
61093,140,12033,17317;17419,28470,0,0,0,2,2
61094,140,12034,17319;17433,28470,0,0,0,2,2
61095,140,12036,17162,28470,0,0,0,1,1
61096,140,12037,17467,28470,0,0,0,1,1
61097,140,12038,17354;17472,28470,0,0,0,2,2
61098,140,12040,17763,28470,0,0,0,1,1
61099,140,12041,17489;17630,28470,0,0,0,2,2
61100,140,12042,17494;17580,28470,0,0,0,2,2
61101,140,12043,16845;17521,28470,0,0,0,2,2
61102,140,12044,17551,28470,0,0,0,1,1
61103,140,12045,17787;17969;20076,28470,0,0,1,2,3
61104,140,12046,17036;17570;20983,28470,0,0,1,2,3
61105,140,12104,15571,28835,0,0,0,1,1
61106,140,12112,16374,28835,0,0,0,1,1
61107,140,12118,16850;17305,28835,0,0,0,2,2
61108,140,12119,16855,28835,0,0,0,1,1
61109,140,12121,17050,28835,0,0,0,1,1
61110,140,12122,17186,28835,0,0,0,1,1
61111,140,12123,17204,28835,0,0,0,1,1
61112,140,12124,17228,28835,0,0,0,1,1
61113,140,12126,17123;17213,28835,0,0,0,2,2
61114,140,12128,17269,28835,0,0,0,1,1
61115,140,12129,17334;17341,28835,0,0,0,2,2
61116,140,12130,17193;17556,28835,0,0,0,2,2
61117,140,12132,17539;17635,28835,0,0,0,2,2
61118,140,12133,17435,28835,0,0,0,1,1
61119,140,12135,17443,28835,0,0,0,1,1
61120,140,12136,17868,28835,0,0,0,1,1
61121,140,12137,17497,28835,0,0,0,1,1
61122,140,12139,17352;17750,28835,0,0,0,2,2
61123,140,12141,17779,28835,0,0,0,1,1
61124,140,12142,17679,28835,0,0,0,1,1
61125,140,12143,17585,28835,0,0,0,1,1
61126,140,12144,17245;17567,28835,0,0,0,2,2
61127,140,12145,17982,28835,0,0,0,1,1
61128,140,12146,17682,28835,0,0,0,1,1
61129,140,12147,17723;17944,28835,0,0,0,2,2
61130,140,12148,17622,28835,0,0,0,1,1
61131,140,12149,17423;17626,28835,0,0,0,2,2
61132,140,12150,17263;17639,28835,0,0,0,2,2
61133,140,12151,17838;17847,28835,0,0,0,2,2
61134,140,12152,17648,28835,0,0,0,1,1
61135,140,12153,17406;17651,28835,0,0,0,2,2
61136,140,12154,17251,28835,0,0,0,1,1
61137,140,12155,17657;17947,28835,0,0,0,2,2
61138,140,12157,17681,28835,0,0,0,1,1
61139,140,12204,16235,29200,0,0,0,1,1
61140,140,12209,16328,29200,0,0,0,1,1
61141,140,12212,16100;16217,29200,0,0,0,2,2
61142,140,12215,16292,29200,0,0,0,1,1
61143,140,12222,16713;17071,29200,0,0,0,2,2
61144,140,12223,16970,29200,0,0,0,1,1
61145,140,12225,16750,29200,0,0,0,1,1
61146,140,12226,21752;21913;25752;26016;26106,29200,2,1,2,0,5
61147,140,12227,17034;17398,29200,0,0,0,2,2
61148,140,12228,16515;16801,29200,0,0,0,2,2
61149,140,12231,17209;17469,29200,0,0,0,2,2
61150,140,12232,17410;17634,29200,0,0,0,2,2
61151,140,12233,17418;17446,29200,0,0,0,2,2
61152,140,12234,17173,29200,0,0,0,1,1
61153,140,12236,17697,29200,0,0,0,1,1
61154,140,12237,17157,29200,0,0,0,1,1
61155,140,12242,17428,29200,0,0,0,1,1
61156,140,12243,17447,29200,0,0,0,1,1
61157,140,12248,17430,29200,0,0,0,1,1
61158,140,12249,17444,29200,0,0,0,1,1
61159,140,12250,17479;17717,29200,0,0,0,2,2
61160,140,12252,17515,29200,0,0,0,1,1
61161,140,12253,17619;17741,29200,0,0,0,2,2
61162,140,12254,17586,29200,0,0,0,1,1
61163,140,12255,17462,29200,0,0,0,1,1
61164,140,12257,17972,29200,0,0,0,1,1
61165,140,12258,17232;17532,29200,0,0,0,2,2
61166,140,12259,18084,29200,0,0,0,1,1
61167,140,12261,17715,29200,0,0,0,1,1
61168,140,12262,17460;17739,29200,0,0,0,2,2
61169,140,12304,16426,29565,0,0,0,1,1
61170,140,12314,16746,29565,0,0,0,1,1
61171,140,12318,17422,29565,0,0,0,1,1
61172,140,12320,17171,29565,0,0,0,1,1
61173,140,12323,17172,29565,0,0,0,1,1
61174,140,12324,17200;17372,29565,0,0,0,2,2
61175,140,12325,17279,29565,0,0,0,1,1
61176,140,12326,17360,29565,0,0,0,1,1
61177,140,12328,17866,29565,0,0,0,1,1
61178,140,12330,17392,29565,0,0,0,1,1
61179,140,12331,17829,29565,0,0,0,1,1
61180,140,12332,18087,29565,0,0,0,1,1
61181,140,12334,17508;17939,29565,0,0,0,2,2
61182,140,12336,17519,29565,0,0,0,1,1
61183,140,12337,17215;17582,29565,0,0,0,2,2
61184,140,12338,17583,29565,0,0,0,1,1
61185,140,12339,17541,29565,0,0,0,1,1
61186,140,12340,17593,29565,0,0,0,1,1
61187,140,12341,17611;17620,29565,0,0,0,2,2
61188,140,12342,17505,29565,0,0,0,1,1
61189,140,12343,17653;17872,29565,0,0,0,2,2
61190,140,12345,17844,29565,0,0,0,1,1
61191,140,12346,17383;17690,29565,0,0,0,2,2
61192,140,12347,17997;18196,29565,0,0,0,2,2
61193,140,12348,17797;17968,29565,0,0,0,2,2
61194,140,12349,17753;17756,29565,0,0,0,2,2
61195,140,12350,17501;17769,29565,0,0,0,2,2
61196,140,12351,17434;17952,29565,0,0,0,2,2
61197,140,12352,17802,29565,0,0,0,1,1
61198,140,12353,22393;25177;25771;26120,29565,1,2,1,0,4
61199,140,12355,17748;17831,29565,0,0,0,2,2
61200,140,12356,17914;17936,29565,0,0,0,2,2
61201,140,12357,17589;17848,29565,0,0,0,2,2
61202,140,12359,17391;17878,29565,0,0,0,2,2
61203,140,12360,18048,29565,0,0,0,1,1
61204,140,12396,16402,29930,0,0,0,1,1
61205,140,12398,21363;21497;24194;24818;26012,29930,1,1,3,0,5
61206,140,12401,17130,29930,0,0,0,1,1
61207,140,12402,17218,29930,0,0,0,1,1
61208,140,12403,16763,29930,0,0,0,1,1
61209,140,12404,16647,29930,0,0,0,1,1
61210,140,12405,17052,29930,0,0,0,1,1
61211,140,12407,17230,29930,0,0,0,1,1
61212,140,12411,17041,29930,0,0,0,1,1
61213,140,12412,17037;17427,29930,0,0,0,2,2
61214,140,12413,17296,29930,0,0,0,1,1
61215,140,12414,17198;17696,29930,0,0,0,2,2
61216,140,12415,17247;17514,29930,0,0,0,2,2
61217,140,12416,17616,29930,0,0,0,1,1
61218,140,12417,17492;17660,29930,0,0,0,2,2
61219,140,12418,17366;17500,29930,0,0,0,2,2
61220,140,12420,17758,29930,0,0,0,1,1
61221,140,12421,17202,29930,0,0,0,1,1
61222,140,12422,17971,29930,0,0,0,1,1
61223,140,12423,17242,29930,0,0,0,1,1
61224,140,12424,17474,29930,0,0,0,1,1
61225,140,12425,17841,29930,0,0,0,1,1
61226,140,12426,17707,29930,0,0,0,1,1
61227,140,12427,17663;18107,29930,0,0,0,2,2
61228,140,12428,17700;17711,29930,0,0,0,2,2
61229,140,12429,17598,29930,0,0,0,1,1
61230,140,12430,18160;18178,29930,0,0,0,2,2
61231,140,12431,18036;18581,29930,0,0,0,2,2
61232,140,12432,18139;18189,29930,0,0,0,2,2
61233,140,12435,17817,29930,0,0,0,1,1
61234,140,12436,17604,29930,0,0,0,1,1
61235,140,12437,17824,29930,0,0,0,1,1
61236,140,12438,17628,29930,0,0,0,1,1
61237,140,12440,17638;17887,29930,0,0,0,2,2
61238,140,12441,17736;17853,29930,0,0,0,2,2
61239,140,12443,17864,29930,0,0,0,1,1
61240,140,12445,17673;17882,29930,0,0,0,2,2
61241,140,12446,17884,29930,0,0,0,1,1
61242,140,12447,17888;18144,29930,0,0,0,2,2
61243,140,12448,17937;18101,29930,0,0,0,2,2
61244,140,12449,17991;18094,29930,0,0,0,2,2
61245,140,12450,17860;17999,29930,0,0,0,2,2
61246,140,12496,16296,30295,0,0,0,1,1
61247,140,12499,16540,30295,0,0,0,1,1
61248,140,12501,15864;16233,30295,0,0,0,2,2
61249,140,12510,16104;17158,30295,0,0,0,2,2
61250,140,12513,17109,30295,0,0,0,1,1
61251,140,12514,17680,30295,0,0,0,1,1
61252,140,12516,17346,30295,0,0,0,1,1
61253,140,12517,17421;17721,30295,0,0,0,2,2
61254,140,12518,17369;17564,30295,0,0,0,2,2
61255,140,12519,17572;18131,30295,0,0,0,2,2
61256,140,12522,17807;17820,30295,0,0,0,2,2
61257,140,12524,17649;17727,30295,0,0,0,2,2
61258,140,12525,17487;17666,30295,0,0,0,2,2
61259,140,12526,17746,30295,0,0,0,1,1
61260,140,12527,17879;18210,30295,0,0,0,2,2
61261,140,12528,17735,30295,0,0,0,1,1
61262,140,12529,17737,30295,0,0,0,1,1
61263,140,12530,17840,30295,0,0,0,1,1
61264,140,12531,17794,30295,0,0,0,1,1
61265,140,12532,17983;21549,30295,0,0,1,1,2
61266,140,12533,17785,30295,0,0,0,1,1
61267,140,12534,17789;17909,30295,0,0,0,2,2
61268,140,12535,17790,30295,0,0,0,1,1
61269,140,12536,17842,30295,0,0,0,1,1
61270,140,12537,17897;17922,30295,0,0,0,2,2
61271,140,12538,17823;17906,30295,0,0,0,2,2
61272,140,12539,18159,30295,0,0,0,1,1
61273,140,12541,17921;17998,30295,0,0,0,2,2
61274,140,12542,17870,30295,0,0,0,1,1
61275,140,12543,17900,30295,0,0,0,1,1
61276,140,12544,17942,30295,0,0,0,1,1
61277,140,12545,18112;18162,30295,0,0,0,2,2
61278,140,12547,18368,30295,0,0,0,1,1
61279,140,12548,17995,30295,0,0,0,1,1
61280,140,12549,17996,30295,0,0,0,1,1
61281,140,12551,17694;18249,30295,0,0,0,2,2
61282,140,12552,18019;18353,30295,0,0,0,2,2
61283,140,12553,17368;18200,30295,0,0,0,2,2
61284,140,12554,18034,30295,0,0,0,1,1
61285,140,12555,17890;18106,30295,0,0,0,2,2
61286,140,12557,18103,30295,0,0,0,1,1
61287,140,12558,17712;18093,30295,0,0,0,2,2
61288,140,12559,17895;18058,30295,0,0,0,2,2
61289,140,12577,15776,30660,0,0,0,1,1
61290,140,12585,15741,30660,0,0,0,1,1
61291,140,12593,16580,30660,0,0,0,1,1
61292,140,12599,16823,30660,0,0,0,1,1
61293,140,12600,16843,30660,0,0,0,1,1
61294,140,12602,16542,30660,0,0,0,1,1
61295,140,12603,17141,30660,0,0,0,1,1
61296,140,12605,16662,30660,0,0,0,1,1
61297,140,12610,17107,30660,0,0,0,1,1
61298,140,12612,18057,30660,0,0,0,1,1
61299,140,12613,17543;17771,30660,0,0,0,2,2
61300,140,12614,18232,30660,0,0,0,1,1
61301,140,12615,18381,30660,0,0,0,1,1
61302,140,12616,17599;18000,30660,0,0,0,2,2
61303,140,12617,17343;17608,30660,0,0,0,2,2
61304,140,12618,17985;18061,30660,0,0,0,2,2
61305,140,12619,17402,30660,0,0,0,1,1
61306,140,12620,17647,30660,0,0,0,1,1
61307,140,12621,18175,30660,0,0,0,1,1
61308,140,12622,17662,30660,0,0,0,1,1
61309,140,12623,17722;17754,30660,0,0,0,2,2
61310,140,12624,17516;18035,30660,0,0,0,2,2
61311,140,12625,17709;17812,30660,0,0,0,2,2
61312,140,12627,18027;22288;25585,30660,0,1,1,1,3
61313,140,12628,18330;23578,30660,0,0,1,1,2
61314,140,12631,18242;22014;24624,30660,0,0,2,1,3
61315,140,12632,17988,30660,0,0,0,1,1
61316,140,12633,17863;18140,30660,0,0,0,2,2
61317,140,12634,18120;18161,30660,0,0,0,2,2
61318,140,12635,18329,30660,0,0,0,1,1
61319,140,12636,17836;17910,30660,0,0,0,2,2
61320,140,12637,18111,30660,0,0,0,1,1
61321,140,12638,17962;18067,30660,0,0,0,2,2
61322,140,12639,18013,30660,0,0,0,1,1
61323,140,12642,23144,30660,0,0,1,0,1
61324,140,12643,17875,30660,0,0,0,1,1
61325,140,12644,18068,30660,0,0,0,1,1
61326,140,12647,18102,30660,0,0,0,1,1
61327,140,12648,17609;18218,30660,0,0,0,2,2
61328,140,12649,17605;18116,30660,0,0,0,2,2
61329,140,12650,18030;18375,30660,0,0,0,2,2
61330,140,12651,18121;18132,30660,0,0,0,2,2
61331,140,12652,18361,30660,0,0,0,1,1
61332,140,12655,18151;18182,30660,0,0,0,2,2
61333,140,12656,17911,30660,0,0,0,1,1
61334,140,12658,17788;18224,30660,0,0,0,2,2
61335,140,12706,17104;17149,31025,0,0,0,2,2
61336,140,12713,17345,31025,0,0,0,1,1
61337,140,12715,17176,31025,0,0,0,1,1
61338,140,12716,17185;17381,31025,0,0,0,2,2
61339,140,12719,18046,31025,0,0,0,1,1
61340,140,12720,17984,31025,0,0,0,1,1
61341,140,12721,17503;18152;21700,31025,0,0,1,2,3
61342,140,12722,17929,31025,0,0,0,1,1
61343,140,12723,17640,31025,0,0,0,1,1
61344,140,12724,18209;18713,31025,0,0,0,2,2
61345,140,12725,17720;18277,31025,0,0,0,2,2
61346,140,12726,17940,31025,0,0,0,1,1
61347,140,12727,17978;18100,31025,0,0,0,2,2
61348,140,12728,17948,31025,0,0,0,1,1
61349,140,12729,17561;18091;21972,31025,0,0,1,2,3
61350,140,12730,17778;17959,31025,0,0,0,2,2
61351,140,12732,17850;17976,31025,0,0,0,2,2
61352,140,12733,17873;18009,31025,0,0,0,2,2
61353,140,12734,18515,31025,0,0,0,1,1
61354,140,12735,17792;17941,31025,0,0,0,2,2
61355,140,12736,17355;17951,31025,0,0,0,2,2
61356,140,12737,18157,31025,0,0,0,1,1
61357,140,12739,17718;17967,31025,0,0,0,2,2
61358,140,12740,18197,31025,0,0,0,1,1
61359,140,12741,17716,31025,0,0,0,1,1
61360,140,12742,18126,31025,0,0,0,1,1
61361,140,12743,18097,31025,0,0,0,1,1
61362,140,12744,18357,31025,0,0,0,1,1
61363,140,12745,18156;18226;21576;24828,31025,0,1,1,2,4
61364,140,12746,18167,31025,0,0,0,1,1
61365,140,12747,18195;18291,31025,0,0,0,2,2
61366,140,12748,17990;18199,31025,0,0,0,2,2
61367,140,12749,18221;18250,31025,0,0,0,2,2
61368,140,12750,18237;18592,31025,0,0,0,2,2
61369,140,12751,18047;18255,31025,0,0,0,2,2
61370,140,12752,17981;18279,31025,0,0,0,2,2
61371,140,12753,18272,31025,0,0,0,1,1
61372,140,12754,18445,31025,0,0,0,1,1
61373,140,12755,18518;18576,31025,0,0,0,2,2
61374,140,12756,18294;18505,31025,0,0,0,2,2
61375,140,12757,18086;18302;21095,31025,0,0,1,2,3
61376,140,12799,16113,31390,0,0,0,1,1
61377,140,12803,16361,31390,0,0,0,1,1
61378,140,12805,17087,31390,0,0,0,1,1
61379,140,12810,16781,31390,0,0,0,1,1
61380,140,12813,17299,31390,0,0,0,1,1
61381,140,12818,17688;18180,31390,0,0,0,2,2
61382,140,12820,17796;17957,31390,0,0,0,2,2
61383,140,12821,16959;17358,31390,0,0,0,2,2
61384,140,12825,16956;17431,31390,0,0,0,2,2
61385,140,12826,17540;17919,31390,0,0,0,2,2
61386,140,12828,17390;17834,31390,0,0,0,2,2
61387,140,12829,17623,31390,0,0,0,1,1
61388,140,12830,18025;18164,31390,0,0,0,2,2
61389,140,12831,18208,31390,0,0,0,1,1
61390,140,12832,17719;17786,31390,0,0,0,2,2
61391,140,12833,17871;18171,31390,0,0,0,2,2
61392,140,12834,17441;18028,31390,0,0,0,2,2
61393,140,12836,17946,31390,0,0,0,1,1
61394,140,12837,18194;18392,31390,0,0,0,2,2
61395,140,12838,17891,31390,0,0,0,1,1
61396,140,12839,18188,31390,0,0,0,1,1
61397,140,12840,18326;18656,31390,0,0,0,2,2
61398,140,12841,18055,31390,0,0,0,1,1
61399,140,12842,18064,31390,0,0,0,1,1
61400,140,12843,18016,31390,0,0,0,1,1
61401,140,12844,17665;18155,31390,0,0,0,2,2
61402,140,12846,18130;18390,31390,0,0,0,2,2
61403,140,12847,18007;18179,31390,0,0,0,2,2
61404,140,12848,17601,31390,0,0,0,1,1
61405,140,12849,18436;18465,31390,0,0,0,2,2
61406,140,12850,18265,31390,0,0,0,1,1
61407,140,12851,18566,31390,0,0,0,1,1
61408,140,12852,18193;18246,31390,0,0,0,2,2
61409,140,12853,18147;18192,31390,0,0,0,2,2
61410,140,12854,18270,31390,0,0,0,1,1
61411,140,12855,18290,31390,0,0,0,1,1
61412,140,12856,18446;18694,31390,0,0,0,2,2
61413,140,12857,18367;18391,31390,0,0,0,2,2
61414,140,12858,18712,31390,0,0,0,1,1
61415,140,12859,18331,31390,0,0,0,1,1
61416,140,12862,17865;18342,31390,0,0,0,2,2
61417,140,12863,18346,31390,0,0,0,1,1
61418,140,12865,18088;18369,31390,0,0,0,2,2
61419,140,12867,18258;18386,31390,0,0,0,2,2
61420,140,12910,17030,31755,0,0,0,1,1
61421,140,12913,17522,31755,0,0,0,1,1
61422,140,12917,17262;17396,31755,0,0,0,2,2
61423,140,12918,17576,31755,0,0,0,1,1
61424,140,12919,17192;17454,31755,0,0,0,2,2
61425,140,12920,17506;17810,31755,0,0,0,2,2
61426,140,12922,17555;17595,31755,0,0,0,2,2
61427,140,12923,17356,31755,0,0,0,1,1
61428,140,12924,17811,31755,0,0,0,1,1
61429,140,12925,17526,31755,0,0,0,1,1
61430,140,12926,17760;17958,31755,0,0,0,2,2
61431,140,12927,17956;18323,31755,0,0,0,2,2
61432,140,12928,17798,31755,0,0,0,1,1
61433,140,12929,18014;18023,31755,0,0,0,2,2
61434,140,12931,18006;18105,31755,0,0,0,2,2
61435,140,12932,18012;18740,31755,0,0,0,2,2
61436,140,12933,18018;18113,31755,0,0,0,2,2
61437,140,12934,18710,31755,0,0,0,1,1
61438,140,12935,18332,31755,0,0,0,1,1
61439,140,12936,18563,31755,0,0,0,1,1
61440,140,12937,18457,31755,0,0,0,1,1
61441,140,12938,18154;18621,31755,0,0,0,2,2
61442,140,12939,18158,31755,0,0,0,1,1
61443,140,12940,17625;18173,31755,0,0,0,2,2
61444,140,12941,18118;18840,31755,0,0,0,2,2
61445,140,12942,18252,31755,0,0,0,1,1
61446,140,12943,18128;18266,31755,0,0,0,2,2
61447,140,12944,18305,31755,0,0,0,1,1
61448,140,12945,18256;18273,31755,0,0,0,2,2
61449,140,12946,18276;18300,31755,0,0,0,2,2
61450,140,12947,18285;18802,31755,0,0,0,2,2
61451,140,12948,18225;18698,31755,0,0,0,2,2
61452,140,12949,18303,31755,0,0,0,1,1
61453,140,12950,17693;18395,31755,0,0,0,2,2
61454,140,12951,18396;18717,31755,0,0,0,2,2
61455,140,12952,17889;18486;22011,31755,0,0,1,2,3
61456,140,12953,18425;21929,31755,0,0,1,1,2
61457,140,12954,18426,31755,0,0,0,1,1
61458,140,12955,18328,31755,0,0,0,1,1
61459,140,12956,18434,31755,0,0,0,1,1
61460,140,12957,18577,31755,0,0,0,1,1
61461,140,12959,18149;18513,31755,0,0,0,2,2
61462,140,12961,18779;18861;23371,31755,0,0,1,2,3
61463,140,12962,18437;18527,31755,0,0,0,2,2
61464,140,13008,17226,32120,0,0,0,1,1
61465,140,13015,17475,32120,0,0,0,1,1
61466,140,13019,18150;18166,32120,0,0,0,2,2
61467,140,13020,18129,32120,0,0,0,1,1
61468,140,13025,17975,32120,0,0,0,1,1
61469,140,13026,18148,32120,0,0,0,1,1
61470,140,13027,17896,32120,0,0,0,1,1
61471,140,13028,17770;17987,32120,0,0,0,2,2
61472,140,13029,18263,32120,0,0,0,1,1
61473,140,13030,18045,32120,0,0,0,1,1
61474,140,13032,18095;18359,32120,0,0,0,2,2
61475,140,13033,17833;18257,32120,0,0,0,2,2
61476,140,13036,18746,32120,0,0,0,1,1
61477,140,13037,18502,32120,0,0,0,1,1
61478,140,13038,18562;18784,32120,0,0,0,2,2
61479,140,13039,18228,32120,0,0,0,1,1
61480,140,13040,18702;18829,32120,0,0,0,2,2
61481,140,13041,18355,32120,0,0,0,1,1
61482,140,13042,18356;18380,32120,0,0,0,2,2
61483,140,13043,18135,32120,0,0,0,1,1
61484,140,13044,18288;18634;21596,32120,0,0,1,2,3
61485,140,13045,18281;18413,32120,0,0,0,2,2
61486,140,13046,18040;18421,32120,0,0,0,2,2
61487,140,13047,18428;18611,32120,0,0,0,2,2
61488,140,13048,18347;18821,32120,0,0,0,2,2
61489,140,13049,18364;18699,32120,0,0,0,2,2
61490,140,13051,18453;18550,32120,0,0,0,2,2
61491,140,13052,17710;18478,32120,0,0,0,2,2
61492,140,13053,18519,32120,0,0,0,1,1
61493,140,13055,18533;18583,32120,0,0,0,2,2
61494,140,13056,18405;18560,32120,0,0,0,2,2
61495,140,13057,18785;18971;23271,32120,0,0,1,2,3
61496,140,13058,18685;18790,32120,0,0,0,2,2
61497,140,13059,18578;18686,32120,0,0,0,2,2
61498,140,13061,18614;18772,32120,0,0,0,2,2
61499,140,13062,18201;18594,32120,0,0,0,2,2
61500,140,13079,15291,32485,0,0,0,1,1
61501,140,13103,16545,32485,0,0,0,1,1
61502,140,13108,17452,32485,0,0,0,1,1
61503,140,13110,17661,32485,0,0,0,1,1
61504,140,13112,17416;17590,32485,0,0,0,2,2
61505,140,13113,17732,32485,0,0,0,1,1
61506,140,13114,17587,32485,0,0,0,1,1
61507,140,13116,17698,32485,0,0,0,1,1
61508,140,13122,18072,32485,0,0,0,1,1
61509,140,13123,18054;18212,32485,0,0,0,2,2
61510,140,13124,18022,32485,0,0,0,1,1
61511,140,13125,17730;17964,32485,0,0,0,2,2
61512,140,13126,18021,32485,0,0,0,1,1
61513,140,13127,18032;18039;22183,32485,0,0,1,2,3
61514,140,13128,18467;18789,32485,0,0,0,2,2
61515,140,13129,18404,32485,0,0,0,1,1
61516,140,13130,18133;18744;22039,32485,0,0,1,2,3
61517,140,13131,18248,32485,0,0,0,1,1
61518,140,13133,18309,32485,0,0,0,1,1
61519,140,13134,18163,32485,0,0,0,1,1
61520,140,13136,18011;18334,32485,0,0,0,2,2
61521,140,13138,18575,32485,0,0,0,1,1
61522,140,13139,18910,32485,0,0,0,1,1
61523,140,13140,18438,32485,0,0,0,1,1
61524,140,13141,18477;18769,32485,0,0,0,2,2
61525,140,13142,18219;18479,32485,0,0,0,2,2
61526,140,13143,18915,32485,0,0,0,1,1
61527,140,13144,17856;18491,32485,0,0,0,2,2
61528,140,13145,18676,32485,0,0,0,1,1
61529,140,13147,18510,32485,0,0,0,1,1
61530,140,13149,18481;18520,32485,0,0,0,2,2
61531,140,13151,18951,32485,0,0,0,1,1
61532,140,13152,18393,32485,0,0,0,1,1
61533,140,13153,18723;18968,32485,0,0,0,2,2
61534,140,13154,18941,32485,0,0,0,1,1
61535,140,13155,18747;18877,32485,0,0,0,2,2
61536,140,13158,18778;19101,32485,0,0,0,2,2
61537,140,13159,18662,32485,0,0,0,1,1
61538,140,13160,18683;18714,32485,0,0,0,2,2
61539,140,13161,18187;18574,32485,0,0,0,2,2
61540,140,13162,18727;19057,32485,0,0,0,2,2
61541,140,13163,18739;19090,32485,0,0,0,2,2
61542,140,13164,18964;19201,32485,0,0,0,2,2
61543,140,13187,16148,32850,0,0,0,1,1
61544,140,13192,16527,32850,0,0,0,1,1
61545,140,13203,17002,32850,0,0,0,1,1
61546,140,13206,17379,32850,0,0,0,1,1
61547,140,13210,17493,32850,0,0,0,1,1
61548,140,13211,17886;18026,32850,0,0,0,2,2
61549,140,13214,17678;18205,32850,0,0,0,2,2
61550,140,13216,18198;18320,32850,0,0,0,2,2
61551,140,13217,17816;18315,32850,0,0,0,2,2
61552,140,13218,17892;18211;22507,32850,0,0,1,2,3
61553,140,13219,17923,32850,0,0,0,1,1
61554,140,13220,18104;18498,32850,0,0,0,2,2
61555,140,13222,17973;18403,32850,0,0,0,2,2
61556,140,13224,17621;18001,32850,0,0,0,2,2
61557,140,13225,17954;18033,32850,0,0,0,2,2
61558,140,13226,18076,32850,0,0,0,1,1
61559,140,13227,18238;18275,32850,0,0,0,2,2
61560,140,13228,18069;18074,32850,0,0,0,2,2
61561,140,13229,18644,32850,0,0,0,1,1
61562,140,13231,18591,32850,0,0,0,1,1
61563,140,13232,17894;18282,32850,0,0,0,2,2
61564,140,13234,18310,32850,0,0,0,1,1
61565,140,13236,18362,32850,0,0,0,1,1
61566,140,13237,18366;18483,32850,0,0,0,2,2
61567,140,13238,18516;18586,32850,0,0,0,2,2
61568,140,13239,18239;18433,32850,0,0,0,2,2
61569,140,13240,18415;19038,32850,0,0,0,2,2
61570,140,13241,18567;18811,32850,0,0,0,2,2
61571,140,13243,18490;22450,32850,0,0,1,1,2
61572,140,13244,18254;18525,32850,0,0,0,2,2
61573,140,13245,18292;18962,32850,0,0,0,2,2
61574,140,13246,18570,32850,0,0,0,1,1
61575,140,13248,18352;18599,32850,0,0,0,2,2
61576,140,13249,18793,32850,0,0,0,1,1
61577,140,13250,18627;18692,32850,0,0,0,2,2
61578,140,13251,18890,32850,0,0,0,1,1
61579,140,13252,18671,32850,0,0,0,1,1
61580,140,13253,18638;18952,32850,0,0,0,2,2
61581,140,13254,18680,32850,0,0,0,1,1
61582,140,13255,18682,32850,0,0,0,1,1
61583,140,13256,18571;18651,32850,0,0,0,2,2
61584,140,13257,18556;18963;23469,32850,0,0,1,2,3
61585,140,13258,18690;19006;23153;25722;26449,32850,1,1,1,2,5
61586,140,13259,18715,32850,0,0,0,1,1
61587,140,13260,18766,32850,0,0,0,1,1
61588,140,13261,18770,32850,0,0,0,1,1
61589,140,13262,18774;19206,32850,0,0,0,2,2
61590,140,13263,18745;18823,32850,0,0,0,2,2
61591,140,13264,18846;18980,32850,0,0,0,2,2
61592,140,13265,18853;19151,32850,0,0,0,2,2
61593,140,13266,18507;18849,32850,0,0,0,2,2
61594,140,13280,15190,33215,0,0,0,1,1
61595,140,13305,17199;17321,33215,0,0,0,2,2
61596,140,13308,18231,33215,0,0,0,1,1
61597,140,13309,17531;17854,33215,0,0,0,2,2
61598,140,13311,18344;18410,33215,0,0,0,2,2
61599,140,13313,18044;18371,33215,0,0,0,2,2
61600,140,13315,18060,33215,0,0,0,1,1
61601,140,13316,18243;18253,33215,0,0,0,2,2
61602,140,13317,18264,33215,0,0,0,1,1
61603,140,13318,18283;18564,33215,0,0,0,2,2
61604,140,13319,18604,33215,0,0,0,1,1
61605,140,13320,18340;18788,33215,0,0,0,2,2
61606,140,13322,18927;19010;22953,33215,0,0,1,2,3
61607,140,13323,18416,33215,0,0,0,1,1
61608,140,13324,18547;19021,33215,0,0,0,2,2
61609,140,13325,18451;18625,33215,0,0,0,2,2
61610,140,13326,18654,33215,0,0,0,1,1
61611,140,13328,18524;18617,33215,0,0,0,2,2
61612,140,13331,18645;18836,33215,0,0,0,2,2
61613,140,13332,19125,33215,0,0,0,1,1
61614,140,13333,18707;18848,33215,0,0,0,2,2
61615,140,13334,18873;19275;22778,33215,0,0,1,2,3
61616,140,13335,18902;18935,33215,0,0,0,2,2
61617,140,13336,18750;18929,33215,0,0,0,2,2
61618,140,13337,19309;19315,33215,0,0,0,2,2
61619,140,13338,18764;19121,33215,0,0,0,2,2
61620,140,13339,18630;18914,33215,0,0,0,2,2
61621,140,13340,18780,33215,0,0,0,1,1
61622,140,13342,18794,33215,0,0,0,1,1
61623,140,13343,19009;19027,33215,0,0,0,2,2
61624,140,13344,19233,33215,0,0,0,1,1
61625,140,13345,18923;19087,33215,0,0,0,2,2
61626,140,13346,19168;19369,33215,0,0,0,2,2
61627,140,13347,18835;18875;23268,33215,0,0,1,2,3
61628,140,13348,18886,33215,0,0,0,1,1
61629,140,13349,18900;18928,33215,0,0,0,2,2
61630,140,13350,18913;18965,33215,0,0,0,2,2
61631,140,13351,18891;18957;23152,33215,0,0,1,2,3
61632,140,13352,18981,33215,0,0,0,1,1
61633,140,13395,17055,33580,0,0,0,1,1
61634,140,13407,18015;18261,33580,0,0,0,2,2
61635,140,13408,17314,33580,0,0,0,1,1
61636,140,13410,17627;18312,33580,0,0,0,2,2
61637,140,13413,18020,33580,0,0,0,1,1
61638,140,13418,18038,33580,0,0,0,1,1
61639,140,13420,17902,33580,0,0,0,1,1
61640,140,13421,17845,33580,0,0,0,1,1
61641,140,13422,18183,33580,0,0,0,1,1
61642,140,13425,18229,33580,0,0,0,1,1
61643,140,13426,18304,33580,0,0,0,1,1
61644,140,13428,18314,33580,0,0,0,1,1
61645,140,13429,18474;18565,33580,0,0,0,2,2
61646,140,13430,18082;18373,33580,0,0,0,2,2
61647,140,13431,18053;18440,33580,0,0,0,2,2
61648,140,13432,18870;18897,33580,0,0,0,2,2
61649,140,13433,18506;18868;22342,33580,0,0,1,2,3
61650,140,13434,18514;18588,33580,0,0,0,2,2
61651,140,13435,18531;18834,33580,0,0,0,2,2
61652,140,13436,18561;18606,33580,0,0,0,2,2
61653,140,13437,18569;19392,33580,0,0,0,2,2
61654,140,13438,18892,33580,0,0,0,1,1
61655,140,13439,18607;19041,33580,0,0,0,2,2
61656,140,13440,18748;18812,33580,0,0,0,2,2
61657,140,13441,19124;22657,33580,0,0,1,1,2
61658,140,13442,18783;19354,33580,0,0,0,2,2
61659,140,13443,18810;19269,33580,0,0,0,2,2
61660,140,13444,18833;19188;22641;26229;26331,33580,2,0,1,2,5
61661,140,13445,18220;18867,33580,0,0,0,2,2
61662,140,13446,18893;18954,33580,0,0,0,2,2
61663,140,13447,18904;19282,33580,0,0,0,2,2
61664,140,13448,18759;18907;23370,33580,0,0,1,2,3
61665,140,13449,18504;18918,33580,0,0,0,2,2
61666,140,13450,18934,33580,0,0,0,1,1
61667,140,13451,18939;18988,33580,0,0,0,2,2
61668,140,13452,18943;19298,33580,0,0,0,2,2
61669,140,13453,19217;19325,33580,0,0,0,2,2
61670,140,13454,19070,33580,0,0,0,1,1
61671,140,13456,19013,33580,0,0,0,1,1
61672,140,13457,19092;19242;23275,33580,0,0,1,2,3
61673,140,13458,18818;19017,33580,0,0,0,2,2
61674,140,13459,19035,33580,0,0,0,1,1
61675,140,13461,19093;19366,33580,0,0,0,2,2
61676,140,13462,19104;19435;21354;24592,33580,0,0,2,2,4
61677,140,13496,17174,33945,0,0,0,1,1
61678,140,13499,17415,33945,0,0,0,1,1
61679,140,13502,17459;17676,33945,0,0,0,2,2
61680,140,13505,17876,33945,0,0,0,1,1
61681,140,13506,17502;17600,33945,0,0,0,2,2
61682,140,13508,17809,33945,0,0,0,1,1
61683,140,13509,18493,33945,0,0,0,1,1
61684,140,13510,17273;17691,33945,0,0,0,2,2
61685,140,13511,17814,33945,0,0,0,1,1
61686,140,13512,18454,33945,0,0,0,1,1
61687,140,13514,18115;18327,33945,0,0,0,2,2
61688,140,13515,18724,33945,0,0,0,1,1
61689,140,13516,17979,33945,0,0,0,1,1
61690,140,13517,18319;18447,33945,0,0,0,2,2
61691,140,13518,18488,33945,0,0,0,1,1
61692,140,13519,18325,33945,0,0,0,1,1
61693,140,13520,18085;18401,33945,0,0,0,2,2
61694,140,13521,18190;18414,33945,0,0,0,2,2
61695,140,13522,18455;18767;21614,33945,0,0,1,2,3
61696,140,13526,18521,33945,0,0,0,1,1
61697,140,13527,18542;18544,33945,0,0,0,2,2
61698,140,13528,18554,33945,0,0,0,1,1
61699,140,13529,17849;18080,33945,0,0,0,2,2
61700,140,13530,18537;18585,33945,0,0,0,2,2
61701,140,13531,18031;18589,33945,0,0,0,2,2
61702,140,13533,18489;18608,33945,0,0,0,2,2
61703,140,13534,18623,33945,0,0,0,1,1
61704,140,13536,18600;18956,33945,0,0,0,2,2
61705,140,13537,18530;18950,33945,0,0,0,2,2
61706,140,13539,17903;18758;23466,33945,0,0,1,2,3
61707,140,13540,18775,33945,0,0,0,1,1
61708,140,13541,19302;19318,33945,0,0,0,2,2
61709,140,13543,18771,33945,0,0,0,1,1
61710,140,13544,18806;19195,33945,0,0,0,2,2
61711,140,13545,18466;18970,33945,0,0,0,2,2
61712,140,13546,18917,33945,0,0,0,1,1
61713,140,13547,18587;18858,33945,0,0,0,2,2
61714,140,13548,18860;19073,33945,0,0,0,2,2
61715,140,13549,19172,33945,0,0,0,1,1
61716,140,13550,19279;19400,33945,0,0,0,2,2
61717,140,13551,19050,33945,0,0,0,1,1
61718,140,13552,19018;19111;21696;24837;25360,33945,0,2,1,2,5
61719,140,13553,18924;19007,33945,0,0,0,2,2
61720,140,13554,18541;18944,33945,0,0,0,2,2
61721,140,13556,18978,33945,0,0,0,1,1
61722,140,13557,18482;19002,33945,0,0,0,2,2
61723,140,13558,19019;19065,33945,0,0,0,2,2
61724,140,13559,19024,33945,0,0,0,1,1
61725,140,13561,19228;19376;21999,33945,0,0,1,2,3
61726,140,13562,18854;18982,33945,0,0,0,2,2
61727,140,13563,19080;19391;23082,33945,0,0,1,2,3
61728,140,13564,19084,33945,0,0,0,1,1
61729,140,13565,18933;19086,33945,0,0,0,2,2
61730,140,13566,18679;19096,33945,0,0,0,2,2
61731,140,13567,18997;19098,33945,0,0,0,2,2
61732,140,13568,18809;19099;23156,33945,0,0,1,2,3
61733,140,13569,18730;19427,33945,0,0,0,2,2
61734,140,13570,19067;19115;24013,33945,0,0,1,2,3
61735,140,13571,19141;19464,33945,0,0,1,1,2
61736,140,13572,19142;19378;23384,33945,0,0,1,2,3
61737,140,13573,18813,33945,0,0,0,1,1
61738,140,13574,18731;19434,33945,0,0,0,2,2
61739,140,13575,19550,33945,0,0,1,0,1
61740,140,13599,16313,34310,0,0,0,1,1
61741,140,13604,16911;17008,34310,0,0,0,2,2
61742,140,13609,16626,34310,0,0,0,1,1
61743,140,13610,17246,34310,0,0,0,1,1
61744,140,13611,17169,34310,0,0,0,1,1
61745,140,13612,17027;17404,34310,0,0,0,2,2
61746,140,13616,17473,34310,0,0,0,1,1
61747,140,13618,17799;17805,34310,0,0,0,2,2
61748,140,13619,18137,34310,0,0,0,1,1
61749,140,13621,18079,34310,0,0,0,1,1
61750,140,13622,17974;18153,34310,0,0,0,2,2
61751,140,13623,17955,34310,0,0,0,1,1
61752,140,13624,17826;17992,34310,0,0,0,2,2
61753,140,13627,17806,34310,0,0,0,1,1
61754,140,13628,18402;18534,34310,0,0,0,2,2
61755,140,13629,18363,34310,0,0,0,1,1
61756,140,13631,18528,34310,0,0,0,1,1
61757,140,13632,18297,34310,0,0,0,1,1
61758,140,13633,18073,34310,0,0,0,1,1
61759,140,13634,18670,34310,0,0,0,1,1
61760,140,13635,18376,34310,0,0,0,1,1
61761,140,13638,18642,34310,0,0,0,1,1
61762,140,13639,18647,34310,0,0,0,1,1
61763,140,13640,18659,34310,0,0,0,1,1
61764,140,13642,18942;19030,34310,0,0,0,2,2
61765,140,13644,18372;18741,34310,0,0,0,2,2
61766,140,13645,19083;19103,34310,0,0,0,2,2
61767,140,13647,18830;18889,34310,0,0,0,2,2
61768,140,13648,18464;18814;22742,34310,0,0,1,2,3
61769,140,13649,19197;19230,34310,0,0,0,2,2
61770,140,13651,18839;18911,34310,0,0,0,2,2
61771,140,13652,19211;19280,34310,0,0,0,2,2
61772,140,13653,19129,34310,0,0,0,1,1
61773,140,13655,19537,34310,0,0,1,0,1
61774,140,13656,18708;19036,34310,0,0,0,2,2
61775,140,13658,18985;19053,34310,0,0,0,2,2
61776,140,13659,19016;19117,34310,0,0,0,2,2
61777,140,13660,18760;19039,34310,0,0,0,2,2
61778,140,13662,19051;19289,34310,0,0,0,2,2
61779,140,13663,19163,34310,0,0,0,1,1
61780,140,13664,18991;19061,34310,0,0,0,2,2
61781,140,13665,18932;19131,34310,0,0,0,2,2
61782,140,13666,19381,34310,0,0,0,1,1
61783,140,13667,19108;19398,34310,0,0,0,2,2
61784,140,13669,19138;19145,34310,0,0,0,2,2
61785,140,13670,19159;19221,34310,0,0,0,2,2
61786,140,13671,19004;19169;23894,34310,0,0,1,2,3
61787,140,13672,18768;19425,34310,0,0,0,2,2
61788,140,13673,19411;19564,34310,0,0,1,1,2
61789,140,13674,18885;19209,34310,0,0,0,2,2
61790,140,13675,19120;19216,34310,0,0,0,2,2
61791,140,13676,19667,34310,0,0,1,0,1
61792,140,13677,19081;19448;23685,34310,0,0,2,1,3
61793,140,13679,19518;19522,34310,0,0,2,0,2
61794,140,13680,19167,34310,0,0,0,1,1
61795,140,13709,18480,34675,0,0,0,1,1
61796,140,13710,17669,34675,0,0,0,1,1
61797,140,13711,18543,34675,0,0,0,1,1
61798,140,13712,18317;18408,34675,0,0,0,2,2
61799,140,13717,18476;18582,34675,0,0,0,2,2
61800,140,13718,18598,34675,0,0,0,1,1
61801,140,13719,18631,34675,0,0,0,1,1
61802,140,13721,18695;18938,34675,0,0,0,2,2
61803,140,13722,18449;18703,34675,0,0,0,2,2
61804,140,13723,18729;18736,34675,0,0,0,2,2
61805,140,13725,18820;19374,34675,0,0,0,2,2
61806,140,13726,19219;19365,34675,0,0,0,2,2
61807,140,13727,19258;19718,34675,0,0,1,1,2
61808,140,13729,18856,34675,0,0,0,1,1
61809,140,13730,18593;18862,34675,0,0,0,2,2
61810,140,13731,19126;19270;23070,34675,0,0,1,2,3
61811,140,13732,18961;18975;23057,34675,0,0,1,2,3
61812,140,13733,18973;18986,34675,0,0,0,2,2
61813,140,13734,18901,34675,0,0,0,1,1
61814,140,13735,19068;19220,34675,0,0,0,2,2
61815,140,13736,19503,34675,0,0,1,0,1
61816,140,13737,19114;23472,34675,0,0,1,1,2
61817,140,13738,19147;19379;23385,34675,0,0,1,2,3
61818,140,13739,19088;19158,34675,0,0,0,2,2
61819,140,13740,19438;19900;22783;22984,34675,0,0,3,1,4
61820,140,13741,19397;19507,34675,0,0,1,1,2
61821,140,13742,19512;22683;25961,34675,0,1,2,0,3
61822,140,13743,19082;19278,34675,0,0,0,2,2
61823,140,13745,19113;19307,34675,0,0,0,2,2
61824,140,13746,19332;23164;26254;26359,34675,2,0,1,1,4
61825,140,13747,19353;19554,34675,0,0,1,1,2
61826,140,13748,18878,34675,0,0,0,1,1
61827,140,13749,19429;19433,34675,0,0,0,2,2
61828,140,13760,15523,35040,0,0,0,1,1
61829,140,13771,16182,35040,0,0,0,1,1
61830,140,13793,18066,35040,0,0,0,1,1
61831,140,13797,18343,35040,0,0,0,1,1
61832,140,13799,18213;18311,35040,0,0,0,2,2
61833,140,13803,22097;22555;22947;23146;24863;24980;25721,35040,0,3,4,0,7
61834,140,13804,18458,35040,0,0,0,1,1
61835,140,13805,18191,35040,0,0,0,1,1
61836,140,13806,18222;18432,35040,0,0,0,2,2
61837,140,13807,18271;18622,35040,0,0,0,2,2
61838,140,13811,18322;18470,35040,0,0,0,2,2
61839,140,13812,18077;22938,35040,0,0,1,1,2
61840,140,13814,18546,35040,0,0,0,1,1
61841,140,13815,19199;19229,35040,0,0,0,2,2
61842,140,13816,18925,35040,0,0,0,1,1
61843,140,13817,18602,35040,0,0,0,1,1
61844,140,13818,18722,35040,0,0,0,1,1
61845,140,13819,18763;19268,35040,0,0,0,2,2
61846,140,13820,18787;19077,35040,0,0,0,2,2
61847,140,13821,18845;19160,35040,0,0,0,2,2
61848,140,13823,18613;18920,35040,0,0,0,2,2
61849,140,13824,19521,35040,0,0,1,0,1
61850,140,13825,18979;19246,35040,0,0,0,2,2
61851,140,13826,18989;19154,35040,0,0,0,2,2
61852,140,13827,19011,35040,0,0,0,1,1
61853,140,13828,19288;19360,35040,0,0,0,2,2
61854,140,13829,18976;19042,35040,0,0,0,2,2
61855,140,13830,19226;19494,35040,0,0,1,1,2
61856,140,13831,18872;19049,35040,0,0,0,2,2
61857,140,13832,19074;22761,35040,0,0,1,1,2
61858,140,13833,18535;19112,35040,0,0,0,2,2
61859,140,13834,19063;19638,35040,0,0,1,1,2
61860,140,13835,19612,35040,0,0,1,0,1
61861,140,13836,18847;19196,35040,0,0,0,2,2
61862,140,13837,19388,35040,0,0,0,1,1
61863,140,13838,18603;19213,35040,0,0,0,2,2
61864,140,13839,19181;19244,35040,0,0,0,2,2
61865,140,13840,19273;19865,35040,0,0,1,1,2
61866,140,13841,19277;19495,35040,0,0,1,1,2
61867,140,13842,19286;19382;23783,35040,0,0,1,2,3
61868,140,13844,19224;19293,35040,0,0,0,2,2
61869,140,13845,18832;19303,35040,0,0,0,2,2
61870,140,13846,19107,35040,0,0,0,1,1
61871,140,13847,18837;19317,35040,0,0,0,2,2
61872,140,13849,19294;19350,35040,0,0,0,2,2
61873,140,13850,19119;19352,35040,0,0,0,2,2
61874,140,13851,19214,35040,0,0,0,1,1
61875,140,13852,19803;19853,35040,0,0,2,0,2
61876,140,13853,18999;19561,35040,0,0,1,1,2
61877,140,13854,19492;19781,35040,0,0,2,0,2
61878,140,13855,19652;19837,35040,0,0,2,0,2
61879,140,13858,19540;19675,35040,0,0,2,0,2
61880,140,13859,19472;19757,35040,0,0,2,0,2
61881,140,13860,19474;19748;23175,35040,0,0,3,0,3
61882,140,13861,19767,35040,0,0,1,0,1
61883,140,13862,19450;19846,35040,0,0,2,0,2
61884,140,13863,19407;19491,35040,0,0,1,1,2
61885,140,13864,19396;19529,35040,0,0,1,1,2
61886,140,13865,19535;19619,35040,0,0,2,0,2
61887,140,13886,16601;16826,35405,0,0,0,2,2
61888,140,13905,17970,35405,0,0,0,1,1
61889,140,13908,18017,35405,0,0,0,1,1
61890,140,13910,18230;18236,35405,0,0,0,2,2
61891,140,13911,18244;18374,35405,0,0,0,2,2
61892,140,13912,18398;18619,35405,0,0,0,2,2
61893,140,13915,18117;23150,35405,0,0,1,1,2
61894,140,13918,18388;18538,35405,0,0,0,2,2
61895,140,13919,18517,35405,0,0,0,1,1
61896,140,13920,18532;18757,35405,0,0,0,2,2
61897,140,13921,18553;19044,35405,0,0,0,2,2
61898,140,13922,18579;19094,35405,0,0,0,2,2
61899,140,13924,18624;18718;21962,35405,0,0,1,2,3
61900,140,13925,18626;18657,35405,0,0,0,2,2
61901,140,13926,18629;19223,35405,0,0,0,2,2
61902,140,13927,18735,35405,0,0,0,1,1
61903,140,13928,18796;19287;22665;23583;25996;26475,35405,1,1,2,2,6
61904,140,13932,18549,35405,0,0,0,1,1
61905,140,13933,18958;19156,35405,0,0,0,2,2
61906,140,13935,19444,35405,0,0,1,0,1
61907,140,13936,18851;19037,35405,0,0,0,2,2
61908,140,13938,19204;19356,35405,0,0,0,2,2
61909,140,13939,19412;19654,35405,0,0,1,1,2
61910,140,13940,18863,35405,0,0,0,1,1
61911,140,13941,19132,35405,0,0,0,1,1
61912,140,13942,18732;19283;23780;24005,35405,0,0,2,2,4
61913,140,13943,18637;19192;22556,35405,0,0,1,2,3
61914,140,13945,18987;19231,35405,0,0,0,2,2
61915,140,13946,19100;19254,35405,0,0,0,2,2
61916,140,13947,19025;19285,35405,0,0,0,2,2
61917,140,13948,19656;24011,35405,0,0,2,0,2
61918,140,13949,19422,35405,0,0,0,1,1
61919,140,13950,19266;19370,35405,0,0,0,2,2
61920,140,13951,19166;19368,35405,0,0,0,2,2
61921,140,13952,19203;19578,35405,0,0,1,1,2
61922,140,13953,19431;19882;23601,35405,0,0,2,1,3
61923,140,13954,19758;19990;23705,35405,0,0,3,0,3
61924,140,13955,19417,35405,0,0,0,1,1
61925,140,13957,18909;19238,35405,0,0,0,2,2
61926,140,13958,19306;19679,35405,0,0,1,1,2
61927,140,13960,19684;19753,35405,0,0,2,0,2
61928,140,13961,19326;19568,35405,0,0,1,1,2
61929,140,13962,19577;23292,35405,0,0,2,0,2
61930,140,13963,19064;19581,35405,0,0,1,1,2
61931,140,13964,19611;20119,35405,0,0,2,0,2
61932,140,13965,19548;19641,35405,0,0,2,0,2
61933,140,13967,19836;19993;24428;24531,35405,0,0,4,0,4
61934,140,13968,19680;19889,35405,0,0,2,0,2
61935,140,13992,16400;16586,35770,0,0,0,2,2
61936,140,14004,17277;17374,35770,0,0,0,2,2
61937,140,14009,17553,35770,0,0,0,1,1
61938,140,14011,17852;18487,35770,0,0,0,2,2
61939,140,14012,17931;18335,35770,0,0,0,2,2
61940,140,14021,18383;18444,35770,0,0,0,2,2
61941,140,14023,18241;18450,35770,0,0,0,2,2
61942,140,14024,18307;18494,35770,0,0,0,2,2
61943,140,14027,18612;19072,35770,0,0,0,2,2
61944,140,14028,18293;18781,35770,0,0,0,2,2
61945,140,14029,19045;19264,35770,0,0,0,2,2
61946,140,14030,19047;19186;22659;26132,35770,1,0,1,2,4
61947,140,14032,18937,35770,0,0,0,1,1
61948,140,14033,19608;19881;22120,35770,0,0,3,0,3
61949,140,14035,19028,35770,0,0,0,1,1
61950,140,14036,18931,35770,0,0,0,1,1
61951,140,14038,19144;19295,35770,0,0,0,2,2
61952,140,14039,18908;19179,35770,0,0,0,2,2
61953,140,14040,19187;19527,35770,0,0,1,1,2
61954,140,14045,19413,35770,0,0,0,1,1
61955,140,14046,19202;19259,35770,0,0,0,2,2
61956,140,14047,18926;19106,35770,0,0,0,2,2
61957,140,14048,19511;23086,35770,0,0,2,0,2
61958,140,14049,23507,35770,0,0,1,0,1
61959,140,14051,19135;19489,35770,0,0,1,1,2
61960,140,14053,19319;19552,35770,0,0,1,1,2
61961,140,14055,19530;19828,35770,0,0,2,0,2
61962,140,14056,19304;19499,35770,0,0,1,1,2
61963,140,14057,19661;19902;23513,35770,0,0,3,0,3
61964,140,14058,19373;19778,35770,0,0,1,1,2
61965,140,14059,19110;19832,35770,0,0,1,1,2
61966,140,14062,19034;19587;22690;23590;26089,35770,1,0,3,1,5
61967,140,14063,19532;19615,35770,0,0,2,0,2
61968,140,14064,19632;19943,35770,0,0,2,0,2
61969,140,14065,19691;20077;23110,35770,0,0,3,0,3
61970,140,14066,19249;19702;22804;23493;25414,35770,0,1,3,1,5
61971,140,14067,19330;19704,35770,0,0,1,1,2
61972,140,14068,19570;19710,35770,0,0,2,0,2
61973,140,14069,19274;19712,35770,0,0,1,1,2
61974,140,14070,18697;19726,35770,0,0,1,1,2
61975,140,14071,19348;19739;23499,35770,0,0,2,1,3
61976,140,14072,19505,35770,0,0,1,0,1
61977,140,14073,19847;20143;23825,35770,0,0,3,0,3
61978,140,14074,19759;19970,35770,0,0,2,0,2
61979,140,14075,20134;20217,35770,0,0,2,0,2
61980,140,14076,19520;19780,35770,0,0,2,0,2
61981,140,14077,19364;19380,35770,0,0,0,2,2
61982,140,14112,18063;18473,36135,0,0,0,2,2
61983,140,14113,17867;17901,36135,0,0,0,2,2
61984,140,14114,18499,36135,0,0,0,1,1
61985,140,14121,18024;18420,36135,0,0,0,2,2
61986,140,14123,18803;18998,36135,0,0,0,2,2
61987,140,14127,18883;19290,36135,0,0,0,2,2
61988,140,14128,18665,36135,0,0,0,1,1
61989,140,14129,18709,36135,0,0,0,1,1
61990,140,14130,18777,36135,0,0,0,1,1
61991,140,14134,18573;18765,36135,0,0,0,2,2
61992,140,14135,18940,36135,0,0,0,1,1
61993,140,14136,18894,36135,0,0,0,1,1
61994,140,14137,18977,36135,0,0,0,1,1
61995,140,14138,18819;18974,36135,0,0,0,2,2
61996,140,14141,19428;19539;22793,36135,0,0,2,1,3
61997,140,14142,19606,36135,0,0,1,0,1
61998,140,14143,19262;19478,36135,0,0,1,1,2
61999,140,14145,19078;19239;23678,36135,0,0,1,2,3
62000,140,14147,19252;19934,36135,0,0,1,1,2
62001,140,14150,19729;23198;26362,36135,1,0,2,0,3
62002,140,14151,19488,36135,0,0,1,0,1
62003,140,14152,19180;19337,36135,0,0,0,2,2
62004,140,14153,19240;19485,36135,0,0,1,1,2
62005,140,14154,18930;19357,36135,0,0,0,2,2
62006,140,14156,19227;19403,36135,0,0,0,2,2
62007,140,14157,19134;19408,36135,0,0,0,2,2
62008,140,14160,19768;20003,36135,0,0,2,0,2
62009,140,14161,19771,36135,0,0,1,0,1
62010,140,14162,19250;20024;23519;23707;24317;25735,36135,0,1,4,1,6
62011,140,14163,19349;19516,36135,0,0,1,1,2
62012,140,14165,19536,36135,0,0,1,0,1
62013,140,14166,19393;19756,36135,0,0,1,1,2
62014,140,14167,19871,36135,0,0,1,0,1
62015,140,14168,19333;19840;23695;23796;26282,36135,1,0,3,1,5
62016,140,14170,19685;24424,36135,0,0,2,0,2
62017,140,14172,19404;19646,36135,0,0,1,1,2
62018,140,14173,19659;19895;23512,36135,0,0,3,0,3
62019,140,14176,19580;19695,36135,0,0,2,0,2
62020,140,14177,19927;20154,36135,0,0,2,0,2
62021,140,14178,19751;20210,36135,0,0,2,0,2
62022,140,14180,19263;19605,36135,0,0,1,1,2
62023,140,14182,19852;19905,36135,0,0,2,0,2
62024,140,14183,19855;19856;23799,36135,0,0,3,0,3
62025,140,14184,19761;19874,36135,0,0,2,0,2
62026,140,14185,19885;23411;26463,36135,1,0,2,0,3
62027,140,14186,19635;19948;24764,36135,0,1,2,0,3
62028,140,14187,19599,36135,0,0,1,0,1
62029,140,14188,19911;20047,36135,0,0,2,0,2
62030,140,14189,19914;20031,36135,0,0,2,0,2
62031,140,14209,16530;16557,36500,0,0,0,2,2
62032,140,14214,16660,36500,0,0,0,1,1
62033,140,14222,17927,36500,0,0,0,1,1
62034,140,14223,17159,36500,0,0,0,1,1
62035,140,14228,18348;18866,36500,0,0,0,2,2
62036,140,14229,18463,36500,0,0,0,1,1
62037,140,14232,18738,36500,0,0,0,1,1
62038,140,14233,18423;18572,36500,0,0,0,2,2
62039,140,14234,18815;18879,36500,0,0,0,2,2
62040,140,14236,19097,36500,0,0,0,1,1
62041,140,14238,19116,36500,0,0,0,1,1
62042,140,14239,18865;19218,36500,0,0,0,2,2
62043,140,14240,18887;19000,36500,0,0,0,2,2
62044,140,14244,18693;19020,36500,0,0,0,2,2
62045,140,14245,19022;19682;22697;22802;25519;25525;25621;26133,36500,1,3,3,1,8
62046,140,14247,19693;19717,36500,0,0,2,0,2
62047,140,14248,19234;19963,36500,0,0,1,1,2
62048,140,14249,19312,36500,0,0,0,1,1
62049,140,14253,19924;20014,36500,0,0,2,0,2
62050,140,14254,19341;19556;23475;23584,36500,0,0,3,1,4
62051,140,14255,19345;19713;23404;26268,36500,1,0,2,1,4
62052,140,14256,19575,36500,0,0,1,0,1
62053,140,14257,19389;19854,36500,0,0,1,1,2
62054,140,14258,19583;20001,36500,0,0,2,0,2
62055,140,14259,18984;19399,36500,0,0,0,2,2
62056,140,14261,19440,36500,0,0,0,1,1
62057,140,14263,19461,36500,0,0,1,0,1
62058,140,14264,19056;19469,36500,0,0,1,1,2
62059,140,14266,19497;19825,36500,0,0,2,0,2
62060,140,14267,19628;19664,36500,0,0,2,0,2
62061,140,14269,19595;19597,36500,0,0,2,0,2
62062,140,14270,19873,36500,0,0,1,0,1
62063,140,14271,19432;19650;23294,36500,0,0,2,1,3
62064,140,14274,19377;19653,36500,0,0,1,1,2
62065,140,14275,19066;19666,36500,0,0,1,1,2
62066,140,14276,19483;19714,36500,0,0,2,0,2
62067,140,14278,19694,36500,0,0,1,0,1
62068,140,14279,19292;19979,36500,0,0,1,1,2
62069,140,14280,19174;19762,36500,0,0,1,1,2
62070,140,14281,19814;23506,36500,0,0,2,0,2
62071,140,14282,19784;20118,36500,0,0,2,0,2
62072,140,14286,19557;19862,36500,0,0,2,0,2
62073,140,14287,19868;20015,36500,0,0,2,0,2
62074,140,14288,19968;23010,36500,0,0,2,0,2
62075,140,14289,20138;23228,36500,0,0,2,0,2
62076,140,14290,19923;22491,36500,0,0,2,0,2
62077,140,14291,19975,36500,0,0,1,0,1
62078,140,14292,19996;20033;22814;23215;24867;25622,36500,0,2,4,0,6
62079,140,14293,19931;20023;23610;26188,36500,1,0,3,0,4
62080,140,14308,16486,36865,0,0,0,1,1
62081,140,14309,17113,36865,0,0,0,1,1
62082,140,14314,17224,36865,0,0,0,1,1
62083,140,14326,18536,36865,0,0,0,1,1
62084,140,14327,18666;19105,36865,0,0,0,2,2
62085,140,14328,18753;19122,36865,0,0,0,2,2
62086,140,14329,19265,36865,0,0,0,1,1
62087,140,14330,18596,36865,0,0,0,1,1
62088,140,14331,19014;19191,36865,0,0,0,2,2
62089,140,14332,18983;19465,36865,0,0,1,1,2
62090,140,14333,19062,36865,0,0,0,1,1
62091,140,14334,18855;19419,36865,0,0,0,2,2
62092,140,14335,19267;19394,36865,0,0,0,2,2
62093,140,14338,19140,36865,0,0,0,1,1
62094,140,14339,19149;19462,36865,0,0,1,1,2
62095,140,14344,19291;19372,36865,0,0,0,2,2
62096,140,14346,19426,36865,0,0,0,1,1
62097,140,14347,19453;19480,36865,0,0,2,0,2
62098,140,14348,19463;19980,36865,0,0,2,0,2
62099,140,14352,19445;19446,36865,0,0,2,0,2
62100,140,14354,19643;19920;22586;25513;26227,36865,1,1,3,0,5
62101,140,14355,19498;19598,36865,0,0,2,0,2
62102,140,14356,19799;20152;24224,36865,0,0,3,0,3
62103,140,14357,19351;19613;24212,36865,0,0,2,1,3
62104,140,14358,19658;24213,36865,0,0,2,0,2
62105,140,14359,20048;20270,36865,0,0,2,0,2
62106,140,14360,19701;20114;23820,36865,0,0,3,0,3
62107,140,14362,19827,36865,0,0,1,0,1
62108,140,14364,19860;19957,36865,0,0,2,0,2
62109,140,14365,20201;20249;24323,36865,0,0,3,0,3
62110,140,14366,19752;19887;23501;24872;25817,36865,0,2,3,0,5
62111,140,14367,19904;20365;24439,36865,0,0,3,0,3
62112,140,14368,19676;19917;25195,36865,0,1,2,0,3
62113,140,14369,19940;20011;23104,36865,0,0,3,0,3
62114,140,14370,20054;20205;23813,36865,0,0,3,0,3
62115,140,14371,19788;20268,36865,0,0,2,0,2
62116,140,14372,20028;20153;24111,36865,0,0,3,0,3
62117,140,14373,19974;20074,36865,0,0,2,0,2
62118,140,14374,20093;20486,36865,0,0,2,0,2
62119,140,14375,20103,36865,0,0,1,0,1
62120,140,14376,20105;20136;23224,36865,0,0,3,0,3
62121,140,14377,20121;20567,36865,0,0,2,0,2
62122,140,14378,20260;23832;26001,36865,0,1,2,0,3
62123,140,14383,15888,37230,0,0,0,1,1
62124,140,14402,17624,37230,0,0,0,1,1
62125,140,14408,18052;18539,37230,0,0,0,2,2
62126,140,14413,18512,37230,0,0,0,1,1
62127,140,14416,18610;18754,37230,0,0,0,2,2
62128,140,14417,18399;18422,37230,0,0,0,2,2
62129,140,14419,18668;19342;23279;26457,37230,1,0,1,2,4
62130,140,14420,18170;18669;23367,37230,0,0,1,2,3
62131,140,14422,18471,37230,0,0,0,1,1
62132,140,14427,18822,37230,0,0,0,1,1
62133,140,14428,19003;19127,37230,0,0,0,2,2
62134,140,14429,19390,37230,0,0,0,1,1
62135,140,14430,19148;19621,37230,0,0,1,1,2
62136,140,14431,19375,37230,0,0,0,1,1
62137,140,14432,19502,37230,0,0,1,0,1
62138,140,14433,19118,37230,0,0,0,1,1
62139,140,14435,19602;19897;23908,37230,0,0,3,0,3
62140,140,14436,19248;19367,37230,0,0,0,2,2
62141,140,14437,19593;19805,37230,0,0,2,0,2
62142,140,14438,19455,37230,0,0,1,0,1
62143,140,14439,19311;19477,37230,0,0,1,1,2
62144,140,14440,18895;19531;22792;23589,37230,0,0,3,1,4
62145,140,14442,19493;19623,37230,0,0,2,0,2
62146,140,14445,19449;20102;24533,37230,0,0,3,0,3
62147,140,14447,19415;19622,37230,0,0,1,1,2
62148,140,14448,19689;19750,37230,0,0,2,0,2
62149,140,14449,19487;20222;24024,37230,0,0,3,0,3
62150,140,14450,19236;19696,37230,0,0,1,1,2
62151,140,14451,19742;20509;23547;23947,37230,0,0,4,0,4
62152,140,14452,20380,37230,0,0,1,0,1
62153,140,14453,20207;20208,37230,0,0,2,0,2
62154,140,14454,19830;20196,37230,0,0,2,0,2
62155,140,14455,19831,37230,0,0,1,0,1
62156,140,14456,19721;19879,37230,0,0,2,0,2
62157,140,14457,19823;19858,37230,0,0,2,0,2
62158,140,14458,19715;23693,37230,0,0,2,0,2
62159,140,14459,19735;20010;24532,37230,0,0,3,0,3
62160,140,14460,20036;20664;23419;24220;25537;25727,37230,0,2,4,0,6
62161,140,14461,19688;20500;23437,37230,0,0,3,0,3
62162,140,14464,20081;24318,37230,0,0,2,0,2
62163,140,14465,19808;20174;23712;24434,37230,0,0,4,0,4
62164,140,14466,19300;19952,37230,0,0,1,1,2
62165,140,14467,20304;24438,37230,0,0,2,0,2
62166,140,14468,19760;19989;23704,37230,0,0,3,0,3
62167,140,14470,20472;20473,37230,0,0,2,0,2
62168,140,14471,20067,37230,0,0,1,0,1
62169,140,14472,19476;20075;23521;25911;25992,37230,0,2,3,0,5
62170,140,14473,20079,37230,0,0,1,0,1
62171,140,14474,19826;20101,37230,0,0,2,0,2
62172,140,14475,19779;20140,37230,0,0,2,0,2
62173,140,14476,20330;20369;24440,37230,0,0,3,0,3
62174,140,14477,20053;20574;23549;23957,37230,0,0,4,0,4
62175,140,14478,20155;24321;24534,37230,0,0,3,0,3
62176,140,14479,20163,37230,0,0,1,0,1
62177,140,14480,20414;20506;24539,37230,0,0,3,0,3
62178,140,14481,19861;20257,37230,0,0,2,0,2
62179,140,14482,20145;20179,37230,0,0,2,0,2
62180,140,14483,20199;20440,37230,0,0,2,0,2
62181,140,14484,20523;20612,37230,0,0,2,0,2
62182,140,14503,17225,37595,0,0,0,1,1
62183,140,14507,17361;17386,37595,0,0,0,2,2
62184,140,14508,17511;17877,37595,0,0,0,2,2
62185,140,14514,17893;18365,37595,0,0,0,2,2
62186,140,14521,18338,37595,0,0,0,1,1
62187,140,14522,18826;18912,37595,0,0,0,2,2
62188,140,14525,18945,37595,0,0,0,1,1
62189,140,14526,18799;19243,37595,0,0,0,2,2
62190,140,14527,18804;19058,37595,0,0,0,2,2
62191,140,14528,18652;19184;23379,37595,0,0,1,2,3
62192,140,14530,19401,37595,0,0,0,1,1
62193,140,14531,19973;20020;23915,37595,0,0,3,0,3
62194,140,14532,18850;19459,37595,0,0,1,1,2
62195,140,14534,19737;20248,37595,0,0,2,0,2
62196,140,14535,19574;19886,37595,0,0,2,0,2
62197,140,14536,19745,37595,0,0,1,0,1
62198,140,14537,19471;19683,37595,0,0,2,0,2
62199,140,14538,19542;19867;24016,37595,0,0,3,0,3
62200,140,14539,19793,37595,0,0,1,0,1
62201,140,14540,19589;19893,37595,0,0,2,0,2
62202,140,14542,19456,37595,0,0,1,0,1
62203,140,14543,19743;19782;24014,37595,0,0,3,0,3
62204,140,14544,19546;19981;24427,37595,0,0,3,0,3
62205,140,14545,19607;19736;23300,37595,0,0,3,0,3
62206,140,14548,19671;20056,37595,0,0,2,0,2
62207,140,14549,19813;20068,37595,0,0,2,0,2
62208,140,14550,19610;19892,37595,0,0,2,0,2
62209,140,14551,19937,37595,0,0,1,0,1
62210,140,14552,20191;20195;24022,37595,0,0,3,0,3
62211,140,14553,19801;19946,37595,0,0,2,0,2
62212,140,14554,19950;19977;23804;24108,37595,0,0,4,0,4
62213,140,14556,20325;20429;24331,37595,0,0,3,0,3
62214,140,14557,19338;23808;24219,37595,0,0,2,1,3
62215,140,14558,20495;23128;24333;24542,37595,0,0,4,0,4
62216,140,14559,20008;20116,37595,0,0,2,0,2
62217,140,14560,19899;20127,37595,0,0,2,0,2
62218,140,14561,19749;19843,37595,0,0,2,0,2
62219,140,14562,20389;20480;24446;26413,37595,1,0,3,0,4
62220,140,14565,19995;20186;24119;26097,37595,1,0,3,0,4
62221,140,14566,19935;20501;24334,37595,0,0,3,0,3
62222,140,14567,20052;20307,37595,0,0,2,0,2
62223,140,14568,20202;20236;24023,37595,0,0,3,0,3
62224,140,14569,20156,37595,0,0,1,0,1
62225,140,14570,20404;20565,37595,0,0,2,0,2
62226,140,14571,19962;20242,37595,0,0,2,0,2
62227,140,14572,19821;20244;23535;24435,37595,0,0,4,0,4
62228,140,14573,20220;22594;23926,37595,0,0,3,0,3
62229,140,14574,20041;20361;24768,37595,0,1,2,0,3
62230,140,14576,20117;20296;24125;24536;26502,37595,1,0,4,0,5
62231,140,14577,20652,37595,0,0,1,0,1
62232,140,14578,20321;20728;23742;24552;24658,37595,0,0,5,0,5
62233,140,14579,20328;20711;24879,37595,0,1,2,0,3
62234,140,14580,20334;20392;23624;25732;26393,37595,1,1,3,0,5
62235,140,14581,20194;20376;24120;24994,37595,0,1,3,0,4
62236,140,14582,20340;20542;23637;24875,37595,0,1,3,0,4
62237,140,14583,20292;20394,37595,0,0,2,0,2
62238,140,14584,20391;20715,37595,0,0,2,0,2
62239,140,14590,16565,37960,0,0,0,1,1
62240,140,14594,16543,37960,0,0,0,1,1
62241,140,14597,16808,37960,0,0,0,1,1
62242,140,14616,18090,37960,0,0,0,1,1
62243,140,14619,18217;18378,37960,0,0,0,2,2
62244,140,14622,18484,37960,0,0,0,1,1
62245,140,14630,18584;19416;22983;26064;26347,37960,2,0,1,2,5
62246,140,14631,18716;19029,37960,0,0,0,2,2
62247,140,14633,18726;18792,37960,0,0,0,2,2
62248,140,14634,19707;20027;23488,37960,0,0,3,0,3
62249,140,14636,19563;19880,37960,0,0,2,0,2
62250,140,14637,19437;19966,37960,0,0,1,1,2
62251,140,14638,19443,37960,0,0,0,1,1
62252,140,14639,19460;19670;23285,37960,0,0,3,0,3
62253,140,14640,18994;19475;23176,37960,0,0,2,1,3
62254,140,14643,19276;19371,37960,0,0,0,2,2
62255,140,14644,19596;19918,37960,0,0,2,0,2
62256,140,14645,19647,37960,0,0,1,0,1
62257,140,14646,19614;19949;24645,37960,0,0,3,0,3
62258,140,14647,19630;19651,37960,0,0,2,0,2
62259,140,14648,19800;20146;24433,37960,0,0,3,0,3
62260,140,14649,19439;19636,37960,0,0,1,1,2
62261,140,14650,19136;19648,37960,0,0,1,1,2
62262,140,14651,19657;20013,37960,0,0,2,0,2
62263,140,14653,19509;19773,37960,0,0,2,0,2
62264,140,14655,19725;19794,37960,0,0,2,0,2
62265,140,14656,19944;24107,37960,0,0,2,0,2
62266,140,14657,19777;20111,37960,0,0,2,0,2
62267,140,14658,19791;19849,37960,0,0,2,0,2
62268,140,14659,19795;20531,37960,0,0,2,0,2
62269,140,14660,19421;19797,37960,0,0,1,1,2
62270,140,14661,19668;20032,37960,0,0,2,0,2
62271,140,14662,19639;19810;23187,37960,0,0,3,0,3
62272,140,14663,19817;19922,37960,0,0,2,0,2
62273,140,14664,20046;20223;23430;26465,37960,1,0,3,0,4
62274,140,14665,19928;23803;24106,37960,0,0,3,0,3
62275,140,14666,20488;20603;24653,37960,0,0,3,0,3
62276,140,14667,19998,37960,0,0,1,0,1
62277,140,14668,20528,37960,0,0,1,0,1
62278,140,14669,20187,37960,0,0,1,0,1
62279,140,14670,19451;20017,37960,0,0,2,0,2
62280,140,14671,20166;20463;24648,37960,0,0,3,0,3
62281,140,14672,20078;20489,37960,0,0,2,0,2
62282,140,14673,19955;20096;23524;26184,37960,1,0,3,0,4
62283,140,14674,20109,37960,0,0,1,0,1
62284,140,14675,20582;21058,37960,0,0,2,0,2
62285,140,14677,20761;23655,37960,0,0,2,0,2
62286,140,14678,20310,37960,0,0,1,0,1
62287,140,14679,20356;20374;23629,37960,0,0,3,0,3
62288,140,14680,20159;23530,37960,0,0,2,0,2
62289,140,14681,20215;20421;24443,37960,0,0,3,0,3
62290,140,14682,20098;20212,37960,0,0,2,0,2
62291,140,14683,20172;20533,37960,0,0,2,0,2
62292,140,14684,20415,37960,0,0,1,0,1
62293,140,14685,19971;20316;24026,37960,0,0,3,0,3
62294,140,14687,20293;20401;24324;24436,37960,0,0,4,0,4
62295,140,14688,20317;20319;23433,37960,0,0,3,0,3
62296,140,14689,20211;20342,37960,0,0,2,0,2
62297,140,14690,20355;20595,37960,0,0,2,0,2
62298,140,14691,20568;20775;24558,37960,0,0,3,0,3
62299,140,14692,20384;20424;23842,37960,0,0,3,0,3
62300,140,14694,20007;20413;24770,37960,0,1,2,0,3
62301,140,14695,20226;20427,37960,0,0,2,0,2
62302,140,14696,20107;20544;23952,37960,0,0,3,0,3
62303,140,14697,20229;20447,37960,0,0,2,0,2
62304,140,14698,19987;20448;24541,37960,0,0,3,0,3
62305,140,14699,20870;21112,37960,0,0,2,0,2
62306,140,14700,20106;23344;24044,37960,0,0,3,0,3
62307,140,14701,20745;24059;24555,37960,0,0,3,0,3
62308,140,14702,20469;20646,37960,0,0,2,0,2
62309,140,14703,20497;20621;23545;23844;26274,37960,1,0,4,0,5
62310,140,14713,17022,38325,0,0,0,1,1
62311,140,14714,16999,38325,0,0,0,1,1
62312,140,14715,16838,38325,0,0,0,1,1
62313,140,14722,17373,38325,0,0,0,1,1
62314,140,14725,17542;18003,38325,0,0,0,2,2
62315,140,14727,17744,38325,0,0,0,1,1
62316,140,14731,17943;18733,38325,0,0,0,2,2
62317,140,14735,18206;18419,38325,0,0,0,2,2
62318,140,14742,18955,38325,0,0,0,1,1
62319,140,14743,18967;19222,38325,0,0,0,2,2
62320,140,14744,19059,38325,0,0,0,1,1
62321,140,14745,19133,38325,0,0,0,1,1
62322,140,14746,19190;19347,38325,0,0,0,2,2
62323,140,14747,19344,38325,0,0,0,1,1
62324,140,14748,19321;19660,38325,0,0,1,1,2
62325,140,14749,19301,38325,0,0,0,1,1
62326,140,14751,19423;19809,38325,0,0,1,1,2
62327,140,14753,19786,38325,0,0,1,0,1
62328,140,14754,19514;19848;23696,38325,0,0,3,0,3
62329,140,14755,19579;19772;22699;25520,38325,0,1,3,0,4
62330,140,14756,19482;19722;23496,38325,0,0,3,0,3
62331,140,14757,19339;19637,38325,0,0,1,1,2
62332,140,14759,19796;23201,38325,0,0,2,0,2
62333,140,14760,19681;20021;23213,38325,0,0,3,0,3
62334,140,14761,20297;20430,38325,0,0,2,0,2
62335,140,14762,19329;19733,38325,0,0,1,1,2
62336,140,14763,19766;19958,38325,0,0,2,0,2
62337,140,14764,19812;19959;24426,38325,0,0,3,0,3
62338,140,14765,19798;19978;24109,38325,0,0,3,0,3
62339,140,14766,19857;19875,38325,0,0,2,0,2
62340,140,14767,20181;20842;24884;25739,38325,0,2,2,0,4
62341,140,14768,20375;23838;24229;24995,38325,0,1,3,0,4
62342,140,14769,20128,38325,0,0,1,0,1
62343,140,14770,20235;20250,38325,0,0,2,0,2
62344,140,14771,20600;23643,38325,0,0,2,0,2
62345,140,14772,19898;20064;24431,38325,0,0,3,0,3
62346,140,14773,20042;20071,38325,0,0,2,0,2
62347,140,14774,19541;19600,38325,0,0,2,0,2
62348,140,14775,20099;20351,38325,0,0,2,0,2
62349,140,14776,20110;20823;24460;25002;25322;25436,38325,0,3,3,0,6
62350,140,14777,19665;20112;23710,38325,0,0,3,0,3
62351,140,14778,20160;20517;24137;25738,38325,0,1,3,0,4
62352,140,14779,20168;20884;24887,38325,0,1,2,0,3
62353,140,14780,20184;20541;24996,38325,0,1,2,0,3
62354,140,14781,20206;20353;23934,38325,0,0,3,0,3
62355,140,14782,20237;20554;23735,38325,0,0,3,0,3
62356,140,14784,20278;20456;24039,38325,0,0,3,0,3
62357,140,14785,20306;20671;23962;24775,38325,0,1,3,0,4
62358,140,14787,20314;20537,38325,0,0,2,0,2
62359,140,14788,19926;20570;24773,38325,0,1,2,0,3
62360,140,14790,19908;20332,38325,0,0,2,0,2
62361,140,14791,19994;20398;24032,38325,0,0,3,0,3
62362,140,14792,20040;20164,38325,0,0,2,0,2
62363,140,14793,20529;20906;24069;24359;25099,38325,0,1,4,0,5
62364,140,14794,20388,38325,0,0,1,0,1
62365,140,14795,20403,38325,0,0,1,0,1
62366,140,14796,20291;20409,38325,0,0,2,0,2
62367,140,14797,20253;20452;24874,38325,0,1,2,0,3
62368,140,14798,20459;20460,38325,0,0,2,0,2
62369,140,14799,20225;20505;23438,38325,0,0,3,0,3
62370,140,14800,20515;20924;24361,38325,0,0,3,0,3
62371,140,14801,20381;20571;24139,38325,0,0,3,0,3
62372,140,14802,20780;24154,38325,0,0,2,0,2
62373,140,14803,20596;20653,38325,0,0,2,0,2
62374,140,14806,17032,38690,0,0,0,1,1
62375,140,14810,17009,38690,0,0,0,1,1
62376,140,14815,17271,38690,0,0,0,1,1
62377,140,14822,17835;18041,38690,0,0,0,2,2
62378,140,14824,18689,38690,0,0,0,1,1
62379,140,14830,18687,38690,0,0,0,1,1
62380,140,14831,19603,38690,0,0,1,0,1
62381,140,14832,19076;19584,38690,0,0,1,1,2
62382,140,14839,19346;19454;23165;26164,38690,1,0,2,1,4
62383,140,14840,19402;19774,38690,0,0,1,1,2
62384,140,14842,19414;19907,38690,0,0,1,1,2
62385,140,14843,19284;19792,38690,0,0,1,1,2
62386,140,14846,20097,38690,0,0,1,0,1
62387,140,14847,19732;20069;24112,38690,0,0,3,0,3
62388,140,14850,20247,38690,0,0,1,0,1
62389,140,14851,19776;19866;22702;25786;26429,38690,1,1,3,0,5
62390,140,14852,20396;23937;24326;24538,38690,0,0,4,0,4
62391,140,14854,20481,38690,0,0,1,0,1
62392,140,14855,19984;20198,38690,0,0,2,0,2
62393,140,14856,19960;20185;24766,38690,0,1,2,0,3
62394,140,14858,20009;20227,38690,0,0,2,0,2
62395,140,14859,19740;20044,38690,0,0,2,0,2
62396,140,14861,20051;20129;24221,38690,0,0,3,0,3
62397,140,14862,20058;20635;24546,38690,0,0,3,0,3
62398,140,14863,20158,38690,0,0,1,0,1
62399,140,14864,19967;20231,38690,0,0,2,0,2
62400,140,14865,20232;20948;24567,38690,0,0,3,0,3
62401,140,14866,20286;20367;24028;26402,38690,1,0,3,0,4
62402,140,14867,20287;20370,38690,0,0,2,0,2
62403,140,14868,20346;20400;23938,38690,0,0,3,0,3
62404,140,14869,20303;21015;24170;24479;25010,38690,0,1,4,0,5
62405,140,14871,20832;24160,38690,0,0,2,0,2
62406,140,14872,20412;24230,38690,0,0,2,0,2
62407,140,14873,20736;24150;24344;24456,38690,0,0,4,0,4
62408,140,14874,20423;20457;24131;24771,38690,0,1,3,0,4
62409,140,14875,20354;20382;23836,38690,0,0,3,0,3
62410,140,14876,19629;20161,38690,0,0,2,0,2
62411,140,14877,20732,38690,0,0,1,0,1
62412,140,14878,20323;20490,38690,0,0,2,0,2
62413,140,14879,20499;20704,38690,0,0,2,0,2
62414,140,14880,20739;24778,38690,0,1,1,0,2
62415,140,14881,20791;21003;25439,38690,0,1,2,0,3
62416,140,14882,20261;20682;24454;24657,38690,0,0,4,0,4
62417,140,14883,20521;20579;23032;23641,38690,0,0,4,0,4
62418,140,14884,21008;23353;24570,38690,0,0,3,0,3
62419,140,14885,20555;20589;24047;24997,38690,0,1,3,0,4
62420,140,14886,20080;20634,38690,0,0,2,0,2
62421,140,14887,20642;20929;24364,38690,0,0,3,0,3
62422,140,14888,21025;24793;25325,38690,0,2,1,0,3
62423,140,14889,20688;24245,38690,0,0,2,0,2
62424,140,14890,20717;20742,38690,0,0,2,0,2
62425,140,14891,20397;20724;24147,38690,0,0,3,0,3
62426,140,14892,20336;20740;24345,38690,0,0,3,0,3
62427,140,14897,16554,39055,0,0,0,1,1
62428,140,14900,16592,39055,0,0,0,1,1
62429,140,14918,18448;19458,39055,0,0,1,1,2
62430,140,14927,19170,39055,0,0,0,1,1
62431,140,14929,18761;19324,39055,0,0,0,2,2
62432,140,14931,19932;23702,39055,0,0,2,0,2
62433,140,14932,19526;19894,39055,0,0,2,0,2
62434,140,14933,19545;20233,39055,0,0,2,0,2
62435,140,14935,20450;20485,39055,0,0,2,0,2
62436,140,14936,19618;19686;24214,39055,0,0,3,0,3
62437,140,14937,19669;19986,39055,0,0,2,0,2
62438,140,14938,19938;20259,39055,0,0,2,0,2
62439,140,14939,19687;19811;22997;23691,39055,0,0,4,0,4
62440,140,14940,19468;19961,39055,0,0,2,0,2
62441,140,14941,19728;20209;23534,39055,0,0,3,0,3
62442,140,14942,19997,39055,0,0,1,0,1
62443,140,14945,20022,39055,0,0,1,0,1
62444,140,14946,19916,39055,0,0,1,0,1
62445,140,14947,20219;23326,39055,0,0,2,0,2
62446,140,14948,20697;20790;24155;24881;26297;26404,39055,2,1,3,0,6
62447,140,14949,19818;20038,39055,0,0,2,0,2
62448,140,14950,19842;20039;23217;23708,39055,0,0,4,0,4
62449,140,14951,20062;20279,39055,0,0,2,0,2
62450,140,14952,20061;20142,39055,0,0,2,0,2
62451,140,14953,19933;20368,39055,0,0,2,0,2
62452,140,14954,20019;20520,39055,0,0,2,0,2
62453,140,14955,20216;20606;24998,39055,0,1,2,0,3
62454,140,14956,19544;20224,39055,0,0,2,0,2
62455,140,14957,20066;20274;23432;24146;25094,39055,0,1,4,0,5
62456,140,14958,20026;20513,39055,0,0,2,0,2
62457,140,14959,20590;20841;25648,39055,0,1,2,0,3
62458,140,14960,20345;20911;24785,39055,0,1,2,0,3
62459,140,14961,20327;20893;24356,39055,0,0,3,0,3
62460,140,14962,20167;20338,39055,0,0,2,0,2
62461,140,14963,20322;20360,39055,0,0,2,0,2
62462,140,14964,20175;20814;24250;24561,39055,0,0,4,0,4
62463,140,14965,20416;24037;24329,39055,0,0,3,0,3
62464,140,14966,20189;20453,39055,0,0,2,0,2
62465,140,14968,20464;20927;24262;24363,39055,0,0,4,0,4
62466,140,14969,20182;20288;23714,39055,0,0,3,0,3
62467,140,14970,20494;20710,39055,0,0,2,0,2
62468,140,14971,20029;20538;23847;24043,39055,0,0,4,0,4
62469,140,14972,20284;20540;23951;24772,39055,0,1,3,0,4
62470,140,14973,20829;20947;24065;24159;24782,39055,0,1,4,0,5
62471,140,14974,20557;20836;24066;24461,39055,0,0,4,0,4
62472,140,14975,20566;20909;24888,39055,0,1,2,0,3
62473,140,14976,20524;20575,39055,0,0,2,0,2
62474,140,14978,20090;20615;23551;23738;24239;24545;24654;26190,39055,1,0,7,0,8
62475,140,14979,20562;20627;23955;24046;24236,39055,0,0,5,0,5
62476,140,14980,20985;21155;24799,39055,0,1,2,0,3
62477,140,14981,20668;20821;23740,39055,0,0,3,0,3
62478,140,14982,20687;20937;24365;24470;24786,39055,0,1,4,0,5
62479,140,14983,20694;20765;24556;24779,39055,0,1,3,0,4
62480,140,14984,20720;20846;24254;24462,39055,0,0,4,0,4
62481,140,14985,20645;20725;25000,39055,0,1,2,0,3
62482,140,14986,20746,39055,0,0,1,0,1
62483,140,14987,20616;20778;24780,39055,0,1,2,0,3
62484,140,14988,20783;20980,39055,0,0,2,0,2
62485,140,14989,20792;23749;24882;25822,39055,0,2,2,0,4
62486,140,14990,20519;20810,39055,0,0,2,0,2
62487,140,14991,20827;21122;23989;24675;25108,39055,0,1,4,0,5
62488,140,15006,16978,39420,0,0,0,1,1
62489,140,15012,17773,39420,0,0,0,1,1
62490,140,15018,18389,39420,0,0,0,1,1
62491,140,15020,18663,39420,0,0,0,1,1
62492,140,15032,19470;19528,39420,0,0,2,0,2
62493,140,15035,20073;20130,39420,0,0,2,0,2
62494,140,15037,19616;19901;23008;25889;26066,39420,1,1,3,0,5
62495,140,15038,20377;20387;23936;24441,39420,0,0,4,0,4
62496,140,15039,20299,39420,0,0,1,0,1
62497,140,15040,20465;24332,39420,0,0,2,0,2
62498,140,15042,20144;20643,39420,0,0,2,0,2
62499,140,15044,20602;20609;24449,39420,0,0,3,0,3
62500,140,15045,20347;24027;24100;24227,39420,0,0,4,0,4
62501,140,15046,20271;20620;24049;24240;24337;24876;25318;26204,39420,1,2,5,0,8
62502,140,15047,20395;20874;24563,39420,0,0,3,0,3
62503,140,15048,20151;20301,39420,0,0,2,0,2
62504,140,15050,20828;21041;24078;24794,39420,0,1,3,0,4
62505,140,15051,20496;20859;24353;24661;25003,39420,0,1,4,0,5
62506,140,15053,20779;24153;24559,39420,0,0,3,0,3
62507,140,15054,20002;20467;23543,39420,0,0,3,0,3
62508,140,15055,20309;20471,39420,0,0,2,0,2
62509,140,15056,19850;20474,39420,0,0,2,0,2
62510,140,15057,20435,39420,0,0,1,0,1
62511,140,15058,20234,39420,0,0,1,0,1
62512,140,15059,20683;20785;24341,39420,0,0,3,0,3
62513,140,15060,20173;20584,39420,0,0,2,0,2
62514,140,15061,20592;21166;24678,39420,0,0,3,0,3
62515,140,15062,20131;20604,39420,0,0,2,0,2
62516,140,15063,20805;21028,39420,0,0,2,0,2
62517,140,15065,20610;20663;24548,39420,0,0,3,0,3
62518,140,15066,20806;21036;25544,39420,0,1,2,0,3
62519,140,15067,20313;20684;23648;24776,39420,0,1,3,0,4
62520,140,15068,21102;24175,39420,0,0,2,0,2
62521,140,15069,20709;24247;26407,39420,1,0,2,0,3
62522,140,15070,20611;21184;24277,39420,0,0,3,0,3
62523,140,15071,20622;20794,39420,0,0,2,0,2
62524,140,15072,20504;21037;24171;24483,39420,0,0,4,0,4
62525,140,15073,20759;20934;25740,39420,0,1,2,0,3
62526,140,15074,20608;21175,39420,0,0,2,0,2
62527,140,15075,20757;21241,39420,0,0,2,0,2
62528,140,15076,20797;21048,39420,0,0,2,0,2
62529,140,15077,21017;23984;24670;25103,39420,0,1,3,0,4
62530,140,15078,20863;20891;24464;25437,39420,0,1,3,0,4
62531,140,15079,20885;21170;24164;24255;24355;26408,39420,1,0,5,0,6
62532,140,15080,20938;21030;24894;25326,39420,0,2,2,0,4
62533,140,15081,20782;20912;24261;24469;25101,39420,0,1,4,0,5
62534,140,15082,20915;21059,39420,0,0,2,0,2
62535,140,15083,21158;21297;25022,39420,0,1,2,0,3
62536,140,15084,20922;20994;24889,39420,0,1,2,0,3
62537,140,15085,20865,39420,0,0,1,0,1
62538,140,15094,17307,39785,0,0,0,1,1
62539,140,15097,17819,39785,0,0,0,1,1
62540,140,15098,17407,39785,0,0,0,1,1
62541,140,15101,17529,39785,0,0,0,1,1
62542,140,15104,17724;17803,39785,0,0,0,2,2
62543,140,15107,17945,39785,0,0,0,1,1
62544,140,15118,19257;19576;24211,39785,0,0,2,1,3
62545,140,15120,19137;19549,39785,0,0,1,1,2
62546,140,15124,19573;19719,39785,0,0,2,0,2
62547,140,15127,19969;20170;24535,39785,0,0,3,0,3
62548,140,15128,20120,39785,0,0,1,0,1
62549,140,15131,19985;20135,39785,0,0,2,0,2
62550,140,15133,19919;23817;24319,39785,0,0,3,0,3
62551,140,15134,19910;20294;24437,39785,0,0,3,0,3
62552,140,15136,20282,39785,0,0,1,0,1
62553,140,15137,20037;23809,39785,0,0,2,0,2
62554,140,15138,20072;20239,39785,0,0,2,0,2
62555,140,15141,20262;20559;24138,39785,0,0,3,0,3
62556,140,15142,20265;20617;24141,39785,0,0,3,0,3
62557,140,15143,20267;20941,39785,0,0,2,0,2
62558,140,15144,20272;20953;23871;24568,39785,0,0,4,0,4
62559,140,15145,20276;20764,39785,0,0,2,0,2
62560,140,15146,20251;20434;24132,39785,0,0,3,0,3
62561,140,15147,20150;20285,39785,0,0,2,0,2
62562,140,15149,20378;20556,39785,0,0,2,0,2
62563,140,15150,20498;25196,39785,0,1,1,0,2
62564,140,15151,20549;20656,39785,0,0,2,0,2
62565,140,15152,20532;20560;23638;24235,39785,0,0,4,0,4
62566,140,15153,20903;23753;24068;24259;24358;24664;24784;25543,39785,0,2,6,0,8
62567,140,15154,21298,39785,0,0,1,0,1
62568,140,15155,21038;24375,39785,0,0,2,0,2
62569,140,15156,21415;24287;25031;25551,39785,0,2,2,0,4
62570,140,15157,20734;24343,39785,0,0,2,0,2
62571,140,15158,20702;20946;24999;25095,39785,0,2,2,0,4
62572,140,15159,20269;20718,39785,0,0,2,0,2
62573,140,15160,20788,39785,0,0,1,0,1
62574,140,15161,20784;20826;23748;26484,39785,1,0,3,0,4
62575,140,15162,20850;20913;23751;24067;25647,39785,0,1,4,0,5
62576,140,15164,21253,39785,0,0,1,0,1
62577,140,15165,20887;21227,39785,0,0,2,0,2
62578,140,15166,20889;20989,39785,0,0,2,0,2
62579,140,15167,20890;21394;24086;24810;24918;25218,39785,0,3,3,0,6
62580,140,15168,20639;20908;24468;24665,39785,0,0,4,0,4
62581,140,15169,20871;21150;24274,39785,0,0,3,0,3
62582,140,15170,20940;21414,39785,0,0,2,0,2
62583,140,15171,20624;20942;24471,39785,0,0,3,0,3
62584,140,15172,20964;21380;23872,39785,0,0,3,0,3
62585,140,15173,20690;20965;24569,39785,0,0,3,0,3
62586,140,15174,21259;21409;24496;25116;25210,39785,0,2,3,0,5
62587,140,15175,20431;21053;24485;24797,39785,0,1,3,0,4
62588,140,15176,21074;21313;25024,39785,0,1,2,0,3
62589,140,15177,16478,40150,0,0,0,1,1
62590,140,15186,17458,40150,0,0,0,1,1
62591,140,15195,18691,40150,0,0,0,1,1
62592,140,15204,19418,40150,0,0,0,1,1
62593,140,15205,19296;19508,40150,0,0,1,1,2
62594,140,15209,19383;19586,40150,0,0,1,1,2
62595,140,15210,19775;23793,40150,0,0,2,0,2
62596,140,15211,19447,40150,0,0,1,0,1
62597,140,15212,19864;20213;23829,40150,0,0,3,0,3
62598,140,15213,20034;20613,40150,0,0,2,0,2
62599,140,15214,19625;20065,40150,0,0,2,0,2
62600,140,15215,19829;20084;24114,40150,0,0,3,0,3
62601,140,15216,19956;20451,40150,0,0,2,0,2
62602,140,15217,20178;20692;25197,40150,0,1,2,0,3
62603,140,15218,20200;20329;24767,40150,0,1,2,0,3
62604,140,15219,19738;20230,40150,0,0,2,0,2
62605,140,15220,20298;20598;24336,40150,0,0,3,0,3
62606,140,15223,20432,40150,0,0,1,0,1
62607,140,15224,20444;20930;24263,40150,0,0,3,0,3
62608,140,15225,20094;20445;24133,40150,0,0,3,0,3
62609,140,15226,20455;20967;24264;24787;25008,40150,0,2,3,0,5
62610,140,15228,20438;20838;24351;24783;24883;26303,40150,1,2,3,0,6
62611,140,15230,20552;20572,40150,0,0,2,0,2
62612,140,15231,20280;20581;24237,40150,0,0,3,0,3
62613,140,15232,20341;20626,40150,0,0,2,0,2
62614,140,15233,19697;20070;24993,40150,0,1,2,0,3
62615,140,15234,20411,40150,0,0,1,0,1
62616,140,15235,20662;21068,40150,0,0,2,0,2
62617,140,15236,20548;20699,40150,0,0,2,0,2
62618,140,15237,21039;21145,40150,0,0,2,0,2
62619,140,15238,20727;20898,40150,0,0,2,0,2
62620,140,15240,20577;20999;24169,40150,0,0,3,0,3
62621,140,15241,20770;20888;23752;25438,40150,0,1,3,0,4
62622,140,15243,20478;20932,40150,0,0,2,0,2
62623,140,15244,20553;20840;23350;23447,40150,0,0,4,0,4
62624,140,15245,20844;20856;23866;24162,40150,0,0,4,0,4
62625,140,15246,20879;21138;24578,40150,0,0,3,0,3
62626,140,15247,21060;24486;24672;26008,40150,1,0,3,0,4
62627,140,15248,20165;23448;23869;24357;26207,40150,1,0,4,0,5
62628,140,15249,20773;20849,40150,0,0,2,0,2
62629,140,15250,21359,40150,0,0,1,0,1
62630,140,15251,20972;24474;25200,40150,0,1,2,0,3
62631,140,15252,20974;20979;24368;24790,40150,0,1,3,0,4
62632,140,15253,20289;21004,40150,0,0,2,0,2
62633,140,15254,21007;21153;25545,40150,0,1,2,0,3
62634,140,15255,21000;21033,40150,0,0,2,0,2
62635,140,15256,20516;21034;24481,40150,0,0,3,0,3
62636,140,15257,21011;21044;23873;24791,40150,0,1,3,0,4
62637,140,15258,21069;21250,40150,0,0,2,0,2
62638,140,15259,21070,40150,0,0,1,0,1
62639,140,15260,21072;24271,40150,0,0,2,0,2
62640,140,15261,21090;21293,40150,0,0,2,0,2
62641,140,15262,21262;24386;24585;24909;25117,40150,0,2,3,0,5
62642,140,15263,20993;21137;24577,40150,0,0,3,0,3
62643,140,15265,21173;24800;25111,40150,0,2,1,0,3
62644,140,15266,21493;24395,40150,0,0,2,0,2
62645,140,15267,16751;17115,40515,0,0,0,2,2
62646,140,15269,16994,40515,0,0,0,1,1
62647,140,15270,16761,40515,0,0,0,1,1
62648,140,15271,17240;17287,40515,0,0,0,2,2
62649,140,15272,17145,40515,0,0,0,1,1
62650,140,15276,17043,40515,0,0,0,1,1
62651,140,15278,17602,40515,0,0,0,1,1
62652,140,15280,17907,40515,0,0,0,1,1
62653,140,15282,17828;18165,40515,0,0,0,2,2
62654,140,15287,18203,40515,0,0,0,1,1
62655,140,15289,18316;18431,40515,0,0,0,2,2
62656,140,15290,18442;18995,40515,0,0,0,2,2
62657,140,15293,18251;18400,40515,0,0,0,2,2
62658,140,15297,18501;18522,40515,0,0,0,2,2
62659,140,15302,19913,40515,0,0,1,0,1
62660,140,15308,19851;20311,40515,0,0,2,0,2
62661,140,15309,19841;19921,40515,0,0,2,0,2
62662,140,15310,19709;20025;23319;23611,40515,0,0,4,0,4
62663,140,15312,20305;20324;23834,40515,0,0,3,0,3
62664,140,15313,20139,40515,0,0,1,0,1
62665,140,15316,19730;20266,40515,0,0,2,0,2
62666,140,15317,20408;23632;24442;24873,40515,0,1,3,0,4
62667,140,15318,20254;20359;23121,40515,0,0,3,0,3
62668,140,15320,20045;20614;24544,40515,0,0,3,0,3
62669,140,15323,20917;24360,40515,0,0,2,0,2
62670,140,15324,20204;20362,40515,0,0,2,0,2
62671,140,15326,20681;20843,40515,0,0,2,0,2
62672,140,15327,20525;20877;24564,40515,0,0,3,0,3
62673,140,15328,20426;20563;24444,40515,0,0,3,0,3
62674,140,15329,20781;21080,40515,0,0,2,0,2
62675,140,15330,20786;24350;25319;26498,40515,1,1,2,0,4
62676,140,15331,19972;20701;24549,40515,0,0,3,0,3
62677,140,15332,20593;21162;24897,40515,0,1,2,0,3
62678,140,15333,20599;21278,40515,0,0,2,0,2
62679,140,15335,20458;20824;24158;24252;24562;26201,40515,1,0,5,0,6
62680,140,15336,20638;21356,40515,0,0,2,0,2
62681,140,15337,20650;20716;23852;24243;24452,40515,0,0,5,0,5
62682,140,15338,20675;21049;23455;24312;24795,40515,0,1,4,0,5
62683,140,15339,20569;20677;24145;24878,40515,0,1,3,0,4
62684,140,15340,21217;21392;25029;25128,40515,0,2,2,0,4
62685,140,15342,20758;24060;25001,40515,0,1,2,0,3
62686,140,15343,20955;21047;24376;24671,40515,0,0,4,0,4
62687,140,15344,21035;21214;24686,40515,0,0,3,0,3
62688,140,15346,20852,40515,0,0,1,0,1
62689,140,15347,20819;20866;24465;24663;24886;25004,40515,0,2,4,0,6
62690,140,15348,20748;20896;24256,40515,0,0,3,0,3
62691,140,15349,20343;20936;25006,40515,0,1,2,0,3
62692,140,15350,20647;20914;25005,40515,0,1,2,0,3
62693,140,15351,20895;21304,40515,0,0,2,0,2
62694,140,15352,21525;21661;24925;25346;25553,40515,0,3,2,0,5
62695,140,15353,20939;21156,40515,0,0,2,0,2
62696,140,15354,20820;24251;25321,40515,0,1,2,0,3
62697,140,15355,21219;21441;25134,40515,0,1,2,0,3
62698,140,15356,20976;21052;24172,40515,0,0,3,0,3
62699,140,15357,20919;20977;24669,40515,0,0,3,0,3
62700,140,15358,21364;21424;24187;25654,40515,0,1,3,0,4
62701,140,15359,21290;25335,40515,0,1,1,0,2
62702,140,15360,21474;25552,40515,0,1,1,0,2
62703,140,15361,20685;21159,40515,0,0,2,0,2
62704,140,15362,21295;24083;24497;24586;25120,40515,0,1,4,0,5
62705,140,15363,20995;21086;24488;25327,40515,0,1,3,0,4
62706,140,15364,20547;21023;24268;25104,40515,0,1,3,0,4
62707,140,15365,20586;21208;25113,40515,0,1,2,0,3
62708,140,15366,20655;21180;23878,40515,0,0,3,0,3
62709,140,15367,20804;21186;24493;25016,40515,0,1,3,0,4
62710,140,15368,20904;21189,40515,0,0,2,0,2
62711,140,15369,21203;24902,40515,0,1,1,0,2
62712,140,15370,21209;21252;24584;24804,40515,0,1,3,0,4
62713,140,15371,20691;21254;24805,40515,0,1,2,0,3
62714,140,15372,21449;24288;24596;25222,40515,0,1,3,0,4
62715,140,15373,21280;24691;25212,40515,0,1,2,0,3
62716,140,15374,21289;21387;24693,40515,0,0,3,0,3
62717,140,15375,21291,40515,0,0,1,0,1
62718,140,15376,21220;24279;24904,40515,0,1,2,0,3
62719,140,15377,21307;21347;23573;25741,40515,0,1,3,0,4
62720,140,15378,16856,40880,0,0,0,1,1
62721,140,15379,16929,40880,0,0,0,1,1
62722,140,15380,16879,40880,0,0,0,1,1
62723,140,15383,16952,40880,0,0,0,1,1
62724,140,15384,17274;17706,40880,0,0,0,2,2
62725,140,15385,17268,40880,0,0,0,1,1
62726,140,15389,17544;17596,40880,0,0,0,2,2
62727,140,15390,17558,40880,0,0,0,1,1
62728,140,15395,17752,40880,0,0,0,1,1
62729,140,15398,18176,40880,0,0,0,1,1
62730,140,15402,22945,40880,0,0,1,0,1
62731,140,15406,19569;23688;25820,40880,0,1,2,0,3
62732,140,15409,19008,40880,0,0,0,1,1
62733,140,15412,19363;19954,40880,0,0,1,1,2
62734,140,15415,19193;19769,40880,0,0,1,1,2
62735,140,15417,19241;19706,40880,0,0,1,1,2
62736,140,15418,19834;20162;24646;24765,40880,0,1,3,0,4
62737,140,15420,19457;20104;24222,40880,0,0,3,0,3
62738,140,15423,20157;20405;24034,40880,0,0,3,0,3
62739,140,15425,20837;20971;23451;24473;24668;24789,40880,0,1,5,0,6
62740,140,15426,20183;20631,40880,0,0,2,0,2
62741,140,15427,20503;20811;24459,40880,0,0,3,0,3
62742,140,15428,21001;25202,40880,0,1,1,0,2
62743,140,15430,20522;20578,40880,0,0,2,0,2
62744,140,15431,20867;23975;24466,40880,0,0,3,0,3
62745,140,15432,20576;20666;23961,40880,0,0,3,0,3
62746,140,15434,21506;24820;25656,40880,0,2,1,0,3
62747,140,15435,20594;20835;24161,40880,0,0,3,0,3
62748,140,15436,20777;21114;24798,40880,0,1,2,0,3
62749,140,15437,21064;21537;23772;24087;24710;24926;25138,40880,0,2,5,0,7
62750,140,15438,20883;21257;24690;25441,40880,0,1,3,0,4
62751,140,15439,20900;25323,40880,0,1,1,0,2
62752,140,15440,20960;23756,40880,0,0,2,0,2
62753,140,15441,20962;21471,40880,0,0,2,0,2
62754,140,15442,21021;21081;24480,40880,0,0,3,0,3
62755,140,15443,21372;25339;25444;25549,40880,0,3,1,0,4
62756,140,15444,21123;21236,40880,0,0,2,0,2
62757,140,15445,21077;24673;24895;25649,40880,0,2,2,0,4
62758,140,15446,21201;24685;24801,40880,0,1,2,0,3
62759,140,15447,21105;21340,40880,0,0,2,0,2
62760,140,15448,21120;21633;24932,40880,0,1,2,0,3
62761,140,15449,21140;25013;25331,40880,0,2,1,0,3
62762,140,15450,21453;24816;25135,40880,0,2,1,0,3
62763,140,15451,21174;21645;24933,40880,0,1,2,0,3
62764,140,15452,20755;21188;23764;24900;25017,40880,0,2,3,0,5
62765,140,15453,21187;21193;24683;24901,40880,0,1,3,0,4
62766,140,15454,21202;21554;24824;25034,40880,0,2,2,0,4
62767,140,15455,21207;21286;25213,40880,0,1,2,0,3
62768,140,15456,21126;21258;25206,40880,0,1,2,0,3
62769,140,15458,21163;21488;24193;24704,40880,0,0,4,0,4
62770,140,15459,20751;21288,40880,0,0,2,0,2
62771,140,15460,21642;25660,40880,0,1,1,0,2
62772,140,15461,21818;21878;25056,40880,0,1,2,0,3
62773,140,15462,21734;24513;24613,40880,0,0,3,0,3
62774,140,15463,21277;21403;24593;25550,40880,0,1,3,0,4
62775,140,15464,21411;23667;25343;25446;26090,40880,1,2,2,0,5
62776,140,15470,17181;17562,41245,0,0,0,2,2
62777,140,15472,17618,41245,0,0,0,1,1
62778,140,15474,17397,41245,0,0,0,1,1
62779,140,15479,17689;18062,41245,0,0,0,2,2
62780,140,15480,17550,41245,0,0,0,1,1
62781,140,15481,18110;18336,41245,0,0,0,2,2
62782,140,15483,18298;18339,41245,0,0,0,2,2
62783,140,15485,18430;18495,41245,0,0,0,2,2
62784,140,15493,19079,41245,0,0,0,1,1
62785,140,15497,19026;19551;23182;25724,41245,0,1,2,1,4
62786,140,15504,19700;23902;24012;26490,41245,1,0,3,0,4
62787,140,15505,20218;20534;24651,41245,0,0,3,0,3
62788,140,15506,19951;20629;24450,41245,0,0,3,0,3
62789,140,15507,20016;24116;24320,41245,0,0,3,0,3
62790,140,15513,20281;20449,41245,0,0,2,0,2
62791,140,15515,20273;20601;24543,41245,0,0,3,0,3
62792,140,15516,20221;20372,41245,0,0,2,0,2
62793,140,15518,20502;20561,41245,0,0,2,0,2
62794,140,15521,20197;20632,41245,0,0,2,0,2
62795,140,15522,20441;20679;23555,41245,0,0,3,0,3
62796,140,15524,20705;23857;24246,41245,0,0,3,0,3
62797,140,15525,20300;20897;24565,41245,0,0,3,0,3
62798,140,15526,20935;21196,41245,0,0,2,0,2
62799,140,15527,20558;20796;23972,41245,0,0,3,0,3
62800,140,15528,20667;20834;25198,41245,0,1,2,0,3
62801,140,15530,20868;20920;24467;25098,41245,0,1,3,0,4
62802,140,15531,21509;24601;25137;25225;25919,41245,0,3,2,0,5
62803,140,15532,20925;24362,41245,0,0,2,0,2
62804,140,15533,20858;23875;24174;25011;25329,41245,0,2,3,0,5
62805,140,15534,20943;21115,41245,0,0,2,0,2
62806,140,15535,20982;21042;24265;25201,41245,0,1,3,0,4
62807,140,15536,20990;21499;24706;25742,41245,0,1,3,0,4
62808,140,15537,21002;21109;24574,41245,0,0,3,0,3
62809,140,15538,21045;21087;24484;24571,41245,0,0,4,0,4
62810,140,15539,21051;24796,41245,0,1,1,0,2
62811,140,15541,21089;21133;24573;24674;25106,41245,0,1,4,0,5
62812,140,15542,21093,41245,0,0,1,0,1
62813,140,15543,20686;20721,41245,0,0,2,0,2
62814,140,15544,21760;22006;24299;25562,41245,0,1,3,0,4
62815,140,15545,21352;21393;24190;24917;25129,41245,0,2,3,0,5
62816,140,15546,21119;21176;24898,41245,0,1,2,0,3
62817,140,15547,21020;21121;25012,41245,0,1,2,0,3
62818,140,15548,21073;21141;24176;25332;25825,41245,0,2,3,0,5
62819,140,15549,21565;24292;24827,41245,0,1,2,0,3
62820,140,15550,21213;21231,41245,0,0,2,0,2
62821,140,15551,21168;21235;24803;25115,41245,0,2,2,0,4
62822,140,15552,21248;21273,41245,0,0,2,0,2
62823,140,15553,20848;21296;24387,41245,0,0,3,0,3
62824,140,15554,21351;21865;25154;25471,41245,0,2,2,0,4
62825,140,15555,21108;21903,41245,0,0,2,0,2
62826,140,15556,21242;21594;24831,41245,0,1,2,0,3
62827,140,15557,21366;21523,41245,0,0,2,0,2
62828,140,15558,21369;21701;25561;25662,41245,0,2,2,0,4
62829,140,15559,21370;21577;25037,41245,0,1,2,0,3
62830,140,15560,21130;21439;24815;25221,41245,0,2,2,0,4
62831,140,15561,21435;21794;25365;26210,41245,1,1,2,0,4
62832,140,15562,21455;21545;23773;24711;25033;25229,41245,0,2,4,0,6
62833,140,15563,21457;21543,41245,0,0,2,0,2
62834,140,15564,21873;25055,41245,0,1,1,0,2
62835,140,15565,21500;21801;24517;24944;25051;25837,41245,0,3,3,0,6
62836,140,15566,21379;21508,41245,0,0,2,0,2
62837,140,15567,21302;21513;24602,41245,0,0,3,0,3
62838,140,15568,21446;21714;24297;24936;25046,41245,0,2,3,0,5
62839,140,15569,21833;25927,41245,0,1,1,0,2
62840,140,15570,17132,41610,0,0,0,1,1
62841,140,15573,17111,41610,0,0,0,1,1
62842,140,15576,17607,41610,0,0,0,1,1
62843,140,15578,17880,41610,0,0,0,1,1
62844,140,15580,17483,41610,0,0,0,1,1
62845,140,15587,18394;18880,41610,0,0,0,2,2
62846,140,15589,17755,41610,0,0,0,1,1
62847,140,15598,18859;18874,41610,0,0,0,2,2
62848,140,15600,19481;19859,41610,0,0,2,0,2
62849,140,15605,20277;20526;23434,41610,0,0,3,0,3
62850,140,15606,19362,41610,0,0,0,1,1
62851,140,15608,20087,41610,0,0,1,0,1
62852,140,15609,20049;20147;24430,41610,0,0,3,0,3
62853,140,15611,20243;20659;23554;24339;26275,41610,1,0,4,0,5
62854,140,15615,20358;23719,41610,0,0,2,0,2
62855,140,15616,20637;23442,41610,0,0,2,0,2
62856,140,15617,20737;23249,41610,0,0,2,0,2
62857,140,15618,20082;20419,41610,0,0,2,0,2
62858,140,15619,19936;20180,41610,0,0,2,0,2
62859,140,15621,20386;20588;24238,41610,0,0,3,0,3
62860,140,15622,20695;20988,41610,0,0,2,0,2
62861,140,15623,20730;21107;25330,41610,0,1,2,0,3
62862,140,15624,20203;20731;24777,41610,0,1,2,0,3
62863,140,15625,20787;20921,41610,0,0,2,0,2
62864,140,15626,20984;21268;24910,41610,0,1,2,0,3
62865,140,15627,20875;21320;24391,41610,0,0,3,0,3
62866,140,15628,20878;21447;24595,41610,0,0,3,0,3
62867,140,15629,21276,41610,0,0,1,0,1
62868,140,15630,20640;20902,41610,0,0,2,0,2
62869,140,15631,20958;21124;25007,41610,0,1,2,0,3
62870,140,15632,20674;20978,41610,0,0,2,0,2
62871,140,15633,20696,41610,0,0,1,0,1
62872,140,15634,20680;21012;24477;24792;24893,41610,0,2,3,0,5
62873,140,15635,20923;21019;24374;25824,41610,0,1,3,0,4
62874,140,15636,21043;21478,41610,0,0,2,0,2
62875,140,15637,21046,41610,0,0,1,0,1
62876,140,15639,20756;21065;25105,41610,0,1,2,0,3
62877,140,15640,21405,41610,0,0,1,0,1
62878,140,15641,21097;21111;25328,41610,0,1,2,0,3
62879,140,15642,21404;24813,41610,0,1,1,0,2
62880,140,15643,21608;21750;25041,41610,0,1,2,0,3
62881,140,15644,21371;23768;24698;24914,41610,0,1,3,0,4
62882,140,15645,21157;24275;24492;24896;25014;25110,41610,0,3,3,0,6
62883,140,15646,21579;21706;25663,41610,0,1,2,0,3
62884,140,15647,20855;21412;24814,41610,0,1,2,0,3
62885,140,15648,21185;24681;25827,41610,0,1,2,0,3
62886,140,15649,20968;21192;23142;24682,41610,0,0,4,0,4
62887,140,15650,20961;21423;25131;25829,41610,0,2,2,0,4
62888,140,15652,21299;21337;23993;24184;25023;25652,41610,0,2,4,0,6
62889,140,15653,21301;21420;24920;25220,41610,0,2,2,0,4
62890,140,15654,20815;21482;24394,41610,0,0,3,0,3
62891,140,15655,21342;25025,41610,0,1,1,0,2
62892,140,15656,21485;24599,41610,0,0,2,0,2
62893,140,15657,21376;21528;25828,41610,0,1,2,0,3
62894,140,15658,21397;21421;24191;24700;25130;25445;26202,41610,1,2,4,0,7
62895,140,15660,21434;22036;24744,41610,0,0,3,0,3
62896,140,15661,21479,41610,0,0,1,0,1
62897,140,15662,21249;21483;24290;24598;25830,41610,0,1,4,0,5
62898,140,15664,21237;21327;24589,41610,0,0,3,0,3
62899,140,15665,21578;21674;25456;25745,41610,0,2,2,0,4
62900,140,15666,21772;25247;25564,41610,0,2,1,0,3
62901,140,15667,21973;24742;24959;25476;25673;25754,41610,0,4,2,0,6
62902,140,15668,21504;24819,41610,0,1,1,0,2
62903,140,15669,21456;21467;24922;25345,41610,0,2,2,0,4
62904,140,15670,21261;21660;25744,41610,0,1,2,0,3
62905,140,15671,17018,41975,0,0,0,1,1
62906,140,15676,17859;17963,41975,0,0,0,2,2
62907,140,15677,17846,41975,0,0,0,1,1
62908,140,15681,18269;18407,41975,0,0,0,2,2
62909,140,15683,18429,41975,0,0,0,1,1
62910,140,15686,18706,41975,0,0,0,1,1
62911,140,15697,19883;24217,41975,0,0,2,0,2
62912,140,15700,19925,41975,0,0,1,0,1
62913,140,15708,20192;21132;24576;25109;25650,41975,0,2,3,0,5
62914,140,15709,19941;20658;23853;23960;24453;26294,41975,1,0,5,0,6
62915,140,15710,19876;20095,41975,0,0,2,0,2
62916,140,15711,20308;20706;23557;24455,41975,0,0,4,0,4
62917,140,15712,20442;20743,41975,0,0,2,0,2
62918,140,15714,20767;21206;24557;24660,41975,0,0,4,0,4
62919,140,15715,19930,41975,0,0,1,0,1
62920,140,15717,20735;21218;24582;25651,41975,0,1,3,0,4
62921,140,15718,20670;20762;23969;24249,41975,0,0,4,0,4
62922,140,15719,20769;23252;25092;26369,41975,1,1,2,0,4
62923,140,15720,20771;20799,41975,0,0,2,0,2
62924,140,15721,20831;20907;24260,41975,0,0,3,0,3
62925,140,15722,20901;24566,41975,0,0,2,0,2
62926,140,15723,20636;20833,41975,0,0,2,0,2
62927,140,15724,20928;21129,41975,0,0,2,0,2
62928,140,15725,20633;21179,41975,0,0,2,0,2
62929,140,15726,20364;21006;24371;25204,41975,0,1,3,0,4
62930,140,15727,21566;21606,41975,0,0,2,0,2
62931,140,15729,21165;24579;24677;26009,41975,1,0,3,0,4
62932,140,15730,21062;21223;25333,41975,0,1,2,0,3
62933,140,15732,21085;21260;24908;25334,41975,0,2,2,0,4
62934,140,15733,21116;21443;24702;25655,41975,0,1,3,0,4
62935,140,15734,21149;21662;24510,41975,0,0,3,0,3
62936,140,15735,20466;21181;24680;24899,41975,0,1,3,0,4
62937,140,15739,21117;21233;23766;24906;25114,41975,0,2,3,0,5
62938,140,15740,21590;24929,41975,0,1,1,0,2
62939,140,15741,20660;21239;24280;25020,41975,0,1,3,0,4
62940,140,15742,21269;21308;24911;25118,41975,0,2,2,0,4
62941,140,15743,21267;21284;24182;24284;24692;25119;25547,41975,0,2,5,0,7
62942,140,15744,21139;21303;24388,41975,0,0,3,0,3
62943,140,15745,21331;21450;24921,41975,0,1,2,0,3
62944,140,15746,21375;24809,41975,0,1,1,0,2
62945,140,15747,21071;21381;23997;24699;25340,41975,0,1,4,0,5
62946,140,15748,21560;21757;25244,41975,0,1,2,0,3
62947,140,15749,21464;21953;25570,41975,0,1,2,0,3
62948,140,15750,20952,41975,0,0,1,0,1
62949,140,15751,21539;21738;24927,41975,0,1,2,0,3
62950,140,15752,21541;22089,41975,0,0,2,0,2
62951,140,15753,21551,41975,0,0,1,0,1
62952,140,15754,21559;22106,41975,0,0,2,0,2
62953,140,15755,21692;21970,41975,0,0,2,0,2
62954,140,15758,21598;21829;24844;25366,41975,0,2,2,0,4
62955,140,15759,21600;21800;25039,41975,0,1,2,0,3
62956,140,15760,21707;22081;24745,41975,0,0,3,0,3
62957,140,15761,20975,41975,0,0,1,0,1
62958,140,15763,21640;25922,41975,0,1,1,0,2
62959,140,15764,21323;21895;24411;24738;25155,41975,0,1,4,0,5
62960,140,15765,21444;21845;25054;25152,41975,0,2,2,0,4
62961,140,15767,21808;21822,41975,0,0,2,0,2
62962,140,15768,21726;21795;24838,41975,0,1,2,0,3
62963,140,15769,21777;25248,41975,0,1,1,0,2
62964,140,15770,21425;22021;24208;25675;25756,41975,0,2,3,0,5
62965,140,15771,21712;21723;24937,41975,0,1,2,0,3
62966,140,15772,21758;21870;24952,41975,0,1,2,0,3
62967,140,15774,17449,42340,0,0,0,1,1
62968,140,15775,17316,42340,0,0,0,1,1
62969,140,15780,18042;18235,42340,0,0,0,2,2
62970,140,15782,18287,42340,0,0,0,1,1
62971,140,15784,18876,42340,0,0,0,1,1
62972,140,15786,19001,42340,0,0,0,1,1
62973,140,15790,19198;19672,42340,0,0,1,1,2
62974,140,15799,20137,42340,0,0,1,0,1
62975,140,15800,19698;19699,42340,0,0,2,0,2
62976,140,15802,20012;20043;24429,42340,0,0,3,0,3
62977,140,15804,19820;20088;24115,42340,0,0,3,0,3
62978,140,15805,20113;20511;24447,42340,0,0,3,0,3
62979,140,15808,20214;20508,42340,0,0,2,0,2
62980,140,15809,21178;24679;25015;25207,42340,0,2,2,0,4
62981,140,15810,20371;20536;24234,42340,0,0,3,0,3
62982,140,15811,20583;20641;24547;24877,42340,0,1,3,0,4
62983,140,15812,20763;20876,42340,0,0,2,0,2
62984,140,15813,20749;20774,42340,0,0,2,0,2
62985,140,15815,20813;21527,42340,0,0,2,0,2
62986,140,15816,20672;20853;23864;24352,42340,0,0,4,0,4
62987,140,15817,20707;20869,42340,0,0,2,0,2
62988,140,15818,20873;20969;25199,42340,0,1,2,0,3
62989,140,15819,20283;20951;23755;24472,42340,0,0,4,0,4
62990,140,15820,20551;20966;24667;25102,42340,0,1,3,0,4
62991,140,15821,21010;24373;24476;26305,42340,1,0,3,0,4
62992,140,15822,21009;21031;24372;25009,42340,0,1,3,0,4
62993,140,15823,21027;21623;25355;25834,42340,0,2,2,0,4
62994,140,15824,21079;21164;25826,42340,0,1,2,0,3
62995,140,15825,21125;21496;24291;24817,42340,0,1,3,0,4
62996,140,15826,21144;21705,42340,0,0,2,0,2
62997,140,15827,21146;21197;25018,42340,0,1,2,0,3
62998,140,15828,20657;21148,42340,0,0,2,0,2
62999,140,15829,21182;21183,42340,0,0,2,0,2
63000,140,15830,21212;21736;24840,42340,0,1,2,0,3
63001,140,15831,21899;21910;25254,42340,0,1,2,0,3
63002,140,15832,21225;24494;24687;24905;25546,42340,0,2,3,0,5
63003,140,15834,20880;21246;24583,42340,0,0,3,0,3
63004,140,15835,21264;21830;25150;25465,42340,0,2,2,0,4
63005,140,15836,21229;21334;24499;25337,42340,0,1,3,0,4
63006,140,15837,20973;21346;23882;24392;24808;25123;26208,42340,1,2,4,0,7
63007,140,15838,21546;21763,42340,0,0,2,0,2
63008,140,15839,21472;21635,42340,0,0,2,0,2
63009,140,15840,21063;21427;24701;25132,42340,0,1,3,0,4
63010,140,15841,21336;21522,42340,0,0,2,0,2
63011,140,15842,21292;21529;24604;24822;25032;25554,42340,0,3,3,0,6
63012,140,15843,21552;21575;24398;24507,42340,0,0,4,0,4
63013,140,15844,21561;25350;25450,42340,0,2,1,0,3
63014,140,15845,21222;21591;24508;25231,42340,0,1,3,0,4
63015,140,15846,21383;21595;24196;25452;25833;26007;26203,42340,1,3,3,0,7
63016,140,15847,21652;21680;24198;25237;25558,42340,0,2,3,0,5
63017,140,15848,21502;21872;25252,42340,0,1,2,0,3
63018,140,15849,21721;22059;26308,42340,1,0,2,0,3
63019,140,15850,21694;24403;25457,42340,0,1,2,0,3
63020,140,15851,21100;21722;25362;25835,42340,0,2,2,0,4
63021,140,15852,21725,42340,0,0,1,0,1
63022,140,15853,21729;22181,42340,0,0,2,0,2
63023,140,15854,21759;22260;25171;25490;26030,42340,1,2,2,0,5
63024,140,15855,21358;21769;25246,42340,0,1,2,0,3
63025,140,15856,21099;21532;24709;24823,42340,0,1,3,0,4
63026,140,15857,21852;25568;25929,42340,0,2,1,0,3
63027,140,15858,21799;25148,42340,0,1,1,0,2
63028,140,15859,21636;21804;24518;25463,42340,0,1,3,0,4
63029,140,15860,21817;22121;25577;25679,42340,0,2,2,0,4
63030,140,15861,21820;21886;24949;25464,42340,0,2,2,0,4
63031,140,15862,21802;21861;25153,42340,0,1,2,0,3
63032,140,15863,21866;22055;24522;25472,42340,0,1,3,0,4
63033,140,15864,21994;22066;24307;24961;26108,42340,1,1,3,0,5
63034,140,15875,18511,42705,0,0,0,1,1
63035,140,15877,18460;18568,42705,0,0,0,2,2
63036,140,15884,19210,42705,0,0,0,1,1
63037,140,15888,19631,42705,0,0,1,0,1
63038,140,15892,19765;19888,42705,0,0,2,0,2
63039,140,15900,19942,42705,0,0,1,0,1
63040,140,15901,20644;24338,42705,0,0,2,0,2
63041,140,15903,20446;20839,42705,0,0,2,0,2
63042,140,15906,20390;20477;23333,42705,0,0,3,0,3
63043,140,15908,20514;24650,42705,0,0,2,0,2
63044,140,15909,20543;20597,42705,0,0,2,0,2
63045,140,15910,20726;21285;24806,42705,0,1,2,0,3
63046,140,15911,20484;20741;23562;24457;24880,42705,0,1,4,0,5
63047,140,15912,21255;24689;25209,42705,0,1,2,0,3
63048,140,15913,20807,42705,0,0,1,0,1
63049,140,15914,20393;20857;23974,42705,0,0,3,0,3
63050,140,15915,21154;21194;24676,42705,0,0,3,0,3
63051,140,15916,21265;24181;24282;25211;26301,42705,1,1,3,0,5
63052,140,15917,21305;21885;25253;25473,42705,0,2,2,0,4
63053,140,15918,20926;21309;24389,42705,0,0,3,0,3
63054,140,15919,21353;21416;24697;25027;25124;25653,42705,0,3,3,0,6
63055,140,15920,21232;21377;23884,42705,0,0,3,0,3
63056,140,15922,21216;21410;25219;25342,42705,0,2,2,0,4
63057,140,15924,21417;21688,42705,0,0,2,0,2
63058,140,15926,21422;21874;24737;24953;25369;26105,42705,1,2,3,0,6
63059,140,15927,21728;22175;25168;25938;26311,42705,1,2,2,0,5
63060,140,15929,21440;21571;25351,42705,0,1,2,0,3
63061,140,15931,21452;22157;26025,42705,1,0,2,0,3
63062,140,15932,21619;24833;25354,42705,0,2,1,0,3
63063,140,15933,21362;21740;24406;25242,42705,0,1,3,0,4
63064,140,15934,21587;21859,42705,0,0,2,0,2
63065,140,15935,21484;21751;25143;26102,42705,1,1,2,0,4
63066,140,15936,22168;22356;25498;25860,42705,0,2,2,0,4
63067,140,15937,21531;21675,42705,0,0,2,0,2
63068,140,15938,21766;22013;24963,42705,0,1,2,0,3
63069,140,15939,21567;25036;25832,42705,0,2,1,0,3
63070,140,15940,21784;21917;24515;24727;24942;25049;25363;25836,42705,0,4,4,0,8
63071,140,15941,21597;25038;25233,42705,0,2,1,0,3
63072,140,15942,21612;22188;25073;26114,42705,1,1,2,0,4
63073,140,15943,21384;21625;24399;24931;25234,42705,0,2,3,0,5
63074,140,15944,21516;21957;24741;25064;25373,42705,0,2,3,0,5
63075,140,15945,21466;21654;24703,42705,0,0,3,0,3
63076,140,15947,22312;22327;24857;25587,42705,0,2,2,0,4
63077,140,15948,21911;24955;25157,42705,0,2,1,0,3
63078,140,15949,21742;21849;23775;25250,42705,0,1,3,0,4
63079,140,15950,22237;22265;26028,42705,1,0,2,0,3
63080,140,15951,21646;21921;25059;25371;25474,42705,0,3,2,0,5
63081,140,15952,21240;21807;24728;24842;24946;25052;25838,42705,0,4,3,0,7
63082,140,15953,21810;22095;24947,42705,0,1,2,0,3
63083,140,15954,21812;21847,42705,0,0,2,0,2
63084,140,15955,22031;22196;25269;25583;26313,42705,1,2,2,0,5
63085,140,15956,22104;25263,42705,0,1,1,0,2
63086,140,15957,21838;22286;24973;25494,42705,0,2,2,0,4
63087,140,15958,22009;22025;24964;25479,42705,0,2,2,0,4
63088,140,15959,22149,42705,0,0,1,0,1
63089,140,15960,21524;21843;25567;26014,42705,1,1,2,0,4
63090,140,15961,21881;21892,42705,0,0,2,0,2
63091,140,15962,21888;22302,42705,0,0,2,0,2
63092,140,15963,21568;21894;24622;24847;25666;25840,42705,0,3,3,0,6
63093,140,15964,21704;21906;25370;25667;26307,42705,1,2,2,0,5
63094,140,15965,21946;22147,42705,0,0,2,0,2
63095,140,15966,21555;21977;25755,42705,0,1,2,0,3
63096,140,15967,22023;24625;25161;25574,42705,0,2,2,0,4
63097,140,15970,17588,43070,0,0,0,1,1
63098,140,15971,17471,43070,0,0,0,1,1
63099,140,15972,17569,43070,0,0,0,1,1
63100,140,15974,17950;18321,43070,0,0,0,2,2
63101,140,15975,17491,43070,0,0,0,1,1
63102,140,15976,17642,43070,0,0,0,1,1
63103,140,15977,17949,43070,0,0,0,1,1
63104,140,15982,18643,43070,0,0,0,1,1
63105,140,15987,18996;19594,43070,0,0,1,1,2
63106,140,15989,19524,43070,0,0,1,0,1
63107,140,15996,19869;20729;24055;24148;24553,43070,0,0,5,0,5
63108,140,16000,20700;23033;23650,43070,0,0,3,0,3
63109,140,16001,20171;20428,43070,0,0,2,0,2
63110,140,16003,20252;20373,43070,0,0,2,0,2
63111,140,16004,20747;24659,43070,0,0,2,0,2
63112,140,16006,19909;20366;24769,43070,0,1,2,0,3
63113,140,16008,20425;20768,43070,0,0,2,0,2
63114,140,16009,20125;20587,43070,0,0,2,0,2
63115,140,16011,20512;20676,43070,0,0,2,0,2
63116,140,16017,20817;21390,43070,0,0,2,0,2
63117,140,16018,20822;20910;25100,43070,0,1,2,0,3
63118,140,16020,20933;21501;24195,43070,0,0,3,0,3
63119,140,16021,20987;21518;24603;24821;25227,43070,0,2,3,0,5
63120,140,16022,21075;21350;25026;25338,43070,0,2,2,0,4
63121,140,16027,21592;21836;23893,43070,0,0,3,0,3
63122,140,16028,21234;21716,43070,0,0,2,0,2
63123,140,16029,21215;21282;23765;23879,43070,0,0,4,0,4
63124,140,16030,21512;24708;26101,43070,1,0,2,0,3
63125,140,16031,21083;21321;24913;25442,43070,0,2,2,0,4
63126,140,16032,21134;21329;24695,43070,0,0,3,0,3
63127,140,16033,21607;24930;25352,43070,0,2,1,0,3
63128,140,16034,21029;21245;24495;25208;26501,43070,1,1,3,0,5
63129,140,16035,21127;21402;24393;24812,43070,0,1,3,0,4
63130,140,16036,21426;21839;25151;25467,43070,0,2,2,0,4
63131,140,16037,20719;21437;25133;26010,43070,1,1,2,0,4
63132,140,16038,21311;21510;25226;25447,43070,0,2,2,0,4
63133,140,16039,21629;24716;25043;25235,43070,0,2,2,0,4
63134,140,16040,21659;21988,43070,0,0,2,0,2
63135,140,16041,21118;21664;24400;24719;24934;25357;25557,43070,0,3,4,0,7
63136,140,16042,21768;25145;25461,43070,0,2,1,0,3
63137,140,16043,21563;21702;24712;24826;25230,43070,0,2,3,0,5
63138,140,16044,21703;21908;25241,43070,0,1,2,0,3
63139,140,16045,21761;22236;25392;26027,43070,1,1,2,0,4
63140,140,16047,21720;22003;25065;25159,43070,0,2,2,0,4
63141,140,16048,21530;21767;25657,43070,0,1,2,0,3
63142,140,16049,21621;21771;25664,43070,0,1,2,0,3
63143,140,16050,21775;22391;24755;25596;25770;25947,43070,0,3,3,0,6
63144,140,16051,21798;22354;25592;25687,43070,0,2,2,0,4
63145,140,16052,21809;22301;24729;25149;25749,43070,0,2,3,0,5
63146,140,16053,21841;26013,43070,1,0,1,0,2
63147,140,16054,21923,43070,0,0,1,0,1
63148,140,16055,21790;22241;25270;25682,43070,0,2,2,0,4
63149,140,16056,21883;21968;24304;25158;26497,43070,1,1,3,0,5
63150,140,16057,22073;22080;25384,43070,0,1,2,0,3
63151,140,16059,21942;22034;25670,43070,0,1,2,0,3
63152,140,16060,21948;22178;25388;25580;25849;26214,43070,1,3,2,0,6
63153,140,16062,22010;22249;25160;25378;26213,43070,1,2,2,0,5
63154,140,16063,22022;22287;25274;25763;26032,43070,1,2,2,0,5
63155,140,16064,22043;22045;25259;26020,43070,1,1,2,0,4
63156,140,16065,21896;22054;24966;25163,43070,0,2,2,0,4
63157,140,16066,21916;22584;25698,43070,0,1,2,0,3
63158,140,16067,22109;22155;24630,43070,0,0,3,0,3
63159,140,16068,21796;22094;25070,43070,0,1,2,0,3
63160,140,16069,22092;22111;24746;24855;25165,43070,0,2,3,0,5
63161,140,16070,22113;22133;25937,43070,0,1,2,0,3
63162,140,16071,21930;22240;24635,43070,0,0,3,0,3
63163,140,16072,21955;22140;24632;25266;25578,43070,0,2,3,0,5
63164,140,16073,22148;25760,43070,0,1,1,0,2
63165,140,16076,17636,43435,0,0,0,1,1
63166,140,16077,17764,43435,0,0,0,1,1
63167,140,16078,17499,43435,0,0,0,1,1
63168,140,16084,18427;18601,43435,0,0,0,2,2
63169,140,16085,18459,43435,0,0,0,1,1
63170,140,16086,17965,43435,0,0,0,1,1
63171,140,16094,19102,43435,0,0,0,1,1
63172,140,16098,19486,43435,0,0,1,0,1
63173,140,16105,20607;20812;23750;24781,43435,0,1,3,0,4
63174,140,16107,21056;24572,43435,0,0,2,0,2
63175,140,16108,20712;20800;24550,43435,0,0,3,0,3
63176,140,16110,20847;21091;25107,43435,0,1,2,0,3
63177,140,16113,20861;21339;24807;25216,43435,0,2,2,0,4
63178,140,16115,20970;21067;24487,43435,0,0,3,0,3
63179,140,16118,20949;21131;24490,43435,0,0,3,0,3
63180,140,16119,21147;21407;24286;24919;25030;26496,43435,1,2,3,0,6
63181,140,16120,20986;23757;24369;24890;26410,43435,1,1,3,0,5
63182,140,16121,21128;21211;24581;24903,43435,0,1,3,0,4
63183,140,16122,21143;21300,43435,0,0,2,0,2
63184,140,16123,21283;21709;24094;24405;25458,43435,0,1,4,0,5
63185,140,16124,21230;21322;25122;25336,43435,0,2,2,0,4
63186,140,16125,21644;21987;24849;25377,43435,0,2,2,0,4
63187,140,16126,20957;21361;24500;25126,43435,0,1,3,0,4
63188,140,16127,21459;25223,43435,0,1,1,0,2
63189,140,16128,21378;21695;25028,43435,0,1,2,0,3
63190,140,16129,21413;21481;25136;25918;26011,43435,1,2,2,0,5
63191,140,16130,21570;21980;25572;26018,43435,1,1,2,0,4
63192,140,16131,21547,43435,0,0,1,0,1
63193,140,16133,21312;21589;24928,43435,0,1,2,0,3
63194,140,16134,21609;21975;25477,43435,0,1,2,0,3
63195,140,16135,21626;21902;24412,43435,0,0,3,0,3
63196,140,16136,21897;25156,43435,0,1,1,0,2
63197,140,16137,21663,43435,0,0,1,0,1
63198,140,16138,21684;21939;25238,43435,0,1,2,0,3
63199,140,16139,22061;25933,43435,0,1,1,0,2
63200,140,16140,21733;22492;25181;26220,43435,1,1,2,0,4
63201,140,16141,21271;21748;24939,43435,0,1,2,0,3
63202,140,16142,21710;21958;25257,43435,0,1,2,0,3
63203,140,16143,21314;21780;24615;26103,43435,1,0,3,0,4
63204,140,16144,21813;22214;25851,43435,0,1,2,0,3
63205,140,16145,21604;21931;24958;25668,43435,0,2,2,0,4
63206,140,16146,21540;21863;24410;24736;25251;26104,43435,1,1,4,0,6
63207,140,16147,21884;22378;25284;25595,43435,0,2,2,0,4
63208,140,16148,21318;21827;24730;25565;25665,43435,0,2,3,0,5
63209,140,16150,21088;21912;25057;25255,43435,0,2,2,0,4
63210,140,16151,21922;22261;25271,43435,0,1,2,0,3
63211,140,16152,21774;21933;24413;25930;26212,43435,1,1,3,0,5
63212,140,16153,21429;21934,43435,0,0,2,0,2
63213,140,16154,21937;22091;24854,43435,0,1,2,0,3
63214,140,16155,22306;25077;25277;25766,43435,0,3,1,0,4
63215,140,16156,21708;22098;24629;25484,43435,0,1,3,0,4
63216,140,16157,22017;22410;25501;25862,43435,0,2,2,0,4
63217,140,16158,21797;22056;25164;25382;25677;25932,43435,0,4,2,0,6
63218,140,16159,22064;22125;24852;25068;25262;26111,43435,1,3,2,0,6
63219,140,16160,22074;22438,43435,0,0,2,0,2
63220,140,16161,22215;22305;25276;25496,43435,0,2,2,0,4
63221,140,16162,22076;22299;25685,43435,0,1,2,0,3
63222,140,16163,22078;22502;24862;25182;25869;26126,43435,1,3,2,0,6
63223,140,16164,22047;22314,43435,0,0,2,0,2
63224,140,16165,22019;22359,43435,0,0,2,0,2
63225,140,16166,22276;24972;25684,43435,0,2,1,0,3
63226,140,16167,22293;25495;25943,43435,0,2,1,0,3
63227,140,16168,22145;22162,43435,0,0,2,0,2
63228,140,16169,22330;25396,43435,0,1,1,0,2
63229,140,16170,22177;22423;26037,43435,1,0,2,0,3
63230,140,16171,22180;22316;25581;26113,43435,1,1,2,0,4
63231,140,16172,22475,43435,0,0,1,0,1
63232,140,16173,22218;22321,43435,0,0,2,0,2
63233,140,16174,21432;22267;26031,43435,1,0,2,0,3
63234,140,16175,22274;22385;25400;26419,43435,1,1,2,0,4
63235,140,16176,17537,43800,0,0,0,1,1
63236,140,16177,17953,43800,0,0,0,1,1
63237,140,16179,17989,43800,0,0,0,1,1
63238,140,16180,17994,43800,0,0,0,1,1
63239,140,16182,18216;18227,43800,0,0,0,2,2
63240,140,16183,18384,43800,0,0,0,1,1
63241,140,16185,18119,43800,0,0,0,1,1
63242,140,16186,18123,43800,0,0,0,1,1
63243,140,16188,18138,43800,0,0,0,1,1
63244,140,16189,18705,43800,0,0,0,1,1
63245,140,16190,18749;18881,43800,0,0,0,2,2
63246,140,16192,19128,43800,0,0,0,1,1
63247,140,16196,18752,43800,0,0,0,1,1
63248,140,16197,19183,43800,0,0,0,1,1
63249,140,16202,19406,43800,0,0,0,1,1
63250,140,16209,19815;20115,43800,0,0,2,0,2
63251,140,16210,20331;20339;23236,43800,0,0,3,0,3
63252,140,16211,20406;20722;24551,43800,0,0,3,0,3
63253,140,16213,20433;20476,43800,0,0,2,0,2
63254,140,16214,20290;20479;24649,43800,0,0,3,0,3
63255,140,16219,20661;24340,43800,0,0,2,0,2
63256,140,16221,21210;25440,43800,0,1,1,0,2
63257,140,16223,20436;20518;24233,43800,0,0,3,0,3
63258,140,16225,20564;20754;23968;25096;25542,43800,0,2,3,0,5
63259,140,16226,21199;25019,43800,0,1,1,0,2
63260,140,16228,20320;20630;24655;24774,43800,0,1,3,0,4
63261,140,16230,20468;21013;24478;25205,43800,0,1,3,0,4
63262,140,16231,21266;21615;25453,43800,0,1,2,0,3
63263,140,16232,21433;21687,43800,0,0,2,0,2
63264,140,16235,20665;21332,43800,0,0,2,0,2
63265,140,16236,21251;24907,43800,0,1,1,0,2
63266,140,16237,20996;21272;24283;25021,43800,0,1,3,0,4
63267,140,16238,21078,43800,0,0,1,0,1
63268,140,16239,21345;22028;24098;24626,43800,0,0,4,0,4
63269,140,16240,21924;22212,43800,0,0,2,0,2
63270,140,16241,21643;22050;24419;25066;26021,43800,1,1,3,0,5
63271,140,16242,21330;21511;24505;24924;25448,43800,0,2,3,0,5
63272,140,16243,21024;21520;25449,43800,0,1,2,0,3
63273,140,16245,21564;25035,43800,0,1,1,0,2
63274,140,16246,21486;21711;24612;25746,43800,0,1,3,0,4
63275,140,16247,21668;22085;24967,43800,0,1,2,0,3
63276,140,16248,21533;21681;24199;25661,43800,0,1,3,0,4
63277,140,16249,20854;20862;23865;24885;25097;26002,43800,0,3,3,0,6
63278,140,16250,21631;21672;25454,43800,0,1,2,0,3
63279,140,16251,21745;21932;25256;25669,43800,0,2,2,0,4
63280,140,16252,21856;25468,43800,0,1,1,0,2
63281,140,16253,21938;22413,43800,0,0,2,0,2
63282,140,16255,21823;22099,43800,0,0,2,0,2
63283,140,16256,21395;21842;25566;26306,43800,1,1,2,0,4
63284,140,16257,21507;21867;24096;24523;24620;25367,43800,0,1,5,0,6
63285,140,16258,21887;22266;24752;25491,43800,0,1,3,0,4
63286,140,16259,21732;21891;24846;24954,43800,0,2,2,0,4
63287,140,16260,21854;22426;25286,43800,0,1,2,0,3
63288,140,16261,22661;22864;25612;26049;26428,43800,2,1,2,0,5
63289,140,16262,21831;24300,43800,0,0,2,0,2
63290,140,16263,21995;22016;25573;25844,43800,0,2,2,0,4
63291,140,16264,22005;25258,43800,0,1,1,0,2
63292,140,16265,22007;22474;25867,43800,0,1,2,0,3
63293,140,16266,21498;22062,43800,0,0,2,0,2
63294,140,16267,22071;22303;26217,43800,1,0,2,0,3
63295,140,16268,22118;22169;24969;25680,43800,0,2,2,0,4
63296,140,16269,21915;22129;25264;25486;26414,43800,1,2,2,0,5
63297,140,16270,22144;22208;24970;25850,43800,0,2,2,0,4
63298,140,16271,21779;22154;24751;25072;26024,43800,1,1,3,0,5
63299,140,16272,21765;22159;25268;25847;26112,43800,1,2,2,0,5
63300,140,16275,22048;22221;25380,43800,0,1,2,0,3
63301,140,16276,22680;26050,43800,1,0,1,0,2
63302,140,16277,22621;22646;26047,43800,1,0,2,0,3
63303,140,16278,22252;22331;25170;25488;25853;26116,43800,1,3,2,0,6
63304,140,16279,22269;22542,43800,0,0,2,0,2
63305,140,16280,22079;22337;24974;26117,43800,1,1,2,0,4
63306,140,16281,22300;22506,43800,0,0,2,0,2
63307,140,16282,21840;22319;25278,43800,0,1,2,0,3
63308,140,16283,22493;22613;25082;26131,43800,1,1,2,0,4
63309,140,16284,22471,43800,0,0,1,0,1
63310,140,16285,22344;22347;24975;25282;25686;25768;25858,43800,0,5,2,0,7
63311,140,16286,22379;24976,43800,0,1,1,0,2
63312,140,16287,22343;22380;25767;25944,43800,0,2,2,0,4
63313,140,16288,22388;22674;26232,43800,1,0,2,0,3
63314,140,16290,17966,44165,0,0,0,1,1
63315,140,16291,17656,44165,0,0,0,1,1
63316,140,16294,18475,44165,0,0,0,1,1
63317,140,16295,18295;18595,44165,0,0,0,2,2
63318,140,16297,18029;18234,44165,0,0,0,2,2
63319,140,16299,18141,44165,0,0,0,1,1
63320,140,16301,18905,44165,0,0,0,1,1
63321,140,16302,18824,44165,0,0,0,1,1
63322,140,16314,20385;24647,44165,0,0,2,0,2
63323,140,16317,20402,44165,0,0,1,0,1
63324,140,16318,20623;20703,44165,0,0,2,0,2
63325,140,16319,20648;20803;24156;24560;25320,44165,0,1,4,0,5
63326,140,16320,20963;24168;24666,44165,0,0,3,0,3
63327,140,16322,21084;21618;25141,44165,0,1,2,0,3
63328,140,16323,21092;22284,44165,0,0,2,0,2
63329,140,16325,21221;24802,44165,0,1,1,0,2
63330,140,16327,21341;24591,44165,0,0,2,0,2
63331,140,16328,21391;21731;24512;24722,44165,0,0,4,0,4
63332,140,16329,21788;21981;24943,44165,0,1,2,0,3
63333,140,16330,21419;22117;25759,44165,0,1,2,0,3
63334,140,16332,22112;25386;25576,44165,0,2,1,0,3
63335,140,16333,22015;22499;25478,44165,0,1,2,0,3
63336,140,16334,21274;21685,44165,0,0,2,0,2
63337,140,16335,21113;21781;24725;24941;25048;25462,44165,0,3,3,0,6
63338,140,16336,21556;21786;25147,44165,0,1,2,0,3
63339,140,16337,21755;21789;25050;25925,44165,0,2,2,0,4
63340,140,16338,21824;21927;23892,44165,0,0,3,0,3
63341,140,16339,21454;21860;24735;25470;25839,44165,0,2,3,0,5
63342,140,16340,21890;21943;24848;25061,44165,0,2,2,0,4
63343,140,16341,21538;21951;24606;25228,44165,0,1,3,0,4
63344,140,16342,21952;22044;24740;26107,44165,1,0,3,0,4
63345,140,16343,21689;21974,44165,0,0,2,0,2
63346,140,16344,22040,44165,0,0,1,0,1
63347,140,16345,21650;22060;25067;25481,44165,0,2,2,0,4
63348,140,16346,21743;22093;25846;26023;26309,44165,2,1,2,0,5
63349,140,16348,22070;24853;25678,44165,0,2,1,0,3
63350,140,16349,22262;22270;24753;26216;26316,44165,2,0,3,0,5
63351,140,16350,22165;22543;25509;25605,44165,0,2,2,0,4
63352,140,16351,22176;22662,44165,0,0,2,0,2
63353,140,16352,22216;22592,44165,0,0,2,0,2
63354,140,16353,22224;22233;26026,44165,1,0,2,0,3
63355,140,16354,22560;25955,44165,0,1,1,0,2
63356,140,16355,22433;22547;25292;25510,44165,0,2,2,0,4
63357,140,16357,22326;22370;25398;25500,44165,0,2,2,0,4
63358,140,16358,22341;22574;26130;26325,44165,2,0,2,0,4
63359,140,16359,22251;22446;25773;26318,44165,1,1,2,0,4
63360,140,16360,22489;22598,44165,0,0,2,0,2
63361,140,16361,22103;22498;25291;25776;26222,44165,1,2,2,0,5
63362,140,16363,18240;18296,44530,0,0,0,2,2
63363,140,16365,18615;18864,44530,0,0,0,2,2
63364,140,16366,18688,44530,0,0,0,1,1
63365,140,16371,19255;19590,44530,0,0,1,1,2
63366,140,16372,19331,44530,0,0,0,1,1
63367,140,16373,19436,44530,0,0,0,1,1
63368,140,16374,19467;19517,44530,0,0,2,0,2
63369,140,16375,20148,44530,0,0,1,0,1
63370,140,16382,19802;19939,44530,0,0,2,0,2
63371,140,16383,20141;20188;22820,44530,0,0,3,0,3
63372,140,16384,20085;20256,44530,0,0,2,0,2
63373,140,16386,19891;20349,44530,0,0,2,0,2
63374,140,16387,20018;20399;24327,44530,0,0,3,0,3
63375,140,16391,20798,44530,0,0,1,0,1
63376,140,16393,20899;21620;24834,44530,0,1,2,0,3
63377,140,16395,21005;21445;24892;25203,44530,0,2,2,0,4
63378,140,16396,21655;24718,44530,0,0,2,0,2
63379,140,16397,21014,44530,0,0,1,0,1
63380,140,16399,21226;21465;23664;24383,44530,0,0,4,0,4
63381,140,16400,21238;21535,44530,0,0,2,0,2
63382,140,16402,21338,44530,0,0,1,0,1
63383,140,16403,21061;21382;24915;25127;25217,44530,0,3,2,0,5
63384,140,16404,21385;21494;24916;25341,44530,0,2,2,0,4
63385,140,16405,21762;24514;24841;25245,44530,0,2,2,0,4
63386,140,16406,21400;21624;24715;25042;25356;25556,44530,0,3,3,0,6
63387,140,16407,21627;22230;24527,44530,0,0,3,0,3
63388,140,16408,21638;22142;25579,44530,0,1,2,0,3
63389,140,16409,21584;21651;25142;25923,44530,0,2,2,0,4
63390,140,16410,21653;22150;25166,44530,0,1,2,0,3
63391,140,16411,21634;21730,44530,0,0,2,0,2
63392,140,16412,21739;21793;24516;25364,44530,0,1,3,0,4
63393,140,16413,21749;21785,44530,0,0,2,0,2
63394,140,16414,21204,44530,0,0,1,0,1
63395,140,16415,22273;25075;25492,44530,0,2,1,0,3
63396,140,16416,21647;21963;25672;26017,44530,1,1,2,0,4
63397,140,16418,21641;21920;25058,44530,0,1,2,0,3
63398,140,16419,21550;22131;24749;25265,44530,0,1,3,0,4
63399,140,16420,21991;22223;24306,44530,0,0,3,0,3
63400,140,16421,21850;22335;25174;25280,44530,0,2,2,0,4
63401,140,16422,22090;22192;25483;25935,44530,0,2,2,0,4
63402,140,16423,22894;24763;24868;25800;26151,44530,1,2,2,0,5
63403,140,16424,22119;22307;25173;25497,44530,0,2,2,0,4
63404,140,16425,22198;22779;25085;25413,44530,0,2,2,0,4
63405,140,16426,22280;22340;25493,44530,0,1,2,0,3
63406,140,16427,22170;22281;25273;25393;25941,44530,0,3,2,0,5
63407,140,16428,22285;22548;24638;25511;25780,44530,0,2,3,0,5
63408,140,16430,22358;24859;25283;25499,44530,0,3,1,0,4
63409,140,16431,22115;22372;25594,44530,0,1,2,0,3
63410,140,16432,22406;22477;25179;25406;25694,44530,0,3,2,0,5
63411,140,16433,22416;22510;25602,44530,0,1,2,0,3
63412,140,16434,22470;22914;25625,44530,0,1,2,0,3
63413,140,16435,22478;22718,44530,0,0,2,0,2
63414,140,16436,22199;22527;25080;25778;26040,44530,1,2,2,0,5
63415,140,16437,22529;22717;25789;25963;26051,44530,1,2,2,0,5
63416,140,16438,22225;22531;25603;25953,44530,0,2,2,0,4
63417,140,16439,22291;22550;25606;25697,44530,0,2,2,0,4
63418,140,16440,22559;22799;25879;26337,44530,1,1,2,0,4
63419,140,16441,21936;22561;26129;26324,44530,2,0,2,0,4
63420,140,16442,22571;22870;26341,44530,1,0,2,0,3
63421,140,16443,22325;22588;26045,44530,1,0,2,0,3
63422,140,16444,22567;22599;24757;25081;25782,44530,0,2,3,0,5
63423,140,16446,17800,44895,0,0,0,1,1
63424,140,16447,18267;18472,44895,0,0,0,2,2
63425,140,16449,18351;18653,44895,0,0,0,2,2
63426,140,16453,18509,44895,0,0,0,1,1
63427,140,16454,18124,44895,0,0,0,1,1
63428,140,16455,18134,44895,0,0,0,1,1
63429,140,16456,18268,44895,0,0,0,1,1
63430,140,16457,18545;18559,44895,0,0,0,2,2
63431,140,16458,18299,44895,0,0,0,1,1
63432,140,16460,18808,44895,0,0,0,1,1
63433,140,16461,19043,44895,0,0,0,1,1
63434,140,16464,19178,44895,0,0,0,1,1
63435,140,16466,18660,44895,0,0,0,1,1
63436,140,16468,19566,44895,0,0,1,0,1
63437,140,16470,19673;19903,44895,0,0,2,0,2
63438,140,16482,20454,44895,0,0,1,0,1
63439,140,16483,20410;20491,44895,0,0,2,0,2
63440,140,16485,20649;20744;24554,44895,0,0,3,0,3
63441,140,16487,20886,44895,0,0,1,0,1
63442,140,16488,21136;21360;25125,44895,0,1,2,0,3
63443,140,16489,21152;21247;24179,44895,0,0,3,0,3
63444,140,16490,21198,44895,0,0,1,0,1
63445,140,16492,22004;25931,44895,0,1,1,0,2
63446,140,16493,21582;22087,44895,0,0,2,0,2
63447,140,16494,21490;21622;24090;24733,44895,0,0,4,0,4
63448,140,16496,21581;21603;24608;24829,44895,0,1,3,0,4
63449,140,16497,21294;21585;24830;25139,44895,0,2,2,0,4
63450,140,16500,21690;22324;24858;25589,44895,0,2,2,0,4
63451,140,16501,21396;21558,44895,0,0,2,0,2
63452,140,16502,21430;21737,44895,0,0,2,0,2
63453,140,16503,21954;22057;24209;24309;25383;26205,44895,1,1,4,0,6
63454,140,16504,22283;22422;24210;25076;25394;25584;25762;25942;26298,44895,1,5,3,0,9
63455,140,16505,21348;22018,44895,0,0,2,0,2
63456,140,16506,22248;22428;24977;25690,44895,0,2,2,0,4
63457,140,16507,21846;21928;24957,44895,0,1,2,0,3
63458,140,16508,22100;22268;24971;25172;25272,44895,0,3,2,0,5
63459,140,16510,21898;22024;24850;26019,44895,1,1,2,0,4
63460,140,16511,22361;22424,44895,0,0,2,0,2
63461,140,16512,21941;22127;24311,44895,0,0,3,0,3
63462,140,16514,22105;22152;25071;25761,44895,0,2,2,0,4
63463,140,16515,21875;22458;25949,44895,0,1,2,0,3
63464,140,16516,22174;22220;25848,44895,0,1,2,0,3
63465,140,16517,22516;26224,44895,1,0,1,0,2
63466,140,16518,22202;22620;25517;26329,44895,1,1,2,0,4
63467,140,16519,22238;22243,44895,0,0,2,0,2
63468,140,16520,22246;22496;24636;25695;26221,44895,1,1,3,0,5
63469,140,16521,21671;22289;25856;26415,44895,1,1,2,0,4
63470,140,16522,22329;22732;25618;25791,44895,0,2,2,0,4
63471,140,16523,22339;22671;24865;25700;25875,44895,0,3,2,0,5
63472,140,16524,22349;22392;25859,44895,0,1,2,0,3
63473,140,16525,22046;22352,44895,0,0,2,0,2
63474,140,16526,22452;22765,44895,0,0,2,0,2
63475,140,16527,22365;22566;24530;25607;26423,44895,1,1,3,0,5
63476,140,16528,21997;22401,44895,0,0,2,0,2
63477,140,16529,22403;22785;25188;25707;26436,44895,1,2,2,0,5
63478,140,16530,21787;21990;24960,44895,0,1,2,0,3
63479,140,16531,22838,44895,0,0,1,0,1
63480,140,16532,22386;22420;25599,44895,0,1,2,0,3
63481,140,16533,22348;22421;25600,44895,0,1,2,0,3
63482,140,16535,22451;23007;25888;26350,44895,1,1,2,0,4
63483,140,16536,22323;25279;26218,44895,1,1,1,0,3
63484,140,16537,22453;22463;25863;26421,44895,1,1,2,0,4
63485,140,16538,22448;22866;26440,44895,1,0,2,0,3
63486,140,16540,22459;22461,44895,0,0,2,0,2
63487,140,16541,22479;22537;25290;25407;26125,44895,1,2,2,0,5
63488,140,16543,22490;25180,44895,0,1,1,0,2
63489,140,16544,22521;22612;25610;26425,44895,1,1,2,0,4
63490,140,16545,22304;22630;25410;25783,44895,0,2,2,0,4
63491,140,16546,22601;23011,44895,0,0,2,0,2
63492,140,16547,22317;22609;24759,44895,0,0,3,0,3
63493,140,16548,22435;22614;25184;25699,44895,0,2,2,0,4
63494,140,16549,22367;22615,44895,0,0,2,0,2
63495,140,16550,22563;22618;26046,44895,1,0,2,0,3
63496,140,16551,22719;22790;25876;26052,44895,1,1,2,0,4
63497,140,16552,22396;22929;24870;26442,44895,1,1,2,0,4
63498,140,16553,22839;22961;25415,44895,0,1,2,0,3
63499,140,16554,22695,44895,0,0,1,0,1
63500,140,16555,22712;25788;25962;26135;26430,44895,2,2,1,0,5
63501,140,16556,22136;22720,44895,0,0,2,0,2
63502,140,16558,17749,45260,0,0,0,1,1
63503,140,16560,17917,45260,0,0,0,1,1
63504,140,16561,18696,45260,0,0,0,1,1
63505,140,16563,19015;19361,45260,0,0,0,2,2
63506,140,16566,19560,45260,0,0,1,0,1
63507,140,16567,18672,45260,0,0,0,1,1
63508,140,16578,20507,45260,0,0,1,0,1
63509,140,16579,20776,45260,0,0,1,0,1
63510,140,16584,20124,45260,0,0,1,0,1
63511,140,16585,20959,45260,0,0,1,0,1
63512,140,16589,20255;20573;23956,45260,0,0,3,0,3
63513,140,16593,21200;24684;25112,45260,0,1,2,0,3
63514,140,16594,21388;21746,45260,0,0,2,0,2
63515,140,16595,21442;21693;24611;25559,45260,0,1,3,0,4
63516,140,16596,21727;24839;24938;25747,45260,0,3,1,0,4
63517,140,16597,21469;21965;25375,45260,0,1,2,0,3
63518,140,16598,21326;21961;24303;25374,45260,0,1,3,0,4
63519,140,16599,21491;24705,45260,0,0,2,0,2
63520,140,16600,21617;25353,45260,0,1,1,0,2
63521,140,16601,21316;24587,45260,0,0,2,0,2
63522,140,16602,21428;21610;24294;24714;24832;25140,45260,0,2,4,0,6
63523,140,16603,21673;22258;25074;25489;25854;26029,45260,1,3,2,0,6
63524,140,16604,21476;22189;24856;25939,45260,0,2,2,0,4
63525,140,16606,21998;22052;25162;25845;26110,45260,1,2,2,0,5
63526,140,16607,21536;21871;24621;25368,45260,0,1,3,0,4
63527,140,16608,22063;22253;25261,45260,0,1,2,0,3
63528,140,16609,21741;21959;23672;24205;25753;25842,45260,0,2,4,0,6
63529,140,16610,21879;21949;24845,45260,0,1,2,0,3
63530,140,16611,21971;22591;25514;26328,45260,1,1,2,0,4
63531,140,16612,21562;21976;24414;24525;25571,45260,0,1,4,0,5
63532,140,16613,21805;21983;24206;25376;25843,45260,0,2,3,0,5
63533,140,16614,21715;22226;25390,45260,0,1,2,0,3
63534,140,16615,22032;22384;24860;25399;25946;26119,45260,1,3,2,0,6
63535,140,16616,22051;22322;25260;25381,45260,0,2,2,0,4
63536,140,16617,21828;22058;26022,45260,1,0,2,0,3
63537,140,16618,21960;22619;25296,45260,0,1,2,0,3
63538,140,16619,22126;22634;26330;26426,45260,2,0,2,0,4
63539,140,16620,22153;22395;24756;24861,45260,0,1,3,0,4
63540,140,16621,21735;22173;25167;26310,45260,1,1,2,0,4
63541,140,16622,22185;22817,45260,0,0,2,0,2
63542,140,16623,22190;22688,45260,0,0,2,0,2
63543,140,16624,21819;22206,45260,0,0,2,0,2
63544,140,16625,22207;25857,45260,0,1,1,0,2
63545,140,16626,21966;22456;25865,45260,0,1,2,0,3
63546,140,16627,22296;22437;25275;25765,45260,0,2,2,0,4
63547,140,16628,22346;22645;25784;25958;26230,45260,1,2,2,0,5
63548,140,16629,22350;25176;25591,45260,0,2,1,0,3
63549,140,16630,22382;22741;25187;26053,45260,1,1,2,0,4
63550,140,16631,22399;22752,45260,0,0,2,0,2
63551,140,16632,22310;22434;25403,45260,0,1,2,0,3
63552,140,16633,23015;25975,45260,0,1,1,0,2
63553,140,16634,21868;22484;25951,45260,0,1,2,0,3
63554,140,16635,22541;22707;24762;25787;26134,45260,1,1,3,0,5
63555,140,16636,22575;25874;26225,45260,1,1,1,0,3
63556,140,16637,22600;22651;25959;26332,45260,1,1,2,0,4
63557,140,16638,22164;22465,45260,0,0,2,0,2
63558,140,16639,22627;22833;24987;25710;25967,45260,0,3,2,0,5
63559,140,16640,23062;25532;26161,45260,1,1,1,0,3
63560,140,16641,22705;22823;25300;25526;26438,45260,1,2,2,0,5
63561,140,16642,22754;22918,45260,0,0,2,0,2
63562,140,16643,22759;23016;26446,45260,1,0,2,0,3
63563,140,16644,22768;25523;26139,45260,1,1,1,0,3
63564,140,16645,22725;22773,45260,0,0,2,0,2
63565,140,16646,22782;22973;26062,45260,1,0,2,0,3
63566,140,16647,22440;22811,45260,0,0,2,0,2
63567,140,16648,23034;25978,45260,0,1,1,0,2
63568,140,16649,18233,45625,0,0,0,1,1
63569,140,16651,18350,45625,0,0,0,1,1
63570,140,16652,17783,45625,0,0,0,1,1
63571,140,16654,18684,45625,0,0,0,1,1
63572,140,16655,18711,45625,0,0,0,1,1
63573,140,16657,18916,45625,0,0,0,1,1
63574,140,16666,19409,45625,0,0,0,1,1
63575,140,16669,19253,45625,0,0,0,1,1
63576,140,16670,19176,45625,0,0,0,1,1
63577,140,16678,19790;19807,45625,0,0,2,0,2
63578,140,16684,19690;19915,45625,0,0,2,0,2
63579,140,16685,20493,45625,0,0,1,0,1
63580,140,16694,21682;25044,45625,0,1,1,0,2
63581,140,16695,21324;21343,45625,0,0,2,0,2
63582,140,16698,21373;21557;24397;24825;25349;25555;25831,45625,0,4,3,0,7
63583,140,16699,21985,45625,0,0,1,0,1
63584,140,16700,21548;24396;25348;25659,45625,0,2,2,0,4
63585,140,16701,21691;21858;26015,45625,1,0,2,0,3
63586,140,16702,21521;21686;24836;25239,45625,0,2,2,0,4
63587,140,16703,21815;22184;25389;26312,45625,1,1,2,0,4
63588,140,16704,21862;22027;24851,45625,0,1,2,0,3
63589,140,16706,21754;21893;25751,45625,0,1,2,0,3
63590,140,16708,21909;22008,45625,0,0,2,0,2
63591,140,16710,21599,45625,0,0,1,0,1
63592,140,16711,21984;22518;25408;25777;26127;26321,45625,2,2,2,0,6
63593,140,16713,21989,45625,0,0,1,0,1
63594,140,16714,22407;22466;25079,45625,0,1,2,0,3
63595,140,16715,22186,45625,0,0,1,0,1
63596,140,16716,22083,45625,0,0,1,0,1
63597,140,16717,22086;22309;26033,45625,1,0,2,0,3
63598,140,16718,22134,45625,0,0,1,0,1
63599,140,16719,21628;22160;25387,45625,0,1,2,0,3
63600,140,16720,22068;22191;25069;25482;25934,45625,0,3,2,0,5
63601,140,16721,22210;22369;25593;25769,45625,0,2,2,0,4
63602,140,16723,22234;22623,45625,0,0,2,0,2
63603,140,16725,22203;22254,45625,0,0,2,0,2
63604,140,16727,22353;22441;25772,45625,0,1,2,0,3
63605,140,16728,22648,45625,0,0,1,0,1
63606,140,16729,22374;22429,45625,0,0,2,0,2
63607,140,16730,22193;22409;25285;25861;26035,45625,1,2,2,0,5
63608,140,16731,22122;22431,45625,0,0,2,0,2
63609,140,16732,22445;22519;24978;25404,45625,0,2,2,0,4
63610,140,16733,22503;22853;26237;26439,45625,2,0,2,0,4
63611,140,16734,22514;25870,45625,0,1,1,0,2
63612,140,16735,22540;22686;25871,45625,0,1,2,0,3
63613,140,16736,22545;22669;26333,45625,1,0,2,0,3
63614,140,16737,22596;22616;26228,45625,1,0,2,0,3
63615,140,16738,22383;22604;24758;25515;25956,45625,0,2,3,0,5
63616,140,16739,22200;22624;25518;26048,45625,1,1,2,0,4
63617,140,16740,22636;22967;25424,45625,0,1,2,0,3
63618,140,16741,22660;22733;24984;25083;25704;25792;26137,45625,1,4,2,0,7
63619,140,16742,22920,45625,0,0,1,0,1
63620,140,16743,22678;23084,45625,0,0,2,0,2
63621,140,16744,22495;22701;25505;26320,45625,1,1,2,0,4
63622,140,16745,22704;23068,45625,0,0,2,0,2
63623,140,16746,22404;22708;25616,45625,0,1,2,0,3
63624,140,16747,22713;23021,45625,0,0,2,0,2
63625,140,16748,22675;24983;25411;25701,45625,0,3,1,0,4
63626,140,16749,22473;22826;24423,45625,0,0,3,0,3
63627,140,16750,22830;22986;26244,45625,1,0,2,0,3
63628,140,16751,22832;22911;25880,45625,0,1,2,0,3
63629,140,16752,22836;23178;25898,45625,0,1,2,0,3
63630,140,16753,22673;22848,45625,0,0,2,0,2
63631,140,16755,22858;22925;25973,45625,0,1,2,0,3
63632,140,16756,22871;22958;26444,45625,1,0,2,0,3
63633,140,16757,23027;23169,45625,0,0,2,0,2
63634,140,16758,22893;26057;26150,45625,2,0,1,0,3
63635,140,16759,22520;22909,45625,0,0,2,0,2
63636,140,16760,22638;22912,45625,0,0,2,0,2
63637,140,16761,22915;23098;25893,45625,0,1,2,0,3
63638,140,16762,22927;23080;25533;26162;26250,45625,2,1,2,0,5
63639,140,16763,18379,45990,0,0,0,1,1
63640,140,16764,18675,45990,0,0,0,1,1
63641,140,16765,18417,45990,0,0,0,1,1
63642,140,16766,18838,45990,0,0,0,1,1
63643,140,16768,18333,45990,0,0,0,1,1
63644,140,16769,18640,45990,0,0,0,1,1
63645,140,16771,18948,45990,0,0,0,1,1
63646,140,16773,18650,45990,0,0,0,1,1
63647,140,16774,19320,45990,0,0,0,1,1
63648,140,16777,19310,45990,0,0,0,1,1
63649,140,16780,19232,45990,0,0,0,1,1
63650,140,16782,19547;19747,45990,0,0,2,0,2
63651,140,16786,19870,45990,0,0,1,0,1
63652,140,16795,20654,45990,0,0,1,0,1
63653,140,16796,21050,45990,0,0,1,0,1
63654,140,16799,21098;21315;24390;24694;24912;25121;25214,45990,0,3,4,0,7
63655,140,16803,21593;25232,45990,0,1,1,0,2
63656,140,16805,21477;21782;24726;25146,45990,0,1,3,0,4
63657,140,16807,21667;21914;24956;25841,45990,0,2,2,0,4
63658,140,16808,21665;21783;25748,45990,0,1,2,0,3
63659,140,16810,21967;22141;24422;24750;24968;25267,45990,0,2,4,0,6
63660,140,16812,21553;25743;25920,45990,0,2,1,0,3
63661,140,16813,22114;25485;25758,45990,0,2,1,0,3
63662,140,16814,21526;21649,45990,0,0,2,0,2
63663,140,16815,21877;22033;24418;25676,45990,0,1,3,0,4
63664,140,16817,22067,45990,0,0,1,0,1
63665,140,16818,22102;22664;25613;26231,45990,1,1,2,0,4
63666,140,16819,22143;22524;25696;26128,45990,1,1,2,0,4
63667,140,16820,22171;22758,45990,0,0,2,0,2
63668,140,16821,22205;22715;24641,45990,0,0,3,0,3
63669,140,16822,21713;22217;25169;25852,45990,0,2,2,0,4
63670,140,16823,22667;22863,45990,0,0,2,0,2
63671,140,16824,22263;22585;26327,45990,1,0,2,0,3
63672,140,16825,22328,45990,0,0,1,0,1
63673,140,16826,22562;22812;24639,45990,0,0,3,0,3
63674,140,16828,22432;22874;25971;26342,45990,1,1,2,0,4
63675,140,16829,22467;25693,45990,0,1,1,0,2
63676,140,16830,22487;23067,45990,0,0,2,0,2
63677,140,16831,21791;22462;25504;25774;26038;26123;26319,45990,3,2,2,0,7
63678,140,16832,22500;22738,45990,0,0,2,0,2
63679,140,16833,22411;22709;25617,45990,0,1,2,0,3
63680,140,16834,22523,45990,0,0,1,0,1
63681,140,16835,22525;22536;25409,45990,0,1,2,0,3
63682,140,16836,22172;22551,45990,0,0,2,0,2
63683,140,16837,22564;22587,45990,0,0,2,0,2
63684,140,16838,22972;23125;24992,45990,0,1,2,0,3
63685,140,16839,22728;25964,45990,0,1,1,0,2
63686,140,16840,22201;22608;24315;24982;25295;25516;25609,45990,0,4,3,0,7
63687,140,16841,22649,45990,0,0,1,0,1
63688,140,16842,22979;22994;25886;26348,45990,1,1,2,0,4
63689,140,16843,22727;22757;25299;25793;26334,45990,1,2,2,0,5
63690,140,16844,22743;22815;26431,45990,1,0,2,0,3
63691,140,16846,22766;22846;25086,45990,0,1,2,0,3
63692,140,16847,22822;23129;25090;25895;26357;26447,45990,2,2,2,0,6
63693,140,16848,22607;22825,45990,0,0,2,0,2
63694,140,16849,22001;22827;25709,45990,0,1,2,0,3
63695,140,16850,22640;22849;26427,45990,1,0,2,0,3
63696,140,16851,22868;23324,45990,0,0,2,0,2
63697,140,16852,22878;23296,45990,0,0,2,0,2
63698,140,16853,22576;22891;26441,45990,1,0,2,0,3
63699,140,16854,22910;23103;25634,45990,0,1,2,0,3
63700,140,16855,22919;23047;25531;26248,45990,1,1,2,0,4
63701,140,16856,22951;23315;26171;26377,45990,2,0,2,0,4
63702,140,16857,22684;22952;26346,45990,1,0,2,0,3
63703,140,16858,22906;23247,45990,0,0,2,0,2
63704,140,16859,22611;22965;26061,45990,1,0,2,0,3
63705,140,16860,22993;23314;26262,45990,1,0,2,0,3
63706,140,16861,22663;22769;25706;25794,45990,0,2,2,0,4
63707,140,16862,22755;23023;25089;25718;25976;26351,45990,1,3,2,0,6
63708,140,16863,22557;23025,45990,0,0,2,0,2
63709,140,16864,22544;23028;25977;26158,45990,1,1,2,0,4
63710,140,16866,18701,46355,0,0,0,1,1
63711,140,16868,18674,46355,0,0,0,1,1
63712,140,16869,18800;18816,46355,0,0,0,2,2
63713,140,16872,19055,46355,0,0,0,1,1
63714,140,16873,19048,46355,0,0,0,1,1
63715,140,16876,19150,46355,0,0,0,1,1
63716,140,16880,19734,46355,0,0,1,0,1
63717,140,16881,20004,46355,0,0,1,0,1
63718,140,16882,19953;20005,46355,0,0,2,0,2
63719,140,16884,19845,46355,0,0,1,0,1
63720,140,16889,20149,46355,0,0,1,0,1
63721,140,16895,20475,46355,0,0,1,0,1
63722,140,16896,21256;21574,46355,0,0,2,0,2
63723,140,16898,21349;21855;24618;24734;24951,46355,0,1,4,0,5
63724,140,16900,21357;21572,46355,0,0,2,0,2
63725,140,16901,21344;21505;24504;24707;24923,46355,0,1,4,0,5
63726,140,16902,21601;21656,46355,0,0,2,0,2
63727,140,16904,21195;21676;25236;25359,46355,0,2,2,0,4
63728,140,16905,21778;22244;26215,46355,1,0,2,0,3
63729,140,16907,21458;21697;25045;25240;25560,46355,0,3,2,0,5
63730,140,16908,21945;22123;25062;25372,46355,0,2,2,0,4
63731,140,16909,21919,46355,0,0,1,0,1
63732,140,16910,21487;21616;24600;25224;26209,46355,1,1,3,0,5
63733,140,16911,22049;22460;25692,46355,0,1,2,0,3
63734,140,16912,22075,46355,0,0,1,0,1
63735,140,16914,22108;22290,46355,0,0,2,0,2
63736,140,16915,22151;22332,46355,0,0,2,0,2
63737,140,16917,22239;22533;25604;25954;26422,46355,1,2,2,0,5
63738,140,16918,22259;22724;25185;25877,46355,0,2,2,0,4
63739,140,16920,22439;22777;25412;26140;26435,46355,2,1,2,0,5
63740,140,16921,22454;25288,46355,0,1,1,0,2
63741,140,16922,22250;22480,46355,0,0,2,0,2
63742,140,16923,22526;23111;25310,46355,0,1,2,0,3
63743,140,16924,22504;22528;26041;26322,46355,2,0,2,0,4
63744,140,16925,23444,46355,0,0,1,0,1
63745,140,16926,22736;24985;25298,46355,0,2,1,0,3
63746,140,16927,22711,46355,0,0,1,0,1
63747,140,16928,22731;22942;25305;26060,46355,1,1,2,0,4
63748,140,16929,22751;22762;26433,46355,1,0,2,0,3
63749,140,16930,22771;22852;25087;26145,46355,1,1,2,0,4
63750,140,16931,22745;22780,46355,0,0,2,0,2
63751,140,16932,23195;25900;26451,46355,1,1,1,0,3
63752,140,16933,22389;22828;26338,46355,1,0,2,0,3
63753,140,16934,22831;22966;25191;25306,46355,0,2,2,0,4
63754,140,16935,22841;23085;25633,46355,0,1,2,0,3
63755,140,16936,23202;25637;26167,46355,1,1,1,0,3
63756,140,16937,22589;22867;25798;25881,46355,0,2,2,0,4
63757,140,16938,22898;23149;25311;25810;26252;26358,46355,2,2,2,0,6
63758,140,16939,22900;23181,46355,0,0,2,0,2
63759,140,16940,22753;22922;25972;26153,46355,1,1,2,0,4
63760,140,16941,22936;25421;26059,46355,1,1,1,0,3
63761,140,16942,22956;23278,46355,0,0,2,0,2
63762,140,16943,22786;22970;24990;25307;26154;26242,46355,2,2,2,0,6
63763,140,16944,23002;23040;25630;25804;25887;26246,46355,1,3,2,0,6
63764,140,16945,22517;23006;25717,46355,0,1,2,0,3
63765,140,16946,22747;23269,46355,0,0,2,0,2
63766,140,16947,22978;23022;25803;26063,46355,1,1,2,0,4
63767,140,16948,23298;26459,46355,1,0,1,0,2
63768,140,16949,23061;23095;25892;26251,46355,1,1,2,0,4
63769,140,16950,23017;23077;25980,46355,0,1,2,0,3
63770,140,16951,23056;23093;25809,46355,0,1,2,0,3
63771,140,16952,22976;23241;25903;26168;26452,46355,2,1,2,0,5
63772,140,16953,23106;23145;25426,46355,0,1,2,0,3
63773,140,16954,23154;23321,46355,0,0,2,0,2
63774,140,16955,23123;23162,46355,0,0,2,0,2
63775,140,16956,22899;23138;25981;26448,46355,1,1,2,0,4
63776,140,16957,18557,46720,0,0,0,1,1
63777,140,16958,18632,46720,0,0,0,1,1
63778,140,16960,18597,46720,0,0,0,1,1
63779,140,16962,18959,46720,0,0,0,1,1
63780,140,16963,18639;18700,46720,0,0,0,2,2
63781,140,16964,18743,46720,0,0,0,1,1
63782,140,16967,19308,46720,0,0,0,1,1
63783,140,16968,19155,46720,0,0,0,1,1
63784,140,16972,19245,46720,0,0,0,1,1
63785,140,16973,19965,46720,0,0,1,0,1
63786,140,16979,19912;20190,46720,0,0,2,0,2
63787,140,16993,20302,46720,0,0,1,0,1
63788,140,16994,20825;21016,46720,0,0,2,0,2
63789,140,16997,21106;21724;25047,46720,0,1,2,0,3
63790,140,16998,21374;22030;24417;25480,46720,0,1,3,0,4
63791,140,16999,21333;21367;24185;24590;24696;25443,46720,0,1,5,0,6
63792,140,17000,21365;21764;25144;25563,46720,0,2,2,0,4
63793,140,17001,21096;21408;24594,46720,0,0,3,0,3
63794,140,17002,22029;22315;25078;25588;26416,46720,1,2,2,0,5
63795,140,17003,21275;21418;25344,46720,0,1,2,0,3
63796,140,17008,21683;21770,46720,0,0,2,0,2
63797,140,17012,22362;25397;25945;26034,46720,1,2,1,0,4
63798,140,17013,22242;22298,46720,0,0,2,0,2
63799,140,17014,22138;22294;25395;25586;25764,46720,0,3,2,0,5
63800,140,17015,21814;22156,46720,0,0,2,0,2
63801,140,17016,22213;22512;24637;26223,46720,1,0,3,0,4
63802,140,17017,22264;22275;25683,46720,0,1,2,0,3
63803,140,17018,22308;23161,46720,0,0,2,0,2
63804,140,17019,22311;22552;26323,46720,1,0,2,0,3
63805,140,17020,22345;22644;25175;25281;25590,46720,0,3,2,0,5
63806,140,17021,22887;25301;26343,46720,1,1,1,0,3
63807,140,17022,22297;22418;25401;26420,46720,1,1,2,0,4
63808,140,17023,22457,46720,0,0,1,0,1
63809,140,17025,22247;22569;25294;26044,46720,1,1,2,0,4
63810,140,17026,22546;22572;25608;25873,46720,0,2,2,0,4
63811,140,17027,22629;23225;26255;26367,46720,2,0,2,0,4
63812,140,17028,22643;23038,46720,0,0,2,0,2
63813,140,17029,22427;22656;24529;25178;26122,46720,1,1,3,0,5
63814,140,17030,22670;23226;25314;25429;26079,46720,1,2,2,0,5
63815,140,17031,22681;23235;25638;26257,46720,1,1,2,0,4
63816,140,17032,22693;23173;26450,46720,1,0,2,0,3
63817,140,17033,22892;25302,46720,0,1,1,0,2
63818,140,17034,22770;23005;26247;26349,46720,2,0,2,0,4
63819,140,17035,22635;22791;26437,46720,1,0,2,0,3
63820,140,17036,22800;23261,46720,0,0,2,0,2
63821,140,17037,22368;22851;25797;26236,46720,1,1,2,0,4
63822,140,17038,22844;22948;25423;25628,46720,0,2,2,0,4
63823,140,17039,23026;23171;25193;26165,46720,1,1,2,0,4
63824,140,17040,22901;23238;26258;26368,46720,2,0,2,0,4
63825,140,17041,22904;23094;25309,46720,0,1,2,0,3
63826,140,17042,22885;22913;25883,46720,0,1,2,0,3
63827,140,17043,22934;23491,46720,0,0,2,0,2
63828,140,17044,23147,46720,0,0,1,0,1
63829,140,17045,22696;22954;26241,46720,1,0,2,0,3
63830,140,17046,22650;22977;26243,46720,1,0,2,0,3
63831,140,17047,22995;23184;25629;25716,46720,0,2,2,0,4
63832,140,17048,22881;22996;26157,46720,1,0,2,0,3
63833,140,17049,23050;23141;25720;25896,46720,0,2,2,0,4
63834,140,17050,23078;23459;25317;26181,46720,1,1,2,0,4
63835,140,17051,23079;23311;25093,46720,0,1,2,0,3
63836,140,17052,23053;23100;25719,46720,0,1,2,0,3
63837,140,17053,23109;23260,46720,0,0,2,0,2
63838,140,17054,22879;23112;25799,46720,0,1,2,0,3
63839,140,17055,23124;23528;25540;26273,46720,1,1,2,0,4
63840,140,17056,23293;23355;26260,46720,1,0,2,0,3
63841,140,17057,23155;23290;25812;25905;26374,46720,1,2,2,0,5
63842,140,17058,23196;23237;25536,46720,0,1,2,0,3
63843,140,17059,23841,46720,0,0,1,0,1
63844,140,17060,23157;25983;26071,46720,1,1,1,0,3
63845,140,17061,22805;23232;26256,46720,1,0,2,0,3
63846,140,17062,23244,46720,0,0,1,0,1
63847,140,17064,19212,47085,0,0,0,1,1
63848,140,17065,18580,47085,0,0,0,1,1
63849,140,17066,19582,47085,0,0,1,0,1
63850,140,17068,19272,47085,0,0,0,1,1
63851,140,17069,18871;19205,47085,0,0,0,2,2
63852,140,17070,18966;19261,47085,0,0,0,2,2
63853,140,17071,19200,47085,0,0,0,1,1
63854,140,17074,19441;19565,47085,0,0,1,1,2
63855,140,17085,20417,47085,0,0,1,0,1
63856,140,17086,20882,47085,0,0,1,0,1
63857,140,17087,20723,47085,0,0,1,0,1
63858,140,17088,21169,47085,0,0,1,0,1
63859,140,17091,21177,47085,0,0,1,0,1
63860,140,17095,21398;24811,47085,0,1,1,0,2
63861,140,17096,21514;22231;24634;25391;26115,47085,1,1,3,0,5
63862,140,17100,21368;21605;25040,47085,0,1,2,0,3
63863,140,17101,21864;21982;24619;25569,47085,0,1,3,0,4
63864,140,17103,21588;22002;24623,47085,0,0,3,0,3
63865,140,17104,21753;21889;24940;25460;25924,47085,0,3,2,0,5
63866,140,17106,22179;22357;25487,47085,0,1,2,0,3
63867,140,17107,22232;22788;25524,47085,0,1,2,0,3
63868,140,17108,22219;22257;26315,47085,1,0,2,0,3
63869,140,17109,22292;22375;25689;26418,47085,1,1,2,0,4
63870,140,17110,21837;22132;24617;24732;24950;25249;25466;25928,47085,0,4,4,0,8
63871,140,17113,22363;22390;25688,47085,0,1,2,0,3
63872,140,17114,22806,47085,0,0,1,0,1
63873,140,17115,22402,47085,0,0,1,0,1
63874,140,17116,22182;22455;25289;25691;25864,47085,0,3,2,0,5
63875,140,17117,22464;22511,47085,0,0,2,0,2
63876,140,17118,22256;22472;25866;25950,47085,0,2,2,0,4
63877,140,17119,22515;22740;25965,47085,0,1,2,0,3
63878,140,17120,22653;22810;25708;25796;26054;26233,47085,2,2,2,0,6
63879,140,17121,22795;26141,47085,1,0,1,0,2
63880,140,17122,22573;22593,47085,0,0,2,0,2
63881,140,17123,22672;22872,47085,0,0,2,0,2
63882,140,17124,22677;22873;25623,47085,0,1,2,0,3
63883,140,17125,22687;22883;25528;25624,47085,0,2,2,0,4
63884,140,17126,22486;22691;25615,47085,0,1,2,0,3
63885,140,17127,22376;22721;24866;25703,47085,0,2,2,0,4
63886,140,17128,22722;22944;25714;25974,47085,0,2,2,0,4
63887,140,17129,22737;22941,47085,0,0,2,0,2
63888,140,17130,22750;23159;25897,47085,0,1,2,0,3
63889,140,17131,22775;22798,47085,0,0,2,0,2
63890,140,17132,22859;23137;25416;25712;25969;26146,47085,1,3,2,0,6
63891,140,17133,22860;23239;26259,47085,1,0,2,0,3
63892,140,17134,22642;22889,47085,0,0,2,0,2
63893,140,17135,22902;23527;26388;26469,47085,2,0,2,0,4
63894,140,17136,22969,47085,0,0,1,0,1
63895,140,17137,23334,47085,0,0,1,0,1
63896,140,17138,22729;23049,47085,0,0,2,0,2
63897,140,17139,23064,47085,0,0,1,0,1
63898,140,17140,22907;23074,47085,0,0,2,0,2
63899,140,17141,22834;23354;25434;26379,47085,1,1,2,0,4
63900,140,17142,23168;23486;26086;26272,47085,2,0,2,0,4
63901,140,17143,23299;23427;26269,47085,1,0,2,0,3
63902,140,17144,23204;23449;26383;26467,47085,2,0,2,0,4
63903,140,17145,22895;23208;26075;26365,47085,2,0,2,0,4
63904,140,17146,22932;23209;25902;26366,47085,1,1,2,0,4
63905,140,17147,23030;23211;26076,47085,1,0,2,0,3
63906,140,17148,23212;23223;26077,47085,1,0,2,0,3
63907,140,17149,22837;26144,47085,1,0,1,0,2
63908,140,17150,23251;25904;26453,47085,1,1,1,0,3
63909,140,17151,22631;23283,47085,0,0,2,0,2
63910,140,17152,23105;23289,47085,0,0,2,0,2
63911,140,17154,23305,47085,0,0,1,0,1
63912,140,17155,23317;23541,47085,0,0,2,0,2
63913,140,17156,23327;23352;25640,47085,0,1,2,0,3
63914,140,17157,23348;23639;25645,47085,0,1,2,0,3
63915,140,17158,23339;23396;26266,47085,1,0,2,0,3
63916,140,17159,23349;23362;26084,47085,1,0,2,0,3
63917,140,17160,23358;23656,47085,0,0,2,0,2
63918,140,17161,18817,47450,0,0,0,1,1
63919,140,17162,18922,47450,0,0,0,1,1
63920,140,17163,18899,47450,0,0,0,1,1
63921,140,17167,19473,47450,0,0,1,0,1
63922,140,17169,19182,47450,0,0,0,1,1
63923,140,17171,19741,47450,0,0,1,0,1
63924,140,17174,20057,47450,0,0,1,0,1
63925,140,17180,20379,47450,0,0,1,0,1
63926,140,17182,20818,47450,0,0,1,0,1
63927,140,17184,20918;21335;25548,47450,0,1,2,0,3
63928,140,17185,21066,47450,0,0,1,0,1
63929,140,17189,21279;21480,47450,0,0,2,0,2
63930,140,17190,20998,47450,0,0,1,0,1
63931,140,17192,21040,47450,0,0,1,0,1
63932,140,17193,21389;21542;25347;25658,47450,0,2,2,0,4
63933,140,17195,21677;22084,47450,0,0,2,0,2
63934,140,17196,21744;24614;25243;25459,47450,0,2,2,0,4
63935,140,17200,21857;21901;25469,47450,0,1,2,0,3
63936,140,17202,21940,47450,0,0,1,0,1
63937,140,17203,21632;22282;25855,47450,0,1,2,0,3
63938,140,17204,21851,47450,0,0,1,0,1
63939,140,17206,22128;22633;25611,47450,0,1,2,0,3
63940,140,17207,21586;22228;24633;25681;26314,47450,1,1,3,0,5
63941,140,17209,22101,47450,0,0,1,0,1
63942,140,17212,22381;24754;26118,47450,1,0,2,0,3
63943,140,17213,22405;22449,47450,0,0,2,0,2
63944,140,17214,22436;22666;24864;25785,47450,0,2,2,0,4
63945,140,17216,22626;24761,47450,0,0,2,0,2
63946,140,17218,22211;22580;26326,47450,1,0,2,0,3
63947,140,17219,22939;22971,47450,0,0,2,0,2
63948,140,17221,22654;23143,47450,0,0,2,0,2
63949,140,17222,22676;22760;25614;25960,47450,0,2,2,0,4
63950,140,17223,22689;22781;25620;26336,47450,1,1,2,0,4
63951,140,17224,22764;22890,47450,0,0,2,0,2
63952,140,17225,22819;23177;25723;26166,47450,1,1,2,0,4
63953,140,17226,22497;22835;25527;25711;26143;26234;26339,47450,3,2,2,0,7
63954,140,17227,22865;23357;26380,47450,1,0,2,0,3
63955,140,17228,22876;25417,47450,0,1,1,0,2
63956,140,17229,22668;22882;26148,47450,1,0,2,0,3
63957,140,17230,22639;22896;25303;25882,47450,0,2,2,0,4
63958,140,17231,22617;22908;25801;26152,47450,1,1,2,0,4
63959,140,17232,22916;22928;26239,47450,1,0,2,0,3
63960,140,17233,22964;23302;26375,47450,1,0,2,0,3
63961,140,17234,22647;22982;26156,47450,1,0,2,0,3
63962,140,17235,22985;23258,47450,0,0,2,0,2
63963,140,17236,22987;23280;26458,47450,1,0,2,0,3
63964,140,17237,22992;23388;25909,47450,0,1,2,0,3
63965,140,17238,23518,47450,0,0,1,0,1
63966,140,17239,23256;25430;26370;26454,47450,2,1,1,0,4
63967,140,17240,23102,47450,0,0,1,0,1
63968,140,17242,22861;23206;25970;26147;26238;26340,47450,3,1,2,0,6
63969,140,17243,23035,47450,0,0,1,0,1
63970,140,17244,23071;23270;26080,47450,1,0,2,0,3
63971,140,17245,23014;23272;25315,47450,0,1,2,0,3
63972,140,17246,22943;23288;26082,47450,1,0,2,0,3
63973,140,17247,22933;23127;25419;26240;26345,47450,2,1,2,0,5
63974,140,17248,23214;23322;25428,47450,0,1,2,0,3
63975,140,17249,23115;23323,47450,0,0,2,0,2
63976,140,17250,23041;23328;26173;26460,47450,2,0,2,0,4
63977,140,17251,23373;23592;26187;26476,47450,2,0,2,0,4
63978,140,17252,23378;23684,47450,0,0,2,0,2
63979,140,17253,23386;26178,47450,1,0,1,0,2
63980,140,17254,23264;23424;26382,47450,1,0,2,0,3
63981,140,17255,19033,47815,0,0,0,1,1
63982,140,17256,19161,47815,0,0,0,1,1
63983,140,17257,19165,47815,0,0,0,1,1
63984,140,17260,18828,47815,0,0,0,1,1
63985,140,17261,18649,47815,0,0,0,1,1
63986,140,17262,19534,47815,0,0,1,0,1
63987,140,17264,19225;19515,47815,0,0,1,1,2
63988,140,17265,19519;19533,47815,0,0,2,0,2
63989,140,17266,19484,47815,0,0,1,0,1
63990,140,17270,20264;20420,47815,0,0,2,0,2
63991,140,17277,20437,47815,0,0,1,0,1
63992,140,17278,20133;20418;24330,47815,0,0,3,0,3
63993,140,17279,20651;20997;24891;25324,47815,0,2,2,0,4
63994,140,17285,21190;21325;24498;24588;25215,47815,0,1,4,0,5
63995,140,17288,21515,47815,0,0,1,0,1
63996,140,17289,21907;22042,47815,0,0,2,0,2
63997,140,17290,21747;21925,47815,0,0,2,0,2
63998,140,17291,21935,47815,0,0,1,0,1
63999,140,17292,21978;22245;25940,47815,0,1,2,0,3
64000,140,17293,21773;22012,47815,0,0,2,0,2
64001,140,17294,22020;22197;25674,47815,0,1,2,0,3
64002,140,17295,22053,47815,0,0,1,0,1
64003,140,17296,21832;21969,47815,0,0,2,0,2
64004,140,17297,22000,47815,0,0,1,0,1
64005,140,17298,22187;22485;25775;26039,47815,1,1,2,0,4
64006,140,17299,21882;22195;25582,47815,0,1,2,0,3
64007,140,17301,22371;22579;26226;26424,47815,2,0,2,0,4
64008,140,17302,22397;22522;25183;25507,47815,0,2,2,0,4
64009,140,17303,22414;25597;25948;26121;26219,47815,2,2,1,0,5
64010,140,17304,22417;25502;25598;26036;26317,47815,2,2,1,0,5
64011,140,17306,22532;22577,47815,0,0,2,0,2
64012,140,17307,22553;25293;25512;26043,47815,1,2,1,0,4
64013,140,17308,22850;24988;25968,47815,0,2,1,0,3
64014,140,17309,22229,47815,0,0,1,0,1
64015,140,17310,22869,47815,0,0,1,0,1
64016,140,17311,22706;23180;26073,47815,1,0,2,0,3
64017,140,17312,22419;22582,47815,0,0,2,0,2
64018,140,17313,22744;23119;25635;25894,47815,0,2,2,0,4
64019,140,17314,22784;23019,47815,0,0,2,0,2
64020,140,17315,22530;22539;25952,47815,0,1,2,0,3
64021,140,17316,22877;23306;25813;26261,47815,1,1,2,0,4
64022,140,17317,22949;23597;25912,47815,0,1,2,0,3
64023,140,17318,22843;23174,47815,0,0,2,0,2
64024,140,17319,22963;23332;25907;26263,47815,1,1,2,0,4
64025,140,17320,22999;23436;26466,47815,1,0,2,0,3
64026,140,17321,22803;23004;24991,47815,0,1,2,0,3
64027,140,17322,22989;23013,47815,0,0,2,0,2
64028,140,17323,22855;23166;26072,47815,1,0,2,0,3
64029,140,17324,23122,47815,0,0,1,0,1
64030,140,17325,23426;23614;25642;25987,47815,0,2,2,0,4
64031,140,17326,23136;23443,47815,0,0,2,0,2
64032,140,17327,23218;23663,47815,0,0,2,0,2
64033,140,17328,23185;23464,47815,0,0,2,0,2
64034,140,17329,23188;23364;26361,47815,1,0,2,0,3
64035,140,17330,23531;23715;25821;26480,47815,1,1,2,0,4
64036,140,17331,23203;23359;26176,47815,1,0,2,0,3
64037,140,17332,22854;23207;25901,47815,0,1,2,0,3
64038,140,17333,23248;23609,47815,0,0,2,0,2
64039,140,17334,23250;23596;26391,47815,1,0,2,0,3
64040,140,17335,23263;23369,47815,0,0,2,0,2
64041,140,17336,23276;23450;25639;26372;26456,47815,2,1,2,0,5
64042,140,17337,23760,47815,0,0,1,0,1
64043,140,17338,23303;23318,47815,0,0,2,0,2
64044,140,17339,23316;23576;25995,47815,0,1,2,0,3
64045,140,17340,23329;23503,47815,0,0,2,0,2
64046,140,17341,23375;23550;26471,47815,1,0,2,0,3
64047,140,17342,23380;23635,47815,0,0,2,0,2
64048,140,17343,23220;23406,47815,0,0,2,0,2
64049,140,17344,23132;23414;25985,47815,0,1,2,0,3
64050,140,17345,23243;23420;26169,47815,1,0,2,0,3
64051,140,17346,23422;23598,47815,0,0,2,0,2
64052,140,17347,23439;23659,47815,0,0,2,0,2
64053,140,17348,23452;23559;25818;25994,47815,0,2,2,0,4
64054,140,17349,23479,47815,0,0,1,0,1
64055,140,17350,23484;23881,47815,0,0,2,0,2
64056,140,17351,23487;23713;26395,47815,1,0,2,0,3
64057,140,17352,23297;23495;25432;25726;26083,47815,1,2,2,0,5
64058,140,17353,23497;23585;25997,47815,0,1,2,0,3
64059,140,17354,23470;23498;26087;26385,47815,2,0,2,0,4
64060,140,17355,23222;23500,47815,0,0,2,0,2
64061,140,17356,23092;23523,47815,0,0,2,0,2
64062,140,17357,23428;23532;26270,47815,1,0,2,0,3
64063,140,17358,23567;23642,47815,0,0,2,0,2
64064,140,17359,23445;23571;25731;25819;26389;26474,47815,2,2,2,0,6
64065,140,17360,23620;26279;26392,47815,2,0,1,0,3
64066,140,17361,19085,48180,0,0,0,1,1
64067,140,17362,18704,48180,0,0,0,1,1
64068,140,17363,19215,48180,0,0,0,1,1
64069,140,17366,18949,48180,0,0,0,1,1
64070,140,17367,19506,48180,0,0,1,0,1
64071,140,17369,19543,48180,0,0,1,0,1
64072,140,17371,19703,48180,0,0,1,0,1
64073,140,17372,19207,48180,0,0,0,1,1
64074,140,17375,19559,48180,0,0,1,0,1
64075,140,17376,19906;20422,48180,0,0,2,0,2
64076,140,17385,20363,48180,0,0,1,0,1
64077,140,17386,20678;21026,48180,0,0,2,0,2
64078,140,17391,21142,48180,0,0,1,0,1
64079,140,17393,21678;21947;25063;25475,48180,0,2,2,0,4
64080,140,17394,21602,48180,0,0,1,0,1
64081,140,17395,21583,48180,0,0,1,0,1
64082,140,17396,21679;22096;24747;25385;25575,48180,0,2,3,0,5
64083,140,17397,21573;21986,48180,0,0,2,0,2
64084,140,17402,21979,48180,0,0,1,0,1
64085,140,17405,22158;22622;25957,48180,0,1,2,0,3
64086,140,17407,22277;22513;25506,48180,0,1,2,0,3
64087,140,17408,22194;22583,48180,0,0,2,0,2
64088,140,17410,22714;22980;26445,48180,1,0,2,0,3
64089,140,17411,22685;22845,48180,0,0,2,0,2
64090,140,17412,22703,48180,0,0,1,0,1
64091,140,17414,22840;22903;26235,48180,1,0,2,0,3
64092,140,17415,22862;23221;25313;26078,48180,1,1,2,0,4
64093,140,17417,22935;23000;25420;25884;26058;26443,48180,2,2,2,0,6
64094,140,17418,23072;25979;26069;26353,48180,2,1,1,0,4
64095,140,17419,23108;23133,48180,0,0,2,0,2
64096,140,17420,23089;23148;25192;25808,48180,0,2,2,0,4
64097,140,17421,23758,48180,0,0,1,0,1
64098,140,17422,23042;23267;25431,48180,0,1,2,0,3
64099,140,17423,23304;23640;25999,48180,0,1,2,0,3
64100,140,17424,22774;23325;25906;26172,48180,1,1,2,0,4
64101,140,17425,23330;23964;26093;26200,48180,2,0,2,0,4
64102,140,17426,23255;23351;26175;26378,48180,2,0,2,0,4
64103,140,17428,23233;23383;25814;26265,48180,1,1,2,0,4
64104,140,17429,23398;23440,48180,0,0,2,0,2
64105,140,17430,23723,48180,0,0,1,0,1
64106,140,17431,23246;23407;26462,48180,1,0,2,0,3
64107,140,17432,23412,48180,0,0,1,0,1
64108,140,17433,23453,48180,0,0,1,0,1
64109,140,17434,23483;23916,48180,0,0,2,0,2
64110,140,17435,23489;23605,48180,0,0,2,0,2
64111,140,17436,23520;23671,48180,0,0,2,0,2
64112,140,17437,23060;23522,48180,0,0,2,0,2
64113,140,17438,23529;23840,48180,0,0,2,0,2
64114,140,17439,23490;23536,48180,0,0,2,0,2
64115,140,17440,23538;25993,48180,0,1,1,0,2
64116,140,17441,23539,48180,0,0,1,0,1
64117,140,17442,23179;23548,48180,0,0,2,0,2
64118,140,17443,23418;23561,48180,0,0,2,0,2
64119,140,17444,23478;23568,48180,0,0,2,0,2
64120,140,17445,23588;23786,48180,0,0,2,0,2
64121,140,17446,23883;25736,48180,0,1,1,0,2
64122,140,17447,23604;23732;25998;26278,48180,1,1,2,0,4
64123,140,17448,23368;23606;26177,48180,1,0,2,0,3
64124,140,17449,23160;23608,48180,0,0,2,0,2
64125,140,17450,23616;23954;26003,48180,0,1,2,0,3
64126,140,17451,23654;26189,48180,1,0,1,0,2
64127,140,17452,23382;23657,48180,0,0,2,0,2
64128,140,17453,23553;23658,48180,0,0,2,0,2
64129,140,17454,23514;23660,48180,0,0,2,0,2
64130,140,17455,23313;23670,48180,0,0,2,0,2
64131,140,17456,19052,48545,0,0,0,1,1
64132,140,17457,19152,48545,0,0,0,1,1
64133,140,17458,18936,48545,0,0,0,1,1
64134,140,17459,19251,48545,0,0,0,1,1
64135,140,17460,19314;19322,48545,0,0,0,2,2
64136,140,17461,19571,48545,0,0,1,0,1
64137,140,17462,19562,48545,0,0,1,0,1
64138,140,17463,19663,48545,0,0,1,0,1
64139,140,17466,19896,48545,0,0,1,0,1
64140,140,17469,19620,48545,0,0,1,0,1
64141,140,17473,20263;20315,48545,0,0,2,0,2
64142,140,17474,20063;20337,48545,0,0,2,0,2
64143,140,17478,20669;20809,48545,0,0,2,0,2
64144,140,17480,21032,48545,0,0,1,0,1
64145,140,17482,21172,48545,0,0,1,0,1
64146,140,17483,21018,48545,0,0,1,0,1
64147,140,17484,21103,48545,0,0,1,0,1
64148,140,17487,21993;22476;24979;25405;25868;26124,48545,1,3,2,0,6
64149,140,17488,22038,48545,0,0,1,0,1
64150,140,17489,22204;22809,48545,0,0,2,0,2
64151,140,17491,21869;22124;25936,48545,0,1,2,0,3
64152,140,17492,22295;22808;24986;25189;26142,48545,1,2,2,0,5
64153,140,17493,22442;22597;24981,48545,0,1,2,0,3
64154,140,17494,22534;25508;25779;26042,48545,1,2,1,0,4
64155,140,17495,22554;22746;25522;26432,48545,1,1,2,0,4
64156,140,17496,22565;22905;25781;25872,48545,0,2,2,0,4
64157,140,17497,22842;26055,48545,1,0,1,0,2
64158,140,17499,22959,48545,0,0,1,0,1
64159,140,17500,22603,48545,0,0,1,0,1
64160,140,17501,22605;22962;25802,48545,0,1,2,0,3
64161,140,17502,22625,48545,0,0,1,0,1
64162,140,17503,22481;22734;25084;25186;25297;25619;25878,48545,0,5,2,0,7
64163,140,17504,22794;23081;25891,48545,0,1,2,0,3
64164,140,17505,23377;23462;25988,48545,0,1,2,0,3
64165,140,17506,22821;22886,48545,0,0,2,0,2
64166,140,17507,22897;22924;24869;25418;25529,48545,0,3,2,0,5
64167,140,17509,23024;24643;25530,48545,0,1,2,0,3
64168,140,17510,23046;23135;25308;25425;25632;25807,48545,0,4,2,0,6
64169,140,17511,23037;23048,48545,0,0,2,0,2
64170,140,17512,23052;23669,48545,0,0,2,0,2
64171,140,17513,23054;23090,48545,0,0,2,0,2
64172,140,17514,23063;26249,48545,1,0,1,0,2
64173,140,17515,23139;25982;26070,48545,1,1,1,0,3
64174,140,17516,23158;23190,48545,0,0,2,0,2
64175,140,17517,22950;23191,48545,0,0,2,0,2
64176,140,17518,23043;23193;25312;25899,48545,0,2,2,0,4
64177,140,17519,23257;23791;26193,48545,1,0,2,0,3
64178,140,17520,23291;23631;26394,48545,1,0,2,0,3
64179,140,17521,23366;23800,48545,0,0,2,0,2
64180,140,17522,23227;23392,48545,0,0,2,0,2
64181,140,17523,23395,48545,0,0,1,0,1
64182,140,17524,23410;23485,48545,0,0,2,0,2
64183,140,17525,23069;23429,48545,0,0,2,0,2
64184,140,17526,22847;23065;26068,48545,1,0,2,0,3
64185,140,17527,23131;23473;25910;26182,48545,1,1,2,0,4
64186,140,17528,23815,48545,0,0,1,0,1
64187,140,17529,23277;23515,48545,0,0,2,0,2
64188,140,17530,23526,48545,0,0,1,0,1
64189,140,17531,23525;23565;26276;26473,48545,2,0,2,0,4
64190,140,17532,23922;24053;26006,48545,0,1,2,0,3
64191,140,17533,23626;23890;26291,48545,1,0,2,0,3
64192,140,17534,23633;24018,48545,0,0,2,0,2
64193,140,17535,23886,48545,0,0,1,0,1
64194,140,17536,23686;24035,48545,0,0,2,0,2
64195,140,17537,23716;23980,48545,0,0,2,0,2
64196,140,17538,23700;25734,48545,0,1,1,0,2
64197,140,17539,23737;23914;26198;26400,48545,2,0,2,0,4
64198,140,17540,23720;23774,48545,0,0,2,0,2
64199,140,17541,23777;23967,48545,0,0,2,0,2
64200,140,17542,23778;24093,48545,0,0,2,0,2
64201,140,17543,19260,48910,0,0,0,1,1
64202,140,17544,19525,48910,0,0,1,0,1
64203,140,17546,19839;20092,48910,0,0,2,0,2
64204,140,17547,19504,48910,0,0,1,0,1
64205,140,17550,20177,48910,0,0,1,0,1
64206,140,17553,20352,48910,0,0,1,0,1
64207,140,17554,20407,48910,0,0,1,0,1
64208,140,17558,20714,48910,0,0,1,0,1
64209,140,17560,20795,48910,0,0,1,0,1
64210,140,17561,20752;20905,48910,0,0,2,0,2
64211,140,17564,21082,48910,0,0,1,0,1
64212,140,17565,21104,48910,0,0,1,0,1
64213,140,17566,21167,48910,0,0,1,0,1
64214,140,17567,21094,48910,0,0,1,0,1
64215,140,17569,20950;21580;24607;24713;25451,48910,0,1,4,0,5
64216,140,17573,21281;21611;25921,48910,0,1,2,0,3
64217,140,17577,21639;21826;24203;24519;24616;24843;25926,48910,0,2,5,0,7
64218,140,17579,21853,48910,0,0,1,0,1
64219,140,17581,22130,48910,0,0,1,0,1
64220,140,17582,22041;22139;24627;25379,48910,0,1,3,0,4
64221,140,17583,22279,48910,0,0,1,0,1
64222,140,17584,22366,48910,0,0,1,0,1
64223,140,17585,22082,48910,0,0,1,0,1
64224,140,17586,22394;23031;25806;26352,48910,1,1,2,0,4
64225,140,17587,22469;25601,48910,0,1,1,0,2
64226,140,17589,22482;23101;26356,48910,1,0,2,0,3
64227,140,17590,22135,48910,0,0,1,0,1
64228,140,17591,21918,48910,0,0,1,0,1
64229,140,17592,22558;22957,48910,0,0,2,0,2
64230,140,17593,22447;22655,48910,0,0,2,0,2
64231,140,17594,22606;22739;25521;26138,48910,1,1,2,0,4
64232,140,17595,22763;26335;26434,48910,2,0,1,0,3
64233,140,17596,22682,48910,0,0,1,0,1
64234,140,17597,22917;23055,48910,0,0,2,0,2
64235,140,17598,22923,48910,0,0,1,0,1
64236,140,17599,22602;23163;26253,48910,1,0,2,0,3
64237,140,17600,22991;23391;26179,48910,1,0,2,0,3
64238,140,17601,23009;23340,48910,0,0,2,0,2
64239,140,17602,22610;23051;26159,48910,1,0,2,0,3
64240,140,17603,23059;23126,48910,0,0,2,0,2
64241,140,17604,23546,48910,0,0,1,0,1
64242,140,17605,22816;23099;26355,48910,1,0,2,0,3
64243,140,17606,22921,48910,0,0,1,0,1
64244,140,17607,23234;23441;25538;26180,48910,1,1,2,0,4
64245,140,17608,23253;23336;26461,48910,1,0,2,0,3
64246,140,17609,23113;23273;26371;26455,48910,2,0,2,0,4
64247,140,17610,23301;23480;26183;26271,48910,2,0,2,0,4
64248,140,17611,22955;23331;25433,48910,0,1,2,0,3
64249,140,17612,22937;23343;25908;26174,48910,1,1,2,0,4
64250,140,17613,23363;23929,48910,0,0,2,0,2
64251,140,17614,23240;23400;25815,48910,0,1,2,0,3
64252,140,17615,23416;23579;26390,48910,1,0,2,0,3
64253,140,17616,23465;23636;25539;25989,48910,0,2,2,0,4
64254,140,17617,23467;23682;26091,48910,1,0,2,0,3
64255,140,17618,23504;23552;25644,48910,0,1,2,0,3
64256,140,17619,23335;23574,48910,0,0,2,0,2
64257,140,17620,23582;23973;26004,48910,0,1,2,0,3
64258,140,17621,23888;24036,48910,0,0,2,0,2
64259,140,17622,23151;23600,48910,0,0,2,0,2
64260,140,17623,23603;23830;26287,48910,1,0,2,0,3
64261,140,17624,23617;23668,48910,0,0,2,0,2
64262,140,17625,23618;23731;26481,48910,1,0,2,0,3
64263,140,17626,23540;23634,48910,0,0,2,0,2
64264,140,17627,23295;23649,48910,0,0,2,0,2
64265,140,17628,23287;23652,48910,0,0,2,0,2
64266,140,17629,23675;23905,48910,0,0,2,0,2
64267,140,17630,23939;25917,48910,0,1,1,0,2
64268,140,17631,23681;23943;26487,48910,1,0,2,0,3
64269,140,17632,23728,48910,0,0,1,0,1
64270,140,17633,23729;23932,48910,0,0,2,0,2
64271,140,17634,23733,48910,0,0,1,0,1
64272,140,17635,23762;23814;26191,48910,1,0,2,0,3
64273,140,17636,23790;24015,48910,0,0,2,0,2
64274,140,17637,23770;23801;26194;26486,48910,2,0,2,0,4
64275,140,17638,23807;24000;26295;26488,48910,2,0,2,0,4
64276,140,17639,23577;23828;26286,48910,1,0,2,0,3
64277,140,17640,23846;24029,48910,0,0,2,0,2
64278,140,17641,23662;23849,48910,0,0,2,0,2
64279,140,17642,23854;23874;26289,48910,1,0,2,0,3
64280,140,17643,23862,48910,0,0,1,0,1
64281,140,17644,19410,49275,0,0,0,1,1
64282,140,17645,19430;19634,49275,0,0,1,1,2
64283,140,17646,19746,49275,0,0,1,0,1
64284,140,17647,19175,49275,0,0,0,1,1
64285,140,17648,19343,49275,0,0,0,1,1
64286,140,17649,19340,49275,0,0,0,1,1
64287,140,17650,20035,49275,0,0,1,0,1
64288,140,17651,20050,49275,0,0,1,0,1
64289,140,17657,21076;21698;25361,49275,0,1,2,0,3
64290,140,17660,21461,49275,0,0,1,0,1
64291,140,17662,21431,49275,0,0,1,0,1
64292,140,17663,21648,49275,0,0,1,0,1
64293,140,17665,22026;24965;25757,49275,0,2,1,0,3
64294,140,17667,22072,49275,0,0,1,0,1
64295,140,17670,22387;23200;25194;26363,49275,1,1,2,0,4
64296,140,17671,22167;22430;25287;25402;25503,49275,0,3,2,0,5
64297,140,17672,22272;22377,49275,0,0,2,0,2
64298,140,17673,22088;22116;24631;24748,49275,0,0,4,0,4
64299,140,17675,22632;22884;25088;26056;26149,49275,2,1,2,0,5
64300,140,17676,22767;23230,49275,0,0,2,0,2
64301,140,17677,22756;23091;25534;26354,49275,1,1,2,0,4
64302,140,17678,22880,49275,0,0,1,0,1
64303,140,17679,22940,49275,0,0,1,0,1
64304,140,17680,22946;23219;25190;25422;25627,49275,0,3,2,0,5
64305,140,17681,22875;23012;24871;25805;26067,49275,1,2,2,0,5
64306,140,17682,22468,49275,0,0,1,0,1
64307,140,17683,23044;23045;25631,49275,0,1,2,0,3
64308,140,17684,23073;23183;25427;26074;26360,49275,2,1,2,0,5
64309,140,17685,22926;23120,49275,0,0,2,0,2
64310,140,17686,22960;23130,49275,0,0,2,0,2
64311,140,17687,22856;23403,49275,0,0,2,0,2
64312,140,17688,23309,49275,0,0,1,0,1
64313,140,17689,23265;23365,49275,0,0,2,0,2
64314,140,17690,23029,49275,0,0,1,0,1
64315,140,17691,22990,49275,0,0,1,0,1
64316,140,17692,23413;23763;25913,49275,0,1,2,0,3
64317,140,17693,23946,49275,0,0,1,0,1
64318,140,17694,23018;23423;25816,49275,0,1,2,0,3
64319,140,17695,23474,49275,0,0,1,0,1
64320,140,17696,23511;23595;26088,49275,1,0,2,0,3
64321,140,17697,23556;25729;26186,49275,1,1,1,0,3
64322,140,17698,23558;23692,49275,0,0,2,0,2
64323,140,17699,23563;26472,49275,1,0,1,0,2
64324,140,17700,23572;23779;26192;26284;26485,49275,3,0,2,0,5
64325,140,17701,23575;23771;26283,49275,1,0,2,0,3
64326,140,17702,23587,49275,0,0,1,0,1
64327,140,17703,23623;23698;25733,49275,0,1,2,0,3
64328,140,17704,23994,49275,0,0,1,0,1
64329,140,17705,23502;23647,49275,0,0,2,0,2
64330,140,17706,23644;23666;26477,49275,1,0,2,0,3
64331,140,17707,23674;24092;26494,49275,1,0,2,0,3
64332,140,17708,23676;23798,49275,0,0,2,0,2
64333,140,17709,23690;24242,49275,0,0,2,0,2
64334,140,17710,23694;23870;25646;26478,49275,1,1,2,0,4
64335,140,17711,23376;23706,49275,0,0,2,0,2
64336,140,17712,23711;24064,49275,0,0,2,0,2
64337,140,17713,23919;26292,49275,1,0,1,0,2
64338,140,17714,23727;26000,49275,0,1,1,0,2
64339,140,17715,23341;23744;26396;26482,49275,2,0,2,0,4
64340,140,17716,23761,49275,0,0,1,0,1
64341,140,17717,23405;23769;26397,49275,1,0,2,0,3
64342,140,17718,23747;23788;26483,49275,1,0,2,0,3
64343,140,17719,23826;23971,49275,0,0,2,0,2
64344,140,17720,23861;23899,49275,0,0,2,0,2
64345,140,17721,23863;24276,49275,0,0,2,0,2
64346,140,17722,23468;23877;26290,49275,1,0,2,0,3
64347,140,17723,23781;23885;26196,49275,1,0,2,0,3
64348,140,17724,23898;24151,49275,0,0,2,0,2
64349,140,17725,23904;23998,49275,0,0,2,0,2
64350,140,17726,23906;24054,49275,0,0,2,0,2
64351,140,17727,23912;24082,49275,0,0,2,0,2
64352,140,17728,23928;23949,49275,0,0,2,0,2
64353,140,17729,23683;23940,49275,0,0,2,0,2
64354,140,17730,23988;24038,49275,0,0,2,0,2
64355,140,17731,19604,49640,0,0,1,0,1
64356,140,17732,18882,49640,0,0,0,1,1
64357,140,17733,19538;19609,49640,0,0,2,0,2
64358,140,17734,19585,49640,0,0,1,0,1
64359,140,17735,19789;19991,49640,0,0,2,0,2
64360,140,17736,19479,49640,0,0,1,0,1
64361,140,17738,19992,49640,0,0,1,0,1
64362,140,17740,20126,49640,0,0,1,0,1
64363,140,17741,20326;20981,49640,0,0,2,0,2
64364,140,17742,20348,49640,0,0,1,0,1
64365,140,17744,20753,49640,0,0,1,0,1
64366,140,17747,20461,49640,0,0,1,0,1
64367,140,17749,20628,49640,0,0,1,0,1
64368,140,17753,21534,49640,0,0,1,0,1
64369,140,17754,21657,49640,0,0,1,0,1
64370,140,17756,21436;21803,49640,0,0,2,0,2
64371,140,17757,21492;21835;24731;25053,49640,0,1,3,0,4
64372,140,17759,22110,49640,0,0,1,0,1
64373,140,17760,21900,49640,0,0,1,0,1
64374,140,17761,21670;21848;24610;24720;24935;25455,49640,0,2,4,0,6
64375,140,17762,22333,49640,0,0,1,0,1
64376,140,17763,22398,49640,0,0,1,0,1
64377,140,17765,22505;22857;24989,49640,0,1,2,0,3
64378,140,17766,22065,49640,0,0,1,0,1
64379,140,17767,22590,49640,0,0,1,0,1
64380,140,17768,22749;23003,49640,0,0,2,0,2
64381,140,17769,22726;22797;25790;26136,49640,1,1,2,0,4
64382,140,17770,22807,49640,0,0,1,0,1
64383,140,17771,22408,49640,0,0,1,0,1
64384,140,17773,22658;22974;25885;26155,49640,1,1,2,0,4
64385,140,17774,23075;23347,49640,0,0,2,0,2
64386,140,17775,23097,49640,0,0,1,0,1
64387,140,17776,23118,49640,0,0,1,0,1
64388,140,17777,23172,49640,0,0,1,0,1
64389,140,17778,23199,49640,0,0,1,0,1
64390,140,17779,23210;23399;25641;26267;26381,49640,2,1,2,0,5
64391,140,17780,23170;23245;25535,49640,0,1,2,0,3
64392,140,17781,23262;23621,49640,0,0,2,0,2
64393,140,17782,23381;23646,49640,0,0,2,0,2
64394,140,17783,23242;23408,49640,0,0,2,0,2
64395,140,17784,23544,49640,0,0,1,0,1
64396,140,17785,23517;23802,49640,0,0,2,0,2
64397,140,17786,23505,49640,0,0,1,0,1
64398,140,17787,23537,49640,0,0,1,0,1
64399,140,17788,23580;24135,49640,0,0,2,0,2
64400,140,17789,23463;25643;26384,49640,1,1,1,0,3
64401,140,17790,23651;23687,49640,0,0,2,0,2
64402,140,17791,23699;24025,49640,0,0,2,0,2
64403,140,17792,23266;23701,49640,0,0,2,0,2
64404,140,17793,23726;24080,49640,0,0,2,0,2
64405,140,17794,23776;23933,49640,0,0,2,0,2
64406,140,17795,23782;23921,49640,0,0,2,0,2
64407,140,17796,23812;23845,49640,0,0,2,0,2
64408,140,17797,23394;23835,49640,0,0,2,0,2
64409,140,17798,23653;23855;26288,49640,1,0,2,0,3
64410,140,17799,23860;23910;25823,49640,0,1,2,0,3
64411,140,17800,23767;23900;25916,49640,0,1,2,0,3
64412,140,17801,23911;24152,49640,0,0,2,0,2
64413,140,17802,23970;23977,49640,0,0,2,0,2
64414,140,17803,23982;24232,49640,0,0,2,0,2
64415,140,17804,23990;24033,49640,0,0,2,0,2
64416,140,17805,24002;24017;26401;26491,49640,2,0,2,0,4
64417,140,17806,24084,49640,0,0,1,0,1
64418,140,17807,24052;24201,49640,0,0,2,0,2
64419,140,17808,24057;24420,49640,0,0,2,0,2
64420,140,17809,24063;24097,49640,0,0,2,0,2
64421,140,17810,24042;24408,49640,0,0,2,0,2
64422,140,17811,24095;24354,49640,0,0,2,0,2
64423,140,17813,19558,50005,0,0,1,0,1
64424,140,17814,19674,50005,0,0,1,0,1
64425,140,17815,19731;19844,50005,0,0,2,0,2
64426,140,17816,19305,50005,0,0,0,1,1
64427,140,17817,19744,50005,0,0,1,0,1
64428,140,17818,19945,50005,0,0,1,0,1
64429,140,17819,19877,50005,0,0,1,0,1
64430,140,17820,20055;20108,50005,0,0,2,0,2
64431,140,17821,19501,50005,0,0,1,0,1
64432,140,17823,20443,50005,0,0,1,0,1
64433,140,17824,20470,50005,0,0,1,0,1
64434,140,17825,20193;20545,50005,0,0,2,0,2
64435,140,17826,20860,50005,0,0,1,0,1
64436,140,17827,20945,50005,0,0,1,0,1
64437,140,17830,21054;21270,50005,0,0,2,0,2
64438,140,17832,21811;24948;25750,50005,0,2,1,0,3
64439,140,17833,21448,50005,0,0,1,0,1
64440,140,17834,21451,50005,0,0,1,0,1
64441,140,17835,21517,50005,0,0,1,0,1
64442,140,17836,21630,50005,0,0,1,0,1
64443,140,17837,21637,50005,0,0,1,0,1
64444,140,17838,21719,50005,0,0,1,0,1
64445,140,17839,21776,50005,0,0,1,0,1
64446,140,17840,21904,50005,0,0,1,0,1
64447,140,17842,21503;21806;24945,50005,0,1,2,0,3
64448,140,17843,22107,50005,0,0,1,0,1
64449,140,17844,22146,50005,0,0,1,0,1
64450,140,17846,21718;22037,50005,0,0,2,0,2
64451,140,17847,22334,50005,0,0,1,0,1
64452,140,17849,22443,50005,0,0,1,0,1
64453,140,17850,22425,50005,0,0,1,0,1
64454,140,17851,22535,50005,0,0,1,0,1
64455,140,17853,22570;22700;25702,50005,0,1,2,0,3
64456,140,17854,22538,50005,0,0,1,0,1
64457,140,17855,22494;22975;25715,50005,0,1,2,0,3
64458,140,17856,22364,50005,0,0,1,0,1
64459,140,17857,22796;23216;25091;25984,50005,0,2,2,0,4
64460,140,17858,22829,50005,0,0,1,0,1
64461,140,17859,23001,50005,0,0,1,0,1
64462,140,17860,23020,50005,0,0,1,0,1
64463,140,17861,23114;23508,50005,0,0,2,0,2
64464,140,17862,23076;23116,50005,0,0,2,0,2
64465,140,17863,22787,50005,0,0,1,0,1
64466,140,17864,23197;23680;26281,50005,1,0,2,0,3
64467,140,17865,23286;24073;26493,50005,1,0,2,0,3
64468,140,17866,23346;23560;25730,50005,0,1,2,0,3
64469,140,17867,23417,50005,0,0,1,0,1
64470,140,17868,23460;23471,50005,0,0,2,0,2
64471,140,17869,23482;23746,50005,0,0,2,0,2
64472,140,17870,23492;23661;25990;26468,50005,1,1,2,0,4
64473,140,17871,23510;26386,50005,1,0,1,0,2
64474,140,17872,23361;23516;26387,50005,1,0,2,0,3
64475,140,17873,23811,50005,0,0,1,0,1
64476,140,17874,23533;24070,50005,0,0,2,0,2
64477,140,17875,23564;23941,50005,0,0,2,0,2
64478,140,17876,23581;23995,50005,0,0,2,0,2
64479,140,17877,23599;23843,50005,0,0,2,0,2
64480,140,17878,23613;23876;25915,50005,0,1,2,0,3
64481,140,17879,23457;23477,50005,0,0,2,0,2
64482,140,17880,23627;23679;25435;26280,50005,1,1,2,0,4
64483,140,17881,23189,50005,0,0,1,0,1
64484,140,17882,23745;23822;25541,50005,0,1,2,0,3
64485,140,17883,23797;24050;26296,50005,1,0,2,0,3
64486,140,17884,23689;23851;26195,50005,1,0,2,0,3
64487,140,17885,23725;23867,50005,0,0,2,0,2
64488,140,17886,23903;23909,50005,0,0,2,0,2
64489,140,17887,23917;24295,50005,0,0,2,0,2
64490,140,17888,23607;23931,50005,0,0,2,0,2
64491,140,17889,23677,50005,0,0,1,0,1
64492,140,17890,23481;23950,50005,0,0,2,0,2
64493,140,17891,23986;24407;26304,50005,1,0,2,0,3
64494,140,17892,23918;23996,50005,0,0,2,0,2
64495,140,17893,24041;26005,50005,0,1,1,0,2
64496,140,17894,24001;24048,50005,0,0,2,0,2
64497,140,17895,23586,50005,0,0,1,0,1
64498,140,17896,24056;24225,50005,0,0,2,0,2
64499,140,17897,24062;24273,50005,0,0,2,0,2
64500,140,17898,24226,50005,0,0,1,0,1
64501,140,17899,23925;24077,50005,0,0,2,0,2
64502,140,17900,24079;26096,50005,1,0,1,0,2
64503,140,17901,24091;24104,50005,0,0,2,0,2
64504,140,17902,24074;24117,50005,0,0,2,0,2
64505,140,17903,24432,50005,0,0,1,0,1
64506,140,17904,24144;24267,50005,0,0,2,0,2
64507,140,17905,24186;24215;26406,50005,1,0,2,0,3
64508,140,17906,24192;24200,50005,0,0,2,0,2
64509,140,17907,19297,50370,0,0,0,1,1
64510,140,17908,19692,50370,0,0,1,0,1
64511,140,17909,19982,50370,0,0,1,0,1
64512,140,17910,19806,50370,0,0,1,0,1
64513,140,17911,20535,50370,0,0,1,0,1
64514,140,17916,20713;21022,50370,0,0,2,0,2
64515,140,17917,20760,50370,0,0,1,0,1
64516,140,17918,20733,50370,0,0,1,0,1
64517,140,17919,20673,50370,0,0,1,0,1
64518,140,17920,21160,50370,0,0,1,0,1
64519,140,17922,21328;21950;24739;25671,50370,0,1,3,0,4
64520,140,17923,21151,50370,0,0,1,0,1
64521,140,17924,21386,50370,0,0,1,0,1
64522,140,17926,20750,50370,0,0,1,0,1
64523,140,17927,21613,50370,0,0,1,0,1
64524,140,17928,21834,50370,0,0,1,0,1
64525,140,17930,21544;21926;25060;26211,50370,1,1,2,0,4
64526,140,17931,21756;21876,50370,0,0,2,0,2
64527,140,17932,21470,50370,0,0,1,0,1
64528,140,17933,22077,50370,0,0,1,0,1
64529,140,17934,22338;22373;26417,50370,1,0,2,0,3
64530,140,17935,22222;22735;25705,50370,0,1,2,0,3
64531,140,17938,22360;22931;25304,50370,0,1,2,0,3
64532,140,17939,22271,50370,0,0,1,0,1
64533,140,17940,22166;22412,50370,0,0,2,0,2
64534,140,17942,22488,50370,0,0,1,0,1
64535,140,17943,22549,50370,0,0,1,0,1
64536,140,17944,22652;23107,50370,0,0,2,0,2
64537,140,17945,22501,50370,0,0,1,0,1
64538,140,17946,22730,50370,0,0,1,0,1
64539,140,17947,22637,50370,0,0,1,0,1
64540,140,17948,22595;22930;25626;25713,50370,0,2,2,0,4
64541,140,17949,22509;22988;26065;26245,50370,2,0,2,0,4
64542,140,17950,22998;23409,50370,0,0,2,0,2
64543,140,17951,22716,50370,0,0,1,0,1
64544,140,17952,23036;25890,50370,0,1,1,0,2
64545,140,17953,23039;23850;25914,50370,0,1,2,0,3
64546,140,17954,22772;23058;26160,50370,1,0,2,0,3
64547,140,17955,23167;23569;26277,50370,1,0,2,0,3
64548,140,17956,23186;23345,50370,0,0,2,0,2
64549,140,17957,23231;23591,50370,0,0,2,0,2
64550,140,17958,23096,50370,0,0,1,0,1
64551,140,17959,23308;23625,50370,0,0,2,0,2
64552,140,17960,23312;24088,50370,0,0,2,0,2
64553,140,17961,23709;26092;26479,50370,2,0,1,0,3
64554,140,17962,23431;23795,50370,0,0,2,0,2
64555,140,17963,23360;23818,50370,0,0,2,0,2
64556,140,17964,23194,50370,0,0,1,0,1
64557,140,17965,23387;23415,50370,0,0,2,0,2
64558,140,17966,23117;23454;26085,50370,1,0,2,0,3
64559,140,17967,23494;25991,50370,0,1,1,0,2
64560,140,17968,23542;26185;26470,50370,2,0,1,0,3
64561,140,17969,23615;24102,50370,0,0,2,0,2
64562,140,17970,23337,50370,0,0,1,0,1
64563,140,17971,23730;23979,50370,0,0,2,0,2
64564,140,17972,23759;24101,50370,0,0,2,0,2
64565,140,17973,23784;24302;26100,50370,1,0,2,0,3
64566,140,17974,23785;24058;26492,50370,1,0,2,0,3
64567,140,17975,23397;23794,50370,0,0,2,0,2
64568,140,17976,23594;23806,50370,0,0,2,0,2
64569,140,17977,23284;23824,50370,0,0,2,0,2
64570,140,17978,23792;23839;26398,50370,1,0,2,0,3
64571,140,17979,23848;24089,50370,0,0,2,0,2
64572,140,17980,23858,50370,0,0,1,0,1
64573,140,17981,23859;24305,50370,0,0,2,0,2
64574,140,17982,23880;24378,50370,0,0,2,0,2
64575,140,17983,23887,50370,0,0,1,0,1
64576,140,17984,23897;24216,50370,0,0,2,0,2
64577,140,17985,23913;24045,50370,0,0,2,0,2
64578,140,17986,23923;23942;26293,50370,1,0,2,0,3
64579,140,17987,23945;24296;26302;26409,50370,2,0,2,0,4
64580,140,17988,24228;26299,50370,1,0,1,0,2
64581,140,17989,23985,50370,0,0,1,0,1
64582,140,17990,23930;23992,50370,0,0,2,0,2
64583,140,17991,23999;24173,50370,0,0,2,0,2
64584,140,17992,23889;24010,50370,0,0,2,0,2
64585,140,17993,24061;26403,50370,1,0,1,0,2
64586,140,17994,24278,50370,0,0,1,0,1
64587,140,17995,23821;24099,50370,0,0,2,0,2
64588,140,17996,24105;24445,50370,0,0,2,0,2
64589,140,17997,24122;24501,50370,0,0,2,0,2
64590,140,17998,23810;24123,50370,0,0,2,0,2
64591,140,17999,24142;24448,50370,0,0,2,0,2
64592,140,18000,24143;24401,50370,0,0,2,0,2
64593,140,18001,24163;24349,50370,0,0,2,0,2
64594,140,18002,24166;24385,50370,0,0,2,0,2
64595,140,18003,23976;24167,50370,0,0,2,0,2
64596,140,18004,24183;24463;26500,50370,1,0,2,0,3
64597,140,18005,24197;24520,50370,0,0,2,0,2
64598,140,18006,24266;24370,50370,0,0,2,0,2
64599,140,18007,24272;24367,50370,0,0,2,0,2
64600,140,18008,24085,50370,0,0,1,0,1
64601,140,18009,24136;24289;26099,50370,1,0,2,0,3
64602,140,18010,24202;24308,50370,0,0,2,0,2
64603,140,18011,24009;24313;26206,50370,1,0,2,0,3
64604,140,18012,19863,50735,0,0,1,0,1
64605,140,18015,19624,50735,0,0,1,0,1
64606,140,18016,19983,50735,0,0,1,0,1
64607,140,18017,19988,50735,0,0,1,0,1
64608,140,18018,20006,50735,0,0,1,0,1
64609,140,18019,19890,50735,0,0,1,0,1
64610,140,18020,19645,50735,0,0,1,0,1
64611,140,18021,19833,50735,0,0,1,0,1
64612,140,18022,20510,50735,0,0,1,0,1
64613,140,18023,20527,50735,0,0,1,0,1
64614,140,18024,20619,50735,0,0,1,0,1
64615,140,18025,20462;20625,50735,0,0,2,0,2
64616,140,18026,20992,50735,0,0,1,0,1
64617,140,18027,20539,50735,0,0,1,0,1
64618,140,18028,20851,50735,0,0,1,0,1
64619,140,18029,20892,50735,0,0,1,0,1
64620,140,18030,20801,50735,0,0,1,0,1
64621,140,18031,21055,50735,0,0,1,0,1
64622,140,18034,21263,50735,0,0,1,0,1
64623,140,18036,21171,50735,0,0,1,0,1
64624,140,18037,21468,50735,0,0,1,0,1
64625,140,18038,21438,50735,0,0,1,0,1
64626,140,18039,21355,50735,0,0,1,0,1
64627,140,18041,21161,50735,0,0,1,0,1
64628,140,18042,21399,50735,0,0,1,0,1
64629,140,18043,21569,50735,0,0,1,0,1
64630,140,18044,21992,50735,0,0,1,0,1
64631,140,18045,21319,50735,0,0,1,0,1
64632,140,18046,22209,50735,0,0,1,0,1
64633,140,18047,22235,50735,0,0,1,0,1
64634,140,18048,22163,50735,0,0,1,0,1
64635,140,18049,22313,50735,0,0,1,0,1
64636,140,18050,22161,50735,0,0,1,0,1
64637,140,18051,22698,50735,0,0,1,0,1
64638,140,18052,22694,50735,0,0,1,0,1
64639,140,18053,22710,50735,0,0,1,0,1
64640,140,18054,22801;25795,50735,0,1,1,0,2
64641,140,18055,22255,50735,0,0,1,0,1
64642,140,18056,22508,50735,0,0,1,0,1
64643,140,18057,22968;23205;26364,50735,1,0,2,0,3
64644,140,18058,22748,50735,0,0,1,0,1
64645,140,18059,23066;23619,50735,0,0,2,0,2
64646,140,18060,23088,50735,0,0,1,0,1
64647,140,18062,23254;23390,50735,0,0,2,0,2
64648,140,18063,23192;23274;26081,50735,1,0,2,0,3
64649,140,18064,23281;23338;26264,50735,1,0,2,0,3
64650,140,18065,23342,50735,0,0,1,0,1
64651,140,18066,23402;23425;25728;25986;26464,50735,1,2,2,0,5
64652,140,18067,23435;23476,50735,0,0,2,0,2
64653,140,18068,23389;23458;25316,50735,0,1,2,0,3
64654,140,18069,23628;23630,50735,0,0,2,0,2
64655,140,18070,23570,50735,0,0,1,0,1
64656,140,18071,23602,50735,0,0,1,0,1
64657,140,18072,23665,50735,0,0,1,0,1
64658,140,18073,23697;24030;26095,50735,1,0,2,0,3
64659,140,18074,23703;24075,50735,0,0,2,0,2
64660,140,18075,23717;24377;26499,50735,1,0,2,0,3
64661,140,18076,23718,50735,0,0,1,0,1
64662,140,18077,23612,50735,0,0,1,0,1
64663,140,18078,23734,50735,0,0,1,0,1
64664,140,18079,23743;24189,50735,0,0,2,0,2
64665,140,18080,23787;24188,50735,0,0,2,0,2
64666,140,18081,23446;23816;26285,50735,1,0,2,0,3
64667,140,18082,23856;23895,50735,0,0,2,0,2
64668,140,18083,23868;24126,50735,0,0,2,0,2
64669,140,18084,23891,50735,0,0,1,0,1
64670,140,18085,23920;24335,50735,0,0,2,0,2
64671,140,18086,23924;24248,50735,0,0,2,0,2
64672,140,18087,23927;26199,50735,1,0,1,0,2
64673,140,18088,23948;24293,50735,0,0,2,0,2
64674,140,18089,23959;24526,50735,0,0,2,0,2
64675,140,18090,23963;23991,50735,0,0,2,0,2
64676,140,18091,23966;24051,50735,0,0,2,0,2
64677,140,18092,23987;24381,50735,0,0,2,0,2
64678,140,18093,23645,50735,0,0,1,0,1
64679,140,18094,23833;24003,50735,0,0,2,0,2
64680,140,18095,24007;24241,50735,0,0,2,0,2
64681,140,18096,24019;24253,50735,0,0,2,0,2
64682,140,18097,24071;24157,50735,0,0,2,0,2
64683,140,18098,24072;24502,50735,0,0,2,0,2
64684,140,18099,24076;24281,50735,0,0,2,0,2
64685,140,18100,24110;24415,50735,0,0,2,0,2
64686,140,18101,24124;24723,50735,0,0,2,0,2
64687,140,18102,24031;24127,50735,0,0,2,0,2
64688,140,18103,23823;24130,50735,0,0,2,0,2
64689,140,18104,24149;24644,50735,0,0,2,0,2
64690,140,18105,24165;24609,50735,0,0,2,0,2
64691,140,18106,24103;24204,50735,0,0,2,0,2
64692,140,18107,23981,50735,0,0,1,0,1
64693,140,18108,23944;24244,50735,0,0,2,0,2
64694,140,18109,24257;24717,50735,0,0,2,0,2
64695,140,18110,24177;24258;26495,50735,1,0,2,0,3
64696,140,18111,24269;24597,50735,0,0,2,0,2
64697,140,18112,24285;24458,50735,0,0,2,0,2
64698,140,18113,24301;24724,50735,0,0,2,0,2
64699,140,18114,24322;24662,50735,0,0,2,0,2
64700,140,18115,24325;24575,50735,0,0,2,0,2
64701,140,18116,24231;24328,50735,0,0,2,0,2
64702,140,18117,24040;24379,50735,0,0,2,0,2
64703,140,18118,24382;24743,50735,0,0,2,0,2
64704,140,18119,24314;24409;26412,50735,1,0,2,0,3
64705,140,18120,24421;24540,50735,0,0,2,0,2
64706,140,18121,19929;20123,51100,0,0,2,0,2
64707,140,18122,20335,51100,0,0,1,0,1
64708,140,18123,19976,51100,0,0,1,0,1
64709,140,18124,20312,51100,0,0,1,0,1
64710,140,18125,20350,51100,0,0,1,0,1
64711,140,18126,19947,51100,0,0,1,0,1
64712,140,18127,20439,51100,0,0,1,0,1
64713,140,18128,20482,51100,0,0,1,0,1
64714,140,18129,20693,51100,0,0,1,0,1
64715,140,18130,20816,51100,0,0,1,0,1
64716,140,18131,20872,51100,0,0,1,0,1
64717,140,18132,20991,51100,0,0,1,0,1
64718,140,18133,20530,51100,0,0,1,0,1
64719,140,18134,21057,51100,0,0,1,0,1
64720,140,18135,20772,51100,0,0,1,0,1
64721,140,18136,20864,51100,0,0,1,0,1
64722,140,18137,21191,51100,0,0,1,0,1
64723,140,18138,20793;21228,51100,0,0,2,0,2
64724,140,18139,21401,51100,0,0,1,0,1
64725,140,18140,21244,51100,0,0,1,0,1
64726,140,18141,20881,51100,0,0,1,0,1
64727,140,18142,21110,51100,0,0,1,0,1
64728,140,18144,21243,51100,0,0,1,0,1
64729,140,18145,20956,51100,0,0,1,0,1
64730,140,18146,21463,51100,0,0,1,0,1
64731,140,18147,21306,51100,0,0,1,0,1
64732,140,18148,21462,51100,0,0,1,0,1
64733,140,18149,21792,51100,0,0,1,0,1
64734,140,18150,21944,51100,0,0,1,0,1
64735,140,18151,21956,51100,0,0,1,0,1
64736,140,18152,21880,51100,0,0,1,0,1
64737,140,18153,22227,51100,0,0,1,0,1
64738,140,18154,22400,51100,0,0,1,0,1
64739,140,18155,22318,51100,0,0,1,0,1
64740,140,18156,21816,51100,0,0,1,0,1
64741,140,18157,22483;22679,51100,0,0,2,0,2
64742,140,18158,22692,51100,0,0,1,0,1
64743,140,18159,22824;23134;25636,51100,0,1,2,0,3
64744,140,18160,22776;23282;25811;26170;26373,51100,2,1,2,0,5
64745,140,18161,22789;23140;26163,51100,1,0,2,0,3
64746,140,18162,22415,51100,0,0,1,0,1
64747,140,18163,22628,51100,0,0,1,0,1
64748,140,18164,22278;22888;26344,51100,1,0,2,0,3
64749,140,18165,22981,51100,0,0,1,0,1
64750,140,18166,23229,51100,0,0,1,0,1
64751,140,18167,23307,51100,0,0,1,0,1
64752,140,18168,23356,51100,0,0,1,0,1
64753,140,18169,23393,51100,0,0,1,0,1
64754,140,18170,23456;23461,51100,0,0,2,0,2
64755,140,18171,23374,51100,0,0,1,0,1
64756,140,18172,23087,51100,0,0,1,0,1
64757,140,18173,23739;24006,51100,0,0,2,0,2
64758,140,18174,23401;23622,51100,0,0,2,0,2
64759,140,18175,23721,51100,0,0,1,0,1
64760,140,18176,23509,51100,0,0,1,0,1
64761,140,18177,23736;24178,51100,0,0,2,0,2
64762,140,18178,23566;23754,51100,0,0,2,0,2
64763,140,18179,23593;23789,51100,0,0,2,0,2
64764,140,18180,23831;24642,51100,0,0,2,0,2
64765,140,18181,23722;23896;26197;26399,51100,2,0,2,0,4
64766,140,18182,23741;23907,51100,0,0,2,0,2
64767,140,18183,23935;24140;26098,51100,1,0,2,0,3
64768,140,18184,23953;24270;26300,51100,1,0,2,0,3
64769,140,18185,23958;24008;26489,51100,1,0,2,0,3
64770,140,18186,23965;24524,51100,0,0,2,0,2
64771,140,18187,23978;24134;25737,51100,0,1,2,0,3
64772,140,18188,23983;26094,51100,1,0,1,0,2
64773,140,18189,24020;24310,51100,0,0,2,0,2
64774,140,18190,23901;24021,51100,0,0,2,0,2
64775,140,18191,24113;24688,51100,0,0,2,0,2
64776,140,18192,23819;24129,51100,0,0,2,0,2
64777,140,18193,24180;24537,51100,0,0,2,0,2
64778,140,18194,24218;24788,51100,0,1,1,0,2
64779,140,18195,24223;24656,51100,0,0,2,0,2
64780,140,18196,24121;24316,51100,0,0,2,0,2
64781,140,18197,24342;24380,51100,0,0,2,0,2
64782,140,18198,24346,51100,0,0,1,0,1
64783,140,18199,24348;24521,51100,0,0,2,0,2
64784,140,18200,24366;24652,51100,0,0,2,0,2
64785,140,18201,24384;24475;26411,51100,1,0,2,0,3
64786,140,18202,24402;24628,51100,0,0,2,0,2
64787,140,18203,24128;24404,51100,0,0,2,0,2
64788,140,18204,24004;24425,51100,0,0,2,0,2
64789,140,18205,24118,51100,0,0,1,0,1
64790,140,18206,24451;24605,51100,0,0,2,0,2
64791,140,18207,24081;24482,51100,0,0,2,0,2
64792,140,18208,24416;24489,51100,0,0,2,0,2
64793,140,18209,24298;24491,51100,0,0,2,0,2
64794,140,18210,24503;24760,51100,0,0,2,0,2
64795,140,18211,24506;24640,51100,0,0,2,0,2
64796,140,18212,24509;24721,51100,0,0,2,0,2
64797,140,18213,24511;24528,51100,0,0,2,0,2
64798,150,7704,17578,14235,0,0,0,1,1
64799,150,7731,19822;19999,14235,0,0,0,2,2
64800,150,8528,18548,17155,0,0,0,1,1
64801,150,8664,19177,17520,0,0,0,1,1
64802,150,8687,18109,17520,0,0,0,1,1
64803,150,9220,17629;17743;17782,19345,0,0,0,3,3
64804,150,9316,18737,19710,0,0,0,1,1
64805,150,9829,17617,21535,0,0,0,1,1
64806,150,10324,18884;18953,22995,0,0,0,2,2
64807,150,10423,18946,23360,0,0,0,1,1
64808,150,10457,16708,23360,0,0,0,1,1
64809,150,10583,18409;18841,23725,0,0,0,2,2
64810,150,10709,19012,24090,0,0,0,1,1
64811,150,10761,18791;18844,24455,0,0,0,2,2
64812,150,10879,20060;23421,24820,0,0,1,1,2
64813,150,10900,16754,24820,0,0,0,1,1
64814,150,11140,20246;20845,25550,0,0,1,1,2
64815,150,11236,16690,25915,0,0,0,1,1
64816,150,11263,16564,25915,0,0,0,1,1
64817,150,11273,17129,25915,0,0,0,1,1
64818,150,11276,17095,25915,0,0,0,1,1
64819,150,11350,16819,26280,0,0,0,1,1
64820,150,11379,16897,26280,0,0,0,1,1
64821,150,11386,17266,26280,0,0,0,1,1
64822,150,11391,17154,26280,0,0,0,1,1
64823,150,11392,17292,26280,0,0,0,1,1
64824,150,11452,16712,26645,0,0,0,1,1
64825,150,11482,16714,26645,0,0,0,1,1
64826,150,11506,17128,26645,0,0,0,1,1
64827,150,11507,16992,26645,0,0,0,1,1
64828,150,11586,19617,27010,0,0,0,1,1
64829,150,11597,17393,27010,0,0,0,1,1
64830,150,11603,17196,27010,0,0,0,1,1
64831,150,11606,17163,27010,0,0,0,1,1
64832,150,11607,17257,27010,0,0,0,1,1
64833,150,11681,16624,27375,0,0,0,1,1
64834,150,11684,17297,27375,0,0,0,1,1
64835,150,11688,17076,27375,0,0,0,1,1
64836,150,11693,16870,27375,0,0,0,1,1
64837,150,11700,16960,27375,0,0,0,1,1
64838,150,11702,16720;16997,27375,0,0,0,2,2
64839,150,11777,16893,27740,0,0,0,1,1
64840,150,11782,17394,27740,0,0,0,1,1
64841,150,11784,16980;16985,27740,0,0,0,2,2
64842,150,11791,17687,27740,0,0,0,1,1
64843,150,11799,17420,27740,0,0,0,1,1
64844,150,11800,17445,27740,0,0,0,1,1
64845,150,11807,17684,27740,0,0,0,1,1
64846,150,11809,17482,27740,0,0,0,1,1
64847,150,11890,16975,28105,0,0,0,1,1
64848,150,11897,17329,28105,0,0,0,1,1
64849,150,11902,17384,28105,0,0,0,1,1
64850,150,11903,17440,28105,0,0,0,1,1
64851,150,11912,19787;19878,28105,0,0,0,2,2
64852,150,11914,17566,28105,0,0,0,1,1
64853,150,11924,17525;17575;20789,28105,0,0,1,2,3
64854,150,12012,17405,28470,0,0,0,1,1
64855,150,12019,17486,28470,0,0,0,1,1
64856,150,12021,17401,28470,0,0,0,1,1
64857,150,12024,17538,28470,0,0,0,1,1
64858,150,12028,17646,28470,0,0,0,1,1
64859,150,12030,17323,28470,0,0,0,1,1
64860,150,12032,17377,28470,0,0,0,1,1
64861,150,12033,17317,28470,0,0,0,1,1
64862,150,12038,17472,28470,0,0,0,1,1
64863,150,12042,17494,28470,0,0,0,1,1
64864,150,12044,17551,28470,0,0,0,1,1
64865,150,12045,17787,28470,0,0,0,1,1
64866,150,12046,17570,28470,0,0,0,1,1
64867,150,12124,17228,28835,0,0,0,1,1
64868,150,12126,17213,28835,0,0,0,1,1
64869,150,12129,17334,28835,0,0,0,1,1
64870,150,12130,17556,28835,0,0,0,1,1
64871,150,12135,17443,28835,0,0,0,1,1
64872,150,12139,17352;17750,28835,0,0,0,2,2
64873,150,12141,17779,28835,0,0,0,1,1
64874,150,12143,17585,28835,0,0,0,1,1
64875,150,12144,17245;17567,28835,0,0,0,2,2
64876,150,12145,17982,28835,0,0,0,1,1
64877,150,12147,17723;17944,28835,0,0,0,2,2
64878,150,12148,17622,28835,0,0,0,1,1
64879,150,12149,17626,28835,0,0,0,1,1
64880,150,12150,17639,28835,0,0,0,1,1
64881,150,12155,17947,28835,0,0,0,1,1
64882,150,12223,16970,29200,0,0,0,1,1
64883,150,12226,21752;21913;26016;26106,29200,0,2,2,0,4
64884,150,12231,17209,29200,0,0,0,1,1
64885,150,12232,17410;17634,29200,0,0,0,2,2
64886,150,12233,17446,29200,0,0,0,1,1
64887,150,12236,17697,29200,0,0,0,1,1
64888,150,12250,17479;17717,29200,0,0,0,2,2
64889,150,12252,17515,29200,0,0,0,1,1
64890,150,12253,17741,29200,0,0,0,1,1
64891,150,12255,17462,29200,0,0,0,1,1
64892,150,12259,18084,29200,0,0,0,1,1
64893,150,12262,17739,29200,0,0,0,1,1
64894,150,12318,17422,29565,0,0,0,1,1
64895,150,12324,17200,29565,0,0,0,1,1
64896,150,12328,17866,29565,0,0,0,1,1
64897,150,12330,17392,29565,0,0,0,1,1
64898,150,12340,17593,29565,0,0,0,1,1
64899,150,12343,17872,29565,0,0,0,1,1
64900,150,12345,17844,29565,0,0,0,1,1
64901,150,12346,17383;17690,29565,0,0,0,2,2
64902,150,12347,18196,29565,0,0,0,1,1
64903,150,12348,17797;17968,29565,0,0,0,2,2
64904,150,12350,17769,29565,0,0,0,1,1
64905,150,12351,17434,29565,0,0,0,1,1
64906,150,12353,22393;22400;25771;26120,29565,0,1,3,0,4
64907,150,12355,17748;17831,29565,0,0,0,2,2
64908,150,12356,17914,29565,0,0,0,1,1
64909,150,12357,17589;17848,29565,0,0,0,2,2
64910,150,12359,17878,29565,0,0,0,1,1
64911,150,12360,18048,29565,0,0,0,1,1
64912,150,12398,21363;21497;26012,29930,0,1,2,0,3
64913,150,12403,16763,29930,0,0,0,1,1
64914,150,12411,17041,29930,0,0,0,1,1
64915,150,12413,17296,29930,0,0,0,1,1
64916,150,12414,17198;17696,29930,0,0,0,2,2
64917,150,12420,17758,29930,0,0,0,1,1
64918,150,12427,17663;18107,29930,0,0,0,2,2
64919,150,12428,17700,29930,0,0,0,1,1
64920,150,12430,18178,29930,0,0,0,1,1
64921,150,12431,18581,29930,0,0,0,1,1
64922,150,12432,18189,29930,0,0,0,1,1
64923,150,12435,17817,29930,0,0,0,1,1
64924,150,12437,17824,29930,0,0,0,1,1
64925,150,12441,17853,29930,0,0,0,1,1
64926,150,12445,17673;17882,29930,0,0,0,2,2
64927,150,12446,17884,29930,0,0,0,1,1
64928,150,12447,17888,29930,0,0,0,1,1
64929,150,12448,17937;18101,29930,0,0,0,2,2
64930,150,12449,17991,29930,0,0,0,1,1
64931,150,12518,17369,30295,0,0,0,1,1
64932,150,12519,18131,30295,0,0,0,1,1
64933,150,12522,17807;17820,30295,0,0,0,2,2
64934,150,12525,17666,30295,0,0,0,1,1
64935,150,12527,17879;18210,30295,0,0,0,2,2
64936,150,12529,17737,30295,0,0,0,1,1
64937,150,12530,17840,30295,0,0,0,1,1
64938,150,12533,17785,30295,0,0,0,1,1
64939,150,12534,17789,30295,0,0,0,1,1
64940,150,12535,17790,30295,0,0,0,1,1
64941,150,12537,17897;17922,30295,0,0,0,2,2
64942,150,12539,18159,30295,0,0,0,1,1
64943,150,12541,17921;17998,30295,0,0,0,2,2
64944,150,12542,17870,30295,0,0,0,1,1
64945,150,12544,17942,30295,0,0,0,1,1
64946,150,12545,18112;18162,30295,0,0,0,2,2
64947,150,12547,18368,30295,0,0,0,1,1
64948,150,12548,17995,30295,0,0,0,1,1
64949,150,12549,17996,30295,0,0,0,1,1
64950,150,12552,18019;18353,30295,0,0,0,2,2
64951,150,12553,18200,30295,0,0,0,1,1
64952,150,12554,18034,30295,0,0,0,1,1
64953,150,12558,18093,30295,0,0,0,1,1
64954,150,12559,18058,30295,0,0,0,1,1
64955,150,12610,17107,30660,0,0,0,1,1
64956,150,12612,18057,30660,0,0,0,1,1
64957,150,12613,17771,30660,0,0,0,1,1
64958,150,12614,18232,30660,0,0,0,1,1
64959,150,12615,18381,30660,0,0,0,1,1
64960,150,12616,17599;18000,30660,0,0,0,2,2
64961,150,12618,17985,30660,0,0,0,1,1
64962,150,12619,17402,30660,0,0,0,1,1
64963,150,12622,17662,30660,0,0,0,1,1
64964,150,12623,17722;17754,30660,0,0,0,2,2
64965,150,12624,18035,30660,0,0,0,1,1
64966,150,12631,18242,30660,0,0,0,1,1
64967,150,12633,17863,30660,0,0,0,1,1
64968,150,12634,18120,30660,0,0,0,1,1
64969,150,12635,18329,30660,0,0,0,1,1
64970,150,12636,17910,30660,0,0,0,1,1
64971,150,12637,18111,30660,0,0,0,1,1
64972,150,12638,17962;18067,30660,0,0,0,2,2
64973,150,12642,23144;23236;27190,30660,1,0,2,0,3
64974,150,12643,17875,30660,0,0,0,1,1
64975,150,12647,18102,30660,0,0,0,1,1
64976,150,12648,18218,30660,0,0,0,1,1
64977,150,12649,17605,30660,0,0,0,1,1
64978,150,12650,18375,30660,0,0,0,1,1
64979,150,12651,18121;18132,30660,0,0,0,2,2
64980,150,12655,18151;18182,30660,0,0,0,2,2
64981,150,12706,17104,31025,0,0,0,1,1
64982,150,12716,17185,31025,0,0,0,1,1
64983,150,12719,18046,31025,0,0,0,1,1
64984,150,12720,17984,31025,0,0,0,1,1
64985,150,12721,18152,31025,0,0,0,1,1
64986,150,12724,18209;18713,31025,0,0,0,2,2
64987,150,12725,17720,31025,0,0,0,1,1
64988,150,12727,17978,31025,0,0,0,1,1
64989,150,12728,17948,31025,0,0,0,1,1
64990,150,12730,17778;17959,31025,0,0,0,2,2
64991,150,12732,17976,31025,0,0,0,1,1
64992,150,12733,18009,31025,0,0,0,1,1
64993,150,12737,18157,31025,0,0,0,1,1
64994,150,12739,17967,31025,0,0,0,1,1
64995,150,12742,18126,31025,0,0,0,1,1
64996,150,12743,18097,31025,0,0,0,1,1
64997,150,12745,18226,31025,0,0,0,1,1
64998,150,12747,18291,31025,0,0,0,1,1
64999,150,12748,17990,31025,0,0,0,1,1
65000,150,12749,18221;18250,31025,0,0,0,2,2
65001,150,12750,18592,31025,0,0,0,1,1
65002,150,12755,18518;18576,31025,0,0,0,2,2
65003,150,12756,18294;18505,31025,0,0,0,2,2
65004,150,12757,18302,31025,0,0,0,1,1
65005,150,12818,17688;18180,31390,0,0,0,2,2
65006,150,12820,17796,31390,0,0,0,1,1
65007,150,12821,17358,31390,0,0,0,1,1
65008,150,12826,17919,31390,0,0,0,1,1
65009,150,12828,17834,31390,0,0,0,1,1
65010,150,12830,18025;18164,31390,0,0,0,2,2
65011,150,12831,18208,31390,0,0,0,1,1
65012,150,12832,17786,31390,0,0,0,1,1
65013,150,12833,18171,31390,0,0,0,1,1
65014,150,12836,17946,31390,0,0,0,1,1
65015,150,12837,18194;18392,31390,0,0,0,2,2
65016,150,12838,17891,31390,0,0,0,1,1
65017,150,12840,18656,31390,0,0,0,1,1
65018,150,12841,18055,31390,0,0,0,1,1
65019,150,12842,18064,31390,0,0,0,1,1
65020,150,12843,18016,31390,0,0,0,1,1
65021,150,12847,18179,31390,0,0,0,1,1
65022,150,12849,18436;18465,31390,0,0,0,2,2
65023,150,12851,18566,31390,0,0,0,1,1
65024,150,12852,18193;18246,31390,0,0,0,2,2
65025,150,12853,18147;18192,31390,0,0,0,2,2
65026,150,12856,18694,31390,0,0,0,1,1
65027,150,12857,18367,31390,0,0,0,1,1
65028,150,12859,18331,31390,0,0,0,1,1
65029,150,12862,18342,31390,0,0,0,1,1
65030,150,12863,18346,31390,0,0,0,1,1
65031,150,12865,18088;18369,31390,0,0,0,2,2
65032,150,12867,18258;18386,31390,0,0,0,2,2
65033,150,12913,17522,31755,0,0,0,1,1
65034,150,12917,17262;17396,31755,0,0,0,2,2
65035,150,12919,17454,31755,0,0,0,1,1
65036,150,12920,17810,31755,0,0,0,1,1
65037,150,12926,17760;17958,31755,0,0,0,2,2
65038,150,12927,17956,31755,0,0,0,1,1
65039,150,12929,18014,31755,0,0,0,1,1
65040,150,12932,18740,31755,0,0,0,1,1
65041,150,12933,18113,31755,0,0,0,1,1
65042,150,12934,18710,31755,0,0,0,1,1
65043,150,12935,18332,31755,0,0,0,1,1
65044,150,12936,18563,31755,0,0,0,1,1
65045,150,12937,18457,31755,0,0,0,1,1
65046,150,12938,18154;18621,31755,0,0,0,2,2
65047,150,12939,18158,31755,0,0,0,1,1
65048,150,12940,17625;18173,31755,0,0,0,2,2
65049,150,12941,18840,31755,0,0,0,1,1
65050,150,12943,18128,31755,0,0,0,1,1
65051,150,12944,18305,31755,0,0,0,1,1
65052,150,12945,18273,31755,0,0,0,1,1
65053,150,12946,18276,31755,0,0,0,1,1
65054,150,12947,18285;18802,31755,0,0,0,2,2
65055,150,12948,18225;18698,31755,0,0,0,2,2
65056,150,12949,18303,31755,0,0,0,1,1
65057,150,12950,18395,31755,0,0,0,1,1
65058,150,12952,17889,31755,0,0,0,1,1
65059,150,12953,18425,31755,0,0,0,1,1
65060,150,12954,18426,31755,0,0,0,1,1
65061,150,12955,18328,31755,0,0,0,1,1
65062,150,12957,18577,31755,0,0,0,1,1
65063,150,12959,18149;18513,31755,0,0,0,2,2
65064,150,12961,18779;18861,31755,0,0,0,2,2
65065,150,12962,18437,31755,0,0,0,1,1
65066,150,13008,17226,32120,0,0,0,1,1
65067,150,13019,18150,32120,0,0,0,1,1
65068,150,13020,18129,32120,0,0,0,1,1
65069,150,13025,17975,32120,0,0,0,1,1
65070,150,13026,18148,32120,0,0,0,1,1
65071,150,13028,17770;17987,32120,0,0,0,2,2
65072,150,13030,18045,32120,0,0,0,1,1
65073,150,13032,18359,32120,0,0,0,1,1
65074,150,13033,18257,32120,0,0,0,1,1
65075,150,13037,18502,32120,0,0,0,1,1
65076,150,13038,18562,32120,0,0,0,1,1
65077,150,13039,18228,32120,0,0,0,1,1
65078,150,13040,18702,32120,0,0,0,1,1
65079,150,13041,18355,32120,0,0,0,1,1
65080,150,13042,18356,32120,0,0,0,1,1
65081,150,13044,18288;18634,32120,0,0,0,2,2
65082,150,13045,18281;18413,32120,0,0,0,2,2
65083,150,13046,18421,32120,0,0,0,1,1
65084,150,13047,18611,32120,0,0,0,1,1
65085,150,13048,18347;18821,32120,0,0,0,2,2
65086,150,13049,18364;18699,32120,0,0,0,2,2
65087,150,13051,18453;18550,32120,0,0,0,2,2
65088,150,13052,18478,32120,0,0,0,1,1
65089,150,13053,18519,32120,0,0,0,1,1
65090,150,13055,18533,32120,0,0,0,1,1
65091,150,13056,18405;18560,32120,0,0,0,2,2
65092,150,13057,18971,32120,0,0,0,1,1
65093,150,13058,18685;18790,32120,0,0,0,2,2
65094,150,13059,18686,32120,0,0,0,1,1
65095,150,13061,18614;18772,32120,0,0,0,2,2
65096,150,13112,17590,32485,0,0,0,1,1
65097,150,13113,17732,32485,0,0,0,1,1
65098,150,13114,17587,32485,0,0,0,1,1
65099,150,13124,18022,32485,0,0,0,1,1
65100,150,13125,17964,32485,0,0,0,1,1
65101,150,13126,18021,32485,0,0,0,1,1
65102,150,13127,22183,32485,0,0,1,0,1
65103,150,13128,18467,32485,0,0,0,1,1
65104,150,13129,18404,32485,0,0,0,1,1
65105,150,13130,18744,32485,0,0,0,1,1
65106,150,13131,18248,32485,0,0,0,1,1
65107,150,13133,18309,32485,0,0,0,1,1
65108,150,13134,18163,32485,0,0,0,1,1
65109,150,13136,18011;18334,32485,0,0,0,2,2
65110,150,13138,18575,32485,0,0,0,1,1
65111,150,13140,18438,32485,0,0,0,1,1
65112,150,13141,18769,32485,0,0,0,1,1
65113,150,13142,18219;18479,32485,0,0,0,2,2
65114,150,13144,17856;18491,32485,0,0,0,2,2
65115,150,13145,18676,32485,0,0,0,1,1
65116,150,13147,18510,32485,0,0,0,1,1
65117,150,13149,18481,32485,0,0,0,1,1
65118,150,13151,18951,32485,0,0,0,1,1
65119,150,13152,18393,32485,0,0,0,1,1
65120,150,13153,18723;18968,32485,0,0,0,2,2
65121,150,13154,18941,32485,0,0,0,1,1
65122,150,13155,18877,32485,0,0,0,1,1
65123,150,13158,18778;19101,32485,0,0,0,2,2
65124,150,13159,18662,32485,0,0,0,1,1
65125,150,13160,18714,32485,0,0,0,1,1
65126,150,13161,18187;18574,32485,0,0,0,2,2
65127,150,13162,18727;19057,32485,0,0,0,2,2
65128,150,13163,18739;19090,32485,0,0,0,2,2
65129,150,13164,18964;19201,32485,0,0,0,2,2
65130,150,13203,17002,32850,0,0,0,1,1
65131,150,13210,17493,32850,0,0,0,1,1
65132,150,13214,18205,32850,0,0,0,1,1
65133,150,13216,18198,32850,0,0,0,1,1
65134,150,13217,17816;18315,32850,0,0,0,2,2
65135,150,13218,17892;18211,32850,0,0,0,2,2
65136,150,13219,17923,32850,0,0,0,1,1
65137,150,13220,18104;18498,32850,0,0,0,2,2
65138,150,13222,17973;18403,32850,0,0,0,2,2
65139,150,13224,18001,32850,0,0,0,1,1
65140,150,13225,18033,32850,0,0,0,1,1
65141,150,13226,18076,32850,0,0,0,1,1
65142,150,13227,18238,32850,0,0,0,1,1
65143,150,13228,18074,32850,0,0,0,1,1
65144,150,13229,18644,32850,0,0,0,1,1
65145,150,13231,18591,32850,0,0,0,1,1
65146,150,13232,17894;18282,32850,0,0,0,2,2
65147,150,13236,18362,32850,0,0,0,1,1
65148,150,13237,18366;18483,32850,0,0,0,2,2
65149,150,13239,18239;18433,32850,0,0,0,2,2
65150,150,13240,19038,32850,0,0,0,1,1
65151,150,13241,18567;18811,32850,0,0,0,2,2
65152,150,13243,18490;22450,32850,0,0,1,1,2
65153,150,13244,18254,32850,0,0,0,1,1
65154,150,13245,18292;18962,32850,0,0,0,2,2
65155,150,13248,18352;18599,32850,0,0,0,2,2
65156,150,13249,18793,32850,0,0,0,1,1
65157,150,13250,18627,32850,0,0,0,1,1
65158,150,13251,18890,32850,0,0,0,1,1
65159,150,13255,18682,32850,0,0,0,1,1
65160,150,13256,18571;18651,32850,0,0,0,2,2
65161,150,13257,18963,32850,0,0,0,1,1
65162,150,13258,19006;23153;25722;26449,32850,0,1,2,1,4
65163,150,13259,18715,32850,0,0,0,1,1
65164,150,13260,18766,32850,0,0,0,1,1
65165,150,13261,18770,32850,0,0,0,1,1
65166,150,13262,18774;19206,32850,0,0,0,2,2
65167,150,13263,18745;18823,32850,0,0,0,2,2
65168,150,13264,18846;18980,32850,0,0,0,2,2
65169,150,13265,18853;19151,32850,0,0,0,2,2
65170,150,13266,18507;18849,32850,0,0,0,2,2
65171,150,13308,18231,33215,0,0,0,1,1
65172,150,13309,17854,33215,0,0,0,1,1
65173,150,13313,18371,33215,0,0,0,1,1
65174,150,13316,18243;18253,33215,0,0,0,2,2
65175,150,13317,18264,33215,0,0,0,1,1
65176,150,13318,18283;18564,33215,0,0,0,2,2
65177,150,13320,18340;18788,33215,0,0,0,2,2
65178,150,13322,18927;19010,33215,0,0,0,2,2
65179,150,13324,18547;19021,33215,0,0,0,2,2
65180,150,13325,18625,33215,0,0,0,1,1
65181,150,13326,18654,33215,0,0,0,1,1
65182,150,13328,18524,33215,0,0,0,1,1
65183,150,13331,18645;18836,33215,0,0,0,2,2
65184,150,13332,19125,33215,0,0,0,1,1
65185,150,13334,18873;19275,33215,0,0,0,2,2
65186,150,13335,18902;18935,33215,0,0,0,2,2
65187,150,13336,18750;18929,33215,0,0,0,2,2
65188,150,13337,19309;19315,33215,0,0,0,2,2
65189,150,13338,18764,33215,0,0,0,1,1
65190,150,13339,18630;18914,33215,0,0,0,2,2
65191,150,13340,18780,33215,0,0,0,1,1
65192,150,13343,19009;19027,33215,0,0,0,2,2
65193,150,13344,19233,33215,0,0,0,1,1
65194,150,13345,18923;19087,33215,0,0,0,2,2
65195,150,13346,19168,33215,0,0,0,1,1
65196,150,13347,18835;18875,33215,0,0,0,2,2
65197,150,13348,18886,33215,0,0,0,1,1
65198,150,13349,18900;18928,33215,0,0,0,2,2
65199,150,13350,18913;18965,33215,0,0,0,2,2
65200,150,13351,18891;18957,33215,0,0,0,2,2
65201,150,13352,18981,33215,0,0,0,1,1
65202,150,13395,17055,33580,0,0,0,1,1
65203,150,13407,18261,33580,0,0,0,1,1
65204,150,13410,17627;18312,33580,0,0,0,2,2
65205,150,13418,18038,33580,0,0,0,1,1
65206,150,13425,18229,33580,0,0,0,1,1
65207,150,13426,18304,33580,0,0,0,1,1
65208,150,13429,18565,33580,0,0,0,1,1
65209,150,13430,18082;18373,33580,0,0,0,2,2
65210,150,13432,18870;18897,33580,0,0,0,2,2
65211,150,13433,18506;18868,33580,0,0,0,2,2
65212,150,13435,18531;18834,33580,0,0,0,2,2
65213,150,13436,18561,33580,0,0,0,1,1
65214,150,13437,18569;19392,33580,0,0,0,2,2
65215,150,13439,19041,33580,0,0,0,1,1
65216,150,13440,18748,33580,0,0,0,1,1
65217,150,13441,19124;22657,33580,0,0,1,1,2
65218,150,13442,18783;19354,33580,0,0,0,2,2
65219,150,13443,18810;19269,33580,0,0,0,2,2
65220,150,13444,18833;19188,33580,0,0,0,2,2
65221,150,13445,18220;18867,33580,0,0,0,2,2
65222,150,13446,18893;18954,33580,0,0,0,2,2
65223,150,13447,18904;19282,33580,0,0,0,2,2
65224,150,13448,18759;18907,33580,0,0,0,2,2
65225,150,13449,18504;18918,33580,0,0,0,2,2
65226,150,13450,18934,33580,0,0,0,1,1
65227,150,13451,18939;18988,33580,0,0,0,2,2
65228,150,13452,19298,33580,0,0,0,1,1
65229,150,13453,19217;19325,33580,0,0,0,2,2
65230,150,13454,19070,33580,0,0,0,1,1
65231,150,13456,19013,33580,0,0,0,1,1
65232,150,13457,19242;23275,33580,0,0,1,1,2
65233,150,13458,19017,33580,0,0,0,1,1
65234,150,13461,19093;19366,33580,0,0,0,2,2
65235,150,13462,19104;19435,33580,0,0,0,2,2
65236,150,13502,17676,33945,0,0,0,1,1
65237,150,13505,17876,33945,0,0,0,1,1
65238,150,13506,17502,33945,0,0,0,1,1
65239,150,13508,17809,33945,0,0,0,1,1
65240,150,13509,18493,33945,0,0,0,1,1
65241,150,13510,17273,33945,0,0,0,1,1
65242,150,13511,17814,33945,0,0,0,1,1
65243,150,13514,18327,33945,0,0,0,1,1
65244,150,13515,18724,33945,0,0,0,1,1
65245,150,13517,18319,33945,0,0,0,1,1
65246,150,13519,18325,33945,0,0,0,1,1
65247,150,13520,18085;18401,33945,0,0,0,2,2
65248,150,13521,18190,33945,0,0,0,1,1
65249,150,13522,18767,33945,0,0,0,1,1
65250,150,13526,18521,33945,0,0,0,1,1
65251,150,13527,18544,33945,0,0,0,1,1
65252,150,13528,18554,33945,0,0,0,1,1
65253,150,13529,17849,33945,0,0,0,1,1
65254,150,13530,18537,33945,0,0,0,1,1
65255,150,13531,18589,33945,0,0,0,1,1
65256,150,13533,18608,33945,0,0,0,1,1
65257,150,13534,18623,33945,0,0,0,1,1
65258,150,13536,18600;18956,33945,0,0,0,2,2
65259,150,13537,18950,33945,0,0,0,1,1
65260,150,13539,18758,33945,0,0,0,1,1
65261,150,13540,18775,33945,0,0,0,1,1
65262,150,13541,19302;19318,33945,0,0,0,2,2
65263,150,13543,18771,33945,0,0,0,1,1
65264,150,13544,18806;19195,33945,0,0,0,2,2
65265,150,13545,18970,33945,0,0,0,1,1
65266,150,13546,18917,33945,0,0,0,1,1
65267,150,13547,18587;18858,33945,0,0,0,2,2
65268,150,13548,18860;19073,33945,0,0,0,2,2
65269,150,13549,19172,33945,0,0,0,1,1
65270,150,13550,19279;19400,33945,0,0,0,2,2
65271,150,13552,19018;19111,33945,0,0,0,2,2
65272,150,13553,18924;19007,33945,0,0,0,2,2
65273,150,13554,18541;18944,33945,0,0,0,2,2
65274,150,13556,18978,33945,0,0,0,1,1
65275,150,13557,19002,33945,0,0,0,1,1
65276,150,13558,19019,33945,0,0,0,1,1
65277,150,13561,19228;19376,33945,0,0,0,2,2
65278,150,13562,18854;18982,33945,0,0,0,2,2
65279,150,13563,19080;19391;23082,33945,0,0,1,2,3
65280,150,13564,19084,33945,0,0,0,1,1
65281,150,13565,18933;19086,33945,0,0,0,2,2
65282,150,13566,18679;19096,33945,0,0,0,2,2
65283,150,13567,18997;19098,33945,0,0,0,2,2
65284,150,13568,18809,33945,0,0,0,1,1
65285,150,13569,18730;19427,33945,0,0,0,2,2
65286,150,13570,19115,33945,0,0,0,1,1
65287,150,13571,19464,33945,0,0,0,1,1
65288,150,13572,19142;19378,33945,0,0,0,2,2
65289,150,13574,18731;19434,33945,0,0,0,2,2
65290,150,13575,19550,33945,0,0,0,1,1
65291,150,13611,17169,34310,0,0,0,1,1
65292,150,13612,17404,34310,0,0,0,1,1
65293,150,13618,17799;17805,34310,0,0,0,2,2
65294,150,13622,17974;18153,34310,0,0,0,2,2
65295,150,13624,17992,34310,0,0,0,1,1
65296,150,13627,17806,34310,0,0,0,1,1
65297,150,13628,18402;18534,34310,0,0,0,2,2
65298,150,13629,18363,34310,0,0,0,1,1
65299,150,13631,18528,34310,0,0,0,1,1
65300,150,13632,18297,34310,0,0,0,1,1
65301,150,13633,18073,34310,0,0,0,1,1
65302,150,13634,18670,34310,0,0,0,1,1
65303,150,13635,18376,34310,0,0,0,1,1
65304,150,13638,18642,34310,0,0,0,1,1
65305,150,13639,18647,34310,0,0,0,1,1
65306,150,13640,18659,34310,0,0,0,1,1
65307,150,13642,18942;19030,34310,0,0,0,2,2
65308,150,13644,18372;18741,34310,0,0,0,2,2
65309,150,13645,19083,34310,0,0,0,1,1
65310,150,13647,18830;18889,34310,0,0,0,2,2
65311,150,13648,18464;18814,34310,0,0,0,2,2
65312,150,13649,19197;19230,34310,0,0,0,2,2
65313,150,13651,18839;18911,34310,0,0,0,2,2
65314,150,13652,19280,34310,0,0,0,1,1
65315,150,13653,19129,34310,0,0,0,1,1
65316,150,13655,19537,34310,0,0,0,1,1
65317,150,13656,19036,34310,0,0,0,1,1
65318,150,13659,19016;19117,34310,0,0,0,2,2
65319,150,13660,18760,34310,0,0,0,1,1
65320,150,13662,19051;19289,34310,0,0,0,2,2
65321,150,13664,18991;19061,34310,0,0,0,2,2
65322,150,13665,19131,34310,0,0,0,1,1
65323,150,13667,19108;19398,34310,0,0,0,2,2
65324,150,13669,19138;19145,34310,0,0,0,2,2
65325,150,13670,19221,34310,0,0,0,1,1
65326,150,13671,19004;19169,34310,0,0,0,2,2
65327,150,13672,18768;19425,34310,0,0,0,2,2
65328,150,13673,19411;19564,34310,0,0,0,2,2
65329,150,13674,18885;19209,34310,0,0,0,2,2
65330,150,13675,19120,34310,0,0,0,1,1
65331,150,13676,19667,34310,0,0,0,1,1
65332,150,13677,19448,34310,0,0,0,1,1
65333,150,13679,19518;19522,34310,0,0,0,2,2
65334,150,13680,19167,34310,0,0,0,1,1
65335,150,13709,18480,34675,0,0,0,1,1
65336,150,13710,17669,34675,0,0,0,1,1
65337,150,13711,18543,34675,0,0,0,1,1
65338,150,13712,18408,34675,0,0,0,1,1
65339,150,13717,18476,34675,0,0,0,1,1
65340,150,13718,18598,34675,0,0,0,1,1
65341,150,13719,18631,34675,0,0,0,1,1
65342,150,13721,18938,34675,0,0,0,1,1
65343,150,13722,18449;18703,34675,0,0,0,2,2
65344,150,13723,18729;18736,34675,0,0,0,2,2
65345,150,13726,19219;19365,34675,0,0,0,2,2
65346,150,13727,19258;19718,34675,0,0,0,2,2
65347,150,13730,18593;18862,34675,0,0,0,2,2
65348,150,13731,19126;19270,34675,0,0,0,2,2
65349,150,13732,18961;18975,34675,0,0,0,2,2
65350,150,13733,18973;18986,34675,0,0,0,2,2
65351,150,13734,18901,34675,0,0,0,1,1
65352,150,13735,19068;19220,34675,0,0,0,2,2
65353,150,13736,19503,34675,0,0,0,1,1
65354,150,13737,19114;23472;27019,34675,1,0,1,1,3
65355,150,13738,19147,34675,0,0,0,1,1
65356,150,13739,19088;19158,34675,0,0,0,2,2
65357,150,13740,19438;19900;22783;26527,34675,0,1,1,2,4
65358,150,13741,19397,34675,0,0,0,1,1
65359,150,13743,19082;19278,34675,0,0,0,2,2
65360,150,13745,19113;19307,34675,0,0,0,2,2
65361,150,13746,19332,34675,0,0,0,1,1
65362,150,13747,19353;19554,34675,0,0,0,2,2
65363,150,13748,18878,34675,0,0,0,1,1
65364,150,13749,19429;19433,34675,0,0,0,2,2
65365,150,13799,18213;18311,35040,0,0,0,2,2
65366,150,13803,22097;22555;22947;23146;25721,35040,0,0,5,0,5
65367,150,13804,18458,35040,0,0,0,1,1
65368,150,13805,18191,35040,0,0,0,1,1
65369,150,13806,18222;18432,35040,0,0,0,2,2
65370,150,13807,18271;18622,35040,0,0,0,2,2
65371,150,13811,18470,35040,0,0,0,1,1
65372,150,13812,18077,35040,0,0,0,1,1
65373,150,13814,18546,35040,0,0,0,1,1
65374,150,13815,19199;19229,35040,0,0,0,2,2
65375,150,13816,18925,35040,0,0,0,1,1
65376,150,13817,18602,35040,0,0,0,1,1
65377,150,13819,18763;19268,35040,0,0,0,2,2
65378,150,13820,18787;19077,35040,0,0,0,2,2
65379,150,13821,18845;19160,35040,0,0,0,2,2
65380,150,13823,18613;18920,35040,0,0,0,2,2
65381,150,13824,19521,35040,0,0,0,1,1
65382,150,13825,18979;19246,35040,0,0,0,2,2
65383,150,13826,18989;19154,35040,0,0,0,2,2
65384,150,13827,19011,35040,0,0,0,1,1
65385,150,13829,18976,35040,0,0,0,1,1
65386,150,13830,19226;19494,35040,0,0,0,2,2
65387,150,13831,19049,35040,0,0,0,1,1
65388,150,13832,19074;22761,35040,0,0,1,1,2
65389,150,13833,18535;19112,35040,0,0,0,2,2
65390,150,13834,19638,35040,0,0,0,1,1
65391,150,13835,19612,35040,0,0,0,1,1
65392,150,13836,18847;19196,35040,0,0,0,2,2
65393,150,13838,18603;19213,35040,0,0,0,2,2
65394,150,13839,19181;19244,35040,0,0,0,2,2
65395,150,13840,19273;19865,35040,0,0,0,2,2
65396,150,13841,19277;19495,35040,0,0,0,2,2
65397,150,13842,19286;19382,35040,0,0,0,2,2
65398,150,13844,19224;19293,35040,0,0,0,2,2
65399,150,13845,18832;19303,35040,0,0,0,2,2
65400,150,13846,19107,35040,0,0,0,1,1
65401,150,13847,19317,35040,0,0,0,1,1
65402,150,13849,19294;19350,35040,0,0,0,2,2
65403,150,13850,19352,35040,0,0,0,1,1
65404,150,13851,19214,35040,0,0,0,1,1
65405,150,13852,19803;19853,35040,0,0,0,2,2
65406,150,13853,18999;19561,35040,0,0,0,2,2
65407,150,13854,19492;19781,35040,0,0,0,2,2
65408,150,13855,19652;19837,35040,0,0,0,2,2
65409,150,13858,19540;19675,35040,0,0,0,2,2
65410,150,13859,19472;19757,35040,0,0,0,2,2
65411,150,13860,19474,35040,0,0,0,1,1
65412,150,13861,19767,35040,0,0,0,1,1
65413,150,13862,19450;19846,35040,0,0,0,2,2
65414,150,13863,19491,35040,0,0,0,1,1
65415,150,13864,19529,35040,0,0,0,1,1
65416,150,13865,19535;19619,35040,0,0,0,2,2
65417,150,13908,18017,35405,0,0,0,1,1
65418,150,13910,18230,35405,0,0,0,1,1
65419,150,13911,18244;18374,35405,0,0,0,2,2
65420,150,13912,18619,35405,0,0,0,1,1
65421,150,13915,23147;23150;26746,35405,0,1,2,0,3
65422,150,13918,18538,35405,0,0,0,1,1
65423,150,13919,18517,35405,0,0,0,1,1
65424,150,13920,18532;18757,35405,0,0,0,2,2
65425,150,13921,18553;19044,35405,0,0,0,2,2
65426,150,13922,18579;19094,35405,0,0,0,2,2
65427,150,13925,18626;18657,35405,0,0,0,2,2
65428,150,13927,18735,35405,0,0,0,1,1
65429,150,13928,19287,35405,0,0,0,1,1
65430,150,13932,18549,35405,0,0,0,1,1
65431,150,13933,18958;19156,35405,0,0,0,2,2
65432,150,13935,19444,35405,0,0,0,1,1
65433,150,13936,19037,35405,0,0,0,1,1
65434,150,13939,19412;19654,35405,0,0,0,2,2
65435,150,13940,18863,35405,0,0,0,1,1
65436,150,13941,19132,35405,0,0,0,1,1
65437,150,13942,18732;19283;23780;26586,35405,0,1,1,2,4
65438,150,13943,19192;22556,35405,0,0,1,1,2
65439,150,13945,18987;19231,35405,0,0,0,2,2
65440,150,13946,19100;19254,35405,0,0,0,2,2
65441,150,13947,19285,35405,0,0,0,1,1
65442,150,13948,19656,35405,0,0,0,1,1
65443,150,13949,19422,35405,0,0,0,1,1
65444,150,13950,19370,35405,0,0,0,1,1
65445,150,13951,19368,35405,0,0,0,1,1
65446,150,13952,19578,35405,0,0,0,1,1
65447,150,13953,19431;19882,35405,0,0,0,2,2
65448,150,13954,19758;19990,35405,0,0,0,2,2
65449,150,13955,19417,35405,0,0,0,1,1
65450,150,13957,18909;19238,35405,0,0,0,2,2
65451,150,13958,19306;19679,35405,0,0,0,2,2
65452,150,13960,19684,35405,0,0,0,1,1
65453,150,13961,19326;19568,35405,0,0,0,2,2
65454,150,13962,19577;23292,35405,0,0,1,1,2
65455,150,13963,19064;19581,35405,0,0,0,2,2
65456,150,13964,19611;20119,35405,0,0,0,2,2
65457,150,13965,19548;19641,35405,0,0,0,2,2
65458,150,13967,19836;19993,35405,0,0,0,2,2
65459,150,13968,19680;19889,35405,0,0,0,2,2
65460,150,13992,16586,35770,0,0,0,1,1
65461,150,14004,17277,35770,0,0,0,1,1
65462,150,14011,18487,35770,0,0,0,1,1
65463,150,14012,17931,35770,0,0,0,1,1
65464,150,14021,18383,35770,0,0,0,1,1
65465,150,14023,18241;18450,35770,0,0,0,2,2
65466,150,14024,18494,35770,0,0,0,1,1
65467,150,14027,19072,35770,0,0,0,1,1
65468,150,14028,18781,35770,0,0,0,1,1
65469,150,14029,19045;19264,35770,0,0,0,2,2
65470,150,14030,19186,35770,0,0,0,1,1
65471,150,14032,18937,35770,0,0,0,1,1
65472,150,14033,19608;19881,35770,0,0,0,2,2
65473,150,14035,19028,35770,0,0,0,1,1
65474,150,14036,18931,35770,0,0,0,1,1
65475,150,14038,19144;19295,35770,0,0,0,2,2
65476,150,14039,18908;19179,35770,0,0,0,2,2
65477,150,14040,19187;19527,35770,0,0,0,2,2
65478,150,14045,19413,35770,0,0,0,1,1
65479,150,14046,19202;19259,35770,0,0,0,2,2
65480,150,14047,18926;19106,35770,0,0,0,2,2
65481,150,14048,19511,35770,0,0,0,1,1
65482,150,14049,23507,35770,0,0,1,0,1
65483,150,14051,19489,35770,0,0,0,1,1
65484,150,14053,19319;19552,35770,0,0,0,2,2
65485,150,14055,19530;19828,35770,0,0,0,2,2
65486,150,14056,19304;19499,35770,0,0,0,2,2
65487,150,14057,19661;19902,35770,0,0,0,2,2
65488,150,14058,19373;19778,35770,0,0,0,2,2
65489,150,14059,19110;19832,35770,0,0,0,2,2
65490,150,14062,19034;19587,35770,0,0,0,2,2
65491,150,14063,19532;19615,35770,0,0,0,2,2
65492,150,14064,19632;19943,35770,0,0,0,2,2
65493,150,14065,19691;20077,35770,0,0,0,2,2
65494,150,14066,19249;19702,35770,0,0,0,2,2
65495,150,14067,19330;19704,35770,0,0,0,2,2
65496,150,14068,19570;19710,35770,0,0,0,2,2
65497,150,14069,19274;19712,35770,0,0,0,2,2
65498,150,14070,19726,35770,0,0,0,1,1
65499,150,14071,19348;19739;23499,35770,0,0,1,2,3
65500,150,14072,19505,35770,0,0,0,1,1
65501,150,14073,19847;20143,35770,0,0,0,2,2
65502,150,14074,19759;19970,35770,0,0,0,2,2
65503,150,14075,20134;20217,35770,0,0,0,2,2
65504,150,14076,19520;19780,35770,0,0,0,2,2
65505,150,14077,19364;19380,35770,0,0,0,2,2
65506,150,14112,18063;18473,36135,0,0,0,2,2
65507,150,14113,17867,36135,0,0,0,1,1
65508,150,14114,18499,36135,0,0,0,1,1
65509,150,14121,18024;18420,36135,0,0,0,2,2
65510,150,14123,18803;18998,36135,0,0,0,2,2
65511,150,14127,18883;19290,36135,0,0,0,2,2
65512,150,14128,18665,36135,0,0,0,1,1
65513,150,14129,18709,36135,0,0,0,1,1
65514,150,14130,18777,36135,0,0,0,1,1
65515,150,14134,18573;18765,36135,0,0,0,2,2
65516,150,14135,18940,36135,0,0,0,1,1
65517,150,14136,18894,36135,0,0,0,1,1
65518,150,14137,18977,36135,0,0,0,1,1
65519,150,14138,18819;18974,36135,0,0,0,2,2
65520,150,14141,19428;19539,36135,0,0,0,2,2
65521,150,14142,19606,36135,0,0,0,1,1
65522,150,14143,19262;19478,36135,0,0,0,2,2
65523,150,14145,19078;19239;23678,36135,0,0,1,2,3
65524,150,14147,19252;19934,36135,0,0,0,2,2
65525,150,14150,19729,36135,0,0,0,1,1
65526,150,14151,19488,36135,0,0,0,1,1
65527,150,14152,19180;19337,36135,0,0,0,2,2
65528,150,14153,19485,36135,0,0,0,1,1
65529,150,14154,19357,36135,0,0,0,1,1
65530,150,14156,19227;19403,36135,0,0,0,2,2
65531,150,14157,19134;19408,36135,0,0,0,2,2
65532,150,14160,20003,36135,0,0,0,1,1
65533,150,14161,19771,36135,0,0,0,1,1
65534,150,14162,19250;20024;24317,36135,0,0,1,2,3
65535,150,14163,19349,36135,0,0,0,1,1
65536,150,14165,19536,36135,0,0,0,1,1
65537,150,14166,19393;19756,36135,0,0,0,2,2
65538,150,14167,19871,36135,0,0,0,1,1
65539,150,14168,19333;19840,36135,0,0,0,2,2
65540,150,14170,19685,36135,0,0,0,1,1
65541,150,14172,19404,36135,0,0,0,1,1
65542,150,14173,19659;19895;23512,36135,0,0,1,2,3
65543,150,14177,20154,36135,0,0,0,1,1
65544,150,14178,19751;20210,36135,0,0,0,2,2
65545,150,14180,19605,36135,0,0,0,1,1
65546,150,14182,19852;19905,36135,0,0,0,2,2
65547,150,14183,19855;19856;23799,36135,0,0,1,2,3
65548,150,14184,19761;19874,36135,0,0,0,2,2
65549,150,14185,19885,36135,0,0,0,1,1
65550,150,14186,19948,36135,0,0,0,1,1
65551,150,14187,19599,36135,0,0,0,1,1
65552,150,14188,19911;20047,36135,0,0,0,2,2
65553,150,14189,19914;20031,36135,0,0,0,2,2
65554,150,14214,16660,36500,0,0,0,1,1
65555,150,14228,18348;18866,36500,0,0,0,2,2
65556,150,14229,18463,36500,0,0,0,1,1
65557,150,14232,18738,36500,0,0,0,1,1
65558,150,14233,18423;18572,36500,0,0,0,2,2
65559,150,14234,18815;18879,36500,0,0,0,2,2
65560,150,14236,19097,36500,0,0,0,1,1
65561,150,14238,19116,36500,0,0,0,1,1
65562,150,14239,18865;19218,36500,0,0,0,2,2
65563,150,14240,18887;19000,36500,0,0,0,2,2
65564,150,14244,18693;19020,36500,0,0,0,2,2
65565,150,14245,19022;19682,36500,0,0,0,2,2
65566,150,14247,19693;19717,36500,0,0,0,2,2
65567,150,14248,19963,36500,0,0,0,1,1
65568,150,14249,19312,36500,0,0,0,1,1
65569,150,14253,19924,36500,0,0,0,1,1
65570,150,14254,19341;19556;23584,36500,0,0,1,2,3
65571,150,14255,19345;19713,36500,0,0,0,2,2
65572,150,14256,19575,36500,0,0,0,1,1
65573,150,14257,19389;19854,36500,0,0,0,2,2
65574,150,14258,19583;20001,36500,0,0,0,2,2
65575,150,14259,18984;19399,36500,0,0,0,2,2
65576,150,14263,19461,36500,0,0,0,1,1
65577,150,14264,19056;19469,36500,0,0,0,2,2
65578,150,14266,19497,36500,0,0,0,1,1
65579,150,14267,19628;19664,36500,0,0,0,2,2
65580,150,14269,19595;19597,36500,0,0,0,2,2
65581,150,14270,19873,36500,0,0,0,1,1
65582,150,14271,19432;19650,36500,0,0,0,2,2
65583,150,14274,19653,36500,0,0,0,1,1
65584,150,14275,19666,36500,0,0,0,1,1
65585,150,14276,19483;19714,36500,0,0,0,2,2
65586,150,14278,19694,36500,0,0,0,1,1
65587,150,14279,19979,36500,0,0,0,1,1
65588,150,14280,19762,36500,0,0,0,1,1
65589,150,14281,19814,36500,0,0,0,1,1
65590,150,14282,19784;20118,36500,0,0,0,2,2
65591,150,14286,19557;19862,36500,0,0,0,2,2
65592,150,14287,19868;20015,36500,0,0,0,2,2
65593,150,14288,19968,36500,0,0,0,1,1
65594,150,14289,20138,36500,0,0,0,1,1
65595,150,14291,19975,36500,0,0,0,1,1
65596,150,14292,19996;20033;22814;25622;27281,36500,1,0,2,2,5
65597,150,14293,19931;20023,36500,0,0,0,2,2
65598,150,14314,17224,36865,0,0,0,1,1
65599,150,14327,18666;19105,36865,0,0,0,2,2
65600,150,14328,18753;19122,36865,0,0,0,2,2
65601,150,14330,18596,36865,0,0,0,1,1
65602,150,14331,19014;19191,36865,0,0,0,2,2
65603,150,14332,18983;19465,36865,0,0,0,2,2
65604,150,14333,19062,36865,0,0,0,1,1
65605,150,14334,18855,36865,0,0,0,1,1
65606,150,14335,19267;19394,36865,0,0,0,2,2
65607,150,14338,19140,36865,0,0,0,1,1
65608,150,14339,19149;19462,36865,0,0,0,2,2
65609,150,14344,19291;19372,36865,0,0,0,2,2
65610,150,14346,19426,36865,0,0,0,1,1
65611,150,14347,19453;19480,36865,0,0,0,2,2
65612,150,14348,19463;19980,36865,0,0,0,2,2
65613,150,14352,19445;19446,36865,0,0,0,2,2
65614,150,14354,19920,36865,0,0,0,1,1
65615,150,14355,19498;19598,36865,0,0,0,2,2
65616,150,14356,19799;24224,36865,0,0,1,1,2
65617,150,14357,19351;19613,36865,0,0,0,2,2
65618,150,14358,19658,36865,0,0,0,1,1
65619,150,14359,20048;20270,36865,0,0,0,2,2
65620,150,14360,19701;20114,36865,0,0,0,2,2
65621,150,14362,19827,36865,0,0,0,1,1
65622,150,14364,19860,36865,0,0,0,1,1
65623,150,14365,20201;20249,36865,0,0,0,2,2
65624,150,14366,19752;19887;23501;25817;26856,36865,0,1,2,2,5
65625,150,14367,19904;20365,36865,0,0,0,2,2
65626,150,14368,19676;19917;25195,36865,0,0,1,2,3
65627,150,14369,19940;20011,36865,0,0,0,2,2
65628,150,14370,20054;20205,36865,0,0,0,2,2
65629,150,14371,19788;20268,36865,0,0,0,2,2
65630,150,14372,20153,36865,0,0,0,1,1
65631,150,14373,19974;20074,36865,0,0,0,2,2
65632,150,14374,20093;20486,36865,0,0,0,2,2
65633,150,14375,20103,36865,0,0,0,1,1
65634,150,14376,20105;20136,36865,0,0,0,2,2
65635,150,14377,20121;20567,36865,0,0,0,2,2
65636,150,14378,20260,36865,0,0,0,1,1
65637,150,14402,17624,37230,0,0,0,1,1
65638,150,14408,18052;18539,37230,0,0,0,2,2
65639,150,14413,18512,37230,0,0,0,1,1
65640,150,14416,18610,37230,0,0,0,1,1
65641,150,14419,18668;19342,37230,0,0,0,2,2
65642,150,14420,18170;18669,37230,0,0,0,2,2
65643,150,14422,18471,37230,0,0,0,1,1
65644,150,14427,18822,37230,0,0,0,1,1
65645,150,14428,19003;19127,37230,0,0,0,2,2
65646,150,14429,19390,37230,0,0,0,1,1
65647,150,14430,19148;19621,37230,0,0,0,2,2
65648,150,14431,19375,37230,0,0,0,1,1
65649,150,14432,19502,37230,0,0,0,1,1
65650,150,14433,19118,37230,0,0,0,1,1
65651,150,14435,19602;19897,37230,0,0,0,2,2
65652,150,14436,19248,37230,0,0,0,1,1
65653,150,14437,19805,37230,0,0,0,1,1
65654,150,14438,19455,37230,0,0,0,1,1
65655,150,14439,19311;19477,37230,0,0,0,2,2
65656,150,14440,18895;19531,37230,0,0,0,2,2
65657,150,14442,19493;19623,37230,0,0,0,2,2
65658,150,14445,20102,37230,0,0,0,1,1
65659,150,14447,19415;19622,37230,0,0,0,2,2
65660,150,14448,19750,37230,0,0,0,1,1
65661,150,14449,19487;20222,37230,0,0,0,2,2
65662,150,14450,19696,37230,0,0,0,1,1
65663,150,14451,19742;20509,37230,0,0,0,2,2
65664,150,14453,20208,37230,0,0,0,1,1
65665,150,14454,19830;20196,37230,0,0,0,2,2
65666,150,14455,19831,37230,0,0,0,1,1
65667,150,14456,19721;19879,37230,0,0,0,2,2
65668,150,14457,19823;19858,37230,0,0,0,2,2
65669,150,14458,19715;23693,37230,0,0,1,1,2
65670,150,14459,19735;20010,37230,0,0,0,2,2
65671,150,14460,20036;20664,37230,0,0,1,1,2
65672,150,14461,19688;20500,37230,0,0,0,2,2
65673,150,14464,20081,37230,0,0,0,1,1
65674,150,14465,19808;20174,37230,0,0,0,2,2
65675,150,14466,19300;19952,37230,0,0,0,2,2
65676,150,14467,20304;20470;24438;26801;27075,37230,1,1,1,2,5
65677,150,14468,19760;19989;23704,37230,0,0,1,2,3
65678,150,14470,20472;20473,37230,0,0,0,2,2
65679,150,14471,20067,37230,0,0,0,1,1
65680,150,14472,20075;23521;25911;25992;26571;26764;26858,37230,0,5,1,1,7
65681,150,14474,19826;20101,37230,0,0,0,2,2
65682,150,14475,20140,37230,0,0,0,1,1
65683,150,14476,20330,37230,0,0,0,1,1
65684,150,14477,20574,37230,0,0,0,1,1
65685,150,14478,19896;20155,37230,0,0,0,2,2
65686,150,14479,20163,37230,0,0,0,1,1
65687,150,14480,20414;20506;24539,37230,0,0,1,2,3
65688,150,14481,19861;20257,37230,0,0,0,2,2
65689,150,14482,20145;20179,37230,0,0,0,2,2
65690,150,14483,20199;20440,37230,0,0,0,2,2
65691,150,14484,20523,37230,0,0,0,1,1
65692,150,14503,17225,37595,0,0,0,1,1
65693,150,14508,17877,37595,0,0,0,1,1
65694,150,14514,18365,37595,0,0,0,1,1
65695,150,14521,18338,37595,0,0,0,1,1
65696,150,14522,18912,37595,0,0,0,1,1
65697,150,14525,18945,37595,0,0,0,1,1
65698,150,14526,18799;19243,37595,0,0,0,2,2
65699,150,14527,18804;19058,37595,0,0,0,2,2
65700,150,14528,18652;19184;23379,37595,0,0,1,2,3
65701,150,14530,19401,37595,0,0,0,1,1
65702,150,14531,19973;20020,37595,0,0,0,2,2
65703,150,14532,19459,37595,0,0,0,1,1
65704,150,14534,19737;20248,37595,0,0,0,2,2
65705,150,14535,19574;19886,37595,0,0,0,2,2
65706,150,14537,19471,37595,0,0,0,1,1
65707,150,14538,19542,37595,0,0,0,1,1
65708,150,14539,19793,37595,0,0,0,1,1
65709,150,14540,19589;19893,37595,0,0,0,2,2
65710,150,14543,19743;19782,37595,0,0,0,2,2
65711,150,14544,19546;19981,37595,0,0,0,2,2
65712,150,14545,19607;19736,37595,0,0,0,2,2
65713,150,14548,19671;20056,37595,0,0,0,2,2
65714,150,14549,19813;20068,37595,0,0,0,2,2
65715,150,14550,19610;19892,37595,0,0,0,2,2
65716,150,14551,19937,37595,0,0,0,1,1
65717,150,14552,20191;20195,37595,0,0,0,2,2
65718,150,14553,19801,37595,0,0,0,1,1
65719,150,14554,19950;19977,37595,0,0,0,2,2
65720,150,14556,20325;20429,37595,0,0,0,2,2
65721,150,14557,19338,37595,0,0,0,1,1
65722,150,14558,20495,37595,0,0,0,1,1
65723,150,14559,20008;20116,37595,0,0,0,2,2
65724,150,14561,19749;19843,37595,0,0,0,2,2
65725,150,14562,20389;20480,37595,0,0,0,2,2
65726,150,14565,19995;20186;24119;26097;26694,37595,0,2,1,2,5
65727,150,14566,19935;20501,37595,0,0,0,2,2
65728,150,14567,20052;20307,37595,0,0,0,2,2
65729,150,14568,20202;20236,37595,0,0,0,2,2
65730,150,14569,20156,37595,0,0,0,1,1
65731,150,14570,20404,37595,0,0,0,1,1
65732,150,14571,19962;20242,37595,0,0,0,2,2
65733,150,14572,19821;20244,37595,0,0,0,2,2
65734,150,14573,20220,37595,0,0,0,1,1
65735,150,14574,20041;20361,37595,0,0,0,2,2
65736,150,14576,20296;24125,37595,0,0,1,1,2
65737,150,14577,20652,37595,0,0,1,0,1
65738,150,14578,20321;20728,37595,0,0,1,1,2
65739,150,14579,20711;24879,37595,0,0,2,0,2
65740,150,14580,20334,37595,0,0,0,1,1
65741,150,14581,20194,37595,0,0,0,1,1
65742,150,14582,20340;20542;23637,37595,0,0,1,2,3
65743,150,14583,20292;20394,37595,0,0,0,2,2
65744,150,14584,20391;20715,37595,0,0,1,1,2
65745,150,14616,18090,37960,0,0,0,1,1
65746,150,14630,19416;22983;26064;26347,37960,0,2,1,1,4
65747,150,14631,18716;19029,37960,0,0,0,2,2
65748,150,14633,18726;18792,37960,0,0,0,2,2
65749,150,14634,19707;20027,37960,0,0,0,2,2
65750,150,14636,19563;19880,37960,0,0,0,2,2
65751,150,14637,19437;19966,37960,0,0,0,2,2
65752,150,14638,19443,37960,0,0,0,1,1
65753,150,14639,19460;19670,37960,0,0,0,2,2
65754,150,14640,18994;19475,37960,0,0,0,2,2
65755,150,14643,19276,37960,0,0,0,1,1
65756,150,14644,19596;19918,37960,0,0,0,2,2
65757,150,14645,19647,37960,0,0,0,1,1
65758,150,14646,19614,37960,0,0,0,1,1
65759,150,14647,19630;19651,37960,0,0,0,2,2
65760,150,14648,19800;20146;24433,37960,0,0,1,2,3
65761,150,14649,19439;19636,37960,0,0,0,2,2
65762,150,14650,19136,37960,0,0,0,1,1
65763,150,14651,19657;20013,37960,0,0,0,2,2
65764,150,14653,19509;19773,37960,0,0,0,2,2
65765,150,14655,19794,37960,0,0,0,1,1
65766,150,14656,19944,37960,0,0,0,1,1
65767,150,14657,19777,37960,0,0,0,1,1
65768,150,14658,19791;19849,37960,0,0,0,2,2
65769,150,14659,19795;20531,37960,0,0,0,2,2
65770,150,14660,19421;19797,37960,0,0,0,2,2
65771,150,14661,19668,37960,0,0,0,1,1
65772,150,14662,19639;19810,37960,0,0,0,2,2
65773,150,14663,19817;19922,37960,0,0,0,2,2
65774,150,14664,20046;20223,37960,0,0,0,2,2
65775,150,14665,19928,37960,0,0,0,1,1
65776,150,14666,20488;20603,37960,0,0,0,2,2
65777,150,14667,19998,37960,0,0,0,1,1
65778,150,14670,19451;20017,37960,0,0,0,2,2
65779,150,14671,20166;20463,37960,0,0,0,2,2
65780,150,14672,20078;20489,37960,0,0,0,2,2
65781,150,14673,19955,37960,0,0,0,1,1
65782,150,14674,20109,37960,0,0,0,1,1
65783,150,14675,20582;21058,37960,0,0,1,1,2
65784,150,14678,20310,37960,0,0,0,1,1
65785,150,14679,20356;20374,37960,0,0,0,2,2
65786,150,14680,20159,37960,0,0,0,1,1
65787,150,14681,20335;20421,37960,0,0,0,2,2
65788,150,14682,20098;20212,37960,0,0,0,2,2
65789,150,14683,20172;20533,37960,0,0,0,2,2
65790,150,14684,20415,37960,0,0,0,1,1
65791,150,14685,19971;20316;24026,37960,0,0,1,2,3
65792,150,14687,20293;20401,37960,0,0,0,2,2
65793,150,14688,20317;20319,37960,0,0,0,2,2
65794,150,14689,20211;20342,37960,0,0,0,2,2
65795,150,14690,20355;20595,37960,0,0,0,2,2
65796,150,14691,20568;20775;24558;27084,37960,1,0,2,1,4
65797,150,14692,20384;20424,37960,0,0,0,2,2
65798,150,14694,20007;20413,37960,0,0,0,2,2
65799,150,14695,20226;20427,37960,0,0,0,2,2
65800,150,14696,20107;20544;23952,37960,0,0,1,2,3
65801,150,14697,20447,37960,0,0,0,1,1
65802,150,14698,19987;20448,37960,0,0,0,2,2
65803,150,14699,20870;21112,37960,0,0,2,0,2
65804,150,14700,23344;23960;24044;24084;26294;26598;27321,37960,1,2,4,0,7
65805,150,14701,20745,37960,0,0,1,0,1
65806,150,14702,20469;20646,37960,0,0,1,1,2
65807,150,14703,20621;20897;23545;26274,37960,0,1,2,1,4
65808,150,14722,17373,38325,0,0,0,1,1
65809,150,14725,17542,38325,0,0,0,1,1
65810,150,14731,18733,38325,0,0,0,1,1
65811,150,14735,18206;18419,38325,0,0,0,2,2
65812,150,14743,18967;19222,38325,0,0,0,2,2
65813,150,14744,19059,38325,0,0,0,1,1
65814,150,14745,19133,38325,0,0,0,1,1
65815,150,14746,19190;19347,38325,0,0,0,2,2
65816,150,14747,19344,38325,0,0,0,1,1
65817,150,14748,19660,38325,0,0,0,1,1
65818,150,14749,19301,38325,0,0,0,1,1
65819,150,14751,19423;19809,38325,0,0,0,2,2
65820,150,14753,19786,38325,0,0,0,1,1
65821,150,14754,19514;19848,38325,0,0,0,2,2
65822,150,14755,19579;19772,38325,0,0,0,2,2
65823,150,14756,19482;19722,38325,0,0,0,2,2
65824,150,14757,19637,38325,0,0,0,1,1
65825,150,14759,19796;23201,38325,0,0,1,1,2
65826,150,14760,19681;20021,38325,0,0,0,2,2
65827,150,14761,20297;20430,38325,0,0,0,2,2
65828,150,14762,19329;19733,38325,0,0,0,2,2
65829,150,14763,19766;19958,38325,0,0,0,2,2
65830,150,14764,19812;19959;24426,38325,0,0,1,2,3
65831,150,14765,19978,38325,0,0,0,1,1
65832,150,14766,19857;19875,38325,0,0,0,2,2
65833,150,14767,20181;20842;24884;25739;27352,38325,1,0,3,1,5
65834,150,14768,20375,38325,0,0,0,1,1
65835,150,14769,20128,38325,0,0,0,1,1
65836,150,14770,20235;20250,38325,0,0,0,2,2
65837,150,14771,20392;20600,38325,0,0,0,2,2
65838,150,14772,20064;24431,38325,0,0,1,1,2
65839,150,14773,20042;20071,38325,0,0,0,2,2
65840,150,14774,19600,38325,0,0,0,1,1
65841,150,14775,20099;20351,38325,0,0,0,2,2
65842,150,14776,20110;20823;25436,38325,0,0,2,1,3
65843,150,14777,19665;20112,38325,0,0,0,2,2
65844,150,14778,20160;20517;25738,38325,0,0,1,2,3
65845,150,14779,20168;20884,38325,0,0,1,1,2
65846,150,14780,20184;20541;24996,38325,0,0,1,2,3
65847,150,14781,20206;20353,38325,0,0,0,2,2
65848,150,14782,20237;20554,38325,0,0,0,2,2
65849,150,14784,20278;20456,38325,0,0,0,2,2
65850,150,14785,20306;20671,38325,0,0,1,1,2
65851,150,14787,20314;20537,38325,0,0,0,2,2
65852,150,14788,19926;20570,38325,0,0,0,2,2
65853,150,14790,19908;20332,38325,0,0,0,2,2
65854,150,14791,19994;20398,38325,0,0,0,2,2
65855,150,14792,20040;20164,38325,0,0,0,2,2
65856,150,14793,20906;24069,38325,0,0,2,0,2
65857,150,14794,20388,38325,0,0,0,1,1
65858,150,14795,20403,38325,0,0,0,1,1
65859,150,14796,20291;20409,38325,0,0,0,2,2
65860,150,14797,20452,38325,0,0,0,1,1
65861,150,14798,20459;20460,38325,0,0,0,2,2
65862,150,14799,20225;20505,38325,0,0,0,2,2
65863,150,14800,20515;20924;24361,38325,0,0,2,1,3
65864,150,14801,20381;20571,38325,0,0,0,2,2
65865,150,14802,20780,38325,0,0,1,0,1
65866,150,14803,20596;20678,38325,0,0,1,1,2
65867,150,14810,17009,38690,0,0,0,1,1
65868,150,14822,17835,38690,0,0,0,1,1
65869,150,14830,18687,38690,0,0,0,1,1
65870,150,14831,19603,38690,0,0,0,1,1
65871,150,14832,19076;19584,38690,0,0,0,2,2
65872,150,14839,19346;19454,38690,0,0,0,2,2
65873,150,14840,19774,38690,0,0,0,1,1
65874,150,14842,19414;19907,38690,0,0,0,2,2
65875,150,14843,19284;19792,38690,0,0,0,2,2
65876,150,14846,20097,38690,0,0,0,1,1
65877,150,14847,19732;20069,38690,0,0,0,2,2
65878,150,14850,20247,38690,0,0,0,1,1
65879,150,14851,19776;19866;22702;25786;26429,38690,0,1,2,2,5
65880,150,14852,20229;20396,38690,0,0,0,2,2
65881,150,14854,20481,38690,0,0,0,1,1
65882,150,14855,20198,38690,0,0,0,1,1
65883,150,14856,20185;24766,38690,0,0,1,1,2
65884,150,14858,20009;20227,38690,0,0,0,2,2
65885,150,14859,19740;20044,38690,0,0,0,2,2
65886,150,14861,20051;20129,38690,0,0,0,2,2
65887,150,14862,20058;20635;24546,38690,0,0,2,1,3
65888,150,14863,20158,38690,0,0,0,1,1
65889,150,14864,19967;20231,38690,0,0,0,2,2
65890,150,14865,20232;20948,38690,0,0,1,1,2
65891,150,14866,20286;20367,38690,0,0,0,2,2
65892,150,14867,20370,38690,0,0,0,1,1
65893,150,14868,20400,38690,0,0,0,1,1
65894,150,14869,21015,38690,0,0,1,0,1
65895,150,14871,20832,38690,0,0,1,0,1
65896,150,14872,20372,38690,0,0,0,1,1
65897,150,14873,20736,38690,0,0,1,0,1
65898,150,14874,20423;20457,38690,0,0,0,2,2
65899,150,14875,20354;20382,38690,0,0,0,2,2
65900,150,14876,20161,38690,0,0,0,1,1
65901,150,14877,20732,38690,0,0,1,0,1
65902,150,14878,20323;20490,38690,0,0,0,2,2
65903,150,14879,20499;20704,38690,0,0,1,1,2
65904,150,14880,20739;20804,38690,0,0,2,0,2
65905,150,14881,20791;25439,38690,0,0,2,0,2
65906,150,14882,20261;20682;24454,38690,0,0,2,1,3
65907,150,14883,20521;20579,38690,0,0,0,2,2
65908,150,14884,21008,38690,0,0,1,0,1
65909,150,14885,20555;20589,38690,0,0,0,2,2
65910,150,14886,20080;20634,38690,0,0,1,1,2
65911,150,14887,20642;20929,38690,0,0,2,0,2
65912,150,14888,20628;21025,38690,0,0,1,1,2
65913,150,14889,20688,38690,0,0,1,0,1
65914,150,14890,20717;20742,38690,0,0,2,0,2
65915,150,14891,20397,38690,0,0,0,1,1
65916,150,14892,20336;20740,38690,0,0,1,1,2
65917,150,14918,19458,39055,0,0,0,1,1
65918,150,14927,19170,39055,0,0,0,1,1
65919,150,14929,18761;19324,39055,0,0,0,2,2
65920,150,14932,19526;19894,39055,0,0,0,2,2
65921,150,14933,19545;20233,39055,0,0,0,2,2
65922,150,14935,20450;20485,39055,0,0,0,2,2
65923,150,14936,19618;19686;24214,39055,0,0,1,2,3
65924,150,14937,19669;19986,39055,0,0,0,2,2
65925,150,14938,20259,39055,0,0,0,1,1
65926,150,14939,19687;19811,39055,0,0,0,2,2
65927,150,14940,19468;19961,39055,0,0,0,2,2
65928,150,14941,19728;20209,39055,0,0,0,2,2
65929,150,14945,20022,39055,0,0,0,1,1
65930,150,14946,19916,39055,0,0,0,1,1
65931,150,14947,20219,39055,0,0,0,1,1
65932,150,14948,20697;20790;24881,39055,0,0,3,0,3
65933,150,14949,20038,39055,0,0,0,1,1
65934,150,14950,19842;20039,39055,0,0,0,2,2
65935,150,14951,20062;20279,39055,0,0,0,2,2
65936,150,14952,20142,39055,0,0,0,1,1
65937,150,14953,20368,39055,0,0,0,1,1
65938,150,14954,20019;20520,39055,0,0,0,2,2
65939,150,14955,20606;24998,39055,0,0,1,1,2
65940,150,14956,19544;20224,39055,0,0,0,2,2
65941,150,14957,20066;20274,39055,0,0,0,2,2
65942,150,14958,20026;20513,39055,0,0,0,2,2
65943,150,14959,20590;20841;25648,39055,0,0,2,1,3
65944,150,14960,20911;24785,39055,0,0,2,0,2
65945,150,14961,20893,39055,0,0,1,0,1
65946,150,14962,20167;20338,39055,0,0,0,2,2
65947,150,14963,20322;20360,39055,0,0,0,2,2
65948,150,14964,20814,39055,0,0,1,0,1
65949,150,14965,20348;20416,39055,0,0,0,2,2
65950,150,14966,20189;20453,39055,0,0,0,2,2
65951,150,14968,20464,39055,0,0,0,1,1
65952,150,14969,20288,39055,0,0,0,1,1
65953,150,14970,20494;20710,39055,0,0,1,1,2
65954,150,14971,20029;20538;24043,39055,0,0,1,2,3
65955,150,14972,20284;20540;23951,39055,0,0,1,2,3
65956,150,14973,20829,39055,0,0,1,0,1
65957,150,14974,20557;20836;24066;26982;27144;27318,39055,2,1,2,1,6
65958,150,14975,20566,39055,0,0,0,1,1
65959,150,14976,20524;20575,39055,0,0,0,2,2
65960,150,14978,20615,39055,0,0,0,1,1
65961,150,14979,20562;24046,39055,0,0,1,1,2
65962,150,14980,20985;21155,39055,0,0,2,0,2
65963,150,14981,20668;20821,39055,0,0,2,0,2
65964,150,14982,20687;20937,39055,0,0,2,0,2
65965,150,14983,20760;20765;24779,39055,0,0,3,0,3
65966,150,14984,20720;20846,39055,0,0,2,0,2
65967,150,14985,20645;20725,39055,0,0,2,0,2
65968,150,14988,20783;20980,39055,0,0,2,0,2
65969,150,14989,20792;24882,39055,0,0,2,0,2
65970,150,14990,20519;20810,39055,0,0,1,1,2
65971,150,14991,21095;21122;24675;25108,39055,0,0,4,0,4
65972,150,15006,16978,39420,0,0,0,1,1
65973,150,15020,18663,39420,0,0,0,1,1
65974,150,15032,19470,39420,0,0,0,1,1
65975,150,15035,20073;20130,39420,0,0,0,2,2
65976,150,15037,19901;23008;25889;26066,39420,0,2,1,1,4
65977,150,15038,20387;23936;26882,39420,0,1,1,1,3
65978,150,15039,20299;20670,39420,0,0,1,1,2
65979,150,15040,20407;20465,39420,0,0,0,2,2
65980,150,15042,20144;20643,39420,0,0,1,1,2
65981,150,15044,20602;20609,39420,0,0,0,2,2
65982,150,15045,20149;20347,39420,0,0,0,2,2
65983,150,15046,20271;20620;24876;25318,39420,0,0,2,2,4
65984,150,15047,20395;20874,39420,0,0,1,1,2
65985,150,15048,20301,39420,0,0,0,1,1
65986,150,15050,20828,39420,0,0,1,0,1
65987,150,15051,20496;20859,39420,0,0,1,1,2
65988,150,15053,20779;20851,39420,0,0,2,0,2
65989,150,15054,20002;20467,39420,0,0,0,2,2
65990,150,15055,20471,39420,0,0,0,1,1
65991,150,15056,20474,39420,0,0,0,1,1
65992,150,15057,20435,39420,0,0,0,1,1
65993,150,15058,20234,39420,0,0,0,1,1
65994,150,15059,20683;20785,39420,0,0,2,0,2
65995,150,15060,20173;20584,39420,0,0,0,2,2
65996,150,15061,20592;21166,39420,0,0,1,1,2
65997,150,15062,20131;20604,39420,0,0,0,2,2
65998,150,15063,20805;21028,39420,0,0,2,0,2
65999,150,15065,20610;20663,39420,0,0,1,1,2
66000,150,15066,20806;21036;25544,39420,0,0,3,0,3
66001,150,15067,20313;20684;23648;24776,39420,0,0,3,1,4
66002,150,15068,21102,39420,0,0,1,0,1
66003,150,15069,20215;20709,39420,0,0,1,1,2
66004,150,15070,20611;21184;24277,39420,0,0,2,1,3
66005,150,15071,20622;20794,39420,0,0,1,1,2
66006,150,15072,20504;21037;24483,39420,0,0,2,1,3
66007,150,15073,20759;20934;25740,39420,0,0,3,0,3
66008,150,15074,20608;21175,39420,0,0,1,1,2
66009,150,15075,20757;21241,39420,0,0,2,0,2
66010,150,15076,20797;21048,39420,0,0,2,0,2
66011,150,15077,20124;21017;25103,39420,0,0,2,1,3
66012,150,15078,20863;20891;25437,39420,0,0,3,0,3
66013,150,15079,20885;21170,39420,0,0,2,0,2
66014,150,15080,20938;21030;24894,39420,0,0,3,0,3
66015,150,15081,20912,39420,0,0,1,0,1
66016,150,15082,20915;21059,39420,0,0,2,0,2
66017,150,15083,21158;21297,39420,0,0,2,0,2
66018,150,15084,20535;20922,39420,0,0,1,1,2
66019,150,15085,20865,39420,0,0,1,0,1
66020,150,15094,17307,39785,0,0,0,1,1
66021,150,15097,17819,39785,0,0,0,1,1
66022,150,15101,17529,39785,0,0,0,1,1
66023,150,15104,17803,39785,0,0,0,1,1
66024,150,15118,19257;24211,39785,0,0,1,1,2
66025,150,15120,19137;19549,39785,0,0,0,2,2
66026,150,15124,19573;19719,39785,0,0,0,2,2
66027,150,15127,19969;20170,39785,0,0,0,2,2
66028,150,15131,19985;20135,39785,0,0,0,2,2
66029,150,15133,19919;24319,39785,0,0,1,1,2
66030,150,15134,19910;20294,39785,0,0,0,2,2
66031,150,15136,20282,39785,0,0,0,1,1
66032,150,15137,20037,39785,0,0,0,1,1
66033,150,15138,20072;20239,39785,0,0,0,2,2
66034,150,15141,20262;20559,39785,0,0,0,2,2
66035,150,15142,20265;20617,39785,0,0,0,2,2
66036,150,15143,20267;20941,39785,0,0,1,1,2
66037,150,15144,20272;20953,39785,0,0,1,1,2
66038,150,15145,20276;20764,39785,0,0,1,1,2
66039,150,15146,20251;20434;24132,39785,0,0,1,2,3
66040,150,15147,20150;20285,39785,0,0,0,2,2
66041,150,15149,20378;20556,39785,0,0,0,2,2
66042,150,15150,20498;25196,39785,0,0,1,1,2
66043,150,15151,20549;20656,39785,0,0,1,1,2
66044,150,15152,20532;20560;24235,39785,0,0,1,2,3
66045,150,15153,20903;23753;24358,39785,0,0,3,0,3
66046,150,15154,21298,39785,0,0,1,0,1
66047,150,15155,21038;21111;24375,39785,0,0,3,0,3
66048,150,15156,21415;25031;25551,39785,0,0,3,0,3
66049,150,15157,20734;24343,39785,0,0,2,0,2
66050,150,15158,20702;20946;24999;27359,39785,1,0,3,0,4
66051,150,15159,20269,39785,0,0,0,1,1
66052,150,15160,20788;20798,39785,0,0,2,0,2
66053,150,15161,20784;20826,39785,0,0,2,0,2
66054,150,15162,20850;20913,39785,0,0,2,0,2
66055,150,15164,20880;21253,39785,0,0,2,0,2
66056,150,15165,20887;21227,39785,0,0,2,0,2
66057,150,15166,20889,39785,0,0,1,0,1
66058,150,15167,20890;21394;24086;24810;25218,39785,0,0,5,0,5
66059,150,15168,20908,39785,0,0,1,0,1
66060,150,15169,20871;21150,39785,0,0,2,0,2
66061,150,15170,20940;21414,39785,0,0,2,0,2
66062,150,15171,20624;20942,39785,0,0,1,1,2
66063,150,15172,20964;21380,39785,0,0,2,0,2
66064,150,15173,20690;20965,39785,0,0,2,0,2
66065,150,15174,21259;21409;25116,39785,0,0,3,0,3
66066,150,15175,20431,39785,0,0,0,1,1
66067,150,15176,21313;25024,39785,0,0,2,0,2
66068,150,15195,18691,40150,0,0,0,1,1
66069,150,15204,19418,40150,0,0,0,1,1
66070,150,15205,19296;19508,40150,0,0,0,2,2
66071,150,15209,19586,40150,0,0,0,1,1
66072,150,15211,19447,40150,0,0,0,1,1
66073,150,15212,19864;20213,40150,0,0,0,2,2
66074,150,15213,20034;20613,40150,0,0,0,2,2
66075,150,15214,19625;20079,40150,0,0,0,2,2
66076,150,15215,19829;20084,40150,0,0,0,2,2
66077,150,15216,19956;20451,40150,0,0,0,2,2
66078,150,15217,20178;20692;25197,40150,0,0,2,1,3
66079,150,15218,20329,40150,0,0,0,1,1
66080,150,15219,19738,40150,0,0,0,1,1
66081,150,15220,20298;20598,40150,0,0,0,2,2
66082,150,15223,20432,40150,0,0,0,1,1
66083,150,15224,20444;20930,40150,0,0,1,1,2
66084,150,15225,20094;20445,40150,0,0,0,2,2
66085,150,15226,20455;20967,40150,0,0,1,1,2
66086,150,15228,20438;20838;24783,40150,0,0,2,1,3
66087,150,15230,20552;20572,40150,0,0,0,2,2
66088,150,15231,20280;20581,40150,0,0,0,2,2
66089,150,15232,20341;20626,40150,0,0,0,2,2
66090,150,15233,20070;24993,40150,0,0,1,1,2
66091,150,15234,20411,40150,0,0,0,1,1
66092,150,15235,20662;21068,40150,0,0,2,0,2
66093,150,15237,21039;21145,40150,0,0,2,0,2
66094,150,15238,20727;20898,40150,0,0,2,0,2
66095,150,15240,20577,40150,0,0,0,1,1
66096,150,15241,20770;20888;23752;25438;26778,40150,0,1,4,0,5
66097,150,15244,20553,40150,0,0,0,1,1
66098,150,15245,20844;20856;23866,40150,0,0,3,0,3
66099,150,15246,21138;24578,40150,0,0,2,0,2
66100,150,15247,21060;26008,40150,0,1,1,0,2
66101,150,15248,20165;20528,40150,0,0,0,2,2
66102,150,15249,20773,40150,0,0,1,0,1
66103,150,15251,20972;21174,40150,0,0,2,0,2
66104,150,15252,20974;20979,40150,0,0,2,0,2
66105,150,15253,20289;21004,40150,0,0,1,1,2
66106,150,15254,21153;25545,40150,0,0,2,0,2
66107,150,15255,21033,40150,0,0,1,0,1
66108,150,15256,20516;21034,40150,0,0,1,1,2
66109,150,15257,21011;21044,40150,0,0,2,0,2
66110,150,15258,21069;21250,40150,0,0,2,0,2
66111,150,15259,20959,40150,0,0,1,0,1
66112,150,15260,21072,40150,0,0,1,0,1
66113,150,15261,21090;21293,40150,0,0,2,0,2
66114,150,15262,20849;21262;24909,40150,0,0,3,0,3
66115,150,15263,20993;21137,40150,0,0,2,0,2
66116,150,15265,20976;21173;25111,40150,0,0,3,0,3
66117,150,15266,21401;21493,40150,0,0,2,0,2
66118,150,15282,17828,40515,0,0,0,1,1
66119,150,15287,18203,40515,0,0,0,1,1
66120,150,15289,18431,40515,0,0,0,1,1
66121,150,15290,18442;18995,40515,0,0,0,2,2
66122,150,15293,18251,40515,0,0,0,1,1
66123,150,15297,18522,40515,0,0,0,1,1
66124,150,15302,19913,40515,0,0,0,1,1
66125,150,15308,19851;20311,40515,0,0,0,2,2
66126,150,15309,19841;19921,40515,0,0,0,2,2
66127,150,15310,19709;20025,40515,0,0,0,2,2
66128,150,15312,20305,40515,0,0,0,1,1
66129,150,15313,20139,40515,0,0,0,1,1
66130,150,15316,20266,40515,0,0,0,1,1
66131,150,15317,20408;24873;27094,40515,1,0,1,1,3
66132,150,15318,20254;20359,40515,0,0,0,2,2
66133,150,15320,20045;20614,40515,0,0,0,2,2
66134,150,15323,20917;20991,40515,0,0,2,0,2
66135,150,15324,20204;20362,40515,0,0,0,2,2
66136,150,15326,20681;20843,40515,0,0,2,0,2
66137,150,15327,20877,40515,0,0,1,0,1
66138,150,15328,20426;20563,40515,0,0,0,2,2
66139,150,15329,20781;21080,40515,0,0,2,0,2
66140,150,15330,20786;25319,40515,0,0,2,0,2
66141,150,15331,19972;20701,40515,0,0,1,1,2
66142,150,15332,20593;21162,40515,0,0,1,1,2
66143,150,15333,21278,40515,0,0,1,0,1
66144,150,15335,20458;20824,40515,0,0,1,1,2
66145,150,15336,20638;21356,40515,0,0,2,0,2
66146,150,15337,20716;24452;26802;27076;27339,40515,2,1,2,0,5
66147,150,15338,20675;21049,40515,0,0,2,0,2
66148,150,15339,20569;20677,40515,0,0,1,1,2
66149,150,15340,21217;21392,40515,0,0,2,0,2
66150,150,15342,20439;20758,40515,0,0,1,1,2
66151,150,15343,20818;21047;24376,40515,0,0,3,0,3
66152,150,15344,21035;21214;24686,40515,0,0,3,0,3
66153,150,15346,20852,40515,0,0,1,0,1
66154,150,15347,20866;24663;25004,40515,0,0,3,0,3
66155,150,15348,20896,40515,0,0,1,0,1
66156,150,15349,20343;20936;25006;26811,40515,0,1,2,1,4
66157,150,15350,20914;25005,40515,0,0,2,0,2
66158,150,15351,20895;21304,40515,0,0,2,0,2
66159,150,15352,21525;24925;25346;25553,40515,0,0,4,0,4
66160,150,15353,20939;21156,40515,0,0,2,0,2
66161,150,15354,20820,40515,0,0,1,0,1
66162,150,15355,21219;21441,40515,0,0,2,0,2
66163,150,15356,21052,40515,0,0,1,0,1
66164,150,15357,20919;20977,40515,0,0,2,0,2
66165,150,15358,21364;21424;25654,40515,0,0,3,0,3
66166,150,15359,20983;21290;25335,40515,0,0,3,0,3
66167,150,15360,21474;25552;27463,40515,1,0,2,0,3
66168,150,15361,20955;21159,40515,0,0,2,0,2
66169,150,15362,21295,40515,0,0,1,0,1
66170,150,15363,20995;21086,40515,0,0,2,0,2
66171,150,15364,20547;21023;25104,40515,0,0,2,1,3
66172,150,15365,20586;21208,40515,0,0,1,1,2
66173,150,15366,20655;21180,40515,0,0,2,0,2
66174,150,15367,20827;21186,40515,0,0,2,0,2
66175,150,15368,20904;21189,40515,0,0,2,0,2
66176,150,15369,21203,40515,0,0,1,0,1
66177,150,15370,21209;21252;24584,40515,0,0,3,0,3
66178,150,15371,20691;21254,40515,0,0,2,0,2
66179,150,15372,20918;21449;24288;24596;25222,40515,0,0,5,0,5
66180,150,15373,20855;21280,40515,0,0,2,0,2
66181,150,15374,21289;21387,40515,0,0,2,0,2
66182,150,15376,20648;21220;24904,40515,0,0,3,0,3
66183,150,15377,21307;21347;25741,40515,0,0,3,0,3
66184,150,15389,17596,40880,0,0,0,1,1
66185,150,15390,17558,40880,0,0,0,1,1
66186,150,15402,22945;23107,40880,0,0,2,0,2
66187,150,15406,19569;23688;25820;26682,40880,0,1,2,1,4
66188,150,15409,19008,40880,0,0,0,1,1
66189,150,15412,19363;19954,40880,0,0,0,2,2
66190,150,15415,19193;19769,40880,0,0,0,2,2
66191,150,15417,19241;19706,40880,0,0,0,2,2
66192,150,15418,19834;20162,40880,0,0,0,2,2
66193,150,15423,20157;20405,40880,0,0,0,2,2
66194,150,15425,20837;20971;23451,40880,0,0,3,0,3
66195,150,15426,20183;20631,40880,0,0,0,2,2
66196,150,15427,20811;24459,40880,0,0,2,0,2
66197,150,15428,20753;21001,40880,0,0,2,0,2
66198,150,15430,20522;20578,40880,0,0,0,2,2
66199,150,15431,20867,40880,0,0,1,0,1
66200,150,15432,20576;20666,40880,0,0,1,1,2
66201,150,15434,21515;22085;24820;25656,40880,0,0,4,0,4
66202,150,15435,20594;20835,40880,0,0,1,1,2
66203,150,15436,21114,40880,0,0,1,0,1
66204,150,15437,21537;23772;25138,40880,0,0,3,0,3
66205,150,15438,20883;21257;25441,40880,0,0,3,0,3
66206,150,15439,20733;20900;25323,40880,0,0,3,0,3
66207,150,15440,20960,40880,0,0,1,0,1
66208,150,15441,20831;21471,40880,0,0,2,0,2
66209,150,15442,21021;21081,40880,0,0,2,0,2
66210,150,15443,20975;21372;25444;25549,40880,0,0,4,0,4
66211,150,15444,21123,40880,0,0,1,0,1
66212,150,15445,21077;24673,40880,0,0,2,0,2
66213,150,15446,21201;24801;26715,40880,0,1,2,0,3
66214,150,15447,21105;21340,40880,0,0,2,0,2
66215,150,15448,21120;21633,40880,0,0,2,0,2
66216,150,15449,20998;21140;25331,40880,0,0,3,0,3
66217,150,15450,20772;21453;25135,40880,0,0,3,0,3
66218,150,15452,20755;21188;25017,40880,0,0,3,0,3
66219,150,15453,21187;21193;24901,40880,0,0,3,0,3
66220,150,15454,21202;21554,40880,0,0,2,0,2
66221,150,15455,21207;21286;25213,40880,0,0,3,0,3
66222,150,15456,21126;21258;25206,40880,0,0,3,0,3
66223,150,15458,21163;21488,40880,0,0,2,0,2
66224,150,15459,20751;21288,40880,0,0,2,0,2
66225,150,15460,21306;21642;25660,40880,0,0,3,0,3
66226,150,15461,21818;21878,40880,0,0,2,0,2
66227,150,15462,21734,40880,0,0,1,0,1
66228,150,15463,21277;21403;25550,40880,0,0,3,0,3
66229,150,15464,21411;25343,40880,0,0,2,0,2
66230,150,15470,17562,41245,0,0,0,1,1
66231,150,15483,18298,41245,0,0,0,1,1
66232,150,15485,18430,41245,0,0,0,1,1
66233,150,15493,19079,41245,0,0,0,1,1
66234,150,15497,19551;23182;25724;26547,41245,0,1,2,1,4
66235,150,15504,19700,41245,0,0,0,1,1
66236,150,15505,20218;20534,41245,0,0,0,2,2
66237,150,15506,19951;20629;24450,41245,0,0,1,2,3
66238,150,15507,20016,41245,0,0,0,1,1
66239,150,15513,20281;20449,41245,0,0,0,2,2
66240,150,15515,20273;20601,41245,0,0,0,2,2
66241,150,15516,20221,41245,0,0,0,1,1
66242,150,15518,20502;20561,41245,0,0,0,2,2
66243,150,15521,20632,41245,0,0,1,0,1
66244,150,15522,20679;23555;27121,41245,1,0,2,0,3
66245,150,15524,20705,41245,0,0,1,0,1
66246,150,15526,21196,41245,0,0,1,0,1
66247,150,15527,20558;20796,41245,0,0,1,1,2
66248,150,15528,20667;20834,41245,0,0,2,0,2
66249,150,15530,20868;20920,41245,0,0,2,0,2
66250,150,15531,21079;21509;25137;25919,41245,0,1,3,0,4
66251,150,15532,20673;20925,41245,0,0,2,0,2
66252,150,15533,20858;21093;25011,41245,0,0,3,0,3
66253,150,15534,20943;21115,41245,0,0,2,0,2
66254,150,15535,20982;25201,41245,0,0,2,0,2
66255,150,15536,20990;21499;25742,41245,0,0,3,0,3
66256,150,15537,21002;21109,41245,0,0,2,0,2
66257,150,15538,21045;21087,41245,0,0,2,0,2
66258,150,15539,21051,41245,0,0,1,0,1
66259,150,15541,21089;21133;24674,41245,0,0,3,0,3
66260,150,15543,20686;20721,41245,0,0,2,0,2
66261,150,15544,21760;22006;25562,41245,0,0,3,0,3
66262,150,15545,21352;21393;24917;25129;27367,41245,1,0,4,0,5
66263,150,15546,21119;21176,41245,0,0,2,0,2
66264,150,15547,21020;21121,41245,0,0,2,0,2
66265,150,15548,21073;21141;25332;25825,41245,0,1,3,0,4
66266,150,15549,21104;21565,41245,0,0,2,0,2
66267,150,15550,21213;21231,41245,0,0,2,0,2
66268,150,15551,21168;21235,41245,0,0,2,0,2
66269,150,15552,21248;21273,41245,0,0,2,0,2
66270,150,15554,21351;21865;25154,41245,0,0,3,0,3
66271,150,15555,21903,41245,0,0,1,0,1
66272,150,15556,21242;21594,41245,0,0,2,0,2
66273,150,15557,21366;21523,41245,0,0,2,0,2
66274,150,15558,21369;21701;25561;25662,41245,0,0,4,0,4
66275,150,15559,21370;21577;25037,41245,0,0,3,0,3
66276,150,15560,21130;21439,41245,0,0,2,0,2
66277,150,15561,21551;21794;26210,41245,0,1,2,0,3
66278,150,15562,21455;21545;25033,41245,0,0,3,0,3
66279,150,15563,21421;21543,41245,0,0,2,0,2
66280,150,15564,25055,41245,0,0,1,0,1
66281,150,15565,21801;24517;24944;25837;26911,41245,0,2,3,0,5
66282,150,15566,21379;21508,41245,0,0,2,0,2
66283,150,15567,21302;21513,41245,0,0,2,0,2
66284,150,15568,21714;24936,41245,0,0,2,0,2
66285,150,15569,21517;21833;25927,41245,0,1,2,0,3
66286,150,15570,17132,41610,0,0,0,1,1
66287,150,15573,17111,41610,0,0,0,1,1
66288,150,15578,17880,41610,0,0,0,1,1
66289,150,15587,18394;18880,41610,0,0,0,2,2
66290,150,15598,18859,41610,0,0,0,1,1
66291,150,15600,19481;19859,41610,0,0,0,2,2
66292,150,15605,20277;20526,41610,0,0,0,2,2
66293,150,15606,19362,41610,0,0,0,1,1
66294,150,15608,20087,41610,0,0,0,1,1
66295,150,15609,20049;20147;24430,41610,0,0,1,2,3
66296,150,15611,20243;20659,41610,0,0,1,1,2
66297,150,15615,20358,41610,0,0,0,1,1
66298,150,15616,20637,41610,0,0,1,0,1
66299,150,15617,20737,41610,0,0,1,0,1
66300,150,15618,20082;20419,41610,0,0,0,2,2
66301,150,15619,19936;20180,41610,0,0,0,2,2
66302,150,15621,20386;20588,41610,0,0,0,2,2
66303,150,15622,20695,41610,0,0,1,0,1
66304,150,15623,20730;21107,41610,0,0,2,0,2
66305,150,15624,20203;20731,41610,0,0,1,1,2
66306,150,15625,20787;20921,41610,0,0,2,0,2
66307,150,15626,20984;21268,41610,0,0,2,0,2
66308,150,15627,20875;21320,41610,0,0,2,0,2
66309,150,15628,21447,41610,0,0,1,0,1
66310,150,15630,20902,41610,0,0,1,0,1
66311,150,15631,20958;25007;27269,41610,1,0,2,0,3
66312,150,15632,20674;20978,41610,0,0,2,0,2
66313,150,15634,21012;24792;24893;27346,41610,1,0,3,0,4
66314,150,15635,20923;21019;25824,41610,0,1,2,0,3
66315,150,15636,21043;21478,41610,0,0,2,0,2
66316,150,15637,21046,41610,0,0,1,0,1
66317,150,15639,21065;25105,41610,0,0,2,0,2
66318,150,15640,21405,41610,0,0,1,0,1
66319,150,15641,20748;21097,41610,0,0,2,0,2
66320,150,15642,21066;21404,41610,0,0,2,0,2
66321,150,15643,21608;21750,41610,0,0,2,0,2
66322,150,15644,21371,41610,0,0,1,0,1
66323,150,15645,21157;25014;25110,41610,0,0,3,0,3
66324,150,15646,21579;21706;25663,41610,0,0,3,0,3
66325,150,15648,24681,41610,0,0,1,0,1
66326,150,15649,20968;21192,41610,0,0,2,0,2
66327,150,15650,20961;21423;25829,41610,0,1,2,0,3
66328,150,15652,21299;21337;25023;25652,41610,0,0,4,0,4
66329,150,15653,21413;21420,41610,0,0,2,0,2
66330,150,15654,20815;21482;24394;26800;27251,41610,1,1,3,0,5
66331,150,15655,20882;21342,41610,0,0,2,0,2
66332,150,15656,21485,41610,0,0,1,0,1
66333,150,15657,21376;21388;25828,41610,0,1,2,0,3
66334,150,15658,21397,41610,0,0,1,0,1
66335,150,15660,21434;22036,41610,0,0,2,0,2
66336,150,15661,21479,41610,0,0,1,0,1
66337,150,15662,21249;21483;24290;25830,41610,0,1,3,0,4
66338,150,15664,21327,41610,0,0,1,0,1
66339,150,15665,21674;22108;25456;27460,41610,1,0,3,0,4
66340,150,15666,21772;25564,41610,0,0,2,0,2
66341,150,15667,21648;21973;25476;25673;25754,41610,0,0,5,0,5
66342,150,15668,21232;21504,41610,0,0,2,0,2
66343,150,15669,21456;21467;25345,41610,0,0,3,0,3
66344,150,15670,21261;21660;25744,41610,0,0,3,0,3
66345,150,15681,18269,41975,0,0,0,1,1
66346,150,15683,18429,41975,0,0,0,1,1
66347,150,15686,18706,41975,0,0,0,1,1
66348,150,15697,19883,41975,0,0,0,1,1
66349,150,15700,19925,41975,0,0,0,1,1
66350,150,15708,21132;25650,41975,0,0,2,0,2
66351,150,15709,23853;23968;24453;27225;27309,41975,2,0,3,0,5
66352,150,15710,19876;20095,41975,0,0,0,2,2
66353,150,15711,20308;20706;23557;26960,41975,0,1,2,1,4
66354,150,15712,20743,41975,0,0,1,0,1
66355,150,15714,20767;21206;24660,41975,0,0,3,0,3
66356,150,15715,19930;20699,41975,0,0,1,1,2
66357,150,15717,20735;21218;25651,41975,0,0,3,0,3
66358,150,15718,20762,41975,0,0,1,0,1
66359,150,15719,20482;20769,41975,0,0,1,1,2
66360,150,15720,20771,41975,0,0,1,0,1
66361,150,15721,20907;20962;24260,41975,0,0,3,0,3
66362,150,15722,20901,41975,0,0,1,0,1
66363,150,15723,20636;20833,41975,0,0,2,0,2
66364,150,15724,20928;21129,41975,0,0,2,0,2
66365,150,15725,20633;21179,41975,0,0,2,0,2
66366,150,15726,20364;21006,41975,0,0,1,1,2
66367,150,15727,21566;21606,41975,0,0,2,0,2
66368,150,15729,20417;21165;26009,41975,0,1,1,1,3
66369,150,15730,21062;21223;25333,41975,0,0,3,0,3
66370,150,15732,21260;24908;25334,41975,0,0,3,0,3
66371,150,15733,21116;21443,41975,0,0,2,0,2
66372,150,15735,20466;21181;24899,41975,0,0,2,1,3
66373,150,15739,21117;21233,41975,0,0,2,0,2
66374,150,15740,21590,41975,0,0,1,0,1
66375,150,15741,20660;21239;24280;26796;26900;27330,41975,1,2,3,0,6
66376,150,15742,21269;21308,41975,0,0,2,0,2
66377,150,15743,21267;21284;25119,41975,0,0,3,0,3
66378,150,15744,21139;21303,41975,0,0,2,0,2
66379,150,15745,21169;21450,41975,0,0,2,0,2
66380,150,15746,21375;21614,41975,0,0,2,0,2
66381,150,15747,21381;25340,41975,0,0,2,0,2
66382,150,15748,21560;21757;25244,41975,0,0,3,0,3
66383,150,15749,21464;21953;25570,41975,0,0,3,0,3
66384,150,15750,20952,41975,0,0,1,0,1
66385,150,15751,21539;21738;24927,41975,0,0,3,0,3
66386,150,15752,22089,41975,0,0,1,0,1
66387,150,15753,21576,41975,0,0,1,0,1
66388,150,15754,21559;22106,41975,0,0,2,0,2
66389,150,15755,21692;21970,41975,0,0,2,0,2
66390,150,15758,21829;22082;25366,41975,0,0,3,0,3
66391,150,15759,21600;21800;25039,41975,0,0,3,0,3
66392,150,15760,21707;22081,41975,0,0,2,0,2
66393,150,15763,21613;21640;25922,41975,0,1,2,0,3
66394,150,15764,21323;21895;24411,41975,0,0,3,0,3
66395,150,15765,21444;21845;25054,41975,0,0,3,0,3
66396,150,15767,21808,41975,0,0,1,0,1
66397,150,15768,21795,41975,0,0,1,0,1
66398,150,15769,21777;25248,41975,0,0,2,0,2
66399,150,15770,21425;22021;25675;25756,41975,0,0,4,0,4
66400,150,15771,21712;21723,41975,0,0,2,0,2
66401,150,15772,21758;21870;24952,41975,0,0,3,0,3
66402,150,15780,18042;18235,42340,0,0,0,2,2
66403,150,15782,18287,42340,0,0,0,1,1
66404,150,15784,18876,42340,0,0,0,1,1
66405,150,15786,19001,42340,0,0,0,1,1
66406,150,15790,19198,42340,0,0,0,1,1
66407,150,15799,20137,42340,0,0,0,1,1
66408,150,15800,19698;19699,42340,0,0,0,2,2
66409,150,15802,20012;20043,42340,0,0,0,2,2
66410,150,15804,19820;20088,42340,0,0,0,2,2
66411,150,15805,20511,42340,0,0,0,1,1
66412,150,15808,20214;20508,42340,0,0,0,2,2
66413,150,15809,21178;24679;25015,42340,0,0,3,0,3
66414,150,15810,20371;20536;24234,42340,0,0,1,2,3
66415,150,15811,20641;24547;26709,42340,0,1,2,0,3
66416,150,15812,20876,42340,0,0,1,0,1
66417,150,15813,20749;20774,42340,0,0,2,0,2
66418,150,15815,20813;21527,42340,0,0,2,0,2
66419,150,15816,20672;20853,42340,0,0,2,0,2
66420,150,15817,20707;20869,42340,0,0,2,0,2
66421,150,15818,20873;20969;25199,42340,0,0,3,0,3
66422,150,15819,20283;20951,42340,0,0,1,1,2
66423,150,15820,20551;24667,42340,0,0,1,1,2
66424,150,15821,20527;21010,42340,0,0,1,1,2
66425,150,15822,21009;21237;25009,42340,0,0,3,0,3
66426,150,15823,21623;25355;25834,42340,0,1,2,0,3
66427,150,15824,20693;21164;25826,42340,0,1,2,0,3
66428,150,15825,21125;21496,42340,0,0,2,0,2
66429,150,15826,21705,42340,0,0,1,0,1
66430,150,15827,21110;21197,42340,0,0,2,0,2
66431,150,15828,21148,42340,0,0,1,0,1
66432,150,15830,21212;21736,42340,0,0,2,0,2
66433,150,15831,21899;21910,42340,0,0,2,0,2
66434,150,15832,21225;24494;24687;24905;25546;26605;26996,42340,0,2,5,0,7
66435,150,15834,20653;21246;24583,42340,0,0,3,0,3
66436,150,15835,21264;21830;25465,42340,0,0,3,0,3
66437,150,15836,21229;21334;24499;25337,42340,0,0,4,0,4
66438,150,15837,20973;21346;23882;26591;26880;27046,42340,1,2,3,0,6
66439,150,15839,21472;21635,42340,0,0,2,0,2
66440,150,15840,21063;21427;24701;25132,42340,0,0,4,0,4
66441,150,15841,21336;21522,42340,0,0,2,0,2
66442,150,15842,21292;21529;25032;25554;27270;27450,42340,2,0,4,0,6
66443,150,15843,21552;21575,42340,0,0,2,0,2
66444,150,15844,21561;25450;27181,42340,1,0,2,0,3
66445,150,15845,21222;21591;24508,42340,0,0,3,0,3
66446,150,15846,21595;25833,42340,0,1,1,0,2
66447,150,15847,21680;25558,42340,0,0,2,0,2
66448,150,15848,21502;21872;25252,42340,0,0,3,0,3
66449,150,15849,21721;22059;26308,42340,0,1,2,0,3
66450,150,15850,21448;21694,42340,0,0,2,0,2
66451,150,15851,21100;21722;25362;25835;27278,42340,1,1,3,0,5
66452,150,15852,21725,42340,0,0,1,0,1
66453,150,15853,21729;22181,42340,0,0,2,0,2
66454,150,15854,21759;22260;26030,42340,0,1,2,0,3
66455,150,15855,21769,42340,0,0,1,0,1
66456,150,15856,21099;21532,42340,0,0,2,0,2
66457,150,15857,21461;21852;25929,42340,0,1,2,0,3
66458,150,15859,21636;21804;25463,42340,0,0,3,0,3
66459,150,15860,21817;22121;25577;25679,42340,0,0,4,0,4
66460,150,15861,21820;25464,42340,0,0,2,0,2
66461,150,15862,21802;21861,42340,0,0,2,0,2
66462,150,15863,21386;21866;24522;25472,42340,0,0,4,0,4
66463,150,15864,21994;22066;26108,42340,0,1,2,0,3
66464,150,15875,18511,42705,0,0,0,1,1
66465,150,15877,18568,42705,0,0,0,1,1
66466,150,15884,19210,42705,0,0,0,1,1
66467,150,15888,19631,42705,0,0,0,1,1
66468,150,15892,19765,42705,0,0,0,1,1
66469,150,15900,19942,42705,0,0,0,1,1
66470,150,15901,20644,42705,0,0,1,0,1
66471,150,15903,20446;20839,42705,0,0,1,1,2
66472,150,15906,20390;20477;23333,42705,0,0,1,2,3
66473,150,15908,20514,42705,0,0,0,1,1
66474,150,15909,20543;20597,42705,0,0,0,2,2
66475,150,15910,21285,42705,0,0,1,0,1
66476,150,15911,20741,42705,0,0,1,0,1
66477,150,15912,20957;21255;24689,42705,0,0,3,0,3
66478,150,15913,20807,42705,0,0,1,0,1
66479,150,15914,20857,42705,0,0,1,0,1
66480,150,15915,21154;21194,42705,0,0,2,0,2
66481,150,15916,21265;25211,42705,0,0,2,0,2
66482,150,15917,21305;21885;25253;25473,42705,0,0,4,0,4
66483,150,15918,20926;21309,42705,0,0,2,0,2
66484,150,15919,21353;21416;25653,42705,0,0,3,0,3
66485,150,15920,21377,42705,0,0,1,0,1
66486,150,15922,21216;21410;25219;25342,42705,0,0,4,0,4
66487,150,15924,21417;21688,42705,0,0,2,0,2
66488,150,15926,21422;21874;25369;26105,42705,0,1,3,0,4
66489,150,15927,21728;22175;25938;26311,42705,0,2,2,0,4
66490,150,15929,21571;25351,42705,0,0,2,0,2
66491,150,15931,21452;22157;26025,42705,0,1,2,0,3
66492,150,15932,21619,42705,0,0,1,0,1
66493,150,15933,21690;21740,42705,0,0,2,0,2
66494,150,15935,21484;21751;25143;26102,42705,0,1,3,0,4
66495,150,15936,22168;22356;25860,42705,0,1,2,0,3
66496,150,15937,21531;21675,42705,0,0,2,0,2
66497,150,15938,21766;22013,42705,0,0,2,0,2
66498,150,15939,21567;25036;25832,42705,0,1,2,0,3
66499,150,15940,21784;21917;25363;25836,42705,0,1,3,0,4
66500,150,15941,21492;21597;25233,42705,0,0,3,0,3
66501,150,15942,21612;22188;26114,42705,0,1,2,0,3
66502,150,15943,21384;21625;24931,42705,0,0,3,0,3
66503,150,15944,21957;25064;25373;27174,42705,1,0,3,0,4
66504,150,15945,21466;21654,42705,0,0,2,0,2
66505,150,15947,22312;22327;25587,42705,0,0,3,0,3
66506,150,15948,21911;24955,42705,0,0,2,0,2
66507,150,15949,21742;21849;23775,42705,0,0,3,0,3
66508,150,15950,22237;22265;26028,42705,0,1,2,0,3
66509,150,15951,21646;21921;25371;25474;27461,42705,1,0,4,0,5
66510,150,15952,21240;21807;25052;25838,42705,0,1,3,0,4
66511,150,15953,21810;22095,42705,0,0,2,0,2
66512,150,15954,21812;21847,42705,0,0,2,0,2
66513,150,15955,22031;22196;25269;25583;26313,42705,0,1,4,0,5
66514,150,15956,21956;22104;25263,42705,0,0,3,0,3
66515,150,15957,22271;22286,42705,0,0,2,0,2
66516,150,15958,22009;22025;24964;25479,42705,0,0,4,0,4
66517,150,15959,21602;22149,42705,0,0,2,0,2
66518,150,15960,21524;21843;26014,42705,0,1,2,0,3
66519,150,15961,21881;21892,42705,0,0,2,0,2
66520,150,15962,21888;22302,42705,0,0,2,0,2
66521,150,15963,21894;25666;25840,42705,0,1,2,0,3
66522,150,15964,21704;21906;25370;25667;26307,42705,0,1,4,0,5
66523,150,15965,21946;22147,42705,0,0,2,0,2
66524,150,15966,21578;21977;25755,42705,0,0,3,0,3
66525,150,15967,21331;22023;25161;25574;27373,42705,1,0,4,0,5
66526,150,15971,17471,43070,0,0,0,1,1
66527,150,15974,18321,43070,0,0,0,1,1
66528,150,15982,18643,43070,0,0,0,1,1
66529,150,15987,18996;19594,43070,0,0,0,2,2
66530,150,15989,19524,43070,0,0,0,1,1
66531,150,15996,20729,43070,0,0,1,0,1
66532,150,16000,20700;23650,43070,0,0,2,0,2
66533,150,16001,20171;20428,43070,0,0,0,2,2
66534,150,16003,20373,43070,0,0,0,1,1
66535,150,16004,20510;20747;24659,43070,0,0,2,1,3
66536,150,16006,19909;20366;24769,43070,0,0,1,2,3
66537,150,16008,20425;20768,43070,0,0,1,1,2
66538,150,16009,20125;20587,43070,0,0,0,2,2
66539,150,16011,20512;20676,43070,0,0,1,1,2
66540,150,16017,20817;21390,43070,0,0,2,0,2
66541,150,16018,20529;20910;25100,43070,0,0,2,1,3
66542,150,16020,20933;21501,43070,0,0,2,0,2
66543,150,16021,20987;21518;24821;25227,43070,0,0,4,0,4
66544,150,16022,21075;21350,43070,0,0,2,0,2
66545,150,16027,21836;23893,43070,0,0,2,0,2
66546,150,16028,21234;21716,43070,0,0,2,0,2
66547,150,16029,21215;21282,43070,0,0,2,0,2
66548,150,16030,21512;26101,43070,0,1,1,0,2
66549,150,16031,21083;21321;24913;25442,43070,0,0,4,0,4
66550,150,16032,21134;21329,43070,0,0,2,0,2
66551,150,16033,21607;24930;25352;27180,43070,1,0,3,0,4
66552,150,16034,21245;24495;26501,43070,0,1,2,0,3
66553,150,16035,21127;21402;24812,43070,0,0,3,0,3
66554,150,16036,21426;21839,43070,0,0,2,0,2
66555,150,16037,20719;21437;25133;26010,43070,0,1,3,0,4
66556,150,16038,21311;21510;25447,43070,0,0,3,0,3
66557,150,16039,21629;25235,43070,0,0,2,0,2
66558,150,16040,21659;21988,43070,0,0,2,0,2
66559,150,16041,21664;24934;25357,43070,0,0,3,0,3
66560,150,16042,21768;25461,43070,0,0,2,0,2
66561,150,16043,21563;21702,43070,0,0,2,0,2
66562,150,16044,21703;25241;27456,43070,1,0,2,0,3
66563,150,16045,22236;25392;26027,43070,0,1,2,0,3
66564,150,16047,21720;22003;25065,43070,0,0,3,0,3
66565,150,16048,21431;21530;25657,43070,0,0,3,0,3
66566,150,16049,21621;21771;25664,43070,0,0,3,0,3
66567,150,16050,21775;22391;25596;25770;25947,43070,0,1,4,0,5
66568,150,16051,21798;22354;25592;25687,43070,0,0,4,0,4
66569,150,16052,21809;22301;25749,43070,0,0,3,0,3
66570,150,16053,21569;21841;26013,43070,0,1,2,0,3
66571,150,16054,21923,43070,0,0,1,0,1
66572,150,16055,21790;22241;25682,43070,0,0,3,0,3
66573,150,16056,21883;21968;25158,43070,0,0,3,0,3
66574,150,16057,22073;22080,43070,0,0,2,0,2
66575,150,16059,21942;22034,43070,0,0,2,0,2
66576,150,16060,21948;22178;25388;25580;25849;26214,43070,0,2,4,0,6
66577,150,16062,22010;22249;25160;25378;26213,43070,0,1,4,0,5
66578,150,16063,22022;22287;25274;25763;26032,43070,0,1,4,0,5
66579,150,16064,22043;22045;25259;26020,43070,0,1,3,0,4
66580,150,16065,21896;22054;24966,43070,0,0,3,0,3
66581,150,16066,21916;22584;25698,43070,0,0,3,0,3
66582,150,16067,22109;22155,43070,0,0,2,0,2
66583,150,16068,21312;22094,43070,0,0,2,0,2
66584,150,16069,22092;22111;24746,43070,0,0,3,0,3
66585,150,16070,22113;22133;25937,43070,0,1,2,0,3
66586,150,16071,21930;22240,43070,0,0,2,0,2
66587,150,16072,22140;22146;24632;25266;25578;27260;27274,43070,2,0,5,0,7
66588,150,16073,22032;22148;25760,43070,0,0,3,0,3
66589,150,16077,17764,43435,0,0,0,1,1
66590,150,16084,18601,43435,0,0,0,1,1
66591,150,16085,18459,43435,0,0,0,1,1
66592,150,16094,19102,43435,0,0,0,1,1
66593,150,16098,19486,43435,0,0,0,1,1
66594,150,16105,20812,43435,0,0,1,0,1
66595,150,16107,21056,43435,0,0,1,0,1
66596,150,16110,20847;21091;25107,43435,0,0,3,0,3
66597,150,16113,21339;24807;25216,43435,0,0,3,0,3
66598,150,16115,20970;21067;24487,43435,0,0,3,0,3
66599,150,16118,20949;21131,43435,0,0,2,0,2
66600,150,16119,21147;21407;25030,43435,0,0,3,0,3
66601,150,16120,20986;23757;26970,43435,0,1,2,0,3
66602,150,16121,21128;21211,43435,0,0,2,0,2
66603,150,16122,21143;21300,43435,0,0,2,0,2
66604,150,16123,21283;21709;24405;25458,43435,0,0,4,0,4
66605,150,16124,21230;21322,43435,0,0,2,0,2
66606,150,16125,21644;21987,43435,0,0,2,0,2
66607,150,16126,21171;21361;24500,43435,0,0,3,0,3
66608,150,16127,20892;21459;25223,43435,0,0,3,0,3
66609,150,16128,21378;21695,43435,0,0,2,0,2
66610,150,16129,21481;25136;25918;26011,43435,0,2,2,0,4
66611,150,16130,21570;21980;25572;26018,43435,0,1,3,0,4
66612,150,16131,21547,43435,0,0,1,0,1
66613,150,16133,21589;21668,43435,0,0,2,0,2
66614,150,16134,21609;21975;25477,43435,0,0,3,0,3
66615,150,16135,21626;21902,43435,0,0,2,0,2
66616,150,16136,21853;21897,43435,0,0,2,0,2
66617,150,16137,21663,43435,0,0,1,0,1
66618,150,16138,21684;21939;25238,43435,0,0,3,0,3
66619,150,16139,21433;22061;25933,43435,0,1,2,0,3
66620,150,16140,21733;22492;25181;26220,43435,0,1,3,0,4
66621,150,16141,21271;21748;24939,43435,0,0,3,0,3
66622,150,16142,21710;21958,43435,0,0,2,0,2
66623,150,16143,21314;21780;24615;26103,43435,0,1,3,0,4
66624,150,16144,22214;25851,43435,0,1,1,0,2
66625,150,16145,21604;21931;24958;25668,43435,0,0,4,0,4
66626,150,16146,21540;21863;25251;26104,43435,0,1,3,0,4
66627,150,16147,22378;25595;26508,43435,0,1,2,0,3
66628,150,16148,21318;21827;25565;25665,43435,0,0,4,0,4
66629,150,16150,21088;21912;25255,43435,0,0,3,0,3
66630,150,16151,21922;22261;25271,43435,0,0,3,0,3
66631,150,16152,21774;21933;25930;26212,43435,0,2,2,0,4
66632,150,16153,21429;21934,43435,0,0,2,0,2
66633,150,16154,22091,43435,0,0,1,0,1
66634,150,16155,22120;22306;25077;25277;25766;27363,43435,1,0,5,0,6
66635,150,16156,21708;22098;25484,43435,0,0,3,0,3
66636,150,16157,22017;22410;25501;25862,43435,0,1,3,0,4
66637,150,16158,21797;22056;25677;25932,43435,0,1,3,0,4
66638,150,16159,22064;22125;24852;25068;25262;26111,43435,0,1,5,0,6
66639,150,16160,22074;22438,43435,0,0,2,0,2
66640,150,16161,22067;22305;25496,43435,0,0,3,0,3
66641,150,16162,22076;22299;25685,43435,0,0,3,0,3
66642,150,16163,22078;22502;24862;25182;25869;26126;27176,43435,1,2,4,0,7
66643,150,16165,22019;22359,43435,0,0,2,0,2
66644,150,16166,22276;24972;25684,43435,0,0,3,0,3
66645,150,16167,22293;25495;25943,43435,0,1,2,0,3
66646,150,16168,22145;22162,43435,0,0,2,0,2
66647,150,16169,22330;22478;25396,43435,0,0,3,0,3
66648,150,16170,22177;22423;26037,43435,0,1,2,0,3
66649,150,16171,22180;22316;25581;26113,43435,0,1,3,0,4
66650,150,16173,22218;22321,43435,0,0,2,0,2
66651,150,16174,21432;22267;26031,43435,0,1,2,0,3
66652,150,16175,22274;22385;26419,43435,0,1,2,0,3
66653,150,16179,17989,43800,0,0,0,1,1
66654,150,16180,17994,43800,0,0,0,1,1
66655,150,16183,18384,43800,0,0,0,1,1
66656,150,16188,18138,43800,0,0,0,1,1
66657,150,16189,18705,43800,0,0,0,1,1
66658,150,16190,18749;18881,43800,0,0,0,2,2
66659,150,16192,19128,43800,0,0,0,1,1
66660,150,16197,19183,43800,0,0,0,1,1
66661,150,16202,19406,43800,0,0,0,1,1
66662,150,16209,19815;20115,43800,0,0,0,2,2
66663,150,16210,20331;20339,43800,0,0,0,2,2
66664,150,16211,20722,43800,0,0,1,0,1
66665,150,16213,20433;20476,43800,0,0,0,2,2
66666,150,16214,20290;20479;24649;26474,43800,0,1,1,2,4
66667,150,16219,20661;24340,43800,0,0,2,0,2
66668,150,16221,21210;25440,43800,0,0,2,0,2
66669,150,16223,20436;20518,43800,0,0,0,2,2
66670,150,16225,20564;20754;25542,43800,0,0,2,1,3
66671,150,16226,20864;21199;25019;27097,43800,1,0,3,0,4
66672,150,16228,20320;20630;24774,43800,0,0,1,2,3
66673,150,16230,20468;21013,43800,0,0,1,1,2
66674,150,16231,21266;21615;25453,43800,0,0,3,0,3
66675,150,16232,21687,43800,0,0,1,0,1
66676,150,16235,20665;21332,43800,0,0,2,0,2
66677,150,16236,21251,43800,0,0,1,0,1
66678,150,16237,20996;21272,43800,0,0,2,0,2
66679,150,16239,21345;22028,43800,0,0,2,0,2
66680,150,16240,21924;22212,43800,0,0,2,0,2
66681,150,16241,21643;22050;24419;25066;26021;27098,43800,1,1,4,0,6
66682,150,16242,21511;24505;26606,43800,0,1,2,0,3
66683,150,16243,21024;21520,43800,0,0,2,0,2
66684,150,16245,21564;25035,43800,0,0,2,0,2
66685,150,16246,21486;21711;25746,43800,0,0,3,0,3
66686,150,16248,21533;21681;25661,43800,0,0,3,0,3
66687,150,16249,20854;25097,43800,0,0,2,0,2
66688,150,16250,21468;21631;25454;27459,43800,1,0,3,0,4
66689,150,16251,21745;21932;25669,43800,0,0,3,0,3
66690,150,16252,21451;21856,43800,0,0,2,0,2
66691,150,16253,22413,43800,0,0,1,0,1
66692,150,16255,21823;22099,43800,0,0,2,0,2
66693,150,16256,21395;21842;25566;26306,43800,0,1,3,0,4
66694,150,16257,21507;21867;24096;25367,43800,0,0,4,0,4
66695,150,16258,21887;22266;24752;25491,43800,0,0,4,0,4
66696,150,16259,21732;21891,43800,0,0,2,0,2
66697,150,16260,21854;22426;25286;26611,43800,0,1,3,0,4
66698,150,16261,22661;22864;26049;26428,43800,0,2,2,0,4
66699,150,16262,21391;21831,43800,0,0,2,0,2
66700,150,16263,21995;22016;25573;25844;27465,43800,1,1,3,0,5
66701,150,16264,22005,43800,0,0,1,0,1
66702,150,16265,22007;22474;25867,43800,0,1,2,0,3
66703,150,16266,21498;22062,43800,0,0,2,0,2
66704,150,16267,21776;22303;26217,43800,0,1,2,0,3
66705,150,16268,22169;25680,43800,0,0,2,0,2
66706,150,16269,22129;25486;26414,43800,0,1,2,0,3
66707,150,16270,22144;22208;24970;25850,43800,0,1,3,0,4
66708,150,16271,21779;22154;25072;26024;26929;27454,43800,1,2,3,0,6
66709,150,16272,22138;22159;25847;26112,43800,0,2,2,0,4
66710,150,16275,21632;22048;25380,43800,0,0,3,0,3
66711,150,16276,22165;22680;26050,43800,0,1,2,0,3
66712,150,16277,22621;22646;26047;26518,43800,0,2,2,0,4
66713,150,16278,22252;22331;25170;25488;25853;26116,43800,0,2,4,0,6
66714,150,16279,22269;22542,43800,0,0,2,0,2
66715,150,16280,22079;22337;26117,43800,0,1,2,0,3
66716,150,16281,22300;22506,43800,0,0,2,0,2
66717,150,16282,21840;22319,43800,0,0,2,0,2
66718,150,16283,22493;22613;26131,43800,0,1,2,0,3
66719,150,16284,22135;22471,43800,0,0,2,0,2
66720,150,16285,22344;22347;25282;25686;25768;25858;26507,43800,0,2,5,0,7
66721,150,16286,22379,43800,0,0,1,0,1
66722,150,16287,22343;22380;25767;25944,43800,0,1,3,0,4
66723,150,16288,22388;22674;26232;26521,43800,0,2,2,0,4
66724,150,16290,17966,44165,0,0,0,1,1
66725,150,16295,18295,44165,0,0,0,1,1
66726,150,16297,18029;18234,44165,0,0,0,2,2
66727,150,16299,18141,44165,0,0,0,1,1
66728,150,16314,24647,44165,0,0,1,0,1
66729,150,16317,20402,44165,0,0,0,1,1
66730,150,16318,20623;20703,44165,0,0,1,1,2
66731,150,16319,20803,44165,0,0,1,0,1
66732,150,16320,20777;20963;24168;26697;26893;26986,44165,0,3,3,0,6
66733,150,16322,21084;21618;25141,44165,0,0,3,0,3
66734,150,16323,21092;22284,44165,0,0,2,0,2
66735,150,16325,20750;21221,44165,0,0,2,0,2
66736,150,16327,20881;21341,44165,0,0,2,0,2
66737,150,16328,21731;24512;27432,44165,1,0,2,0,3
66738,150,16329,21788;21981,44165,0,0,2,0,2
66739,150,16330,21886;22117;25759,44165,0,0,3,0,3
66740,150,16332,22112;22425;25386;25576,44165,0,0,4,0,4
66741,150,16333,22015;22499;25478,44165,0,0,3,0,3
66742,150,16334,21274;21685,44165,0,0,2,0,2
66743,150,16335,21113;21781;25462,44165,0,0,3,0,3
66744,150,16336,21786;25147,44165,0,0,2,0,2
66745,150,16337,21755;21789;25050;25925,44165,0,1,3,0,4
66746,150,16338,21824;21927,44165,0,0,2,0,2
66747,150,16339,21454;21860;25470;25839,44165,0,1,3,0,4
66748,150,16340,21890;21943;25061;27452,44165,1,0,3,0,4
66749,150,16341,21538;21951;25228,44165,0,0,3,0,3
66750,150,16342,21952;22044;26107,44165,0,1,2,0,3
66751,150,16343,21689;21974,44165,0,0,2,0,2
66752,150,16345,21438;22060,44165,0,0,2,0,2
66753,150,16346,21743;22093;25846;26023;26309,44165,0,3,2,0,5
66754,150,16348,22055;22070;25678,44165,0,0,3,0,3
66755,150,16349,22262;22270;26216;26316,44165,0,2,2,0,4
66756,150,16350,22543;25509;25605;26514,44165,0,1,3,0,4
66757,150,16351,22176;22662;26520,44165,0,1,2,0,3
66758,150,16352,22216;22592;26517,44165,0,1,2,0,3
66759,150,16353,22224;22233;26026,44165,0,1,2,0,3
66760,150,16355,22433;22547;25510,44165,0,0,3,0,3
66761,150,16357,22326;22370,44165,0,0,2,0,2
66762,150,16358,22341;22574;26130;26325,44165,0,2,2,0,4
66763,150,16359,22446;25773;26318,44165,0,1,2,0,3
66764,150,16360,22489;22598,44165,0,0,2,0,2
66765,150,16361,21944;22498;25291;25776;26222,44165,0,1,4,0,5
66766,150,16363,18240;18296,44530,0,0,0,2,2
66767,150,16365,18615;18864,44530,0,0,0,2,2
66768,150,16366,18688,44530,0,0,0,1,1
66769,150,16371,19255;19590,44530,0,0,0,2,2
66770,150,16372,19331,44530,0,0,0,1,1
66771,150,16373,19436,44530,0,0,0,1,1
66772,150,16374,19467;19517,44530,0,0,0,2,2
66773,150,16375,20148,44530,0,0,0,1,1
66774,150,16382,19802;19939,44530,0,0,0,2,2
66775,150,16383,20188;22820;26728,44530,0,1,1,1,3
66776,150,16384,20085;20256,44530,0,0,0,2,2
66777,150,16386,20349,44530,0,0,0,1,1
66778,150,16387,20018;20399,44530,0,0,0,2,2
66779,150,16393,20899;21620,44530,0,0,2,0,2
66780,150,16395,21005;21445;24892,44530,0,0,3,0,3
66781,150,16396,21655,44530,0,0,1,0,1
66782,150,16400,21238;21535,44530,0,0,2,0,2
66783,150,16402,21338;21514,44530,0,0,2,0,2
66784,150,16403,21061;21382;25217,44530,0,0,3,0,3
66785,150,16404,21244;21385;25341,44530,0,0,3,0,3
66786,150,16405,21014;21762,44530,0,0,2,0,2
66787,150,16406,21400;21624;25042;25556;27464,44530,1,0,4,0,5
66788,150,16407,21627;22230,44530,0,0,2,0,2
66789,150,16408,21638;22142;25579,44530,0,0,3,0,3
66790,150,16409,21584;21651;25923,44530,0,1,2,0,3
66791,150,16410,22150;25166,44530,0,0,2,0,2
66792,150,16411,21634;21730,44530,0,0,2,0,2
66793,150,16412,21739;21793;25364,44530,0,0,3,0,3
66794,150,16413,21749;21785,44530,0,0,2,0,2
66795,150,16414,21204,44530,0,0,1,0,1
66796,150,16415,21599;22273;25492,44530,0,0,3,0,3
66797,150,16416,21647;21963;25672;26017,44530,0,1,3,0,4
66798,150,16419,21550;22131,44530,0,0,2,0,2
66799,150,16420,21991;22223,44530,0,0,2,0,2
66800,150,16421,21979;22335;25174,44530,0,0,3,0,3
66801,150,16422,22090;22192;25935,44530,0,1,2,0,3
66802,150,16423,22894;25800;26151,44530,0,1,2,0,3
66803,150,16424,22119;22307;25173,44530,0,0,3,0,3
66804,150,16425,22198;22779;25085,44530,0,0,3,0,3
66805,150,16426,22280,44530,0,0,1,0,1
66806,150,16427,22170;22281;25273;25393;25941,44530,0,1,4,0,5
66807,150,16428,22548;24638;25511;25780,44530,0,0,4,0,4
66808,150,16430,22358,44530,0,0,1,0,1
66809,150,16431,22372;22440;25594,44530,0,0,3,0,3
66810,150,16432,22406;22477;25406;25694;26512,44530,0,1,4,0,5
66811,150,16433,22416;22510;25602,44530,0,0,3,0,3
66812,150,16434,22914;22923;25625,44530,0,0,3,0,3
66813,150,16436,22491;22527;25778;26040,44530,0,1,3,0,4
66814,150,16437,22529;22717;25789;25963;26051,44530,0,2,3,0,5
66815,150,16438,22225;22531;25953,44530,0,1,2,0,3
66816,150,16439,22291;22550;25697;26615,44530,0,1,3,0,4
66817,150,16440,22559;22799;25879;26337,44530,0,2,2,0,4
66818,150,16441,21936;26129;26324,44530,0,2,1,0,3
66819,150,16442,22571;22870;26341;26623;26730,44530,0,3,2,0,5
66820,150,16443,22325;22588;26045,44530,0,1,2,0,3
66821,150,16444,22567;22599;25782,44530,0,0,3,0,3
66822,150,16446,17800,44895,0,0,0,1,1
66823,150,16447,18267,44895,0,0,0,1,1
66824,150,16449,18351,44895,0,0,0,1,1
66825,150,16453,18509,44895,0,0,0,1,1
66826,150,16454,18124,44895,0,0,0,1,1
66827,150,16455,18134,44895,0,0,0,1,1
66828,150,16457,18545,44895,0,0,0,1,1
66829,150,16461,19043,44895,0,0,0,1,1
66830,150,16464,19178,44895,0,0,0,1,1
66831,150,16468,19566,44895,0,0,0,1,1
66832,150,16470,19673;19903,44895,0,0,0,2,2
66833,150,16482,20454,44895,0,0,0,1,1
66834,150,16483,20410,44895,0,0,0,1,1
66835,150,16485,20744,44895,0,0,1,0,1
66836,150,16487,20886;21296,44895,0,0,2,0,2
66837,150,16488,21136;21360;25125,44895,0,0,3,0,3
66838,150,16489,21247,44895,0,0,1,0,1
66839,150,16490,21198,44895,0,0,1,0,1
66840,150,16492,22004;25931,44895,0,1,1,0,2
66841,150,16493,21582;22087,44895,0,0,2,0,2
66842,150,16494,21622,44895,0,0,1,0,1
66843,150,16496,21581;21603;24608,44895,0,0,3,0,3
66844,150,16497,21585;21700;24830,44895,0,0,3,0,3
66845,150,16500,21918;22324,44895,0,0,2,0,2
66846,150,16501,21396;21558,44895,0,0,2,0,2
66847,150,16502,21430;21737,44895,0,0,2,0,2
66848,150,16503,21954;22057;24209;25383;27065,44895,1,0,4,0,5
66849,150,16504,22283;22422;25076;25394;25584;25762;25942,44895,0,1,6,0,7
66850,150,16505,21348;22018,44895,0,0,2,0,2
66851,150,16506,22248;22428;25690,44895,0,0,3,0,3
66852,150,16507,21846;21928;24957;27446,44895,1,0,3,0,4
66853,150,16508,22268;25172;25272,44895,0,0,3,0,3
66854,150,16510,21898;22024;26019,44895,0,1,2,0,3
66855,150,16511,22361;22424,44895,0,0,2,0,2
66856,150,16512,21941;22127;24311,44895,0,0,3,0,3
66857,150,16514,22105;22152;25761,44895,0,0,3,0,3
66858,150,16515,21875;22458;25949,44895,0,1,2,0,3
66859,150,16516,22174;22220;25848,44895,0,1,2,0,3
66860,150,16517,22516;26224,44895,0,1,1,0,2
66861,150,16518,22202;22620;26329,44895,0,1,2,0,3
66862,150,16519,22238,44895,0,0,1,0,1
66863,150,16520,22496;25695;26221,44895,0,1,2,0,3
66864,150,16521,21796;22289;25856;26415,44895,0,2,2,0,4
66865,150,16522,22229;22732;25618;25791;26523,44895,0,1,4,0,5
66866,150,16523,22339;22671;24865;25700;25875;26716,44895,0,2,4,0,6
66867,150,16524,22349;22392;25859,44895,0,1,2,0,3
66868,150,16525,22046;22352,44895,0,0,2,0,2
66869,150,16526,22765;26618,44895,0,1,1,0,2
66870,150,16527,22365;22566;24530;26423,44895,0,1,3,0,4
66871,150,16529,22403;22785;25188;25707;26436,44895,0,1,4,0,5
66872,150,16530,21787;21990,44895,0,0,2,0,2
66873,150,16531,22194;22838;26529,44895,0,1,2,0,3
66874,150,16532,22386;22420;25599;26721,44895,0,1,3,0,4
66875,150,16533,22348;22421;25600,44895,0,0,3,0,3
66876,150,16535,22451;23007;25888;26350;26630;26934,44895,0,4,2,0,6
66877,150,16536,22323;22558;25279;26218,44895,0,1,3,0,4
66878,150,16537,22453;22463;25863;26421,44895,0,2,2,0,4
66879,150,16538,22448;22866;26440,44895,0,1,2,0,3
66880,150,16540,22459;22461,44895,0,0,2,0,2
66881,150,16541,22479;22537;25290;25407;26125;26614,44895,0,2,4,0,6
66882,150,16543,22490,44895,0,0,1,0,1
66883,150,16544,22376;22612;25610;26425,44895,0,1,3,0,4
66884,150,16545,22304;22630;25410;25783,44895,0,0,4,0,4
66885,150,16546,22601;23011,44895,0,0,2,0,2
66886,150,16547,22317;22609;26723,44895,0,1,2,0,3
66887,150,16548,22435;22614;25699,44895,0,0,3,0,3
66888,150,16549,22367;22615,44895,0,0,2,0,2
66889,150,16550,22563;22618;26046,44895,0,1,2,0,3
66890,150,16551,22719;22790;25876;26052,44895,0,2,2,0,4
66891,150,16552,22396;22929;26442,44895,0,1,2,0,3
66892,150,16553,22839;22961,44895,0,0,2,0,2
66893,150,16554,21962;22695,44895,0,0,2,0,2
66894,150,16555,22712;25962;26135;26430,44895,0,3,1,0,4
66895,150,16556,22136;22720,44895,0,0,2,0,2
66896,150,16561,18696,45260,0,0,0,1,1
66897,150,16563,19015;19361,45260,0,0,0,2,2
66898,150,16566,19560,45260,0,0,0,1,1
66899,150,16578,20507,45260,0,0,0,1,1
66900,150,16579,20776,45260,0,0,1,0,1
66901,150,16589,20255;20573,45260,0,0,0,2,2
66902,150,16593,21200,45260,0,0,1,0,1
66903,150,16594,21746,45260,0,0,1,0,1
66904,150,16595,21442;21693,45260,0,0,2,0,2
66905,150,16596,21727;24839;24938;25747;26807,45260,0,1,4,0,5
66906,150,16597,21469;21965;26718,45260,0,1,2,0,3
66907,150,16598,21961;22199;25374,45260,0,0,3,0,3
66908,150,16599,21491,45260,0,0,1,0,1
66909,150,16600,21275;21617,45260,0,0,2,0,2
66910,150,16602,21428;21610,45260,0,0,2,0,2
66911,150,16603,21673;22258;25074;25489;25854;26029,45260,0,2,4,0,6
66912,150,16604,21937;22189;25939;26504,45260,0,2,2,0,4
66913,150,16606,21998;22052;25162;25845;26110,45260,0,2,3,0,5
66914,150,16607,21871;25368,45260,0,0,2,0,2
66915,150,16608,22063;22253,45260,0,0,2,0,2
66916,150,16609,21741;21959;23672;25753;25842;26680,45260,0,2,4,0,6
66917,150,16610,21879,45260,0,0,1,0,1
66918,150,16611,22371;22591;25514;26328,45260,0,1,3,0,4
66919,150,16612,21562;21976;25571,45260,0,0,3,0,3
66920,150,16613,21805;21983;25376;25843,45260,0,1,3,0,4
66921,150,16614,21715;22226,45260,0,0,2,0,2
66922,150,16615,22384;25399;25946;26119,45260,0,2,2,0,4
66923,150,16616,22051;22322;25260;25381,45260,0,0,4,0,4
66924,150,16617,21828;22058;26022,45260,0,1,2,0,3
66925,150,16618,21960;22619,45260,0,0,2,0,2
66926,150,16619,22634;26330;26426;26930,45260,0,3,1,0,4
66927,150,16621,22173;26310,45260,0,1,1,0,2
66928,150,16622,22185;22817;26621,45260,0,1,2,0,3
66929,150,16623,22190;22688;27377,45260,1,0,2,0,3
66930,150,16624,21999;22206,45260,0,0,2,0,2
66931,150,16626,21966;22456;25865,45260,0,1,2,0,3
66932,150,16627,22296;22437;25765;26506,45260,0,1,3,0,4
66933,150,16628,22346;22645;25784;25958;26230,45260,0,2,3,0,5
66934,150,16629,21904;22350,45260,0,0,2,0,2
66935,150,16630,22382;22741;25187;26053;26525;26815,45260,0,3,3,0,6
66936,150,16631,22399;22752;26617,45260,0,1,2,0,3
66937,150,16632,22310;22434;25403,45260,0,0,3,0,3
66938,150,16633,23015;25975;26829;26935,45260,0,3,1,0,4
66939,150,16634,21868;25951,45260,0,1,1,0,2
66940,150,16635,22541;22707;26134,45260,0,1,2,0,3
66941,150,16636,22575;22730;25874;26225,45260,0,2,2,0,4
66942,150,16637,22600;22651;25959;26332,45260,0,2,2,0,4
66943,150,16638,22164;22465,45260,0,0,2,0,2
66944,150,16639,22833;25710;25967;26528,45260,0,2,2,0,4
66945,150,16640,23062;26161,45260,0,1,1,0,2
66946,150,16641,22383;22823;25300;25526;26438,45260,0,1,4,0,5
66947,150,16642,22754;22918;26825,45260,0,1,2,0,3
66948,150,16643,22670;23016;26446,45260,0,1,2,0,3
66949,150,16644,22768;25523;26139;26817,45260,0,2,2,0,4
66950,150,16646,22782;22973;26062;26536;27006,45260,1,2,2,0,5
66951,150,16647,22705;22811,45260,0,0,2,0,2
66952,150,16648,22643;23034;25978;26631;27106,45260,1,2,2,0,5
66953,150,16651,18350,45625,0,0,0,1,1
66954,150,16654,18684,45625,0,0,0,1,1
66955,150,16657,18916,45625,0,0,0,1,1
66956,150,16666,19409,45625,0,0,0,1,1
66957,150,16669,19253,45625,0,0,0,1,1
66958,150,16678,19790;19807,45625,0,0,0,2,2
66959,150,16694,21546;21682,45625,0,0,2,0,2
66960,150,16695,21324;21343,45625,0,0,2,0,2
66961,150,16698,21373;21557;25349;25831,45625,0,1,3,0,4
66962,150,16699,21650;21985,45625,0,0,2,0,2
66963,150,16700,20860;21548;25659,45625,0,0,3,0,3
66964,150,16701,21355;21858;26015,45625,0,1,2,0,3
66965,150,16702,21521;21686,45625,0,0,2,0,2
66966,150,16703,22184;25389;26312,45625,0,1,2,0,3
66967,150,16704,22027,45625,0,0,1,0,1
66968,150,16706,21754;21893,45625,0,0,2,0,2
66969,150,16708,21909;22008,45625,0,0,2,0,2
66970,150,16711,21984;22518;25408;25777;26127;26321,45625,0,2,4,0,6
66971,150,16713,21989,45625,0,0,1,0,1
66972,150,16714,22407;22466;25079;26510,45625,0,1,3,0,4
66973,150,16715,22186,45625,0,0,1,0,1
66974,150,16716,22083,45625,0,0,1,0,1
66975,150,16717,22086;22309;26033,45625,0,1,2,0,3
66976,150,16718,22134;22659;26132,45625,0,1,2,0,3
66977,150,16719,21628;22160;25387,45625,0,0,3,0,3
66978,150,16720,22068;22191;25069;25482;25934,45625,0,1,4,0,5
66979,150,16721,22210;22369;25593;25769,45625,0,0,4,0,4
66980,150,16723,22234;22623,45625,0,0,2,0,2
66981,150,16725,22075;22203,45625,0,0,2,0,2
66982,150,16727,22277;22441;25772,45625,0,0,3,0,3
66983,150,16728,22318;22648,45625,0,0,2,0,2
66984,150,16729,22374;22429;26612,45625,0,1,2,0,3
66985,150,16730,22193;22409;25861;26035,45625,0,2,2,0,4
66986,150,16731,22122;22431,45625,0,0,2,0,2
66987,150,16732,22445;22519;25404,45625,0,0,3,0,3
66988,150,16733,22853;26237;26439,45625,0,2,1,0,3
66989,150,16734,22235;22514;25870,45625,0,1,2,0,3
66990,150,16735,22540;25871,45625,0,1,1,0,2
66991,150,16736,22545;22669;26333,45625,0,1,2,0,3
66992,150,16737,22596;22616;26228;26616,45625,0,2,2,0,4
66993,150,16738,22604;25956,45625,0,1,1,0,2
66994,150,16739,22200;22624;25518;26048;26519,45625,0,2,3,0,5
66995,150,16740,22967;25424;26735;27280,45625,1,1,2,0,4
66996,150,16741,22660;22733;25083;25792;26137,45625,0,1,4,0,5
66997,150,16743,22678;23084;27188,45625,1,0,2,0,3
66998,150,16744,22053;22495;25505;26320,45625,0,1,3,0,4
66999,150,16745,22704;23068,45625,0,0,2,0,2
67000,150,16746,22708;25616,45625,0,0,2,0,2
67001,150,16747,22713;23021,45625,0,0,2,0,2
67002,150,16748,22675;25701,45625,0,0,2,0,2
67003,150,16749,22826;26622,45625,0,1,1,0,2
67004,150,16750,22830;22986;26244,45625,0,1,2,0,3
67005,150,16751,22832;22911;25880,45625,0,1,2,0,3
67006,150,16752,22836;23178;25898;26841,45625,0,2,2,0,4
67007,150,16753,22673;22848,45625,0,0,2,0,2
67008,150,16755,22925;25973;26933,45625,0,2,1,0,3
67009,150,16756,22871;22958;26444,45625,0,1,2,0,3
67010,150,16757,23027;23169,45625,0,0,2,0,2
67011,150,16758,22893;26057;26150,45625,0,2,1,0,3
67012,150,16759,22520;22909;26533,45625,0,1,2,0,3
67013,150,16760,22638;22912;26733;26824;27005;27105,45625,2,2,2,0,6
67014,150,16761,22915;23098;25893,45625,0,1,2,0,3
67015,150,16762,23080;26162;26250,45625,0,2,1,0,3
67016,150,16765,18417,45990,0,0,0,1,1
67017,150,16766,18838,45990,0,0,0,1,1
67018,150,16768,18333,45990,0,0,0,1,1
67019,150,16769,18640,45990,0,0,0,1,1
67020,150,16771,18948,45990,0,0,0,1,1
67021,150,16773,18650,45990,0,0,0,1,1
67022,150,16774,19320,45990,0,0,0,1,1
67023,150,16777,19310,45990,0,0,0,1,1
67024,150,16782,19547;19747,45990,0,0,0,2,2
67025,150,16786,19870,45990,0,0,0,1,1
67026,150,16796,21050,45990,0,0,1,0,1
67027,150,16799,21098;21315;24694;25121;25214,45990,0,0,5,0,5
67028,150,16803,21476;21593;25232,45990,0,0,3,0,3
67029,150,16805,21477;21782;25146,45990,0,0,3,0,3
67030,150,16807,21667;21914;24956;25841,45990,0,1,3,0,4
67031,150,16808,21665;21783;25748,45990,0,0,3,0,3
67032,150,16810,21967;22141;25267,45990,0,0,3,0,3
67033,150,16812,21294;21553;25743;25920,45990,0,1,3,0,4
67034,150,16813,21719;22114;25758;26610,45990,0,1,3,0,4
67035,150,16814,21526;21649,45990,0,0,2,0,2
67036,150,16815,21536;22033;25676,45990,0,0,3,0,3
67037,150,16818,22102;22664;26231;26724,45990,0,2,2,0,4
67038,150,16819,22143;22524;25696;26128,45990,0,1,3,0,4
67039,150,16820,22171;22758,45990,0,0,2,0,2
67040,150,16821,22205;22715;26725,45990,0,1,2,0,3
67041,150,16822,21713;22217;25169;25852;26505,45990,0,2,3,0,5
67042,150,16823,22863;26932,45990,0,1,1,0,2
67043,150,16824,22263;22585;26327;26814,45990,0,2,2,0,4
67044,150,16825,22328,45990,0,0,1,0,1
67045,150,16826,22562;22812,45990,0,0,2,0,2
67046,150,16828,22432;22874;25971;26342,45990,0,2,2,0,4
67047,150,16829,22243;22467;25693,45990,0,0,3,0,3
67048,150,16830,22487;23067;27187,45990,1,0,2,0,3
67049,150,16831,21791;22462;25774;26038;26123;26319,45990,0,3,3,0,6
67050,150,16832,22500;22738,45990,0,0,2,0,2
67051,150,16833,22411;22709;25617,45990,0,0,3,0,3
67052,150,16834,22523,45990,0,0,1,0,1
67053,150,16835,22525;22536,45990,0,0,2,0,2
67054,150,16836,22172;22551,45990,0,0,2,0,2
67055,150,16837,22564;22587,45990,0,0,2,0,2
67056,150,16838,22927;23125;24992;27010,45990,1,0,3,0,4
67057,150,16839,22728;22748;25964;26522,45990,0,2,2,0,4
67058,150,16840,22608;25516;25609,45990,0,0,3,0,3
67059,150,16841,22649;22698,45990,0,0,2,0,2
67060,150,16842,22979;22994;25886;26348,45990,0,2,2,0,4
67061,150,16843,22727;22757;25793;26334,45990,0,1,3,0,4
67062,150,16844,22743;22815;26431,45990,0,1,2,0,3
67063,150,16846,22766;22846;25086;27099,45990,1,0,3,0,4
67064,150,16847,22822;25895;26357;26447;26638,45990,0,4,1,0,5
67065,150,16848,22607;22825,45990,0,0,2,0,2
67066,150,16849,22001;22827;25709,45990,0,0,3,0,3
67067,150,16850,22640;22849;26427,45990,0,1,2,0,3
67068,150,16851,22868;23324,45990,0,0,2,0,2
67069,150,16852,22878;23296;26943,45990,0,1,2,0,3
67070,150,16853,22891;26441;26532,45990,0,2,1,0,3
67071,150,16854,22910;23103;25634;26636;26742,45990,0,2,3,0,5
67072,150,16855,22919;23047;25531;26248;26832,45990,0,2,3,0,5
67073,150,16856,22951;23315;26171;26377;26555;26649,45990,0,4,2,0,6
67074,150,16857,22684;22952;26346,45990,0,1,2,0,3
67075,150,16858,22906;23247;26553,45990,0,1,2,0,3
67076,150,16859,22611;22965;26061;26734,45990,0,2,2,0,4
67077,150,16860,22993;23314;26262,45990,0,1,2,0,3
67078,150,16861,22663;22769;25706;25794,45990,0,0,4,0,4
67079,150,16862,22755;23023;25718;25976;26351,45990,0,2,3,0,5
67080,150,16863,22557;23025,45990,0,0,2,0,2
67081,150,16864,22544;23028;25977;26158,45990,0,2,2,0,4
67082,150,16866,18701,46355,0,0,0,1,1
67083,150,16868,18674,46355,0,0,0,1,1
67084,150,16869,18800;18816,46355,0,0,0,2,2
67085,150,16872,19055,46355,0,0,0,1,1
67086,150,16873,19048,46355,0,0,0,1,1
67087,150,16876,19150,46355,0,0,0,1,1
67088,150,16880,19734,46355,0,0,0,1,1
67089,150,16881,20004,46355,0,0,0,1,1
67090,150,16882,19953;20005,46355,0,0,0,2,2
67091,150,16884,19845,46355,0,0,0,1,1
67092,150,16895,20475,46355,0,0,0,1,1
67093,150,16896,21256;21574,46355,0,0,2,0,2
67094,150,16898,21349;21855,46355,0,0,2,0,2
67095,150,16900,21357;21572,46355,0,0,2,0,2
67096,150,16901,21344;21505,46355,0,0,2,0,2
67097,150,16902,21601;21656,46355,0,0,2,0,2
67098,150,16904,21195;21676;25359,46355,0,0,3,0,3
67099,150,16905,22244;26215,46355,0,1,1,0,2
67100,150,16907,21458;21697;25045;25240,46355,0,0,4,0,4
67101,150,16908,21778;21945,46355,0,0,2,0,2
67102,150,16909,21919,46355,0,0,1,0,1
67103,150,16910,21487;25224;26209,46355,0,1,2,0,3
67104,150,16911,22049;22460;25692,46355,0,0,3,0,3
67105,150,16915,22151;22332,46355,0,0,2,0,2
67106,150,16917,22065;22533;25604;25954;26422,46355,0,2,3,0,5
67107,150,16918,22259;22724;25877;26726,46355,0,2,2,0,4
67108,150,16920,22439;22777;25412;26140;26435,46355,0,2,3,0,5
67109,150,16921,22454;25288,46355,0,0,2,0,2
67110,150,16922,22250;22480,46355,0,0,2,0,2
67111,150,16923,22526;23111,46355,0,0,2,0,2
67112,150,16924,22504;22528;26041;26322;26813,46355,0,3,2,0,5
67113,150,16926,22736;24985;26524,46355,0,1,2,0,3
67114,150,16928,22731;22942;26060,46355,0,1,2,0,3
67115,150,16929,22751;22762;26433,46355,0,1,2,0,3
67116,150,16930,22771;22852;26145;26530;26820,46355,0,3,2,0,5
67117,150,16931,22745;22780,46355,0,0,2,0,2
67118,150,16932,23195;25900;26451,46355,0,2,1,0,3
67119,150,16933,22436;22828;26338;26729,46355,0,2,2,0,4
67120,150,16934,22831;22966,46355,0,0,2,0,2
67121,150,16935,22841;23085;26635;26741,46355,0,2,2,0,4
67122,150,16936,23202;25637;26167,46355,0,1,2,0,3
67123,150,16937,22589;22867;25798;25827;25881,46355,0,2,3,0,5
67124,150,16938,23149;25810;26252;26358,46355,0,2,2,0,4
67125,150,16939,22415;23181;26747;26842,46355,0,2,2,0,4
67126,150,16940,22753;22922;25972;26153,46355,0,2,2,0,4
67127,150,16941,22936;25421;26059,46355,0,1,2,0,3
67128,150,16942,22956;23278,46355,0,0,2,0,2
67129,150,16943,22521;22970;25307;26154;26242;26627,46355,0,3,3,0,6
67130,150,16944,23002;23040;25630;25804;25887;26246,46355,0,2,4,0,6
67131,150,16945,22517;23006;25717;26738,46355,0,1,3,0,4
67132,150,16946,22747;23269,46355,0,0,2,0,2
67133,150,16947,22978;25803;26063,46355,0,1,2,0,3
67134,150,16948,23298;23326;26459,46355,0,1,2,0,3
67135,150,16949,23095;25892;26251,46355,0,2,1,0,3
67136,150,16950,23017;23077;25980;26835,46355,0,2,2,0,4
67137,150,16951,23056;23093;25809,46355,0,0,3,0,3
67138,150,16952,22976;23241;25903;26168;26452;26552;26644,46355,0,5,2,0,7
67139,150,16953,23106;23145,46355,0,0,2,0,2
67140,150,16954,23321;23350;26650;27110,46355,1,1,2,0,4
67141,150,16955,23123;23189;26544;26637;26744,46355,0,3,2,0,5
67142,150,16956,22899;23138;25981;26448;26639,46355,0,3,2,0,5
67143,150,16962,18959,46720,0,0,0,1,1
67144,150,16963,18639;18700,46720,0,0,0,2,2
67145,150,16964,18743,46720,0,0,0,1,1
67146,150,16967,19308,46720,0,0,0,1,1
67147,150,16968,19155,46720,0,0,0,1,1
67148,150,16972,19245,46720,0,0,0,1,1
67149,150,16973,19965,46720,0,0,0,1,1
67150,150,16979,19912;20190,46720,0,0,0,2,2
67151,150,16993,20302,46720,0,0,0,1,1
67152,150,16994,20825;21016,46720,0,0,2,0,2
67153,150,16997,21106;21724;25047,46720,0,0,3,0,3
67154,150,16998,21374;22030;24417;25480;27427,46720,1,0,4,0,5
67155,150,16999,21333;21367;24590,46720,0,0,3,0,3
67156,150,17000,21365;21764;25563,46720,0,0,3,0,3
67157,150,17001,21096;21408,46720,0,0,2,0,2
67158,150,17002,22029;22315;25078;25588;26416,46720,0,1,4,0,5
67159,150,17003,20956;21418;25344,46720,0,0,3,0,3
67160,150,17008,21683;21770,46720,0,0,2,0,2
67161,150,17012,22201;22362;25397;25945;26034,46720,0,2,3,0,5
67162,150,17013,22242;22298,46720,0,0,2,0,2
67163,150,17014,22100;22294;25395;25586;25764;27466,46720,1,0,5,0,6
67164,150,17015,21814;22156,46720,0,0,2,0,2
67165,150,17016,22213;22512;26223,46720,0,1,2,0,3
67166,150,17017,22264;22275;25683,46720,0,0,3,0,3
67167,150,17018,22308;23161,46720,0,0,2,0,2
67168,150,17019,22311;22552;26323,46720,0,1,2,0,3
67169,150,17020,22345;25281;25590,46720,0,0,3,0,3
67170,150,17021,22887;25301;26343;26732,46720,0,2,2,0,4
67171,150,17022,22418;25401;26420;26720,46720,0,2,2,0,4
67172,150,17023,22457;22793;26619,46720,0,1,2,0,3
67173,150,17025,22569;25294;26044,46720,0,1,2,0,3
67174,150,17026,22546;22572;25608;25873;26515,46720,0,2,3,0,5
67175,150,17027,23225;26255;26367,46720,0,2,1,0,3
67176,150,17028,23038;23192;26831,46720,0,1,2,0,3
67177,150,17029,22427;22656;24529;26122,46720,0,1,3,0,4
67178,150,17030,23010;23226;25429;26079,46720,0,1,3,0,4
67179,150,17031,22921;23235;25638;26257;26551;26750;26843;27107,46720,1,4,3,0,8
67180,150,17032,22693;23173;26450;26545;27378,46720,1,2,2,0,5
67181,150,17033,22892;25302;26823,46720,0,1,2,0,3
67182,150,17034,22770;23005;26247;26349,46720,0,2,2,0,4
67183,150,17035,22635;22791;26437,46720,0,1,2,0,3
67184,150,17036,23261,46720,0,0,1,0,1
67185,150,17037,22161;22851;25797;26236;26931;27282,46720,1,2,3,0,6
67186,150,17038,22900;22948;25628,46720,0,0,3,0,3
67187,150,17039,23026;23171;25193;26165;26939,46720,0,2,3,0,5
67188,150,17040,22901;23238;26258;26368,46720,0,2,2,0,4
67189,150,17041,22904;23094;25309;26543;26837,46720,0,2,3,0,5
67190,150,17042,22885;22913,46720,0,0,2,0,2
67191,150,17043,22934;23491,46720,0,0,2,0,2
67192,150,17045,22954;26241;26827,46720,0,2,1,0,3
67193,150,17046,22650;22977;26243,46720,0,1,2,0,3
67194,150,17047,22995;23184;25629;25716;27183,46720,1,0,4,0,5
67195,150,17048,22881;22996;26157,46720,0,1,2,0,3
67196,150,17049,23050;23141;25720;25896,46720,0,1,3,0,4
67197,150,17050,23078;23459;26181;26760,46720,0,2,2,0,4
67198,150,17051,23249;23311;25093,46720,0,0,3,0,3
67199,150,17052,23053;23100;25719,46720,0,0,3,0,3
67200,150,17053,23109;23260;27191,46720,1,0,2,0,3
67201,150,17054,22879;25799;26624,46720,0,1,2,0,3
67202,150,17055,23124;23528;25540;26273;26672,46720,0,2,3,0,5
67203,150,17056,23293;23355;26260,46720,0,1,2,0,3
67204,150,17057,23155;23290;25812;25905;26374;26942,46720,0,3,3,0,6
67205,150,17058,23196;23237;25536;26549,46720,0,1,3,0,4
67206,150,17059,23537;23841;26587,46720,0,1,2,0,3
67207,150,17060,23018;23157;25983;26071;27189,46720,1,2,2,0,5
67208,150,17061,22805;23232;26256,46720,0,1,2,0,3
67209,150,17064,19212,47085,0,0,0,1,1
67210,150,17065,18580,47085,0,0,0,1,1
67211,150,17066,19582,47085,0,0,0,1,1
67212,150,17068,19272,47085,0,0,0,1,1
67213,150,17069,18871;19205,47085,0,0,0,2,2
67214,150,17070,18966;19261,47085,0,0,0,2,2
67215,150,17071,19200,47085,0,0,0,1,1
67216,150,17074,19565,47085,0,0,0,1,1
67217,150,17087,20723,47085,0,0,1,0,1
67218,150,17091,21177,47085,0,0,1,0,1
67219,150,17095,21076;21398;24811;27442,47085,1,0,3,0,4
67220,150,17096,22110;22231;24634;26115,47085,0,1,3,0,4
67221,150,17100,21368;21605,47085,0,0,2,0,2
67222,150,17101,21864;21982;25569,47085,0,0,3,0,3
67223,150,17103,21588;22002,47085,0,0,2,0,2
67224,150,17104,21753;21889;25460;25924,47085,0,1,3,0,4
67225,150,17106,21992;22179,47085,0,0,2,0,2
67226,150,17107,22232;22788;25524,47085,0,0,3,0,3
67227,150,17108,22219;22257;26315,47085,0,1,2,0,3
67228,150,17109,22292;22375;25689;26418;27184,47085,1,1,3,0,5
67229,150,17110,22132;22395;24756;25466;25928;26719,47085,0,2,4,0,6
67230,150,17113,22334;22363;25688,47085,0,0,3,0,3
67231,150,17115,22402;22475,47085,0,0,2,0,2
67232,150,17116,22182;22455;25691;25864;26722,47085,0,2,3,0,5
67233,150,17117,22464;22511,47085,0,0,2,0,2
67234,150,17118,22256;22472;25866;25950;26613,47085,0,3,2,0,5
67235,150,17119,22515;22740;25965;26727,47085,0,2,2,0,4
67236,150,17120,22653;22810;25708;25796;26054;26233,47085,0,2,4,0,6
67237,150,17121,22795;26141;26818,47085,0,2,1,0,3
67238,150,17122,22573;22593,47085,0,0,2,0,2
67239,150,17123,22672;22872,47085,0,0,2,0,2
67240,150,17124,22677;22873;25623;26821,47085,0,1,3,0,4
67241,150,17125,22687;22883;25528;25624,47085,0,0,4,0,4
67242,150,17126,22486;22691;25615,47085,0,0,3,0,3
67243,150,17127,22721;25703,47085,0,0,2,0,2
67244,150,17128,22722;22944;25974,47085,0,1,2,0,3
67245,150,17129,22737;22941,47085,0,0,2,0,2
67246,150,17130,22750;23159,47085,0,0,2,0,2
67247,150,17131,22798,47085,0,0,1,0,1
67248,150,17132,22859;23137;25416;25712;25969;26146,47085,0,2,4,0,6
67249,150,17133,22860;23239;26259,47085,0,1,2,0,3
67250,150,17134,22642;22889,47085,0,0,2,0,2
67251,150,17135,22902;23527;26388;26469;26671,47085,0,3,2,0,5
67252,150,17136,22829;22969;26535,47085,0,1,2,0,3
67253,150,17137,23104;23334,47085,0,0,2,0,2
67254,150,17138,22775;23049;26936,47085,0,1,2,0,3
67255,150,17139,22665;23064;26833,47085,0,1,2,0,3
67256,150,17140,22907;23074,47085,0,0,2,0,2
67257,150,17141,22834;23354;25434;26379;26559;26652,47085,0,3,3,0,6
67258,150,17142,23168;23486;26086;26272;26665;27020,47085,1,3,2,0,6
67259,150,17143,23299;23427;26269,47085,0,1,2,0,3
67260,150,17144,23204;23449;26383;26467;26564;26951;27114,47085,1,4,2,0,7
67261,150,17145,22895;23208;26075;26365,47085,0,2,2,0,4
67262,150,17146,22932;23209;25902;26366;26748,47085,0,3,2,0,5
67263,150,17147,23030;23211;26076,47085,0,1,2,0,3
67264,150,17148,23212;23223;26077;26643,47085,0,2,2,0,4
67265,150,17149,22837;26144;27104,47085,1,1,1,0,3
67266,150,17150,23185;23251;25904;26453,47085,0,2,2,0,4
67267,150,17151,22631;23283;27192,47085,1,0,2,0,3
67268,150,17152,23105;23289,47085,0,0,2,0,2
67269,150,17154,23102;23305,47085,0,0,2,0,2
67270,150,17155,23541;26572;26673,47085,0,2,1,0,3
67271,150,17156,22950;23352;25640;27374,47085,1,0,3,0,4
67272,150,17157,23348;23639;25645,47085,0,0,3,0,3
67273,150,17158,23339;23396;26266;26655;26849;26948,47085,0,4,2,0,6
67274,150,17159,23349;23362;26084;26653;26757,47085,0,3,2,0,5
67275,150,17160,23656;26964;27125,47085,1,1,1,0,3
67276,150,17162,18922,47450,0,0,0,1,1
67277,150,17163,18899,47450,0,0,0,1,1
67278,150,17169,19182,47450,0,0,0,1,1
67279,150,17171,19741,47450,0,0,0,1,1
67280,150,17174,20057,47450,0,0,0,1,1
67281,150,17180,20379,47450,0,0,0,1,1
67282,150,17184,21335;25548,47450,0,0,2,0,2
67283,150,17189,21279;21480,47450,0,0,2,0,2
67284,150,17192,21040,47450,0,0,1,0,1
67285,150,17193,21389;21542;25347;25658,47450,0,0,4,0,4
67286,150,17195,21677;22084,47450,0,0,2,0,2
67287,150,17196,21549;21744;25243,47450,0,0,3,0,3
67288,150,17200,21857;21901;25469,47450,0,0,3,0,3
67289,150,17203,21761;22282;25855,47450,0,1,2,0,3
67290,150,17204,21851,47450,0,0,1,0,1
67291,150,17206,22128;22633;25611,47450,0,0,3,0,3
67292,150,17207,22228;25681;26314,47450,0,1,2,0,3
67293,150,17209,22101,47450,0,0,1,0,1
67294,150,17212,22123;22381;24754;26118,47450,0,1,3,0,4
67295,150,17213,22405;22449;26509,47450,0,1,2,0,3
67296,150,17214,22501;22666;25785,47450,0,0,3,0,3
67297,150,17216,22626;22682;24761,47450,0,0,3,0,3
67298,150,17218,22211;22580;26326,47450,0,1,2,0,3
67299,150,17219,22939;22971;26736,47450,0,1,2,0,3
67300,150,17221,22654;23143,47450,0,0,2,0,2
67301,150,17222,22676;22760;25614;25960,47450,0,1,3,0,4
67302,150,17223,22373;22781;26336,47450,0,1,2,0,3
67303,150,17224,22764;22890;26526,47450,0,1,2,0,3
67304,150,17225,22819;23177;25723;26166;26546,47450,0,2,3,0,5
67305,150,17226,22497;22835;25711;26143;26234;26339,47450,0,3,3,0,6
67306,150,17227,22865;23357;26380,47450,0,1,2,0,3
67307,150,17228,22778;22876;25417,47450,0,0,3,0,3
67308,150,17229,22668;22882;26148;26531;26822,47450,0,3,2,0,5
67309,150,17230,22639;22896;25882,47450,0,1,2,0,3
67310,150,17231,22617;22908;25801;26152,47450,0,1,3,0,4
67311,150,17232,22756;22928;26239,47450,0,1,2,0,3
67312,150,17233,22964;23302;26375;26554,47450,0,2,2,0,4
67313,150,17234,22982;23001;26156;26537,47450,0,2,2,0,4
67314,150,17235,22985;23258;27008;27186,47450,2,0,2,0,4
67315,150,17236,22987;23280;26458,47450,0,1,2,0,3
67316,150,17237,22992;23388;25909;27012,47450,1,1,2,0,4
67317,150,17238,23317;23518;26669;27022,47450,1,1,2,0,4
67318,150,17239,23244;23256;26370;26454;26844,47450,0,3,2,0,5
67319,150,17242,22861;23206;25970;26147;26238;26340,47450,0,4,2,0,6
67320,150,17244,23071;23270;26080,47450,0,1,2,0,3
67321,150,17245,23014;23272;26646,47450,0,1,2,0,3
67322,150,17246,22943;23288;26082;26754,47450,0,2,2,0,4
67323,150,17247,22933;23127;25419;26240;26345;26626;27370,47450,1,3,3,0,7
67324,150,17248,23214;23322,47450,0,0,2,0,2
67325,150,17249,23115;23323;27193,47450,1,0,2,0,3
67326,150,17250,23041;23328;26173;26460,47450,0,2,2,0,4
67327,150,17251,23373;23592;26187;26476;26765,47450,0,3,2,0,5
67328,150,17252,23540;23684;27031,47450,1,0,2,0,3
67329,150,17253,23386;23544;26178;26847,47450,0,2,2,0,4
67330,150,17254,23264;23424;26382,47450,0,1,2,0,3
67331,150,17255,19033,47815,0,0,0,1,1
67332,150,17257,19165,47815,0,0,0,1,1
67333,150,17260,18828,47815,0,0,0,1,1
67334,150,17261,18649,47815,0,0,0,1,1
67335,150,17262,19534,47815,0,0,0,1,1
67336,150,17264,19225;19515,47815,0,0,0,2,2
67337,150,17265,19533,47815,0,0,0,1,1
67338,150,17266,19484,47815,0,0,0,1,1
67339,150,17270,20264;20420,47815,0,0,0,2,2
67340,150,17277,20437,47815,0,0,0,1,1
67341,150,17278,20133;20418;24330,47815,0,0,1,2,3
67342,150,17279,20651;20997,47815,0,0,2,0,2
67343,150,17285,21190;21920;24498;25058;27079,47815,1,0,4,0,5
67344,150,17289,21907;22042,47815,0,0,2,0,2
67345,150,17290,21747;21925,47815,0,0,2,0,2
67346,150,17291,21935,47815,0,0,1,0,1
67347,150,17292,21978;22245;25819;25940,47815,0,1,3,0,4
67348,150,17293,22012,47815,0,0,1,0,1
67349,150,17294,21767;22020;25674,47815,0,0,3,0,3
67350,150,17296,21969,47815,0,0,1,0,1
67351,150,17297,22000;22288;25585,47815,0,0,3,0,3
67352,150,17298,22187;22485;25775;26039,47815,0,1,3,0,4
67353,150,17299,21949;22195,47815,0,0,2,0,2
67354,150,17301,22538;22579;26226;26424,47815,0,2,2,0,4
67355,150,17302,22397;22522;25507;27371,47815,1,0,3,0,4
67356,150,17303,22414;25597;25857;25948;26121;26219,47815,0,4,2,0,6
67357,150,17304,22072;22417;25502;25598;26036;26317,47815,0,2,4,0,6
67358,150,17306,22011;22577,47815,0,0,2,0,2
67359,150,17307,22553;22590;25293;26043,47815,0,1,3,0,4
67360,150,17308,22637;22850;24988;25968,47815,0,1,3,0,4
67361,150,17310,22869,47815,0,0,1,0,1
67362,150,17311,23180;26073,47815,0,1,1,0,2
67363,150,17312,22419;22582,47815,0,0,2,0,2
67364,150,17313,22744;23119;25635;25894;26743,47815,0,2,3,0,5
67365,150,17314,22784;23019,47815,0,0,2,0,2
67366,150,17315,22530;22539;25952,47815,0,1,2,0,3
67367,150,17316,22877;23306;25813;26261;26648,47815,0,2,3,0,5
67368,150,17317,23597;25912;27207,47815,1,1,1,0,3
67369,150,17318,22843;23174,47815,0,0,2,0,2
67370,150,17319,22963;23332;25907;26263;26556;26945,47815,0,4,2,0,6
67371,150,17320,22999;23436;26466,47815,0,1,2,0,3
67372,150,17321,23004,47815,0,0,1,0,1
67373,150,17322,22989;23013;26629,47815,0,1,2,0,3
67374,150,17323,23166;26072;26840,47815,0,2,1,0,3
67375,150,17325,23426;23614;25642;25987;27198,47815,1,1,3,0,5
67376,150,17326,23136;23443;26759,47815,0,1,2,0,3
67377,150,17327,23218;23663;26579;26768,47815,0,2,2,0,4
67378,150,17328,23156;23464;25731;27018,47815,1,0,3,0,4
67379,150,17329,22803;23188;26361;26641,47815,0,2,2,0,4
67380,150,17330,23715;25821;26480,47815,0,1,2,0,3
67381,150,17331,23203;23359;26176,47815,0,1,2,0,3
67382,150,17332,23122;23207;25901,47815,0,1,2,0,3
67383,150,17333,23248;23609;26576;26678;27123,47815,1,2,2,0,5
67384,150,17334,23250;23596;26391;26766,47815,0,2,2,0,4
67385,150,17335,23369,47815,0,0,1,0,1
67386,150,17336,23276;23450;25639;26372;26456;26647,47815,0,3,3,0,6
67387,150,17337,23448;23760;26971;27134;27214,47815,2,1,2,0,5
67388,150,17338,23303;23318;26944,47815,0,1,2,0,3
67389,150,17339,23316;23576;25995;26861,47815,0,2,2,0,4
67390,150,17340,23329;23503;26667;27021;27117;27381,47815,3,1,2,0,6
67391,150,17341,23550;23759;26471,47815,0,1,2,0,3
67392,150,17342,23635;27298,47815,1,0,1,0,2
67393,150,17343,23220;23406,47815,0,0,2,0,2
67394,150,17344,23132;23414;25985;26658,47815,0,2,2,0,4
67395,150,17345,23243;23420;26169,47815,0,1,2,0,3
67396,150,17346,23598;26864,47815,0,1,1,0,2
67397,150,17347,23439;23659,47815,0,0,2,0,2
67398,150,17348,23452;23559;25994,47815,0,1,2,0,3
67399,150,17349,23479;27115,47815,1,0,1,0,2
67400,150,17350,23881;26879,47815,0,1,1,0,2
67401,150,17351,23487;23713;26395,47815,0,1,2,0,3
67402,150,17352,23187;23297;25432;26083;26755,47815,0,2,3,0,5
67403,150,17353,23497;23585;25997;27027,47815,1,1,2,0,4
67404,150,17354,23470;23498;26087;26385;26568;26955;27289;27380,47815,2,4,2,0,8
67405,150,17355,23222;23500;26569;26855,47815,0,2,2,0,4
67406,150,17356,23092;23523;26956;27025,47815,1,1,2,0,4
67407,150,17357,23428;23532;26270;26659;27113,47815,1,2,2,0,5
67408,150,17358,23567;23642;26867,47815,0,1,2,0,3
67409,150,17360,23358;23620;26279;26392,47815,0,2,2,0,4
67410,150,17361,19085,48180,0,0,0,1,1
67411,150,17362,18704,48180,0,0,0,1,1
67412,150,17366,18949,48180,0,0,0,1,1
67413,150,17367,19506,48180,0,0,0,1,1
67414,150,17369,19543,48180,0,0,0,1,1
67415,150,17371,19703,48180,0,0,0,1,1
67416,150,17372,19207,48180,0,0,0,1,1
67417,150,17375,19559,48180,0,0,0,1,1
67418,150,17376,20422,48180,0,0,0,1,1
67419,150,17385,20363,48180,0,0,0,1,1
67420,150,17391,21142,48180,0,0,1,0,1
67421,150,17393,21678;21947;25475;26503,48180,0,1,3,0,4
67422,150,17396,22096;24747;25385,48180,0,0,3,0,3
67423,150,17397,21986,48180,0,0,1,0,1
67424,150,17405,22158;22622;25957,48180,0,1,2,0,3
67425,150,17407,22513;25506;26513,48180,0,1,2,0,3
67426,150,17408,22532;22583;26516,48180,0,1,2,0,3
67427,150,17410,22980;26445;26628,48180,0,2,1,0,3
67428,150,17411,22685;22845,48180,0,0,2,0,2
67429,150,17412,22255;22703,48180,0,0,2,0,2
67430,150,17414,22840;26235;26819,48180,0,2,1,0,3
67431,150,17415,22862;23221;25313;26078;27368,48180,1,1,3,0,5
67432,150,17417,22935;25884;26058;26443,48180,0,3,1,0,4
67433,150,17418,23072;23110;25979;26069;26353;26540,48180,0,4,2,0,6
67434,150,17419,23108;23133;26838,48180,0,1,2,0,3
67435,150,17420,23089;23148;25808;26542;27009,48180,1,1,3,0,5
67436,150,17421,23758;23834;27133,48180,1,0,2,0,3
67437,150,17422,23042;23267;25431;26752,48180,0,1,3,0,4
67438,150,17423,23304;23640;25999;26578;26963,48180,0,3,2,0,5
67439,150,17424,22774;23325;25906;26172;27284,48180,1,2,2,0,5
67440,150,17425,23330;23964;26093;26200;27052,48180,1,2,2,0,5
67441,150,17426,23255;23351;26175;26378,48180,0,2,2,0,4
67442,150,17428,23233;23383;25814;26265;26846,48180,0,2,3,0,5
67443,150,17429,23398;23440,48180,0,0,2,0,2
67444,150,17430,23513;23723;26775;26872,48180,0,2,2,0,4
67445,150,17431,23246;23407;26462;26758;27014,48180,1,2,2,0,5
67446,150,17432,23412;23879,48180,0,0,2,0,2
67447,150,17433,23277;23453;27017,48180,1,0,2,0,3
67448,150,17434,23483;23916;27048,48180,1,0,2,0,3
67449,150,17435,23434;23605;26575;27295,48180,1,1,2,0,4
67450,150,17436,23520;23671;26670,48180,0,1,2,0,3
67451,150,17437,23060;23522;27024;27200,48180,2,0,2,0,4
67452,150,17438,23529;23840;27217,48180,1,0,2,0,3
67453,150,17439,23490;23536;26666;26953;27116,48180,1,2,2,0,5
67454,150,17440,23175;23538;25993,48180,0,1,2,0,3
67455,150,17441,23539;24012;26490,48180,0,1,2,0,3
67456,150,17442,23548,48180,0,0,1,0,1
67457,150,17443,23418;23561;26562,48180,0,1,2,0,3
67458,150,17444,23478;23568,48180,0,0,2,0,2
67459,150,17445,23588;23786;26689,48180,0,1,2,0,3
67460,150,17446,23883;25736;26592;27306,48180,1,1,2,0,4
67461,150,17447,23160;23604;25998;26278;26677,48180,0,3,2,0,5
67462,150,17448,23368;23606;26177,48180,0,1,2,0,3
67463,150,17449,23608;23813;26767;26865;27208;27296,48180,2,2,2,0,6
67464,150,17450,23616;23954;26003,48180,0,1,2,0,3
67465,150,17451,23654;26189;27299,48180,1,1,1,0,3
67466,150,17452,23657,48180,0,0,1,0,1
67467,150,17453,23553;23658;26868,48180,0,1,2,0,3
67468,150,17454,23514;23660;26869;26965,48180,0,2,2,0,4
67469,150,17455,23313;23670;26580;27384,48180,1,1,2,0,4
67470,150,17457,19152,48545,0,0,0,1,1
67471,150,17458,18936,48545,0,0,0,1,1
67472,150,17460,19314;19322,48545,0,0,0,2,2
67473,150,17461,19571,48545,0,0,0,1,1
67474,150,17462,19562,48545,0,0,0,1,1
67475,150,17463,19663,48545,0,0,0,1,1
67476,150,17469,19620,48545,0,0,0,1,1
67477,150,17473,20263;20315,48545,0,0,0,2,2
67478,150,17474,20063;20337,48545,0,0,0,2,2
67479,150,17478,20669;20809,48545,0,0,2,0,2
67480,150,17487,21993;22476;25405;25868;26124;26511,48545,0,3,3,0,6
67481,150,17489,22204;22809,48545,0,0,2,0,2
67482,150,17491,21869;22124;25936,48545,0,1,2,0,3
67483,150,17492,22295;22808;26142,48545,0,1,2,0,3
67484,150,17493,22442;22597,48545,0,0,2,0,2
67485,150,17494,22534;25508;25779;26042,48545,0,1,3,0,4
67486,150,17495,22746;26432,48545,0,1,1,0,2
67487,150,17496,22565;22905;25781;25872,48545,0,1,3,0,4
67488,150,17497,22842;26055,48545,0,1,1,0,2
67489,150,17499,22398;22959,48545,0,0,2,0,2
67490,150,17500,22603;22792,48545,0,0,2,0,2
67491,150,17501,22605;22962;25802;26534,48545,0,1,3,0,4
67492,150,17503,22481;22734;25297;25619;25878,48545,0,1,4,0,5
67493,150,17504,23081;25891;26541;26634,48545,0,3,1,0,4
67494,150,17505,23377;23462;25988,48545,0,1,2,0,3
67495,150,17506,22821;22886,48545,0,0,2,0,2
67496,150,17507,22924;23070;25418;25529;26625;26826,48545,0,2,4,0,6
67497,150,17509,22714;23024,48545,0,0,2,0,2
67498,150,17510,23046;23135;25632;25807,48545,0,0,4,0,4
67499,150,17511,23037;23048,48545,0,0,2,0,2
67500,150,17512,23052;23669;27126;27209,48545,2,0,2,0,4
67501,150,17513,23054;23090,48545,0,0,2,0,2
67502,150,17514,23032;23063;26249,48545,0,1,2,0,3
67503,150,17515,22692;23139;25982;26070;26745,48545,0,3,2,0,5
67504,150,17516,23158;23190;26640,48545,0,1,2,0,3
67505,150,17517,23035;23191;26548,48545,0,1,2,0,3
67506,150,17518,23193;25312;25899,48545,0,1,2,0,3
67507,150,17519,23257;23791;26193;27036,48545,1,1,2,0,4
67508,150,17520,23631;26394,48545,0,1,1,0,2
67509,150,17521,23366;23800;27038,48545,1,0,2,0,3
67510,150,17522,23227;23392;26654;27195,48545,1,1,2,0,4
67511,150,17523,23395;23554;26275;27203,48545,1,1,2,0,4
67512,150,17524,23485;26762;26952,48545,0,2,1,0,3
67513,150,17525,23069;23429;26660;26949;27015,48545,1,2,2,0,5
67514,150,17526,22847;23065;26068;26633;26740;26834,48545,0,4,2,0,6
67515,150,17527,23473;25910;26182;26567,48545,0,3,1,0,4
67516,150,17528,23815;23844;26972;27040,48545,1,1,2,0,4
67517,150,17529,23515,48545,0,0,1,0,1
67518,150,17530,23371;23526;26957;27119;27291,48545,2,1,2,0,5
67519,150,17531,23525;23565;26276;26473;27204,48545,1,2,2,0,5
67520,150,17532,23922;24053;26006;27057;27315,48545,2,1,2,0,5
67521,150,17533,23626;23890;26291;27396,48545,1,1,2,0,4
67522,150,17534,24018;27229,48545,1,0,1,0,2
67523,150,17535,23573;23886,48545,0,0,2,0,2
67524,150,17536,23686;24035;26595;26979,48545,0,2,2,0,4
67525,150,17537,23716;23980,48545,0,0,2,0,2
67526,150,17538,23700;23829;25734;26683,48545,0,1,3,0,4
67527,150,17539,23549;23914;26198;26400,48545,0,2,2,0,4
67528,150,17540,23720;23774,48545,0,0,2,0,2
67529,150,17541,23777;23967;26594;27400,48545,1,1,2,0,4
67530,150,17542,23778;24093,48545,0,0,2,0,2
67531,150,17543,19260,48910,0,0,0,1,1
67532,150,17546,19839;20092,48910,0,0,0,2,2
67533,150,17547,19504,48910,0,0,0,1,1
67534,150,17550,20177;20187,48910,0,0,0,2,2
67535,150,17553,20352,48910,0,0,0,1,1
67536,150,17558,20714,48910,0,0,1,0,1
67537,150,17561,20752,48910,0,0,1,0,1
67538,150,17569,20950;21580;25451,48910,0,0,3,0,3
67539,150,17573,21611;25921,48910,0,1,1,0,2
67540,150,17577,21639;21826;24519;24843;25926;27265,48910,1,1,4,0,6
67541,150,17581,22130,48910,0,0,1,0,1
67542,150,17582,22041;22139;24627;25379,48910,0,0,4,0,4
67543,150,17583,22279,48910,0,0,1,0,1
67544,150,17586,22394;23031;25806;26352,48910,0,1,3,0,4
67545,150,17587,21940;22469,48910,0,0,2,0,2
67546,150,17589,22482;23101;26356,48910,0,1,2,0,3
67547,150,17592,22957,48910,0,0,1,0,1
67548,150,17593,22447;22655,48910,0,0,2,0,2
67549,150,17594,22503;22739;26138,48910,0,1,2,0,3
67550,150,17595,22763;26335;26434;26816;27004,48910,1,3,1,0,5
67551,150,17597,22917;23055;26739,48910,0,1,2,0,3
67552,150,17599,22602;23163;26253,48910,0,1,2,0,3
67553,150,17600,23391;26179;26947;27194,48910,1,2,1,0,4
67554,150,17601,23009;23340;26651;26946,48910,0,2,2,0,4
67555,150,17602,22610;23051;26159;26937,48910,0,2,2,0,4
67556,150,17603,23059;23126,48910,0,0,2,0,2
67557,150,17604,23353;23546;26674;26958,48910,0,2,2,0,4
67558,150,17605,22710;23099;26355,48910,0,1,2,0,3
67559,150,17607,23234;23441;26180;26563,48910,0,2,2,0,4
67560,150,17608,23253;23336;26461,48910,0,1,2,0,3
67561,150,17609,23113;23273;26371;26455,48910,0,2,2,0,4
67562,150,17610,23301;23480;26183;26271,48910,0,2,2,0,4
67563,150,17611,22955;23331;25433;26756,48910,0,1,3,0,4
67564,150,17612,23343;23384;25908;26174,48910,0,2,2,0,4
67565,150,17613,23531;23929,48910,0,0,2,0,2
67566,150,17614,23240;23400;25815;26560;26850,48910,0,2,3,0,5
67567,150,17615,23416;23579;26390;27293,48910,1,1,2,0,4
67568,150,17616,23382;23465;25539;25989;26663;26852,48910,0,3,3,0,6
67569,150,17617,23467;23682;26091,48910,0,1,2,0,3
67570,150,17618,23504;23552;25644;26860;27026,48910,1,1,3,0,5
67571,150,17619,23335;23574;26574;26675,48910,0,2,2,0,4
67572,150,17620,23582;26004,48910,0,1,1,0,2
67573,150,17621,23888;24036;26887,48910,0,1,2,0,3
67574,150,17622,23151;23600;27122,48910,1,0,2,0,3
67575,150,17623,23603;23830;26287;26781,48910,0,2,2,0,4
67576,150,17624,23617;23668;26866,48910,0,1,2,0,3
67577,150,17625,23731;26481,48910,0,1,1,0,2
67578,150,17627,23295;23649;27383,48910,1,0,2,0,3
67579,150,17628,23287;23652;26753,48910,0,1,2,0,3
67580,150,17629,23675;23905,48910,0,0,2,0,2
67581,150,17630,23721;23939;25917;27050,48910,1,1,2,0,4
67582,150,17631,23938;23943;26487,48910,0,1,2,0,3
67583,150,17632,23643;23728;26968;27033,48910,1,1,2,0,4
67584,150,17633,23729;23932,48910,0,0,2,0,2
67585,150,17635,23762;23814;26191;26585;26875,48910,0,3,2,0,5
67586,150,17636,23535;24015,48910,0,0,2,0,2
67587,150,17637,23770;23801;26194;26486,48910,0,2,2,0,4
67588,150,17638,23807;24000;26295;26488,48910,0,2,2,0,4
67589,150,17639,23456;23828;26286,48910,0,1,2,0,3
67590,150,17640,23846;24029,48910,0,0,2,0,2
67591,150,17641,23662;23849;27138,48910,1,0,2,0,3
67592,150,17642,23854;23874;26289,48910,0,1,2,0,3
67593,150,17643,23862;26877,48910,0,1,1,0,2
67594,150,17644,19410,49275,0,0,0,1,1
67595,150,17645,19430;19634,49275,0,0,0,2,2
67596,150,17646,19746,49275,0,0,0,1,1
67597,150,17647,19175,49275,0,0,0,1,1
67598,150,17648,19343,49275,0,0,0,1,1
67599,150,17649,19340,49275,0,0,0,1,1
67600,150,17650,20035;20120,49275,0,0,0,2,2
67601,150,17651,20050,49275,0,0,0,1,1
67602,150,17657,21583;21698;25361,49275,0,0,3,0,3
67603,150,17665,22026;22038;25757,49275,0,0,3,0,3
67604,150,17670,22387;23200;26363;26642,49275,0,2,2,0,4
67605,150,17671,22167;22430;25287;25402,49275,0,0,4,0,4
67606,150,17672,22377,49275,0,0,1,0,1
67607,150,17673,22088;22116,49275,0,0,2,0,2
67608,150,17675,22632;22884;26056;26149;26731,49275,0,3,2,0,5
67609,150,17676,22767;23230,49275,0,0,2,0,2
67610,150,17677,23091;26354;26836,49275,0,2,1,0,3
67611,150,17678,22880,49275,0,0,1,0,1
67612,150,17680,22946;23219;25422;25627,49275,0,0,4,0,4
67613,150,17681,22875;23012;25805;26067,49275,0,1,3,0,4
67614,150,17682,22468,49275,0,0,1,0,1
67615,150,17683,23044;23045,49275,0,0,2,0,2
67616,150,17684,23073;23183;26074;26360,49275,0,2,2,0,4
67617,150,17685,22926;23120,49275,0,0,2,0,2
67618,150,17686,22960;26828,49275,0,1,1,0,2
67619,150,17687,22856;23403;27013;27285,49275,2,0,2,0,4
67620,150,17689,23265;23365,49275,0,0,2,0,2
67621,150,17691,22990;23404;26268;26656,49275,0,2,2,0,4
67622,150,17692,23413;23763;25913;26687,49275,0,2,2,0,4
67623,150,17694,23229;23423;25816,49275,0,0,3,0,3
67624,150,17695,23474;23937;26977,49275,0,1,2,0,3
67625,150,17696,23511;26088;26857,49275,0,2,1,0,3
67626,150,17697,23556;25729;26186,49275,0,1,2,0,3
67627,150,17698,23558;23692,49275,0,0,2,0,2
67628,150,17699,23563;26472,49275,0,1,1,0,2
67629,150,17700,23572;23779;26192;26284;26485;26688;26779;27135,49275,1,5,2,0,8
67630,150,17701,23575;23771;26283,49275,0,1,2,0,3
67631,150,17702,23551;23587;27028,49275,1,0,2,0,3
67632,150,17703,23623;23698;25733;26582;26773;26870,49275,0,3,3,0,6
67633,150,17704,23847;23994,49275,0,0,2,0,2
67634,150,17705,23502,49275,0,0,1,0,1
67635,150,17706,23644;23666;26477,49275,0,1,2,0,3
67636,150,17707,23674;24092;26494,49275,0,1,2,0,3
67637,150,17708,23676;23798;27303,49275,1,0,2,0,3
67638,150,17709,23690;24242;27066,49275,1,0,2,0,3
67639,150,17710,23410;23694;25646;26478,49275,0,1,3,0,4
67640,150,17711,23665;23706;26966;27300,49275,1,1,2,0,4
67641,150,17712,23711;24064;27387,49275,1,0,2,0,3
67642,150,17713,23919;24047;26292,49275,0,1,2,0,3
67643,150,17714,23570;23727;26000;26584,49275,0,2,2,0,4
67644,150,17715,23341;23744;26396;26482;26684;26777,49275,0,4,2,0,6
67645,150,17716,23761;23766,49275,0,0,2,0,2
67646,150,17717,23405;23769;26397,49275,0,1,2,0,3
67647,150,17718,23747;23788;26483;26873;27035;27130;27212,49275,3,2,2,0,7
67648,150,17719,23826;23971;27137,49275,1,0,2,0,3
67649,150,17720,23861;23899,49275,0,0,2,0,2
67650,150,17721,23863;24276;27070,49275,1,0,2,0,3
67651,150,17722,23877;26290;26691;27044,49275,1,2,1,0,4
67652,150,17723,23885;26196,49275,0,1,1,0,2
67653,150,17724,23898;24151;27235,49275,1,0,2,0,3
67654,150,17726,23906;23974;26786,49275,0,1,2,0,3
67655,150,17727,23912,49275,0,0,1,0,1
67656,150,17728,23928;23949;27308,49275,1,0,2,0,3
67657,150,17729,23309;23683;26771;27030,49275,1,1,2,0,4
67658,150,17730,23988;24038;26980,49275,0,1,2,0,3
67659,150,17731,19604,49640,0,0,0,1,1
67660,150,17732,18882,49640,0,0,0,1,1
67661,150,17733,19538;19609,49640,0,0,0,2,2
67662,150,17734,19585,49640,0,0,0,1,1
67663,150,17735,19991,49640,0,0,0,1,1
67664,150,17736,19479,49640,0,0,0,1,1
67665,150,17738,19992,49640,0,0,0,1,1
67666,150,17740,20126,49640,0,0,0,1,1
67667,150,17741,20326;20981,49640,0,0,1,1,2
67668,150,17747,20461,49640,0,0,0,1,1
67669,150,17753,21534,49640,0,0,1,0,1
67670,150,17754,21354;21657,49640,0,0,2,0,2
67671,150,17756,21436;21803,49640,0,0,2,0,2
67672,150,17757,21018;21835;25053,49640,0,0,3,0,3
67673,150,17760,21900,49640,0,0,1,0,1
67674,150,17761,21670;21773;25455,49640,0,0,3,0,3
67675,150,17762,22333,49640,0,0,1,0,1
67676,150,17765,22505;22857,49640,0,0,2,0,2
67677,150,17768,22749;23003;26538,49640,0,1,2,0,3
67678,150,17769,22726;25790;26136,49640,0,1,2,0,3
67679,150,17770,22807,49640,0,0,1,0,1
67680,150,17771,22408;22804;25414;26620,49640,0,1,3,0,4
67681,150,17773,22974;25885;26155,49640,0,2,1,0,3
67682,150,17774,23075;23347;27112,49640,1,0,2,0,3
67683,150,17775,23097;23419;25537;25727;27379,49640,1,0,4,0,5
67684,150,17777,23172;23519;27023,49640,1,0,2,0,3
67685,150,17779,23210;23399;26267;26381;27196,49640,1,2,2,0,5
67686,150,17780,23170;23245;25535,49640,0,0,3,0,3
67687,150,17781,23262;23621,49640,0,0,2,0,2
67688,150,17782,23381;23646,49640,0,0,2,0,2
67689,150,17783,23242;23408;26751,49640,0,1,2,0,3
67690,150,17785,23517;23802,49640,0,0,2,0,2
67691,150,17786,23505;23872;26784;27221,49640,1,1,2,0,4
67692,150,17788,23580;24135;27233,49640,1,0,2,0,3
67693,150,17789,23367;23463;25643;26384;27287,49640,1,1,3,0,5
67694,150,17791,23699;24025,49640,0,0,2,0,2
67695,150,17792,23266;23701;26871,49640,0,1,2,0,3
67696,150,17793,23726;24080;27146,49640,1,0,2,0,3
67697,150,17795,23543;23921;26881,49640,0,1,2,0,3
67698,150,17796,23845;27219,49640,1,0,1,0,2
67699,150,17797,23394;23835,49640,0,0,2,0,2
67700,150,17798,23653;23855;26288;26690,49640,0,2,2,0,4
67701,150,17799,23860;23910;25823,49640,0,0,3,0,3
67702,150,17800,23900;25916,49640,0,1,1,0,2
67703,150,17801,23911;24152,49640,0,0,2,0,2
67704,150,17802,23970;23977,49640,0,0,2,0,2
67705,150,17803,23982;24232;27328,49640,1,0,2,0,3
67706,150,17804,23990;24033;27143;27313,49640,2,0,2,0,4
67707,150,17805,24002;24017;26401;26491,49640,0,2,2,0,4
67708,150,17807,24052;24201,49640,0,0,2,0,2
67709,150,17808,24420;26908;27428,49640,1,1,1,0,3
67710,150,17809,24063;24097;26693,49640,0,1,2,0,3
67711,150,17810,23915;24408,49640,0,0,2,0,2
67712,150,17811,24095;24354,49640,0,0,2,0,2
67713,150,17813,19558,50005,0,0,0,1,1
67714,150,17814,19674,50005,0,0,0,1,1
67715,150,17815,19731;19844,50005,0,0,0,2,2
67716,150,17816,19305,50005,0,0,0,1,1
67717,150,17817,19744,50005,0,0,0,1,1
67718,150,17818,19945,50005,0,0,0,1,1
67719,150,17819,19877,50005,0,0,0,1,1
67720,150,17820,20055;20108,50005,0,0,0,2,2
67721,150,17825,20193;20545,50005,0,0,0,2,2
67722,150,17827,20945,50005,0,0,1,0,1
67723,150,17830,21054;21270,50005,0,0,2,0,2
67724,150,17832,21972;22560;25750;25955,50005,0,1,3,0,4
67725,150,17836,21630;21666;25358,50005,0,0,3,0,3
67726,150,17837,21637,50005,0,0,1,0,1
67727,150,17842,21503;21806,50005,0,0,2,0,2
67728,150,17843,22107,50005,0,0,1,0,1
67729,150,17846,21718;22037,50005,0,0,2,0,2
67730,150,17851,22535;22802,50005,0,0,2,0,2
67731,150,17853,22570;22700;25702;27376,50005,1,0,3,0,4
67732,150,17855,22494;22975;25715;27007,50005,1,0,3,0,4
67733,150,17856,22364,50005,0,0,1,0,1
67734,150,17857,22796;23216;25091;25984,50005,0,1,3,0,4
67735,150,17860,23768,50005,0,0,1,0,1
67736,150,17861,23114;23508,50005,0,0,2,0,2
67737,150,17862,23076;23116,50005,0,0,2,0,2
67738,150,17863,22773,50005,0,0,1,0,1
67739,150,17864,23197;23680;26281;26581;26770;27127;27210,50005,2,3,2,0,7
67740,150,17865,23286;24073;26493;27320;27404,50005,2,1,2,0,5
67741,150,17866,23346;23560;25730,50005,0,0,3,0,3
67742,150,17867,23417;23590;26089;27206,50005,1,1,2,0,4
67743,150,17868,23460;23471;26854,50005,0,1,2,0,3
67744,150,17869,23482;23746;26969;27034;27301,50005,2,1,2,0,5
67745,150,17870,23492;23661;25990;26468;26954;27288,50005,1,3,2,0,6
67746,150,17871,23215;23510;26386;26570;26668;27290;27382,50005,2,3,2,0,7
67747,150,17872,23361;23516;26387;27118,50005,1,1,2,0,4
67748,150,17874,23533;24070;27058;27319,50005,2,0,2,0,4
67749,150,17875,23564;23941,50005,0,0,2,0,2
67750,150,17876,23581;23995;27142,50005,1,0,2,0,3
67751,150,17877,23843;23870;26876;26973;27218,50005,1,2,2,0,5
67752,150,17878,23613;23876;25915;26878;27139;27222;27393,50005,3,2,2,0,7
67753,150,17879,23457;23477,50005,0,0,2,0,2
67754,150,17880,23627;23679;25435;26280;26769,50005,0,2,3,0,5
67755,150,17882,23745;23822;27129,50005,1,0,2,0,3
67756,150,17883,23797;24050;26296,50005,0,1,2,0,3
67757,150,17884,23689;23851;26195,50005,0,1,2,0,3
67758,150,17885,23725;23867;26590;26783;26974,50005,0,3,2,0,5
67759,150,17886,23903;23909;26389;27047,50005,1,1,2,0,4
67760,150,17887,24105;24295;27332,50005,1,0,2,0,3
67761,150,17888,23931;27398,50005,1,0,1,0,2
67762,150,17889,23677;24392;26208;27250;27425,50005,2,1,2,0,5
67763,150,17890,23481;23950;26788;27051,50005,1,1,2,0,4
67764,150,17891,23986;24407;26304,50005,0,1,2,0,3
67765,150,17892,23996;26884,50005,0,1,1,0,2
67766,150,17893,24041;26005;26981;27056,50005,1,2,1,0,4
67767,150,17894,23811;24048;26789;26888,50005,0,2,2,0,4
67768,150,17896,24056;24225;26897,50005,0,1,2,0,3
67769,150,17897,24273,50005,0,0,1,0,1
67770,150,17899,23925;24077,50005,0,0,2,0,2
67771,150,17900,23737;24079;26096;26597;26889;26983,50005,0,4,2,0,6
67772,150,17901,24091;24104,50005,0,0,2,0,2
67773,150,17902,24074;24117,50005,0,0,2,0,2
67774,150,17903,24237;24432;27255,50005,1,0,2,0,3
67775,150,17904,24144;24267;27069,50005,1,0,2,0,3
67776,150,17905,24186;24215;26406;27240;27327,50005,2,1,2,0,5
67777,150,17906,24192;24200;26700;27415,50005,1,1,2,0,4
67778,150,17907,19297,50370,0,0,0,1,1
67779,150,17909,19982,50370,0,0,0,1,1
67780,150,17910,19806,50370,0,0,0,1,1
67781,150,17916,20713;21022,50370,0,0,2,0,2
67782,150,17920,21160,50370,0,0,1,0,1
67783,150,17922,21328;21950;25671,50370,0,0,3,0,3
67784,150,17923,21151;21359,50370,0,0,2,0,2
67785,150,17928,21834,50370,0,0,1,0,1
67786,150,17930,21544;21926;26211,50370,0,1,2,0,3
67787,150,17931,21756;21876,50370,0,0,2,0,2
67788,150,17932,21470;21696,50370,0,0,2,0,2
67789,150,17933,22077;22290,50370,0,0,2,0,2
67790,150,17934,22338;26417,50370,0,1,1,0,2
67791,150,17935,22222;22735;25705,50370,0,0,3,0,3
67792,150,17938,22931,50370,0,0,1,0,1
67793,150,17940,22166;22412,50370,0,0,2,0,2
67794,150,17942,22488;22806,50370,0,0,2,0,2
67795,150,17943,22549,50370,0,0,1,0,1
67796,150,17948,22930;25626;25713,50370,0,0,3,0,3
67797,150,17949,22988;26065;26245;26737,50370,0,3,1,0,4
67798,150,17950,22998;23409,50370,0,0,2,0,2
67799,150,17952,23029;23036;25890;26632;26830,50370,0,3,2,0,5
67800,150,17953,23039;23850;25914;26588;27391,50370,1,2,2,0,5
67801,150,17954,22772;23058;26160;26539,50370,0,2,2,0,4
67802,150,17955,23167;23569;26277;27205,50370,1,1,2,0,4
67803,150,17956,23186;23345;26558,50370,0,1,2,0,3
67804,150,17957,23231;23591;26676;26863;27294,50370,1,2,2,0,5
67805,150,17959,23308;23625;26577,50370,0,1,2,0,3
67806,150,17960,23312;24088,50370,0,0,2,0,2
67807,150,17961,23385;23709;26092;26479;26774;27128,50370,1,3,2,0,6
67808,150,17962,23431;23795;27136,50370,1,0,2,0,3
67809,150,17963,23586;23818;27389,50370,1,0,2,0,3
67810,150,17964,23194,50370,0,0,1,0,1
67811,150,17965,23387;23415;26848,50370,0,1,2,0,3
67812,150,17966,23228;23454;26085;26565;26662;26851,50370,0,4,2,0,6
67813,150,17967,23437;23494;25991;26763;27199,50370,1,2,2,0,5
67814,150,17968,23542;26185;26470;26573;26859;27202,50370,1,4,1,0,6
67815,150,17969,23615;24102,50370,0,0,2,0,2
67816,150,17971,23730;23979;26883;27227,50370,1,1,2,0,4
67817,150,17972,24101;26984,50370,0,1,1,0,2
67818,150,17973,23784;24302;26100,50370,0,1,2,0,3
67819,150,17974,23785;24058;26492,50370,0,1,2,0,3
67820,150,17975,23397;23794;27037;27388,50370,2,0,2,0,4
67821,150,17976,23594;23806,50370,0,0,2,0,2
67822,150,17977,23284;23824;26780;27216,50370,1,1,2,0,4
67823,150,17978,23792;23839;26398;27390,50370,1,1,2,0,4
67824,150,17979,23848,50370,0,0,1,0,1
67825,150,17980,23708;23858;26583;27386,50370,1,1,2,0,4
67826,150,17981,23859;24305;26797,50370,0,1,2,0,3
67827,150,17982,24378,50370,0,0,1,0,1
67828,150,17983,23887;26593;27395,50370,1,1,1,0,3
67829,150,17984,23897;24216,50370,0,0,2,0,2
67830,150,17985,23913;24045;27402,50370,1,0,2,0,3
67831,150,17986,23923;23942;26293;26787;27224,50370,1,2,2,0,5
67832,150,17987,23945;24296;26302;26409,50370,0,2,2,0,4
67833,150,17988,23632;24228;26299;26793,50370,0,2,2,0,4
67834,150,17989,23985;24350;26498;26906,50370,0,2,2,0,4
67835,150,17990,23930;23992,50370,0,0,2,0,2
67836,150,17991,23999;24173,50370,0,0,2,0,2
67837,150,17992,23889;24010,50370,0,0,2,0,2
67838,150,17993,23719;24061;26403;27317,50370,1,1,2,0,4
67839,150,17994,24082;24278;27071;27153,50370,2,0,2,0,4
67840,150,17995,24099;27322,50370,1,0,1,0,2
67841,150,17996,24445;26706,50370,0,1,1,0,2
67842,150,17997,24501;27080,50370,1,0,1,0,2
67843,150,17998,24123,50370,0,0,1,0,1
67844,150,17999,24142;24448;26696,50370,0,1,2,0,3
67845,150,18000,24401;27162,50370,1,0,1,0,2
67846,150,18001,24163;24349,50370,0,0,2,0,2
67847,150,18002,24166;24385,50370,0,0,2,0,2
67848,150,18003,23976;24167;27410,50370,1,0,2,0,3
67849,150,18004,24463;26500,50370,0,1,1,0,2
67850,150,18005,24197;24520,50370,0,0,2,0,2
67851,150,18006,24266;24370;26907,50370,0,1,2,0,3
67852,150,18007,24367,50370,0,0,1,0,1
67853,150,18009,24136;24289;26099,50370,0,1,2,0,3
67854,150,18010,24202;24308;27416,50370,1,0,2,0,3
67855,150,18011,24009;24313;26206;26901,50370,0,2,2,0,4
67856,150,18012,19863,50735,0,0,0,1,1
67857,150,18016,19983,50735,0,0,0,1,1
67858,150,18017,19988,50735,0,0,0,1,1
67859,150,18018,20006,50735,0,0,0,1,1
67860,150,18019,19890,50735,0,0,0,1,1
67861,150,18020,19645,50735,0,0,0,1,1
67862,150,18021,19833,50735,0,0,0,1,1
67863,150,18025,20462,50735,0,0,0,1,1
67864,150,18026,20992,50735,0,0,1,0,1
67865,150,18027,20539,50735,0,0,0,1,1
67866,150,18030,20746;20801,50735,0,0,2,0,2
67867,150,18031,21055;21182,50735,0,0,2,0,2
67868,150,18034,21263;21316,50735,0,0,2,0,2
67869,150,18041,21161;21291,50735,0,0,2,0,2
67870,150,18045,21226;21319,50735,0,0,2,0,2
67871,150,18048,22163,50735,0,0,1,0,1
67872,150,18049,22313;22314,50735,0,0,2,0,2
67873,150,18052,22694;23433,50735,0,0,2,0,2
67874,150,18054,22443;22801;25795;27185,50735,1,0,3,0,4
67875,150,18057,22968;23205;26364;26550;27283,50735,1,2,2,0,5
67876,150,18059,23066;23619,50735,0,0,2,0,2
67877,150,18060,23088,50735,0,0,1,0,1
67878,150,18062,23254;23390,50735,0,0,2,0,2
67879,150,18063,23274;26081,50735,0,1,1,0,2
67880,150,18064,23281;23338;26264;26557;27111,50735,1,2,2,0,5
67881,150,18065,23342;23634;26962;27029,50735,1,1,2,0,4
67882,150,18066,23425;25728;25986;26464;27197,50735,1,2,2,0,5
67883,150,18067,23435;23476;26661,50735,0,1,2,0,3
67884,150,18068,23389;23458;27286,50735,1,0,2,0,3
67885,150,18069,23628;23630,50735,0,0,2,0,2
67886,150,18071,23602;23755;26686,50735,0,1,2,0,3
67887,150,18073,24030;26095;26886,50735,0,2,1,0,3
67888,150,18074,23703;24075;27145,50735,1,0,2,0,3
67889,150,18075,24377;26499,50735,0,1,1,0,2
67890,150,18076,24447,50735,0,0,1,0,1
67891,150,18077,23612,50735,0,0,1,0,1
67892,150,18079,23743;24189;27063,50735,1,0,2,0,3
67893,150,18080,23787;24188;27062,50735,1,0,2,0,3
67894,150,18081,23710;23816;26285,50735,0,1,2,0,3
67895,150,18082,23856;23895;26692;26975,50735,0,2,2,0,4
67896,150,18083,23868;24126;27406,50735,1,0,2,0,3
67897,150,18084,23891;24153;26891;27408,50735,1,1,2,0,4
67898,150,18085,23920;24335;26990,50735,0,1,2,0,3
67899,150,18086,23924;24248;26794;27242,50735,1,1,2,0,4
67900,150,18087,23152;23927;26199;27307;27397,50735,2,1,2,0,5
67901,150,18088,23948;24293;27243,50735,1,0,2,0,3
67902,150,18089,24118;24526,50735,0,0,2,0,2
67903,150,18090,23963;23991;27141,50735,1,0,2,0,3
67904,150,18091,24051;27314,50735,1,0,1,0,2
67905,150,18092,24381;27336,50735,1,0,1,0,2
67906,150,18093,23645;23892,50735,0,0,2,0,2
67907,150,18094,23833;27042;27305,50735,2,0,1,0,3
67908,150,18095,24007;24241,50735,0,0,2,0,2
67909,150,18096,24019;24253,50735,0,0,2,0,2
67910,150,18097,24071;24157;26892;27324,50735,1,1,2,0,4
67911,150,18098,24072;24502;26994,50735,0,1,2,0,3
67912,150,18099,24122;24281,50735,0,0,2,0,2
67913,150,18100,24113;24415;27337,50735,1,0,2,0,3
67914,150,18101,24124;24723;27171;27345,50735,2,0,2,0,4
67915,150,18102,24031;24127;26978,50735,0,1,2,0,3
67916,150,18103,23823;24130,50735,0,0,2,0,2
67917,150,18104,24644;27436,50735,1,0,1,0,2
67918,150,18105,24165;24609,50735,0,0,2,0,2
67919,150,18106,24103;24204;27405,50735,1,0,2,0,3
67920,150,18107,23981;24476;26305;26909,50735,0,2,2,0,4
67921,150,18108,23944;24244;27067;27152;27241,50735,3,0,2,0,5
67922,150,18109,24257;24717,50735,0,0,2,0,2
67923,150,18110,23740;24177;26495;27061;27147;27411,50735,3,1,2,0,6
67924,150,18111,24269;24597,50735,0,0,2,0,2
67925,150,18112,24285;24458;27340,50735,1,0,2,0,3
67926,150,18113,24301;24724,50735,0,0,2,0,2
67927,150,18114,24422;24662;27089,50735,1,0,2,0,3
67928,150,18115,24325;24575,50735,0,0,2,0,2
67929,150,18116,24231;24328;27072;27244;27422,50735,3,0,2,0,5
67930,150,18117,24040;24379;27074,50735,1,0,2,0,3
67931,150,18118,24382;24743,50735,0,0,2,0,2
67932,150,18119,24314;24409;26412;27253,50735,1,1,2,0,4
67933,150,18120,24421;24540;26708,50735,0,1,2,0,3
67934,150,18121,19929;20123,51100,0,0,0,2,2
67935,150,18124,20312,51100,0,0,0,1,1
67936,150,18126,19947,51100,0,0,0,1,1
67937,150,18130,20816,51100,0,0,1,0,1
67938,150,18131,20872,51100,0,0,1,0,1
67939,150,18133,20530,51100,0,0,0,1,1
67940,150,18134,21057;21596,51100,0,0,2,0,2
67941,150,18137,21191;21224,51100,0,0,2,0,2
67942,150,18138,20793;21228,51100,0,0,2,0,2
67943,150,18146,21463,51100,0,0,1,0,1
67944,150,18148,21462,51100,0,0,1,0,1
67945,150,18152,21880;22014,51100,0,0,2,0,2
67946,150,18153,22227;22401,51100,0,0,2,0,2
67947,150,18157,22483;22679,51100,0,0,2,0,2
67948,150,18159,22824;23134;25636,51100,0,0,3,0,3
67949,150,18160,22776;23282;25811;26170;26373,51100,0,2,3,0,5
67950,150,18161,22789;23140;26163;26839;26938,51100,0,3,2,0,5
67951,150,18163,22628,51100,0,0,1,0,1
67952,150,18164,22644;22888;26344,51100,0,1,2,0,3
67953,150,18165,22981,51100,0,0,1,0,1
67954,150,18167,23307,51100,0,0,1,0,1
67955,150,18168,23356,51100,0,0,1,0,1
67956,150,18169,23393;23998,51100,0,0,2,0,2
67957,150,18170,23461;26566,51100,0,1,1,0,2
67958,150,18171,23374;23547;26959;27120;27292,51100,2,1,2,0,5
67959,150,18173,24006;27228;27401,51100,2,0,1,0,3
67960,150,18174,23401;23622;27124,51100,1,0,2,0,3
67961,150,18176,23509;24005;27054,51100,1,0,2,0,3
67962,150,18177,23736;24178;26599;27148;27237,51100,2,1,2,0,5
67963,150,18178,23566;23754;26685,51100,0,1,2,0,3
67964,150,18179,23593;23789;27215,51100,1,0,2,0,3
67965,150,18180,23831;24642;27435,51100,1,0,2,0,3
67966,150,18181,23722;23896;26197;26399;26785,51100,0,3,2,0,5
67967,150,18182,23741;23907,51100,0,0,2,0,2
67968,150,18183,23935;24140;26098;27060;27407,51100,2,1,2,0,5
67969,150,18184,23953;24270;26300,51100,0,1,2,0,3
67970,150,18185,24008;26489;27055;27311,51100,2,1,1,0,4
67971,150,18186,23965;24524;26608,51100,0,1,2,0,3
67972,150,18187,23697;23978;25737;27226,51100,1,0,3,0,4
67973,150,18188,23820;23983;26094,51100,0,1,2,0,3
67974,150,18189,24020;24310;27154,51100,1,0,2,0,3
67975,150,18190,23901;24021,51100,0,0,2,0,2
67976,150,18191,24688;27168,51100,1,0,1,0,2
67977,150,18192,23819;24129,51100,0,0,2,0,2
67978,150,18193,24180;24537;26914,51100,0,1,2,0,3
67979,150,18194,24218;24788,51100,0,0,2,0,2
67980,150,18195,24656,51100,0,0,1,0,1
67981,150,18196,24316;27155,51100,1,0,1,0,2
67982,150,18197,24141;24380,51100,0,0,2,0,2
67983,150,18198,24346;26703;27073;27423,51100,2,1,1,0,4
67984,150,18199,24521;26607;26912,51100,0,2,1,0,3
67985,150,18200,24366;24652;27088,51100,1,0,2,0,3
67986,150,18201,24384;24475;26411;26798;26991;27160,51100,1,3,2,0,6
67987,150,18202,24402;24628,51100,0,0,2,0,2
67988,150,18203,24128;24404;27252,51100,1,0,2,0,3
67989,150,18204,24004;24425,51100,0,0,2,0,2
67990,150,18206,24451;27338;27430,51100,2,0,1,0,3
67991,150,18207,24081;24482,51100,0,0,2,0,2
67992,150,18208,24416;24489;27341,51100,1,0,2,0,3
67993,150,18209,24491;26910,51100,0,1,1,0,2
67994,150,18210,24503;24760;26714,51100,0,1,2,0,3
67995,150,18211,24506;24640;27163,51100,1,0,2,0,3
67996,150,18212,24721;24869;27170,51100,1,0,2,0,3
67997,150,18213,24511;24528,51100,0,0,2,0,2
67998,150,18214,19818,51465,0,0,0,1,1
67999,150,18218,20200,51465,0,0,0,1,1
68000,150,18220,20548;20932,51465,0,0,1,1,2
68001,150,18223,20994,51465,0,0,1,0,1
68002,150,18226,21146,51465,0,0,1,0,1
68003,150,18229,21587;21996;26109,51465,0,1,2,0,3
68004,150,18230,21616,51465,0,0,1,0,1
68005,150,18232,21652,51465,0,0,1,0,1
68006,150,18233,21908,51465,0,0,1,0,1
68007,150,18234,22197,51465,0,0,1,0,1
68008,150,18235,21763;21862,51465,0,0,2,0,2
68009,150,18237,22071,51465,0,0,1,0,1
68010,150,18239,22701,51465,0,0,1,0,1
68011,150,18240,22594;22641;26229;26331,51465,0,2,2,0,4
68012,150,18241,22725,51465,0,0,1,0,1
68013,150,18242,22389,51465,0,0,1,0,1
68014,150,18243,22360;22938,51465,0,0,2,0,2
68015,150,18244,22647,51465,0,0,1,0,1
68016,150,18245,23000;23128,51465,0,0,2,0,2
68017,150,18247,23079,51465,0,0,1,0,1
68018,150,18248,22816,51465,0,0,1,0,1
68019,150,18249,23162,51465,0,0,1,0,1
68020,150,18250,23176;23610;26188;26679;27297,51465,1,2,2,0,5
68021,150,18251,22844;23198;26362;26940,51465,0,2,2,0,4
68022,150,18252,22681,51465,0,0,1,0,1
68023,150,18253,23495,51465,0,0,1,0,1
68024,150,18254,22940;23300;26845;27109,51465,1,1,2,0,4
68025,150,18255,23263;23444;27016,51465,1,0,2,0,3
68026,150,18258,23285,51465,0,0,1,0,1
68027,150,18259,23438;23624;25732;26393,51465,0,1,3,0,4
68028,150,18260,23271;23447,51465,0,0,2,0,2
68029,150,18261,23455;23750,51465,0,0,2,0,2
68030,150,18262,23468;23803;27039,51465,1,0,2,0,3
68031,150,18263,23506;24171,51465,0,0,2,0,2
68032,150,18264,23530;23685;26681,51465,0,1,2,0,3
68033,150,18265,23599;23687,51465,0,0,2,0,2
68034,150,18266,23360;23611;26961,51465,0,1,2,0,3
68035,150,18267,23695;23733;26282,51465,0,1,2,0,3
68036,150,18268,23956;27140,51465,1,0,1,0,2
68037,150,18269,23776;24213;26792,51465,0,1,2,0,3
68038,150,18270,23782;24395;26603,51465,0,1,2,0,3
68039,150,18271,23446;23933;26976,51465,0,1,2,0,3
68040,150,18272,23836;24172,51465,0,0,2,0,2
68041,150,18273,23812,51465,0,0,1,0,1
68042,150,18274,23878;24100;27045;27394,51465,2,0,2,0,4
68043,150,18275,23562,51465,0,0,1,0,1
68044,150,18276,23959;24181;26987,51465,0,1,2,0,3
68045,150,18277,23969;24195;26698;27064;27413,51465,2,1,2,0,5
68046,150,18278,24107;24624,51465,0,0,2,0,2
68047,150,18279,23838;24114;27232,51465,1,0,2,0,3
68048,150,18280,24120;24374;27159,51465,1,0,2,0,3
68049,150,18281,24150;24650;27087,51465,1,0,2,0,3
68050,150,18282,24191;26202,51465,0,1,1,0,2
68051,150,18283,24190;24509,51465,0,0,2,0,2
68052,150,18284,24217;24541;26803;27081,51465,1,1,2,0,4
68053,150,18285,24307,51465,0,0,1,0,1
68054,150,18286,24323;24581,51465,0,0,2,0,2
68055,150,18287,24333;24373;27245,51465,1,0,2,0,3
68056,150,18288,24162;24339;26904,51465,0,1,2,0,3
68057,150,18289,24545;26915;27433,51465,1,1,1,0,3
68058,150,18290,24085,51465,0,0,1,0,1
68059,150,18291,24342;24734;26713,51465,0,1,2,0,3
68060,150,18292,24446;26413;26604,51465,0,2,1,0,3
68061,150,18293,24413;24950;27001,51465,0,1,2,0,3
68062,150,18294,24436;24949;27357,51465,1,0,2,0,3
68063,150,18295,24406,51465,0,0,1,0,1
68064,150,18296,24398;24449;27161,51465,1,0,2,0,3
68065,150,18297,24396;24603,51465,0,0,2,0,2
68066,150,18298,24467;24795,51465,0,0,2,0,2
68067,150,18299,24212;24470,51465,0,0,2,0,2
68068,150,18300,24369;26410,51465,0,1,1,0,2
68069,150,18301,24478;24612;27259,51465,1,0,2,0,3
68070,150,18302,24680;24857;26923,51465,0,1,2,0,3
68071,150,18303,24513;24874;27351,51465,1,0,2,0,3
68072,150,18304,24543;24758,51465,0,0,2,0,2
68073,150,18305,24510;24564;26995,51465,0,1,2,0,3
68074,150,18306,24571;24844;27092,51465,1,0,2,0,3
68075,150,18307,24332;24937,51465,0,0,2,0,2
68076,150,18308,24579;24693;27263,51465,1,0,2,0,3
68077,150,18309,19927,51830,0,0,0,1,1
68078,150,18310,20324,51830,0,0,0,1,1
68079,150,18311,20345,51830,0,0,0,1,1
68080,150,18312,20346,51830,0,0,0,1,1
68081,150,18314,20565;20712,51830,0,0,1,1,2
68082,150,18315,20800,51830,0,0,1,0,1
68083,150,18318,20822,51830,0,0,1,0,1
68084,150,18319,20647,51830,0,0,1,0,1
68085,150,18321,21183,51830,0,0,1,0,1
68086,150,18322,20848,51830,0,0,1,0,1
68087,150,18325,21661,51830,0,0,1,0,1
68088,150,18328,22040,51830,0,0,1,0,1
68089,150,18332,22278,51830,0,0,1,0,1
68090,150,18333,22215,51830,0,0,1,0,1
68091,150,18334,22507;22683;25961,51830,0,1,2,0,3
68092,150,18339,22686,51830,0,0,1,0,1
68093,150,18340,22729,51830,0,0,1,0,1
68094,150,18344,22470,51830,0,0,1,0,1
68095,150,18346,23033;23164;26254;26359,51830,0,2,2,0,4
68096,150,18347,23121;23742;26776,51830,0,1,2,0,3
68097,150,18349,23667;26090,51830,0,1,1,0,2
68098,150,18353,23488;23817;27041,51830,1,0,2,0,3
68099,150,18354,23375;23707;25735;26967,51830,0,1,3,0,4
68100,150,18355,23578;24022,51830,0,0,2,0,2
68101,150,18357,23629;23751;25647;27132;27213;27302,51830,3,0,3,0,6
68102,150,18359,23681,51830,0,0,1,0,1
68103,150,18360,23809;27304,51830,1,0,1,0,2
68104,150,18362,23884;24065;26596;27403,51830,1,1,2,0,4
68105,150,18364,23947;24133;26695;27323,51830,1,1,2,0,4
68106,150,18365,23793;23962;27399,51830,1,0,2,0,3
68107,150,18366,23972;23984;27053;27310,51830,2,0,2,0,4
68108,150,18367,23790;24282;26301,51830,0,1,2,0,3
68109,150,18368,24016;24604,51830,0,0,2,0,2
68110,150,18369,24220;24400,51830,0,0,2,0,2
68111,150,18370,24111;24883;27173,51830,1,0,2,0,3
68112,150,18371,24115;24279;26790;27059,51830,1,1,2,0,4
68113,150,18372,24131;24265;26702;27068,51830,1,1,2,0,4
68114,150,18373,24138,51830,0,0,1,0,1
68115,150,18374,23908;24139,51830,0,0,2,0,2
68116,150,18375,24160;24355;27158,51830,1,0,2,0,3
68117,150,18376,23442;24185;26894;27149;27238;27412,51830,3,1,2,0,6
68118,150,18377,24203;24474,51830,0,0,2,0,2
68119,150,18378,24147;24207;26405;26701;26895;26988;27150;27417,51830,2,4,2,0,8
68120,150,18379,24261;24504,51830,0,0,2,0,2
68121,150,18380,24360;27335,51830,1,0,1,0,2
68122,150,18381,24306;24479,51830,0,0,2,0,2
68123,150,18382,24108;24326;26601;26903,51830,0,2,2,0,4
68124,150,18383,24389;24990,51830,0,0,2,0,2
68125,150,18384,24854,51830,0,0,1,0,1
68126,150,18385,24324;24424,51830,0,0,2,0,2
68127,150,18386,24690,51830,0,0,1,0,1
68128,150,18387,24435,51830,0,0,1,0,1
68129,150,18388,24461;24534,51830,0,0,2,0,2
68130,150,18389,24414;24542,51830,0,0,2,0,2
68131,150,18390,24544;24877,51830,0,0,2,0,2
68132,150,18391,24559;24748,51830,0,0,2,0,2
68133,150,18392,24560;24886,51830,0,0,2,0,2
68134,150,18393,24570;24711,51830,0,0,2,0,2
68135,150,18394,24497;24595;26917,51830,0,1,2,0,3
68136,150,18395,24602;24960;27434,51830,1,0,2,0,3
68137,150,18396,24645;24867,51830,0,0,2,0,2
68138,150,18397,24646;24850,51830,0,0,2,0,2
68139,150,18398,24322;24845,51830,0,0,2,0,2
68140,150,18399,24664;24775;26804;27437,51830,1,1,2,0,4
68141,150,18401,24387;24692,51830,0,0,2,0,2
68142,150,18402,24550;24737;27082,51830,1,0,2,0,3
68143,150,18404,24554;24745,51830,0,0,2,0,2
68144,150,18405,24750;24969,51830,0,0,2,0,2
68145,150,18406,20182,52195,0,0,0,1,1
68146,150,18408,19906,52195,0,0,0,1,1
68147,150,18409,20625,52195,0,0,0,1,1
68148,150,18410,20309,52195,0,0,0,1,1
68149,150,18411,19850,52195,0,0,0,1,1
68150,150,18412,20607,52195,0,0,0,1,1
68151,150,18413,20694,52195,0,0,1,0,1
68152,150,18414,20763,52195,0,0,1,0,1
68153,150,18417,20640,52195,0,0,1,0,1
68154,150,18418,20782,52195,0,0,1,0,1
68155,150,18420,21027,52195,0,0,1,0,1
68156,150,18421,21000,52195,0,0,1,0,1
68157,150,18426,21440,52195,0,0,1,0,1
68158,150,18430,21108,52195,0,0,1,0,1
68159,150,18432,22153,52195,0,0,1,0,1
68160,150,18436,22297;22586;25513;26227,52195,0,1,3,0,4
68161,150,18438,22368,52195,0,0,1,0,1
68162,150,18439,22984;23873;27392,52195,1,0,2,0,3
68163,150,18440,23199;23310;26376,52195,0,1,2,0,3
68164,150,18441,22629;23224;26749;27011,52195,1,1,2,0,4
68165,150,18442,23083;23252;25092;26369;26645,52195,0,2,3,0,5
68166,150,18443,23294;23430;26465;26950,52195,0,2,2,0,4
68167,150,18445,23469;23475;26664;26761;26853,52195,0,3,2,0,5
68168,150,18446,23534;24094;27230,52195,1,0,2,0,3
68169,150,18447,23577;24312;27333,52195,1,0,2,0,3
68170,150,18448,23268;23489;26941;27108,52195,1,1,2,0,4
68171,150,18449,24187;27239;27325,52195,2,0,1,0,3
68172,150,18450,23651;24252,52195,0,0,2,0,2
68173,150,18452,23821;24364;27246,52195,1,0,2,0,3
68174,150,18453,23842;24090,52195,0,0,2,0,2
68175,150,18454,23864;24199;26699,52195,0,1,2,0,3
68176,150,18455,23880;24060;27316,52195,1,0,2,0,3
68177,150,18456,23902;24251,52195,0,0,2,0,2
68178,150,18457,23363;23583;25996;26475;26862,52195,0,3,2,0,5
68179,150,18458,23934;27049,52195,1,0,1,0,2
68180,150,18459,23961;24246,52195,0,0,2,0,2
68181,150,18460,23904;24372,52195,0,0,2,0,2
68182,150,18461,24039;24155;26297;26404,52195,0,2,2,0,4
68183,150,18462,24174;24393;26993;27426,52195,1,1,2,0,4
68184,150,18463,24175;24222,52195,0,0,2,0,2
68185,150,18464,24227;24388;26992;27248,52195,1,1,2,0,4
68186,150,18465,24243;24568,52195,0,0,2,0,2
68187,150,18466,24250;24292,52195,0,0,2,0,2
68188,150,18467,24256;24573;27164,52195,1,0,2,0,3
68189,150,18468,24299;24321;26902,52195,0,1,2,0,3
68190,150,18469,24315;24625,52195,0,0,2,0,2
68191,150,18470,24755;24978;27003,52195,0,1,2,0,3
68192,150,18471,24418;24726,52195,0,0,2,0,2
68193,150,18472,24456;24710,52195,0,0,2,0,2
68194,150,18473,24356;24586,52195,0,0,2,0,2
68195,150,18474,24516;24784,52195,0,0,2,0,2
68196,150,18475,24318;24527;26707;26913,52195,0,2,2,0,4
68197,150,18476,24535;25127,52195,0,0,2,0,2
68198,150,18477,24552;27083,52195,1,0,1,0,2
68199,150,18478,24569;24668;26711,52195,0,1,2,0,3
68200,150,18479,24329;24585;27156,52195,1,0,2,0,3
68201,150,18480,24466;24587;27166,52195,1,0,2,0,3
68202,150,18481,24386;24594,52195,0,0,2,0,2
68203,150,18482,24359,52195,0,0,1,0,1
68204,150,18483,24460,52195,0,0,1,0,1
68205,150,18484,24722;27090,52195,1,0,1,0,2
68206,150,18485,24523;24702,52195,0,0,2,0,2
68207,150,18486,24620;24961;27002,52195,0,1,2,0,3
68208,150,18487,24630;27343,52195,1,0,1,0,2
68209,150,18488,24639;24940,52195,0,0,2,0,2
68210,150,18489,24661,52195,0,0,1,0,1
68211,150,18490,24923,52195,0,0,1,0,1
68212,150,18491,25148;25231,52195,0,0,2,0,2
68213,150,18492,24712;24859,52195,0,0,2,0,2
68214,150,18493,24338;24718,52195,0,0,2,0,2
68215,150,18494,24728;24878,52195,0,0,2,0,2
68216,150,18495,24730,52195,0,0,1,0,1
68217,150,18496,24655;24736,52195,0,0,2,0,2
68218,150,18497,24368;24757,52195,0,0,2,0,2
68219,150,18498,24485;24759;27078,52195,1,0,2,0,3
68220,150,18499,24765;24891,52195,0,0,2,0,2
68221,150,18500,24771,52195,0,0,1,0,1
68222,150,18501,25101;27100,52195,1,0,1,0,2
68223,150,18502,25071,52195,0,0,1,0,1
68224,150,18503,24829;27349,52195,1,0,1,0,2
68225,150,18504,24848;25084,52195,0,0,2,0,2
68226,150,18505,24861;25094;27366,52195,1,0,2,0,3
68227,150,18507,20599,52560,0,0,0,1,1
68228,150,18509,20525,52560,0,0,0,1,1
68229,150,18512,20478,52560,0,0,0,1,1
68230,150,18514,21124,52560,0,0,1,0,1
68231,150,18515,21042,52560,0,0,1,0,1
68232,150,18519,20861,52560,0,0,1,0,1
68233,150,18520,21457,52560,0,0,1,0,1
68234,150,18523,21859;21882,52560,0,0,2,0,2
68235,150,18527,22285;22711,52560,0,0,2,0,2
68236,150,18528,21671;22039,52560,0,0,2,0,2
68237,150,18529,22340,52560,0,0,1,0,1
68238,150,18531,22390,52560,0,0,1,0,1
68239,150,18533,22251,52560,0,0,1,0,1
68240,150,18536,22697;26133,52560,0,1,1,0,2
68241,150,18538,22855,52560,0,0,1,0,1
68242,150,18540,22937;23370,52560,0,0,2,0,2
68243,150,18541,23380,52560,0,0,1,0,1
68244,150,18542,22991,52560,0,0,1,0,1
68245,150,18543,23411;26463;26561;26657,52560,0,3,1,0,4
68246,150,18544,23589;23832;26001,52560,0,1,2,0,3
68247,150,18545,23376,52560,0,0,1,0,1
68248,150,18546,23735;23748;26484;26874;27131,52560,1,2,2,0,5
68249,150,18547,23825;24255;26408;26795;27419,52560,1,2,2,0,5
68250,150,18548,23958,52560,0,0,1,0,1
68251,150,18549,24011;24158;26201;27409,52560,1,1,2,0,4
68252,150,18550,24334,52560,0,0,1,0,1
68253,150,18551,23702;24057;27032;27211,52560,2,0,2,0,4
68254,150,18552,24087,52560,0,0,1,0,1
68255,150,18553,23957;24112,52560,0,0,2,0,2
68256,150,18554,23810;23871,52560,0,0,2,0,2
68257,150,18555,24198;24441;26705;27256,52560,1,1,2,0,4
68258,150,18556,24249;24840,52560,0,0,2,0,2
68259,150,18557,24274;24741,52560,0,0,2,0,2
68260,150,18558,24856,52560,0,0,1,0,1
68261,150,18559,24309;26205;27421,52560,1,1,1,0,3
68262,150,18560,24320;24477;27334,52560,1,0,2,0,3
68263,150,18561,24327;24906;27354,52560,1,0,2,0,3
68264,150,18562,24259;24410;27254,52560,1,0,2,0,3
68265,150,18563,24412;24708;26712;27169,52560,1,1,2,0,4
68266,150,18564,24464;27077,52560,1,0,1,0,2
68267,150,18565,24493;24870,52560,0,0,2,0,2
68268,150,18566,23894;24557,52560,0,0,2,0,2
68269,150,18567,24538;24778,52560,0,0,2,0,2
68270,150,18568,24907;26925,52560,0,1,1,0,2
68271,150,18569,24572;24799,52560,0,0,2,0,2
68272,150,18570,24591;24791,52560,0,0,2,0,2
68273,150,18571,24871,52560,0,0,1,0,1
68274,150,18572,24606,52560,0,0,1,0,1
68275,150,18573,24643;24863,52560,0,0,2,0,2
68276,150,18574,24651;24805,52560,0,0,2,0,2
68277,150,18575,24706;24986,52560,0,0,2,0,2
68278,150,18576,24532;24716,52560,0,0,2,0,2
68279,150,18577,24184;24740;27440,52560,1,0,2,0,3
68280,150,18578,24789;25002;27360,52560,1,0,2,0,3
68281,150,18579,24469;24794;27264,52560,1,0,2,0,3
68282,150,18580,24798;25088;27347,52560,1,0,2,0,3
68283,150,18581,24803;24916,52560,0,0,2,0,2
68284,150,18582,24492;24809,52560,0,0,2,0,2
68285,150,18583,24548;24822,52560,0,0,2,0,2
68286,150,18584,24831;25315;27369,52560,1,0,2,0,3
68287,150,18585,24551;24838,52560,0,0,2,0,2
68288,150,18586,24562;24855;26922;27350,52560,1,1,2,0,4
68289,150,18587,24921;25144,52560,0,0,2,0,2
68290,150,18588,24924;25123;26927,52560,0,1,2,0,3
68291,150,18589,24943;25276,52560,0,0,2,0,2
68292,150,18590,25192,52560,0,0,1,0,1
68293,150,18591,20197,52925,0,0,0,1,1
68294,150,18592,20649,52925,0,0,1,0,1
68295,150,18593,20756,52925,0,0,1,0,1
68296,150,18597,20862,52925,0,0,1,0,1
68297,150,18599,20905,52925,0,0,1,0,1
68298,150,18600,21103,52925,0,0,1,0,1
68299,150,18601,20657,52925,0,0,1,0,1
68300,150,18602,21152,52925,0,0,1,0,1
68301,150,18604,21326,52925,0,0,1,0,1
68302,150,18606,21500,52925,0,0,1,0,1
68303,150,18608,21641,52925,0,0,1,0,1
68304,150,18613,21877,52925,0,0,1,0,1
68305,150,18614,21799;22047,52925,0,0,2,0,2
68306,150,18616,22118,52925,0,0,1,0,1
68307,150,18618,22254,52925,0,0,1,0,1
68308,150,18620,22329,52925,0,0,1,0,1
68309,150,18621,22787,52925,0,0,1,0,1
68310,150,18623,22903,52925,0,0,1,0,1
68311,150,18624,22916,52925,0,0,1,0,1
68312,150,18625,22972,52925,0,0,1,0,1
68313,150,18626,22658,52925,0,0,1,0,1
68314,150,18627,22576;22920,52925,0,0,2,0,2
68315,150,18629,22898,52925,0,0,1,0,1
68316,150,18632,23364,52925,0,0,1,0,1
68317,150,18633,23378;23796,52925,0,0,2,0,2
68318,150,18634,23493,52925,0,0,1,0,1
68319,150,18635,23524;26184;27201,52925,1,1,1,0,3
68320,150,18636,24159;26791,52925,0,1,1,0,2
68321,150,18637,23691;26772,52925,0,1,1,0,2
68322,150,18639,23466;23852;26589;26782;27220,52925,1,2,2,0,5
68323,150,18641,24271,52925,0,0,1,0,1
68324,150,18642,23975;24028;26402;26885;27312,52925,1,2,2,0,5
68325,150,18643,24054;24665;27438,52925,1,0,2,0,3
68326,150,18644,24083;24391;26799;27249;27424,52925,2,1,2,0,5
68327,150,18645,23641;24098;26890,52925,0,1,2,0,3
68328,150,18647,24161;24666;26919,52925,0,1,2,0,3
68329,150,18648,23756;24176,52925,0,0,2,0,2
68330,150,18649,24169;24230;27151,52925,1,0,2,0,3
68331,150,18650,24027;24390;26704,52925,0,1,2,0,3
68332,150,18651,24143;24965;27447,52925,1,0,2,0,3
68333,150,18652,24429;24598,52925,0,0,2,0,2
68334,150,18653,24443;24704;26997,52925,0,1,2,0,3
68335,150,18654,23718,52925,0,0,1,0,1
68336,150,18655,24488;25159,52925,0,0,2,0,2
68337,150,18656,24481;25226,52925,0,0,2,0,2
68338,150,18657,24515;25018,52925,0,0,2,0,2
68339,150,18658,24348,52925,0,0,1,0,1
68340,150,18659,24206;24525,52925,0,0,2,0,2
68341,150,18660,24148;24533,52925,0,0,2,0,2
68342,150,18661,24254;24565,52925,0,0,2,0,2
68343,150,18662,24566,52925,0,0,1,0,1
68344,150,18663,24275;24576,52925,0,0,2,0,2
68345,150,18664,24605,52925,0,0,1,0,1
68346,150,18665,24611;24709,52925,0,0,2,0,2
68347,150,18666,24262;24629;27086,52925,1,0,2,0,3
68348,150,18667,24631;24817,52925,0,0,2,0,2
68349,150,18668,24636;24715,52925,0,0,2,0,2
68350,150,18669,24669;24864,52925,0,0,2,0,2
68351,150,18670,24682,52925,0,0,1,0,1
68352,150,18671,24336;24700,52925,0,0,2,0,2
68353,150,18672,24739,52925,0,0,1,0,1
68354,150,18673,24703;24763,52925,0,0,2,0,2
68355,150,18674,24713;26805,52925,0,1,1,0,2
68356,150,18675,24770;24890;27444,52925,1,0,2,0,3
68357,150,18676,24819;25112,52925,0,0,2,0,2
68358,150,18677,24806;24827,52925,0,0,2,0,2
68359,150,18678,24828;25013;26812,52925,0,1,2,0,3
68360,150,18679,25413,52925,0,0,1,0,1
68361,150,18680,24866;24929,52925,0,0,2,0,2
68362,150,18681,24851;24897,52925,0,0,2,0,2
68363,150,18682,24900;25289,52925,0,0,2,0,2
68364,150,18683,24915;25427,52925,0,0,2,0,2
68365,150,18684,24932;25264,52925,0,0,2,0,2
68366,150,18685,24951;25409,52925,0,0,2,0,2
68367,150,18686,24954,52925,0,0,1,0,1
68368,150,18687,24556;24959,52925,0,0,2,0,2
68369,150,18688,24610;24976;27358,52925,1,0,2,0,3
68370,150,18689,24987;25278;27178,52925,1,0,2,0,3
68371,150,18690,25229;25398,52925,0,0,2,0,2
68372,150,18691,25070;27175,52925,1,0,1,0,2
68373,150,18692,24815,52925,0,0,1,0,1
68374,150,18693,25082;25304,52925,0,0,2,0,2
68375,150,18694,25089;25415,52925,0,0,2,0,2
68376,150,18695,19976,53290,0,0,0,1,1
68377,150,18696,20328,53290,0,0,0,1,1
68378,150,18697,20503,53290,0,0,0,1,1
68379,150,18700,20619,53290,0,0,0,1,1
68380,150,18701,20989,53290,0,0,1,0,1
68381,150,18702,21071,53290,0,0,1,0,1
68382,150,18703,20879,53290,0,0,1,0,1
68383,150,18704,21007;21412,53290,0,0,2,0,2
68384,150,18705,21085,53290,0,0,1,0,1
68385,150,18706,21568,53290,0,0,1,0,1
68386,150,18708,21586,53290,0,0,1,0,1
68387,150,18710,21118,53290,0,0,1,0,1
68388,150,18712,21997,53290,0,0,1,0,1
68389,150,18717,22209,53290,0,0,1,0,1
68390,150,18718,21884,53290,0,0,1,0,1
68391,150,18719,22239,53290,0,0,1,0,1
68392,150,18720,22126,53290,0,0,1,0,1
68393,150,18721,23057;23319,53290,0,0,2,0,2
68394,150,18724,22595,53290,0,0,1,0,1
68395,150,18725,22636,53290,0,0,1,0,1
68396,150,18727,23086;23165;26164,53290,0,1,2,0,3
68397,150,18732,22953,53290,0,0,1,0,1
68398,150,18733,23636;23696;27385,53290,1,0,2,0,3
68399,150,18734,23445,53290,0,0,1,0,1
68400,150,18735,23422;23865;26002;27043,53290,1,1,2,0,4
68401,150,18736,23601,53290,0,0,1,0,1
68402,150,18737,23732,53290,0,0,1,0,1
68403,150,18738,23664;23783,53290,0,0,2,0,2
68404,150,18739,23940,53290,0,0,1,0,1
68405,150,18741,23749;23993,53290,0,0,2,0,2
68406,150,18742,23869;23926;27223,53290,1,0,2,0,3
68407,150,18743,23781;24164;27236,53290,1,0,2,0,3
68408,150,18744,23734,53290,0,0,1,0,1
68409,150,18745,24034;24109;27231,53290,1,0,2,0,3
68410,150,18746,24055;24337;27157,53290,1,0,2,0,3
68411,150,18747,24304;26497,53290,0,1,1,0,2
68412,150,18748,24170;24182,53290,0,0,2,0,2
68413,150,18749,24193;24849;26809;27443,53290,1,1,2,0,4
68414,150,18750,23989;24238,53290,0,0,2,0,2
68415,150,18751,24300;24531,53290,0,0,2,0,2
68416,150,18752,24156;24226,53290,0,0,2,0,2
68417,150,18753,24291,53290,0,0,1,0,1
68418,150,18754,24397,53290,0,0,1,0,1
68419,150,18755,24428;24823,53290,0,0,2,0,2
68420,150,18756,24457;24496,53290,0,0,2,0,2
68421,150,18757,24462;24735;26921;27439,53290,1,1,2,0,4
68422,150,18758,24298,53290,0,0,1,0,1
68423,150,18759,24536;24616;26502;27342,53290,1,1,2,0,4
68424,150,18760,24561;24742,53290,0,0,2,0,2
68425,150,18761,24592;24780,53290,0,0,2,0,2
68426,150,18762,24577;24600;26916;27165,53290,1,1,2,0,4
68427,150,18763,24635;24982;26926,53290,0,1,2,0,3
68428,150,18764,24676;24796;26998,53290,0,1,2,0,3
68429,150,18765,24345;24683;26920;27262,53290,1,1,2,0,4
68430,150,18766,24514;24697,53290,0,0,2,0,2
68431,150,18767,24725;25365,53290,0,0,2,0,2
68432,150,18768,24733,53290,0,0,1,0,1
68433,150,18769,24744;24804,53290,0,0,2,0,2
68434,150,18770,24749;25183,53290,0,0,2,0,2
68435,150,18771,24657,53290,0,0,1,0,1
68436,150,18772,24549;24800,53290,0,0,2,0,2
68437,150,18773,24816;25317,53290,0,0,2,0,2
68438,150,18774,24818;24903;26999;27348,53290,1,1,2,0,4
68439,150,18775,24832,53290,0,0,1,0,1
68440,150,18776,24834;25038,53290,0,0,2,0,2
68441,150,18777,24837;25310,53290,0,0,2,0,2
68442,150,18778,24847,53290,0,0,1,0,1
68443,150,18779,24853;25063;27271,53290,1,0,2,0,3
68444,150,18780,24677,53290,0,0,1,0,1
68445,150,18781,24928;27356,53290,1,0,1,0,2
68446,150,18782,24935;25124,53290,0,0,2,0,2
68447,150,18783,24593;24946,53290,0,0,2,0,2
68448,150,18784,24968,53290,0,0,1,0,1
68449,150,18785,24971,53290,0,0,1,0,1
68450,150,18786,25209,53290,0,0,1,0,1
68451,150,18787,24991;25060,53290,0,0,2,0,2
68452,150,18788,24997;25001,53290,0,0,2,0,2
68453,150,18789,24825;25020,53290,0,0,2,0,2
68454,150,18790,24842;25090;26717,53290,0,1,2,0,3
68455,150,18791,25096;25533,53290,0,0,2,0,2
68456,150,18792,24802;25109,53290,0,0,2,0,2
68457,150,18793,25114;25527,53290,0,0,2,0,2
68458,150,18794,25118;25303,53290,0,0,2,0,2
68459,150,18795,25128,53290,0,0,1,0,1
68460,150,18796,25120;25130,53290,0,0,2,0,2
68461,150,18797,25134,53290,0,0,1,0,1
68462,150,18798,25145;25512,53290,0,0,2,0,2
68463,150,18799,25519,53290,0,0,1,0,1
68464,150,18800,24731;25180,53290,0,0,2,0,2
68465,150,18801,20616,53655,0,0,0,1,1
68466,150,18803,20639,53655,0,0,1,0,1
68467,150,18804,21031,53655,0,0,1,0,1
68468,150,18805,20680,53655,0,0,1,0,1
68469,150,18806,20192,53655,0,0,0,1,1
68470,150,18809,21435,53655,0,0,1,0,1
68471,150,18810,21528,53655,0,0,1,0,1
68472,150,18812,21792,53655,0,0,1,0,1
68473,150,18813,21653,53655,0,0,1,0,1
68474,150,18815,21938,53655,0,0,1,0,1
68475,150,18816,21832,53655,0,0,1,0,1
68476,150,18817,21662;21679,53655,0,0,2,0,2
68477,150,18818,21765,53655,0,0,1,0,1
68478,150,18819,22357,53655,0,0,1,0,1
68479,150,18822,22473,53655,0,0,1,0,1
68480,150,18823,21971,53655,0,0,1,0,1
68481,150,18825,22625,53655,0,0,1,0,1
68482,150,18826,22627,53655,0,0,1,0,1
68483,150,18827,22508;22699;25520,53655,0,0,3,0,3
68484,150,18829,22897,53655,0,0,1,0,1
68485,150,18830,22997;23279;26457,53655,0,1,2,0,3
68486,150,18832,22706,53655,0,0,1,0,1
68487,150,18833,23484,53655,0,0,1,0,1
68488,150,18834,23595;23714,53655,0,0,2,0,2
68489,150,18835,22949,53655,0,0,1,0,1
68490,150,18837,23217;23738;26190,53655,0,1,2,0,3
68491,150,18838,23764;24619,53655,0,0,2,0,2
68492,150,18839,23875;24194;27326,53655,1,0,2,0,3
68493,150,18840,23946;23955,53655,0,0,2,0,2
68494,150,18842,23997;24371;27247,53655,1,0,2,0,3
68495,150,18843,24059,53655,0,0,1,0,1
68496,150,18844,24076;24484;27258;27431,53655,2,0,2,0,4
68497,150,18845,24106;24179,53655,0,0,2,0,2
68498,150,18846,24134;24623;26918;27085;27167,53655,2,1,2,0,5
68499,150,18847,24362;25067;27453,53655,1,0,2,0,3
68500,150,18848,23808;24210;26298,53655,0,1,2,0,3
68501,150,18849,24245;24357;26207,53655,0,1,2,0,3
68502,150,18850,24247;24284;26407;26899;26989,53655,0,3,2,0,5
68503,150,18851,24626,53655,0,0,1,0,1
68504,150,18852,24121;24678;27261,53655,1,0,2,0,3
68505,150,18853,24344,53655,0,0,1,0,1
68506,150,18854,24383,53655,0,0,1,0,1
68507,150,18855,24110;24219;26600;26896,53655,0,2,2,0,4
68508,150,18856,24183;24427;27429,53655,1,0,2,0,3
68509,150,18857,24480;24920,53655,0,0,2,0,2
68510,150,18859,24507;24567,53655,0,0,2,0,2
68511,150,18860,24434;24601,53655,0,0,2,0,2
68512,150,18861,24607,53655,0,0,1,0,1
68513,150,18862,24588,53655,0,0,1,0,1
68514,150,18863,24654;25265,53655,0,0,2,0,2
68515,150,18864,24696;24942;27445,53655,1,0,2,0,3
68516,150,18865,24707;24824,53655,0,0,2,0,2
68517,150,18866,24613;24720,53655,0,0,2,0,2
68518,150,18867,24732;25075,53655,0,0,2,0,2
68519,150,18869,24764;25025,53655,0,0,2,0,2
68520,150,18870,24790;25106,53655,0,0,2,0,2
68521,150,18871,24403;24841,53655,0,0,2,0,2
68522,150,18872,24294,53655,0,0,1,0,1
68523,150,18873,24814;25327,53655,0,0,2,0,2
68524,150,18874,24896;24975,53655,0,0,2,0,2
68525,150,18875,24910;25117,53655,0,0,2,0,2
68526,150,18876,24933;25102;27101;27273;27455,53655,3,0,2,0,5
68527,150,18877,24974;25620,53655,0,0,2,0,2
68528,150,18878,24641;25051,53655,0,0,2,0,2
68529,150,18879,25056;25384,53655,0,0,2,0,2
68530,150,18880,24880;25057,53655,0,0,2,0,2
68531,150,18881,25073,53655,0,0,1,0,1
68532,150,18882,25087;25258;27272;27365,53655,2,0,2,0,4
68533,150,18883,24782;25428,53655,0,0,2,0,2
68534,150,18884,25115,53655,0,0,1,0,1
68535,150,18885,25157;25316;27179,53655,1,0,2,0,3
68536,150,18886,25175;25270;27275,53655,1,0,2,0,3
68537,150,18887,25184;25621,53655,0,0,2,0,2
68538,150,18888,25044;25186,53655,0,0,2,0,2
68539,150,18889,25043;25194,53655,0,0,2,0,2
68540,150,18890,25126;25530,53655,0,0,2,0,2
68541,150,18891,25225;25560,53655,0,0,2,0,2
68542,150,18892,25261;25589,53655,0,0,2,0,2
68543,150,18893,25268;25543,53655,0,0,2,0,2
68544,150,18894,25285;25582,53655,0,0,2,0,2
68545,150,18895,24653;25295,53655,0,0,2,0,2
68546,150,18896,25306;25354,53655,0,0,2,0,2
68547,150,18897,25308;25631,53655,0,0,2,0,2
68548,150,18898,25314;25568,53655,0,0,2,0,2
68549,150,18899,20076,54020,0,0,0,1,1
68550,150,18900,20819,54020,0,0,1,0,1
68551,150,18901,21167,54020,0,0,1,0,1
68552,150,18902,21362,54020,0,0,1,0,1
68553,150,18904,21276;21383,54020,0,0,2,0,2
68554,150,18905,21598,54020,0,0,1,0,1
68555,150,18907,21838,54020,0,0,1,0,1
68556,150,18908,21915,54020,0,0,1,0,1
68557,150,18909,21419,54020,0,0,1,0,1
68558,150,18910,21813,54020,0,0,1,0,1
68559,150,18911,22246,54020,0,0,1,0,1
68560,150,18912,21850,54020,0,0,1,0,1
68561,150,18913,22115,54020,0,0,1,0,1
68562,150,18915,22353,54020,0,0,1,0,1
68563,150,18917,22667,54020,0,0,1,0,1
68564,150,18918,22690,54020,0,0,1,0,1
68565,150,18919,22606,54020,0,0,1,0,1
68566,150,18920,22854,54020,0,0,1,0,1
68567,150,18921,22858,54020,0,0,1,0,1
68568,150,18922,22797,54020,0,0,1,0,1
68569,150,18923,23022,54020,0,0,1,0,1
68570,150,18926,23712,54020,0,0,1,0,1
68571,150,18927,23804;24154;26985,54020,0,1,2,0,3
68572,150,18930,23987;24208,54020,0,0,2,0,2
68573,150,18931,24001,54020,0,0,1,0,1
68574,150,18932,23633,54020,0,0,1,0,1
68575,150,18933,24032;24287,54020,0,0,2,0,2
68576,150,18935,24145;24331,54020,0,0,2,0,2
68577,150,18937,24037;24196;26007;26203;27414,54020,1,2,2,0,5
68578,150,18938,24014;24205,54020,0,0,2,0,2
68579,150,18939,24068,54020,0,0,1,0,1
68580,150,18940,24233;24618;26710,54020,0,1,2,0,3
68581,150,18941,24236;24240;26204;26898;27329;27418,54020,2,2,2,0,6
68582,150,18943,24023;24286;26496;27331;27420,54020,2,1,2,0,5
68583,150,18944,24146;27234,54020,1,0,1,0,2
68584,150,18945,24049,54020,0,0,1,0,1
68585,150,18946,24399,54020,0,0,1,0,1
68586,150,18947,24042;24685,54020,0,0,2,0,2
68587,150,18948,24423;24751,54020,0,0,2,0,2
68588,150,18949,23857;24455;27257,54020,1,0,2,0,3
68589,150,18950,24468;24914;27095;27355,54020,2,0,2,0,4
68590,150,18951,24486;24984,54020,0,0,2,0,2
68591,150,18952,24518,54020,0,0,1,0,1
68592,150,18953,24553;24614,54020,0,0,2,0,2
68593,150,18954,24670;24979,54020,0,0,2,0,2
68594,150,18955,24671;24684;26609;27344,54020,1,1,2,0,4
68595,150,18956,24691;24875,54020,0,0,2,0,2
68596,150,18957,24695;25008;27361;27448,54020,2,0,2,0,4
68597,150,18958,24617;24772;27091,54020,1,0,2,0,3
68598,150,18959,24439;24705,54020,0,0,2,0,2
68599,150,18960,24768;24781,54020,0,0,2,0,2
68600,150,18961,24582;24797,54020,0,0,2,0,2
68601,150,18962,24808;24833,54020,0,0,2,0,2
68602,150,18963,24599;25139,54020,0,0,2,0,2
68603,150,18964,24887;25236,54020,0,0,2,0,2
68604,150,18965,24672;24947;27000,54020,0,1,2,0,3
68605,150,18966,24977;25010;27449,54020,1,0,2,0,3
68606,150,18967,25155,54020,0,0,1,0,1
68607,150,18968,25021;25372,54020,0,0,2,0,2
68608,150,18969,25034;25612,54020,0,0,2,0,2
68609,150,18970,24912;25059;27451,54020,1,0,2,0,3
68610,150,18971,25062,54020,0,0,1,0,1
68611,150,18972,24918;25080;27364,54020,1,0,2,0,3
68612,150,18973,25140;25190,54020,0,0,2,0,2
68613,150,18974,25142,54020,0,0,1,0,1
68614,150,18975,25149;25521,54020,0,0,2,0,2
68615,150,18976,24981;25168,54020,0,0,2,0,2
68616,150,18977,25177;25185,54020,0,0,2,0,2
68617,150,18978,24872;25191;27093;27266,54020,2,0,2,0,4
68618,150,18979,25198;25256,54020,0,0,2,0,2
68619,150,18980,24911;25203,54020,0,0,2,0,2
68620,150,18981,25204;25726,54020,0,0,2,0,2
68621,150,18982,25210;25246,54020,0,0,2,0,2
68622,150,18983,25171;25242,54020,0,0,2,0,2
68623,150,18984,25275,54020,0,0,1,0,1
68624,150,18985,25027;25280,54020,0,0,2,0,2
68625,150,18986,25311;25426,54020,0,0,2,0,2
68626,150,18987,25321;25522,54020,0,0,2,0,2
68627,150,18988,25178;25322,54020,0,0,2,0,2
68628,150,18989,25324;25445,54020,0,0,2,0,2
68629,150,18990,25325;25515,54020,0,0,2,0,2
68630,150,18991,25326;25487;27462,54020,1,0,2,0,3
68631,150,18992,25329;25555,54020,0,0,2,0,2
68632,150,18993,25048;25330,54020,0,0,2,0,2
68633,150,18994,25207;25336,54020,0,0,2,0,2
68634,150,18995,25234;25338;26928,54020,0,1,2,0,3
68635,150,18996,25202;25356,54020,0,0,2,0,2
68636,150,18997,25360;25459,54020,0,0,2,0,2
68637,150,18998,25220;25382,54020,0,0,2,0,2
68638,150,18999,25221;25390;27458,54020,1,0,2,0,3
68639,150,19000,25423;25670,54020,0,0,2,0,2
68640,150,19001,25400;25430,54020,0,0,2,0,2
68641,150,19002,21144,54385,0,0,1,0,1
68642,150,19003,21078,54385,0,0,1,0,1
68643,150,19004,21555,54385,0,0,1,0,1
68644,150,19005,21592;21645,54385,0,0,2,0,2
68645,150,19006,21672,54385,0,0,1,0,1
68646,150,19007,21819,54385,0,0,1,0,1
68647,150,19008,21955,54385,0,0,1,0,1
68648,150,19009,22221,54385,0,0,1,0,1
68649,150,19012,22366,54385,0,0,1,0,1
68650,150,19014,22742,54385,0,0,1,0,1
68651,150,19015,22452,54385,0,0,1,0,1
68652,150,19016,22786,54385,0,0,1,0,1
68653,150,19018,23087,54385,0,0,1,0,1
68654,150,19019,23043,54385,0,0,1,0,1
68655,150,19020,23061,54385,0,0,1,0,1
68656,150,19021,22652,54385,0,0,1,0,1
68657,150,19022,23142,54385,0,0,1,0,1
68658,150,19023,23179,54385,0,0,1,0,1
68659,150,19024,23213,54385,0,0,1,0,1
68660,150,19025,22800,54385,0,0,1,0,1
68661,150,19026,23291,54385,0,0,1,0,1
68662,150,19027,23717,54385,0,0,1,0,1
68663,150,19028,23773,54385,0,0,1,0,1
68664,150,19029,23767,54385,0,0,1,0,1
68665,150,19030,23918,54385,0,0,1,0,1
68666,150,19031,23966;24351;26303,54385,0,1,2,0,3
68667,150,19032,24078,54385,0,0,1,0,1
68668,150,19033,24116,54385,0,0,1,0,1
68669,150,19034,24137,54385,0,0,1,0,1
68670,150,19035,23638,54385,0,0,1,0,1
68671,150,19036,24263;24622,54385,0,0,2,0,2
68672,150,19037,24268;24753;26806,54385,0,1,2,0,3
68673,150,19038,24062,54385,0,0,1,0,1
68674,150,19039,24283,54385,0,0,1,0,1
68675,150,19040,23917,54385,0,0,1,0,1
68676,150,19041,24352;24365;26602,54385,0,1,2,0,3
68677,150,19042,24363,54385,0,0,1,0,1
68678,150,19043,24437,54385,0,0,1,0,1
68679,150,19044,24444;24574,54385,0,0,2,0,2
68680,150,19045,24563;24633,54385,0,0,2,0,2
68681,150,19046,24637,54385,0,0,1,0,1
68682,150,19047,24490;24589,54385,0,0,2,0,2
68683,150,19048,24239,54385,0,0,1,0,1
68684,150,19049,24258,54385,0,0,1,0,1
68685,150,19050,24149,54385,0,0,1,0,1
68686,150,19051,24223,54385,0,0,1,0,1
68687,150,19052,24714;25205;27177,54385,1,0,2,0,3
68688,150,19053,24777;25164;27441,54385,1,0,2,0,3
68689,150,19054,24786;24888,54385,0,0,2,0,2
68690,150,19055,24787;24926;27268,54385,1,0,2,0,3
68691,150,19056,24793;25353;27277,54385,1,0,2,0,3
68692,150,19057,24826;24895;27172,54385,1,0,2,0,3
68693,150,19058,24835;24860;26924,54385,0,1,2,0,3
68694,150,19059,24836,54385,0,0,1,0,1
68695,150,19060,24868;25040;27362,54385,1,0,2,0,3
68696,150,19061,24658;24885;27267,54385,1,0,2,0,3
68697,150,19062,24472;24919;27096,54385,1,0,2,0,3
68698,150,19063,24945;25457,54385,0,0,2,0,2
68699,150,19064,24963;25212,54385,0,0,2,0,2
68700,150,19065,24973;25230,54385,0,0,2,0,2
68701,150,19066,24983;25163,54385,0,0,2,0,2
68702,150,19067,25012;25328;27276,54385,1,0,2,0,3
68703,150,19068,25041,54385,0,0,1,0,1
68704,150,19069,25049;25249,54385,0,0,2,0,2
68705,150,19070,24738;25131,54385,0,0,2,0,2
68706,150,19071,25151;25606;27182,54385,1,0,2,0,3
68707,150,19072,25156,54385,0,0,1,0,1
68708,150,19073,25028;25167,54385,0,0,2,0,2
68709,150,19074,25200;25215,54385,0,0,2,0,2
68710,150,19075,25022;25411;27279,54385,1,0,2,0,3
68711,150,19076,25237;25532,54385,0,0,2,0,2
68712,150,19077,25239;25538;27372,54385,1,0,2,0,3
68713,150,19078,25250,54385,0,0,1,0,1
68714,150,19079,25254;25499,54385,0,0,2,0,2
68715,150,19080,25283;25575,54385,0,0,2,0,2
68716,150,19081,25247;25292,54385,0,0,2,0,2
68717,150,19082,25296,54385,0,0,1,0,1
68718,150,19083,25298,54385,0,0,1,0,1
68719,150,19084,25299,54385,0,0,1,0,1
68720,150,19085,25350,54385,0,0,1,0,1
68721,150,19086,24967;25377,54385,0,0,2,0,2
68722,150,19087,25420,54385,0,0,1,0,1
68723,150,19088,25704,54385,0,0,1,0,1
68724,150,19089,25443;25494,54385,0,0,2,0,2
68725,150,19090,25448;25655,54385,0,0,2,0,2
68726,150,19091,25449;25649,54385,0,0,2,0,2
68727,150,19092,25467;25500,54385,0,0,2,0,2
68728,150,19093,25016;25483,54385,0,0,2,0,2
68729,150,19095,25498;25714,54385,0,0,2,0,2
68730,150,19096,21281,54750,0,0,1,0,1
68731,150,19097,21446,54750,0,0,1,0,1
68732,150,19098,21064,54750,0,0,1,0,1
68733,150,19099,21691,54750,0,0,1,0,1
68734,150,19100,21735,54750,0,0,1,0,1
68735,150,19101,21822,54750,0,0,1,0,1
68736,150,19102,21541,54750,0,0,1,0,1
68737,150,19103,21815,54750,0,0,1,0,1
68738,150,19104,22207,54750,0,0,1,0,1
68739,150,19105,22272,54750,0,0,1,0,1
68740,150,19106,22404;22718,54750,0,0,2,0,2
68741,150,19107,22342,54750,0,0,1,0,1
68742,150,19108,22247,54750,0,0,1,0,1
68743,150,19109,22696,54750,0,0,1,0,1
68744,150,19110,22509,54750,0,0,1,0,1
68745,150,19111,23020,54750,0,0,1,0,1
68746,150,19112,23130,54750,0,0,1,0,1
68747,150,19113,23131,54750,0,0,1,0,1
68748,150,19114,23096,54750,0,0,1,0,1
68749,150,19115,23402,54750,0,0,1,0,1
68750,150,19116,23118,54750,0,0,1,0,1
68751,150,19117,23496,54750,0,0,1,0,1
68752,150,19118,23337,54750,0,0,1,0,1
68753,150,19119,23607,54750,0,0,1,0,1
68754,150,19120,23618,54750,0,0,1,0,1
68755,150,19121,23655,54750,0,0,1,0,1
68756,150,19122,23739,54750,0,0,1,0,1
68757,150,19123,24024,54750,0,0,1,0,1
68758,150,19124,24089,54750,0,0,1,0,1
68759,150,19126,24303,54750,0,0,1,0,1
68760,150,19127,24221;24648,54750,0,0,2,0,2
68761,150,19128,24067;24341;26905,54750,0,1,2,0,3
68762,150,19129,24465;24471,54750,0,0,2,0,2
68763,150,19130,24473,54750,0,0,1,0,1
68764,150,19131,24353,54750,0,0,1,0,1
68765,150,19132,24555,54750,0,0,1,0,1
68766,150,19133,24698;25000,54750,0,0,2,0,2
68767,150,19134,24699;24994,54750,0,0,2,0,2
68768,150,19135,24719,54750,0,0,1,0,1
68769,150,19136,24762;25113,54750,0,0,2,0,2
68770,150,19137,24767;24858,54750,0,0,2,0,2
68771,150,19138,24773;24941,54750,0,0,2,0,2
68772,150,19139,24813,54750,0,0,1,0,1
68773,150,19140,24729;24846;26808,54750,0,1,2,0,3
68774,150,19141,24727;24902;26810;27353,54750,1,1,2,0,4
68775,150,19142,24922,54750,0,0,1,0,1
68776,150,19143,24948;25189,54750,0,0,2,0,2
68777,150,19144,24898;24953,54750,0,0,2,0,2
68778,150,19145,24962;25471,54750,0,0,2,0,2
68779,150,19146,24442,54750,0,0,1,0,1
68780,150,19147,24980;25485,54750,0,0,2,0,2
68781,150,19148,24989,54750,0,0,1,0,1
68782,150,19149,25026;25029,54750,0,0,2,0,2
68783,150,19150,25046,54750,0,0,1,0,1
68784,150,19151,25081;25607,54750,0,0,2,0,2
68785,150,19152,25095;25633,54750,0,0,2,0,2
68786,150,19153,25099;25391,54750,0,0,2,0,2
68787,150,19154,25122;25348;27457,54750,1,0,2,0,3
68788,150,19155,25152;25153;27102,54750,1,0,2,0,3
68789,150,19156,24995,54750,0,0,1,0,1
68790,150,19157,25165;25641;27375,54750,1,0,2,0,3
68791,150,19158,25176;25208;27103,54750,1,0,2,0,3
68792,150,19159,25179,54750,0,0,1,0,1
68793,150,19160,25245;25822,54750,0,0,2,0,2
68794,150,19161,25257;25751,54750,0,0,2,0,2
68795,150,19162,25098;25284,54750,0,0,2,0,2
68796,150,19163,25305;25468,54750,0,0,2,0,2
68797,150,19164,25003;25320,54750,0,0,2,0,2
68798,150,19165,25375;25818,54750,0,0,2,0,2
68799,150,19166,25425,54750,0,0,1,0,1
68800,150,19167,25339;25446,54750,0,0,2,0,2
68801,150,19168,25452;25567,54750,0,0,2,0,2
68802,150,19169,25481;25788,54750,0,0,2,0,2
68803,150,19170,25490;25493,54750,0,0,2,0,2
68804,150,19171,25497;25752,54750,0,0,2,0,2
68805,150,19172,25517;25787,54750,0,0,2,0,2
68806,150,19173,25525;25883,54750,0,1,1,0,2
68807,150,19174,25534;25745,54750,0,0,2,0,2
68808,150,19175,25547;25603,54750,0,0,2,0,2
68809,150,19176,25541;25557,54750,0,0,2,0,2
68810,150,19177,25504;25559,54750,0,0,2,0,2
68811,150,19178,25591,54750,0,0,1,0,1
68812,150,19179,25503;25601,54750,0,0,2,0,2
68813,150,19180,25613;25897,54750,0,1,1,0,2
68814,160,7704,17578,14235,0,0,0,1,1
68815,160,7731,19822;19999,14235,0,0,0,2,2
68816,160,8664,19177,17520,0,0,0,1,1
68817,160,10324,18884,22995,0,0,0,1,1
68818,160,10709,19012,24090,0,0,0,1,1
68819,160,10879,20060,24820,0,0,0,1,1
68820,160,11140,20246,25550,0,0,0,1,1
68821,160,11586,19617,27010,0,0,0,1,1
68822,160,11912,19878,28105,0,0,0,1,1
68823,160,11924,20789,28105,0,0,0,1,1
68824,160,12226,21266;21913,29200,0,0,1,1,2
68825,160,12340,17593,29565,0,0,0,1,1
68826,160,12348,17968,29565,0,0,0,1,1
68827,160,12353,22393;25771;26120,29565,0,0,3,0,3
68828,160,12355,17748,29565,0,0,0,1,1
68829,160,12360,18048,29565,0,0,0,1,1
68830,160,12398,21363;21497;26012,29930,0,0,1,2,3
68831,160,12430,18178,29930,0,0,0,1,1
68832,160,12437,17824,29930,0,0,0,1,1
68833,160,12527,17879,30295,0,0,0,1,1
68834,160,12537,17897,30295,0,0,0,1,1
68835,160,12545,18112,30295,0,0,0,1,1
68836,160,12553,18200,30295,0,0,0,1,1
68837,160,12558,18093,30295,0,0,0,1,1
68838,160,12634,18120,30660,0,0,0,1,1
68839,160,12635,18329,30660,0,0,0,1,1
68840,160,12642,23144;23236;27190,30660,0,1,2,0,3
68841,160,12647,18102,30660,0,0,0,1,1
68842,160,12648,18218,30660,0,0,0,1,1
68843,160,12655,18151,30660,0,0,0,1,1
68844,160,12733,18009,31025,0,0,0,1,1
68845,160,12749,18221,31025,0,0,0,1,1
68846,160,12750,18592,31025,0,0,0,1,1
68847,160,12755,18518;18576,31025,0,0,0,2,2
68848,160,12756,18505,31025,0,0,0,1,1
68849,160,12818,18180,31390,0,0,0,1,1
68850,160,12830,18025,31390,0,0,0,1,1
68851,160,12837,18392,31390,0,0,0,1,1
68852,160,12840,18656,31390,0,0,0,1,1
68853,160,12849,18436,31390,0,0,0,1,1
68854,160,12853,18192,31390,0,0,0,1,1
68855,160,12859,18331,31390,0,0,0,1,1
68856,160,12862,18342,31390,0,0,0,1,1
68857,160,12863,18346,31390,0,0,0,1,1
68858,160,12926,17958,31755,0,0,0,1,1
68859,160,12929,18014,31755,0,0,0,1,1
68860,160,12932,18740,31755,0,0,0,1,1
68861,160,12933,18113,31755,0,0,0,1,1
68862,160,12934,18710,31755,0,0,0,1,1
68863,160,12935,18332,31755,0,0,0,1,1
68864,160,12941,18840,31755,0,0,0,1,1
68865,160,12947,18285;18802,31755,0,0,0,2,2
68866,160,12948,18698,31755,0,0,0,1,1
68867,160,12955,18328,31755,0,0,0,1,1
68868,160,12959,18149;18513,31755,0,0,0,2,2
68869,160,12961,18861,31755,0,0,0,1,1
68870,160,13026,18148,32120,0,0,0,1,1
68871,160,13030,18045,32120,0,0,0,1,1
68872,160,13032,18359,32120,0,0,0,1,1
68873,160,13044,18288;18634,32120,0,0,0,2,2
68874,160,13045,18281;18413,32120,0,0,0,2,2
68875,160,13048,18347;18821,32120,0,0,0,2,2
68876,160,13052,18478,32120,0,0,0,1,1
68877,160,13056,18560,32120,0,0,0,1,1
68878,160,13058,18790,32120,0,0,0,1,1
68879,160,13059,18686,32120,0,0,0,1,1
68880,160,13061,18614;18772,32120,0,0,0,2,2
68881,160,13114,17587,32485,0,0,0,1,1
68882,160,13125,17964,32485,0,0,0,1,1
68883,160,13127,22183,32485,0,0,1,0,1
68884,160,13128,18467,32485,0,0,0,1,1
68885,160,13130,18744,32485,0,0,0,1,1
68886,160,13141,18769,32485,0,0,0,1,1
68887,160,13142,18219;18479,32485,0,0,0,2,2
68888,160,13145,18676,32485,0,0,0,1,1
68889,160,13149,18481,32485,0,0,0,1,1
68890,160,13154,18941,32485,0,0,0,1,1
68891,160,13159,18662,32485,0,0,0,1,1
68892,160,13160,18714,32485,0,0,0,1,1
68893,160,13162,18727;19057,32485,0,0,0,2,2
68894,160,13163,19090,32485,0,0,0,1,1
68895,160,13164,18964,32485,0,0,0,1,1
68896,160,13216,18198,32850,0,0,0,1,1
68897,160,13218,18211,32850,0,0,0,1,1
68898,160,13222,18403,32850,0,0,0,1,1
68899,160,13227,18238,32850,0,0,0,1,1
68900,160,13229,18644,32850,0,0,0,1,1
68901,160,13236,18362,32850,0,0,0,1,1
68902,160,13237,18366,32850,0,0,0,1,1
68903,160,13240,19038,32850,0,0,0,1,1
68904,160,13241,18567,32850,0,0,0,1,1
68905,160,13243,18490,32850,0,0,0,1,1
68906,160,13248,18599,32850,0,0,0,1,1
68907,160,13249,18793,32850,0,0,0,1,1
68908,160,13250,18627,32850,0,0,0,1,1
68909,160,13255,18682,32850,0,0,0,1,1
68910,160,13256,18651,32850,0,0,0,1,1
68911,160,13258,19006;23153;25722;26449,32850,0,0,3,1,4
68912,160,13265,19151,32850,0,0,0,1,1
68913,160,13266,18507,32850,0,0,0,1,1
68914,160,13308,18231,33215,0,0,0,1,1
68915,160,13322,19010,33215,0,0,0,1,1
68916,160,13324,19021,33215,0,0,0,1,1
68917,160,13326,18654,33215,0,0,0,1,1
68918,160,13331,18645,33215,0,0,0,1,1
68919,160,13334,19275,33215,0,0,0,1,1
68920,160,13335,18935,33215,0,0,0,1,1
68921,160,13336,18929,33215,0,0,0,1,1
68922,160,13337,19315,33215,0,0,0,1,1
68923,160,13339,18914,33215,0,0,0,1,1
68924,160,13343,19009,33215,0,0,0,1,1
68925,160,13344,19233,33215,0,0,0,1,1
68926,160,13345,18923;19087,33215,0,0,0,2,2
68927,160,13346,19168,33215,0,0,0,1,1
68928,160,13349,18900,33215,0,0,0,1,1
68929,160,13350,18913;18965,33215,0,0,0,2,2
68930,160,13351,18891;18957,33215,0,0,0,2,2
68931,160,13352,18981,33215,0,0,0,1,1
68932,160,13425,18229,33580,0,0,0,1,1
68933,160,13426,18304,33580,0,0,0,1,1
68934,160,13429,18565,33580,0,0,0,1,1
68935,160,13430,18082,33580,0,0,0,1,1
68936,160,13432,18897,33580,0,0,0,1,1
68937,160,13433,18868,33580,0,0,0,1,1
68938,160,13437,19392,33580,0,0,0,1,1
68939,160,13439,19041,33580,0,0,0,1,1
68940,160,13441,19124,33580,0,0,0,1,1
68941,160,13442,18783;19354,33580,0,0,0,2,2
68942,160,13443,18810;19269,33580,0,0,0,2,2
68943,160,13445,18867,33580,0,0,0,1,1
68944,160,13448,18759;18907,33580,0,0,0,2,2
68945,160,13449,18918,33580,0,0,0,1,1
68946,160,13450,18934,33580,0,0,0,1,1
68947,160,13452,19298,33580,0,0,0,1,1
68948,160,13453,19325,33580,0,0,0,1,1
68949,160,13454,19070,33580,0,0,0,1,1
68950,160,13456,19013,33580,0,0,0,1,1
68951,160,13457,19242;23275,33580,0,0,1,1,2
68952,160,13461,19093;19366,33580,0,0,0,2,2
68953,160,13462,19435,33580,0,0,0,1,1
68954,160,13522,18767,33945,0,0,0,1,1
68955,160,13527,18544,33945,0,0,0,1,1
68956,160,13530,18537,33945,0,0,0,1,1
68957,160,13531,18589,33945,0,0,0,1,1
68958,160,13536,18956,33945,0,0,0,1,1
68959,160,13540,18775,33945,0,0,0,1,1
68960,160,13541,19302;19318,33945,0,0,0,2,2
68961,160,13544,19195,33945,0,0,0,1,1
68962,160,13545,18970,33945,0,0,0,1,1
68963,160,13547,18587,33945,0,0,0,1,1
68964,160,13549,19172,33945,0,0,0,1,1
68965,160,13553,18924;19007,33945,0,0,0,2,2
68966,160,13554,18944,33945,0,0,0,1,1
68967,160,13556,18978,33945,0,0,0,1,1
68968,160,13561,19228;19376,33945,0,0,0,2,2
68969,160,13562,18982,33945,0,0,0,1,1
68970,160,13563,19080;19391,33945,0,0,0,2,2
68971,160,13564,19084,33945,0,0,0,1,1
68972,160,13565,18933,33945,0,0,0,1,1
68973,160,13566,19096,33945,0,0,0,1,1
68974,160,13569,19427,33945,0,0,0,1,1
68975,160,13572,19142;19378,33945,0,0,0,2,2
68976,160,13574,19434,33945,0,0,0,1,1
68977,160,13575,19550,33945,0,0,0,1,1
68978,160,13618,17805,34310,0,0,0,1,1
68979,160,13622,17974,34310,0,0,0,1,1
68980,160,13634,18670,34310,0,0,0,1,1
68981,160,13635,18376,34310,0,0,0,1,1
68982,160,13638,18642,34310,0,0,0,1,1
68983,160,13640,18659,34310,0,0,0,1,1
68984,160,13644,18372;18741,34310,0,0,0,2,2
68985,160,13648,18814,34310,0,0,0,1,1
68986,160,13651,18839,34310,0,0,0,1,1
68987,160,13652,19280,34310,0,0,0,1,1
68988,160,13653,19129,34310,0,0,0,1,1
68989,160,13655,19537,34310,0,0,0,1,1
68990,160,13660,18760,34310,0,0,0,1,1
68991,160,13662,19051;19289,34310,0,0,0,2,2
68992,160,13664,19061,34310,0,0,0,1,1
68993,160,13667,19108,34310,0,0,0,1,1
68994,160,13669,19138,34310,0,0,0,1,1
68995,160,13671,19004;19169,34310,0,0,0,2,2
68996,160,13672,18768;19425,34310,0,0,0,2,2
68997,160,13673,19411,34310,0,0,0,1,1
68998,160,13674,19209,34310,0,0,0,1,1
68999,160,13676,19667,34310,0,0,0,1,1
69000,160,13677,19448,34310,0,0,0,1,1
69001,160,13679,19518;19522,34310,0,0,0,2,2
69002,160,13680,19167,34310,0,0,0,1,1
69003,160,13711,18543,34675,0,0,0,1,1
69004,160,13712,18408,34675,0,0,0,1,1
69005,160,13721,18938,34675,0,0,0,1,1
69006,160,13722,18703,34675,0,0,0,1,1
69007,160,13730,18862,34675,0,0,0,1,1
69008,160,13731,19270,34675,0,0,0,1,1
69009,160,13732,18975,34675,0,0,0,1,1
69010,160,13733,18973,34675,0,0,0,1,1
69011,160,13735,19068,34675,0,0,0,1,1
69012,160,13736,19503,34675,0,0,0,1,1
69013,160,13737,23472;27019,34675,0,1,1,0,2
69014,160,13739,19088;19158,34675,0,0,0,2,2
69015,160,13740,19438;19900;22783;26527,34675,0,0,2,2,4
69016,160,13741,19397,34675,0,0,0,1,1
69017,160,13743,19278,34675,0,0,0,1,1
69018,160,13747,19554,34675,0,0,0,1,1
69019,160,13749,19433,34675,0,0,0,1,1
69020,160,13803,22097;22555;22947;23146,35040,0,0,4,0,4
69021,160,13815,19199,35040,0,0,0,1,1
69022,160,13816,18925,35040,0,0,0,1,1
69023,160,13819,18763,35040,0,0,0,1,1
69024,160,13820,18787,35040,0,0,0,1,1
69025,160,13821,18845,35040,0,0,0,1,1
69026,160,13823,18613,35040,0,0,0,1,1
69027,160,13825,18979;19246,35040,0,0,0,2,2
69028,160,13826,19154,35040,0,0,0,1,1
69029,160,13827,19011,35040,0,0,0,1,1
69030,160,13830,19226;19494,35040,0,0,0,2,2
69031,160,13831,19049,35040,0,0,0,1,1
69032,160,13832,19074,35040,0,0,0,1,1
69033,160,13834,19638,35040,0,0,0,1,1
69034,160,13838,19213,35040,0,0,0,1,1
69035,160,13839,19244,35040,0,0,0,1,1
69036,160,13840,19273,35040,0,0,0,1,1
69037,160,13841,19277;19495,35040,0,0,0,2,2
69038,160,13842,19286;19382,35040,0,0,0,2,2
69039,160,13844,19224;19293,35040,0,0,0,2,2
69040,160,13845,19303,35040,0,0,0,1,1
69041,160,13846,19107,35040,0,0,0,1,1
69042,160,13849,19294;19350,35040,0,0,0,2,2
69043,160,13850,19352,35040,0,0,0,1,1
69044,160,13851,19214,35040,0,0,0,1,1
69045,160,13852,19803,35040,0,0,0,1,1
69046,160,13854,19492;19781,35040,0,0,0,2,2
69047,160,13855,19652,35040,0,0,0,1,1
69048,160,13858,19540;19675,35040,0,0,0,2,2
69049,160,13859,19757,35040,0,0,0,1,1
69050,160,13860,19474,35040,0,0,0,1,1
69051,160,13861,19767,35040,0,0,0,1,1
69052,160,13862,19846,35040,0,0,0,1,1
69053,160,13863,19491,35040,0,0,0,1,1
69054,160,13864,19529,35040,0,0,0,1,1
69055,160,13865,19619,35040,0,0,0,1,1
69056,160,13915,23009;23147;26746,35405,0,0,3,0,3
69057,160,13925,18626,35405,0,0,0,1,1
69058,160,13928,19287,35405,0,0,0,1,1
69059,160,13933,18958;19156,35405,0,0,0,2,2
69060,160,13935,19444,35405,0,0,0,1,1
69061,160,13936,19037,35405,0,0,0,1,1
69062,160,13939,19412;19654,35405,0,0,0,2,2
69063,160,13941,19132,35405,0,0,0,1,1
69064,160,13942,19283,35405,0,0,0,1,1
69065,160,13946,19254,35405,0,0,0,1,1
69066,160,13948,19656,35405,0,0,0,1,1
69067,160,13949,19422,35405,0,0,0,1,1
69068,160,13951,19368,35405,0,0,0,1,1
69069,160,13952,19578,35405,0,0,0,1,1
69070,160,13955,19417,35405,0,0,0,1,1
69071,160,13958,19306;19679,35405,0,0,0,2,2
69072,160,13960,19684,35405,0,0,0,1,1
69073,160,13961,19326;19568,35405,0,0,0,2,2
69074,160,13962,19577,35405,0,0,0,1,1
69075,160,13963,19581,35405,0,0,0,1,1
69076,160,13964,20119,35405,0,0,0,1,1
69077,160,13965,19548,35405,0,0,0,1,1
69078,160,13967,19993,35405,0,0,0,1,1
69079,160,14023,18241,35770,0,0,0,1,1
69080,160,14028,18781,35770,0,0,0,1,1
69081,160,14029,19045;19264,35770,0,0,0,2,2
69082,160,14030,19186,35770,0,0,0,1,1
69083,160,14032,18937,35770,0,0,0,1,1
69084,160,14035,19028,35770,0,0,0,1,1
69085,160,14036,18931,35770,0,0,0,1,1
69086,160,14038,19144,35770,0,0,0,1,1
69087,160,14039,18908,35770,0,0,0,1,1
69088,160,14040,19527,35770,0,0,0,1,1
69089,160,14045,19413,35770,0,0,0,1,1
69090,160,14047,18926;19106,35770,0,0,0,2,2
69091,160,14048,19511,35770,0,0,0,1,1
69092,160,14051,19489,35770,0,0,0,1,1
69093,160,14053,19552,35770,0,0,0,1,1
69094,160,14055,19530;19828,35770,0,0,0,2,2
69095,160,14056,19304;19499,35770,0,0,0,2,2
69096,160,14057,19661;19902,35770,0,0,0,2,2
69097,160,14059,19832,35770,0,0,0,1,1
69098,160,14062,19587,35770,0,0,0,1,1
69099,160,14063,19615,35770,0,0,0,1,1
69100,160,14064,19943,35770,0,0,0,1,1
69101,160,14065,20077,35770,0,0,0,1,1
69102,160,14067,19330,35770,0,0,0,1,1
69103,160,14068,19710,35770,0,0,0,1,1
69104,160,14069,19274;19712,35770,0,0,0,2,2
69105,160,14070,19726,35770,0,0,0,1,1
69106,160,14071,19739,35770,0,0,0,1,1
69107,160,14072,19505,35770,0,0,0,1,1
69108,160,14073,19847,35770,0,0,0,1,1
69109,160,14074,19759,35770,0,0,0,1,1
69110,160,14075,20134,35770,0,0,0,1,1
69111,160,14076,19520;19780,35770,0,0,0,2,2
69112,160,14077,19364;19380,35770,0,0,0,2,2
69113,160,14112,18473,36135,0,0,0,1,1
69114,160,14121,18420,36135,0,0,0,1,1
69115,160,14123,18803,36135,0,0,0,1,1
69116,160,14134,18573;18765,36135,0,0,0,2,2
69117,160,14137,18977,36135,0,0,0,1,1
69118,160,14141,19428,36135,0,0,0,1,1
69119,160,14142,19606,36135,0,0,0,1,1
69120,160,14145,19239,36135,0,0,0,1,1
69121,160,14147,19252;19934,36135,0,0,0,2,2
69122,160,14150,19729,36135,0,0,0,1,1
69123,160,14151,19488,36135,0,0,0,1,1
69124,160,14152,19337,36135,0,0,0,1,1
69125,160,14153,19485,36135,0,0,0,1,1
69126,160,14154,19357,36135,0,0,0,1,1
69127,160,14156,19227;19403,36135,0,0,0,2,2
69128,160,14157,19134,36135,0,0,0,1,1
69129,160,14160,20003,36135,0,0,0,1,1
69130,160,14162,20024,36135,0,0,0,1,1
69131,160,14163,19349,36135,0,0,0,1,1
69132,160,14165,19536,36135,0,0,0,1,1
69133,160,14166,19393;19756,36135,0,0,0,2,2
69134,160,14167,19871,36135,0,0,0,1,1
69135,160,14168,19333;19840,36135,0,0,0,2,2
69136,160,14170,19685,36135,0,0,0,1,1
69137,160,14172,19404,36135,0,0,0,1,1
69138,160,14173,19659;19895;23512,36135,0,0,1,2,3
69139,160,14177,20154,36135,0,0,0,1,1
69140,160,14178,19751;20210,36135,0,0,0,2,2
69141,160,14182,19852;19905,36135,0,0,0,2,2
69142,160,14183,19855;19856,36135,0,0,0,2,2
69143,160,14184,19761;19874,36135,0,0,0,2,2
69144,160,14186,19948,36135,0,0,0,1,1
69145,160,14187,19599,36135,0,0,0,1,1
69146,160,14188,19911;20047,36135,0,0,0,2,2
69147,160,14189,19914,36135,0,0,0,1,1
69148,160,14234,18815,36500,0,0,0,1,1
69149,160,14238,19116,36500,0,0,0,1,1
69150,160,14239,19218,36500,0,0,0,1,1
69151,160,14240,19000,36500,0,0,0,1,1
69152,160,14244,18693,36500,0,0,0,1,1
69153,160,14245,19022;19682,36500,0,0,0,2,2
69154,160,14247,19693,36500,0,0,0,1,1
69155,160,14248,19963,36500,0,0,0,1,1
69156,160,14253,19924,36500,0,0,0,1,1
69157,160,14254,19556,36500,0,0,0,1,1
69158,160,14255,19345;19713,36500,0,0,0,2,2
69159,160,14256,19575,36500,0,0,0,1,1
69160,160,14257,19389;19854,36500,0,0,0,2,2
69161,160,14258,19583;20001,36500,0,0,0,2,2
69162,160,14259,18984;19399,36500,0,0,0,2,2
69163,160,14266,19497,36500,0,0,0,1,1
69164,160,14267,19628;19664,36500,0,0,0,2,2
69165,160,14269,19595,36500,0,0,0,1,1
69166,160,14270,19873,36500,0,0,0,1,1
69167,160,14271,19432;19650,36500,0,0,0,2,2
69168,160,14274,19653,36500,0,0,0,1,1
69169,160,14275,19666,36500,0,0,0,1,1
69170,160,14276,19483;19714,36500,0,0,0,2,2
69171,160,14278,19694,36500,0,0,0,1,1
69172,160,14279,19979,36500,0,0,0,1,1
69173,160,14280,19762,36500,0,0,0,1,1
69174,160,14281,19814,36500,0,0,0,1,1
69175,160,14282,19784;20118,36500,0,0,0,2,2
69176,160,14286,19557;19862,36500,0,0,0,2,2
69177,160,14287,19868;20015,36500,0,0,0,2,2
69178,160,14288,19968,36500,0,0,0,1,1
69179,160,14289,20138,36500,0,0,0,1,1
69180,160,14291,19975,36500,0,0,0,1,1
69181,160,14292,19996;20033,36500,0,0,0,2,2
69182,160,14293,20023,36500,0,0,0,1,1
69183,160,14327,19105,36865,0,0,0,1,1
69184,160,14330,18596,36865,0,0,0,1,1
69185,160,14331,19014,36865,0,0,0,1,1
69186,160,14332,18983;19465,36865,0,0,0,2,2
69187,160,14335,19267;19394,36865,0,0,0,2,2
69188,160,14339,19149,36865,0,0,0,1,1
69189,160,14344,19291,36865,0,0,0,1,1
69190,160,14348,19463;19980,36865,0,0,0,2,2
69191,160,14352,19446,36865,0,0,0,1,1
69192,160,14354,19920,36865,0,0,0,1,1
69193,160,14355,19598,36865,0,0,0,1,1
69194,160,14357,19613,36865,0,0,0,1,1
69195,160,14359,20270,36865,0,0,0,1,1
69196,160,14360,19701;20114,36865,0,0,0,2,2
69197,160,14362,19827,36865,0,0,0,1,1
69198,160,14364,19860,36865,0,0,0,1,1
69199,160,14365,20201;20249,36865,0,0,0,2,2
69200,160,14366,19887;23501;26856,36865,0,1,1,1,3
69201,160,14367,19904;20365,36865,0,0,0,2,2
69202,160,14368,19676;19917,36865,0,0,0,2,2
69203,160,14369,20011,36865,0,0,0,1,1
69204,160,14370,20054;20205,36865,0,0,0,2,2
69205,160,14371,20268,36865,0,0,0,1,1
69206,160,14373,20074,36865,0,0,0,1,1
69207,160,14374,20093,36865,0,0,0,1,1
69208,160,14375,20103,36865,0,0,0,1,1
69209,160,14376,20105;20136,36865,0,0,0,2,2
69210,160,14377,20121,36865,0,0,0,1,1
69211,160,14378,20260,36865,0,0,0,1,1
69212,160,14408,18539,37230,0,0,0,1,1
69213,160,14413,18512,37230,0,0,0,1,1
69214,160,14416,18610,37230,0,0,0,1,1
69215,160,14419,19342,37230,0,0,0,1,1
69216,160,14420,18170,37230,0,0,0,1,1
69217,160,14427,18822,37230,0,0,0,1,1
69218,160,14428,19127,37230,0,0,0,1,1
69219,160,14429,19390,37230,0,0,0,1,1
69220,160,14430,19621,37230,0,0,0,1,1
69221,160,14431,19375,37230,0,0,0,1,1
69222,160,14432,19502,37230,0,0,0,1,1
69223,160,14433,19118,37230,0,0,0,1,1
69224,160,14435,19602;19897,37230,0,0,0,2,2
69225,160,14436,19248,37230,0,0,0,1,1
69226,160,14437,19805,37230,0,0,0,1,1
69227,160,14438,19455,37230,0,0,0,1,1
69228,160,14439,19477,37230,0,0,0,1,1
69229,160,14440,19531,37230,0,0,0,1,1
69230,160,14442,19623,37230,0,0,0,1,1
69231,160,14445,20102,37230,0,0,0,1,1
69232,160,14447,19415;19622,37230,0,0,0,2,2
69233,160,14448,19750,37230,0,0,0,1,1
69234,160,14449,19487;20222,37230,0,0,0,2,2
69235,160,14450,19696,37230,0,0,0,1,1
69236,160,14451,19742;20509,37230,0,0,0,2,2
69237,160,14453,20208,37230,0,0,0,1,1
69238,160,14454,19830;20196,37230,0,0,0,2,2
69239,160,14455,19831,37230,0,0,0,1,1
69240,160,14456,19721;19879,37230,0,0,0,2,2
69241,160,14457,19858,37230,0,0,0,1,1
69242,160,14458,19715,37230,0,0,0,1,1
69243,160,14459,20010,37230,0,0,0,1,1
69244,160,14460,20036;20664,37230,0,0,0,2,2
69245,160,14461,20500,37230,0,0,0,1,1
69246,160,14464,20081,37230,0,0,0,1,1
69247,160,14465,19808,37230,0,0,0,1,1
69248,160,14466,19952,37230,0,0,0,1,1
69249,160,14467,20304;20470,37230,0,0,0,2,2
69250,160,14468,19760;19989,37230,0,0,0,2,2
69251,160,14470,20472;20473,37230,0,0,0,2,2
69252,160,14471,20067,37230,0,0,0,1,1
69253,160,14472,20075,37230,0,0,0,1,1
69254,160,14474,20101,37230,0,0,0,1,1
69255,160,14475,20140,37230,0,0,0,1,1
69256,160,14476,20330,37230,0,0,0,1,1
69257,160,14477,20574,37230,0,0,0,1,1
69258,160,14478,19896;20155,37230,0,0,0,2,2
69259,160,14479,20163,37230,0,0,0,1,1
69260,160,14480,20414;20506;24539,37230,0,0,1,2,3
69261,160,14481,19861;20257,37230,0,0,0,2,2
69262,160,14483,20199;20440,37230,0,0,0,2,2
69263,160,14484,20523,37230,0,0,0,1,1
69264,160,14521,18338,37595,0,0,0,1,1
69265,160,14525,18945,37595,0,0,0,1,1
69266,160,14526,19243,37595,0,0,0,1,1
69267,160,14527,18804,37595,0,0,0,1,1
69268,160,14528,23379,37595,0,0,1,0,1
69269,160,14531,19973;20020,37595,0,0,0,2,2
69270,160,14532,19459,37595,0,0,0,1,1
69271,160,14534,19737;20248,37595,0,0,0,2,2
69272,160,14535,19886,37595,0,0,0,1,1
69273,160,14537,19471,37595,0,0,0,1,1
69274,160,14540,19589;19893,37595,0,0,0,2,2
69275,160,14544,19546,37595,0,0,0,1,1
69276,160,14545,19607;19736,37595,0,0,0,2,2
69277,160,14548,20056,37595,0,0,0,1,1
69278,160,14549,19813,37595,0,0,0,1,1
69279,160,14550,19610;19892,37595,0,0,0,2,2
69280,160,14551,19937,37595,0,0,0,1,1
69281,160,14552,20191,37595,0,0,0,1,1
69282,160,14554,19950;19977,37595,0,0,0,2,2
69283,160,14556,20325,37595,0,0,0,1,1
69284,160,14557,19338,37595,0,0,0,1,1
69285,160,14558,20495,37595,0,0,0,1,1
69286,160,14559,20008;20116,37595,0,0,0,2,2
69287,160,14561,19749;19843,37595,0,0,0,2,2
69288,160,14562,20389;20480,37595,0,0,0,2,2
69289,160,14565,19995;20186,37595,0,0,0,2,2
69290,160,14566,19935;20501,37595,0,0,0,2,2
69291,160,14567,20307,37595,0,0,0,1,1
69292,160,14568,20202;20236,37595,0,0,0,2,2
69293,160,14569,20156,37595,0,0,0,1,1
69294,160,14570,20404,37595,0,0,0,1,1
69295,160,14571,19962;20242,37595,0,0,0,2,2
69296,160,14572,19821;20244,37595,0,0,0,2,2
69297,160,14573,20220,37595,0,0,0,1,1
69298,160,14574,20041;20361,37595,0,0,0,2,2
69299,160,14576,20296,37595,0,0,0,1,1
69300,160,14577,20652,37595,0,0,0,1,1
69301,160,14578,20321;20728,37595,0,0,0,2,2
69302,160,14579,20711,37595,0,0,0,1,1
69303,160,14580,20334,37595,0,0,0,1,1
69304,160,14581,20194,37595,0,0,0,1,1
69305,160,14582,20340;20542,37595,0,0,0,2,2
69306,160,14583,20292;20394,37595,0,0,0,2,2
69307,160,14584,20391;20715,37595,0,0,0,2,2
69308,160,14616,18090,37960,0,0,0,1,1
69309,160,14630,19416;22983;26064,37960,0,0,2,1,3
69310,160,14631,19029,37960,0,0,0,1,1
69311,160,14633,18726;18792,37960,0,0,0,2,2
69312,160,14634,19707;20027,37960,0,0,0,2,2
69313,160,14636,19880,37960,0,0,0,1,1
69314,160,14637,19437;19966,37960,0,0,0,2,2
69315,160,14639,19460;19670,37960,0,0,0,2,2
69316,160,14640,18994;19475,37960,0,0,0,2,2
69317,160,14643,19276,37960,0,0,0,1,1
69318,160,14644,19596;19918,37960,0,0,0,2,2
69319,160,14645,19647,37960,0,0,0,1,1
69320,160,14647,19630;19651,37960,0,0,0,2,2
69321,160,14648,19800;20146,37960,0,0,0,2,2
69322,160,14649,19439;19636,37960,0,0,0,2,2
69323,160,14650,19136,37960,0,0,0,1,1
69324,160,14651,19657,37960,0,0,0,1,1
69325,160,14653,19773,37960,0,0,0,1,1
69326,160,14655,19794,37960,0,0,0,1,1
69327,160,14656,19944,37960,0,0,0,1,1
69328,160,14657,19777,37960,0,0,0,1,1
69329,160,14658,19791;19849,37960,0,0,0,2,2
69330,160,14659,20531,37960,0,0,0,1,1
69331,160,14660,19421;19797,37960,0,0,0,2,2
69332,160,14661,19668,37960,0,0,0,1,1
69333,160,14662,19810,37960,0,0,0,1,1
69334,160,14663,19817;19922,37960,0,0,0,2,2
69335,160,14664,20046,37960,0,0,0,1,1
69336,160,14665,19928,37960,0,0,0,1,1
69337,160,14666,20488;20603,37960,0,0,0,2,2
69338,160,14667,19998,37960,0,0,0,1,1
69339,160,14670,19451;20017,37960,0,0,0,2,2
69340,160,14671,20166;20463,37960,0,0,0,2,2
69341,160,14672,20078;20489,37960,0,0,0,2,2
69342,160,14673,19955,37960,0,0,0,1,1
69343,160,14674,20109,37960,0,0,0,1,1
69344,160,14675,20582,37960,0,0,0,1,1
69345,160,14678,20310,37960,0,0,0,1,1
69346,160,14680,20159,37960,0,0,0,1,1
69347,160,14681,20335;20421,37960,0,0,0,2,2
69348,160,14682,20098;20212,37960,0,0,0,2,2
69349,160,14683,20172,37960,0,0,0,1,1
69350,160,14684,20415,37960,0,0,0,1,1
69351,160,14685,19971;20316;24026,37960,0,0,1,2,3
69352,160,14687,20401,37960,0,0,0,1,1
69353,160,14688,20317;20319,37960,0,0,0,2,2
69354,160,14689,20211,37960,0,0,0,1,1
69355,160,14690,20355;20595,37960,0,0,0,2,2
69356,160,14691,20775,37960,0,0,0,1,1
69357,160,14692,20384;20424,37960,0,0,0,2,2
69358,160,14694,20413,37960,0,0,0,1,1
69359,160,14695,20226,37960,0,0,0,1,1
69360,160,14696,20107;20544,37960,0,0,0,2,2
69361,160,14697,20447,37960,0,0,0,1,1
69362,160,14698,19987;20448,37960,0,0,0,2,2
69363,160,14699,20870;21112,37960,0,0,0,2,2
69364,160,14700,23344;23960;24044;24084;26598;27321;27579;27846,37960,0,3,5,0,8
69365,160,14702,20469;20646,37960,0,0,0,2,2
69366,160,14703,20621;20897,37960,0,0,0,2,2
69367,160,14731,18733,38325,0,0,0,1,1
69368,160,14735,18419,38325,0,0,0,1,1
69369,160,14743,19222,38325,0,0,0,1,1
69370,160,14745,19133,38325,0,0,0,1,1
69371,160,14746,19347,38325,0,0,0,1,1
69372,160,14747,19344,38325,0,0,0,1,1
69373,160,14748,19660,38325,0,0,0,1,1
69374,160,14751,19423;19809,38325,0,0,0,2,2
69375,160,14753,19786,38325,0,0,0,1,1
69376,160,14754,19514;19848,38325,0,0,0,2,2
69377,160,14755,19772,38325,0,0,0,1,1
69378,160,14756,19482;19722,38325,0,0,0,2,2
69379,160,14757,19637,38325,0,0,0,1,1
69380,160,14759,19796,38325,0,0,0,1,1
69381,160,14760,19681;20021,38325,0,0,0,2,2
69382,160,14761,20297;20430,38325,0,0,0,2,2
69383,160,14762,19329;19733,38325,0,0,0,2,2
69384,160,14763,19766;19958,38325,0,0,0,2,2
69385,160,14764,19812;19959,38325,0,0,0,2,2
69386,160,14766,19857;19875,38325,0,0,0,2,2
69387,160,14767,20842,38325,0,0,0,1,1
69388,160,14768,20375,38325,0,0,0,1,1
69389,160,14769,20128,38325,0,0,0,1,1
69390,160,14770,20235;20250,38325,0,0,0,2,2
69391,160,14771,20392;20600,38325,0,0,0,2,2
69392,160,14772,20064,38325,0,0,0,1,1
69393,160,14773,20042,38325,0,0,0,1,1
69394,160,14774,19600,38325,0,0,0,1,1
69395,160,14775,20099;20351,38325,0,0,0,2,2
69396,160,14776,20110;20823,38325,0,0,0,2,2
69397,160,14777,20112,38325,0,0,0,1,1
69398,160,14778,20160;20517,38325,0,0,0,2,2
69399,160,14779,20168;20884,38325,0,0,0,2,2
69400,160,14780,20541,38325,0,0,0,1,1
69401,160,14782,20554,38325,0,0,0,1,1
69402,160,14784,20278;20456,38325,0,0,0,2,2
69403,160,14785,20671,38325,0,0,0,1,1
69404,160,14787,20314;20537,38325,0,0,0,2,2
69405,160,14788,19926;20570,38325,0,0,0,2,2
69406,160,14790,19908;20332,38325,0,0,0,2,2
69407,160,14791,19994;20398,38325,0,0,0,2,2
69408,160,14792,20164,38325,0,0,0,1,1
69409,160,14793,20906,38325,0,0,0,1,1
69410,160,14794,20388,38325,0,0,0,1,1
69411,160,14796,20291,38325,0,0,0,1,1
69412,160,14797,20452,38325,0,0,0,1,1
69413,160,14798,20459;20460,38325,0,0,0,2,2
69414,160,14799,20225;20505,38325,0,0,0,2,2
69415,160,14800,20515;20924,38325,0,0,0,2,2
69416,160,14801,20381;20571,38325,0,0,0,2,2
69417,160,14802,20780,38325,0,0,0,1,1
69418,160,14803,20596;20678,38325,0,0,0,2,2
69419,160,14830,18687,38690,0,0,0,1,1
69420,160,14831,19603,38690,0,0,0,1,1
69421,160,14832,19076;19584,38690,0,0,0,2,2
69422,160,14839,19346;19454,38690,0,0,0,2,2
69423,160,14840,19774,38690,0,0,0,1,1
69424,160,14842,19414;19907,38690,0,0,0,2,2
69425,160,14843,19284;19792,38690,0,0,0,2,2
69426,160,14846,20097,38690,0,0,0,1,1
69427,160,14847,19732;20069,38690,0,0,0,2,2
69428,160,14850,20247,38690,0,0,0,1,1
69429,160,14851,19776;19866,38690,0,0,0,2,2
69430,160,14852,20396,38690,0,0,0,1,1
69431,160,14854,20481,38690,0,0,0,1,1
69432,160,14855,20198,38690,0,0,0,1,1
69433,160,14858,20009;20227,38690,0,0,0,2,2
69434,160,14859,19740;20044,38690,0,0,0,2,2
69435,160,14861,20051;20129,38690,0,0,0,2,2
69436,160,14864,19967,38690,0,0,0,1,1
69437,160,14865,20232;20948,38690,0,0,0,2,2
69438,160,14866,20286;20367,38690,0,0,0,2,2
69439,160,14867,20370,38690,0,0,0,1,1
69440,160,14868,20400,38690,0,0,0,1,1
69441,160,14869,21015,38690,0,0,0,1,1
69442,160,14871,20832,38690,0,0,0,1,1
69443,160,14872,20372,38690,0,0,0,1,1
69444,160,14873,20736,38690,0,0,0,1,1
69445,160,14874,20423;20457,38690,0,0,0,2,2
69446,160,14875,20382,38690,0,0,0,1,1
69447,160,14876,20161,38690,0,0,0,1,1
69448,160,14877,20732,38690,0,0,0,1,1
69449,160,14878,20323;20490,38690,0,0,0,2,2
69450,160,14879,20499;20704,38690,0,0,0,2,2
69451,160,14880,20739,38690,0,0,0,1,1
69452,160,14881,20791,38690,0,0,0,1,1
69453,160,14882,20261;20682,38690,0,0,0,2,2
69454,160,14883,20521,38690,0,0,0,1,1
69455,160,14884,21008,38690,0,0,0,1,1
69456,160,14885,20555;20589,38690,0,0,0,2,2
69457,160,14886,20080;20634,38690,0,0,0,2,2
69458,160,14887,20642;20929,38690,0,0,0,2,2
69459,160,14888,20628;21025,38690,0,0,0,2,2
69460,160,14890,20717;20742,38690,0,0,0,2,2
69461,160,14891,20397,38690,0,0,0,1,1
69462,160,14892,20740,38690,0,0,0,1,1
69463,160,14918,19458,39055,0,0,0,1,1
69464,160,14927,19170,39055,0,0,0,1,1
69465,160,14929,18761;19324,39055,0,0,0,2,2
69466,160,14932,19526;19894,39055,0,0,0,2,2
69467,160,14935,20450,39055,0,0,0,1,1
69468,160,14936,19618;19686,39055,0,0,0,2,2
69469,160,14937,19986,39055,0,0,0,1,1
69470,160,14938,20259,39055,0,0,0,1,1
69471,160,14939,19687;19811,39055,0,0,0,2,2
69472,160,14940,19468;19961,39055,0,0,0,2,2
69473,160,14941,20209,39055,0,0,0,1,1
69474,160,14945,20022,39055,0,0,0,1,1
69475,160,14946,19916,39055,0,0,0,1,1
69476,160,14947,20219,39055,0,0,0,1,1
69477,160,14948,20697;20790;24881;27710;27889;28075,39055,1,2,1,2,6
69478,160,14950,19842;20039,39055,0,0,0,2,2
69479,160,14951,20062,39055,0,0,0,1,1
69480,160,14952,20142,39055,0,0,0,1,1
69481,160,14953,20368,39055,0,0,0,1,1
69482,160,14954,20520,39055,0,0,0,1,1
69483,160,14955,20606,39055,0,0,0,1,1
69484,160,14956,20224,39055,0,0,0,1,1
69485,160,14957,20066,39055,0,0,0,1,1
69486,160,14958,20026,39055,0,0,0,1,1
69487,160,14959,20590;20841,39055,0,0,0,2,2
69488,160,14960,20911,39055,0,0,0,1,1
69489,160,14961,20893,39055,0,0,0,1,1
69490,160,14962,20167;20338,39055,0,0,0,2,2
69491,160,14963,20322;20360,39055,0,0,0,2,2
69492,160,14964,20814,39055,0,0,0,1,1
69493,160,14965,20348,39055,0,0,0,1,1
69494,160,14966,20189,39055,0,0,0,1,1
69495,160,14968,20464,39055,0,0,0,1,1
69496,160,14969,20288,39055,0,0,0,1,1
69497,160,14970,20494;20710,39055,0,0,0,2,2
69498,160,14971,20029;20538,39055,0,0,0,2,2
69499,160,14972,20284,39055,0,0,0,1,1
69500,160,14973,20829,39055,0,0,0,1,1
69501,160,14974,20557;20836,39055,0,0,0,2,2
69502,160,14975,20566,39055,0,0,0,1,1
69503,160,14976,20524;20575,39055,0,0,0,2,2
69504,160,14978,20615,39055,0,0,0,1,1
69505,160,14979,20562,39055,0,0,0,1,1
69506,160,14980,21155,39055,0,0,0,1,1
69507,160,14981,20668;20821,39055,0,0,0,2,2
69508,160,14982,20687;20937,39055,0,0,0,2,2
69509,160,14983,20760;20765,39055,0,0,0,2,2
69510,160,14984,20720;20846,39055,0,0,0,2,2
69511,160,14985,20645;20725,39055,0,0,0,2,2
69512,160,14988,20980,39055,0,0,0,1,1
69513,160,14989,20792,39055,0,0,0,1,1
69514,160,14990,20519;20810,39055,0,0,0,2,2
69515,160,14991,21095;21122,39055,0,0,0,2,2
69516,160,15035,20073;20130,39420,0,0,0,2,2
69517,160,15037,19901,39420,0,0,0,1,1
69518,160,15038,20387,39420,0,0,0,1,1
69519,160,15039,20299;20670,39420,0,0,0,2,2
69520,160,15040,20407;20465,39420,0,0,0,2,2
69521,160,15042,20643,39420,0,0,0,1,1
69522,160,15044,20602;20609,39420,0,0,0,2,2
69523,160,15045,20149;20347,39420,0,0,0,2,2
69524,160,15046,20620,39420,0,0,0,1,1
69525,160,15047,20874,39420,0,0,0,1,1
69526,160,15048,20301,39420,0,0,0,1,1
69527,160,15050,20828,39420,0,0,0,1,1
69528,160,15051,20496;20859,39420,0,0,0,2,2
69529,160,15053,20779;20851,39420,0,0,0,2,2
69530,160,15054,20002;20467,39420,0,0,0,2,2
69531,160,15055,20471,39420,0,0,0,1,1
69532,160,15056,20474,39420,0,0,0,1,1
69533,160,15058,20234,39420,0,0,0,1,1
69534,160,15060,20173;20584,39420,0,0,0,2,2
69535,160,15061,20592;21166,39420,0,0,0,2,2
69536,160,15062,20131;20604,39420,0,0,0,2,2
69537,160,15063,20805;21028,39420,0,0,0,2,2
69538,160,15065,20610;20663,39420,0,0,0,2,2
69539,160,15066,20806;21036,39420,0,0,0,2,2
69540,160,15067,20313;20684,39420,0,0,0,2,2
69541,160,15068,21102,39420,0,0,0,1,1
69542,160,15069,20215;20709,39420,0,0,0,2,2
69543,160,15070,20611;21184,39420,0,0,0,2,2
69544,160,15071,20794,39420,0,0,0,1,1
69545,160,15072,20504;21037,39420,0,0,0,2,2
69546,160,15073,20759;20934,39420,0,0,0,2,2
69547,160,15074,20608;21175,39420,0,0,0,2,2
69548,160,15075,20757;21241,39420,0,0,0,2,2
69549,160,15076,20797;21048,39420,0,0,0,2,2
69550,160,15077,21017,39420,0,0,0,1,1
69551,160,15078,20863;20891,39420,0,0,0,2,2
69552,160,15079,20885;21170,39420,0,0,0,2,2
69553,160,15080,20938;21030,39420,0,0,0,2,2
69554,160,15081,20912,39420,0,0,0,1,1
69555,160,15082,20915;21059,39420,0,0,0,2,2
69556,160,15083,21158;21297,39420,0,0,0,2,2
69557,160,15084,20535;20922,39420,0,0,0,2,2
69558,160,15085,20865,39420,0,0,0,1,1
69559,160,15120,19549,39785,0,0,0,1,1
69560,160,15124,19573;19719,39785,0,0,0,2,2
69561,160,15127,19969;20170,39785,0,0,0,2,2
69562,160,15131,19985;20135,39785,0,0,0,2,2
69563,160,15133,19919,39785,0,0,0,1,1
69564,160,15134,19910;20294,39785,0,0,0,2,2
69565,160,15136,20282,39785,0,0,0,1,1
69566,160,15137,20037,39785,0,0,0,1,1
69567,160,15141,20262;20559,39785,0,0,0,2,2
69568,160,15142,20265;20617,39785,0,0,0,2,2
69569,160,15143,20267;20941,39785,0,0,0,2,2
69570,160,15144,20272;20953,39785,0,0,0,2,2
69571,160,15145,20764,39785,0,0,0,1,1
69572,160,15146,20251;20434,39785,0,0,0,2,2
69573,160,15147,20150;20285,39785,0,0,0,2,2
69574,160,15149,20378;20556,39785,0,0,0,2,2
69575,160,15150,20498,39785,0,0,0,1,1
69576,160,15152,20532;20560;24235,39785,0,0,1,2,3
69577,160,15153,20903;23753,39785,0,0,1,1,2
69578,160,15154,21298,39785,0,0,0,1,1
69579,160,15155,21111,39785,0,0,0,1,1
69580,160,15156,21415;25551,39785,0,0,1,1,2
69581,160,15157,23588;24343;27857,39785,0,1,2,0,3
69582,160,15158,20702;20946,39785,0,0,0,2,2
69583,160,15159,20269,39785,0,0,0,1,1
69584,160,15160,20788;20798,39785,0,0,0,2,2
69585,160,15161,20784;20826,39785,0,0,0,2,2
69586,160,15162,20850;20913,39785,0,0,0,2,2
69587,160,15164,20880;21253,39785,0,0,0,2,2
69588,160,15165,20887;21227,39785,0,0,0,2,2
69589,160,15166,20889,39785,0,0,0,1,1
69590,160,15167,20890;21394;24086;25218,39785,0,0,2,2,4
69591,160,15168,20908,39785,0,0,0,1,1
69592,160,15169,20871;21150,39785,0,0,0,2,2
69593,160,15170,20940;21414,39785,0,0,0,2,2
69594,160,15171,20942,39785,0,0,0,1,1
69595,160,15172,20964;21380,39785,0,0,0,2,2
69596,160,15173,20690;20965,39785,0,0,0,2,2
69597,160,15174,21259,39785,0,0,0,1,1
69598,160,15175,20431,39785,0,0,0,1,1
69599,160,15176,25024,39785,0,0,1,0,1
69600,160,15204,19418,40150,0,0,0,1,1
69601,160,15205,19296;19508,40150,0,0,0,2,2
69602,160,15212,19864;20213,40150,0,0,0,2,2
69603,160,15213,20034;20613,40150,0,0,0,2,2
69604,160,15214,19625;20079,40150,0,0,0,2,2
69605,160,15215,19829;20084,40150,0,0,0,2,2
69606,160,15216,20451,40150,0,0,0,1,1
69607,160,15217,20178;20692,40150,0,0,0,2,2
69608,160,15218,20329,40150,0,0,0,1,1
69609,160,15219,19738,40150,0,0,0,1,1
69610,160,15220,20298;20598,40150,0,0,0,2,2
69611,160,15223,20432,40150,0,0,0,1,1
69612,160,15224,20444;20930,40150,0,0,0,2,2
69613,160,15225,20094;20445,40150,0,0,0,2,2
69614,160,15226,20455;20967,40150,0,0,0,2,2
69615,160,15228,20838,40150,0,0,0,1,1
69616,160,15230,20552;20572,40150,0,0,0,2,2
69617,160,15231,20280;20581,40150,0,0,0,2,2
69618,160,15232,20341;20626,40150,0,0,0,2,2
69619,160,15233,20070,40150,0,0,0,1,1
69620,160,15234,20411,40150,0,0,0,1,1
69621,160,15235,20662;21068,40150,0,0,0,2,2
69622,160,15237,21145,40150,0,0,0,1,1
69623,160,15238,20727;20898,40150,0,0,0,2,2
69624,160,15240,20577,40150,0,0,0,1,1
69625,160,15241,20770;20888,40150,0,0,0,2,2
69626,160,15244,20553,40150,0,0,0,1,1
69627,160,15245,20856,40150,0,0,0,1,1
69628,160,15246,21138,40150,0,0,0,1,1
69629,160,15247,21060;26008,40150,0,0,1,1,2
69630,160,15248,20165;20528,40150,0,0,0,2,2
69631,160,15249,20773,40150,0,0,0,1,1
69632,160,15251,20972;21174,40150,0,0,0,2,2
69633,160,15252,20979,40150,0,0,0,1,1
69634,160,15253,20289;21004,40150,0,0,0,2,2
69635,160,15254,21153,40150,0,0,0,1,1
69636,160,15255,21033,40150,0,0,0,1,1
69637,160,15256,20516;21034,40150,0,0,0,2,2
69638,160,15257,21011;21044,40150,0,0,0,2,2
69639,160,15258,21069;21250,40150,0,0,0,2,2
69640,160,15259,20959,40150,0,0,0,1,1
69641,160,15260,21072,40150,0,0,0,1,1
69642,160,15261,21090;21293,40150,0,0,0,2,2
69643,160,15262,20849;21262,40150,0,0,0,2,2
69644,160,15263,21137,40150,0,0,0,1,1
69645,160,15265,20976;21173;25111,40150,0,0,1,2,3
69646,160,15266,21401;21493,40150,0,0,0,2,2
69647,160,15290,18995,40515,0,0,0,1,1
69648,160,15297,18522,40515,0,0,0,1,1
69649,160,15308,20311,40515,0,0,0,1,1
69650,160,15309,19841;19921,40515,0,0,0,2,2
69651,160,15310,19709,40515,0,0,0,1,1
69652,160,15313,20139,40515,0,0,0,1,1
69653,160,15316,20266,40515,0,0,0,1,1
69654,160,15317,20408,40515,0,0,0,1,1
69655,160,15318,20359,40515,0,0,0,1,1
69656,160,15320,20045;20614,40515,0,0,0,2,2
69657,160,15323,20991,40515,0,0,0,1,1
69658,160,15324,20204;20362,40515,0,0,0,2,2
69659,160,15326,20681;20843,40515,0,0,0,2,2
69660,160,15327,20877,40515,0,0,0,1,1
69661,160,15328,20426;20563,40515,0,0,0,2,2
69662,160,15329,20781,40515,0,0,0,1,1
69663,160,15330,20786,40515,0,0,0,1,1
69664,160,15331,19972;20701,40515,0,0,0,2,2
69665,160,15332,21162,40515,0,0,0,1,1
69666,160,15333,21278,40515,0,0,0,1,1
69667,160,15335,20458;20824,40515,0,0,0,2,2
69668,160,15336,20638;21356,40515,0,0,0,2,2
69669,160,15337,20716,40515,0,0,0,1,1
69670,160,15338,20675;21049,40515,0,0,0,2,2
69671,160,15339,20569;20677,40515,0,0,0,2,2
69672,160,15340,21217;21392,40515,0,0,0,2,2
69673,160,15342,20439;20758,40515,0,0,0,2,2
69674,160,15343,21047,40515,0,0,0,1,1
69675,160,15344,21035;21214;24686,40515,0,0,1,2,3
69676,160,15346,20852,40515,0,0,0,1,1
69677,160,15347,25004,40515,0,0,1,0,1
69678,160,15348,20896,40515,0,0,0,1,1
69679,160,15349,20936;25006;26811;27716,40515,0,1,2,1,4
69680,160,15350,20914;25005,40515,0,0,1,1,2
69681,160,15351,20895;21304,40515,0,0,0,2,2
69682,160,15352,21525,40515,0,0,0,1,1
69683,160,15353,21156,40515,0,0,0,1,1
69684,160,15354,20820,40515,0,0,0,1,1
69685,160,15355,21219;21441,40515,0,0,0,2,2
69686,160,15356,21052,40515,0,0,0,1,1
69687,160,15357,20919;20977,40515,0,0,0,2,2
69688,160,15358,21364;25654;28389,40515,1,0,1,1,3
69689,160,15359,20983;21290,40515,0,0,0,2,2
69690,160,15360,21474;25552;27463;27820;27926,40515,0,3,1,1,5
69691,160,15361,20955;21159,40515,0,0,0,2,2
69692,160,15362,21295,40515,0,0,0,1,1
69693,160,15363,20995;21086,40515,0,0,0,2,2
69694,160,15364,21023,40515,0,0,0,1,1
69695,160,15365,21208,40515,0,0,0,1,1
69696,160,15366,20655;21180,40515,0,0,0,2,2
69697,160,15367,20827;21186,40515,0,0,0,2,2
69698,160,15368,20904;21189,40515,0,0,0,2,2
69699,160,15369,21203,40515,0,0,0,1,1
69700,160,15370,21209;21252,40515,0,0,0,2,2
69701,160,15371,20691;21254,40515,0,0,0,2,2
69702,160,15372,20918;21449,40515,0,0,0,2,2
69703,160,15373,20855;21280,40515,0,0,0,2,2
69704,160,15374,21289;21387,40515,0,0,0,2,2
69705,160,15376,20648;21220,40515,0,0,0,2,2
69706,160,15377,21307;21347,40515,0,0,0,2,2
69707,160,15402,22945;23107,40880,0,0,2,0,2
69708,160,15406,19569;23688;25820;26682,40880,0,0,3,1,4
69709,160,15409,19008,40880,0,0,0,1,1
69710,160,15412,19363;19954,40880,0,0,0,2,2
69711,160,15415,19193;19769,40880,0,0,0,2,2
69712,160,15417,19706,40880,0,0,0,1,1
69713,160,15418,19834;20162,40880,0,0,0,2,2
69714,160,15425,20837,40880,0,0,0,1,1
69715,160,15426,20183;20631,40880,0,0,0,2,2
69716,160,15427,20811;24459;27773,40880,0,1,1,1,3
69717,160,15428,20753;21001,40880,0,0,0,2,2
69718,160,15430,20522;20578,40880,0,0,0,2,2
69719,160,15431,20867,40880,0,0,0,1,1
69720,160,15432,20576;20666,40880,0,0,0,2,2
69721,160,15434,21515;22085,40880,0,0,1,1,2
69722,160,15435,20594;20835,40880,0,0,0,2,2
69723,160,15436,21114,40880,0,0,0,1,1
69724,160,15437,21537;25138,40880,0,0,1,1,2
69725,160,15438,20883;21257,40880,0,0,0,2,2
69726,160,15439,20733;20900,40880,0,0,0,2,2
69727,160,15440,20960,40880,0,0,0,1,1
69728,160,15441,21471,40880,0,0,0,1,1
69729,160,15442,21021;21081,40880,0,0,0,2,2
69730,160,15443,20975;21372,40880,0,0,0,2,2
69731,160,15444,21123,40880,0,0,0,1,1
69732,160,15445,21077,40880,0,0,0,1,1
69733,160,15446,21201,40880,0,0,0,1,1
69734,160,15447,21105;21340,40880,0,0,0,2,2
69735,160,15448,21120;21633,40880,0,0,0,2,2
69736,160,15449,20998;21140,40880,0,0,0,2,2
69737,160,15450,21453,40880,0,0,0,1,1
69738,160,15452,20755,40880,0,0,0,1,1
69739,160,15453,21187;21193,40880,0,0,0,2,2
69740,160,15454,21202;21554,40880,0,0,0,2,2
69741,160,15455,21207,40880,0,0,0,1,1
69742,160,15456,21126;21258;25206;28094,40880,1,0,1,2,4
69743,160,15458,21163;21488,40880,0,0,0,2,2
69744,160,15459,20751;21288,40880,0,0,0,2,2
69745,160,15460,21306;21642,40880,0,0,0,2,2
69746,160,15461,21818;21878,40880,0,0,2,0,2
69747,160,15463,21277;21403,40880,0,0,0,2,2
69748,160,15464,21411,40880,0,0,0,1,1
69749,160,15497,23182;25724;26547,41245,0,0,3,0,3
69750,160,15504,19700,41245,0,0,0,1,1
69751,160,15505,20218;20534,41245,0,0,0,2,2
69752,160,15506,19951;20629,41245,0,0,0,2,2
69753,160,15513,20281;20449,41245,0,0,0,2,2
69754,160,15515,20601,41245,0,0,0,1,1
69755,160,15516,20221,41245,0,0,0,1,1
69756,160,15518,20502;20561,41245,0,0,0,2,2
69757,160,15521,20632,41245,0,0,0,1,1
69758,160,15522,20679,41245,0,0,0,1,1
69759,160,15524,20705,41245,0,0,0,1,1
69760,160,15526,21196,41245,0,0,0,1,1
69761,160,15527,20558;20796,41245,0,0,0,2,2
69762,160,15528,20834,41245,0,0,0,1,1
69763,160,15530,20868;20920,41245,0,0,0,2,2
69764,160,15531,21079,41245,0,0,0,1,1
69765,160,15532,20673;20925,41245,0,0,0,2,2
69766,160,15533,20858;21093,41245,0,0,0,2,2
69767,160,15534,20943;21115,41245,0,0,0,2,2
69768,160,15535,20982;25201,41245,0,0,1,1,2
69769,160,15536,21499;25742,41245,0,0,1,1,2
69770,160,15537,21002;21109,41245,0,0,0,2,2
69771,160,15538,21045;21087,41245,0,0,0,2,2
69772,160,15539,21051,41245,0,0,0,1,1
69773,160,15541,21089;21133,41245,0,0,0,2,2
69774,160,15543,20686;20721,41245,0,0,0,2,2
69775,160,15544,21760,41245,0,0,0,1,1
69776,160,15545,21352;21393,41245,0,0,0,2,2
69777,160,15546,21119;21176,41245,0,0,0,2,2
69778,160,15547,21020;21121,41245,0,0,0,2,2
69779,160,15548,21073;21141,41245,0,0,0,2,2
69780,160,15549,21104;21565,41245,0,0,0,2,2
69781,160,15550,21213;21231,41245,0,0,0,2,2
69782,160,15551,21168;21235,41245,0,0,0,2,2
69783,160,15552,21248,41245,0,0,0,1,1
69784,160,15554,21351;21865,41245,0,0,1,1,2
69785,160,15556,21242;21594,41245,0,0,0,2,2
69786,160,15557,21366;21523,41245,0,0,0,2,2
69787,160,15558,21369;21701,41245,0,0,0,2,2
69788,160,15559,21370;21577,41245,0,0,0,2,2
69789,160,15560,21130;21439,41245,0,0,0,2,2
69790,160,15561,21794;26210,41245,0,0,2,0,2
69791,160,15562,21455;21545,41245,0,0,0,2,2
69792,160,15563,21421,41245,0,0,0,1,1
69793,160,15564,25014;25055;27717,41245,0,1,2,0,3
69794,160,15565,21801;24517;26911;27690;28056;28236,41245,2,2,2,0,6
69795,160,15566,21379;21508,41245,0,0,0,2,2
69796,160,15567,21302;21513,41245,0,0,0,2,2
69797,160,15568,21714,41245,0,0,0,1,1
69798,160,15569,21517;21833;25927,41245,0,0,2,1,3
69799,160,15600,19481;19859,41610,0,0,0,2,2
69800,160,15605,20526,41610,0,0,0,1,1
69801,160,15606,19362,41610,0,0,0,1,1
69802,160,15608,20087,41610,0,0,0,1,1
69803,160,15609,20049;20147,41610,0,0,0,2,2
69804,160,15611,20243;20659,41610,0,0,0,2,2
69805,160,15615,20358,41610,0,0,0,1,1
69806,160,15616,20637,41610,0,0,0,1,1
69807,160,15617,20737,41610,0,0,0,1,1
69808,160,15618,20419,41610,0,0,0,1,1
69809,160,15619,20180,41610,0,0,0,1,1
69810,160,15621,20386;20588,41610,0,0,0,2,2
69811,160,15622,20695,41610,0,0,0,1,1
69812,160,15624,20203;20731,41610,0,0,0,2,2
69813,160,15625,20787;20921,41610,0,0,0,2,2
69814,160,15626,20984;21268,41610,0,0,0,2,2
69815,160,15627,20875;21320,41610,0,0,0,2,2
69816,160,15628,21447,41610,0,0,0,1,1
69817,160,15630,20902,41610,0,0,0,1,1
69818,160,15631,20958,41610,0,0,0,1,1
69819,160,15632,20674,41610,0,0,0,1,1
69820,160,15634,21012;24893,41610,0,0,1,1,2
69821,160,15635,20923;21019;25824,41610,0,0,1,2,3
69822,160,15636,21043;21478,41610,0,0,0,2,2
69823,160,15637,21046,41610,0,0,0,1,1
69824,160,15639,21065,41610,0,0,0,1,1
69825,160,15640,21405;21500,41610,0,0,0,2,2
69826,160,15641,20748;21097,41610,0,0,0,2,2
69827,160,15642,21066;21404,41610,0,0,0,2,2
69828,160,15643,21608,41610,0,0,0,1,1
69829,160,15644,21371,41610,0,0,0,1,1
69830,160,15645,21157;25110;27642,41610,0,1,1,1,3
69831,160,15646,21579;21706,41610,0,0,0,2,2
69832,160,15648,24879;24905,41610,0,0,2,0,2
69833,160,15649,20968;21192,41610,0,0,0,2,2
69834,160,15650,20961;21423,41610,0,0,0,2,2
69835,160,15652,21299;21337,41610,0,0,0,2,2
69836,160,15653,21413;21420,41610,0,0,0,2,2
69837,160,15654,20815;21482,41610,0,0,0,2,2
69838,160,15655,20882;21342,41610,0,0,0,2,2
69839,160,15657,21376;21388;25828,41610,0,0,1,2,3
69840,160,15660,22036,41610,0,0,1,0,1
69841,160,15661,21479,41610,0,0,0,1,1
69842,160,15662,21249;21483;24290;25830,41610,0,0,2,2,4
69843,160,15664,21327,41610,0,0,0,1,1
69844,160,15665,22005;22108,41610,0,0,2,0,2
69845,160,15666,21409;21772,41610,0,0,0,2,2
69846,160,15667,21648;21973,41610,0,0,1,1,2
69847,160,15668,21232;21504,41610,0,0,0,2,2
69848,160,15669,21456;21467;25345,41610,0,0,1,2,3
69849,160,15670,21261;21660,41610,0,0,0,2,2
69850,160,15683,18429,41975,0,0,0,1,1
69851,160,15697,19883,41975,0,0,0,1,1
69852,160,15700,19925,41975,0,0,0,1,1
69853,160,15708,21132,41975,0,0,0,1,1
69854,160,15709,23853;23968;24453;24944;27225;27309;27666;27894;28079;28172,41975,2,4,4,0,10
69855,160,15710,19876;20095,41975,0,0,0,2,2
69856,160,15711,20706,41975,0,0,0,1,1
69857,160,15714,20767;21206,41975,0,0,0,2,2
69858,160,15715,19930;20699,41975,0,0,0,2,2
69859,160,15717,20735;21218;25651;27561,41975,0,1,1,2,4
69860,160,15718,20762,41975,0,0,0,1,1
69861,160,15719,20482;20769,41975,0,0,0,2,2
69862,160,15720,20771,41975,0,0,0,1,1
69863,160,15722,20901,41975,0,0,0,1,1
69864,160,15723,20636;20833,41975,0,0,0,2,2
69865,160,15724,20928;21129,41975,0,0,0,2,2
69866,160,15725,20633;21179,41975,0,0,0,2,2
69867,160,15726,21006,41975,0,0,0,1,1
69868,160,15727,21566;21606,41975,0,0,0,2,2
69869,160,15729,20417;21165,41975,0,0,0,2,2
69870,160,15730,21223,41975,0,0,0,1,1
69871,160,15732,21260;24908;28078;28341,41975,2,0,1,1,4
69872,160,15733,21116;21443,41975,0,0,0,2,2
69873,160,15735,20466;21181,41975,0,0,0,2,2
69874,160,15739,21117;21233,41975,0,0,0,2,2
69875,160,15740,21590,41975,0,0,0,1,1
69876,160,15741,20660;21239,41975,0,0,0,2,2
69877,160,15742,21269;21308,41975,0,0,0,2,2
69878,160,15743,21267;21284;25119,41975,0,0,1,2,3
69879,160,15744,21303,41975,0,0,0,1,1
69880,160,15745,21169;21450,41975,0,0,0,2,2
69881,160,15746,21375;21614,41975,0,0,0,2,2
69882,160,15747,21381,41975,0,0,0,1,1
69883,160,15748,21757,41975,0,0,0,1,1
69884,160,15749,21464;21953,41975,0,0,1,1,2
69885,160,15751,21539;21738;24927,41975,0,0,1,2,3
69886,160,15752,22089,41975,0,0,1,0,1
69887,160,15753,21576;21652,41975,0,0,0,2,2
69888,160,15754,21559;22106,41975,0,0,1,1,2
69889,160,15755,21692;21970,41975,0,0,1,1,2
69890,160,15758,21829;22082,41975,0,0,2,0,2
69891,160,15759,21600;21800,41975,0,0,1,1,2
69892,160,15760,21707;22081,41975,0,0,1,1,2
69893,160,15763,21640,41975,0,0,0,1,1
69894,160,15764,21323;21895,41975,0,0,1,1,2
69895,160,15765,21444;21845,41975,0,0,1,1,2
69896,160,15767,21808,41975,0,0,1,0,1
69897,160,15769,21777;21956,41975,0,0,1,1,2
69898,160,15770,22021,41975,0,0,1,0,1
69899,160,15771,21712,41975,0,0,0,1,1
69900,160,15772,21870;24952,41975,0,0,2,0,2
69901,160,15780,18042;18235,42340,0,0,0,2,2
69902,160,15784,18876,42340,0,0,0,1,1
69903,160,15786,19001,42340,0,0,0,1,1
69904,160,15799,20137,42340,0,0,0,1,1
69905,160,15800,19698;19699,42340,0,0,0,2,2
69906,160,15802,20012,42340,0,0,0,1,1
69907,160,15804,19820;20088,42340,0,0,0,2,2
69908,160,15805,20511,42340,0,0,0,1,1
69909,160,15808,20214;20508,42340,0,0,0,2,2
69910,160,15809,21178,42340,0,0,0,1,1
69911,160,15810,20371;20536,42340,0,0,0,2,2
69912,160,15811,20641,42340,0,0,0,1,1
69913,160,15813,20749;20774,42340,0,0,0,2,2
69914,160,15815,20813;21527,42340,0,0,0,2,2
69915,160,15816,20672;20853,42340,0,0,0,2,2
69916,160,15818,20873;20969,42340,0,0,0,2,2
69917,160,15819,20283;20951,42340,0,0,0,2,2
69918,160,15820,20551,42340,0,0,0,1,1
69919,160,15821,20527;21010,42340,0,0,0,2,2
69920,160,15822,21009;21237,42340,0,0,0,2,2
69921,160,15823,21623,42340,0,0,0,1,1
69922,160,15824,20693;21164,42340,0,0,0,2,2
69923,160,15825,21125;21496,42340,0,0,0,2,2
69924,160,15827,21110;21197,42340,0,0,0,2,2
69925,160,15828,21148,42340,0,0,0,1,1
69926,160,15830,21212,42340,0,0,0,1,1
69927,160,15831,21910,42340,0,0,1,0,1
69928,160,15832,21225,42340,0,0,0,1,1
69929,160,15834,20653;21246,42340,0,0,0,2,2
69930,160,15835,21264;21830,42340,0,0,1,1,2
69931,160,15836,21229;21334,42340,0,0,0,2,2
69932,160,15837,20973;21346,42340,0,0,0,2,2
69933,160,15839,21635,42340,0,0,0,1,1
69934,160,15840,21063;21427,42340,0,0,0,2,2
69935,160,15841,21336;21522,42340,0,0,0,2,2
69936,160,15842,21292;21529;25554,42340,0,0,1,2,3
69937,160,15843,21552;21575,42340,0,0,0,2,2
69938,160,15844,21561,42340,0,0,0,1,1
69939,160,15845,21222;21591;24508,42340,0,0,1,2,3
69940,160,15846,21551;21595,42340,0,0,0,2,2
69941,160,15847,21680,42340,0,0,0,1,1
69942,160,15848,21502;21872;25252,42340,0,0,2,1,3
69943,160,15849,21721;22059,42340,0,0,1,1,2
69944,160,15850,21448;21694,42340,0,0,0,2,2
69945,160,15851,21722,42340,0,0,0,1,1
69946,160,15852,21725,42340,0,0,0,1,1
69947,160,15853,21729;22181,42340,0,0,1,1,2
69948,160,15854,21759;22260,42340,0,0,1,1,2
69949,160,15855,21769,42340,0,0,0,1,1
69950,160,15856,21099;21532,42340,0,0,0,2,2
69951,160,15857,21461;21852,42340,0,0,1,1,2
69952,160,15859,21636;21804,42340,0,0,1,1,2
69953,160,15860,21817;22121,42340,0,0,2,0,2
69954,160,15861,21820,42340,0,0,1,0,1
69955,160,15862,21802;21861,42340,0,0,2,0,2
69956,160,15863,21386;21866,42340,0,0,1,1,2
69957,160,15864,21994;22066;26108,42340,0,0,3,0,3
69958,160,15888,19631,42705,0,0,0,1,1
69959,160,15900,19942,42705,0,0,0,1,1
69960,160,15901,20644,42705,0,0,0,1,1
69961,160,15903,20446;20839,42705,0,0,0,2,2
69962,160,15906,20390;20477,42705,0,0,0,2,2
69963,160,15908,20514,42705,0,0,0,1,1
69964,160,15909,20543;20597,42705,0,0,0,2,2
69965,160,15910,21285,42705,0,0,0,1,1
69966,160,15911,20741,42705,0,0,0,1,1
69967,160,15912,20957;21255,42705,0,0,0,2,2
69968,160,15913,20807,42705,0,0,0,1,1
69969,160,15914,20857,42705,0,0,0,1,1
69970,160,15915,21154;21194,42705,0,0,0,2,2
69971,160,15916,21265,42705,0,0,0,1,1
69972,160,15917,21305;21885,42705,0,0,1,1,2
69973,160,15918,20926;21309,42705,0,0,0,2,2
69974,160,15919,21353;21416;25653,42705,0,0,1,2,3
69975,160,15920,21377,42705,0,0,0,1,1
69976,160,15922,21216;21410,42705,0,0,0,2,2
69977,160,15924,21417;21688,42705,0,0,0,2,2
69978,160,15926,21874;25369;26105,42705,0,0,3,0,3
69979,160,15927,21728;22175;26311,42705,0,0,2,1,3
69980,160,15929,21571,42705,0,0,0,1,1
69981,160,15931,21452;22157;26025,42705,0,0,2,1,3
69982,160,15932,21619,42705,0,0,0,1,1
69983,160,15933,21690;21740,42705,0,0,0,2,2
69984,160,15935,21484;21751;25143,42705,0,0,1,2,3
69985,160,15936,22168;22356;25860;27828,42705,0,1,3,0,4
69986,160,15937,21531;21675,42705,0,0,0,2,2
69987,160,15938,21766;22013,42705,0,0,1,1,2
69988,160,15939,21567;25832,42705,0,0,1,1,2
69989,160,15940,21784;21917,42705,0,0,2,0,2
69990,160,15941,21492,42705,0,0,0,1,1
69991,160,15942,21612;22188;26114,42705,0,0,2,1,3
69992,160,15943,21384;21625,42705,0,0,0,2,2
69993,160,15944,21957,42705,0,0,1,0,1
69994,160,15945,21466;21654,42705,0,0,0,2,2
69995,160,15947,22227;22312,42705,0,0,2,0,2
69996,160,15948,21792;21911,42705,0,0,2,0,2
69997,160,15949,21742;21849;23775,42705,0,0,2,1,3
69998,160,15950,22237,42705,0,0,1,0,1
69999,160,15951,21646;21921,42705,0,0,1,1,2
70000,160,15952,21240;21807;25052;28176,42705,1,0,2,1,4
70001,160,15953,21810;22095,42705,0,0,2,0,2
70002,160,15954,21812,42705,0,0,1,0,1
70003,160,15955,22031;22196;26313,42705,0,0,3,0,3
70004,160,15956,22104,42705,0,0,1,0,1
70005,160,15957,22271;22286,42705,0,0,2,0,2
70006,160,15958,22009;22025,42705,0,0,2,0,2
70007,160,15959,21602;22149,42705,0,0,1,1,2
70008,160,15960,21524;21843;26014,42705,0,0,2,1,3
70009,160,15961,21881;21892,42705,0,0,2,0,2
70010,160,15962,21888;22302,42705,0,0,2,0,2
70011,160,15963,21880;21894,42705,0,0,2,0,2
70012,160,15964,21704;21906;25370;25667;27732,42705,0,1,3,1,5
70013,160,15965,21946;22147,42705,0,0,2,0,2
70014,160,15966,21578;21977,42705,0,0,1,1,2
70015,160,15967,21331;22023,42705,0,0,1,1,2
70016,160,15987,18996;19594,43070,0,0,0,2,2
70017,160,15989,19524,43070,0,0,0,1,1
70018,160,15996,20729,43070,0,0,0,1,1
70019,160,16000,20700,43070,0,0,0,1,1
70020,160,16001,20171;20428,43070,0,0,0,2,2
70021,160,16003,20373,43070,0,0,0,1,1
70022,160,16004,20510;20747,43070,0,0,0,2,2
70023,160,16006,19909,43070,0,0,0,1,1
70024,160,16008,20425;20768,43070,0,0,0,2,2
70025,160,16009,20125;20587,43070,0,0,0,2,2
70026,160,16011,20512;20676,43070,0,0,0,2,2
70027,160,16017,20817;21390,43070,0,0,0,2,2
70028,160,16018,20529;20910,43070,0,0,0,2,2
70029,160,16020,21501,43070,0,0,0,1,1
70030,160,16021,20987;21518;24821,43070,0,0,1,2,3
70031,160,16022,21075;21350,43070,0,0,0,2,2
70032,160,16027,21641;21836;23893,43070,0,0,2,1,3
70033,160,16028,21716,43070,0,0,0,1,1
70034,160,16029,21215;21282,43070,0,0,0,2,2
70035,160,16030,21512,43070,0,0,0,1,1
70036,160,16031,21083;21321,43070,0,0,0,2,2
70037,160,16032,21134;21329,43070,0,0,0,2,2
70038,160,16033,21607;25352;27180;28008;28364,43070,2,1,1,1,5
70039,160,16034,21245,43070,0,0,0,1,1
70040,160,16035,21402;24812,43070,0,0,1,1,2
70041,160,16036,21426;21839,43070,0,0,1,1,2
70042,160,16037,20719;21437,43070,0,0,0,2,2
70043,160,16038,21311;21510,43070,0,0,0,2,2
70044,160,16039,21629,43070,0,0,0,1,1
70045,160,16040,21988,43070,0,0,1,0,1
70046,160,16041,21664;24934,43070,0,0,1,1,2
70047,160,16042,21621;21768,43070,0,0,0,2,2
70048,160,16043,21702,43070,0,0,0,1,1
70049,160,16044,21703,43070,0,0,0,1,1
70050,160,16045,21989;22236,43070,0,0,2,0,2
70051,160,16047,21720;22003,43070,0,0,1,1,2
70052,160,16048,21431;21530,43070,0,0,0,2,2
70053,160,16049,21433;21771,43070,0,0,0,2,2
70054,160,16050,21775;22391;25770;25947,43070,0,0,3,1,4
70055,160,16051,21798;22354;25687;27929,43070,0,1,3,0,4
70056,160,16052,21809,43070,0,0,1,0,1
70057,160,16053,21569;21841;26013,43070,0,0,2,1,3
70058,160,16055,21790;22241,43070,0,0,2,0,2
70059,160,16056,21883,43070,0,0,1,0,1
70060,160,16057,22073;22080,43070,0,0,2,0,2
70061,160,16059,21942;22034,43070,0,0,2,0,2
70062,160,16060,21948;22178;25388;25580;26214,43070,0,0,5,0,5
70063,160,16062,22010;26213,43070,0,0,2,0,2
70064,160,16063,22022;22287,43070,0,0,2,0,2
70065,160,16064,22043;22045,43070,0,0,2,0,2
70066,160,16065,21896;22054,43070,0,0,2,0,2
70067,160,16066,21916;22584,43070,0,0,2,0,2
70068,160,16068,21312;22094,43070,0,0,1,1,2
70069,160,16069,22092;22111;24746,43070,0,0,3,0,3
70070,160,16070,22113;22133,43070,0,0,2,0,2
70071,160,16071,21930;22240,43070,0,0,2,0,2
70072,160,16072,22146;22516;24632;26224;27260;27870,43070,0,2,4,0,6
70073,160,16073,22032;22148,43070,0,0,2,0,2
70074,160,16077,17764,43435,0,0,0,1,1
70075,160,16084,18601,43435,0,0,0,1,1
70076,160,16085,18459,43435,0,0,0,1,1
70077,160,16094,19102,43435,0,0,0,1,1
70078,160,16105,20812,43435,0,0,0,1,1
70079,160,16107,21056,43435,0,0,0,1,1
70080,160,16110,20847;21091,43435,0,0,0,2,2
70081,160,16113,21339,43435,0,0,0,1,1
70082,160,16115,20970;21067,43435,0,0,0,2,2
70083,160,16118,20949;21131,43435,0,0,0,2,2
70084,160,16119,21147;21407,43435,0,0,0,2,2
70085,160,16120,20986,43435,0,0,0,1,1
70086,160,16121,21128;21211,43435,0,0,0,2,2
70087,160,16122,21143;21300,43435,0,0,0,2,2
70088,160,16123,21709,43435,0,0,0,1,1
70089,160,16124,21230;21322,43435,0,0,0,2,2
70090,160,16125,21644;21987,43435,0,0,1,1,2
70091,160,16126,21171;21361,43435,0,0,0,2,2
70092,160,16127,21459,43435,0,0,0,1,1
70093,160,16128,21378,43435,0,0,0,1,1
70094,160,16129,21481,43435,0,0,0,1,1
70095,160,16130,21980,43435,0,0,1,0,1
70096,160,16133,21589,43435,0,0,0,1,1
70097,160,16134,21975,43435,0,0,1,0,1
70098,160,16135,21626;21902,43435,0,0,1,1,2
70099,160,16136,21853;21897,43435,0,0,2,0,2
70100,160,16138,21684;21939,43435,0,0,1,1,2
70101,160,16139,22061,43435,0,0,1,0,1
70102,160,16140,21733;22492;25181;26220,43435,0,0,3,1,4
70103,160,16141,21271;21748,43435,0,0,0,2,2
70104,160,16143,21314;21780,43435,0,0,0,2,2
70105,160,16144,22187;22214,43435,0,0,2,0,2
70106,160,16145,21604;21931,43435,0,0,1,1,2
70107,160,16146,21540;21863,43435,0,0,1,1,2
70108,160,16147,22378;25595,43435,0,0,2,0,2
70109,160,16148,21827,43435,0,0,1,0,1
70110,160,16150,21088;21912;25255,43435,0,0,2,1,3
70111,160,16151,21922;22261;25271;27915,43435,0,1,3,0,4
70112,160,16152,21933;26212,43435,0,0,2,0,2
70113,160,16153,21934,43435,0,0,1,0,1
70114,160,16154,22091,43435,0,0,1,0,1
70115,160,16155,22120;22306;25766,43435,0,0,3,0,3
70116,160,16156,21708;22098,43435,0,0,1,1,2
70117,160,16157,22017;22410,43435,0,0,2,0,2
70118,160,16158,21797;22056,43435,0,0,2,0,2
70119,160,16159,22064;22125,43435,0,0,2,0,2
70120,160,16160,22074;22438,43435,0,0,2,0,2
70121,160,16161,22182;22305,43435,0,0,2,0,2
70122,160,16162,22076;22299,43435,0,0,2,0,2
70123,160,16163,22078;22502,43435,0,0,2,0,2
70124,160,16165,22019;22359,43435,0,0,2,0,2
70125,160,16166,22100;22276,43435,0,0,2,0,2
70126,160,16167,21971;22293;25943,43435,0,0,3,0,3
70127,160,16168,22145;22162,43435,0,0,2,0,2
70128,160,16169,22330;22478;25396;27650,43435,0,1,3,0,4
70129,160,16170,22177;22423,43435,0,0,2,0,2
70130,160,16171,22180,43435,0,0,1,0,1
70131,160,16173,22218;22321,43435,0,0,2,0,2
70132,160,16174,21919;22267;26031;28300,43435,1,0,3,0,4
70133,160,16175,22274;22385;26419,43435,0,0,3,0,3
70134,160,16189,18705,43800,0,0,0,1,1
70135,160,16190,18881,43800,0,0,0,1,1
70136,160,16197,19183,43800,0,0,0,1,1
70137,160,16202,19406,43800,0,0,0,1,1
70138,160,16209,19815;20115,43800,0,0,0,2,2
70139,160,16210,20331;20339,43800,0,0,0,2,2
70140,160,16211,20722,43800,0,0,0,1,1
70141,160,16213,20476,43800,0,0,0,1,1
70142,160,16214,20290;20479;26474,43800,0,0,1,2,3
70143,160,16219,20661,43800,0,0,0,1,1
70144,160,16221,21210,43800,0,0,0,1,1
70145,160,16223,20436;20518,43800,0,0,0,2,2
70146,160,16225,20564;20754,43800,0,0,0,2,2
70147,160,16226,20864;21199,43800,0,0,0,2,2
70148,160,16228,20320;20630;24774,43800,0,0,1,2,3
70149,160,16230,20468;21013,43800,0,0,0,2,2
70150,160,16231,21615,43800,0,0,0,1,1
70151,160,16232,21687,43800,0,0,0,1,1
70152,160,16235,20665;21332,43800,0,0,0,2,2
70153,160,16236,21251,43800,0,0,0,1,1
70154,160,16237,20996;21272,43800,0,0,0,2,2
70155,160,16239,21735;22028,43800,0,0,1,1,2
70156,160,16240,21924;22212,43800,0,0,2,0,2
70157,160,16241,21643;22050,43800,0,0,1,1,2
70158,160,16242,21511;24505;27610;28054,43800,1,1,1,1,4
70159,160,16243,21024;21520,43800,0,0,0,2,2
70160,160,16245,21564,43800,0,0,0,1,1
70161,160,16246,21486;21711,43800,0,0,0,2,2
70162,160,16248,21533;21681,43800,0,0,0,2,2
70163,160,16249,20854,43800,0,0,0,1,1
70164,160,16250,21468;21631,43800,0,0,0,2,2
70165,160,16251,21745;21932;25669,43800,0,0,2,1,3
70166,160,16252,21451;21856,43800,0,0,1,1,2
70167,160,16253,22164;22413,43800,0,0,2,0,2
70168,160,16255,21823;22099,43800,0,0,2,0,2
70169,160,16256,21842;26306,43800,0,0,2,0,2
70170,160,16257,21507;21867,43800,0,0,1,1,2
70171,160,16258,22079;22266;24752,43800,0,0,3,0,3
70172,160,16259,21732;21891,43800,0,0,1,1,2
70173,160,16260,21854;22426;26611,43800,0,0,3,0,3
70174,160,16261,22661;22864;26428,43800,0,0,3,0,3
70175,160,16262,21391;21831,43800,0,0,1,1,2
70176,160,16263,21995;22016,43800,0,0,2,0,2
70177,160,16265,22007;22474,43800,0,0,2,0,2
70178,160,16266,21498;22062,43800,0,0,1,1,2
70179,160,16267,21776;22303,43800,0,0,1,1,2
70180,160,16268,21795;22169,43800,0,0,2,0,2
70181,160,16269,22101;22129;26414,43800,0,0,3,0,3
70182,160,16270,22208;22546,43800,0,0,2,0,2
70183,160,16271,21779;22154;26929,43800,0,1,1,1,3
70184,160,16272,22138;22159,43800,0,0,2,0,2
70185,160,16275,21632;22048,43800,0,0,1,1,2
70186,160,16276,22165;22680,43800,0,0,2,0,2
70187,160,16277,22621,43800,0,0,1,0,1
70188,160,16278,22252;22331,43800,0,0,2,0,2
70189,160,16279,22269;22542,43800,0,0,2,0,2
70190,160,16280,22337,43800,0,0,1,0,1
70191,160,16281,22300;22506,43800,0,0,2,0,2
70192,160,16282,22319,43800,0,0,1,0,1
70193,160,16283,22493;22613;26131,43800,0,0,3,0,3
70194,160,16284,22471,43800,0,0,1,0,1
70195,160,16285,22115;22347;25282;25686;26507;28316,43800,1,0,5,0,6
70196,160,16286,22249;22379,43800,0,0,2,0,2
70197,160,16287,22343;22380,43800,0,0,2,0,2
70198,160,16288,26232,43800,0,0,1,0,1
70199,160,16295,18295,44165,0,0,0,1,1
70200,160,16314,24647;25083;28351,44165,1,0,2,0,3
70201,160,16317,20402,44165,0,0,0,1,1
70202,160,16318,20623;20703,44165,0,0,0,2,2
70203,160,16319,20803,44165,0,0,0,1,1
70204,160,16320,20777;20963;24168;26697;26893;26986;27675,44165,0,3,2,2,7
70205,160,16322,21084;21618,44165,0,0,0,2,2
70206,160,16325,20750;21221,44165,0,0,0,2,2
70207,160,16327,20881;21341,44165,0,0,0,2,2
70208,160,16328,21541;21731;24512;27432;28055,44165,1,1,1,2,5
70209,160,16329,21788;21981,44165,0,0,2,0,2
70210,160,16330,22117,44165,0,0,1,0,1
70211,160,16332,22112;22425,44165,0,0,2,0,2
70212,160,16333,22015;22499,44165,0,0,2,0,2
70213,160,16334,21274;21685,44165,0,0,0,2,2
70214,160,16335,21781,44165,0,0,0,1,1
70215,160,16336,21786,44165,0,0,1,0,1
70216,160,16337,21755;21789;25050;28349,44165,1,0,2,1,4
70217,160,16338,21824;21927,44165,0,0,2,0,2
70218,160,16339,21454;21860,44165,0,0,1,1,2
70219,160,16340,21890;21943,44165,0,0,2,0,2
70220,160,16341,21538;21951;25228,44165,0,0,2,1,3
70221,160,16342,21952;22044,44165,0,0,2,0,2
70222,160,16343,21689;21974,44165,0,0,1,1,2
70223,160,16345,22060,44165,0,0,1,0,1
70224,160,16346,22093,44165,0,0,1,0,1
70225,160,16348,22055;22070,44165,0,0,2,0,2
70226,160,16349,22270;26216;26316,44165,0,0,3,0,3
70227,160,16350,22543;25605,44165,0,0,2,0,2
70228,160,16351,22176;22662;26520,44165,0,0,3,0,3
70229,160,16352,22216;22592;26517,44165,0,0,3,0,3
70230,160,16353,22233;26026,44165,0,0,2,0,2
70231,160,16355,22547;25510,44165,0,0,2,0,2
70232,160,16358,22341;22574;26130;26325,44165,0,0,4,0,4
70233,160,16359,21851;22446,44165,0,0,2,0,2
70234,160,16360,22489;22598,44165,0,0,2,0,2
70235,160,16361,21944;22498;25291;26222;27725,44165,0,1,4,0,5
70236,160,16363,18296,44530,0,0,0,1,1
70237,160,16371,19590,44530,0,0,0,1,1
70238,160,16374,19467,44530,0,0,0,1,1
70239,160,16375,20148,44530,0,0,0,1,1
70240,160,16382,19802;19939,44530,0,0,0,2,2
70241,160,16383,20188,44530,0,0,0,1,1
70242,160,16384,20085,44530,0,0,0,1,1
70243,160,16386,20349,44530,0,0,0,1,1
70244,160,16387,20018;20399,44530,0,0,0,2,2
70245,160,16393,20899;21620,44530,0,0,0,2,2
70246,160,16395,21005;21445,44530,0,0,0,2,2
70247,160,16396,21655,44530,0,0,0,1,1
70248,160,16400,21238;21535,44530,0,0,0,2,2
70249,160,16402,21338;21514,44530,0,0,0,2,2
70250,160,16403,21061;21382;25217;28264,44530,1,0,1,2,4
70251,160,16404,21244;21385,44530,0,0,0,2,2
70252,160,16405,21762,44530,0,0,0,1,1
70253,160,16406,25556;27464;28016,44530,1,1,1,0,3
70254,160,16407,21627;22230,44530,0,0,1,1,2
70255,160,16408,22142,44530,0,0,1,0,1
70256,160,16409,21584;21651,44530,0,0,0,2,2
70257,160,16410,21555;22150,44530,0,0,1,1,2
70258,160,16411,21634;21730,44530,0,0,0,2,2
70259,160,16412,21739;21793,44530,0,0,1,1,2
70260,160,16413,21749;21785,44530,0,0,1,1,2
70261,160,16414,21204,44530,0,0,0,1,1
70262,160,16415,21599;22273;25492,44530,0,0,2,1,3
70263,160,16416,21963;27423,44530,0,1,1,0,2
70264,160,16420,21991,44530,0,0,1,0,1
70265,160,16421,22335;25174,44530,0,0,2,0,2
70266,160,16422,22090,44530,0,0,1,0,1
70267,160,16423,22894;25800,44530,0,0,2,0,2
70268,160,16424,22119;22307,44530,0,0,2,0,2
70269,160,16425,22198;22779,44530,0,0,2,0,2
70270,160,16426,22280,44530,0,0,1,0,1
70271,160,16427,22170;22281;25273;27916;28267,44530,1,1,3,0,5
70272,160,16430,22358,44530,0,0,1,0,1
70273,160,16431,22372;22440;25594,44530,0,0,3,0,3
70274,160,16432,22406;22477;25406;26512;28103,44530,1,0,4,0,5
70275,160,16436,22491;22527;26040,44530,0,0,3,0,3
70276,160,16437,22529;22717;26051,44530,0,0,3,0,3
70277,160,16438,22225;22531,44530,0,0,2,0,2
70278,160,16439,22329;22550;26615,44530,0,0,3,0,3
70279,160,16440,22799;26337,44530,0,0,2,0,2
70280,160,16441,21815;22238;26324,44530,0,0,3,0,3
70281,160,16442,22870;26623;26730,44530,0,0,3,0,3
70282,160,16443,22325;22588,44530,0,0,2,0,2
70283,160,16444,22567;22599,44530,0,0,2,0,2
70284,160,16449,18351,44895,0,0,0,1,1
70285,160,16454,18124,44895,0,0,0,1,1
70286,160,16461,19043,44895,0,0,0,1,1
70287,160,16468,19566,44895,0,0,0,1,1
70288,160,16470,19673,44895,0,0,0,1,1
70289,160,16482,20454,44895,0,0,0,1,1
70290,160,16483,20410,44895,0,0,0,1,1
70291,160,16485,20744,44895,0,0,0,1,1
70292,160,16487,20886;21296,44895,0,0,0,2,2
70293,160,16488,21136;21360,44895,0,0,0,2,2
70294,160,16489,21247,44895,0,0,0,1,1
70295,160,16490,21198,44895,0,0,0,1,1
70296,160,16492,22004,44895,0,0,1,0,1
70297,160,16493,21582,44895,0,0,0,1,1
70298,160,16496,21581;21603,44895,0,0,0,2,2
70299,160,16497,21585;21700;24830,44895,0,0,1,2,3
70300,160,16500,21918;22324,44895,0,0,2,0,2
70301,160,16501,21396,44895,0,0,0,1,1
70302,160,16502,21737,44895,0,0,0,1,1
70303,160,16503,21954;22057;24209;25383;27065,44895,0,1,4,0,5
70304,160,16504,22283;22422;25584,44895,0,0,3,0,3
70305,160,16505,21348;22018,44895,0,0,1,1,2
70306,160,16506,22248;22428,44895,0,0,2,0,2
70307,160,16507,21846;21928,44895,0,0,2,0,2
70308,160,16508,22126;22268;25272,44895,0,0,3,0,3
70309,160,16510,21898;22024,44895,0,0,2,0,2
70310,160,16511,22361;22424,44895,0,0,2,0,2
70311,160,16512,21941;22127,44895,0,0,2,0,2
70312,160,16514,22105;22152,44895,0,0,2,0,2
70313,160,16515,21875;22458,44895,0,0,2,0,2
70314,160,16516,22174;25848;27932,44895,0,1,2,0,3
70315,160,16518,22202;22620;26329,44895,0,0,3,0,3
70316,160,16520,21915;22496;26221,44895,0,0,3,0,3
70317,160,16521,21796;22289;25856;26415,44895,0,0,4,0,4
70318,160,16522,22732;26523,44895,0,0,2,0,2
70319,160,16523,22339;22671;25875,44895,0,0,3,0,3
70320,160,16524,22349;22392,44895,0,0,2,0,2
70321,160,16525,22352,44895,0,0,1,0,1
70322,160,16526,22765;26618,44895,0,0,2,0,2
70323,160,16527,22365;22566;24530;27776;27966,44895,1,1,3,0,5
70324,160,16529,22403;22785;25707,44895,0,0,3,0,3
70325,160,16530,21787;21990,44895,0,0,2,0,2
70326,160,16531,22194;22838;26529,44895,0,0,3,0,3
70327,160,16532,22386;22420;26721,44895,0,0,3,0,3
70328,160,16533,22348;22421,44895,0,0,2,0,2
70329,160,16535,22451;23007;25888;26350;26630;26934,44895,0,1,5,0,6
70330,160,16536,22323;26218,44895,0,0,2,0,2
70331,160,16537,22453;22503;25863;26421;28025,44895,1,0,4,0,5
70332,160,16538,22448;22866;26440,44895,0,0,3,0,3
70333,160,16540,22459;22461,44895,0,0,2,0,2
70334,160,16541,22479;22537;26125;26614,44895,0,0,4,0,4
70335,160,16544,22301;22612;26425,44895,0,0,3,0,3
70336,160,16545,22304;22630,44895,0,0,2,0,2
70337,160,16546,22601;23011,44895,0,0,2,0,2
70338,160,16547,22317;22609;26723,44895,0,0,3,0,3
70339,160,16548,22435;22614,44895,0,0,2,0,2
70340,160,16549,22367;22615,44895,0,0,2,0,2
70341,160,16550,22618;22670,44895,0,0,2,0,2
70342,160,16551,22719;22790,44895,0,0,2,0,2
70343,160,16552,22396;22929,44895,0,0,2,0,2
70344,160,16553,22839;22961,44895,0,0,2,0,2
70345,160,16554,21962;22695,44895,0,0,2,0,2
70346,160,16555,22209;22712;26135;26430;28134,44895,1,0,4,0,5
70347,160,16556,22136;22720,44895,0,0,2,0,2
70348,160,16563,19361,45260,0,0,0,1,1
70349,160,16578,20507,45260,0,0,0,1,1
70350,160,16579,20776,45260,0,0,0,1,1
70351,160,16589,20255;20573,45260,0,0,0,2,2
70352,160,16594,21457;21746,45260,0,0,0,2,2
70353,160,16595,21442;21693,45260,0,0,0,2,2
70354,160,16596,21727;24839;26807;27987;28067,45260,2,0,2,1,5
70355,160,16597,21469;21965;26718,45260,0,0,2,1,3
70356,160,16598,22199,45260,0,0,1,0,1
70357,160,16599,21491,45260,0,0,0,1,1
70358,160,16600,21617,45260,0,0,0,1,1
70359,160,16602,21428;21610,45260,0,0,0,2,2
70360,160,16603,21673;22258;26029,45260,0,0,2,1,3
70361,160,16604,21937;22189;25939;26504,45260,0,0,4,0,4
70362,160,16606,21998;22052,45260,0,0,2,0,2
70363,160,16607,21871,45260,0,0,1,0,1
70364,160,16609,21741;21959,45260,0,0,1,1,2
70365,160,16611,22371;22591;26328,45260,0,0,3,0,3
70366,160,16612,21562;21976,45260,0,0,1,1,2
70367,160,16613,21805;21983,45260,0,0,2,0,2
70368,160,16614,21715;22226,45260,0,0,1,1,2
70369,160,16615,22247;22384;25946,45260,0,0,3,0,3
70370,160,16616,22051;22322,45260,0,0,2,0,2
70371,160,16617,22058;26022,45260,0,0,2,0,2
70372,160,16618,21960;22619,45260,0,0,2,0,2
70373,160,16619,22357;22634;26426;26930,45260,0,1,3,0,4
70374,160,16621,22173;26310,45260,0,0,2,0,2
70375,160,16622,22817;26621,45260,0,0,2,0,2
70376,160,16623,22190;22688;27377,45260,0,1,2,0,3
70377,160,16624,21999;22206,45260,0,0,2,0,2
70378,160,16626,21966;22456;25865,45260,0,0,3,0,3
70379,160,16627,22296;22437;26506,45260,0,0,3,0,3
70380,160,16628,22346;22645;26230,45260,0,0,3,0,3
70381,160,16629,21904;22350,45260,0,0,2,0,2
70382,160,16630,22382;22741;26053;26525;26815,45260,0,1,4,0,5
70383,160,16631,22399;22752;26617,45260,0,0,3,0,3
70384,160,16632,22310;22434;25403;27733,45260,0,1,3,0,4
70385,160,16634,21868;22284,45260,0,0,2,0,2
70386,160,16635,22707,45260,0,0,1,0,1
70387,160,16636,22575;22730,45260,0,0,2,0,2
70388,160,16637,22600;22651;26332,45260,0,0,3,0,3
70389,160,16639,22744;22833,45260,0,0,2,0,2
70390,160,16640,23062;26161,45260,0,0,2,0,2
70391,160,16641,22433;22823,45260,0,0,2,0,2
70392,160,16642,22918;26825,45260,0,1,1,0,2
70393,160,16643,23016;26446,45260,0,0,2,0,2
70394,160,16644,22192;22768;26139;26817,45260,0,1,3,0,4
70395,160,16646,22973;26062;26536;27006,45260,0,1,3,0,4
70396,160,16647,22705;22811,45260,0,0,2,0,2
70397,160,16648,22643;23034;25978;27106,45260,0,1,3,0,4
70398,160,16678,19807,45625,0,0,0,1,1
70399,160,16694,21682,45625,0,0,0,1,1
70400,160,16695,21343,45625,0,0,0,1,1
70401,160,16698,21373;21557,45625,0,0,0,2,2
70402,160,16699,21985,45625,0,0,1,0,1
70403,160,16700,20860;21548;25659,45625,0,0,1,2,3
70404,160,16701,21355;21858;26015,45625,0,0,2,1,3
70405,160,16703,22184,45625,0,0,1,0,1
70406,160,16704,22027,45625,0,0,1,0,1
70407,160,16706,21754;21893,45625,0,0,1,1,2
70408,160,16708,21909;22008,45625,0,0,2,0,2
70409,160,16711,22518;25408;26321,45625,0,0,3,0,3
70410,160,16714,22407;22466;26510,45625,0,0,3,0,3
70411,160,16715,21534;22186,45625,0,0,1,1,2
70412,160,16716,22083,45625,0,0,1,0,1
70413,160,16717,22086;22309;26033,45625,0,0,3,0,3
70414,160,16718,22239;22659,45625,0,0,2,0,2
70415,160,16719,21628;22160,45625,0,0,1,1,2
70416,160,16720,22068;22191;25934,45625,0,0,3,0,3
70417,160,16721,22210;22369;25593,45625,0,0,3,0,3
70418,160,16723,22623,45625,0,0,1,0,1
70419,160,16725,22075;22203,45625,0,0,2,0,2
70420,160,16727,22277;22441;25772,45625,0,0,3,0,3
70421,160,16728,22648,45625,0,0,1,0,1
70422,160,16729,22374;22429;26612,45625,0,0,3,0,3
70423,160,16730,22193;22409,45625,0,0,2,0,2
70424,160,16731,22197;22431,45625,0,0,2,0,2
70425,160,16732,22445;22519,45625,0,0,2,0,2
70426,160,16733,22223;22853;26237;26439,45625,0,0,4,0,4
70427,160,16734,22514,45625,0,0,1,0,1
70428,160,16735,22376;22540;25871,45625,0,0,3,0,3
70429,160,16736,22545;22669;26333;27834,45625,0,1,3,0,4
70430,160,16737,22596;22616;26616,45625,0,0,3,0,3
70431,160,16738,22604,45625,0,0,1,0,1
70432,160,16739,22200;22624,45625,0,0,2,0,2
70433,160,16740,22627;22967;26735,45625,0,0,3,0,3
70434,160,16741,22660;22733;26137,45625,0,0,3,0,3
70435,160,16743,22678;23084;27188,45625,0,1,2,0,3
70436,160,16744,22053;22495;26320,45625,0,0,3,0,3
70437,160,16745,22704;23068,45625,0,0,2,0,2
70438,160,16746,22389;22548,45625,0,0,2,0,2
70439,160,16747,22713;23021,45625,0,0,2,0,2
70440,160,16749,22571;22826;26622,45625,0,0,3,0,3
70441,160,16750,22830;22986;26244;28307,45625,1,0,3,0,4
70442,160,16751,22832;22911,45625,0,0,2,0,2
70443,160,16752,23178;26841,45625,0,1,1,0,2
70444,160,16755,22652;22925;26933,45625,0,1,2,0,3
70445,160,16756,22871;22958;26444,45625,0,0,3,0,3
70446,160,16757,23027;23169,45625,0,0,2,0,2
70447,160,16758,22342;22893;26057,45625,0,0,3,0,3
70448,160,16759,22909;26533,45625,0,0,2,0,2
70449,160,16760,22638;22912;26733;26824;27005;27105,45625,0,3,3,0,6
70450,160,16761,22915;23098,45625,0,0,2,0,2
70451,160,16762,22807;23080;26250,45625,0,0,3,0,3
70452,160,16766,18838,45990,0,0,0,1,1
70453,160,16771,18948,45990,0,0,0,1,1
70454,160,16773,18650,45990,0,0,0,1,1
70455,160,16777,19310,45990,0,0,0,1,1
70456,160,16782,19547,45990,0,0,0,1,1
70457,160,16796,21050,45990,0,0,0,1,1
70458,160,16799,21098;21315;25121,45990,0,0,1,2,3
70459,160,16803,21476;21593,45990,0,0,0,2,2
70460,160,16805,21477;21782,45990,0,0,0,2,2
70461,160,16807,21834;21914;24956,45990,0,0,3,0,3
70462,160,16808,21665;21783,45990,0,0,0,2,2
70463,160,16810,21967;22141;25267;28004;28098,45990,2,0,3,0,5
70464,160,16812,21553,45990,0,0,0,1,1
70465,160,16813,22114;26610,45990,0,0,2,0,2
70466,160,16815,21536;22033,45990,0,0,1,1,2
70467,160,16818,22102;22664;26231;26724,45990,0,0,4,0,4
70468,160,16819,22143;22524,45990,0,0,2,0,2
70469,160,16820,22687;22758,45990,0,0,2,0,2
70470,160,16821,22205;22715;26725,45990,0,0,3,0,3
70471,160,16822,22217;22388;25169,45990,0,0,3,0,3
70472,160,16823,22800;22863;26932,45990,0,1,2,0,3
70473,160,16824,22263;22585;26327;26814,45990,0,1,3,0,4
70474,160,16826,22328;22562,45990,0,0,2,0,2
70475,160,16828,22874;26342,45990,0,0,2,0,2
70476,160,16829,22243;22467,45990,0,0,2,0,2
70477,160,16830,22487;23067;27187,45990,0,1,2,0,3
70478,160,16831,21791;22462;26038;26123,45990,0,0,4,0,4
70479,160,16832,22500;22738,45990,0,0,2,0,2
70480,160,16833,22709,45990,0,0,1,0,1
70481,160,16834,22523,45990,0,0,1,0,1
70482,160,16835,22525;22536,45990,0,0,2,0,2
70483,160,16836,22172;22551,45990,0,0,2,0,2
70484,160,16837,22564;22587,45990,0,0,2,0,2
70485,160,16838,22927;23125;27010,45990,0,1,2,0,3
70486,160,16839,22728;22748;25964;26522,45990,0,0,4,0,4
70487,160,16841,22649;22698,45990,0,0,2,0,2
70488,160,16842,22979;22994;26348,45990,0,0,3,0,3
70489,160,16843,22727;22757,45990,0,0,2,0,2
70490,160,16844,22743;22815;26431,45990,0,0,3,0,3
70491,160,16846,22766;22846,45990,0,0,2,0,2
70492,160,16847,22822;23015;26357;26447;26638;26829;26935,45990,0,2,5,0,7
70493,160,16848,22450;22825,45990,0,0,2,0,2
70494,160,16849,22001;22827,45990,0,0,2,0,2
70495,160,16850,22640;22849;26427,45990,0,0,3,0,3
70496,160,16851,22868;23324,45990,0,0,2,0,2
70497,160,16852,22877;23296;26261;26648;26943;27468,45990,0,2,4,0,6
70498,160,16853,22891;26441;26532,45990,0,0,3,0,3
70499,160,16854,22910;23103;26636;26742,45990,0,0,4,0,4
70500,160,16855,22987;23047;26248;26832;28320,45990,1,1,3,0,5
70501,160,16856,23299;23315;26377;26555;26649;27746,45990,0,1,5,0,6
70502,160,16857,22684;22952;26346,45990,0,0,3,0,3
70503,160,16858,22906;23247;26553,45990,0,0,3,0,3
70504,160,16859,22611;22965;26734,45990,0,0,3,0,3
70505,160,16860,22993;23314;26262,45990,0,0,3,0,3
70506,160,16861,22769,45990,0,0,1,0,1
70507,160,16862,22755;23023;25976;26351,45990,0,0,4,0,4
70508,160,16863,22557;23025,45990,0,0,2,0,2
70509,160,16864,22544;23028;25977,45990,0,0,3,0,3
70510,160,16868,18674,46355,0,0,0,1,1
70511,160,16869,18800;18816,46355,0,0,0,2,2
70512,160,16873,19048,46355,0,0,0,1,1
70513,160,16880,19734,46355,0,0,0,1,1
70514,160,16881,20004,46355,0,0,0,1,1
70515,160,16882,19953;20005,46355,0,0,0,2,2
70516,160,16895,20475,46355,0,0,0,1,1
70517,160,16896,21256;21574,46355,0,0,0,2,2
70518,160,16898,21855,46355,0,0,1,0,1
70519,160,16900,21357;21572,46355,0,0,0,2,2
70520,160,16901,21344;21505,46355,0,0,0,2,2
70521,160,16902,21656,46355,0,0,0,1,1
70522,160,16904,21195;21676,46355,0,0,0,2,2
70523,160,16905,22244;22254,46355,0,0,2,0,2
70524,160,16907,21458;21697;25045,46355,0,0,1,2,3
70525,160,16908,21778;21945,46355,0,0,1,1,2
70526,160,16910,21487;25224;26209,46355,0,0,2,1,3
70527,160,16911,22049;22460,46355,0,0,2,0,2
70528,160,16915,22259;22332,46355,0,0,2,0,2
70529,160,16917,22065;22533;25604;25954;28018;28284;28385,46355,3,0,4,0,7
70530,160,16918,22724;25877,46355,0,0,2,0,2
70531,160,16920,22777;26140,46355,0,0,2,0,2
70532,160,16921,22454;25288,46355,0,0,2,0,2
70533,160,16922,22250;22480,46355,0,0,2,0,2
70534,160,16924,22528;26041;26813,46355,0,1,2,0,3
70535,160,16926,22736;26524,46355,0,0,2,0,2
70536,160,16928,22731;22942;26060,46355,0,0,3,0,3
70537,160,16929,22751;23079;26433,46355,0,0,3,0,3
70538,160,16930,22852;26145;26530;26820;28416,46355,1,1,3,0,5
70539,160,16931,22780,46355,0,0,1,0,1
70540,160,16932,22880;23195;25900;26451,46355,0,0,4,0,4
70541,160,16933,22828;26338;26729,46355,0,0,3,0,3
70542,160,16934,22831;22966,46355,0,0,2,0,2
70543,160,16935,22841;23085;26635;26741,46355,0,0,4,0,4
70544,160,16936,22854;23202,46355,0,0,2,0,2
70545,160,16937,22589;22867;25798,46355,0,0,3,0,3
70546,160,16938,23082;23149;26252;28033,46355,1,0,3,0,4
70547,160,16939,22415;23181;26747;26842,46355,0,1,3,0,4
70548,160,16940,22753;22922,46355,0,0,2,0,2
70549,160,16941,22916;22936;26059;27935,46355,0,1,3,0,4
70550,160,16942,22956;23278,46355,0,0,2,0,2
70551,160,16943,22521;22970;25307;26154;26242;26627;28197;28268;28362,46355,3,0,6,0,9
70552,160,16944,23002;23040;25887;26246,46355,0,0,4,0,4
70553,160,16945,22517;23006;26738,46355,0,0,3,0,3
70554,160,16946,22747;23269,46355,0,0,2,0,2
70555,160,16947,22617;22978,46355,0,0,2,0,2
70556,160,16948,23326,46355,0,0,1,0,1
70557,160,16949,22770;23095,46355,0,0,2,0,2
70558,160,16950,23017;23077;26835,46355,0,1,2,0,3
70559,160,16951,23056;23093;25809,46355,0,0,3,0,3
70560,160,16952,22976;23241;26168;26452;26644,46355,0,0,5,0,5
70561,160,16954,23321;23350;26650;27110,46355,0,1,3,0,4
70562,160,16955,23123;23189;26544;26637;26744,46355,0,0,5,0,5
70563,160,16956,23138;26639,46355,0,0,2,0,2
70564,160,16963,18639,46720,0,0,0,1,1
70565,160,16964,18743,46720,0,0,0,1,1
70566,160,16979,19912;20190,46720,0,0,0,2,2
70567,160,16994,20825;21016,46720,0,0,0,2,2
70568,160,16997,21106;21724,46720,0,0,0,2,2
70569,160,16998,21374;22030,46720,0,0,1,1,2
70570,160,16999,21333;21367,46720,0,0,0,2,2
70571,160,17000,21365;21764;25563;28378,46720,1,0,1,2,4
70572,160,17001,21096;21408,46720,0,0,0,2,2
70573,160,17002,22029;22315,46720,0,0,2,0,2
70574,160,17003,20956;21418;25344,46720,0,0,1,2,3
70575,160,17012,22362;25397;25945,46720,0,0,3,0,3
70576,160,17013,22242;22298,46720,0,0,2,0,2
70577,160,17014,22294,46720,0,0,1,0,1
70578,160,17015,21814;22156,46720,0,0,2,0,2
70579,160,17016,22402;26223,46720,0,0,2,0,2
70580,160,17017,22264;22275,46720,0,0,2,0,2
70581,160,17018,22308;23161,46720,0,0,2,0,2
70582,160,17019,22311;22552;26323,46720,0,0,3,0,3
70583,160,17020,22071;22345;25281,46720,0,0,3,0,3
70584,160,17021,22887;26343;26732,46720,0,0,3,0,3
70585,160,17022,22390;22418;25401;26420;26720,46720,0,0,5,0,5
70586,160,17023,22793;26619,46720,0,0,2,0,2
70587,160,17025,22452;22569,46720,0,0,2,0,2
70588,160,17026,22572;25873;27655;28026,46720,1,1,2,0,4
70589,160,17027,22742;23225;26255;26367,46720,0,0,4,0,4
70590,160,17028,22778;23038;26831,46720,0,1,2,0,3
70591,160,17029,22427;22656,46720,0,0,2,0,2
70592,160,17030,22646;23226;26079,46720,0,0,3,0,3
70593,160,17031,22921;23235;26843;27107,46720,0,2,2,0,4
70594,160,17032,22693;23173;26450;26545;27378;27565,46720,0,2,4,0,6
70595,160,17033,22892;26823,46720,0,1,1,0,2
70596,160,17034,22725;23005,46720,0,0,2,0,2
70597,160,17035,22791;26437,46720,0,0,2,0,2
70598,160,17037,22161;22851;26931;27282,46720,0,2,2,0,4
70599,160,17038,22900;22948,46720,0,0,2,0,2
70600,160,17039,23026;23171;26165;26939,46720,0,1,3,0,4
70601,160,17040,22901;23238;26368,46720,0,0,3,0,3
70602,160,17041,22904;23094;26543;26837,46720,0,1,3,0,4
70603,160,17042,22885;22913,46720,0,0,2,0,2
70604,160,17043,23491,46720,0,0,1,0,1
70605,160,17045,22595;22954;26827,46720,0,1,2,0,3
70606,160,17046,22650;22977;26243,46720,0,0,3,0,3
70607,160,17047,22995;23184,46720,0,0,2,0,2
70608,160,17048,22881;22996;26157;27745,46720,0,1,3,0,4
70609,160,17049,23050;23141;25720,46720,0,0,3,0,3
70610,160,17050,23078;23459;26181;26760,46720,0,0,4,0,4
70611,160,17051,23249;23311,46720,0,0,2,0,2
70612,160,17052,23053;23100,46720,0,0,2,0,2
70613,160,17053,23109;23260;27191,46720,0,1,2,0,3
70614,160,17054,22879;26624,46720,0,0,2,0,2
70615,160,17055,23124;23528;26672,46720,0,0,3,0,3
70616,160,17056,23293;23355,46720,0,0,2,0,2
70617,160,17057,22903;23290;25905;26374;26942,46720,0,1,4,0,5
70618,160,17058,23196;26549,46720,0,0,2,0,2
70619,160,17059,23841;26587;27664,46720,0,1,2,0,3
70620,160,17060,23018;23157;27189,46720,0,1,2,0,3
70621,160,17061,22805;23232,46720,0,0,2,0,2
70622,160,17064,19212,47085,0,0,0,1,1
70623,160,17066,19582,47085,0,0,0,1,1
70624,160,17068,19272,47085,0,0,0,1,1
70625,160,17070,19261,47085,0,0,0,1,1
70626,160,17074,19565,47085,0,0,0,1,1
70627,160,17091,21177,47085,0,0,0,1,1
70628,160,17095,21076;21398;24811;27442;27880,47085,0,2,1,2,5
70629,160,17096,22110;22231;26115,47085,0,0,3,0,3
70630,160,17100,21368;21605,47085,0,0,0,2,2
70631,160,17101,21864;21982,47085,0,0,2,0,2
70632,160,17103,21588;22002,47085,0,0,1,1,2
70633,160,17104,21753;21889,47085,0,0,1,1,2
70634,160,17106,22144;22179,47085,0,0,2,0,2
70635,160,17107,22232;22788,47085,0,0,2,0,2
70636,160,17108,22219;22257;26315,47085,0,0,3,0,3
70637,160,17109,22292;22375;26418,47085,0,0,3,0,3
70638,160,17110,22132;22395;26719,47085,0,0,3,0,3
70639,160,17113,22334;22363,47085,0,0,2,0,2
70640,160,17115,22475,47085,0,0,1,0,1
70641,160,17116,22455;25691;25864;26722;27930,47085,0,1,4,0,5
70642,160,17117,22464;22511,47085,0,0,2,0,2
70643,160,17118,22256;26613,47085,0,0,2,0,2
70644,160,17119,22740;26727,47085,0,0,2,0,2
70645,160,17120,22653;22810;26054,47085,0,0,3,0,3
70646,160,17121,22606;22795;26818,47085,0,1,2,0,3
70647,160,17123,22672;22872,47085,0,0,2,0,2
70648,160,17124,22677;22873;26821,47085,0,1,2,0,3
70649,160,17125,22883;25624,47085,0,0,2,0,2
70650,160,17126,22486;22691,47085,0,0,2,0,2
70651,160,17127,22468;22721,47085,0,0,2,0,2
70652,160,17128,22722;22944;25974,47085,0,0,3,0,3
70653,160,17129,22737;22941,47085,0,0,2,0,2
70654,160,17130,22750;23159,47085,0,0,2,0,2
70655,160,17131,22798,47085,0,0,1,0,1
70656,160,17132,22859;23137;25969,47085,0,0,3,0,3
70657,160,17133,23239,47085,0,0,1,0,1
70658,160,17134,22889,47085,0,0,1,0,1
70659,160,17135,22902;23527;26671,47085,0,0,3,0,3
70660,160,17136,22829;22969;26535,47085,0,0,3,0,3
70661,160,17137,23104;23334;27566,47085,0,1,2,0,3
70662,160,17138,22775;23049;26936,47085,0,1,2,0,3
70663,160,17139,22665;23064;26833,47085,0,1,2,0,3
70664,160,17140,22907;23074,47085,0,0,2,0,2
70665,160,17141,22834;23354;26559;26652,47085,0,0,4,0,4
70666,160,17142,23486;26272;26665;27020,47085,0,1,3,0,4
70667,160,17143,23427,47085,0,0,1,0,1
70668,160,17144,23204;23449;26383;26467;26564;26951;27114;28314,47085,1,2,5,0,8
70669,160,17145,22895;23208;26075;26365,47085,0,0,4,0,4
70670,160,17146,22932;23209;26748,47085,0,0,3,0,3
70671,160,17147,23030;23211,47085,0,0,2,0,2
70672,160,17148,23088;23212;26643,47085,0,0,3,0,3
70673,160,17149,22647;22837;27104,47085,0,1,2,0,3
70674,160,17150,23061;23251;26453,47085,0,0,3,0,3
70675,160,17151,23283;27192,47085,0,1,1,0,2
70676,160,17152,23105;23289,47085,0,0,2,0,2
70677,160,17155,23541;23650;26572;26673,47085,0,0,4,0,4
70678,160,17156,23352;23374,47085,0,0,2,0,2
70679,160,17157,23348;23639,47085,0,0,2,0,2
70680,160,17158,22991;23396;26655;26849;26948,47085,0,2,3,0,5
70681,160,17159,23349;23362;26757,47085,0,0,3,0,3
70682,160,17160,23339;23656;26964;27125,47085,0,2,2,0,4
70683,160,17171,19741,47450,0,0,0,1,1
70684,160,17174,20057,47450,0,0,0,1,1
70685,160,17180,20379,47450,0,0,0,1,1
70686,160,17184,21335,47450,0,0,0,1,1
70687,160,17189,21279;21480,47450,0,0,0,2,2
70688,160,17192,21040,47450,0,0,0,1,1
70689,160,17193,21389;21542,47450,0,0,0,2,2
70690,160,17195,22084,47450,0,0,1,0,1
70691,160,17196,21744,47450,0,0,0,1,1
70692,160,17200,21857;21901,47450,0,0,2,0,2
70693,160,17203,21761;22282,47450,0,0,1,1,2
70694,160,17206,22628;22633;25611,47450,0,0,3,0,3
70695,160,17207,21653;22228,47450,0,0,1,1,2
70696,160,17212,22381;26118,47450,0,0,2,0,2
70697,160,17213,22405;22449;26509,47450,0,0,3,0,3
70698,160,17214,22501;22666;25785,47450,0,0,3,0,3
70699,160,17216,22626;22682,47450,0,0,2,0,2
70700,160,17218,22211;22580;26326,47450,0,0,3,0,3
70701,160,17219,22939;22971;26736,47450,0,0,3,0,3
70702,160,17221,22654;23143,47450,0,0,2,0,2
70703,160,17222,22676;22760;25960,47450,0,0,3,0,3
70704,160,17223,22373;22781;26336,47450,0,0,3,0,3
70705,160,17224,22764;22890;26526,47450,0,0,3,0,3
70706,160,17225,22819;23177;26166,47450,0,0,3,0,3
70707,160,17226,22636;26234;26339;28032;28410,47450,2,0,3,0,5
70708,160,17227,23201;23357,47450,0,0,2,0,2
70709,160,17228,22876,47450,0,0,1,0,1
70710,160,17229,22668;22882;26531;26822,47450,0,1,3,0,4
70711,160,17230,22896,47450,0,0,1,0,1
70712,160,17231,22908;25801,47450,0,0,2,0,2
70713,160,17232,22756;22928,47450,0,0,2,0,2
70714,160,17233,22964;23302;26554;27658,47450,0,1,3,0,4
70715,160,17234,22982;23001;26537,47450,0,0,3,0,3
70716,160,17235,22985;23258;27008;27186,47450,0,2,2,0,4
70717,160,17236,23131;23280;26458,47450,0,0,3,0,3
70718,160,17237,23388;27012,47450,0,1,1,0,2
70719,160,17238,23518;26669;27022,47450,0,1,2,0,3
70720,160,17239,22950;23256;26370;26454;26844,47450,0,1,4,0,5
70721,160,17242,22861;23206;26238;26340,47450,0,0,4,0,4
70722,160,17244,23071;23270;26080,47450,0,0,3,0,3
70723,160,17245,23014;23272,47450,0,0,2,0,2
70724,160,17246,23288;26754,47450,0,0,2,0,2
70725,160,17247,22933;26240;26626,47450,0,0,3,0,3
70726,160,17248,23214;23322;27939,47450,1,0,2,0,3
70727,160,17249,23115;23323;27193,47450,0,1,2,0,3
70728,160,17250,23041;23328;26173;26460,47450,0,0,4,0,4
70729,160,17251,23373;23592;26476;26765,47450,0,0,4,0,4
70730,160,17252,23540;23684;27031,47450,0,1,2,0,3
70731,160,17253,23386;23544;26847,47450,0,1,2,0,3
70732,160,17254,23264;23424;26382,47450,0,0,3,0,3
70733,160,17255,19033,47815,0,0,0,1,1
70734,160,17257,19165,47815,0,0,0,1,1
70735,160,17260,18828,47815,0,0,0,1,1
70736,160,17261,18649,47815,0,0,0,1,1
70737,160,17262,19534,47815,0,0,0,1,1
70738,160,17264,19515,47815,0,0,0,1,1
70739,160,17265,19533,47815,0,0,0,1,1
70740,160,17266,19484,47815,0,0,0,1,1
70741,160,17270,20264,47815,0,0,0,1,1
70742,160,17277,20437,47815,0,0,0,1,1
70743,160,17279,20651,47815,0,0,0,1,1
70744,160,17285,21190;21920;24498;27079;27609,47815,0,2,2,1,5
70745,160,17289,22042,47815,0,0,1,0,1
70746,160,17290,21925,47815,0,0,1,0,1
70747,160,17291,21935,47815,0,0,1,0,1
70748,160,17292,21978;22245,47815,0,0,2,0,2
70749,160,17293,22012,47815,0,0,1,0,1
70750,160,17294,21767;22020,47815,0,0,1,1,2
70751,160,17296,21969,47815,0,0,1,0,1
70752,160,17297,22000;22288,47815,0,0,2,0,2
70753,160,17298,22485,47815,0,0,1,0,1
70754,160,17299,21949;22195,47815,0,0,2,0,2
70755,160,17301,22538;22579;26424,47815,0,0,3,0,3
70756,160,17302,22397;22522,47815,0,0,2,0,2
70757,160,17303,22414;22602;26219,47815,0,0,3,0,3
70758,160,17304,22072;22417;26317,47815,0,0,3,0,3
70759,160,17306,22011;22577,47815,0,0,2,0,2
70760,160,17307,22553;22590;26043,47815,0,0,3,0,3
70761,160,17308,22637;22850;24988,47815,0,0,3,0,3
70762,160,17310,22869,47815,0,0,1,0,1
70763,160,17311,22706;23180,47815,0,0,2,0,2
70764,160,17312,22419;22582,47815,0,0,2,0,2
70765,160,17313,22981;23119;25635;26743,47815,0,0,4,0,4
70766,160,17315,22530;22539,47815,0,0,2,0,2
70767,160,17317,23597;27207,47815,0,1,1,0,2
70768,160,17318,22843;23174,47815,0,0,2,0,2
70769,160,17319,22963;23332;26556;26945,47815,0,1,3,0,4
70770,160,17320,22999;23436;26466,47815,0,0,3,0,3
70771,160,17322,22989;23013;26629,47815,0,0,3,0,3
70772,160,17323,23148;23166;26072;26840,47815,0,1,3,0,4
70773,160,17325,23426;23614;25642;25987;27198,47815,0,1,4,0,5
70774,160,17326,23136;23443;26759,47815,0,0,3,0,3
70775,160,17327,23218;23663;26579;26768,47815,0,0,4,0,4
70776,160,17328,23156;23464;25731;27018,47815,0,1,3,0,4
70777,160,17329,22803;23188;26361;26641,47815,0,0,4,0,4
70778,160,17330,23715;25821;26480,47815,0,0,3,0,3
70779,160,17331,23203;23359;26176;28303,47815,1,0,3,0,4
70780,160,17332,23122;23207;27656,47815,0,1,2,0,3
70781,160,17333,23248;23609;26576;26678;27123;27571,47815,0,2,4,0,6
70782,160,17334,23250;23596;26766,47815,0,0,3,0,3
70783,160,17335,22816;23369,47815,0,0,2,0,2
70784,160,17336,23276;23450;26372;26456;26647,47815,0,0,5,0,5
70785,160,17337,23760;26971;27134;27214;27573,47815,0,4,1,0,5
70786,160,17338,23303;23318;26944,47815,0,1,2,0,3
70787,160,17339,23316;23576;26861,47815,0,1,2,0,3
70788,160,17340,23503;27021;27117;27381,47815,0,3,1,0,4
70789,160,17341,23550;23759;26471,47815,0,0,3,0,3
70790,160,17342,23533;23635;27298,47815,0,1,2,0,3
70791,160,17343,23220;23406,47815,0,0,2,0,2
70792,160,17344,23132;23414;25985;26658,47815,0,0,4,0,4
70793,160,17345,23243;23420;26169,47815,0,0,3,0,3
70794,160,17346,23598;26864,47815,0,1,1,0,2
70795,160,17347,23439;23659,47815,0,0,2,0,2
70796,160,17348,23559,47815,0,0,1,0,1
70797,160,17349,23479;27115,47815,0,1,1,0,2
70798,160,17350,23361;23881;26879;27753;27839,47815,0,3,2,0,5
70799,160,17351,23487;23713,47815,0,0,2,0,2
70800,160,17352,23297;26755,47815,0,0,2,0,2
70801,160,17353,23330;23585;27027,47815,0,1,2,0,3
70802,160,17354,23470;23498;26385;26568;26955;27289;27380,47815,0,3,4,0,7
70803,160,17355,23222;23500;26569;26855,47815,0,1,3,0,4
70804,160,17356,23092;23523;26956;27025,47815,0,2,2,0,4
70805,160,17357,23428;23532;26270;26659;27113,47815,0,1,4,0,5
70806,160,17358,23567;23642;26867,47815,0,1,2,0,3
70807,160,17360,23358;23620,47815,0,0,2,0,2
70808,160,17361,19085,48180,0,0,0,1,1
70809,160,17369,19543,48180,0,0,0,1,1
70810,160,17375,19559,48180,0,0,0,1,1
70811,160,17376,20422,48180,0,0,0,1,1
70812,160,17385,20363,48180,0,0,0,1,1
70813,160,17391,21142,48180,0,0,0,1,1
70814,160,17393,21678;21947;26503,48180,0,0,2,1,3
70815,160,17396,22096;25385,48180,0,0,2,0,2
70816,160,17397,21979;21986,48180,0,0,2,0,2
70817,160,17405,22158;22622;25957,48180,0,0,3,0,3
70818,160,17407,22163;22513;26513,48180,0,0,3,0,3
70819,160,17408,22532;22583;26516,48180,0,0,3,0,3
70820,160,17410,22897;22980;26628,48180,0,0,3,0,3
70821,160,17411,22845,48180,0,0,1,0,1
70822,160,17412,22255;22703,48180,0,0,2,0,2
70823,160,17414,22840;26819,48180,0,1,1,0,2
70824,160,17415,22862;23221,48180,0,0,2,0,2
70825,160,17417,22667;22935;25884;26443,48180,0,0,4,0,4
70826,160,17418,23072;23110,48180,0,0,2,0,2
70827,160,17419,23133;26838,48180,0,1,1,0,2
70828,160,17420,22658;23089;26542;27009,48180,0,1,3,0,4
70829,160,17421,23758;23834;27133,48180,0,1,2,0,3
70830,160,17422,23042;23267;26752,48180,0,0,3,0,3
70831,160,17423,23304;23640;26578;26963,48180,0,1,3,0,4
70832,160,17424,22774;23325;25906;26172;27284,48180,0,1,4,0,5
70833,160,17425,23964;26093;27052;28405,48180,1,1,2,0,4
70834,160,17426,23255;23351,48180,0,0,2,0,2
70835,160,17428,23233;23383;26846,48180,0,1,2,0,3
70836,160,17430,23513;23723;26775;26872,48180,0,1,3,0,4
70837,160,17431,23246;23407;26462;26758;27014,48180,0,1,4,0,5
70838,160,17432,23412;23879,48180,0,0,2,0,2
70839,160,17433,23168;23453;27017,48180,0,1,2,0,3
70840,160,17434,23483;23916;27048;27755,48180,0,2,2,0,4
70841,160,17435,23434;23605;27295;27747,48180,0,2,2,0,4
70842,160,17436,23520;23671;26670,48180,0,0,3,0,3
70843,160,17437,23060;23522;27024;27200;27569,48180,0,3,2,0,5
70844,160,17438,23529;23840;27217,48180,0,1,2,0,3
70845,160,17439,23490;23536;26666;26953;27116,48180,0,2,3,0,5
70846,160,17440,23538,48180,0,0,1,0,1
70847,160,17441,24012;26490;27760,48180,0,1,2,0,3
70848,160,17443,23418;23561;26562,48180,0,0,3,0,3
70849,160,17444,23478,48180,0,0,1,0,1
70850,160,17445,23786;26689,48180,0,0,2,0,2
70851,160,17446,23732;23883;26592;27306,48180,0,1,3,0,4
70852,160,17447,23604;26677,48180,0,0,2,0,2
70853,160,17448,23368;23606,48180,0,0,2,0,2
70854,160,17449,23333;23608;26767;26865;27208;27296,48180,0,3,3,0,6
70855,160,17450,23616;23954;26003,48180,0,0,3,0,3
70856,160,17451,23638;23654;26189;27299,48180,0,1,3,0,4
70857,160,17452,23657,48180,0,0,1,0,1
70858,160,17453,23553;23658;26868,48180,0,1,2,0,3
70859,160,17454,23660;26869;26965;28035,48180,1,2,1,0,4
70860,160,17455,23313;23670;26580;27384,48180,0,1,3,0,4
70861,160,17457,19152,48545,0,0,0,1,1
70862,160,17458,18936,48545,0,0,0,1,1
70863,160,17460,19314;19322,48545,0,0,0,2,2
70864,160,17469,19620,48545,0,0,0,1,1
70865,160,17473,20263;20315,48545,0,0,0,2,2
70866,160,17474,20063;20337,48545,0,0,0,2,2
70867,160,17478,20669,48545,0,0,0,1,1
70868,160,17487,21993;22476;26511,48545,0,0,3,0,3
70869,160,17489,22204;22809,48545,0,0,2,0,2
70870,160,17491,22124;25936,48545,0,0,2,0,2
70871,160,17492,22432;22808;26142,48545,0,0,3,0,3
70872,160,17493,22442;22597,48545,0,0,2,0,2
70873,160,17494,22340;22534;26042,48545,0,0,3,0,3
70874,160,17495,22729;22746;26432,48545,0,0,3,0,3
70875,160,17496,22565;22905;25872;28224,48545,1,0,3,0,4
70876,160,17497,22556;22842,48545,0,0,2,0,2
70877,160,17499,22398;22959,48545,0,0,2,0,2
70878,160,17500,22792,48545,0,0,1,0,1
70879,160,17501,22962;26534,48545,0,0,2,0,2
70880,160,17503,22481;22734;25619,48545,0,0,3,0,3
70881,160,17504,23081,48545,0,0,1,0,1
70882,160,17505,23462,48545,0,0,1,0,1
70883,160,17506,22821;22886,48545,0,0,2,0,2
70884,160,17507,22772;22924;25418;26625;26826,48545,0,1,4,0,5
70885,160,17509,22714;23024,48545,0,0,2,0,2
70886,160,17510,23046;23135,48545,0,0,2,0,2
70887,160,17511,23037;23048,48545,0,0,2,0,2
70888,160,17512,23052;23669;27126;27209,48545,0,2,2,0,4
70889,160,17513,23054;23090,48545,0,0,2,0,2
70890,160,17514,23032;23063;26249,48545,0,0,3,0,3
70891,160,17515,22692;23139;25982;26745,48545,0,0,4,0,4
70892,160,17516,23158;23190;26640,48545,0,0,3,0,3
70893,160,17517,23035;23191;26548,48545,0,0,3,0,3
70894,160,17518,25899,48545,0,0,1,0,1
70895,160,17519,23607;23791;27036,48545,0,1,2,0,3
70896,160,17520,23584;23631;26394,48545,0,0,3,0,3
70897,160,17521,23366;23800;27038,48545,0,1,2,0,3
70898,160,17522,23392;23568;26654;27195,48545,0,1,3,0,4
70899,160,17523,23554;27203;27469,48545,0,2,1,0,3
70900,160,17524,23485;26762;26952;27568,48545,0,2,2,0,4
70901,160,17525,23069;23429;26660;26949;27015,48545,0,2,3,0,5
70902,160,17526,22786;23065;26068;26633;26740;26834,48545,0,1,5,0,6
70903,160,17527,23213;23473;26567,48545,0,0,3,0,3
70904,160,17528,23734;23815;26972;27040,48545,0,2,2,0,4
70905,160,17530,23526;26957;27119;27291,48545,0,3,1,0,4
70906,160,17531,23525;23565;26473;27204,48545,0,1,3,0,4
70907,160,17532,23922;24053;26006;27057;27315;27671,48545,0,3,3,0,6
70908,160,17533,23626;23890;27396;27474,48545,0,2,2,0,4
70909,160,17534,23655;24018;27229;27761,48545,0,2,2,0,4
70910,160,17535,23573;23886;27754,48545,0,1,2,0,3
70911,160,17536,23686;24035;26595;26979;27945,48545,1,1,3,0,5
70912,160,17538,23700;23829;26683,48545,0,0,3,0,3
70913,160,17539,23549;23914;26198,48545,0,0,3,0,3
70914,160,17541,23967;26594;27400,48545,0,1,2,0,3
70915,160,17542,23804;24093,48545,0,0,2,0,2
70916,160,17543,19260,48910,0,0,0,1,1
70917,160,17546,19839;20092,48910,0,0,0,2,2
70918,160,17547,19504,48910,0,0,0,1,1
70919,160,17550,20177;20187,48910,0,0,0,2,2
70920,160,17553,20352,48910,0,0,0,1,1
70921,160,17558,20714,48910,0,0,0,1,1
70922,160,17569,20950;21580,48910,0,0,0,2,2
70923,160,17573,21462;21611;25921,48910,0,0,1,2,3
70924,160,17577,21639;21826,48910,0,0,1,1,2
70925,160,17582,22041;22139,48910,0,0,2,0,2
70926,160,17583,22279,48910,0,0,1,0,1
70927,160,17586,22394;23031,48910,0,0,2,0,2
70928,160,17587,21940;22469,48910,0,0,2,0,2
70929,160,17589,22482;23101,48910,0,0,2,0,2
70930,160,17593,22447;22655,48910,0,0,2,0,2
70931,160,17594,22739,48910,0,0,1,0,1
70932,160,17595,22473;22763;26434;26816;27004,48910,0,2,3,0,5
70933,160,17597,22917;23055;26739,48910,0,0,3,0,3
70934,160,17599,23481,48910,0,0,1,0,1
70935,160,17600,23142;23391;26947;27194;27659,48910,0,3,2,0,5
70936,160,17601,23340;26651;26946,48910,0,1,2,0,3
70937,160,17602,22610;23051;26159;26937,48910,0,1,3,0,4
70938,160,17603,23126,48910,0,0,1,0,1
70939,160,17604,23353;23546;26674;26958,48910,0,1,3,0,4
70940,160,17605,22710;23099;26355,48910,0,0,3,0,3
70941,160,17607,23234;23441;26180;26563,48910,0,0,4,0,4
70942,160,17608,23253;23336;26461,48910,0,0,3,0,3
70943,160,17609,23113;23273;26371;26455;27657,48910,0,1,4,0,5
70944,160,17610,23301;23480;26271,48910,0,0,3,0,3
70945,160,17611,22955;23331;26756,48910,0,0,3,0,3
70946,160,17612,23343;26174,48910,0,0,2,0,2
70947,160,17613,23531;23929;27843,48910,0,1,2,0,3
70948,160,17614,23240;23400;26560;26850,48910,0,1,3,0,4
70949,160,17615,23416;23579;26390;27293,48910,0,1,3,0,4
70950,160,17616,23364;23465;25539;26663;26852,48910,0,1,4,0,5
70951,160,17617,23682;23712,48910,0,0,2,0,2
70952,160,17618,23552;26860;27026,48910,0,2,1,0,3
70953,160,17619,23262;23574;26574;26675,48910,0,0,4,0,4
70954,160,17621,23958;24036;26887,48910,0,1,2,0,3
70955,160,17622,23151;23600;27122,48910,0,1,2,0,3
70956,160,17623,23603;23830;27575,48910,0,1,2,0,3
70957,160,17624,23617;26866,48910,0,1,1,0,2
70958,160,17625,23602;23731;26481,48910,0,0,3,0,3
70959,160,17627,23295;23649;27383,48910,0,1,2,0,3
70960,160,17628,23287;23652;26753,48910,0,0,3,0,3
70961,160,17629,23179;23905,48910,0,0,2,0,2
70962,160,17630,23939;24024;27050;28137,48910,1,1,2,0,4
70963,160,17631,23938;23943;26487,48910,0,0,3,0,3
70964,160,17632,23643;23728;26968;27033;27941,48910,1,2,2,0,5
70965,160,17633,23729;23932,48910,0,0,2,0,2
70966,160,17635,23762;23814;26585;26875,48910,0,1,3,0,4
70967,160,17636,23535;24015;27669,48910,0,1,2,0,3
70968,160,17637,23770;23801;26486;27574,48910,0,1,3,0,4
70969,160,17638,23807;24000;26295;26488,48910,0,0,4,0,4
70970,160,17639,23456;23828,48910,0,0,2,0,2
70971,160,17640,23846;24029;27583,48910,0,1,2,0,3
70972,160,17641,23662;23849;27138;27751,48910,0,2,2,0,4
70973,160,17642,23854;23874;26289,48910,0,0,3,0,3
70974,160,17643,23612;23862;26877,48910,0,1,2,0,3
70975,160,17644,19410,49275,0,0,0,1,1
70976,160,17647,19175,49275,0,0,0,1,1
70977,160,17650,20035;20120,49275,0,0,0,2,2
70978,160,17651,20050,49275,0,0,0,1,1
70979,160,17657,21583;21698,49275,0,0,0,2,2
70980,160,17665,22026;22038,49275,0,0,2,0,2
70981,160,17670,22387;23200;26642,49275,0,0,3,0,3
70982,160,17671,22430;25287;28006,49275,1,0,2,0,3
70983,160,17672,22368;22377,49275,0,0,2,0,2
70984,160,17673,22116,49275,0,0,1,0,1
70985,160,17675,22632;22884,49275,0,0,2,0,2
70986,160,17676,22767;23230,49275,0,0,2,0,2
70987,160,17677,23091;26354;26836,49275,0,1,2,0,3
70988,160,17680,22946;23219,49275,0,0,2,0,2
70989,160,17681,23012;26067,49275,0,0,2,0,2
70990,160,17683,23044;27467,49275,0,1,1,0,2
70991,160,17684,23073;23183;26360,49275,0,0,3,0,3
70992,160,17685,22926;23120,49275,0,0,2,0,2
70993,160,17686,22663;22960;26828,49275,0,1,2,0,3
70994,160,17687,22856;23403;27013;27285,49275,0,2,2,0,4
70995,160,17689,23265;23365,49275,0,0,2,0,2
70996,160,17691,23404;26656,49275,0,0,2,0,2
70997,160,17692,23763;25913;26687,49275,0,0,3,0,3
70998,160,17694,23229;23423,49275,0,0,2,0,2
70999,160,17695,23474;23937;26977;27944,49275,1,1,2,0,4
71000,160,17696,23160;23511;26088;26857,49275,0,1,3,0,4
71001,160,17697,23106;23556,49275,0,0,2,0,2
71002,160,17698,23692,49275,0,0,1,0,1
71003,160,17699,23380;23563;26472,49275,0,0,3,0,3
71004,160,17700,23572;23779;26284;26688;26779;27135;27472,49275,0,2,5,0,7
71005,160,17701,23575;23771;26283,49275,0,0,3,0,3
71006,160,17702,23551;23587;27028,49275,0,1,2,0,3
71007,160,17703,23623;23698;26582;26773;26870,49275,0,1,4,0,5
71008,160,17704,23847;23994;28138,49275,1,0,2,0,3
71009,160,17705,23502,49275,0,0,1,0,1
71010,160,17706,23644;23666,49275,0,0,2,0,2
71011,160,17707,23674;24092;26494,49275,0,0,3,0,3
71012,160,17708,23484;23798;27303,49275,0,1,2,0,3
71013,160,17709,23690;24242;27066,49275,0,1,2,0,3
71014,160,17710,23694;26478;27471,49275,0,1,2,0,3
71015,160,17711,23665;23706;26966;27300,49275,0,2,2,0,4
71016,160,17712,23711;24064;27387,49275,0,1,2,0,3
71017,160,17713,23919;24047,49275,0,0,2,0,2
71018,160,17714,23601;23727;26584,49275,0,0,3,0,3
71019,160,17715,23341;23744;26396;26482;26684;26777,49275,0,0,6,0,6
71020,160,17716,23761;23766,49275,0,0,2,0,2
71021,160,17717,23769,49275,0,0,1,0,1
71022,160,17718,23747;23788;26483;26703;26873;27035;27130;27212,49275,0,4,4,0,8
71023,160,17719,23826;23971;27137,49275,0,1,2,0,3
71024,160,17720,23785;23899;27840,49275,0,1,2,0,3
71025,160,17721,23863;24276,49275,0,0,2,0,2
71026,160,17722,23877;26290;27044,49275,0,1,2,0,3
71027,160,17723,23489;23885;26196,49275,0,0,3,0,3
71028,160,17724,23898;24151;27235;27673;27762,49275,0,3,2,0,5
71029,160,17726,23906;23974;26786,49275,0,0,3,0,3
71030,160,17727,23537;23912;27841,49275,0,1,2,0,3
71031,160,17728,23774;23928;27308,49275,0,1,2,0,3
71032,160,17729,23309;23683;26771;27030,49275,0,1,3,0,4
71033,160,17730,23988;24038;26980;28139,49275,1,1,2,0,4
71034,160,17733,19609,49640,0,0,0,1,1
71035,160,17734,19585,49640,0,0,0,1,1
71036,160,17735,19991,49640,0,0,0,1,1
71037,160,17736,19479,49640,0,0,0,1,1
71038,160,17738,19992,49640,0,0,0,1,1
71039,160,17740,20126,49640,0,0,0,1,1
71040,160,17741,20326;20981,49640,0,0,0,2,2
71041,160,17754,21354,49640,0,0,0,1,1
71042,160,17756,21436;21803,49640,0,0,1,1,2
71043,160,17757,21018;21835;25053,49640,0,0,2,1,3
71044,160,17761,21670;21773,49640,0,0,0,2,2
71045,160,17762,22333;22490,49640,0,0,2,0,2
71046,160,17765,22505;22857,49640,0,0,2,0,2
71047,160,17768,22749;23003,49640,0,0,2,0,2
71048,160,17769,22509;22726;25790,49640,0,0,3,0,3
71049,160,17771,22804;26620,49640,0,0,2,0,2
71050,160,17773,22701;22974,49640,0,0,2,0,2
71051,160,17774,23075;23347;27112,49640,0,1,2,0,3
71052,160,17775,23419;27379,49640,0,1,1,0,2
71053,160,17777,23172;23519;27023,49640,0,1,2,0,3
71054,160,17779,23210;23399;26267;26381;27196,49640,0,1,4,0,5
71055,160,17780,23170;23245;25535,49640,0,0,3,0,3
71056,160,17781,23621,49640,0,0,1,0,1
71057,160,17782,23381;23646,49640,0,0,2,0,2
71058,160,17783,23087;23242;26751,49640,0,0,3,0,3
71059,160,17785,23802,49640,0,0,1,0,1
71060,160,17786,23872;27221,49640,0,1,1,0,2
71061,160,17788,23580;24135;27233,49640,0,1,2,0,3
71062,160,17789,23367;23463;26384;27287,49640,0,1,3,0,4
71063,160,17791,23699;24025,49640,0,0,2,0,2
71064,160,17792,23266;23701;26871,49640,0,1,2,0,3
71065,160,17793,23726;24080;27146,49640,0,1,2,0,3
71066,160,17795,23543;23921;26881;27577;27756,49640,0,3,2,0,5
71067,160,17796,23845;27219,49640,0,1,1,0,2
71068,160,17797,23394;23835;28038,49640,1,0,2,0,3
71069,160,17798,23653;23855;26690;28039,49640,1,0,3,0,4
71070,160,17799,23860;23910;25823;27475;28023;28293,49640,2,1,3,0,6
71071,160,17800,23900,49640,0,0,1,0,1
71072,160,17801,23911,49640,0,0,1,0,1
71073,160,17802,23778;23977;27480,49640,0,1,2,0,3
71074,160,17803,24111;24232;27328,49640,0,1,2,0,3
71075,160,17804,23990;24033;27143;27313,49640,0,2,2,0,4
71076,160,17805,24002;24017;26401;26491;28041;28321,49640,2,0,4,0,6
71077,160,17807,24052;24201;28042,49640,1,0,2,0,3
71078,160,17808,24420;26908;27428;27501;27604,49640,0,4,1,0,5
71079,160,17809,24063;24097;26693,49640,0,0,3,0,3
71080,160,17810,23915;24408;27499;27962,49640,1,1,2,0,4
71081,160,17811,24095;24354;27858,49640,0,1,2,0,3
71082,160,17813,19558,50005,0,0,0,1,1
71083,160,17814,19674,50005,0,0,0,1,1
71084,160,17815,19731;19844,50005,0,0,0,2,2
71085,160,17816,19305,50005,0,0,0,1,1
71086,160,17818,19945,50005,0,0,0,1,1
71087,160,17819,19877,50005,0,0,0,1,1
71088,160,17820,20055;20108,50005,0,0,0,2,2
71089,160,17825,20193;20545,50005,0,0,0,2,2
71090,160,17827,20945,50005,0,0,0,1,1
71091,160,17830,21054;21270,50005,0,0,0,2,2
71092,160,17832,21972;22560,50005,0,0,2,0,2
71093,160,17836,21630;21666;25358,50005,0,0,1,2,3
71094,160,17842,21503;21806,50005,0,0,1,1,2
71095,160,17843,22107,50005,0,0,1,0,1
71096,160,17846,21718;22037,50005,0,0,1,1,2
71097,160,17851,22535;22802,50005,0,0,2,0,2
71098,160,17853,22700,50005,0,0,1,0,1
71099,160,17855,22949;22975;27007,50005,0,1,2,0,3
71100,160,17856,22364,50005,0,0,1,0,1
71101,160,17857,22796;23216,50005,0,0,2,0,2
71102,160,17861,23114;23508,50005,0,0,2,0,2
71103,160,17862,23076;23116,50005,0,0,2,0,2
71104,160,17864,23197;23680;26281;26581;26770;27127;27210,50005,0,2,5,0,7
71105,160,17865,24073;27320;27404,50005,0,2,1,0,3
71106,160,17866,23346;23560;25730,50005,0,0,3,0,3
71107,160,17867,23590;26089;27206,50005,0,1,2,0,3
71108,160,17868,23471;26854,50005,0,1,1,0,2
71109,160,17869,23482;23746;26969;27034;27301,50005,0,3,2,0,5
71110,160,17870,23492;25990;26468;26954;27288;27835,50005,0,3,3,0,6
71111,160,17871,23215;23510;26386;26570;26668;27290;27382;27661,50005,0,3,5,0,8
71112,160,17872,23516;26387;27118,50005,0,1,2,0,3
71113,160,17874,24070;27058;27319,50005,0,2,1,0,3
71114,160,17875,23564;23941,50005,0,0,2,0,2
71115,160,17876,23995;27142;27844,50005,0,2,1,0,3
71116,160,17877,23675;23843;26876;26973;27218;27750,50005,0,4,2,0,6
71117,160,17878,23613;23876;26878;27139;27222;27393,50005,0,4,2,0,6
71118,160,17879,23292;23457;27660,50005,0,1,2,0,3
71119,160,17880,23627;23679;25435;26769,50005,0,0,4,0,4
71120,160,17882,23745;23822;27129,50005,0,1,2,0,3
71121,160,17883,23797;24050;27670,50005,0,1,2,0,3
71122,160,17884,23689;23851;27752,50005,0,1,2,0,3
71123,160,17885,23725;23867;26590;26783;26974,50005,0,1,4,0,5
71124,160,17886,23903;23909;26389;27047,50005,0,1,3,0,4
71125,160,17887,24105;24295;27332,50005,0,1,2,0,3
71126,160,17888,23648;23931;27398;27476,50005,0,2,2,0,4
71127,160,17889,23677;24392;27250;27425,50005,0,2,2,0,4
71128,160,17890,23507;23950;26788;27051,50005,0,1,3,0,4
71129,160,17891,23986;24407;26304;27685;27862;27961,50005,1,2,3,0,6
71130,160,17892,23996;24078;26884,50005,0,1,2,0,3
71131,160,17893,24041;24288;26981;27056,50005,0,2,2,0,4
71132,160,17894,24048;26789;26888;27587,50005,0,2,2,0,4
71133,160,17896,24225;26897;27593;27678;27853,50005,0,4,1,0,5
71134,160,17897,24001;24273;27956;28233,50005,2,0,2,0,4
71135,160,17899,23925;24077,50005,0,0,2,0,2
71136,160,17900,23737;24079;26597;26889;26983,50005,0,2,3,0,5
71137,160,17901,24104;24117,50005,0,0,2,0,2
71138,160,17902,23517;24074,50005,0,0,2,0,2
71139,160,17903,24432;27255,50005,0,1,1,0,2
71140,160,17904,24144;24267;27069;27955,50005,1,1,2,0,4
71141,160,17905,24186;24215;27240;27327;28141,50005,1,2,2,0,5
71142,160,17906,24192;24200;26700;27415;27592,50005,0,2,3,0,5
71143,160,17910,19806,50370,0,0,0,1,1
71144,160,17916,20713;21022,50370,0,0,0,2,2
71145,160,17920,21160,50370,0,0,0,1,1
71146,160,17922,21328;21950,50370,0,0,1,1,2
71147,160,17923,21151;21359,50370,0,0,0,2,2
71148,160,17930,21544;21926,50370,0,0,1,1,2
71149,160,17931,21756;21876,50370,0,0,1,1,2
71150,160,17932,21470;21696,50370,0,0,0,2,2
71151,160,17933,22077;22290,50370,0,0,2,0,2
71152,160,17934,22338,50370,0,0,1,0,1
71153,160,17935,22222;22735,50370,0,0,2,0,2
71154,160,17938,22931,50370,0,0,1,0,1
71155,160,17940,22166;22412,50370,0,0,2,0,2
71156,160,17942,22488;22806,50370,0,0,2,0,2
71157,160,17948,22930,50370,0,0,1,0,1
71158,160,17949,22762;22988;26245;26737,50370,0,0,4,0,4
71159,160,17950,23409,50370,0,0,1,0,1
71160,160,17952,23029;23036;26632;26830,50370,0,1,3,0,4
71161,160,17953,23039;23850;26588;27391;27836,50370,0,2,3,0,5
71162,160,17954,23058;26539,50370,0,0,2,0,2
71163,160,17955,23167;23569;27205,50370,0,1,2,0,3
71164,160,17956,23186;23345,50370,0,0,2,0,2
71165,160,17957,23231;23591;26863;27294,50370,0,2,2,0,4
71166,160,17959,23308;23625;26577,50370,0,0,3,0,3
71167,160,17960,24088;27483,50370,0,1,1,0,2
71168,160,17961,23709;26092;26774;27128,50370,0,1,3,0,4
71169,160,17962,23431;23795;27136,50370,0,1,2,0,3
71170,160,17963,23586;23818;27389,50370,0,1,2,0,3
71171,160,17965,23387;23415;26848,50370,0,1,2,0,3
71172,160,17966,23228;23454;26662;26851,50370,0,1,3,0,4
71173,160,17967,23437;23494;26763;27199,50370,0,1,3,0,4
71174,160,17968,23020;23542;26185;26470;26573;26859;27202,50370,0,2,5,0,7
71175,160,17969,23615;24102;27484,50370,0,1,2,0,3
71176,160,17971,23730;23979;26883;27227;27580,50370,0,3,2,0,5
71177,160,17972,23743;24101;26984,50370,0,1,2,0,3
71178,160,17973,23784;24302;26100;27493;27598,50370,0,2,3,0,5
71179,160,17974,24058;24069;27482,50370,0,1,2,0,3
71180,160,17975,23397;23794;27037;27388,50370,0,2,2,0,4
71181,160,17976,23594;23806,50370,0,0,2,0,2
71182,160,17977,23704;23824;27216,50370,0,1,2,0,3
71183,160,17978,23718;23839;26398;27390,50370,0,1,3,0,4
71184,160,17979,23693;23848,50370,0,0,2,0,2
71185,160,17980,23708;23858;26583;27386,50370,0,1,3,0,4
71186,160,17981,23859;24305;26797;27494,50370,0,1,3,0,4
71187,160,17982,24214;24378,50370,0,0,2,0,2
71188,160,17983,23887;26593;27395,50370,0,1,2,0,3
71189,160,17984,23897;24216,50370,0,0,2,0,2
71190,160,17985,23913;24045;27402;27586,50370,0,2,2,0,4
71191,160,17986,23923;23942;26293;26787;27224;27478,50370,0,2,4,0,6
71192,160,17987,24296;26302;26409;27597,50370,0,1,3,0,4
71193,160,17988,23632;24228;26299;26793;27854,50370,0,1,4,0,5
71194,160,17989,23985;24350;26498;26906,50370,0,1,3,0,4
71195,160,17990,23930;23992,50370,0,0,2,0,2
71196,160,17991,23999;24173,50370,0,0,2,0,2
71197,160,17992,23889;24010;27668,50370,0,1,2,0,3
71198,160,17993,23719;24061;27317,50370,0,1,2,0,3
71199,160,17994,24082;24278;27071;27153;27492,50370,0,3,2,0,5
71200,160,17995,24085;24099;27322,50370,0,1,2,0,3
71201,160,17996,24224;24445;26706,50370,0,0,3,0,3
71202,160,17997,24501;24663;27080,50370,0,1,2,0,3
71203,160,17999,24142;24448;26696;27672,50370,0,1,3,0,4
71204,160,18000,24401;27162;27769,50370,0,2,1,0,3
71205,160,18001,24163;24349;27958,50370,1,0,2,0,3
71206,160,18002,24166;24385;27498,50370,0,1,2,0,3
71207,160,18003,24091;24167;27410;27674,50370,0,2,2,0,4
71208,160,18004,24431;24463;26500;27505,50370,0,1,3,0,4
71209,160,18005,24197;24520;27691;27775;28147,50370,1,2,2,0,5
71210,160,18006,24266;24370;26907;27859,50370,0,2,2,0,4
71211,160,18007,23940;24367,50370,0,0,2,0,2
71212,160,18009,24136;24289,50370,0,0,2,0,2
71213,160,18010,24202;24308;27416,50370,0,1,2,0,3
71214,160,18011,24009;24313;26206;26901,50370,0,1,3,0,4
71215,160,18016,19983,50735,0,0,0,1,1
71216,160,18018,20006,50735,0,0,0,1,1
71217,160,18019,19890,50735,0,0,0,1,1
71218,160,18020,19645,50735,0,0,0,1,1
71219,160,18021,19833,50735,0,0,0,1,1
71220,160,18025,20462,50735,0,0,0,1,1
71221,160,18026,20992,50735,0,0,0,1,1
71222,160,18027,20539,50735,0,0,0,1,1
71223,160,18030,20746;20801,50735,0,0,0,2,2
71224,160,18031,21055;21182,50735,0,0,0,2,2
71225,160,18034,21263;21316,50735,0,0,0,2,2
71226,160,18041,21161;21291,50735,0,0,0,2,2
71227,160,18045,21226;21319,50735,0,0,0,2,2
71228,160,18049,22253;22314,50735,0,0,2,0,2
71229,160,18052,22694;23433,50735,0,0,2,0,2
71230,160,18054,22443;22801;27185,50735,0,1,2,0,3
71231,160,18057,22968;23205;26364;26550;27283,50735,0,1,4,0,5
71232,160,18059,23066;23619,50735,0,0,2,0,2
71233,160,18063,22639;23274,50735,0,0,2,0,2
71234,160,18064,23281;23338;26557;27111,50735,0,1,3,0,4
71235,160,18065,23342;23634;26962;27029,50735,0,2,2,0,4
71236,160,18066,23425;23493;25986;26464;27073;27197,50735,0,2,4,0,6
71237,160,18067,23435;23476;26661,50735,0,0,3,0,3
71238,160,18068,23458;27286,50735,0,1,1,0,2
71239,160,18069,23630,50735,0,0,1,0,1
71240,160,18071,23468;23755;26686,50735,0,0,3,0,3
71241,160,18073,24030;24087;26886;27584,50735,0,2,2,0,4
71242,160,18074,23703;24075;27145;27845,50735,0,2,2,0,4
71243,160,18075,24377;26499;27860,50735,0,1,2,0,3
71244,160,18076,24411;24447;28050,50735,1,0,2,0,3
71245,160,18079,24043;24189;27063;27591,50735,0,2,2,0,4
71246,160,18080,23787;24188;27062;28043,50735,1,1,2,0,4
71247,160,18082,23895;26692;26975,50735,0,1,2,0,3
71248,160,18083,24126;24268;27406,50735,0,1,2,0,3
71249,160,18084,23891;24153;26891;27408,50735,0,2,2,0,4
71250,160,18085,23920;24335;26990,50735,0,1,2,0,3
71251,160,18086,23924;24248;27242,50735,0,1,2,0,3
71252,160,18087,23927;23976;27307;27397,50735,0,2,2,0,4
71253,160,18088,23948;24293;27243,50735,0,1,2,0,3
71254,160,18089,24526,50735,0,0,1,0,1
71255,160,18090,23963;23991;27141;27758,50735,0,2,2,0,4
71256,160,18091,23949;24051;27314;27946,50735,1,1,2,0,4
71257,160,18092,24381;24675;27336,50735,0,1,2,0,3
71258,160,18093,23645;23892,50735,0,0,2,0,2
71259,160,18094,23833;27042;27305;27749,50735,0,3,1,0,4
71260,160,18095,24007;24241,50735,0,0,2,0,2
71261,160,18097,24071;24157;26892;27324,50735,0,2,2,0,4
71262,160,18098,24072;24502;26994,50735,0,1,2,0,3
71263,160,18099,24122;24281;27680;28143,50735,1,1,2,0,4
71264,160,18100,24113;24415;27337,50735,0,1,2,0,3
71265,160,18101,24124;24723;27171;27345,50735,0,2,2,0,4
71266,160,18102,24031;24127;26978;27585,50735,0,2,2,0,4
71267,160,18103,23952;24130,50735,0,0,2,0,2
71268,160,18104,24344;24644;27436,50735,0,1,2,0,3
71269,160,18105,24609;27782;27974,50735,1,1,1,0,3
71270,160,18106,24103;24204;27405;27947,50735,1,1,2,0,4
71271,160,18107,23981;24476;26909,50735,0,1,2,0,3
71272,160,18108,23944;24244;27067;27152;27241;27490;27679;28142,50735,1,5,2,0,8
71273,160,18109,24717;27705;28332,50735,1,1,1,0,3
71274,160,18110,23740;24177;27061;27147;27411,50735,0,3,2,0,5
71275,160,18111,24433;24597;27517;27618,50735,0,2,2,0,4
71276,160,18112,24285;24458;27340;27606;27772,50735,0,3,2,0,5
71277,160,18113,24301;24724,50735,0,0,2,0,2
71278,160,18114,24662;27089;28240,50735,1,1,1,0,3
71279,160,18115,24575;27694;28152,50735,1,1,1,0,3
71280,160,18116,24231;24328;27072;27244;27422;27599,50735,0,4,2,0,6
71281,160,18117,24040;24379;27074,50735,0,1,2,0,3
71282,160,18118,24382;24743,50735,0,0,2,0,2
71283,160,18119,24314;24409;26412;27253;27770;28235,50735,1,2,3,0,6
71284,160,18120,24421;24540;26708,50735,0,0,3,0,3
71285,160,18121,19929,51100,0,0,0,1,1
71286,160,18124,20312,51100,0,0,0,1,1
71287,160,18126,19947,51100,0,0,0,1,1
71288,160,18130,20816,51100,0,0,0,1,1
71289,160,18131,20872,51100,0,0,0,1,1
71290,160,18133,20530,51100,0,0,0,1,1
71291,160,18134,21057;21596,51100,0,0,0,2,2
71292,160,18137,21191;21224,51100,0,0,0,2,2
71293,160,18138,20793;21228,51100,0,0,0,2,2
71294,160,18146,21463;21683,51100,0,0,0,2,2
71295,160,18152,22014,51100,0,0,1,0,1
71296,160,18157,22483;22679,51100,0,0,2,0,2
71297,160,18159,22824;23134,51100,0,0,2,0,2
71298,160,18160,22776;23282;26170;26373;28135,51100,1,0,4,0,5
71299,160,18161,22789;23140;26839;26938,51100,0,2,2,0,4
71300,160,18164,22644;22888;26344,51100,0,0,3,0,3
71301,160,18167,23307,51100,0,0,1,0,1
71302,160,18168,23395;23515,51100,0,0,2,0,2
71303,160,18169,23393;23998;27481;27759,51100,0,2,2,0,4
71304,160,18170,23376;23461;26566,51100,0,0,3,0,3
71305,160,18171,23421;23547;26959;27120;27292,51100,0,3,2,0,5
71306,160,18173,23875;24006;27228;27401,51100,0,2,2,0,4
71307,160,18174,23582;23622;27124;27748,51100,0,2,2,0,4
71308,160,18176,23509;24005;27054;27581,51100,0,2,2,0,4
71309,160,18177,23736;24178;27148;27237,51100,0,2,2,0,4
71310,160,18178,23566;23754;26685,51100,0,0,3,0,3
71311,160,18179,23593;23789;27215;27663,51100,0,2,2,0,4
71312,160,18180,23831;24642;27435,51100,0,1,2,0,3
71313,160,18181,23896;24150;26785,51100,0,0,3,0,3
71314,160,18182,23907,51100,0,0,1,0,1
71315,160,18183,23935;24140;27060;27407,51100,0,2,2,0,4
71316,160,18184,23953;24270,51100,0,0,2,0,2
71317,160,18185,23505;24008;27055;27311,51100,0,2,2,0,4
71318,160,18186,23965;24524;26608,51100,0,0,3,0,3
71319,160,18187,23697;23978;27226,51100,0,1,2,0,3
71320,160,18188,23983;26094,51100,0,0,2,0,2
71321,160,18189,24310;27154;27767,51100,0,2,1,0,3
71322,160,18190,24021,51100,0,0,1,0,1
71323,160,18191,24688;24968;27168;27522;27703,51100,0,3,2,0,5
71324,160,18193,24180;24537;26914,51100,0,1,2,0,3
71325,160,18194,24218;24788;27528,51100,0,1,2,0,3
71326,160,18195,24656,51100,0,0,1,0,1
71327,160,18196,24234;24316;27155,51100,0,1,2,0,3
71328,160,18197,24141;24380;27959,51100,1,0,2,0,3
71329,160,18199,24062;24521;26607;26912;27509;28148,51100,1,2,3,0,6
71330,160,18200,24366;24652;27088;27871,51100,0,2,2,0,4
71331,160,18201,24384;24475;26798;26991;27160;27861;27960;28048,51100,2,3,3,0,8
71332,160,18202,24628,51100,0,0,1,0,1
71333,160,18203,24404;27252;28146,51100,1,1,1,0,3
71334,160,18204,24004;24425,51100,0,0,2,0,2
71335,160,18206,24443;24451;27338;27430;27503,51100,0,3,2,0,5
71336,160,18207,24081;24482;27506;27607;27689,51100,0,3,2,0,5
71337,160,18208,24416;24489;27341;27507;27774;27964,51100,1,3,2,0,6
71338,160,18209,24491;26910,51100,0,1,1,0,2
71339,160,18210,24503;24760;26714;27791,51100,0,1,3,0,4
71340,160,18211,24506;24640;27163,51100,0,1,2,0,3
71341,160,18212,24362;24721;27170,51100,0,1,2,0,3
71342,160,18213,24511;24528,51100,0,0,2,0,2
71343,160,18214,19818,51465,0,0,0,1,1
71344,160,18220,20548,51465,0,0,0,1,1
71345,160,18223,20994,51465,0,0,0,1,1
71346,160,18226,21146,51465,0,0,0,1,1
71347,160,18229,21774;21996;26109,51465,0,0,2,1,3
71348,160,18230,21616,51465,0,0,0,1,1
71349,160,18233,21908,51465,0,0,1,0,1
71350,160,18235,21763;21862,51465,0,0,1,1,2
71351,160,18240,22594;22641,51465,0,0,2,0,2
71352,160,18243,22938,51465,0,0,1,0,1
71353,160,18245,23000;23128,51465,0,0,2,0,2
71354,160,18249,22957;23162,51465,0,0,2,0,2
71355,160,18250,23176;23610;26679;27297,51465,0,1,3,0,4
71356,160,18251,23198;26362;26940,51465,0,1,2,0,3
71357,160,18252,22681,51465,0,0,1,0,1
71358,160,18253,23495,51465,0,0,1,0,1
71359,160,18254,22940;23300;26845;27109,51465,0,2,2,0,4
71360,160,18255,23263;23444;27016;27567,51465,0,2,2,0,4
71361,160,18258,23285,51465,0,0,1,0,1
71362,160,18259,23438;23624;26393;28034;28311,51465,2,0,3,0,5
71363,160,18260,23271;23447,51465,0,0,2,0,2
71364,160,18261,23455;23750,51465,0,0,2,0,2
71365,160,18262,23803;27039,51465,0,1,1,0,2
71366,160,18263,23506;24171,51465,0,0,2,0,2
71367,160,18264,23530;23685;26681,51465,0,0,3,0,3
71368,160,18265,23599;23687;27940,51465,1,0,2,0,3
71369,160,18266,23360;23611;26961,51465,0,1,2,0,3
71370,160,18267,23695;23733;26282,51465,0,0,3,0,3
71371,160,18268,23956;24298;27140;27578;27757,51465,0,3,2,0,5
71372,160,18269,23776;24213;26792,51465,0,0,3,0,3
71373,160,18270,24395;26603,51465,0,0,2,0,2
71374,160,18271,23933;26976,51465,0,1,1,0,2
71375,160,18272,23836;24172;27590;27849,51465,0,2,2,0,4
71376,160,18273,23866,51465,0,0,1,0,1
71377,160,18274,23878;24100;27045;27394,51465,0,2,2,0,4
71378,160,18275,23562;23752;26778,51465,0,0,3,0,3
71379,160,18276,23959;24181;26987,51465,0,1,2,0,3
71380,160,18277,23969;24195;26698;27064;27413,51465,0,2,3,0,5
71381,160,18278,24624;24638,51465,0,0,2,0,2
71382,160,18279,23838;24114;27232,51465,0,1,2,0,3
71383,160,18280,24120;24374;27159;27768;28145,51465,1,2,2,0,5
71384,160,18281,24650;27087;27621;28157,51465,1,2,1,0,4
71385,160,18282,23888;24191;27487;27850,51465,0,2,2,0,4
71386,160,18283,24190;24509,51465,0,0,2,0,2
71387,160,18284,24541;26803;27081;27612,51465,0,2,2,0,4
71388,160,18285,24307,51465,0,0,1,0,1
71389,160,18286,24581;24694;27695,51465,0,1,2,0,3
71390,160,18287,24333;24373;27245,51465,0,1,2,0,3
71391,160,18288,24162;24339;26904,51465,0,1,2,0,3
71392,160,18289,24545;26915;27433,51465,0,2,1,0,3
71393,160,18291,24342;24734;26713;27526,51465,0,1,3,0,4
71394,160,18292,24358;24446;26413;26604;27502;28232;28312,51465,2,1,4,0,7
71395,160,18293,24413;24950;27001;27990,51465,1,1,2,0,4
71396,160,18294,24436;24949;27357;27536;27896,51465,0,3,2,0,5
71397,160,18296,24398;24449;27161;27603,51465,0,2,2,0,4
71398,160,18297,24277;24603;27973,51465,1,0,2,0,3
71399,160,18298,24467;24795;28336,51465,1,0,2,0,3
71400,160,18299,24212;24470,51465,0,0,2,0,2
71401,160,18300,24239;24369,51465,0,0,2,0,2
71402,160,18301,24584;24612;27259;27519;28156,51465,1,2,2,0,5
71403,160,18302,24680;24857;26923,51465,0,1,2,0,3
71404,160,18303,24874;27351;27886;27989,51465,1,2,1,0,4
71405,160,18304,24543;24758;27707,51465,0,1,2,0,3
71406,160,18305,24510;24564;26995;27615;27693,51465,0,3,2,0,5
71407,160,18306,24571;24844;27092;28167,51465,1,1,2,0,4
71408,160,18307,24332;24937;28256,51465,1,0,2,0,3
71409,160,18308,24579;24693;27263,51465,0,1,2,0,3
71410,160,18311,20345,51830,0,0,0,1,1
71411,160,18314,20565;20712,51830,0,0,0,2,2
71412,160,18315,20800,51830,0,0,0,1,1
71413,160,18318,20822,51830,0,0,0,1,1
71414,160,18319,20647,51830,0,0,0,1,1
71415,160,18321,21183,51830,0,0,0,1,1
71416,160,18322,20848,51830,0,0,0,1,1
71417,160,18332,22278,51830,0,0,1,0,1
71418,160,18333,22215;22593,51830,0,0,2,0,2
71419,160,18334,22507;22683,51830,0,0,2,0,2
71420,160,18344,22470,51830,0,0,1,0,1
71421,160,18346,23033;23164;26359,51830,0,0,3,0,3
71422,160,18347,23742,51830,0,0,1,0,1
71423,160,18349,23402;23667,51830,0,0,2,0,2
71424,160,18353,23488;23817;27041,51830,0,1,2,0,3
71425,160,18354,23375;23707;26967,51830,0,1,2,0,3
71426,160,18355,23578;24022,51830,0,0,2,0,2
71427,160,18357,23629;23751;25647;27132;27213;27302,51830,0,3,3,0,6
71428,160,18359,23681;23936;26882;27943,51830,1,1,2,0,4
71429,160,18360,23809;23917;27304;28037,51830,1,1,2,0,4
71430,160,18362,23884;24065;27403,51830,0,1,2,0,3
71431,160,18364,23947;24133;26695;27323,51830,0,1,3,0,4
71432,160,18365,23793;23962;27399;28040,51830,1,1,2,0,4
71433,160,18366,23972;23984;27053;27310;27667,51830,0,3,2,0,5
71434,160,18367,23790;24282;26301,51830,0,0,3,0,3
71435,160,18368,24604;27619;28327,51830,1,1,1,0,3
71436,160,18369,24220;24400,51830,0,0,2,0,2
71437,160,18370,24661;24883;27173,51830,0,1,2,0,3
71438,160,18371,24115;24279;26790;27059,51830,0,1,3,0,4
71439,160,18372,24131;24265;27068;27595,51830,0,2,2,0,4
71440,160,18373,24138;27485;27949,51830,1,1,1,0,3
71441,160,18374,23908;24139,51830,0,0,2,0,2
71442,160,18375,24355;27158,51830,0,1,1,0,2
71443,160,18376,23442;24185;26894;27149;27238;27412;27763,51830,0,5,2,0,7
71444,160,18377,24203;27688,51830,0,1,1,0,2
71445,160,18378,24147;24207;26405;26701;26895;26988;27150;27417;27952,51830,1,4,4,0,9
71446,160,18379,24261;24504,51830,0,0,2,0,2
71447,160,18380,24360;27335;27496,51830,0,2,1,0,3
71448,160,18381,24306;24479,51830,0,0,2,0,2
71449,160,18382,24326;24583;26601;26903,51830,0,1,3,0,4
71450,160,18383,24389;24990;27991;28345,51830,2,0,2,0,4
71451,160,18384,24761;24854;27534;28071;28338,51830,2,1,2,0,5
71452,160,18385,24324;24424,51830,0,0,2,0,2
71453,160,18386,24311;24690,51830,0,0,2,0,2
71454,160,18388,24534;27511,51830,0,1,1,0,2
71455,160,18389,24414;24542;27512;27863,51830,0,2,2,0,4
71456,160,18390,24481;24877;27887,51830,0,1,2,0,3
71457,160,18391,24559;24748;27790;28061,51830,1,1,2,0,4
71458,160,18392,24560;24886,51830,0,0,2,0,2
71459,160,18393,24570;24711;27704,51830,0,1,2,0,3
71460,160,18394,24497;24595;26917;27697;27971,51830,1,2,2,0,5
71461,160,18395,24602;24960;27434;27972,51830,1,1,2,0,4
71462,160,18396,24867;27709,51830,0,1,1,0,2
71463,160,18397,24646;24850;28070;28337,51830,2,0,2,0,4
71464,160,18398,24322;24845;27796;27881;28069,51830,1,2,2,0,5
71465,160,18399,24664;24775;26804;27437;27872,51830,0,2,3,0,5
71466,160,18401,24375;24692;27626;27979,51830,1,1,2,0,4
71467,160,18402,24116;24550;27082,51830,0,1,2,0,3
71468,160,18404,24554;24745;27778,51830,0,1,2,0,3
71469,160,18405,24750;24969,51830,0,0,2,0,2
71470,160,18406,20182,52195,0,0,0,1,1
71471,160,18408,19906,52195,0,0,0,1,1
71472,160,18410,20309,52195,0,0,0,1,1
71473,160,18411,19850,52195,0,0,0,1,1
71474,160,18412,20607,52195,0,0,0,1,1
71475,160,18413,20694,52195,0,0,0,1,1
71476,160,18414,20763,52195,0,0,0,1,1
71477,160,18417,20640,52195,0,0,0,1,1
71478,160,18418,20782,52195,0,0,0,1,1
71479,160,18426,21440;21622,52195,0,0,0,2,2
71480,160,18430,21108,52195,0,0,0,1,1
71481,160,18432,22153,52195,0,0,1,0,1
71482,160,18436,22586,52195,0,0,1,0,1
71483,160,18439,22984;23873;27392,52195,0,1,2,0,3
71484,160,18440,23199;23310;26376;28231,52195,1,0,3,0,4
71485,160,18441,22629;23224;26749;27011,52195,0,1,3,0,4
71486,160,18442,23252;26369;26645,52195,0,0,3,0,3
71487,160,18443,23294;23430;26465;26950,52195,0,1,3,0,4
71488,160,18445,23469;23475;26664;26853,52195,0,1,3,0,4
71489,160,18446,23534;24094;27230,52195,0,1,2,0,3
71490,160,18447,23577;24312;27333;28144,52195,1,1,2,0,4
71491,160,18448,23268;26941;27108,52195,0,2,1,0,3
71492,160,18449,24187;27239;27325,52195,0,2,1,0,3
71493,160,18452,23821;24364;27246;27497;27683,52195,0,3,2,0,5
71494,160,18453,23842;24090,52195,0,0,2,0,2
71495,160,18454,23864;24199;26699;27764,52195,0,1,3,0,4
71496,160,18455,23880;24060;27316;27588,52195,0,2,2,0,4
71497,160,18456,23902;24251;28323,52195,1,0,2,0,3
71498,160,18457,23583;26862,52195,0,1,1,0,2
71499,160,18458,23499;23934;27049;27477,52195,0,2,2,0,4
71500,160,18459,23961;24246;27491;27765,52195,0,2,2,0,4
71501,160,18460,23904;24372,52195,0,0,2,0,2
71502,160,18461,24039;24155;26297;27847;28140,52195,1,1,3,0,5
71503,160,18462,24174;24393;26993;27426;27684,52195,0,3,2,0,5
71504,160,18463,24175;24222;27488,52195,0,1,2,0,3
71505,160,18464,24227;24388;26992;27248,52195,0,2,2,0,4
71506,160,18465,24243;24568;27514;27968,52195,1,1,2,0,4
71507,160,18466,24250;24292,52195,0,0,2,0,2
71508,160,18467,24256;24573;27164,52195,0,1,2,0,3
71509,160,18468,24299;24321;26902;27855;27957,52195,1,2,2,0,5
71510,160,18469,24315;24625;27869,52195,0,1,2,0,3
71511,160,18470,24755;24978;27003;27898,52195,0,2,2,0,4
71512,160,18471,24522;24726;27982,52195,1,0,2,0,3
71513,160,18472,24710,52195,0,0,1,0,1
71514,160,18473,24356;24586,52195,0,0,2,0,2
71515,160,18474,24516;24784;27629;28162,52195,1,1,2,0,4
71516,160,18475,24318;24527;26707;26913,52195,0,1,3,0,4
71517,160,18476,24535;25127;27998,52195,1,0,2,0,3
71518,160,18477,24435;24552;27083;27613;28057,52195,1,2,2,0,5
71519,160,18478,24569;24668;27702,52195,0,1,2,0,3
71520,160,18479,24329;24585;27156;27681,52195,0,2,2,0,4
71521,160,18480,24466;24587;27166,52195,0,1,2,0,3
71522,160,18481,24386;24594;27696;27868;27970;28153,52195,2,2,2,0,6
71523,160,18483,24460,52195,0,0,1,0,1
71524,160,18484,24149;24722;27090;28159,52195,1,1,2,0,4
71525,160,18485,24702;27787;27981;28241,52195,2,1,1,0,4
71526,160,18486,24620;24961;27002,52195,0,1,2,0,3
71527,160,18487,24258;24630;27343;28060,52195,1,1,2,0,4
71528,160,18488,24639;24940,52195,0,0,2,0,2
71529,160,18490,24923;28342,52195,1,0,1,0,2
71530,160,18491,25148;25231;27910,52195,0,1,2,0,3
71531,160,18492,24430;24859;28072;28252;28339,52195,3,0,2,0,5
71532,160,18493,24718;27789;27875,52195,0,2,1,0,3
71533,160,18494,24728;24878;28243,52195,1,0,2,0,3
71534,160,18495,24730,52195,0,0,1,0,1
71535,160,18496,24655;24736;27701,52195,0,1,2,0,3
71536,160,18497,24368;24757;28334,52195,1,0,2,0,3
71537,160,18498,24485;24759;27078,52195,0,1,2,0,3
71538,160,18499,24765;24891;27792;28062,52195,1,1,2,0,4
71539,160,18500,24562;24771;27984,52195,1,0,2,0,3
71540,160,18501,25101;25213;27100;27996;28352,52195,2,1,2,0,5
71541,160,18502,24657;25071,52195,0,0,2,0,2
71542,160,18503,24829;27349,52195,0,1,1,0,2
71543,160,18504,25084,52195,0,0,1,0,1
71544,160,18505,25094;27366,52195,0,1,1,0,2
71545,160,18507,20599,52560,0,0,0,1,1
71546,160,18509,20525,52560,0,0,0,1,1
71547,160,18512,20478,52560,0,0,0,1,1
71548,160,18514,21124,52560,0,0,0,1,1
71549,160,18515,21042,52560,0,0,0,1,1
71550,160,18519,20861,52560,0,0,0,1,1
71551,160,18523,21859;21882,52560,0,0,2,0,2
71552,160,18527,22285;22711,52560,0,0,2,0,2
71553,160,18528,21671,52560,0,0,0,1,1
71554,160,18533,22251,52560,0,0,1,0,1
71555,160,18536,22696;22697,52560,0,0,2,0,2
71556,160,18540,22937;23370,52560,0,0,2,0,2
71557,160,18542,22899;23261,52560,0,0,2,0,2
71558,160,18543,23411;26463;26657,52560,0,0,3,0,3
71559,160,18544,23589;23832;26001;27473,52560,0,1,3,0,4
71560,160,18546,23748;26874;27131,52560,0,2,1,0,3
71561,160,18547,23825;24255;26795;27419;28044,52560,1,1,3,0,5
71562,160,18549,24011;24158;26201;27409,52560,0,1,3,0,4
71563,160,18550,24160;24334,52560,0,0,2,0,2
71564,160,18551,23702;24057;27032;27211,52560,0,2,2,0,4
71565,160,18554,23871;27838,52560,0,1,1,0,2
71566,160,18555,24198;24441;26705;27256;27963,52560,1,1,3,0,5
71567,160,18556,24249;24840;27531;28249,52560,1,1,2,0,4
71568,160,18557,24274;24741;27627;28160,52560,1,1,2,0,4
71569,160,18559,24309;26205;27421,52560,0,1,2,0,3
71570,160,18560,24320;24477;27334,52560,0,1,2,0,3
71571,160,18561,24327;24906;27354;27634,52560,0,2,2,0,4
71572,160,18562,24259;24410;27254,52560,0,1,2,0,3
71573,160,18563,24412;24708;26712;27169;27788,52560,0,2,3,0,5
71574,160,18564,24211;24464;27077;28052,52560,1,1,2,0,4
71575,160,18565,24493;24870;27884,52560,0,1,2,0,3
71576,160,18566,23894;24557;27864;28151,52560,1,1,2,0,4
71577,160,18567,24778;27628,52560,0,1,1,0,2
71578,160,18568,24555;24907;26925;27800,52560,0,2,2,0,4
71579,160,18569,24572;24799;27985,52560,1,0,2,0,3
71580,160,18570,24591;24681;27617;27867,52560,0,2,2,0,4
71581,160,18571,24519;24871;28168;28340,52560,2,0,2,0,4
71582,160,18572,24319;24606;27698,52560,0,1,2,0,3
71583,160,18573,24643;24863;27988;28073,52560,2,0,2,0,4
71584,160,18574,24651;24805;27784,52560,0,1,2,0,3
71585,160,18575,24706;24986,52560,0,0,2,0,2
71586,160,18576,24532;27777,52560,0,1,1,0,2
71587,160,18577,24740;27440;27876;27983;28244,52560,2,2,1,0,5
71588,160,18578,24789;25002;27360;27637;28259,52560,1,2,2,0,5
71589,160,18579,24469;24794;27264,52560,0,1,2,0,3
71590,160,18580,24798;25088;27347;28163,52560,1,1,2,0,4
71591,160,18581,24803;24916,52560,0,0,2,0,2
71592,160,18582,24492;24809;27631;28066;28165,52560,2,1,2,0,5
71593,160,18583,24548,52560,0,0,1,0,1
71594,160,18584,24831;25315;27369,52560,0,1,2,0,3
71595,160,18585,24667;24838,52560,0,0,2,0,2
71596,160,18586,24855;26922;27350,52560,0,2,1,0,3
71597,160,18587,24921;25144,52560,0,0,2,0,2
71598,160,18588,24924;25123;26927;27997,52560,1,1,2,0,4
71599,160,18589,24943;25276;28193,52560,1,0,2,0,3
71600,160,18590,25192,52560,0,0,1,0,1
71601,160,18591,20197,52925,0,0,0,1,1
71602,160,18592,20649,52925,0,0,0,1,1
71603,160,18593,20756,52925,0,0,0,1,1
71604,160,18597,21397,52925,0,0,0,1,1
71605,160,18599,20905,52925,0,0,0,1,1
71606,160,18600,21103,52925,0,0,0,1,1
71607,160,18601,20657,52925,0,0,0,1,1
71608,160,18602,21152,52925,0,0,0,1,1
71609,160,18613,21877,52925,0,0,1,0,1
71610,160,18614,21799;22047,52925,0,0,2,0,2
71611,160,18616,22118,52925,0,0,1,0,1
71612,160,18621,22787;23004,52925,0,0,2,0,2
71613,160,18625,22972,52925,0,0,1,0,1
71614,160,18627,22576;22920,52925,0,0,2,0,2
71615,160,18629,22898,52925,0,0,1,0,1
71616,160,18633,23378;23796,52925,0,0,2,0,2
71617,160,18635,23524;26184;27201,52925,0,1,2,0,3
71618,160,18636,24159;26791,52925,0,0,2,0,2
71619,160,18637,23451;23691;26772;27470,52925,0,1,3,0,4
71620,160,18639,23466;23852;26782;27220;27576;27837,52925,0,3,3,0,6
71621,160,18641,24271;24348;27596,52925,0,1,2,0,3
71622,160,18642,23823;24028;26402;26885;27312;27582,52925,0,3,3,0,6
71623,160,18643,24054;24665;27438;27785,52925,0,2,2,0,4
71624,160,18644,24083;24391;26799;27249;27424;27602,52925,0,3,3,0,6
71625,160,18645,23641;24098;26890,52925,0,1,2,0,3
71626,160,18647,24161;24666;26919;27622,52925,0,2,2,0,4
71627,160,18648,23756;24176;27486,52925,0,1,2,0,3
71628,160,18649,24169;24230;27151,52925,0,1,2,0,3
71629,160,18650,24027;24390;26704,52925,0,0,3,0,3
71630,160,18651,24143;24965;27447;27537,52925,0,2,2,0,4
71631,160,18652,24429;24598,52925,0,0,2,0,2
71632,160,18653,24704;26997;27523,52925,0,2,1,0,3
71633,160,18655,24852;25159;27803,52925,0,1,2,0,3
71634,160,18656,24682;25226;27546;28001;28355,52925,2,1,2,0,5
71635,160,18657,24515;25018,52925,0,0,2,0,2
71636,160,18659,24206;24525;27965,52925,1,0,2,0,3
71637,160,18660,24533;27510;27611;28237,52925,1,2,1,0,4
71638,160,18661,24254;24565,52925,0,0,2,0,2
71639,160,18662,24317;24566;27616;28058,52925,1,1,2,0,4
71640,160,18663,24275;24576;27865;28238,52925,1,1,2,0,4
71641,160,18664,24605,52925,0,0,1,0,1
71642,160,18665,24611;24709;28155,52925,1,0,2,0,3
71643,160,18666,24629;27086;27700,52925,0,2,1,0,3
71644,160,18667,24817;27529;27632;28248,52925,1,2,1,0,4
71645,160,18668,24636;24715,52925,0,0,2,0,2
71646,160,18669,24669;27977,52925,1,0,1,0,2
71647,160,18671,24336;24700;27874,52925,0,1,2,0,3
71648,160,18672,24739,52925,0,0,1,0,1
71649,160,18673,24763,52925,0,0,1,0,1
71650,160,18674,24713;26805;27525,52925,0,1,2,0,3
71651,160,18675,24890;27444;27633;27799;27890,52925,0,4,1,0,5
71652,160,18676,24819;25112;28353,52925,1,0,2,0,3
71653,160,18677,24827,52925,0,0,1,0,1
71654,160,18678,24828;25013,52925,0,0,2,0,2
71655,160,18679,25146;25413,52925,0,0,2,0,2
71656,160,18680,24866;24929,52925,0,0,2,0,2
71657,160,18681,24851;24897;27882,52925,0,1,2,0,3
71658,160,18682,24900;25289;28194,52925,1,0,2,0,3
71659,160,18683,24915;25427;27555,52925,0,1,2,0,3
71660,160,18684,25264;28192,52925,1,0,1,0,2
71661,160,18685,24951;25409;28200;28272,52925,2,0,2,0,4
71662,160,18686,24954;25137;27635;28258,52925,1,1,2,0,4
71663,160,18687,24556;24959;28080,52925,1,0,2,0,3
71664,160,18688,24976;27358,52925,0,1,1,0,2
71665,160,18689,24987;25278;27178,52925,0,1,2,0,3
71666,160,18690,25229,52925,0,0,1,0,1
71667,160,18691,24981;25070;27175;27802,52925,0,2,2,0,4
71668,160,18693,25082;25304;28196;28360,52925,2,0,2,0,4
71669,160,18694,25415,52925,0,0,1,0,1
71670,160,18695,19976,53290,0,0,0,1,1
71671,160,18696,20328,53290,0,0,0,1,1
71672,160,18700,20619,53290,0,0,0,1,1
71673,160,18701,20989,53290,0,0,0,1,1
71674,160,18702,21071,53290,0,0,0,1,1
71675,160,18703,20879,53290,0,0,0,1,1
71676,160,18704,21007;21412,53290,0,0,0,2,2
71677,160,18706,21568,53290,0,0,0,1,1
71678,160,18708,21586;21705,53290,0,0,0,2,2
71679,160,18710,21118,53290,0,0,0,1,1
71680,160,18712,21734;21997,53290,0,0,1,1,2
71681,160,18718,21884,53290,0,0,1,0,1
71682,160,18721,23319,53290,0,0,1,0,1
71683,160,18727,23165;26164,53290,0,0,2,0,2
71684,160,18733,23636;23696;27385,53290,0,1,2,0,3
71685,160,18734,23445,53290,0,0,1,0,1
71686,160,18735,23865;27043,53290,0,1,1,0,2
71687,160,18738,23664;23783,53290,0,0,2,0,2
71688,160,18741,23749;23993;27572,53290,0,1,2,0,3
71689,160,18742,23869;23926;27223;27665;27842,53290,0,3,2,0,5
71690,160,18743,23781;24164;27236;27848,53290,0,2,2,0,4
71691,160,18745,24034;24109;27231,53290,0,1,2,0,3
71692,160,18746,24055;24337;27157,53290,0,1,2,0,3
71693,160,18747,24304;26497;27766,53290,0,1,2,0,3
71694,160,18748,24170;24182;27589,53290,0,1,2,0,3
71695,160,18749,24193;24849;26809;27443;27533;28251,53290,1,2,3,0,6
71696,160,18750,23989;24238;27489;27594,53290,0,2,2,0,4
71697,160,18751,24300;24531;28149,53290,1,0,2,0,3
71698,160,18752,24156;24226,53290,0,0,2,0,2
71699,160,18755,24823,53290,0,0,1,0,1
71700,160,18756,24457;24496;27504,53290,0,1,2,0,3
71701,160,18757,24462;24735;26921;27439,53290,0,2,2,0,4
71702,160,18759,24536;24616;26502;27342;27692,53290,0,2,3,0,5
71703,160,18760,24359;24561;27614;28325,53290,1,1,2,0,4
71704,160,18761,24780,53290,0,0,1,0,1
71705,160,18762,24577;24600;26916;27165;27515;27969,53290,1,3,2,0,6
71706,160,18763,24635;24982;26926,53290,0,1,2,0,3
71707,160,18764,24676;24796;26998;28064,53290,1,1,2,0,4
71708,160,18765,24345;24683;26920;27262;27978,53290,1,2,2,0,5
71709,160,18766,24257;24697,53290,0,0,2,0,2
71710,160,18767,24725;25365,53290,0,0,2,0,2
71711,160,18768,24733,53290,0,0,1,0,1
71712,160,18769,24338;24804;27795;28065,53290,1,1,2,0,4
71713,160,18770,24749;25183;28092,53290,1,0,2,0,3
71714,160,18772,24800;27986,53290,1,0,1,0,2
71715,160,18774,24818;24903;26999;27348,53290,0,2,2,0,4
71716,160,18775,24832,53290,0,0,1,0,1
71717,160,18776,25038;27638;28084;28348,53290,2,1,1,0,4
71718,160,18777,24837;25310,53290,0,0,2,0,2
71719,160,18778,24815;24847;28250,53290,1,0,2,0,3
71720,160,18779,25063;27271;27540,53290,0,2,1,0,3
71721,160,18780,24677;25319;27729,53290,0,1,2,0,3
71722,160,18781,24928;27356;27893,53290,0,2,1,0,3
71723,160,18782,24935;25124;27644,53290,0,1,2,0,3
71724,160,18783,24946;27895;28257,53290,1,1,1,0,3
71725,160,18785,24689;24971;27713;27897;28081,53290,1,2,2,0,5
71726,160,18786,25209;28263,53290,1,0,1,0,2
71727,160,18787,24991;25060;27639,53290,0,1,2,0,3
71728,160,18788,24997;25001;27539,53290,0,1,2,0,3
71729,160,18789,24825;25020;28083;28347,53290,2,0,2,0,4
71730,160,18790,24842;25090;27907;27995,53290,1,1,2,0,4
71731,160,18791,25347;25533,53290,0,0,2,0,2
71732,160,18792,24802;25109,53290,0,0,2,0,2
71733,160,18793,25114;25527;28374,53290,1,0,2,0,3
71734,160,18794,25160;25303;28359,53290,1,0,2,0,3
71735,160,18795,25128,53290,0,0,1,0,1
71736,160,18796,25120;25130,53290,0,0,2,0,2
71737,160,18797,25134;25454;27459;27557;28274,53290,1,2,2,0,5
71738,160,18798,25145;25512;28110,53290,1,0,2,0,3
71739,160,18799,25037;25519;27653;27924;28111,53290,1,2,2,0,5
71740,160,18800,25180;27722;28091,53290,1,1,1,0,3
71741,160,18801,20616,53655,0,0,0,1,1
71742,160,18804,21031,53655,0,0,0,1,1
71743,160,18806,20192,53655,0,0,0,1,1
71744,160,18809,21435,53655,0,0,0,1,1
71745,160,18810,21528,53655,0,0,0,1,1
71746,160,18816,21832,53655,0,0,1,0,1
71747,160,18817,21662;21679,53655,0,0,0,2,2
71748,160,18818,21765,53655,0,0,0,1,1
71749,160,18825,22625,53655,0,0,1,0,1
71750,160,18827,22508;22699,53655,0,0,2,0,2
71751,160,18830,22997;23279;26457,53655,0,0,3,0,3
71752,160,18834,23595;23714,53655,0,0,2,0,2
71753,160,18837,23738,53655,0,0,1,0,1
71754,160,18838,23764;24619,53655,0,0,2,0,2
71755,160,18839,24194;27326;27951,53655,1,1,1,0,3
71756,160,18840,23946;23955;27479,53655,0,1,2,0,3
71757,160,18842,24371;24422;27247,53655,0,1,2,0,3
71758,160,18844,24484;27258;27431;28053,53655,1,2,1,0,4
71759,160,18845,24106;24179,53655,0,0,2,0,2
71760,160,18846,24134;24623;26918;27085;27167;27783;27976,53655,1,4,2,0,7
71761,160,18847,24712;25067;27453;27640;28086,53655,1,2,2,0,5
71762,160,18848,24210;26298;28322,53655,1,0,2,0,3
71763,160,18849,24245;24357;26207;27682,53655,0,1,3,0,4
71764,160,18850,24247;24284;26899;26989;27954,53655,1,2,2,0,5
71765,160,18851,24626;24955,53655,0,0,2,0,2
71766,160,18852,24121;24678;27261;27623,53655,0,2,2,0,4
71767,160,18854,24383;24405,53655,0,0,2,0,2
71768,160,18855,24110;24219;26600;26896;27677,53655,0,2,3,0,5
71769,160,18856,24183;24427;27429,53655,0,1,2,0,3
71770,160,18857,24920;28254,53655,1,0,1,0,2
71771,160,18859,24567;28059,53655,1,0,1,0,2
71772,160,18860,24601;27780,53655,0,1,1,0,2
71773,160,18861,24607,53655,0,0,1,0,1
71774,160,18862,24376;24588;27779;27866;28239,53655,1,2,2,0,5
71775,160,18863,24654;25265;27645;28003,53655,1,1,2,0,4
71776,160,18864,24942;27445,53655,0,1,1,0,2
71777,160,18865,24707;24824;27524,53655,0,1,2,0,3
71778,160,18866,24613;24720,53655,0,0,2,0,2
71779,160,18867,24396;24732,53655,0,0,2,0,2
71780,160,18869,24764;25025,53655,0,0,2,0,2
71781,160,18870,25106,53655,0,0,1,0,1
71782,160,18871,24403;24841;28068;28166,53655,2,0,2,0,4
71783,160,18872,24294,53655,0,0,1,0,1
71784,160,18873,25327,53655,0,0,1,0,1
71785,160,18874,24896;24975;28173,53655,1,0,2,0,3
71786,160,18875,24910;25117,53655,0,0,2,0,2
71787,160,18876,25102;27101;27273;27455;28179,53655,1,3,1,0,5
71788,160,18877,24974;25620,53655,0,0,2,0,2
71789,160,18878,24641;25051;27718;27904,53655,0,2,2,0,4
71790,160,18879,25384;25756;27922;28271;28368,53655,2,1,2,0,5
71791,160,18880,24880;25057;27888;28169,53655,1,1,2,0,4
71792,160,18881,24999;25073;27359;28082,53655,1,1,2,0,4
71793,160,18882,25087;25258;27272;27365;27994,53655,1,2,2,0,5
71794,160,18883,24782;25428;28273,53655,1,0,2,0,3
71795,160,18884,25115,53655,0,0,1,0,1
71796,160,18885,24948;25316;27179;27552;27728;27808,53655,0,4,2,0,6
71797,160,18886,25175;25270;27275,53655,0,1,2,0,3
71798,160,18887,25184;25621,53655,0,0,2,0,2
71799,160,18888,25044;25186;27544;28093,53655,1,1,2,0,4
71800,160,18889,25043;25194;28185,53655,1,0,2,0,3
71801,160,18890,25126;25530,53655,0,0,2,0,2
71802,160,18891,25225;25560;28282,53655,1,0,2,0,3
71803,160,18892,25417;25589,53655,0,0,2,0,2
71804,160,18893,25543,53655,0,0,1,0,1
71805,160,18894,25285;25582,53655,0,0,2,0,2
71806,160,18895,24653;25295;27551;27726,53655,0,2,2,0,4
71807,160,18896,25306;27727;28361,53655,1,1,1,0,3
71808,160,18897,25308;25631;28118,53655,1,0,2,0,3
71809,160,18898,25568;28209,53655,1,0,1,0,2
71810,160,18899,20076,54020,0,0,0,1,1
71811,160,18900,20819,54020,0,0,0,1,1
71812,160,18901,21167,54020,0,0,0,1,1
71813,160,18904,21276;21383,54020,0,0,0,2,2
71814,160,18907,21838,54020,0,0,1,0,1
71815,160,18909,21419;21649,54020,0,0,0,2,2
71816,160,18910,21813,54020,0,0,1,0,1
71817,160,18912,21850,54020,0,0,1,0,1
71818,160,18915,22353,54020,0,0,1,0,1
71819,160,18918,22690;22814,54020,0,0,2,0,2
71820,160,18921,22858;22914,54020,0,0,2,0,2
71821,160,18922,22797,54020,0,0,1,0,1
71822,160,18923,23022,54020,0,0,1,0,1
71823,160,18927,24154;24291;26985,54020,0,1,2,0,3
71824,160,18930,23987;24208;27676;27852;27953,54020,1,2,2,0,5
71825,160,18932,23633;23768,54020,0,0,2,0,2
71826,160,18933,24032;24287,54020,0,0,2,0,2
71827,160,18935,24145;24331;28046,54020,1,0,2,0,3
71828,160,18937,24037;24196;26203;27414,54020,0,1,3,0,4
71829,160,18938,24014;24205;27851,54020,0,1,2,0,3
71830,160,18939,24068;24330;28234,54020,1,0,2,0,3
71831,160,18940,24618;26710;27699;27975,54020,1,1,2,0,4
71832,160,18941,24236;24240;26204;26898;27329;27418,54020,0,3,3,0,6
71833,160,18943,24049;24286;26496;27331;27420,54020,0,2,3,0,5
71834,160,18944,23773;24146;27234;27950,54020,1,1,2,0,4
71835,160,18946,24406;28049,54020,1,0,1,0,2
71836,160,18947,24685;27521;27625;27873,54020,0,3,1,0,4
71837,160,18948,24423;24751;27706;27877;28333,54020,1,2,2,0,5
71838,160,18949,23857;24455;27257,54020,0,1,2,0,3
71839,160,18950,24468;24914;27095;27355;27711,54020,0,3,2,0,5
71840,160,18951,24486;24984;27538;27636;27714;28175,54020,1,3,2,0,6
71841,160,18953,24553;24614;27967;28150,54020,2,0,2,0,4
71842,160,18954,24670;24979;28174,54020,1,0,2,0,3
71843,160,18955,24671;26609;27344;28330,54020,1,1,2,0,4
71844,160,18956,24691;24875,54020,0,0,2,0,2
71845,160,18957,25008;27361;27448;27901,54020,0,3,1,0,4
71846,160,18958,24617;24772;27091;28335,54020,1,1,2,0,4
71847,160,18959,24439;24705;28242,54020,1,0,2,0,3
71848,160,18960,24500;24781;28246,54020,1,0,2,0,3
71849,160,18961,24582;24797,54020,0,0,2,0,2
71850,160,18962,24808;24833;27708,54020,0,1,2,0,3
71851,160,18963,24599;25139;27543;27721,54020,0,2,2,0,4
71852,160,18964,24887;25236;28002;28265,54020,2,0,2,0,4
71853,160,18965,24672;24947;27000,54020,0,1,2,0,3
71854,160,18966,24977;25010;27449;28346,54020,1,1,2,0,4
71855,160,18967,24816;25155;28181,54020,1,0,2,0,3
71856,160,18968,25021;25372;28367,54020,1,0,2,0,3
71857,160,18969,25034;25612;28285,54020,1,0,2,0,3
71858,160,18970,24912;25059;27451,54020,0,1,2,0,3
71859,160,18971,25009;25062;28260,54020,1,0,2,0,3
71860,160,18972,25080;27364;28178,54020,1,1,1,0,3
71861,160,18973,25104;25190;28184;28354,54020,2,0,2,0,4
71862,160,18974,25142,54020,0,0,1,0,1
71863,160,18975,25149;25521;28112;28205,54020,2,0,2,0,4
71864,160,18976,25168;25188;27911,54020,0,1,2,0,3
71865,160,18977,25177;25185;27804;27999;28090;28182,54020,3,1,2,0,6
71866,160,18978,24872;25191;27093;27266;27535;27885;28074,54020,1,4,2,0,7
71867,160,18979,25198,54020,0,0,1,0,1
71868,160,18980,24911;25203;27913,54020,0,1,2,0,3
71869,160,18981,25713;25726;28215,54020,1,0,2,0,3
71870,160,18982,25210;25246;28189,54020,1,0,2,0,3
71871,160,18983,25171;25242;27549;28095;28356,54020,2,1,2,0,5
71872,160,18984,25056;25275,54020,0,0,2,0,2
71873,160,18986,25311;25426,54020,0,0,2,0,2
71874,160,18987,25321;25522,54020,0,0,2,0,2
71875,160,18988,25322,54020,0,0,1,0,1
71876,160,18989,25324;25445,54020,0,0,2,0,2
71877,160,18990,25325;25515,54020,0,0,2,0,2
71878,160,18991,25326;25487;27462;27558,54020,0,2,2,0,4
71879,160,18992,25329;25555,54020,0,0,2,0,2
71880,160,18993,25048;25330;28100;28198,54020,2,0,2,0,4
71881,160,18994,25207;25336;27812,54020,0,1,2,0,3
71882,160,18995,25234;25338;26928,54020,0,1,2,0,3
71883,160,18996,25356,54020,0,0,1,0,1
71884,160,18997,25360;25459;28199,54020,1,0,2,0,3
71885,160,18998,25220;25382,54020,0,0,2,0,2
71886,160,18999,25221;25390;27458;28010,54020,1,1,2,0,4
71887,160,19000,25423;25670,54020,0,0,2,0,2
71888,160,19001,25400;25436;28369,54020,1,0,2,0,3
71889,160,19002,21144,54385,0,0,0,1,1
71890,160,19003,21078,54385,0,0,0,1,1
71891,160,19005,21645,54385,0,0,0,1,1
71892,160,19006,21672,54385,0,0,0,1,1
71893,160,19007,21819,54385,0,0,1,0,1
71894,160,19008,21955,54385,0,0,1,0,1
71895,160,19009,22221;22675,54385,0,0,2,0,2
71896,160,19019,23043,54385,0,0,1,0,1
71897,160,19026,23291;23637,54385,0,0,2,0,2
71898,160,19027,23717,54385,0,0,1,0,1
71899,160,19029,23767,54385,0,0,1,0,1
71900,160,19030,23918,54385,0,0,1,0,1
71901,160,19031,23966;24351;26303;27600,54385,0,1,3,0,4
71902,160,19036,24622;28329,54385,1,0,1,0,2
71903,160,19037,24753;26806;27878,54385,0,1,2,0,3
71904,160,19039,24283,54385,0,0,1,0,1
71905,160,19041,24352;24365;27601;28047,54385,1,1,2,0,4
71906,160,19043,24437;24608;27518;27620;27781;28154;28328,54385,2,3,2,0,7
71907,160,19044,24444;24518;27605,54385,0,1,2,0,3
71908,160,19045,24563;24633,54385,0,0,2,0,2
71909,160,19046,24637,54385,0,0,1,0,1
71910,160,19047,24490;24589,54385,0,0,2,0,2
71911,160,19051,24223,54385,0,0,1,0,1
71912,160,19052,24714;25205;27177;27545,54385,0,2,2,0,4
71913,160,19053,24777;25164;27441,54385,0,1,2,0,3
71914,160,19054,24786;24888,54385,0,0,2,0,2
71915,160,19055,24787;24926;27268;27712;27892;28255,54385,1,3,2,0,6
71916,160,19056,25353;27277;27553;28365,54385,1,2,1,0,4
71917,160,19057,24826;24895;27172,54385,0,1,2,0,3
71918,160,19058,24835;24860;26924;27883;28253,54385,1,2,2,0,5
71919,160,19060,24868;25040;27362;27903,54385,0,2,2,0,4
71920,160,19061,24658;24885;27267,54385,0,1,2,0,3
71921,160,19062,24472;24919;27096;28170,54385,1,1,2,0,4
71922,160,19063,24945;25457;28106,54385,1,0,2,0,3
71923,160,19064,24963;25212,54385,0,0,2,0,2
71924,160,19065,24973;25230;27914,54385,0,1,2,0,3
71925,160,19066,24983;25163,54385,0,0,2,0,2
71926,160,19067,25328;25378;27276;27810,54385,0,2,2,0,4
71927,160,19068,25041;25484,54385,0,0,2,0,2
71928,160,19069,25049;25249;28266,54385,1,0,2,0,3
71929,160,19070,24738;25131;27720;27908;28089,54385,1,2,2,0,5
71930,160,19071,25151;25606;27182,54385,0,1,2,0,3
71931,160,19072,25156;25170,54385,0,0,2,0,2
71932,160,19073,25028;25167,54385,0,0,2,0,2
71933,160,19074,25200;25215,54385,0,0,2,0,2
71934,160,19075,25022;25411;27279;28201,54385,1,1,2,0,4
71935,160,19076,25237;25532;28113;28279,54385,2,0,2,0,4
71936,160,19077,25239;25538;27372;28281,54385,1,1,2,0,4
71937,160,19078,25250;27806;28190;28357,54385,2,1,1,0,4
71938,160,19079,25254;25499;27807;28096,54385,1,1,2,0,4
71939,160,19080,25283;25575;26521;27559;28283,54385,1,1,3,0,5
71940,160,19081,24909;25292;27550;28195,54385,1,1,2,0,4
71941,160,19082,25296,54385,0,0,1,0,1
71942,160,19083,25796,54385,0,0,1,0,1
71943,160,19084,24660;25299;28099,54385,1,0,2,0,3
71944,160,19085,25108;25350;27813,54385,0,1,2,0,3
71945,160,19086,24967;25377,54385,0,0,2,0,2
71946,160,19088,25374;25704,54385,0,0,2,0,2
71947,160,19089,25443;25494;27819,54385,0,1,2,0,3
71948,160,19090,25448;25655,54385,0,0,2,0,2
71949,160,19091,25449;25649,54385,0,0,2,0,2
71950,160,19092,25467;25500;27734,54385,0,1,2,0,3
71951,160,19093,25483,54385,0,0,1,0,1
71952,160,19095,25498;25714,54385,0,0,2,0,2
71953,160,19096,21281;21958,54750,0,0,1,1,2
71954,160,19097,21446;21903,54750,0,0,1,1,2
71955,160,19099,21691,54750,0,0,0,1,1
71956,160,19101,21822,54750,0,0,1,0,1
71957,160,19105,22272,54750,0,0,1,0,1
71958,160,19106,22404;22718,54750,0,0,2,0,2
71959,160,19112,23130,54750,0,0,1,0,1
71960,160,19114,23096;23521;25992;26764;26858,54750,0,1,4,0,5
71961,160,19116,23118,54750,0,0,1,0,1
71962,160,19118,23337;23555;27121,54750,0,1,2,0,3
71963,160,19120,23618;23780;26586;27942,54750,1,0,3,0,4
71964,160,19122,23739,54750,0,0,1,0,1
71965,160,19124,24089;24112,54750,0,0,2,0,2
71966,160,19126,24303,54750,0,0,1,0,1
71967,160,19127,24221;24648,54750,0,0,2,0,2
71968,160,19128,24059;24341;26905;27495,54750,0,2,2,0,4
71969,160,19129,24465;24471,54750,0,0,2,0,2
71970,160,19130,24473;24546,54750,0,0,2,0,2
71971,160,19131,24353;25019;27097;27993,54750,1,1,2,0,4
71972,160,19133,24698;25000,54750,0,0,2,0,2
71973,160,19134,24488;24994;27715;27992,54750,1,1,2,0,4
71974,160,19135,24719,54750,0,0,1,0,1
71975,160,19136,24762;25113;27643,54750,0,1,2,0,3
71976,160,19137,24767;24858;27797,54750,0,1,2,0,3
71977,160,19138,24773;24941;27794,54750,0,1,2,0,3
71978,160,19139,24801;24813;26715;27630;27879;28164,54750,1,2,3,0,6
71979,160,19140,24729;24846;26808,54750,0,0,3,0,3
71980,160,19141,24727;24902;26810;27353;28076,54750,1,1,3,0,5
71981,160,19142,24922;25116,54750,0,0,2,0,2
71982,160,19144,24898;24953;27891,54750,0,1,2,0,3
71983,160,19145,25421;25471;28012;28107,54750,2,0,2,0,4
71984,160,19147,24980;25485;28276,54750,1,0,2,0,3
71985,160,19148,24989;25086;27099,54750,0,1,2,0,3
71986,160,19149,25026;25029,54750,0,0,2,0,2
71987,160,19150,24792;25046;27346;28063,54750,1,1,2,0,4
71988,160,19151,25081;25607;28212,54750,1,0,2,0,3
71989,160,19152,25095;25633,54750,0,0,2,0,2
71990,160,19153,25099,54750,0,0,1,0,1
71991,160,19154,25348;27457,54750,0,1,1,0,2
71992,160,19155,25152;25153;27102,54750,0,1,2,0,3
71993,160,19156,24995;25583,54750,0,0,2,0,2
71994,160,19157,25165;25641;27375,54750,0,1,2,0,3
71995,160,19158,25176;27103,54750,0,1,1,0,2
71996,160,19159,25011;25331;27811,54750,0,1,2,0,3
71997,160,19160,25245;25822;27827;28292,54750,1,1,2,0,4
71998,160,19161,25751;26010;27736,54750,0,1,2,0,3
71999,160,19162,25098;25284;27646;27917,54750,0,2,2,0,4
72000,160,19163,25305;25468,54750,0,0,2,0,2
72001,160,19164,25302;25320;28007,54750,1,0,2,0,3
72002,160,19165,25375;25818;28126,54750,1,0,2,0,3
72003,160,19166,25425;25802;28022;28124,54750,2,0,2,0,4
72004,160,19167,25339;25446;27817,54750,0,1,2,0,3
72005,160,19168,25452;25567;28379,54750,1,0,2,0,3
72006,160,19169,25481;25788,54750,0,0,2,0,2
72007,160,19170,25490;25493;28014,54750,1,0,2,0,3
72008,160,19171,25666;25752;27931;28291,54750,1,1,2,0,4
72009,160,19172,25517;25787,54750,0,0,2,0,2
72010,160,19173,25525;25883,54750,0,0,2,0,2
72011,160,19174,25534;25745;28122,54750,1,0,2,0,3
72012,160,19175,25547;25603;28115,54750,1,0,2,0,3
72013,160,19176,25541;25557;28015;28206;28375,54750,3,0,2,0,5
72014,160,19177,25504;25559;28207,54750,1,0,2,0,3
72015,160,19178,25591;28382,54750,1,0,1,0,2
72016,160,19179,25503;25601;28116;28211,54750,2,0,2,0,4
72017,160,19180,25613;25897;28296,54750,1,0,2,0,3
72018,160,19181,21273;21547,55115,0,0,0,2,2
72019,160,19183,21139,55115,0,0,0,1,1
72020,160,19185,21434,55115,0,0,0,1,1
72021,160,19186,20990,55115,0,0,0,1,1
72022,160,19188,21400,55115,0,0,0,1,1
72023,160,19189,21667,55115,0,0,0,1,1
72024,160,19190,21747,55115,0,0,0,1,1
72025,160,19191,21758,55115,0,0,0,1,1
72026,160,19192,21318;21485,55115,0,0,0,2,2
72027,160,19193,21395,55115,0,0,0,1,1
72028,160,19194,21710;21879,55115,0,0,1,1,2
72029,160,19195,22088;22657,55115,0,0,2,0,2
72030,160,19196,22122;22465,55115,0,0,2,0,2
72031,160,19197,22123;22401,55115,0,0,2,0,2
72032,160,19201,22812;23008;25889;26066,55115,0,0,4,0,4
72033,160,19205,22784,55115,0,0,1,0,1
72034,160,19206,23070;23305,55115,0,0,2,0,2
72035,160,19209,23192;23390,55115,0,0,2,0,2
72036,160,19210,23398;23548;27570,55115,0,1,2,0,3
72037,160,19213,23813,55115,0,0,1,0,1
72038,160,19215,23217,55115,0,0,1,0,1
72039,160,19216,23405;23757;26970;27662;28036,55115,1,2,2,0,5
72040,160,19217,23257,55115,0,0,1,0,1
72041,160,19219,23844;24253,55115,0,0,2,0,2
72042,160,19220,23951;24280;26796;26900;27330;28045,55115,1,2,3,0,6
72043,160,19221,24019;24123;27948,55115,1,0,2,0,3
72044,160,19223,24132;24843;27265;27532,55115,0,2,2,0,4
72045,160,19226,24325;24494;26605;27508;27608,55115,0,2,3,0,5
72046,160,19227,24108;24394;26800;27251,55115,0,1,3,0,4
72047,160,19228,24340;24590;27856,55115,0,1,2,0,3
72048,160,19230,24260;24438;26801;27075;27771,55115,0,2,3,0,5
72049,160,19233,24615;24998,55115,0,0,2,0,2
72050,160,19234,24865;26716,55115,0,0,2,0,2
72051,160,19235,24659;25036;27902,55115,0,1,2,0,3
72052,160,19236,24687;25085;26996;28331,55115,1,1,2,0,4
72053,160,19237,24547;26709;27513,55115,0,1,2,0,3
72054,160,19238,24873;25158;27094;27798,55115,0,2,2,0,4
72055,160,19239,24931;25232,55115,0,0,2,0,2
72056,160,19240,25042;25072;27454;27542;28087,55115,1,2,2,0,5
72057,160,19241,25030;25078;27906;28088,55115,1,1,2,0,4
72058,160,19242,25035;25162,55115,0,0,2,0,2
72059,160,19243,25394,55115,0,0,1,0,1
72060,160,19244,25208;25773,55115,0,0,2,0,2
72061,160,19245,25233;25529,55115,0,0,2,0,2
72062,160,19246,25513,55115,0,0,1,0,1
72063,160,19247,24932;25065;28350,55115,1,0,2,0,3
72064,160,19248,25172;25286;27918,55115,0,1,2,0,3
72065,160,19249,25293;25355;28009,55115,1,0,2,0,3
72066,160,19250,25178;25712,55115,0,0,2,0,2
72067,160,19251,25332;25478;27731;27921,55115,0,2,2,0,4
72068,160,19252,25125;25349,55115,0,0,2,0,2
72069,160,19253,25379;25640;27374,55115,0,1,2,0,3
72070,160,19254,25389;25748,55115,0,0,2,0,2
72071,160,19255,25391;25727;28020;28392,55115,2,0,2,0,4
72072,160,19256,25815;25831,55115,0,0,2,0,2
72073,160,19257,25399;25511;28109,55115,1,0,2,0,3
72074,160,19258,25407;25799,55115,0,0,2,0,2
72075,160,19259,25129;25422;27367,55115,0,1,2,0,3
72076,160,19260,25439;25718;28391,55115,1,0,2,0,3
72077,160,19261,25166;25444;27816;28372,55115,1,1,2,0,4
72078,160,19262,25450;25757;27181,55115,0,1,2,0,3
72079,160,19263,25455;25825;28128,55115,1,0,2,0,3
72080,160,19264,25312;25464,55115,0,0,2,0,2
72081,160,19265,25904,55115,0,0,1,0,1
72082,160,19266,25469;25537;28280,55115,1,0,2,0,3
72083,160,19267,25480;25531;27652,55115,0,1,2,0,3
72084,160,19268,25497;25930;28400,55115,1,0,2,0,3
72085,160,19269,25219;25501,55115,0,0,2,0,2
72086,160,19270,25505;25917;28130,55115,1,0,2,0,3
72087,160,19271,25518,55115,0,0,1,0,1
72088,160,19272,25553;25628;28377,55115,1,0,2,0,3
72089,160,19273,25340;25565;27927;28208,55115,1,1,2,0,4
72090,160,19274,25314,55115,0,0,1,0,1
72091,160,19275,25097;25571;28380,55115,1,0,2,0,3
72092,160,19276,25614;25890,55115,0,0,2,0,2
72093,160,19277,25617;25626;27822;28386,55115,1,1,2,0,4
72094,160,19278,25643;25876;28295,55115,1,0,2,0,3
72095,160,19279,25671,55115,0,0,1,0,1
72096,160,19280,25701;25902;27740,55115,0,1,2,0,3
72097,160,19281,25719;25769;28120;28214,55115,2,0,2,0,4
72098,160,19282,25723;25810;28221,55115,1,0,2,0,3
72099,160,19284,25735;25886;27564,55115,0,1,2,0,3
72100,160,19285,21345,55480,0,0,0,1,1
72101,160,19286,21526,55480,0,0,0,1,1
72102,160,19287,21275;21686,55480,0,0,0,2,2
72103,160,19298,21432,55480,0,0,0,1,1
72104,160,19299,23010,55480,0,0,1,0,1
72105,160,19300,23223;23557;26960,55480,0,1,2,0,3
72106,160,19301,23244,55480,0,0,1,0,1
72107,160,19304,22998,55480,0,0,1,0,1
72108,160,19305,23477,55480,0,0,1,0,1
72109,160,19308,23335,55480,0,0,1,0,1
72110,160,19311,23672;23678;26680,55480,0,0,3,0,3
72111,160,19312,23722,55480,0,0,1,0,1
72112,160,19313,23413,55480,0,0,1,0,1
72113,160,19315,23870,55480,0,0,1,0,1
72114,160,19317,23721,55480,0,0,1,0,1
72115,160,19318,23975;24119;26097;26694;28319,55480,1,0,4,0,5
72116,160,19321,24679;27624;27786;28158,55480,1,2,1,0,4
72117,160,19322,23982;24066;26982;27144;27318,55480,0,3,2,0,5
72118,160,19323,24023,55480,0,0,1,0,1
72119,160,19325,24742;25313;27368;27920;28269,55480,1,2,2,0,5
72120,160,19326,24574,55480,0,0,1,0,1
72121,160,19327,24627;25373,55480,0,0,2,0,2
72122,160,19329,24514,55480,0,0,1,0,1
72123,160,19330,24716,55480,0,0,1,0,1
72124,160,19331,24747;24884;27352,55480,0,1,2,0,3
72125,160,19332,24766;25017;27527;27793;28245,55480,1,2,2,0,5
72126,160,19334,24939;25290;27647;27919,55480,0,2,2,0,4
72127,160,19336,25015;25161,55480,0,0,2,0,2
72128,160,19337,25031;25154,55480,0,0,2,0,2
72129,160,19338,25047;25260;28097;28191;28358,55480,3,0,2,0,5
72130,160,19340,25075,55480,0,0,1,0,1
72131,160,19341,24918;25516;28204;28278,55480,2,0,2,0,4
72132,160,19342,25091;25578,55480,0,0,2,0,2
72133,160,19343,25257;25474;27461,55480,0,1,2,0,3
72134,160,19344,25266;25301;27274,55480,0,1,2,0,3
72135,160,19345,25279;25507;27371,55480,0,1,2,0,3
72136,160,19346,25193;25323;27648;27730;27809,55480,0,3,2,0,5
72137,160,19347,25463,55480,0,0,1,0,1
72138,160,19348,25975;28226,55480,1,0,1,0,2
72139,160,19349,25381;25662,55480,0,0,2,0,2
72140,160,19350,25858;28294,55480,1,0,1,0,2
72141,160,19351,25618;28286,55480,1,0,1,0,2
72142,160,19352,25506;25684,55480,0,0,2,0,2
72143,160,19353,25508;25689;27184,55480,0,1,2,0,3
72144,160,19354,25520;25846,55480,0,0,2,0,2
72145,160,19355,25544;26037,55480,0,0,2,0,2
72146,160,19356,25466;25562,55480,0,0,2,0,2
72147,160,19357,25570;26036,55480,0,0,2,0,2
72148,160,19358,25690;25981,55480,0,0,2,0,2
72149,160,19359,25759,55480,0,0,1,0,1
72150,160,19360,25300;25741;28290,55480,1,0,2,0,3
72151,160,19361,25697;25755;28218,55480,1,0,2,0,3
72152,160,19362,25758;26016;28298,55480,1,0,2,0,3
72153,160,19363,25648;25761;28021;28219,55480,2,0,2,0,4
72154,160,19364,25645;25764;27466,55480,0,1,2,0,3
72155,160,19365,25768;25962;28131,55480,1,0,2,0,3
72156,160,19366,25780;26000;27831;27934;28297;28402,55480,2,2,2,0,6
72157,160,19367,25734;25793,55480,0,0,2,0,2
72158,160,19368,25795,55480,0,0,1,0,1
72159,160,19369,21546,55845,0,0,0,1,1
72160,160,19370,21601,55845,0,0,0,1,1
72161,160,19372,21349,55845,0,0,0,1,1
72162,160,19374,21719,55845,0,0,0,1,1
72163,160,19375,21886,55845,0,0,1,0,1
72164,160,19377,21637,55845,0,0,0,1,1
72165,160,19379,22541;22702;25786;26429,55845,0,0,4,0,4
72166,160,19381,22607,55845,0,0,1,0,1
72167,160,19383,22128,55845,0,0,1,0,1
72168,160,19386,22836,55845,0,0,1,0,1
72169,160,19388,23086;23440,55845,0,0,2,0,2
72170,160,19389,23446,55845,0,0,1,0,1
72171,160,19390,23467;23720,55845,0,0,2,0,2
72172,160,19392,23792,55845,0,0,1,0,1
72173,160,19393,23152,55845,0,0,1,0,1
72174,160,19394,24046;24419;27687,55845,0,1,2,0,3
72175,160,19396,23980;24128,55845,0,0,2,0,2
72176,160,19397,24233;24529,55845,0,0,2,0,2
72177,160,19398,24323;24417;27427;27500;27686,55845,0,3,2,0,5
72178,160,19401,24461;25066;27098;27905;28177,55845,1,2,2,0,5
72179,160,19402,24480,55845,0,0,1,0,1
72180,160,19403,24483;24904;28077,55845,1,0,2,0,3
72181,160,19405,24634;25540;28114,55845,1,0,2,0,3
72182,160,19407,24418,55845,0,0,1,0,1
72183,160,19408,24768,55845,0,0,1,0,1
72184,160,19409,24791;24958;28344,55845,1,0,2,0,3
72185,160,19410,24776;28161,55845,1,0,1,0,2
72186,160,19411,24894;25453;28203;28373,55845,2,0,2,0,4
72187,160,19412,25033;25189,55845,0,0,2,0,2
72188,160,19413,24754;25054,55845,0,0,2,0,2
72189,160,19414,25089;25514,55845,0,0,2,0,2
72190,160,19416,25136,55845,0,0,1,0,1
72191,160,19417,24836,55845,0,0,1,0,1
72192,160,19418,25392;25717,55845,0,0,2,0,2
72193,160,19419,25412;25675,55845,0,0,2,0,2
72194,160,19420,25309;26005,55845,0,0,2,0,2
72195,160,19421,24814;24930;28171;28343,55845,2,0,2,0,4
72196,160,19422,24972;25335;28363,55845,1,0,2,0,3
72197,160,19423,25141;25608,55845,0,0,2,0,2
72198,160,19424,25376;25672,55845,0,0,2,0,2
72199,160,19425,25430;25440;27556;27651;27815;28371,55845,1,3,2,0,6
72200,160,19426,25405;25489;28108,55845,1,0,2,0,3
72201,160,19427,25243;25462,55845,0,0,2,0,2
72202,160,19428,25337;25495;27649,55845,0,1,2,0,3
72203,160,19429,25596;28210;28383,55845,2,0,1,0,3
72204,160,19430,25268,55845,0,0,1,0,1
72205,160,19431,25545;25665;27562;28019,55845,1,1,2,0,4
72206,160,19432,25393,55845,0,0,1,0,1
72207,160,19433,25564;26138;27832,55845,0,1,2,0,3
72208,160,19434,25573;25634;27465;28017,55845,1,1,2,0,4
72209,160,19435,25598;25920,55845,0,0,2,0,2
72210,160,19436,25609;25813;27735,55845,0,1,2,0,3
72211,160,19437,25778,55845,0,0,1,0,1
72212,160,19438,25652;25762,55845,0,0,2,0,2
72213,160,19439,25473;25663;27825,55845,0,1,2,0,3
72214,160,19440,25103;25680,55845,0,0,2,0,2
72215,160,19441,25585;25708;28119,55845,1,0,2,0,3
72216,160,19442,25740;26046,55845,0,0,2,0,2
72217,160,19443,25706;25746,55845,0,0,2,0,2
72218,160,19444,25777;26098;28406,55845,1,0,2,0,3
72219,160,19445,25420;25783;27654;28220,55845,1,1,2,0,4
72220,160,19446,25794;25833,55845,0,0,2,0,2
72221,160,19447,25826,55845,0,0,1,0,1
72222,160,19448,25729;25847;28121;28216,55845,2,0,2,0,4
72223,160,19449,25853;25882;27739,55845,0,1,2,0,3
72224,160,19450,25859;26021,55845,0,0,2,0,2
72225,160,19451,25894;26122,55845,0,0,2,0,2
72226,160,19452,25910;25958;27743,55845,0,1,2,0,3
72227,160,19453,26113,55845,0,0,1,0,1
72228,160,19454,21587,56210,0,0,0,1,1
72229,160,19456,21770;22040,56210,0,0,1,1,2
72230,160,19457,21609,56210,0,0,0,1,1
72231,160,19458,21984,56210,0,0,1,0,1
72232,160,19459,21992,56210,0,0,1,0,1
72233,160,19460,22006,56210,0,0,1,0,1
72234,160,19463,22151,56210,0,0,1,0,1
72235,160,19464,22167,56210,0,0,1,0,1
72236,160,19465,22213,56210,0,0,1,0,1
72237,160,19466,22313,56210,0,0,1,0,1
72238,160,19467,22327,56210,0,0,1,0,1
72239,160,19471,22463;23019,56210,0,0,2,0,2
72240,160,19472,22291,56210,0,0,1,0,1
72241,160,19474,22761,56210,0,0,1,0,1
72242,160,19476,22673,56210,0,0,1,0,1
72243,160,19480,21923;22494,56210,0,0,2,0,2
72244,160,19481,22848;23045,56210,0,0,2,0,2
72245,160,19482,23059,56210,0,0,1,0,1
72246,160,19484,22608;22860,56210,0,0,2,0,2
72247,160,19485,22865;23145,56210,0,0,2,0,2
72248,160,19486,23401,56210,0,0,1,0,1
72249,160,19489,23716,56210,0,0,1,0,1
72250,160,19490,23422,56210,0,0,1,0,1
72251,160,19491,23539,56210,0,0,1,0,1
72252,160,19492,24056,56210,0,0,1,0,1
72253,160,19494,24148;24450;28051,56210,1,0,2,0,3
72254,160,19496,24165,56210,0,0,1,0,1
72255,160,19497,24252;24269,56210,0,0,2,0,2
72256,160,19499,24487;24820;27530,56210,0,1,2,0,3
72257,160,19500,24107,56210,0,0,1,0,1
72258,160,19501,24810;25238;27548,56210,0,1,2,0,3
72259,160,19502,24892;25364,56210,0,0,2,0,2
72260,160,19503,24925;25574;27373,56210,0,1,2,0,3
72261,160,19504,24957;27446,56210,0,1,1,0,2
72262,160,19505,24985;25032;27270;27450,56210,0,2,2,0,4
72263,160,19506,25039;25683;28213;28390,56210,2,0,2,0,4
72264,160,19507,24882;25061;27452;28085;28261,56210,2,1,2,0,5
72265,160,19508,25743;25765,56210,0,0,2,0,2
72266,160,19509,24426;25093;28262,56210,1,0,2,0,3
72267,160,19510,25096,56210,0,0,1,0,1
72268,160,19511,25600;28384,56210,1,0,1,0,2
72269,160,19512,25214;25343;28186,56210,1,0,2,0,3
72270,160,19513,25241;27456;27723;28188,56210,1,2,1,0,4
72271,160,19514,25318;25907,56210,0,0,2,0,2
72272,160,19515,25012,56210,0,0,1,0,1
72273,160,19516,25366;25829;28395,56210,1,0,2,0,3
72274,160,19517,25380;25491;28277,56210,1,0,2,0,3
72275,160,19518,25576;25879,56210,0,0,2,0,2
72276,160,19519,25387;25441,56210,0,0,2,0,2
72277,160,19520,25502,56210,0,0,1,0,1
72278,160,19521,25479;25656,56210,0,0,2,0,2
72279,160,19523,25676;25678,56210,0,0,2,0,2
72280,160,19524,25679;26134,56210,0,0,2,0,2
72281,160,19525,25688;25836,56210,0,0,2,0,2
72282,160,19526,25696;25819;28127,56210,1,0,2,0,3
72283,160,19527,25566;25700,56210,0,0,2,0,2
72284,160,19528,26111,56210,0,0,1,0,1
72285,160,19529,25711;26018;28299,56210,1,0,2,0,3
72286,160,19530,25744;26023,56210,0,0,2,0,2
72287,160,19531,25749;25996,56210,0,0,2,0,2
72288,160,19532,25760;25849;28397,56210,1,0,2,0,3
72289,160,19533,25827;26050,56210,0,0,2,0,2
72290,160,19534,25685;25867,56210,0,0,2,0,2
72291,160,19535,25857;25869,56210,0,0,2,0,2
72292,160,19536,25870;25908,56210,0,0,2,0,2
72293,160,19537,25402,56210,0,0,1,0,1
72294,160,19538,25881;26182,56210,0,0,2,0,2
72295,160,19539,25805;25896,56210,0,0,2,0,2
72296,160,19540,25259;25901,56210,0,0,2,0,2
72297,160,19541,25915;26083,56210,0,0,2,0,2
72298,160,19542,25918;26027;28399,56210,1,0,2,0,3
72299,160,19543,25922;26225,56210,0,0,2,0,2
72300,160,19544,25932;26265;28136,56210,1,0,2,0,3
72301,160,19545,25935,56210,0,0,1,0,1
72302,160,19546,25952;26199;28305,56210,1,0,2,0,3
72303,160,19547,25782;25967;27933;28027,56210,1,1,2,0,4
72304,160,19548,25673;25980,56210,0,0,2,0,2
72305,160,19549,25984;26030,56210,0,0,2,0,2
72306,160,19550,25988;26273;28309,56210,1,0,2,0,3
72307,160,19551,25909;25998,56210,0,0,2,0,2
72308,160,19552,21695,56575,0,0,0,1,1
72309,160,19553,21752;22370,56575,0,0,1,1,2
72310,160,19554,21560,56575,0,0,0,1,1
72311,160,19555,21113,56575,0,0,0,1,1
72312,160,19556,21677,56575,0,0,0,1,1
72313,160,19557,21869,56575,0,0,1,0,1
72314,160,19559,21570,56575,0,0,0,1,1
72315,160,19562,22171,56575,0,0,1,0,1
72316,160,19563,22558,56575,0,0,1,0,1
72317,160,19564,22520,56575,0,0,1,0,1
72318,160,19565,22563,56575,0,0,1,0,1
72319,160,19566,22773,56575,0,0,1,0,1
72320,160,19567,22847,56575,0,0,1,0,1
72321,160,19569,23150,56575,0,0,1,0,1
72322,160,19570,23187,56575,0,0,1,0,1
72323,160,19571,23227,56575,0,0,1,0,1
72324,160,19572,22878,56575,0,0,1,0,1
72325,160,19573,23254,56575,0,0,1,0,1
72326,160,19575,23408,56575,0,0,1,0,1
72327,160,19576,23496,56575,0,0,1,0,1
72328,160,19577,23329,56575,0,0,1,0,1
72329,160,19579,23371,56575,0,0,1,0,1
72330,160,19580,23661,56575,0,0,1,0,1
72331,160,19581,23772,56575,0,0,1,0,1
72332,160,19585,24442,56575,0,0,1,0,1
72333,160,19586,24478,56575,0,0,1,0,1
72334,160,19587,24096;24495;26501,56575,0,0,3,0,3
72335,160,19589,24684,56575,0,0,1,0,1
72336,160,19590,24701;27980,56575,1,0,1,0,2
72337,160,19591,24869;25561,56575,0,0,2,0,2
72338,160,19592,24184,56575,0,0,1,0,1
72339,160,19593,24834,56575,0,0,1,0,1
72340,160,19594,24936;25646;27824,56575,0,1,2,0,3
72341,160,19595,24964;25274;28005,56575,1,0,2,0,3
72342,160,19596,24610,56575,0,0,1,0,1
72343,160,19597,24993;27899,56575,0,1,1,0,2
72344,160,19598,24876;25068;27801,56575,0,1,2,0,3
72345,160,19599,25069;25076;27641,56575,0,1,2,0,3
72346,160,19600,25079;25658,56575,0,0,2,0,2
72347,160,19601,24848,56575,0,0,1,0,1
72348,160,19602,25223;27805,56575,0,1,1,0,2
72349,160,19603,25398,56575,0,0,1,0,1
72350,160,19604,25248;25739,56575,0,0,2,0,2
72351,160,19605,25261,56575,0,0,1,0,1
72352,160,19606,25118;25363;27814,56575,0,1,2,0,3
72353,160,19607,25362;25429;27278;28101;28366,56575,2,1,2,0,5
72354,160,19608,25410;25855;28398,56575,1,0,2,0,3
72355,160,19609,25371;25438,56575,0,0,2,0,2
72356,160,19610,25460;26091;28404,56575,1,0,2,0,3
72357,160,19611,25472;25839;28129;28223,56575,2,0,2,0,4
72358,160,19612,25244,56575,0,0,1,0,1
72359,160,19613,25804;27826,56575,0,1,1,0,2
72360,160,19614,25558;25914,56575,0,0,2,0,2
72361,160,19615,25569,56575,0,0,1,0,1
72362,160,19616,25581;26163,56575,0,0,2,0,2
72363,160,19617,25699,56575,0,0,1,0,1
72364,160,19618,25616;25694;27821,56575,0,1,2,0,3
72365,160,19619,25627;26063,56575,0,0,2,0,2
72366,160,19620,25588;25629;27183;28117,56575,1,1,2,0,4
72367,160,19621,25638;26071,56575,0,0,2,0,2
72368,160,19622,25644;26082,56575,0,0,2,0,2
72369,160,19623,25550;25657;28376,56575,1,0,2,0,3
72370,160,19624,25750;25991,56575,0,0,2,0,2
72371,160,19625,25816;26047,56575,0,0,2,0,2
72372,160,19626,25817;25999;28401,56575,1,0,2,0,3
72373,160,19627,25732;25893;27830,56575,0,1,2,0,3
72374,160,19628,25956;26106,56575,0,0,2,0,2
72375,160,19629,25963;26107,56575,0,0,2,0,2
72376,160,19631,25854;25993,56575,0,0,2,0,2
72377,160,19632,25838;26048,56575,0,0,2,0,2
72378,160,19633,26061;26241;27936,56575,0,1,2,0,3
72379,160,19634,26017;26069,56575,0,0,2,0,2
72380,160,19635,26081;26195,56575,0,0,2,0,2
72381,160,19636,25602;26087;27744;28228;28403,56575,2,1,2,0,5
72382,160,19637,26099;26256,56575,0,0,2,0,2
72383,160,19638,21847,56940,0,0,1,0,1
72384,160,19639,21647,56940,0,0,0,1,1
72385,160,19640,21438,56940,0,0,0,1,1
72386,160,19641,21743,56940,0,0,0,1,1
72387,160,19642,21638,56940,0,0,0,1,1
72388,160,19645,21598,56940,0,0,0,1,1
72389,160,19646,22067,56940,0,0,1,0,1
72390,160,19647,22201,56940,0,0,1,0,1
72391,160,19648,22383,56940,0,0,1,0,1
72392,160,19650,22497;22820;26728,56940,0,0,3,0,3
72393,160,19651,22063;22235,56940,0,0,2,0,2
72394,160,19652,22573,56940,0,0,1,0,1
72395,160,19653,22570,56940,0,0,1,0,1
72396,160,19654,22436,56940,0,0,1,0,1
72397,160,19655,22875,56940,0,0,1,0,1
72398,160,19656,23545,56940,0,0,1,0,1
72399,160,19657,22782,56940,0,0,1,0,1
72400,160,19658,23382;24125,56940,0,0,2,0,2
72401,160,19662,23777,56940,0,0,1,0,1
72402,160,19663,23970,56940,0,0,1,0,1
72403,160,19664,23882;26591;26880;27046,56940,0,2,2,0,4
72404,160,19665,23997,56940,0,0,1,0,1
72405,160,19666,24387;24558;27084;28324,56940,1,1,2,0,4
72406,160,19667,24523,56940,0,0,1,0,1
72407,160,19669,24673;25107;27719;28180,56940,1,1,2,0,4
72408,160,19670,24695,56940,0,0,1,0,1
72409,160,19673,24756;24996;27900,56940,0,1,2,0,3
72410,160,19674,24769,56940,0,0,1,0,1
72411,160,19675,24499;25074,56940,0,0,2,0,2
72412,160,19676,24549,56940,0,0,1,0,1
72413,160,19677,24806,56940,0,0,1,0,1
72414,160,19678,24992;25007;27269,56940,0,1,2,0,3
72415,160,19679,24901,56940,0,0,1,0,1
72416,160,19680,25058;25240;28187,56940,1,0,2,0,3
72417,160,19682,24970;25182;27176;27912;28183,56940,1,2,2,0,5
72418,160,19683,24899;25187,56940,0,0,2,0,2
72419,160,19684,24783;25211;28000,56940,1,0,2,0,3
72420,160,19685,25262;25351,56940,0,0,2,0,2
72421,160,19686,25333;25367,56940,0,0,2,0,2
72422,160,19687,25414;25885;27563,56940,0,1,2,0,3
72423,160,19688,25891,56940,0,0,1,0,1
72424,160,19689,25442;25637;27560,56940,0,1,2,0,3
72425,160,19690,25807;28394,56940,1,0,1,0,2
72426,160,19691,25294,56940,0,0,1,0,1
72427,160,19692,25542;25903;27741,56940,0,1,2,0,3
72428,160,19693,25486;25536;28013,56940,1,0,2,0,3
72429,160,19694,25577;25747;28393,56940,1,0,2,0,3
72430,160,19695,25361;25738;28217,56940,1,0,2,0,3
72431,160,19696,25728,56940,0,0,1,0,1
72432,160,19697,25668;25767,56940,0,0,2,0,2
72433,160,19698,25776;26179;28304,56940,1,0,2,0,3
72434,160,19699,25789;25928,56940,0,0,2,0,2
72435,160,19700,25779;25797,56940,0,0,2,0,2
72436,160,19701,25395,56940,0,0,1,0,1
72437,160,19702,25841;27738,56940,0,1,1,0,2
72438,160,19703,25636;25842,56940,0,0,2,0,2
72439,160,19704,25488;25862,56940,0,0,2,0,2
72440,160,19705,25898;25924,56940,0,0,2,0,2
72441,160,19706,25916;26077,56940,0,0,2,0,2
72442,160,19707,25925;26227,56940,0,0,2,0,2
72443,160,19708,25814;25933,56940,0,0,2,0,2
72444,160,19709,25973;26127,56940,0,0,2,0,2
72445,160,19710,26004;26410,56940,0,0,2,0,2
72446,160,19711,26007;26194;27938,56940,0,1,2,0,3
72447,160,19712,25972;26028;28227,56940,1,0,2,0,3
72448,160,19713,26002;26034;28132,56940,1,0,2,0,3
72449,160,19714,26044;26102,56940,0,0,2,0,2
72450,160,19715,26052;26489,56940,0,0,2,0,2
72451,160,19716,26058;26406,56940,0,0,2,0,2
72452,160,19717,26070;26285,56940,0,0,2,0,2
72453,160,19718,25792;26101,56940,0,0,2,0,2
72454,160,19719,26124;26233;28306;28409,56940,2,0,2,0,4
72455,160,19720,26126,56940,0,0,1,0,1
72456,160,19721,25850;26129,56940,0,0,2,0,2
72457,160,19722,26141;26147,56940,0,0,2,0,2
72458,160,19723,26144,56940,0,0,1,0,1
72459,160,19724,25677;26150;28407,56940,1,0,2,0,3
72460,160,19725,26152,56940,0,0,1,0,1
72461,160,19726,26171,56940,0,0,1,0,1
72462,160,19727,26116;26178,56940,0,0,2,0,2
72463,160,19728,25959;26192;28408,56940,1,0,2,0,3
72464,160,19729,21650,57305,0,0,0,1,1
72465,160,19730,21900,57305,0,0,1,0,1
72466,160,19731,21550,57305,0,0,0,1,1
72467,160,19732,22207,57305,0,0,1,0,1
72468,160,19733,22265,57305,0,0,1,0,1
72469,160,19734,22246,57305,0,0,1,0,1
72470,160,19735,22262,57305,0,0,1,0,1
72471,160,19736,22360,57305,0,0,1,0,1
72472,160,19738,22134,57305,0,0,1,0,1
72473,160,19739,22754,57305,0,0,1,0,1
72474,160,19740,22771,57305,0,0,1,0,1
72475,160,19741,22855,57305,0,0,1,0,1
72476,160,19742,22923,57305,0,0,1,0,1
72477,160,19745,23108,57305,0,0,1,0,1
72478,160,19746,23175,57305,0,0,1,0,1
72479,160,19748,23194,57305,0,0,1,0,1
72480,160,19750,23277,57305,0,0,1,0,1
72481,160,19752,23514,57305,0,0,1,0,1
72482,160,19755,23628,57305,0,0,1,0,1
72483,160,19756,23741,57305,0,0,1,0,1
72484,160,19757,23448,57305,0,0,1,0,1
72485,160,19758,23710,57305,0,0,1,0,1
72486,160,19759,23868,57305,0,0,1,0,1
72487,160,19760,23286,57305,0,0,1,0,1
72488,160,19761,24020,57305,0,0,1,0,1
72489,160,19762,24363,57305,0,0,1,0,1
72490,160,19764,24237,57305,0,0,1,0,1
72491,160,19765,24544,57305,0,0,1,0,1
72492,160,19766,24042,57305,0,0,1,0,1
72493,160,19767,24731;24917,57305,0,0,2,0,2
72494,160,19769,24785;24862;28247,57305,1,0,2,0,3
72495,160,19770,24645,57305,0,0,1,0,1
72496,160,19771,25147;27909,57305,0,1,1,0,2
72497,160,19772,25195;25461;28275,57305,1,0,2,0,3
72498,160,19773,25197;25386;27923;28102,57305,1,1,2,0,4
72499,160,19774,25222;25458;27818,57305,0,1,2,0,3
72500,160,19775,25227;25597,57305,0,0,2,0,2
72501,160,19776,25247;25587;28381,57305,1,0,2,0,3
72502,160,19777,25346;25682,57305,0,0,2,0,2
72503,160,19778,24793,57305,0,0,1,0,1
72504,160,19779,25812,57305,0,0,1,0,1
72505,160,19780,25251;25357,57305,0,0,2,0,2
72506,160,19781,25709,57305,0,0,1,0,1
72507,160,19782,25579;25599,57305,0,0,2,0,2
72508,160,19783,25615;25623,57305,0,0,2,0,2
72509,160,19784,25477;25632;28387,57305,1,0,2,0,3
72510,160,19785,25664;25695;28287,57305,1,0,2,0,3
72511,160,19786,25715,57305,0,0,1,0,1
72512,160,19787,25716;25781,57305,0,0,2,0,2
72513,160,19788,25681;25733;28289,57305,1,0,2,0,3
72514,160,19789,25737,57305,0,0,1,0,1
72515,160,19790,25763;25803,57305,0,0,2,0,2
72516,160,19791,25811;25845,57305,0,0,2,0,2
72517,160,19792,25852;25997,57305,0,0,2,0,2
72518,160,19793,25840;25861;28024,57305,1,0,2,0,3
72519,160,19794,25868;25929,57305,0,0,2,0,2
72520,160,19795,25590;25892,57305,0,0,2,0,2
72521,160,19796,25911;26183;28030,57305,1,0,2,0,3
72522,160,19797,25919;26278;28310,57305,1,0,2,0,3
72523,160,19798,25948;26085,57305,0,0,2,0,2
72524,160,19799,25950;26280,57305,0,0,2,0,2
72525,160,19800,25674;25989,57305,0,0,2,0,2
72526,160,19801,25994;26095,57305,0,0,2,0,2
72527,160,19802,26032,57305,0,0,1,0,1
72528,160,19803,26056;26264;28308,57305,1,0,2,0,3
72529,160,19804,26019;26073,57305,0,0,2,0,2
72530,160,19805,26065;26110;28302,57305,1,0,2,0,3
72531,160,19806,26149;26388,57305,0,0,2,0,2
72532,160,19807,26160;26676,57305,0,0,2,0,2
72533,160,19808,26186;26312,57305,0,0,2,0,2
72534,160,19809,26187;26417,57305,0,0,2,0,2
72535,160,19810,26156;26197;28029,57305,1,0,2,0,3
72536,160,19811,26211;26279;28031;28230,57305,2,0,2,0,4
72537,160,19812,25971;26228,57305,0,0,2,0,2
72538,160,19813,26235;26287,57305,0,0,2,0,2
72539,160,19814,26020;26239,57305,0,0,2,0,2
72540,160,19815,26254;26599,57305,0,0,2,0,2
72541,160,19816,26294;26571,57305,0,0,2,0,2
72542,160,19817,22135,57670,0,0,1,0,1
72543,160,19818,22185,57670,0,0,1,0,1
72544,160,19819,22234,57670,0,0,1,0,1
72545,160,19820,22400,57670,0,0,1,0,1
72546,160,19821,22559,57670,0,0,1,0,1
72547,160,19822,22229,57670,0,0,1,0,1
72548,160,19823,22411,57670,0,0,1,0,1
72549,160,19824,22439;22510,57670,0,0,2,0,2
72550,160,19825,22603,57670,0,0,1,0,1
72551,160,19827,22549,57670,0,0,1,0,1
72552,160,19829,23127,57670,0,0,1,0,1
72553,160,19830,23155,57670,0,0,1,0,1
72554,160,19831,23312,57670,0,0,1,0,1
72555,160,19832,22951,57670,0,0,1,0,1
72556,160,19834,23363,57670,0,0,1,0,1
72557,160,19835,23504;23816,57670,0,0,2,0,2
72558,160,19836,23570,57670,0,0,1,0,1
72559,160,19837,23581,57670,0,0,1,0,1
72560,160,19838,23410,57670,0,0,1,0,1
72561,160,19840,23819;24129,57670,0,0,2,0,2
72562,160,19841,23820,57670,0,0,1,0,1
72563,160,19842,23861,57670,0,0,1,0,1
72564,160,19843,24067,57670,0,0,1,0,1
72565,160,19844,24361;24596;27516;28326,57670,1,1,2,0,4
72566,160,19845,23782,57670,0,0,1,0,1
72567,160,19846,24118,57670,0,0,1,0,1
72568,160,19847,24538,57670,0,0,1,0,1
72569,160,19848,24592,57670,0,0,1,0,1
72570,160,19849,24593,57670,0,0,1,0,1
72571,160,19850,24016,57670,0,0,1,0,1
72572,160,19852,24456;24913,57670,0,0,2,0,2
72573,160,19853,24770,57670,0,0,1,0,1
72574,160,19854,24744,57670,0,0,1,0,1
72575,160,19855,24822,57670,0,0,1,0,1
72576,160,19856,24428,57670,0,0,1,0,1
72577,160,19857,24853,57670,0,0,1,0,1
72578,160,19858,24807,57670,0,0,1,0,1
72579,160,19859,25003,57670,0,0,1,0,1
72580,160,19860,25133;25235;27547,57670,0,1,2,0,3
72581,160,19861,25135;25702;27376,57670,0,1,2,0,3
72582,160,19862,25204,57670,0,0,1,0,1
72583,160,19863,25216,57670,0,0,1,0,1
72584,160,19864,25256,57670,0,0,1,0,1
72585,160,19865,25263;25297;27724,57670,0,1,2,0,3
72586,160,19866,25334,57670,0,0,1,0,1
72587,160,19867,25404;25416;28104,57670,1,0,2,0,3
72588,160,19868,25432;25528;28202,57670,1,0,2,0,3
72589,160,19869,25196;25456;27460;28011;28105,57670,2,1,2,0,5
72590,160,19870,25482,57670,0,0,1,0,1
72591,160,19871,25586;25650;28388,57670,1,0,2,0,3
72592,160,19872,25622;25698;27281,57670,0,1,2,0,3
72593,160,19873,25447;25625;27928,57670,0,1,2,0,3
72594,160,19874,25660,57670,0,0,1,0,1
72595,160,19875,25661;26275,57670,0,0,2,0,2
72596,160,19876,25705;25923,57670,0,0,2,0,2
72597,160,19877,25179,57670,0,0,1,0,1
72598,160,19878,25753;25942,57670,0,0,2,0,2
72599,160,19879,25774;25937,57670,0,0,2,0,2
72600,160,19880,25775;25844,57670,0,0,2,0,2
72601,160,19881,25431;25791,57670,0,0,2,0,2
72602,160,19882,25509,57670,0,0,1,0,1
72603,160,19883,25354,57670,0,0,1,0,1
72604,160,19884,25851;26096,57670,0,0,2,0,2
72605,160,19885,25433,57670,0,0,1,0,1
72606,160,19886,25968;26274,57670,0,0,2,0,2
72607,160,19887,25949,57670,0,0,1,0,1
72608,160,19888,25953;26153,57670,0,0,2,0,2
72609,160,19889,26045;26117,57670,0,0,2,0,2
72610,160,19890,25843;26104,57670,0,0,2,0,2
72611,160,19891,25710,57670,0,0,1,0,1
72612,160,19892,26132;26133;28229,57670,1,0,2,0,3
72613,160,19893,25970;26136,57670,0,0,2,0,2
72614,160,19894,26146;26162,57670,0,0,2,0,2
72615,160,19895,26436;26602;28313,57670,1,0,2,0,3
72616,160,19896,26128;26208,57670,0,0,2,0,2
72617,160,19897,25806;28125,57670,1,0,1,0,2
72618,160,19898,26247;26268,57670,0,0,2,0,2
72619,160,19899,26251;26395,57670,0,0,2,0,2
72620,160,19900,26253;26477,57670,0,0,2,0,2
72621,160,19901,26257;26711,57670,0,0,2,0,2
72622,160,19902,26258;26561;28317,57670,1,0,2,0,3
72623,160,19903,26277;26528,57670,0,0,2,0,2
72624,160,19904,25944;26291,57670,0,0,2,0,2
72625,160,19905,26296;26631,57670,0,0,2,0,2
72626,160,19906,26319,57670,0,0,1,0,1
72627,160,19907,26309;26335,57670,0,0,2,0,2
72628,160,19908,26366;26407,57670,0,0,2,0,2
72629,160,19909,26379;26667,57670,0,0,2,0,2
72630,160,19910,26403;26589,57670,0,0,2,0,2
72631,160,19911,26259;26411;28414,57670,1,0,2,0,3
72632,160,19912,22316,58035,0,0,1,0,1
72633,160,19913,22224,58035,0,0,1,0,1
72634,160,19914,21840,58035,0,0,1,0,1
72635,160,19915,22220,58035,0,0,1,0,1
72636,160,19916,22416,58035,0,0,1,0,1
72637,160,19917,22504,58035,0,0,1,0,1
72638,160,19918,22685,58035,0,0,1,0,1
72639,160,19919,22515,58035,0,0,1,0,1
72640,160,19921,22295,58035,0,0,1,0,1
72641,160,19922,22953,58035,0,0,1,0,1
72642,160,19923,22990,58035,0,0,1,0,1
72643,160,19924,23057,58035,0,0,1,0,1
72644,160,19925,23185,58035,0,0,1,0,1
72645,160,19926,23083,58035,0,0,1,0,1
72646,160,19928,22992,58035,0,0,1,0,1
72647,160,19929,23417,58035,0,0,1,0,1
72648,160,19930,23097,58035,0,0,1,0,1
72649,160,19931,23377,58035,0,0,1,0,1
72650,160,19932,23497,58035,0,0,1,0,1
72651,160,19933,23558,58035,0,0,1,0,1
72652,160,19934,23452,58035,0,0,1,0,1
72653,160,19935,23799,58035,0,0,1,0,1
72654,160,19936,23651,58035,0,0,1,0,1
72655,160,19937,23945;24397,58035,0,0,2,0,2
72656,160,19938,23901,58035,0,0,1,0,1
72657,160,19939,23811,58035,0,0,1,0,1
72658,160,19941,24402,58035,0,0,1,0,1
72659,160,19942,24434,58035,0,0,1,0,1
72660,160,19943,24454;25023,58035,0,0,2,0,2
72661,160,19944,24076,58035,0,0,1,0,1
72662,160,19945,24507,58035,0,0,1,0,1
72663,160,19946,24578,58035,0,0,1,0,1
72664,160,19947,24263,58035,0,0,1,0,1
72665,160,19948,24674,58035,0,0,1,0,1
72666,160,19949,24790,58035,0,0,1,0,1
72667,160,19950,25027,58035,0,0,1,0,1
72668,160,19951,24779;25064;27174;27541,58035,0,2,2,0,4
72669,160,19952,24933,58035,0,0,1,0,1
72670,160,19953,25132;25419;27370;28370,58035,1,1,2,0,4
72671,160,19955,25199;25253,58035,0,0,2,0,2
72672,160,19956,25359;25834,58035,0,0,2,0,2
72673,160,19957,25368,58035,0,0,1,0,1
72674,160,19958,25105;25424;27280;27554,58035,0,2,2,0,4
72675,160,19959,25434,58035,0,0,1,0,1
72676,160,19960,25470;25475,58035,0,0,2,0,2
72677,160,19961,25523;26039;28133;28301,58035,2,0,2,0,4
72678,160,19962,25524,58035,0,0,1,0,1
72679,160,19963,25546;25693;27925,58035,0,1,2,0,3
72680,160,19965,25157,58035,0,0,1,0,1
72681,160,19966,25610;26266,58035,0,0,2,0,2
72682,160,19967,25692;26148,58035,0,0,2,0,2
72683,160,19968,25736;25955;27742,58035,0,1,2,0,3
72684,160,19969,25784;25874;27737;28123,58035,1,1,2,0,4
72685,160,19970,25298,58035,0,0,1,0,1
72686,160,19971,26236,58035,0,0,1,0,1
72687,160,19972,25754;25835;28222;28396,58035,2,0,2,0,4
72688,160,19973,25837;26286,58035,0,0,2,0,2
72689,160,19974,25866,58035,0,0,1,0,1
72690,160,19975,25437;25880;27829;28225,58035,1,1,2,0,4
72691,160,19976,25938;25983,58035,0,0,2,0,2
72692,160,19977,25941;26143,58035,0,0,2,0,2
72693,160,19978,25878;25951,58035,0,0,2,0,2
72694,160,19979,25961,58035,0,0,1,0,1
72695,160,19980,25341;25703;28288,58035,1,0,2,0,3
72696,160,19981,25979,58035,0,0,1,0,1
72697,160,19982,26011;26314,58035,0,0,2,0,2
72698,160,19983,26078;26341,58035,0,0,2,0,2
72699,160,19984,26112;26519,58035,0,0,2,0,2
72700,160,19985,26121;26175,58035,0,0,2,0,2
72701,160,19986,26151;26538;28417,58035,1,0,2,0,3
72702,160,19987,26177;26331,58035,0,0,2,0,2
72703,160,19988,26103;26188,58035,0,0,2,0,2
72704,160,19989,26200;26215,58035,0,0,2,0,2
72705,160,19990,25965;26260,58035,0,0,2,0,2
72706,160,19991,26263;26750,58035,0,0,2,0,2
72707,160,19992,26217;26269,58035,0,0,2,0,2
72708,160,19993,26276;26717,58035,0,0,2,0,2
72709,160,19994,26288;26485;28315,58035,1,0,2,0,3
72710,160,19995,26292;26334,58035,0,0,2,0,2
72711,160,19996,26084;26307,58035,0,0,2,0,2
72712,160,19997,26318,58035,0,0,1,0,1
72713,160,19998,26191;26330,58035,0,0,2,0,2
72714,160,19999,26347;26508,58035,0,0,2,0,2
72715,160,20000,26356;26375,58035,0,0,2,0,2
72716,160,20001,26397;26606,58035,0,0,2,0,2
72717,160,20002,26416;26702,58035,0,0,2,0,2
72718,160,20003,26422,58035,0,0,1,0,1
72719,160,20004,26442;26781,58035,0,0,2,0,2
72720,160,20005,26352;26445;28412,58035,1,0,2,0,3
72721,160,20006,26448;26459,58035,0,0,2,0,2
72722,160,20007,26475;26565,58035,0,0,2,0,2
72723,160,20008,26049;26479;28415,58035,1,0,2,0,3
72724,160,20009,26423;26493,58035,0,0,2,0,2
72725,160,20010,22297,58400,0,0,1,0,1
72726,160,20011,22366,58400,0,0,1,0,1
72727,160,20012,22635,58400,0,0,1,0,1
72728,160,20014,22457,58400,0,0,1,0,1
72729,160,20015,22919,58400,0,0,1,0,1
72730,160,20017,22631,58400,0,0,1,0,1
72731,160,20018,22943,58400,0,0,1,0,1
72732,160,20019,23384,58400,0,0,1,0,1
72733,160,20020,23385,58400,0,0,1,0,1
72734,160,20021,23389,58400,0,0,1,0,1
72735,160,20022,23460,58400,0,0,1,0,1
72736,160,20023,23317,58400,0,0,1,0,1
72737,160,20024,23668,58400,0,0,1,0,1
72738,160,20025,23121,58400,0,0,1,0,1
72739,160,20026,23735,58400,0,0,1,0,1
72740,160,20027,23810,58400,0,0,1,0,1
72741,160,20028,23812,58400,0,0,1,0,1
72742,160,20029,23856,58400,0,0,1,0,1
72743,160,20030,23957,58400,0,0,1,0,1
72744,160,20031,24152,58400,0,0,1,0,1
72745,160,20032,23808,58400,0,0,1,0,1
72746,160,20033,24399;24452;26802;27076;27339,58400,0,2,3,0,5
72747,160,20034,24137,58400,0,0,1,0,1
72748,160,20035,24513,58400,0,0,1,0,1
72749,160,20036,24551,58400,0,0,1,0,1
72750,160,20037,24262,58400,0,0,1,0,1
72751,160,20038,24631,58400,0,0,1,0,1
72752,160,20039,24649,58400,0,0,1,0,1
72753,160,20040,24696;25269,58400,0,0,2,0,2
72754,160,20041,24966;25077;27363,58400,0,1,2,0,3
72755,160,20042,25092;25280,58400,0,0,2,0,2
72756,160,20043,25173,58400,0,0,1,0,1
72757,160,20044,25277;25630;27823,58400,0,1,2,0,3
72758,160,20045,25100;25342;28270,58400,1,0,2,0,3
72759,160,20046,25122,58400,0,0,1,0,1
72760,160,20047,25202,58400,0,0,1,0,1
72761,160,20048,25140,58400,0,0,1,0,1
72762,160,20049,25451,58400,0,0,1,0,1
72763,160,20050,25496,58400,0,0,1,0,1
72764,160,20051,25526;25808,58400,0,0,2,0,2
72765,160,20052,25548;26024;28028,58400,1,0,2,0,3
72766,160,20053,25549;25592,58400,0,0,2,0,2
72767,160,20054,25639,58400,0,0,1,0,1
72768,160,20055,25721,58400,0,0,1,0,1
72769,160,20056,25895;26408,58400,0,0,2,0,2
72770,160,20057,25465,58400,0,0,1,0,1
72771,160,20058,25912,58400,0,0,1,0,1
72772,160,20059,25926;26035,58400,0,0,2,0,2
72773,160,20060,26055;26155,58400,0,0,2,0,2
72774,160,20061,26074;26435,58400,0,0,2,0,2
72775,160,20062,26086;26158,58400,0,0,2,0,2
72776,160,20063,26090;26305;27937,58400,0,1,2,0,3
72777,160,20064,26119,58400,0,0,1,0,1
72778,160,20065,26167;26193,58400,0,0,2,0,2
72779,160,20066,25995,58400,0,0,1,0,1
72780,160,20067,25931;26190;27833,58400,0,1,2,0,3
72781,160,20068,26009;26202,58400,0,0,2,0,2
72782,160,20069,26229;26575,58400,0,0,2,0,2
72783,160,20070,26300;26392,58400,0,0,2,0,2
72784,160,20071,26322;26646,58400,0,0,2,0,2
72785,160,20072,26349;26495,58400,0,0,2,0,2
72786,160,20073,26345;26353;28411,58400,1,0,2,0,3
72787,160,20074,26363;26634,58400,0,0,2,0,2
72788,160,20075,26378;26691,58400,0,0,2,0,2
72789,160,20076,26380;26731,58400,0,0,2,0,2
72790,160,20077,26391,58400,0,0,1,0,1
72791,160,20078,26399,58400,0,0,1,0,1
72792,160,20079,26400;26541,58400,0,0,2,0,2
72793,160,20080,26404;26518,58400,0,0,2,0,2
72794,160,20081,26438;26794,58400,0,0,2,0,2
72795,160,20082,26358;26469;28413,58400,1,0,2,0,3
72796,160,20083,26484;26492,58400,0,0,2,0,2
72797,160,20084,26505;26514,58400,0,0,2,0,2
72798,160,20085,26515;26812,58400,0,0,2,0,2
72799,160,20086,26540;26776,58400,0,0,2,0,2
72800,160,20087,26546;26780,58400,0,0,2,0,2
72801,160,20088,26076;26551,58400,0,0,2,0,2
72802,160,20089,26552;26761,58400,0,0,2,0,2
72803,160,20090,26558;26653;28318,58400,1,0,2,0,3
72804,160,20091,26596;26784,58400,0,0,2,0,2
72805,170,7731,19999,14235,0,0,0,1,1
72806,170,11912,19878,28105,0,0,0,1,1
72807,170,11924,20789,28105,0,0,0,1,1
72808,170,12226,21266,29200,0,0,0,1,1
72809,170,12353,22393;26120,29565,0,0,1,1,2
72810,170,12398,21363;21497,29930,0,0,0,2,2
72811,170,12642,23144;23236;27190,30660,0,0,3,0,3
72812,170,13048,18821,32120,0,0,0,1,1
72813,170,13127,22183,32485,0,0,0,1,1
72814,170,13256,18651,32850,0,0,0,1,1
72815,170,13324,19021,33215,0,0,0,1,1
72816,170,13331,18645,33215,0,0,0,1,1
72817,170,13334,19275,33215,0,0,0,1,1
72818,170,13351,18891,33215,0,0,0,1,1
72819,170,13352,18981,33215,0,0,0,1,1
72820,170,13442,19354,33580,0,0,0,1,1
72821,170,13456,19013,33580,0,0,0,1,1
72822,170,13461,19366,33580,0,0,0,1,1
72823,170,13540,18775,33945,0,0,0,1,1
72824,170,13541,19302;19318,33945,0,0,0,2,2
72825,170,13569,19427,33945,0,0,0,1,1
72826,170,13572,19142;19378,33945,0,0,0,2,2
72827,170,13574,19434,33945,0,0,0,1,1
72828,170,13671,19169,34310,0,0,0,1,1
72829,170,13672,18768,34310,0,0,0,1,1
72830,170,13677,19448,34310,0,0,0,1,1
72831,170,13679,19518,34310,0,0,0,1,1
72832,170,13680,19167,34310,0,0,0,1,1
72833,170,13737,23377;23472,34675,0,0,2,0,2
72834,170,13739,19158,34675,0,0,0,1,1
72835,170,13740,22783;26527;29173,34675,1,0,1,1,3
72836,170,13803,22097;22555;22947;23146,35040,0,0,2,2,4
72837,170,13832,19074,35040,0,0,0,1,1
72838,170,13834,19638,35040,0,0,0,1,1
72839,170,13851,19214,35040,0,0,0,1,1
72840,170,13855,19652,35040,0,0,0,1,1
72841,170,13859,19757,35040,0,0,0,1,1
72842,170,13861,19767,35040,0,0,0,1,1
72843,170,13862,19846,35040,0,0,0,1,1
72844,170,13915,23147,35405,0,0,1,0,1
72845,170,13949,19422,35405,0,0,0,1,1
72846,170,13967,19993,35405,0,0,0,1,1
72847,170,14029,19045,35770,0,0,0,1,1
72848,170,14038,19144,35770,0,0,0,1,1
72849,170,14045,19413,35770,0,0,0,1,1
72850,170,14053,19552,35770,0,0,0,1,1
72851,170,14056,19499,35770,0,0,0,1,1
72852,170,14057,19902,35770,0,0,0,1,1
72853,170,14063,19615,35770,0,0,0,1,1
72854,170,14064,19943,35770,0,0,0,1,1
72855,170,14065,20077,35770,0,0,0,1,1
72856,170,14071,19739,35770,0,0,0,1,1
72857,170,14076,19780,35770,0,0,0,1,1
72858,170,14123,18803,36135,0,0,0,1,1
72859,170,14142,19606,36135,0,0,0,1,1
72860,170,14145,19239,36135,0,0,0,1,1
72861,170,14147,19934,36135,0,0,0,1,1
72862,170,14151,19488,36135,0,0,0,1,1
72863,170,14152,19337,36135,0,0,0,1,1
72864,170,14162,20024,36135,0,0,0,1,1
72865,170,14168,19840,36135,0,0,0,1,1
72866,170,14172,19404,36135,0,0,0,1,1
72867,170,14173,23512,36135,0,0,1,0,1
72868,170,14177,20154,36135,0,0,0,1,1
72869,170,14182,19905,36135,0,0,0,1,1
72870,170,14183,19855,36135,0,0,0,1,1
72871,170,14187,19599,36135,0,0,0,1,1
72872,170,14188,19911;20047,36135,0,0,0,2,2
72873,170,14189,19914,36135,0,0,0,1,1
72874,170,14238,19116,36500,0,0,0,1,1
72875,170,14245,19022,36500,0,0,0,1,1
72876,170,14253,19924,36500,0,0,0,1,1
72877,170,14257,19389;19854,36500,0,0,0,2,2
72878,170,14259,19399,36500,0,0,0,1,1
72879,170,14270,19873,36500,0,0,0,1,1
72880,170,14271,19432;19650,36500,0,0,0,2,2
72881,170,14274,19653,36500,0,0,0,1,1
72882,170,14276,19714,36500,0,0,0,1,1
72883,170,14279,19979,36500,0,0,0,1,1
72884,170,14281,19814,36500,0,0,0,1,1
72885,170,14282,19784,36500,0,0,0,1,1
72886,170,14286,19862,36500,0,0,0,1,1
72887,170,14287,20015,36500,0,0,0,1,1
72888,170,14288,19968,36500,0,0,0,1,1
72889,170,14327,19105,36865,0,0,0,1,1
72890,170,14335,19394,36865,0,0,0,1,1
72891,170,14348,19463;19980,36865,0,0,0,2,2
72892,170,14354,19920,36865,0,0,0,1,1
72893,170,14359,20270,36865,0,0,0,1,1
72894,170,14360,20114,36865,0,0,0,1,1
72895,170,14364,19860,36865,0,0,0,1,1
72896,170,14365,20201;20249,36865,0,0,0,2,2
72897,170,14366,19887,36865,0,0,0,1,1
72898,170,14367,19904;20365,36865,0,0,0,2,2
72899,170,14368,19917,36865,0,0,0,1,1
72900,170,14369,20011,36865,0,0,0,1,1
72901,170,14371,20268,36865,0,0,0,1,1
72902,170,14376,20136,36865,0,0,0,1,1
72903,170,14419,19342,37230,0,0,0,1,1
72904,170,14430,19621,37230,0,0,0,1,1
72905,170,14431,19375,37230,0,0,0,1,1
72906,170,14432,19502,37230,0,0,0,1,1
72907,170,14442,19623,37230,0,0,0,1,1
72908,170,14445,20102,37230,0,0,0,1,1
72909,170,14447,19622,37230,0,0,0,1,1
72910,170,14449,20222,37230,0,0,0,1,1
72911,170,14450,19696,37230,0,0,0,1,1
72912,170,14453,20208,37230,0,0,0,1,1
72913,170,14454,20196,37230,0,0,0,1,1
72914,170,14455,19831,37230,0,0,0,1,1
72915,170,14458,19715,37230,0,0,0,1,1
72916,170,14460,20664,37230,0,0,0,1,1
72917,170,14461,20500,37230,0,0,0,1,1
72918,170,14464,20081,37230,0,0,0,1,1
72919,170,14467,20304;20470,37230,0,0,0,2,2
72920,170,14468,19989,37230,0,0,0,1,1
72921,170,14470,20473,37230,0,0,0,1,1
72922,170,14472,20075,37230,0,0,0,1,1
72923,170,14477,20574,37230,0,0,0,1,1
72924,170,14480,20414;24539,37230,0,0,1,1,2
72925,170,14483,20440,37230,0,0,0,1,1
72926,170,14484,20523,37230,0,0,0,1,1
72927,170,14534,19737;20248,37595,0,0,0,2,2
72928,170,14540,19893,37595,0,0,0,1,1
72929,170,14548,20056,37595,0,0,0,1,1
72930,170,14551,19937,37595,0,0,0,1,1
72931,170,14554,19950,37595,0,0,0,1,1
72932,170,14556,20325,37595,0,0,0,1,1
72933,170,14558,20495,37595,0,0,0,1,1
72934,170,14561,19749;19843,37595,0,0,0,2,2
72935,170,14562,20480,37595,0,0,0,1,1
72936,170,14566,19935;20501,37595,0,0,0,2,2
72937,170,14567,20307,37595,0,0,0,1,1
72938,170,14571,19962;20242,37595,0,0,0,2,2
72939,170,14574,20041,37595,0,0,0,1,1
72940,170,14576,20296,37595,0,0,0,1,1
72941,170,14577,20652,37595,0,0,0,1,1
72942,170,14578,20321;20728,37595,0,0,0,2,2
72943,170,14581,20194,37595,0,0,0,1,1
72944,170,14582,20542,37595,0,0,0,1,1
72945,170,14583,20394,37595,0,0,0,1,1
72946,170,14584,20715,37595,0,0,0,1,1
72947,170,14630,22983,37960,0,0,1,0,1
72948,170,14631,19029,37960,0,0,0,1,1
72949,170,14633,18792,37960,0,0,0,1,1
72950,170,14637,19966,37960,0,0,0,1,1
72951,170,14644,19596,37960,0,0,0,1,1
72952,170,14648,20146,37960,0,0,0,1,1
72953,170,14650,19136,37960,0,0,0,1,1
72954,170,14651,19657,37960,0,0,0,1,1
72955,170,14655,19794,37960,0,0,0,1,1
72956,170,14656,19944,37960,0,0,0,1,1
72957,170,14658,19791;19849,37960,0,0,0,2,2
72958,170,14659,20531,37960,0,0,0,1,1
72959,170,14660,19421,37960,0,0,0,1,1
72960,170,14662,19810,37960,0,0,0,1,1
72961,170,14663,19922,37960,0,0,0,1,1
72962,170,14670,19451,37960,0,0,0,1,1
72963,170,14671,20463,37960,0,0,0,1,1
72964,170,14672,20078;20489,37960,0,0,0,2,2
72965,170,14674,20109,37960,0,0,0,1,1
72966,170,14675,20582,37960,0,0,0,1,1
72967,170,14678,20310,37960,0,0,0,1,1
72968,170,14682,20212,37960,0,0,0,1,1
72969,170,14683,20172,37960,0,0,0,1,1
72970,170,14684,20415,37960,0,0,0,1,1
72971,170,14688,20317;20319,37960,0,0,0,2,2
72972,170,14689,20211,37960,0,0,0,1,1
72973,170,14690,20355;20595,37960,0,0,0,2,2
72974,170,14691,20775,37960,0,0,0,1,1
72975,170,14692,20424,37960,0,0,0,1,1
72976,170,14694,20413,37960,0,0,0,1,1
72977,170,14695,20226,37960,0,0,0,1,1
72978,170,14696,20544,37960,0,0,0,1,1
72979,170,14697,20447,37960,0,0,0,1,1
72980,170,14699,20870;21112,37960,0,0,0,2,2
72981,170,14700,23344;23960;24044;24084;27321;27579;27846,37960,0,1,6,0,7
72982,170,14702,20646,37960,0,0,0,1,1
72983,170,14703,20897,37960,0,0,0,1,1
72984,170,14743,19222,38325,0,0,0,1,1
72985,170,14747,19344,38325,0,0,0,1,1
72986,170,14751,19809,38325,0,0,0,1,1
72987,170,14754,19848,38325,0,0,0,1,1
72988,170,14755,19772,38325,0,0,0,1,1
72989,170,14760,19681;20021,38325,0,0,0,2,2
72990,170,14761,20297;20430,38325,0,0,0,2,2
72991,170,14762,19733,38325,0,0,0,1,1
72992,170,14763,19766,38325,0,0,0,1,1
72993,170,14764,19959,38325,0,0,0,1,1
72994,170,14767,20842,38325,0,0,0,1,1
72995,170,14768,20375,38325,0,0,0,1,1
72996,170,14770,20235;20250,38325,0,0,0,2,2
72997,170,14771,20600,38325,0,0,0,1,1
72998,170,14775,20351,38325,0,0,0,1,1
72999,170,14776,20823,38325,0,0,0,1,1
73000,170,14777,20112,38325,0,0,0,1,1
73001,170,14778,20160;20517,38325,0,0,0,2,2
73002,170,14779,20884,38325,0,0,0,1,1
73003,170,14780,20541,38325,0,0,0,1,1
73004,170,14784,20456,38325,0,0,0,1,1
73005,170,14785,20671,38325,0,0,0,1,1
73006,170,14787,20314;20537,38325,0,0,0,2,2
73007,170,14788,20570,38325,0,0,0,1,1
73008,170,14790,20332,38325,0,0,0,1,1
73009,170,14791,19994;20398,38325,0,0,0,2,2
73010,170,14792,20164,38325,0,0,0,1,1
73011,170,14793,20906,38325,0,0,0,1,1
73012,170,14794,20388,38325,0,0,0,1,1
73013,170,14798,20460,38325,0,0,0,1,1
73014,170,14799,20505,38325,0,0,0,1,1
73015,170,14800,20515;20924,38325,0,0,0,2,2
73016,170,14801,20571,38325,0,0,0,1,1
73017,170,14802,20780,38325,0,0,0,1,1
73018,170,14803,20596,38325,0,0,0,1,1
73019,170,14839,19346;19454,38690,0,0,0,2,2
73020,170,14847,19732,38690,0,0,0,1,1
73021,170,14850,20247,38690,0,0,0,1,1
73022,170,14851,19776,38690,0,0,0,1,1
73023,170,14852,20396,38690,0,0,0,1,1
73024,170,14854,20481,38690,0,0,0,1,1
73025,170,14855,20198,38690,0,0,0,1,1
73026,170,14859,20044,38690,0,0,0,1,1
73027,170,14861,20051;20129,38690,0,0,0,2,2
73028,170,14864,19967,38690,0,0,0,1,1
73029,170,14865,20232;20948,38690,0,0,0,2,2
73030,170,14866,20367,38690,0,0,0,1,1
73031,170,14868,20400,38690,0,0,0,1,1
73032,170,14869,21015,38690,0,0,0,1,1
73033,170,14874,20423;20457,38690,0,0,0,2,2
73034,170,14876,20161,38690,0,0,0,1,1
73035,170,14877,20732,38690,0,0,0,1,1
73036,170,14879,20704,38690,0,0,0,1,1
73037,170,14880,20739,38690,0,0,0,1,1
73038,170,14882,20682,38690,0,0,0,1,1
73039,170,14883,20521,38690,0,0,0,1,1
73040,170,14885,20555,38690,0,0,0,1,1
73041,170,14886,20080;20634,38690,0,0,0,2,2
73042,170,14887,20642;20929,38690,0,0,0,2,2
73043,170,14888,20628;21025,38690,0,0,0,2,2
73044,170,14890,20742,38690,0,0,0,1,1
73045,170,14918,19458,39055,0,0,0,1,1
73046,170,14932,19526,39055,0,0,0,1,1
73047,170,14937,19986,39055,0,0,0,1,1
73048,170,14938,20259,39055,0,0,0,1,1
73049,170,14947,20219,39055,0,0,0,1,1
73050,170,14948,20697;20790,39055,0,0,0,2,2
73051,170,14950,20039,39055,0,0,0,1,1
73052,170,14952,20142,39055,0,0,0,1,1
73053,170,14953,20368,39055,0,0,0,1,1
73054,170,14954,20520,39055,0,0,0,1,1
73055,170,14955,20606,39055,0,0,0,1,1
73056,170,14956,20224,39055,0,0,0,1,1
73057,170,14957,20066,39055,0,0,0,1,1
73058,170,14960,20911,39055,0,0,0,1,1
73059,170,14961,20893,39055,0,0,0,1,1
73060,170,14962,20167;20338,39055,0,0,0,2,2
73061,170,14963,20322,39055,0,0,0,1,1
73062,170,14964,20814,39055,0,0,0,1,1
73063,170,14966,20189,39055,0,0,0,1,1
73064,170,14969,20288,39055,0,0,0,1,1
73065,170,14970,20494;20710,39055,0,0,0,2,2
73066,170,14971,20538,39055,0,0,0,1,1
73067,170,14972,20284,39055,0,0,0,1,1
73068,170,14973,20829,39055,0,0,0,1,1
73069,170,14974,20836,39055,0,0,0,1,1
73070,170,14976,20524,39055,0,0,0,1,1
73071,170,14978,20615,39055,0,0,0,1,1
73072,170,14980,21155,39055,0,0,0,1,1
73073,170,14981,20668;20821,39055,0,0,0,2,2
73074,170,14983,20760,39055,0,0,0,1,1
73075,170,14984,20720,39055,0,0,0,1,1
73076,170,14988,20980,39055,0,0,0,1,1
73077,170,14989,20792,39055,0,0,0,1,1
73078,170,14990,20810,39055,0,0,0,1,1
73079,170,14991,21095;21122,39055,0,0,0,2,2
73080,170,15035,20073;20130,39420,0,0,0,2,2
73081,170,15038,20387,39420,0,0,0,1,1
73082,170,15039,20670,39420,0,0,0,1,1
73083,170,15040,20407;20465,39420,0,0,0,2,2
73084,170,15042,20643,39420,0,0,0,1,1
73085,170,15044,20602;20609,39420,0,0,0,2,2
73086,170,15045,20149;20347,39420,0,0,0,2,2
73087,170,15046,20620,39420,0,0,0,1,1
73088,170,15048,20301,39420,0,0,0,1,1
73089,170,15051,20496,39420,0,0,0,1,1
73090,170,15054,20002;20467,39420,0,0,0,2,2
73091,170,15055,20471,39420,0,0,0,1,1
73092,170,15056,20474,39420,0,0,0,1,1
73093,170,15060,20173;20584,39420,0,0,0,2,2
73094,170,15062,20131;20604,39420,0,0,0,2,2
73095,170,15063,20805;21028,39420,0,0,0,2,2
73096,170,15065,20663,39420,0,0,0,1,1
73097,170,15066,20806,39420,0,0,0,1,1
73098,170,15067,20684,39420,0,0,0,1,1
73099,170,15068,21102,39420,0,0,0,1,1
73100,170,15069,20709,39420,0,0,0,1,1
73101,170,15070,21184,39420,0,0,0,1,1
73102,170,15072,21037,39420,0,0,0,1,1
73103,170,15073,20759,39420,0,0,0,1,1
73104,170,15074,20608;21175,39420,0,0,0,2,2
73105,170,15075,20757,39420,0,0,0,1,1
73106,170,15076,20797;21048,39420,0,0,0,2,2
73107,170,15077,21017,39420,0,0,0,1,1
73108,170,15078,20863,39420,0,0,0,1,1
73109,170,15079,21170,39420,0,0,0,1,1
73110,170,15080,21030,39420,0,0,0,1,1
73111,170,15081,20912,39420,0,0,0,1,1
73112,170,15082,20915;21059,39420,0,0,0,2,2
73113,170,15083,21158,39420,0,0,0,1,1
73114,170,15084,20535;20922,39420,0,0,0,2,2
73115,170,15085,20865,39420,0,0,0,1,1
73116,170,15120,19549,39785,0,0,0,1,1
73117,170,15127,19969,39785,0,0,0,1,1
73118,170,15131,19985;20135,39785,0,0,0,2,2
73119,170,15133,19919,39785,0,0,0,1,1
73120,170,15134,19910;20294,39785,0,0,0,2,2
73121,170,15136,20282,39785,0,0,0,1,1
73122,170,15142,20265;20617,39785,0,0,0,2,2
73123,170,15143,20941,39785,0,0,0,1,1
73124,170,15144,20953,39785,0,0,0,1,1
73125,170,15145,20764,39785,0,0,0,1,1
73126,170,15146,20251,39785,0,0,0,1,1
73127,170,15147,20285,39785,0,0,0,1,1
73128,170,15149,20378;20556,39785,0,0,0,2,2
73129,170,15150,20498,39785,0,0,0,1,1
73130,170,15152,20560;24235,39785,0,0,1,1,2
73131,170,15153,23753,39785,0,0,1,0,1
73132,170,15154,21298,39785,0,0,0,1,1
73133,170,15157,23588;24343;27857,39785,0,1,2,0,3
73134,170,15158,20946,39785,0,0,0,1,1
73135,170,15160,20798,39785,0,0,0,1,1
73136,170,15161,20784;20826,39785,0,0,0,2,2
73137,170,15162,20850;20913,39785,0,0,0,2,2
73138,170,15164,21253,39785,0,0,0,1,1
73139,170,15165,20887;21227,39785,0,0,0,2,2
73140,170,15167,20890;21394,39785,0,0,0,2,2
73141,170,15168,20908,39785,0,0,0,1,1
73142,170,15169,20871,39785,0,0,0,1,1
73143,170,15170,20940;21414,39785,0,0,0,2,2
73144,170,15171,20942,39785,0,0,0,1,1
73145,170,15172,20964;21380,39785,0,0,0,2,2
73146,170,15173,20690;20965,39785,0,0,0,2,2
73147,170,15174,21259,39785,0,0,0,1,1
73148,170,15176,24806;25024,39785,0,0,2,0,2
73149,170,15212,20213,40150,0,0,0,1,1
73150,170,15213,20034;20613,40150,0,0,0,2,2
73151,170,15215,19829;20084,40150,0,0,0,2,2
73152,170,15216,20451,40150,0,0,0,1,1
73153,170,15217,20178,40150,0,0,0,1,1
73154,170,15220,20298;20598,40150,0,0,0,2,2
73155,170,15223,20432,40150,0,0,0,1,1
73156,170,15224,20444;20930,40150,0,0,0,2,2
73157,170,15226,20455;20967,40150,0,0,0,2,2
73158,170,15228,20838,40150,0,0,0,1,1
73159,170,15230,20552;20572,40150,0,0,0,2,2
73160,170,15231,20581,40150,0,0,0,1,1
73161,170,15232,20341,40150,0,0,0,1,1
73162,170,15233,20070,40150,0,0,0,1,1
73163,170,15234,20411,40150,0,0,0,1,1
73164,170,15235,20662;21068,40150,0,0,0,2,2
73165,170,15237,21145,40150,0,0,0,1,1
73166,170,15238,20727;20898,40150,0,0,0,2,2
73167,170,15240,20577,40150,0,0,0,1,1
73168,170,15241,20770,40150,0,0,0,1,1
73169,170,15244,20553,40150,0,0,0,1,1
73170,170,15245,20856,40150,0,0,0,1,1
73171,170,15247,21060,40150,0,0,0,1,1
73172,170,15248,20165;20528,40150,0,0,0,2,2
73173,170,15251,20972,40150,0,0,0,1,1
73174,170,15252,20979,40150,0,0,0,1,1
73175,170,15253,21004,40150,0,0,0,1,1
73176,170,15254,21153,40150,0,0,0,1,1
73177,170,15255,21033,40150,0,0,0,1,1
73178,170,15256,20516;21034,40150,0,0,0,2,2
73179,170,15257,21011,40150,0,0,0,1,1
73180,170,15258,21069,40150,0,0,0,1,1
73181,170,15259,20959,40150,0,0,0,1,1
73182,170,15260,21072,40150,0,0,0,1,1
73183,170,15261,21293,40150,0,0,0,1,1
73184,170,15263,21137,40150,0,0,0,1,1
73185,170,15265,21173,40150,0,0,0,1,1
73186,170,15266,21401;21493,40150,0,0,0,2,2
73187,170,15308,20311,40515,0,0,0,1,1
73188,170,15313,20139,40515,0,0,0,1,1
73189,170,15317,20408,40515,0,0,0,1,1
73190,170,15318,20359,40515,0,0,0,1,1
73191,170,15320,20614,40515,0,0,0,1,1
73192,170,15323,20991,40515,0,0,0,1,1
73193,170,15326,20681;20843,40515,0,0,0,2,2
73194,170,15328,20426;20563,40515,0,0,0,2,2
73195,170,15329,20781,40515,0,0,0,1,1
73196,170,15330,20786,40515,0,0,0,1,1
73197,170,15331,19972,40515,0,0,0,1,1
73198,170,15332,21162,40515,0,0,0,1,1
73199,170,15333,21278,40515,0,0,0,1,1
73200,170,15335,20458;20824,40515,0,0,0,2,2
73201,170,15336,20638;21356,40515,0,0,0,2,2
73202,170,15339,20677,40515,0,0,0,1,1
73203,170,15340,21392,40515,0,0,0,1,1
73204,170,15342,20758,40515,0,0,0,1,1
73205,170,15343,21047,40515,0,0,0,1,1
73206,170,15344,21035;21214,40515,0,0,0,2,2
73207,170,15346,20852,40515,0,0,0,1,1
73208,170,15347,25004,40515,0,0,1,0,1
73209,170,15348,20896,40515,0,0,0,1,1
73210,170,15350,25005;28509,40515,0,1,1,0,2
73211,170,15351,21304,40515,0,0,0,1,1
73212,170,15352,21525,40515,0,0,0,1,1
73213,170,15353,21156,40515,0,0,0,1,1
73214,170,15354,20820,40515,0,0,0,1,1
73215,170,15355,21441,40515,0,0,0,1,1
73216,170,15356,21052,40515,0,0,0,1,1
73217,170,15357,20919;20977,40515,0,0,0,2,2
73218,170,15359,20983;21290,40515,0,0,0,2,2
73219,170,15360,21474,40515,0,0,0,1,1
73220,170,15361,21159,40515,0,0,0,1,1
73221,170,15362,21295,40515,0,0,0,1,1
73222,170,15363,20995,40515,0,0,0,1,1
73223,170,15365,21208,40515,0,0,0,1,1
73224,170,15366,20655;21180,40515,0,0,0,2,2
73225,170,15367,20827;21186,40515,0,0,0,2,2
73226,170,15368,20904;21189,40515,0,0,0,2,2
73227,170,15369,21203,40515,0,0,0,1,1
73228,170,15370,21209;21252,40515,0,0,0,2,2
73229,170,15371,20691;21254,40515,0,0,0,2,2
73230,170,15373,21280,40515,0,0,0,1,1
73231,170,15374,21387,40515,0,0,0,1,1
73232,170,15376,20648;21220,40515,0,0,0,2,2
73233,170,15377,21307,40515,0,0,0,1,1
73234,170,15402,22945;23107,40880,0,0,2,0,2
73235,170,15406,19569;23688;26682;29181;29273,40880,2,0,2,1,5
73236,170,15412,19363,40880,0,0,0,1,1
73237,170,15427,20811;24459;27773,40880,0,1,1,1,3
73238,170,15428,20753;21001,40880,0,0,0,2,2
73239,170,15430,20522,40880,0,0,0,1,1
73240,170,15431,20867,40880,0,0,0,1,1
73241,170,15432,20576;20666,40880,0,0,0,2,2
73242,170,15434,21515;22085,40880,0,0,0,2,2
73243,170,15435,20835,40880,0,0,0,1,1
73244,170,15436,21114,40880,0,0,0,1,1
73245,170,15437,21537,40880,0,0,0,1,1
73246,170,15438,20883;21257,40880,0,0,0,2,2
73247,170,15439,20733;20900,40880,0,0,0,2,2
73248,170,15440,20960,40880,0,0,0,1,1
73249,170,15441,21471,40880,0,0,0,1,1
73250,170,15442,21081,40880,0,0,0,1,1
73251,170,15444,21123,40880,0,0,0,1,1
73252,170,15445,21077,40880,0,0,0,1,1
73253,170,15446,21201,40880,0,0,0,1,1
73254,170,15447,21340,40880,0,0,0,1,1
73255,170,15448,21633,40880,0,0,0,1,1
73256,170,15449,21140,40880,0,0,0,1,1
73257,170,15452,20755,40880,0,0,0,1,1
73258,170,15453,21187;21193,40880,0,0,0,2,2
73259,170,15454,21202;21554,40880,0,0,0,2,2
73260,170,15456,21126;21258,40880,0,0,0,2,2
73261,170,15458,21163,40880,0,0,0,1,1
73262,170,15459,21288,40880,0,0,0,1,1
73263,170,15460,21306;21642,40880,0,0,0,2,2
73264,170,15461,21878,40880,0,0,0,1,1
73265,170,15463,21277;21403,40880,0,0,0,2,2
73266,170,15464,21411,40880,0,0,0,1,1
73267,170,15497,22953;23182,41245,0,0,2,0,2
73268,170,15504,19700,41245,0,0,0,1,1
73269,170,15505,20218,41245,0,0,0,1,1
73270,170,15513,20281,41245,0,0,0,1,1
73271,170,15516,20221,41245,0,0,0,1,1
73272,170,15518,20561,41245,0,0,0,1,1
73273,170,15521,20632,41245,0,0,0,1,1
73274,170,15522,20679,41245,0,0,0,1,1
73275,170,15524,20705,41245,0,0,0,1,1
73276,170,15526,21196,41245,0,0,0,1,1
73277,170,15527,20796,41245,0,0,0,1,1
73278,170,15528,20834,41245,0,0,0,1,1
73279,170,15530,20868;20920,41245,0,0,0,2,2
73280,170,15532,20925,41245,0,0,0,1,1
73281,170,15533,21093,41245,0,0,0,1,1
73282,170,15534,21115,41245,0,0,0,1,1
73283,170,15535,20982,41245,0,0,0,1,1
73284,170,15536,25742;26481;28585;28668;28913,41245,1,2,2,0,5
73285,170,15537,21002;21109,41245,0,0,0,2,2
73286,170,15538,21045;21087,41245,0,0,0,2,2
73287,170,15539,21051,41245,0,0,0,1,1
73288,170,15541,21089;21133,41245,0,0,0,2,2
73289,170,15543,20721,41245,0,0,0,1,1
73290,170,15544,21760,41245,0,0,0,1,1
73291,170,15545,21352;21393,41245,0,0,0,2,2
73292,170,15546,21119;21176,41245,0,0,0,2,2
73293,170,15547,21020;21121,41245,0,0,0,2,2
73294,170,15549,21104;21565,41245,0,0,0,2,2
73295,170,15550,21213;21231,41245,0,0,0,2,2
73296,170,15551,21168,41245,0,0,0,1,1
73297,170,15552,21248,41245,0,0,0,1,1
73298,170,15554,21351;21865,41245,0,0,0,2,2
73299,170,15556,21594,41245,0,0,0,1,1
73300,170,15557,21366;21523,41245,0,0,0,2,2
73301,170,15558,21369;21701,41245,0,0,0,2,2
73302,170,15559,21370;21577,41245,0,0,0,2,2
73303,170,15560,21439,41245,0,0,0,1,1
73304,170,15561,21794,41245,0,0,0,1,1
73305,170,15562,21455;21545,41245,0,0,0,2,2
73306,170,15563,21421,41245,0,0,0,1,1
73307,170,15564,25014;25055;27717;28440,41245,0,1,3,0,4
73308,170,15565,21801,41245,0,0,0,1,1
73309,170,15566,21379;21508,41245,0,0,0,2,2
73310,170,15567,21302;21513,41245,0,0,0,2,2
73311,170,15568,21714,41245,0,0,0,1,1
73312,170,15569,21517;21833,41245,0,0,0,2,2
73313,170,15605,20526,41610,0,0,0,1,1
73314,170,15609,20147,41610,0,0,0,1,1
73315,170,15611,20243;20659,41610,0,0,0,2,2
73316,170,15617,20737,41610,0,0,0,1,1
73317,170,15619,20180,41610,0,0,0,1,1
73318,170,15621,20386;20588,41610,0,0,0,2,2
73319,170,15624,20203;20731,41610,0,0,0,2,2
73320,170,15625,20787;20921,41610,0,0,0,2,2
73321,170,15626,20984;21268,41610,0,0,0,2,2
73322,170,15627,21320,41610,0,0,0,1,1
73323,170,15628,21447,41610,0,0,0,1,1
73324,170,15630,20902,41610,0,0,0,1,1
73325,170,15632,20674,41610,0,0,0,1,1
73326,170,15634,21012,41610,0,0,0,1,1
73327,170,15635,20923;25824;29051;29143,41610,2,0,1,1,4
73328,170,15636,21043,41610,0,0,0,1,1
73329,170,15637,21046,41610,0,0,0,1,1
73330,170,15639,21065,41610,0,0,0,1,1
73331,170,15640,21405,41610,0,0,0,1,1
73332,170,15641,20748;21097,41610,0,0,0,2,2
73333,170,15642,21066,41610,0,0,0,1,1
73334,170,15645,21157,41610,0,0,0,1,1
73335,170,15646,21579;21706,41610,0,0,0,2,2
73336,170,15648,24905,41610,0,0,1,0,1
73337,170,15649,21192,41610,0,0,0,1,1
73338,170,15650,20961;21423,41610,0,0,0,2,2
73339,170,15652,21299,41610,0,0,0,1,1
73340,170,15653,21413;21420,41610,0,0,0,2,2
73341,170,15654,20815;21482,41610,0,0,0,2,2
73342,170,15655,21342,41610,0,0,0,1,1
73343,170,15657,21388,41610,0,0,0,1,1
73344,170,15660,22036,41610,0,0,0,1,1
73345,170,15662,21249;21483,41610,0,0,0,2,2
73346,170,15664,21327,41610,0,0,0,1,1
73347,170,15665,22005;22108,41610,0,0,0,2,2
73348,170,15666,21409;21772,41610,0,0,0,2,2
73349,170,15667,21648;21973,41610,0,0,0,2,2
73350,170,15668,21232;21504,41610,0,0,0,2,2
73351,170,15669,21456,41610,0,0,0,1,1
73352,170,15670,21261;21660,41610,0,0,0,2,2
73353,170,15697,19883,41975,0,0,0,1,1
73354,170,15708,21132,41975,0,0,0,1,1
73355,170,15709,23968;24453;24944;27666;27894;28079;28172;28684,41975,0,4,4,0,8
73356,170,15710,19876;20095,41975,0,0,0,2,2
73357,170,15711,20706,41975,0,0,0,1,1
73358,170,15714,21206,41975,0,0,0,1,1
73359,170,15717,20735;21218;25651;27561,41975,0,0,2,2,4
73360,170,15718,20762,41975,0,0,0,1,1
73361,170,15722,20901,41975,0,0,0,1,1
73362,170,15723,20833,41975,0,0,0,1,1
73363,170,15724,20928;21129,41975,0,0,0,2,2
73364,170,15725,20633;21179,41975,0,0,0,2,2
73365,170,15726,21006,41975,0,0,0,1,1
73366,170,15727,21566,41975,0,0,0,1,1
73367,170,15729,21165,41975,0,0,0,1,1
73368,170,15730,21223,41975,0,0,0,1,1
73369,170,15732,21260;24908;28078;28341,41975,0,2,1,1,4
73370,170,15733,21116;21443,41975,0,0,0,2,2
73371,170,15735,21181,41975,0,0,0,1,1
73372,170,15740,21590,41975,0,0,0,1,1
73373,170,15741,21239,41975,0,0,0,1,1
73374,170,15742,21269,41975,0,0,0,1,1
73375,170,15743,21267;21284;25119,41975,0,0,1,2,3
73376,170,15744,21303,41975,0,0,0,1,1
73377,170,15745,21169;21450,41975,0,0,0,2,2
73378,170,15746,21375;21614,41975,0,0,0,2,2
73379,170,15747,21381,41975,0,0,0,1,1
73380,170,15748,21757,41975,0,0,0,1,1
73381,170,15749,21464;21953,41975,0,0,0,2,2
73382,170,15751,21539;21738,41975,0,0,0,2,2
73383,170,15752,22089,41975,0,0,0,1,1
73384,170,15753,21576;21652,41975,0,0,0,2,2
73385,170,15754,21559;22106,41975,0,0,0,2,2
73386,170,15755,21692;21970,41975,0,0,0,2,2
73387,170,15758,21829;22082,41975,0,0,0,2,2
73388,170,15759,21600;21800,41975,0,0,0,2,2
73389,170,15760,21707;22081,41975,0,0,0,2,2
73390,170,15763,21640,41975,0,0,0,1,1
73391,170,15764,21323;21895,41975,0,0,0,2,2
73392,170,15765,21444;21845,41975,0,0,0,2,2
73393,170,15767,21808,41975,0,0,0,1,1
73394,170,15769,21956,41975,0,0,0,1,1
73395,170,15771,21712,41975,0,0,0,1,1
73396,170,15772,21870;24952,41975,0,0,1,1,2
73397,170,15799,20137,42340,0,0,0,1,1
73398,170,15804,20088,42340,0,0,0,1,1
73399,170,15805,20511,42340,0,0,0,1,1
73400,170,15808,20508,42340,0,0,0,1,1
73401,170,15809,21178,42340,0,0,0,1,1
73402,170,15810,20371;20536,42340,0,0,0,2,2
73403,170,15811,20641,42340,0,0,0,1,1
73404,170,15813,20749,42340,0,0,0,1,1
73405,170,15815,21527,42340,0,0,0,1,1
73406,170,15816,20672,42340,0,0,0,1,1
73407,170,15818,20873,42340,0,0,0,1,1
73408,170,15819,20283;20951,42340,0,0,0,2,2
73409,170,15820,20551,42340,0,0,0,1,1
73410,170,15822,21237,42340,0,0,0,1,1
73411,170,15823,21623,42340,0,0,0,1,1
73412,170,15824,20693;21164,42340,0,0,0,2,2
73413,170,15825,21125;21496,42340,0,0,0,2,2
73414,170,15827,21197,42340,0,0,0,1,1
73415,170,15828,21148,42340,0,0,0,1,1
73416,170,15830,21212,42340,0,0,0,1,1
73417,170,15832,21225,42340,0,0,0,1,1
73418,170,15834,20653,42340,0,0,0,1,1
73419,170,15835,21264;21830,42340,0,0,0,2,2
73420,170,15836,21229;21334,42340,0,0,0,2,2
73421,170,15837,21346,42340,0,0,0,1,1
73422,170,15839,21635,42340,0,0,0,1,1
73423,170,15840,21063;21427,42340,0,0,0,2,2
73424,170,15841,21336;21522,42340,0,0,0,2,2
73425,170,15842,21529;25554,42340,0,0,1,1,2
73426,170,15843,21552;21575,42340,0,0,0,2,2
73427,170,15844,21561,42340,0,0,0,1,1
73428,170,15845,21222,42340,0,0,0,1,1
73429,170,15846,21551;21595,42340,0,0,0,2,2
73430,170,15847,21680,42340,0,0,0,1,1
73431,170,15848,21502;21872,42340,0,0,0,2,2
73432,170,15849,21721,42340,0,0,0,1,1
73433,170,15850,21448;21694,42340,0,0,0,2,2
73434,170,15851,21722,42340,0,0,0,1,1
73435,170,15853,22181,42340,0,0,0,1,1
73436,170,15854,21759,42340,0,0,0,1,1
73437,170,15855,21769,42340,0,0,0,1,1
73438,170,15856,21099;21532,42340,0,0,0,2,2
73439,170,15857,21461;21852,42340,0,0,0,2,2
73440,170,15859,21636;21804,42340,0,0,0,2,2
73441,170,15860,21817;22121,42340,0,0,0,2,2
73442,170,15861,21820,42340,0,0,0,1,1
73443,170,15862,21802;21861,42340,0,0,0,2,2
73444,170,15863,21386;21866,42340,0,0,0,2,2
73445,170,15864,21994,42340,0,0,0,1,1
73446,170,15900,19942,42705,0,0,0,1,1
73447,170,15901,20644,42705,0,0,0,1,1
73448,170,15906,20390,42705,0,0,0,1,1
73449,170,15908,20514,42705,0,0,0,1,1
73450,170,15910,21285,42705,0,0,0,1,1
73451,170,15911,20741,42705,0,0,0,1,1
73452,170,15912,21255,42705,0,0,0,1,1
73453,170,15915,21154;21194,42705,0,0,0,2,2
73454,170,15916,21265,42705,0,0,0,1,1
73455,170,15917,21305;21885,42705,0,0,0,2,2
73456,170,15918,21309,42705,0,0,0,1,1
73457,170,15919,21353;21416,42705,0,0,0,2,2
73458,170,15922,21216;21410,42705,0,0,0,2,2
73459,170,15924,21417;21688,42705,0,0,0,2,2
73460,170,15926,21874;25369,42705,0,0,1,1,2
73461,170,15927,21728;22175,42705,0,0,0,2,2
73462,170,15929,21571,42705,0,0,0,1,1
73463,170,15931,21452;26025,42705,0,0,1,1,2
73464,170,15933,21740,42705,0,0,0,1,1
73465,170,15935,21484;21751,42705,0,0,0,2,2
73466,170,15936,22168;22356,42705,0,0,0,2,2
73467,170,15937,21531;21675,42705,0,0,0,2,2
73468,170,15938,21766;22013,42705,0,0,0,2,2
73469,170,15939,21567,42705,0,0,0,1,1
73470,170,15940,21917,42705,0,0,0,1,1
73471,170,15941,21492,42705,0,0,0,1,1
73472,170,15942,21612;22188,42705,0,0,0,2,2
73473,170,15943,21384;21625,42705,0,0,0,2,2
73474,170,15944,21957,42705,0,0,0,1,1
73475,170,15945,21466;21654,42705,0,0,0,2,2
73476,170,15947,22227;22312,42705,0,0,0,2,2
73477,170,15948,21792;21911,42705,0,0,0,2,2
73478,170,15949,21742;21849,42705,0,0,0,2,2
73479,170,15950,22237,42705,0,0,0,1,1
73480,170,15951,21646;21921,42705,0,0,0,2,2
73481,170,15952,21240;21807,42705,0,0,0,2,2
73482,170,15953,21810;22095,42705,0,0,0,2,2
73483,170,15955,22031;22196,42705,0,0,0,2,2
73484,170,15956,22104,42705,0,0,0,1,1
73485,170,15957,22271;22286,42705,0,0,0,2,2
73486,170,15958,22009;22025,42705,0,0,0,2,2
73487,170,15959,21602;22149,42705,0,0,0,2,2
73488,170,15960,21524;21843,42705,0,0,0,2,2
73489,170,15961,21881;21892,42705,0,0,0,2,2
73490,170,15962,22302,42705,0,0,0,1,1
73491,170,15963,21880;21894,42705,0,0,0,2,2
73492,170,15964,21704;21906;25370;27732;28699,42705,0,1,2,2,5
73493,170,15965,21946,42705,0,0,0,1,1
73494,170,15966,21578;21977,42705,0,0,0,2,2
73495,170,15967,21331;22023,42705,0,0,0,2,2
73496,170,15989,19524,43070,0,0,0,1,1
73497,170,15996,20729,43070,0,0,0,1,1
73498,170,16000,20700,43070,0,0,0,1,1
73499,170,16004,20747,43070,0,0,0,1,1
73500,170,16009,20587,43070,0,0,0,1,1
73501,170,16011,20512;20676,43070,0,0,0,2,2
73502,170,16017,20817;21390,43070,0,0,0,2,2
73503,170,16018,20529;20910,43070,0,0,0,2,2
73504,170,16020,21501,43070,0,0,0,1,1
73505,170,16021,20987;21518,43070,0,0,0,2,2
73506,170,16022,21075;21350,43070,0,0,0,2,2
73507,170,16027,21836,43070,0,0,0,1,1
73508,170,16028,21716,43070,0,0,0,1,1
73509,170,16029,21282,43070,0,0,0,1,1
73510,170,16030,21512,43070,0,0,0,1,1
73511,170,16031,21083;21321,43070,0,0,0,2,2
73512,170,16032,21134;21329,43070,0,0,0,2,2
73513,170,16033,21607,43070,0,0,0,1,1
73514,170,16034,21245,43070,0,0,0,1,1
73515,170,16036,21426;21839,43070,0,0,0,2,2
73516,170,16037,20719;21437,43070,0,0,0,2,2
73517,170,16038,21311;21510,43070,0,0,0,2,2
73518,170,16039,21629,43070,0,0,0,1,1
73519,170,16040,21988,43070,0,0,0,1,1
73520,170,16041,21664,43070,0,0,0,1,1
73521,170,16042,21621;21768,43070,0,0,0,2,2
73522,170,16043,21702,43070,0,0,0,1,1
73523,170,16044,21703,43070,0,0,0,1,1
73524,170,16045,21989;22236,43070,0,0,0,2,2
73525,170,16047,21720;22003,43070,0,0,0,2,2
73526,170,16048,21431;21530,43070,0,0,0,2,2
73527,170,16049,21433;21771,43070,0,0,0,2,2
73528,170,16050,21775;22391,43070,0,0,0,2,2
73529,170,16051,21798;22354,43070,0,0,0,2,2
73530,170,16052,21809,43070,0,0,0,1,1
73531,170,16053,21569;21841,43070,0,0,0,2,2
73532,170,16055,21790;22241,43070,0,0,0,2,2
73533,170,16056,21883,43070,0,0,0,1,1
73534,170,16057,22073;22080,43070,0,0,0,2,2
73535,170,16059,21942;22034,43070,0,0,0,2,2
73536,170,16060,22178,43070,0,0,0,1,1
73537,170,16062,22010,43070,0,0,0,1,1
73538,170,16063,22287,43070,0,0,0,1,1
73539,170,16064,22043;22045,43070,0,0,0,2,2
73540,170,16065,21896,43070,0,0,0,1,1
73541,170,16066,21916;22584,43070,0,0,0,2,2
73542,170,16068,21312;22094,43070,0,0,0,2,2
73543,170,16069,22092;22111;24746,43070,0,0,1,2,3
73544,170,16070,22113,43070,0,0,0,1,1
73545,170,16071,21930;22240,43070,0,0,0,2,2
73546,170,16072,22146,43070,0,0,0,1,1
73547,170,16073,22032;22148,43070,0,0,0,2,2
73548,170,16105,20812,43435,0,0,0,1,1
73549,170,16107,21056,43435,0,0,0,1,1
73550,170,16110,20847;21091,43435,0,0,0,2,2
73551,170,16113,21339,43435,0,0,0,1,1
73552,170,16115,20970;21067,43435,0,0,0,2,2
73553,170,16118,20949;21131,43435,0,0,0,2,2
73554,170,16119,21147;21407,43435,0,0,0,2,2
73555,170,16120,20986,43435,0,0,0,1,1
73556,170,16121,21128;21211,43435,0,0,0,2,2
73557,170,16122,21143;21300,43435,0,0,0,2,2
73558,170,16123,21709,43435,0,0,0,1,1
73559,170,16124,21230;21322,43435,0,0,0,2,2
73560,170,16125,21644;21987,43435,0,0,0,2,2
73561,170,16126,21171;21361,43435,0,0,0,2,2
73562,170,16127,21459,43435,0,0,0,1,1
73563,170,16128,21378,43435,0,0,0,1,1
73564,170,16129,21481,43435,0,0,0,1,1
73565,170,16130,21980,43435,0,0,0,1,1
73566,170,16133,21589,43435,0,0,0,1,1
73567,170,16134,21975,43435,0,0,0,1,1
73568,170,16135,21902,43435,0,0,0,1,1
73569,170,16136,21853;21897,43435,0,0,0,2,2
73570,170,16138,21684;21939,43435,0,0,0,2,2
73571,170,16139,22061,43435,0,0,0,1,1
73572,170,16140,21733;22492;26220,43435,0,0,1,2,3
73573,170,16141,21271;21748,43435,0,0,0,2,2
73574,170,16143,21314;21780,43435,0,0,0,2,2
73575,170,16144,22187,43435,0,0,0,1,1
73576,170,16145,21604;21931,43435,0,0,0,2,2
73577,170,16146,21540;21863,43435,0,0,0,2,2
73578,170,16147,22378,43435,0,0,0,1,1
73579,170,16148,21827,43435,0,0,0,1,1
73580,170,16150,21088;21912;25255,43435,0,0,1,2,3
73581,170,16151,21922;22261;25271;27915,43435,0,1,1,2,4
73582,170,16152,21933,43435,0,0,0,1,1
73583,170,16154,22091,43435,0,0,0,1,1
73584,170,16155,22120;22306,43435,0,0,0,2,2
73585,170,16156,21708;22098,43435,0,0,0,2,2
73586,170,16157,22017;22410,43435,0,0,0,2,2
73587,170,16158,21797,43435,0,0,0,1,1
73588,170,16159,22064;22125,43435,0,0,0,2,2
73589,170,16160,22074;22438,43435,0,0,0,2,2
73590,170,16161,22182;22305,43435,0,0,0,2,2
73591,170,16162,22076;22299,43435,0,0,0,2,2
73592,170,16163,22078;22502,43435,0,0,0,2,2
73593,170,16165,22019;22359,43435,0,0,0,2,2
73594,170,16166,22100;22276,43435,0,0,0,2,2
73595,170,16167,21971;22293,43435,0,0,0,2,2
73596,170,16168,22145;22162,43435,0,0,0,2,2
73597,170,16169,22330;22478,43435,0,0,0,2,2
73598,170,16170,22177;22423,43435,0,0,0,2,2
73599,170,16171,22180,43435,0,0,0,1,1
73600,170,16173,22218;22321,43435,0,0,0,2,2
73601,170,16174,21919;22267,43435,0,0,0,2,2
73602,170,16175,22274;22385;26419,43435,0,0,1,2,3
73603,170,16209,20115,43800,0,0,0,1,1
73604,170,16211,20722,43800,0,0,0,1,1
73605,170,16214,20290;20479,43800,0,0,0,2,2
73606,170,16221,21210,43800,0,0,0,1,1
73607,170,16223,20436;20518,43800,0,0,0,2,2
73608,170,16225,20564;20754,43800,0,0,0,2,2
73609,170,16226,20864;21199,43800,0,0,0,2,2
73610,170,16228,20320;20630,43800,0,0,0,2,2
73611,170,16230,21013,43800,0,0,0,1,1
73612,170,16231,21615,43800,0,0,0,1,1
73613,170,16232,21687,43800,0,0,0,1,1
73614,170,16235,21332,43800,0,0,0,1,1
73615,170,16236,21251,43800,0,0,0,1,1
73616,170,16237,20996;21272,43800,0,0,0,2,2
73617,170,16239,21735;22028,43800,0,0,0,2,2
73618,170,16240,21924;22212,43800,0,0,0,2,2
73619,170,16241,21643;22050,43800,0,0,0,2,2
73620,170,16242,21511,43800,0,0,0,1,1
73621,170,16243,21024;21520,43800,0,0,0,2,2
73622,170,16245,21564,43800,0,0,0,1,1
73623,170,16246,21711,43800,0,0,0,1,1
73624,170,16248,21533;21681,43800,0,0,0,2,2
73625,170,16249,20854,43800,0,0,0,1,1
73626,170,16250,21468;21631,43800,0,0,0,2,2
73627,170,16251,25669;26111,43800,0,0,2,0,2
73628,170,16252,21451;21856,43800,0,0,0,2,2
73629,170,16253,22164;22413,43800,0,0,0,2,2
73630,170,16255,21823;22099,43800,0,0,0,2,2
73631,170,16256,21842,43800,0,0,0,1,1
73632,170,16257,21507;21867,43800,0,0,0,2,2
73633,170,16258,22079;22266,43800,0,0,0,2,2
73634,170,16259,21891,43800,0,0,0,1,1
73635,170,16260,21854;22426,43800,0,0,0,2,2
73636,170,16262,21391;21831,43800,0,0,0,2,2
73637,170,16265,22007;22474,43800,0,0,0,2,2
73638,170,16266,21498;22062,43800,0,0,0,2,2
73639,170,16267,21776;22303,43800,0,0,0,2,2
73640,170,16268,21795;22169,43800,0,0,0,2,2
73641,170,16269,22129,43800,0,0,0,1,1
73642,170,16270,22208;22546,43800,0,0,0,2,2
73643,170,16271,21779;22154,43800,0,0,0,2,2
73644,170,16272,22138;22159,43800,0,0,0,2,2
73645,170,16275,21632;22048,43800,0,0,0,2,2
73646,170,16276,22680,43800,0,0,0,1,1
73647,170,16278,22252;22331,43800,0,0,0,2,2
73648,170,16279,22269;22542,43800,0,0,0,2,2
73649,170,16280,22337,43800,0,0,0,1,1
73650,170,16281,22300;22506,43800,0,0,0,2,2
73651,170,16282,22319,43800,0,0,0,1,1
73652,170,16283,22493;22613,43800,0,0,0,2,2
73653,170,16284,22471,43800,0,0,0,1,1
73654,170,16285,22115;22347;26507;28316,43800,0,1,1,2,4
73655,170,16286,22249;22379,43800,0,0,0,2,2
73656,170,16287,22343;22380,43800,0,0,0,2,2
73657,170,16288,26232;26563;29102,43800,1,0,2,0,3
73658,170,16314,24647;25083;28351,44165,0,1,2,0,3
73659,170,16317,20402,44165,0,0,0,1,1
73660,170,16318,20703,44165,0,0,0,1,1
73661,170,16319,20803,44165,0,0,0,1,1
73662,170,16320,20963,44165,0,0,0,1,1
73663,170,16322,21618,44165,0,0,0,1,1
73664,170,16325,20750;21221,44165,0,0,0,2,2
73665,170,16327,21341,44165,0,0,0,1,1
73666,170,16328,21541;21731,44165,0,0,0,2,2
73667,170,16329,21788;21981,44165,0,0,0,2,2
73668,170,16330,22117,44165,0,0,0,1,1
73669,170,16332,22112;22425,44165,0,0,0,2,2
73670,170,16333,22015;22499,44165,0,0,0,2,2
73671,170,16334,21274,44165,0,0,0,1,1
73672,170,16335,21781,44165,0,0,0,1,1
73673,170,16336,21786,44165,0,0,0,1,1
73674,170,16337,21755;21789;25050;28349;28511,44165,0,2,1,2,5
73675,170,16338,21824;21927,44165,0,0,0,2,2
73676,170,16339,21454;21860,44165,0,0,0,2,2
73677,170,16340,21890;21943,44165,0,0,0,2,2
73678,170,16341,21538;21951,44165,0,0,0,2,2
73679,170,16342,21952;22044,44165,0,0,0,2,2
73680,170,16343,21689;21974,44165,0,0,0,2,2
73681,170,16345,22060,44165,0,0,0,1,1
73682,170,16346,22093,44165,0,0,0,1,1
73683,170,16348,22055;22070,44165,0,0,0,2,2
73684,170,16350,22543,44165,0,0,0,1,1
73685,170,16351,22176;22662,44165,0,0,0,2,2
73686,170,16352,22216;22592,44165,0,0,0,2,2
73687,170,16353,26026,44165,0,0,1,0,1
73688,170,16355,22547,44165,0,0,0,1,1
73689,170,16358,22341;22574,44165,0,0,0,2,2
73690,170,16359,21851;22446,44165,0,0,0,2,2
73691,170,16360,22489;22598,44165,0,0,0,2,2
73692,170,16361,21944;22498,44165,0,0,0,2,2
73693,170,16371,19590,44530,0,0,0,1,1
73694,170,16374,19467,44530,0,0,0,1,1
73695,170,16375,20148,44530,0,0,0,1,1
73696,170,16382,19939,44530,0,0,0,1,1
73697,170,16387,20018;20399,44530,0,0,0,2,2
73698,170,16393,20899;21620,44530,0,0,0,2,2
73699,170,16395,21005;21445,44530,0,0,0,2,2
73700,170,16396,21655,44530,0,0,0,1,1
73701,170,16400,21238;21535,44530,0,0,0,2,2
73702,170,16402,21338;21514,44530,0,0,0,2,2
73703,170,16403,21061;25217;28264,44530,0,1,1,1,3
73704,170,16404,21244;21385,44530,0,0,0,2,2
73705,170,16405,21762,44530,0,0,0,1,1
73706,170,16406,25556;27464;28016;28704;29040,44530,1,2,2,0,5
73707,170,16407,21627,44530,0,0,0,1,1
73708,170,16408,22142,44530,0,0,0,1,1
73709,170,16409,21584;21651,44530,0,0,0,2,2
73710,170,16410,22150,44530,0,0,0,1,1
73711,170,16411,21634,44530,0,0,0,1,1
73712,170,16412,21739;21793,44530,0,0,0,2,2
73713,170,16413,21749;21785,44530,0,0,0,2,2
73714,170,16415,21599;22273,44530,0,0,0,2,2
73715,170,16416,21963;27423,44530,0,0,1,1,2
73716,170,16420,21991,44530,0,0,0,1,1
73717,170,16421,22335,44530,0,0,0,1,1
73718,170,16422,22090,44530,0,0,0,1,1
73719,170,16423,22894,44530,0,0,0,1,1
73720,170,16424,22119;22307,44530,0,0,0,2,2
73721,170,16425,22198;22779,44530,0,0,0,2,2
73722,170,16426,22280,44530,0,0,0,1,1
73723,170,16427,22170;22281;25273;27916;28267;29029,44530,1,2,1,2,6
73724,170,16430,22358,44530,0,0,0,1,1
73725,170,16431,22372;22440,44530,0,0,0,2,2
73726,170,16432,22406;22477,44530,0,0,0,2,2
73727,170,16436,22491;22527,44530,0,0,0,2,2
73728,170,16437,22717;26051,44530,0,0,1,1,2
73729,170,16438,22225;22531,44530,0,0,0,2,2
73730,170,16439,22329;22550,44530,0,0,0,2,2
73731,170,16440,22799,44530,0,0,0,1,1
73732,170,16441,21815;22238,44530,0,0,0,2,2
73733,170,16442,22725;22870,44530,0,0,0,2,2
73734,170,16443,22325;22588,44530,0,0,0,2,2
73735,170,16444,22567;22599,44530,0,0,0,2,2
73736,170,16483,20410,44895,0,0,0,1,1
73737,170,16485,20744,44895,0,0,0,1,1
73738,170,16487,20886;21296,44895,0,0,0,2,2
73739,170,16488,21136;21360,44895,0,0,0,2,2
73740,170,16489,21247,44895,0,0,0,1,1
73741,170,16490,21198,44895,0,0,0,1,1
73742,170,16492,22004,44895,0,0,0,1,1
73743,170,16496,21581;21603,44895,0,0,0,2,2
73744,170,16497,21585;21700;24830,44895,0,0,1,2,3
73745,170,16500,21918;22324,44895,0,0,0,2,2
73746,170,16501,21396,44895,0,0,0,1,1
73747,170,16502,21737,44895,0,0,0,1,1
73748,170,16503,21954;22057,44895,0,0,0,2,2
73749,170,16504,22283;22422,44895,0,0,0,2,2
73750,170,16505,21348;22018,44895,0,0,0,2,2
73751,170,16506,22248;22428,44895,0,0,0,2,2
73752,170,16507,21846;21928,44895,0,0,0,2,2
73753,170,16508,22126;22268;25272,44895,0,0,1,2,3
73754,170,16510,21898;22024,44895,0,0,0,2,2
73755,170,16511,22361;22424,44895,0,0,0,2,2
73756,170,16512,21941;22127,44895,0,0,0,2,2
73757,170,16514,22105;22152,44895,0,0,0,2,2
73758,170,16515,22458,44895,0,0,0,1,1
73759,170,16516,22174;25848;27932;28563;28960;29053,44895,2,2,1,1,6
73760,170,16518,22202;22620;26329,44895,0,0,1,2,3
73761,170,16520,21915;22496;26221,44895,0,0,1,2,3
73762,170,16521,21796;22289;26415,44895,0,0,1,2,3
73763,170,16523,22339;22671,44895,0,0,0,2,2
73764,170,16524,22349,44895,0,0,0,1,1
73765,170,16526,22765,44895,0,0,0,1,1
73766,170,16527,23856;24530;27776;27966,44895,0,2,2,0,4
73767,170,16529,22403;22785,44895,0,0,0,2,2
73768,170,16530,21787;21990,44895,0,0,0,2,2
73769,170,16531,22194;22838,44895,0,0,0,2,2
73770,170,16532,22386;22420,44895,0,0,0,2,2
73771,170,16533,22348;22421,44895,0,0,0,2,2
73772,170,16535,22451;23007,44895,0,0,1,1,2
73773,170,16536,22323;26218;29164;29247,44895,2,0,1,1,4
73774,170,16537,22453;22503,44895,0,0,0,2,2
73775,170,16538,22448;22866,44895,0,0,0,2,2
73776,170,16540,22459;22461,44895,0,0,0,2,2
73777,170,16541,22479;22537,44895,0,0,0,2,2
73778,170,16544,22301;22612,44895,0,0,0,2,2
73779,170,16545,22304;22630,44895,0,0,0,2,2
73780,170,16546,22601;23011,44895,0,0,1,1,2
73781,170,16547,22317;22609,44895,0,0,0,2,2
73782,170,16548,22435;22614,44895,0,0,0,2,2
73783,170,16549,22367;22615,44895,0,0,0,2,2
73784,170,16550,22618;22670,44895,0,0,0,2,2
73785,170,16551,22719;22790,44895,0,0,0,2,2
73786,170,16552,22396;22929,44895,0,0,0,2,2
73787,170,16553,22839;22961,44895,0,0,1,1,2
73788,170,16554,21962;22695,44895,0,0,0,2,2
73789,170,16555,22209;22712;26135;28134;28577;28742;29160,44895,1,3,1,2,7
73790,170,16556,22720,44895,0,0,0,1,1
73791,170,16579,20776,45260,0,0,0,1,1
73792,170,16589,20573,45260,0,0,0,1,1
73793,170,16594,21457;21746,45260,0,0,0,2,2
73794,170,16595,21693,45260,0,0,0,1,1
73795,170,16596,21727,45260,0,0,0,1,1
73796,170,16597,21469;21965;26718,45260,0,0,1,2,3
73797,170,16598,22199,45260,0,0,0,1,1
73798,170,16599,21491,45260,0,0,0,1,1
73799,170,16602,21428;21610,45260,0,0,0,2,2
73800,170,16603,21673;22258,45260,0,0,0,2,2
73801,170,16604,21937;22189;25939,45260,0,0,1,2,3
73802,170,16606,21998;22052,45260,0,0,0,2,2
73803,170,16607,21871,45260,0,0,0,1,1
73804,170,16609,21741,45260,0,0,0,1,1
73805,170,16611,22591;26328,45260,0,0,1,1,2
73806,170,16612,21976,45260,0,0,0,1,1
73807,170,16613,21983,45260,0,0,0,1,1
73808,170,16614,21715;22226,45260,0,0,0,2,2
73809,170,16615,22247;22384,45260,0,0,0,2,2
73810,170,16616,22051;22322,45260,0,0,0,2,2
73811,170,16617,22058,45260,0,0,0,1,1
73812,170,16618,21960;22619,45260,0,0,0,2,2
73813,170,16619,22357;22634;26930,45260,0,0,1,2,3
73814,170,16621,22173,45260,0,0,0,1,1
73815,170,16622,22817,45260,0,0,0,1,1
73816,170,16623,22688;27377,45260,0,0,1,1,2
73817,170,16624,21999;22206,45260,0,0,0,2,2
73818,170,16626,21966;22456,45260,0,0,0,2,2
73819,170,16627,22296;22437,45260,0,0,0,2,2
73820,170,16628,22346;22645;26230,45260,0,0,1,2,3
73821,170,16629,21904;22350,45260,0,0,0,2,2
73822,170,16630,22382;22741;26815,45260,0,0,1,2,3
73823,170,16631,22752;26617,45260,0,0,1,1,2
73824,170,16632,22310;22434,45260,0,0,0,2,2
73825,170,16634,21868;22284,45260,0,0,0,2,2
73826,170,16636,22575;22730,45260,0,0,0,2,2
73827,170,16637,22600,45260,0,0,0,1,1
73828,170,16639,22744;22833,45260,0,0,0,2,2
73829,170,16640,22963;23062,45260,0,0,2,0,2
73830,170,16641,22433;22823,45260,0,0,0,2,2
73831,170,16642,22918,45260,0,0,0,1,1
73832,170,16644,22192;26139;26817,45260,0,0,2,1,3
73833,170,16646,22973;26536,45260,0,0,2,0,2
73834,170,16647,22705;22811,45260,0,0,0,2,2
73835,170,16648,22643;23034,45260,0,0,1,1,2
73836,170,16678,19807,45625,0,0,0,1,1
73837,170,16694,21682,45625,0,0,0,1,1
73838,170,16695,21343,45625,0,0,0,1,1
73839,170,16698,21373;21557,45625,0,0,0,2,2
73840,170,16699,21985,45625,0,0,0,1,1
73841,170,16700,20860;21548,45625,0,0,0,2,2
73842,170,16701,21355;21858,45625,0,0,0,2,2
73843,170,16703,22184,45625,0,0,0,1,1
73844,170,16704,22027,45625,0,0,0,1,1
73845,170,16706,21893,45625,0,0,0,1,1
73846,170,16708,21909,45625,0,0,0,1,1
73847,170,16711,22518;25408,45625,0,0,1,1,2
73848,170,16714,22407;22466;26510,45625,0,0,1,2,3
73849,170,16715,22186,45625,0,0,0,1,1
73850,170,16717,22086;22309,45625,0,0,0,2,2
73851,170,16718,22239;22659,45625,0,0,0,2,2
73852,170,16719,21628;22160,45625,0,0,0,2,2
73853,170,16720,22068;22191,45625,0,0,0,2,2
73854,170,16721,22210;25593,45625,0,0,1,1,2
73855,170,16723,22623,45625,0,0,0,1,1
73856,170,16725,22075;22203,45625,0,0,0,2,2
73857,170,16727,22277;22441,45625,0,0,0,2,2
73858,170,16728,22648,45625,0,0,0,1,1
73859,170,16729,22374;22429,45625,0,0,0,2,2
73860,170,16730,22409,45625,0,0,0,1,1
73861,170,16731,22197;22431,45625,0,0,0,2,2
73862,170,16732,22445;22519,45625,0,0,0,2,2
73863,170,16733,22853,45625,0,0,0,1,1
73864,170,16734,22514,45625,0,0,0,1,1
73865,170,16735,22376;22540,45625,0,0,0,2,2
73866,170,16736,22545;22669,45625,0,0,0,2,2
73867,170,16737,22596;22616;26616,45625,0,0,1,2,3
73868,170,16739,22200;22624,45625,0,0,0,2,2
73869,170,16740,22627;22967,45625,0,0,1,1,2
73870,170,16741,22660;22733,45625,0,0,0,2,2
73871,170,16743,22678;23084;27188,45625,0,0,2,1,3
73872,170,16744,22053;22495,45625,0,0,0,2,2
73873,170,16745,22704;23068,45625,0,0,1,1,2
73874,170,16746,22389;22548,45625,0,0,0,2,2
73875,170,16747,22713;23021,45625,0,0,1,1,2
73876,170,16749,22571;22826,45625,0,0,0,2,2
73877,170,16750,22986,45625,0,0,1,0,1
73878,170,16751,22832,45625,0,0,0,1,1
73879,170,16752,22979;23178;26841,45625,0,0,3,0,3
73880,170,16755,22925,45625,0,0,0,1,1
73881,170,16756,22871;22958,45625,0,0,1,1,2
73882,170,16757,23027;23169,45625,0,0,2,0,2
73883,170,16758,22342;22893,45625,0,0,0,2,2
73884,170,16759,22909;26533;28917;29175,45625,2,0,1,1,4
73885,170,16760,22912;26733;27005;27105;28838;29289,45625,1,1,3,1,6
73886,170,16761,22915;23098,45625,0,0,1,1,2
73887,170,16762,23080,45625,0,0,1,0,1
73888,170,16796,21050,45990,0,0,0,1,1
73889,170,16799,21098;21315;25121,45990,0,0,1,2,3
73890,170,16803,21476;21593,45990,0,0,0,2,2
73891,170,16805,21477;21782,45990,0,0,0,2,2
73892,170,16807,21834;21914,45990,0,0,0,2,2
73893,170,16808,21665;21783,45990,0,0,0,2,2
73894,170,16810,21967;22141,45990,0,0,0,2,2
73895,170,16812,21553,45990,0,0,0,1,1
73896,170,16813,22114,45990,0,0,0,1,1
73897,170,16815,21536;22033,45990,0,0,0,2,2
73898,170,16818,22102;22664;26231;28814,45990,0,1,1,2,4
73899,170,16819,22143;22524,45990,0,0,0,2,2
73900,170,16820,22687;22792,45990,0,0,0,2,2
73901,170,16821,22205;22715,45990,0,0,0,2,2
73902,170,16822,22217;22388,45990,0,0,0,2,2
73903,170,16824,22263;22585;26814,45990,0,0,1,2,3
73904,170,16826,22328;22562,45990,0,0,0,2,2
73905,170,16829,22243;22467,45990,0,0,0,2,2
73906,170,16830,22487;23067;27187,45990,0,0,2,1,3
73907,170,16831,21791;22462,45990,0,0,0,2,2
73908,170,16832,22500;22738,45990,0,0,0,2,2
73909,170,16833,22709,45990,0,0,0,1,1
73910,170,16834,22523,45990,0,0,0,1,1
73911,170,16835,22525;22536,45990,0,0,0,2,2
73912,170,16836,22172;22551,45990,0,0,0,2,2
73913,170,16837,22564;22587,45990,0,0,0,2,2
73914,170,16838,22927;23125,45990,0,0,1,1,2
73915,170,16839,22728,45990,0,0,0,1,1
73916,170,16841,22649;22698,45990,0,0,0,2,2
73917,170,16842,22994,45990,0,0,1,0,1
73918,170,16843,22727;22757,45990,0,0,0,2,2
73919,170,16844,22743;22815;26431,45990,0,0,1,2,3
73920,170,16846,22766;22846,45990,0,0,0,2,2
73921,170,16847,22822,45990,0,0,0,1,1
73922,170,16848,22450;22825,45990,0,0,0,2,2
73923,170,16849,22001;22827,45990,0,0,0,2,2
73924,170,16850,22640;22849,45990,0,0,0,2,2
73925,170,16851,22868;23324,45990,0,0,1,1,2
73926,170,16852,23296;26943;27468,45990,0,0,3,0,3
73927,170,16853,22891;26532;29174,45990,1,0,1,1,3
73928,170,16854,22910;23103;26742,45990,0,0,2,1,3
73929,170,16855,22987;23047,45990,0,0,2,0,2
73930,170,16856,23315;23615;26555;27746;28587;28918,45990,1,2,3,0,6
73931,170,16857,22684;22952,45990,0,0,1,1,2
73932,170,16858,22906;23247,45990,0,0,1,1,2
73933,170,16859,22611;22965,45990,0,0,1,1,2
73934,170,16860,23314,45990,0,0,1,0,1
73935,170,16861,22769,45990,0,0,0,1,1
73936,170,16862,22755;23023;26351,45990,0,0,2,1,3
73937,170,16863,22557,45990,0,0,0,1,1
73938,170,16864,22544;25977,45990,0,0,1,1,2
73939,170,16880,19734,46355,0,0,0,1,1
73940,170,16881,20004,46355,0,0,0,1,1
73941,170,16882,20005,46355,0,0,0,1,1
73942,170,16895,20475,46355,0,0,0,1,1
73943,170,16896,21256;21574,46355,0,0,0,2,2
73944,170,16898,21855,46355,0,0,0,1,1
73945,170,16900,21357;21572,46355,0,0,0,2,2
73946,170,16901,21344;21505,46355,0,0,0,2,2
73947,170,16902,21656,46355,0,0,0,1,1
73948,170,16904,21195;21676,46355,0,0,0,2,2
73949,170,16905,22244;22254,46355,0,0,0,2,2
73950,170,16907,21458;21697,46355,0,0,0,2,2
73951,170,16908,21778;21945,46355,0,0,0,2,2
73952,170,16910,21487,46355,0,0,0,1,1
73953,170,16911,22049;22460,46355,0,0,0,2,2
73954,170,16915,22259,46355,0,0,0,1,1
73955,170,16917,22065;22533,46355,0,0,0,2,2
73956,170,16918,22724,46355,0,0,0,1,1
73957,170,16920,22777,46355,0,0,0,1,1
73958,170,16921,22454;25288,46355,0,0,1,1,2
73959,170,16922,22480,46355,0,0,0,1,1
73960,170,16924,22528,46355,0,0,0,1,1
73961,170,16926,22736;26524,46355,0,0,1,1,2
73962,170,16928,22731;22942,46355,0,0,1,1,2
73963,170,16929,22751;26433,46355,0,0,1,1,2
73964,170,16930,22852;26145;26530;26820;28416,46355,0,1,3,1,5
73965,170,16932,25900;26451;28667,46355,0,1,2,0,3
73966,170,16933,22316;22828,46355,0,0,0,2,2
73967,170,16934,22831;22966,46355,0,0,1,1,2
73968,170,16935,22841;23085;26635,46355,0,0,2,1,3
73969,170,16936,23202,46355,0,0,1,0,1
73970,170,16937,22589;22867,46355,0,0,0,2,2
73971,170,16938,23082;23149,46355,0,0,2,0,2
73972,170,16939,22415;23181;26842,46355,0,0,2,1,3
73973,170,16940,22753;22922,46355,0,0,0,2,2
73974,170,16941,22916;22936;26059;27935;29152,46355,1,1,2,1,5
73975,170,16942,22956;23278,46355,0,0,2,0,2
73976,170,16943,22521;22970;26627,46355,0,0,2,1,3
73977,170,16944,23002;23040;26246,46355,0,0,3,0,3
73978,170,16945,22517;23006,46355,0,0,1,1,2
73979,170,16946,22747;23269,46355,0,0,1,1,2
73980,170,16947,22617;22978,46355,0,0,1,1,2
73981,170,16949,22770;23095,46355,0,0,1,1,2
73982,170,16950,23017;23077;26835,46355,0,0,3,0,3
73983,170,16951,23056;23093,46355,0,0,2,0,2
73984,170,16952,23241,46355,0,0,1,0,1
73985,170,16954,23321;23350;26650,46355,0,0,3,0,3
73986,170,16955,23123;23189;26544;26637,46355,0,0,4,0,4
73987,170,16956,22607,46355,0,0,0,1,1
73988,170,16979,19912,46720,0,0,0,1,1
73989,170,16994,20825;21016,46720,0,0,0,2,2
73990,170,16997,21106,46720,0,0,0,1,1
73991,170,16998,21374;22030,46720,0,0,0,2,2
73992,170,16999,21333;21367,46720,0,0,0,2,2
73993,170,17000,21365;21764;25563;28378;28540,46720,0,2,1,2,5
73994,170,17001,21096;21408,46720,0,0,0,2,2
73995,170,17002,22029;22315,46720,0,0,0,2,2
73996,170,17003,21418,46720,0,0,0,1,1
73997,170,17012,22362,46720,0,0,0,1,1
73998,170,17013,22242;22298,46720,0,0,0,2,2
73999,170,17014,22294,46720,0,0,0,1,1
74000,170,17015,21814;22156,46720,0,0,0,2,2
74001,170,17016,22402,46720,0,0,0,1,1
74002,170,17018,22308;23161,46720,0,0,1,1,2
74003,170,17019,22552,46720,0,0,0,1,1
74004,170,17020,22071;22345,46720,0,0,0,2,2
74005,170,17021,22400;22887,46720,0,0,0,2,2
74006,170,17022,22418,46720,0,0,0,1,1
74007,170,17023,22793;26619;28673;29000,46720,1,1,1,1,4
74008,170,17025,22452;22569,46720,0,0,0,2,2
74009,170,17026,22572,46720,0,0,0,1,1
74010,170,17027,22742;23225,46720,0,0,1,1,2
74011,170,17028,22778;23038,46720,0,0,1,1,2
74012,170,17029,22656,46720,0,0,0,1,1
74013,170,17030,22646;23226,46720,0,0,1,1,2
74014,170,17031,22921;23235;27107,46720,0,0,2,1,3
74015,170,17032,22693;23173;27378;27565,46720,0,0,3,1,4
74016,170,17033,22892,46720,0,0,0,1,1
74017,170,17035,22791,46720,0,0,0,1,1
74018,170,17037,22161;22851,46720,0,0,0,2,2
74019,170,17038,22900;22948,46720,0,0,1,1,2
74020,170,17039,23026;23171,46720,0,0,2,0,2
74021,170,17040,22901;23238,46720,0,0,1,1,2
74022,170,17041,22904;23094,46720,0,0,1,1,2
74023,170,17042,22913,46720,0,0,0,1,1
74024,170,17043,23491,46720,0,0,1,0,1
74025,170,17045,22595;22954,46720,0,0,1,1,2
74026,170,17046,22650;22977;26243,46720,0,0,2,1,3
74027,170,17047,22995,46720,0,0,1,0,1
74028,170,17048,22996,46720,0,0,1,0,1
74029,170,17050,23217;23459,46720,0,0,2,0,2
74030,170,17051,23249;23311,46720,0,0,2,0,2
74031,170,17052,23053;23100,46720,0,0,2,0,2
74032,170,17053,23109;23260;27191,46720,0,0,3,0,3
74033,170,17054,22879;26624,46720,0,0,1,1,2
74034,170,17055,23124;23528,46720,0,0,2,0,2
74035,170,17056,23293;23355,46720,0,0,2,0,2
74036,170,17057,22903;23290,46720,0,0,1,1,2
74037,170,17058,23196,46720,0,0,1,0,1
74038,170,17059,23570;23841;26587;27664,46720,0,0,4,0,4
74039,170,17060,23018;23157;27189,46720,0,0,3,0,3
74040,170,17061,22805;23232,46720,0,0,1,1,2
74041,170,17074,19565,47085,0,0,0,1,1
74042,170,17091,21177,47085,0,0,0,1,1
74043,170,17095,21076;21398,47085,0,0,0,2,2
74044,170,17096,22110;22231,47085,0,0,0,2,2
74045,170,17100,21368;21605,47085,0,0,0,2,2
74046,170,17101,21864;21982,47085,0,0,0,2,2
74047,170,17103,21588;22002,47085,0,0,0,2,2
74048,170,17104,21753;21889,47085,0,0,0,2,2
74049,170,17106,22144;22179,47085,0,0,0,2,2
74050,170,17107,22232;22788,47085,0,0,0,2,2
74051,170,17108,22219;22257,47085,0,0,0,2,2
74052,170,17109,22292;22375,47085,0,0,0,2,2
74053,170,17110,22132;22395,47085,0,0,0,2,2
74054,170,17113,22334;22363,47085,0,0,0,2,2
74055,170,17115,22475,47085,0,0,0,1,1
74056,170,17116,22455;25864,47085,0,0,1,1,2
74057,170,17117,22464;22511,47085,0,0,0,2,2
74058,170,17118,22256,47085,0,0,0,1,1
74059,170,17119,22740,47085,0,0,0,1,1
74060,170,17120,26054,47085,0,0,1,0,1
74061,170,17121,22795,47085,0,0,0,1,1
74062,170,17123,22672;22872,47085,0,0,0,2,2
74063,170,17124,22677;22873;26821,47085,0,0,1,2,3
74064,170,17125,22864;22883,47085,0,0,0,2,2
74065,170,17126,22486;22691,47085,0,0,0,2,2
74066,170,17127,22468;22721,47085,0,0,0,2,2
74067,170,17128,22722;22944,47085,0,0,1,1,2
74068,170,17129,22737;22941,47085,0,0,1,1,2
74069,170,17130,22750;23159,47085,0,0,1,1,2
74070,170,17132,22859,47085,0,0,0,1,1
74071,170,17134,22889,47085,0,0,0,1,1
74072,170,17135,23527;26671,47085,0,0,2,0,2
74073,170,17136,22969;26535,47085,0,0,2,0,2
74074,170,17137,23244;23334;27566,47085,0,0,3,0,3
74075,170,17138,22775;23049,47085,0,0,1,1,2
74076,170,17139,22665;23064,47085,0,0,1,1,2
74077,170,17140,22907;23074,47085,0,0,1,1,2
74078,170,17141,22834;23354,47085,0,0,1,1,2
74079,170,17142,23486;23868;26665;27020,47085,0,0,4,0,4
74080,170,17144,23204;23449;26951,47085,0,0,3,0,3
74081,170,17145,22895;23208,47085,0,0,1,1,2
74082,170,17146,22932;23209,47085,0,0,1,1,2
74083,170,17147,23030;23211,47085,0,0,2,0,2
74084,170,17148,23088;23212,47085,0,0,2,0,2
74085,170,17149,22647;22837,47085,0,0,0,2,2
74086,170,17150,23061;23251,47085,0,0,2,0,2
74087,170,17151,23073;23283;27192,47085,0,0,3,0,3
74088,170,17152,23105;23289,47085,0,0,2,0,2
74089,170,17155,23541;23650;26572;28824;29267,47085,1,1,3,0,5
74090,170,17156,23352;23374,47085,0,0,2,0,2
74091,170,17157,23348;23639,47085,0,0,2,0,2
74092,170,17158,22991;23396,47085,0,0,2,0,2
74093,170,17160,23339;23816,47085,0,0,2,0,2
74094,170,17174,20057,47450,0,0,0,1,1
74095,170,17184,21335,47450,0,0,0,1,1
74096,170,17189,21279;21480,47450,0,0,0,2,2
74097,170,17192,21040,47450,0,0,0,1,1
74098,170,17193,21389,47450,0,0,0,1,1
74099,170,17195,22084,47450,0,0,0,1,1
74100,170,17196,21744,47450,0,0,0,1,1
74101,170,17200,21857;21901,47450,0,0,0,2,2
74102,170,17203,21761;22282,47450,0,0,0,2,2
74103,170,17206,22628;22633,47450,0,0,0,2,2
74104,170,17207,21653;22228,47450,0,0,0,2,2
74105,170,17212,22381,47450,0,0,0,1,1
74106,170,17213,22405,47450,0,0,0,1,1
74107,170,17214,22501;22666,47450,0,0,0,2,2
74108,170,17216,22626;22682,47450,0,0,0,2,2
74109,170,17218,22211;22580;26326,47450,0,0,1,2,3
74110,170,17219,22939;22971;26736,47450,0,0,3,0,3
74111,170,17221,22654;23143,47450,0,0,1,1,2
74112,170,17222,22676;22760,47450,0,0,0,2,2
74113,170,17223,22373;22781,47450,0,0,0,2,2
74114,170,17224,22764;22890,47450,0,0,0,2,2
74115,170,17225,22819;23177;26166,47450,0,0,2,1,3
74116,170,17226,22636;23058;26539;29176;29263,47450,2,0,2,1,5
74117,170,17227,23357,47450,0,0,1,0,1
74118,170,17229,22882;26531,47450,0,0,1,1,2
74119,170,17231,25801;26210;29245,47450,1,0,2,0,3
74120,170,17232,22756;22928,47450,0,0,0,2,2
74121,170,17233,22878;23302;27658,47450,0,0,2,1,3
74122,170,17234,22982;23001;26537,47450,0,0,3,0,3
74123,170,17235,22985;23258;27008;27186,47450,0,0,4,0,4
74124,170,17236,23131;23280,47450,0,0,2,0,2
74125,170,17237,23388;27012,47450,0,0,2,0,2
74126,170,17238,23518,47450,0,0,1,0,1
74127,170,17239,22950;23256,47450,0,0,2,0,2
74128,170,17242,22861;23206;26238;26340;28748;29083,47450,1,1,3,1,6
74129,170,17244,23071;23270,47450,0,0,2,0,2
74130,170,17245,23014;23272,47450,0,0,2,0,2
74131,170,17246,22972;23288,47450,0,0,2,0,2
74132,170,17247,22933;26626,47450,0,0,2,0,2
74133,170,17248,23214;23322;27939,47450,0,1,2,0,3
74134,170,17249,23115;23323;27193,47450,0,0,3,0,3
74135,170,17250,23152;23328;26173;26460,47450,0,0,4,0,4
74136,170,17251,23373;23592,47450,0,0,2,0,2
74137,170,17252,23540;23684;27031,47450,0,0,3,0,3
74138,170,17253,23386;23544,47450,0,0,2,0,2
74139,170,17254,23264;23424,47450,0,0,2,0,2
74140,170,17255,19033,47815,0,0,0,1,1
74141,170,17264,19515,47815,0,0,0,1,1
74142,170,17265,19533,47815,0,0,0,1,1
74143,170,17279,20651,47815,0,0,0,1,1
74144,170,17285,21190;21920,47815,0,0,0,2,2
74145,170,17289,22042,47815,0,0,0,1,1
74146,170,17290,21925,47815,0,0,0,1,1
74147,170,17291,21935,47815,0,0,0,1,1
74148,170,17292,21978,47815,0,0,0,1,1
74149,170,17293,22012,47815,0,0,0,1,1
74150,170,17294,21767;22020,47815,0,0,0,2,2
74151,170,17296,21969,47815,0,0,0,1,1
74152,170,17297,22000;22288,47815,0,0,0,2,2
74153,170,17299,21949;22195,47815,0,0,0,2,2
74154,170,17301,22538;22579,47815,0,0,0,2,2
74155,170,17302,22397;22522,47815,0,0,0,2,2
74156,170,17303,22414;22602,47815,0,0,0,2,2
74157,170,17304,22072;22417,47815,0,0,0,2,2
74158,170,17306,22011;22577,47815,0,0,0,2,2
74159,170,17307,22553;22590,47815,0,0,0,2,2
74160,170,17308,22637;22850;24988,47815,0,0,1,2,3
74161,170,17310,22869,47815,0,0,0,1,1
74162,170,17311,22706;23180,47815,0,0,1,1,2
74163,170,17312,22419;22582,47815,0,0,0,2,2
74164,170,17313,22981;23119;25635,47815,0,0,3,0,3
74165,170,17315,22530;22539,47815,0,0,0,2,2
74166,170,17318,22843;23174,47815,0,0,1,1,2
74167,170,17319,23184;23332,47815,0,0,2,0,2
74168,170,17320,22999;23436,47815,0,0,2,0,2
74169,170,17322,22989,47815,0,0,1,0,1
74170,170,17323,23148;23166,47815,0,0,2,0,2
74171,170,17325,23614;24209;27198,47815,0,0,3,0,3
74172,170,17326,23136;23443,47815,0,0,2,0,2
74173,170,17327,23218;23663;26768;29277,47815,1,0,3,0,4
74174,170,17328,23156;23464,47815,0,0,2,0,2
74175,170,17329,22803;23188,47815,0,0,1,1,2
74176,170,17330,23715;26480,47815,0,0,2,0,2
74177,170,17331,23203;23359,47815,0,0,2,0,2
74178,170,17332,23122;23207;27656,47815,0,0,3,0,3
74179,170,17333,23248;23609;27571,47815,0,0,3,0,3
74180,170,17334,23250;23596;26766,47815,0,0,3,0,3
74181,170,17335,22816;23369,47815,0,0,1,1,2
74182,170,17336,23276;23450;26456,47815,0,0,3,0,3
74183,170,17337,23760;27134;27214;27573,47815,0,0,4,0,4
74184,170,17338,23318;26944,47815,0,0,2,0,2
74185,170,17339,23576,47815,0,0,1,0,1
74186,170,17340,23422;23503;27021;27381,47815,0,0,4,0,4
74187,170,17341,23550;23759;26471,47815,0,0,3,0,3
74188,170,17342,23533;23635;27298,47815,0,0,3,0,3
74189,170,17344,23132;23414,47815,0,0,2,0,2
74190,170,17345,23243;23420,47815,0,0,2,0,2
74191,170,17346,23598,47815,0,0,1,0,1
74192,170,17347,23439;23659,47815,0,0,2,0,2
74193,170,17348,23534;23559,47815,0,0,2,0,2
74194,170,17349,23385;23479,47815,0,0,2,0,2
74195,170,17350,23881;26879;27753;27839,47815,0,2,2,0,4
74196,170,17351,23487;23713,47815,0,0,2,0,2
74197,170,17352,23297,47815,0,0,1,0,1
74198,170,17353,23585,47815,0,0,1,0,1
74199,170,17354,23470;23498,47815,0,0,2,0,2
74200,170,17355,23222;23500;26569,47815,0,0,3,0,3
74201,170,17356,23333;23523;27025,47815,0,0,3,0,3
74202,170,17357,22992;23428,47815,0,0,2,0,2
74203,170,17358,23642;26867,47815,0,0,2,0,2
74204,170,17360,23358;23620,47815,0,0,2,0,2
74205,170,17376,20422,48180,0,0,0,1,1
74206,170,17385,20363,48180,0,0,0,1,1
74207,170,17391,21142,48180,0,0,0,1,1
74208,170,17393,21678;21947,48180,0,0,0,2,2
74209,170,17396,22096,48180,0,0,0,1,1
74210,170,17397,21979;21986,48180,0,0,0,2,2
74211,170,17405,22158;22622,48180,0,0,0,2,2
74212,170,17407,22163;22513,48180,0,0,0,2,2
74213,170,17408,22583,48180,0,0,0,1,1
74214,170,17410,22897;22980;26628,48180,0,0,2,1,3
74215,170,17412,22255;22703,48180,0,0,0,2,2
74216,170,17414,22840,48180,0,0,0,1,1
74217,170,17415,22862;23221,48180,0,0,1,1,2
74218,170,17417,22667;22935;26443,48180,0,0,2,1,3
74219,170,17418,23072;23110,48180,0,0,2,0,2
74220,170,17419,23010;26838,48180,0,0,2,0,2
74221,170,17420,23089,48180,0,0,1,0,1
74222,170,17421,23758;27133,48180,0,0,2,0,2
74223,170,17422,23042;23267,48180,0,0,2,0,2
74224,170,17423,23640;23651;26578,48180,0,0,3,0,3
74225,170,17424,22774;23325;26172,48180,0,0,2,1,3
74226,170,17425,23964,48180,0,0,1,0,1
74227,170,17428,23233;23383,48180,0,0,2,0,2
74228,170,17430,23513;23723;26775,48180,0,0,3,0,3
74229,170,17431,23246;23526,48180,0,0,2,0,2
74230,170,17432,23412;23879,48180,0,0,2,0,2
74231,170,17433,23168;23453,48180,0,0,2,0,2
74232,170,17434,23483;23916;27048;27755,48180,0,1,3,0,4
74233,170,17435,23434;23605;27747,48180,0,1,2,0,3
74234,170,17436,23520;23671,48180,0,0,2,0,2
74235,170,17437,23522;27569,48180,0,0,2,0,2
74236,170,17438,23529;23840,48180,0,0,2,0,2
74237,170,17439,23490;23536;26953;27116,48180,0,0,4,0,4
74238,170,17441,23772;24012;27760,48180,0,1,2,0,3
74239,170,17443,23418;23561,48180,0,0,2,0,2
74240,170,17444,23478,48180,0,0,1,0,1
74241,170,17445,23379;23786,48180,0,0,2,0,2
74242,170,17446,23732;23883,48180,0,0,2,0,2
74243,170,17447,23604,48180,0,0,1,0,1
74244,170,17448,23368;23606,48180,0,0,2,0,2
74245,170,17449,23608;26865;27208;27296;28930,48180,1,0,4,0,5
74246,170,17450,23616;23954,48180,0,0,2,0,2
74247,170,17451,23638;23654;27299,48180,0,0,3,0,3
74248,170,17452,23371;23657,48180,0,0,2,0,2
74249,170,17453,23645;23658,48180,0,0,2,0,2
74250,170,17454,23660;23710;28035,48180,0,1,2,0,3
74251,170,17455,23313;23670;27384,48180,0,0,3,0,3
74252,170,17457,19152,48545,0,0,0,1,1
74253,170,17460,19314,48545,0,0,0,1,1
74254,170,17473,20263,48545,0,0,0,1,1
74255,170,17478,20669,48545,0,0,0,1,1
74256,170,17487,21993;22476,48545,0,0,0,2,2
74257,170,17489,22809,48545,0,0,0,1,1
74258,170,17491,22124;25936,48545,0,0,1,1,2
74259,170,17492,22432;22808;26142;28900;29078,48545,2,0,1,2,5
74260,170,17493,22597,48545,0,0,0,1,1
74261,170,17494,22340;22534;26042,48545,0,0,1,2,3
74262,170,17495,22729;22746,48545,0,0,0,2,2
74263,170,17496,22565;22905,48545,0,0,0,2,2
74264,170,17497,22556;22842,48545,0,0,0,2,2
74265,170,17499,22398;22959,48545,0,0,1,1,2
74266,170,17501,22685;22962,48545,0,0,1,1,2
74267,170,17503,22734;25619,48545,0,0,1,1,2
74268,170,17505,23462,48545,0,0,1,0,1
74269,170,17506,22886,48545,0,0,0,1,1
74270,170,17507,22772;22924;25418;26625,48545,0,0,2,2,4
74271,170,17509,22714;23024,48545,0,0,1,1,2
74272,170,17510,23046;23135,48545,0,0,2,0,2
74273,170,17511,23037;23048,48545,0,0,2,0,2
74274,170,17512,23052;23669;27126,48545,0,0,3,0,3
74275,170,17513,23054;23090,48545,0,0,2,0,2
74276,170,17514,23063,48545,0,0,1,0,1
74277,170,17515,22692;23139;25982;26745,48545,0,0,3,1,4
74278,170,17516,23158;26640,48545,0,0,2,0,2
74279,170,17517,23035;23191,48545,0,0,2,0,2
74280,170,17518,25899;26242;29248,48545,1,0,2,0,3
74281,170,17519,23607;23791,48545,0,0,2,0,2
74282,170,17520,23584;23631,48545,0,0,2,0,2
74283,170,17521,23382;23800,48545,0,0,2,0,2
74284,170,17522,23215;23392;27195,48545,0,0,3,0,3
74285,170,17523,23554;27469,48545,0,0,2,0,2
74286,170,17524,23485;26762;27568;28676,48545,0,1,3,0,4
74287,170,17525,23069;23429,48545,0,0,2,0,2
74288,170,17526,23065,48545,0,0,1,0,1
74289,170,17527,23213;23473,48545,0,0,2,0,2
74290,170,17528,23734;23815,48545,0,0,2,0,2
74291,170,17531,23525;23565,48545,0,0,2,0,2
74292,170,17532,23922;24053;27315;27671,48545,0,0,4,0,4
74293,170,17533,23626;23890,48545,0,0,2,0,2
74294,170,17534,23655;24018;27229;27761,48545,0,1,3,0,4
74295,170,17535,23573;23886;27754,48545,0,1,2,0,3
74296,170,17536,23686;24035;27945,48545,0,1,2,0,3
74297,170,17538,23700;23829,48545,0,0,2,0,2
74298,170,17539,23549;23914;26198,48545,0,0,3,0,3
74299,170,17541,23735;23967;27400,48545,0,0,3,0,3
74300,170,17542,23804;24093,48545,0,0,2,0,2
74301,170,17546,20092,48910,0,0,0,1,1
74302,170,17550,20177;20187,48910,0,0,0,2,2
74303,170,17558,20714,48910,0,0,0,1,1
74304,170,17569,21580,48910,0,0,0,1,1
74305,170,17573,21462,48910,0,0,0,1,1
74306,170,17577,21639,48910,0,0,0,1,1
74307,170,17582,22139,48910,0,0,0,1,1
74308,170,17583,22279,48910,0,0,0,1,1
74309,170,17586,22394;23031,48910,0,0,1,1,2
74310,170,17587,21940;22469,48910,0,0,0,2,2
74311,170,17589,22482;23101,48910,0,0,1,1,2
74312,170,17593,22447;22655,48910,0,0,0,2,2
74313,170,17595,22473;22763;27004,48910,0,0,1,2,3
74314,170,17597,22917;23055,48910,0,0,1,1,2
74315,170,17600,23142;23391;27194;27659,48910,0,0,4,0,4
74316,170,17601,23185;23340,48910,0,0,2,0,2
74317,170,17602,22610;23051;26159;26937,48910,0,0,3,1,4
74318,170,17604,23546,48910,0,0,1,0,1
74319,170,17605,22710;23099,48910,0,0,1,1,2
74320,170,17607,23234;23441,48910,0,0,2,0,2
74321,170,17608,23253;23336,48910,0,0,2,0,2
74322,170,17609,23113;23273;26455;27657,48910,0,0,4,0,4
74323,170,17610,23301;23480,48910,0,0,2,0,2
74324,170,17611,22955;23331,48910,0,0,2,0,2
74325,170,17612,23097;23343;26174,48910,0,0,3,0,3
74326,170,17613,23929;27843,48910,0,1,1,0,2
74327,170,17614,23240;23400,48910,0,0,2,0,2
74328,170,17615,23445;23579,48910,0,0,2,0,2
74329,170,17616,23465;26852,48910,0,0,2,0,2
74330,170,17617,23682;23712,48910,0,0,2,0,2
74331,170,17618,23552,48910,0,0,1,0,1
74332,170,17619,23262;23574;26574,48910,0,0,3,0,3
74333,170,17621,23958;24036,48910,0,0,2,0,2
74334,170,17622,23539;23600,48910,0,0,2,0,2
74335,170,17623,23830;27575,48910,0,0,2,0,2
74336,170,17624,23329;23617,48910,0,0,2,0,2
74337,170,17625,23731,48910,0,0,1,0,1
74338,170,17627,23295;23649;27383,48910,0,0,3,0,3
74339,170,17628,23287;23652,48910,0,0,2,0,2
74340,170,17629,23179;23905,48910,0,0,2,0,2
74341,170,17630,23939;24024;27050;28137;28767,48910,0,2,3,0,5
74342,170,17631,23943,48910,0,0,1,0,1
74343,170,17632,23643;23728;26968;27033;27941,48910,0,1,4,0,5
74344,170,17635,23762;23814;26875,48910,0,0,3,0,3
74345,170,17636,23535;24015;27669,48910,0,0,3,0,3
74346,170,17637,23770;23801;26486;27574,48910,0,0,4,0,4
74347,170,17638,23807;24000,48910,0,0,2,0,2
74348,170,17639,23828,48910,0,0,1,0,1
74349,170,17640,24029;24049;27583,48910,0,0,3,0,3
74350,170,17641,23662;23849;27751,48910,0,1,2,0,3
74351,170,17642,23874,48910,0,0,1,0,1
74352,170,17643,23612;23862,48910,0,0,2,0,2
74353,170,17650,20035;20120,49275,0,0,0,2,2
74354,170,17651,20050,49275,0,0,0,1,1
74355,170,17657,21583;21698,49275,0,0,0,2,2
74356,170,17665,22026;22038,49275,0,0,0,2,2
74357,170,17670,23200,49275,0,0,1,0,1
74358,170,17671,22430,49275,0,0,0,1,1
74359,170,17672,22368;22377,49275,0,0,0,2,2
74360,170,17673,22116,49275,0,0,0,1,1
74361,170,17675,22632;22884,49275,0,0,0,2,2
74362,170,17676,22767;23230,49275,0,0,1,1,2
74363,170,17677,23091;26354,49275,0,0,2,0,2
74364,170,17680,22946;23219,49275,0,0,2,0,2
74365,170,17681,23012;26067,49275,0,0,2,0,2
74366,170,17683,23044;27467,49275,0,0,2,0,2
74367,170,17685,22926;23120,49275,0,0,1,1,2
74368,170,17686,22663;22960,49275,0,0,1,1,2
74369,170,17687,22856,49275,0,0,0,1,1
74370,170,17689,23079;23365,49275,0,0,2,0,2
74371,170,17691,23404;23477,49275,0,0,2,0,2
74372,170,17692,23389;23763,49275,0,0,2,0,2
74373,170,17694,23229;23423,49275,0,0,2,0,2
74374,170,17695,23474;23937;27944,49275,0,1,2,0,3
74375,170,17696,23160;23511;26857,49275,0,0,3,0,3
74376,170,17697,23106;23556,49275,0,0,2,0,2
74377,170,17699,23380;23563;26472,49275,0,0,3,0,3
74378,170,17700,23572;23779;26284;27135;29196;29294,49275,2,0,4,0,6
74379,170,17701,23575;23771,49275,0,0,2,0,2
74380,170,17702,23551;23587,49275,0,0,2,0,2
74381,170,17703,23623;23698;26870;28497;29113;29284,49275,2,1,3,0,6
74382,170,17704,23847;23994;28138,49275,0,1,2,0,3
74383,170,17705,23190;23502,49275,0,0,2,0,2
74384,170,17706,23644;23666,49275,0,0,2,0,2
74385,170,17707,23674;24092,49275,0,0,2,0,2
74386,170,17708,23798,49275,0,0,1,0,1
74387,170,17709,24026;24242;28418,49275,0,1,2,0,3
74388,170,17710,23694;27471,49275,0,0,2,0,2
74389,170,17711,23665;23706;27300,49275,0,0,3,0,3
74390,170,17712,23711;24064;27387,49275,0,0,3,0,3
74391,170,17713,23919;24047,49275,0,0,2,0,2
74392,170,17714,23601;23727;26584,49275,0,0,3,0,3
74393,170,17715,23341;23744;26396,49275,0,0,3,0,3
74394,170,17716,23761;23766,49275,0,0,2,0,2
74395,170,17717,23769,49275,0,0,1,0,1
74396,170,17718,23747;23788;26873;27130;27212,49275,0,0,5,0,5
74397,170,17719,23826;23971,49275,0,0,2,0,2
74398,170,17720,23785;23899;27840,49275,0,1,2,0,3
74399,170,17721,23863;24276,49275,0,0,2,0,2
74400,170,17722,23877,49275,0,0,1,0,1
74401,170,17723,23489;23885,49275,0,0,2,0,2
74402,170,17724,23898;24151;27762,49275,0,1,2,0,3
74403,170,17726,23906;23974,49275,0,0,2,0,2
74404,170,17727,23912;27841,49275,0,1,1,0,2
74405,170,17728,23774;23928;27308,49275,0,0,3,0,3
74406,170,17729,23309;23683;27030,49275,0,0,3,0,3
74407,170,17730,23988;24038;28139,49275,0,1,2,0,3
74408,170,17734,19585,49640,0,0,0,1,1
74409,170,17738,19992,49640,0,0,0,1,1
74410,170,17740,20126,49640,0,0,0,1,1
74411,170,17741,20326;20981,49640,0,0,0,2,2
74412,170,17754,21354,49640,0,0,0,1,1
74413,170,17756,21436;21803,49640,0,0,0,2,2
74414,170,17757,21018;21835;25053;28774,49640,0,1,1,2,4
74415,170,17761,21670;21773,49640,0,0,0,2,2
74416,170,17762,22333;22490,49640,0,0,0,2,2
74417,170,17765,22505;22857,49640,0,0,0,2,2
74418,170,17768,22749;23003,49640,0,0,1,1,2
74419,170,17769,22509;22726,49640,0,0,0,2,2
74420,170,17771,22804;22898;26620;28588,49640,0,1,1,2,4
74421,170,17773,22701;22974,49640,0,0,1,1,2
74422,170,17774,23075;23347;27112,49640,0,0,3,0,3
74423,170,17775,23275;23419;27379,49640,0,0,3,0,3
74424,170,17779,23399;26267,49640,0,0,2,0,2
74425,170,17780,23170;23245;25535,49640,0,0,3,0,3
74426,170,17781,23410;23621,49640,0,0,2,0,2
74427,170,17782,23381;23646,49640,0,0,2,0,2
74428,170,17783,23087;23345,49640,0,0,2,0,2
74429,170,17785,23802,49640,0,0,1,0,1
74430,170,17786,23722;23872;27221,49640,0,0,3,0,3
74431,170,17788,23580;24135,49640,0,0,2,0,2
74432,170,17789,23367;23463,49640,0,0,2,0,2
74433,170,17791,24025,49640,0,0,1,0,1
74434,170,17792,23532;23701,49640,0,0,2,0,2
74435,170,17793,23726;24080,49640,0,0,2,0,2
74436,170,17795,23921;27577;27756,49640,0,1,2,0,3
74437,170,17796,23408;23845,49640,0,0,2,0,2
74438,170,17797,23394;23835;28038,49640,0,1,2,0,3
74439,170,17798,23653;23855;26690;28039,49640,0,1,3,0,4
74440,170,17799,23860;23910,49640,0,0,2,0,2
74441,170,17800,23739;23900,49640,0,0,2,0,2
74442,170,17802,23778;23977;27480;29204,49640,1,0,3,0,4
74443,170,17803,24232,49640,0,0,1,0,1
74444,170,17804,23990;24033;27143,49640,0,0,3,0,3
74445,170,17805,24017;28041;28321,49640,0,2,1,0,3
74446,170,17807,24052;24291;28042,49640,0,1,2,0,3
74447,170,17808,24420;26908;27428;27501;27604,49640,0,0,5,0,5
74448,170,17809,24063,49640,0,0,1,0,1
74449,170,17810,23915;24408;27499;27962,49640,0,1,3,0,4
74450,170,17811,24354;27858,49640,0,1,1,0,2
74451,170,17814,19674,50005,0,0,0,1,1
74452,170,17820,20108,50005,0,0,0,1,1
74453,170,17825,20545,50005,0,0,0,1,1
74454,170,17827,20945,50005,0,0,0,1,1
74455,170,17830,21054;21270,50005,0,0,0,2,2
74456,170,17832,21972;22560,50005,0,0,0,2,2
74457,170,17836,21630;21666,50005,0,0,0,2,2
74458,170,17842,21503;21806,50005,0,0,0,2,2
74459,170,17843,22485,50005,0,0,0,1,1
74460,170,17846,21718;22037,50005,0,0,0,2,2
74461,170,17851,22535;22802,50005,0,0,0,2,2
74462,170,17853,22700,50005,0,0,0,1,1
74463,170,17855,22975,50005,0,0,1,0,1
74464,170,17856,22364,50005,0,0,0,1,1
74465,170,17861,23114;23508,50005,0,0,2,0,2
74466,170,17862,23076;23116,50005,0,0,2,0,2
74467,170,17864,23197;23680;26770;29007,50005,1,0,3,0,4
74468,170,17865,23767;24073;27404,50005,0,0,3,0,3
74469,170,17866,23560,50005,0,0,1,0,1
74470,170,17867,23257;23590;26089;27206,50005,0,0,4,0,4
74471,170,17868,23471;26854,50005,0,0,2,0,2
74472,170,17869,23482;23746;27034,50005,0,0,3,0,3
74473,170,17870,23492;26954;27835,50005,0,1,2,0,3
74474,170,17871,23187;23510;26386;27290;27382;27661;28929,50005,1,0,6,0,7
74475,170,17872,23108;23516,50005,0,0,2,0,2
74476,170,17874,24070;27058;27319,50005,0,0,3,0,3
74477,170,17875,23564;23941,50005,0,0,2,0,2
74478,170,17876,23995;24069;27844,50005,0,1,2,0,3
74479,170,17877,23675;23843;27750,50005,0,1,2,0,3
74480,170,17878,23613;23876;26878;27139;27222;27393,50005,0,0,6,0,6
74481,170,17879,23292;23457;27660,50005,0,0,3,0,3
74482,170,17880,23627;23679;26769;28831,50005,0,1,3,0,4
74483,170,17882,23745;23822;27129,50005,0,0,3,0,3
74484,170,17883,23797;24050;27670,50005,0,0,3,0,3
74485,170,17884,23689;23851;27752,50005,0,1,2,0,3
74486,170,17885,23725;23867;26783;26974;29278,50005,1,0,4,0,5
74487,170,17886,23903;23909,50005,0,0,2,0,2
74488,170,17887,24105;24295,50005,0,0,2,0,2
74489,170,17888,23648;23931;27398,50005,0,0,3,0,3
74490,170,17889,23677;24392,50005,0,0,2,0,2
74491,170,17890,23628;23950,50005,0,0,2,0,2
74492,170,17891,23986;24407;27685;27862;27961,50005,0,2,3,0,5
74493,170,17893,24041,50005,0,0,1,0,1
74494,170,17894,23448;24048;27587,50005,0,0,3,0,3
74495,170,17896,24225;26897;27593;27678;27853,50005,0,1,4,0,5
74496,170,17897,24001;24273;27956;28233,50005,0,2,2,0,4
74497,170,17899,23925;24077,50005,0,0,2,0,2
74498,170,17900,23737,50005,0,0,1,0,1
74499,170,17901,24104,50005,0,0,1,0,1
74500,170,17903,24368;24432,50005,0,0,2,0,2
74501,170,17904,24144;24267;27069;27955,50005,0,1,3,0,4
74502,170,17905,24186;24215;27240;27327;28141,50005,0,1,4,0,5
74503,170,17906,24192;24200;26700;27415;27592,50005,0,0,5,0,5
74504,170,17910,19806,50370,0,0,0,1,1
74505,170,17916,20713,50370,0,0,0,1,1
74506,170,17920,21160,50370,0,0,0,1,1
74507,170,17922,21328;21950,50370,0,0,0,2,2
74508,170,17923,21359,50370,0,0,0,1,1
74509,170,17930,21926,50370,0,0,0,1,1
74510,170,17931,21756;21876,50370,0,0,0,2,2
74511,170,17932,21470;21696,50370,0,0,0,2,2
74512,170,17933,22077;22290,50370,0,0,0,2,2
74513,170,17934,22338,50370,0,0,0,1,1
74514,170,17935,22222;22735,50370,0,0,0,2,2
74515,170,17938,22931,50370,0,0,0,1,1
74516,170,17940,22166;22412,50370,0,0,0,2,2
74517,170,17942,22488;22806,50370,0,0,0,2,2
74518,170,17949,22988;26245;26737,50370,0,0,3,0,3
74519,170,17950,23409,50370,0,0,1,0,1
74520,170,17952,23029;23036,50370,0,0,2,0,2
74521,170,17953,23577;23850;27836,50370,0,1,2,0,3
74522,170,17955,23167;23569;27205,50370,0,0,3,0,3
74523,170,17957,23231;23591;26863,50370,0,0,3,0,3
74524,170,17959,23308;23625,50370,0,0,2,0,2
74525,170,17960,23970;24088;27483,50370,0,0,3,0,3
74526,170,17961,23709;26092,50370,0,0,2,0,2
74527,170,17962,23795;27136;28840,50370,0,1,2,0,3
74528,170,17963,23818;27389,50370,0,0,2,0,2
74529,170,17965,23387;23415;26848,50370,0,0,3,0,3
74530,170,17966,23228;23454;26662;28828,50370,0,1,3,0,4
74531,170,17967,23437;23494;27199,50370,0,0,3,0,3
74532,170,17968,23542;26573;27202,50370,0,0,3,0,3
74533,170,17969,23993;24102,50370,0,0,2,0,2
74534,170,17971,23730;23979;26883;27227;27580,50370,0,0,5,0,5
74535,170,17973,23784;24302;27493;27598,50370,0,0,4,0,4
74536,170,17974,23775;24058;27482,50370,0,0,3,0,3
74537,170,17975,23397;23794;27388,50370,0,0,3,0,3
74538,170,17976,23594;23806,50370,0,0,2,0,2
74539,170,17977,23704;23824,50370,0,0,2,0,2
74540,170,17978,23718;23839;27390,50370,0,0,3,0,3
74541,170,17979,23693;23848,50370,0,0,2,0,2
74542,170,17980,23708,50370,0,0,1,0,1
74543,170,17981,23859;24305;27494,50370,0,0,3,0,3
74544,170,17982,24214;24378,50370,0,0,2,0,2
74545,170,17983,23531;23887;26593;27395,50370,0,0,4,0,4
74546,170,17984,23897;24216,50370,0,0,2,0,2
74547,170,17985,23913;24045;27402;27586,50370,0,0,4,0,4
74548,170,17986,23923;23942;26293,50370,0,0,3,0,3
74549,170,17987,24042;24296;27597,50370,0,0,3,0,3
74550,170,17988,23632;24228;26299;27854,50370,0,1,3,0,4
74551,170,17989,23985;24350,50370,0,0,2,0,2
74552,170,17990,23930;23992,50370,0,0,2,0,2
74553,170,17991,23999;24173,50370,0,0,2,0,2
74554,170,17992,24010;27668,50370,0,0,2,0,2
74555,170,17993,23719;24061;27317,50370,0,0,3,0,3
74556,170,17994,24055;24278;27153;27492,50370,0,0,4,0,4
74557,170,17995,24085;24099;27322,50370,0,0,3,0,3
74558,170,17996,24224;24445,50370,0,0,2,0,2
74559,170,17997,24501,50370,0,0,1,0,1
74560,170,17999,24142;24448;27672,50370,0,0,3,0,3
74561,170,18000,24294;24401;27162;27769,50370,0,1,3,0,4
74562,170,18001,24163;24349;27958,50370,0,1,2,0,3
74563,170,18002,24166;24385;27498,50370,0,0,3,0,3
74564,170,18003,24091;24167;27674,50370,0,0,3,0,3
74565,170,18004,24431;24463,50370,0,0,2,0,2
74566,170,18005,24197;24520;27691;27775;28147;28500,50370,0,3,3,0,6
74567,170,18006,24266;24370;26907;27859,50370,0,1,3,0,4
74568,170,18007,23940;24367,50370,0,0,2,0,2
74569,170,18009,24136;24289,50370,0,0,2,0,2
74570,170,18010,24202;24308;27416;29128,50370,1,0,3,0,4
74571,170,18011,24009;24313,50370,0,0,2,0,2
74572,170,18021,19833,50735,0,0,0,1,1
74573,170,18025,20462,50735,0,0,0,1,1
74574,170,18027,20539,50735,0,0,0,1,1
74575,170,18030,20801,50735,0,0,0,1,1
74576,170,18031,21055;21182,50735,0,0,0,2,2
74577,170,18034,21263;21316,50735,0,0,0,2,2
74578,170,18041,21161,50735,0,0,0,1,1
74579,170,18045,21226;21319,50735,0,0,0,2,2
74580,170,18049,22253;22314,50735,0,0,0,2,2
74581,170,18052,22694;23433,50735,0,0,1,1,2
74582,170,18054,22443;22801;27185,50735,0,0,1,2,3
74583,170,18057,22968;23205;27283,50735,0,0,3,0,3
74584,170,18059,23066;23619,50735,0,0,2,0,2
74585,170,18063,22639;23274,50735,0,0,1,1,2
74586,170,18064,23281;23338,50735,0,0,2,0,2
74587,170,18065,23342;23634;27029,50735,0,0,3,0,3
74588,170,18066,23425;23493;26464,50735,0,0,3,0,3
74589,170,18067,23435;23476,50735,0,0,2,0,2
74590,170,18068,23458;23460;27286,50735,0,0,3,0,3
74591,170,18069,23401;23630,50735,0,0,2,0,2
74592,170,18071,23468;23755,50735,0,0,2,0,2
74593,170,18073,24030;24087;27584,50735,0,0,3,0,3
74594,170,18074,24075;27845,50735,0,1,1,0,2
74595,170,18075,24377;24509;27860,50735,0,1,2,0,3
74596,170,18076,24411;24447;28050,50735,0,1,2,0,3
74597,170,18079,24189,50735,0,0,1,0,1
74598,170,18080,23787;24188;28043,50735,0,1,2,0,3
74599,170,18082,23895,50735,0,0,1,0,1
74600,170,18083,24126;24268;27406,50735,0,0,3,0,3
74601,170,18084,23891;24153;26891;27408,50735,0,0,4,0,4
74602,170,18085,23920;24335,50735,0,0,2,0,2
74603,170,18086,23924;24248,50735,0,0,2,0,2
74604,170,18087,23927;23976;27307,50735,0,0,3,0,3
74605,170,18088,23948;24293,50735,0,0,2,0,2
74606,170,18089,24526,50735,0,0,1,0,1
74607,170,18090,23963;27758,50735,0,1,1,0,2
74608,170,18091,23949;24051;27946,50735,0,1,2,0,3
74609,170,18092,24381;24675;27336,50735,0,0,3,0,3
74610,170,18094,23833;27749,50735,0,1,1,0,2
74611,170,18095,24007;24241,50735,0,0,2,0,2
74612,170,18097,24071;24157;26892;27324,50735,0,0,4,0,4
74613,170,18098,24072;24502,50735,0,0,2,0,2
74614,170,18099,24281;27680;28143,50735,0,1,2,0,3
74615,170,18100,24113;24415,50735,0,0,2,0,2
74616,170,18101,24461;24723;27345;28680,50735,0,1,3,0,4
74617,170,18102,24031;24127,50735,0,0,2,0,2
74618,170,18103,23952;24130,50735,0,0,2,0,2
74619,170,18104,24644,50735,0,0,1,0,1
74620,170,18105,24363;24609;27782;27974,50735,0,2,2,0,4
74621,170,18106,24103;27947,50735,0,1,1,0,2
74622,170,18107,23981;24476;26909,50735,0,0,3,0,3
74623,170,18108,23944;24244;27067;27152;27490;28142,50735,0,1,5,0,6
74624,170,18109,24467;24717;27705;28332,50735,0,1,3,0,4
74625,170,18110,24177;24203;27061;27411;27688;28927;29291,50735,2,0,5,0,7
74626,170,18111,24481;24597;27618;27887,50735,0,1,3,0,4
74627,170,18112,24285;24458;27340;27606;27772,50735,0,1,4,0,5
74628,170,18113,24724,50735,0,0,1,0,1
74629,170,18114,24523;24662;28240,50735,0,1,2,0,3
74630,170,18115,24575;27694;28152,50735,0,1,2,0,3
74631,170,18116,24231;24328;27072;27422;27599,50735,0,0,5,0,5
74632,170,18117,24040;24379,50735,0,0,2,0,2
74633,170,18118,24382;24743,50735,0,0,2,0,2
74634,170,18119,24314;24409;27253;27770;28235,50735,0,2,3,0,5
74635,170,18130,20816,51100,0,0,0,1,1
74636,170,18133,20530,51100,0,0,0,1,1
74637,170,18134,21057;21596,51100,0,0,0,2,2
74638,170,18137,21191;21224,51100,0,0,0,2,2
74639,170,18138,20793,51100,0,0,0,1,1
74640,170,18146,21463;21683,51100,0,0,0,2,2
74641,170,18152,22014,51100,0,0,0,1,1
74642,170,18157,22483;22679,51100,0,0,0,2,2
74643,170,18159,22824;23134,51100,0,0,1,1,2
74644,170,18160,23175;23282;26170;28135;29242,51100,1,1,3,0,5
74645,170,18161,22789;23140;26839,51100,0,0,2,1,3
74646,170,18164,22644;22888,51100,0,0,0,2,2
74647,170,18168,23395;23515,51100,0,0,2,0,2
74648,170,18169,23393;23998;27759,51100,0,1,2,0,3
74649,170,18170,23461,51100,0,0,1,0,1
74650,170,18171,23421;23547;27292,51100,0,0,3,0,3
74651,170,18173,23875;24006;27228;27401,51100,0,0,4,0,4
74652,170,18174,23582;23622;27748,51100,0,1,2,0,3
74653,170,18176,23509;24005;27581,51100,0,0,3,0,3
74654,170,18177,23736;24178;27237,51100,0,0,3,0,3
74655,170,18178,23566;23754;26685,51100,0,0,3,0,3
74656,170,18179,23593;23789;27663,51100,0,0,3,0,3
74657,170,18180,23831;24642;27435,51100,0,0,3,0,3
74658,170,18181,23896;24150,51100,0,0,2,0,2
74659,170,18182,23326;23907,51100,0,0,2,0,2
74660,170,18183,24140;27407,51100,0,0,2,0,2
74661,170,18184,23953;24270,51100,0,0,2,0,2
74662,170,18185,23505;24008,51100,0,0,2,0,2
74663,170,18186,23965;24524,51100,0,0,2,0,2
74664,170,18187,23978;27226,51100,0,0,2,0,2
74665,170,18188,23983;26094,51100,0,0,2,0,2
74666,170,18189,24310;27767,51100,0,1,1,0,2
74667,170,18190,24021,51100,0,0,1,0,1
74668,170,18191,24688;27168;27522;27703;29301,51100,1,0,4,0,5
74669,170,18193,24180;24537;26914;28836,51100,0,1,3,0,4
74670,170,18194,24788;27528,51100,0,0,2,0,2
74671,170,18196,24234;24316,51100,0,0,2,0,2
74672,170,18197,23932;24380;27959,51100,0,1,2,0,3
74673,170,18199,24062;24521;28148,51100,0,1,2,0,3
74674,170,18200,24366;24652;27871,51100,0,1,2,0,3
74675,170,18201,24475;26991;27160;27861;27960;28048;29303,51100,1,3,3,0,7
74676,170,18202,23901;24628,51100,0,0,2,0,2
74677,170,18203,24404;27252;28146,51100,0,1,2,0,3
74678,170,18204,24004;24425,51100,0,0,2,0,2
74679,170,18206,24117;24451;27503,51100,0,0,3,0,3
74680,170,18207,24081;24482;27506;27607;27689,51100,0,0,5,0,5
74681,170,18208,24416;24489;27341;27507;27774;27964,51100,0,2,4,0,6
74682,170,18209,23982;24491;26910,51100,0,0,3,0,3
74683,170,18210,24760;27791,51100,0,1,1,0,2
74684,170,18211,24506;24640;27163,51100,0,0,3,0,3
74685,170,18212,24362;24721;27170,51100,0,0,3,0,3
74686,170,18213,24511;24528,51100,0,0,2,0,2
74687,170,18223,20994,51465,0,0,0,1,1
74688,170,18226,21146,51465,0,0,0,1,1
74689,170,18229,21774;21996,51465,0,0,0,2,2
74690,170,18230,21616,51465,0,0,0,1,1
74691,170,18233,21908,51465,0,0,0,1,1
74692,170,18235,21763;21862,51465,0,0,0,2,2
74693,170,18240,22594;22641,51465,0,0,0,2,2
74694,170,18243,22938,51465,0,0,1,0,1
74695,170,18245,23000;23128,51465,0,0,2,0,2
74696,170,18249,22957;23162,51465,0,0,2,0,2
74697,170,18250,23176;23610;26679;27297,51465,0,0,4,0,4
74698,170,18251,23198,51465,0,0,1,0,1
74699,170,18252,22681,51465,0,0,0,1,1
74700,170,18253,23495,51465,0,0,1,0,1
74701,170,18254,23130;23300;26845,51465,0,0,3,0,3
74702,170,18255,23263;23444;27016;27567,51465,0,0,4,0,4
74703,170,18258,23285,51465,0,0,1,0,1
74704,170,18259,23438;23624,51465,0,0,2,0,2
74705,170,18260,23271;23447,51465,0,0,2,0,2
74706,170,18261,23455;23750,51465,0,0,2,0,2
74707,170,18262,23803;23870,51465,0,0,2,0,2
74708,170,18263,24171,51465,0,0,1,0,1
74709,170,18264,23530;23685,51465,0,0,2,0,2
74710,170,18265,23599;23687;27940,51465,0,1,2,0,3
74711,170,18267,23695;23733,51465,0,0,2,0,2
74712,170,18268,23956;24298;27140;27578;27757,51465,0,1,4,0,5
74713,170,18269,23776;24213;26792,51465,0,0,3,0,3
74714,170,18270,24283;24395,51465,0,0,2,0,2
74715,170,18271,23933,51465,0,0,1,0,1
74716,170,18272,23836;24172;27590;27849,51465,0,1,3,0,4
74717,170,18273,23678;23866,51465,0,0,2,0,2
74718,170,18274,23878;24100,51465,0,0,2,0,2
74719,170,18275,23562;23752,51465,0,0,2,0,2
74720,170,18276,23959;24181,51465,0,0,2,0,2
74721,170,18277,23969;24195;27413,51465,0,0,3,0,3
74722,170,18278,24624;24638,51465,0,0,2,0,2
74723,170,18279,24067;24114,51465,0,0,2,0,2
74724,170,18280,24120;24374;27159;27768;28145,51465,0,2,3,0,5
74725,170,18281,24650;27621;28157,51465,0,1,2,0,3
74726,170,18282,24191;27850,51465,0,1,1,0,2
74727,170,18283,24190,51465,0,0,1,0,1
74728,170,18284,24311;24541;26803;27612,51465,0,0,4,0,4
74729,170,18285,23997;24307,51465,0,0,2,0,2
74730,170,18286,24581;24694;27695;28424,51465,0,1,3,0,4
74731,170,18287,24333;27245,51465,0,0,2,0,2
74732,170,18288,24162;24339,51465,0,0,2,0,2
74733,170,18289,24421;24545;27433;28501,51465,0,1,3,0,4
74734,170,18291,24342;24734;27526,51465,0,0,3,0,3
74735,170,18292,24446;24966;27502,51465,0,0,3,0,3
74736,170,18293,24413;24950;27990,51465,0,1,2,0,3
74737,170,18294,24436;24949;27357;27536;27896;28844,51465,0,2,4,0,6
74738,170,18297,24277;24603;27973,51465,0,1,2,0,3
74739,170,18298,24795;28336,51465,0,1,1,0,2
74740,170,18299,24212;24470,51465,0,0,2,0,2
74741,170,18300,24239;24369,51465,0,0,2,0,2
74742,170,18301,24612;27259;27519;28156,51465,0,1,3,0,4
74743,170,18302,24680;24857;28599,51465,0,1,2,0,3
74744,170,18303,24874;25027;27351;27886;27989,51465,0,2,3,0,5
74745,170,18304,24543;24758;27707,51465,0,0,3,0,3
74746,170,18305,24510;24564;26995;27615;27693,51465,0,0,5,0,5
74747,170,18306,24571;24844;28167,51465,0,1,2,0,3
74748,170,18307,24937;28256,51465,0,1,1,0,2
74749,170,18308,24693;28427,51465,0,1,1,0,2
74750,170,18311,20345,51830,0,0,0,1,1
74751,170,18314,20712,51830,0,0,0,1,1
74752,170,18318,20822,51830,0,0,0,1,1
74753,170,18321,21183,51830,0,0,0,1,1
74754,170,18332,22278,51830,0,0,0,1,1
74755,170,18333,22593,51830,0,0,0,1,1
74756,170,18334,22507;22683,51830,0,0,0,2,2
74757,170,18344,22470,51830,0,0,0,1,1
74758,170,18346,23033;23164;26359,51830,0,0,3,0,3
74759,170,18347,23504;23742,51830,0,0,2,0,2
74760,170,18349,23667,51830,0,0,1,0,1
74761,170,18353,23817,51830,0,0,1,0,1
74762,170,18354,23375;23707;26967,51830,0,0,3,0,3
74763,170,18355,23578;24022,51830,0,0,2,0,2
74764,170,18357,23629;23751;27132;27213,51830,0,0,4,0,4
74765,170,18359,23681;23936;27943,51830,0,1,2,0,3
74766,170,18360,23809;23917;28037,51830,0,1,2,0,3
74767,170,18362,23884;24065;27403,51830,0,0,3,0,3
74768,170,18364,23947;24133,51830,0,0,2,0,2
74769,170,18365,23793;23962;27399;28040,51830,0,1,3,0,4
74770,170,18366,23812;23972;27310;27667,51830,0,0,4,0,4
74771,170,18367,24282;26301;28907,51830,1,0,2,0,3
74772,170,18368,24262;24604;27619;28327,51830,0,1,3,0,4
74773,170,18369,24220;24400,51830,0,0,2,0,2
74774,170,18370,24661;24883;27173;28842,51830,0,1,3,0,4
74775,170,18371,24115;24279;27059,51830,0,0,3,0,3
74776,170,18372,24131;24265,51830,0,0,2,0,2
74777,170,18373,24138;27485;27949,51830,0,1,2,0,3
74778,170,18374,23908;24139,51830,0,0,2,0,2
74779,170,18375,24355;27158,51830,0,0,2,0,2
74780,170,18376,23442;24185;27238;27412;27763,51830,0,1,4,0,5
74781,170,18378,24147;24207;27417;27952,51830,0,1,3,0,4
74782,170,18379,24261;24504;28422,51830,0,1,2,0,3
74783,170,18380,24290;24360;27496;29205,51830,1,0,3,0,4
74784,170,18381,24479,51830,0,0,1,0,1
74785,170,18382,24326;24583,51830,0,0,2,0,2
74786,170,18383,24389;24990;27991;28345,51830,0,2,2,0,4
74787,170,18384,24854;27534;28071;28338,51830,0,2,2,0,4
74788,170,18385,24324;24424,51830,0,0,2,0,2
74789,170,18386,24690,51830,0,0,1,0,1
74790,170,18388,23957;24534,51830,0,0,2,0,2
74791,170,18389,24414;24542;27512;27863,51830,0,1,3,0,4
74792,170,18391,24559;24748;27790;28061,51830,0,2,2,0,4
74793,170,18392,24560;24886,51830,0,0,2,0,2
74794,170,18393,24570;24711;27704;29302,51830,1,0,3,0,4
74795,170,18394,24497;24595;27697;27971,51830,0,1,3,0,4
74796,170,18395,24602;27434;27972,51830,0,1,2,0,3
74797,170,18396,24867;27709,51830,0,0,2,0,2
74798,170,18397,24646;24850;28070;28337,51830,0,2,2,0,4
74799,170,18398,24322;24845;27881;28069,51830,0,2,2,0,4
74800,170,18399,24664;27437;27872,51830,0,1,2,0,3
74801,170,18401,24692;24812;27979;28426,51830,0,2,2,0,4
74802,170,18402,24116;24550,51830,0,0,2,0,2
74803,170,18404,24554;24745;27778,51830,0,1,2,0,3
74804,170,18405,24969,51830,0,0,1,0,1
74805,170,18406,20182,52195,0,0,0,1,1
74806,170,18408,19906,52195,0,0,0,1,1
74807,170,18410,20309,52195,0,0,0,1,1
74808,170,18412,20607,52195,0,0,0,1,1
74809,170,18413,20694,52195,0,0,0,1,1
74810,170,18414,20763,52195,0,0,0,1,1
74811,170,18426,21440;21622,52195,0,0,0,2,2
74812,170,18432,22153,52195,0,0,0,1,1
74813,170,18436,22586,52195,0,0,0,1,1
74814,170,18439,22984;23873;27392;29127,52195,1,0,3,0,4
74815,170,18440,23310,52195,0,0,1,0,1
74816,170,18441,23224,52195,0,0,1,0,1
74817,170,18442,23032;23252,52195,0,0,2,0,2
74818,170,18443,23430;23602;26465,52195,0,0,3,0,3
74819,170,18445,23469;23475,52195,0,0,2,0,2
74820,170,18446,23854;24094,52195,0,0,2,0,2
74821,170,18447,23808;24312;27333;28144,52195,0,1,3,0,4
74822,170,18448,23118;23268;26941;27108,52195,0,0,4,0,4
74823,170,18449,24187;27239,52195,0,0,2,0,2
74824,170,18452,23821;24364;27683,52195,0,0,3,0,3
74825,170,18453,24090,52195,0,0,1,0,1
74826,170,18454,23864;24199;27764,52195,0,1,2,0,3
74827,170,18455,23880;24060;27316;27588,52195,0,0,4,0,4
74828,170,18456,23902;24251;28323,52195,0,1,2,0,3
74829,170,18457,23583,52195,0,0,1,0,1
74830,170,18458,23413;23934;27477,52195,0,0,3,0,3
74831,170,18459,23961;24246;27491;27765,52195,0,1,3,0,4
74832,170,18460,23904;24372,52195,0,0,2,0,2
74833,170,18461,24039;24155;27847;28140,52195,0,2,2,0,4
74834,170,18462,24174;24393;27426;27684,52195,0,0,4,0,4
74835,170,18463,24175;24222,52195,0,0,2,0,2
74836,170,18464,24227;24388;27248,52195,0,0,3,0,3
74837,170,18465,24243;24568;27968,52195,0,1,2,0,3
74838,170,18467,24573;27164,52195,0,0,2,0,2
74839,170,18468,24299;24321;27855;27957,52195,0,2,2,0,4
74840,170,18469,24184;24625;27869,52195,0,1,2,0,3
74841,170,18470,24978;27003;27898;28602,52195,0,2,2,0,4
74842,170,18471,24522;24726;27982;28428,52195,0,2,2,0,4
74843,170,18473,24356;24586,52195,0,0,2,0,2
74844,170,18474,24516;24784;27629;28162,52195,0,1,3,0,4
74845,170,18475,23810;24527;26913,52195,0,0,3,0,3
74846,170,18476,24535;25127;27998,52195,0,1,2,0,3
74847,170,18477,24435;24552;27613;28057,52195,0,1,3,0,4
74848,170,18478,24668;27702,52195,0,0,2,0,2
74849,170,18479,24329;24585;27156;27681,52195,0,0,4,0,4
74850,170,18480,24466;24587,52195,0,0,2,0,2
74851,170,18481,24386;24594;27868;27970;28153,52195,0,3,2,0,5
74852,170,18483,24460,52195,0,0,1,0,1
74853,170,18484,24149;24722;27090;28159,52195,0,1,3,0,4
74854,170,18485,24578;24702;27787;27981;28241,52195,0,3,2,0,5
74855,170,18486,24620;24961;29209,52195,1,0,2,0,3
74856,170,18487,24258;24630;28060,52195,0,1,2,0,3
74857,170,18488,24639;24940,52195,0,0,2,0,2
74858,170,18490,24923;25075;28342;28435;28772,52195,0,3,2,0,5
74859,170,18491,25148;25231;27910,52195,0,1,2,0,3
74860,170,18492,24761;24859;28072;28252;28339,52195,0,3,2,0,5
74861,170,18493,24718;24738;27789;27875,52195,0,2,2,0,4
74862,170,18494,24728;24878;28243,52195,0,1,2,0,3
74863,170,18495,24730,52195,0,0,1,0,1
74864,170,18496,24655;24736;27701;28598,52195,0,1,3,0,4
74865,170,18497,24449;24757;27603;28334,52195,0,1,3,0,4
74866,170,18498,24485;24747,52195,0,0,2,0,2
74867,170,18499,24765;24822;27792;28062,52195,0,2,2,0,4
74868,170,18500,24562;24771;27984,52195,0,1,2,0,3
74869,170,18501,25101;25170;27996;28352,52195,0,2,2,0,4
74870,170,18502,24657;25071,52195,0,0,2,0,2
74871,170,18503,24480;24829,52195,0,0,2,0,2
74872,170,18504,24418;25084,52195,0,0,2,0,2
74873,170,18505,24927;25094;28933,52195,1,0,2,0,3
74874,170,18509,20525,52560,0,0,0,1,1
74875,170,18512,20478,52560,0,0,0,1,1
74876,170,18514,21124,52560,0,0,0,1,1
74877,170,18515,21042,52560,0,0,0,1,1
74878,170,18523,21859;21882,52560,0,0,0,2,2
74879,170,18527,22285;22711,52560,0,0,0,2,2
74880,170,18528,21671,52560,0,0,0,1,1
74881,170,18533,22251,52560,0,0,0,1,1
74882,170,18536,22696;22697,52560,0,0,0,2,2
74883,170,18540,23370,52560,0,0,1,0,1
74884,170,18542,23261,52560,0,0,1,0,1
74885,170,18543,23497;23611,52560,0,0,2,0,2
74886,170,18544,23589;23832;27473,52560,0,0,3,0,3
74887,170,18546,23748,52560,0,0,1,0,1
74888,170,18547,23825;24255;27419;28044,52560,0,1,3,0,4
74889,170,18549,24158;27409,52560,0,0,2,0,2
74890,170,18550,24160;24334,52560,0,0,2,0,2
74891,170,18551,23702;24057;27032,52560,0,0,3,0,3
74892,170,18554,23417;23871;27838,52560,0,1,2,0,3
74893,170,18555,24198;24441;27256;27963,52560,0,1,3,0,4
74894,170,18556,24249;24840;27531;28249,52560,0,1,3,0,4
74895,170,18557,24274;24741;27627;28160,52560,0,1,3,0,4
74896,170,18559,23773;24309;27234;27421;27950,52560,0,1,4,0,5
74897,170,18560,24320;24477,52560,0,0,2,0,2
74898,170,18561,24906;27634,52560,0,0,2,0,2
74899,170,18562,24410;27254,52560,0,0,2,0,2
74900,170,18563,24412;24708;27169;27788;29122,52560,1,1,3,0,5
74901,170,18564,24211;24464;28052,52560,0,1,2,0,3
74902,170,18565,24870;27884,52560,0,1,1,0,2
74903,170,18566,24478;24557;27864;28151,52560,0,2,2,0,4
74904,170,18567,24538;24778;27628,52560,0,0,3,0,3
74905,170,18568,24555;24907;27800;29027,52560,1,1,2,0,4
74906,170,18569,24572;24799;27985,52560,0,1,2,0,3
74907,170,18570,24591;24681;27617;27867,52560,0,1,3,0,4
74908,170,18571,24519;24871;28168;28340,52560,0,2,2,0,4
74909,170,18572,24319;24606;27698;28769,52560,0,1,3,0,4
74910,170,18573,24428;24863;27988;28073;28682,52560,0,3,2,0,5
74911,170,18574,24651;24805;27784,52560,0,1,2,0,3
74912,170,18575,24706;24986;28438,52560,0,1,2,0,3
74913,170,18576,24532;27777,52560,0,1,1,0,2
74914,170,18577,24740;24821;27440;27876;27983;28244,52560,0,3,3,0,6
74915,170,18578,24789;25002;27360;27637;28259,52560,0,1,4,0,5
74916,170,18579,24469;24794,52560,0,0,2,0,2
74917,170,18580,24798;28163,52560,0,1,1,0,2
74918,170,18582,24809;27631;28066;28165,52560,0,2,2,0,4
74919,170,18584,24831;25315;28695,52560,0,1,2,0,3
74920,170,18585,24667;24838;28432;28931,52560,1,1,2,0,4
74921,170,18586,24855,52560,0,0,1,0,1
74922,170,18587,24921;25144;29028,52560,1,0,2,0,3
74923,170,18588,24924;25123;27997,52560,0,1,2,0,3
74924,170,18589,24943;25276;28193,52560,0,1,2,0,3
74925,170,18590,25192,52560,0,0,1,0,1
74926,170,18591,20197,52925,0,0,0,1,1
74927,170,18592,20649,52925,0,0,0,1,1
74928,170,18593,20756,52925,0,0,0,1,1
74929,170,18597,21397,52925,0,0,0,1,1
74930,170,18599,20905,52925,0,0,0,1,1
74931,170,18600,21103,52925,0,0,0,1,1
74932,170,18602,21152,52925,0,0,0,1,1
74933,170,18613,21877,52925,0,0,0,1,1
74934,170,18614,21799;22047,52925,0,0,0,2,2
74935,170,18616,22118,52925,0,0,0,1,1
74936,170,18621,22787;23004,52925,0,0,1,1,2
74937,170,18627,22576;22920,52925,0,0,0,2,2
74938,170,18633,23378;23796,52925,0,0,2,0,2
74939,170,18635,23452;23524;26184,52925,0,0,3,0,3
74940,170,18636,23820;24159,52925,0,0,2,0,2
74941,170,18637,23451;23691;27470,52925,0,0,3,0,3
74942,170,18639,23466;23852;26782;27220;27576;27837;28677;28764;29198,52925,1,3,5,0,9
74943,170,18641,24271;24348;27596,52925,0,0,3,0,3
74944,170,18642,23823;24028;26885;27312;27582,52925,0,0,5,0,5
74945,170,18643,24665;24759;27438;27785,52925,0,1,3,0,4
74946,170,18644,23740;24391;26799;27249;27602;28421,52925,0,1,5,0,6
74947,170,18645,23641;24098,52925,0,0,2,0,2
74948,170,18647,24161;24666;27622,52925,0,0,3,0,3
74949,170,18648,23756;24176;27486,52925,0,0,3,0,3
74950,170,18649,24169;24230;27151,52925,0,0,3,0,3
74951,170,18650,24027;24390,52925,0,0,2,0,2
74952,170,18651,24965;27447;27537;28507,52925,0,1,3,0,4
74953,170,18652,24429;24598,52925,0,0,2,0,2
74954,170,18653,24704;26997;27523,52925,0,0,3,0,3
74955,170,18655,24852;25159;27803,52925,0,1,2,0,3
74956,170,18656,24682;25226;28001;28355;28934,52925,1,2,2,0,5
74957,170,18657,24515;25018,52925,0,0,2,0,2
74958,170,18659,24206;24525;27965,52925,0,1,2,0,3
74959,170,18660,24514;24533;27510;27611;28237;28596,52925,0,2,4,0,6
74960,170,18661,24254;24565,52925,0,0,2,0,2
74961,170,18662,24317;24566;27616;28058,52925,0,1,3,0,4
74962,170,18663,24576;27865;28238,52925,0,2,1,0,3
74963,170,18664,25099,52925,0,0,1,0,1
74964,170,18665,24611;28155,52925,0,1,1,0,2
74965,170,18666,24019;24629;27700,52925,0,0,3,0,3
74966,170,18667,24817;27529;27632;28248,52925,0,1,3,0,4
74967,170,18668,24636;24715,52925,0,0,2,0,2
74968,170,18669,24669;27977,52925,0,1,1,0,2
74969,170,18671,24336;24700;27874,52925,0,1,2,0,3
74970,170,18672,24739;24934,52925,0,0,2,0,2
74971,170,18674,24508;24713,52925,0,0,2,0,2
74972,170,18675,24769;24890;27444;27633;27799;27890;29298,52925,1,2,4,0,7
74973,170,18676,24819;25112;28353,52925,0,1,2,0,3
74974,170,18677,24684;24827,52925,0,0,2,0,2
74975,170,18678,24828;25013,52925,0,0,2,0,2
74976,170,18679,25146;25413,52925,0,0,2,0,2
74977,170,18680,24866;24929,52925,0,0,2,0,2
74978,170,18681,24851;24897;27882,52925,0,1,2,0,3
74979,170,18682,25122;25289;28194;29210,52925,1,1,2,0,4
74980,170,18683,25427;27555,52925,0,0,2,0,2
74981,170,18684,24970;25264;28192,52925,0,1,2,0,3
74982,170,18685,24951;25409;28200;28272;28455;28529;28854,52925,1,4,2,0,7
74983,170,18686,24954;25137;27635;28258,52925,0,1,3,0,4
74984,170,18687,24556;24959;28080,52925,0,1,2,0,3
74985,170,18688,24118;24976;27358;28601,52925,0,1,3,0,4
74986,170,18689,24987;25278,52925,0,0,2,0,2
74987,170,18691,24981;25070;27802;28686,52925,0,2,2,0,4
74988,170,18693,25082;25304;28196;28360,52925,0,2,2,0,4
74989,170,18694,25415,52925,0,0,1,0,1
74990,170,18700,20619,53290,0,0,0,1,1
74991,170,18703,20879,53290,0,0,0,1,1
74992,170,18706,21568,53290,0,0,0,1,1
74993,170,18708,21586;21705,53290,0,0,0,2,2
74994,170,18710,21118,53290,0,0,0,1,1
74995,170,18712,21734;21997,53290,0,0,0,2,2
74996,170,18718,21884,53290,0,0,0,1,1
74997,170,18721,22673;23319,53290,0,0,1,1,2
74998,170,18727,23165,53290,0,0,1,0,1
74999,170,18733,23636;23696;27385,53290,0,0,3,0,3
75000,170,18735,23865,53290,0,0,1,0,1
75001,170,18738,23664;23783,53290,0,0,2,0,2
75002,170,18741,23661;23749,53290,0,0,2,0,2
75003,170,18742,23869;23926;27223;27665;27842,53290,0,1,4,0,5
75004,170,18743,23781;24164;27236;27848,53290,0,1,3,0,4
75005,170,18745,24034;24109,53290,0,0,2,0,2
75006,170,18746,24337;28498,53290,0,1,1,0,2
75007,170,18747,24124;24304;26497;27766,53290,0,1,3,0,4
75008,170,18748,24170;24182,53290,0,0,2,0,2
75009,170,18749,24849;26809;27443;27533;28251;28681;29025;29297,53290,2,2,4,0,8
75010,170,18750,23989;24238;27489;27594,53290,0,0,4,0,4
75011,170,18751,24531;28149,53290,0,1,1,0,2
75012,170,18752,24156;24226,53290,0,0,2,0,2
75013,170,18755,24433;24823;28431,53290,0,1,2,0,3
75014,170,18756,24083;24457;27504,53290,0,0,3,0,3
75015,170,18757,24462;24735;27439,53290,0,0,3,0,3
75016,170,18759,24536;26502;27692;28597,53290,0,1,3,0,4
75017,170,18760,24359;24561;27614;28325,53290,0,1,3,0,4
75018,170,18761,24780,53290,0,0,1,0,1
75019,170,18762,24577;24600;26916;27165;27515;27969,53290,0,1,5,0,6
75020,170,18763,24635;24982,53290,0,0,2,0,2
75021,170,18764,24676;24796;28064,53290,0,1,2,0,3
75022,170,18765,24493;24683;27978,53290,0,1,2,0,3
75023,170,18766,24257;24697,53290,0,0,2,0,2
75024,170,18767,24725;25365;28853;28938,53290,2,0,2,0,4
75025,170,18768,24733;25267;28004;28098;28937,53290,1,2,2,0,5
75026,170,18769,24338;24804;28065,53290,0,1,2,0,3
75027,170,18770,24633;25183;28092,53290,0,1,2,0,3
75028,170,18772,24800;27986;28430,53290,0,2,1,0,3
75029,170,18774,24483;24818;27348;28502,53290,0,1,3,0,4
75030,170,18775,24832,53290,0,0,1,0,1
75031,170,18776,24492;25038;27638;28084;28348,53290,0,2,3,0,5
75032,170,18777,24837;25310,53290,0,0,2,0,2
75033,170,18778,24847;28250,53290,0,1,1,0,2
75034,170,18779,25063;27271;29199,53290,1,0,2,0,3
75035,170,18780,24677;25319;27729;28615,53290,0,1,3,0,4
75036,170,18781,24928;27356;27893;28600,53290,0,2,2,0,4
75037,170,18782,24935;25124;27644;28516,53290,0,1,3,0,4
75038,170,18783,24770;24946;27895;28257,53290,0,2,2,0,4
75039,170,18785,24689;24971;27713;27897;28081,53290,0,2,3,0,5
75040,170,18786,25209;25451;28263;28445,53290,0,2,2,0,4
75041,170,18787,24991;25060;27639;29206,53290,1,0,3,0,4
75042,170,18788,24997;25001;27539,53290,0,0,3,0,3
75043,170,18789,24825;25020;28083;28347,53290,0,2,2,0,4
75044,170,18790,24842;25090;27907;27995,53290,0,2,2,0,4
75045,170,18791,25347;25533,53290,0,0,2,0,2
75046,170,18792,24802;25109;28607,53290,0,1,2,0,3
75047,170,18793,25114;25527;28374,53290,0,1,2,0,3
75048,170,18794,25160;25303;28359,53290,0,1,2,0,3
75049,170,18796,25120;28846,53290,1,0,1,0,2
75050,170,18797,25134;25454;27557;28274;28855,53290,1,1,3,0,5
75051,170,18798,25145;25512;28110,53290,0,1,2,0,3
75052,170,18799,25519;27653;27924;28111,53290,0,2,2,0,4
75053,170,18800,25180;27722;28091,53290,0,1,2,0,3
75054,170,18806,20192,53655,0,0,0,1,1
75055,170,18809,21435,53655,0,0,0,1,1
75056,170,18810,21528,53655,0,0,0,1,1
75057,170,18816,21832,53655,0,0,0,1,1
75058,170,18817,21662,53655,0,0,0,1,1
75059,170,18818,21765,53655,0,0,0,1,1
75060,170,18825,22625,53655,0,0,0,1,1
75061,170,18827,22508;22699,53655,0,0,0,2,2
75062,170,18830,23227;23279;26457,53655,0,0,3,0,3
75063,170,18834,23595;23714,53655,0,0,2,0,2
75064,170,18837,23738,53655,0,0,1,0,1
75065,170,18838,23764;24619;28425,53655,0,1,2,0,3
75066,170,18839,23984;24194;27326;27951,53655,0,1,3,0,4
75067,170,18840,23946;23955;27479,53655,0,0,3,0,3
75068,170,18842,24371;24422;27247,53655,0,0,3,0,3
75069,170,18844,24358;24484;27431;28053,53655,0,1,3,0,4
75070,170,18845,24106;24179,53655,0,0,2,0,2
75071,170,18846,24134;24623;26918;27167;27783;27976,53655,0,2,4,0,6
75072,170,18847,24712;25067;27453;27640;28086,53655,0,1,4,0,5
75073,170,18848,24086;24210;28322,53655,0,1,2,0,3
75074,170,18849,24245;24357;27682,53655,0,0,3,0,3
75075,170,18850,24247;24284;27954,53655,0,1,2,0,3
75076,170,18852,24121;24678;27261;27623,53655,0,0,4,0,4
75077,170,18854,24383;24405,53655,0,0,2,0,2
75078,170,18855,24110;24219;27677,53655,0,0,3,0,3
75079,170,18856,24183;24427,53655,0,0,2,0,2
75080,170,18857,24763;28254;28845,53655,1,1,1,0,3
75081,170,18859,24567;28059,53655,0,1,1,0,2
75082,170,18860,24137;24601;27780,53655,0,1,2,0,3
75083,170,18862,24376;24588;27779;27866;28239,53655,0,3,2,0,5
75084,170,18863,24654;25265;27645;28003;28523,53655,0,2,3,0,5
75085,170,18864,24631;24942,53655,0,0,2,0,2
75086,170,18865,24707;27524,53655,0,0,2,0,2
75087,170,18866,24613;24720,53655,0,0,2,0,2
75088,170,18867,24396;24732,53655,0,0,2,0,2
75089,170,18869,24716;25025,53655,0,0,2,0,2
75090,170,18871,24403;24841;28068;28166,53655,0,2,2,0,4
75091,170,18873,25327,53655,0,0,1,0,1
75092,170,18874,24896;24975;28173,53655,0,1,2,0,3
75093,170,18875,25117,53655,0,0,1,0,1
75094,170,18876,24590;25102;27455;28179,53655,0,1,3,0,4
75095,170,18877,24974;25620,53655,0,0,2,0,2
75096,170,18878,24641;25051;27718;27904,53655,0,1,3,0,4
75097,170,18879,25384;25756;27922;28271;28368;28700,53655,0,4,2,0,6
75098,170,18880,24880;25057;27888;28169;28433,53655,0,3,2,0,5
75099,170,18881,24496;24999;28082,53655,0,1,2,0,3
75100,170,18882,25087;25258;27272;27994,53655,0,1,3,0,4
75101,170,18883,24782;25428;28273;28531,53655,0,2,2,0,4
75102,170,18884,25115;25604;28018;28284;28385;29043,53655,1,3,2,0,6
75103,170,18885,24948;25316;27552;27728;27808,53655,0,1,4,0,5
75104,170,18886,25270;27275,53655,0,0,2,0,2
75105,170,18887,25184;25621;28549,53655,0,1,2,0,3
75106,170,18888,25044;25186;27544;28093,53655,0,1,3,0,4
75107,170,18889,25043;25194;28185,53655,0,1,2,0,3
75108,170,18890,25138;25530,53655,0,0,2,0,2
75109,170,18891,25560;25580;28282;28625,53655,0,2,2,0,4
75110,170,18892,25417;25589;28547,53655,0,1,2,0,3
75111,170,18893,25430;25543;29132,53655,1,0,2,0,3
75112,170,18894,25111;25582;28544,53655,0,1,2,0,3
75113,170,18895,25295;27551;27726;29299,53655,1,0,3,0,4
75114,170,18896,25306;27727;28361;28777,53655,0,2,2,0,4
75115,170,18897,25631;28118,53655,0,1,1,0,2
75116,170,18898,25568;28209,53655,0,1,1,0,2
75117,170,18901,21167,54020,0,0,0,1,1
75118,170,18904,21276;21383,54020,0,0,0,2,2
75119,170,18907,21838,54020,0,0,0,1,1
75120,170,18909,21419,54020,0,0,0,1,1
75121,170,18910,21813,54020,0,0,0,1,1
75122,170,18915,22353,54020,0,0,0,1,1
75123,170,18918,22690;22814,54020,0,0,0,2,2
75124,170,18921,22858;22914,54020,0,0,0,2,2
75125,170,18922,22797;22876,54020,0,0,0,2,2
75126,170,18923,23022;23183,54020,0,0,2,0,2
75127,170,18927,24016;24154;26985,54020,0,0,3,0,3
75128,170,18930,23987;24208;27676;27852;27953,54020,0,2,3,0,5
75129,170,18932,23633;23768,54020,0,0,2,0,2
75130,170,18933,24032;24287;28420,54020,0,1,2,0,3
75131,170,18935,24145;24331;28046,54020,0,1,2,0,3
75132,170,18937,24037;24196;26203,54020,0,0,3,0,3
75133,170,18938,24205;27851,54020,0,1,1,0,2
75134,170,18939,24068;24330;28234,54020,0,1,2,0,3
75135,170,18940,24318;24618;27699;27975,54020,0,1,3,0,4
75136,170,18941,24236;24240;26898;27329;27418;29201,54020,1,0,5,0,6
75137,170,18943,24286;27331;27420,54020,0,0,3,0,3
75138,170,18946,24011;24406;28049,54020,0,1,2,0,3
75139,170,18947,24685;24768;27521;27625;27873,54020,0,1,4,0,5
75140,170,18948,24423;24751;27706;27877;28333,54020,0,2,3,0,5
75141,170,18949,23857;24455;27257,54020,0,0,3,0,3
75142,170,18950,24914;27095;27355;27711,54020,0,0,4,0,4
75143,170,18951,24486;24984;27636;27714;28175,54020,0,1,4,0,5
75144,170,18953,24553;24614;27967;28150,54020,0,2,2,0,4
75145,170,18954,24979;28174,54020,0,1,1,0,2
75146,170,18955,24671;27344;28330,54020,0,1,2,0,3
75147,170,18956,24691;24875;28505,54020,0,1,2,0,3
75148,170,18957,24918;25008;27448;27901;28439,54020,0,2,3,0,5
75149,170,18958,24617;24772;27091;28335;28679,54020,0,2,3,0,5
75150,170,18959,24584;24705;28242,54020,0,1,2,0,3
75151,170,18960,24500;24781;28246,54020,0,1,2,0,3
75152,170,18961,24582;24797,54020,0,0,2,0,2
75153,170,18962,24808;24833;27708,54020,0,0,3,0,3
75154,170,18963,24599;25139;27543;27721,54020,0,0,4,0,4
75155,170,18964,24887;25236;28002;28265;28447;28935,54020,1,3,2,0,6
75156,170,18965,24947;28685,54020,0,1,1,0,2
75157,170,18966,24977;25010;27449;28346,54020,0,1,3,0,4
75158,170,18967,24879;25155;28181,54020,0,1,2,0,3
75159,170,18968,25021;25372;28367,54020,0,1,2,0,3
75160,170,18969,25034;25612;28285;29134,54020,1,1,2,0,4
75161,170,18970,24912;25059;27451;28513,54020,0,1,3,0,4
75162,170,18971,25009;25062;28260;28510,54020,0,2,2,0,4
75163,170,18972,24544;25080;27364;28178,54020,0,1,3,0,4
75164,170,18973,25104;25190;28184;28354;28609,54020,0,3,2,0,5
75165,170,18975,25149;25521;28112;28205,54020,0,2,2,0,4
75166,170,18976,25168;25188;27911,54020,0,1,2,0,3
75167,170,18977,25177;25185;27804;27999;28090;28182;28444,54020,0,5,2,0,7
75168,170,18978,24872;25191;27266;27885;28074,54020,0,2,3,0,5
75169,170,18980,24911;25203;27913,54020,0,1,2,0,3
75170,170,18981,25713;25726;28215;28950,54020,1,1,2,0,4
75171,170,18982,25246;28189;28449,54020,0,2,1,0,3
75172,170,18983,25174;25242;27549;28095;28356;28521,54020,0,3,3,0,6
75173,170,18984,25275;28451,54020,0,1,1,0,2
75174,170,18986,25218;25426,54020,0,0,2,0,2
75175,170,18987,24793;25321;29031,54020,1,0,2,0,3
75176,170,18988,24569;25322,54020,0,0,2,0,2
75177,170,18989,25324;25445,54020,0,0,2,0,2
75178,170,18990,25388;25515,54020,0,0,2,0,2
75179,170,18991,25326;25487;27462;27558;28622;28703;29213,54020,1,2,4,0,7
75180,170,18992,25329;25555;28859,54020,1,0,2,0,3
75181,170,18993,25048;25330;28100;28198,54020,0,2,2,0,4
75182,170,18994,25207;25336;27812;28526,54020,0,2,2,0,4
75183,170,18995,25234;25338,54020,0,0,2,0,2
75184,170,18996,25356,54020,0,0,1,0,1
75185,170,18997,25360;25459;28199;28697,54020,0,2,2,0,4
75186,170,18998,25220;25382;28610,54020,0,1,2,0,3
75187,170,18999,25221;25390;28010,54020,0,1,2,0,3
75188,170,19000,25423;25670,54020,0,0,2,0,2
75189,170,19001,25400;25436;28369,54020,0,1,2,0,3
75190,170,19002,21144,54385,0,0,0,1,1
75191,170,19006,21672,54385,0,0,0,1,1
75192,170,19007,21819,54385,0,0,0,1,1
75193,170,19008,21955,54385,0,0,0,1,1
75194,170,19009,22221;22675,54385,0,0,0,2,2
75195,170,19019,23043,54385,0,0,1,0,1
75196,170,19026,23637,54385,0,0,1,0,1
75197,170,19027,23717,54385,0,0,1,0,1
75198,170,19030,23918,54385,0,0,1,0,1
75199,170,19031,23966;24351;27600,54385,0,0,3,0,3
75200,170,19036,24622;28329,54385,0,1,1,0,2
75201,170,19037,24753;26806;27878,54385,0,1,2,0,3
75202,170,19041,24352;24365;27601;28047,54385,0,1,3,0,4
75203,170,19043,24437;24608;27518;27620;27781;28154;28328,54385,0,3,4,0,7
75204,170,19044,24444;27605,54385,0,0,2,0,2
75205,170,19045,24456;24563,54385,0,0,2,0,2
75206,170,19046,24637,54385,0,0,1,0,1
75207,170,19047,24490;24589,54385,0,0,2,0,2
75208,170,19052,24714;25205,54385,0,0,2,0,2
75209,170,19053,24777;25164,54385,0,0,2,0,2
75210,170,19054,24786;24888;28771,54385,0,1,2,0,3
75211,170,19055,24787;24926;27712;27892;28255;28436,54385,0,3,3,0,6
75212,170,19056,25012;25353;27553;28365;28852,54385,1,1,3,0,5
75213,170,19057,24826;24895;27172;28770,54385,0,1,3,0,4
75214,170,19058,24835;24860;26924;27883;28253,54385,0,2,3,0,5
75215,170,19060,24868;25040;27903,54385,0,1,2,0,3
75216,170,19061,24658;24885;27267,54385,0,0,3,0,3
75217,170,19062,24472;24919;28170,54385,0,1,2,0,3
75218,170,19063,24945;25457;28106;28702;28779;28856,54385,1,3,2,0,6
75219,170,19064,24963;25212,54385,0,0,2,0,2
75220,170,19065,24973;25230;27914,54385,0,1,2,0,3
75221,170,19066,25163;28608,54385,0,1,1,0,2
75222,170,19067,25328;25378;27810;28525;28616;29211,54385,1,3,2,0,6
75223,170,19068,25041;25484;28945,54385,1,0,2,0,3
75224,170,19069,24983;25249;28266,54385,0,1,2,0,3
75225,170,19070,25042;25131;27908;28089,54385,0,2,2,0,4
75226,170,19071,25151;25606;27182;28863;29044,54385,2,0,3,0,5
75227,170,19072,25156;28688,54385,0,1,1,0,2
75228,170,19073,25028;25167,54385,0,0,2,0,2
75229,170,19074,25215;28776,54385,0,1,1,0,2
75230,170,19075,25022;25411;28201;28530;28618,54385,0,3,2,0,5
75231,170,19076,25393;25532;28113;28279;28624,54385,0,3,2,0,5
75232,170,19077,25368;25538;27372;28281;28858,54385,1,1,3,0,5
75233,170,19078,24834;25250;27806;28190;28357;28450,54385,0,4,2,0,6
75234,170,19079,25254;25499;28096,54385,0,1,2,0,3
75235,170,19080,25433;25575;26521;27559;28283;28708;29042,54385,1,2,4,0,7
75236,170,19081,24909;25292;27550;28195;28453,54385,0,2,3,0,5
75237,170,19083,25796;25877;28717;28870,54385,1,1,2,0,4
75238,170,19084,24660;25299;28099,54385,0,1,2,0,3
75239,170,19085,25108;25350;27813,54385,0,1,2,0,3
75240,170,19086,24967;25377,54385,0,0,2,0,2
75241,170,19088,25704,54385,0,0,1,0,1
75242,170,19089,25443;25494;27819,54385,0,1,2,0,3
75243,170,19090,25448;25655;28631,54385,0,1,2,0,3
75244,170,19091,25449;25649;28464,54385,0,1,2,0,3
75245,170,19092,25467;25500;27734,54385,0,0,3,0,3
75246,170,19093,25296;25483,54385,0,0,2,0,2
75247,170,19095,25498;25714;28633;29048,54385,1,1,2,0,4
75248,170,19096,21958,54750,0,0,0,1,1
75249,170,19097,21446;21903,54750,0,0,0,2,2
75250,170,19099,21691,54750,0,0,0,1,1
75251,170,19101,21822,54750,0,0,0,1,1
75252,170,19105,22272,54750,0,0,0,1,1
75253,170,19106,22404;22718,54750,0,0,0,2,2
75254,170,19114,23096;23521,54750,0,0,2,0,2
75255,170,19118,23337;23555;27121,54750,0,0,3,0,3
75256,170,19120,23618;23780;26586;27942,54750,0,1,3,0,4
75257,170,19124,24112,54750,0,0,1,0,1
75258,170,19126,24303,54750,0,0,1,0,1
75259,170,19127,24221;24648,54750,0,0,2,0,2
75260,170,19128,24059;24341;27495,54750,0,0,3,0,3
75261,170,19129,24465;24471,54750,0,0,2,0,2
75262,170,19130,24546,54750,0,0,1,0,1
75263,170,19131,25019;25142;27993,54750,0,1,2,0,3
75264,170,19133,24698;25000,54750,0,0,2,0,2
75265,170,19134,24488;24994;27715;27992,54750,0,1,3,0,4
75266,170,19135,24719,54750,0,0,1,0,1
75267,170,19136,25098;25113;27643,54750,0,0,3,0,3
75268,170,19137,24767;24858;27797,54750,0,1,2,0,3
75269,170,19138,24773;24941;27794,54750,0,1,2,0,3
75270,170,19139,24801;24813;26715;27630;27879;28164,54750,0,2,4,0,6
75271,170,19140,24846;28503,54750,0,1,1,0,2
75272,170,19141,24727;24902;28076,54750,0,1,2,0,3
75273,170,19142,24922;25116,54750,0,0,2,0,2
75274,170,19144,24898;24953;27891,54750,0,1,2,0,3
75275,170,19145,25421;25471;28012;28107,54750,0,2,2,0,4
75276,170,19147,24980;25485;28276,54750,0,1,2,0,3
75277,170,19148,24989;25086;27099;28443;28515;28687;29119,54750,1,3,3,0,7
75278,170,19149,25026;25029,54750,0,0,2,0,2
75279,170,19150,24792;25046;27346;28063;28429;28843,54750,0,3,3,0,6
75280,170,19151,25607;28212;28948,54750,1,1,1,0,3
75281,170,19152,25095;25633;28628,54750,0,1,2,0,3
75282,170,19154,25348;25551;27457,54750,0,0,3,0,3
75283,170,19155,25152;25153;27102;28847,54750,1,0,3,0,4
75284,170,19156,24995;25583,54750,0,0,2,0,2
75285,170,19157,25165;25641,54750,0,0,2,0,2
75286,170,19158,25176,54750,0,0,1,0,1
75287,170,19159,25011;25331;27811,54750,0,1,2,0,3
75288,170,19160,25245;25822;27827;28292;28473;28559;28957;29050,54750,2,4,2,0,8
75289,170,19161,25751;27736;28714,54750,0,1,2,0,3
75290,170,19162,25284;27646;27917;28613;29300,54750,1,2,2,0,5
75291,170,19163,25305;25468,54750,0,0,2,0,2
75292,170,19164,25320;28007,54750,0,1,1,0,2
75293,170,19165,25818;28126;28719;28956;29141;29220,54750,3,2,1,0,6
75294,170,19166,25425;25802;28022;28124;28871,54750,1,2,2,0,5
75295,170,19167,25252;25446;27817,54750,0,1,2,0,3
75296,170,19168,25567;28379;28461,54750,0,2,1,0,3
75297,170,19169,25481;25788;29219,54750,1,0,2,0,3
75298,170,19170,25490;25493;28014,54750,0,1,2,0,3
75299,170,19171,25666;25752;27931;28291,54750,0,2,2,0,4
75300,170,19173,25525;25883;28877,54750,1,0,2,0,3
75301,170,19174,25745;25986;28122;28635,54750,0,2,2,0,4
75302,170,19175,25547;25603;28115;29214,54750,1,1,2,0,4
75303,170,19176,25541;25557;28015;28206;28375,54750,0,3,2,0,5
75304,170,19177,25504;25559;28207;28459;28705,54750,0,3,2,0,5
75305,170,19178,25591;28382,54750,0,1,1,0,2
75306,170,19179,25503;25601;28116;28211;28463,54750,0,3,2,0,5
75307,170,19180,25613;25897;28296;29144,54750,1,1,2,0,4
75308,170,19181,21273;21547,55115,0,0,0,2,2
75309,170,19183,21139,55115,0,0,0,1,1
75310,170,19185,21434,55115,0,0,0,1,1
75311,170,19186,20990,55115,0,0,0,1,1
75312,170,19188,21400,55115,0,0,0,1,1
75313,170,19190,21747,55115,0,0,0,1,1
75314,170,19191,21758,55115,0,0,0,1,1
75315,170,19192,21318;21485,55115,0,0,0,2,2
75316,170,19194,21879,55115,0,0,0,1,1
75317,170,19195,22088;22657,55115,0,0,0,2,2
75318,170,19196,22122;22465,55115,0,0,0,2,2
75319,170,19197,22123;22401,55115,0,0,0,2,2
75320,170,19201,22949;23008;25889,55115,0,0,3,0,3
75321,170,19205,22784,55115,0,0,0,1,1
75322,170,19206,23070;23305,55115,0,0,2,0,2
75323,170,19209,23192;23390,55115,0,0,2,0,2
75324,170,19210,23548;27570,55115,0,0,2,0,2
75325,170,19216,23405;23757;27662;28036,55115,0,1,3,0,4
75326,170,19219,23844;24253;28419,55115,0,1,2,0,3
75327,170,19220,23951;24280;27330;28045;29202,55115,1,1,3,0,5
75328,170,19221,23782;24123;27948,55115,0,1,2,0,3
75329,170,19223,24132;24843;27265;27532,55115,0,0,4,0,4
75330,170,19226,24325;24494;27508;27608,55115,0,0,4,0,4
75331,170,19227,24394,55115,0,0,1,0,1
75332,170,19228,24223;24340;27856,55115,0,1,2,0,3
75333,170,19230,24260;24438;27771,55115,0,1,2,0,3
75334,170,19233,24998;29130,55115,1,0,1,0,2
75335,170,19234,24107;24865,55115,0,0,2,0,2
75336,170,19235,24659;25036;27902,55115,0,1,2,0,3
75337,170,19236,24687;28331,55115,0,1,1,0,2
75338,170,19237,24375;24547;26709;27513,55115,0,0,4,0,4
75339,170,19238,24873;25158;27094;27798;28504,55115,0,2,3,0,5
75340,170,19239,24931;25232;28520,55115,0,1,2,0,3
75341,170,19240,24764;25072;27454;28087,55115,0,1,3,0,4
75342,170,19241,25030;25078;27906;28088;28606,55115,0,3,2,0,5
75343,170,19242,25162;28689,55115,0,1,1,0,2
75344,170,19243,24774;25394,55115,0,0,2,0,2
75345,170,19244,25208;25773;28715,55115,0,1,2,0,3
75346,170,19245,25233;25529;28446,55115,0,1,2,0,3
75347,170,19246,25228;25513;28537,55115,0,1,2,0,3
75348,170,19247,24932;25065;28350,55115,0,1,2,0,3
75349,170,19248,25172;25286;27918;28849,55115,1,1,2,0,4
75350,170,19249,25293;25355;28009,55115,0,1,2,0,3
75351,170,19250,25178;25712,55115,0,0,2,0,2
75352,170,19251,24592;25332;27731;27921;29032,55115,1,1,3,0,5
75353,170,19252,25125;25349,55115,0,0,2,0,2
75354,170,19253,25379;25640;27374;28550;28629;28710;28785,55115,0,4,3,0,7
75355,170,19254,25748;28636,55115,0,1,1,0,2
75356,170,19255,25391;25727;28020;28392,55115,0,2,2,0,4
75357,170,19256,25815;25831,55115,0,0,2,0,2
75358,170,19257,25399;25511;28109;28536;29039,55115,1,2,2,0,5
75359,170,19258,25799,55115,0,0,1,0,1
75360,170,19259,25129;25422,55115,0,0,2,0,2
75361,170,19260,25595;25718;28391;28865,55115,1,1,2,0,4
75362,170,19261,25166;25444;27816;28372;28457;28619;28942,55115,1,4,2,0,7
75363,170,19262,25450;25757;28778,55115,0,1,2,0,3
75364,170,19263,25455;25825;28128,55115,0,1,2,0,3
75365,170,19264,25312;25464;28532,55115,0,1,2,0,3
75366,170,19266,25469;25537;28280,55115,0,1,2,0,3
75367,170,19267,25480;25531;27652;28534,55115,0,1,3,0,4
75368,170,19268,25497;25930;28400;28648;28798;29228,55115,1,3,2,0,6
75369,170,19269,25501,55115,0,0,1,0,1
75370,170,19270,25477;25917;28130;28647;28880;28964,55115,2,2,2,0,6
75371,170,19271,25435;25518,55115,0,0,2,0,2
75372,170,19272,25553;25628;28377,55115,0,1,2,0,3
75373,170,19273,25340;25565;27927;28208;28541,55115,0,3,2,0,5
75374,170,19274,25314,55115,0,0,1,0,1
75375,170,19275,25505;25571;28380;28542,55115,0,2,2,0,4
75376,170,19276,25614;25890;28568,55115,0,1,2,0,3
75377,170,19277,25617;25626;27822;28386;28627;28709,55115,0,4,2,0,6
75378,170,19278,25643;25876;28295;28566;28726,55115,0,3,2,0,5
75379,170,19279,25671;25786;29216,55115,1,0,2,0,3
75380,170,19280,25701;25902;27740,55115,0,0,3,0,3
75381,170,19281,25719;25769;28120;28214;28787,55115,0,3,2,0,5
75382,170,19282,25723;25810;28221;28557;28640,55115,0,3,2,0,5
75383,170,19284,25886;26001;27564;28567;28795,55115,0,2,3,0,5
75384,170,19285,21345,55480,0,0,0,1,1
75385,170,19286,21526,55480,0,0,0,1,1
75386,170,19287,21275;21686,55480,0,0,0,2,2
75387,170,19298,21432,55480,0,0,0,1,1
75388,170,19300,23223;23557,55480,0,0,2,0,2
75389,170,19304,22998,55480,0,0,1,0,1
75390,170,19308,23335,55480,0,0,1,0,1
75391,170,19311,23172;23672;26680;28675,55480,0,1,3,0,4
75392,170,19317,23721;24168;27675,55480,0,0,3,0,3
75393,170,19318,23975;24119,55480,0,0,2,0,2
75394,170,19321,24679;27624;27786;28158,55480,0,2,2,0,4
75395,170,19322,24066,55480,0,0,1,0,1
75396,170,19323,24023,55480,0,0,1,0,1
75397,170,19325,24742;25313;27368;27920;28269,55480,0,2,3,0,5
75398,170,19326,24574,55480,0,0,1,0,1
75399,170,19327,24627;25373;28617,55480,0,1,2,0,3
75400,170,19331,24884;28683,55480,0,1,1,0,2
75401,170,19332,24766;25017;28245,55480,0,1,2,0,3
75402,170,19334,25290;27647;27919;28850,55480,1,1,2,0,4
75403,170,19336,25015;25161,55480,0,0,2,0,2
75404,170,19337,25031;25154,55480,0,0,2,0,2
75405,170,19338,25039;25260;28097;28191;28358;28522;28693;28936,55480,1,5,2,0,8
75406,170,19341,25268;25516;28204;28278;28946,55480,1,2,2,0,5
75407,170,19342,25091;25578;28947,55480,1,0,2,0,3
75408,170,19343,25257;25474;27461,55480,0,0,3,0,3
75409,170,19344,24956;25266;27274;28611,55480,0,1,3,0,4
75410,170,19345,25279;25507,55480,0,0,2,0,2
75411,170,19346,25193;25323;27648;27730,55480,0,0,4,0,4
75412,170,19347,25463;28621;28857,55480,1,1,1,0,3
75413,170,19348,25624;25975;28226;29231,55480,1,1,2,0,4
75414,170,19349,25381;25662;28786;29135,55480,1,1,2,0,4
75415,170,19350,25858;28294,55480,0,1,1,0,2
75416,170,19351,25473;25618;28286,55480,0,1,2,0,3
75417,170,19352,25506;25684;28468,55480,0,1,2,0,3
75418,170,19353,25689;27184;29218,55480,1,0,2,0,3
75419,170,19354,25520;25846;28723;29225,55480,1,1,2,0,4
75420,170,19355,25544;26037;28481,55480,0,1,2,0,3
75421,170,19356,25466;25562;28781;29041,55480,1,1,2,0,4
75422,170,19357,25570;26036;28735;28804;28891,55480,1,2,2,0,5
75423,170,19358,25981;26118;29061;29149,55480,2,0,2,0,4
75424,170,19359,25524;25759;28471;28952,55480,1,1,2,0,4
75425,170,19360,25300;25741;28290,55480,0,1,2,0,3
75426,170,19361,25697;25755;28218;28951,55480,1,1,2,0,4
75427,170,19362,25758;26016;28298,55480,0,1,2,0,3
75428,170,19363,25648;25761;28021;28219;28637,55480,0,3,2,0,5
75429,170,19364,25645;25764;27466,55480,0,0,3,0,3
75430,170,19365,25768;25962;28131;29148,55480,1,1,2,0,4
75431,170,19366,26000;26006;27831;27934;28297;28402;28889,55480,1,4,2,0,7
75432,170,19367,25734;25793,55480,0,0,2,0,2
75433,170,19368,25795;26075;28806;29237,55480,1,1,2,0,4
75434,170,19369,21546,55845,0,0,0,1,1
75435,170,19370,21601,55845,0,0,0,1,1
75436,170,19372,21349,55845,0,0,0,1,1
75437,170,19374,21719,55845,0,0,0,1,1
75438,170,19375,21886,55845,0,0,0,1,1
75439,170,19377,21637,55845,0,0,0,1,1
75440,170,19379,22541;22702,55845,0,0,0,2,2
75441,170,19383,22128,55845,0,0,0,1,1
75442,170,19386,22836,55845,0,0,0,1,1
75443,170,19388,23316;23440,55845,0,0,2,0,2
75444,170,19389,23446,55845,0,0,1,0,1
75445,170,19390,23467;23720,55845,0,0,2,0,2
75446,170,19394,24046;24419;27687,55845,0,0,3,0,3
75447,170,19396,23980;24128,55845,0,0,2,0,2
75448,170,19397,24233;24529,55845,0,0,2,0,2
75449,170,19398,24323;24417;27427;27500;27686,55845,0,0,5,0,5
75450,170,19401,25066;27098;27905;28177;28441,55845,0,3,2,0,5
75451,170,19403,24141;24904;28077;28932,55845,1,1,2,0,4
75452,170,19405,24634;25540;28114;28539,55845,0,2,2,0,4
75453,170,19409,24958;28344,55845,0,1,1,0,2
75454,170,19410,24513;24776;28161,55845,0,1,2,0,3
75455,170,19411,25181;25453;28203;28373;28620;28943;29037,55845,2,3,2,0,7
75456,170,19412,25033;25189,55845,0,0,2,0,2
75457,170,19413,25054;28604,55845,0,1,1,0,2
75458,170,19414,25514;28538;28623,55845,0,2,1,0,3
75459,170,19417,24836,55845,0,0,1,0,1
75460,170,19418,25392;25717,55845,0,0,2,0,2
75461,170,19419,25412;25675,55845,0,0,2,0,2
75462,170,19420,25309;26005;28970;29150,55845,2,0,2,0,4
75463,170,19421,24814;24930;28171;28343,55845,0,2,2,0,4
75464,170,19422,25335;28363;28851,55845,1,1,1,0,3
75465,170,19423,25401;25608,55845,0,0,2,0,2
75466,170,19424,25376;25672,55845,0,0,2,0,2
75467,170,19425,25179;25440;27556;27651;27815;28371,55845,0,2,4,0,6
75468,170,19426,25171;25489;28108;28535,55845,0,2,2,0,4
75469,170,19427,25243;25462;28944,55845,1,0,2,0,3
75470,170,19428,25337;25495,55845,0,0,2,0,2
75471,170,19429,25596;28210;28383,55845,0,2,1,0,3
75472,170,19431,25545;25665;27562;28019,55845,0,1,3,0,4
75473,170,19433,25564;26138;27832,55845,0,1,2,0,3
75474,170,19434,25573;25634;28017;28707,55845,0,2,2,0,4
75475,170,19435,25598;25920;28881;29145;29227,55845,3,0,2,0,5
75476,170,19436,25609;25813;27735,55845,0,0,3,0,3
75477,170,19437,25496;25778,55845,0,0,2,0,2
75478,170,19438,25652;25762;28465,55845,0,1,2,0,3
75479,170,19439,25663;27825,55845,0,1,1,0,2
75480,170,19440,25680;28466,55845,0,1,1,0,2
75481,170,19441,25585;25708;28119;28864,55845,1,1,2,0,4
75482,170,19442,25740;26046;28892;29234,55845,2,0,2,0,4
75483,170,19443,25442;25746;28867,55845,1,0,2,0,3
75484,170,19444,25777;26098;28406,55845,0,1,2,0,3
75485,170,19445,25420;25783;27654;28220;28868;29049,55845,2,1,3,0,6
75486,170,19446,25833;28476;28561;28720;28872,55845,1,3,1,0,5
75487,170,19447,25826,55845,0,0,1,0,1
75488,170,19448,25729;25847;28121;28216,55845,0,2,2,0,4
75489,170,19449,25853;25882;27739;28793;28876,55845,1,1,3,0,5
75490,170,19450,25859;26021;28480,55845,0,1,2,0,3
75491,170,19451,26040;26122;28741;28980;29158;29239,55845,3,1,2,0,6
75492,170,19452,25794;25958;27743;28479;28731,55845,0,2,3,0,5
75493,170,19453,25866;26113;28575;28978,55845,1,1,2,0,4
75494,170,19454,21587,56210,0,0,0,1,1
75495,170,19456,21770;22040,56210,0,0,0,2,2
75496,170,19457,21609,56210,0,0,0,1,1
75497,170,19458,21984,56210,0,0,0,1,1
75498,170,19459,21992,56210,0,0,0,1,1
75499,170,19460,22006,56210,0,0,0,1,1
75500,170,19463,22151,56210,0,0,0,1,1
75501,170,19464,22167,56210,0,0,0,1,1
75502,170,19465,22213,56210,0,0,0,1,1
75503,170,19466,22313,56210,0,0,0,1,1
75504,170,19467,22327,56210,0,0,0,1,1
75505,170,19471,22463;23019,56210,0,0,1,1,2
75506,170,19472,22291,56210,0,0,0,1,1
75507,170,19480,21923;22494,56210,0,0,0,2,2
75508,170,19481,22848;23045,56210,0,0,1,1,2
75509,170,19482,23059;23153,56210,0,0,2,0,2
75510,170,19484,22608;22860,56210,0,0,0,2,2
75511,170,19485,22865;23145,56210,0,0,1,1,2
75512,170,19492,24056,56210,0,0,1,0,1
75513,170,19494,24148;24450;28051;28499,56210,0,2,2,0,4
75514,170,19496,24165;24710,56210,0,0,2,0,2
75515,170,19497,24252;24269,56210,0,0,2,0,2
75516,170,19499,24487;24820;27530,56210,0,0,3,0,3
75517,170,19501,24810;25238;27548;28691,56210,0,1,3,0,4
75518,170,19502,24892;25364,56210,0,0,2,0,2
75519,170,19503,24925;25574;28543;28782,56210,0,2,2,0,4
75520,170,19504,24803;24957;27446;28437,56210,0,1,3,0,4
75521,170,19505,24985;25032;27270;28773,56210,0,1,3,0,4
75522,170,19506,25683;28213;28390;28467,56210,0,3,1,0,4
75523,170,19507,24882;25061;27452;28085;28261,56210,0,2,3,0,5
75524,170,19508,25371;25743;28866,56210,1,0,2,0,3
75525,170,19509,24426;25093;28262,56210,0,1,2,0,3
75526,170,19510,25096,56210,0,0,1,0,1
75527,170,19511,25397;25600;28384;28462,56210,0,2,2,0,4
75528,170,19512,25214;25343;28186,56210,0,1,2,0,3
75529,170,19513,25241;27723;28188,56210,0,1,2,0,3
75530,170,19514,25318;25907,56210,0,0,2,0,2
75531,170,19516,25366;25829;28395;28474;28958,56210,1,2,2,0,5
75532,170,19517,25380;25491;28277,56210,0,1,2,0,3
75533,170,19518,25576;25879;28646;28961,56210,1,1,2,0,4
75534,170,19519,25387;25441;28701,56210,0,1,2,0,3
75535,170,19520,25502,56210,0,0,1,0,1
75536,170,19521,25479;25656;28551,56210,0,1,2,0,3
75537,170,19523,25676;25678;29217,56210,1,0,2,0,3
75538,170,19524,25679;26134;28576;28655,56210,0,2,2,0,4
75539,170,19525,25688;25836,56210,0,0,2,0,2
75540,170,19526,25696;25819;28127;28789;29221,56210,1,2,2,0,5
75541,170,19527,25566;25700,56210,0,0,2,0,2
75542,170,19529,25711;26018;28299;28802;28890;29064;29151,56210,3,2,2,0,7
75543,170,19530,25744;26023,56210,0,0,2,0,2
75544,170,19531,25996,56210,0,0,1,0,1
75545,170,19532,25760;25849;28397;28477;28643,56210,0,3,2,0,5
75546,170,19533,25827;26050;28893,56210,1,0,2,0,3
75547,170,19534,25685;25867;28874,56210,1,0,2,0,3
75548,170,19535,25857;25869,56210,0,0,2,0,2
75549,170,19536,25870;25908,56210,0,0,2,0,2
75550,170,19538,25881;26182,56210,0,0,2,0,2
75551,170,19539,25896;29057,56210,1,0,1,0,2
75552,170,19540,25901,56210,0,0,1,0,1
75553,170,19541,25915;26083;28652;28895;28973;29156,56210,3,1,2,0,6
75554,170,19542,25918;26027;28399;29059,56210,1,1,2,0,4
75555,170,19543,25922;26225;28903,56210,1,0,2,0,3
75556,170,19544,25932;26265;28136;28905;29250,56210,2,1,2,0,5
75557,170,19545,25935,56210,0,0,1,0,1
75558,170,19546,25952;26199;28305,56210,0,1,2,0,3
75559,170,19547,25782;25967;27933;28027;28650;28884,56210,1,3,2,0,6
75560,170,19548,25673;25980;28800,56210,0,1,2,0,3
75561,170,19549,26008;26030,56210,0,0,2,0,2
75562,170,19550,25988;26273;28309,56210,0,1,2,0,3
75563,170,19551,25909;25998,56210,0,0,2,0,2
75564,170,19553,21752;22370,56575,0,0,0,2,2
75565,170,19554,21560,56575,0,0,0,1,1
75566,170,19556,21677,56575,0,0,0,1,1
75567,170,19557,21869,56575,0,0,0,1,1
75568,170,19559,21570,56575,0,0,0,1,1
75569,170,19562,22171,56575,0,0,0,1,1
75570,170,19563,22558,56575,0,0,0,1,1
75571,170,19564,22520,56575,0,0,0,1,1
75572,170,19565,22563,56575,0,0,0,1,1
75573,170,19566,22773,56575,0,0,0,1,1
75574,170,19567,22847;23005,56575,0,0,1,1,2
75575,170,19569,23150,56575,0,0,1,0,1
75576,170,19570,23362,56575,0,0,1,0,1
75577,170,19585,24442;24632;27870,56575,0,1,2,0,3
75578,170,19587,24096;24495,56575,0,0,2,0,2
75579,170,19590,24686;24701;27980,56575,0,1,2,0,3
75580,170,19591,24869;25561;28460;28706;28860,56575,1,2,2,0,5
75581,170,19594,24936;25646;27824,56575,0,1,2,0,3
75582,170,19595,25274;28005;28612,56575,0,2,1,0,3
75583,170,19596,24610;24881;27710;27889;28075;28434;28506,56575,0,4,3,0,7
75584,170,19597,24549;24993;27899,56575,0,1,2,0,3
75585,170,19598,25068;27801,56575,0,1,1,0,2
75586,170,19599,25069;25076;27641,56575,0,0,3,0,3
75587,170,19600,25079;25658;28712,56575,0,1,2,0,3
75588,170,19602,25223;25285,56575,0,0,2,0,2
75589,170,19603,25398;25709;28469;28554,56575,0,2,2,0,4
75590,170,19604,25248;25739,56575,0,0,2,0,2
75591,170,19605,25261,56575,0,0,1,0,1
75592,170,19606,25118;25363;27814,56575,0,1,2,0,3
75593,170,19607,25362;25429;28101;28366;28698;29034;29212,56575,2,3,2,0,7
75594,170,19608,25410;25855;28398,56575,0,1,2,0,3
75595,170,19609,25438;29036,56575,1,0,1,0,2
75596,170,19610,26091;28404;28976,56575,1,1,1,0,3
75597,170,19611,25472;25839;28129;28223;28642,56575,0,3,2,0,5
75598,170,19612,25244,56575,0,0,1,0,1
75599,170,19613,25804;25906;27826,56575,0,1,2,0,3
75600,170,19614,25914,56575,0,0,1,0,1
75601,170,19616,25581;26163;28657,56575,0,1,2,0,3
75602,170,19617,25699,56575,0,0,1,0,1
75603,170,19618,25616;25694;27821,56575,0,1,2,0,3
75604,170,19619,25627;26063;28805;29071,56575,1,1,2,0,4
75605,170,19620,25588;25629;28117,56575,0,1,2,0,3
75606,170,19621,25638;26071;29236,56575,1,0,2,0,3
75607,170,19622,25644;26082;29155,56575,1,0,2,0,3
75608,170,19623,25550;25657;28376,56575,0,1,2,0,3
75609,170,19624,25750;25991,56575,0,0,2,0,2
75610,170,19625,25816;26047;28572;28737;29068,56575,1,2,2,0,5
75611,170,19626,25817;25999;28401;28969;29063,56575,2,1,2,0,5
75612,170,19627,25732;25893;28727,56575,0,1,2,0,3
75613,170,19628,25956;26106,56575,0,0,2,0,2
75614,170,19629,25963;26107,56575,0,0,2,0,2
75615,170,19631,25854;25993;28733;28888,56575,1,1,2,0,4
75616,170,19632,25990;26048;29235,56575,1,0,2,0,3
75617,170,19633,25402;26061;27936;29070;29153,56575,2,1,2,0,5
75618,170,19634,26017;26069;28482;29072,56575,1,1,2,0,4
75619,170,19635,26195;28812,56575,0,1,1,0,2
75620,170,19636,25602;26087;27744;28228;28403;28738;28807;28975,56575,1,4,3,0,8
75621,170,19637,26256;26283,56575,0,0,2,0,2
75622,170,19638,21847,56940,0,0,0,1,1
75623,170,19640,21438,56940,0,0,0,1,1
75624,170,19641,21743,56940,0,0,0,1,1
75625,170,19642,21638,56940,0,0,0,1,1
75626,170,19645,21598,56940,0,0,0,1,1
75627,170,19646,22067,56940,0,0,0,1,1
75628,170,19647,22201,56940,0,0,0,1,1
75629,170,19648,22383,56940,0,0,0,1,1
75630,170,19650,22943,56940,0,0,1,0,1
75631,170,19651,22063;22235,56940,0,0,0,2,2
75632,170,19652,22573,56940,0,0,0,1,1
75633,170,19653,22570,56940,0,0,0,1,1
75634,170,19654,22436,56940,0,0,0,1,1
75635,170,19656,23545,56940,0,0,1,0,1
75636,170,19657,22732;22782,56940,0,0,0,2,2
75637,170,19658,24125,56940,0,0,1,0,1
75638,170,19664,23384;23882;27046,56940,0,0,3,0,3
75639,170,19666,24387;24558;27084;28324,56940,0,1,3,0,4
75640,170,19669,24673;25107;27719;28180,56940,0,1,3,0,4
75641,170,19673,24996;27900;28508,56940,0,2,1,0,3
75642,170,19675,24499;25074;28442;28605,56940,0,2,2,0,4
75643,170,19678,24992;25007;27269;28603,56940,0,1,3,0,4
75644,170,19679,24901;25206;28094;28690,56940,0,2,2,0,4
75645,170,19680,25058;25240;28187;28448,56940,0,2,2,0,4
75646,170,19682,25182;27912;28183,56940,0,2,1,0,3
75647,170,19683,24899;25187;28518,56940,0,1,2,0,3
75648,170,19684,24783;25211;28000;28775;28848,56940,1,2,2,0,5
75649,170,19685,25262;25351,56940,0,0,2,0,2
75650,170,19686,25333;25367;29033,56940,1,0,2,0,3
75651,170,19687,25414;25885;28794,56940,0,1,2,0,3
75652,170,19688,25891;28962,56940,1,0,1,0,2
75653,170,19689,25637;27560,56940,0,0,2,0,2
75654,170,19690,25749;25807;28394;28718,56940,0,2,2,0,4
75655,170,19691,25294;25653;28630;28711,56940,0,2,2,0,4
75656,170,19692,25542;25903;27741;28879;28963,56940,2,0,3,0,5
75657,170,19693,25175;25486;28013,56940,0,1,2,0,3
75658,170,19694,25577;25747;28393;29139,56940,1,1,2,0,4
75659,170,19695,25738;28217,56940,0,1,1,0,2
75660,170,19696,25204;25728,56940,0,0,2,0,2
75661,170,19697,25668;25767;28638,56940,0,1,2,0,3
75662,170,19698,25776;26179;28304;28747;29162,56940,1,2,2,0,5
75663,170,19699,25789;25928;28730;28966;29146,56940,2,1,2,0,5
75664,170,19700,25779;25797,56940,0,0,2,0,2
75665,170,19702,25841;25912;27738;29052,56940,1,0,3,0,4
75666,170,19703,25636;25842;28721;28959,56940,1,1,2,0,4
75667,170,19704,25488;25862,56940,0,0,2,0,2
75668,170,19705,25924;26064,56940,0,0,2,0,2
75669,170,19706,26077;28573;29073;29154,56940,2,1,1,0,4
75670,170,19707,25925;26227;29082,56940,1,0,2,0,3
75671,170,19708,25814;25933,56940,0,0,2,0,2
75672,170,19709,26127,56940,0,0,1,0,1
75673,170,19710,26004;26410;28489;28664;28991,56940,1,2,2,0,5
75674,170,19711,26007;26194;27938,56940,0,1,2,0,3
75675,170,19712,25972;26028;28227;29232,56940,1,1,2,0,4
75676,170,19713,26002;26034;28132;29066,56940,1,1,2,0,4
75677,170,19714,26044;26102;28483;29076,56940,1,1,2,0,4
75678,170,19715,26052;26489,56940,0,0,2,0,2
75679,170,19716,26400;26406,56940,0,0,2,0,2
75680,170,19717,26070;26285;29252,56940,1,0,2,0,3
75681,170,19718,25792;26101;28653;28739;28898;28977;29075,56940,3,2,2,0,7
75682,170,19719,26124;26233;28306;28409;28579,56940,0,3,2,0,5
75683,170,19721,25850;26129,56940,0,0,2,0,2
75684,170,19722,26147,56940,0,0,1,0,1
75685,170,19723,26126;26144;28578,56940,0,1,2,0,3
75686,170,19724,25677;26150;28407;29161,56940,1,1,2,0,4
75687,170,19726,26130;26171,56940,0,0,2,0,2
75688,170,19727,25960;26178;28746,56940,0,1,2,0,3
75689,170,19728,25959;26192;28408,56940,0,1,2,0,3
75690,170,19731,21550,57305,0,0,0,1,1
75691,170,19732,22207,57305,0,0,0,1,1
75692,170,19733,22265,57305,0,0,0,1,1
75693,170,19734,22246,57305,0,0,0,1,1
75694,170,19735,22262,57305,0,0,0,1,1
75695,170,19736,22360;22930,57305,0,0,0,2,2
75696,170,19738,22134,57305,0,0,0,1,1
75697,170,19739,22754,57305,0,0,0,1,1
75698,170,19740,22771;22780,57305,0,0,0,2,2
75699,170,19741,22855;23016,57305,0,0,1,1,2
75700,170,19742,22923,57305,0,0,0,1,1
75701,170,19756,23729;23741,57305,0,0,2,0,2
75702,170,19760,23286;23501,57305,0,0,2,0,2
75703,170,19767,24731;24917,57305,0,0,2,0,2
75704,170,19769,24785;24862;28247,57305,0,1,2,0,3
75705,170,19770,24645;25052;28176;28512,57305,0,2,2,0,4
75706,170,19771,24744;25147;27909;28517,57305,0,2,2,0,4
75707,170,19772,25461;25539;28275,57305,0,1,2,0,3
75708,170,19773,25197;25386;27923;28102;28454;28940,57305,1,3,2,0,6
75709,170,19774,25222;25458;27818,57305,0,1,2,0,3
75710,170,19775,25597,57305,0,0,1,0,1
75711,170,19776,25247;25587;28381;28546;28862,57305,1,2,2,0,5
75712,170,19777,25346;28696,57305,0,1,1,0,2
75713,170,19779,25345;25812;28472;28558,57305,0,2,2,0,4
75714,170,19780,25251,57305,0,0,1,0,1
75715,170,19782,25599,57305,0,0,1,0,1
75716,170,19783,25615;25623;28783,57305,0,1,2,0,3
75717,170,19784,25478;25632;28387;29046,57305,1,1,2,0,4
75718,170,19785,25664;25695;28287;29215,57305,1,1,2,0,4
75719,170,19786,25395;25715,57305,0,0,2,0,2
75720,170,19787,25357;25781;28953,57305,1,0,2,0,3
75721,170,19788,25681;25733;28289;28634;28788,57305,0,3,2,0,5
75722,170,19790,25763;25803;29140,57305,1,0,2,0,3
75723,170,19791,25811;25845;28722;29224,57305,1,1,2,0,4
75724,170,19792,25852;25997,57305,0,0,2,0,2
75725,170,19793,25840;25861;28024;28564;28792,57305,0,3,2,0,5
75726,170,19794,25868;25929;28797;28967,57305,1,1,2,0,4
75727,170,19795,25590;25892;28878;29056,57305,2,0,2,0,4
75728,170,19796,25911;26183;28030,57305,0,1,2,0,3
75729,170,19797,25919;26278;28310;29168,57305,1,1,2,0,4
75730,170,19798,25948;26085;28974,57305,1,0,2,0,3
75731,170,19799,25950;26280,57305,0,0,2,0,2
75732,170,19800,25674;25989,57305,0,0,2,0,2
75733,170,19801,25994;26095;28810,57305,0,1,2,0,3
75734,170,19802,26032;28972,57305,1,0,1,0,2
75735,170,19803,25969;26264;28308,57305,0,1,2,0,3
75736,170,19804,26019;26073;28971,57305,1,0,2,0,3
75737,170,19805,26065;26110;28302,57305,0,1,2,0,3
75738,170,19806,26388;28580;28756;28818,57305,0,3,1,0,4
75739,170,19807,26160;26676,57305,0,0,2,0,2
75740,170,19808,26186;26312;28986,57305,1,0,2,0,3
75741,170,19809,26187;26417;28581,57305,0,1,2,0,3
75742,170,19810,26156;26197;28029,57305,0,1,2,0,3
75743,170,19811,26211;26279;28031;28230,57305,0,2,2,0,4
75744,170,19812,25971;26228;28659,57305,0,1,2,0,3
75745,170,19813,26235;26287,57305,0,0,2,0,2
75746,170,19814,26239;28660;29084,57305,1,1,1,0,3
75747,170,19815,26254;26599,57305,0,0,2,0,2
75748,170,19816,26571,57305,0,0,1,0,1
75749,170,19818,22185,57670,0,0,0,1,1
75750,170,19819,22234,57670,0,0,0,1,1
75751,170,19821,22559,57670,0,0,0,1,1
75752,170,19822,22229,57670,0,0,0,1,1
75753,170,19824,22439;22510,57670,0,0,0,2,2
75754,170,19825,22603;22604,57670,0,0,0,2,2
75755,170,19827,22549,57670,0,0,0,1,1
75756,170,19829,23127,57670,0,0,1,0,1
75757,170,19830,23155,57670,0,0,1,0,1
75758,170,19832,22951,57670,0,0,1,0,1
75759,170,19834,23363,57670,0,0,1,0,1
75760,170,19837,23406;23581,57670,0,0,2,0,2
75761,170,19840,23819;24129,57670,0,0,2,0,2
75762,170,19842,23861,57670,0,0,1,0,1
75763,170,19844,24361;24596;27516;28326,57670,0,1,3,0,4
75764,170,19852,24913,57670,0,0,1,0,1
75765,170,19858,24807;25406;28103,57670,0,1,2,0,3
75766,170,19859,25003,57670,0,0,1,0,1
75767,170,19860,25133;25235,57670,0,0,2,0,2
75768,170,19861,25135;25702;27376,57670,0,0,3,0,3
75769,170,19864,25256,57670,0,0,1,0,1
75770,170,19865,25263;25297;27724,57670,0,0,3,0,3
75771,170,19866,25334;25552;27463;27820;27926,57670,0,2,3,0,5
75772,170,19867,25404;25416;28104,57670,0,1,2,0,3
75773,170,19868,25432;25528;28202;28941,57670,1,1,2,0,4
75774,170,19869,25196;25456;27460;28011;28105;28458,57670,0,3,3,0,6
75775,170,19870,25482,57670,0,0,1,0,1
75776,170,19871,25650;28388,57670,0,1,1,0,2
75777,170,19872,25622;27281;29045,57670,1,0,2,0,3
75778,170,19873,25447;25625;27928;28784;28949,57670,1,2,2,0,5
75779,170,19874,25660;26152,57670,0,0,2,0,2
75780,170,19875,25661;26275,57670,0,0,2,0,2
75781,170,19876,25705;25923;28569;28796,57670,0,2,2,0,4
75782,170,19878,25753;25942;28649;29229,57670,1,1,2,0,4
75783,170,19879,25937;26377,57670,0,0,2,0,2
75784,170,19880,25775,57670,0,0,1,0,1
75785,170,19881,25431;25791;28716;28869,57670,1,1,2,0,4
75786,170,19882,25509,57670,0,0,1,0,1
75787,170,19883,25354;25720,57670,0,0,2,0,2
75788,170,19884,26010;26096;29157,57670,1,0,2,0,3
75789,170,19886,25968;26274;29251,57670,1,0,2,0,3
75790,170,19887,25888;25949;28882,57670,1,0,2,0,3
75791,170,19888,25953;26153;28981;29079,57670,2,0,2,0,4
75792,170,19889,26045;26117,57670,0,0,2,0,2
75793,170,19890,26104;26277,57670,0,0,2,0,2
75794,170,19891,26157;27745;28743;28901,57670,1,1,2,0,4
75795,170,19892,26132;26133;28229;28899;29159,57670,2,1,2,0,5
75796,170,19893,25970;26136;28732;28885,57670,1,1,2,0,4
75797,170,19894,26131;26162,57670,0,0,2,0,2
75798,170,19895,26436;26602;28313;28666;28993,57670,1,2,2,0,5
75799,170,19896,26208;26394;28658,57670,0,1,2,0,3
75800,170,19897,25737;25806;28125;28555;28639;28955,57670,1,3,2,0,6
75801,170,19898,26247;26268,57670,0,0,2,0,2
75802,170,19899,26251;26395,57670,0,0,2,0,2
75803,170,19900,26253;26477,57670,0,0,2,0,2
75804,170,19901,26711,57670,0,0,1,0,1
75805,170,19902,26258;26561;28317;28997;29265,57670,2,1,2,0,5
75806,170,19903,26248;26528,57670,0,0,2,0,2
75807,170,19904,25944;26291;28906,57670,1,0,2,0,3
75808,170,19905,26296;26631,57670,0,0,2,0,2
75809,170,19906,26600;26610,57670,0,0,2,0,2
75810,170,19907,26309;26335,57670,0,0,2,0,2
75811,170,19908,26366;26407;28758,57670,0,1,2,0,3
75812,170,19909,26379;26667,57670,0,0,2,0,2
75813,170,19910,26257;26589;29268,57670,1,0,2,0,3
75814,170,19911,26411;28414,57670,0,1,1,0,2
75815,170,19913,22224,58035,0,0,0,1,1
75816,170,19914,21840,58035,0,0,0,1,1
75817,170,19915,22220;22798,58035,0,0,0,2,2
75818,170,19916,22416,58035,0,0,0,1,1
75819,170,19917,22504,58035,0,0,0,1,1
75820,170,19919,22515,58035,0,0,0,1,1
75821,170,19921,22295;22621,58035,0,0,0,2,2
75822,170,19923,22990,58035,0,0,1,0,1
75823,170,19926,23083,58035,0,0,1,0,1
75824,170,19933,23538;23558,58035,0,0,2,0,2
75825,170,19935,23799,58035,0,0,1,0,1
75826,170,19937,23945;24397,58035,0,0,2,0,2
75827,170,19939,23811,58035,0,0,1,0,1
75828,170,19942,24434;25006;26811;27716,58035,0,0,4,0,4
75829,170,19943,24454;25023,58035,0,0,2,0,2
75830,170,19944,24076,58035,0,0,1,0,1
75831,170,19945,24507;24517;26911;27690;28056;28236,58035,0,2,4,0,6
75832,170,19948,24656;24674,58035,0,0,2,0,2
75833,170,19949,24790,58035,0,0,1,0,1
75834,170,19951,24779;25064;27541,58035,0,0,3,0,3
75835,170,19952,24933,58035,0,0,1,0,1
75836,170,19953,25132;25419;27370;28370,58035,0,1,3,0,4
75837,170,19955,25199;25253;28692,58035,0,1,2,0,3
75838,170,19956,25359;25834;28641;28791;29223,58035,1,2,2,0,5
75839,170,19958,25105;25424;27554;28456,58035,0,1,3,0,4
75840,170,19959,25291;25434;27725;28614,58035,0,1,3,0,4
75841,170,19960,25470;25475;28533;29038,58035,1,1,2,0,4
75842,170,19961,26039;26249;28133;28301;28651,58035,0,3,2,0,5
75843,170,19963,25546;25693;27925;28780,58035,0,2,2,0,4
75844,170,19965,25157;25287;28006;29030,58035,1,1,2,0,4
75845,170,19966,25610;28985,58035,1,0,1,0,2
75846,170,19967,26148;29240,58035,1,0,1,0,2
75847,170,19968,25682;25955;27742;28883;29207,58035,2,0,3,0,5
75848,170,19969,25784;25874;27737;28123;28954,58035,1,1,3,0,5
75849,170,19970,25298,58035,0,0,1,0,1
75850,170,19971,26236,58035,0,0,1,0,1
75851,170,19972,25754;25835;28222;28396;28562,58035,0,3,2,0,5
75852,170,19973,25837;26286;29087,58035,1,0,2,0,3
75853,170,19975,25437;25880;27829;28225;29055,58035,1,2,2,0,5
75854,170,19976,25647;25983;28886,58035,1,0,2,0,3
75855,170,19977,25941;26143,58035,0,0,2,0,2
75856,170,19978,25878;25951;28799;29230,58035,1,1,2,0,4
75857,170,19979,25961;26290;29169;29253,58035,2,0,2,0,4
75858,170,19980,25569;25703;28288;28553;29137,58035,1,2,2,0,5
75859,170,19981,25979,58035,0,0,1,0,1
75860,170,19982,26011;26314;28908;29089;29255,58035,3,0,2,0,5
75861,170,19983,26078;26341;28910;29090,58035,2,0,2,0,4
75862,170,19984,26112;26519;28671,58035,0,1,2,0,3
75863,170,19985,26121;26175,58035,0,0,2,0,2
75864,170,19986,26538;28417;29101,58035,1,1,1,0,3
75865,170,19987,26177;26331,58035,0,0,2,0,2
75866,170,19988,26103;26188;28654;29077,58035,1,1,2,0,4
75867,170,19989,26215,58035,0,0,1,0,1
75868,170,19990,25965;26260;28486,58035,0,1,2,0,3
75869,170,19991,26263;26750,58035,0,0,2,0,2
75870,170,19992,26269;26381;28750,58035,0,1,2,0,3
75871,170,19993,26717;28592;28762,58035,0,2,1,0,3
75872,170,19994,26288;26485;28315,58035,0,1,2,0,3
75873,170,19995,26292;26334;29170,58035,1,0,2,0,3
75874,170,19996,26084;26307,58035,0,0,2,0,2
75875,170,19998,26191;26330,58035,0,0,2,0,2
75876,170,19999,26313;26508;28586,58035,0,1,2,0,3
75877,170,20000,26356;26375;29091;29257,58035,2,0,2,0,4
75878,170,20001,26397;26606;28757,58035,0,1,2,0,3
75879,170,20002,26416;26702,58035,0,0,2,0,2
75880,170,20003,26422,58035,0,0,1,0,1
75881,170,20004,26442;26781,58035,0,0,2,0,2
75882,170,20005,26352;26445;28412;28987,58035,1,1,2,0,4
75883,170,20006,26448;26459,58035,0,0,2,0,2
75884,170,20007,26219;26565;28823;29103,58035,1,1,2,0,4
75885,170,20008,26049;26479;28415;28821,58035,0,2,2,0,4
75886,170,20009,26423;26493,58035,0,0,2,0,2
75887,170,20010,22297;22845,58400,0,0,0,2,2
75888,170,20011,22366;22761,58400,0,0,0,2,2
75889,170,20012,22635;23239,58400,0,0,1,1,2
75890,170,20014,22457,58400,0,0,0,1,1
75891,170,20015,22919,58400,0,0,0,1,1
75892,170,20017,22631,58400,0,0,0,1,1
75893,170,20023,23317,58400,0,0,1,0,1
75894,170,20024,23692,58400,0,0,1,0,1
75895,170,20025,23081;23121,58400,0,0,2,0,2
75896,170,20033,24452;27339,58400,0,0,2,0,2
75897,170,20039,24649;25136,58400,0,0,2,0,2
75898,170,20040,24696;25269,58400,0,0,2,0,2
75899,170,20041,24695;25077;27363;28514;29296,58400,1,1,3,0,5
75900,170,20042,25092;25280;28524,58400,0,1,2,0,3
75901,170,20044,25534;25630;27823,58400,0,1,2,0,3
75902,170,20045,25100;25342;28270;28527,58400,0,2,2,0,4
75903,170,20047,25202,58400,0,0,1,0,1
75904,170,20048,25140,58400,0,0,1,0,1
75905,170,20051,25526;25808;28556,58400,0,1,2,0,3
75906,170,20052,25548;26024;28028;29065,58400,1,1,2,0,4
75907,170,20053,25592;29133,58400,1,0,1,0,2
75908,170,20054,25639,58400,0,0,1,0,1
75909,170,20055,25201;25721;28470,58400,0,1,2,0,3
75910,170,20056,25895;26408;28759,58400,0,1,2,0,3
75911,170,20059,25926;26035;28729;28965;29060,58400,2,1,2,0,5
75912,170,20060,26055;26155;28656,58400,0,1,2,0,3
75913,170,20061,26074;26435;29094,58400,1,0,2,0,3
75914,170,20062,26158,58400,0,0,1,0,1
75915,170,20063,26090;26305;27937;28574;28896,58400,1,2,2,0,5
75916,170,20064,26119;26376;28231,58400,0,1,2,0,3
75917,170,20065,26167;26193;29243,58400,1,0,2,0,3
75918,170,20066,25995;26467;28314;28492,58400,0,2,2,0,4
75919,170,20067,25931;26190;27833;28902;29080,58400,2,1,2,0,5
75920,170,20068,26009;26202,58400,0,0,2,0,2
75921,170,20069,26421;26575;28998,58400,1,0,2,0,3
75922,170,20070,26300;26392;28751,58400,0,1,2,0,3
75923,170,20071,26646,58400,0,0,1,0,1
75924,170,20072,26349;26495;29097,58400,1,0,2,0,3
75925,170,20073,26066;26345;28411,58400,0,1,2,0,3
75926,170,20074,26363;26634,58400,0,0,2,0,2
75927,170,20075,26378;26691,58400,0,0,2,0,2
75928,170,20076,26380;26731;29006;29108;29274,58400,3,0,2,0,5
75929,170,20077,26740;29185,58400,1,0,1,0,2
75930,170,20078,26399;26708;29106,58400,1,0,2,0,3
75931,170,20079,26541;26672;28995;29264,58400,2,0,2,0,4
75932,170,20080,26404;26518;29099,58400,1,0,2,0,3
75933,170,20081,26794,58400,0,0,1,0,1
75934,170,20082,26358;26469;28413,58400,0,1,2,0,3
75935,170,20083,26484;26492;28914,58400,1,0,2,0,3
75936,170,20084,26505;26514;28670,58400,0,1,2,0,3
75937,170,20085,26515;26812;29281,58400,1,0,2,0,3
75938,170,20086,26540;26776;28832;28921,58400,1,1,2,0,4
75939,170,20087,26546;26780;29009;29110,58400,2,0,2,0,4
75940,170,20088,26076;26551,58400,0,0,2,0,2
75941,170,20089,26552;26761;29276,58400,1,0,2,0,3
75942,170,20090,26653;28318;29179,58400,1,1,1,0,3
75943,170,20091,26596;26784;29111,58400,1,0,2,0,3
75944,170,20092,22390,58765,0,0,0,1,1
75945,170,20093,22629;22874,58765,0,0,0,2,2
75946,170,20095,22653,58765,0,0,0,1,1
75947,170,20097,22911,58765,0,0,0,1,1
75948,170,20098,22707;23137,58765,0,0,1,1,2
75949,170,20100,22964,58765,0,0,1,0,1
75950,170,20103,22997;23351,58765,0,0,2,0,2
75951,170,20104,23456,58765,0,0,1,0,1
75952,170,20105,23078;23216,58765,0,0,2,0,2
75953,170,20106,23507;23519,58765,0,0,2,0,2
75954,170,20108,23568,58765,0,0,1,0,1
75955,170,20115,23838,58765,0,0,1,0,1
75956,170,20118,24518;24811;27442;27880,58765,0,1,3,0,4
75957,170,20120,24839;24903;26807;27987;28067;29010,58765,1,2,3,0,6
75958,170,20126,25224;25687;27929;28552,58765,0,2,2,0,4
75959,170,20130,25389;25611;28548,58765,0,1,2,0,3
75960,170,20131,25344;25403;27733;28528,58765,0,1,3,0,4
75961,170,20132,24894,58765,0,0,1,0,1
75962,170,20135,25141,58765,0,0,1,0,1
75963,170,20136,25667;25860;27828,58765,0,1,2,0,3
75964,170,20138,26154,58765,0,0,1,0,1
75965,170,20140,25766;26093;28405;28809;28897;29238,58765,2,2,2,0,6
75966,170,20141,25772;25974,58765,0,0,2,0,2
75967,170,20142,25800;25913;28728,58765,0,1,2,0,3
75968,170,20143,25987;26209;28801;28887,58765,1,1,2,0,4
75969,170,20144,25985;26080;28968;29062,58765,2,0,2,0,4
75970,170,20145,26137;26428;28491;28819,58765,0,2,2,0,4
75971,170,20147,26185;29163,58765,1,0,1,0,2
75972,170,20148,26189,58765,0,0,1,0,1
75973,170,20149,25856;26204,58765,0,0,2,0,2
75974,170,20150,26029;26212,58765,0,0,2,0,2
75975,170,20152,25785;26222;29165,58765,1,0,2,0,3
75976,170,20153,25954;26252;28033;28661;28904,58765,1,2,2,0,5
75977,170,20154,25809;26295;29254,58765,1,0,2,0,3
75978,170,20155,26779;26831;29008,58765,1,0,2,0,3
75979,170,20156,26336;26564;29266,58765,1,0,2,0,3
75980,170,20157,26398;28663;28912,58765,1,1,1,0,3
75981,170,20158,26357;26367;28988,58765,1,0,2,0,3
75982,170,20159,25921;26368,58765,0,0,2,0,2
75983,170,20160,26385;26724;28763;29005,58765,1,1,2,0,4
75984,170,20161,26207;26529;29100,58765,1,0,2,0,3
75985,170,20162,26420;26948,58765,0,0,2,0,2
75986,170,20163,26425;26612;28825,58765,0,1,2,0,3
75987,170,20164,26427;26468,58765,0,0,2,0,2
75988,170,20165,26298;26437;29095,58765,1,0,2,0,3
75989,170,20166,26441;26614,58765,0,0,2,0,2
75990,170,20167,26332;26674,58765,0,0,2,0,2
75991,170,20168,26430;26523,58765,0,0,2,0,2
75992,170,20169,26164;26501;29262,58765,1,0,2,0,3
75993,170,20170,26324;26503;28916,58765,1,0,2,0,3
75994,170,20171,26424;26509;28490;28582;29259,58765,1,2,2,0,5
75995,170,20172,26496;26706;29183,58765,1,0,2,0,3
75996,170,20173,26311;26550,58765,0,0,2,0,2
75997,170,20174,26576;26790;29188,58765,1,0,2,0,3
75998,170,20175,26577,58765,0,0,1,0,1
75999,170,20176,26432;26583,58765,0,0,2,0,2
76000,170,20177,26318;26840;28594,58765,0,1,2,0,3
76001,170,20178,26592;26759,58765,0,0,2,0,2
76002,170,20179,26294;26598;28672,58765,0,1,2,0,3
76003,170,20180,26804;29189,58765,1,0,1,0,2
76004,170,20181,26549;26675,58765,0,0,2,0,2
76005,170,20182,26681;29180,58765,1,0,1,0,2
76006,170,20183,26695;26923;29287,58765,1,0,2,0,3
76007,170,20184,26683;26713;29184,58765,1,0,2,0,3
76008,170,20185,26714;29107,58765,1,0,1,0,2
76009,170,20186,22532;22739,59130,0,0,0,2,2
76010,170,20187,22371,59130,0,0,0,1,1
76011,170,20188,22215,59130,0,0,0,1,1
76012,170,20189,22606,59130,0,0,0,1,1
76013,170,20190,22854,59130,0,0,0,1,1
76014,170,20191,22668,59130,0,0,0,1,1
76015,170,20192,23041,59130,0,0,1,0,1
76016,170,20193,23104,59130,0,0,1,0,1
76017,170,20196,23255,59130,0,0,1,0,1
76018,170,20197,23199,59130,0,0,1,0,1
76019,170,20203,24043;24512;27432;28055;28423,59130,0,2,3,0,5
76020,170,20206,24122;24292,59130,0,0,2,0,2
76021,170,20208,24399;24540,59130,0,0,2,0,2
76022,170,20210,24498;24752;27609,59130,0,0,3,0,3
76023,170,20211,24548;24663,59130,0,0,2,0,2
76024,170,20215,24816;25106,59130,0,0,2,0,2
76025,170,20216,25073;25198;28519,59130,0,1,2,0,3
76026,170,20217,24893;25110;27642,59130,0,0,3,0,3
76027,170,20218,25035;25352;27180;28008;28364,59130,0,2,3,0,5
76028,170,20219,25237;25282;28452;28694,59130,0,2,2,0,4
76029,170,20220,25383;25659;28939,59130,1,0,2,0,3
76030,170,20221,25339;25691;27930;28713;29047;29136,59130,2,2,2,0,6
76031,170,20222,25594,59130,0,0,1,0,1
76032,170,20223,25358;25654;28389,59130,0,1,2,0,3
76033,170,20224,25686;25798;28632,59130,0,1,2,0,3
76034,170,20225,25771;25823;28023;28293;28560;29142,59130,1,3,2,0,6
76035,170,20226,25844,59130,0,0,1,0,1
76036,170,20227,25865;25957,59130,0,0,2,0,2
76037,170,20229,25964;26043;28736;29067;29233,59130,2,1,2,0,5
76038,170,20230,26013;26086,59130,0,0,2,0,2
76039,170,20231,25978;26333;27834;29256,59130,1,1,2,0,4
76040,170,20232,25976;26038,59130,0,0,2,0,2
76041,170,20233,26014,59130,0,0,1,0,1
76042,170,20234,26072;26440;28583,59130,0,1,2,0,3
76043,170,20235,25851,59130,0,0,1,0,1
76044,170,20236,25843,59130,0,0,1,0,1
76045,170,20237,25898;26115;28811,59130,0,1,2,0,3
76046,170,20238,26140;26374;28488,59130,0,1,2,0,3
76047,170,20239,26214;26281,59130,0,0,2,0,2
76048,170,20240,26270;26698;28591,59130,0,1,2,0,3
76049,170,20241,26282;26553,59130,0,0,2,0,2
76050,170,20242,26570,59130,0,0,1,0,1
76051,170,20243,26097;26304;28752,59130,0,1,2,0,3
76052,170,20244,26320;26664;29104,59130,1,0,2,0,3
76053,170,20245,26321;26476;28909,59130,1,0,2,0,3
76054,170,20246,26343;26656,59130,0,0,2,0,2
76055,170,20247,25992;26360;28989,59130,1,0,2,0,3
76056,170,20248,26276;26453,59130,0,0,2,0,2
76057,170,20249,26703,59130,0,0,1,0,1
76058,170,20250,26403;26444,59130,0,0,2,0,2
76059,170,20251,26466,59130,0,0,1,0,1
76060,170,20252,26449;26753,59130,0,0,2,0,2
76061,170,20253,26429;26458,59130,0,0,2,0,2
76062,170,20254,26384;26490;28755,59130,0,1,2,0,3
76063,170,20255,26494;26594,59130,0,0,2,0,2
76064,170,20256,26196;26542,59130,0,0,2,0,2
76065,170,20257,26556;26777,59130,0,0,2,0,2
76066,170,20258,26560;26798,59130,0,0,2,0,2
76067,170,20259,26591;26705;28495,59130,0,1,2,0,3
76068,170,20260,26109;26601;29269,59130,1,0,2,0,3
76069,170,20261,26608,59130,0,0,1,0,1
76070,170,20262,26580;26639;29001,59130,1,0,2,0,3
76071,170,20264,26678;27042,59130,0,0,2,0,2
76072,170,20265,26686,59130,0,0,1,0,1
76073,170,20266,26487,59130,0,0,1,0,1
76074,170,20268,26729;26928,59130,0,0,2,0,2
76075,170,20269,26752;27018;29193,59130,1,0,2,0,3
76076,170,20270,26787,59130,0,0,1,0,1
76077,170,20271,26797;27000,59130,0,0,2,0,2
76078,170,20272,26461;26800;28765;29279,59130,1,1,2,0,4
76079,170,20274,22786,59495,0,0,0,1,1
76080,170,20275,22796,59495,0,0,0,1,1
76081,170,20276,22204,59495,0,0,0,1,1
76082,170,20277,22829;23126,59495,0,0,1,1,2
76083,170,20279,23151,59495,0,0,1,0,1
76084,170,20280,23186,59495,0,0,1,0,1
76085,170,20281,23265,59495,0,0,1,0,1
76086,170,20282,22776,59495,0,0,0,1,1
76087,170,20288,23790,59495,0,0,1,0,1
76088,170,20290,24439,59495,0,0,1,0,1
76089,170,20300,25126,59495,0,0,1,0,1
76090,170,20303,25375,59495,0,0,1,0,1
76091,170,20304,25311,59495,0,0,1,0,1
76092,170,20305,25439;25730;29138,59495,1,0,2,0,3
76093,170,20308,25219,59495,0,0,1,0,1
76094,170,20309,25523,59495,0,0,1,0,1
76095,170,20310,25225,59495,0,0,1,0,1
76096,170,20311,25341;25731,59495,0,0,2,0,2
76097,170,20313,25838,59495,0,0,1,0,1
76098,170,20314,26306;29088,59495,1,0,1,0,2
76099,170,20315,25938;26412;28992;29093,59495,2,0,2,0,4
76100,170,20316,25828;25943,59495,0,0,2,0,2
76101,170,20317,25945,59495,0,0,1,0,1
76102,170,20318,25605;25947;29147,59495,1,0,2,0,3
76103,170,20319,25820;26003,59495,0,0,2,0,2
76104,170,20320,26088;26105;28808;29074,59495,1,1,2,0,4
76105,170,20321,26041;26099;28571,59495,0,1,2,0,3
76106,170,20322,26100;26315,59495,0,0,2,0,2
76107,170,20323,26116,59495,0,0,1,0,1
76108,170,20324,26081,59495,0,0,1,0,1
76109,170,20325,26229,59495,0,0,1,0,1
76110,170,20326,26180;26244;28307;28816;29085;29167;29249,59495,3,2,2,0,7
76111,170,20327,26123;26255,59495,0,0,2,0,2
76112,170,20328,26289;26926,59495,0,0,2,0,2
76113,170,20329,26317;26434,59495,0,0,2,0,2
76114,170,20330,26337;26994,59495,0,0,2,0,2
76115,170,20331,26181;26361;29092,59495,1,0,2,0,3
76116,170,20332,26369;26390;28754;28990;29258,59495,2,1,2,0,5
76117,170,20333,26383;26491;28669;28915;29261,59495,2,1,2,0,5
76118,170,20335,26725,59495,0,0,1,0,1
76119,170,20336,26454,59495,0,0,1,0,1
76120,170,20337,26475,59495,0,0,1,0,1
76121,170,20338,26327;26482;29096;29172,59495,2,0,2,0,4
76122,170,20339,26483;26939,59495,0,0,2,0,2
76123,170,20340,26499;27039,59495,0,0,2,0,2
76124,170,20341,26500,59495,0,0,1,0,1
76125,170,20342,26522;26658;28590;28827,59495,0,2,2,0,4
76126,170,20343,26261;26526,59495,0,0,2,0,2
76127,170,20344,26545;26636;28589,59495,0,1,2,0,3
76128,170,20345,26548;28996,59495,1,0,1,0,2
76129,170,20346,26611;26856;29112,59495,1,0,2,0,3
76130,170,20347,26655;26877;29115,59495,1,0,2,0,3
76131,170,20348,26657;28826,59495,0,1,1,0,2
76132,170,20349,26669;28674;29003,59495,1,1,1,0,3
76133,170,20350,26980;27060,59495,0,0,2,0,2
76134,170,20351,26568;26719,59495,0,0,2,0,2
76135,170,20352,27089;29020,59495,1,0,1,0,2
76136,170,20353,26734;27065;29019,59495,1,0,2,0,3
76137,170,20354,26746;26919;28926,59495,1,0,2,0,3
76138,170,20355,26446;26754,59495,0,0,2,0,2
76139,170,20356,26825,59495,0,0,1,0,1
76140,170,20357,26827;27043,59495,0,0,2,0,2
76141,170,20358,26828;27086,59495,0,0,2,0,2
76142,170,20359,26830;26969,59495,0,0,2,0,2
76143,170,20360,26850;27023,59495,0,0,2,0,2
76144,170,20361,26767;26899;28830;29109,59495,1,1,2,0,4
76145,170,20362,26901;27154,59495,0,0,2,0,2
76146,170,20363,26693;26904,59495,0,0,2,0,2
76147,170,20364,22885,59860,0,0,0,1,1
76148,170,20366,22830,59860,0,0,0,1,1
76149,170,20367,22812,59860,0,0,0,1,1
76150,170,20368,23060,59860,0,0,1,0,1
76151,170,20370,23086;23427,59860,0,0,2,0,2
76152,170,20371,23050,59860,0,0,1,0,1
76153,170,20373,22976,59860,0,0,1,0,1
76154,170,20374,22877,59860,0,0,0,1,1
76155,170,20375,23194,59860,0,0,1,0,1
76156,170,20377,23517;23597,59860,0,0,2,0,2
76157,170,20378,24082;24505;27610;28054,59860,0,1,3,0,4
76158,170,20379,24074;24237,59860,0,0,2,0,2
76159,170,20382,24960,59860,0,0,1,0,1
76160,170,20383,24824,59860,0,0,1,0,1
76161,170,20385,25081,59860,0,0,1,0,1
76162,170,20387,25047;25396;29035;29131,59860,2,0,2,0,4
76163,170,20388,25195,59860,0,0,1,0,1
76164,170,20391,25770;26031;28570;28734;28803,59860,0,3,2,0,5
76165,170,20392,25872;26062;28224;29054,59860,1,1,2,0,4
76166,170,20393,25724,59860,0,0,1,0,1
76167,170,20394,25904;29058;29226,59860,2,0,1,0,3
76168,170,20395,26012;26176;28303,59860,0,1,2,0,3
76169,170,20396,26058,59860,0,0,1,0,1
76170,170,20397,26060;26216;28983,59860,1,0,2,0,3
76171,170,20398,25946;26079;28478,59860,0,1,2,0,3
76172,170,20399,25894;26272,59860,0,0,2,0,2
76173,170,20400,26146,59860,0,0,1,0,1
76174,170,20401,26141;26413;28232;28312,59860,0,2,2,0,4
76175,170,20402,26223;26638;29271,59860,1,0,2,0,3
76176,170,20404,26323,59860,0,0,1,0,1
76177,170,20405,26206;26350;29244,59860,1,0,2,0,3
76178,170,20406,26355;26816,59860,0,0,2,0,2
76179,170,20407,26438,59860,0,0,1,0,1
76180,170,20408,26621,59860,0,0,1,0,1
76181,170,20409,26402;26504;28994,59860,1,0,2,0,3
76182,170,20410,26525;26920;29191,59860,1,0,2,0,3
76183,170,20411,26643;26990;29116,59860,1,0,2,0,3
76184,170,20412,26488;26559;29177,59860,1,0,2,0,3
76185,170,20413,26588,59860,0,0,1,0,1
76186,170,20414,26623;26971,59860,0,0,2,0,2
76187,170,20415,26940;28678,59860,0,1,1,0,2
76188,170,20416,26660,59860,0,0,1,0,1
76189,170,20417,26869;29012,59860,1,0,1,0,2
76190,170,20418,26684;26735,59860,0,0,2,0,2
76191,170,20419,26743;26760,59860,0,0,2,0,2
76192,170,20420,26765;26818,59860,0,0,2,0,2
76193,170,20421,26562;26785;28593;29187,59860,1,1,2,0,4
76194,170,20422,26744;26801,59860,0,0,2,0,2
76195,170,20423,26772;26805;29280,59860,1,0,2,0,3
76196,170,20424,26704;26813;29011,59860,1,0,2,0,3
76197,170,20425,26823;27207,59860,0,0,2,0,2
76198,170,20426,26826;27083,59860,0,0,2,0,2
76199,170,20427,26829;27052,59860,0,0,2,0,2
76200,170,20428,27181,59860,0,0,1,0,1
76201,170,20429,26844;27232,59860,0,0,2,0,2
76202,170,20430,26851;27430,59860,0,0,2,0,2
76203,170,20431,26860;26973;29288,59860,1,0,2,0,3
76204,170,20432,26866;27076;28835;28924,59860,1,1,2,0,4
76205,170,20433,26513;26893,59860,0,0,2,0,2
76206,170,20434,26894;27104;29293,59860,1,0,2,0,3
76207,170,20435,26905;29014;29286,59860,2,0,1,0,3
76208,170,20436,26925;27179,59860,0,0,2,0,2
76209,170,20437,26927;27141,59860,0,0,2,0,2
76210,170,20438,26935;27131,59860,0,0,2,0,2
76211,170,20439,26936;26946,59860,0,0,2,0,2
76212,170,20440,26884;26965,59860,0,0,2,0,2
76213,170,20441,26984;27053,59860,0,0,2,0,2
76214,170,20442,26987;27171;28768,59860,0,1,2,0,3
76215,170,20443,26989;27219,59860,0,0,2,0,2
76216,170,20444,22638,60225,0,0,0,1,1
76217,170,20445,23057;23141,60225,0,0,2,0,2
76218,170,20446,23499,60225,0,0,1,0,1
76219,170,20447,23699;23996,60225,0,0,2,0,2
76220,170,20448,23894,60225,0,0,1,0,1
76221,170,20450,24078,60225,0,0,1,0,1
76222,170,20451,24250,60225,0,0,1,0,1
76223,170,20454,24815,60225,0,0,1,0,1
76224,170,20455,24968;25229,60225,0,0,2,0,2
76225,170,20458,25690;26168;28745,60225,0,1,2,0,3
76226,170,20460,25765;25875;28725,60225,0,1,2,0,3
76227,170,20462,25586;25863;28025;28565;28644;28873,60225,1,3,2,0,6
76228,170,20464,26056,60225,0,0,1,0,1
76229,170,20465,26201;26414;28665,60225,0,1,2,0,3
76230,170,20466,26271;26881,60225,0,0,2,0,2
76231,170,20467,26316;26450,60225,0,0,2,0,2
76232,170,20468,26365,60225,0,0,1,0,1
76233,170,20470,26405;26975,60225,0,0,2,0,2
76234,170,20471,26409;26771,60225,0,0,2,0,2
76235,170,20472,26774,60225,0,0,1,0,1
76236,170,20473,26347;26618;28999;29270,60225,2,0,2,0,4
76237,170,20474,26512;26964,60225,0,0,2,0,2
76238,170,20475,26579,60225,0,0,1,0,1
76239,170,20477,26641;26747;29186,60225,1,0,2,0,3
76240,170,20478,26649;26872,60225,0,0,2,0,2
76241,170,20479,26651;26763,60225,0,0,2,0,2
76242,170,20480,26696;26868,60225,0,0,2,0,2
76243,170,20481,26712;26952,60225,0,0,2,0,2
76244,170,20482,26534;26722,60225,0,0,2,0,2
76245,170,20483,26728;27066,60225,0,0,2,0,2
76246,170,20484,26732;27092;29118,60225,1,0,2,0,3
76247,170,20485,26224;26773,60225,0,0,2,0,2
76248,170,20486,26630;26810;28496,60225,0,1,2,0,3
76249,170,20487,26585;26694;28319;28760;29182,60225,1,2,2,0,5
76250,170,20488,26802;26843;28766,60225,0,1,2,0,3
76251,170,20489,26846;27047,60225,0,0,2,0,2
76252,170,20490,26853;26962,60225,0,0,2,0,2
76253,170,20491,26862;26979,60225,0,0,2,0,2
76254,170,20492,26632;26864;29283,60225,1,0,2,0,3
76255,170,20493,26887;27258,60225,0,0,2,0,2
76256,170,20494,26597;26895,60225,0,0,2,0,2
76257,170,20495,26958;27080,60225,0,0,2,0,2
76258,170,20496,26992;27359,60225,0,0,2,0,2
76259,170,20497,27006;27325;29200,60225,1,0,2,0,3
76260,170,20498,27260,60225,0,0,1,0,1
76261,170,20499,26890;27009,60225,0,0,2,0,2
76262,170,20500,26757;27024;28839,60225,0,1,2,0,3
76263,170,20501,27040;27120,60225,0,0,2,0,2
76264,170,20502,26730;27073;29194,60225,1,0,2,0,3
76265,170,20503,26751;27079,60225,0,0,2,0,2
76266,170,20504,27085;27209,60225,0,0,2,0,2
76267,170,20505,26755;27100,60225,0,0,2,0,2
76268,170,20506,23013,60590,0,0,1,0,1
76269,170,20507,23009,60590,0,0,1,0,1
76270,170,20508,23220,60590,0,0,1,0,1
76271,170,20509,23299,60590,0,0,1,0,1
76272,170,20510,23364,60590,0,0,1,0,1
76273,170,20512,23553,60590,0,0,1,0,1
76274,170,20513,23567,60590,0,0,1,0,1
76275,170,20515,23668;23893,60590,0,0,2,0,2
76276,170,20516,23716,60590,0,0,1,0,1
76277,170,20517,23743,60590,0,0,1,0,1
76278,170,20518,23481,60590,0,0,1,0,1
76279,170,20519,23846,60590,0,0,1,0,1
76280,170,20521,24054,60590,0,0,1,0,1
76281,170,20522,23703,60590,0,0,1,0,1
76282,170,20523,24097,60590,0,0,1,0,1
76283,170,20526,24020,60590,0,0,1,0,1
76284,170,20528,24709,60590,0,0,1,0,1
76285,170,20530,25307;28197;28268;28362,60590,0,3,1,0,4
76286,170,20532,25049,60590,0,0,1,0,1
76287,170,20533,25103,60590,0,0,1,0,1
76288,170,20535,25089,60590,0,0,1,0,1
76289,170,20537,25173,60590,0,0,1,0,1
76290,170,20538,25213,60590,0,0,1,0,1
76291,170,20539,25259,60590,0,0,1,0,1
76292,170,20540,25301,60590,0,0,1,0,1
76293,170,20541,25277,60590,0,0,1,0,1
76294,170,20542,25492;25821,60590,0,0,2,0,2
76295,170,20543,25227,60590,0,0,1,0,1
76296,170,20544,25642;25707,60590,0,0,2,0,2
76297,170,20545,25736;26057;29069,60590,1,0,2,0,3
76298,170,20546,25706,60590,0,0,1,0,1
76299,170,20547,25830;28475,60590,0,1,1,0,2
76300,170,20548,25871;26234;28032;28410;28815;28984;29166,60590,2,3,2,0,7
76301,170,20549,25910,60590,0,0,1,0,1
76302,170,20550,25927,60590,0,0,1,0,1
76303,170,20552,25984,60590,0,0,1,0,1
76304,170,20553,26015;26582;28493,60590,0,1,2,0,3
76305,170,20554,26241;26344;28662;28753;28911,60590,1,2,2,0,5
76306,170,20555,26125,60590,0,0,1,0,1
76307,170,20556,26205;26478;28484;28813;29081,60590,1,2,2,0,5
76308,170,20557,26250;26262;28487;28817;29086,60590,1,2,2,0,5
76309,170,20558,26217,60590,0,0,1,0,1
76310,170,20559,26114;26303;28740;28979,60590,1,1,2,0,4
76311,170,20560,26339;26666;29002,60590,1,0,2,0,3
76312,170,20561,26373;26462;28584;28820,60590,0,2,2,0,4
76313,170,20562,26463;26961,60590,0,0,2,0,2
76314,170,20563,26498,60590,0,0,1,0,1
76315,170,20564,26590,60590,0,0,1,0,1
76316,170,20565,26604;26977;29016,60590,1,0,2,0,3
76317,170,20566,26644;27142;29021,60590,1,0,2,0,3
76318,170,20567,26322;26338,60590,0,0,2,0,2
76319,170,20568,26647,60590,0,0,1,0,1
76320,170,20569,26581;26663,60590,0,0,2,0,2
76321,170,20570,26670;27242,60590,0,0,2,0,2
76322,170,20571,26677;26716;28494,60590,0,1,2,0,3
76323,170,20572,26701;27148;29022,60590,1,0,2,0,3
76324,170,20574,26642;26764,60590,0,0,2,0,2
76325,170,20575,26788;26942,60590,0,0,2,0,2
76326,170,20576,26824;26837,60590,0,0,2,0,2
76327,170,20578,27235,60590,0,0,1,0,1
76328,170,20579,26756;26917;29190,60590,1,0,2,0,3
76329,170,20580,26934;26972,60590,0,0,2,0,2
76330,170,20581,26949;27161;29015;29192,60590,2,0,2,0,4
76331,170,20582,26882;26959,60590,0,0,2,0,2
76332,170,20583,27007,60590,0,0,1,0,1
76333,170,20584,27056,60590,0,0,1,0,1
76334,170,20585,27071;27262;29124,60590,1,0,2,0,3
76335,170,20586,27087;27115;29120,60590,1,0,2,0,3
76336,170,20587,27055;27097;29290,60590,1,0,2,0,3
76337,170,20588,27101;27119,60590,0,0,2,0,2
76338,170,20589,26855;27123;29282,60590,1,0,2,0,3
76339,170,20590,27128;27215,60590,0,0,2,0,2
76340,170,20591,27078;27138,60590,0,0,2,0,2
76341,170,20592,27147;27203,60590,0,0,2,0,2
76342,170,20594,23303,60955,0,0,1,0,1
76343,170,20595,23416,60955,0,0,1,0,1
76344,170,20596,23346,60955,0,0,1,0,1
76345,170,20597,23431,60955,0,0,1,0,1
76346,170,20598,23484,60955,0,0,1,0,1
76347,170,20600,23697,60955,0,0,1,0,1
76348,170,20601,24002,60955,0,0,1,0,1
76349,170,20603,23813,60955,0,0,1,0,1
76350,170,20604,24259,60955,0,0,1,0,1
76351,170,20605,24327,60955,0,0,1,0,1
76352,170,20608,24607;24916,60955,0,0,2,0,2
76353,170,20609,24653,60955,0,0,1,0,1
76354,170,20611,24750,60955,0,0,1,0,1
76355,170,20612,24551,60955,0,0,1,0,1
76356,170,20613,24755,60955,0,0,1,0,1
76357,170,20614,24503,60955,0,0,1,0,1
76358,170,20615,24762,60955,0,0,1,0,1
76359,170,20616,24791,60955,0,0,1,0,1
76360,170,20617,24853,60955,0,0,1,0,1
76361,170,20618,24891,60955,0,0,1,0,1
76362,170,20619,25130,60955,0,0,1,0,1
76363,170,20620,25200,60955,0,0,1,0,1
76364,170,20621,25056,60955,0,0,1,0,1
76365,170,20622,25302,60955,0,0,1,0,1
76366,170,20623,25325,60955,0,0,1,0,1
76367,170,20624,24915,60955,0,0,1,0,1
76368,170,20626,25579,60955,0,0,1,0,1
76369,170,20627,25374,60955,0,0,1,0,1
76370,170,20628,25465;25790,60955,0,0,2,0,2
76371,170,20629,26022;26346,60955,0,0,2,0,2
76372,170,20630,26068;28894,60955,1,0,1,0,2
76373,170,20631,26128,60955,0,0,1,0,1
76374,170,20632,25905,60955,0,0,1,0,1
76375,170,20633,26169;26310;28982;29241,60955,2,0,2,0,4
76376,170,20634,26353;26956;28837,60955,0,1,2,0,3
76377,170,20635,26370;26778;28922,60955,1,0,2,0,3
76378,170,20636,26348;26389,60955,0,0,2,0,2
76379,170,20637,26516;26847,60955,0,0,2,0,2
76380,170,20638,27088,60955,0,0,1,0,1
76381,170,20640,26543,60955,0,0,1,0,1
76382,170,20641,26554;26932,60955,0,0,2,0,2
76383,170,20642,26615;26998,60955,0,0,2,0,2
76384,170,20643,26629,60955,0,0,1,0,1
76385,170,20644,26558;26874;29013,60955,1,0,2,0,3
76386,170,20645,26688;29105,60955,1,0,1,0,2
76387,170,20646,26401,60955,0,0,1,0,1
76388,170,20647,26595;26710;29178,60955,1,0,2,0,3
76389,170,20648,26738;28920,60955,1,0,1,0,2
76390,170,20649,26739;26978,60955,0,0,2,0,2
76391,170,20650,26748;26986,60955,0,0,2,0,2
76392,170,20651,26439,60955,0,0,1,0,1
76393,170,20652,26793;26861,60955,0,0,2,0,2
76394,170,20653,26819;26950;28834,60955,0,1,2,0,3
76395,170,20654,26727,60955,0,0,1,0,1
76396,170,20655,26889;27244;29024,60955,1,0,2,0,3
76397,170,20656,26900;27301,60955,0,0,2,0,2
76398,170,20657,26720;26922,60955,0,0,2,0,2
76399,170,20658,26955;27196,60955,0,0,2,0,2
76400,170,20659,26960;27144;28928,60955,1,0,2,0,3
76401,170,20660,26996;27352;29126,60955,1,0,2,0,3
76402,170,20661,27015;27547,60955,0,0,2,0,2
76403,170,20662,26871;27028;29114,60955,1,0,2,0,3
76404,170,20663,26929;27035,60955,0,0,2,0,2
76405,170,20664,27045;27057,60955,0,0,2,0,2
76406,170,20665,27002;27077,60955,0,0,2,0,2
76407,170,20666,27014;27082,60955,0,0,2,0,2
76408,170,20667,27093;27224,60955,0,0,2,0,2
76409,170,20668,26896;27096,60955,0,0,2,0,2
76410,170,20669,26970;27103,60955,0,0,2,0,2
76411,170,20670,26791;27113,60955,0,0,2,0,2
76412,170,20671,27117;27511,60955,0,0,2,0,2
76413,170,20672,27118;27251;29195,60955,1,0,2,0,3
76414,170,20673,26988;27145,60955,0,0,2,0,2
76415,170,20674,26983;27146;28841;29121,60955,1,1,2,0,4
76416,170,20675,26622;27149,60955,0,0,2,0,2
76417,170,20676,27150;27542,60955,0,0,2,0,2
76418,170,20677,27157;27177,60955,0,0,2,0,2
76419,170,20678,27233;27280,60955,0,0,2,0,2
76420,170,20679,27230;27241,60955,0,0,2,0,2
76421,170,20680,26886;27250;29123;29295,60955,2,0,2,0,4
76422,170,20681,27211;27273,60955,0,0,2,0,2
76423,170,20682,27277;27425,60955,0,0,2,0,2
76424,170,20683,23291,61320,0,0,1,0,1
76425,170,20684,23266,61320,0,0,1,0,1
76426,170,20686,23201,61320,0,0,1,0,1
76427,170,20687,23361,61320,0,0,1,0,1
76428,170,20688,22937,61320,0,0,1,0,1
76429,170,20689,23506,61320,0,0,1,0,1
76430,170,20690,23092,61320,0,0,1,0,1
76431,170,20691,23366,61320,0,0,1,0,1
76432,170,20692,23888,61320,0,0,1,0,1
76433,170,20693,23889,61320,0,0,1,0,1
76434,170,20695,23690;23892,61320,0,0,2,0,2
76435,170,20696,24089,61320,0,0,1,0,1
76436,170,20697,24315,61320,0,0,1,0,1
76437,170,20698,24095,61320,0,0,1,0,1
76438,170,20699,24373,61320,0,0,1,0,1
76439,170,20700,23792,61320,0,0,1,0,1
76440,170,20701,24473,61320,0,0,1,0,1
76441,170,20703,24848,61320,0,0,1,0,1
76442,170,20706,24605,61320,0,0,1,0,1
76443,170,20707,25169,61320,0,0,1,0,1
76444,170,20709,25283,61320,0,0,1,0,1
76445,170,20710,24939,61320,0,0,1,0,1
76446,170,20711,25281,61320,0,0,1,0,1
76447,170,20713,25536,61320,0,0,1,0,1
76448,170,20714,25452,61320,0,0,1,0,1
76449,170,20715,25774;25787,61320,0,0,2,0,2
76450,170,20716,25805,61320,0,0,1,0,1
76451,170,20718,26053;26165;28744,61320,0,1,2,0,3
76452,170,20719,26259,61320,0,0,1,0,1
76453,170,20720,26391,61320,0,0,1,0,1
76454,170,20721,26371,61320,0,0,1,0,1
76455,170,20722,26607,61320,0,0,1,0,1
76456,170,20723,26473;26692,61320,0,0,2,0,2
76457,170,20724,26151;26393;28034;28311,61320,0,2,2,0,4
76458,170,20726,26474,61320,0,0,1,0,1
76459,170,20727,26319,61320,0,0,1,0,1
76460,170,20728,26609,61320,0,0,1,0,1
76461,170,20729,26659;26963,61320,0,0,2,0,2
76462,170,20730,26661;27017,61320,0,0,2,0,2
76463,170,20731,26426,61320,0,0,1,0,1
76464,170,20732,26506;26687;29004,61320,1,0,2,0,3
76465,170,20733,26633;26689,61320,0,0,2,0,2
76466,170,20734,26697;26981,61320,0,0,2,0,2
76467,170,20735,26447,61320,0,0,1,0,1
76468,170,20736,26566;26836;28923,61320,1,0,2,0,3
76469,170,20737,26387;26880,61320,0,0,2,0,2
76470,170,20738,26912,61320,0,0,1,0,1
76471,170,20739,26876;26915,61320,0,0,2,0,2
76472,170,20740,26993;27505,61320,0,0,2,0,2
76473,170,20741,26931;27011,61320,0,0,2,0,2
76474,170,20742,26957;27019;29017,61320,1,0,2,0,3
76475,170,20743,26789;27026,61320,0,0,2,0,2
76476,170,20744,26859;27038,61320,0,0,2,0,2
76477,170,20745,27049;27350,61320,0,0,2,0,2
76478,170,20746,27064;27127,61320,0,0,2,0,2
76479,170,20747,26832;27068;28320,61320,0,1,2,0,3
76480,170,20748,27074;27410,61320,0,0,2,0,2
76481,170,20749,27081;27106,61320,0,0,2,0,2
76482,170,20750,27109;27284,61320,0,0,2,0,2
76483,170,20751,27110;27367,61320,0,0,2,0,2
76484,170,20752,26945;27114,61320,0,0,2,0,2
76485,170,20753,26834,61320,0,0,1,0,1
76486,170,20754,27137;27200;29197,61320,1,0,2,0,3
76487,170,20755,27204;27585,61320,0,0,2,0,2
76488,170,20756,27216;27306;29125,61320,1,0,2,0,3
76489,170,20757,27217;27335,61320,0,0,2,0,2
76490,170,20758,27166;27263,61320,0,0,2,0,2
76491,170,20759,27279;27488,61320,0,0,2,0,2
76492,170,20760,27295;27476,61320,0,0,2,0,2
76493,170,20761,27303;27591,61320,0,0,2,0,2
76494,170,20762,27264;27313,61320,0,0,2,0,2
76495,170,20763,27318;27497,61320,0,0,2,0,2
76496,170,20764,27332;27509,61320,0,0,2,0,2
76497,170,20765,27334;27397,61320,0,0,2,0,2
76498,170,20766,27201;27337,61320,0,0,2,0,2
76499,170,20767,27278;27349,61320,0,0,2,0,2
76500,170,20768,27231;27353,61320,0,0,2,0,2
76501,170,20769,27361;27546,61320,0,0,2,0,2
76502,170,20770,27362;27380,61320,0,0,2,0,2
76503,170,20771,27354;27365,61320,0,0,2,0,2
76504,170,20772,27175;27371,61320,0,0,2,0,2
76505,170,20773,27183;27373,61320,0,0,2,0,2
76506,170,20774,23307,61685,0,0,1,0,1
76507,170,20775,23376,61685,0,0,1,0,1
76508,170,20776,22902,61685,0,0,0,1,1
76509,170,20777,23537,61685,0,0,1,0,1
76510,170,20778,23330,61685,0,0,1,0,1
76511,170,20780,23254,61685,0,0,1,0,1
76512,170,20781,23304,61685,0,0,1,0,1
76513,170,20783,23488,61685,0,0,1,0,1
76514,170,20784,23039,61685,0,0,1,0,1
76515,170,20785,23935,61685,0,0,1,0,1
76516,170,20786,23853,61685,0,0,1,0,1
76517,170,20788,24108,61685,0,0,1,0,1
76518,170,20789,24430,61685,0,0,1,0,1
76519,170,20790,24626,61685,0,0,1,0,1
76520,170,20791,24616,61685,0,0,1,0,1
76521,170,20792,24775,61685,0,0,1,0,1
76522,170,20794,24101;24143,61685,0,0,2,0,2
76523,170,20795,25216,61685,0,0,1,0,1
76524,170,20796,24964,61685,0,0,1,0,1
76525,170,20797,25405,61685,0,0,1,0,1
76526,170,20799,25460,61685,0,0,1,0,1
76527,170,20800,25510,61685,0,0,1,0,1
76528,170,20801,25549,61685,0,0,1,0,1
76529,170,20803,25710,61685,0,0,1,0,1
76530,170,20804,25716,61685,0,0,1,0,1
76531,170,20805,25735;25832;28790;29222,61685,1,1,2,0,4
76532,170,20806,25308,61685,0,0,1,0,1
76533,170,20807,25780;26033,61685,0,0,2,0,2
76534,170,20808,25873;27655;28026;28645;28724;28875,61685,1,3,2,0,6
76535,170,20810,26237;26902;28595;29285,61685,1,1,2,0,4
76536,170,20811,26240;28485;28749,61685,0,2,1,0,3
76537,170,20812,26297;26452;29260,61685,1,0,2,0,3
76538,170,20813,26302,61685,0,0,1,0,1
76539,170,20814,26325;26648;28919;29272,61685,2,0,2,0,4
76540,170,20815,26364;26613,61685,0,0,2,0,2
76541,170,20816,26470,61685,0,0,1,0,1
76542,170,20817,26707,61685,0,0,1,0,1
76543,170,20818,26511;27022;29018,61685,1,0,2,0,3
76544,170,20819,26557;26903;28925,61685,1,0,2,0,3
76545,170,20820,26567;26858,61685,0,0,2,0,2
76546,170,20821,26603,61685,0,0,1,0,1
76547,170,20822,26605;26749;29275,61685,1,0,2,0,3
76548,170,20823,26517;26645;28822;29098,61685,1,1,2,0,4
76549,170,20824,26654;27155,61685,0,0,2,0,2
76550,170,20825,26668;26721,61685,0,0,2,0,2
76551,170,20826,26786,61685,0,0,1,0,1
76552,170,20827,26758;26795;28833,61685,0,1,2,0,3
76553,170,20828,26796,61685,0,0,1,0,1
76554,170,20829,26849;26938,61685,0,0,2,0,2
76555,170,20830,26673,61685,0,0,1,0,1
76556,170,20831,26906;27595,61685,0,0,2,0,2
76557,170,20832,26933,61685,0,0,1,0,1
76558,170,20833,26976;27001,61685,0,0,2,0,2
76559,170,20834,26982;27626,61685,0,0,2,0,2
76560,170,20835,26999;27441,61685,0,0,2,0,2
76561,170,20836,27013;27445,61685,0,0,2,0,2
76562,170,20837,27041;27051,61685,0,0,2,0,2
76563,170,20838,27044;27429,61685,0,0,2,0,2
76564,170,20839,26520,61685,0,0,1,0,1
76565,170,20840,27122;27459,61685,0,0,2,0,2
76566,170,20841,27176;27375,61685,0,0,2,0,2
76567,170,20842,27124;27178,61685,0,0,2,0,2
76568,170,20843,27210;27472;29129,61685,1,0,2,0,3
76569,170,20844,27276;27287,61685,0,0,2,0,2
76570,170,20845,27285;27458,61685,0,0,2,0,2
76571,170,20846,27293;27673,61685,0,0,2,0,2
76572,170,20847,27309;27720,61685,0,0,2,0,2
76573,170,20848,26947;27311,61685,0,0,2,0,2
76574,170,20849,27320,61685,0,0,1,0,1
76575,170,20850,27075;27323,61685,0,0,2,0,2
76576,170,20851,27328;27540,61685,0,0,2,0,2
76577,170,20852,27338;27650,61685,0,0,2,0,2
76578,170,20853,27288;27347,61685,0,0,2,0,2
76579,170,20854,27314;27369,61685,0,0,2,0,2
76580,170,20855,27436;27679,61685,0,0,2,0,2
76581,170,20856,27414;27450,61685,0,0,2,0,2
76582,170,20857,27394;27456;29203,61685,1,0,2,0,3
76583,170,20858,23398,62050,0,0,1,0,1
76584,170,20859,23210,62050,0,0,1,0,1
76585,170,20860,23353,62050,0,0,1,0,1
76586,170,20862,23777,62050,0,0,1,0,1
76587,170,20863,23514,62050,0,0,1,0,1
76588,170,20864,23834,62050,0,0,1,0,1
76589,170,20865,23991,62050,0,0,1,0,1
76590,170,20866,24014,62050,0,0,1,0,1
76591,170,20867,23842,62050,0,0,1,0,1
76592,170,20868,24204,62050,0,0,1,0,1
76593,170,20869,24111,62050,0,0,1,0,1
76594,170,20870,24193,62050,0,0,1,0,1
76595,170,20871,24263,62050,0,0,1,0,1
76596,170,20872,24256,62050,0,0,1,0,1
76597,170,20873,24275,62050,0,0,1,0,1
76598,170,20874,24300,62050,0,0,1,0,1
76599,170,20875,24301,62050,0,0,1,0,1
76600,170,20876,24332,62050,0,0,1,0,1
76601,170,20877,24306,62050,0,0,1,0,1
76602,170,20878,24615,62050,0,0,1,0,1
76603,170,20879,24643,62050,0,0,1,0,1
76604,170,20880,24443,62050,0,0,1,0,1
76605,170,20881,24756,62050,0,0,1,0,1
76606,170,20882,25088,62050,0,0,1,0,1
76607,170,20883,24876,62050,0,0,1,0,1
76608,170,20884,24900,62050,0,0,1,0,1
76609,170,20885,24910,62050,0,0,1,0,1
76610,170,20886,24972,62050,0,0,1,0,1
76611,170,20887,24670,62050,0,0,1,0,1
76612,170,20888,25037,62050,0,0,1,0,1
76613,170,20889,24754,62050,0,0,1,0,1
76614,170,20890,25097,62050,0,0,1,0,1
76615,170,20891,25045;25143,62050,0,0,2,0,2
76616,170,20892,25361,62050,0,0,1,0,1
76617,170,20893,25407,62050,0,0,1,0,1
76618,170,20894,25128,62050,0,0,1,0,1
76619,170,20895,25522,62050,0,0,1,0,1
76620,170,20896,25385;25584;28545;28626;28861,62050,1,2,2,0,5
76621,170,20897,25508,62050,0,0,1,0,1
76622,170,20898,25698,62050,0,0,1,0,1
76623,170,20899,25722,62050,0,0,1,0,1
76624,170,20900,25517,62050,0,0,1,0,1
76625,170,20901,25934,62050,0,0,1,0,1
76626,170,20902,25887;26362;29171,62050,1,0,2,0,3
76627,170,20903,25973,62050,0,0,1,0,1
76628,170,20904,25916,62050,0,0,1,0,1
76629,170,20905,25692,62050,0,0,1,0,1
76630,170,20906,26161;26699;28761,62050,0,1,2,0,3
76631,170,20907,26108;26213;29246,62050,1,0,2,0,3
76632,170,20908,26200,62050,0,0,1,0,1
76633,170,20909,26020,62050,0,0,1,0,1
76634,170,20910,26342,62050,0,0,1,0,1
76635,170,20911,26149,62050,0,0,1,0,1
76636,170,20912,26418;26888,62050,0,0,2,0,2
76637,170,20913,26547;27343,62050,0,0,2,0,2
76638,170,20914,26652,62050,0,0,1,0,1
76639,170,20915,26723,62050,0,0,1,0,1
76640,170,20916,26741;27174,62050,0,0,2,0,2
76641,170,20917,26808;27027,62050,0,0,2,0,2
76642,170,20918,26833;27246,62050,0,0,2,0,2
76643,170,20919,26921;27062;29292,62050,1,0,2,0,3
76644,170,20920,26966;27218,62050,0,0,2,0,2
76645,170,20921,27010;27465,62050,0,0,2,0,2
76646,170,20922,27037;27268,62050,0,0,2,0,2
76647,170,20923,26822;27054;29117,62050,1,0,2,0,3
76648,170,20924,27063;27125,62050,0,0,2,0,2
76649,170,20925,27036;27111,62050,0,0,2,0,2
76650,170,20926,27197;29023,62050,1,0,1,0,2
76651,170,20927,27225;27396,62050,0,0,2,0,2
76652,170,20928,27243;27572,62050,0,0,2,0,2
76653,170,20929,27255;27282,62050,0,0,2,0,2
76654,170,20930,27302,62050,0,0,1,0,1
76655,170,20931,27305;27796,62050,0,1,1,0,2
76656,170,20932,27366;27589,62050,0,0,2,0,2
76657,170,20933,27386;27487,62050,0,0,2,0,2
76658,170,20934,27391;27696,62050,0,0,2,0,2
76659,170,20935,27405;27809,62050,0,1,1,0,2
76660,170,20936,27291;27424,62050,0,0,2,0,2
76661,170,20937,27474;27830;29208,62050,1,1,1,0,3
76662,170,20938,27342;27475,62050,0,0,2,0,2
76663,170,20939,27481,62050,0,0,1,0,1
76664,170,20940,27289;27484,62050,0,0,2,0,2
76665,170,20941,27514;27793,62050,0,1,1,0,2
76666,170,20942,27478;27525;29026,62050,1,0,2,0,3
76667,170,20943,27527;27795,62050,0,1,1,0,2
76668,170,20944,27535;27805,62050,0,1,1,0,2
76669,170,20945,27304;27538,62050,0,0,2,0,2
76670,170,20946,27545;27807,62050,0,1,1,0,2
76671,170,20947,27563;27649,62050,0,0,2,0,2
76672,180,12353,22393;26120,29565,0,0,1,1,2
76673,180,12398,21363,29930,0,0,0,1,1
76674,180,12642,27190,30660,0,0,1,0,1
76675,180,13737,23377;23472,34675,0,0,0,2,2
76676,180,13740,22783;26527;29173,34675,0,1,1,1,3
76677,180,13803,22097;22555,35040,0,0,0,2,2
76678,180,13915,23147,35405,0,0,0,1,1
76679,180,14147,19934,36135,0,0,0,1,1
76680,180,14168,19840,36135,0,0,0,1,1
76681,180,14173,23512,36135,0,0,0,1,1
76682,180,14364,19860,36865,0,0,0,1,1
76683,180,14365,20249,36865,0,0,0,1,1
76684,180,14367,20365,36865,0,0,0,1,1
76685,180,14454,20196,37230,0,0,0,1,1
76686,180,14461,20500,37230,0,0,0,1,1
76687,180,14477,20574,37230,0,0,0,1,1
76688,180,14480,20414,37230,0,0,0,1,1
76689,180,14561,19843,37595,0,0,0,1,1
76690,180,14577,20652,37595,0,0,0,1,1
76691,180,14578,20321,37595,0,0,0,1,1
76692,180,14581,20194,37595,0,0,0,1,1
76693,180,14678,20310,37960,0,0,0,1,1
76694,180,14683,20172,37960,0,0,0,1,1
76695,180,14688,20317,37960,0,0,0,1,1
76696,180,14695,20226,37960,0,0,0,1,1
76697,180,14699,21112,37960,0,0,0,1,1
76698,180,14700,23344;23960;24044;24084;27846,37960,0,0,3,2,5
76699,180,14751,19809,38325,0,0,0,1,1
76700,180,14775,20351,38325,0,0,0,1,1
76701,180,14777,20112,38325,0,0,0,1,1
76702,180,14780,20541,38325,0,0,0,1,1
76703,180,14784,20456,38325,0,0,0,1,1
76704,180,14798,20460,38325,0,0,0,1,1
76705,180,14800,20515,38325,0,0,0,1,1
76706,180,14801,20571,38325,0,0,0,1,1
76707,180,14802,20780,38325,0,0,0,1,1
76708,180,14865,20948,38690,0,0,0,1,1
76709,180,14876,20161,38690,0,0,0,1,1
76710,180,14877,20732,38690,0,0,0,1,1
76711,180,14887,20642,38690,0,0,0,1,1
76712,180,14888,21025,38690,0,0,0,1,1
76713,180,14948,20790,39055,0,0,0,1,1
76714,180,14963,20322,39055,0,0,0,1,1
76715,180,14966,20189,39055,0,0,0,1,1
76716,180,14969,20288,39055,0,0,0,1,1
76717,180,14976,20524,39055,0,0,0,1,1
76718,180,14978,20615,39055,0,0,0,1,1
76719,180,14980,21155,39055,0,0,0,1,1
76720,180,14981,20668,39055,0,0,0,1,1
76721,180,14988,20980,39055,0,0,0,1,1
76722,180,14991,21095;21122,39055,0,0,0,2,2
76723,180,15051,20496,39420,0,0,0,1,1
76724,180,15055,20471,39420,0,0,0,1,1
76725,180,15056,20474,39420,0,0,0,1,1
76726,180,15060,20584,39420,0,0,0,1,1
76727,180,15062,20604,39420,0,0,0,1,1
76728,180,15063,20805,39420,0,0,0,1,1
76729,180,15070,21184,39420,0,0,0,1,1
76730,180,15074,20608,39420,0,0,0,1,1
76731,180,15076,20797;21048,39420,0,0,0,2,2
76732,180,15077,21017,39420,0,0,0,1,1
76733,180,15078,20863,39420,0,0,0,1,1
76734,180,15081,20912,39420,0,0,0,1,1
76735,180,15085,20865,39420,0,0,0,1,1
76736,180,15152,20560;24235,39785,0,0,1,1,2
76737,180,15153,23753;23769,39785,0,0,0,2,2
76738,180,15157,23588;24343,39785,0,0,1,1,2
76739,180,15160,20798,39785,0,0,0,1,1
76740,180,15162,20850;20913,39785,0,0,0,2,2
76741,180,15167,20890,39785,0,0,0,1,1
76742,180,15168,20908,39785,0,0,0,1,1
76743,180,15170,20940,39785,0,0,0,1,1
76744,180,15171,20942,39785,0,0,0,1,1
76745,180,15172,20964,39785,0,0,0,1,1
76746,180,15173,20965,39785,0,0,0,1,1
76747,180,15176,24806;25024,39785,0,0,2,0,2
76748,180,15216,20451,40150,0,0,0,1,1
76749,180,15226,20967,40150,0,0,0,1,1
76750,180,15230,20552,40150,0,0,0,1,1
76751,180,15231,20581,40150,0,0,0,1,1
76752,180,15234,20411,40150,0,0,0,1,1
76753,180,15235,20662,40150,0,0,0,1,1
76754,180,15245,20856,40150,0,0,0,1,1
76755,180,15247,21060,40150,0,0,0,1,1
76756,180,15248,20528,40150,0,0,0,1,1
76757,180,15251,20972,40150,0,0,0,1,1
76758,180,15256,21034,40150,0,0,0,1,1
76759,180,15258,21069,40150,0,0,0,1,1
76760,180,15259,20959,40150,0,0,0,1,1
76761,180,15261,21293,40150,0,0,0,1,1
76762,180,15265,21173,40150,0,0,0,1,1
76763,180,15320,20614,40515,0,0,0,1,1
76764,180,15326,20843,40515,0,0,0,1,1
76765,180,15328,20426,40515,0,0,0,1,1
76766,180,15336,21356,40515,0,0,0,1,1
76767,180,15339,20677,40515,0,0,0,1,1
76768,180,15340,21392,40515,0,0,0,1,1
76769,180,15343,21047,40515,0,0,0,1,1
76770,180,15344,21214,40515,0,0,0,1,1
76771,180,15350,25005;28509,40515,0,0,2,0,2
76772,180,15351,21304,40515,0,0,0,1,1
76773,180,15352,21525,40515,0,0,0,1,1
76774,180,15353,21156,40515,0,0,0,1,1
76775,180,15355,21441,40515,0,0,0,1,1
76776,180,15357,20919,40515,0,0,0,1,1
76777,180,15360,21474,40515,0,0,0,1,1
76778,180,15362,21295,40515,0,0,0,1,1
76779,180,15365,21208,40515,0,0,0,1,1
76780,180,15367,21186,40515,0,0,0,1,1
76781,180,15369,21203,40515,0,0,0,1,1
76782,180,15370,21252,40515,0,0,0,1,1
76783,180,15371,21254,40515,0,0,0,1,1
76784,180,15373,21280,40515,0,0,0,1,1
76785,180,15402,22945;23107,40880,0,0,0,2,2
76786,180,15406,23688,40880,0,0,0,1,1
76787,180,15427,20811;24459,40880,0,0,1,1,2
76788,180,15428,20753,40880,0,0,0,1,1
76789,180,15430,20522,40880,0,0,0,1,1
76790,180,15435,20835,40880,0,0,0,1,1
76791,180,15436,21114,40880,0,0,0,1,1
76792,180,15438,20883,40880,0,0,0,1,1
76793,180,15442,21081,40880,0,0,0,1,1
76794,180,15445,21077,40880,0,0,0,1,1
76795,180,15446,21201,40880,0,0,0,1,1
76796,180,15449,21140,40880,0,0,0,1,1
76797,180,15453,21187;21193,40880,0,0,0,2,2
76798,180,15456,21258,40880,0,0,0,1,1
76799,180,15461,21878,40880,0,0,0,1,1
76800,180,15463,21277,40880,0,0,0,1,1
76801,180,15464,21411,40880,0,0,0,1,1
76802,180,15497,22953;23182,41245,0,0,0,2,2
76803,180,15524,20705,41245,0,0,0,1,1
76804,180,15526,21196,41245,0,0,0,1,1
76805,180,15528,20834,41245,0,0,0,1,1
76806,180,15534,21115,41245,0,0,0,1,1
76807,180,15535,20982,41245,0,0,0,1,1
76808,180,15536,25742;26481;28585;28668;28913;29606;29766,41245,1,2,4,0,7
76809,180,15537,21002;21109,41245,0,0,0,2,2
76810,180,15538,21045,41245,0,0,0,1,1
76811,180,15541,21133,41245,0,0,0,1,1
76812,180,15544,21760,41245,0,0,0,1,1
76813,180,15545,21352;21393,41245,0,0,0,2,2
76814,180,15547,21121,41245,0,0,0,1,1
76815,180,15549,21104;21565,41245,0,0,0,2,2
76816,180,15550,21213,41245,0,0,0,1,1
76817,180,15551,21168,41245,0,0,0,1,1
76818,180,15552,21248,41245,0,0,0,1,1
76819,180,15554,21865,41245,0,0,0,1,1
76820,180,15556,21594,41245,0,0,0,1,1
76821,180,15557,21523,41245,0,0,0,1,1
76822,180,15558,21369;21701,41245,0,0,0,2,2
76823,180,15560,21439,41245,0,0,0,1,1
76824,180,15561,21794,41245,0,0,0,1,1
76825,180,15562,21545,41245,0,0,0,1,1
76826,180,15564,25014;25055,41245,0,0,2,0,2
76827,180,15565,21801,41245,0,0,0,1,1
76828,180,15566,21379,41245,0,0,0,1,1
76829,180,15567,21302,41245,0,0,0,1,1
76830,180,15569,21833,41245,0,0,0,1,1
76831,180,15619,20180,41610,0,0,0,1,1
76832,180,15621,20588,41610,0,0,0,1,1
76833,180,15625,20787;20921,41610,0,0,0,2,2
76834,180,15627,21320,41610,0,0,0,1,1
76835,180,15634,21012,41610,0,0,0,1,1
76836,180,15636,21043,41610,0,0,0,1,1
76837,180,15640,21405,41610,0,0,0,1,1
76838,180,15641,21097,41610,0,0,0,1,1
76839,180,15646,21579;21706,41610,0,0,0,2,2
76840,180,15648,24830;24905,41610,0,0,2,0,2
76841,180,15650,20961;21423,41610,0,0,0,2,2
76842,180,15653,21413,41610,0,0,0,1,1
76843,180,15654,20815;21482,41610,0,0,0,2,2
76844,180,15660,22036,41610,0,0,0,1,1
76845,180,15662,21249;21483,41610,0,0,0,2,2
76846,180,15665,22108,41610,0,0,0,1,1
76847,180,15666,21409;21772,41610,0,0,0,2,2
76848,180,15667,21973,41610,0,0,0,1,1
76849,180,15668,21232;21504,41610,0,0,0,2,2
76850,180,15669,21456,41610,0,0,0,1,1
76851,180,15670,21660,41610,0,0,0,1,1
76852,180,15709,23968;24453;24944;28684,41975,0,1,2,1,4
76853,180,15714,21206,41975,0,0,0,1,1
76854,180,15717,21218,41975,0,0,0,1,1
76855,180,15718,20762,41975,0,0,0,1,1
76856,180,15722,20901,41975,0,0,0,1,1
76857,180,15724,20928,41975,0,0,0,1,1
76858,180,15725,21179,41975,0,0,0,1,1
76859,180,15727,21566,41975,0,0,0,1,1
76860,180,15729,21165,41975,0,0,0,1,1
76861,180,15732,24908;28078,41975,0,0,2,0,2
76862,180,15733,21116;21443,41975,0,0,0,2,2
76863,180,15740,21590,41975,0,0,0,1,1
76864,180,15741,21239,41975,0,0,0,1,1
76865,180,15743,21267;21284,41975,0,0,0,2,2
76866,180,15746,21375,41975,0,0,0,1,1
76867,180,15747,21381,41975,0,0,0,1,1
76868,180,15749,21464;21953,41975,0,0,0,2,2
76869,180,15751,21539,41975,0,0,0,1,1
76870,180,15754,22106,41975,0,0,0,1,1
76871,180,15755,21692;21970,41975,0,0,0,2,2
76872,180,15758,22082,41975,0,0,0,1,1
76873,180,15759,21600;21800,41975,0,0,0,2,2
76874,180,15760,21707;22081,41975,0,0,0,2,2
76875,180,15763,21640,41975,0,0,0,1,1
76876,180,15764,21895,41975,0,0,0,1,1
76877,180,15765,21845,41975,0,0,0,1,1
76878,180,15767,21808,41975,0,0,0,1,1
76879,180,15769,21956,41975,0,0,0,1,1
76880,180,15772,21870,41975,0,0,0,1,1
76881,180,15809,21178,42340,0,0,0,1,1
76882,180,15813,20749,42340,0,0,0,1,1
76883,180,15815,21527,42340,0,0,0,1,1
76884,180,15822,21237,42340,0,0,0,1,1
76885,180,15824,20693,42340,0,0,0,1,1
76886,180,15825,21125,42340,0,0,0,1,1
76887,180,15827,21197,42340,0,0,0,1,1
76888,180,15835,21830,42340,0,0,0,1,1
76889,180,15837,21346,42340,0,0,0,1,1
76890,180,15839,21635,42340,0,0,0,1,1
76891,180,15840,21427,42340,0,0,0,1,1
76892,180,15841,21522,42340,0,0,0,1,1
76893,180,15843,21552;21575,42340,0,0,0,2,2
76894,180,15847,21680,42340,0,0,0,1,1
76895,180,15848,21872,42340,0,0,0,1,1
76896,180,15850,21448;21694,42340,0,0,0,2,2
76897,180,15851,21722,42340,0,0,0,1,1
76898,180,15853,22181,42340,0,0,0,1,1
76899,180,15854,21759,42340,0,0,0,1,1
76900,180,15855,21769,42340,0,0,0,1,1
76901,180,15856,21532,42340,0,0,0,1,1
76902,180,15859,21804,42340,0,0,0,1,1
76903,180,15860,21817;22121,42340,0,0,0,2,2
76904,180,15861,21820,42340,0,0,0,1,1
76905,180,15862,21861,42340,0,0,0,1,1
76906,180,15863,21386,42340,0,0,0,1,1
76907,180,15900,19942,42705,0,0,0,1,1
76908,180,15901,20644,42705,0,0,0,1,1
76909,180,15912,21255,42705,0,0,0,1,1
76910,180,15916,21265,42705,0,0,0,1,1
76911,180,15919,21353;21416,42705,0,0,0,2,2
76912,180,15924,21688,42705,0,0,0,1,1
76913,180,15926,21874;25369,42705,0,0,1,1,2
76914,180,15927,22175,42705,0,0,0,1,1
76915,180,15929,21571,42705,0,0,0,1,1
76916,180,15931,21452,42705,0,0,0,1,1
76917,180,15935,21484;21751,42705,0,0,0,2,2
76918,180,15936,22168;22356,42705,0,0,0,2,2
76919,180,15938,21766;22013,42705,0,0,0,2,2
76920,180,15939,21567,42705,0,0,0,1,1
76921,180,15940,21917,42705,0,0,0,1,1
76922,180,15943,21384,42705,0,0,0,1,1
76923,180,15944,21957,42705,0,0,0,1,1
76924,180,15947,22227;22312,42705,0,0,0,2,2
76925,180,15948,21911,42705,0,0,0,1,1
76926,180,15949,21742;21849,42705,0,0,0,2,2
76927,180,15950,22237,42705,0,0,0,1,1
76928,180,15951,21646,42705,0,0,0,1,1
76929,180,15952,21807,42705,0,0,0,1,1
76930,180,15953,21810;22095,42705,0,0,0,2,2
76931,180,15955,22031;22196,42705,0,0,0,2,2
76932,180,15956,22104,42705,0,0,0,1,1
76933,180,15957,22271;22286,42705,0,0,0,2,2
76934,180,15958,22009,42705,0,0,0,1,1
76935,180,15959,21602;22149,42705,0,0,0,2,2
76936,180,15960,21524;21843,42705,0,0,0,2,2
76937,180,15961,21881;21892,42705,0,0,0,2,2
76938,180,15962,22302,42705,0,0,0,1,1
76939,180,15963,21880,42705,0,0,0,1,1
76940,180,15964,21906,42705,0,0,0,1,1
76941,180,15965,21946,42705,0,0,0,1,1
76942,180,15966,21977,42705,0,0,0,1,1
76943,180,15967,22023,42705,0,0,0,1,1
76944,180,15996,20729,43070,0,0,0,1,1
76945,180,16009,20587,43070,0,0,0,1,1
76946,180,16017,21390,43070,0,0,0,1,1
76947,180,16018,20910,43070,0,0,0,1,1
76948,180,16027,21836,43070,0,0,0,1,1
76949,180,16028,21716,43070,0,0,0,1,1
76950,180,16029,21282,43070,0,0,0,1,1
76951,180,16030,21512,43070,0,0,0,1,1
76952,180,16031,21083,43070,0,0,0,1,1
76953,180,16032,21329,43070,0,0,0,1,1
76954,180,16034,21245,43070,0,0,0,1,1
76955,180,16037,21437,43070,0,0,0,1,1
76956,180,16038,21510,43070,0,0,0,1,1
76957,180,16039,21629,43070,0,0,0,1,1
76958,180,16040,21988,43070,0,0,0,1,1
76959,180,16041,21664,43070,0,0,0,1,1
76960,180,16042,21621;21768,43070,0,0,0,2,2
76961,180,16043,21702,43070,0,0,0,1,1
76962,180,16044,21703,43070,0,0,0,1,1
76963,180,16045,21989;22236,43070,0,0,0,2,2
76964,180,16047,21720,43070,0,0,0,1,1
76965,180,16048,21431,43070,0,0,0,1,1
76966,180,16049,21433;21771,43070,0,0,0,2,2
76967,180,16050,21775;22391,43070,0,0,0,2,2
76968,180,16051,22354,43070,0,0,0,1,1
76969,180,16052,21809,43070,0,0,0,1,1
76970,180,16053,21569,43070,0,0,0,1,1
76971,180,16055,21790,43070,0,0,0,1,1
76972,180,16056,21883,43070,0,0,0,1,1
76973,180,16057,22073;22080,43070,0,0,0,2,2
76974,180,16059,21942;22034,43070,0,0,0,2,2
76975,180,16060,22178,43070,0,0,0,1,1
76976,180,16062,22010,43070,0,0,0,1,1
76977,180,16063,22287,43070,0,0,0,1,1
76978,180,16064,22045,43070,0,0,0,1,1
76979,180,16065,21896,43070,0,0,0,1,1
76980,180,16066,22584,43070,0,0,0,1,1
76981,180,16068,21312;22094,43070,0,0,0,2,2
76982,180,16069,22092;22111,43070,0,0,0,2,2
76983,180,16070,22113,43070,0,0,0,1,1
76984,180,16071,21930;22240,43070,0,0,0,2,2
76985,180,16072,22146,43070,0,0,0,1,1
76986,180,16073,22032;22148,43070,0,0,0,2,2
76987,180,16107,21056,43435,0,0,0,1,1
76988,180,16110,21091,43435,0,0,0,1,1
76989,180,16113,21339,43435,0,0,0,1,1
76990,180,16118,21131,43435,0,0,0,1,1
76991,180,16119,21147;21407,43435,0,0,0,2,2
76992,180,16122,21143;21300,43435,0,0,0,2,2
76993,180,16123,21709,43435,0,0,0,1,1
76994,180,16124,21230;21322,43435,0,0,0,2,2
76995,180,16126,21171,43435,0,0,0,1,1
76996,180,16127,21459,43435,0,0,0,1,1
76997,180,16128,21378,43435,0,0,0,1,1
76998,180,16129,21481,43435,0,0,0,1,1
76999,180,16130,21980,43435,0,0,0,1,1
77000,180,16134,21975,43435,0,0,0,1,1
77001,180,16135,21902,43435,0,0,0,1,1
77002,180,16136,21853;21897,43435,0,0,0,2,2
77003,180,16138,21684;21939,43435,0,0,0,2,2
77004,180,16139,22061,43435,0,0,0,1,1
77005,180,16140,21733;22492,43435,0,0,0,2,2
77006,180,16143,21314;21780,43435,0,0,0,2,2
77007,180,16145,21604;21931,43435,0,0,0,2,2
77008,180,16146,21540;21863,43435,0,0,0,2,2
77009,180,16147,22378,43435,0,0,0,1,1
77010,180,16148,21827,43435,0,0,0,1,1
77011,180,16150,21088;21912;25255,43435,0,0,1,2,3
77012,180,16151,21922;22261,43435,0,0,0,2,2
77013,180,16152,21933,43435,0,0,0,1,1
77014,180,16154,22091,43435,0,0,0,1,1
77015,180,16155,22120;22306,43435,0,0,0,2,2
77016,180,16156,22098,43435,0,0,0,1,1
77017,180,16157,22410,43435,0,0,0,1,1
77018,180,16159,22125,43435,0,0,0,1,1
77019,180,16161,22182;22305,43435,0,0,0,2,2
77020,180,16162,22076;22299,43435,0,0,0,2,2
77021,180,16163,22502,43435,0,0,0,1,1
77022,180,16165,22019,43435,0,0,0,1,1
77023,180,16166,22100,43435,0,0,0,1,1
77024,180,16167,21971;22293,43435,0,0,0,2,2
77025,180,16168,22145;22162,43435,0,0,0,2,2
77026,180,16169,22478,43435,0,0,0,1,1
77027,180,16170,22423,43435,0,0,0,1,1
77028,180,16171,22180,43435,0,0,0,1,1
77029,180,16174,21919;22267,43435,0,0,0,2,2
77030,180,16175,22274;22385,43435,0,0,0,2,2
77031,180,16214,20479,43800,0,0,0,1,1
77032,180,16221,21210,43800,0,0,0,1,1
77033,180,16223,20518,43800,0,0,0,1,1
77034,180,16226,20864,43800,0,0,0,1,1
77035,180,16228,20320;20630,43800,0,0,0,2,2
77036,180,16237,20996;21272,43800,0,0,0,2,2
77037,180,16239,21735,43800,0,0,0,1,1
77038,180,16240,21924;22212,43800,0,0,0,2,2
77039,180,16241,21643,43800,0,0,0,1,1
77040,180,16242,21511,43800,0,0,0,1,1
77041,180,16243,21024;21520,43800,0,0,0,2,2
77042,180,16245,21564,43800,0,0,0,1,1
77043,180,16248,21681,43800,0,0,0,1,1
77044,180,16251,25669;26111,43800,0,0,2,0,2
77045,180,16252,21451;21856,43800,0,0,0,2,2
77046,180,16253,22164;22413,43800,0,0,0,2,2
77047,180,16255,22099,43800,0,0,0,1,1
77048,180,16257,21507,43800,0,0,0,1,1
77049,180,16258,22266,43800,0,0,0,1,1
77050,180,16259,21891,43800,0,0,0,1,1
77051,180,16260,22426,43800,0,0,0,1,1
77052,180,16262,21831,43800,0,0,0,1,1
77053,180,16265,22474,43800,0,0,0,1,1
77054,180,16266,21498,43800,0,0,0,1,1
77055,180,16267,21776;22303,43800,0,0,0,2,2
77056,180,16268,22169,43800,0,0,0,1,1
77057,180,16270,22208;22546,43800,0,0,0,2,2
77058,180,16271,21779;22154,43800,0,0,0,2,2
77059,180,16272,22138;22159,43800,0,0,0,2,2
77060,180,16275,21632;22048,43800,0,0,0,2,2
77061,180,16276,22680,43800,0,0,0,1,1
77062,180,16278,22252;22331,43800,0,0,0,2,2
77063,180,16279,22542,43800,0,0,0,1,1
77064,180,16281,22300;22506,43800,0,0,0,2,2
77065,180,16282,22319,43800,0,0,0,1,1
77066,180,16283,22493;22613,43800,0,0,0,2,2
77067,180,16284,22471,43800,0,0,0,1,1
77068,180,16285,22115;22347;26507;28316;30191,43800,1,0,2,2,5
77069,180,16286,22249;22379,43800,0,0,0,2,2
77070,180,16287,22343;22380,43800,0,0,0,2,2
77071,180,16288,26232;26563;29102,43800,0,1,2,0,3
77072,180,16314,24647;25083;28351,44165,0,0,3,0,3
77073,180,16318,20703,44165,0,0,0,1,1
77074,180,16320,20963,44165,0,0,0,1,1
77075,180,16325,21221,44165,0,0,0,1,1
77076,180,16328,21541,44165,0,0,0,1,1
77077,180,16329,21788;21981,44165,0,0,0,2,2
77078,180,16330,22117,44165,0,0,0,1,1
77079,180,16332,22425,44165,0,0,0,1,1
77080,180,16333,22015;22499,44165,0,0,0,2,2
77081,180,16334,21274,44165,0,0,0,1,1
77082,180,16335,21781,44165,0,0,0,1,1
77083,180,16336,21786,44165,0,0,0,1,1
77084,180,16337,21755;21789,44165,0,0,0,2,2
77085,180,16338,21824,44165,0,0,0,1,1
77086,180,16339,21454;21860,44165,0,0,0,2,2
77087,180,16340,21890;21943,44165,0,0,0,2,2
77088,180,16341,21538,44165,0,0,0,1,1
77089,180,16342,22044,44165,0,0,0,1,1
77090,180,16343,21974,44165,0,0,0,1,1
77091,180,16346,22093,44165,0,0,0,1,1
77092,180,16348,22055,44165,0,0,0,1,1
77093,180,16350,22543,44165,0,0,0,1,1
77094,180,16351,22662,44165,0,0,0,1,1
77095,180,16352,22592,44165,0,0,0,1,1
77096,180,16353,26026,44165,0,0,1,0,1
77097,180,16355,22547,44165,0,0,0,1,1
77098,180,16358,22341;22574,44165,0,0,0,2,2
77099,180,16359,21851;22446,44165,0,0,0,2,2
77100,180,16360,22489;22598,44165,0,0,0,2,2
77101,180,16361,21944;22498,44165,0,0,0,2,2
77102,180,16393,21620,44530,0,0,0,1,1
77103,180,16395,21005;21445,44530,0,0,0,2,2
77104,180,16400,21535,44530,0,0,0,1,1
77105,180,16402,21338;21514,44530,0,0,0,2,2
77106,180,16404,21385,44530,0,0,0,1,1
77107,180,16406,25288;25556;28016;28704;29040,44530,0,2,3,0,5
77108,180,16410,22150,44530,0,0,0,1,1
77109,180,16412,21793,44530,0,0,0,1,1
77110,180,16413,21749,44530,0,0,0,1,1
77111,180,16415,21599;22273,44530,0,0,0,2,2
77112,180,16416,21963,44530,0,0,0,1,1
77113,180,16420,21991,44530,0,0,0,1,1
77114,180,16421,22335,44530,0,0,0,1,1
77115,180,16422,22090,44530,0,0,0,1,1
77116,180,16423,22894,44530,0,0,0,1,1
77117,180,16424,22119;22307,44530,0,0,0,2,2
77118,180,16425,22198;22779,44530,0,0,0,2,2
77119,180,16426,22280,44530,0,0,0,1,1
77120,180,16427,22170;22281,44530,0,0,0,2,2
77121,180,16430,22358,44530,0,0,0,1,1
77122,180,16431,22372;22440,44530,0,0,0,2,2
77123,180,16432,22477,44530,0,0,0,1,1
77124,180,16436,22491;22527,44530,0,0,0,2,2
77125,180,16437,22717;26051,44530,0,0,1,1,2
77126,180,16438,22531,44530,0,0,0,1,1
77127,180,16439,22550,44530,0,0,0,1,1
77128,180,16440,22799,44530,0,0,0,1,1
77129,180,16441,22238,44530,0,0,0,1,1
77130,180,16442,22725;22870,44530,0,0,0,2,2
77131,180,16443,22325;22588,44530,0,0,0,2,2
77132,180,16444,22567;22599,44530,0,0,0,2,2
77133,180,16488,21136,44895,0,0,0,1,1
77134,180,16490,21198,44895,0,0,0,1,1
77135,180,16492,22004,44895,0,0,0,1,1
77136,180,16496,21581,44895,0,0,0,1,1
77137,180,16497,21700,44895,0,0,0,1,1
77138,180,16500,21918;22324,44895,0,0,0,2,2
77139,180,16502,21737,44895,0,0,0,1,1
77140,180,16503,22057,44895,0,0,0,1,1
77141,180,16504,22283;22422,44895,0,0,0,2,2
77142,180,16505,22018,44895,0,0,0,1,1
77143,180,16506,22248;22428,44895,0,0,0,2,2
77144,180,16507,21846;21928,44895,0,0,0,2,2
77145,180,16508,22268;25272,44895,0,0,1,1,2
77146,180,16510,21898;22024,44895,0,0,0,2,2
77147,180,16511,22361;22424,44895,0,0,0,2,2
77148,180,16512,22127,44895,0,0,0,1,1
77149,180,16514,22105;22152,44895,0,0,0,2,2
77150,180,16515,22458,44895,0,0,0,1,1
77151,180,16516,22174,44895,0,0,0,1,1
77152,180,16518,22202;22620,44895,0,0,0,2,2
77153,180,16520,21915;22496,44895,0,0,0,2,2
77154,180,16521,21796;22289;26415,44895,0,0,1,2,3
77155,180,16523,22671,44895,0,0,0,1,1
77156,180,16524,22349,44895,0,0,0,1,1
77157,180,16526,22765,44895,0,0,0,1,1
77158,180,16527,23856;24530;27776,44895,0,0,2,1,3
77159,180,16529,22403;22785,44895,0,0,0,2,2
77160,180,16530,21990,44895,0,0,0,1,1
77161,180,16531,22838,44895,0,0,0,1,1
77162,180,16532,22386;22420,44895,0,0,0,2,2
77163,180,16533,22421,44895,0,0,0,1,1
77164,180,16535,22451;23007,44895,0,0,0,2,2
77165,180,16536,22323,44895,0,0,0,1,1
77166,180,16537,22453;22503,44895,0,0,0,2,2
77167,180,16538,22448;22866,44895,0,0,0,2,2
77168,180,16540,22461,44895,0,0,0,1,1
77169,180,16541,22479;22537,44895,0,0,0,2,2
77170,180,16544,22612,44895,0,0,0,1,1
77171,180,16545,22304;22630,44895,0,0,0,2,2
77172,180,16546,22601;23011,44895,0,0,0,2,2
77173,180,16548,22435,44895,0,0,0,1,1
77174,180,16549,22367;22615,44895,0,0,0,2,2
77175,180,16550,22618,44895,0,0,0,1,1
77176,180,16551,22719;22790,44895,0,0,0,2,2
77177,180,16552,22396;22929,44895,0,0,0,2,2
77178,180,16553,22839;22961,44895,0,0,0,2,2
77179,180,16554,21962;22695,44895,0,0,0,2,2
77180,180,16555,22209;26135;28134;28577;28742;29160,44895,0,2,3,1,6
77181,180,16556,22720,44895,0,0,0,1,1
77182,180,16579,20776,45260,0,0,0,1,1
77183,180,16594,21457,45260,0,0,0,1,1
77184,180,16597,21965,45260,0,0,0,1,1
77185,180,16598,22199,45260,0,0,0,1,1
77186,180,16602,21428;21610,45260,0,0,0,2,2
77187,180,16603,21673,45260,0,0,0,1,1
77188,180,16604,22189,45260,0,0,0,1,1
77189,180,16606,21998,45260,0,0,0,1,1
77190,180,16609,21741,45260,0,0,0,1,1
77191,180,16611,22591,45260,0,0,0,1,1
77192,180,16613,21983,45260,0,0,0,1,1
77193,180,16614,21715;22226,45260,0,0,0,2,2
77194,180,16615,22247;22384,45260,0,0,0,2,2
77195,180,16616,22322,45260,0,0,0,1,1
77196,180,16617,22058,45260,0,0,0,1,1
77197,180,16619,22357;22634;26930,45260,0,0,1,2,3
77198,180,16621,22173,45260,0,0,0,1,1
77199,180,16622,22817,45260,0,0,0,1,1
77200,180,16623,22688,45260,0,0,0,1,1
77201,180,16624,21999,45260,0,0,0,1,1
77202,180,16626,22456,45260,0,0,0,1,1
77203,180,16627,22296;22437,45260,0,0,0,2,2
77204,180,16628,22346;22645,45260,0,0,0,2,2
77205,180,16629,22350,45260,0,0,0,1,1
77206,180,16630,22741,45260,0,0,0,1,1
77207,180,16631,22752,45260,0,0,0,1,1
77208,180,16632,22310;22434,45260,0,0,0,2,2
77209,180,16636,22575;22730,45260,0,0,0,2,2
77210,180,16639,22744;22833,45260,0,0,0,2,2
77211,180,16640,23062,45260,0,0,0,1,1
77212,180,16641,22433;22823,45260,0,0,0,2,2
77213,180,16642,22918,45260,0,0,0,1,1
77214,180,16644,22192;26817,45260,0,0,1,1,2
77215,180,16647,22705;22811,45260,0,0,0,2,2
77216,180,16648,23034,45260,0,0,0,1,1
77217,180,16694,21682,45625,0,0,0,1,1
77218,180,16698,21373,45625,0,0,0,1,1
77219,180,16699,21985,45625,0,0,0,1,1
77220,180,16701,21355,45625,0,0,0,1,1
77221,180,16703,22184,45625,0,0,0,1,1
77222,180,16706,21893,45625,0,0,0,1,1
77223,180,16711,25408,45625,0,0,1,0,1
77224,180,16714,22407;26510,45625,0,0,1,1,2
77225,180,16715,22186,45625,0,0,0,1,1
77226,180,16717,22309,45625,0,0,0,1,1
77227,180,16718,22239;22659,45625,0,0,0,2,2
77228,180,16719,21628;22160,45625,0,0,0,2,2
77229,180,16720,22068,45625,0,0,0,1,1
77230,180,16725,22075;22203,45625,0,0,0,2,2
77231,180,16727,22277;22441,45625,0,0,0,2,2
77232,180,16728,22648,45625,0,0,0,1,1
77233,180,16729,22429,45625,0,0,0,1,1
77234,180,16731,22197;22431,45625,0,0,0,2,2
77235,180,16732,22445;22519,45625,0,0,0,2,2
77236,180,16733,22853,45625,0,0,0,1,1
77237,180,16734,22514,45625,0,0,0,1,1
77238,180,16735,22540,45625,0,0,0,1,1
77239,180,16736,22545;22669,45625,0,0,0,2,2
77240,180,16737,22616,45625,0,0,0,1,1
77241,180,16739,22200;22624,45625,0,0,0,2,2
77242,180,16740,22627;22967,45625,0,0,0,2,2
77243,180,16741,22660;22733,45625,0,0,0,2,2
77244,180,16744,22053;22495,45625,0,0,0,2,2
77245,180,16745,22704;23068,45625,0,0,0,2,2
77246,180,16746,22389;22548,45625,0,0,0,2,2
77247,180,16747,22713;23021,45625,0,0,0,2,2
77248,180,16749,22571,45625,0,0,0,1,1
77249,180,16750,22986,45625,0,0,0,1,1
77250,180,16751,22832,45625,0,0,0,1,1
77251,180,16752,22979;23178,45625,0,0,0,2,2
77252,180,16755,22925,45625,0,0,0,1,1
77253,180,16756,22871;22958,45625,0,0,0,2,2
77254,180,16757,23027;23169,45625,0,0,0,2,2
77255,180,16758,22893,45625,0,0,0,1,1
77256,180,16759,22909,45625,0,0,0,1,1
77257,180,16760,22912;27005;28838;29289;29794,45625,1,2,1,1,5
77258,180,16761,22915;23098,45625,0,0,0,2,2
77259,180,16762,23080,45625,0,0,0,1,1
77260,180,16805,21477;21782,45990,0,0,0,2,2
77261,180,16807,21914,45990,0,0,0,1,1
77262,180,16808,21783,45990,0,0,0,1,1
77263,180,16810,21967;22141,45990,0,0,0,2,2
77264,180,16812,21553,45990,0,0,0,1,1
77265,180,16813,22114,45990,0,0,0,1,1
77266,180,16818,22664,45990,0,0,0,1,1
77267,180,16819,22524,45990,0,0,0,1,1
77268,180,16820,22687;22792,45990,0,0,0,2,2
77269,180,16821,22205;22715,45990,0,0,0,2,2
77270,180,16822,22217,45990,0,0,0,1,1
77271,180,16824,22585,45990,0,0,0,1,1
77272,180,16826,22328;22562,45990,0,0,0,2,2
77273,180,16829,22243;22467,45990,0,0,0,2,2
77274,180,16830,22487;23067,45990,0,0,0,2,2
77275,180,16831,21791;22462,45990,0,0,0,2,2
77276,180,16832,22500;22738,45990,0,0,0,2,2
77277,180,16833,22709,45990,0,0,0,1,1
77278,180,16834,22523,45990,0,0,0,1,1
77279,180,16835,22536,45990,0,0,0,1,1
77280,180,16836,22551,45990,0,0,0,1,1
77281,180,16837,22564;22587,45990,0,0,0,2,2
77282,180,16838,23125,45990,0,0,0,1,1
77283,180,16839,22728,45990,0,0,0,1,1
77284,180,16841,22649;22698,45990,0,0,0,2,2
77285,180,16842,22994,45990,0,0,0,1,1
77286,180,16843,22727,45990,0,0,0,1,1
77287,180,16844,22743;22815,45990,0,0,0,2,2
77288,180,16846,22766;22846,45990,0,0,0,2,2
77289,180,16847,22822,45990,0,0,0,1,1
77290,180,16848,22450;22825,45990,0,0,0,2,2
77291,180,16849,22001;22827,45990,0,0,0,2,2
77292,180,16850,22640;22849,45990,0,0,0,2,2
77293,180,16851,22868;23324,45990,0,0,0,2,2
77294,180,16852,23296;26943,45990,0,0,1,1,2
77295,180,16853,22891,45990,0,0,0,1,1
77296,180,16854,22910;23103,45990,0,0,0,2,2
77297,180,16855,22987;23047,45990,0,0,0,2,2
77298,180,16856,23315;23615,45990,0,0,0,2,2
77299,180,16857,22952,45990,0,0,0,1,1
77300,180,16858,22906;23247,45990,0,0,0,2,2
77301,180,16859,22611,45990,0,0,0,1,1
77302,180,16860,23314,45990,0,0,0,1,1
77303,180,16861,22769,45990,0,0,0,1,1
77304,180,16862,22755;23023;26351,45990,0,0,1,2,3
77305,180,16864,22544,45990,0,0,0,1,1
77306,180,16896,21574,46355,0,0,0,1,1
77307,180,16898,21855,46355,0,0,0,1,1
77308,180,16900,21357,46355,0,0,0,1,1
77309,180,16901,21505,46355,0,0,0,1,1
77310,180,16902,21656,46355,0,0,0,1,1
77311,180,16904,21195,46355,0,0,0,1,1
77312,180,16905,22244;22254,46355,0,0,0,2,2
77313,180,16907,21697,46355,0,0,0,1,1
77314,180,16908,21945,46355,0,0,0,1,1
77315,180,16910,21487,46355,0,0,0,1,1
77316,180,16911,22049;22460,46355,0,0,0,2,2
77317,180,16917,22533,46355,0,0,0,1,1
77318,180,16918,22724,46355,0,0,0,1,1
77319,180,16920,22777,46355,0,0,0,1,1
77320,180,16921,22454,46355,0,0,0,1,1
77321,180,16922,22480,46355,0,0,0,1,1
77322,180,16924,22528,46355,0,0,0,1,1
77323,180,16926,22736,46355,0,0,0,1,1
77324,180,16928,22942,46355,0,0,0,1,1
77325,180,16929,26433,46355,0,0,1,0,1
77326,180,16930,22852,46355,0,0,0,1,1
77327,180,16932,25900;26451;28667;29955,46355,1,0,3,0,4
77328,180,16933,22828,46355,0,0,0,1,1
77329,180,16934,22831;22966,46355,0,0,0,2,2
77330,180,16935,22841;23085,46355,0,0,0,2,2
77331,180,16936,23202,46355,0,0,0,1,1
77332,180,16937,22867,46355,0,0,0,1,1
77333,180,16938,23082;23149,46355,0,0,0,2,2
77334,180,16939,22415;23181;26842,46355,0,0,1,2,3
77335,180,16940,22922,46355,0,0,0,1,1
77336,180,16941,22916;22936;26059;27935;29152,46355,0,1,2,2,5
77337,180,16942,22956;23278,46355,0,0,0,2,2
77338,180,16943,22521;22970,46355,0,0,0,2,2
77339,180,16944,23002;23040,46355,0,0,0,2,2
77340,180,16945,22517;23006,46355,0,0,0,2,2
77341,180,16946,22747;23269,46355,0,0,0,2,2
77342,180,16947,22617;22978,46355,0,0,0,2,2
77343,180,16949,22770;23095,46355,0,0,0,2,2
77344,180,16950,23077,46355,0,0,0,1,1
77345,180,16951,23056;23093,46355,0,0,0,2,2
77346,180,16954,23321;23350,46355,0,0,0,2,2
77347,180,16955,23189;26637,46355,0,0,1,1,2
77348,180,16994,20825,46720,0,0,0,1,1
77349,180,16997,21106,46720,0,0,0,1,1
77350,180,16998,21374,46720,0,0,0,1,1
77351,180,17000,21365;21764,46720,0,0,0,2,2
77352,180,17002,22315,46720,0,0,0,1,1
77353,180,17013,22298,46720,0,0,0,1,1
77354,180,17014,22294,46720,0,0,0,1,1
77355,180,17015,21814;22156,46720,0,0,0,2,2
77356,180,17019,22552,46720,0,0,0,1,1
77357,180,17020,22071,46720,0,0,0,1,1
77358,180,17021,22887,46720,0,0,0,1,1
77359,180,17022,22418,46720,0,0,0,1,1
77360,180,17023,26403;26619;28673;29000,46720,0,1,3,0,4
77361,180,17025,22452,46720,0,0,0,1,1
77362,180,17026,22572,46720,0,0,0,1,1
77363,180,17027,22742;23225,46720,0,0,0,2,2
77364,180,17028,22778;23038,46720,0,0,0,2,2
77365,180,17029,22656,46720,0,0,0,1,1
77366,180,17030,23226,46720,0,0,0,1,1
77367,180,17031,22921;23235,46720,0,0,0,2,2
77368,180,17032,22693,46720,0,0,0,1,1
77369,180,17033,22892,46720,0,0,0,1,1
77370,180,17037,22851,46720,0,0,0,1,1
77371,180,17038,22900;22948,46720,0,0,0,2,2
77372,180,17039,23026;23171,46720,0,0,0,2,2
77373,180,17040,22901;23238,46720,0,0,0,2,2
77374,180,17041,22904;23094,46720,0,0,0,2,2
77375,180,17042,22913,46720,0,0,0,1,1
77376,180,17043,23491,46720,0,0,0,1,1
77377,180,17045,22595,46720,0,0,0,1,1
77378,180,17046,22977;26243,46720,0,0,1,1,2
77379,180,17048,22996,46720,0,0,0,1,1
77380,180,17050,23217;23459,46720,0,0,0,2,2
77381,180,17051,23249;23311,46720,0,0,0,2,2
77382,180,17052,23053;23100,46720,0,0,0,2,2
77383,180,17053,23109;23260,46720,0,0,0,2,2
77384,180,17054,22879,46720,0,0,0,1,1
77385,180,17055,23124;23528,46720,0,0,0,2,2
77386,180,17056,23293;23355,46720,0,0,0,2,2
77387,180,17057,22903;23290,46720,0,0,0,2,2
77388,180,17058,23196,46720,0,0,0,1,1
77389,180,17059,23570;23841;26587,46720,0,0,1,2,3
77390,180,17060,23157;27189,46720,0,0,1,1,2
77391,180,17061,23232,46720,0,0,0,1,1
77392,180,17095,21398,47085,0,0,0,1,1
77393,180,17096,22110,47085,0,0,0,1,1
77394,180,17100,21368,47085,0,0,0,1,1
77395,180,17101,21864;21982,47085,0,0,0,2,2
77396,180,17103,22002,47085,0,0,0,1,1
77397,180,17104,21753;21889,47085,0,0,0,2,2
77398,180,17106,22144,47085,0,0,0,1,1
77399,180,17107,22232;22788,47085,0,0,0,2,2
77400,180,17108,22219;22257,47085,0,0,0,2,2
77401,180,17109,22292,47085,0,0,0,1,1
77402,180,17110,22132;22395,47085,0,0,0,2,2
77403,180,17113,22334;22363,47085,0,0,0,2,2
77404,180,17115,22475,47085,0,0,0,1,1
77405,180,17117,22511,47085,0,0,0,1,1
77406,180,17118,22256,47085,0,0,0,1,1
77407,180,17119,22740,47085,0,0,0,1,1
77408,180,17121,22795,47085,0,0,0,1,1
77409,180,17123,22672;22872,47085,0,0,0,2,2
77410,180,17124,22677;22873;26821;29435;29633;29786,47085,1,2,1,2,6
77411,180,17125,22864;22883,47085,0,0,0,2,2
77412,180,17126,22691,47085,0,0,0,1,1
77413,180,17127,22468;22721,47085,0,0,0,2,2
77414,180,17128,22722;22944,47085,0,0,0,2,2
77415,180,17129,22737;22941,47085,0,0,0,2,2
77416,180,17130,22750,47085,0,0,0,1,1
77417,180,17132,22859,47085,0,0,0,1,1
77418,180,17134,22889,47085,0,0,0,1,1
77419,180,17135,23527,47085,0,0,0,1,1
77420,180,17136,22969,47085,0,0,0,1,1
77421,180,17137,23334;27566,47085,0,0,1,1,2
77422,180,17138,22775;23049,47085,0,0,0,2,2
77423,180,17140,23074,47085,0,0,0,1,1
77424,180,17141,22834;23354,47085,0,0,0,2,2
77425,180,17142,23486;23868;26665,47085,0,0,1,2,3
77426,180,17144,23204;23449;26951,47085,0,0,1,2,3
77427,180,17145,22895;23208,47085,0,0,0,2,2
77428,180,17146,22932;23209,47085,0,0,0,2,2
77429,180,17147,23030;23211,47085,0,0,0,2,2
77430,180,17148,23088;23212,47085,0,0,0,2,2
77431,180,17149,22647;22837,47085,0,0,0,2,2
77432,180,17150,23251,47085,0,0,0,1,1
77433,180,17151,23073;23283,47085,0,0,0,2,2
77434,180,17152,23105;23289,47085,0,0,0,2,2
77435,180,17155,23541;23650;26572;28824;29267,47085,0,2,1,2,5
77436,180,17156,23374,47085,0,0,0,1,1
77437,180,17157,23348;23639,47085,0,0,0,2,2
77438,180,17158,22991;23396,47085,0,0,0,2,2
77439,180,17160,23339;23816,47085,0,0,0,2,2
77440,180,17184,21335,47450,0,0,0,1,1
77441,180,17195,22084,47450,0,0,0,1,1
77442,180,17196,21744,47450,0,0,0,1,1
77443,180,17200,21857;21901,47450,0,0,0,2,2
77444,180,17203,21761;22282,47450,0,0,0,2,2
77445,180,17206,22628;22633,47450,0,0,0,2,2
77446,180,17207,22228,47450,0,0,0,1,1
77447,180,17212,22381,47450,0,0,0,1,1
77448,180,17213,22405,47450,0,0,0,1,1
77449,180,17214,22501;22666,47450,0,0,0,2,2
77450,180,17216,22626;22682,47450,0,0,0,2,2
77451,180,17218,22211;22580,47450,0,0,0,2,2
77452,180,17219,22939;22971,47450,0,0,0,2,2
77453,180,17221,22654;23143,47450,0,0,0,2,2
77454,180,17222,22676;22760,47450,0,0,0,2,2
77455,180,17223,22373;22781,47450,0,0,0,2,2
77456,180,17224,22764;22890,47450,0,0,0,2,2
77457,180,17225,22819;26166,47450,0,0,1,1,2
77458,180,17226,23058;26539;29176;29263;29768,47450,1,2,1,1,5
77459,180,17227,23357,47450,0,0,0,1,1
77460,180,17229,22882,47450,0,0,0,1,1
77461,180,17231,25801;26210;29245;29840,47450,1,1,2,0,4
77462,180,17232,22928,47450,0,0,0,1,1
77463,180,17233,22878;23302,47450,0,0,0,2,2
77464,180,17234,22982;23001,47450,0,0,0,2,2
77465,180,17235,22985;23258,47450,0,0,0,2,2
77466,180,17236,23131;23280,47450,0,0,0,2,2
77467,180,17237,23388,47450,0,0,0,1,1
77468,180,17238,23518,47450,0,0,0,1,1
77469,180,17239,23256,47450,0,0,0,1,1
77470,180,17242,22861;23206,47450,0,0,0,2,2
77471,180,17245,23014;23272,47450,0,0,0,2,2
77472,180,17246,22972;23288,47450,0,0,0,2,2
77473,180,17247,22933,47450,0,0,0,1,1
77474,180,17248,23214;23322,47450,0,0,0,2,2
77475,180,17249,23115;23323,47450,0,0,0,2,2
77476,180,17250,23152;23328;26173,47450,0,0,1,2,3
77477,180,17251,23373;23592,47450,0,0,0,2,2
77478,180,17252,23540;23684,47450,0,0,0,2,2
77479,180,17253,23386;23544,47450,0,0,0,2,2
77480,180,17254,23264;23424,47450,0,0,0,2,2
77481,180,17279,20651,47815,0,0,0,1,1
77482,180,17285,21920,47815,0,0,0,1,1
77483,180,17289,22042,47815,0,0,0,1,1
77484,180,17290,21925,47815,0,0,0,1,1
77485,180,17292,21978,47815,0,0,0,1,1
77486,180,17293,22012,47815,0,0,0,1,1
77487,180,17294,22020,47815,0,0,0,1,1
77488,180,17297,22000;22288,47815,0,0,0,2,2
77489,180,17299,22195,47815,0,0,0,1,1
77490,180,17301,22538;22579,47815,0,0,0,2,2
77491,180,17302,22397,47815,0,0,0,1,1
77492,180,17303,22414;22602,47815,0,0,0,2,2
77493,180,17304,22072;22417,47815,0,0,0,2,2
77494,180,17307,22553;22590,47815,0,0,0,2,2
77495,180,17308,22637;22850,47815,0,0,0,2,2
77496,180,17310,22869,47815,0,0,0,1,1
77497,180,17311,22706;23180,47815,0,0,0,2,2
77498,180,17312,22582,47815,0,0,0,1,1
77499,180,17313,22981;25635,47815,0,0,1,1,2
77500,180,17315,22530;22539,47815,0,0,0,2,2
77501,180,17318,22843;23174,47815,0,0,0,2,2
77502,180,17319,23184;23332,47815,0,0,0,2,2
77503,180,17320,22999;23436,47815,0,0,0,2,2
77504,180,17322,22989,47815,0,0,0,1,1
77505,180,17323,23148,47815,0,0,0,1,1
77506,180,17325,23614;24209,47815,0,0,1,1,2
77507,180,17326,23443,47815,0,0,0,1,1
77508,180,17327,23218;23663,47815,0,0,0,2,2
77509,180,17328,23464,47815,0,0,0,1,1
77510,180,17329,22803;23188,47815,0,0,0,2,2
77511,180,17330,23715;26480,47815,0,0,1,1,2
77512,180,17331,23203;23359,47815,0,0,0,2,2
77513,180,17332,23122;23207;27656,47815,0,0,1,2,3
77514,180,17333,23248;23609;27571,47815,0,0,1,2,3
77515,180,17334,23250;23596,47815,0,0,0,2,2
77516,180,17335,22816;23369,47815,0,0,0,2,2
77517,180,17336,23276;23450;26456,47815,0,0,1,2,3
77518,180,17337,23616;23760;27214,47815,0,0,1,2,3
77519,180,17338,23318;26944,47815,0,0,1,1,2
77520,180,17339,23576,47815,0,0,0,1,1
77521,180,17340,23422;23503,47815,0,0,0,2,2
77522,180,17341,23550;23759,47815,0,0,0,2,2
77523,180,17342,23533,47815,0,0,0,1,1
77524,180,17344,23132;23414,47815,0,0,0,2,2
77525,180,17345,23243;23420,47815,0,0,0,2,2
77526,180,17347,23659,47815,0,0,0,1,1
77527,180,17348,23534;23559,47815,0,0,0,2,2
77528,180,17349,23385;23479,47815,0,0,0,2,2
77529,180,17350,23881;27753;27839;30007;30084,47815,2,0,2,1,5
77530,180,17351,23713,47815,0,0,0,1,1
77531,180,17352,23297,47815,0,0,0,1,1
77532,180,17353,23585,47815,0,0,0,1,1
77533,180,17354,23470;23498,47815,0,0,0,2,2
77534,180,17355,23222;26569,47815,0,0,1,1,2
77535,180,17356,23333;23523,47815,0,0,0,2,2
77536,180,17357,22992;23428,47815,0,0,0,2,2
77537,180,17358,23642;26867,47815,0,0,1,1,2
77538,180,17360,23358,47815,0,0,0,1,1
77539,180,17393,21678,48180,0,0,0,1,1
77540,180,17396,22096,48180,0,0,0,1,1
77541,180,17397,21979;21986,48180,0,0,0,2,2
77542,180,17405,22158;22622,48180,0,0,0,2,2
77543,180,17407,22163,48180,0,0,0,1,1
77544,180,17408,22583,48180,0,0,0,1,1
77545,180,17410,22897;22980,48180,0,0,0,2,2
77546,180,17412,22703,48180,0,0,0,1,1
77547,180,17414,22840,48180,0,0,0,1,1
77548,180,17415,22862;23221,48180,0,0,0,2,2
77549,180,17417,22667;22935,48180,0,0,0,2,2
77550,180,17418,23072;23110,48180,0,0,0,2,2
77551,180,17419,23010;26838,48180,0,0,1,1,2
77552,180,17420,23089,48180,0,0,0,1,1
77553,180,17421,23758;24097,48180,0,0,1,1,2
77554,180,17422,23042;23267,48180,0,0,0,2,2
77555,180,17423,23640;23651,48180,0,0,0,2,2
77556,180,17424,22774;23325,48180,0,0,0,2,2
77557,180,17425,23964,48180,0,0,0,1,1
77558,180,17428,23233;23383,48180,0,0,0,2,2
77559,180,17430,23513;23723,48180,0,0,0,2,2
77560,180,17431,23246;23526,48180,0,0,0,2,2
77561,180,17432,23412;23879,48180,0,0,0,2,2
77562,180,17433,23168;23453,48180,0,0,0,2,2
77563,180,17434,23483;23916,48180,0,0,0,2,2
77564,180,17435,23434;23605;27747,48180,0,0,1,2,3
77565,180,17436,23520;23671,48180,0,0,0,2,2
77566,180,17437,23488;23522,48180,0,0,0,2,2
77567,180,17438,23529;23840,48180,0,0,0,2,2
77568,180,17439,23490;23536;27116;30054,48180,1,0,1,2,4
77569,180,17441,24012,48180,0,0,1,0,1
77570,180,17443,23418;23561,48180,0,0,0,2,2
77571,180,17444,23478,48180,0,0,0,1,1
77572,180,17445,23786,48180,0,0,0,1,1
77573,180,17446,23732;23883,48180,0,0,0,2,2
77574,180,17447,23604,48180,0,0,0,1,1
77575,180,17448,23368;23606,48180,0,0,0,2,2
77576,180,17449,23608;27296;28930;29720,48180,0,2,1,1,4
77577,180,17451,23638;23654;27299,48180,0,0,1,2,3
77578,180,17452,23371;23657,48180,0,0,0,2,2
77579,180,17453,23645;23658,48180,0,0,0,2,2
77580,180,17454,23660;23710,48180,0,0,0,2,2
77581,180,17455,23313;23670,48180,0,0,0,2,2
77582,180,17478,20669,48545,0,0,0,1,1
77583,180,17487,21993,48545,0,0,0,1,1
77584,180,17492,22808;26142;28900;29078;29405,48545,0,3,1,1,5
77585,180,17493,22597,48545,0,0,0,1,1
77586,180,17494,22340;22534,48545,0,0,0,2,2
77587,180,17495,22729;22746,48545,0,0,0,2,2
77588,180,17496,22565;22905,48545,0,0,0,2,2
77589,180,17499,22398;22959,48545,0,0,0,2,2
77590,180,17501,22685;22962,48545,0,0,0,2,2
77591,180,17503,22734,48545,0,0,0,1,1
77592,180,17505,23462,48545,0,0,0,1,1
77593,180,17506,22886,48545,0,0,0,1,1
77594,180,17507,22924,48545,0,0,0,1,1
77595,180,17509,22714;23024,48545,0,0,0,2,2
77596,180,17510,23046;23135,48545,0,0,0,2,2
77597,180,17511,23037;23048,48545,0,0,0,2,2
77598,180,17512,23052;23669;27126;29710;29802,48545,1,1,1,2,5
77599,180,17513,23090,48545,0,0,0,1,1
77600,180,17514,23063,48545,0,0,0,1,1
77601,180,17515,22692;23139,48545,0,0,0,2,2
77602,180,17516,23158,48545,0,0,0,1,1
77603,180,17517,23035;23191,48545,0,0,0,2,2
77604,180,17518,25899;26242;29248,48545,0,1,2,0,3
77605,180,17519,23607;23791,48545,0,0,0,2,2
77606,180,17520,23584;23631,48545,0,0,0,2,2
77607,180,17521,23382;23800,48545,0,0,0,2,2
77608,180,17522,23215;23392,48545,0,0,0,2,2
77609,180,17523,23554,48545,0,0,0,1,1
77610,180,17524,23485;26762;28676;29432;29537;29625;29869,48545,1,3,2,1,7
77611,180,17525,23069;23429,48545,0,0,0,2,2
77612,180,17526,23065,48545,0,0,0,1,1
77613,180,17527,23213;23473,48545,0,0,0,2,2
77614,180,17528,23815,48545,0,0,0,1,1
77615,180,17531,23525;23565,48545,0,0,0,2,2
77616,180,17532,23922;24053,48545,0,0,1,1,2
77617,180,17533,23626;23890,48545,0,0,0,2,2
77618,180,17534,23655;24018,48545,0,0,1,1,2
77619,180,17535,23886,48545,0,0,0,1,1
77620,180,17536,23686;24035,48545,0,0,1,1,2
77621,180,17538,23700;23829,48545,0,0,0,2,2
77622,180,17539,23549;23914,48545,0,0,0,2,2
77623,180,17541,23735;23967,48545,0,0,0,2,2
77624,180,17542,23804;24093,48545,0,0,1,1,2
77625,180,17546,20092,48910,0,0,0,1,1
77626,180,17569,21580,48910,0,0,0,1,1
77627,180,17573,21462,48910,0,0,0,1,1
77628,180,17582,22139,48910,0,0,0,1,1
77629,180,17586,22394,48910,0,0,0,1,1
77630,180,17589,22482;23101,48910,0,0,0,2,2
77631,180,17593,22447;22655,48910,0,0,0,2,2
77632,180,17595,22473;22763,48910,0,0,0,2,2
77633,180,17597,22917;23055,48910,0,0,0,2,2
77634,180,17600,23142;23391,48910,0,0,0,2,2
77635,180,17601,23185;23340,48910,0,0,0,2,2
77636,180,17602,22610;23051,48910,0,0,0,2,2
77637,180,17604,23546,48910,0,0,0,1,1
77638,180,17605,23099,48910,0,0,0,1,1
77639,180,17607,23234;23441,48910,0,0,0,2,2
77640,180,17608,23336,48910,0,0,0,1,1
77641,180,17609,23113;23273;27657,48910,0,0,1,2,3
77642,180,17610,23301;23480,48910,0,0,0,2,2
77643,180,17611,22955;23331,48910,0,0,0,2,2
77644,180,17612,23097;23343,48910,0,0,0,2,2
77645,180,17613,27843,48910,0,0,1,0,1
77646,180,17614,23240;23400,48910,0,0,0,2,2
77647,180,17615,23445;23579,48910,0,0,0,2,2
77648,180,17616,23465,48910,0,0,0,1,1
77649,180,17617,23682;23712,48910,0,0,0,2,2
77650,180,17619,23262;23574,48910,0,0,0,2,2
77651,180,17621,23917;24036,48910,0,0,1,1,2
77652,180,17622,23539;23600,48910,0,0,0,2,2
77653,180,17623,23830;27575,48910,0,0,1,1,2
77654,180,17624,23329;23617,48910,0,0,0,2,2
77655,180,17627,23295;23649,48910,0,0,0,2,2
77656,180,17628,23287;23652,48910,0,0,0,2,2
77657,180,17629,23179;23905,48910,0,0,0,2,2
77658,180,17630,23939;28137,48910,0,0,1,1,2
77659,180,17632,23643;23728,48910,0,0,0,2,2
77660,180,17635,23762;23814;26875,48910,0,0,1,2,3
77661,180,17636,23535;24015,48910,0,0,1,1,2
77662,180,17637,23801;26486,48910,0,0,1,1,2
77663,180,17638,23807;24000,48910,0,0,0,2,2
77664,180,17639,23828,48910,0,0,0,1,1
77665,180,17640,24029,48910,0,0,1,0,1
77666,180,17641,23662;23849,48910,0,0,0,2,2
77667,180,17643,23612;23933,48910,0,0,0,2,2
77668,180,17665,22026,49275,0,0,0,1,1
77669,180,17670,23200,49275,0,0,0,1,1
77670,180,17671,22430,49275,0,0,0,1,1
77671,180,17672,22368,49275,0,0,0,1,1
77672,180,17673,22116,49275,0,0,0,1,1
77673,180,17675,22632;22884,49275,0,0,0,2,2
77674,180,17676,22767;23230,49275,0,0,0,2,2
77675,180,17677,23091,49275,0,0,0,1,1
77676,180,17680,22946;23219,49275,0,0,0,2,2
77677,180,17681,23012,49275,0,0,0,1,1
77678,180,17683,23044,49275,0,0,0,1,1
77679,180,17685,22926;23120,49275,0,0,0,2,2
77680,180,17686,22663;22960,49275,0,0,0,2,2
77681,180,17687,22856,49275,0,0,0,1,1
77682,180,17689,23079;23365,49275,0,0,0,2,2
77683,180,17691,23404,49275,0,0,0,1,1
77684,180,17692,23389;23763,49275,0,0,0,2,2
77685,180,17694,23229;23423,49275,0,0,0,2,2
77686,180,17695,23474;23937,49275,0,0,0,2,2
77687,180,17696,23160;23511,49275,0,0,0,2,2
77688,180,17697,23106;23556,49275,0,0,0,2,2
77689,180,17699,23380,49275,0,0,0,1,1
77690,180,17700,23572;23779;26284;27135;29196;29294;29899;30137,49275,2,2,2,2,8
77691,180,17701,23575;23771,49275,0,0,0,2,2
77692,180,17702,23551;23587,49275,0,0,0,2,2
77693,180,17703,23698,49275,0,0,0,1,1
77694,180,17704,23847;23994,49275,0,0,0,2,2
77695,180,17705,23502,49275,0,0,0,1,1
77696,180,17706,23644;23666,49275,0,0,0,2,2
77697,180,17707,24092,49275,0,0,1,0,1
77698,180,17708,23798,49275,0,0,0,1,1
77699,180,17709,24026;24242;28418,49275,0,0,3,0,3
77700,180,17710,23694,49275,0,0,0,1,1
77701,180,17711,23665;23706,49275,0,0,0,2,2
77702,180,17712,23711;24064,49275,0,0,1,1,2
77703,180,17713,23919;24047,49275,0,0,1,1,2
77704,180,17714,23601;23727,49275,0,0,0,2,2
77705,180,17715,23341;23744,49275,0,0,0,2,2
77706,180,17716,23761;23766,49275,0,0,0,2,2
77707,180,17718,23747;23788;27212,49275,0,0,1,2,3
77708,180,17719,23826;23971,49275,0,0,0,2,2
77709,180,17720,23785;23899;27840,49275,0,0,1,2,3
77710,180,17721,23863;24276,49275,0,0,1,1,2
77711,180,17723,23489;23885,49275,0,0,0,2,2
77712,180,17724,23898;24151;27762,49275,0,0,2,1,3
77713,180,17726,23906;23974,49275,0,0,0,2,2
77714,180,17727,23431;23912,49275,0,0,0,2,2
77715,180,17728,23774;23928,49275,0,0,0,2,2
77716,180,17729,23309;23683,49275,0,0,0,2,2
77717,180,17730,23988;24038;28139;30094;30188,49275,2,0,2,1,5
77718,180,17741,20326,49640,0,0,0,1,1
77719,180,17754,21354,49640,0,0,0,1,1
77720,180,17756,21436;21803,49640,0,0,0,2,2
77721,180,17757,21018;25053;28774,49640,0,1,1,1,3
77722,180,17761,21773,49640,0,0,0,1,1
77723,180,17762,22333;22490,49640,0,0,0,2,2
77724,180,17765,22505;22857,49640,0,0,0,2,2
77725,180,17768,22749;23003,49640,0,0,0,2,2
77726,180,17769,22509,49640,0,0,0,1,1
77727,180,17771,22804;22898,49640,0,0,0,2,2
77728,180,17773,22974,49640,0,0,0,1,1
77729,180,17774,23347;27112,49640,0,0,1,1,2
77730,180,17775,23275;23419,49640,0,0,0,2,2
77731,180,17779,23399;26267,49640,0,0,1,1,2
77732,180,17780,23170;23245,49640,0,0,0,2,2
77733,180,17781,23410;23621,49640,0,0,0,2,2
77734,180,17782,23381;23646,49640,0,0,0,2,2
77735,180,17783,23087;23345,49640,0,0,0,2,2
77736,180,17785,23802,49640,0,0,0,1,1
77737,180,17786,23872,49640,0,0,0,1,1
77738,180,17788,23580;24135,49640,0,0,1,1,2
77739,180,17789,23367;23463,49640,0,0,0,2,2
77740,180,17792,23532;23701,49640,0,0,0,2,2
77741,180,17793,24080,49640,0,0,1,0,1
77742,180,17795,23921,49640,0,0,0,1,1
77743,180,17796,23408;23845,49640,0,0,0,2,2
77744,180,17797,23394;23835,49640,0,0,0,2,2
77745,180,17798,23653;23855;28039,49640,0,0,1,2,3
77746,180,17799,23860;23910,49640,0,0,0,2,2
77747,180,17800,23739;23900,49640,0,0,0,2,2
77748,180,17802,23778;23977,49640,0,0,0,2,2
77749,180,17803,24232,49640,0,0,1,0,1
77750,180,17804,23990;24033,49640,0,0,1,1,2
77751,180,17805,24017;28321,49640,0,0,2,0,2
77752,180,17807,24052;24291,49640,0,0,2,0,2
77753,180,17808,23790;24420;27501;29731;30159,49640,1,1,2,1,5
77754,180,17809,24063,49640,0,0,1,0,1
77755,180,17810,23915;24408,49640,0,0,1,1,2
77756,180,17811,24354;24503;27858,49640,0,0,3,0,3
77757,180,17830,21054;21270,50005,0,0,0,2,2
77758,180,17832,21972;22560,50005,0,0,0,2,2
77759,180,17842,21806,50005,0,0,0,1,1
77760,180,17843,22485,50005,0,0,0,1,1
77761,180,17851,22535;22802,50005,0,0,0,2,2
77762,180,17853,22700,50005,0,0,0,1,1
77763,180,17855,22975,50005,0,0,0,1,1
77764,180,17856,22364,50005,0,0,0,1,1
77765,180,17861,23114;23508,50005,0,0,0,2,2
77766,180,17862,23076;23116,50005,0,0,0,2,2
77767,180,17864,23197;23680;26770;29007,50005,0,1,1,2,4
77768,180,17865,23767;24073,50005,0,0,1,1,2
77769,180,17866,23560,50005,0,0,0,1,1
77770,180,17867,23257;23590;26089,50005,0,0,1,2,3
77771,180,17868,23471;26854,50005,0,0,1,1,2
77772,180,17869,23482;23746,50005,0,0,0,2,2
77773,180,17870,23492;27835,50005,0,0,1,1,2
77774,180,17871,23187;23510,50005,0,0,0,2,2
77775,180,17872,23108;23516,50005,0,0,0,2,2
77776,180,17874,24070;27058,50005,0,0,2,0,2
77777,180,17875,23564;23941,50005,0,0,0,2,2
77778,180,17876,23995;24069,50005,0,0,1,1,2
77779,180,17877,23675;23843,50005,0,0,0,2,2
77780,180,17878,23613;23876;27139,50005,0,0,1,2,3
77781,180,17879,23292;23457,50005,0,0,0,2,2
77782,180,17880,23627;23679;26769;28831,50005,0,1,1,2,4
77783,180,17882,23822;24025,50005,0,0,1,1,2
77784,180,17883,23797;24050;27670,50005,0,0,2,1,3
77785,180,17884,23689;23851;27752;29581,50005,0,1,1,2,4
77786,180,17885,23725;23867,50005,0,0,0,2,2
77787,180,17886,23909,50005,0,0,0,1,1
77788,180,17887,24105;24295,50005,0,0,2,0,2
77789,180,17888,23648;23931,50005,0,0,0,2,2
77790,180,17889,23677;24392,50005,0,0,1,1,2
77791,180,17890,23628;23950,50005,0,0,0,2,2
77792,180,17891,23986;24407;27685,50005,0,0,2,1,3
77793,180,17893,24041,50005,0,0,1,0,1
77794,180,17894,24048,50005,0,0,1,0,1
77795,180,17896,23697;24225,50005,0,0,1,1,2
77796,180,17897,24001;24273;28233,50005,0,0,2,1,3
77797,180,17899,23925;24077,50005,0,0,1,1,2
77798,180,17900,23737,50005,0,0,0,1,1
77799,180,17901,23703;24104,50005,0,0,1,1,2
77800,180,17903,24368;24432,50005,0,0,2,0,2
77801,180,17904,24144;24267;27069;27955,50005,0,0,4,0,4
77802,180,17905,24186;24215;27240;27327;29379,50005,0,1,4,0,5
77803,180,17906,24192;24200;26700,50005,0,0,3,0,3
77804,180,17922,21950,50370,0,0,0,1,1
77805,180,17930,21926,50370,0,0,0,1,1
77806,180,17931,21756;21876,50370,0,0,0,2,2
77807,180,17932,21470,50370,0,0,0,1,1
77808,180,17933,22077;22290,50370,0,0,0,2,2
77809,180,17934,22338,50370,0,0,0,1,1
77810,180,17935,22222;22735,50370,0,0,0,2,2
77811,180,17938,22931,50370,0,0,0,1,1
77812,180,17940,22166;22412,50370,0,0,0,2,2
77813,180,17942,22488;22806,50370,0,0,0,2,2
77814,180,17949,22988;26737,50370,0,0,1,1,2
77815,180,17950,23409,50370,0,0,0,1,1
77816,180,17952,23029;23036,50370,0,0,0,2,2
77817,180,17953,23577;23850;27836,50370,0,0,1,2,3
77818,180,17955,23569,50370,0,0,0,1,1
77819,180,17957,23231;23591;26863,50370,0,0,1,2,3
77820,180,17959,23308,50370,0,0,0,1,1
77821,180,17960,23970;24088,50370,0,0,1,1,2
77822,180,17961,23709;26092,50370,0,0,1,1,2
77823,180,17962,23795;27136;28840,50370,0,1,1,1,3
77824,180,17963,23818;23834;27389,50370,0,0,1,2,3
77825,180,17965,23387;23415,50370,0,0,0,2,2
77826,180,17966,23228;23454,50370,0,0,0,2,2
77827,180,17967,23437;23494,50370,0,0,0,2,2
77828,180,17968,23542;26573,50370,0,0,1,1,2
77829,180,17969,23993;24102,50370,0,0,1,1,2
77830,180,17971,23730;23979;26883,50370,0,0,1,2,3
77831,180,17973,23784;24302;27598;30000,50370,1,0,2,1,4
77832,180,17974,27482,50370,0,0,1,0,1
77833,180,17975,23397;23794,50370,0,0,0,2,2
77834,180,17976,23594;23806,50370,0,0,0,2,2
77835,180,17977,23704;23824,50370,0,0,0,2,2
77836,180,17978,23839;27390,50370,0,0,1,1,2
77837,180,17979,23693;23848,50370,0,0,0,2,2
77838,180,17980,23708,50370,0,0,0,1,1
77839,180,17981,23859;24305,50370,0,0,1,1,2
77840,180,17982,24214;24378,50370,0,0,2,0,2
77841,180,17983,23531;23887,50370,0,0,0,2,2
77842,180,17984,23897;24216,50370,0,0,1,1,2
77843,180,17985,23913;24045,50370,0,0,1,1,2
77844,180,17986,23923;23942,50370,0,0,0,2,2
77845,180,17987,24042;24296,50370,0,0,2,0,2
77846,180,17988,24228,50370,0,0,1,0,1
77847,180,17989,23985;24350,50370,0,0,1,1,2
77848,180,17990,23930,50370,0,0,0,1,1
77849,180,17991,23999;24173,50370,0,0,1,1,2
77850,180,17992,24010,50370,0,0,1,0,1
77851,180,17993,23719;24061,50370,0,0,1,1,2
77852,180,17994,24055;24278,50370,0,0,2,0,2
77853,180,17995,24085,50370,0,0,1,0,1
77854,180,17996,24224;24445,50370,0,0,2,0,2
77855,180,17997,24501,50370,0,0,1,0,1
77856,180,17999,24142,50370,0,0,1,0,1
77857,180,18000,24294;24401;27769,50370,0,0,3,0,3
77858,180,18001,24163;24349,50370,0,0,2,0,2
77859,180,18002,24385;27498,50370,0,0,2,0,2
77860,180,18003,24167;27674,50370,0,0,2,0,2
77861,180,18005,24197;24520;27775,50370,0,0,3,0,3
77862,180,18006,24266;24370,50370,0,0,2,0,2
77863,180,18007,23940;24367,50370,0,0,1,1,2
77864,180,18009,24289,50370,0,0,1,0,1
77865,180,18010,24202;24308,50370,0,0,2,0,2
77866,180,18011,24009;24313,50370,0,0,2,0,2
77867,180,18034,21316,50735,0,0,0,1,1
77868,180,18045,21226;21319,50735,0,0,0,2,2
77869,180,18049,22253;22314,50735,0,0,0,2,2
77870,180,18052,23433,50735,0,0,0,1,1
77871,180,18054,22443;22801;27185,50735,0,0,1,2,3
77872,180,18057,22968;23205,50735,0,0,0,2,2
77873,180,18059,23066;23619,50735,0,0,0,2,2
77874,180,18063,22639;23274,50735,0,0,0,2,2
77875,180,18064,23281;23338,50735,0,0,0,2,2
77876,180,18065,23634,50735,0,0,0,1,1
77877,180,18066,23425;23493,50735,0,0,0,2,2
77878,180,18067,23435;23476,50735,0,0,0,2,2
77879,180,18068,23460;27286,50735,0,0,1,1,2
77880,180,18069,23401;23630,50735,0,0,0,2,2
77881,180,18071,23468;23755,50735,0,0,0,2,2
77882,180,18073,24030,50735,0,0,1,0,1
77883,180,18074,24075;27845;29934,50735,1,0,2,0,3
77884,180,18075,24377;24509,50735,0,0,2,0,2
77885,180,18076,24411;24447,50735,0,0,2,0,2
77886,180,18080,24188;28043,50735,0,0,2,0,2
77887,180,18083,24126,50735,0,0,1,0,1
77888,180,18084,23891;24153,50735,0,0,1,1,2
77889,180,18086,23924;24248,50735,0,0,1,1,2
77890,180,18087,23927;23976,50735,0,0,0,2,2
77891,180,18088,23948;24293,50735,0,0,1,1,2
77892,180,18089,24526,50735,0,0,1,0,1
77893,180,18090,23963;27758,50735,0,0,1,1,2
77894,180,18091,23949;24051;27946,50735,0,0,2,1,3
77895,180,18092,24381,50735,0,0,1,0,1
77896,180,18094,23833,50735,0,0,0,1,1
77897,180,18095,24241,50735,0,0,1,0,1
77898,180,18097,24071;24157;26892,50735,0,0,3,0,3
77899,180,18098,24502,50735,0,0,1,0,1
77900,180,18099,23792;24281;27680;28143;30173,50735,1,0,3,1,5
77901,180,18101,24723;28680,50735,0,1,1,0,2
77902,180,18102,24031;24127,50735,0,0,2,0,2
77903,180,18103,23952,50735,0,0,0,1,1
77904,180,18104,24644,50735,0,0,1,0,1
77905,180,18105,24363;24609,50735,0,0,2,0,2
77906,180,18106,24103;27947,50735,0,0,2,0,2
77907,180,18107,24476;24539,50735,0,0,2,0,2
77908,180,18108,23944;24244,50735,0,0,1,1,2
77909,180,18109,24467;24717;28332,50735,0,0,3,0,3
77910,180,18110,24177,50735,0,0,1,0,1
77911,180,18111,24481;24597,50735,0,0,2,0,2
77912,180,18112,24458,50735,0,0,1,0,1
77913,180,18113,24724,50735,0,0,1,0,1
77914,180,18114,24523;24662,50735,0,0,2,0,2
77915,180,18115,24575;27694;28152;29927,50735,1,0,3,0,4
77916,180,18117,24040;24379,50735,0,0,2,0,2
77917,180,18118,24382;24743,50735,0,0,2,0,2
77918,180,18119,24409;27253;28235,50735,0,0,3,0,3
77919,180,18134,21057,51100,0,0,0,1,1
77920,180,18137,21224,51100,0,0,0,1,1
77921,180,18146,21683,51100,0,0,0,1,1
77922,180,18152,22014,51100,0,0,0,1,1
77923,180,18157,22483;22679,51100,0,0,0,2,2
77924,180,18159,22824;23134,51100,0,0,0,2,2
77925,180,18160,23175;23282,51100,0,0,0,2,2
77926,180,18161,22789;23140;26839,51100,0,0,1,2,3
77927,180,18164,22644;22888,51100,0,0,0,2,2
77928,180,18168,23395;23515,51100,0,0,0,2,2
77929,180,18169,23393;23998,51100,0,0,0,2,2
77930,180,18170,23461,51100,0,0,0,1,1
77931,180,18171,23421;23547,51100,0,0,0,2,2
77932,180,18173,23875;24006,51100,0,0,1,1,2
77933,180,18174,23582;23622,51100,0,0,0,2,2
77934,180,18176,23509;24005,51100,0,0,1,1,2
77935,180,18177,24178,51100,0,0,1,0,1
77936,180,18178,23566;23754;26685,51100,0,0,1,2,3
77937,180,18179,23593;23789;27663,51100,0,0,1,2,3
77938,180,18180,23831;24642,51100,0,0,1,1,2
77939,180,18181,23896;24150,51100,0,0,1,1,2
77940,180,18182,23326;23907,51100,0,0,0,2,2
77941,180,18183,24140;27407,51100,0,0,2,0,2
77942,180,18184,24037;24270,51100,0,0,2,0,2
77943,180,18185,23505;24008,51100,0,0,1,1,2
77944,180,18187,23978,51100,0,0,0,1,1
77945,180,18188,23983,51100,0,0,0,1,1
77946,180,18190,24021,51100,0,0,1,0,1
77947,180,18193,24180;24537,51100,0,0,2,0,2
77948,180,18194,24658;24788;27528,51100,0,0,3,0,3
77949,180,18196,24234;24316,51100,0,0,2,0,2
77950,180,18197,23932;24380,51100,0,0,1,1,2
77951,180,18199,24062;24521;28148,51100,0,0,3,0,3
77952,180,18200,24652;27871,51100,0,0,2,0,2
77953,180,18201,24475;24753;26991;27160,51100,0,0,4,0,4
77954,180,18202,23901;24628,51100,0,0,1,1,2
77955,180,18203,24404;28146,51100,0,0,2,0,2
77956,180,18204,24004;24425,51100,0,0,2,0,2
77957,180,18206,24117;24451,51100,0,0,2,0,2
77958,180,18207,24081;24482,51100,0,0,2,0,2
77959,180,18208,24416;24489,51100,0,0,2,0,2
77960,180,18209,23982;24491,51100,0,0,1,1,2
77961,180,18210,24694;24760,51100,0,0,2,0,2
77962,180,18211,24506;24640;27163,51100,0,0,3,0,3
77963,180,18212,24362;24721,51100,0,0,2,0,2
77964,180,18213,24511;24528,51100,0,0,2,0,2
77965,180,18226,21146,51465,0,0,0,1,1
77966,180,18229,21996,51465,0,0,0,1,1
77967,180,18233,21908,51465,0,0,0,1,1
77968,180,18235,21763;21862,51465,0,0,0,2,2
77969,180,18240,22641,51465,0,0,0,1,1
77970,180,18243,22938,51465,0,0,0,1,1
77971,180,18245,23000;23128,51465,0,0,0,2,2
77972,180,18249,22957;23162,51465,0,0,0,2,2
77973,180,18250,23176;23610,51465,0,0,0,2,2
77974,180,18251,23198,51465,0,0,0,1,1
77975,180,18252,22681,51465,0,0,0,1,1
77976,180,18253,23495,51465,0,0,0,1,1
77977,180,18254,23130;23300,51465,0,0,0,2,2
77978,180,18255,23444,51465,0,0,0,1,1
77979,180,18258,23285,51465,0,0,0,1,1
77980,180,18259,23438;23624,51465,0,0,0,2,2
77981,180,18260,23271;23447,51465,0,0,0,2,2
77982,180,18261,23455;23750,51465,0,0,0,2,2
77983,180,18262,23803;23870,51465,0,0,0,2,2
77984,180,18263,23799;24171,51465,0,0,1,1,2
77985,180,18264,23530;23685,51465,0,0,0,2,2
77986,180,18265,23599;23687,51465,0,0,0,2,2
77987,180,18267,23695;23733,51465,0,0,0,2,2
77988,180,18268,23956;24298;27757;29390;30178,51465,1,1,2,1,5
77989,180,18269,23776;24213,51465,0,0,1,1,2
77990,180,18270,24283;24395,51465,0,0,2,0,2
77991,180,18272,23836;24172,51465,0,0,1,1,2
77992,180,18273,23678;23866,51465,0,0,0,2,2
77993,180,18274,23878;24100,51465,0,0,1,1,2
77994,180,18275,23562;23752,51465,0,0,0,2,2
77995,180,18278,24624;24638,51465,0,0,2,0,2
77996,180,18279,24067;24114,51465,0,0,2,0,2
77997,180,18280,24120;24374;27159;29567,51465,0,1,3,0,4
77998,180,18281,24650;24815;28157,51465,0,0,3,0,3
77999,180,18282,24191,51465,0,0,1,0,1
78000,180,18283,24190,51465,0,0,1,0,1
78001,180,18284,24311;24541,51465,0,0,2,0,2
78002,180,18285,24108;24307,51465,0,0,2,0,2
78003,180,18286,24314;24581;28424,51465,0,0,3,0,3
78004,180,18287,24333;24400;27245,51465,0,0,3,0,3
78005,180,18288,24339,51465,0,0,1,0,1
78006,180,18289,24421;24545;28501,51465,0,0,3,0,3
78007,180,18291,24734;27526,51465,0,0,2,0,2
78008,180,18292,24446;24966,51465,0,0,2,0,2
78009,180,18293,24413;24950,51465,0,0,2,0,2
78010,180,18294,24436;24949;27357;27896;28844,51465,0,1,4,0,5
78011,180,18297,24277;24603;27973,51465,0,0,3,0,3
78012,180,18300,24369,51465,0,0,1,0,1
78013,180,18301,24612;28156,51465,0,0,2,0,2
78014,180,18302,24680;24857;28599,51465,0,0,3,0,3
78015,180,18303,24874;25027;27886,51465,0,0,3,0,3
78016,180,18304,24543;24758,51465,0,0,2,0,2
78017,180,18305,24510;26995;27693,51465,0,0,3,0,3
78018,180,18306,24571;24844;28167;29750,51465,0,1,3,0,4
78019,180,18307,24937;25169,51465,0,0,2,0,2
78020,180,18308,24693;28427,51465,0,0,2,0,2
78021,180,18311,20345,51830,0,0,0,1,1
78022,180,18321,21183,51830,0,0,0,1,1
78023,180,18332,22278,51830,0,0,0,1,1
78024,180,18333,22593,51830,0,0,0,1,1
78025,180,18334,22507;22683,51830,0,0,0,2,2
78026,180,18344,22470,51830,0,0,0,1,1
78027,180,18346,23164,51830,0,0,0,1,1
78028,180,18347,23504;23742,51830,0,0,0,2,2
78029,180,18349,23667,51830,0,0,0,1,1
78030,180,18354,23375,51830,0,0,0,1,1
78031,180,18355,23578;24022,51830,0,0,1,1,2
78032,180,18357,23629;23751,51830,0,0,0,2,2
78033,180,18359,23681;23936,51830,0,0,0,2,2
78034,180,18360,23809;28037,51830,0,0,1,1,2
78035,180,18362,23884;24065;27403;29990,51830,1,0,2,1,4
78036,180,18364,23947;24133,51830,0,0,1,1,2
78037,180,18365,23793,51830,0,0,0,1,1
78038,180,18366,23972,51830,0,0,0,1,1
78039,180,18368,23981;24604;28327,51830,0,0,2,1,3
78040,180,18370,24661;24883,51830,0,0,2,0,2
78041,180,18371,24115;24279;27059,51830,0,0,3,0,3
78042,180,18372,24131;24265,51830,0,0,2,0,2
78043,180,18373,24138,51830,0,0,1,0,1
78044,180,18374,23908;24139,51830,0,0,1,1,2
78045,180,18375,24203;24355,51830,0,0,2,0,2
78046,180,18376,24185;24306,51830,0,0,2,0,2
78047,180,18378,24147;24207,51830,0,0,2,0,2
78048,180,18379,24504;28422,51830,0,0,2,0,2
78049,180,18380,24290;24360,51830,0,0,2,0,2
78050,180,18381,24479,51830,0,0,1,0,1
78051,180,18382,24326;24583,51830,0,0,2,0,2
78052,180,18383,24389;24990;27991;28345,51830,0,0,4,0,4
78053,180,18384,24854;28071;28338,51830,0,0,3,0,3
78054,180,18385,24324;24424,51830,0,0,2,0,2
78055,180,18386,24690;24750,51830,0,0,2,0,2
78056,180,18388,23957;24534,51830,0,0,1,1,2
78057,180,18389,24414;24542,51830,0,0,2,0,2
78058,180,18391,24748,51830,0,0,1,0,1
78059,180,18392,24560;24886,51830,0,0,2,0,2
78060,180,18393,24711;27704;29302,51830,0,1,2,0,3
78061,180,18394,24497;24595,51830,0,0,2,0,2
78062,180,18395,24551;24602,51830,0,0,2,0,2
78063,180,18396,24867,51830,0,0,1,0,1
78064,180,18397,24646;24850;28070,51830,0,0,3,0,3
78065,180,18398,24322;24845,51830,0,0,2,0,2
78066,180,18399,24664,51830,0,0,1,0,1
78067,180,18401,24692;28426,51830,0,0,2,0,2
78068,180,18402,24116;24550,51830,0,0,2,0,2
78069,180,18404,24554;24745;27778;30008,51830,1,0,3,0,4
78070,180,18405,24969,51830,0,0,1,0,1
78071,180,18414,20763,52195,0,0,0,1,1
78072,180,18426,21440,52195,0,0,0,1,1
78073,180,18432,22153,52195,0,0,0,1,1
78074,180,18436,22586,52195,0,0,0,1,1
78075,180,18439,22984;23873,52195,0,0,0,2,2
78076,180,18440,23310,52195,0,0,0,1,1
78077,180,18441,23224,52195,0,0,0,1,1
78078,180,18442,23032,52195,0,0,0,1,1
78079,180,18443,23430;23602,52195,0,0,0,2,2
78080,180,18445,23469;23475,52195,0,0,0,2,2
78081,180,18447,23808;24312,52195,0,0,1,1,2
78082,180,18448,23118;23268,52195,0,0,0,2,2
78083,180,18449,23718;24187;27239,52195,0,0,2,1,3
78084,180,18452,23821;24364,52195,0,0,1,1,2
78085,180,18454,23864;24199,52195,0,0,1,1,2
78086,180,18455,23880;24060;27316;27588,52195,0,0,3,1,4
78087,180,18456,24251;28323,52195,0,0,2,0,2
78088,180,18457,23583,52195,0,0,0,1,1
78089,180,18458,23413;23934,52195,0,0,0,2,2
78090,180,18459,23961;24246;27491;27765,52195,0,0,3,1,4
78091,180,18460,23904;24372,52195,0,0,1,1,2
78092,180,18461,24039;24155;27847;28140,52195,0,0,4,0,4
78093,180,18462,24174;24393,52195,0,0,2,0,2
78094,180,18463,24175;24222,52195,0,0,2,0,2
78095,180,18464,24227;24388,52195,0,0,2,0,2
78096,180,18465,24243;24568,52195,0,0,2,0,2
78097,180,18467,24430;24573,52195,0,0,2,0,2
78098,180,18468,24299;24321;27957,52195,0,0,3,0,3
78099,180,18469,24184;24625,52195,0,0,2,0,2
78100,180,18470,24756;24978;28602,52195,0,0,3,0,3
78101,180,18471,24726;27982;28428;30098,52195,1,0,3,0,4
78102,180,18473,24356;24586,52195,0,0,2,0,2
78103,180,18474,24516;24784;27629,52195,0,0,3,0,3
78104,180,18475,23810;24527,52195,0,0,1,1,2
78105,180,18476,24535;25127,52195,0,0,2,0,2
78106,180,18477,24342;24552,52195,0,0,2,0,2
78107,180,18478,24473;24668,52195,0,0,2,0,2
78108,180,18479,24329;24585,52195,0,0,2,0,2
78109,180,18480,24466;24587,52195,0,0,2,0,2
78110,180,18481,24386;24594;28153,52195,0,0,3,0,3
78111,180,18484,24149;24722,52195,0,0,2,0,2
78112,180,18485,24702;27981,52195,0,0,2,0,2
78113,180,18486,24620;24961;29209,52195,0,1,2,0,3
78114,180,18487,24258;24630,52195,0,0,2,0,2
78115,180,18488,24639;24940,52195,0,0,2,0,2
78116,180,18490,24923;25075;28772,52195,0,1,2,0,3
78117,180,18491,25057;25148,52195,0,0,2,0,2
78118,180,18492,24859;28339,52195,0,0,2,0,2
78119,180,18493,24718;27875,52195,0,0,2,0,2
78120,180,18494,24728;28243,52195,0,0,2,0,2
78121,180,18496,24548;24736;28598,52195,0,0,3,0,3
78122,180,18497,24449;24757;27603;28334;30022,52195,1,0,4,0,5
78123,180,18498,24485;24747,52195,0,0,2,0,2
78124,180,18499,24765;24822,52195,0,0,2,0,2
78125,180,18500,24361;24771,52195,0,0,2,0,2
78126,180,18501,25101;25170;28352,52195,0,0,3,0,3
78127,180,18502,24657;25071,52195,0,0,2,0,2
78128,180,18503,24480;24829,52195,0,0,2,0,2
78129,180,18504,24418;25084,52195,0,0,2,0,2
78130,180,18505,25094;28933,52195,0,1,1,0,2
78131,180,18523,21859,52560,0,0,0,1,1
78132,180,18527,22711,52560,0,0,0,1,1
78133,180,18528,21671,52560,0,0,0,1,1
78134,180,18533,22251,52560,0,0,0,1,1
78135,180,18536,22696;22697,52560,0,0,0,2,2
78136,180,18540,23370,52560,0,0,0,1,1
78137,180,18542,23261,52560,0,0,0,1,1
78138,180,18543,23497;23611,52560,0,0,0,2,2
78139,180,18544,23589;23832,52560,0,0,0,2,2
78140,180,18547,24255,52560,0,0,1,0,1
78141,180,18549,24158,52560,0,0,1,0,1
78142,180,18550,24160;24334,52560,0,0,2,0,2
78143,180,18551,23702;24057,52560,0,0,1,1,2
78144,180,18554,23417;23871,52560,0,0,0,2,2
78145,180,18555,24198;24441,52560,0,0,2,0,2
78146,180,18556,24249;24840;28249,52560,0,0,3,0,3
78147,180,18557,24274;24741,52560,0,0,2,0,2
78148,180,18559,23773,52560,0,0,0,1,1
78149,180,18560,24320;24477,52560,0,0,2,0,2
78150,180,18561,24483;24906,52560,0,0,2,0,2
78151,180,18562,24078;24410,52560,0,0,2,0,2
78152,180,18563,24412;24708,52560,0,0,2,0,2
78153,180,18564,24275;24464,52560,0,0,2,0,2
78154,180,18565,24269;24870;27884,52560,0,0,3,0,3
78155,180,18566,24478;24557,52560,0,0,2,0,2
78156,180,18567,24538;24778,52560,0,0,2,0,2
78157,180,18568,24555;24907;27800;29027,52560,0,1,3,0,4
78158,180,18569,24572;24799,52560,0,0,2,0,2
78159,180,18570,24591;24681,52560,0,0,2,0,2
78160,180,18571,24519;24871;28168;28340,52560,0,0,4,0,4
78161,180,18572,24319;24606;28769,52560,0,1,2,0,3
78162,180,18573,24428;24863;28073;28682,52560,0,1,3,0,4
78163,180,18575,24986;28438,52560,0,0,2,0,2
78164,180,18576,24193;24532,52560,0,0,2,0,2
78165,180,18577,24740;24821;28244,52560,0,0,3,0,3
78166,180,18578,24789;25002,52560,0,0,2,0,2
78167,180,18579,24469;24794,52560,0,0,2,0,2
78168,180,18580,24798,52560,0,0,1,0,1
78169,180,18582,24762;24809;27631;28066;28165,52560,0,0,5,0,5
78170,180,18584,24831;25315;28695,52560,0,1,2,0,3
78171,180,18585,24667;24838;28432;28931,52560,0,1,3,0,4
78172,180,18586,24855,52560,0,0,1,0,1
78173,180,18587,24921;25144;29028,52560,0,1,2,0,3
78174,180,18589,24943;25276;28193,52560,0,0,3,0,3
78175,180,18590,24988;25192,52560,0,0,2,0,2
78176,180,18592,20649,52925,0,0,0,1,1
78177,180,18597,21397,52925,0,0,0,1,1
78178,180,18600,21103,52925,0,0,0,1,1
78179,180,18614,21799,52925,0,0,0,1,1
78180,180,18621,22787;23004,52925,0,0,0,2,2
78181,180,18627,22576;22920,52925,0,0,0,2,2
78182,180,18633,23378;23796,52925,0,0,0,2,2
78183,180,18635,23452;23524,52925,0,0,0,2,2
78184,180,18636,23820;24159,52925,0,0,1,1,2
78185,180,18637,23691,52925,0,0,0,1,1
78186,180,18639,23466;23852;27576;29469,52925,0,1,1,2,4
78187,180,18641,24271;24348,52925,0,0,2,0,2
78188,180,18642,24028;26885,52925,0,0,2,0,2
78189,180,18643,24665;24759,52925,0,0,2,0,2
78190,180,18644,23740;24391;28421,52925,0,0,2,1,3
78191,180,18645,23641;24098,52925,0,0,1,1,2
78192,180,18647,24161;24666,52925,0,0,2,0,2
78193,180,18648,23756;24176,52925,0,0,1,1,2
78194,180,18649,24169;24230,52925,0,0,2,0,2
78195,180,18650,24027;24390,52925,0,0,2,0,2
78196,180,18651,24965;28507,52925,0,0,2,0,2
78197,180,18652,24429;24598,52925,0,0,2,0,2
78198,180,18653,24704;26997,52925,0,0,2,0,2
78199,180,18655,24852;25159,52925,0,0,2,0,2
78200,180,18656,25226;28001;28355;28934,52925,0,1,3,0,4
78201,180,18657,24515;25018,52925,0,0,2,0,2
78202,180,18659,24525;27965,52925,0,0,2,0,2
78203,180,18660,24514;24533;28237;28596,52925,0,0,4,0,4
78204,180,18661,24565,52925,0,0,1,0,1
78205,180,18662,24317;24566;27616,52925,0,0,3,0,3
78206,180,18663,24576;27865,52925,0,0,2,0,2
78207,180,18664,24643;25099,52925,0,0,2,0,2
78208,180,18665,24439;24611,52925,0,0,2,0,2
78209,180,18667,24817;28248,52925,0,0,2,0,2
78210,180,18668,24636;24715,52925,0,0,2,0,2
78211,180,18669,24669,52925,0,0,1,0,1
78212,180,18671,24336;24700,52925,0,0,2,0,2
78213,180,18672,24739;24934,52925,0,0,2,0,2
78214,180,18674,24508;24713,52925,0,0,2,0,2
78215,180,18675,24769;24890;27633;29741,52925,0,1,3,0,4
78216,180,18676,24819;25112,52925,0,0,2,0,2
78217,180,18677,24684;24827,52925,0,0,2,0,2
78218,180,18678,24828;25013,52925,0,0,2,0,2
78219,180,18679,25146;25413,52925,0,0,2,0,2
78220,180,18680,24866;24929,52925,0,0,2,0,2
78221,180,18681,24851;24897;27882,52925,0,0,3,0,3
78222,180,18682,25122;25289;28194;29210,52925,0,1,3,0,4
78223,180,18683,25225;25427,52925,0,0,2,0,2
78224,180,18684,24970;25264,52925,0,0,2,0,2
78225,180,18685,25409;28272;28455;28529;28854,52925,0,1,4,0,5
78226,180,18686,24954;25137,52925,0,0,2,0,2
78227,180,18687,24556;24959,52925,0,0,2,0,2
78228,180,18688,24118;24688;27168,52925,0,0,3,0,3
78229,180,18689,25278,52925,0,0,1,0,1
78230,180,18691,24981;25070;28686,52925,0,1,2,0,3
78231,180,18693,25082;25304;28196;28360,52925,0,0,4,0,4
78232,180,18703,20879,53290,0,0,0,1,1
78233,180,18708,21705,53290,0,0,0,1,1
78234,180,18718,21884,53290,0,0,0,1,1
78235,180,18721,22673;23319,53290,0,0,0,2,2
78236,180,18727,23165,53290,0,0,0,1,1
78237,180,18733,23636;23696,53290,0,0,0,2,2
78238,180,18735,23865,53290,0,0,0,1,1
78239,180,18738,23664;23783,53290,0,0,0,2,2
78240,180,18741,23661;23749,53290,0,0,0,2,2
78241,180,18742,23869;23926;27842,53290,0,0,1,2,3
78242,180,18743,23781;24164;27848,53290,0,0,2,1,3
78243,180,18745,24034;24109,53290,0,0,2,0,2
78244,180,18746,24337;24719;28498,53290,0,0,3,0,3
78245,180,18747,24124;24304;26497,53290,0,0,3,0,3
78246,180,18748,24170;24182,53290,0,0,2,0,2
78247,180,18749,24849;28681,53290,0,1,1,0,2
78248,180,18750,23989;24238,53290,0,0,1,1,2
78249,180,18751,24332;24531,53290,0,0,2,0,2
78250,180,18752,24156;24226,53290,0,0,2,0,2
78251,180,18755,24433;24823;28431;30195,53290,1,0,3,0,4
78252,180,18756,24083;24457,53290,0,0,2,0,2
78253,180,18757,24462;24735,53290,0,0,2,0,2
78254,180,18759,24536;24761;27692;28597,53290,0,0,4,0,4
78255,180,18760,24359;24561;28325,53290,0,0,3,0,3
78256,180,18761,24780,53290,0,0,1,0,1
78257,180,18762,24577;24600;26916,53290,0,0,3,0,3
78258,180,18763,24635;24982,53290,0,0,2,0,2
78259,180,18764,24676;24796,53290,0,0,2,0,2
78260,180,18765,24493;24683;27978,53290,0,0,3,0,3
78261,180,18766,24257;24697,53290,0,0,2,0,2
78262,180,18767,24725;25365;28853;28938,53290,0,2,2,0,4
78263,180,18768,24733;25267;28937,53290,0,1,2,0,3
78264,180,18769,24338;24804,53290,0,0,2,0,2
78265,180,18770,24633;25183,53290,0,0,2,0,2
78266,180,18772,24800;27986;28430,53290,0,0,3,0,3
78267,180,18774,24818;28502,53290,0,0,2,0,2
78268,180,18776,24492;25038;27638;28348,53290,0,0,4,0,4
78269,180,18777,24837;25310,53290,0,0,2,0,2
78270,180,18778,24847;28250,53290,0,0,2,0,2
78271,180,18779,24812;25063,53290,0,0,2,0,2
78272,180,18780,24677;25319;27729;28615,53290,0,0,4,0,4
78273,180,18781,24928;27893,53290,0,0,2,0,2
78274,180,18782,24935;25124;28516;30099,53290,1,0,3,0,4
78275,180,18783,24770;24946;27895,53290,0,0,3,0,3
78276,180,18785,24689;24971;27897;29826,53290,1,0,3,0,4
78277,180,18786,25209;25451;28263,53290,0,0,3,0,3
78278,180,18787,24991;25060,53290,0,0,2,0,2
78279,180,18789,24825;25020,53290,0,0,2,0,2
78280,180,18790,24842;25090;27907,53290,0,0,3,0,3
78281,180,18791,25533,53290,0,0,1,0,1
78282,180,18792,24802;25109,53290,0,0,2,0,2
78283,180,18793,25114;25527,53290,0,0,2,0,2
78284,180,18794,25140;25303;28359,53290,0,0,3,0,3
78285,180,18796,24836;25120;28846,53290,0,1,2,0,3
78286,180,18797,25134;25454;28855,53290,0,1,2,0,3
78287,180,18798,25145;25512,53290,0,0,2,0,2
78288,180,18799,25519;25535;27924;28111;30093,53290,1,0,4,0,5
78289,180,18800,25160;25180;28091,53290,0,0,3,0,3
78290,180,18809,21435,53655,0,0,0,1,1
78291,180,18827,22508;22699,53655,0,0,0,2,2
78292,180,18830,23227;26457,53655,0,0,1,1,2
78293,180,18834,23714,53655,0,0,0,1,1
78294,180,18838,23764;24619;28425;30097,53655,1,0,2,1,4
78295,180,18839,23984;24194,53655,0,0,1,1,2
78296,180,18840,23946,53655,0,0,0,1,1
78297,180,18842,24371;24499;27247,53655,0,0,3,0,3
78298,180,18844,24358;24484,53655,0,0,2,0,2
78299,180,18845,24106;24179,53655,0,0,2,0,2
78300,180,18846,24623;27167;27976,53655,0,0,3,0,3
78301,180,18847,24712;25067,53655,0,0,2,0,2
78302,180,18848,24086;28322,53655,0,0,2,0,2
78303,180,18849,24357;27682,53655,0,0,2,0,2
78304,180,18850,24247;24284;27954,53655,0,0,3,0,3
78305,180,18854,24405,53655,0,0,1,0,1
78306,180,18855,24110;24219;27677,53655,0,0,3,0,3
78307,180,18856,24183;24427,53655,0,0,2,0,2
78308,180,18857,25001;28845,53655,0,1,1,0,2
78309,180,18859,24567;24653;28059,53655,0,0,3,0,3
78310,180,18860,24137;24601,53655,0,0,2,0,2
78311,180,18862,24376;24588,53655,0,0,2,0,2
78312,180,18863,24654;25265;28523,53655,0,0,3,0,3
78313,180,18864,24631;24942,53655,0,0,2,0,2
78314,180,18865,24707,53655,0,0,1,0,1
78315,180,18866,24613;24720,53655,0,0,2,0,2
78316,180,18867,24396;24732,53655,0,0,2,0,2
78317,180,18869,25025,53655,0,0,1,0,1
78318,180,18871,24403;24841;28166,53655,0,0,3,0,3
78319,180,18873,25216;25327,53655,0,0,2,0,2
78320,180,18874,24896;24975,53655,0,0,2,0,2
78321,180,18875,25117,53655,0,0,1,0,1
78322,180,18876,24590;25102,53655,0,0,2,0,2
78323,180,18878,24641;25051;27718,53655,0,0,3,0,3
78324,180,18879,25384;28368;28700,53655,0,1,2,0,3
78325,180,18880,24880;27888;28169,53655,0,0,3,0,3
78326,180,18881,24999,53655,0,0,1,0,1
78327,180,18882,25087;25258;27994,53655,0,0,3,0,3
78328,180,18883,24782;25428;28531,53655,0,0,3,0,3
78329,180,18884,25604;28385;29043,53655,0,1,2,0,3
78330,180,18885,24948;25316;27728;29744,53655,0,1,3,0,4
78331,180,18886,25270,53655,0,0,1,0,1
78332,180,18887,25347;25621;28549;29948,53655,1,0,3,0,4
78333,180,18888,25044;25186,53655,0,0,2,0,2
78334,180,18889,25043;25194;28185,53655,0,0,3,0,3
78335,180,18890,25138;25530,53655,0,0,2,0,2
78336,180,18891,25560;25580;28282;28625,53655,0,0,4,0,4
78337,180,18892,25417;25589;28547,53655,0,0,3,0,3
78338,180,18893,25430;25543;29132,53655,0,1,2,0,3
78339,180,18894,25111;25582;28544,53655,0,0,3,0,3
78340,180,18895,25295;27726,53655,0,0,2,0,2
78341,180,18896,25306;27727;28361;28777,53655,0,1,3,0,4
78342,180,18897,25439;25631,53655,0,0,2,0,2
78343,180,18898,25296;25568;28209;29393,53655,0,1,3,0,4
78344,180,18904,21383,54020,0,0,0,1,1
78345,180,18907,21838,54020,0,0,0,1,1
78346,180,18915,22353,54020,0,0,0,1,1
78347,180,18918,22690;22814,54020,0,0,0,2,2
78348,180,18921,22914,54020,0,0,0,1,1
78349,180,18922,22797;22876,54020,0,0,0,2,2
78350,180,18923,23022;23183,54020,0,0,0,2,2
78351,180,18927,24016;24154;26985,54020,0,0,3,0,3
78352,180,18930,23987;24208;27953,54020,0,0,2,1,3
78353,180,18933,24032;24287;28420,54020,0,0,3,0,3
78354,180,18935,24145;24331;28046,54020,0,0,3,0,3
78355,180,18937,24196;26203,54020,0,0,2,0,2
78356,180,18938,23717;24205;27851;29935,54020,1,0,2,1,4
78357,180,18939,24068;24330;28234,54020,0,0,3,0,3
78358,180,18940,24318;24618,54020,0,0,2,0,2
78359,180,18941,24236;24240;27329;29201;29569;29986,54020,1,2,3,0,6
78360,180,18943,24056;24286,54020,0,0,2,0,2
78361,180,18946,24011;24406,54020,0,0,2,0,2
78362,180,18947,24685;24768,54020,0,0,2,0,2
78363,180,18948,24423;24751;28333,54020,0,0,3,0,3
78364,180,18949,23857;24455,54020,0,0,1,1,2
78365,180,18950,24876;24914,54020,0,0,2,0,2
78366,180,18951,24486;24984,54020,0,0,2,0,2
78367,180,18953,24614;24622;27967;28150;30090,54020,1,0,4,0,5
78368,180,18954,24979,54020,0,0,1,0,1
78369,180,18955,24671;24787;28330,54020,0,0,3,0,3
78370,180,18956,24691;24875;28505,54020,0,0,3,0,3
78371,180,18957,24918;25008;28439,54020,0,0,3,0,3
78372,180,18958,24746;24772;27091;28335;29800;29897,54020,2,0,4,0,6
78373,180,18959,24584;24705;28242,54020,0,0,3,0,3
78374,180,18960,24500;24781,54020,0,0,2,0,2
78375,180,18961,24670;24797,54020,0,0,2,0,2
78376,180,18962,24808;24833,54020,0,0,2,0,2
78377,180,18963,25139;27543;29734;29921,54020,1,1,2,0,4
78378,180,18964,24887;25236;28265;28447;28935,54020,0,1,4,0,5
78379,180,18965,24947;24964;28685,54020,0,1,2,0,3
78380,180,18966,24977;25010;27449;28346;29992,54020,1,0,4,0,5
78381,180,18967,24894;25155;28181,54020,0,0,3,0,3
78382,180,18968,25372,54020,0,0,1,0,1
78383,180,18969,25612;25692;28285;29134,54020,0,1,3,0,4
78384,180,18970,24912;25059;28513,54020,0,0,3,0,3
78385,180,18971,25009;25062;28260;28510,54020,0,0,4,0,4
78386,180,18972,24544;25080,54020,0,0,2,0,2
78387,180,18973,25104;25190;28354;28609,54020,0,0,4,0,4
78388,180,18975,25149;25521,54020,0,0,2,0,2
78389,180,18976,25168;25188,54020,0,0,2,0,2
78390,180,18977,24983;25177;27804;28182;28444;30189,54020,1,0,5,0,6
78391,180,18978,24263;24872;28074,54020,0,0,3,0,3
78392,180,18980,24911,54020,0,0,1,0,1
78393,180,18981,25713;25726;28215;28950,54020,0,1,3,0,4
78394,180,18982,24775;25246;28189;28449,54020,0,0,4,0,4
78395,180,18983,25174;25242;27549;28521,54020,0,0,4,0,4
78396,180,18984,25275,54020,0,0,1,0,1
78397,180,18986,25218;25426,54020,0,0,2,0,2
78398,180,18987,25097;25321;29031,54020,0,1,2,0,3
78399,180,18988,24569;25322,54020,0,0,2,0,2
78400,180,18989,25445,54020,0,0,1,0,1
78401,180,18990,25515,54020,0,0,1,0,1
78402,180,18991,25487;28622;28703;29213,54020,0,2,2,0,4
78403,180,18992,25329;25555;28859,54020,0,1,2,0,3
78404,180,18993,25048;25330,54020,0,0,2,0,2
78405,180,18994,25207;25336;28526,54020,0,0,3,0,3
78406,180,18995,25261;25338,54020,0,0,2,0,2
78407,180,18996,25356,54020,0,0,1,0,1
78408,180,18997,25360;28697,54020,0,1,1,0,2
78409,180,18998,25220;25382;28610,54020,0,0,3,0,3
78410,180,18999,25221;25390,54020,0,0,2,0,2
78411,180,19000,25423;25670,54020,0,0,2,0,2
78412,180,19001,25400;25407;28369,54020,0,0,3,0,3
78413,180,19002,21144,54385,0,0,0,1,1
78414,180,19006,21672,54385,0,0,0,1,1
78415,180,19007,21819,54385,0,0,0,1,1
78416,180,19009,22221;22675,54385,0,0,0,2,2
78417,180,19019,23043,54385,0,0,0,1,1
78418,180,19030,23918;24394,54385,0,0,1,1,2
78419,180,19031,23966;24351,54385,0,0,1,1,2
78420,180,19041,24352;24365;28047,54385,0,0,3,0,3
78421,180,19043,24437;24608;28154;28328,54385,0,0,4,0,4
78422,180,19044,24239;24444,54385,0,0,2,0,2
78423,180,19045,24456;24563,54385,0,0,2,0,2
78424,180,19046,24335,54385,0,0,1,0,1
78425,180,19047,24490;24589,54385,0,0,2,0,2
78426,180,19052,24714;25205,54385,0,0,2,0,2
78427,180,19053,24777;25164,54385,0,0,2,0,2
78428,180,19054,24786;28771,54385,0,1,1,0,2
78429,180,19055,24926;28255;28436,54385,0,0,3,0,3
78430,180,19056,25012;25353;28852,54385,0,1,2,0,3
78431,180,19057,24826;27172;28770;29454;29648,54385,0,3,2,0,5
78432,180,19058,24860;27883;28253,54385,0,0,3,0,3
78433,180,19060,24868;25040,54385,0,0,2,0,2
78434,180,19062,24472;24919,54385,0,0,2,0,2
78435,180,19063,25302;25457;28702;28779;28856,54385,0,3,2,0,5
78436,180,19064,24963;25212,54385,0,0,2,0,2
78437,180,19065,24973;25230,54385,0,0,2,0,2
78438,180,19066,24945;25163;28608,54385,0,0,3,0,3
78439,180,19067,25328;25405;27810;28525;29211,54385,0,1,4,0,5
78440,180,19068,25021;25484;28945,54385,0,1,2,0,3
78441,180,19069,25249;28266,54385,0,0,2,0,2
78442,180,19070,25042;25131;28089,54385,0,0,3,0,3
78443,180,19071,25151;25606;27182;28863;29044,54385,0,2,3,0,5
78444,180,19072,24992;25156;28688,54385,0,1,2,0,3
78445,180,19073,25167,54385,0,0,1,0,1
78446,180,19074,24574;25215;28776,54385,0,1,2,0,3
78447,180,19075,24791;25411;28201;28530;28618;30019,54385,1,0,5,0,6
78448,180,19076,25532;28113;28624,54385,0,0,3,0,3
78449,180,19077,25538;28281;28858,54385,0,1,2,0,3
78450,180,19078,24834;25250;27806;28190;28357;29751,54385,0,1,5,0,6
78451,180,19079,25254;25499;28096;29943,54385,1,0,3,0,4
78452,180,19080,25433;25575;26521;28283;28708;29042,54385,0,2,4,0,6
78453,180,19081,25292;28195,54385,0,0,2,0,2
78454,180,19083,25796;25877;28717;28870,54385,0,2,2,0,4
78455,180,19084,24660;25299,54385,0,0,2,0,2
78456,180,19085,25108;25350;27813,54385,0,0,3,0,3
78457,180,19086,25377,54385,0,0,1,0,1
78458,180,19089,25046;25494;27819,54385,0,0,3,0,3
78459,180,19090,25655;28631,54385,0,0,2,0,2
78460,180,19091,25449;25649;28464;29946,54385,1,0,3,0,4
78461,180,19092,25467,54385,0,0,1,0,1
78462,180,19093,25234;25483,54385,0,0,2,0,2
78463,180,19095,25498;25714;28633;29048,54385,0,1,3,0,4
78464,180,19097,21903,54750,0,0,0,1,1
78465,180,19101,21822,54750,0,0,0,1,1
78466,180,19105,22272,54750,0,0,0,1,1
78467,180,19106,22404;22718,54750,0,0,0,2,2
78468,180,19114,23096;23521,54750,0,0,0,2,2
78469,180,19118,23337;23555,54750,0,0,0,2,2
78470,180,19120,23780,54750,0,0,0,1,1
78471,180,19124,24112,54750,0,0,1,0,1
78472,180,19127,24648,54750,0,0,1,0,1
78473,180,19128,24059;24341;27495,54750,0,0,3,0,3
78474,180,19129,24471,54750,0,0,1,0,1
78475,180,19130,24546,54750,0,0,1,0,1
78476,180,19131,25019;25142;27993,54750,0,0,3,0,3
78477,180,19133,25000,54750,0,0,1,0,1
78478,180,19134,24488;24994,54750,0,0,2,0,2
78479,180,19136,24435;25113,54750,0,0,2,0,2
78480,180,19137,24767;24858;27797,54750,0,0,3,0,3
78481,180,19138,24773;24941,54750,0,0,2,0,2
78482,180,19139,24801;24813;28164,54750,0,0,3,0,3
78483,180,19140,24460;24846;28503,54750,0,0,3,0,3
78484,180,19142,24922;25116,54750,0,0,2,0,2
78485,180,19144,24898;27891,54750,0,0,2,0,2
78486,180,19145,25471,54750,0,0,1,0,1
78487,180,19147,24980;25485;28276,54750,0,0,3,0,3
78488,180,19148,25086;28443;28515;28687,54750,0,1,3,0,4
78489,180,19149,25026;25029,54750,0,0,2,0,2
78490,180,19150,24792;28063;28429,54750,0,0,3,0,3
78491,180,19151,25436;25607;28212;28948,54750,0,1,3,0,4
78492,180,19152,25095;25633;28628,54750,0,0,3,0,3
78493,180,19154,25348;25551;27457;29916,54750,1,0,3,0,4
78494,180,19155,25152;25153;28847,54750,0,1,2,0,3
78495,180,19156,24995;25583,54750,0,0,2,0,2
78496,180,19157,25165;25641,54750,0,0,2,0,2
78497,180,19159,25331,54750,0,0,1,0,1
78498,180,19160,25245;25822;27827;28473;28559;28957;29050,54750,0,2,5,0,7
78499,180,19161,25751;26094;28714,54750,0,1,2,0,3
78500,180,19162,25284;28613,54750,0,0,2,0,2
78501,180,19164,25320,54750,0,0,1,0,1
78502,180,19165,25818;26128;28126;28956;29141;29220,54750,0,3,3,0,6
78503,180,19166,25425;25802;28871,54750,0,1,2,0,3
78504,180,19167,25252;25446,54750,0,0,2,0,2
78505,180,19168,25195;25567;28379;28461,54750,0,0,4,0,4
78506,180,19169,25481;25788;29219,54750,0,1,2,0,3
78507,180,19170,25490;25493,54750,0,0,2,0,2
78508,180,19171,25666;25752;27931;29754,54750,1,0,3,0,4
78509,180,19173,25525;25883;28877,54750,0,1,2,0,3
78510,180,19174,25745;25986;28635,54750,0,0,3,0,3
78511,180,19175,25547;25603;28115;29214,54750,0,1,3,0,4
78512,180,19176,25541;25557,54750,0,0,2,0,2
78513,180,19177,25559;28207;28459;28705,54750,0,1,3,0,4
78514,180,19178,25554;25591;28382,54750,0,0,3,0,3
78515,180,19179,25601;28211;28463,54750,0,0,3,0,3
78516,180,19180,25613;25897;28296;29144,54750,0,1,3,0,4
78517,180,19181,21273;21547,55115,0,0,0,2,2
78518,180,19183,21139,55115,0,0,0,1,1
78519,180,19186,20990,55115,0,0,0,1,1
78520,180,19191,21758,55115,0,0,0,1,1
78521,180,19194,21879,55115,0,0,0,1,1
78522,180,19195,22657,55115,0,0,0,1,1
78523,180,19196,22465,55115,0,0,0,1,1
78524,180,19197,22401,55115,0,0,0,1,1
78525,180,19201,23008,55115,0,0,0,1,1
78526,180,19206,23070;23305,55115,0,0,0,2,2
78527,180,19209,23192;23390,55115,0,0,0,2,2
78528,180,19210,23548,55115,0,0,0,1,1
78529,180,19216,23405;23757;28036,55115,0,0,1,2,3
78530,180,19219,23889;24253;28419,55115,0,0,2,1,3
78531,180,19220,24280,55115,0,0,1,0,1
78532,180,19221,23782;24123,55115,0,0,1,1,2
78533,180,19223,24709;24843;27532,55115,0,0,3,0,3
78534,180,19226,24325;24494;27608,55115,0,0,3,0,3
78535,180,19228,24223;24340;27856,55115,0,0,3,0,3
78536,180,19230,27780;29930,55115,1,0,1,0,2
78537,180,19233,24998;29130,55115,0,1,1,0,2
78538,180,19234,24107;24865,55115,0,0,2,0,2
78539,180,19235,24659;25036,55115,0,0,2,0,2
78540,180,19236,24687;28331,55115,0,0,2,0,2
78541,180,19237,24375;24547,55115,0,0,2,0,2
78542,180,19238,24873;25158;27094;28504,55115,0,0,4,0,4
78543,180,19239,25232;25298;28520,55115,0,0,3,0,3
78544,180,19240,24764;24795;27454;28087;28336;30016,55115,1,0,5,0,6
78545,180,19241,25078;28088;28606,55115,0,0,3,0,3
78546,180,19242,25162;28689,55115,0,1,1,0,2
78547,180,19243,24774;25394,55115,0,0,2,0,2
78548,180,19244,25523;25773;28715,55115,0,1,2,0,3
78549,180,19245,25233;28446,55115,0,0,2,0,2
78550,180,19246,25513;28537,55115,0,0,2,0,2
78551,180,19247,24932;25065;28350,55115,0,0,3,0,3
78552,180,19248,25172;25286;27918;28849,55115,0,1,3,0,4
78553,180,19249,25293;25355,55115,0,0,2,0,2
78554,180,19250,25712,55115,0,0,1,0,1
78555,180,19251,24592;25332;27921;29032;30012,55115,1,1,3,0,5
78556,180,19252,25125;25349,55115,0,0,2,0,2
78557,180,19253,25379;25640;28629;28710;28785;29394,55115,0,3,3,0,6
78558,180,19254,25227;25748;28636,55115,0,0,3,0,3
78559,180,19255,25510;25727;28392,55115,0,0,3,0,3
78560,180,19256,25815;25831,55115,0,0,2,0,2
78561,180,19257,25358;25511;28109;28536;29039,55115,0,1,4,0,5
78562,180,19259,25129;25422,55115,0,0,2,0,2
78563,180,19260,25595;25718;28391;28865,55115,0,1,3,0,4
78564,180,19261,25398;25444;28619;28942,55115,0,1,3,0,4
78565,180,19262,25450;25757;28778,55115,0,1,2,0,3
78566,180,19263,25455;25825;28128;29479,55115,0,1,3,0,4
78567,180,19264,25464;28532,55115,0,0,2,0,2
78568,180,19266,25469;25537,55115,0,0,2,0,2
78569,180,19267,25480;25531,55115,0,0,2,0,2
78570,180,19268,25930;25939;28400;28648;28798;29228,55115,0,2,4,0,6
78571,180,19270,25477;25917;28647;28880;28964,55115,0,2,3,0,5
78572,180,19271,25435;25518,55115,0,0,2,0,2
78573,180,19272,25553;25628;29753,55115,1,0,2,0,3
78574,180,19273,25529;25565;28541,55115,0,0,3,0,3
78575,180,19274,25314,55115,0,0,1,0,1
78576,180,19275,25505;25571;28542,55115,0,0,3,0,3
78577,180,19276,25614;25890;28568,55115,0,0,3,0,3
78578,180,19277,25617;25626;28627;28709,55115,0,1,3,0,4
78579,180,19278,25643;25876;28566;28726;29312,55115,0,2,3,0,5
78580,180,19279,25671;25786;29216,55115,0,1,2,0,3
78581,180,19280,25902,55115,0,0,1,0,1
78582,180,19281,25719;25769;28787;29395,55115,0,2,2,0,4
78583,180,19282,25723;25810;28557;28640;29669,55115,0,1,4,0,5
78584,180,19284,25886;26001;28567;28795,55115,0,1,3,0,4
78585,180,19286,21526,55480,0,0,0,1,1
78586,180,19287,21275;21686,55480,0,0,0,2,2
78587,180,19298,21432,55480,0,0,0,1,1
78588,180,19300,23223;23557,55480,0,0,0,2,2
78589,180,19304,22998,55480,0,0,0,1,1
78590,180,19308,23335,55480,0,0,0,1,1
78591,180,19311,23672,55480,0,0,0,1,1
78592,180,19317,24168;24301,55480,0,0,2,0,2
78593,180,19318,23975;24119,55480,0,0,1,1,2
78594,180,19321,24679,55480,0,0,1,0,1
78595,180,19322,24066,55480,0,0,1,0,1
78596,180,19325,24742;25313;27920;28269;29828,55480,1,0,4,0,5
78597,180,19327,24627;25373;28617,55480,0,0,3,0,3
78598,180,19331,24884;28683,55480,0,1,1,0,2
78599,180,19332,24766;25017,55480,0,0,2,0,2
78600,180,19334,24967;25290;27647;27919;28850,55480,0,1,4,0,5
78601,180,19336,25015;25161,55480,0,0,2,0,2
78602,180,19337,25031;25154,55480,0,0,2,0,2
78603,180,19338,25039;28191;28522;28693;28936,55480,0,2,3,0,5
78604,180,19341,25268;25516;28204;28278;28946,55480,0,1,4,0,5
78605,180,19342,25091;25578;28947,55480,0,1,2,0,3
78606,180,19343,25301;25474,55480,0,0,2,0,2
78607,180,19344,24939;25266;28611,55480,0,0,3,0,3
78608,180,19345,25279;25507,55480,0,0,2,0,2
78609,180,19346,25049;25323,55480,0,0,2,0,2
78610,180,19347,25179;25463;28621;28857,55480,0,1,3,0,4
78611,180,19348,25975;28226;28691;29231,55480,0,2,2,0,4
78612,180,19349,25381;25662;28786;29135,55480,0,2,2,0,4
78613,180,19350,25858,55480,0,0,1,0,1
78614,180,19351,25473;25618;28286,55480,0,0,3,0,3
78615,180,19352,25506;25684;28468,55480,0,0,3,0,3
78616,180,19353,25689;25716;29218,55480,0,1,2,0,3
78617,180,19354,25520;25846;28723;29225,55480,0,2,2,0,4
78618,180,19355,25544;26037;28481;29485,55480,0,1,3,0,4
78619,180,19356,25466;25562;28781;29041,55480,0,2,2,0,4
78620,180,19357,25570;26036;28735;28804;28891,55480,0,3,2,0,5
78621,180,19358,25981;29061;29149;29589,55480,0,3,1,0,4
78622,180,19359,25524;25759;28952,55480,0,1,2,0,3
78623,180,19360,25300;25741;28290,55480,0,0,3,0,3
78624,180,19361,25697;25755;28951,55480,0,1,2,0,3
78625,180,19362,25758;26016;28298,55480,0,0,3,0,3
78626,180,19363,25219;25761;28219;28637,55480,0,0,4,0,4
78627,180,19364,25645;25764;29476,55480,0,1,2,0,3
78628,180,19365,25768;25962;28131;29148,55480,0,1,3,0,4
78629,180,19366,26000;27831;28402;28889;29483;29746,55480,0,3,3,0,6
78630,180,19368,25795;26075;28806;29237,55480,0,2,2,0,4
78631,180,19375,21886,55845,0,0,0,1,1
78632,180,19379,22541;22702,55845,0,0,0,2,2
78633,180,19383,22128,55845,0,0,0,1,1
78634,180,19386,22836,55845,0,0,0,1,1
78635,180,19388,23316;23440,55845,0,0,0,2,2
78636,180,19389,23446,55845,0,0,0,1,1
78637,180,19390,23467;23720,55845,0,0,0,2,2
78638,180,19397,24233;24529,55845,0,0,2,0,2
78639,180,19398,24323;24417;27686,55845,0,0,3,0,3
78640,180,19401,24814;25066;28177;28441,55845,0,0,4,0,4
78641,180,19403,24141;24904;28077;28932,55845,0,1,3,0,4
78642,180,19405,24634;25540;28539,55845,0,0,3,0,3
78643,180,19409,24752;24958,55845,0,0,2,0,2
78644,180,19410,24513;24776;28161,55845,0,0,3,0,3
78645,180,19411,25181;25453;28203;28373;28620;28943;29037,55845,0,2,5,0,7
78646,180,19412,25128;25189,55845,0,0,2,0,2
78647,180,19413,25054;28604;30024,55845,1,0,2,0,3
78648,180,19414,24805;25514;28538;28623;30197,55845,1,0,4,0,5
78649,180,19418,25392;25717,55845,0,0,2,0,2
78650,180,19419,25412;25675,55845,0,0,2,0,2
78651,180,19420,25375;26005;28970;29150,55845,0,2,2,0,4
78652,180,19421,24930;28171;28343,55845,0,0,3,0,3
78653,180,19422,25335;28851,55845,0,1,1,0,2
78654,180,19423,25401;25608,55845,0,0,2,0,2
78655,180,19424,25376;25672,55845,0,0,2,0,2
78656,180,19425,25440;25579,55845,0,0,2,0,2
78657,180,19426,25171;25489;28535,55845,0,0,3,0,3
78658,180,19427,25243;25462;28944,55845,0,1,2,0,3
78659,180,19429,25596;28383,55845,0,0,2,0,2
78660,180,19431,25593;25665;28019,55845,0,0,3,0,3
78661,180,19433,25564;26138;27832;29665;30179,55845,1,1,3,0,5
78662,180,19434,25573;25634;28707,55845,0,1,2,0,3
78663,180,19435,25598;25920;28881;29145;29227,55845,0,3,2,0,5
78664,180,19436,25609;25813,55845,0,0,2,0,2
78665,180,19437,25778;29477,55845,0,1,1,0,2
78666,180,19438,25652;25762;28465,55845,0,0,3,0,3
78667,180,19440,25619;25680,55845,0,0,2,0,2
78668,180,19441,25585;25708;28864,55845,0,1,2,0,3
78669,180,19442,25740;26046;28892;29234;29486;29836;29949,55845,2,3,2,0,7
78670,180,19443,25442;25746;28867,55845,0,1,2,0,3
78671,180,19444,25777;26098;28406;29592,55845,0,1,3,0,4
78672,180,19445,25420;25783;27654;28868;29049,55845,0,2,3,0,5
78673,180,19446,25431;25833;28476;28561;28720;28872,55845,0,2,4,0,6
78674,180,19448,25729;25847;28121;28216,55845,0,0,4,0,4
78675,180,19449,25853;25882;28793;28876,55845,0,2,2,0,4
78676,180,19450,25859;26021;28480,55845,0,0,3,0,3
78677,180,19451,26040;26122;28741;28980;29158;29239;29320,55845,0,5,2,0,7
78678,180,19452,25794;25958;28731,55845,0,1,2,0,3
78679,180,19453,25866;28575;28978,55845,0,1,2,0,3
78680,180,19454,21587,56210,0,0,0,1,1
78681,180,19456,22040,56210,0,0,0,1,1
78682,180,19458,21984,56210,0,0,0,1,1
78683,180,19459,21992,56210,0,0,0,1,1
78684,180,19460,22006,56210,0,0,0,1,1
78685,180,19463,22151,56210,0,0,0,1,1
78686,180,19464,22167,56210,0,0,0,1,1
78687,180,19465,22213,56210,0,0,0,1,1
78688,180,19466,22313,56210,0,0,0,1,1
78689,180,19471,22463,56210,0,0,0,1,1
78690,180,19472,22291,56210,0,0,0,1,1
78691,180,19480,21923;22494,56210,0,0,0,2,2
78692,180,19482,23059;23153,56210,0,0,0,2,2
78693,180,19484,22860,56210,0,0,0,1,1
78694,180,19485,22865;23145,56210,0,0,0,2,2
78695,180,19494,24148;24450;28499,56210,0,0,3,0,3
78696,180,19496,24710,56210,0,0,1,0,1
78697,180,19499,24820,56210,0,0,1,0,1
78698,180,19502,24892;25364,56210,0,0,2,0,2
78699,180,19503,24925;25574;28543;28782,56210,0,1,3,0,4
78700,180,19504,24803;24957;28437,56210,0,0,3,0,3
78701,180,19505,24985;25032;27270;28773,56210,0,1,3,0,4
78702,180,19506,25683,56210,0,0,1,0,1
78703,180,19507,25061;28085;28261,56210,0,0,3,0,3
78704,180,19508,25371;25743;28866,56210,0,1,2,0,3
78705,180,19509,25093,56210,0,0,1,0,1
78706,180,19510,25096,56210,0,0,1,0,1
78707,180,19511,25397;25600;28384;28462,56210,0,0,4,0,4
78708,180,19512,25214;25343;28186;29667;30018,56210,1,1,3,0,5
78709,180,19513,25241;28188,56210,0,0,2,0,2
78710,180,19514,25318;25907;29313,56210,0,1,2,0,3
78711,180,19516,25366;25829;28958,56210,0,1,2,0,3
78712,180,19517,25491;28277,56210,0,0,2,0,2
78713,180,19518,25576;25879;28646;28961,56210,0,1,3,0,4
78714,180,19519,25326;25441;28701,56210,0,1,2,0,3
78715,180,19520,25502,56210,0,0,1,0,1
78716,180,19521,25656;25838;28551,56210,0,0,3,0,3
78717,180,19523,25418;25678;29217,56210,0,1,2,0,3
78718,180,19524,25679;26134;28655;29675,56210,0,1,3,0,4
78719,180,19525,25688;25836;29309,56210,0,1,2,0,3
78720,180,19526,25696;25819;28127;28789;29221,56210,0,2,3,0,5
78721,180,19527,25700,56210,0,0,1,0,1
78722,180,19529,25711;26018;28802;28890;29064;29151,56210,0,4,2,0,6
78723,180,19530,25744;26023,56210,0,0,2,0,2
78724,180,19531,25945;25996,56210,0,0,2,0,2
78725,180,19532,25849;28397;28477,56210,0,0,3,0,3
78726,180,19533,25827;26050;28893,56210,0,1,2,0,3
78727,180,19534,25685;25867;28874,56210,0,1,2,0,3
78728,180,19535,25857;25869;29480;29755,56210,1,1,2,0,4
78729,180,19536,25870,56210,0,0,1,0,1
78730,180,19538,25881;26182,56210,0,0,2,0,2
78731,180,19539,25509;25896;29057,56210,0,1,2,0,3
78732,180,19541,25915;26083;28652;28895;28973;29156,56210,0,3,3,0,6
78733,180,19542,25918;26027;28399;29059,56210,0,1,3,0,4
78734,180,19543,25922;26225;28903,56210,0,1,2,0,3
78735,180,19544,25932;26265;28136;28905;29250;29505,56210,0,3,3,0,6
78736,180,19546,25952;26199;28305;29498,56210,0,1,3,0,4
78737,180,19547,25782;25967;28027;28650;28884;29757,56210,1,1,4,0,6
78738,180,19548,25673;25980;28800,56210,0,1,2,0,3
78739,180,19550,25988;26273;28309;29414;29679;29843,56210,1,2,3,0,6
78740,180,19551,25909;25998;29397,56210,0,1,2,0,3
78741,180,19553,21752;22370,56575,0,0,0,2,2
78742,180,19556,21677,56575,0,0,0,1,1
78743,180,19557,21869,56575,0,0,0,1,1
78744,180,19559,21570,56575,0,0,0,1,1
78745,180,19562,22171,56575,0,0,0,1,1
78746,180,19564,22520,56575,0,0,0,1,1
78747,180,19566,22773,56575,0,0,0,1,1
78748,180,19567,22847;23005,56575,0,0,0,2,2
78749,180,19569,23150,56575,0,0,0,1,1
78750,180,19570,23362,56575,0,0,0,1,1
78751,180,19585,24442;24632,56575,0,0,2,0,2
78752,180,19587,24495,56575,0,0,1,0,1
78753,180,19590,24686;24701,56575,0,0,2,0,2
78754,180,19591,24869;25561;28460;28706;28860,56575,0,2,3,0,5
78755,180,19594,24936;25646;27824,56575,0,0,3,0,3
78756,180,19595,25213;25274;28612,56575,0,0,3,0,3
78757,180,19596,24610;24881;28075;28434;28506,56575,0,0,5,0,5
78758,180,19597,24549;24993,56575,0,0,2,0,2
78759,180,19599,25069,56575,0,0,1,0,1
78760,180,19600,25079;25658;28712,56575,0,1,2,0,3
78761,180,19603,25709;28469;28554;29306,56575,0,1,3,0,4
78762,180,19604,25248;25739,56575,0,0,2,0,2
78763,180,19606,25033;25363;27814,56575,0,0,3,0,3
78764,180,19607,25362;25429;28101;28366;28698;29034;29212;29749,56575,0,4,4,0,8
78765,180,19608,25410;25855;28398;29835,56575,1,0,3,0,4
78766,180,19609,25438;25482;29036,56575,0,1,2,0,3
78767,180,19610,25979;26091;28404;28976;29590,56575,0,2,3,0,5
78768,180,19611,25756;25839;28642,56575,0,0,3,0,3
78769,180,19612,25244,56575,0,0,1,0,1
78770,180,19613,25804,56575,0,0,1,0,1
78771,180,19614,25724;25914,56575,0,0,2,0,2
78772,180,19616,25581;26163;28657;29495,56575,0,1,3,0,4
78773,180,19618,25616;25694;29305,56575,0,1,2,0,3
78774,180,19619,26063;28805;29071,56575,0,2,1,0,3
78775,180,19620,25588;25629,56575,0,0,2,0,2
78776,180,19621,25638;26071;29236,56575,0,1,2,0,3
78777,180,19622,25644;26082;29155,56575,0,1,2,0,3
78778,180,19623,25550;25657;28376,56575,0,0,3,0,3
78779,180,19624,25750;25991,56575,0,0,2,0,2
78780,180,19625,25816;26047;28572;28737;29068;29400,56575,0,3,3,0,6
78781,180,19626,25817;25999;28401;28969;29063;29482,56575,0,3,3,0,6
78782,180,19627,25732;25893;28727;29585,56575,0,2,2,0,4
78783,180,19628,25956;26106,56575,0,0,2,0,2
78784,180,19629,26107;29674,56575,0,1,1,0,2
78785,180,19631,25854;25993;28733;28888,56575,0,2,2,0,4
78786,180,19632,25990;26048;29235,56575,0,1,2,0,3
78787,180,19633,25402;26061;27936;29070;29153;29401,56575,0,3,3,0,6
78788,180,19634,26017;26069;29072,56575,0,1,2,0,3
78789,180,19635,26188;26195;28812;29597;29839,56575,1,2,2,0,5
78790,180,19636,26087;26392;28403;28738;28807;28975;29837,56575,1,3,3,0,7
78791,180,19637,26256;26283;29413,56575,0,1,2,0,3
78792,180,19638,21847,56940,0,0,0,1,1
78793,180,19641,21743,56940,0,0,0,1,1
78794,180,19642,21638,56940,0,0,0,1,1
78795,180,19645,21598,56940,0,0,0,1,1
78796,180,19647,22201,56940,0,0,0,1,1
78797,180,19648,22383,56940,0,0,0,1,1
78798,180,19650,22943,56940,0,0,0,1,1
78799,180,19651,22063;22235,56940,0,0,0,2,2
78800,180,19652,22573,56940,0,0,0,1,1
78801,180,19653,22570,56940,0,0,0,1,1
78802,180,19654,22436,56940,0,0,0,1,1
78803,180,19656,23545,56940,0,0,0,1,1
78804,180,19657,22732;22782,56940,0,0,0,2,2
78805,180,19664,23882,56940,0,0,0,1,1
78806,180,19666,24387;24558;27084;28324;29447;29709;30192,56940,1,2,4,0,7
78807,180,19669,24673;25107;27719;28180,56940,0,0,4,0,4
78808,180,19673,24853;24996;28508,56940,0,0,3,0,3
78809,180,19675,25074;28442;28605,56940,0,0,3,0,3
78810,180,19678,25007;27269;28603,56940,0,0,3,0,3
78811,180,19679,24901;25206;28094;28690,56940,0,1,3,0,4
78812,180,19680,25058;25240;28448,56940,0,0,3,0,3
78813,180,19682,25182;28183,56940,0,0,2,0,2
78814,180,19683,24899;25187,56940,0,0,2,0,2
78815,180,19684,24783;25211;28000;28775;28848,56940,0,2,3,0,5
78816,180,19685,25262;25351,56940,0,0,2,0,2
78817,180,19686,25367;29033,56940,0,1,1,0,2
78818,180,19687,25414;25885;28794,56940,0,1,2,0,3
78819,180,19688,25749;25891;28962,56940,0,1,2,0,3
78820,180,19689,25374;25637;29584,56940,0,1,2,0,3
78821,180,19690,25602;25807;28394;28718,56940,0,1,3,0,4
78822,180,19691,25294;25653;28630;28711,56940,0,1,3,0,4
78823,180,19692,25636;25903;28879;28963,56940,0,2,2,0,4
78824,180,19693,25175;25486;28013,56940,0,0,3,0,3
78825,180,19694,25577;25747;29139,56940,0,1,2,0,3
78826,180,19695,25722;25738,56940,0,0,2,0,2
78827,180,19696,25204;25728,56940,0,0,2,0,2
78828,180,19697,25767,56940,0,0,1,0,1
78829,180,19698,25776;26179;28304;28747;29162,56940,0,2,3,0,5
78830,180,19699,25789;25928;28966;29146,56940,0,2,2,0,4
78831,180,19700,25779,56940,0,0,1,0,1
78832,180,19702,25841;25912;29052,56940,0,1,2,0,3
78833,180,19703,25842;25910;28721;28959,56940,0,2,2,0,4
78834,180,19704,25862,56940,0,0,1,0,1
78835,180,19705,25924;26064,56940,0,0,2,0,2
78836,180,19707,25925;26227;29082;29599,56940,0,2,2,0,4
78837,180,19708,25814;25933;29586;29670,56940,0,2,2,0,4
78838,180,19709,26127;30026,56940,1,0,1,0,2
78839,180,19710,26004;26410;28489;28664;28991;29604,56940,0,2,4,0,6
78840,180,19711,26007;26194,56940,0,0,2,0,2
78841,180,19712,25972;26028;29232,56940,0,1,2,0,3
78842,180,19713,26002;26034;29066;30102,56940,1,1,2,0,4
78843,180,19714,26102;28483;29076,56940,0,1,2,0,3
78844,180,19716,26400;26406;29764,56940,1,0,2,0,3
78845,180,19717,26070;26285;29252;30104,56940,1,1,2,0,4
78846,180,19718,25792;26101;28653;28739;28898;28977;29075,56940,0,4,3,0,7
78847,180,19719,26233;26381;28306;28409;28579;29328,56940,0,1,5,0,6
78848,180,19721,25850;26129;29310,56940,0,1,2,0,3
78849,180,19723,26144;29406;29493,56940,0,2,1,0,3
78850,180,19724,25677;26150;28573;29161,56940,0,1,3,0,4
78851,180,19726,26130;26171,56940,0,0,2,0,2
78852,180,19727,25960;26178;28746,56940,0,1,2,0,3
78853,180,19728,25959;26192;29497,56940,0,1,2,0,3
78854,180,19731,21550,57305,0,0,0,1,1
78855,180,19732,22207,57305,0,0,0,1,1
78856,180,19733,22265,57305,0,0,0,1,1
78857,180,19735,22262,57305,0,0,0,1,1
78858,180,19736,22360;22930,57305,0,0,0,2,2
78859,180,19739,22754,57305,0,0,0,1,1
78860,180,19740,22771;22780,57305,0,0,0,2,2
78861,180,19741,22855;23016,57305,0,0,0,2,2
78862,180,19742,22923,57305,0,0,0,1,1
78863,180,19756,23729;23741,57305,0,0,0,2,2
78864,180,19760,23286;23501,57305,0,0,0,2,2
78865,180,19767,24731;24917,57305,0,0,2,0,2
78866,180,19769,24785;24862;28247,57305,0,0,3,0,3
78867,180,19770,24645;25052;28176;28512;30023,57305,1,0,4,0,5
78868,180,19771,24744;25147;28517,57305,0,0,3,0,3
78869,180,19772,25461;25539;28275,57305,0,0,3,0,3
78870,180,19773,25197;25386;27923;28102;28454;28940,57305,0,1,5,0,6
78871,180,19774,25222;25458,57305,0,0,2,0,2
78872,180,19776,25247;25587;28381;28546;28862,57305,0,1,4,0,5
78873,180,19777,25037;25346;28696,57305,0,1,2,0,3
78874,180,19779,25648;25812;28472;28558;29478,57305,0,1,4,0,5
78875,180,19783,25615;25623;28783;29304,57305,0,2,2,0,4
78876,180,19784,25478;25632;28387;29046,57305,0,1,3,0,4
78877,180,19785,25664;25695;28287;29215,57305,0,1,3,0,4
78878,180,19786,25308;25715,57305,0,0,2,0,2
78879,180,19787,25357;25781;28953,57305,0,1,2,0,3
78880,180,19788,25681;25733;28289;28634;28788,57305,0,1,4,0,5
78881,180,19790,25763;25803;29140,57305,0,1,2,0,3
78882,180,19791,25811;25845;28722;29224,57305,0,2,2,0,4
78883,180,19792,25852;25997,57305,0,0,2,0,2
78884,180,19793,25840;25861;28024;28564;28792,57305,0,1,4,0,5
78885,180,19794,25929;28797;28967,57305,0,2,1,0,3
78886,180,19795,25590;25892;28878;29056,57305,0,2,2,0,4
78887,180,19796,25911;26183;29323,57305,0,1,2,0,3
78888,180,19797,25919;26278;29168;29844,57305,1,1,2,0,4
78889,180,19798,25948;26085;28974;29402,57305,0,2,2,0,4
78890,180,19799,25950;26280,57305,0,0,2,0,2
78891,180,19800,25989,57305,0,0,1,0,1
78892,180,19801,26095;28810;29591,57305,0,2,1,0,3
78893,180,19802,25874;26032;28972,57305,0,1,2,0,3
78894,180,19803,25969;26264;28308;29761,57305,1,0,3,0,4
78895,180,19804,26019;26073;28971;29484,57305,0,2,2,0,4
78896,180,19805,26065;26249;28302;29488,57305,0,1,3,0,4
78897,180,19806,26388;28580;28756;28818,57305,0,2,2,0,4
78898,180,19807,26160;26676,57305,0,0,2,0,2
78899,180,19808,26186;26312;28986,57305,0,1,2,0,3
78900,180,19809,26187;26417;28581;29513,57305,0,1,3,0,4
78901,180,19810,26156;26197;28029;29595,57305,0,1,3,0,4
78902,180,19811,26211;26279;29499,57305,0,1,2,0,3
78903,180,19812,26228;28659,57305,0,0,2,0,2
78904,180,19813,26235;29410;29503,57305,0,2,1,0,3
78905,180,19814,26025;26239;28660;29084;30103,57305,1,1,3,0,5
78906,180,19815,26536;26599;29423,57305,0,1,2,0,3
78907,180,19816,26118;26571,57305,0,0,2,0,2
78908,180,19818,22185,57670,0,0,0,1,1
78909,180,19819,22234,57670,0,0,0,1,1
78910,180,19821,22559,57670,0,0,0,1,1
78911,180,19824,22439;22510,57670,0,0,0,2,2
78912,180,19825,22604,57670,0,0,0,1,1
78913,180,19830,23155,57670,0,0,0,1,1
78914,180,19832,22951,57670,0,0,0,1,1
78915,180,19834,23363,57670,0,0,0,1,1
78916,180,19837,23406;23581,57670,0,0,0,2,2
78917,180,19840,23819;24129,57670,0,0,1,1,2
78918,180,19842,23861,57670,0,0,0,1,1
78919,180,19844,24596,57670,0,0,1,0,1
78920,180,19852,24607;24913,57670,0,0,2,0,2
78921,180,19858,24807;25406,57670,0,0,2,0,2
78922,180,19859,25003;25176,57670,0,0,2,0,2
78923,180,19860,25133;25235,57670,0,0,2,0,2
78924,180,19861,25702,57670,0,0,1,0,1
78925,180,19865,25263,57670,0,0,1,0,1
78926,180,19866,25334;25552;27820,57670,0,0,3,0,3
78927,180,19867,25404;25416,57670,0,0,2,0,2
78928,180,19868,25432;25528;28202;28941,57670,0,1,3,0,4
78929,180,19869,25196;25456;28011;28458,57670,0,0,4,0,4
78930,180,19871,25650,57670,0,0,1,0,1
78931,180,19872,25345;25622;27281;29045,57670,0,1,3,0,4
78932,180,19873,25447;25625;27928;28784;28949,57670,0,2,3,0,5
78933,180,19874,25660;26152;29322;29951,57670,1,1,2,0,4
78934,180,19875,25661;26275;29508,57670,0,1,2,0,3
78935,180,19876,25705;25923;28569;28796,57670,0,1,3,0,4
78936,180,19878,25753;25942;28649;29229,57670,0,1,3,0,4
78937,180,19879,25937;26377;29587,57670,0,1,2,0,3
78938,180,19880,25399;25775,57670,0,0,2,0,2
78939,180,19881,25594;25791;28716;28869,57670,0,2,2,0,4
78940,180,19883,25354;25720,57670,0,0,2,0,2
78941,180,19884,26010;26096;29157;29491,57670,0,2,2,0,4
78942,180,19886,25968;26274;29251,57670,0,1,2,0,3
78943,180,19887,25888;25949;28882;29314,57670,0,2,2,0,4
78944,180,19888,25953;26153;28981;29079,57670,0,2,2,0,4
78945,180,19889,26045;26117;29319;29404;29593,57670,0,3,2,0,5
78946,180,19890,26104,57670,0,0,1,0,1
78947,180,19891,26157;27745;28743;28901,57670,0,2,2,0,4
78948,180,19892,26132;26133;28229;28899;29159;29838,57670,1,2,3,0,6
78949,180,19893,25970;26136;28732;28885,57670,0,2,2,0,4
78950,180,19894,26131;26162,57670,0,0,2,0,2
78951,180,19895,26602;26869;28313;28666;28993;29012;29874,57670,1,2,4,0,7
78952,180,19896,26208;26394;28658,57670,0,0,3,0,3
78953,180,19897,25737;25806;28555;28639;28955,57670,0,1,4,0,5
78954,180,19898,26247;26268,57670,0,0,2,0,2
78955,180,19899,26251;26395,57670,0,0,2,0,2
78956,180,19900,26253;26477;29412,57670,0,1,2,0,3
78957,180,19901,26711,57670,0,0,1,0,1
78958,180,19902,26258;26561;28317;28997;29265;29420;30031,57670,1,3,3,0,7
78959,180,19903,26248;26528;29517;30105,57670,1,1,2,0,4
78960,180,19904,25944;26291;28906;29762,57670,1,1,2,0,4
78961,180,19905,26631;29857,57670,1,0,1,0,2
78962,180,19906,26600;26610;29685;29771,57670,1,1,2,0,4
78963,180,19907,26309;26335,57670,0,0,2,0,2
78964,180,19908,26366;26407;28758,57670,0,1,2,0,3
78965,180,19909,26667;29528;29619,57670,0,2,1,0,3
78966,180,19910,26257;26589;29268;29770,57670,1,1,2,0,4
78967,180,19911,26411;26431;28414,57670,0,0,3,0,3
78968,180,19914,21840,58035,0,0,0,1,1
78969,180,19915,22220;22798,58035,0,0,0,2,2
78970,180,19919,22515,58035,0,0,0,1,1
78971,180,19921,22621,58035,0,0,0,1,1
78972,180,19923,22990,58035,0,0,0,1,1
78973,180,19933,23538,58035,0,0,0,1,1
78974,180,19937,24397,58035,0,0,1,0,1
78975,180,19939,23811,58035,0,0,0,1,1
78976,180,19942,24434;25006;27716,58035,0,0,3,0,3
78977,180,19943,25023,58035,0,0,1,0,1
78978,180,19944,24076,58035,0,0,1,0,1
78979,180,19945,24507;24517;28236,58035,0,0,3,0,3
78980,180,19948,24656,58035,0,0,1,0,1
78981,180,19951,25064,58035,0,0,1,0,1
78982,180,19953,25132;25419;28370,58035,0,0,3,0,3
78983,180,19955,25199;25253;28692,58035,0,1,2,0,3
78984,180,19956,25359;25834;28641;28791;29223,58035,0,2,3,0,5
78985,180,19958,25105;25424,58035,0,0,2,0,2
78986,180,19959,25291;25434;27725;28614,58035,0,0,4,0,4
78987,180,19960,25103;25470;28533;29038,58035,0,1,3,0,4
78988,180,19961,25856;26039;28651;29673;29759,58035,1,1,3,0,5
78989,180,19963,25546;25682;28780;29668,58035,0,2,2,0,4
78990,180,19965,25157;25287;29030,58035,0,1,2,0,3
78991,180,19966,25610;28985,58035,0,1,1,0,2
78992,180,19967,25927;26148;29240;29321;29594,58035,0,3,2,0,5
78993,180,19968,25522;25955;27742;28883;29207;29671;29823,58035,1,3,3,0,7
78994,180,19969,25361;25784;28954,58035,0,1,2,0,3
78995,180,19971,26236;26879;30121,58035,1,0,2,0,3
78996,180,19972,25754;25835;28222;28396;28562,58035,0,0,5,0,5
78997,180,19973,25837;26286;29087;29330,58035,0,2,2,0,4
78998,180,19975,25437;25880;27829;28225;29055,58035,0,1,4,0,5
78999,180,19976,25647;25983;28886,58035,0,1,2,0,3
79000,180,19977,25941;26143;29492,58035,0,1,2,0,3
79001,180,19978,25951;28799;29230;29396,58035,0,3,1,0,4
79002,180,19979,25961;26290;29169;29253,58035,0,2,2,0,4
79003,180,19980,25703;28553;29137,58035,0,1,2,0,3
79004,180,19982,26220;26314;28908;29089;29255,58035,0,3,2,0,5
79005,180,19983,26078;26341;28910;29090,58035,0,2,2,0,4
79006,180,19984,26112;26519;28671;29609,58035,0,1,3,0,4
79007,180,19985,26121;26175,58035,0,0,2,0,2
79008,180,19986,26538;28417;29101;29518,58035,0,2,2,0,4
79009,180,19987,26177;26331;29418;29846,58035,1,1,2,0,4
79010,180,19988,26103;28654;29077,58035,0,1,2,0,3
79011,180,19989,26215;26282;29501,58035,0,1,2,0,3
79012,180,19990,25965;26260;28486,58035,0,0,3,0,3
79013,180,19991,26263;26750;29355;29431;29782;29960,58035,2,2,2,0,6
79014,180,19992,25889;26269;28750;29506,58035,0,2,2,0,4
79015,180,19993,26717;28592;28762;29533;29690,58035,0,3,2,0,5
79016,180,19994,26288;26485;28315;29515,58035,0,1,3,0,4
79017,180,19995,26292;26334;29170,58035,0,1,2,0,3
79018,180,19996,26084;26307;29334,58035,0,1,2,0,3
79019,180,19998,26191;26330,58035,0,0,2,0,2
79020,180,19999,26313;26508;28586;29344;29516,58035,0,2,3,0,5
79021,180,20000,26356;26375;29091;29257,58035,0,2,2,0,4
79022,180,20001,26367;26397;28757;29848,58035,1,1,2,0,4
79023,180,20002,26416;26702;29778,58035,1,0,2,0,3
79024,180,20003,26299;26422,58035,0,0,2,0,2
79025,180,20004,26625;26781;29961,58035,1,0,2,0,3
79026,180,20005,26352;28987,58035,0,1,1,0,2
79027,180,20006,26448;26459,58035,0,0,2,0,2
79028,180,20007,26219;26565;28823;29103;29523;30032,58035,1,3,2,0,6
79029,180,20008,26049;26479;28821;29605,58035,0,2,2,0,4
79030,180,20009,26423;26493;29849;29956,58035,2,0,2,0,4
79031,180,20010,22845,58400,0,0,0,1,1
79032,180,20012,22635;23239,58400,0,0,0,2,2
79033,180,20014,22457,58400,0,0,0,1,1
79034,180,20015,22919,58400,0,0,0,1,1
79035,180,20017,22631,58400,0,0,0,1,1
79036,180,20023,23317,58400,0,0,0,1,1
79037,180,20024,23692,58400,0,0,0,1,1
79038,180,20025,23081;23121,58400,0,0,0,2,2
79039,180,20033,24452,58400,0,0,1,0,1
79040,180,20039,24649;25136,58400,0,0,2,0,2
79041,180,20040,25256;25269,58400,0,0,2,0,2
79042,180,20041,24695;25077;28514,58400,0,0,3,0,3
79043,180,20042,25092;25280,58400,0,0,2,0,2
79044,180,20044,25630,58400,0,0,1,0,1
79045,180,20045,25342;25389;28527,58400,0,0,3,0,3
79046,180,20047,25202,58400,0,0,1,0,1
79047,180,20051,25526;25808;28556;30100,58400,1,0,3,0,4
79048,180,20052,25548;26024;28028;29065,58400,0,1,3,0,4
79049,180,20053,25089;25592;29133,58400,0,1,2,0,3
79050,180,20054,25639;26189,58400,0,0,2,0,2
79051,180,20055,25201;25721;29475,58400,0,1,2,0,3
79052,180,20056,25895;26408;28759;29682,58400,0,2,2,0,4
79053,180,20059,25926;26035;28729;28965;29060,58400,0,3,2,0,5
79054,180,20060,26055;26155,58400,0,0,2,0,2
79055,180,20061,26074;26435;29094,58400,0,1,2,0,3
79056,180,20062,26158;29676,58400,0,1,1,0,2
79057,180,20063,26090;28574;28896,58400,0,1,2,0,3
79058,180,20064,26119;26376;28231,58400,0,0,3,0,3
79059,180,20065,26167;26193;29243;30027,58400,1,1,2,0,4
79060,180,20066,25995;26467;28314;28492,58400,0,0,4,0,4
79061,180,20067,25931;26190;28902;29080;29324,58400,0,3,2,0,5
79062,180,20068,26009;26202;29316;29672,58400,0,2,2,0,4
79063,180,20069,26421;26575;28998;29524,58400,0,2,2,0,4
79064,180,20070,26300;28751;29332,58400,0,2,1,0,3
79065,180,20071,26646;30107,58400,1,0,1,0,2
79066,180,20072,26349;26495;29097;29850,58400,1,1,2,0,4
79067,180,20073,26066;26345;29681,58400,0,1,2,0,3
79068,180,20074,26363;26634;29774,58400,1,0,2,0,3
79069,180,20075,26691;29428;29529,58400,0,2,1,0,3
79070,180,20076,26380;26731;29006;29108;29274;29622;29867;30036,58400,2,4,2,0,8
79071,180,20077,26740;29185,58400,0,1,1,0,2
79072,180,20078,26399;26708;29106,58400,0,1,2,0,3
79073,180,20079,26541;26672;28995;29264,58400,0,2,2,0,4
79074,180,20080,26404;26518;29099;30029,58400,1,1,2,0,4
79075,180,20081,26794;26803,58400,0,0,2,0,2
79076,180,20082,26358;26469;28413,58400,0,0,3,0,3
79077,180,20083,26484;26492;28914;29343;29514;29607,58400,0,4,2,0,6
79078,180,20084,26505;26514;28670,58400,0,0,3,0,3
79079,180,20085,26515;26812;29281,58400,0,1,2,0,3
79080,180,20086,26776;28832;28921;29629,58400,0,3,1,0,4
79081,180,20087,26546;26780;29009;29110;29538;29694,58400,0,4,2,0,6
79082,180,20088,26076;26551;29613,58400,0,1,2,0,3
79083,180,20089,26552;26761;29276;30038,58400,1,1,2,0,4
79084,180,20090,26653;28318;29179;29617,58400,0,2,2,0,4
79085,180,20091,26784;29111,58400,0,1,1,0,2
79086,180,20093,22629;22874,58765,0,0,0,2,2
79087,180,20095,22653,58765,0,0,0,1,1
79088,180,20098,22707;23137,58765,0,0,0,2,2
79089,180,20100,22964,58765,0,0,0,1,1
79090,180,20103,22997;23351,58765,0,0,0,2,2
79091,180,20104,23456;23637,58765,0,0,0,2,2
79092,180,20105,23078;23216,58765,0,0,0,2,2
79093,180,20106,23507;23519,58765,0,0,0,2,2
79094,180,20108,23568,58765,0,0,0,1,1
79095,180,20115,23838;24282,58765,0,0,1,1,2
79096,180,20118,24811,58765,0,0,1,0,1
79097,180,20120,24839;27987;28067;30091,58765,1,0,3,0,4
79098,180,20126,25224;25687;28552,58765,0,0,3,0,3
79099,180,20130,25119;25611;28548,58765,0,0,3,0,3
79100,180,20131,25344;25403;28528,58765,0,0,3,0,3
79101,180,20135,25141;25217,58765,0,0,2,0,2
79102,180,20136,25667;25860,58765,0,0,2,0,2
79103,180,20138,25935;26154;29494,58765,0,1,2,0,3
79104,180,20140,25766;26093;28809;28897;29238,58765,0,3,2,0,5
79105,180,20142,25706;25913;28728;29481,58765,0,2,2,0,4
79106,180,20143,25987;26209;28801;28887,58765,0,2,2,0,4
79107,180,20144,25985;28968;29062,58765,0,2,1,0,3
79108,180,20145,26137;26428;28491;28819,58765,0,1,3,0,4
79109,180,20147,25936;26185;29163,58765,0,1,2,0,3
79110,180,20150,26212;29325,58765,0,1,1,0,2
79111,180,20152,25843;26222;29165,58765,0,1,2,0,3
79112,180,20153,25954;26252;28661;28904;29952,58765,1,1,3,0,5
79113,180,20154,25809;26295;29254;29415;29845,58765,1,2,2,0,5
79114,180,20155,26779;26831;29008;30113,58765,1,1,2,0,4
79115,180,20156,26564;29266;29421;29522,58765,0,3,1,0,4
79116,180,20157,25994;26398;28663;28912;30198,58765,1,1,3,0,5
79117,180,20158,26357;26365;28988;29336;29511,58765,0,3,2,0,5
79118,180,20159,26368;26401;29419,58765,0,1,2,0,3
79119,180,20160,26385;26724;28763;29005;29430;29691,58765,0,4,2,0,6
79120,180,20161,26207;26529;29100,58765,0,1,2,0,3
79121,180,20162,26948;29443,58765,0,1,1,0,2
79122,180,20163,26612;28825;29772,58765,1,1,1,0,3
79123,180,20164,26468;29341,58765,0,1,1,0,2
79124,180,20165,26298;26437;29095,58765,0,1,2,0,3
79125,180,20166,26441;26614,58765,0,0,2,0,2
79126,180,20167,26332;26674;29776,58765,1,0,2,0,3
79127,180,20168,26402;26523;29684,58765,0,1,2,0,3
79128,180,20169,26501;29262,58765,0,1,1,0,2
79129,180,20170,26259;26503;28916;29608;29851,58765,1,2,2,0,5
79130,180,20171,26424;28490;28582;29259,58765,0,1,3,0,4
79131,180,20172,26496;26706;29183;29689;29779,58765,1,2,2,0,5
79132,180,20173,26311;26550,58765,0,0,2,0,2
79133,180,20174,26576;26790;29188;29540,58765,0,2,2,0,4
79134,180,20176,26432;26583,58765,0,0,2,0,2
79135,180,20177,26318;26840;28594;29359,58765,0,1,3,0,4
79136,180,20178,26592;26759;30111,58765,1,0,2,0,3
79137,180,20179,26294;26598;28672,58765,0,0,3,0,3
79138,180,20180,26438;26804;29189,58765,0,1,2,0,3
79139,180,20181,26549;26675;29620,58765,0,1,2,0,3
79140,180,20182,26644;26681;29180,58765,0,1,2,0,3
79141,180,20183,26695;26923;29287;29554;29881,58765,1,2,2,0,5
79142,180,20184,26683;26713;29184;29429;29532;29621,58765,0,4,2,0,6
79143,180,20185,26714;29107;29866,58765,1,1,1,0,3
79144,180,20186,22532;22739,59130,0,0,0,2,2
79145,180,20189,22606,59130,0,0,0,1,1
79146,180,20190,22854,59130,0,0,0,1,1
79147,180,20192,23041,59130,0,0,0,1,1
79148,180,20193,23104,59130,0,0,0,1,1
79149,180,20196,23255,59130,0,0,0,1,1
79150,180,20203,24043;24512,59130,0,0,2,0,2
79151,180,20206,24122;24292,59130,0,0,2,0,2
79152,180,20208,24399;24540,59130,0,0,2,0,2
79153,180,20210,24231;24498,59130,0,0,2,0,2
79154,180,20215,24816;25106,59130,0,0,2,0,2
79155,180,20216,25073;25198;28519,59130,0,0,3,0,3
79156,180,20217,24893;25110;27642;29392,59130,0,1,3,0,4
79157,180,20218,25035;25352;27180;28008;28364;30096,59130,1,0,5,0,6
79158,180,20219,25237;25282;28694,59130,0,1,2,0,3
79159,180,20220,25383;25659;28939,59130,0,1,2,0,3
79160,180,20221,25339;25691;27930;28713;29047;29136,59130,0,3,3,0,6
79161,180,20222,25974;26052;29588,59130,0,1,2,0,3
79162,180,20223,25566;25654;28389,59130,0,0,3,0,3
79163,180,20224,25686;25798;28632,59130,0,0,3,0,3
79164,180,20225,25771;25823;28023;28293;29142;29308,59130,0,2,4,0,6
79165,180,20226,26245;26246;29411,59130,0,1,2,0,3
79166,180,20227,25957,59130,0,0,1,0,1
79167,180,20229,25964;26043;28736;29067;29233,59130,0,3,2,0,5
79168,180,20230,26013;26086,59130,0,0,2,0,2
79169,180,20231,26333;27834;29256;29509,59130,0,2,2,0,4
79170,180,20232,26038,59130,0,0,1,0,1
79171,180,20233,26014;26184;29496,59130,0,1,2,0,3
79172,180,20234,26072;26440;28583,59130,0,0,3,0,3
79173,180,20237,25898;26115;28811,59130,0,1,2,0,3
79174,180,20238,26140;26374;28488;29603;29847,59130,1,1,3,0,5
79175,180,20239,26214;26281;29677,59130,0,1,2,0,3
79176,180,20240,26270;26698;28591;30035,59130,1,0,3,0,4
79177,180,20241,26126;26553;29520,59130,0,1,2,0,3
79178,180,20242,26229;26570;29346;29769,59130,1,1,2,0,4
79179,180,20243,26097;26304;28752;29333;30101,59130,1,2,2,0,5
79180,180,20244,26320;26664;29104;29352,59130,0,2,2,0,4
79181,180,20245,26321;26476;28909;29335;29417,59130,0,3,2,0,5
79182,180,20246,26343;26656;29426;29860,59130,1,1,2,0,4
79183,180,20247,26124;26360;28989,59130,0,1,2,0,3
79184,180,20248,26276;26453,59130,0,0,2,0,2
79185,180,20249,26703;26775;30109,59130,1,0,2,0,3
79186,180,20250,26444;26586;29338,59130,0,1,2,0,3
79187,180,20251,26319;26466,59130,0,0,2,0,2
79188,180,20252,26449;26753;29536,59130,0,1,2,0,3
79189,180,20253,26429;26458,59130,0,0,2,0,2
79190,180,20254,26384;26490;28755;29337,59130,0,2,2,0,4
79191,180,20255,26594;29854;30106,59130,2,0,1,0,3
79192,180,20256,26196;26542;29612,59130,0,1,2,0,3
79193,180,20257,26556;26777;29357,59130,0,1,2,0,3
79194,180,20258,26715;26798;30115,59130,1,0,2,0,3
79195,180,20259,26591;26705;28495;29530;29865,59130,1,1,3,0,5
79196,180,20260,26601;29269,59130,0,1,1,0,2
79197,180,20261,26608;27050;28767;29374,59130,0,2,2,0,4
79198,180,20262,26580;26639;29001;29688,59130,0,2,2,0,4
79199,180,20264,26678;27042;29891;29968,59130,2,0,2,0,4
79200,180,20265,26354;26686;29862,59130,1,0,2,0,3
79201,180,20266,26487,59130,0,0,1,0,1
79202,180,20268,26729;26928;29440;29556,59130,0,2,2,0,4
79203,180,20269,27018;29193,59130,0,1,1,0,2
79204,180,20270,26787;29539;29784,59130,1,1,1,0,3
79205,180,20271,26797;27000;30125,59130,1,0,2,0,3
79206,180,20272,26461;26800;28765;29279;29542,59130,0,3,2,0,5
79207,180,20274,22786,59495,0,0,0,1,1
79208,180,20275,22796,59495,0,0,0,1,1
79209,180,20276,22204,59495,0,0,0,1,1
79210,180,20277,22829;23126,59495,0,0,0,2,2
79211,180,20279,23151,59495,0,0,0,1,1
79212,180,20280,23186,59495,0,0,0,1,1
79213,180,20281,23265,59495,0,0,0,1,1
79214,180,20282,22776,59495,0,0,0,1,1
79215,180,20304,25311,59495,0,0,1,0,1
79216,180,20305,25730;29138,59495,0,1,1,0,2
79217,180,20311,25341;25731,59495,0,0,2,0,2
79218,180,20314,25865;26306;29088;29416;29602;29680,59495,0,4,2,0,6
79219,180,20315,25938;26412;28992;29093;29765,59495,1,2,2,0,5
79220,180,20316,25943,59495,0,0,1,0,1
79221,180,20318,25605;25947;29147,59495,0,1,2,0,3
79222,180,20319,25820;26003,59495,0,0,2,0,2
79223,180,20320,26088;26105;28808;29074;29403;29490,59495,0,4,2,0,6
79224,180,20321,26041;26099;28571;29398,59495,0,1,3,0,4
79225,180,20322,26100;26315,59495,0,0,2,0,2
79226,180,20323,26116,59495,0,0,1,0,1
79227,180,20324,26081,59495,0,0,1,0,1
79228,180,20326,26180;26244;28816;29085;29167;29249;29601,59495,0,5,2,0,7
79229,180,20327,26123;26255;29504;29841,59495,1,1,2,0,4
79230,180,20328,26926;29555;29790;30124,59495,2,1,1,0,4
79231,180,20329,26317;26434,59495,0,0,2,0,2
79232,180,20330,26337;26994;29368,59495,0,1,2,0,3
79233,180,20331,26181;26361;29092,59495,0,1,2,0,3
79234,180,20332,26369;28754;28990;29258,59495,0,3,1,0,4
79235,180,20333,26383;26491;28669;28915;29261,59495,0,2,3,0,5
79236,180,20336,26454;26544;29339,59495,0,1,2,0,3
79237,180,20337,26475,59495,0,0,1,0,1
79238,180,20338,26327;26482;29096;29172;29342,59495,0,3,2,0,5
79239,180,20339,26483;26939;29883,59495,1,0,2,0,3
79240,180,20340,26499;27039;29444,59495,0,1,2,0,3
79241,180,20341,26500,59495,0,0,1,0,1
79242,180,20342,26522;26658;28590;28827;29861,59495,1,1,3,0,5
79243,180,20343,26261;26526;29610,59495,0,1,2,0,3
79244,180,20344,26545;26636;28589,59495,0,0,3,0,3
79245,180,20345,26340;26548;28996;29519;29853,59495,1,2,2,0,5
79246,180,20346,26611;26856;29112;29873,59495,1,1,2,0,4
79247,180,20347,26655;26877;29115;29551,59495,0,2,2,0,4
79248,180,20348,26443;26657;28826;29526;29618,59495,0,3,2,0,5
79249,180,20349,26669;28674;29003;29154;29353;29775,59495,1,3,2,0,6
79250,180,20350,26980;27060;30129,59495,1,0,2,0,3
79251,180,20351,26568;26719,59495,0,0,2,0,2
79252,180,20352,26848;27089;29020,59495,0,1,2,0,3
79253,180,20353,26734;27065;29019;29707;29796;30051,59495,2,2,2,0,6
79254,180,20354,26617;26919;28926;29364,59495,0,2,2,0,4
79255,180,20355,26446;26754,59495,0,0,2,0,2
79256,180,20356,26825;29545,59495,0,1,1,0,2
79257,180,20357,26827;27043,59495,0,0,2,0,2
79258,180,20358,26828;27086,59495,0,0,2,0,2
79259,180,20359,26830;26969;29884,59495,1,0,2,0,3
79260,180,20360,26850;27023;30046,59495,1,0,2,0,3
79261,180,20361,26767;26899;28830;29109;30112,59495,1,2,2,0,5
79262,180,20362,26901;27154;29715;29901,59495,1,1,2,0,4
79263,180,20363,26693;26904,59495,0,0,2,0,2
79264,180,20366,22830,59860,0,0,0,1,1
79265,180,20368,23060,59860,0,0,0,1,1
79266,180,20370,23086;23427,59860,0,0,0,2,2
79267,180,20371,23050,59860,0,0,0,1,1
79268,180,20373,22976,59860,0,0,0,1,1
79269,180,20374,22877,59860,0,0,0,1,1
79270,180,20375,23194,59860,0,0,0,1,1
79271,180,20377,23517;23597,59860,0,0,0,2,2
79272,180,20378,24082;24505,59860,0,0,2,0,2
79273,180,20379,24074,59860,0,0,1,0,1
79274,180,20382,24960,59860,0,0,1,0,1
79275,180,20383,24824,59860,0,0,1,0,1
79276,180,20385,25081;25271,59860,0,0,2,0,2
79277,180,20387,25047;25396;29035;29131,59860,0,2,2,0,4
79278,180,20391,25770;26031;28570;28734;28803,59860,0,2,3,0,5
79279,180,20392,25872;26062;29054,59860,0,1,2,0,3
79280,180,20394,25904;29058;29226,59860,0,2,1,0,3
79281,180,20395,26012;26176,59860,0,0,2,0,2
79282,180,20396,26058;26489;29683,59860,0,1,2,0,3
79283,180,20397,26060;26216;28983;29407,59860,0,2,2,0,4
79284,180,20398,25946;26079;28478,59860,0,0,3,0,3
79285,180,20399,25894;26272;29507;29678,59860,0,2,2,0,4
79286,180,20400,26146,59860,0,0,1,0,1
79287,180,20401,26141;26413;28232;28312;29954,59860,1,0,4,0,5
79288,180,20402,26223;26638;29271;29858,59860,1,1,2,0,4
79289,180,20404,26323,59860,0,0,1,0,1
79290,180,20405,26206;26350;29244;29598,59860,0,2,2,0,4
79291,180,20406,26355;26816,59860,0,0,2,0,2
79292,180,20408,26520;26621;29425;29687,59860,0,2,2,0,4
79293,180,20409,26504;28994;29852,59860,1,1,1,0,3
79294,180,20410,26525;26920;29191,59860,0,1,2,0,3
79295,180,20411,26643;26990;29116;29704,59860,0,2,2,0,4
79296,180,20412,26488;26559;29177;29521;29958,59860,1,2,2,0,5
79297,180,20413,26588;26635;29614,59860,0,1,2,0,3
79298,180,20414,26623;26971;29560;29636;29885,59860,1,2,2,0,5
79299,180,20415,26509;26940;28678;29366,59860,0,1,3,0,4
79300,180,20416,26660;26742;29624,59860,0,1,2,0,3
79301,180,20418,26596;26735;29623;29692;29959;30037,59860,2,2,2,0,6
79302,180,20419,26743;26760,59860,0,0,2,0,2
79303,180,20420,26765;26818,59860,0,0,2,0,2
79304,180,20421,26562;26785;28593;29187;29630;30114,59860,1,2,3,0,6
79305,180,20422,26744;26801;29535;29868;30110,59860,2,1,2,0,5
79306,180,20423,26772;26805;29280;29871,59860,1,1,2,0,4
79307,180,20424,26704;26813;29011;29544,59860,0,2,2,0,4
79308,180,20425,27158;27207;29904,59860,1,0,2,0,3
79309,180,20426,26826;27083;29376,59860,0,1,2,0,3
79310,180,20427,26829;27052;29375;29561,59860,0,2,2,0,4
79311,180,20428,27181;27227;29979,59860,1,0,2,0,3
79312,180,20429,26844;27232,59860,0,0,2,0,2
79313,180,20430,26851;27430,59860,0,0,2,0,2
79314,180,20431,26860;26973;29288,59860,0,1,2,0,3
79315,180,20432,26866;27076;28835;28924;29549,59860,0,3,2,0,5
79316,180,20433,26513;26893,59860,0,0,2,0,2
79317,180,20434,26894;27104;29293,59860,0,1,2,0,3
79318,180,20435,26796;26905;29014;29286,59860,0,2,2,0,4
79319,180,20436,26925;27179;29902,59860,1,0,2,0,3
79320,180,20437,26927;27141,59860,0,0,2,0,2
79321,180,20438,26935;27131;30056,59860,1,0,2,0,3
79322,180,20439,26936;26946,59860,0,0,2,0,2
79323,180,20440,26965;29558,59860,0,1,1,0,2
79324,180,20441,26984;27053;29969;30128,59860,2,0,2,0,4
79325,180,20442,26987;27171;28768;29977,59860,1,1,2,0,4
79326,180,20443,27219;27321;30064,59860,1,0,2,0,3
79327,180,20444,22638,60225,0,0,0,1,1
79328,180,20445,23057;23141,60225,0,0,0,2,2
79329,180,20446,23499;23877,60225,0,0,0,2,2
79330,180,20447,23699;23996,60225,0,0,0,2,2
79331,180,20451,24250,60225,0,0,1,0,1
79332,180,20455,24968;25229,60225,0,0,2,0,2
79333,180,20458,26139;26168;28745,60225,0,1,2,0,3
79334,180,20460,25765;25875;28725;29756,60225,1,1,2,0,4
79335,180,20462,25586;25863;28025;28565;28873;29311,60225,0,2,4,0,6
79336,180,20464,26056;26147,60225,0,0,2,0,2
79337,180,20465,26201;26414;28665,60225,0,0,3,0,3
79338,180,20466,26271;26881;29438,60225,0,1,2,0,3
79339,180,20467,26316;26450,60225,0,0,2,0,2
79340,180,20470,26405;26975;30044,60225,1,0,2,0,3
79341,180,20471,26409;26771;29628,60225,0,1,2,0,3
79342,180,20472,26326;26774;29433,60225,0,1,2,0,3
79343,180,20473,26347;26618;28999;29270;29686,60225,0,3,2,0,5
79344,180,20474,26512;26964,60225,0,0,2,0,2
79345,180,20475,26427;26579;29422,60225,0,1,2,0,3
79346,180,20477,26640;26747;29186;29780,60225,1,1,2,0,4
79347,180,20479,26651;26763;29859,60225,1,0,2,0,3
79348,180,20480,26868,60225,0,0,1,0,1
79349,180,20481,26712;26952;29966,60225,1,0,2,0,3
79350,180,20482,26534;26722;29354;29534,60225,0,2,2,0,4
79351,180,20483,26728;27066;29894;30052,60225,2,0,2,0,4
79352,180,20484,26502;27092;29118;29448,60225,0,2,2,0,4
79353,180,20485,26465;26773,60225,0,0,2,0,2
79354,180,20486,26630;26810;28496;29632,60225,0,1,3,0,4
79355,180,20487,26694;28760;29182,60225,0,2,1,0,3
79356,180,20488,26733;26843;28766;29546;30118,60225,1,2,2,0,5
79357,180,20489,26846;27047,60225,0,0,2,0,2
79358,180,20490,26853;26962,60225,0,0,2,0,2
79359,180,20491,26862;26979,60225,0,0,2,0,2
79360,180,20492,26391;26864;29283,60225,0,1,2,0,3
79361,180,20493,27199;27258;29909;29983,60225,2,0,2,0,4
79362,180,20494,26895;29880;30042,60225,2,0,1,0,3
79363,180,20495,26110;26958,60225,0,0,2,0,2
79364,180,20496,26992;27359;29384;29461;29571,60225,0,3,2,0,5
79365,180,20497,27006;27325;29200,60225,0,1,2,0,3
79366,180,20498,27256;27260,60225,0,0,2,0,2
79367,180,20499,26890;27009;30126,60225,1,0,2,0,3
79368,180,20500,26757;27024;28839;29639;30047,60225,1,2,2,0,5
79369,180,20501,27040;27120;29898,60225,1,0,2,0,3
79370,180,20502,26730;27073;29073;29194;29797;30131,60225,2,2,2,0,6
79371,180,20503,26751;27079;29708;29798;29896;30132,60225,3,1,2,0,6
79372,180,20504,27085;27209,60225,0,0,2,0,2
79373,180,20505,26755;27100;30134,60225,1,0,2,0,3
79374,180,20506,23013,60590,0,0,0,1,1
79375,180,20509,23299,60590,0,0,0,1,1
79376,180,20510,23364,60590,0,0,0,1,1
79377,180,20512,23553;23748,60590,0,0,0,2,2
79378,180,20513,23567;23943,60590,0,0,0,2,2
79379,180,20515,23668;23893,60590,0,0,0,2,2
79380,180,20516,23716,60590,0,0,0,1,1
79381,180,20517,23743,60590,0,0,0,1,1
79382,180,20518,23481,60590,0,0,0,1,1
79383,180,20519,23846,60590,0,0,0,1,1
79384,180,20521,24054,60590,0,0,1,0,1
79385,180,20526,24020;24189,60590,0,0,2,0,2
79386,180,20530,25307,60590,0,0,1,0,1
79387,180,20539,25259,60590,0,0,1,0,1
79388,180,20541,25251;25277,60590,0,0,2,0,2
79389,180,20542,25492;25821;29307,60590,0,1,2,0,3
79390,180,20544,25642;25707,60590,0,0,2,0,2
79391,180,20545,26054;29069;29487,60590,0,2,1,0,3
79392,180,20547,25701;25830;28475,60590,0,0,3,0,3
79393,180,20548,25871;26234;28410;28815;28984;29166;29502;30193,60590,1,4,3,0,8
79394,180,20552,25984,60590,0,0,1,0,1
79395,180,20553,26015;26582,60590,0,0,2,0,2
79396,180,20554,26241;26344;28662;28753;28911;29763,60590,1,2,3,0,6
79397,180,20555,26530;29767;30030,60590,2,0,1,0,3
79398,180,20556,26205;26342;28484;28813;29081;29947,60590,1,2,3,0,6
79399,180,20557,26250;26262;28487;28817;29086;29842;30028,60590,2,2,3,0,7
79400,180,20559,26114;26303;28740;28979,60590,0,2,2,0,4
79401,180,20560,26339;26666;29002;29527,60590,0,2,2,0,4
79402,180,20561,26373;26462;28584;28820;29340,60590,0,2,3,0,5
79403,180,20562,26463;26961;29703,60590,0,1,2,0,3
79404,180,20563,26498,60590,0,0,1,0,1
79405,180,20564,26590,60590,0,0,1,0,1
79406,180,20565,26604;26977;29016;29886,60590,1,1,2,0,4
79407,180,20566,27142;29021;30058,60590,1,1,1,0,3
79408,180,20567,26322;26338,60590,0,0,2,0,2
79409,180,20568,26647,60590,0,0,1,0,1
79410,180,20569,26581;26663,60590,0,0,2,0,2
79411,180,20570,26670;27242;29650;29717;29807,60590,1,2,2,0,5
79412,180,20571,26677;28494,60590,0,0,2,0,2
79413,180,20572,26701;26873;29022,60590,0,1,2,0,3
79414,180,20574,26764;29626,60590,0,1,1,0,2
79415,180,20575,26788;26942;29965;30043,60590,2,0,2,0,4
79416,180,20576,26824;26837;30117,60590,1,0,2,0,3
79417,180,20578,27235;27248;30140,60590,1,0,2,0,3
79418,180,20579,26756;26917;29190;29701;29964,60590,1,2,2,0,5
79419,180,20580,26524;26934,60590,0,0,2,0,2
79420,180,20581,26949;27161;29015;29192,60590,0,2,2,0,4
79421,180,20582,26882;26959;29878,60590,1,0,2,0,3
79422,180,20583,27007,60590,0,0,1,0,1
79423,180,20584,27056,60590,0,0,1,0,1
79424,180,20585,27071;27262;29124;29651,60590,0,2,2,0,4
79425,180,20586,26684;27115;29120,60590,0,1,2,0,3
79426,180,20587,27055;27097;29290;29445,60590,0,2,2,0,4
79427,180,20588,27101;27119;29377;29645;30055,60590,1,2,2,0,5
79428,180,20589,26855;27123;29282;29547,60590,0,2,2,0,4
79429,180,20590,27128;27215;29905,60590,1,0,2,0,3
79430,180,20591,27078;27138;29712,60590,0,1,2,0,3
79431,180,20592,27147;27203;29455,60590,0,1,2,0,3
79432,180,20594,23303,60955,0,0,0,1,1
79433,180,20595,23416,60955,0,0,0,1,1
79434,180,20596,23346,60955,0,0,0,1,1
79435,180,20598,23484,60955,0,0,0,1,1
79436,180,20601,23895;24002,60955,0,0,0,2,2
79437,180,20605,24220,60955,0,0,1,0,1
79438,180,20608,24559;24916,60955,0,0,2,0,2
79439,180,20613,24629;24755,60955,0,0,2,0,2
79440,180,20619,25130;25501,60955,0,0,2,0,2
79441,180,20620,25200;27732;28699;29929,60955,1,1,2,0,4
79442,180,20621,25056;25599,60955,0,0,2,0,2
79443,180,20628,25465;25790,60955,0,0,2,0,2
79444,180,20629,26174;26346;29510,60955,0,1,2,0,3
79445,180,20630,25772;26068;28894;29950,60955,1,1,2,0,4
79446,180,20632,25824;25905;29051;29143,60955,0,2,2,0,4
79447,180,20633,26169;26310;28982;29241,60955,0,2,2,0,4
79448,180,20634,26353;26956;28837;29557;29792,60955,1,2,2,0,5
79449,180,20635,26370;26778;28922;29434;29870,60955,1,2,2,0,5
79450,180,20636,26198;26348,60955,0,0,2,0,2
79451,180,20637,26516;26847,60955,0,0,2,0,2
79452,180,20638,26891;27088,60955,0,0,2,0,2
79453,180,20640,26543,60955,0,0,1,0,1
79454,180,20641,26554;26932,60955,0,0,2,0,2
79455,180,20642,26615;26998;29637,60955,0,1,2,0,3
79456,180,20643,26629,60955,0,0,1,0,1
79457,180,20644,26558;26874;29013;30120,60955,1,1,2,0,4
79458,180,20645,26584;26688;29105,60955,0,1,2,0,3
79459,180,20647,26595;26710;29178;29855;30033,60955,2,1,2,0,5
79460,180,20648,26690;26738;28920;29693,60955,0,2,2,0,4
79461,180,20649,26978,60955,0,0,1,0,1
79462,180,20650,26649;26986;29367;30045,60955,1,1,2,0,4
79463,180,20651,26439,60955,0,0,1,0,1
79464,180,20652,26793;26861;29548;29699,60955,0,2,2,0,4
79465,180,20653,26819;28834;30116,60955,1,1,1,0,3
79466,180,20654,26727;27031,60955,0,0,2,0,2
79467,180,20655,26918;27244;29024;30067,60955,1,1,2,0,4
79468,180,20656,26900;27301;30070,60955,1,0,2,0,3
79469,180,20657,26922;29365;29439;30123,60955,1,2,1,0,4
79470,180,20658,26955;27196;29903,60955,1,0,2,0,3
79471,180,20659,26960;27144;28928;29900;29974;30059,60955,3,1,2,0,6
79472,180,20660,26996;27352;29126;29381,60955,0,2,2,0,4
79473,180,20661,27015;27547,60955,0,0,2,0,2
79474,180,20662,26871;29114;29876,60955,1,1,1,0,3
79475,180,20663,26929;29441;29882,60955,1,1,1,0,3
79476,180,20664,27057;29563,60955,0,1,1,0,2
79477,180,20665,27002;27077;29793,60955,1,0,2,0,3
79478,180,20666,26968;27082;30133,60955,1,0,2,0,3
79479,180,20667,27093;27224;29981;30139,60955,2,0,2,0,4
79480,180,20668,26896;27096;29565,60955,0,1,2,0,3
79481,180,20669,26970;27103;29559;29635,60955,0,2,2,0,4
79482,180,20670,26791;27113;29450;29971,60955,1,1,2,0,4
79483,180,20671,27511;30161,60955,1,0,1,0,2
79484,180,20672,27118;29195;30136,60955,1,1,1,0,3
79485,180,20673,26988;27145;29713;29804;30060,60955,2,1,2,0,5
79486,180,20674,26983;27146;28841;29121,60955,0,2,2,0,4
79487,180,20675,26622;27149;29975;30061;30138,60955,3,0,2,0,5
79488,180,20676,27150;27542;30162,60955,1,0,2,0,3
79489,180,20677,27177,60955,0,0,1,0,1
79490,180,20678,27233;27280;29719,60955,0,1,2,0,3
79491,180,20679,27230;27241;29907,60955,1,0,2,0,3
79492,180,20680,26886;27250;29123;29295,60955,0,2,2,0,4
79493,180,20681,27211;27273,60955,0,0,2,0,2
79494,180,20682,27277;27425;29463;29655,60955,0,2,2,0,4
79495,180,20683,23291;23552,61320,0,0,0,2,2
79496,180,20686,23201,61320,0,0,0,1,1
79497,180,20687,23361,61320,0,0,0,1,1
79498,180,20688,22937,61320,0,0,0,1,1
79499,180,20689,23506;23731,61320,0,0,0,2,2
79500,180,20690,23092,61320,0,0,0,1,1
79501,180,20691,23366,61320,0,0,0,1,1
79502,180,20695,23690;23892,61320,0,0,0,2,2
79503,180,20696,24089,61320,0,0,1,0,1
79504,180,20697,24315;24415,61320,0,0,2,0,2
79505,180,20699,24094;24373,61320,0,0,2,0,2
79506,180,20703,24848,61320,0,0,1,0,1
79507,180,20709,25283,61320,0,0,1,0,1
79508,180,20711,25281,61320,0,0,1,0,1
79509,180,20713,25536;25848;28563;28960;29053,61320,0,2,3,0,5
79510,180,20714,25452,61320,0,0,1,0,1
79511,180,20715,25774;25787,61320,0,0,2,0,2
79512,180,20716,25805;26067;29318;29489,61320,0,2,2,0,4
79513,180,20718,26165;28744,61320,0,1,1,0,2
79514,180,20721,26371;26725,61320,0,0,2,0,2
79515,180,20722,26607,61320,0,0,1,0,1
79516,180,20723,26473;26692;29864,61320,1,0,2,0,3
79517,180,20724,26151;26393;28034;29512,61320,0,1,3,0,4
79518,180,20726,26474;26909,61320,0,0,2,0,2
79519,180,20729,26659;26963;29427,61320,0,1,2,0,3
79520,180,20730,26661;27017;30127,61320,1,0,2,0,3
79521,180,20731,26426,61320,0,0,1,0,1
79522,180,20732,26506;26687;29004;29863;30108,61320,2,1,2,0,5
79523,180,20733,26633;26689;29350;29525;29616,61320,0,3,2,0,5
79524,180,20734,26697;26981;29967,61320,1,0,2,0,3
79525,180,20735,26447,61320,0,0,1,0,1
79526,180,20736,26566;26836;28923;29436;29788,61320,1,2,2,0,5
79527,180,20737,26387;26880;29361,61320,0,1,2,0,3
79528,180,20738,26912,61320,0,0,1,0,1
79529,180,20739,26876;29437;29877,61320,1,1,1,0,3
79530,180,20740,26993;27505;29661,61320,0,1,2,0,3
79531,180,20741,26931;27011;29442;29791,61320,1,1,2,0,4
79532,180,20742,26957;27019;29017;29888,61320,1,1,2,0,4
79533,180,20743,26789;27026;29890,61320,1,0,2,0,3
79534,180,20744,26859;27038;29372,61320,0,1,2,0,3
79535,180,20745,27049;27350,61320,0,0,2,0,2
79536,180,20746,27064;27127;29451;29646;29972,61320,1,2,2,0,5
79537,180,20747,26832;27068;28320;29787,61320,1,0,3,0,4
79538,180,20748,27074;27410;29723,61320,0,1,2,0,3
79539,180,20749,27081;27106;29446;29799;30053,61320,2,1,2,0,5
79540,180,20750,27016;27284,61320,0,0,2,0,2
79541,180,20751,27110;27367,61320,0,0,2,0,2
79542,180,20752,26945;27114;29644,61320,0,1,2,0,3
79543,180,20753,26834;27033;29642,61320,0,1,2,0,3
79544,180,20754,27137;27200;29197,61320,0,1,2,0,3
79545,180,20755,27204;27585,61320,0,0,2,0,2
79546,180,20756,27306;27360;29125;29809,61320,1,1,2,0,4
79547,180,20757,27217;27335,61320,0,0,2,0,2
79548,180,20758,27166;27263;29647,61320,0,1,2,0,3
79549,180,20759,27279;27488;29814,61320,1,0,2,0,3
79550,180,20760,27295;27476;29660,61320,0,1,2,0,3
79551,180,20761,27303;27591,61320,0,0,2,0,2
79552,180,20762,27264;27313;29721,61320,0,1,2,0,3
79553,180,20763,27318;27497;29817,61320,1,0,2,0,3
79554,180,20764,27332;27384,61320,0,0,2,0,2
79555,180,20765,27334;27397,61320,0,0,2,0,2
79556,180,20766,27201;27337;29987,61320,1,0,2,0,3
79557,180,20767,27278,61320,0,0,1,0,1
79558,180,20768,27231;27353;29382,61320,0,1,2,0,3
79559,180,20769,27361;27546,61320,0,0,2,0,2
79560,180,20770,27362;27380;29810,61320,1,0,2,0,3
79561,180,20771,27354;27365;29383,61320,0,1,2,0,3
79562,180,20772,27175;27371;29722,61320,0,1,2,0,3
79563,180,20773,27183;27373,61320,0,0,2,0,2
79564,180,20774,23307,61685,0,0,0,1,1
79565,180,20776,22902,61685,0,0,0,1,1
79566,180,20778,23330,61685,0,0,0,1,1
79567,180,20780,23254,61685,0,0,0,1,1
79568,180,20781,23304,61685,0,0,0,1,1
79569,180,20784,23039,61685,0,0,0,1,1
79570,180,20785,23935,61685,0,0,0,1,1
79571,180,20786,23853,61685,0,0,0,1,1
79572,180,20790,24626,61685,0,0,1,0,1
79573,180,20791,24616,61685,0,0,1,0,1
79574,180,20799,25460,61685,0,0,1,0,1
79575,180,20801,25549;25620,61685,0,0,2,0,2
79576,180,20803,25710,61685,0,0,1,0,1
79577,180,20805,25735;25832;28790;29222,61685,0,2,2,0,4
79578,180,20807,25780;26033;29317;29758,61685,1,1,2,0,4
79579,180,20808,25479;25873;28645;28724;28875,61685,0,2,3,0,5
79580,180,20810,26237;26902;29285;29363;29552;30122,61685,1,3,2,0,6
79581,180,20811,26240;28749,61685,0,1,1,0,2
79582,180,20812,26297;26452;29260,61685,0,1,2,0,3
79583,180,20813,26533;28917;29175;29611,61685,0,3,1,0,4
79584,180,20814,26325;26648;28919;29272;29351,61685,0,3,2,0,5
79585,180,20815,26585;26613;29856,61685,1,0,2,0,3
79586,180,20816,26470,61685,0,0,1,0,1
79587,180,20817,26707;27061;28927;29291;29893,61685,1,2,2,0,5
79588,180,20818,26511;27022;29018;29889,61685,1,1,2,0,4
79589,180,20819,26557;26903;28925;29700,61685,0,2,2,0,4
79590,180,20820,26567;26858,61685,0,0,2,0,2
79591,180,20821,26603;26768;29277;29356;29627;29783;30039,61685,2,3,2,0,7
79592,180,20822,26605;26749;29275;29781,61685,1,1,2,0,4
79593,180,20823,26517;28822;29098,61685,0,2,1,0,3
79594,180,20824,26654;27155;29976,61685,1,0,2,0,3
79595,180,20825,26668;26721,61685,0,0,2,0,2
79596,180,20826,26364;26786,61685,0,0,2,0,2
79597,180,20827,26758;26795;28833;29541,61685,0,2,2,0,4
79598,180,20829,26849;26938;29360;30041,61685,1,1,2,0,4
79599,180,20830,26673;26807;29010;29543;29631;29785,61685,1,3,2,0,6
79600,180,20831,27267;27595;30168,61685,1,0,2,0,3
79601,180,20832,26933,61685,0,0,1,0,1
79602,180,20833,26976;27001;29887,61685,1,0,2,0,3
79603,180,20834,27274;27626;29739,61685,0,1,2,0,3
79604,180,20835,26999;27441;29574;29656,61685,0,2,2,0,4
79605,180,20836,27445;29657,61685,0,1,1,0,2
79606,180,20837,27041;27051,61685,0,0,2,0,2
79607,180,20838,27044;27429;29464;29725;30075,61685,1,2,2,0,5
79608,180,20840,27122;27459,61685,0,0,2,0,2
79609,180,20841,27176;27375,61685,0,0,2,0,2
79610,180,20842,27124;27178;29378;29649,61685,0,2,2,0,4
79611,180,20843,27452;27472;29129,61685,0,1,2,0,3
79612,180,20844,27276;27287;29456,61685,0,1,2,0,3
79613,180,20845,27285;27458;29917;29993,61685,2,0,2,0,4
79614,180,20846,27293;27673,61685,0,0,2,0,2
79615,180,20847,27720;27721,61685,0,0,2,0,2
79616,180,20848,26947;27311;29984,61685,1,0,2,0,3
79617,180,20849,27080;27320;29457;29652;30144,61685,1,2,2,0,5
79618,180,20850,27075;27323;30071;30145,61685,2,0,2,0,4
79619,180,20851,27328;27540;29920,61685,1,0,2,0,3
79620,180,20852,27338;27650;30002;30171,61685,2,0,2,0,4
79621,180,20853,27288;27347;29570,61685,0,1,2,0,3
79622,180,20854,27314;27369;29985,61685,1,0,2,0,3
79623,180,20855,27436;27679,61685,0,0,2,0,2
79624,180,20856,27414;27450;30150,61685,1,0,2,0,3
79625,180,20857,27087;27394;29203,61685,0,1,2,0,3
79626,180,20858,23398,62050,0,0,0,1,1
79627,180,20860,23353,62050,0,0,0,1,1
79628,180,20862,23777,62050,0,0,0,1,1
79629,180,20863,23514,62050,0,0,0,1,1
79630,180,20865,23991,62050,0,0,0,1,1
79631,180,20866,24014,62050,0,0,1,0,1
79632,180,20868,24204,62050,0,0,1,0,1
79633,180,20869,24111;24463,62050,0,0,2,0,2
79634,180,20872,24256,62050,0,0,1,0,1
79635,180,20874,24101;24300,62050,0,0,2,0,2
79636,180,20882,25088;25468,62050,0,0,2,0,2
79637,180,20884,24900;25651,62050,0,0,2,0,2
79638,180,20886,24972,62050,0,0,1,0,1
79639,180,20891,25045;25143,62050,0,0,2,0,2
79640,180,20896,25385;25584;28545;28861,62050,0,1,3,0,4
79641,180,20897,25508,62050,0,0,1,0,1
79642,180,20898,25597;25698,62050,0,0,2,0,2
79643,180,20900,25337;25517,62050,0,0,2,0,2
79644,180,20901,25934;26170;29242;29596,62050,0,2,2,0,4
79645,180,20902,25887;26362;29171,62050,0,1,2,0,3
79646,180,20903,25793;25973,62050,0,0,2,0,2
79647,180,20904,25916;26301;28907,62050,0,1,2,0,3
79648,180,20906,26161;26699;28761,62050,0,1,2,0,3
79649,180,20907,26108;26213;29246;29326;29500,62050,0,3,2,0,5
79650,180,20908,26200,62050,0,0,1,0,1
79651,180,20909,26020,62050,0,0,1,0,1
79652,180,20911,26149,62050,0,0,1,0,1
79653,180,20912,26418;26888;29362;29879,62050,1,1,2,0,4
79654,180,20913,26547;27343,62050,0,0,2,0,2
79655,180,20914,26652;26914;28836,62050,0,1,2,0,3
79656,180,20915,26723,62050,0,0,1,0,1
79657,180,20916,27174;30063,62050,1,0,1,0,2
79658,180,20917,26808;27027;29640;29705;30048,62050,1,2,2,0,5
79659,180,20918,26833;27246;29718;29982,62050,1,1,2,0,4
79660,180,20919,26921;27062;29292;30130,62050,1,1,2,0,4
79661,180,20920,27218,62050,0,0,1,0,1
79662,180,20921,27010;27465,62050,0,0,2,0,2
79663,180,20922,27037;27268,62050,0,0,2,0,2
79664,180,20923,26822;27054;29117;29562;30050,62050,1,2,2,0,5
79665,180,20924,27063;27125;29706,62050,0,1,2,0,3
79666,180,20925,27036;27111,62050,0,0,2,0,2
79667,180,20926,27197;29023;29980,62050,1,1,1,0,3
79668,180,20927,27225;27396,62050,0,0,2,0,2
79669,180,20928,27208;27572;30164,62050,1,0,2,0,3
79670,180,20929,27255;27282;29908;30068,62050,2,0,2,0,4
79671,180,20930,27173;27302;28842;29978;30062,62050,2,1,2,0,5
79672,180,20931,27305;27796;29932,62050,1,0,2,0,3
79673,180,20932,27589,62050,0,0,1,0,1
79674,180,20933,27386;27487,62050,0,0,2,0,2
79675,180,20934,27565;27696,62050,0,0,2,0,2
79676,180,20935,27809;29825;30088,62050,2,0,1,0,3
79677,180,20936,27291;27424;29724,62050,0,1,2,0,3
79678,180,20937,27474;27830;29208,62050,0,1,2,0,3
79679,180,20938,27342,62050,0,0,1,0,1
79680,180,20939,27481,62050,0,0,1,0,1
79681,180,20940,27289;27484;29388;29729;29996;30156,62050,2,2,2,0,6
79682,180,20941,27793,62050,0,0,1,0,1
79683,180,20942,27478;27525;29026,62050,0,1,2,0,3
79684,180,20943,27795;29931,62050,1,0,1,0,2
79685,180,20944,27805;30087,62050,1,0,1,0,2
79686,180,20945,27304;27538;29919,62050,1,0,2,0,3
79687,180,20946,27545;27807,62050,0,0,2,0,2
79688,180,20947,27563;27649,62050,0,0,2,0,2
79689,180,20949,23618;23738,62415,0,0,0,2,2
79690,180,20950,23954,62415,0,0,0,1,1
79691,180,20951,23633;23874,62415,0,0,0,2,2
79692,180,20952,23379,62415,0,0,0,1,1
79693,180,20953,24091,62415,0,0,1,0,1
79694,180,20954,23442,62415,0,0,0,1,1
79695,180,20956,23997,62415,0,0,0,1,1
79696,180,20958,24285,62415,0,0,1,0,1
79697,180,20963,24738,62415,0,0,1,0,1
79698,180,20966,24974,62415,0,0,1,0,1
79699,180,20970,24879;25273;29029,62415,0,1,2,0,3
79700,180,20973,25676,62415,0,0,1,0,1
79701,180,20974,25693,62415,0,0,1,0,1
79702,180,20976,25921;26628,62415,0,0,2,0,2
79703,180,20977,25497,62415,0,0,1,0,1
79704,180,20978,25624,62415,0,0,1,0,1
79705,180,20979,26022,62415,0,0,1,0,1
79706,180,20980,26159;26238;28748;29083;29329,62415,0,3,2,0,5
79707,180,20981,26478;26841;29698;29963;30040,62415,2,1,2,0,5
79708,180,20983,26293;26386;29331,62415,0,1,2,0,3
79709,180,20985,26460,62415,0,0,1,0,1
79710,180,20986,26464;27034;29643;29795,62415,1,1,2,0,4
79711,180,20987,26535;26911;29553,62415,0,1,2,0,3
79712,180,20988,26145;26662;28828,62415,0,1,2,0,3
79713,180,20989,26720,62415,0,0,1,0,1
79714,180,20990,26593;26835;29872,62415,1,0,2,0,3
79715,180,20991,26907;26924;29702,62415,0,1,2,0,3
79716,180,20992,26954;27020;29369;29638,62415,0,2,2,0,4
79717,180,20993,26898;27151;29789,62415,1,0,2,0,3
79718,180,20994,27121;27165;29453;29716,62415,0,2,2,0,4
79719,180,20995,27152;27222;29568;30065,62415,1,1,2,0,4
79720,180,20996,27221;27818,62415,0,0,2,0,2
79721,180,20997,27416;29128;29811,62415,1,1,1,0,3
79722,180,20998,27234;27238,62415,0,0,2,0,2
79723,180,20999,27254;27372;30073,62415,1,0,2,0,3
79724,180,21000,27266;27444;29298;29726,62415,0,2,2,0,4
79725,180,21001,27408;27529;29914,62415,1,0,2,0,3
79726,180,21002,27513;27577;29736,62415,0,1,2,0,3
79727,180,21003,27129;27393;30074,62415,1,0,2,0,3
79728,180,21004,27400;27493,62415,0,0,2,0,2
79729,180,21005,27413;27515,62415,0,0,2,0,2
79730,180,21006,27423;27614,62415,0,0,2,0,2
79731,180,21007,27432;27573,62415,0,0,2,0,2
79732,180,21008,27439;27828,62415,0,0,2,0,2
79733,180,21009,27469;27735,62415,0,0,2,0,2
79734,180,21010,27170;27480;29204,62415,0,1,2,0,3
79735,180,21011,27494,62415,0,0,1,0,1
79736,180,21012,27108;27510;29732,62415,0,1,2,0,3
79737,180,21013,27226;30066,62415,1,0,1,0,2
79738,180,21014,27512;27639;29206,62415,0,1,2,0,3
79739,180,21015,27162;27521;29467,62415,0,1,2,0,3
79740,180,21016,27534,62415,0,0,1,0,1
79741,180,21017,27536;27688;30004,62415,1,0,2,0,3
79742,180,21018,27272;27551;29299;29576;29662;29922,62415,1,3,2,0,6
79743,180,21019,27552;27714;30005,62415,1,0,2,0,3
79744,180,21020,27319;27568,62415,0,0,2,0,2
79745,180,21021,27522;27623;30001,62415,1,0,2,0,3
79746,180,21022,27191;27632;29740,62415,0,1,2,0,3
79747,180,21023,27922,62415,0,0,1,0,1
79748,180,21024,27646;27710;29300;30170,62415,1,1,2,0,4
79749,180,21025,23772,62780,0,0,0,1,1
79750,180,21026,23813,62780,0,0,0,1,1
79751,180,21027,23992;24328,62780,0,0,1,1,2
79752,180,21028,23955,62780,0,0,0,1,1
79753,180,21032,24260;24678,62780,0,0,2,0,2
79754,180,21037,25022;25068,62780,0,0,2,0,2
79755,180,21038,24927;25050;28511,62780,0,0,3,0,3
79756,180,21039,25185,62780,0,0,1,0,1
79757,180,21041,25193,62780,0,0,1,0,1
79758,180,21042,24933,62780,0,0,1,0,1
79759,180,21043,25305,62780,0,0,1,0,1
79760,180,21047,25309,62780,0,0,1,0,1
79761,180,21052,26289;26328;29953,62780,1,0,2,0,3
79762,180,21055,26472;26537,62780,0,0,2,0,2
79763,180,21056,26578;26671,62780,0,0,2,0,2
79764,180,21057,26359;26736,62780,0,0,2,0,2
79765,180,21058,27153;29714;29805,62780,1,1,1,0,3
79766,180,21059,26574;26782;28764;29695,62780,0,2,2,0,4
79767,180,21060,26806;27029;30049,62780,1,0,2,0,3
79768,180,21061,26815;27502,62780,0,0,2,0,2
79769,180,21062,26823,62780,0,0,1,0,1
79770,180,21063,26913;27261,62780,0,0,2,0,2
79771,180,21064,26972,62780,0,0,1,0,1
79772,180,21065,26982;27187,62780,0,0,2,0,2
79773,180,21066,27003;27102;29970;30135,62780,2,0,2,0,4
79774,180,21067,27012;27098;29449,62780,0,1,2,0,3
79775,180,21068,27188;27346;28843;30146,62780,1,1,2,0,4
79776,180,21069,26857;27317;30143,62780,1,0,2,0,3
79777,180,21070,27205;27330;29202;29458,62780,0,2,2,0,4
79778,180,21071,27290;27336;28929;30141,62780,1,1,2,0,4
79779,180,21072,27645,62780,0,0,1,0,1
79780,180,21073,27341;27443;29025;29297;29465,62780,0,3,2,0,5
79781,180,21074,27344;27600,62780,0,0,2,0,2
79782,180,21075,27134;27374;29452,62780,0,1,2,0,3
79783,180,21076,27223;27379,62780,0,0,2,0,2
79784,180,21077,27391;27604;29925;30080,62780,2,0,2,0,4
79785,180,21078,27401;27402,62780,0,0,2,0,2
79786,180,21079,27411;30149,62780,1,0,1,0,2
79787,180,21080,27419;27560,62780,0,0,2,0,2
79788,180,21081,27440;27586;29470;29737;29924;30079;30167,62780,3,2,2,0,7
79789,180,21082,27460;27466;29658;29994,62780,1,1,2,0,4
79790,180,21083,27249;27473,62780,0,0,2,0,2
79791,180,21084,27426;27490;29815;29997,62780,2,0,2,0,4
79792,180,21085,27705,62780,0,0,1,0,1
79793,180,21086,27504;27709,62780,0,0,2,0,2
79794,180,21087,27483;27556,62780,0,0,2,0,2
79795,180,21088,27580;27734;29663;30166,62780,1,1,2,0,4
79796,180,21089,27582,62780,0,0,1,0,1
79797,180,21090,27606;27695;30174,62780,1,0,2,0,3
79798,180,21091,27615;27768,62780,0,0,2,0,2
79799,180,21092,27471;27620,62780,0,0,2,0,2
79800,180,21093,27653;27866,62780,0,0,2,0,2
79801,180,21094,27691;27890,62780,0,0,2,0,2
79802,180,21095,27690;27699,62780,0,0,2,0,2
79803,180,21096,27760;28005,62780,0,0,2,0,2
79804,180,21097,27486;27722;30175,62780,1,0,2,0,3
79805,180,21098,27462;27723;29928;30006;30176,62780,3,0,2,0,5
79806,180,21099,27733;27838,62780,0,0,2,0,2
79807,180,21100,27194;27739,62780,0,0,2,0,2
79808,180,21101,23451,63145,0,0,0,1,1
79809,180,21103,23722,63145,0,0,0,1,1
79810,180,21105,23951,63145,0,0,0,1,1
79811,180,21106,23623;23817,63145,0,0,0,2,2
79812,180,21108,23823,63145,0,0,0,1,1
79813,180,21109,23674,63145,0,0,0,1,1
79814,180,21113,24113,63145,0,0,1,0,1
79815,180,21114,24046;24090,63145,0,0,2,0,2
79816,180,21116,24599,63145,0,0,1,0,1
79817,180,21118,24793;24902,63145,0,0,2,0,2
79818,180,21121,25378,63145,0,0,1,0,1
79819,180,21122,25387;25699,63145,0,0,2,0,2
79820,180,21124,25443,63145,0,0,1,0,1
79821,180,21125,25257,63145,0,0,1,0,1
79822,180,21127,25785;26204,63145,0,0,2,0,2
79823,180,21128,25878,63145,0,0,1,0,1
79824,180,21131,26164,63145,0,0,1,0,1
79825,180,21136,26396;26532;29174;29345,63145,0,2,2,0,4
79826,180,21138,26560;26872,63145,0,0,2,0,2
79827,180,21139,26606,63145,0,0,1,0,1
79828,180,21140,26802,63145,0,0,1,0,1
79829,180,21141,27025;27275;29808;29910,63145,2,0,2,0,4
79830,180,21142,26626;26814;29697;29962,63145,1,1,2,0,4
79831,180,21143,26820;27220;29198;29906,63145,1,1,2,0,4
79832,180,21144,26953;27447,63145,0,0,2,0,2
79833,180,21145,26967;27355;29459;29912;29988;30147,63145,3,1,2,0,6
79834,180,21146,27048;29373;29892,63145,1,1,1,0,3
79835,180,21147,27032,63145,0,0,1,0,1
79836,180,21148,26745;27067;29564;29895,63145,1,1,2,0,4
79837,180,21150,27014;27596;29389,63145,0,1,2,0,3
79838,180,21151,27140;27811,63145,0,0,2,0,2
79839,180,21152,26941;27143;29803,63145,1,0,2,0,3
79840,180,21153,27169;29122,63145,0,1,1,0,2
79841,180,21154,27157;27415;29572,63145,0,1,2,0,3
79842,180,21155,27198;27448,63145,0,0,2,0,2
79843,180,21156,26989,63145,0,0,1,0,1
79844,180,21157,27236;29806,63145,1,0,1,0,2
79845,180,21158,27331;27557;29735,63145,0,1,2,0,3
79846,180,21159,27333;27621,63145,0,0,2,0,2
79847,180,21161,27767,63145,0,0,1,0,1
79848,180,21162,27186;27392;29127;29913,63145,1,1,2,0,4
79849,180,21163,27395;27678,63145,0,0,2,0,2
79850,180,21164,27322;27611,63145,0,0,2,0,2
79851,180,21165,27428;27496;29205;29466,63145,0,2,2,0,4
79852,180,21166,27442;27652;30172,63145,1,0,2,0,3
79853,180,21167,27464;27470,63145,0,0,2,0,2
79854,180,21168,27506;27917,63145,0,0,2,0,2
79855,180,21169,27531;27932,63145,0,0,2,0,2
79856,180,21170,27567;27748;29580,63145,0,1,2,0,3
79857,180,21171,27541;27579;29577;29999;30165,63145,2,1,2,0,5
79858,180,21172,27592;27940;29938,63145,1,0,2,0,3
79859,180,21173,27594;27910,63145,0,0,2,0,2
79860,180,21174,27610;28098,63145,0,0,2,0,2
79861,180,21175,27612;27909;29937,63145,1,0,2,0,3
79862,180,21176,27399;27492;29816;30158,63145,2,0,2,0,4
79863,180,21177,27648;29820,63145,1,0,1,0,2
79864,180,21178,27661;27870,63145,0,0,2,0,2
79865,180,21179,27130;27662;29743,63145,0,1,2,0,3
79866,180,21180,27665;27790,63145,0,0,2,0,2
79867,180,21181,27667;27942,63145,0,0,2,0,2
79868,180,21182,27683;27792;29472;30009,63145,1,1,2,0,4
79869,180,21183,27701;27985;30184,63145,1,0,2,0,3
79870,180,21184,27607;27777,63145,0,0,2,0,2
79871,180,21185,28031,63145,0,0,1,0,1
79872,180,21186,27785;27945;30014,63145,1,0,2,0,3
79873,180,21187,27801;27941,63145,0,0,2,0,2
79874,180,21188,23770,63510,0,0,0,1,1
79875,180,21189,23854,63510,0,0,0,1,1
79876,180,21191,23958;24195,63510,0,0,1,1,2
79877,180,21192,24023,63510,0,0,1,0,1
79878,180,21193,24049;24419,63510,0,0,2,0,2
79879,180,21194,23736,63510,0,0,0,1,1
79880,180,21196,24327,63510,0,0,1,0,1
79881,180,21197,24125;24166,63510,0,0,2,0,2
79882,180,21199,24212,63510,0,0,1,0,1
79883,180,21202,24134;24524,63510,0,0,2,0,2
79884,180,21203,24019,63510,0,0,1,0,1
79885,180,21205,24909;25223,63510,0,0,2,0,2
79886,180,21206,25191;25663,63510,0,0,2,0,2
79887,180,21211,25415;25495,63510,0,0,2,0,2
79888,180,21217,26277,63510,0,0,1,0,1
79889,180,21220,26389;26555;28587;28918;29957,63510,1,1,3,0,5
79890,180,21221,25992;26218;29164;29247;29327;29408,63510,0,4,2,0,6
79891,180,21222,26042;26425;29399;29760,63510,1,1,2,0,4
79892,180,21223,26632,63510,0,0,1,0,1
79893,180,21225,26910;29634,63510,0,1,1,0,2
79894,180,21226,26716,63510,0,0,1,0,1
79895,180,21227,26577;26620;28588;29348,63510,0,1,3,0,4
79896,180,21228,26378;26680;28675,63510,0,0,3,0,3
79897,180,21230,26809;27368,63510,0,0,2,0,2
79898,180,21232,26974;27435,63510,0,0,2,0,2
79899,180,21233,27004;27489;29730;30157,63510,1,1,2,0,4
79900,180,21234,27109,63510,0,0,1,0,1
79901,180,21235,27243;27605;30169,63510,1,0,2,0,3
79902,180,21236,27251;27548;29998,63510,1,0,2,0,3
79903,180,21238,27193;27300;29911;30069,63510,2,0,2,0,4
79904,180,21239,27307;27989,63510,0,0,2,0,2
79905,180,21241,27406;27467;29659;30076;30154,63510,2,1,2,0,5
79906,180,21242,27434;27731,63510,0,0,2,0,2
79907,180,21243,27095;27446;29386;29915;29991,63510,2,1,2,0,5
79908,180,21244,27463;27651;29742;30082,63510,1,1,2,0,4
79909,180,21245,27468;27637,63510,0,0,2,0,2
79910,180,21246,27627;28083;29748,63510,0,1,2,0,3
79911,180,21247,27508;27628;29578,63510,0,1,2,0,3
79912,180,21248,27535,63510,0,0,1,0,1
79913,180,21249,27383;27537,63510,0,0,2,0,2
79914,180,21250,27455;27558;29813;30153,63510,2,0,2,0,4
79915,180,21251,27550;27561;30078;30163,63510,2,0,2,0,4
79916,180,21252,27587;28099,63510,0,0,2,0,2
79917,180,21253,27599;27962;30089,63510,1,0,2,0,3
79918,180,21254,27624;27816;29745,63510,0,1,2,0,3
79919,180,21255,27669;27774,63510,0,0,2,0,2
79920,180,21256,27412;27672,63510,0,0,2,0,2
79921,180,21257,27385;27675,63510,0,0,2,0,2
79922,180,21258,27684;28129;29944;30187,63510,2,0,2,0,4
79923,180,21259,27687;30003,63510,1,0,1,0,2
79924,180,21260,27697;27706,63510,0,0,2,0,2
79925,180,21262,27613;27744;30081,63510,1,0,2,0,3
79926,180,21263,27746;27911;30182,63510,1,0,2,0,3
79927,180,21264,27761;28412,63510,0,0,2,0,2
79928,180,21265,27772;28038,63510,0,0,2,0,2
79929,180,21266,27784;28145,63510,0,0,2,0,2
79930,180,21267,27802;28160,63510,0,0,2,0,2
79931,180,21268,27524;27803;30010,63510,1,0,2,0,3
79932,180,21269,27641;27821;29933,63510,1,0,2,0,3
79933,180,21270,27713;27833,63510,0,0,2,0,2
79934,180,21271,27849,63510,0,0,1,0,1
79935,180,21272,27861;27908;29303;29391,63510,0,2,2,0,4
79936,180,21273,27863;28103,63510,0,0,2,0,2
79937,180,21274,27876;27977;29473,63510,0,1,2,0,3
79938,180,21275,27643;27877,63510,0,0,2,0,2
79939,180,21276,27880;28158,63510,0,0,2,0,2
79940,180,21277,27881;29583,63510,0,1,1,0,2
79941,180,21278,27737;27913;29822;30083,63510,2,0,2,0,4
79942,180,21279,27554;27925,63510,0,0,2,0,2
79943,180,21280,27822;27926;29829;30013,63510,2,0,2,0,4
79944,180,21281,24181,63875,0,0,1,0,1
79945,180,21282,23812,63875,0,0,0,1,1
79946,180,21283,23726,63875,0,0,0,1,1
79947,180,21284,24136,63875,0,0,1,0,1
79948,180,21285,24268,63875,0,0,1,0,1
79949,180,21288,24518;24952,63875,0,0,2,0,2
79950,180,21289,24206,63875,0,0,1,0,1
79951,180,21291,24578,63875,0,0,1,0,1
79952,180,21296,24706,63875,0,0,1,0,1
79953,180,21299,25166,63875,0,0,1,0,1
79954,180,21301,25324,63875,0,0,1,0,1
79955,180,21302,25100,63875,0,0,1,0,1
79956,180,21304,25395,63875,0,0,1,0,1
79957,180,21305,25504,63875,0,0,1,0,1
79958,180,21306,25178,63875,0,0,1,0,1
79959,180,21308,25797;25799,63875,0,0,2,0,2
79960,180,21309,25977;26230;29409;29600,63875,0,2,2,0,4
79961,180,21311,26109,63875,0,0,1,0,1
79962,180,21312,26125,63875,0,0,1,0,1
79963,180,21314,25982;26221,63875,0,0,2,0,2
79964,180,21315,26302,63875,0,0,1,0,1
79965,180,21316,26011,63875,0,0,1,0,1
79966,180,21317,26430,63875,0,0,1,0,1
79967,180,21318,26531,63875,0,0,1,0,1
79968,180,21319,26540,63875,0,0,1,0,1
79969,180,21321,26682;29181;29273;29777,63875,1,2,1,0,4
79970,180,21322,26811;27099;29119;29801,63875,1,1,2,0,4
79971,180,21324,26419;27090,63875,0,0,2,0,2
79972,180,21325,27202;27421;29812,63875,1,0,2,0,3
79973,180,21326,27206;27257;29380,63875,0,1,2,0,3
79974,180,21327,27259;29462;29654,63875,0,2,1,0,3
79975,180,21328,27292;27297;30142,63875,1,0,2,0,3
79976,180,21329,27326,63875,0,0,1,0,1
79977,180,21330,27339;27635,63875,0,0,2,0,2
79978,180,21331,27345,63875,0,0,1,0,1
79979,180,21332,27105;27358;29460;30072,63875,1,1,2,0,4
79980,180,21334,27381;28117,63875,0,0,2,0,2
79981,180,21335,27456;27584;29923,63875,1,0,2,0,3
79982,180,21336,27378;27420;30148,63875,1,0,2,0,3
79983,180,21337,27433;27698,63875,0,0,2,0,2
79984,180,21339,27519;27958,63875,0,0,2,0,2
79985,180,21340,27570;27681,63875,0,0,2,0,2
79986,180,21341,27583;27971,63875,0,0,2,0,2
79987,180,21342,27617;28259,63875,0,0,2,0,2
79988,180,21343,27619;27622,63875,0,0,2,0,2
79989,180,21344,27574,63875,0,0,1,0,1
79990,180,21345,27634;27961,63875,0,0,2,0,2
79991,180,21346,27640,63875,0,0,1,0,1
79992,180,21347,27658;27787;29582,63875,0,1,2,0,3
79993,180,21348,27671;28021,63875,0,0,2,0,2
79994,180,21349,27664;27711,63875,0,0,2,0,2
79995,180,21350,27712;27799,63875,0,0,2,0,2
79996,180,21351,27564;27755,63875,0,0,2,0,2
79997,180,21352,27387;28064,63875,0,0,2,0,2
79998,180,21353,27715;27773,63875,0,0,2,0,2
79999,180,21354,27783;27905,63875,0,0,2,0,2
80000,180,21355,27764;27944,63875,0,0,2,0,2
80001,180,21356,27736;27862,63875,0,0,2,0,2
80002,180,21357,27869;27887;29936,63875,1,0,2,0,3
80003,180,21358,27885;27972,63875,0,0,2,0,2
80004,180,21360,27916;30183,63875,1,0,1,0,2
80005,180,21361,28007;28119,63875,0,0,2,0,2
80006,180,21362,27808;27969,63875,0,0,2,0,2
80007,180,21363,27904;27979,63875,0,0,2,0,2
80008,180,21364,28018,63875,0,0,1,0,1
80009,180,21365,28273,63875,0,0,1,0,1
80010,180,21366,27782,63875,0,0,1,0,1
80011,180,21367,24237,64240,0,0,1,0,1
80012,180,21368,24121,64240,0,0,1,0,1
80013,180,21369,23787,64240,0,0,0,1,1
80014,180,21370,23920,64240,0,0,0,1,1
80015,180,21371,24303,64240,0,0,1,0,1
80016,180,21372,24454,64240,0,0,1,0,1
80017,180,21374,24254,64240,0,0,1,0,1
80018,180,21375,24262,64240,0,0,1,0,1
80019,180,21376,24696,64240,0,0,1,0,1
80020,180,21377,24095,64240,0,0,1,0,1
80021,180,21378,24522;24730,64240,0,0,2,0,2
80022,180,21381,24832;25004,64240,0,0,2,0,2
80023,180,21382,24132,64240,0,0,1,0,1
80024,180,21383,24924,64240,0,0,1,0,1
80025,180,21384,24496,64240,0,0,1,0,1
80026,180,21386,25231,64240,0,0,1,0,1
80027,180,21388,25118,64240,0,0,1,0,1
80028,180,21391,25448,64240,0,0,1,0,1
80029,180,21392,25500,64240,0,0,1,0,1
80030,180,21394,25545,64240,0,0,1,0,1
80031,180,21395,25391,64240,0,0,1,0,1
80032,180,21396,25704;25736,64240,0,0,2,0,2
80033,180,21397,25760;26030,64240,0,0,2,0,2
80034,180,21398,25472,64240,0,0,1,0,1
80035,180,21399,25800,64240,0,0,1,0,1
80036,180,21400,25828,64240,0,0,1,0,1
80037,180,21401,25976,64240,0,0,1,0,1
80038,180,21403,26217,64240,0,0,1,0,1
80039,180,21406,26390,64240,0,0,1,0,1
80040,180,21408,26455;26783;29278;29358;29696,64240,0,3,2,0,5
80041,180,21409,26641,64240,0,0,1,0,1
80042,180,21411,26379;26709;29531,64240,0,1,2,0,3
80043,180,21412,26732,64240,0,0,1,0,1
80044,180,21413,26741,64240,0,0,1,0,1
80045,180,21414,26748;27132;29566;29711,64240,0,2,2,0,4
80046,180,21415,26865;26870;28497;29113;29284;29550;29875;30119,64240,2,3,3,0,8
80047,180,21416,27028;27370;29989,64240,1,0,2,0,3
80048,180,21417,26906,64240,0,0,1,0,1
80049,180,21418,26937;27133;29973;30057,64240,2,0,2,0,4
80050,180,21419,27030;29371;29641,64240,0,2,1,0,3
80051,180,21420,27107,64240,0,0,1,0,1
80052,180,21421,26766,64240,0,0,1,0,1
80053,180,21422,27237;27363;29296;29385;29653,64240,0,3,2,0,5
80054,180,21423,27008;27271;29199,64240,0,1,2,0,3
80055,180,21424,27312;27377,64240,0,0,2,0,2
80056,180,21425,27418,64240,0,0,1,0,1
80057,180,21426,27518;27730,64240,0,0,2,0,2
80058,180,21427,27072;27544,64240,0,0,2,0,2
80059,180,21428,27308;27555;29468,64240,0,1,2,0,3
80060,180,21429,27315;27666;29579,64240,0,1,2,0,3
80061,180,21430,27689;27781;30085,64240,1,0,2,0,3
80062,180,21431,27707;27837,64240,0,0,2,0,2
80063,180,21432,27743;28090;29942,64240,1,0,2,0,3
80064,180,21433,27749;27750;29824,64240,1,0,2,0,3
80065,180,21434,27759;28093,64240,0,0,2,0,2
80066,180,21435,27763;27826;29471,64240,0,1,2,0,3
80067,180,21436,27779;27950,64240,0,0,2,0,2
80068,180,21437,27461;27798,64240,0,0,2,0,2
80069,180,21438,27854;27855,64240,0,0,2,0,2
80070,180,21439,28220,64240,0,0,1,0,1
80071,180,21440,27874;28124,64240,0,0,2,0,2
80072,180,21441,27899;28120,64240,0,0,2,0,2
80073,180,21442,27929;28344,64240,0,0,2,0,2
80074,180,21443,27934;28060,64240,0,0,2,0,2
80075,180,21444,27948;28155,64240,0,0,2,0,2
80076,180,21445,27949;28274,64240,0,0,2,0,2
80077,180,21446,27914;29827,64240,1,0,1,0,2
80078,180,21447,27952,64240,0,0,1,0,1
80079,180,21448,27960;28172,64240,0,0,2,0,2
80080,180,21449,27984;28407,64240,0,0,2,0,2
80081,180,21450,27655;27995,64240,0,0,2,0,2
80082,180,21451,27700,64240,0,0,1,0,1
80083,180,21452,28030;28041,64240,0,0,2,0,2
80084,180,21453,28045,64240,0,0,1,0,1
80085,180,21454,28055;28319,64240,0,0,2,0,2
80086,180,21455,28042;28058,64240,0,0,2,0,2
80087,180,21456,28061;28310,64240,0,0,2,0,2
80088,180,21457,28072;28197;29832,64240,1,0,2,0,3
80089,180,21458,28079;28347,64240,0,0,2,0,2
80090,180,21459,27825;28092,64240,0,0,2,0,2
80091,180,21460,28100;28390,64240,0,0,2,0,2
80092,180,21461,28106,64240,0,0,1,0,1
80093,180,21462,28086;28118,64240,0,0,2,0,2
80094,180,21463,27898;28125,64240,0,0,2,0,2
80095,180,21464,24128,64605,0,0,1,0,1
80096,180,21465,23721,64605,0,0,0,1,1
80097,180,21466,23965,64605,0,0,0,1,1
80098,180,21468,24211,64605,0,0,1,0,1
80099,180,21469,24245,64605,0,0,1,0,1
80100,180,21470,23902,64605,0,0,0,1,1
80101,180,21471,23945,64605,0,0,0,1,1
80102,180,21472,24221;24310,64605,0,0,2,0,2
80103,180,21474,24835;24885,64605,0,0,2,0,2
80104,180,21475,24882,64605,0,0,1,0,1
80105,180,21476,24727,64605,0,0,1,0,1
80106,180,21478,24763,64605,0,0,1,0,1
80107,180,21482,25098,64605,0,0,1,0,1
80108,180,21483,25184,64605,0,0,1,0,1
80109,180,21484,25285,64605,0,0,1,0,1
80110,180,21485,25325;25563;28378,64605,0,0,3,0,3
80111,180,21486,25668,64605,0,0,1,0,1
80112,180,21487,25734;25901,64605,0,0,2,0,2
80113,180,21489,25864;26471,64605,0,0,2,0,2
80114,180,21490,26231;28814,64605,0,1,1,0,2
80115,180,21491,25906,64605,0,0,1,0,1
80116,180,21492,26029,64605,0,0,1,0,1
80117,180,21493,26445,64605,0,0,1,0,1
80118,180,21495,26442,64605,0,0,1,0,1
80119,180,21497,26679,64605,0,0,1,0,1
80120,180,21498,26718;27356,64605,0,0,2,0,2
80121,180,21499,26746,64605,0,0,1,0,1
80122,180,21500,26650;27021;29370,64605,0,1,2,0,3
80123,180,21501,27035;27184,64605,0,0,2,0,2
80124,180,21502,27210,64605,0,0,1,0,1
80125,180,21503,27216;27477;29727;30155,64605,1,1,2,0,4
80126,180,21504,26887,64605,0,0,1,0,1
80127,180,21505,27324;27581,64605,0,0,2,0,2
80128,180,21506,27382;27625;29738,64605,0,1,2,0,3
80129,180,21507,27388;27618,64605,0,0,2,0,2
80130,180,21508,27539;29733;30077,64605,1,1,1,0,3
80131,180,21509,27516;27900,64605,0,0,2,0,2
80132,180,21510,27553;28050,64605,0,0,2,0,2
80133,180,21511,27530;27578,64605,0,0,2,0,2
80134,180,21512,27609;27933,64605,0,0,2,0,2
80135,180,21513,27422;27703;29301;29821,64605,1,1,2,0,4
80136,180,21514,27751;28123,64605,0,0,2,0,2
80137,180,21515,27453,64605,0,0,1,0,1
80138,180,21516,27786;28252,64605,0,0,2,0,2
80139,180,21517,27788;28130,64605,0,0,2,0,2
80140,180,21518,27794;27903,64605,0,0,2,0,2
80141,180,21519,27485;27823,64605,0,0,2,0,2
80142,180,21520,27844;28214,64605,0,0,2,0,2
80143,180,21521,27857;28026,64605,0,0,2,0,2
80144,180,21522,27859;28284,64605,0,0,2,0,2
80145,180,21523,27766,64605,0,0,1,0,1
80146,180,21524,27906;28135,64605,0,0,2,0,2
80147,180,21525,27912;28054,64605,0,0,2,0,2
80148,180,21526,27964;27975,64605,0,0,2,0,2
80149,180,21527,27966,64605,0,0,1,0,1
80150,180,21528,27939;28358,64605,0,0,2,0,2
80151,180,21529,27815;28022,64605,0,0,2,0,2
80152,180,21530,28051;28268,64605,0,0,2,0,2
80153,180,21531,27889;28056;30092;30186,64605,2,0,2,0,4
80154,180,21532,28062;28116;29941,64605,1,0,2,0,3
80155,180,21533,28065;28076,64605,0,0,2,0,2
80156,180,21534,28081;28095,64605,0,0,2,0,2
80157,180,21535,28032;28133;29833,64605,1,0,2,0,3
80158,180,21536,28138;28471,64605,0,0,2,0,2
80159,180,21537,28141;28299,64605,0,0,2,0,2
80160,180,21538,28159;28200;29834,64605,1,0,2,0,3
80161,180,21539,27902;28170,64605,0,0,2,0,2
80162,180,21540,28080;28175,64605,0,0,2,0,2
80163,180,21541,28179;28271,64605,0,0,2,0,2
80164,180,21542,28199;28372,64605,0,0,2,0,2
80165,180,21543,28208,64605,0,0,1,0,1
80166,180,21544,28210,64605,0,0,1,0,1
80167,180,21545,28223;28329,64605,0,0,2,0,2
80168,180,21546,28174;28227,64605,0,0,2,0,2
80169,180,21547,24448,64970,0,0,1,0,1
80170,180,21548,24465,64970,0,0,1,0,1
80171,180,21549,24072,64970,0,0,1,0,1
80172,180,21550,24617,64970,0,0,1,0,1
80173,180,21551,24443,64970,0,0,1,0,1
80174,180,21552,24754,64970,0,0,1,0,1
80175,180,21554,24366,64970,0,0,1,0,1
80176,180,21555,24903,64970,0,0,1,0,1
80177,180,21556,25030,64970,0,0,1,0,1
80178,180,21557,25076,64970,0,0,1,0,1
80179,180,21558,24987;25123,64970,0,0,2,0,2
80180,180,21559,25340,64970,0,0,1,0,1
80181,180,21560,25496,64970,0,0,1,0,1
80182,180,21561,25569,64970,0,0,1,0,1
80183,180,21563,25690,64970,0,0,1,0,1
80184,180,21566,26080,64970,0,0,1,0,1
80185,180,21567,26044,64970,0,0,1,0,1
80186,180,21569,26053,64970,0,0,1,0,1
80187,180,21570,25844,64970,0,0,1,0,1
80188,180,21572,26254,64970,0,0,1,0,1
80189,180,21574,26950,64970,0,0,1,0,1
80190,180,21575,26845;26852,64970,0,0,2,0,2
80191,180,21576,26915;27437;29573;30151,64970,1,1,2,0,4
80192,180,21577,27046,64970,0,0,1,0,1
80193,180,21578,26627;26752;29773;30034,64970,2,0,2,0,4
80194,180,21580,27265;27636;29819;29926,64970,2,0,2,0,4
80195,180,21581,27298;27597;29818,64970,1,0,2,0,3
80196,180,21582,27340,64970,0,0,1,0,1
80197,180,21583,27364;27507;30160,64970,1,0,2,0,3
80198,180,21584,27404;27756,64970,0,0,2,0,2
80199,180,21585,27438;27479;29387;29728;29918;29995,64970,2,2,2,0,6
80200,180,21586,27229;27451;30152,64970,1,0,2,0,3
80201,180,21587,27475,64970,0,0,1,0,1
80202,180,21588,27503;28033;29831,64970,1,0,2,0,3
80203,180,21589,27559,64970,0,0,1,0,1
80204,180,21590,27562;27724;29664;30177,64970,1,1,2,0,4
80205,180,21591,27427,64970,0,0,1,0,1
80206,180,21592,27593;27668,64970,0,0,2,0,2
80207,180,21593,27660;28198,64970,0,0,2,0,2
80208,180,21594,27676;28006,64970,0,0,2,0,2
80209,180,21595,27499,64970,0,0,1,0,1
80210,180,21596,27770;27864;30011,64970,1,0,2,0,3
80211,180,21597,27500;27789;30086,64970,1,0,2,0,3
80212,180,21598,27602;27867,64970,0,0,2,0,2
80213,180,21599,27659;27868;30181,64970,1,0,2,0,3
80214,180,21600,27872;28004,64970,0,0,2,0,2
80215,180,21601,27873;28184,64970,0,0,2,0,2
80216,180,21602,27938;28173,64970,0,0,2,0,2
80217,180,21603,27943;28485,64970,0,0,2,0,2
80218,180,21604,27951,64970,0,0,1,0,1
80219,180,21605,27956;28534,64970,0,0,2,0,2
80220,180,21606,27970;28057;29940,64970,1,0,2,0,3
80221,180,21607,27974;28110,64970,0,0,2,0,2
80222,180,21608,27998,64970,0,0,1,0,1
80223,180,21609,27717,64970,0,0,1,0,1
80224,180,21610,28020,64970,0,0,1,0,1
80225,180,21611,28035;28540,64970,0,0,2,0,2
80226,180,21612,28052;28416,64970,0,0,2,0,2
80227,180,21613,28053,64970,0,0,1,0,1
80228,180,21614,28068;28218,64970,0,0,2,0,2
80229,180,21615,28097;28205;30017,64970,1,0,2,0,3
80230,180,21616,28105;28479,64970,0,0,2,0,2
80231,180,21617,28107,64970,0,0,1,0,1
80232,180,21618,28112,64970,0,0,1,0,1
80233,180,21619,28163;28221,64970,0,0,2,0,2
80234,180,21620,28238,64970,0,0,1,0,1
80235,180,21621,28246;28518,64970,0,0,2,0,2
80236,180,21622,28254;28423;30194,64970,1,0,2,0,3
80237,180,21623,28262;28264;30020,64970,1,0,2,0,3
80238,180,21624,28142;28291,64970,0,0,2,0,2
80239,180,21625,27983;28295;30190,64970,1,0,2,0,3
80240,180,21626,28311;28578,64970,0,0,2,0,2
80241,180,21627,24383,65335,0,0,1,0,1
80242,180,21628,24651;24674,65335,0,0,2,0,2
80243,180,21629,24951,65335,0,0,1,0,1
80244,180,21631,24143,65335,0,0,1,0,1
80245,180,21632,25028,65335,0,0,1,0,1
80246,180,21633,24953,65335,0,0,1,0,1
80247,180,21634,24910,65335,0,0,1,0,1
80248,180,21635,25173,65335,0,0,1,0,1
80249,180,21636,24891,65335,0,0,1,0,1
80250,180,21637,25011,65335,0,0,1,0,1
80251,180,21639,25380,65335,0,0,1,0,1
80252,180,21640,25388,65335,0,0,1,0,1
80253,180,21641,25393,65335,0,0,1,0,1
80254,180,21642,25627,65335,0,0,1,0,1
80255,180,21644,25851,65335,0,0,1,0,1
80256,180,21645,25868,65335,0,0,1,0,1
80257,180,21646,25826,65335,0,0,1,0,1
80258,180,21647,26006,65335,0,0,1,0,1
80259,180,21648,26008,65335,0,0,1,0,1
80260,180,21649,25908,65335,0,0,1,0,1
80261,180,21650,26296,65335,0,0,1,0,1
80262,180,21651,26305,65335,0,0,1,0,1
80263,180,21652,26420,65335,0,0,1,0,1
80264,180,21653,26624;26878,65335,0,0,2,0,2
80265,180,21654,26645,65335,0,0,1,0,1
80266,180,21655,26696,65335,0,0,1,0,1
80267,180,21656,26616;26799;29347;29424;29615,65335,0,3,2,0,5
80268,180,21657,26884,65335,0,0,1,0,1
80269,180,21658,26597,65335,0,0,1,0,1
80270,180,21659,26739,65335,0,0,1,0,1
80271,180,21660,27164,65335,0,0,1,0,1
80272,180,21661,27117,65335,0,0,1,0,1
80273,180,21662,27195,65335,0,0,1,0,1
80274,180,21663,27213;27409,65335,0,0,2,0,2
80275,180,21664,26966,65335,0,0,1,0,1
80276,180,21665,27228,65335,0,0,1,0,1
80277,180,21666,27283,65335,0,0,1,0,1
80278,180,21667,27509,65335,0,0,1,0,1
80279,180,21668,27351,65335,0,0,1,0,1
80280,180,21669,27348,65335,0,0,1,0,1
80281,180,21671,27630,65335,0,0,1,0,1
80282,180,21672,28363,65335,0,0,1,0,1
80283,180,21673,27309,65335,0,0,1,0,1
80284,180,21674,28217,65335,0,0,1,0,1
80285,180,21675,27527,65335,0,0,1,0,1
80286,180,21676,27853;27980;29666,65335,0,1,2,0,3
80287,180,21677,27754;27879,65335,0,0,2,0,2
80288,180,21678,27892;28084,65335,0,0,2,0,2
80289,180,21679,27901;29747,65335,0,1,1,0,2
80290,180,21680,27878;27915,65335,0,0,2,0,2
80291,180,21681,27817;28003,65335,0,0,2,0,2
80292,180,21682,27968,65335,0,0,1,0,1
80293,180,21683,27997;28297;29752,65335,0,1,2,0,3
80294,180,21684,28049;28280,65335,0,0,2,0,2
80295,180,21685,27850,65335,0,0,1,0,1
80296,180,21686,28082;28326,65335,0,0,2,0,2
80297,180,21687,28104;28230,65335,0,0,2,0,2
80298,180,21688,28108;28466,65335,0,0,2,0,2
80299,180,21689,28132,65335,0,0,1,0,1
80300,180,21690,28144,65335,0,0,1,0,1
80301,180,21691,28178;28524,65335,0,0,2,0,2
80302,180,21692,27860,65335,0,0,1,0,1
80303,180,21693,28224;28377,65335,0,0,2,0,2
80304,180,21694,27841;28239,65335,0,0,2,0,2
80305,180,21695,28241;28301;30095,65335,1,0,2,0,3
80306,180,21696,28245,65335,0,0,1,0,1
80307,180,21697,28251;28375,65335,0,0,2,0,2
80308,180,21698,28122;28257,65335,0,0,2,0,2
80309,180,21699,28187;28258,65335,0,0,2,0,2
80310,180,21700,28279,65335,0,0,1,0,1
80311,180,21701,28151;28294,65335,0,0,2,0,2
80312,180,21702,28303;30021,65335,1,0,1,0,2
80313,180,21703,28341;28643,65335,0,0,2,0,2
80314,180,21704,28349;28616,65335,0,0,2,0,2
80315,180,21705,28307;28353,65335,0,0,2,0,2
80316,180,21706,28014,65335,0,0,1,0,1
80317,180,21707,28365;28644,65335,0,0,2,0,2
80318,180,21708,28367;28677,65335,0,0,2,0,2
80319,180,21709,28371;28595,65335,0,0,2,0,2
80320,180,21710,28374;28679,65335,0,0,2,0,2
80321,180,21711,28386;28626,65335,0,0,2,0,2
80322,180,21712,28213;28393,65335,0,0,2,0,2
80323,180,21713,28395;28482,65335,0,0,2,0,2
80324,180,21714,28408;28656;30025,65335,1,0,2,0,3
80325,180,21715,24615,65700,0,0,1,0,1
80326,180,21716,24637,65700,0,0,1,0,1
80327,180,21717,24663,65700,0,0,1,0,1
80328,180,21718,24675,65700,0,0,1,0,1
80329,180,21719,24682,65700,0,0,1,0,1
80330,180,21720,24461,65700,0,0,1,0,1
80331,180,21721,24895,65700,0,0,1,0,1
80332,180,21722,24956,65700,0,0,1,0,1
80333,180,21723,24989,65700,0,0,1,0,1
80334,180,21724,24716,65700,0,0,1,0,1
80335,180,21725,25041,65700,0,0,1,0,1
80336,180,21726,24779,65700,0,0,1,0,1
80337,180,21727,25297,65700,0,0,1,0,1
80338,180,21728,25312,65700,0,0,1,0,1
80339,180,21729,25368,65700,0,0,1,0,1
80340,180,21730,25421,65700,0,0,1,0,1
80341,180,21731,25488,65700,0,0,1,0,1
80342,180,21732,25228,65700,0,0,1,0,1
80343,180,21733,25503,65700,0,0,1,0,1
80344,180,21734,25115,65700,0,0,1,0,1
80345,180,21735,25534,65700,0,0,1,0,1
80346,180,21736,25674,65700,0,0,1,0,1
80347,180,21737,26172,65700,0,0,1,0,1
80348,180,21738,25971,65700,0,0,1,0,1
80349,180,21739,26287,65700,0,0,1,0,1
80350,180,21740,26324,65700,0,0,1,0,1
80351,180,21741,25978,65700,0,0,1,0,1
80352,180,21742,26336,65700,0,0,1,0,1
80353,180,21743,27013,65700,0,0,1,0,1
80354,180,21744,27045,65700,0,0,1,0,1
80355,180,21745,27252,65700,0,0,1,0,1
80356,180,21746,27349,65700,0,0,1,0,1
80357,180,21747,27192;27417,65700,0,0,2,0,2
80358,180,21748,27431,65700,0,0,1,0,1
80359,180,21750,27514,65700,0,0,1,0,1
80360,180,21751,27156;27523;29575,65700,0,1,2,0,3
80361,180,21752,27366,65700,0,0,1,0,1
80362,180,21753,27601;28017,65700,0,0,2,0,2
80363,180,21754,27310;27644,65700,0,0,2,0,2
80364,180,21755,27740,65700,0,0,1,0,1
80365,180,21756,27741,65700,0,0,1,0,1
80366,180,21757,27771,65700,0,0,1,0,1
80367,180,21758,27791;27894,65700,0,0,2,0,2
80368,180,21759,27569;27852;30180,65700,1,0,2,0,3
80369,180,21760,27927,65700,0,0,1,0,1
80370,180,21761,27988;27992;29474;29939,65700,1,1,2,0,4
80371,180,21762,28002;28015;29830;30015;30185,65700,3,0,2,0,5
80372,180,21763,28009;28457,65700,0,0,2,0,2
80373,180,21764,28012;28192,65700,0,0,2,0,2
80374,180,21765,27702;28044,65700,0,0,2,0,2
80375,180,21766,28010;28048,65700,0,0,2,0,2
80376,180,21767,28162,65700,0,0,1,0,1
80377,180,21768,28206;28500,65700,0,0,2,0,2
80378,180,21769,28240;28267,65700,0,0,2,0,2
80379,180,21770,28433,65700,0,0,1,0,1
80380,180,21771,28270,65700,0,0,1,0,1
80381,180,21772,28288;28493,65700,0,0,2,0,2
80382,180,21773,27999;28292,65700,0,0,2,0,2
80383,180,21774,28362;28601,65700,0,0,2,0,2
80384,180,21775,27590,65700,0,0,1,0,1
80385,180,21776,28380;28638,65700,0,0,2,0,2
80386,180,21777,27963;28388;29945,65700,1,0,2,0,3
80387,180,21778,28405;28415,65700,0,0,2,0,2
80388,180,21779,27959;28411,65700,0,0,2,0,2
80389,180,21780,28256,65700,0,0,1,0,1
80390,180,21781,28435;28576,65700,0,0,2,0,2
80391,180,21782,28342;28440,65700,0,0,2,0,2
80392,180,21783,28149;28445;30196,65700,1,0,2,0,3
80393,180,21784,28450;28560,65700,0,0,2,0,2
80394,180,21785,28451;28600,65700,0,0,2,0,2
80395,180,21786,28356;28452,65700,0,0,2,0,2
80396,180,21787,28453;28730,65700,0,1,1,0,2
80397,180,21788,28337;28456,65700,0,0,2,0,2
80398,180,21789,27996;28467,65700,0,0,2,0,2
80399,180,21790,28470;28550,65700,0,0,2,0,2
80400,180,21791,28474;28607,65700,0,0,2,0,2
80401,190,12353,22393,29565,0,0,0,1,1
80402,190,12642,27135;29196;29294;29899;30137;30313;30584,30660,0,4,3,0,7
80403,190,13737,23377;23472,34675,0,0,0,2,2
80404,190,13915,23147,35405,0,0,0,1,1
80405,190,14173,23512,36135,0,0,0,1,1
80406,190,14700,23344;23960;24084,37960,0,0,0,3,3
80407,190,15070,21184,39420,0,0,0,1,1
80408,190,15152,24235,39785,0,0,0,1,1
80409,190,15153,23769,39785,0,0,0,1,1
80410,190,15157,23588;24343,39785,0,0,0,2,2
80411,190,15176,25024;25076,39785,0,0,0,2,2
80412,190,15251,20972,40150,0,0,0,1,1
80413,190,15350,24770;25005,40515,0,0,0,2,2
80414,190,15352,21525,40515,0,0,0,1,1
80415,190,15370,21252,40515,0,0,0,1,1
80416,190,15402,22945;23107,40880,0,0,0,2,2
80417,190,15406,23688,40880,0,0,0,1,1
80418,190,15427,24459,40880,0,0,0,1,1
80419,190,15445,21077,40880,0,0,0,1,1
80420,190,15449,21140,40880,0,0,0,1,1
80421,190,15461,21878,40880,0,0,0,1,1
80422,190,15497,22953;23182,41245,0,0,0,2,2
80423,190,15536,25742;26481;29606;29766,41245,0,2,2,0,4
80424,190,15545,21352,41245,0,0,0,1,1
80425,190,15551,21168,41245,0,0,0,1,1
80426,190,15564,25014;25055,41245,0,0,0,2,2
80427,190,15569,21833,41245,0,0,0,1,1
80428,190,15648,24830;24905,41610,0,0,0,2,2
80429,190,15660,22036,41610,0,0,0,1,1
80430,190,15662,21483,41610,0,0,0,1,1
80431,190,15666,21772,41610,0,0,0,1,1
80432,190,15709,23968;24453;24944,41975,0,0,0,3,3
80433,190,15717,21218,41975,0,0,0,1,1
80434,190,15740,21590,41975,0,0,0,1,1
80435,190,15743,21284,41975,0,0,0,1,1
80436,190,15747,21381,41975,0,0,0,1,1
80437,190,15751,21539,41975,0,0,0,1,1
80438,190,15755,21970,41975,0,0,0,1,1
80439,190,15760,21707,41975,0,0,0,1,1
80440,190,15835,21830,42340,0,0,0,1,1
80441,190,15851,21722,42340,0,0,0,1,1
80442,190,15860,22121,42340,0,0,0,1,1
80443,190,15861,21820,42340,0,0,0,1,1
80444,190,15919,21416,42705,0,0,0,1,1
80445,190,15927,22175,42705,0,0,0,1,1
80446,190,15935,21484,42705,0,0,0,1,1
80447,190,15936,22356,42705,0,0,0,1,1
80448,190,15938,21766;22013,42705,0,0,0,2,2
80449,190,15940,21917,42705,0,0,0,1,1
80450,190,15948,21911,42705,0,0,0,1,1
80451,190,15950,22237,42705,0,0,0,1,1
80452,190,15955,22196,42705,0,0,0,1,1
80453,190,15958,22009,42705,0,0,0,1,1
80454,190,15961,21881;21892,42705,0,0,0,2,2
80455,190,15963,21880,42705,0,0,0,1,1
80456,190,15966,21977,42705,0,0,0,1,1
80457,190,15967,22023,42705,0,0,0,1,1
80458,190,16017,21390,43070,0,0,0,1,1
80459,190,16029,21282,43070,0,0,0,1,1
80460,190,16032,21329,43070,0,0,0,1,1
80461,190,16040,21988,43070,0,0,0,1,1
80462,190,16045,21989;22236,43070,0,0,0,2,2
80463,190,16049,21771,43070,0,0,0,1,1
80464,190,16050,21775,43070,0,0,0,1,1
80465,190,16051,22354,43070,0,0,0,1,1
80466,190,16056,21883,43070,0,0,0,1,1
80467,190,16057,22073,43070,0,0,0,1,1
80468,190,16060,22178,43070,0,0,0,1,1
80469,190,16062,22010,43070,0,0,0,1,1
80470,190,16063,22287,43070,0,0,0,1,1
80471,190,16064,22045,43070,0,0,0,1,1
80472,190,16066,22584,43070,0,0,0,1,1
80473,190,16069,22111,43070,0,0,0,1,1
80474,190,16072,22146,43070,0,0,0,1,1
80475,190,16127,21459,43435,0,0,0,1,1
80476,190,16134,21975,43435,0,0,0,1,1
80477,190,16135,21902,43435,0,0,0,1,1
80478,190,16150,25255,43435,0,0,1,0,1
80479,190,16151,22261,43435,0,0,0,1,1
80480,190,16154,22091,43435,0,0,0,1,1
80481,190,16155,22120;22306,43435,0,0,0,2,2
80482,190,16157,22410,43435,0,0,0,1,1
80483,190,16161,22305,43435,0,0,0,1,1
80484,190,16162,22076;22299,43435,0,0,0,2,2
80485,190,16168,22162,43435,0,0,0,1,1
80486,190,16169,22478,43435,0,0,0,1,1
80487,190,16174,22267,43435,0,0,0,1,1
80488,190,16239,21735,43800,0,0,0,1,1
80489,190,16240,22212,43800,0,0,0,1,1
80490,190,16241,21643,43800,0,0,0,1,1
80491,190,16251,25669;26111,43800,0,0,2,0,2
80492,190,16252,21856,43800,0,0,0,1,1
80493,190,16255,22099,43800,0,0,0,1,1
80494,190,16258,22266,43800,0,0,0,1,1
80495,190,16259,21891,43800,0,0,0,1,1
80496,190,16265,22474,43800,0,0,0,1,1
80497,190,16267,21776;22303,43800,0,0,0,2,2
80498,190,16268,22169,43800,0,0,0,1,1
80499,190,16270,22208,43800,0,0,0,1,1
80500,190,16271,22154,43800,0,0,0,1,1
80501,190,16272,22138,43800,0,0,0,1,1
80502,190,16276,22680,43800,0,0,0,1,1
80503,190,16278,22252,43800,0,0,0,1,1
80504,190,16279,22542,43800,0,0,0,1,1
80505,190,16283,22493;22613,43800,0,0,0,2,2
80506,190,16284,22471,43800,0,0,0,1,1
80507,190,16285,26507;26696,43800,0,0,2,0,2
80508,190,16286,22379,43800,0,0,0,1,1
80509,190,16288,26232;26563;29102,43800,0,0,3,0,3
80510,190,16314,24647;25083,44165,0,0,0,2,2
80511,190,16329,21981,44165,0,0,0,1,1
80512,190,16330,22117,44165,0,0,0,1,1
80513,190,16333,22015,44165,0,0,0,1,1
80514,190,16336,21786,44165,0,0,0,1,1
80515,190,16337,21789,44165,0,0,0,1,1
80516,190,16338,21824,44165,0,0,0,1,1
80517,190,16340,21943,44165,0,0,0,1,1
80518,190,16341,21538,44165,0,0,0,1,1
80519,190,16342,22044,44165,0,0,0,1,1
80520,190,16350,22543,44165,0,0,0,1,1
80521,190,16351,22662,44165,0,0,0,1,1
80522,190,16353,25957;26026,44165,0,0,2,0,2
80523,190,16355,22547,44165,0,0,0,1,1
80524,190,16360,22489,44165,0,0,0,1,1
80525,190,16393,21620,44530,0,0,0,1,1
80526,190,16400,21535,44530,0,0,0,1,1
80527,190,16402,21514,44530,0,0,0,1,1
80528,190,16406,25288;25556;28704,44530,0,0,3,0,3
80529,190,16410,22150,44530,0,0,0,1,1
80530,190,16412,21793,44530,0,0,0,1,1
80531,190,16415,22273,44530,0,0,0,1,1
80532,190,16421,22335,44530,0,0,0,1,1
80533,190,16423,22894,44530,0,0,0,1,1
80534,190,16424,22119;22307,44530,0,0,0,2,2
80535,190,16426,22280,44530,0,0,0,1,1
80536,190,16430,22358,44530,0,0,0,1,1
80537,190,16431,22372;22440,44530,0,0,0,2,2
80538,190,16436,22491;22527,44530,0,0,0,2,2
80539,190,16437,22717,44530,0,0,0,1,1
80540,190,16439,22550,44530,0,0,0,1,1
80541,190,16442,22870,44530,0,0,0,1,1
80542,190,16443,22325;22588,44530,0,0,0,2,2
80543,190,16444,22567,44530,0,0,0,1,1
80544,190,16504,22283,44895,0,0,0,1,1
80545,190,16505,22018,44895,0,0,0,1,1
80546,190,16506,22428,44895,0,0,0,1,1
80547,190,16508,25272,44895,0,0,1,0,1
80548,190,16511,22424,44895,0,0,0,1,1
80549,190,16515,22458,44895,0,0,0,1,1
80550,190,16518,22202,44895,0,0,0,1,1
80551,190,16520,22496,44895,0,0,0,1,1
80552,190,16523,22671,44895,0,0,0,1,1
80553,190,16524,22349,44895,0,0,0,1,1
80554,190,16526,22765,44895,0,0,0,1,1
80555,190,16527,23856;24530;27776,44895,0,0,1,2,3
80556,190,16531,22838,44895,0,0,0,1,1
80557,190,16532,22386,44895,0,0,0,1,1
80558,190,16535,23007,44895,0,0,0,1,1
80559,190,16537,22503,44895,0,0,0,1,1
80560,190,16540,22461,44895,0,0,0,1,1
80561,190,16541,22479,44895,0,0,0,1,1
80562,190,16544,22612,44895,0,0,0,1,1
80563,190,16545,22304;22630,44895,0,0,0,2,2
80564,190,16546,22601;23011,44895,0,0,0,2,2
80565,190,16548,22435,44895,0,0,0,1,1
80566,190,16550,22618,44895,0,0,0,1,1
80567,190,16551,22719;22790,44895,0,0,0,2,2
80568,190,16552,22929,44895,0,0,0,1,1
80569,190,16554,22695,44895,0,0,0,1,1
80570,190,16555,22209,44895,0,0,0,1,1
80571,190,16556,22720,44895,0,0,0,1,1
80572,190,16611,22591,45260,0,0,0,1,1
80573,190,16614,22226,45260,0,0,0,1,1
80574,190,16616,22322,45260,0,0,0,1,1
80575,190,16619,22634,45260,0,0,0,1,1
80576,190,16622,22817,45260,0,0,0,1,1
80577,190,16623,22688,45260,0,0,0,1,1
80578,190,16627,22296,45260,0,0,0,1,1
80579,190,16628,22346;22645,45260,0,0,0,2,2
80580,190,16629,22350,45260,0,0,0,1,1
80581,190,16630,22741,45260,0,0,0,1,1
80582,190,16631,22752,45260,0,0,0,1,1
80583,190,16632,22434,45260,0,0,0,1,1
80584,190,16636,22575,45260,0,0,0,1,1
80585,190,16639,22833,45260,0,0,0,1,1
80586,190,16641,22433;22823,45260,0,0,0,2,2
80587,190,16647,22811,45260,0,0,0,1,1
80588,190,16648,23034,45260,0,0,0,1,1
80589,190,16698,21373,45625,0,0,0,1,1
80590,190,16701,21355,45625,0,0,0,1,1
80591,190,16703,22184,45625,0,0,0,1,1
80592,190,16706,21893,45625,0,0,0,1,1
80593,190,16711,25231;25408,45625,0,0,2,0,2
80594,190,16715,22186,45625,0,0,0,1,1
80595,190,16718,22659,45625,0,0,0,1,1
80596,190,16719,21628;22160,45625,0,0,0,2,2
80597,190,16728,22648,45625,0,0,0,1,1
80598,190,16731,22197;22431,45625,0,0,0,2,2
80599,190,16732,22445;22519,45625,0,0,0,2,2
80600,190,16733,22853,45625,0,0,0,1,1
80601,190,16734,22514,45625,0,0,0,1,1
80602,190,16736,22545;22669,45625,0,0,0,2,2
80603,190,16737,22616,45625,0,0,0,1,1
80604,190,16739,22200;22624,45625,0,0,0,2,2
80605,190,16740,22967,45625,0,0,0,1,1
80606,190,16745,23068,45625,0,0,0,1,1
80607,190,16749,22571,45625,0,0,0,1,1
80608,190,16751,22832,45625,0,0,0,1,1
80609,190,16752,22979;23178,45625,0,0,0,2,2
80610,190,16755,22925,45625,0,0,0,1,1
80611,190,16757,23027;23169,45625,0,0,0,2,2
80612,190,16759,22909,45625,0,0,0,1,1
80613,190,16760,26763;27005;28838;29289;29794,45625,0,1,4,0,5
80614,190,16761,23098,45625,0,0,0,1,1
80615,190,16808,21783,45990,0,0,0,1,1
80616,190,16812,21553,45990,0,0,0,1,1
80617,190,16819,22524,45990,0,0,0,1,1
80618,190,16821,22205,45990,0,0,0,1,1
80619,190,16822,22217,45990,0,0,0,1,1
80620,190,16829,22467,45990,0,0,0,1,1
80621,190,16832,22738,45990,0,0,0,1,1
80622,190,16833,22709,45990,0,0,0,1,1
80623,190,16837,22564;22587,45990,0,0,0,2,2
80624,190,16838,23125,45990,0,0,0,1,1
80625,190,16839,22728,45990,0,0,0,1,1
80626,190,16841,22698,45990,0,0,0,1,1
80627,190,16842,22994,45990,0,0,0,1,1
80628,190,16843,22727,45990,0,0,0,1,1
80629,190,16844,22743,45990,0,0,0,1,1
80630,190,16846,22846,45990,0,0,0,1,1
80631,190,16848,22450,45990,0,0,0,1,1
80632,190,16849,22827,45990,0,0,0,1,1
80633,190,16850,22640,45990,0,0,0,1,1
80634,190,16851,22868;23324,45990,0,0,0,2,2
80635,190,16852,23296;26943,45990,0,0,1,1,2
80636,190,16853,22891,45990,0,0,0,1,1
80637,190,16854,22910;23103,45990,0,0,0,2,2
80638,190,16855,23047,45990,0,0,0,1,1
80639,190,16856,23315,45990,0,0,0,1,1
80640,190,16857,22952,45990,0,0,0,1,1
80641,190,16858,23247,45990,0,0,0,1,1
80642,190,16859,22611,45990,0,0,0,1,1
80643,190,16860,23314,45990,0,0,0,1,1
80644,190,16862,23023,45990,0,0,0,1,1
80645,190,16896,21574,46355,0,0,0,1,1
80646,190,16905,22244;22254,46355,0,0,0,2,2
80647,190,16910,21487,46355,0,0,0,1,1
80648,190,16911,22460,46355,0,0,0,1,1
80649,190,16918,22724,46355,0,0,0,1,1
80650,190,16920,22777,46355,0,0,0,1,1
80651,190,16926,22736,46355,0,0,0,1,1
80652,190,16928,22942,46355,0,0,0,1,1
80653,190,16930,22852,46355,0,0,0,1,1
80654,190,16932,25900;26032;26353;26451;28972;29955,46355,0,1,5,0,6
80655,190,16934,22831;22966,46355,0,0,0,2,2
80656,190,16935,22841;23085,46355,0,0,0,2,2
80657,190,16937,22867,46355,0,0,0,1,1
80658,190,16938,23149,46355,0,0,0,1,1
80659,190,16939,22415;23181,46355,0,0,0,2,2
80660,190,16940,22922,46355,0,0,0,1,1
80661,190,16941,22916;22936;30273,46355,0,1,0,2,3
80662,190,16942,22956;23278,46355,0,0,0,2,2
80663,190,16943,22521;22970,46355,0,0,0,2,2
80664,190,16944,23002;23040,46355,0,0,0,2,2
80665,190,16945,23006,46355,0,0,0,1,1
80666,190,16946,23269,46355,0,0,0,1,1
80667,190,16947,22978,46355,0,0,0,1,1
80668,190,16949,22770;23095,46355,0,0,0,2,2
80669,190,16950,23077,46355,0,0,0,1,1
80670,190,16951,23056;23093,46355,0,0,0,2,2
80671,190,16954,23321,46355,0,0,0,1,1
80672,190,17013,22298,46720,0,0,0,1,1
80673,190,17014,22294,46720,0,0,0,1,1
80674,190,17015,22156,46720,0,0,0,1,1
80675,190,17022,22418,46720,0,0,0,1,1
80676,190,17023,26403;26619,46720,0,0,2,0,2
80677,190,17025,22452,46720,0,0,0,1,1
80678,190,17026,22572,46720,0,0,0,1,1
80679,190,17027,22742;23225,46720,0,0,0,2,2
80680,190,17028,22778;23038,46720,0,0,0,2,2
80681,190,17030,23226,46720,0,0,0,1,1
80682,190,17033,22892,46720,0,0,0,1,1
80683,190,17037,22851,46720,0,0,0,1,1
80684,190,17039,23171,46720,0,0,0,1,1
80685,190,17040,22901;23238,46720,0,0,0,2,2
80686,190,17041,22904;23094,46720,0,0,0,2,2
80687,190,17043,23491,46720,0,0,0,1,1
80688,190,17046,22977,46720,0,0,0,1,1
80689,190,17048,22996,46720,0,0,0,1,1
80690,190,17050,23217;23459,46720,0,0,0,2,2
80691,190,17051,23249;23311,46720,0,0,0,2,2
80692,190,17052,23100,46720,0,0,0,1,1
80693,190,17053,23109;23260,46720,0,0,0,2,2
80694,190,17055,23124;23528,46720,0,0,0,2,2
80695,190,17056,23293,46720,0,0,0,1,1
80696,190,17057,23290,46720,0,0,0,1,1
80697,190,17058,23196,46720,0,0,0,1,1
80698,190,17059,23570;23841,46720,0,0,0,2,2
80699,190,17060,23157;27189,46720,0,0,1,1,2
80700,190,17061,23232,46720,0,0,0,1,1
80701,190,17107,22788,47085,0,0,0,1,1
80702,190,17110,22132;22395,47085,0,0,0,2,2
80703,190,17113,22334,47085,0,0,0,1,1
80704,190,17117,22511,47085,0,0,0,1,1
80705,190,17118,22256,47085,0,0,0,1,1
80706,190,17123,22872,47085,0,0,0,1,1
80707,190,17124,22873,47085,0,0,0,1,1
80708,190,17125,22883,47085,0,0,0,1,1
80709,190,17126,22691,47085,0,0,0,1,1
80710,190,17127,22468,47085,0,0,0,1,1
80711,190,17128,22722,47085,0,0,0,1,1
80712,190,17129,22737;22941,47085,0,0,0,2,2
80713,190,17130,22750,47085,0,0,0,1,1
80714,190,17132,22859,47085,0,0,0,1,1
80715,190,17135,23527,47085,0,0,0,1,1
80716,190,17136,22969,47085,0,0,0,1,1
80717,190,17138,23049,47085,0,0,0,1,1
80718,190,17140,23074,47085,0,0,0,1,1
80719,190,17141,23354,47085,0,0,0,1,1
80720,190,17142,23868;26665,47085,0,0,1,1,2
80721,190,17144,23449,47085,0,0,0,1,1
80722,190,17145,23208,47085,0,0,0,1,1
80723,190,17146,22932;23209,47085,0,0,0,2,2
80724,190,17147,23030;23211,47085,0,0,0,2,2
80725,190,17148,23212,47085,0,0,0,1,1
80726,190,17149,22837,47085,0,0,0,1,1
80727,190,17150,23251,47085,0,0,0,1,1
80728,190,17151,23283,47085,0,0,0,1,1
80729,190,17152,23105;23289,47085,0,0,0,2,2
80730,190,17155,23541,47085,0,0,0,1,1
80731,190,17157,23348;23639,47085,0,0,0,2,2
80732,190,17158,22991;23396,47085,0,0,0,2,2
80733,190,17160,23339;23816,47085,0,0,0,2,2
80734,190,17200,21857;21901,47450,0,0,0,2,2
80735,190,17203,22282,47450,0,0,0,1,1
80736,190,17206,22633,47450,0,0,0,1,1
80737,190,17212,22381,47450,0,0,0,1,1
80738,190,17213,22405,47450,0,0,0,1,1
80739,190,17214,22501,47450,0,0,0,1,1
80740,190,17218,22580,47450,0,0,0,1,1
80741,190,17219,22971,47450,0,0,0,1,1
80742,190,17221,23143,47450,0,0,0,1,1
80743,190,17222,22676,47450,0,0,0,1,1
80744,190,17223,22781,47450,0,0,0,1,1
80745,190,17224,22764;22890,47450,0,0,0,2,2
80746,190,17225,22819,47450,0,0,0,1,1
80747,190,17226,23058,47450,0,0,0,1,1
80748,190,17227,23357,47450,0,0,0,1,1
80749,190,17229,22882,47450,0,0,0,1,1
80750,190,17231,25801;26210;29245;29840,47450,0,1,3,0,4
80751,190,17232,22928,47450,0,0,0,1,1
80752,190,17233,23302,47450,0,0,0,1,1
80753,190,17234,23001,47450,0,0,0,1,1
80754,190,17235,23258,47450,0,0,0,1,1
80755,190,17236,23280,47450,0,0,0,1,1
80756,190,17238,23518,47450,0,0,0,1,1
80757,190,17239,23256,47450,0,0,0,1,1
80758,190,17242,22861;23206,47450,0,0,0,2,2
80759,190,17245,23014;23272,47450,0,0,0,2,2
80760,190,17246,23288,47450,0,0,0,1,1
80761,190,17247,22933,47450,0,0,0,1,1
80762,190,17249,23115;23323,47450,0,0,0,2,2
80763,190,17250,23152;23328,47450,0,0,0,2,2
80764,190,17251,23373;23592,47450,0,0,0,2,2
80765,190,17252,23540;23684,47450,0,0,0,2,2
80766,190,17253,23386;23544,47450,0,0,0,2,2
80767,190,17254,23264;23424,47450,0,0,0,2,2
80768,190,17285,21920,47815,0,0,0,1,1
80769,190,17292,21978,47815,0,0,0,1,1
80770,190,17294,22020,47815,0,0,0,1,1
80771,190,17301,22538,47815,0,0,0,1,1
80772,190,17303,22414,47815,0,0,0,1,1
80773,190,17304,22417,47815,0,0,0,1,1
80774,190,17307,22553;22590,47815,0,0,0,2,2
80775,190,17308,22637;22850,47815,0,0,0,2,2
80776,190,17313,22981,47815,0,0,0,1,1
80777,190,17315,22530,47815,0,0,0,1,1
80778,190,17318,22843,47815,0,0,0,1,1
80779,190,17320,22999,47815,0,0,0,1,1
80780,190,17322,22989,47815,0,0,0,1,1
80781,190,17325,23614;24209,47815,0,0,0,2,2
80782,190,17326,23443,47815,0,0,0,1,1
80783,190,17327,23218;23663,47815,0,0,0,2,2
80784,190,17329,22803,47815,0,0,0,1,1
80785,190,17330,23715,47815,0,0,0,1,1
80786,190,17331,23359,47815,0,0,0,1,1
80787,190,17332,23122;23207,47815,0,0,0,2,2
80788,190,17333,23609;27571,47815,0,0,1,1,2
80789,190,17334,23250;23596,47815,0,0,0,2,2
80790,190,17335,22816;23369,47815,0,0,0,2,2
80791,190,17336,23276;23450,47815,0,0,0,2,2
80792,190,17337,23616;23760;27214,47815,0,0,1,2,3
80793,190,17338,23318,47815,0,0,0,1,1
80794,190,17340,23422;23503,47815,0,0,0,2,2
80795,190,17341,23759,47815,0,0,0,1,1
80796,190,17342,23533,47815,0,0,0,1,1
80797,190,17344,23414,47815,0,0,0,1,1
80798,190,17345,23243,47815,0,0,0,1,1
80799,190,17348,23559,47815,0,0,0,1,1
80800,190,17349,23385;23479,47815,0,0,0,2,2
80801,190,17350,23881,47815,0,0,0,1,1
80802,190,17351,23713,47815,0,0,0,1,1
80803,190,17352,23297,47815,0,0,0,1,1
80804,190,17353,23585,47815,0,0,0,1,1
80805,190,17354,23498,47815,0,0,0,1,1
80806,190,17355,23222,47815,0,0,0,1,1
80807,190,17357,22992;23428,47815,0,0,0,2,2
80808,190,17358,23642,47815,0,0,0,1,1
80809,190,17360,23358,47815,0,0,0,1,1
80810,190,17397,21986,48180,0,0,0,1,1
80811,190,17407,22163,48180,0,0,0,1,1
80812,190,17408,22583,48180,0,0,0,1,1
80813,190,17410,22897;22980,48180,0,0,0,2,2
80814,190,17412,22703,48180,0,0,0,1,1
80815,190,17414,22840,48180,0,0,0,1,1
80816,190,17417,22935,48180,0,0,0,1,1
80817,190,17418,23072;23110,48180,0,0,0,2,2
80818,190,17419,23010;26838,48180,0,0,1,1,2
80819,190,17421,23758,48180,0,0,0,1,1
80820,190,17422,23042,48180,0,0,0,1,1
80821,190,17423,23651,48180,0,0,0,1,1
80822,190,17424,22774;23325,48180,0,0,0,2,2
80823,190,17428,23233,48180,0,0,0,1,1
80824,190,17431,23246;23526,48180,0,0,0,2,2
80825,190,17432,23412;23879,48180,0,0,0,2,2
80826,190,17433,23168;23453,48180,0,0,0,2,2
80827,190,17434,23483;23916,48180,0,0,0,2,2
80828,190,17435,23434;23605,48180,0,0,0,2,2
80829,190,17436,23520;23671,48180,0,0,0,2,2
80830,190,17437,23488;23522,48180,0,0,0,2,2
80831,190,17438,23529;23840,48180,0,0,0,2,2
80832,190,17439,23490;23536;27116;30054;30497,48180,0,2,1,2,5
80833,190,17443,23418;23561,48180,0,0,0,2,2
80834,190,17444,23478,48180,0,0,0,1,1
80835,190,17445,23786,48180,0,0,0,1,1
80836,190,17446,23883,48180,0,0,0,1,1
80837,190,17447,23604,48180,0,0,0,1,1
80838,190,17448,23368;23606,48180,0,0,0,2,2
80839,190,17449,23608,48180,0,0,0,1,1
80840,190,17451,23638;23654,48180,0,0,0,2,2
80841,190,17452,23371;23657,48180,0,0,0,2,2
80842,190,17453,23645;23658,48180,0,0,0,2,2
80843,190,17454,23660;23710,48180,0,0,0,2,2
80844,190,17455,23313;23670,48180,0,0,0,2,2
80845,190,17494,22534,48545,0,0,0,1,1
80846,190,17495,22729;22746,48545,0,0,0,2,2
80847,190,17496,22565;22905,48545,0,0,0,2,2
80848,190,17499,22959,48545,0,0,0,1,1
80849,190,17501,22962,48545,0,0,0,1,1
80850,190,17505,23462,48545,0,0,0,1,1
80851,190,17506,22886,48545,0,0,0,1,1
80852,190,17507,22924,48545,0,0,0,1,1
80853,190,17509,22714;23024,48545,0,0,0,2,2
80854,190,17510,23046,48545,0,0,0,1,1
80855,190,17511,23037,48545,0,0,0,1,1
80856,190,17512,23669;27126;29710;29802,48545,0,2,1,1,4
80857,190,17514,23063,48545,0,0,0,1,1
80858,190,17516,23158,48545,0,0,0,1,1
80859,190,17517,23191,48545,0,0,0,1,1
80860,190,17518,26242;29248,48545,0,0,2,0,2
80861,190,17519,23607;23791,48545,0,0,0,2,2
80862,190,17520,23584;23631,48545,0,0,0,2,2
80863,190,17521,23382;23800,48545,0,0,0,2,2
80864,190,17522,23215;23392,48545,0,0,0,2,2
80865,190,17523,23554,48545,0,0,0,1,1
80866,190,17524,23485,48545,0,0,0,1,1
80867,190,17525,23069;23429,48545,0,0,0,2,2
80868,190,17526,23065,48545,0,0,0,1,1
80869,190,17527,23213,48545,0,0,0,1,1
80870,190,17528,23815,48545,0,0,0,1,1
80871,190,17531,23525;23565,48545,0,0,0,2,2
80872,190,17532,23922;24053,48545,0,0,0,2,2
80873,190,17533,23626;23890,48545,0,0,0,2,2
80874,190,17534,23655;24018,48545,0,0,0,2,2
80875,190,17535,23886,48545,0,0,0,1,1
80876,190,17536,23686;24035,48545,0,0,0,2,2
80877,190,17538,23700;23829,48545,0,0,0,2,2
80878,190,17539,23914,48545,0,0,0,1,1
80879,190,17541,23735;23967,48545,0,0,0,2,2
80880,190,17542,23804,48545,0,0,0,1,1
80881,190,17586,22394,48910,0,0,0,1,1
80882,190,17589,22482;23101,48910,0,0,0,2,2
80883,190,17593,22447,48910,0,0,0,1,1
80884,190,17595,22763,48910,0,0,0,1,1
80885,190,17597,22917;23055,48910,0,0,0,2,2
80886,190,17600,23391,48910,0,0,0,1,1
80887,190,17601,23185,48910,0,0,0,1,1
80888,190,17604,23546,48910,0,0,0,1,1
80889,190,17605,23099,48910,0,0,0,1,1
80890,190,17607,23234;23441,48910,0,0,0,2,2
80891,190,17609,23273,48910,0,0,0,1,1
80892,190,17610,23301;23480,48910,0,0,0,2,2
80893,190,17611,22955;23331,48910,0,0,0,2,2
80894,190,17613,28588;28791,48910,0,0,2,0,2
80895,190,17614,23240;23400,48910,0,0,0,2,2
80896,190,17615,23445;23579,48910,0,0,0,2,2
80897,190,17616,23465,48910,0,0,0,1,1
80898,190,17617,23682;23712,48910,0,0,0,2,2
80899,190,17619,23262;23574,48910,0,0,0,2,2
80900,190,17621,23917;24036,48910,0,0,0,2,2
80901,190,17622,23600,48910,0,0,0,1,1
80902,190,17623,23830;27575,48910,0,0,1,1,2
80903,190,17624,23329;23617,48910,0,0,0,2,2
80904,190,17627,23649,48910,0,0,0,1,1
80905,190,17628,23287;23652,48910,0,0,0,2,2
80906,190,17629,23905,48910,0,0,0,1,1
80907,190,17630,23939,48910,0,0,0,1,1
80908,190,17632,23643;23728,48910,0,0,0,2,2
80909,190,17635,23762;23814;26875,48910,0,0,1,2,3
80910,190,17636,23535;24015,48910,0,0,0,2,2
80911,190,17637,23801,48910,0,0,0,1,1
80912,190,17638,23807;24000,48910,0,0,0,2,2
80913,190,17639,23828,48910,0,0,0,1,1
80914,190,17640,24029,48910,0,0,0,1,1
80915,190,17641,23849,48910,0,0,0,1,1
80916,190,17643,23612;23933,48910,0,0,0,2,2
80917,190,17670,23200,49275,0,0,0,1,1
80918,190,17671,22430,49275,0,0,0,1,1
80919,190,17673,22116,49275,0,0,0,1,1
80920,190,17675,22632;22884,49275,0,0,0,2,2
80921,190,17676,22767;23230,49275,0,0,0,2,2
80922,190,17680,22946;23219,49275,0,0,0,2,2
80923,190,17681,23012,49275,0,0,0,1,1
80924,190,17683,23044,49275,0,0,0,1,1
80925,190,17685,22926;23120,49275,0,0,0,2,2
80926,190,17689,23079;23365,49275,0,0,0,2,2
80927,190,17691,23404,49275,0,0,0,1,1
80928,190,17692,23763,49275,0,0,0,1,1
80929,190,17694,23229,49275,0,0,0,1,1
80930,190,17695,23474;23937,49275,0,0,0,2,2
80931,190,17696,23160;23511,49275,0,0,0,2,2
80932,190,17697,23556,49275,0,0,0,1,1
80933,190,17700,23572;23779,49275,0,0,0,2,2
80934,190,17701,23771,49275,0,0,0,1,1
80935,190,17702,23551;23587,49275,0,0,0,2,2
80936,190,17703,23698,49275,0,0,0,1,1
80937,190,17704,23847;23994,49275,0,0,0,2,2
80938,190,17705,23502,49275,0,0,0,1,1
80939,190,17706,23644;23666,49275,0,0,0,2,2
80940,190,17707,24092,49275,0,0,0,1,1
80941,190,17709,24026;24242;28418;30387;30990,49275,1,1,1,2,5
80942,190,17710,23694,49275,0,0,0,1,1
80943,190,17711,23706,49275,0,0,0,1,1
80944,190,17712,23711;24064,49275,0,0,0,2,2
80945,190,17713,23919;24047,49275,0,0,0,2,2
80946,190,17714,23727,49275,0,0,0,1,1
80947,190,17715,23341,49275,0,0,0,1,1
80948,190,17716,23761;23766,49275,0,0,0,2,2
80949,190,17718,23747;23788;27212,49275,0,0,1,2,3
80950,190,17719,23826,49275,0,0,0,1,1
80951,190,17720,23785;23899;27840;30541;30946,49275,1,1,1,2,5
80952,190,17721,23863;24276,49275,0,0,0,2,2
80953,190,17724,23898;24151,49275,0,0,0,2,2
80954,190,17726,23906,49275,0,0,0,1,1
80955,190,17727,23431;23912,49275,0,0,0,2,2
80956,190,17728,23774;23928,49275,0,0,0,2,2
80957,190,17729,23309,49275,0,0,0,1,1
80958,190,17730,23988;24038,49275,0,0,0,2,2
80959,190,17757,25053,49640,0,0,0,1,1
80960,190,17762,22333;22490,49640,0,0,0,2,2
80961,190,17765,22505;22857,49640,0,0,0,2,2
80962,190,17768,22749;23003,49640,0,0,0,2,2
80963,190,17773,22974,49640,0,0,0,1,1
80964,190,17774,23347,49640,0,0,0,1,1
80965,190,17775,23419,49640,0,0,0,1,1
80966,190,17779,23399;26267,49640,0,0,1,1,2
80967,190,17780,23170;23245,49640,0,0,0,2,2
80968,190,17781,23410,49640,0,0,0,1,1
80969,190,17782,23646,49640,0,0,0,1,1
80970,190,17783,23345,49640,0,0,0,1,1
80971,190,17785,23802,49640,0,0,0,1,1
80972,190,17786,23872,49640,0,0,0,1,1
80973,190,17788,23580;24135,49640,0,0,0,2,2
80974,190,17792,23701,49640,0,0,0,1,1
80975,190,17793,24080,49640,0,0,0,1,1
80976,190,17796,23408;23845,49640,0,0,0,2,2
80977,190,17797,23394;23835,49640,0,0,0,2,2
80978,190,17798,28177;30280,49640,0,1,1,0,2
80979,190,17799,23860;23910,49640,0,0,0,2,2
80980,190,17800,23900,49640,0,0,0,1,1
80981,190,17802,23778,49640,0,0,0,1,1
80982,190,17803,24232,49640,0,0,0,1,1
80983,190,17804,23990;24033,49640,0,0,0,2,2
80984,190,17805,24017,49640,0,0,0,1,1
80985,190,17807,24052;24291,49640,0,0,0,2,2
80986,190,17808,23790;24420,49640,0,0,0,2,2
80987,190,17809,24063,49640,0,0,0,1,1
80988,190,17810,23915;24408,49640,0,0,0,2,2
80989,190,17811,24354;24503,49640,0,0,0,2,2
80990,190,17832,22560,50005,0,0,0,1,1
80991,190,17843,22485,50005,0,0,0,1,1
80992,190,17851,22535;22802,50005,0,0,0,2,2
80993,190,17853,22700,50005,0,0,0,1,1
80994,190,17855,22975,50005,0,0,0,1,1
80995,190,17856,22364,50005,0,0,0,1,1
80996,190,17861,23114;23508,50005,0,0,0,2,2
80997,190,17862,23076;23116,50005,0,0,0,2,2
80998,190,17865,23767;24073,50005,0,0,0,2,2
80999,190,17866,23560,50005,0,0,0,1,1
81000,190,17867,23257;26089,50005,0,0,1,1,2
81001,190,17868,23471,50005,0,0,0,1,1
81002,190,17869,23482;23746,50005,0,0,0,2,2
81003,190,17870,23492,50005,0,0,0,1,1
81004,190,17871,23187;23510,50005,0,0,0,2,2
81005,190,17872,23516,50005,0,0,0,1,1
81006,190,17876,23995;24069,50005,0,0,0,2,2
81007,190,17877,23675;23843,50005,0,0,0,2,2
81008,190,17878,23613;23876;27139,50005,0,0,1,2,3
81009,190,17879,23457,50005,0,0,0,1,1
81010,190,17880,23627;23679,50005,0,0,0,2,2
81011,190,17882,23822;24025,50005,0,0,0,2,2
81012,190,17883,23797,50005,0,0,0,1,1
81013,190,17884,23689;23851,50005,0,0,0,2,2
81014,190,17885,23725;23867,50005,0,0,0,2,2
81015,190,17886,23909,50005,0,0,0,1,1
81016,190,17887,24105;24295,50005,0,0,0,2,2
81017,190,17888,23931,50005,0,0,0,1,1
81018,190,17889,23677,50005,0,0,0,1,1
81019,190,17891,23986;24407;27685,50005,0,0,1,2,3
81020,190,17893,24041,50005,0,0,0,1,1
81021,190,17894,24048,50005,0,0,0,1,1
81022,190,17896,23697;24225,50005,0,0,0,2,2
81023,190,17897,24001;24273,50005,0,0,0,2,2
81024,190,17899,23925;24077,50005,0,0,0,2,2
81025,190,17901,24104,50005,0,0,0,1,1
81026,190,17903,24368;24432,50005,0,0,0,2,2
81027,190,17904,24144;24267,50005,0,0,0,2,2
81028,190,17905,24186;24215,50005,0,0,0,2,2
81029,190,17906,24192;24200;26700,50005,0,0,1,2,3
81030,190,17922,21950,50370,0,0,0,1,1
81031,190,17931,21876,50370,0,0,0,1,1
81032,190,17933,22077,50370,0,0,0,1,1
81033,190,17934,22338,50370,0,0,0,1,1
81034,190,17935,22735,50370,0,0,0,1,1
81035,190,17940,22412,50370,0,0,0,1,1
81036,190,17942,22488,50370,0,0,0,1,1
81037,190,17949,22988,50370,0,0,0,1,1
81038,190,17950,23409,50370,0,0,0,1,1
81039,190,17952,23029;23036,50370,0,0,0,2,2
81040,190,17953,23850,50370,0,0,0,1,1
81041,190,17955,23569,50370,0,0,0,1,1
81042,190,17957,23231;23591,50370,0,0,0,2,2
81043,190,17959,23308,50370,0,0,0,1,1
81044,190,17960,23970;24088,50370,0,0,0,2,2
81045,190,17961,23709,50370,0,0,0,1,1
81046,190,17962,27136;28840,50370,0,0,2,0,2
81047,190,17963,23818;23834,50370,0,0,0,2,2
81048,190,17965,23415,50370,0,0,0,1,1
81049,190,17966,23228;23454,50370,0,0,0,2,2
81050,190,17967,23494,50370,0,0,0,1,1
81051,190,17968,23542;26573,50370,0,0,1,1,2
81052,190,17969,23993;24102,50370,0,0,0,2,2
81053,190,17971,23730;23979,50370,0,0,0,2,2
81054,190,17973,23784;24302,50370,0,0,0,2,2
81055,190,17974,27482;27957;30545;30956,50370,1,1,2,0,4
81056,190,17975,23397;23794,50370,0,0,0,2,2
81057,190,17976,23594;23806,50370,0,0,0,2,2
81058,190,17977,23704;23824,50370,0,0,0,2,2
81059,190,17978,23839,50370,0,0,0,1,1
81060,190,17979,23693;23848,50370,0,0,0,2,2
81061,190,17980,23708,50370,0,0,0,1,1
81062,190,17981,23859;24305,50370,0,0,0,2,2
81063,190,17982,24214;24378,50370,0,0,0,2,2
81064,190,17983,23531;23887,50370,0,0,0,2,2
81065,190,17984,23897;24216,50370,0,0,0,2,2
81066,190,17985,23913;24045,50370,0,0,0,2,2
81067,190,17986,23923;23942,50370,0,0,0,2,2
81068,190,17987,24042;24296,50370,0,0,0,2,2
81069,190,17988,24228,50370,0,0,0,1,1
81070,190,17989,23985;24350,50370,0,0,0,2,2
81071,190,17990,23930,50370,0,0,0,1,1
81072,190,17991,24173,50370,0,0,0,1,1
81073,190,17992,24010,50370,0,0,0,1,1
81074,190,17993,24061,50370,0,0,0,1,1
81075,190,17994,24055;24278,50370,0,0,0,2,2
81076,190,17995,24085,50370,0,0,0,1,1
81077,190,17996,24224;24445,50370,0,0,0,2,2
81078,190,17997,24501,50370,0,0,0,1,1
81079,190,17999,24142,50370,0,0,0,1,1
81080,190,18000,24294;24401,50370,0,0,0,2,2
81081,190,18001,24163;24349,50370,0,0,0,2,2
81082,190,18002,24385,50370,0,0,0,1,1
81083,190,18003,24167;27674,50370,0,0,1,1,2
81084,190,18005,24197;24520,50370,0,0,0,2,2
81085,190,18006,24266;24370,50370,0,0,0,2,2
81086,190,18007,24367,50370,0,0,0,1,1
81087,190,18009,24289,50370,0,0,0,1,1
81088,190,18010,24202;24308,50370,0,0,0,2,2
81089,190,18011,24009;24313,50370,0,0,0,2,2
81090,190,18049,22253;22314,50735,0,0,0,2,2
81091,190,18054,22801;27185,50735,0,0,1,1,2
81092,190,18057,23205,50735,0,0,0,1,1
81093,190,18059,23066;23619,50735,0,0,0,2,2
81094,190,18063,23274,50735,0,0,0,1,1
81095,190,18064,23338,50735,0,0,0,1,1
81096,190,18065,23634,50735,0,0,0,1,1
81097,190,18066,23425;23493,50735,0,0,0,2,2
81098,190,18067,23435;23476,50735,0,0,0,2,2
81099,190,18068,23460,50735,0,0,0,1,1
81100,190,18069,23630,50735,0,0,0,1,1
81101,190,18071,23468,50735,0,0,0,1,1
81102,190,18074,24075;27845;29934,50735,0,1,1,1,3
81103,190,18075,24377;24509,50735,0,0,0,2,2
81104,190,18076,24411;24447,50735,0,0,0,2,2
81105,190,18080,24188,50735,0,0,0,1,1
81106,190,18083,24126,50735,0,0,0,1,1
81107,190,18084,23891;24153,50735,0,0,0,2,2
81108,190,18086,23924;24248,50735,0,0,0,2,2
81109,190,18087,23927;23976,50735,0,0,0,2,2
81110,190,18088,23948;24293,50735,0,0,0,2,2
81111,190,18089,24526,50735,0,0,0,1,1
81112,190,18090,23963,50735,0,0,0,1,1
81113,190,18091,23949;24051,50735,0,0,0,2,2
81114,190,18092,24381,50735,0,0,0,1,1
81115,190,18094,23833,50735,0,0,0,1,1
81116,190,18095,24241,50735,0,0,0,1,1
81117,190,18097,24157,50735,0,0,0,1,1
81118,190,18098,24502,50735,0,0,0,1,1
81119,190,18099,23792;24281,50735,0,0,0,2,2
81120,190,18101,24723;28680,50735,0,0,1,1,2
81121,190,18102,24031;24127,50735,0,0,0,2,2
81122,190,18103,23952,50735,0,0,0,1,1
81123,190,18104,24644,50735,0,0,0,1,1
81124,190,18105,24363;24609,50735,0,0,0,2,2
81125,190,18106,24103;27947;30706,50735,1,0,1,1,3
81126,190,18107,24476;24539,50735,0,0,0,2,2
81127,190,18108,23944;24244,50735,0,0,0,2,2
81128,190,18109,24467;24717;28332,50735,0,0,1,2,3
81129,190,18110,24177,50735,0,0,0,1,1
81130,190,18111,24481;24597,50735,0,0,0,2,2
81131,190,18112,24458,50735,0,0,0,1,1
81132,190,18114,24523;24662,50735,0,0,0,2,2
81133,190,18115,24575,50735,0,0,0,1,1
81134,190,18117,24040;24379,50735,0,0,0,2,2
81135,190,18118,24743,50735,0,0,0,1,1
81136,190,18119,24409;28235,50735,0,0,1,1,2
81137,190,18157,22483,51100,0,0,0,1,1
81138,190,18159,23134,51100,0,0,0,1,1
81139,190,18160,23175;23282,51100,0,0,0,2,2
81140,190,18161,22789,51100,0,0,0,1,1
81141,190,18164,22644,51100,0,0,0,1,1
81142,190,18168,23395;23515,51100,0,0,0,2,2
81143,190,18169,23393;23998,51100,0,0,0,2,2
81144,190,18171,23547,51100,0,0,0,1,1
81145,190,18173,23875;24006,51100,0,0,0,2,2
81146,190,18174,23622,51100,0,0,0,1,1
81147,190,18176,24005,51100,0,0,0,1,1
81148,190,18177,24178,51100,0,0,0,1,1
81149,190,18178,23566;23754,51100,0,0,0,2,2
81150,190,18179,23593;23789,51100,0,0,0,2,2
81151,190,18180,24642,51100,0,0,0,1,1
81152,190,18181,23896;24150,51100,0,0,0,2,2
81153,190,18182,23326;23907,51100,0,0,0,2,2
81154,190,18183,24140,51100,0,0,0,1,1
81155,190,18184,24037;24270,51100,0,0,0,2,2
81156,190,18185,23505;24008,51100,0,0,0,2,2
81157,190,18187,23978,51100,0,0,0,1,1
81158,190,18188,23983,51100,0,0,0,1,1
81159,190,18190,24021,51100,0,0,0,1,1
81160,190,18193,24180;24537,51100,0,0,0,2,2
81161,190,18194,24658;24788,51100,0,0,0,2,2
81162,190,18196,24234;24316,51100,0,0,0,2,2
81163,190,18197,23932;24380,51100,0,0,0,2,2
81164,190,18199,24062,51100,0,0,0,1,1
81165,190,18200,24652;27871;30443,51100,0,1,1,1,3
81166,190,18201,24475;24753;26991,51100,0,0,1,2,3
81167,190,18202,23901,51100,0,0,0,1,1
81168,190,18203,24404,51100,0,0,0,1,1
81169,190,18204,24004;24425,51100,0,0,0,2,2
81170,190,18206,24117;24451,51100,0,0,0,2,2
81171,190,18207,24081;24482,51100,0,0,0,2,2
81172,190,18208,24489,51100,0,0,0,1,1
81173,190,18209,23982;24491,51100,0,0,0,2,2
81174,190,18210,24760,51100,0,0,0,1,1
81175,190,18211,24506,51100,0,0,0,1,1
81176,190,18212,24721,51100,0,0,0,1,1
81177,190,18213,24528,51100,0,0,0,1,1
81178,190,18229,21996,51465,0,0,0,1,1
81179,190,18235,21862,51465,0,0,0,1,1
81180,190,18245,23000,51465,0,0,0,1,1
81181,190,18249,22957;23162,51465,0,0,0,2,2
81182,190,18250,23176,51465,0,0,0,1,1
81183,190,18251,23198,51465,0,0,0,1,1
81184,190,18253,23495,51465,0,0,0,1,1
81185,190,18254,23300,51465,0,0,0,1,1
81186,190,18255,23444,51465,0,0,0,1,1
81187,190,18259,23624,51465,0,0,0,1,1
81188,190,18260,23271,51465,0,0,0,1,1
81189,190,18261,23455;23750,51465,0,0,0,2,2
81190,190,18262,23803,51465,0,0,0,1,1
81191,190,18263,23799;24171,51465,0,0,0,2,2
81192,190,18264,23685,51465,0,0,0,1,1
81193,190,18265,23599,51465,0,0,0,1,1
81194,190,18267,23695;23733,51465,0,0,0,2,2
81195,190,18268,23956;24298,51465,0,0,0,2,2
81196,190,18270,24395,51465,0,0,0,1,1
81197,190,18272,23836;24172,51465,0,0,0,2,2
81198,190,18273,23678;23866,51465,0,0,0,2,2
81199,190,18274,23878;24100,51465,0,0,0,2,2
81200,190,18275,23752,51465,0,0,0,1,1
81201,190,18278,24624,51465,0,0,0,1,1
81202,190,18279,24067;24114,51465,0,0,0,2,2
81203,190,18280,24120;24374,51465,0,0,0,2,2
81204,190,18281,24650;24815;28157;30559,51465,0,1,1,2,4
81205,190,18282,24191,51465,0,0,0,1,1
81206,190,18283,24190,51465,0,0,0,1,1
81207,190,18284,24541,51465,0,0,0,1,1
81208,190,18285,24108,51465,0,0,0,1,1
81209,190,18286,24314;24581,51465,0,0,0,2,2
81210,190,18287,24333;24400,51465,0,0,0,2,2
81211,190,18288,24339,51465,0,0,0,1,1
81212,190,18289,24421,51465,0,0,0,1,1
81213,190,18291,24734,51465,0,0,0,1,1
81214,190,18292,24446;24966,51465,0,0,0,2,2
81215,190,18293,24413;24950,51465,0,0,0,2,2
81216,190,18294,24436;24949,51465,0,0,0,2,2
81217,190,18297,24277;24603,51465,0,0,0,2,2
81218,190,18300,24369,51465,0,0,0,1,1
81219,190,18301,24612,51465,0,0,0,1,1
81220,190,18302,24680;24857;28599,51465,0,0,1,2,3
81221,190,18303,24874;27886,51465,0,0,1,1,2
81222,190,18304,24543;24758,51465,0,0,0,2,2
81223,190,18305,24510;26995,51465,0,0,1,1,2
81224,190,18306,24571;24844,51465,0,0,0,2,2
81225,190,18307,24937;25169,51465,0,0,1,1,2
81226,190,18308,24693,51465,0,0,0,1,1
81227,190,18333,22593,51830,0,0,0,1,1
81228,190,18334,22507;22683,51830,0,0,0,2,2
81229,190,18346,23164,51830,0,0,0,1,1
81230,190,18347,23504,51830,0,0,0,1,1
81231,190,18349,23667,51830,0,0,0,1,1
81232,190,18354,23375,51830,0,0,0,1,1
81233,190,18355,23578;24022,51830,0,0,0,2,2
81234,190,18357,23629;23751,51830,0,0,0,2,2
81235,190,18359,23681;23936,51830,0,0,0,2,2
81236,190,18360,23809,51830,0,0,0,1,1
81237,190,18362,23884;24065,51830,0,0,0,2,2
81238,190,18364,23947;24133,51830,0,0,0,2,2
81239,190,18365,23793,51830,0,0,0,1,1
81240,190,18366,23972,51830,0,0,0,1,1
81241,190,18368,23981;24604,51830,0,0,0,2,2
81242,190,18370,24661;24883,51830,0,0,0,2,2
81243,190,18371,24115;24279,51830,0,0,0,2,2
81244,190,18372,24131,51830,0,0,0,1,1
81245,190,18374,24139,51830,0,0,0,1,1
81246,190,18375,24355,51830,0,0,0,1,1
81247,190,18376,24185;24306,51830,0,0,0,2,2
81248,190,18378,24147;24207,51830,0,0,0,2,2
81249,190,18379,24504,51830,0,0,0,1,1
81250,190,18380,24290;24360,51830,0,0,0,2,2
81251,190,18381,24479,51830,0,0,0,1,1
81252,190,18382,24326;24583,51830,0,0,0,2,2
81253,190,18383,24990;28345;30822,51830,1,0,1,1,3
81254,190,18384,24675;24854,51830,0,0,0,2,2
81255,190,18385,24324;24424,51830,0,0,0,2,2
81256,190,18386,24690;24750,51830,0,0,0,2,2
81257,190,18388,23957;24534,51830,0,0,0,2,2
81258,190,18389,24414;24542,51830,0,0,0,2,2
81259,190,18392,24560;24886,51830,0,0,0,2,2
81260,190,18393,24711;27704;29302;30433;30689,51830,1,1,2,1,5
81261,190,18394,24497;24595,51830,0,0,0,2,2
81262,190,18395,24551;24602,51830,0,0,0,2,2
81263,190,18396,24867,51830,0,0,0,1,1
81264,190,18397,24850;28070;30718;30802;30884,51830,3,0,1,1,5
81265,190,18398,24322;24845,51830,0,0,0,2,2
81266,190,18399,24664,51830,0,0,0,1,1
81267,190,18401,24692,51830,0,0,0,1,1
81268,190,18402,24116;24550,51830,0,0,0,2,2
81269,190,18404,24554;24745,51830,0,0,0,2,2
81270,190,18405,24969,51830,0,0,0,1,1
81271,190,18432,22153,52195,0,0,0,1,1
81272,190,18439,22984;23873,52195,0,0,0,2,2
81273,190,18440,23310,52195,0,0,0,1,1
81274,190,18443,23430,52195,0,0,0,1,1
81275,190,18447,23808;24312,52195,0,0,0,2,2
81276,190,18448,23118;23268,52195,0,0,0,2,2
81277,190,18449,24187;27239,52195,0,0,1,1,2
81278,190,18452,24364,52195,0,0,0,1,1
81279,190,18454,23864;24199,52195,0,0,0,2,2
81280,190,18455,23880;24060,52195,0,0,0,2,2
81281,190,18456,24251,52195,0,0,0,1,1
81282,190,18457,23583,52195,0,0,0,1,1
81283,190,18458,23413;23934,52195,0,0,0,2,2
81284,190,18459,23961;24246;27491,52195,0,0,1,2,3
81285,190,18460,23904;24372,52195,0,0,0,2,2
81286,190,18461,24039;24155;28140;30371;30970,52195,1,1,1,2,5
81287,190,18462,24174;24393,52195,0,0,0,2,2
81288,190,18463,24175;24222,52195,0,0,0,2,2
81289,190,18464,24227;24388,52195,0,0,0,2,2
81290,190,18465,24243,52195,0,0,0,1,1
81291,190,18467,24430;24573,52195,0,0,0,2,2
81292,190,18468,24299;24321,52195,0,0,0,2,2
81293,190,18469,24184;24625,52195,0,0,0,2,2
81294,190,18470,24756;24978,52195,0,0,0,2,2
81295,190,18471,24726,52195,0,0,0,1,1
81296,190,18473,24356;24586,52195,0,0,0,2,2
81297,190,18474,24784,52195,0,0,0,1,1
81298,190,18475,24527,52195,0,0,0,1,1
81299,190,18476,24535;25127,52195,0,0,1,1,2
81300,190,18477,24342;24552,52195,0,0,0,2,2
81301,190,18478,24473;24668,52195,0,0,0,2,2
81302,190,18479,24329;24585,52195,0,0,0,2,2
81303,190,18480,24466;24587,52195,0,0,0,2,2
81304,190,18481,24386;24594,52195,0,0,0,2,2
81305,190,18484,24149;24722,52195,0,0,0,2,2
81306,190,18485,24454;24702,52195,0,0,0,2,2
81307,190,18486,24620;29209,52195,0,0,1,1,2
81308,190,18487,24258;24630,52195,0,0,0,2,2
81309,190,18488,24639,52195,0,0,0,1,1
81310,190,18490,24923,52195,0,0,0,1,1
81311,190,18491,25057;25148,52195,0,0,1,1,2
81312,190,18492,24859,52195,0,0,0,1,1
81313,190,18493,24718;27875,52195,0,0,1,1,2
81314,190,18494,24728,52195,0,0,0,1,1
81315,190,18496,24548;24736,52195,0,0,0,2,2
81316,190,18497,24449;24757,52195,0,0,0,2,2
81317,190,18498,24485;24747,52195,0,0,0,2,2
81318,190,18499,24765;24822,52195,0,0,0,2,2
81319,190,18500,24361;24771,52195,0,0,0,2,2
81320,190,18501,25101;25170,52195,0,0,2,0,2
81321,190,18502,24657;25071,52195,0,0,0,2,2
81322,190,18503,24480;24829,52195,0,0,0,2,2
81323,190,18504,24418;25084,52195,0,0,0,2,2
81324,190,18505,25094;28933,52195,0,0,2,0,2
81325,190,18523,21859,52560,0,0,0,1,1
81326,190,18527,22711,52560,0,0,0,1,1
81327,190,18536,22696,52560,0,0,0,1,1
81328,190,18540,23370,52560,0,0,0,1,1
81329,190,18542,23261,52560,0,0,0,1,1
81330,190,18543,23497;23611,52560,0,0,0,2,2
81331,190,18544,23589,52560,0,0,0,1,1
81332,190,18547,24255,52560,0,0,0,1,1
81333,190,18549,24158,52560,0,0,0,1,1
81334,190,18550,24334,52560,0,0,0,1,1
81335,190,18551,23702;24057,52560,0,0,0,2,2
81336,190,18554,23871,52560,0,0,0,1,1
81337,190,18555,24441,52560,0,0,0,1,1
81338,190,18556,24249;24840,52560,0,0,0,2,2
81339,190,18557,24274;24741,52560,0,0,0,2,2
81340,190,18559,23773,52560,0,0,0,1,1
81341,190,18560,24320;24477,52560,0,0,0,2,2
81342,190,18561,24483;24906,52560,0,0,0,2,2
81343,190,18562,24078;24410,52560,0,0,0,2,2
81344,190,18563,24412;24708,52560,0,0,0,2,2
81345,190,18564,24275;24464,52560,0,0,0,2,2
81346,190,18565,24269;24870,52560,0,0,0,2,2
81347,190,18566,24478;24557,52560,0,0,0,2,2
81348,190,18567,24778,52560,0,0,0,1,1
81349,190,18568,24555;24907;29027,52560,0,0,1,2,3
81350,190,18569,24572;24799,52560,0,0,0,2,2
81351,190,18570,24591;24681,52560,0,0,0,2,2
81352,190,18571,24871,52560,0,0,0,1,1
81353,190,18572,24319;24606;28769,52560,0,0,1,2,3
81354,190,18573,24428;24863,52560,0,0,0,2,2
81355,190,18575,24616;24986,52560,0,0,0,2,2
81356,190,18576,24193;24532,52560,0,0,0,2,2
81357,190,18577,24740;28244,52560,0,0,1,1,2
81358,190,18578,24789;25002,52560,0,0,0,2,2
81359,190,18579,24469;24794,52560,0,0,0,2,2
81360,190,18582,24762;24809;28066;30278,52560,0,1,1,2,4
81361,190,18584,25311;25315;28695,52560,0,0,3,0,3
81362,190,18585,24667;24838,52560,0,0,0,2,2
81363,190,18587,24921;25144;29028;30576,52560,0,1,2,1,4
81364,190,18589,24943;25276,52560,0,0,1,1,2
81365,190,18590,24988;25192,52560,0,0,1,1,2
81366,190,18621,23004,52925,0,0,0,1,1
81367,190,18627,22576;22920,52925,0,0,0,2,2
81368,190,18633,23378;23796,52925,0,0,0,2,2
81369,190,18635,23452,52925,0,0,0,1,1
81370,190,18636,23820;24159,52925,0,0,0,2,2
81371,190,18637,23691,52925,0,0,0,1,1
81372,190,18639,23466;23852,52925,0,0,0,2,2
81373,190,18641,24271;24348,52925,0,0,0,2,2
81374,190,18642,24028;26885,52925,0,0,1,1,2
81375,190,18643,24665;24759,52925,0,0,0,2,2
81376,190,18644,24391;28421,52925,0,0,1,1,2
81377,190,18645,23641;24098,52925,0,0,0,2,2
81378,190,18647,24161;24666,52925,0,0,0,2,2
81379,190,18648,23756;24176,52925,0,0,0,2,2
81380,190,18649,24169;24230,52925,0,0,0,2,2
81381,190,18650,24027;24390,52925,0,0,0,2,2
81382,190,18651,24965;28507,52925,0,0,1,1,2
81383,190,18652,24429;24598,52925,0,0,0,2,2
81384,190,18653,24704;26997,52925,0,0,1,1,2
81385,190,18655,25159,52925,0,0,1,0,1
81386,190,18656,25226;28934,52925,0,0,2,0,2
81387,190,18657,24515;25018,52925,0,0,0,2,2
81388,190,18659,24525;27965;30275;30709,52925,1,1,1,1,4
81389,190,18660,24514;24533,52925,0,0,0,2,2
81390,190,18661,24565,52925,0,0,0,1,1
81391,190,18662,24317;24566,52925,0,0,0,2,2
81392,190,18663,24576,52925,0,0,0,1,1
81393,190,18664,24643;25099,52925,0,0,1,1,2
81394,190,18665,24439;24611,52925,0,0,0,2,2
81395,190,18667,24817,52925,0,0,0,1,1
81396,190,18668,24636;24715,52925,0,0,0,2,2
81397,190,18669,24669,52925,0,0,0,1,1
81398,190,18671,24336;24700,52925,0,0,0,2,2
81399,190,18672,24934,52925,0,0,0,1,1
81400,190,18674,24508;24713,52925,0,0,0,2,2
81401,190,18675,24769;27633;29741,52925,0,1,1,1,3
81402,190,18676,24819;25112,52925,0,0,1,1,2
81403,190,18677,24684;24827,52925,0,0,0,2,2
81404,190,18678,25013,52925,0,0,0,1,1
81405,190,18679,25146;25413,52925,0,0,2,0,2
81406,190,18680,24866,52925,0,0,0,1,1
81407,190,18681,24851;24897,52925,0,0,0,2,2
81408,190,18682,25122;25289;29210,52925,0,0,3,0,3
81409,190,18683,25225;25427,52925,0,0,2,0,2
81410,190,18684,24970;25264,52925,0,0,1,1,2
81411,190,18685,25409;28455;28854,52925,0,0,3,0,3
81412,190,18686,24954,52925,0,0,0,1,1
81413,190,18687,24556;24959,52925,0,0,0,2,2
81414,190,18688,24118;24688,52925,0,0,0,2,2
81415,190,18689,25278,52925,0,0,1,0,1
81416,190,18691,24981;25070,52925,0,0,0,2,2
81417,190,18693,25082;25304,52925,0,0,1,1,2
81418,190,18708,21705,53290,0,0,0,1,1
81419,190,18721,23319,53290,0,0,0,1,1
81420,190,18727,23165,53290,0,0,0,1,1
81421,190,18733,23636;23696,53290,0,0,0,2,2
81422,190,18735,23865,53290,0,0,0,1,1
81423,190,18738,23664;23783,53290,0,0,0,2,2
81424,190,18741,23661,53290,0,0,0,1,1
81425,190,18742,23869;23926,53290,0,0,0,2,2
81426,190,18743,23781;24164,53290,0,0,0,2,2
81427,190,18745,24034;24109,53290,0,0,0,2,2
81428,190,18746,24337;28498,53290,0,0,1,1,2
81429,190,18747,24304,53290,0,0,0,1,1
81430,190,18748,24170;24182,53290,0,0,0,2,2
81431,190,18749,24849,53290,0,0,0,1,1
81432,190,18750,24238,53290,0,0,0,1,1
81433,190,18751,24332;24531,53290,0,0,0,2,2
81434,190,18752,24156;24226,53290,0,0,0,2,2
81435,190,18755,24433,53290,0,0,0,1,1
81436,190,18756,24083;24457,53290,0,0,0,2,2
81437,190,18757,24462;24735,53290,0,0,0,2,2
81438,190,18759,24536;24761,53290,0,0,0,2,2
81439,190,18760,24359;24561,53290,0,0,0,2,2
81440,190,18761,24780,53290,0,0,0,1,1
81441,190,18762,24577;24600,53290,0,0,0,2,2
81442,190,18763,24635;24982,53290,0,0,0,2,2
81443,190,18764,24796,53290,0,0,0,1,1
81444,190,18765,24683,53290,0,0,0,1,1
81445,190,18766,24257;24697,53290,0,0,0,2,2
81446,190,18767,24725;25365,53290,0,0,1,1,2
81447,190,18768,24733;28937,53290,0,0,1,1,2
81448,190,18769,24804,53290,0,0,0,1,1
81449,190,18770,24633;25183,53290,0,0,1,1,2
81450,190,18772,24800,53290,0,0,0,1,1
81451,190,18774,24818,53290,0,0,0,1,1
81452,190,18777,24837;25310,53290,0,0,1,1,2
81453,190,18778,24847,53290,0,0,0,1,1
81454,190,18779,24812;25063,53290,0,0,0,2,2
81455,190,18780,24677;25319;27729;28615;30532;30610,53290,0,2,3,1,6
81456,190,18781,24928,53290,0,0,0,1,1
81457,190,18782,24935,53290,0,0,0,1,1
81458,190,18783,24366;24946,53290,0,0,0,2,2
81459,190,18785,24689;24971,53290,0,0,0,2,2
81460,190,18786,25209;25451,53290,0,0,2,0,2
81461,190,18787,24991;25060,53290,0,0,0,2,2
81462,190,18789,25020,53290,0,0,0,1,1
81463,190,18790,25090;25388,53290,0,0,1,1,2
81464,190,18792,24802;25109,53290,0,0,1,1,2
81465,190,18793,25114;25527,53290,0,0,2,0,2
81466,190,18794,25140;25303,53290,0,0,2,0,2
81467,190,18796,24836;25120,53290,0,0,1,1,2
81468,190,18797,25134;25454;28855,53290,0,0,3,0,3
81469,190,18798,25145;25512,53290,0,0,2,0,2
81470,190,18799,25519;25535;28111;30093;30630;30809;30968;31049,53290,3,2,3,0,8
81471,190,18800,25160;25180,53290,0,0,2,0,2
81472,190,18809,21435,53655,0,0,0,1,1
81473,190,18827,22508;22699,53655,0,0,0,2,2
81474,190,18830,23227,53655,0,0,0,1,1
81475,190,18838,23764;24619,53655,0,0,0,2,2
81476,190,18839,24194,53655,0,0,0,1,1
81477,190,18840,23946,53655,0,0,0,1,1
81478,190,18842,24371;24499,53655,0,0,0,2,2
81479,190,18844,24358;24484,53655,0,0,0,2,2
81480,190,18845,24106;24179,53655,0,0,0,2,2
81481,190,18846,24623;27167,53655,0,0,1,1,2
81482,190,18847,24712;25067,53655,0,0,0,2,2
81483,190,18848,24086,53655,0,0,0,1,1
81484,190,18849,24357,53655,0,0,0,1,1
81485,190,18850,24247;24284,53655,0,0,0,2,2
81486,190,18854,24405,53655,0,0,0,1,1
81487,190,18855,24110;24219,53655,0,0,0,2,2
81488,190,18856,24183;24427,53655,0,0,0,2,2
81489,190,18857,24806;25001;28845,53655,0,0,1,2,3
81490,190,18859,24567;24653;28059,53655,0,0,1,2,3
81491,190,18860,24137;24601,53655,0,0,0,2,2
81492,190,18862,24376;24588,53655,0,0,0,2,2
81493,190,18863,24654;25265,53655,0,0,1,1,2
81494,190,18864,24631;24942,53655,0,0,0,2,2
81495,190,18866,24720,53655,0,0,0,1,1
81496,190,18867,24396;24732,53655,0,0,0,2,2
81497,190,18869,25025,53655,0,0,0,1,1
81498,190,18871,24403;24841,53655,0,0,0,2,2
81499,190,18873,25216;25327,53655,0,0,2,0,2
81500,190,18874,24896;24975,53655,0,0,0,2,2
81501,190,18875,25117,53655,0,0,1,0,1
81502,190,18876,24590;25102,53655,0,0,1,1,2
81503,190,18878,25051,53655,0,0,0,1,1
81504,190,18879,25030;25384,53655,0,0,1,1,2
81505,190,18880,24880;27888,53655,0,0,1,1,2
81506,190,18881,24999,53655,0,0,0,1,1
81507,190,18882,25087;25258,53655,0,0,1,1,2
81508,190,18883,25428,53655,0,0,1,0,1
81509,190,18884,25604;25866;28385;29043;30989,53655,1,0,4,0,5
81510,190,18885,24948;25316;27728;29744,53655,0,1,2,1,4
81511,190,18887,25347;25621;29948,53655,0,1,2,0,3
81512,190,18888,25044;25186,53655,0,0,1,1,2
81513,190,18889,25043;25194,53655,0,0,1,1,2
81514,190,18890,25138;25530,53655,0,0,2,0,2
81515,190,18891,25560,53655,0,0,1,0,1
81516,190,18892,25417;25589;28547;30829,53655,1,0,3,0,4
81517,190,18893,25421;25543,53655,0,0,2,0,2
81518,190,18894,25111;25582,53655,0,0,2,0,2
81519,190,18895,24960;25295;27726,53655,0,0,2,1,3
81520,190,18896,25306,53655,0,0,1,0,1
81521,190,18897,25631,53655,0,0,1,0,1
81522,190,18898,25296;25568;29393,53655,0,0,3,0,3
81523,190,18922,22797;22876,54020,0,0,0,2,2
81524,190,18923,23022;23183,54020,0,0,0,2,2
81525,190,18927,24016;24154,54020,0,0,0,2,2
81526,190,18930,23987;24208,54020,0,0,0,2,2
81527,190,18933,24032;24287,54020,0,0,0,2,2
81528,190,18935,24145;24331,54020,0,0,0,2,2
81529,190,18937,24196,54020,0,0,0,1,1
81530,190,18938,23717;24205,54020,0,0,0,2,2
81531,190,18939,24068;24330,54020,0,0,0,2,2
81532,190,18940,24318;24618,54020,0,0,0,2,2
81533,190,18941,24236;24240;27329;29201;29569;29986,54020,0,1,3,2,6
81534,190,18943,24056;24286,54020,0,0,0,2,2
81535,190,18946,24011;24406,54020,0,0,0,2,2
81536,190,18947,24685,54020,0,0,0,1,1
81537,190,18948,24423;24751,54020,0,0,0,2,2
81538,190,18949,24455,54020,0,0,0,1,1
81539,190,18950,24914,54020,0,0,0,1,1
81540,190,18951,24486;24984,54020,0,0,0,2,2
81541,190,18953,24614;24622,54020,0,0,0,2,2
81542,190,18954,24979,54020,0,0,0,1,1
81543,190,18955,24671;24787,54020,0,0,0,2,2
81544,190,18956,24875,54020,0,0,0,1,1
81545,190,18957,24918;25008,54020,0,0,0,2,2
81546,190,18958,24746;24772;28335,54020,0,0,1,2,3
81547,190,18959,24584;24705,54020,0,0,0,2,2
81548,190,18960,24500;24781,54020,0,0,0,2,2
81549,190,18961,24670;24797,54020,0,0,0,2,2
81550,190,18962,24808;24833,54020,0,0,0,2,2
81551,190,18964,24887;25236;28935,54020,0,0,2,1,3
81552,190,18965,24947;24964;28685;30835;31002,54020,2,0,1,2,5
81553,190,18966,24977;25010,54020,0,0,0,2,2
81554,190,18967,24894;25155,54020,0,0,1,1,2
81555,190,18969,25612;25692;28285;30818,54020,1,0,3,0,4
81556,190,18970,24924,54020,0,0,0,1,1
81557,190,18971,25009;25062,54020,0,0,0,2,2
81558,190,18972,24544;25080,54020,0,0,0,2,2
81559,190,18973,25104;25190,54020,0,0,2,0,2
81560,190,18975,25500;25521,54020,0,0,2,0,2
81561,190,18976,25168;25188,54020,0,0,2,0,2
81562,190,18977,24983;25177;28182;30189;30281;30972;31053,54020,2,2,2,1,7
81563,190,18978,24263;24872,54020,0,0,0,2,2
81564,190,18980,24911;25167,54020,0,0,1,1,2
81565,190,18981,25726,54020,0,0,1,0,1
81566,190,18982,24775;25246,54020,0,0,1,1,2
81567,190,18983,25174;25242,54020,0,0,2,0,2
81568,190,18984,25275,54020,0,0,1,0,1
81569,190,18986,25426,54020,0,0,1,0,1
81570,190,18987,25321,54020,0,0,1,0,1
81571,190,18988,24569;25322,54020,0,0,1,1,2
81572,190,18990,25515;25635,54020,0,0,2,0,2
81573,190,18991,25487,54020,0,0,1,0,1
81574,190,18992,25329;25555,54020,0,0,2,0,2
81575,190,18993,25048;25330,54020,0,0,1,1,2
81576,190,18994,25207;25336,54020,0,0,2,0,2
81577,190,18995,25261;25338,54020,0,0,2,0,2
81578,190,18996,25185;25356,54020,0,0,2,0,2
81579,190,18998,25220;25382,54020,0,0,2,0,2
81580,190,18999,25221;25390,54020,0,0,2,0,2
81581,190,19000,25423;25670,54020,0,0,2,0,2
81582,190,19001,25400;25407,54020,0,0,2,0,2
81583,190,19030,23918;24394,54385,0,0,0,2,2
81584,190,19031,23966,54385,0,0,0,1,1
81585,190,19041,24352;24365,54385,0,0,0,2,2
81586,190,19043,24437;24608;28154,54385,0,0,1,2,3
81587,190,19044,24239;24444,54385,0,0,0,2,2
81588,190,19045,24456,54385,0,0,0,1,1
81589,190,19046,24335,54385,0,0,0,1,1
81590,190,19047,24490;24589,54385,0,0,0,2,2
81591,190,19052,24714;25205,54385,0,0,1,1,2
81592,190,19053,25164,54385,0,0,1,0,1
81593,190,19054,24707;24786;28771;31091,54385,1,0,1,2,4
81594,190,19055,24926;28255,54385,0,0,1,1,2
81595,190,19056,25012;25353,54385,0,0,1,1,2
81596,190,19057,24826;28770;30484,54385,0,1,1,1,3
81597,190,19058,24860;27883,54385,0,0,1,1,2
81598,190,19060,24868;25040,54385,0,0,0,2,2
81599,190,19062,24472;24919,54385,0,0,0,2,2
81600,190,19063,25302;25457,54385,0,0,2,0,2
81601,190,19065,25230,54385,0,0,1,0,1
81602,190,19066,25163,54385,0,0,1,0,1
81603,190,19067,25328;29211,54385,0,0,2,0,2
81604,190,19068,25228;25484;28945,54385,0,0,3,0,3
81605,190,19069,24821;25249,54385,0,0,1,1,2
81606,190,19071,25606;29044,54385,0,0,2,0,2
81607,190,19072,24992;25156,54385,0,0,1,1,2
81608,190,19074,24574;25215,54385,0,0,1,1,2
81609,190,19075,24791;25411,54385,0,0,1,1,2
81610,190,19076,25532;28624;30913,54385,1,0,2,0,3
81611,190,19077,25538;28858,54385,0,0,2,0,2
81612,190,19078,24834;25250;28190;28357;29751;30383;30723;30902,54385,2,2,3,1,8
81613,190,19079,25254;25499,54385,0,0,2,0,2
81614,190,19080,25575,54385,0,0,1,0,1
81615,190,19081,25292;28195;30813;30891,54385,2,0,2,0,4
81616,190,19083,25796;25877,54385,0,0,2,0,2
81617,190,19084,24660;25299,54385,0,0,1,1,2
81618,190,19085,25108;25350,54385,0,0,2,0,2
81619,190,19086,25377,54385,0,0,1,0,1
81620,190,19089,25046;25494,54385,0,0,1,1,2
81621,190,19090,25520;25655,54385,0,0,2,0,2
81622,190,19091,25649;28464;29946,54385,0,1,2,0,3
81623,190,19092,25305;25467,54385,0,0,2,0,2
81624,190,19093,25483,54385,0,0,1,0,1
81625,190,19095,25498;25714,54385,0,0,2,0,2
81626,190,19105,22272,54750,0,0,0,1,1
81627,190,19114,23096;23521,54750,0,0,0,2,2
81628,190,19118,23337,54750,0,0,0,1,1
81629,190,19120,23780,54750,0,0,0,1,1
81630,190,19124,24112,54750,0,0,0,1,1
81631,190,19128,24059;24341,54750,0,0,0,2,2
81632,190,19129,24471,54750,0,0,0,1,1
81633,190,19130,24546,54750,0,0,0,1,1
81634,190,19131,25019,54750,0,0,0,1,1
81635,190,19133,25000,54750,0,0,0,1,1
81636,190,19134,24488;24994,54750,0,0,0,2,2
81637,190,19136,24435;25113,54750,0,0,1,1,2
81638,190,19137,24767;24858,54750,0,0,0,2,2
81639,190,19138,24773;24941,54750,0,0,0,2,2
81640,190,19139,24801;24813,54750,0,0,0,2,2
81641,190,19140,24460;24846,54750,0,0,0,2,2
81642,190,19142,24922;25116,54750,0,0,1,1,2
81643,190,19144,24898,54750,0,0,0,1,1
81644,190,19148,25028;28687,54750,0,0,1,1,2
81645,190,19149,25026;25029,54750,0,0,0,2,2
81646,190,19150,24615;24792;28429,54750,0,0,1,2,3
81647,190,19151,25607,54750,0,0,1,0,1
81648,190,19152,25095;25633;28628,54750,0,0,3,0,3
81649,190,19154,25348;25551,54750,0,0,2,0,2
81650,190,19155,25152;25153,54750,0,0,2,0,2
81651,190,19156,24995;25583,54750,0,0,1,1,2
81652,190,19157,25369;25641,54750,0,0,2,0,2
81653,190,19160,25245;25822;28957;29050,54750,0,0,4,0,4
81654,190,19161,25751;28714,54750,0,0,2,0,2
81655,190,19162,25184;25284,54750,0,0,2,0,2
81656,190,19165,25488;25818;28956;29141;29220,54750,0,0,5,0,5
81657,190,19166,25425;25802,54750,0,0,2,0,2
81658,190,19167,25252;25446,54750,0,0,2,0,2
81659,190,19168,25195;25567;28379;28461,54750,0,0,4,0,4
81660,190,19169,25481;25788;29219,54750,0,0,3,0,3
81661,190,19170,25490,54750,0,0,1,0,1
81662,190,19171,25752;25814;29754,54750,0,1,2,0,3
81663,190,19173,25525;25883;28877,54750,0,0,3,0,3
81664,190,19174,25745,54750,0,0,1,0,1
81665,190,19175,25547;25603,54750,0,0,2,0,2
81666,190,19176,25541,54750,0,0,1,0,1
81667,190,19177,25559,54750,0,0,1,0,1
81668,190,19178,25554;25591;28382,54750,0,0,3,0,3
81669,190,19179,25452;25601;28463;30732;30825;30992,54750,3,0,3,0,6
81670,190,19180,25613;25897;29144,54750,0,0,3,0,3
81671,190,19191,21758,55115,0,0,0,1,1
81672,190,19194,21879,55115,0,0,0,1,1
81673,190,19195,22657,55115,0,0,0,1,1
81674,190,19196,22465,55115,0,0,0,1,1
81675,190,19197,22401,55115,0,0,0,1,1
81676,190,19201,23008,55115,0,0,0,1,1
81677,190,19206,23070;23305,55115,0,0,0,2,2
81678,190,19209,23390,55115,0,0,0,1,1
81679,190,19210,23548,55115,0,0,0,1,1
81680,190,19216,23405,55115,0,0,0,1,1
81681,190,19219,23889;24253,55115,0,0,0,2,2
81682,190,19220,24280,55115,0,0,0,1,1
81683,190,19221,24123,55115,0,0,0,1,1
81684,190,19223,24709;24843;27532,55115,0,0,1,2,3
81685,190,19226,24325;24494,55115,0,0,0,2,2
81686,190,19228,24223;24340,55115,0,0,0,2,2
81687,190,19230,27718;27780;29930;30535;30694,55115,1,2,2,0,5
81688,190,19233,24998,55115,0,0,0,1,1
81689,190,19234,24107;24865,55115,0,0,0,2,2
81690,190,19235,24659;25036,55115,0,0,0,2,2
81691,190,19236,24383;24687;28331,55115,0,0,1,2,3
81692,190,19237,24375;24547,55115,0,0,0,2,2
81693,190,19238,24873;25158,55115,0,0,1,1,2
81694,190,19239,25232,55115,0,0,1,0,1
81695,190,19240,24764;24795,55115,0,0,0,2,2
81696,190,19241,25078;28088,55115,0,0,1,1,2
81697,190,19242,24716;25162,55115,0,0,1,1,2
81698,190,19243,24774;25394,55115,0,0,1,1,2
81699,190,19244,25523;25773,55115,0,0,2,0,2
81700,190,19245,25233,55115,0,0,1,0,1
81701,190,19246,25096;25513;28537,55115,0,0,3,0,3
81702,190,19247,25065,55115,0,0,0,1,1
81703,190,19248,25172;25286;27918,55115,0,0,3,0,3
81704,190,19249,25293,55115,0,0,1,0,1
81705,190,19250,25712,55115,0,0,1,0,1
81706,190,19251,25332,55115,0,0,1,0,1
81707,190,19252,25349,55115,0,0,1,0,1
81708,190,19253,25257;25640;28710;28785;29394,55115,0,0,5,0,5
81709,190,19254,25227;25748,55115,0,0,2,0,2
81710,190,19255,25727,55115,0,0,1,0,1
81711,190,19256,25815;25831,55115,0,0,2,0,2
81712,190,19257,25166;25511;29039,55115,0,0,3,0,3
81713,190,19259,25129;25422,55115,0,0,2,0,2
81714,190,19260,25595;25718;28391;30642,55115,0,1,3,0,4
81715,190,19261,25398;25444,55115,0,0,2,0,2
81716,190,19262,25450;25757,55115,0,0,2,0,2
81717,190,19263,25825;25935;29479,55115,0,0,3,0,3
81718,190,19264,24831;25464,55115,0,0,1,1,2
81719,190,19266,25469;25537,55115,0,0,2,0,2
81720,190,19267,25480;25531,55115,0,0,2,0,2
81721,190,19268,25930;25939;29228,55115,0,0,3,0,3
81722,190,19270,25917,55115,0,0,1,0,1
81723,190,19271,25518,55115,0,0,1,0,1
81724,190,19272,25553;25628;29753,55115,0,1,2,0,3
81725,190,19273,25565,55115,0,0,1,0,1
81726,190,19275,25505;25571,55115,0,0,2,0,2
81727,190,19276,25614;25890,55115,0,0,2,0,2
81728,190,19277,25617;25626,55115,0,0,2,0,2
81729,190,19278,25643;25876;28726;29312,55115,0,0,4,0,4
81730,190,19279,25671;25786;29216,55115,0,0,3,0,3
81731,190,19280,25902,55115,0,0,1,0,1
81732,190,19281,25719;25769;29395,55115,0,0,3,0,3
81733,190,19282,25760;25810;29669,55115,0,1,2,0,3
81734,190,19284,25886;28795,55115,0,0,2,0,2
81735,190,19287,21275;21686,55480,0,0,0,2,2
81736,190,19300,23223;23557,55480,0,0,0,2,2
81737,190,19304,22998,55480,0,0,0,1,1
81738,190,19308,23335,55480,0,0,0,1,1
81739,190,19311,23672,55480,0,0,0,1,1
81740,190,19317,24168,55480,0,0,0,1,1
81741,190,19318,24119,55480,0,0,0,1,1
81742,190,19321,24679,55480,0,0,0,1,1
81743,190,19322,24066,55480,0,0,0,1,1
81744,190,19325,24742;25313;28269,55480,0,0,2,1,3
81745,190,19327,24627;25373,55480,0,0,1,1,2
81746,190,19331,24884,55480,0,0,0,1,1
81747,190,19332,24766;25017,55480,0,0,0,2,2
81748,190,19334,24967;25290;28850,55480,0,0,2,1,3
81749,190,19336,25015;25161,55480,0,0,1,1,2
81750,190,19337,25031;25154,55480,0,0,1,1,2
81751,190,19338,24908;25039,55480,0,0,0,2,2
81752,190,19341,25268;25516;28946,55480,0,0,3,0,3
81753,190,19342,25091;25578,55480,0,0,1,1,2
81754,190,19343,25474,55480,0,0,1,0,1
81755,190,19344,24939;25266,55480,0,0,1,1,2
81756,190,19345,25279;25507,55480,0,0,2,0,2
81757,190,19346,25049;25323,55480,0,0,1,1,2
81758,190,19347,25179;25463;28857,55480,0,0,3,0,3
81759,190,19348,25975;29231,55480,0,0,2,0,2
81760,190,19349,25381;25662;28786,55480,0,0,3,0,3
81761,190,19350,25858,55480,0,0,1,0,1
81762,190,19351,25473;25618,55480,0,0,2,0,2
81763,190,19352,25506;25684,55480,0,0,2,0,2
81764,190,19353,25472;25689;29218,55480,0,0,3,0,3
81765,190,19354,25846,55480,0,0,1,0,1
81766,190,19355,25544;26037;29485,55480,0,0,3,0,3
81767,190,19356,25466;25562;28781;29041;30922,55480,1,0,4,0,5
81768,190,19357,25570;26036;28735;28804,55480,0,0,4,0,4
81769,190,19358,25981;29061;29149;29589,55480,0,1,3,0,4
81770,190,19359,25524;25759,55480,0,0,2,0,2
81771,190,19360,25300;25741;28290,55480,0,0,3,0,3
81772,190,19361,25697;25755,55480,0,0,2,0,2
81773,190,19362,25758;26016;28298;30727,55480,1,0,3,0,4
81774,190,19363,25219;25761,55480,0,0,2,0,2
81775,190,19364,25645;25764;29476,55480,0,0,3,0,3
81776,190,19365,25768;25962;28131,55480,0,0,3,0,3
81777,190,19366,25800;26000;28889;29483,55480,0,0,4,0,4
81778,190,19368,25795;26075,55480,0,0,2,0,2
81779,190,19375,21886,55845,0,0,0,1,1
81780,190,19379,22702,55845,0,0,0,1,1
81781,190,19388,23316;23440,55845,0,0,0,2,2
81782,190,19389,23446,55845,0,0,0,1,1
81783,190,19390,23467;23720,55845,0,0,0,2,2
81784,190,19397,24233;24529,55845,0,0,0,2,2
81785,190,19398,24323;24417,55845,0,0,0,2,2
81786,190,19401,24814;25066,55845,0,0,0,2,2
81787,190,19403,24904,55845,0,0,0,1,1
81788,190,19405,24634;25540,55845,0,0,1,1,2
81789,190,19409,24752;24958,55845,0,0,0,2,2
81790,190,19410,24513;24776,55845,0,0,0,2,2
81791,190,19411,25391;25453;28620;29037,55845,0,0,4,0,4
81792,190,19412,25128;25189,55845,0,0,2,0,2
81793,190,19413,25054,55845,0,0,0,1,1
81794,190,19414,24805;25514,55845,0,0,1,1,2
81795,190,19418,25392;25717,55845,0,0,2,0,2
81796,190,19419,25412;25675,55845,0,0,2,0,2
81797,190,19420,25375;26005;29150,55845,0,0,3,0,3
81798,190,19422,25178;25335,55845,0,0,2,0,2
81799,190,19423,25401;25608,55845,0,0,2,0,2
81800,190,19424,25376;25672,55845,0,0,2,0,2
81801,190,19425,25440;25579,55845,0,0,2,0,2
81802,190,19426,25171;25489;28535,55845,0,0,3,0,3
81803,190,19427,25243;25462;28944,55845,0,0,3,0,3
81804,190,19429,25294;25596;28383;30385,55845,0,1,3,0,4
81805,190,19431,25564;25665,55845,0,0,2,0,2
81806,190,19433,26138;26302,55845,0,0,2,0,2
81807,190,19434,25573;25634;28707,55845,0,0,3,0,3
81808,190,19435,25598;25920;29145;29227,55845,0,0,4,0,4
81809,190,19436,25609;25813,55845,0,0,2,0,2
81810,190,19437,25778;29477,55845,0,0,2,0,2
81811,190,19438,25652;25762,55845,0,0,2,0,2
81812,190,19440,25619;25680,55845,0,0,2,0,2
81813,190,19441,25585;25708;28864,55845,0,0,3,0,3
81814,190,19442,25740;26046;29234;29486;29836;29949,55845,0,2,4,0,6
81815,190,19443,25442;25746,55845,0,0,2,0,2
81816,190,19444,25777;26098;28406;29592,55845,0,1,3,0,4
81817,190,19445,25420;25783;28868,55845,0,0,3,0,3
81818,190,19446,25431;25833;28476;28720,55845,0,0,4,0,4
81819,190,19448,25729,55845,0,0,1,0,1
81820,190,19449,25853;25882;28793,55845,0,0,3,0,3
81821,190,19450,25859;26021,55845,0,0,2,0,2
81822,190,19451,26122;28980;29158;29239;29320,55845,0,0,5,0,5
81823,190,19452,25794;25958,55845,0,0,2,0,2
81824,190,19456,22040,56210,0,0,0,1,1
81825,190,19458,21984,56210,0,0,0,1,1
81826,190,19465,22213,56210,0,0,0,1,1
81827,190,19466,22313,56210,0,0,0,1,1
81828,190,19471,22463,56210,0,0,0,1,1
81829,190,19472,22291,56210,0,0,0,1,1
81830,190,19480,21923,56210,0,0,0,1,1
81831,190,19482,23059;23153,56210,0,0,0,2,2
81832,190,19484,22860,56210,0,0,0,1,1
81833,190,19485,22865;23145,56210,0,0,0,2,2
81834,190,19494,24148;24450,56210,0,0,0,2,2
81835,190,19496,24710,56210,0,0,0,1,1
81836,190,19499,24820,56210,0,0,0,1,1
81837,190,19502,24892;25364,56210,0,0,1,1,2
81838,190,19503,25574,56210,0,0,1,0,1
81839,190,19504,24803;24957,56210,0,0,0,2,2
81840,190,19505,24985;25032;28773,56210,0,0,1,2,3
81841,190,19507,25061;25504,56210,0,0,1,1,2
81842,190,19508,25371;25743,56210,0,0,2,0,2
81843,190,19509,25093;25298,56210,0,0,1,1,2
81844,190,19511,25397;25600,56210,0,0,2,0,2
81845,190,19512,25214;25343,56210,0,0,2,0,2
81846,190,19513,25241;25569,56210,0,0,2,0,2
81847,190,19514,25318;25907;29313,56210,0,0,3,0,3
81848,190,19516,25366;25829;28958,56210,0,0,3,0,3
81849,190,19517,25297;25491,56210,0,0,2,0,2
81850,190,19518,25576;25879,56210,0,0,2,0,2
81851,190,19519,25326;25441,56210,0,0,2,0,2
81852,190,19521,25656;25838,56210,0,0,2,0,2
81853,190,19523,25418;25678;29217,56210,0,0,3,0,3
81854,190,19524,26134;28655;29675,56210,0,1,2,0,3
81855,190,19525,25497;25836;29309,56210,0,0,3,0,3
81856,190,19526,25696;25819;28789;29221,56210,0,0,4,0,4
81857,190,19527,25700,56210,0,0,1,0,1
81858,190,19529,25711;26018;29064;29151,56210,0,0,4,0,4
81859,190,19530,26023;26203,56210,0,0,2,0,2
81860,190,19531,25945;25996,56210,0,0,2,0,2
81861,190,19532,25849,56210,0,0,1,0,1
81862,190,19533,25827;26050,56210,0,0,2,0,2
81863,190,19534,25685;25867,56210,0,0,2,0,2
81864,190,19535,25869;29480;29755,56210,0,1,2,0,3
81865,190,19536,25534;25870,56210,0,0,2,0,2
81866,190,19539,25509;25896;29057,56210,0,0,3,0,3
81867,190,19541,26083;28973;29156,56210,0,0,3,0,3
81868,190,19542,25918;29059,56210,0,0,2,0,2
81869,190,19543,25922;26225,56210,0,0,2,0,2
81870,190,19544,25932;26265;29250;29505,56210,0,0,4,0,4
81871,190,19546,25952;26199;29498,56210,0,0,3,0,3
81872,190,19547,25782;25967;28884;29757,56210,0,1,3,0,4
81873,190,19548,25828;25980,56210,0,0,2,0,2
81874,190,19550,25988;26273;28309;29414;29679;29843,56210,0,2,4,0,6
81875,190,19551,25368;25998;29397,56210,0,0,3,0,3
81876,190,19553,22370,56575,0,0,0,1,1
81877,190,19557,21869,56575,0,0,0,1,1
81878,190,19566,22773,56575,0,0,0,1,1
81879,190,19567,22847;23005,56575,0,0,0,2,2
81880,190,19569,23150,56575,0,0,0,1,1
81881,190,19585,24442;24632,56575,0,0,0,2,2
81882,190,19587,24495,56575,0,0,0,1,1
81883,190,19590,24686;24701,56575,0,0,0,2,2
81884,190,19591,24869;25561;28706,56575,0,0,2,1,3
81885,190,19594,24936;25646,56575,0,0,1,1,2
81886,190,19595,25213;25274,56575,0,0,2,0,2
81887,190,19596,24881;28075;28506,56575,0,0,2,1,3
81888,190,19597,24993,56575,0,0,0,1,1
81889,190,19599,25069,56575,0,0,0,1,1
81890,190,19600,25658,56575,0,0,1,0,1
81891,190,19603,25395;25709,56575,0,0,2,0,2
81892,190,19604,25435;25739,56575,0,0,2,0,2
81893,190,19606,25363,56575,0,0,1,0,1
81894,190,19607,25362;28698;29212,56575,0,0,3,0,3
81895,190,19608,25410;25855;28398;29835,56575,0,1,3,0,4
81896,190,19609,25438;25482,56575,0,0,2,0,2
81897,190,19610,25979;26091;28976;29590,56575,0,1,3,0,4
81898,190,19611,25756;25839;28642,56575,0,0,3,0,3
81899,190,19612,25244;25683,56575,0,0,2,0,2
81900,190,19613,25503;25804,56575,0,0,2,0,2
81901,190,19614,25724;25914,56575,0,0,2,0,2
81902,190,19616,25581;26163;29495,56575,0,0,3,0,3
81903,190,19618,25616;29305,56575,0,0,2,0,2
81904,190,19619,26063;26080;29071,56575,0,0,3,0,3
81905,190,19620,25629,56575,0,0,1,0,1
81906,190,19621,25638;26071;29236;31100,56575,1,0,3,0,4
81907,190,19622,26082,56575,0,0,1,0,1
81908,190,19623,25550;25657,56575,0,0,2,0,2
81909,190,19624,25750;25991,56575,0,0,2,0,2
81910,190,19625,25912;26047;28572;28737;29400,56575,0,0,5,0,5
81911,190,19626,25817;25999;28969;29482,56575,0,0,4,0,4
81912,190,19627,25732;29585,56575,0,1,1,0,2
81913,190,19628,26106,56575,0,0,1,0,1
81914,190,19629,26107;29674,56575,0,1,1,0,2
81915,190,19631,25854;25993,56575,0,0,2,0,2
81916,190,19632,25990;26048;29235,56575,0,0,3,0,3
81917,190,19633,26061;29070;29153;29401,56575,0,0,4,0,4
81918,190,19634,26017;26069;29072,56575,0,0,3,0,3
81919,190,19635,26188;26195;29597;29839,56575,0,2,2,0,4
81920,190,19636,26087;26392;28403;28975;29837,56575,0,1,4,0,5
81921,190,19637,25965;26256;29413,56575,0,0,3,0,3
81922,190,19651,22063,56940,0,0,0,1,1
81923,190,19656,23545,56940,0,0,0,1,1
81924,190,19657,22732;22782,56940,0,0,0,2,2
81925,190,19664,23882,56940,0,0,0,1,1
81926,190,19666,24387;24558;28324;30192;31065,56940,1,1,1,2,5
81927,190,19669,24673;25107,56940,0,0,1,1,2
81928,190,19673,24853;24996;28508;30736,56940,1,0,1,2,4
81929,190,19675,25074,56940,0,0,0,1,1
81930,190,19678,25007;28603;30738;31000,56940,2,0,1,1,4
81931,190,19679,25206;25374;28690,56940,0,0,3,0,3
81932,190,19680,25240,56940,0,0,1,0,1
81933,190,19682,24663;25182,56940,0,0,1,1,2
81934,190,19683,24899;25187,56940,0,0,1,1,2
81935,190,19684,24783;25211,56940,0,0,1,1,2
81936,190,19685,25262;25351,56940,0,0,2,0,2
81937,190,19686,25367;25720;29033,56940,0,0,3,0,3
81938,190,19687,25414;25885,56940,0,0,2,0,2
81939,190,19688,25749;25891,56940,0,0,2,0,2
81940,190,19689,25637;29584,56940,0,1,1,0,2
81941,190,19690,25602;25807,56940,0,0,2,0,2
81942,190,19691,25653;28711,56940,0,0,2,0,2
81943,190,19692,25636;25903;28963,56940,0,0,3,0,3
81944,190,19693,25175;25486,56940,0,0,2,0,2
81945,190,19694,25577;25747;29139,56940,0,0,3,0,3
81946,190,19695,25722;25738,56940,0,0,2,0,2
81947,190,19696,25204;25728,56940,0,0,2,0,2
81948,190,19698,26109;26179;28747;29162,56940,0,0,4,0,4
81949,190,19699,25789;25928,56940,0,0,2,0,2
81950,190,19702,25841;29052,56940,0,0,2,0,2
81951,190,19703,25842;25910;28959,56940,0,0,3,0,3
81952,190,19704,25862,56940,0,0,1,0,1
81953,190,19705,25924;26064,56940,0,0,2,0,2
81954,190,19707,25925;26227;29082;29599,56940,0,1,3,0,4
81955,190,19708,25933;29586;29670,56940,0,2,1,0,3
81956,190,19709,26127;30026,56940,0,1,1,0,2
81957,190,19710,26004;26410;28664;29604,56940,0,1,3,0,4
81958,190,19711,26194,56940,0,0,1,0,1
81959,190,19712,25972;26028,56940,0,0,2,0,2
81960,190,19713,26002;26034;30102,56940,0,1,2,0,3
81961,190,19714,26102;29076,56940,0,0,2,0,2
81962,190,19716,26400;26406;29764,56940,0,1,2,0,3
81963,190,19717,26070;26285;29252;30104,56940,0,1,3,0,4
81964,190,19718,25792;26101;28653;28977,56940,0,0,4,0,4
81965,190,19719,25956;26233;29328;31021,56940,1,0,3,0,4
81966,190,19721,25688;25850;29310,56940,0,0,3,0,3
81967,190,19723,26144;26207;29406;29493,56940,0,0,4,0,4
81968,190,19724,25677;26150;29161,56940,0,0,3,0,3
81969,190,19726,26130;26171,56940,0,0,2,0,2
81970,190,19727,25960;26178,56940,0,0,2,0,2
81971,190,19728,26011;26192;29497,56940,0,0,3,0,3
81972,190,19731,21550,57305,0,0,0,1,1
81973,190,19732,22207,57305,0,0,0,1,1
81974,190,19735,22262,57305,0,0,0,1,1
81975,190,19736,22930,57305,0,0,0,1,1
81976,190,19740,22780,57305,0,0,0,1,1
81977,190,19741,22855,57305,0,0,0,1,1
81978,190,19742,22923,57305,0,0,0,1,1
81979,190,19756,23729,57305,0,0,0,1,1
81980,190,19760,23286;23501,57305,0,0,0,2,2
81981,190,19767,24917,57305,0,0,0,1,1
81982,190,19769,24785;24862,57305,0,0,0,2,2
81983,190,19770,24645;25052,57305,0,0,0,2,2
81984,190,19771,24744;25147;28517,57305,0,0,2,1,3
81985,190,19772,25461;25539,57305,0,0,2,0,2
81986,190,19773,25197;25386,57305,0,0,2,0,2
81987,190,19774,25458,57305,0,0,1,0,1
81988,190,19776,25247;25587,57305,0,0,2,0,2
81989,190,19777,25037;25346,57305,0,0,1,1,2
81990,190,19779,25648;25812;29478,57305,0,0,3,0,3
81991,190,19783,25615;25623;28783;29304,57305,0,0,4,0,4
81992,190,19784,25478;25632,57305,0,0,2,0,2
81993,190,19785,25664;25695;29215,57305,0,0,3,0,3
81994,190,19786,25715,57305,0,0,1,0,1
81995,190,19787,25357;25781,57305,0,0,2,0,2
81996,190,19788,25681;25733;28788,57305,0,0,3,0,3
81997,190,19790,25763;25803;29140,57305,0,0,3,0,3
81998,190,19791,25548;25845,57305,0,0,2,0,2
81999,190,19792,25852;25997,57305,0,0,2,0,2
82000,190,19793,25840;25861;28024;28792;30746,57305,1,0,4,0,5
82001,190,19795,25892;29056,57305,0,0,2,0,2
82002,190,19796,25911;26183;29323,57305,0,0,3,0,3
82003,190,19797,25919;26278;29168;29844,57305,0,1,3,0,4
82004,190,19798,25776;26085;28974;29402,57305,0,0,4,0,4
82005,190,19799,25950;26280,57305,0,0,2,0,2
82006,190,19800,25393;25989,57305,0,0,2,0,2
82007,190,19801,26095;29591,57305,0,1,1,0,2
82008,190,19803,25969;26264;29761,57305,0,1,2,0,3
82009,190,19804,26019;26073;29484,57305,0,0,3,0,3
82010,190,19805,26065;26249;29488,57305,0,0,3,0,3
82011,190,19806,26388,57305,0,0,1,0,1
82012,190,19807,26160;26676,57305,0,0,2,0,2
82013,190,19808,26186;26312,57305,0,0,2,0,2
82014,190,19809,26187;26417;29513,57305,0,0,3,0,3
82015,190,19810,26156;26197;29595,57305,0,1,2,0,3
82016,190,19811,25915;26211;29499,57305,0,0,3,0,3
82017,190,19813,26166;26235;29410;29503,57305,0,0,4,0,4
82018,190,19814,26025;26239;30103,57305,0,1,2,0,3
82019,190,19815,26536;26599;29423,57305,0,0,3,0,3
82020,190,19816,26118;26571,57305,0,0,2,0,2
82021,190,19818,22185,57670,0,0,0,1,1
82022,190,19824,22439;22510,57670,0,0,0,2,2
82023,190,19825,22604,57670,0,0,0,1,1
82024,190,19830,23155,57670,0,0,0,1,1
82025,190,19834,23363,57670,0,0,0,1,1
82026,190,19837,23406;23581,57670,0,0,0,2,2
82027,190,19840,23819;24129,57670,0,0,0,2,2
82028,190,19842,23861,57670,0,0,0,1,1
82029,190,19844,24596,57670,0,0,0,1,1
82030,190,19852,24607;24913,57670,0,0,0,2,2
82031,190,19858,24807;25406,57670,0,0,1,1,2
82032,190,19859,25003;25176,57670,0,0,1,1,2
82033,190,19860,25133;25235,57670,0,0,2,0,2
82034,190,19865,25263,57670,0,0,1,0,1
82035,190,19866,25334;25552,57670,0,0,2,0,2
82036,190,19867,25404;25416,57670,0,0,2,0,2
82037,190,19868,25432;25528,57670,0,0,2,0,2
82038,190,19869,25196;25456;28011;28458,57670,0,0,4,0,4
82039,190,19871,25650,57670,0,0,1,0,1
82040,190,19872,25345;25622;29045;30923,57670,1,0,3,0,4
82041,190,19873,25625;27928;31040,57670,1,0,2,0,3
82042,190,19874,25660;26152;29322;29951,57670,0,1,3,0,4
82043,190,19875,25661;26275;29508,57670,0,0,3,0,3
82044,190,19876,25705;25923,57670,0,0,2,0,2
82045,190,19878,25753;25942,57670,0,0,2,0,2
82046,190,19879,25937;26377;29587,57670,0,1,2,0,3
82047,190,19880,25399;25775,57670,0,0,2,0,2
82048,190,19881,25594;25791;28869,57670,0,0,3,0,3
82049,190,19884,26010;26096;29157;29491;31104,57670,1,0,4,0,5
82050,190,19886,25968;26274;29251,57670,0,0,3,0,3
82051,190,19887,25888;25949;28882;29314,57670,0,0,4,0,4
82052,190,19888,25986;26153;28981;29079,57670,0,0,4,0,4
82053,190,19889,26045;26117;29319;29404;29593,57670,0,1,4,0,5
82054,190,19890,26104;26125,57670,0,0,2,0,2
82055,190,19891,26157,57670,0,0,1,0,1
82056,190,19892,26132;26133;28899;29838,57670,0,1,3,0,4
82057,190,19893,25970;26136,57670,0,0,2,0,2
82058,190,19894,26131;26162,57670,0,0,2,0,2
82059,190,19895,26602;26869;29874,57670,0,1,2,0,3
82060,190,19896,26208,57670,0,0,1,0,1
82061,190,19897,25737;25806;28955,57670,0,0,3,0,3
82062,190,19898,26247,57670,0,0,1,0,1
82063,190,19899,26251;26456,57670,0,0,2,0,2
82064,190,19900,26253;26477;29412,57670,0,0,3,0,3
82065,190,19901,26429;26711;30293,57670,0,1,2,0,3
82066,190,19902,26258;26561;29420;30031,57670,0,1,3,0,4
82067,190,19903,26248;26528;29517;30105,57670,0,1,3,0,4
82068,190,19904,25944;26291;29762,57670,0,1,2,0,3
82069,190,19905,26426;26631;29857,57670,0,1,2,0,3
82070,190,19906,26600;26610;29685;29771,57670,0,2,2,0,4
82071,190,19907,26309;26335,57670,0,0,2,0,2
82072,190,19908,25978;26407;28758,57670,0,0,3,0,3
82073,190,19909,26667;29528;29619,57670,0,1,2,0,3
82074,190,19910,26257;26589;29268;29770;30848;31019,57670,2,1,3,0,6
82075,190,19911,26411;26431;28414;30386,57670,0,1,3,0,4
82076,190,19915,22798,58035,0,0,0,1,1
82077,190,19921,22621,58035,0,0,0,1,1
82078,190,19933,23538,58035,0,0,0,1,1
82079,190,19937,24397,58035,0,0,0,1,1
82080,190,19942,24434;25006,58035,0,0,0,2,2
82081,190,19943,25023,58035,0,0,0,1,1
82082,190,19944,24076,58035,0,0,0,1,1
82083,190,19945,24507;24517,58035,0,0,0,2,2
82084,190,19948,24656,58035,0,0,0,1,1
82085,190,19951,25064,58035,0,0,0,1,1
82086,190,19953,25132;25419;28370,58035,0,0,3,0,3
82087,190,19955,25199;25253;28692,58035,0,0,3,0,3
82088,190,19956,25834;28641;29223,58035,0,0,3,0,3
82089,190,19958,25105;25424,58035,0,0,2,0,2
82090,190,19959,25291;25434;27725;28614;30390;31027,58035,1,1,4,0,6
82091,190,19960,25103;25470,58035,0,0,2,0,2
82092,190,19961,25856;26039;29673;29759,58035,0,2,2,0,4
82093,190,19963,25546;28780;29668;31092,58035,1,1,2,0,4
82094,190,19965,25157;25287,58035,0,0,2,0,2
82095,190,19967,25927;26148;29240;29321;29594,58035,0,1,4,0,5
82096,190,19968,25443;25955;29671,58035,0,1,2,0,3
82097,190,19969,25361;25784,58035,0,0,2,0,2
82098,190,19971,26879;26887;30121,58035,0,1,2,0,3
82099,190,19972,25835;28222,58035,0,0,2,0,2
82100,190,19973,25837;26286;29330,58035,0,0,3,0,3
82101,190,19975,25437;25880;29055,58035,0,0,3,0,3
82102,190,19976,25647;25983;28886,58035,0,0,3,0,3
82103,190,19977,25906;26143;29492,58035,0,0,3,0,3
82104,190,19978,25693;25951;28799;29230;29396;30841,58035,1,0,5,0,6
82105,190,19979,25961;26290;29169;29253,58035,0,0,4,0,4
82106,190,19980,25694;25703;29137,58035,0,0,3,0,3
82107,190,19982,26220;26314;29255,58035,0,0,3,0,3
82108,190,19983,26172;26341;29090,58035,0,0,3,0,3
82109,190,19984,26112;26519;29609;30488,58035,0,2,2,0,4
82110,190,19985,26121;26175,58035,0,0,2,0,2
82111,190,19986,26538;29101;29518,58035,0,0,3,0,3
82112,190,19987,26177;26331;29418;29846,58035,0,1,3,0,4
82113,190,19988,25976;26103;29077,58035,0,0,3,0,3
82114,190,19989,26215;26282,58035,0,0,2,0,2
82115,190,19990,26260,58035,0,0,1,0,1
82116,190,19991,26263;26750;29431;29782;29960,58035,0,2,3,0,5
82117,190,19992,25889;26269;28750;29506;31089,58035,1,0,4,0,5
82118,190,19993,26717;26741;29533;29690,58035,0,1,3,0,4
82119,190,19994,26288;26485;29515,58035,0,0,3,0,3
82120,190,19995,26327;26334;29170,58035,0,0,3,0,3
82121,190,19996,26084;26307;29334,58035,0,0,3,0,3
82122,190,19998,26094;26330,58035,0,0,2,0,2
82123,190,19999,26313;26508;28586;29344,58035,0,0,4,0,4
82124,190,20000,26356;26375;29091;29257,58035,0,0,4,0,4
82125,190,20001,26367;26397;29848,58035,0,1,2,0,3
82126,190,20002,26416;26702;29778,58035,0,1,2,0,3
82127,190,20003,26299;26422,58035,0,0,2,0,2
82128,190,20004,26625;26781;29961,58035,0,1,2,0,3
82129,190,20005,26129;26352;28987,58035,0,0,3,0,3
82130,190,20006,26448,58035,0,0,1,0,1
82131,190,20007,26219;26565;28823;29103;29523;30032,58035,0,1,5,0,6
82132,190,20008,26049;26479;28821;29605,58035,0,1,3,0,4
82133,190,20009,26423;26493;29849;29956,58035,0,2,2,0,4
82134,190,20012,23239,58400,0,0,0,1,1
82135,190,20014,22457,58400,0,0,0,1,1
82136,190,20015,22919,58400,0,0,0,1,1
82137,190,20023,23317,58400,0,0,0,1,1
82138,190,20024,23692,58400,0,0,0,1,1
82139,190,20025,23081,58400,0,0,0,1,1
82140,190,20033,24452,58400,0,0,0,1,1
82141,190,20039,24649;25136,58400,0,0,1,1,2
82142,190,20040,25256;25269,58400,0,0,2,0,2
82143,190,20041,25077,58400,0,0,0,1,1
82144,190,20042,25092;25280,58400,0,0,1,1,2
82145,190,20044,25630,58400,0,0,1,0,1
82146,190,20045,25342;25389,58400,0,0,2,0,2
82147,190,20047,25270,58400,0,0,1,0,1
82148,190,20051,25526;25808,58400,0,0,2,0,2
82149,190,20052,26024;29065,58400,0,0,2,0,2
82150,190,20053,25089;25592;29133,58400,0,0,2,1,3
82151,190,20054,25639;26189,58400,0,0,2,0,2
82152,190,20055,25201;25721,58400,0,0,2,0,2
82153,190,20056,26008;26408;29682;30200,58400,0,2,2,0,4
82154,190,20059,25926;26035;29060,58400,0,0,3,0,3
82155,190,20060,26055;26155,58400,0,0,2,0,2
82156,190,20061,26074;26435;29094,58400,0,0,3,0,3
82157,190,20062,26137;29676,58400,0,1,1,0,2
82158,190,20063,25624;26090;28896,58400,0,0,3,0,3
82159,190,20064,26376,58400,0,0,1,0,1
82160,190,20065,26193;30027,58400,0,1,1,0,2
82161,190,20066,26066;26467,58400,0,0,2,0,2
82162,190,20067,25931;26190;29324,58400,0,0,3,0,3
82163,190,20068,26009;26202;29672,58400,0,1,2,0,3
82164,190,20069,26421;26575;28998;29524;31097,58400,1,0,4,0,5
82165,190,20070,26300;26390;29332,58400,0,0,3,0,3
82166,190,20071,26645;26646;30107;30205,58400,0,2,2,0,4
82167,190,20072,26349;26495;29850,58400,0,1,2,0,3
82168,190,20073,26128;26345;29681,58400,0,1,2,0,3
82169,190,20074,26363;26634;29774;30204,58400,0,2,2,0,4
82170,190,20075,26691;29428;29529,58400,0,0,3,0,3
82171,190,20076,26643;26731;29108;29274;29622;29867;30036,58400,0,3,4,0,7
82172,190,20077,26740,58400,0,0,1,0,1
82173,190,20078,26399;26708;29106,58400,0,0,3,0,3
82174,190,20079,26541;26672;28995;29264,58400,0,0,4,0,4
82175,190,20080,26404;26518;30029,58400,0,1,2,0,3
82176,190,20081,26794,58400,0,0,1,0,1
82177,190,20082,26358,58400,0,0,1,0,1
82178,190,20083,26484;26492;29343;29514;29607,58400,0,1,4,0,5
82179,190,20084,26505;26514,58400,0,0,2,0,2
82180,190,20085,26812;29281;30207,58400,0,1,2,0,3
82181,190,20086,26776;28832;29629,58400,0,1,2,0,3
82182,190,20087,26546;26780;29538;29694;30399,58400,0,2,3,0,5
82183,190,20088,26551;29613;30579,58400,0,2,1,0,3
82184,190,20089,26552;26761;29276;30038,58400,0,1,3,0,4
82185,190,20090,26097;26653;29179;29617,58400,0,1,3,0,4
82186,190,20091,26784;26912;30489,58400,0,1,2,0,3
82187,190,20093,22629;22874,58765,0,0,0,2,2
82188,190,20095,22653,58765,0,0,0,1,1
82189,190,20098,22707;23137,58765,0,0,0,2,2
82190,190,20103,22997;23351,58765,0,0,0,2,2
82191,190,20104,23456;23637,58765,0,0,0,2,2
82192,190,20106,23507;23519,58765,0,0,0,2,2
82193,190,20108,23568,58765,0,0,0,1,1
82194,190,20115,24282,58765,0,0,0,1,1
82195,190,20118,24811,58765,0,0,0,1,1
82196,190,20120,24839,58765,0,0,0,1,1
82197,190,20126,25224;25687;28552;30646,58765,0,1,3,0,4
82198,190,20130,25119;25611,58765,0,0,2,0,2
82199,190,20131,25344;25403;28528,58765,0,0,3,0,3
82200,190,20135,25141;25217,58765,0,0,2,0,2
82201,190,20136,25667;25860,58765,0,0,2,0,2
82202,190,20138,26154;29494,58765,0,0,2,0,2
82203,190,20140,25766;26093;28809,58765,0,0,3,0,3
82204,190,20142,25772;25913;28728;29481;31022,58765,1,0,4,0,5
82205,190,20143,25987;26209,58765,0,0,2,0,2
82206,190,20144,25744;25985;28968;29062;30749,58765,1,0,4,0,5
82207,190,20145,26428;28491,58765,0,0,2,0,2
82208,190,20147,25936;26185,58765,0,0,2,0,2
82209,190,20150,25984;26212;29325,58765,0,0,3,0,3
82210,190,20152,26222,58765,0,0,1,0,1
82211,190,20153,25954;26252;29952,58765,0,1,2,0,3
82212,190,20154,25809;26295;29254;29415;29845,58765,0,1,4,0,5
82213,190,20155,26779;26831;29008;30113;30398;31013,58765,1,2,3,0,6
82214,190,20156,26279;26564;29266;29421;29522,58765,0,0,5,0,5
82215,190,20157,25994;26398;30578,58765,0,1,2,0,3
82216,190,20158,26357;26365;28988;29511,58765,0,0,4,0,4
82217,190,20159,26368;26401;29419,58765,0,0,3,0,3
82218,190,20160,26385;26724;29430;29691;30295,58765,0,2,3,0,5
82219,190,20161,26402;26529;29100,58765,0,0,3,0,3
82220,190,20162,26854;26948;29443,58765,0,0,3,0,3
82221,190,20163,26029;26612;28825;29772;30396,58765,0,2,3,0,5
82222,190,20164,26149;26468,58765,0,0,2,0,2
82223,190,20165,26298;26437,58765,0,0,2,0,2
82224,190,20166,26614,58765,0,0,1,0,1
82225,190,20167,26332;26674;29776,58765,0,1,2,0,3
82226,190,20168,26523;29684,58765,0,1,1,0,2
82227,190,20169,25878;26501;29262,58765,0,0,3,0,3
82228,190,20170,26259;26503;29608;29851,58765,0,2,2,0,4
82229,190,20171,26053;26424;28582;29259;30998,58765,1,0,4,0,5
82230,190,20172,26496;26706;29689;29779,58765,0,2,2,0,4
82231,190,20174,26587;26790;29540,58765,0,0,3,0,3
82232,190,20176,26432;26583,58765,0,0,2,0,2
82233,190,20177,26318;26840,58765,0,0,2,0,2
82234,190,20178,26592;26759;30111,58765,0,1,2,0,3
82235,190,20179,26598,58765,0,0,1,0,1
82236,190,20180,26438;26804;29189;30298,58765,0,1,3,0,4
82237,190,20181,26549;26675;29620,58765,0,1,2,0,3
82238,190,20182,26644;26681,58765,0,0,2,0,2
82239,190,20183,26695;26923;29287;29554;29881,58765,0,1,4,0,5
82240,190,20184,26683;26713;29184;29429;29532;29621,58765,0,1,5,0,6
82241,190,20185,26433;26714;29107;29866,58765,0,1,3,0,4
82242,190,20186,22739,59130,0,0,0,1,1
82243,190,20192,23041,59130,0,0,0,1,1
82244,190,20193,23104,59130,0,0,0,1,1
82245,190,20203,24043,59130,0,0,0,1,1
82246,190,20206,24122;24292,59130,0,0,0,2,2
82247,190,20208,24399;24540,59130,0,0,0,2,2
82248,190,20210,24231;24498,59130,0,0,0,2,2
82249,190,20215,25106,59130,0,0,1,0,1
82250,190,20216,25073;25198,59130,0,0,1,1,2
82251,190,20217,24893;25110;29392,59130,0,0,2,1,3
82252,190,20218,25035;25352,59130,0,0,1,1,2
82253,190,20219,25282;28694,59130,0,0,2,0,2
82254,190,20220,25383;25659;28939,59130,0,0,3,0,3
82255,190,20221,25339;25691;29047,59130,0,0,3,0,3
82256,190,20222,25974;26052;29588,59130,0,1,2,0,3
82257,190,20223,25360;25566,59130,0,0,2,0,2
82258,190,20224,25686;25798;28632,59130,0,0,3,0,3
82259,190,20225,25771;25823;29308,59130,0,0,3,0,3
82260,190,20226,26245;26246;29411,59130,0,0,3,0,3
82261,190,20229,25964;26043;28736;29233,59130,0,0,4,0,4
82262,190,20230,26013;26086,59130,0,0,2,0,2
82263,190,20231,26284;26333;29256;29509,59130,0,0,4,0,4
82264,190,20232,25899;26038,59130,0,0,2,0,2
82265,190,20233,26014;26184;29496,59130,0,0,3,0,3
82266,190,20234,26072;26440;28583,59130,0,0,3,0,3
82267,190,20237,25898;26115;28811;31009,59130,1,0,3,0,4
82268,190,20238,26140;26374;29603;29847,59130,0,2,2,0,4
82269,190,20239,26214;26281;29677,59130,0,1,2,0,3
82270,190,20240,26698;30035,59130,0,1,1,0,2
82271,190,20241,26126;26553;29520,59130,0,0,3,0,3
82272,190,20242,26229;26570;29346;29769,59130,0,1,3,0,4
82273,190,20243,26304;29333,59130,0,0,2,0,2
82274,190,20244,26320;26664;30206,59130,0,1,2,0,3
82275,190,20245,26321;26476;29335;29417,59130,0,0,4,0,4
82276,190,20246,26343;26656;29426;29860,59130,0,1,3,0,4
82277,190,20247,26124;26360;28989,59130,0,0,3,0,3
82278,190,20248,26283;26453,59130,0,0,2,0,2
82279,190,20249,26703;26775;30109,59130,0,1,2,0,3
82280,190,20250,26120;26444,59130,0,0,2,0,2
82281,190,20251,26319;26466,59130,0,0,2,0,2
82282,190,20252,26449;26753;29536,59130,0,0,3,0,3
82283,190,20254,26384;26490;29337,59130,0,0,3,0,3
82284,190,20255,26351;26594;29854;30106,59130,0,2,2,0,4
82285,190,20256,26196;26542;29612,59130,0,1,2,0,3
82286,190,20257,26556;26777;29357,59130,0,0,3,0,3
82287,190,20258,26798;30115,59130,0,1,1,0,2
82288,190,20259,26591;26705;29530;29865;30580,59130,0,2,3,0,5
82289,190,20260,26601;29269,59130,0,0,2,0,2
82290,190,20261,26608;27050,59130,0,0,2,0,2
82291,190,20262,26580;26639;29001;29688,59130,0,1,3,0,4
82292,190,20264,26678;27042;29891;29968,59130,0,2,2,0,4
82293,190,20265,26354;26686;29862,59130,0,1,2,0,3
82294,190,20266,26200;26487,59130,0,0,2,0,2
82295,190,20268,26729;26928;29440;29556,59130,0,0,4,0,4
82296,190,20269,26867;27018,59130,0,0,2,0,2
82297,190,20270,26430;26787;29539;29784,59130,0,1,3,0,4
82298,190,20271,26797;27000;30125,59130,0,1,2,0,3
82299,190,20272,26461;26800;29542,59130,0,0,3,0,3
82300,190,20276,22204,59495,0,0,0,1,1
82301,190,20277,23126,59495,0,0,0,1,1
82302,190,20279,23151,59495,0,0,0,1,1
82303,190,20281,23265,59495,0,0,0,1,1
82304,190,20305,25610;25730;28985;29138,59495,0,0,4,0,4
82305,190,20311,25341;25731,59495,0,0,2,0,2
82306,190,20314,25865;26306;29088;29416;29602;29680;30846,59495,1,2,4,0,7
82307,190,20315,26243;26412;29765,59495,0,1,2,0,3
82308,190,20318,25605;25947;29147,59495,0,0,3,0,3
82309,190,20319,25820;26003,59495,0,0,2,0,2
82310,190,20320,26088;29074;29403;29490;30751,59495,1,0,4,0,5
82311,190,20321,26041;28571;29398,59495,0,0,3,0,3
82312,190,20322,26100;26315,59495,0,0,2,0,2
82313,190,20323,26116,59495,0,0,1,0,1
82314,190,20326,26180;26244;29249;29601,59495,0,1,3,0,4
82315,190,20327,26123;26255;29504;29841,59495,0,1,3,0,4
82316,190,20328,26268;26926;29555;29790;30124;30212,59495,0,3,3,0,6
82317,190,20329,26434,59495,0,0,1,0,1
82318,190,20330,26337;26994;29368,59495,0,0,3,0,3
82319,190,20331,26181;26361;29092,59495,0,0,3,0,3
82320,190,20332,26369;26395;29258,59495,0,0,3,0,3
82321,190,20333,26491;28915;29261,59495,0,0,3,0,3
82322,190,20336,26454;26544;29339,59495,0,0,3,0,3
82323,190,20338,26482;29096;29342,59495,0,0,3,0,3
82324,190,20339,26483;26939;29883;30301,59495,0,2,2,0,4
82325,190,20340,26499;27039;29444;30217;30657,59495,1,1,3,0,5
82326,190,20342,26522;26658;29861,59495,0,1,2,0,3
82327,190,20343,26261;26526;29610,59495,0,1,2,0,3
82328,190,20344,26636,59495,0,0,1,0,1
82329,190,20345,26548;29519;29853;30201,59495,0,2,2,0,4
82330,190,20346,26856;29873,59495,0,1,1,0,2
82331,190,20347,26655;26877;29551;30300,59495,0,1,3,0,4
82332,190,20348,26443;26657;28826;29618,59495,0,1,3,0,4
82333,190,20349,26669;29003;29154;29353;29775,59495,0,1,4,0,5
82334,190,20350,26980;27060;30129,59495,0,1,2,0,3
82335,190,20351,26568;26719,59495,0,0,2,0,2
82336,190,20352,26848;27089;30307,59495,0,1,2,0,3
82337,190,20353,26734;27065;29019;29707;29796;30051,59495,0,3,3,0,6
82338,190,20354,26617;26919;29364,59495,0,0,3,0,3
82339,190,20355,26446;26754;30397,59495,0,1,2,0,3
82340,190,20356,26442;26825;29545,59495,0,0,3,0,3
82341,190,20357,26827;27043,59495,0,0,2,0,2
82342,190,20358,26828;27086,59495,0,0,2,0,2
82343,190,20359,26830;26969;29884,59495,0,1,2,0,3
82344,190,20360,26850;27023;30046,59495,0,1,2,0,3
82345,190,20361,26767;26899;28830;29109;30112,59495,0,1,4,0,5
82346,190,20362,27109;27154;29715;29901;30226,59495,0,3,2,0,5
82347,190,20363,26904,59495,0,0,1,0,1
82348,190,20366,22830,59860,0,0,0,1,1
82349,190,20368,23060,59860,0,0,0,1,1
82350,190,20370,23086;23427,59860,0,0,0,2,2
82351,190,20374,22877,59860,0,0,0,1,1
82352,190,20377,23517;23597,59860,0,0,0,2,2
82353,190,20378,24082,59860,0,0,0,1,1
82354,190,20379,24074,59860,0,0,0,1,1
82355,190,20383,24824,59860,0,0,0,1,1
82356,190,20385,25081,59860,0,0,0,1,1
82357,190,20387,25047;25396,59860,0,0,1,1,2
82358,190,20391,25770;26031,59860,0,0,2,0,2
82359,190,20392,25872;26062;29054,59860,0,0,3,0,3
82360,190,20394,25904;29226,59860,0,0,2,0,2
82361,190,20395,26012;26176,59860,0,0,2,0,2
82362,190,20396,26058;26489;29683,59860,0,1,2,0,3
82363,190,20397,26060;26216;28983;29407,59860,0,0,4,0,4
82364,190,20398,25946;26079,59860,0,0,2,0,2
82365,190,20399,25894;26272;29507;29678,59860,0,1,3,0,4
82366,190,20400,26146,59860,0,0,1,0,1
82367,190,20401,26141;26413;29954,59860,0,1,2,0,3
82368,190,20402,26223;26638;29271;29858,59860,0,1,3,0,4
82369,190,20404,26323,59860,0,0,1,0,1
82370,190,20405,26206;26350;29598,59860,0,1,2,0,3
82371,190,20406,26355;26816,59860,0,0,2,0,2
82372,190,20408,26520;26621;29425;29687,59860,0,1,3,0,4
82373,190,20409,26504;29852,59860,0,1,1,0,2
82374,190,20410,26525;26920;29191,59860,0,0,3,0,3
82375,190,20411,26990;27059;29704;30216,59860,0,2,2,0,4
82376,190,20412,26488;26559;29177;29521;29958,59860,0,1,4,0,5
82377,190,20413,26588;26635;29614,59860,0,1,2,0,3
82378,190,20414,26623;26971;29560;29636;29885,59860,0,2,3,0,5
82379,190,20415,26509;26940;29366,59860,0,0,3,0,3
82380,190,20416,26742;29624,59860,0,1,1,0,2
82381,190,20418,26596;26735;29623;29692;29959;30037,59860,0,4,2,0,6
82382,190,20419,26743;26760,59860,0,0,2,0,2
82383,190,20420,26765;26818,59860,0,0,2,0,2
82384,190,20421,26562;26785;28593;29187;29630;30114;30570;31081,59860,1,3,4,0,8
82385,190,20422,26744;26801;29535;29868;30110,59860,0,2,3,0,5
82386,190,20423,26772;26805;29280;29871,59860,0,1,3,0,4
82387,190,20424,26704;26813;29544,59860,0,0,3,0,3
82388,190,20425,27158;27207;29904,59860,0,1,2,0,3
82389,190,20426,26826;27083;29376,59860,0,0,3,0,3
82390,190,20427,27052;29375;29561;30218,59860,0,1,3,0,4
82391,190,20428,27181;27227;29979,59860,0,1,2,0,3
82392,190,20429,26844;27232,59860,0,0,2,0,2
82393,190,20430,26851;27430;30506;30671,59860,1,1,2,0,4
82394,190,20431,26973;27221,59860,0,0,2,0,2
82395,190,20432,26866;27076,59860,0,0,2,0,2
82396,190,20433,26513;26893,59860,0,0,2,0,2
82397,190,20434,26894;27104;29293;30309,59860,0,1,3,0,4
82398,190,20435,26521;26905,59860,0,0,2,0,2
82399,190,20436,26925;27179;29902;30501;30585,59860,0,3,2,0,5
82400,190,20437,26927;27141,59860,0,0,2,0,2
82401,190,20438,26935;27131;30056,59860,0,1,2,0,3
82402,190,20439,26936;26946,59860,0,0,2,0,2
82403,190,20440,26622;26965;29558,59860,0,0,3,0,3
82404,190,20441,26984;27053;29969;30128,59860,0,2,2,0,4
82405,190,20442,26987;27171;28768;29977,59860,0,1,3,0,4
82406,190,20443,27219;27321;30064;30407;30502;30660,59860,1,3,2,0,6
82407,190,20444,22638,60225,0,0,0,1,1
82408,190,20445,23057,60225,0,0,0,1,1
82409,190,20446,23499;23877,60225,0,0,0,2,2
82410,190,20447,23699;23996,60225,0,0,0,2,2
82411,190,20451,24250,60225,0,0,0,1,1
82412,190,20455,24968;25229,60225,0,0,1,1,2
82413,190,20458,26139;26168;28745;30199,60225,0,1,3,0,4
82414,190,20460,25765;25875;29756,60225,0,1,2,0,3
82415,190,20462,25863;25881;29311,60225,0,0,3,0,3
82416,190,20464,26056;26147,60225,0,0,2,0,2
82417,190,20465,26201;26414;28665;30395,60225,0,1,3,0,4
82418,190,20466,26271;26881;30753,60225,1,0,2,0,3
82419,190,20467,26316;26450,60225,0,0,2,0,2
82420,190,20470,26405;26975;30044;30303,60225,0,2,2,0,4
82421,190,20471,26771;29628,60225,0,1,1,0,2
82422,190,20472,26326;26774;29433,60225,0,0,3,0,3
82423,190,20473,26347;26618;29686,60225,0,1,2,0,3
82424,190,20474,26512;26964,60225,0,0,2,0,2
82425,190,20475,26427;26579;29422;30202,60225,0,1,3,0,4
82426,190,20477,26747;29780;30296,60225,0,2,1,0,3
82427,190,20479,26515;26651;29859,60225,0,1,2,0,3
82428,190,20480,26641;26868,60225,0,0,2,0,2
82429,190,20481,26952;26982;29966,60225,0,1,2,0,3
82430,190,20482,26534;26722;29534;30294,60225,0,1,3,0,4
82431,190,20483,26728;27066;29894;30052,60225,0,2,2,0,4
82432,190,20484,26502;27092,60225,0,0,2,0,2
82433,190,20485,26465;26773,60225,0,0,2,0,2
82434,190,20486,26630;26810;29632,60225,0,1,2,0,3
82435,190,20487,25959;26694;28760;29182,60225,0,0,4,0,4
82436,190,20488,26733;26843;29546;30118;30400,60225,0,2,3,0,5
82437,190,20489,27047;30582,60225,0,1,1,0,2
82438,190,20490,26853;26972,60225,0,0,2,0,2
82439,190,20491,26862;26979;30215,60225,0,1,2,0,3
82440,190,20492,26391;26864;29283,60225,0,0,3,0,3
82441,190,20493,27058;27258;29909;29983,60225,0,2,2,0,4
82442,190,20494,26895;26906;29880;30042;30211,60225,0,3,2,0,5
82443,190,20495,26110;26958;30656,60225,1,0,2,0,3
82444,190,20496,26992;27359;29384;29571;30235,60225,0,1,4,0,5
82445,190,20497,27006;27325;30325;30664,60225,1,1,2,0,4
82446,190,20498,27260,60225,0,0,1,0,1
82447,190,20499,26890;27009;30126,60225,0,1,2,0,3
82448,190,20500,26757;27024;29639;30047,60225,0,2,2,0,4
82449,190,20501,27120;29898,60225,0,1,1,0,2
82450,190,20502,26497;27073;29073;29194;29797;30131,60225,0,2,4,0,6
82451,190,20503,26751;29708;29798;29896;30132,60225,0,4,1,0,5
82452,190,20504,27085;27209,60225,0,0,2,0,2
82453,190,20505,27100;27180;30134,60225,0,1,2,0,3
82454,190,20506,23013,60590,0,0,0,1,1
82455,190,20510,23364,60590,0,0,0,1,1
82456,190,20512,23553;23748,60590,0,0,0,2,2
82457,190,20513,23567;23943,60590,0,0,0,2,2
82458,190,20515,23668;23893,60590,0,0,0,2,2
82459,190,20516,23716,60590,0,0,0,1,1
82460,190,20518,23481,60590,0,0,0,1,1
82461,190,20519,23846,60590,0,0,0,1,1
82462,190,20521,24054,60590,0,0,0,1,1
82463,190,20526,24020;24189,60590,0,0,0,2,2
82464,190,20530,25307,60590,0,0,1,0,1
82465,190,20539,25259,60590,0,0,1,0,1
82466,190,20541,25251;25277,60590,0,0,2,0,2
82467,190,20542,25492;25821;29307,60590,0,0,3,0,3
82468,190,20545,26054;29069;29487;31103,60590,1,0,3,0,4
82469,190,20547,25701;25830;28475,60590,0,0,3,0,3
82470,190,20548,25871;26234;28815;29502,60590,0,0,4,0,4
82471,190,20553,26015;26582;30203,60590,0,1,2,0,3
82472,190,20554,26310;26344;28911;29763,60590,0,1,3,0,4
82473,190,20555,26044;26530;29767;30030,60590,0,2,2,0,4
82474,190,20556,26205;26342;28813;29081,60590,0,0,4,0,4
82475,190,20557,26250;26262;29086;29842;30028,60590,0,2,3,0,5
82476,190,20559,26114;26303;28979,60590,0,0,3,0,3
82477,190,20560,26666;26723;29527,60590,0,0,3,0,3
82478,190,20561,26462;28584;28820;30575;30747,60590,1,1,3,0,5
82479,190,20562,26463;26961;29703;30214,60590,0,2,2,0,4
82480,190,20565,26604;26977;29886,60590,0,1,2,0,3
82481,190,20566,27142;29021;30058;30314,60590,0,2,2,0,4
82482,190,20567,26322;26338,60590,0,0,2,0,2
82483,190,20568,26647,60590,0,0,1,0,1
82484,190,20569,26581;26663,60590,0,0,2,0,2
82485,190,20570,26670;27242;29650;29717;29807,60590,0,3,2,0,5
82486,190,20571,26677;28494,60590,0,0,2,0,2
82487,190,20572,26701;26858;29022,60590,0,0,3,0,3
82488,190,20574,26022;26764;29626;30297,60590,0,2,2,0,4
82489,190,20575,26788;26942;29965;30043,60590,0,2,2,0,4
82490,190,20576,26824;26837;30117,60590,0,1,2,0,3
82491,190,20578,27235;27248;30140;30409,60590,0,2,2,0,4
82492,190,20579,26756;26917;29701;29964,60590,0,2,2,0,4
82493,190,20580,26524;26934,60590,0,0,2,0,2
82494,190,20581,26949;27161;29192;30403,60590,0,1,3,0,4
82495,190,20582,26882;26959;29878;30210,60590,0,2,2,0,4
82496,190,20583,27007,60590,0,0,1,0,1
82497,190,20585,26799;27262;29124;29651;30231,60590,0,2,3,0,5
82498,190,20586,26684;27115;30496,60590,0,1,2,0,3
82499,190,20587,27055;27097;29290;29445;30219;31102,60590,1,1,4,0,6
82500,190,20588,27119;29377;29645;30055;30224;30405;30925,60590,1,4,2,0,7
82501,190,20589,26855;29547,60590,0,0,2,0,2
82502,190,20590,27128;27215;29905,60590,0,1,2,0,3
82503,190,20591,27078;27138;29712,60590,0,1,2,0,3
82504,190,20592,27147;27203;29455;30317;30755,60590,1,1,3,0,5
82505,190,20594,23303,60955,0,0,0,1,1
82506,190,20595,23416,60955,0,0,0,1,1
82507,190,20596,23346,60955,0,0,0,1,1
82508,190,20598,23484,60955,0,0,0,1,1
82509,190,20601,23895;24002,60955,0,0,0,2,2
82510,190,20605,24220,60955,0,0,0,1,1
82511,190,20608,24916,60955,0,0,0,1,1
82512,190,20613,24629;24755,60955,0,0,0,2,2
82513,190,20619,25130;25501,60955,0,0,2,0,2
82514,190,20620,25200;27732;28699;29929,60955,0,1,3,0,4
82515,190,20621,25056;25599,60955,0,0,1,1,2
82516,190,20628,25465;25790,60955,0,0,2,0,2
82517,190,20629,26174;26346;29510,60955,0,0,3,0,3
82518,190,20630,26006;26068;28894;29950,60955,0,1,3,0,4
82519,190,20632,25824;25905;29051;29143,60955,0,0,4,0,4
82520,190,20633,25706;28982;29241,60955,0,0,3,0,3
82521,190,20634,26739;26956;29557;29792;30302,60955,0,2,3,0,5
82522,190,20635,26370;26778;29434;29870,60955,0,1,3,0,4
82523,190,20636,26198;26348,60955,0,0,2,0,2
82524,190,20637,26498;26847,60955,0,0,2,0,2
82525,190,20638,26891;27088,60955,0,0,2,0,2
82526,190,20641,26554;26932;30213,60955,0,1,2,0,3
82527,190,20642,26615;26998;29637,60955,0,1,2,0,3
82528,190,20644,26558;26874;30120,60955,0,1,2,0,3
82529,190,20645,26584;26688,60955,0,0,2,0,2
82530,190,20647,26595;26710;29178;29855;30033,60955,0,2,3,0,5
82531,190,20648,26690;26738;28920;29693,60955,0,1,3,0,4
82532,190,20649,26606;26978,60955,0,0,2,0,2
82533,190,20650,26649;26986;30045,60955,0,1,2,0,3
82534,190,20651,26439,60955,0,0,1,0,1
82535,190,20652,26793;26861;29548;29699,60955,0,1,3,0,4
82536,190,20653,26819;26916;28834;30116,60955,0,1,3,0,4
82537,190,20654,26727;27031,60955,0,0,2,0,2
82538,190,20655,26918;27244;30067;30587,60955,0,2,2,0,4
82539,190,20656,26900;27301;30070;30233,60955,0,2,2,0,4
82540,190,20657,26803;26922;29365;29439;30123,60955,0,1,4,0,5
82541,190,20658,26955;27196;29903;30316,60955,0,2,2,0,4
82542,190,20659,27144;28928;29900;29974;30059;30843,60955,1,3,2,0,6
82543,190,20660,26996;27352;29126,60955,0,0,3,0,3
82544,190,20661,27015;27547;30341,60955,0,1,2,0,3
82545,190,20662,26339;26871;29876,60955,0,1,2,0,3
82546,190,20663,26629;26929;29441;29882,60955,0,1,3,0,4
82547,190,20664,26593;27057;29563;30492,60955,0,1,3,0,4
82548,190,20665,27002;27077;29793,60955,0,1,2,0,3
82549,190,20666,26968;27082;30133,60955,0,1,2,0,3
82550,190,20667,27224;29981;30139;30320;30408,60955,0,4,1,0,5
82551,190,20668,27096;29565;30308,60955,0,1,2,0,3
82552,190,20669,26970;27103;29559;29635,60955,0,1,3,0,4
82553,190,20670,26791;27113;29450;29971,60955,0,1,3,0,4
82554,190,20671,27252;27511;30161;30599,60955,0,2,2,0,4
82555,190,20672,27013;27118;29195;30136;30498,60955,0,2,3,0,5
82556,190,20673,26988;27145;29713;29804;30060,60955,0,3,2,0,5
82557,190,20674,26983;27146,60955,0,0,2,0,2
82558,190,20675,27149;29975;30061;30138,60955,0,3,1,0,4
82559,190,20676,27150;27542;30162;30767,60955,1,1,2,0,4
82560,190,20677,27003;27177,60955,0,0,2,0,2
82561,190,20678,27280;29719,60955,0,1,1,0,2
82562,190,20680,26886;27250,60955,0,0,2,0,2
82563,190,20681,27211;27273,60955,0,0,2,0,2
82564,190,20682,27277;27425;29463;29655,60955,0,1,3,0,4
82565,190,20686,23201,61320,0,0,0,1,1
82566,190,20689,23506;23731,61320,0,0,0,2,2
82567,190,20690,23092,61320,0,0,0,1,1
82568,190,20691,23366,61320,0,0,0,1,1
82569,190,20695,23690;23892,61320,0,0,0,2,2
82570,190,20696,24089,61320,0,0,0,1,1
82571,190,20697,24315;24415,61320,0,0,0,2,2
82572,190,20699,24094;24373,61320,0,0,0,2,2
82573,190,20703,24848,61320,0,0,0,1,1
82574,190,20709,25283,61320,0,0,1,0,1
82575,190,20711,25281,61320,0,0,1,0,1
82576,190,20713,25536;25848;28563;28960;29053,61320,0,0,5,0,5
82577,190,20715,25774;25787,61320,0,0,2,0,2
82578,190,20716,25805;26067;29318;29489,61320,0,0,4,0,4
82579,190,20718,26165;28744;30838;31005,61320,2,0,2,0,4
82580,190,20721,26371;26725,61320,0,0,2,0,2
82581,190,20722,26607,61320,0,0,1,0,1
82582,190,20723,26473;26692;29864,61320,0,1,2,0,3
82583,190,20724,26151;26393;29512,61320,0,0,3,0,3
82584,190,20726,26474;26909,61320,0,0,2,0,2
82585,190,20729,26659;26963;29427,61320,0,0,3,0,3
82586,190,20730,26661;27017;30127;30305,61320,0,2,2,0,4
82587,190,20732,26687;29004;29863;30108,61320,0,2,2,0,4
82588,190,20733,26633;26689;29525;29616,61320,0,1,3,0,4
82589,190,20734,26697;26981;29967,61320,0,1,2,0,3
82590,190,20736,26566;26836;29436;29788,61320,0,1,3,0,4
82591,190,20737,26880;27163;29361,61320,0,0,3,0,3
82592,190,20739,26876;29437;29877,61320,0,1,2,0,3
82593,190,20740,26993;29661;30598,61320,0,2,1,0,3
82594,190,20741,26931;27011;29791,61320,0,1,2,0,3
82595,190,20742,26957;27019;29888;30306,61320,0,2,2,0,4
82596,190,20743,26789;27026;29890,61320,0,1,2,0,3
82597,190,20744,26859;27038;29372,61320,0,0,3,0,3
82598,190,20745,27049;27350;30234,61320,0,1,2,0,3
82599,190,20746,27064;27127;29451;29646;29972;30225;30499,61320,0,4,3,0,7
82600,190,20747,26832;27068;29787,61320,0,1,2,0,3
82601,190,20748,27410;29723;30760,61320,1,1,1,0,3
82602,190,20749,27081;29446;29799;30053,61320,0,2,2,0,4
82603,190,20750,26716;27284,61320,0,0,2,0,2
82604,190,20751,27110;27367,61320,0,0,2,0,2
82605,190,20752,26945;27114;29644;30223,61320,0,2,2,0,4
82606,190,20753,26834;27033;29642;30754,61320,1,1,2,0,4
82607,190,20754,27137;27200;30500,61320,0,1,2,0,3
82608,190,20755,27204;27585,61320,0,0,2,0,2
82609,190,20756,27306;27360;29809;30662,61320,1,1,2,0,4
82610,190,20757,27217;27335;30318,61320,0,1,2,0,3
82611,190,20758,27166;27263;29647,61320,0,1,2,0,3
82612,190,20759,27279;27488;29814;30674;31023,61320,2,1,2,0,5
82613,190,20760,27476;29660;30764,61320,1,1,1,0,3
82614,190,20761,27591,61320,0,0,1,0,1
82615,190,20762,27264;27313;29721;30663,61320,1,1,2,0,4
82616,190,20763,27497;29817;30765,61320,1,1,1,0,3
82617,190,20764,27332;27384;30326;30589,61320,0,2,2,0,4
82618,190,20765,27130;27397,61320,0,0,2,0,2
82619,190,20766,27201;27337;29987;30412;30756,61320,1,2,2,0,5
82620,190,20768,27353;29382;30666,61320,1,0,2,0,3
82621,190,20769,27253;27546;30245;30518,61320,0,2,2,0,4
82622,190,20770,27362;27380;29810,61320,0,1,2,0,3
82623,190,20771,27354;27365;29383,61320,0,0,3,0,3
82624,190,20772,27175;27371;29722;30667,61320,1,1,2,0,4
82625,190,20773,27183;27373,61320,0,0,2,0,2
82626,190,20774,23307,61685,0,0,0,1,1
82627,190,20776,22902,61685,0,0,0,1,1
82628,190,20778,23330,61685,0,0,0,1,1
82629,190,20781,23304,61685,0,0,0,1,1
82630,190,20784,23039,61685,0,0,0,1,1
82631,190,20785,23935,61685,0,0,0,1,1
82632,190,20790,24626,61685,0,0,0,1,1
82633,190,20799,25460,61685,0,0,1,0,1
82634,190,20801,25620,61685,0,0,1,0,1
82635,190,20803,25710,61685,0,0,1,0,1
82636,190,20805,25735;25832;29222,61685,0,0,3,0,3
82637,190,20807,25780;26033;29317;29758,61685,0,1,3,0,4
82638,190,20808,25873,61685,0,0,1,0,1
82639,190,20810,26237;26902;29285;29363;29552;30122;30581,61685,0,2,5,0,7
82640,190,20812,26297;26452;29260,61685,0,0,3,0,3
82641,190,20813,26457;26533;28917;29611,61685,0,1,3,0,4
82642,190,20814,26325;26648;29272;30924,61685,1,0,3,0,4
82643,190,20815,26585;26613;29856,61685,0,1,2,0,3
82644,190,20817,26707;27061;29291;29893;30220,61685,0,2,3,0,5
82645,190,20818,26511;27022;29889,61685,0,1,2,0,3
82646,190,20819,26903;29700,61685,0,1,1,0,2
82647,190,20821,26603;26768;29277;29356;29627;29783;30039,61685,0,3,4,0,7
82648,190,20822,26749;29275;29781,61685,0,1,2,0,3
82649,190,20823,26276;26517,61685,0,0,2,0,2
82650,190,20824,26654;27155;29976;30227,61685,0,2,2,0,4
82651,190,20825,26668;26721,61685,0,0,2,0,2
82652,190,20826,26364;26786,61685,0,0,2,0,2
82653,190,20827,26758;26795;28833;29541,61685,0,0,4,0,4
82654,190,20829,27230;29360;29907;30041,61685,0,2,2,0,4
82655,190,20830,26807;29010;29543;29631;29785,61685,0,2,3,0,5
82656,190,20831,27267;27595;30168;31025,61685,1,1,2,0,4
82657,190,20832,26821;26933;29435;29633;29786,61685,0,2,3,0,5
82658,190,20833,26976;27001;29887;30304,61685,0,2,2,0,4
82659,190,20834,27626;27968;29739,61685,0,1,2,0,3
82660,190,20835,26999;27441;29574;29656;30332;30507,61685,0,3,3,0,6
82661,190,20836,27366;27445;29657,61685,0,1,2,0,3
82662,190,20837,27041;27051,61685,0,0,2,0,2
82663,190,20838,27044;27429;29464;29725;30075,61685,0,2,3,0,5
82664,190,20840,27122;27459;30334,61685,0,1,2,0,3
82665,190,20841,27176;27375;30236;30668,61685,1,1,2,0,4
82666,190,20842,27124;27178;29378;29649,61685,0,1,3,0,4
82667,190,20843,27452;27472;30597;30673,61685,1,1,2,0,4
82668,190,20844,27287;29456,61685,0,0,2,0,2
82669,190,20845,27344;27458;29917;29993;30333,61685,0,3,2,0,5
82670,190,20846,27293;27673;30936,61685,1,0,2,0,3
82671,190,20847,27720;27721;30690,61685,1,0,2,0,3
82672,190,20848,27311;29984;30588,61685,0,2,1,0,3
82673,190,20849,27080;27320;29457;29652;30144,61685,0,2,3,0,5
82674,190,20850,27075;27323;30071;30145,61685,0,2,2,0,4
82675,190,20851,27540;29920;31024,61685,1,1,1,0,3
82676,190,20852,27650;30002;30171;30432,61685,0,3,1,0,4
82677,190,20853,27288;27347;29570;30665,61685,1,0,3,0,4
82678,190,20854,27314;27369;29985;30411,61685,0,2,2,0,4
82679,190,20855,27679;30608,61685,0,1,1,0,2
82680,190,20856,27414;27450;30150;30331,61685,0,2,2,0,4
82681,190,20857,27087;27394;29203;30416;30592;30757,61685,1,2,3,0,6
82682,190,20858,23398,62050,0,0,0,1,1
82683,190,20862,23777,62050,0,0,0,1,1
82684,190,20863,23514,62050,0,0,0,1,1
82685,190,20865,23991,62050,0,0,0,1,1
82686,190,20866,24014,62050,0,0,0,1,1
82687,190,20868,24204,62050,0,0,0,1,1
82688,190,20869,24463,62050,0,0,0,1,1
82689,190,20872,24256,62050,0,0,0,1,1
82690,190,20874,24101;24300,62050,0,0,0,2,2
82691,190,20882,25447;25468,62050,0,0,2,0,2
82692,190,20884,24900;25651,62050,0,0,1,1,2
82693,190,20886,24972,62050,0,0,0,1,1
82694,190,20891,25045;25143,62050,0,0,1,1,2
82695,190,20896,25385;25584;28861,62050,0,0,3,0,3
82696,190,20897,25508,62050,0,0,1,0,1
82697,190,20898,25597;25698,62050,0,0,2,0,2
82698,190,20900,25337;25517,62050,0,0,2,0,2
82699,190,20901,25934;26170;29596,62050,0,1,2,0,3
82700,190,20902,25887;26362,62050,0,0,2,0,2
82701,190,20903,25793;25973,62050,0,0,2,0,2
82702,190,20904,25916;26301,62050,0,0,2,0,2
82703,190,20906,26500;26699,62050,0,0,2,0,2
82704,190,20907,26108;26213;29246;29326;29500,62050,0,0,5,0,5
82705,190,20912,26418;26888;29879,62050,0,1,2,0,3
82706,190,20913,26547;27343,62050,0,0,2,0,2
82707,190,20914,26652;26914;28836,62050,0,0,3,0,3
82708,190,20916,27174;30063;30228,62050,0,2,1,0,3
82709,190,20917,26632;27027;29640;29705;30048,62050,0,3,2,0,5
82710,190,20918,27246;27340;29718;29982,62050,0,2,2,0,4
82711,190,20919,26921;27062;29292;30130,62050,0,1,3,0,4
82712,190,20920,26732;27218,62050,0,0,2,0,2
82713,190,20921,27465;30336,62050,0,1,1,0,2
82714,190,20922,27037;27268,62050,0,0,2,0,2
82715,190,20923,26822;27054;29562;30050;30583,62050,0,2,3,0,5
82716,190,20924,27063;27125;29706,62050,0,1,2,0,3
82717,190,20925,27111,62050,0,0,1,0,1
82718,190,20926,27197;27281;29980;30586,62050,0,2,2,0,4
82719,190,20927,27396;27495;30329,62050,0,1,2,0,3
82720,190,20928,27318;27572;30164;30426;30678,62050,1,2,2,0,5
82721,190,20929,27255;27282;29908;30068,62050,0,2,2,0,4
82722,190,20930,27173;27302;28842;29978;30062,62050,0,2,3,0,5
82723,190,20931,27303;27796;29932;30265,62050,0,2,2,0,4
82724,190,20932,27270;27589,62050,0,0,2,0,2
82725,190,20933,27386;27487;30512;30857,62050,1,1,2,0,4
82726,190,20934,27565;27696;30687,62050,1,0,2,0,3
82727,190,20935,27631;27809;29825;30088;30266;30784,62050,1,3,2,0,6
82728,190,20936,27424;29724;30670;30762,62050,2,1,1,0,4
82729,190,20937,27830;29208,62050,0,0,2,0,2
82730,190,20940,27289;27484;29388;29729;29996;30156;30338,62050,0,4,3,0,7
82731,190,20941,27663;27793;30944,62050,1,0,2,0,3
82732,190,20942,27478;30510,62050,0,1,1,0,2
82733,190,20943,27795;29931;30439;30872,62050,1,2,1,0,4
82734,190,20944,27647;27805;30087;30355;30783;31031,62050,2,2,2,0,6
82735,190,20945,27304;27538;29919,62050,0,1,2,0,3
82736,190,20946,27545;27807;30538,62050,0,1,2,0,3
82737,190,20947,27563;27649;30685,62050,1,0,2,0,3
82738,190,20949,23618;23738,62415,0,0,0,2,2
82739,190,20950,23954,62415,0,0,0,1,1
82740,190,20951,23633;23874,62415,0,0,0,2,2
82741,190,20952,23379,62415,0,0,0,1,1
82742,190,20953,24091,62415,0,0,0,1,1
82743,190,20954,23442,62415,0,0,0,1,1
82744,190,20956,23997,62415,0,0,0,1,1
82745,190,20958,24285,62415,0,0,0,1,1
82746,190,20963,24738,62415,0,0,0,1,1
82747,190,20966,24974;25372,62415,0,0,1,1,2
82748,190,20970,24879;25273;29029,62415,0,0,2,1,3
82749,190,20973,25676;25779,62415,0,0,2,0,2
82750,190,20976,25921;26628,62415,0,0,2,0,2
82751,190,20980,26159;26238;29329,62415,0,0,3,0,3
82752,190,20981,26478;26841;29698;29963;30040,62415,0,3,2,0,5
82753,190,20983,26293;26386;29331,62415,0,0,3,0,3
82754,190,20986,26464;27034;29643;29795,62415,0,2,2,0,4
82755,190,20987,26543;26911;29553,62415,0,0,3,0,3
82756,190,20988,26145;26662;28828,62415,0,0,3,0,3
82757,190,20989,26720,62415,0,0,1,0,1
82758,190,20990,26447;26835;29872,62415,0,1,2,0,3
82759,190,20991,26907;26924;29702,62415,0,1,2,0,3
82760,190,20992,26954;27020;29369;29638,62415,0,1,3,0,4
82761,190,20993,26381;26898;29789,62415,0,1,2,0,3
82762,190,20994,27121;27165;29453;29716,62415,0,1,3,0,4
82763,190,20995,27152;27222;29568;30065;30319,62415,0,2,3,0,5
82764,190,20997,27206;27416;29811,62415,0,1,2,0,3
82765,190,20998,27234;27238;30229,62415,0,1,2,0,3
82766,190,20999,27254;27372;30073;30328,62415,0,2,2,0,4
82767,190,21000,27266;27444;29726;30238,62415,0,2,2,0,4
82768,190,21001,27186;27408;29914,62415,0,1,2,0,3
82769,190,21002,27513;27577;29736;30248;30428;30679;30933,62415,2,3,2,0,7
82770,190,21003,27129;27393;30074;30415,62415,0,2,2,0,4
82771,190,21004,27400;30330;30593;30758,62415,1,2,1,0,4
82772,190,21005,27413;27515;30761,62415,1,0,2,0,3
82773,190,21006,27614;27810,62415,0,0,2,0,2
82774,190,21007,27573;27741;30247;30427,62415,0,2,2,0,4
82775,190,21008,27828;30616,62415,0,1,1,0,2
82776,190,21009,27469;27735;30260;30436;30534,62415,0,3,2,0,5
82777,190,21010,27170;27480;30241,62415,0,1,2,0,3
82778,190,21011,27494;27657;30420;30514,62415,0,2,2,0,4
82779,190,21012,27108;27510;29732;30422;30676,62415,1,2,2,0,5
82780,190,21013,26989;27226;30066;30321,62415,0,2,2,0,4
82781,190,21014,27512;27639;29206;30605;30935,62415,1,1,3,0,5
82782,190,21015,27162;27521;29467;30339,62415,0,1,3,0,4
82783,190,21016,27427;27534;30243;30515;30600,62415,0,3,2,0,5
82784,190,21017,27536;27688;30004;30528;30938,62415,1,2,2,0,5
82785,190,21018,27272;27551;29299;29576;29662;29922;30519,62415,0,3,4,0,7
82786,190,21019,27474;27714;30005;30435,62415,0,2,2,0,4
82787,190,21020,27319;27568,62415,0,0,2,0,2
82788,190,21021,27522;27623;30001;30253,62415,0,2,2,0,4
82789,190,21022,27632;29740;30254;30524,62415,0,3,1,0,4
82790,190,21023,27800;27922;30446,62415,0,1,2,0,3
82791,190,21024,27646;27710;29300;30170;30773,62415,1,1,3,0,5
82792,190,21026,23813,62780,0,0,0,1,1
82793,190,21027,23992,62780,0,0,0,1,1
82794,190,21032,24260;24678,62780,0,0,0,2,2
82795,190,21037,25068,62780,0,0,0,1,1
82796,190,21038,24927;25050;28511,62780,0,0,1,2,3
82797,190,21041,25193,62780,0,0,1,0,1
82798,190,21047,25309,62780,0,0,1,0,1
82799,190,21052,26289;26328;29953,62780,0,1,2,0,3
82800,190,21055,26472;26537,62780,0,0,2,0,2
82801,190,21056,26578;26671;30292,62780,0,1,2,0,3
82802,190,21057,26359;26736,62780,0,0,2,0,2
82803,190,21058,27153;29714;29805;30406,62780,0,3,1,0,4
82804,190,21059,26574;26782;29695,62780,0,1,2,0,3
82805,190,21060,26806;27029;30049,62780,0,1,2,0,3
82806,190,21061,26815;27502,62780,0,0,2,0,2
82807,190,21063,27261;30230,62780,0,1,1,0,2
82808,190,21065,27025;27187;30315,62780,0,1,2,0,3
82809,190,21066,26962;27102;29970;30135,62780,0,2,2,0,4
82810,190,21067,27012;27098;29449;30404;30494;30659,62780,1,2,3,0,6
82811,190,21068,27225;27346;30146,62780,0,1,2,0,3
82812,190,21069,26839;27317;30143;30324,62780,0,2,2,0,4
82813,190,21070,27205;27330;29202;29458,62780,0,0,4,0,4
82814,190,21071,27290;27336;30141,62780,0,1,2,0,3
82815,190,21073,27341;27443;29025;29297;29465;30508;30595;30855,62780,1,2,5,0,8
82816,190,21074,27454;27600;30429,62780,0,1,2,0,3
82817,190,21075,27134;27374;29452;30312,62780,0,1,3,0,4
82818,190,21076,27223;27379;30669,62780,1,0,2,0,3
82819,190,21077,27391;27604;29925;30080;30523,62780,0,3,2,0,5
82820,190,21079,27411;30149,62780,0,1,1,0,2
82821,190,21080,27419;27560,62780,0,0,2,0,2
82822,190,21081,27586;29470;29737;29924;30079;30167;30343;30603;30682;30770,62780,2,6,2,0,10
82823,190,21082,27460;27466;29658;29994;30335;30509,62780,0,4,2,0,6
82824,190,21083,27249;27473,62780,0,0,2,0,2
82825,190,21084,27426;27490;29815;29997;30242,62780,0,3,2,0,5
82826,190,21085,27705;27822;30258;30530;31026,62780,1,2,2,0,5
82827,190,21086,27504;27709,62780,0,0,2,0,2
82828,190,21087,27483;27556;30246,62780,0,1,2,0,3
82829,190,21088,27580;27734;29663;30166;30861,62780,1,2,2,0,5
82830,190,21089,27582;27638;30249;30769,62780,1,1,2,0,4
82831,190,21090,27606;27695;30174,62780,0,1,2,0,3
82832,190,21091,27615;27768;30779,62780,1,0,2,0,3
82833,190,21092,27620;30252,62780,0,1,1,0,2
82834,190,21093,27653;27866,62780,0,0,2,0,2
82835,190,21094,27890;30359;30619;31036,62780,1,2,1,0,4
82836,190,21095,27690;27699;30529;30688,62780,1,1,2,0,4
82837,190,21096,27740;28005;30550,62780,0,1,2,0,3
82838,190,21097,27486;27722;30175;30868,62780,1,1,2,0,4
82839,190,21098,27462;27723;29928;30006;30176;30609,62780,0,4,2,0,6
82840,190,21099,27733;27838;30440,62780,0,1,2,0,3
82841,190,21101,23451,63145,0,0,0,1,1
82842,190,21103,23722,63145,0,0,0,1,1
82843,190,21105,23951,63145,0,0,0,1,1
82844,190,21106,23817,63145,0,0,0,1,1
82845,190,21108,23823,63145,0,0,0,1,1
82846,190,21109,23674,63145,0,0,0,1,1
82847,190,21113,24113,63145,0,0,0,1,1
82848,190,21114,24046,63145,0,0,0,1,1
82849,190,21118,24793;24902,63145,0,0,0,2,2
82850,190,21122,25387;25699,63145,0,0,2,0,2
82851,190,21127,25785;26204,63145,0,0,2,0,2
82852,190,21131,26164,63145,0,0,1,0,1
82853,190,21136,26532;26535;29174,63145,0,0,3,0,3
82854,190,21138,26685;26872,63145,0,0,2,0,2
82855,190,21139,26470;26770,63145,0,0,2,0,2
82856,190,21140,26802,63145,0,0,1,0,1
82857,190,21141,27275;29808;29910,63145,0,2,1,0,3
82858,190,21142,26626;26814;29697;29962;30208;30299,63145,0,4,2,0,6
82859,190,21143,26820;27220;29198;29906,63145,0,1,3,0,4
82860,190,21145,27355;29459;29912;29988;30147,63145,0,3,2,0,5
82861,190,21146,26480;27048;29373;29892;30491,63145,0,2,3,0,5
82862,190,21147,26637;27032;30852,63145,1,0,2,0,3
82863,190,21148,26745;27067;29895;30221,63145,0,2,2,0,4
82864,190,21150,27014;27596;29389;30522;30862,63145,1,1,3,0,5
82865,190,21151,27775;27811,63145,0,0,2,0,2
82866,190,21152,26941;27143;29803,63145,0,1,2,0,3
82867,190,21153,26966;27169,63145,0,0,2,0,2
82868,190,21154,27157;27415;29572;30594,63145,0,1,3,0,4
82869,190,21155,27198;27448;30596,63145,0,1,2,0,3
82870,190,21157,27151;27236;29806;30322;30503,63145,0,3,2,0,5
82871,190,21158,27331;27557;29735;30425;30768;30859,63145,2,2,2,0,6
82872,190,21159,27333;27621,63145,0,0,2,0,2
82873,190,21161,27727;27767;30693;30943,63145,2,0,2,0,4
82874,190,21162,27392;29127;29913;30591,63145,0,2,2,0,4
82875,190,21163,27395;30256;30527,63145,0,2,1,0,3
82876,190,21164,27525;27611;30430;30604,63145,0,2,2,0,4
82877,190,21165,27428;27496;29205;29466;30929,63145,1,0,4,0,5
82878,190,21166,27652;30172,63145,0,1,1,0,2
82879,190,21167,27285;27470,63145,0,0,2,0,2
82880,190,21168,27506;27917;30704,63145,1,0,2,0,3
82881,190,21169,27531;27932;30794;30953,63145,2,0,2,0,4
82882,190,21170,27567;27748;29580;30611;30692,63145,1,1,3,0,5
82883,190,21171,27541;27579;29577;29999;30165;30521,63145,0,3,3,0,6
82884,190,21172,27592;27940;29938;30447,63145,0,2,2,0,4
82885,190,21173,27594;27910;30949,63145,1,0,2,0,3
82886,190,21174,27610;28098;30369;30458,63145,0,2,2,0,4
82887,190,21175,27612;27909;29937;30361;30621;30701,63145,1,3,2,0,6
82888,190,21176,27492;29816;30158,63145,0,2,1,0,3
82889,190,21177,27648;29820;30864,63145,1,1,1,0,3
82890,190,21178,27661;30774,63145,1,0,1,0,2
82891,190,21179,27662;29743;30255,63145,0,2,1,0,3
82892,190,21180,27665;27790;30352;31030,63145,1,1,2,0,4
82893,190,21181,27942;30878;30955,63145,2,0,1,0,3
82894,190,21182,27683;27792;29472;30009,63145,0,1,3,0,4
82895,190,21183,27701;27985;30184;30547;30711,63145,1,2,2,0,5
82896,190,21184,27607;27777;30351;30780;31029,63145,2,1,2,0,5
82897,190,21185,28013;28031;31045,63145,1,0,2,0,3
82898,190,21186,27785;27945;30014;31041,63145,1,1,2,0,4
82899,190,21187,27801;27941;30448;30795,63145,1,1,2,0,4
82900,190,21188,23770,63510,0,0,0,1,1
82901,190,21189,23854,63510,0,0,0,1,1
82902,190,21191,23958;24195,63510,0,0,0,2,2
82903,190,21193,24049;24419,63510,0,0,0,2,2
82904,190,21194,23736,63510,0,0,0,1,1
82905,190,21196,24327,63510,0,0,0,1,1
82906,190,21197,24125;24166,63510,0,0,0,2,2
82907,190,21199,24212,63510,0,0,0,1,1
82908,190,21202,24134;24524,63510,0,0,0,2,2
82909,190,21203,24019,63510,0,0,0,1,1
82910,190,21205,24909;25223,63510,0,0,1,1,2
82911,190,21206,25663,63510,0,0,1,0,1
82912,190,21211,25415;25495,63510,0,0,2,0,2
82913,190,21220,26389;26555;29957,63510,0,1,2,0,3
82914,190,21221,25953;26218;29164;29247;29408,63510,0,0,5,0,5
82915,190,21222,26042;26161;29399;29760,63510,0,1,3,0,4
82916,190,21225,26324;26910;29634;30402,63510,0,2,2,0,4
82917,190,21227,26620;29348;30849,63510,1,0,2,0,3
82918,190,21228,26378;26680,63510,0,0,2,0,2
82919,190,21230,26809;27368,63510,0,0,2,0,2
82920,190,21232,26974;27435,63510,0,0,2,0,2
82921,190,21233,27004;27489;29730;30157;30513,63510,0,3,2,0,5
82922,190,21234,27278,63510,0,0,1,0,1
82923,190,21235,27243;27605;30169,63510,0,1,2,0,3
82924,190,21236,27251;27548;29998;30858,63510,1,1,2,0,4
82925,190,21238,27193;27300;29911;30069,63510,0,2,2,0,4
82926,190,21239,27307;27989;30549;30628;30712,63510,1,2,2,0,5
82927,190,21241,27406;27467;29659;30076;30154;30419,63510,0,4,2,0,6
82928,190,21242,27700;27731;30940,63510,1,0,2,0,3
82929,190,21243,27095;27446;29386;29915;29991,63510,0,2,3,0,5
82930,190,21244,27463;27651;29742;30082;30526,63510,0,3,2,0,5
82931,190,21245,27468;27637;30337,63510,0,1,2,0,3
82932,190,21246,27627;28083;29748;30885,63510,1,1,2,0,4
82933,190,21247,27508;27628;29578;30431;30771,63510,1,1,3,0,5
82934,190,21248,27535,63510,0,0,1,0,1
82935,190,21249,27383;27537;30516;30601;30930,63510,1,2,2,0,5
82936,190,21250,27455;29813;30153;30928,63510,1,2,1,0,4
82937,190,21251,27434;27561;30078;30163;30520,63510,0,3,2,0,5
82938,190,21252,27587;28099;30808,63510,1,0,2,0,3
82939,190,21253,27599;27962;30089;30708;31042,63510,2,1,2,0,5
82940,190,21254,27550;27816;29745;30356;30539;30697,63510,1,3,2,0,6
82941,190,21255,27669;27774,63510,0,0,2,0,2
82942,190,21256,27412;27672,63510,0,0,2,0,2
82943,190,21257,27385;27675;30606;30866,63510,1,1,2,0,4
82944,190,21258,27684;28129;29944;30187;30631,63510,0,3,2,0,5
82945,190,21259,27687;27999;30003;30776,63510,1,1,2,0,4
82946,190,21260,27697;27706,63510,0,0,2,0,2
82947,190,21262,27613;30081,63510,0,1,1,0,2
82948,190,21263,27746;27911;30182;30445;30622;30791,63510,1,3,2,0,6
82949,190,21264,27761;28412,63510,0,0,2,0,2
82950,190,21265,27772;28038;30552;30801;31046,63510,2,1,2,0,5
82951,190,21266,27784;28145;30971,63510,1,0,2,0,3
82952,190,21267,27802;28160,63510,0,0,2,0,2
82953,190,21268,27803;30010;30354;30696;30782,63510,2,2,1,0,5
82954,190,21269,27641;27821;29933;30615,63510,0,2,2,0,4
82955,190,21270,27713;27833;30873,63510,1,0,2,0,3
82956,190,21271,27849;28306;30728,63510,1,0,2,0,3
82957,190,21272,27861;27908;29303;29391,63510,0,0,4,0,4
82958,190,21273,27863;28103;30720,63510,1,0,2,0,3
82959,190,21274,27481;27876;29473;30699,63510,1,0,3,0,4
82960,190,21275,27643;27877;30269,63510,0,1,2,0,3
82961,190,21276,27880;28158,63510,0,0,2,0,2
82962,190,21277,27881;29583;30700;30790,63510,2,0,2,0,4
82963,190,21278,27737;29822;30083;30261,63510,0,3,1,0,4
82964,190,21279,27554;27925;30272;30626;30952,63510,1,2,2,0,5
82965,190,21280,27439;27926;29829;30013,63510,0,2,2,0,4
82966,190,21281,24181,63875,0,0,0,1,1
82967,190,21282,23812,63875,0,0,0,1,1
82968,190,21283,23726,63875,0,0,0,1,1
82969,190,21284,24136,63875,0,0,0,1,1
82970,190,21285,24268,63875,0,0,0,1,1
82971,190,21288,24518;24952,63875,0,0,0,2,2
82972,190,21289,24206,63875,0,0,0,1,1
82973,190,21291,24578,63875,0,0,0,1,1
82974,190,21296,24706;24798,63875,0,0,0,2,2
82975,190,21302,25100,63875,0,0,1,0,1
82976,190,21308,25797;25799,63875,0,0,2,0,2
82977,190,21309,25977;26230;29409;29600,63875,0,1,3,0,4
82978,190,21314,26221;26445,63875,0,0,2,0,2
82979,190,21318,26531,63875,0,0,1,0,1
82980,190,21321,26425;26682;29181;29777,63875,0,1,3,0,4
82981,190,21322,26811;27099;29801;30495,63875,0,2,2,0,4
82982,190,21324,26419;27090,63875,0,0,2,0,2
82983,190,21325,27202;27421;29812,63875,0,1,2,0,3
82984,190,21326,27257;29380,63875,0,0,2,0,2
82985,190,21328,27292;27297;30142;30323;30410;30504,63875,0,4,2,0,6
82986,190,21330,27339;27635,63875,0,0,2,0,2
82987,190,21331,27345;27608,63875,0,0,2,0,2
82988,190,21332,27105;27358;29460;30072,63875,0,1,3,0,4
82989,190,21334,27622;28117,63875,0,0,2,0,2
82990,190,21335,27456;27584;29923;30250;30602;30681,63875,1,3,2,0,6
82991,190,21336,27378;27420;30148;30237;30505;30590,63875,0,4,2,0,6
82992,190,21337,27433;27698,63875,0,0,2,0,2
82993,190,21339,27827;27958;30707;30879;30957,63875,3,0,2,0,5
82994,190,21340,27509;27570;30677,63875,1,0,2,0,3
82995,190,21341,27971,63875,0,0,1,0,1
82996,190,21342,27617;28259;30282;30380;30725,63875,1,2,2,0,5
82997,190,21343,27619;30344;30684,63875,1,1,1,0,3
82998,190,21344,27056;27574;30860,63875,1,0,2,0,3
82999,190,21345,27634;27961;30363,63875,0,1,2,0,3
83000,190,21346,27640;27924,63875,0,0,2,0,2
83001,190,21347,27658;27787;29582;30263,63875,0,1,3,0,4
83002,190,21348,27671;28021;30366,63875,0,1,2,0,3
83003,190,21349,27664;27711;30434,63875,0,1,2,0,3
83004,190,21350,27744;27799,63875,0,0,2,0,2
83005,190,21351,27564;27755,63875,0,0,2,0,2
83006,190,21352,27387;28064;30453,63875,0,1,2,0,3
83007,190,21353,27715;27773,63875,0,0,2,0,2
83008,190,21354,27783;27905,63875,0,0,2,0,2
83009,190,21355,27764;27944,63875,0,0,2,0,2
83010,190,21356,27836;27862,63875,0,0,2,0,2
83011,190,21357,27869;27887;29936,63875,0,1,2,0,3
83012,190,21358,27885;27972;30450;30881,63875,1,1,2,0,4
83013,190,21360,27916;27930;30183;30703,63875,1,1,2,0,4
83014,190,21361,28007;28119;30887,63875,1,0,2,0,3
83015,190,21362,27808;27969;30880,63875,1,0,2,0,3
83016,190,21363,27979,63875,0,0,1,0,1
83017,190,21364,27762;28018;30713;30961,63875,2,0,2,0,4
83018,190,21365,28273;30467;30979,63875,1,1,1,0,3
83019,190,21366,27782;27936;30705;30877,63875,2,0,2,0,4
83020,190,21367,24237,64240,0,0,0,1,1
83021,190,21368,24121,64240,0,0,0,1,1
83022,190,21370,23920,64240,0,0,0,1,1
83023,190,21371,24303,64240,0,0,0,1,1
83024,190,21374,24254,64240,0,0,0,1,1
83025,190,21375,24262,64240,0,0,0,1,1
83026,190,21376,24696,64240,0,0,0,1,1
83027,190,21377,24095,64240,0,0,0,1,1
83028,190,21378,24730,64240,0,0,0,1,1
83029,190,21381,25004,64240,0,0,0,1,1
83030,190,21382,24132,64240,0,0,0,1,1
83031,190,21388,25118,64240,0,0,1,0,1
83032,190,21391,25448;25471,64240,0,0,2,0,2
83033,190,21394,25545,64240,0,0,1,0,1
83034,190,21396,25704,64240,0,0,1,0,1
83035,190,21403,26217,64240,0,0,1,0,1
83036,190,21408,26455;26783;29278;29358;29696,64240,0,1,4,0,5
83037,190,21411,26379;26709;29531,64240,0,0,3,0,3
83038,190,21414,26748;27132;29566;29711;30311,64240,0,2,3,0,5
83039,190,21415,26865;26870;29113;29550;29875;30119,64240,0,2,4,0,6
83040,190,21416,27028;27370;29989;30414;30927,64240,1,2,2,0,5
83041,190,21418,27133;27245;29973;30057,64240,0,2,2,0,4
83042,190,21419,26540;27030;29641;30490;30851,64240,1,2,2,0,5
83043,190,21420,27107,64240,0,0,1,0,1
83044,190,21422,27237;27363;29296;29385;29653;30327;30413,64240,0,3,4,0,7
83045,190,21423,27008;27271;29199;30232,64240,0,1,3,0,4
83046,190,21424,27312;27377,64240,0,0,2,0,2
83047,190,21425,27283;27418;30417,64240,0,1,2,0,3
83048,190,21426,27518;27730;30259;30533;30869,64240,1,2,2,0,5
83049,190,21427,27072;27544;30517,64240,0,1,2,0,3
83050,190,21428,27308;27555;29468;30424,64240,0,1,3,0,4
83051,190,21429,27315;27666;29579,64240,0,0,3,0,3
83052,190,21430,27689;27781;30085,64240,0,1,2,0,3
83053,190,21431,27837;30786,64240,1,0,1,0,2
83054,190,21432,27743;28090;29942;30805,64240,1,1,2,0,4
83055,190,21433,27749;27750;29824;30612;30942,64240,1,2,2,0,5
83056,190,21434,27931;28093;30806,64240,1,0,2,0,3
83057,190,21435,27763;29471;30262,64240,0,1,2,0,3
83058,190,21436,27779;27950;30274;30449,64240,0,2,2,0,4
83059,190,21437,27461;27798;30353;30781,64240,1,1,2,0,4
83060,190,21438,27854;27855;30441;30542;30698,64240,1,2,2,0,5
83061,190,21439,27819;28220;30635,64240,0,1,2,0,3
83062,190,21440,28001;28124;30888,64240,1,0,2,0,3
83063,190,21441,27899;28120;30444,64240,0,1,2,0,3
83064,190,21442,28344;30900,64240,1,0,1,0,2
83065,190,21443,27934;28060;30277;30629;30965,64240,1,2,2,0,5
83066,190,21444,27948;28155;31051,64240,1,0,2,0,3
83067,190,21445,27949;28274,64240,0,0,2,0,2
83068,190,21446,27758;27914;29827;30270;30623;30702;30792;30950;31038,64240,4,3,2,0,9
83069,190,21447,27952;28441,64240,0,0,2,0,2
83070,190,21448,28172;30890,64240,1,0,1,0,2
83071,190,21449,27984;30958;31044,64240,2,0,1,0,3
83072,190,21450,27655;27995,64240,0,0,2,0,2
83073,190,21452,28030;28041;30716,64240,1,0,2,0,3
83074,190,21453,28045,64240,0,0,1,0,1
83075,190,21454,28055;28319;31064,64240,1,0,2,0,3
83076,190,21455,28042;28058,64240,0,0,2,0,2
83077,190,21456,28061;28310;30562;31063,64240,1,1,2,0,4
83078,190,21457,28072;28197;29832,64240,0,1,2,0,3
83079,190,21458,28079;28347,64240,0,0,2,0,2
83080,190,21459,27825;28092,64240,0,0,2,0,2
83081,190,21460,28100;28390,64240,0,0,2,0,2
83082,190,21461,28106,64240,0,0,1,0,1
83083,190,21462,28086;28118;30556,64240,0,1,2,0,3
83084,190,21463,27898;28125;30279;30459;31050,64240,1,2,2,0,5
83085,190,21464,24128,64605,0,0,0,1,1
83086,190,21465,23721,64605,0,0,0,1,1
83087,190,21466,23965,64605,0,0,0,1,1
83088,190,21468,24211,64605,0,0,0,1,1
83089,190,21469,24245,64605,0,0,0,1,1
83090,190,21472,24221;24310,64605,0,0,0,2,2
83091,190,21474,24885,64605,0,0,0,1,1
83092,190,21475,24882,64605,0,0,0,1,1
83093,190,21476,24648;24727,64605,0,0,0,2,2
83094,190,21478,24763,64605,0,0,0,1,1
83095,190,21482,25098;25212,64605,0,0,2,0,2
83096,190,21484,25285;25702,64605,0,0,2,0,2
83097,190,21485,25563,64605,0,0,1,0,1
83098,190,21486,25668,64605,0,0,1,0,1
83099,190,21487,25734;25901,64605,0,0,2,0,2
83100,190,21489,25864;26471,64605,0,0,2,0,2
83101,190,21497,26679,64605,0,0,1,0,1
83102,190,21498,27356,64605,0,0,1,0,1
83103,190,21500,26650;27021;29370,64605,0,0,3,0,3
83104,190,21501,27035;27184;30926,64605,1,0,2,0,3
83105,190,21503,27216;29727;30155;30240,64605,0,3,1,0,4
83106,190,21505,27324;27581;30680,64605,1,0,2,0,3
83107,190,21506,27625;29738;30345,64605,0,2,1,0,3
83108,190,21507,27351;27618;30251,64605,0,1,2,0,3
83109,190,21508,27228;27539;29733;30077;30931,64605,1,2,2,0,5
83110,190,21509,27516;27900;30360;31037,64605,1,1,2,0,4
83111,190,21510,28050;30964,64605,1,0,1,0,2
83112,190,21511,27530;27578,64605,0,0,2,0,2
83113,190,21512,27609;27933;30627;30876;30954,64605,2,1,2,0,5
83114,190,21513,27703;29301;29821;30349;30778,64605,1,2,2,0,5
83115,190,21514,27751;28123,64605,0,0,2,0,2
83116,190,21515,27453;27742;29823;30350;30437;31028,64605,1,3,2,0,6
83117,190,21516,28161;28252;30560;30637;30897;31058,64605,2,2,2,0,6
83118,190,21517,27692;28130;30632;30811;30969,64605,2,1,2,0,5
83119,190,21518,27794;27903;30948,64605,1,0,2,0,3
83120,190,21519,27823;31032,64605,1,0,1,0,2
83121,190,21520,27844;28214;30463;30893,64605,1,1,2,0,4
83122,190,21521,27857;28026;30358;30442;30787;31034,64605,2,2,2,0,6
83123,190,21522,28284;30381;30561,64605,0,2,1,0,3
83124,190,21523,27766;28275;30817;30898,64605,2,0,2,0,4
83125,190,21524,27906;28135;30460,64605,0,1,2,0,3
83126,190,21525,28054;28115;30554,64605,0,1,2,0,3
83127,190,21526,27964;30364;30796,64605,1,1,1,0,3
83128,190,21528,27939;28358,64605,0,0,2,0,2
83129,190,21529,27815;28022;30714,64605,1,0,2,0,3
83130,190,21530,28051;28268;30285,64605,0,1,2,0,3
83131,190,21531,27889;28056;30092;30186;30452;31048,64605,1,3,2,0,6
83132,190,21532,28062;29941;30717,64605,1,1,1,0,3
83133,190,21533,28065;28076;30454,64605,0,1,2,0,3
83134,190,21534,28081;28095;30456,64605,0,1,2,0,3
83135,190,21535,28032;28133;29833;30721,64605,1,1,2,0,4
83136,190,21536,28138;28471;30734,64605,1,0,2,0,3
83137,190,21537,28141;28299,64605,0,0,2,0,2
83138,190,21538,28159;28200;29834;31055,64605,1,1,2,0,4
83139,190,21539,27902;28170,64605,0,0,2,0,2
83140,190,21540,28080;28175;30804,64605,1,0,2,0,3
83141,190,21541,28271;28543,64605,0,0,2,0,2
83142,190,21542,28199;28372,64605,0,0,2,0,2
83143,190,21543,28544,64605,0,0,1,0,1
83144,190,21544,28210;28431;30195,64605,0,1,2,0,3
83145,190,21545,28329;30639,64605,0,1,1,0,2
83146,190,21546,28174;28227;30896,64605,1,0,2,0,3
83147,190,21547,24448,64970,0,0,0,1,1
83148,190,21548,24465,64970,0,0,0,1,1
83149,190,21549,24072,64970,0,0,0,1,1
83150,190,21550,24617;24724,64970,0,0,0,2,2
83151,190,21551,24443,64970,0,0,0,1,1
83152,190,21555,24903,64970,0,0,0,1,1
83153,190,21558,24987;25123,64970,0,0,1,1,2
83154,190,21559,25340,64970,0,0,1,0,1
83155,190,21560,25445;25496,64970,0,0,2,0,2
83156,190,21563,25690,64970,0,0,1,0,1
83157,190,21570,25844,64970,0,0,1,0,1
83158,190,21572,26254,64970,0,0,1,0,1
83159,190,21574,26950;27528,64970,0,0,2,0,2
83160,190,21575,26845;26852;30209;30401,64970,0,2,2,0,4
83161,190,21576,26915;27437;29573;30151;30418;30672;30763,64970,2,2,3,0,7
83162,190,21577,27046;27094,64970,0,0,2,0,2
83163,190,21578,26627;26752;29773;30034,64970,0,2,2,0,4
83164,190,21580,27259;27636;29462;29654;29819;29926;30863,64970,1,3,3,0,7
83165,190,21581,27597;27603;29818;30683;30934,64970,2,1,2,0,5
83166,190,21583,27364;27507;30160,64970,0,1,2,0,3
83167,190,21584,27404;27756;30613,64970,0,1,2,0,3
83168,190,21585,27438;27479;29387;29728;29918;29995;30511,64970,0,4,3,0,7
83169,190,21586,27229;27451;30152,64970,0,1,2,0,3
83170,190,21587,27629;27851;29935;30874,64970,1,1,2,0,4
83171,190,21588,27503;28033;29831;30715,64970,1,1,2,0,4
83172,190,21589,27559;27865;30788,64970,1,0,2,0,3
83173,190,21590,27562;27724;29664;30177;30531;30691,64970,1,3,2,0,6
83174,190,21592,27593;27668;30346;30686;30775,64970,2,1,2,0,5
83175,190,21593,27660;28198;30376,64970,0,1,2,0,3
83176,190,21594,27676;28006,64970,0,0,2,0,2
83177,190,21595,27499;28019,64970,0,0,2,0,2
83178,190,21596,27864;30011,64970,0,1,1,0,2
83179,190,21597,27500;27789;30086;30264;30536;30695;30871,64970,2,3,2,0,7
83180,190,21598,27602;27867;30543,64970,0,1,2,0,3
83181,190,21599,27868;30181;30544;30789,64970,1,2,1,0,4
83182,190,21600,27769;27872,64970,0,0,2,0,2
83183,190,21601,27873;28184,64970,0,0,2,0,2
83184,190,21602,27938;28173;30722;31052,64970,2,0,2,0,4
83185,190,21603,27943;28485;30908;31076,64970,2,0,2,0,4
83186,190,21604,27951;28180;30373;30461,64970,0,2,2,0,4
83187,190,21605,27956;28534;30389,64970,0,1,2,0,3
83188,190,21606,27970;28057;29940,64970,0,1,2,0,3
83189,190,21607,27974;28110;30370,64970,0,1,2,0,3
83190,190,21608,27998;28139;30094;30188,64970,0,2,2,0,4
83191,190,21609,27717,64970,0,0,1,0,1
83192,190,21610,27856;28020;30618;30947,64970,1,1,2,0,4
83193,190,21611,28540;28652;30645,64970,0,1,2,0,3
83194,190,21612,28052;28416,64970,0,0,2,0,2
83195,190,21613,27804;28053;30367;30451;30883;31047,64970,2,2,2,0,6
83196,190,21614,28068;28218,64970,0,0,2,0,2
83197,190,21615,28097;28205;30017;30368;30967,64970,1,2,2,0,5
83198,190,21616,28105;28479,64970,0,0,2,0,2
83199,190,21618,28112,64970,0,0,1,0,1
83200,190,21619,28163;28221;30378;30464;30895;31056,64970,2,2,2,0,6
83201,190,21620,27960;28238;30636;30978,64970,1,1,2,0,4
83202,190,21621,28246;28518;30909,64970,1,0,2,0,3
83203,190,21622,28254;28423;30194;30289;30566,64970,0,3,2,0,5
83204,190,21623,27630;28264;30020;30284,64970,0,2,2,0,4
83205,190,21624,28142;28291,64970,0,0,2,0,2
83206,190,21625,27983;28295;30190,64970,0,1,2,0,3
83207,190,21626,28311;28578,64970,0,0,2,0,2
83208,190,21628,24651;24674,65335,0,0,0,2,2
83209,190,21629,24855,65335,0,0,0,1,1
83210,190,21633,24953,65335,0,0,0,1,1
83211,190,21634,24910,65335,0,0,0,1,1
83212,190,21636,24891,65335,0,0,0,1,1
83213,190,21637,25011,65335,0,0,0,1,1
83214,190,21639,25380,65335,0,0,1,0,1
83215,190,21642,25627;25767,65335,0,0,2,0,2
83216,190,21644,25851,65335,0,0,1,0,1
83217,190,21645,25868,65335,0,0,1,0,1
83218,190,21649,26135;28742;29160,65335,0,0,3,0,3
83219,190,21651,26305;26527;29173,65335,0,0,3,0,3
83220,190,21652,26420,65335,0,0,1,0,1
83221,190,21653,26624;26878,65335,0,0,2,0,2
83222,190,21656,26616;29424;29615,65335,0,1,2,0,3
83223,190,21657,26884,65335,0,0,1,0,1
83224,190,21658,26597,65335,0,0,1,0,1
83225,190,21660,27164,65335,0,0,1,0,1
83226,190,21663,27213;27409;30759,65335,1,0,2,0,3
83227,190,21665,27402,65335,0,0,1,0,1
83228,190,21669,27348,65335,0,0,1,0,1
83229,190,21672,28363;30384;30640,65335,0,2,1,0,3
83230,190,21673,27309;27694;29927;30348;30777,65335,1,2,2,0,5
83231,190,21674,27824;28217;30894;30976,65335,2,0,2,0,4
83232,190,21675,27527;27834,65335,0,0,2,0,2
83233,190,21676,27846;27853;29666,65335,0,1,2,0,3
83234,190,21678,27892;28084,65335,0,0,2,0,2
83235,190,21679,27566;27901;29747,65335,0,1,2,0,3
83236,190,21680,27878;27915;30271;30951,65335,1,1,2,0,4
83237,190,21681,27817;28003;30798;30959,65335,2,0,2,0,4
83238,190,21683,27997;28297;29752;30286;30980,65335,1,2,2,0,5
83239,190,21684,28049;28280,65335,0,0,2,0,2
83240,190,21685,27850;27966;31043,65335,1,0,2,0,3
83241,190,21686,28074;28326;30984,65335,1,0,2,0,3
83242,190,21687,28230;30815;31057,65335,2,0,1,0,3
83243,190,21688,28108;28466;30473,65335,0,1,2,0,3
83244,190,21689,28132,65335,0,0,1,0,1
83245,190,21690,28334;30022;30820,65335,1,1,1,0,3
83246,190,21691,28178;28524;30737;31079,65335,2,0,2,0,4
83247,190,21692,27860,65335,0,0,1,0,1
83248,190,21693,28377;30824,65335,1,0,1,0,2
83249,190,21694,28077;28239;30465;30816,65335,1,1,2,0,4
83250,190,21695,28241;28301;30095,65335,0,1,2,0,3
83251,190,21696,27919;28245;30379,65335,0,1,2,0,3
83252,190,21697,28251;28375;30987,65335,1,0,2,0,3
83253,190,21698,28122;28257,65335,0,0,2,0,2
83254,190,21699,28187;28258;30638,65335,0,1,2,0,3
83255,190,21700,28279;31061,65335,1,0,1,0,2
83256,190,21701,28151;28294;30726,65335,1,0,2,0,3
83257,190,21702,28082;28303;30021;31062,65335,1,1,2,0,4
83258,190,21703,28341;28643,65335,0,0,2,0,2
83259,190,21704,28349;28616;31082,65335,1,0,2,0,3
83260,190,21705,28307;28353;30287,65335,0,1,2,0,3
83261,190,21706,28014,65335,0,0,1,0,1
83262,190,21707,28365;28644;30741,65335,1,0,2,0,3
83263,190,21708,28367;28677,65335,0,0,2,0,2
83264,190,21709,28256;28595;30290,65335,0,1,2,0,3
83265,190,21710,28401;28679,65335,0,0,2,0,2
83266,190,21711,28386;28626,65335,0,0,2,0,2
83267,190,21712,28213;28393,65335,0,0,2,0,2
83268,190,21713,28395;28482;30907;31075,65335,2,0,2,0,4
83269,190,21714,28408;28656;30025;30834,65335,1,1,2,0,4
83270,190,21716,24637,65700,0,0,0,1,1
83271,190,21719,24682,65700,0,0,0,1,1
83272,190,21720,24461,65700,0,0,0,1,1
83273,190,21721,24895,65700,0,0,0,1,1
83274,190,21722,24956,65700,0,0,0,1,1
83275,190,21723,24989,65700,0,0,0,1,1
83276,190,21725,25041,65700,0,0,0,1,1
83277,190,21726,24779,65700,0,0,0,1,1
83278,190,21728,25312,65700,0,0,1,0,1
83279,190,21730,25331,65700,0,0,1,0,1
83280,190,21734,25115,65700,0,0,1,0,1
83281,190,21738,25971,65700,0,0,1,0,1
83282,190,21739,26231;26287,65700,0,0,2,0,2
83283,190,21742,26336,65700,0,0,1,0,1
83284,190,21744,27045,65700,0,0,1,0,1
83285,190,21746,27349,65700,0,0,1,0,1
83286,190,21747,27192;27417,65700,0,0,2,0,2
83287,190,21748,27431;27839;30268;30945,65700,1,1,2,0,4
83288,190,21750,27514;27778;30008,65700,0,1,2,0,3
83289,190,21751,27156;27523;29575;30423,65700,0,1,3,0,4
83290,190,21753,27601;28017,65700,0,0,2,0,2
83291,190,21754,27310;27644;30525;30772,65700,1,1,2,0,4
83292,190,21757,27771,65700,0,0,1,0,1
83293,190,21758,27791;27894;30537,65700,0,1,2,0,3
83294,190,21759,27852;30180;30617;30875,65700,1,2,1,0,4
83295,190,21760,27927,65700,0,0,1,0,1
83296,190,21761,27988;27992;29474;29939,65700,0,1,3,0,4
83297,190,21762,28002;28015;29830;30015;30185;30960,65700,1,3,2,0,6
83298,190,21763,28457,65700,0,0,1,0,1
83299,190,21764,28012;28192;30375;30973,65700,1,1,2,0,4
83300,190,21765,27702;28044;30553;30882;30963,65700,2,1,2,0,5
83301,190,21766,28048,65700,0,0,1,0,1
83302,190,21768,28206;28500,65700,0,0,2,0,2
83303,190,21769,28240;28267,65700,0,0,2,0,2
83304,190,21770,28433,65700,0,0,1,0,1
83305,190,21771,28270,65700,0,0,1,0,1
83306,190,21772,28288;28493,65700,0,0,2,0,2
83307,190,21773,28094;28292,65700,0,0,2,0,2
83308,190,21774,28362;28601,65700,0,0,2,0,2
83309,190,21775,27590,65700,0,0,1,0,1
83310,190,21776,28380;28638,65700,0,0,2,0,2
83311,190,21777,27963;28388;29945;30565,65700,0,2,2,0,4
83312,190,21778,28405;31069,65700,1,0,1,0,2
83313,190,21779,27959;28411,65700,0,0,2,0,2
83314,190,21781,28289;28576,65700,0,0,2,0,2
83315,190,21782,28107;28440,65700,0,0,2,0,2
83316,190,21783,28445;30196;31072,65700,1,1,1,0,3
83317,190,21784,28450;28560;30996,65700,1,0,2,0,3
83318,190,21785,28451;28600;30911,65700,1,0,2,0,3
83319,190,21786,28435;28452;30731;30905,65700,2,0,2,0,4
83320,190,21787,28453;28730;30573;30745;31003,65700,2,1,2,0,5
83321,190,21788,28456;30643,65700,0,1,1,0,2
83322,190,21789,27996;28467,65700,0,0,2,0,2
83323,190,21790,28470;28550,65700,0,0,2,0,2
83324,190,21791,28474;28607;30479,65700,0,1,2,0,3
83325,190,21792,24559,66065,0,0,0,1,1
83326,190,21794,24876,66065,0,0,0,1,1
83327,190,21795,25137;25533,66065,0,0,2,0,2
83328,190,21797,25248,66065,0,0,1,0,1
83329,190,21798,25402,66065,0,0,1,0,1
83330,190,21799,25429,66065,0,0,1,0,1
83331,190,21801,25682,66065,0,0,1,0,1
83332,190,21804,25642;25943,66065,0,0,2,0,2
83333,190,21807,26001,66065,0,0,1,0,1
83334,190,21809,26020;26142;29405;30850,66065,1,0,3,0,4
83335,190,21811,26182;26294,66065,0,0,2,0,2
83336,190,21813,25929;25995,66065,0,0,2,0,2
83337,190,21814,26510;26572;28824;29267;31010,66065,1,0,4,0,5
83338,190,21816,26550,66065,0,0,1,0,1
83339,190,21818,26673,66065,0,0,1,0,1
83340,190,21820,26458,66065,0,0,1,0,1
83341,190,21821,26817;27403;29990,66065,0,1,2,0,3
83342,190,21822,26560,66065,0,0,1,0,1
83343,190,21825,27160;27316,66065,0,0,2,0,2
83344,190,21826,26951;27299;30661,66065,1,0,2,0,3
83345,190,21827,26937,66065,0,0,1,0,1
83346,190,21828,26930;27168,66065,0,0,2,0,2
83347,190,21829,27194;27831;29746;30540;31033,66065,1,2,2,0,5
83348,190,21830,27199,66065,0,0,1,0,1
83349,190,21831,27240;27269;29379,66065,0,0,3,0,3
83350,190,21833,27256;27357,66065,0,0,2,0,2
83351,190,21834,27286;27814;30785,66065,1,0,2,0,3
83352,190,21835,27327;27946,66065,0,0,2,0,2
83353,190,21836,27529;27897;29826,66065,0,1,2,0,3
83354,190,21837,27074,66065,0,0,1,0,1
83355,190,21838,26892;27449;29992,66065,0,1,2,0,3
83356,190,21839,27543;27642;29734;29921;30244;30340,66065,0,4,2,0,6
83357,190,21840,27549;27576;29469;30342;30932,66065,1,1,3,0,5
83358,190,21841,27191,66065,0,0,1,0,1
83359,190,21842,27654,66065,0,0,1,0,1
83360,190,21843,27953;28113;30810;30886,66065,2,0,2,0,4
83361,190,21844,27659;27670;30865,66065,1,0,2,0,3
83362,190,21845,27820;27954,66065,0,0,2,0,2
83363,190,21847,28162;28410;30193,66065,0,1,2,0,3
83364,190,21849,27757;27842;29390;30178;30438;30870,66065,1,2,3,0,6
83365,190,21850,27858;28036;30962,66065,1,0,2,0,3
83366,190,21851,27923;28004;31039,66065,1,0,2,0,3
83367,190,21852,27754;28316;30191,66065,0,1,2,0,3
83368,190,21853,27519,66065,0,0,1,0,1
83369,190,21854,28037,66065,0,0,1,0,1
83370,190,21855,28010,66065,0,0,1,0,1
83371,190,21856,28146;28492;30474;30993,66065,1,1,2,0,4
83372,190,21857,28261;30283,66065,0,1,1,0,2
83373,190,21858,28225;28278;30468,66065,0,1,2,0,3
83374,190,21859,28091;28236;30455;30719,66065,1,1,2,0,4
83375,190,21860,28165;28247;30889,66065,1,0,2,0,3
83376,190,21862,28320;28360;30899,66065,1,0,2,0,3
83377,190,21863,27955;28313;30982,66065,1,0,2,0,3
83378,190,21864,28188;28308;30374,66065,0,1,2,0,3
83379,190,21865,28328,66065,0,0,1,0,1
83380,190,21866,27993;28330;30985;31066,66065,2,0,2,0,4
83381,190,21867,28338;28361;30986,66065,1,0,2,0,3
83382,190,21868,28286;28354;30819,66065,1,0,2,0,3
83383,190,21869,28196;28369;31068,66065,1,0,2,0,3
83384,190,21870,28399;30903,66065,1,0,1,0,2
83385,190,21872,28448;28762,66065,0,0,2,0,2
83386,190,21873,28315;28459,66065,0,0,2,0,2
83387,190,21874,28478;28827,66065,0,0,2,0,2
83388,190,21876,28666,66065,0,0,1,0,1
83389,190,21877,28515;28818,66065,0,0,2,0,2
83390,190,21878,28519;28779,66065,0,0,2,0,2
83391,190,21879,28446;28575;30569;30830,66065,1,1,2,0,4
83392,190,21880,28580;28581;30648,66065,0,1,2,0,3
83393,190,21881,28371,66065,0,0,1,0,1
83394,190,21882,24676,66430,0,0,0,1,1
83395,190,21883,24493,66430,0,0,0,1,1
83396,190,21885,24538,66430,0,0,0,1,1
83397,190,21887,24646,66430,0,0,0,1,1
83398,190,21888,24519,66430,0,0,0,1,1
83399,190,21889,24141,66430,0,0,0,1,1
83400,190,21890,24951,66430,0,0,0,1,1
83401,190,21891,24599,66430,0,0,0,1,1
83402,190,21892,25165,66430,0,0,1,0,1
83403,190,21896,25580,66430,0,0,1,0,1
83404,190,21900,25909,66430,0,0,1,0,1
83405,190,21902,26040;26311,66430,0,0,2,0,2
83406,190,21903,25843,66430,0,0,1,0,1
83407,190,21906,26486;26762;29432;29537;29625;29869,66430,0,2,4,0,6
83408,190,21907,26586,66430,0,0,1,0,1
83409,190,21911,26236,66430,0,0,1,0,1
83410,190,21913,27322;27832;29665;30179,66430,0,2,2,0,4
83411,190,21914,27390;27818;30614,66430,0,1,2,0,3
83412,190,21915,27407;27680;30173;30257;30867;30937,66430,2,2,2,0,6
83413,190,21916,27583;27829;30267;30357,66430,0,2,2,0,4
83414,190,21917,27432,66430,0,0,1,0,1
83415,190,21918,27498;28016;30276;30800,66430,1,1,2,0,4
83416,190,21919,27526;27987;30091;30548;30797,66430,1,2,2,0,5
83417,190,21923,27389;27682;30347,66430,0,1,2,0,3
83418,190,21925,27896;28226;30724,66430,1,0,2,0,3
83419,190,21926,27759;28008;30365;30551;30799,66430,1,2,2,0,5
83420,190,21927,27624,66430,0,0,1,0,1
83421,190,21929,27882;28340,66430,0,0,2,0,2
83422,190,21930,27765;27907;30620,66430,0,1,2,0,3
83423,190,21932,28029;28283,66430,0,0,2,0,2
83424,190,21934,28085;28087;30016,66430,0,1,2,0,3
83425,190,21935,28096;28343;29943;30457;30807;30966,66430,2,2,2,0,6
83426,190,21936,28121;28150;30372,66430,0,1,2,0,3
83427,190,21937,27788,66430,0,0,1,0,1
83428,190,21938,28143;28185,66430,0,0,2,0,2
83429,190,21939,28089;28152;30558,66430,0,1,2,0,3
83430,190,21940,28262;28567;30997,66430,1,0,2,0,3
83431,190,21941,28688;28862;30920,66430,1,0,2,0,3
83432,190,21942,28109;28181;30462,66430,0,1,2,0,3
83433,190,21943,28211;28469;30826;30906,66430,2,0,2,0,4
83434,190,21944,28212;28263,66430,0,0,2,0,2
83435,190,21945,28232;28585,66430,0,0,2,0,2
83436,190,21946,27986;28266;31060,66430,1,0,2,0,3
83437,190,21947,28296;28481;31074,66430,1,0,2,0,3
83438,190,21948,28336;28764;30840,66430,1,0,2,0,3
83439,190,21949,28346;28697;31087,66430,1,0,2,0,3
83440,190,21950,28204;28397,66430,0,0,2,0,2
83441,190,21951,28422;28538;30197,66430,0,1,2,0,3
83442,190,21952,28439,66430,0,0,1,0,1
83443,190,21953,28430;28444;31071,66430,1,0,2,0,3
83444,190,21954,28047;28454,66430,0,0,2,0,2
83445,190,21955,28462,66430,0,0,1,0,1
83446,190,21956,28486;28919,66430,0,0,2,0,2
83447,190,21957,28323;28487;31077,66430,1,0,2,0,3
83448,190,21958,28489;28556;30100;30477;30647;31080,66430,1,3,2,0,6
83449,190,21959,28505;28659;30480,66430,0,1,2,0,3
83450,190,21960,28738;30837,66430,1,0,1,0,2
83451,190,21961,28512;30023,66430,0,1,1,0,2
83452,190,21962,28342;28432;30730;30904,66430,2,0,2,0,4
83453,190,21963,28488;28536,66430,0,0,2,0,2
83454,190,21964,28553;28908,66430,0,0,2,0,2
83455,190,21965,28549;28716;31088,66430,1,0,2,0,3
83456,190,21966,28577,66430,0,0,1,0,1
83457,190,21967,28587;28705,66430,0,0,2,0,2
83458,190,21968,28276;28589,66430,0,0,2,0,2
83459,190,21969,28594;28772,66430,0,0,2,0,2
83460,190,21970,28623;28885,66430,0,0,2,0,2
83461,190,21971,28351;28640;30833;30914,66430,2,0,2,0,4
83462,190,21972,28651;28814;30653,66430,0,1,2,0,3
83463,190,21973,28667;28713;30391,66430,0,1,2,0,3
83464,190,21974,28668;29026,66430,0,0,2,0,2
83465,190,21975,28564;28672,66430,0,0,2,0,2
83466,190,21976,24496,66795,0,0,0,1,1
83467,190,21978,24901,66795,0,0,0,1,1
83468,190,21979,24731;25131,66795,0,0,1,1,2
83469,190,21980,25142,66795,0,0,1,0,1
83470,190,21981,24945,66795,0,0,0,1,1
83471,190,21983,25320;25455,66795,0,0,2,0,2
83472,190,21984,25707,66795,0,0,1,0,1
83473,190,21985,25079,66795,0,0,0,1,1
83474,190,21987,25811,66795,0,0,1,0,1
83475,190,21990,26173,66795,0,0,1,0,1
83476,190,21991,26191,66795,0,0,1,0,1
83477,190,21994,26366,66795,0,0,1,0,1
83478,190,21996,26590,66795,0,0,1,0,1
83479,190,21997,26081,66795,0,0,1,0,1
83480,190,22000,26766;27084;29447;29709;30493,66795,0,2,3,0,5
83481,190,22001,26769,66795,0,0,1,0,1
83482,190,22002,26539;26576;29768,66795,0,1,2,0,3
83483,190,22006,26857,66795,0,0,1,0,1
83484,190,22008,27616;28025,66795,0,0,2,0,2
83485,190,22010,27338,66795,0,0,1,0,1
83486,190,22011,27588;27677;30607,66795,0,1,2,0,3
83487,190,22012,27712,66795,0,0,1,0,1
83488,190,22013,27752;28028;29581,66795,0,0,3,0,3
83489,190,22014,27112;27140;30310,66795,0,1,2,0,3
83490,190,22015,27980;28325;30563;30983,66795,1,1,2,0,4
83491,190,22017,27978;28102,66795,0,0,2,0,2
83492,190,22018,27747;27994,66795,0,0,2,0,2
83493,190,22019,28023;28078;30803,66795,1,0,2,0,3
83494,190,22020,28137;30557;30812,66795,1,1,1,0,3
83495,190,22021,28046;28312,66795,0,0,2,0,2
83496,190,22022,28126,66795,0,0,1,0,1
83497,190,22023,27920;28043;29828;30362;30624,66795,0,3,2,0,5
83498,190,22024,28234;28237;30977,66795,1,0,2,0,3
83499,190,22025,28570,66795,0,0,1,0,1
83500,190,22026,27848;28243;30466,66795,0,1,2,0,3
83501,190,22027,28136;28282,66795,0,0,2,0,2
83502,190,22028,28317;28514;30388;31078,66795,1,1,2,0,4
83503,190,22029,28322;28402;30469;30729,66795,1,1,2,0,4
83504,190,22031,28348;28689;30392,66795,0,1,2,0,3
83505,190,22032,28437;28558;30478,66795,0,1,2,0,3
83506,190,22033,28356;28442;30472;30991,66795,1,1,2,0,4
83507,190,22034,28000;28495;30475;30567;30827,66795,1,2,2,0,5
83508,190,22035,28501;28856,66795,0,0,2,0,2
83509,190,22036,28545;28895,66795,0,0,2,0,2
83510,190,22037,28554;28929,66795,0,0,2,0,2
83511,190,22038,28676;28810;30652;31008,66795,1,1,2,0,4
83512,190,22039,28606;30831,66795,1,0,1,0,2
83513,190,22040,29002;29015,66795,0,0,2,0,2
83514,190,22041,28610;28634,66795,0,0,2,0,2
83515,190,22042,28654;28888,66795,0,0,2,0,2
83516,190,22043,28661;28798,66795,0,0,2,0,2
83517,190,22044,28682;28817;30574,66795,0,1,2,0,3
83518,190,22045,28670;28755,66795,0,0,2,0,2
83519,190,22046,28673;28872,66795,0,0,2,0,2
83520,190,22047,28683;28947,66795,0,0,2,0,2
83521,190,22048,28622;28712,66795,0,0,2,0,2
83522,190,22049,28717;28893;31095,66795,1,0,2,0,3
83523,190,22050,28743;30650;31004,66795,1,1,1,0,3
83524,190,22051,28250;28753;30839;31090,66795,2,0,2,0,4
83525,190,22052,28631;28759;31006,66795,1,0,2,0,3
83526,190,22053,28761;28831,66795,0,0,2,0,2
83527,190,22054,24610,67160,0,0,0,1,1
83528,190,22055,24389,67160,0,0,0,1,1
83529,190,22056,25027,67160,0,0,0,1,1
83530,190,22057,25033,67160,0,0,0,1,1
83531,190,22058,24641,67160,0,0,0,1,1
83532,190,22059,24852,67160,0,0,0,1,1
83533,190,22060,25038,67160,0,0,0,1,1
83534,190,22062,25449,67160,0,0,1,0,1
83535,190,22063,25191,67160,0,0,1,0,1
83536,190,22064,25716,67160,0,0,1,0,1
83537,190,22067,25941,67160,0,0,1,0,1
83538,190,22068,26059;26092;27935;29152,67160,0,0,4,0,4
83539,190,22069,25679,67160,0,0,1,0,1
83540,190,22071,25982,67160,0,0,1,0,1
83541,190,22081,26863,67160,0,0,1,0,1
83542,190,22082,26883;27091;29800;29897;30222;30658,67160,1,3,2,0,6
83543,190,22083,26947;27159;29567;30853,67160,1,0,3,0,4
83544,190,22085,27188,67160,0,0,1,0,1
83545,190,22086,27093,67160,0,0,1,0,1
83546,190,22088,27464;27753;30007;30084,67160,0,2,2,0,4
83547,190,22089,27342;27361,67160,0,0,2,0,2
83548,190,22090,27326,67160,0,0,1,0,1
83549,190,22091,27656;27921;30012;30625;30793,67160,1,2,2,0,5
83550,190,22092,27681,67160,0,0,1,0,1
83551,190,22093,27422,67160,0,0,1,0,1
83552,190,22094,27716;27982,67160,0,0,2,0,2
83553,190,22095,27305;27719;30939,67160,1,0,2,0,3
83554,190,22096,27797;27991,67160,0,0,2,0,2
83555,190,22097,27813;28194;30975,67160,1,0,2,0,3
83556,190,22098,27847,67160,0,0,1,0,1
83557,190,22099,27975,67160,0,0,1,0,1
83558,190,22100,27973;28591,67160,0,0,2,0,2
83559,190,22101,27904,67160,0,0,1,0,1
83560,190,22102,28149;28650;30916;31086,67160,2,0,2,0,4
83561,190,22103,28223;28413;31070,67160,1,0,2,0,3
83562,190,22104,28233;28318,67160,0,0,2,0,2
83563,190,22105,28253;28304;31059,67160,1,0,2,0,3
83564,190,22106,28376,67160,0,0,1,0,1
83565,190,22107,28272;28663;30198,67160,0,1,2,0,3
83566,190,22108,28203;30634,67160,0,1,1,0,2
83567,190,22109,28366,67160,0,0,1,0,1
83568,190,22110,28321;28483,67160,0,0,2,0,2
83569,190,22111,28327;28611;30571,67160,0,1,2,0,3
83570,190,22112,28333;28426,67160,0,0,2,0,2
83571,190,22113,28071;28359;31067,67160,1,0,2,0,3
83572,190,22114,28374;28971,67160,0,0,2,0,2
83573,190,22115,28249;28425;30097,67160,0,1,2,0,3
83574,190,22116,28428;30098,67160,0,1,1,0,2
83575,190,22117,28166;28465;30733;31073,67160,2,0,2,0,4
83576,190,22118,28504;28898;30654,67160,0,1,2,0,3
83577,190,22119,28521;29013;31098,67160,1,0,2,0,3
83578,190,22120,28526;28822,67160,0,0,2,0,2
83579,190,22121,27835;28168,67160,0,0,2,0,2
83580,190,22122,28513;28573,67160,0,0,2,0,2
83581,190,22123,28231;28597,67160,0,0,2,0,2
83582,190,22124,28627;28732;30918,67160,1,0,2,0,3
83583,190,22125,28503;28636;30740,67160,1,0,2,0,3
83584,190,22126,28392;28691,67160,0,0,2,0,2
83585,190,22127,28696;28994;31096,67160,1,0,2,0,3
83586,190,22128,28447;28715,67160,0,0,2,0,2
83587,190,22129,28954,67160,0,0,1,0,1
83588,190,22130,28740;28865,67160,0,0,2,0,2
83589,190,22131,28741;28776,67160,0,0,2,0,2
83590,190,22132,28751;28765;31007,67160,1,0,2,0,3
83591,190,22133,28496;28790,67160,0,0,2,0,2
83592,190,22134,28532;28803,67160,0,0,2,0,2
83593,190,22135,28839;29085;30655,67160,0,1,2,0,3
83594,190,22136,25042,67525,0,0,0,1,1
83595,190,22137,25058,67525,0,0,0,1,1
83596,190,22138,25237,67525,0,0,1,0,1
83597,190,22139,24592,67525,0,0,0,1,1
83598,190,22140,25358,67525,0,0,1,0,1
83599,190,22141,25359,67525,0,0,1,0,1
83600,190,22144,25666,67525,0,0,1,0,1
83601,190,22145,25908,67525,0,0,1,0,1
83602,190,22146,25826,67525,0,0,1,0,1
83603,190,22148,26292,67525,0,0,1,0,1
83604,190,22150,26469,67525,0,0,1,0,1
83605,190,22152,26746,67525,0,0,1,0,1
83606,190,22153,26823,67525,0,0,1,0,1
83607,190,22154,27036,67525,0,0,1,0,1
83608,190,22155,27247;27598;30000,67525,0,1,2,0,3
83609,190,22156,27291;27686,67525,0,0,2,0,2
83610,190,22157,27295,67525,0,0,1,0,1
83611,190,22158,27296;28930;29720,67525,0,1,2,0,3
83612,190,22159,27298,67525,0,0,1,0,1
83613,190,22160,27401;27501;29731;30159;30421;30675;30766,67525,2,3,2,0,7
83614,190,22161,27493,67525,0,0,1,0,1
83615,190,22162,27552;27739;30941,67525,1,0,2,0,3
83616,190,22163,27423,67525,0,0,1,0,1
83617,190,22164,27475;27645,67525,0,0,2,0,2
83618,190,22165,27693;27884,67525,0,0,2,0,2
83619,190,22166,28035,67525,0,0,1,0,1
83620,190,22167,27912;28101;29749;30555,67525,0,2,2,0,4
83621,190,22168,27967;28073;30090;30546,67525,0,2,2,0,4
83622,190,22170,28127;28216;30377;30814,67525,1,1,2,0,4
83623,190,22171,28134;28438,67525,0,0,2,0,2
83624,190,22173,28293;28604;30024,67525,0,1,2,0,3
83625,190,22174,28153;28368;30823,67525,1,0,2,0,3
83626,190,22175,28186;28407;29667;30018;31054,67525,1,2,2,0,5
83627,190,22176,28381;28409,67525,0,0,2,0,2
83628,190,22177,28477;28497;30994,67525,1,0,2,0,3
83629,190,22178,28148;28484;29947;30644,67525,0,2,2,0,4
83630,190,22179,28510,67525,0,0,1,0,1
83631,190,22180,28520;28796,67525,0,0,2,0,2
83632,190,22181,28242,67525,0,0,1,0,1
83633,190,22182,28260;28574,67525,0,0,2,0,2
83634,190,22183,28473;28619,67525,0,0,2,0,2
83635,190,22184,28647;28669;30742,67525,1,0,2,0,3
83636,190,22185,28648;28662;30915,67525,1,0,2,0,3
83637,190,22186,28675;29063,67525,0,0,2,0,2
83638,190,22187,28156;28678;30481,67525,0,1,2,0,3
83639,190,22188,28731;28749,67525,0,0,2,0,2
83640,190,22189,28394;28752;30101;30919,67525,1,1,2,0,4
83641,190,22190,28499;28763;30483;30651,67525,0,2,2,0,4
83642,190,22191,28436;28774,67525,0,0,2,0,2
83643,190,22192,28782;29083,67525,0,0,2,0,2
83644,190,22193,28787;29186,67525,0,0,2,0,2
83645,190,22194,28812;30485,67525,0,1,1,0,2
83646,190,22195,28748;29011;31014,67525,1,0,2,0,3
83647,190,22196,28841;29112,67525,0,0,2,0,2
83648,190,22197,28846;28847;31093,67525,1,0,2,0,3
83649,190,22198,28870;29023;30394,67525,0,1,2,0,3
83650,190,22199,28596;28875,67525,0,0,2,0,2
83651,190,22200,28645;28878,67525,0,0,2,0,2
83652,190,22201,28844;28883,67525,0,0,2,0,2
83653,190,22202,28608;28891,67525,0,0,2,0,2
83654,190,22203,28892;29110,67525,0,0,2,0,2
83655,190,22204,28897;29111,67525,0,0,2,0,2
83656,190,22205,28902;28940,67525,0,0,2,0,2
83657,190,22206,28903;29136,67525,0,0,2,0,2
83658,190,22207,28913;29068;30845,67525,1,0,2,0,3
83659,190,22208,28916;29185;30577,67525,0,1,2,0,3
83660,190,22209,28906;28923,67525,0,0,2,0,2
83661,190,22210,28926;29176,67525,0,0,2,0,2
83662,190,22211,25151,67890,0,0,1,0,1
83663,190,22212,25874,67890,0,0,1,0,1
83664,190,22213,25992,67890,0,0,1,0,1
83665,190,22218,26715,67890,0,0,1,0,1
83666,190,22219,26660,67890,0,0,1,0,1
83667,190,22220,26944,67890,0,0,1,0,1
83668,190,22222,27101,67890,0,0,1,0,1
83669,190,22223,26842;27172;29454;29648;30854,67890,1,1,3,0,5
83670,190,22224,27231,67890,0,0,1,0,1
83671,190,22225,26913,67890,0,0,1,0,1
83672,190,22226,27265,67890,0,0,1,0,1
83673,190,22227,27381,67890,0,0,1,0,1
83674,190,22228,27388,67890,0,0,1,0,1
83675,190,22230,27553,67890,0,0,1,0,1
83676,190,22232,27895;28193;30974,67890,1,0,2,0,3
83677,190,22233,28116,67890,0,0,1,0,1
83678,190,22235,28167;29750,67890,0,1,1,0,2
83679,190,22236,28183;28215,67890,0,0,2,0,2
83680,190,22238,28314;28681;30743,67890,1,0,2,0,3
83681,190,22239,28305;28339;30470;30821,67890,1,1,2,0,4
83682,190,22240,27879;27929;31035,67890,1,0,2,0,3
83683,190,22241,28384;28480;30641;30988,67890,1,1,2,0,4
83684,190,22242,28387,67890,0,0,1,0,1
83685,190,22243,28523;30828;30995,67890,2,0,1,0,3
83686,190,22244,28400;28709;30649,67890,0,1,2,0,3
83687,190,22245,28404;28449,67890,0,0,2,0,2
83688,190,22246,28415,67890,0,0,1,0,1
83689,190,22247,28527,67890,0,0,1,0,1
83690,190,22248,28207,67890,0,0,1,0,1
83691,190,22249,28009,67890,0,0,1,0,1
83692,190,22250,28522;28658,67890,0,0,2,0,2
83693,190,22251,28525;30476,67890,0,1,1,0,2
83694,190,22252,28548;28734,67890,0,0,2,0,2
83695,190,22253,28472;28555;30735,67890,1,0,2,0,3
83696,190,22254,28559;28602;30912,67890,1,0,2,0,3
83697,190,22255,27843;28613,67890,0,0,2,0,2
83698,190,22256,28605;28686;31001,67890,1,0,2,0,3
83699,190,22257,28529;28618,67890,0,0,2,0,2
83700,190,22258,28718;29042,67890,0,0,2,0,2
83701,190,22259,28746;29197;31018,67890,1,0,2,0,3
83702,190,22260,28754;29207,67890,0,0,2,0,2
83703,190,22261,28784;28853;30393,67890,0,1,2,0,3
83704,190,22262,28807;29123,67890,0,0,2,0,2
83705,190,22263,28843,67890,0,0,1,0,1
83706,190,22264,28852,67890,0,0,1,0,1
83707,190,22265,28424;28859,67890,0,0,2,0,2
83708,190,22266,28874;29188,67890,0,0,2,0,2
83709,190,22267,28876,67890,0,0,1,0,1
83710,190,22268,28756;28881,67890,0,0,2,0,2
83711,190,22269,28900;29204,67890,0,0,2,0,2
83712,190,22270,28901;29148,67890,0,0,2,0,2
83713,190,22271,28816;28907,67890,0,0,2,0,2
83714,190,22272,28797;28948,67890,0,0,2,0,2
83715,190,22273,28997;29232,67890,0,0,2,0,2
83716,190,22274,28941;29000,67890,0,0,2,0,2
83717,190,22275,24973,68255,0,0,0,1,1
83718,190,22276,25202,68255,0,0,1,0,1
83719,190,22277,25405,68255,0,0,1,0,1
83720,190,22278,25354,68255,0,0,1,0,1
83721,190,22279,25378,68255,0,0,1,0,1
83722,190,22280,25510,68255,0,0,1,0,1
83723,190,22281,25436,68255,0,0,1,0,1
83724,190,22282,25644,68255,0,0,1,0,1
83725,190,22283,25713,68255,0,0,1,0,1
83726,190,22285,25522,68255,0,0,1,0,1
83727,190,22286,26007,68255,0,0,1,0,1
83728,190,22287,25816,68255,0,0,1,0,1
83729,190,22290,26577,68255,0,0,1,0,1
83730,190,22291,26718,68255,0,0,1,0,1
83731,190,22292,26730,68255,0,0,1,0,1
83732,190,22293,26808,68255,0,0,1,0,1
83733,190,22294,26901,68255,0,0,1,0,1
83734,190,22295,26967,68255,0,0,1,0,1
83735,190,22296,27071,68255,0,0,1,0,1
83736,190,22298,26833,68255,0,0,1,0,1
83737,190,22299,27274,68255,0,0,1,0,1
83738,190,22301,27233;27447,68255,0,0,2,0,2
83739,190,22302,27399,68255,0,0,1,0,1
83740,190,22303,27440,68255,0,0,1,0,1
83741,190,22306,27471,68255,0,0,1,0,1
83742,190,22307,27745,68255,0,0,1,0,1
83743,190,22308,27524,68255,0,0,1,0,1
83744,190,22309,27841,68255,0,0,1,0,1
83745,190,22310,27736,68255,0,0,1,0,1
83746,190,22311,27870,68255,0,0,1,0,1
83747,190,22313,27981;28646,68255,0,0,2,0,2
83748,190,22314,28169;28516;30099,68255,0,1,2,0,3
83749,190,22315,28179,68255,0,0,1,0,1
83750,190,22316,28277,68255,0,0,1,0,1
83751,190,22317,28350;28427,68255,0,0,2,0,2
83752,190,22318,28128;28373,68255,0,0,2,0,2
83753,190,22319,28224,68255,0,0,1,0,1
83754,190,22320,28378;28565,68255,0,0,2,0,2
83755,190,22321,28396;28617,68255,0,0,2,0,2
83756,190,22322,28562;28722;30482;30917,68255,1,1,2,0,4
83757,190,22323,28579,68255,0,0,1,0,1
83758,190,22324,28434;28629;30739;30832;31084,68255,3,0,2,0,5
83759,190,22325,28551;28612,68255,0,0,2,0,2
83760,190,22326,28635;28880;30487;31094,68255,1,1,2,0,4
83761,190,22327,28649;28936,68255,0,0,2,0,2
83762,190,22328,28708;28723;30572,68255,0,1,2,0,3
83763,190,22329,28287;28729;30744;30836,68255,2,0,2,0,4
83764,190,22330,28739,68255,0,0,1,0,1
83765,190,22331,28766;29030,68255,0,0,2,0,2
83766,190,22332,29121,68255,0,0,1,0,1
83767,190,22333,28800;29172,68255,0,0,2,0,2
83768,190,22334,28837,68255,0,0,1,0,1
83769,190,22335,28693;28890,68255,0,0,2,0,2
83770,190,22336,28904;29075,68255,0,0,2,0,2
83771,190,22337,29159,68255,0,0,1,0,1
83772,190,22338,28863;28921;30748;30842,68255,2,0,2,0,4
83773,190,22339,28922;28965,68255,0,0,2,0,2
83774,190,22340,28867;28964;31012,68255,1,0,2,0,3
83775,190,22341,28967;29122,68255,0,0,2,0,2
83776,190,22342,28986;29316,68255,0,0,2,0,2
83777,190,22343,28924;28993,68255,0,0,2,0,2
83778,190,22344,28996;29175,68255,0,0,2,0,2
83779,190,22345,29016;29066,68255,0,0,2,0,2
83780,190,22346,29031,68255,0,0,1,0,1
83781,190,22347,29038;29354,68255,0,0,2,0,2
83782,190,22348,29049;29237,68255,0,0,2,0,2
83783,190,22349,29067;29359;30752,68255,1,0,2,0,3
83784,190,22350,29080;29166,68255,0,0,2,0,2
83785,190,22351,29093;29298,68255,0,0,2,0,2
83786,190,22352,29099;29351,68255,0,0,2,0,2
83787,190,22353,29114;29118,68255,0,0,2,0,2
83788,190,22354,29119;29345;31101,68255,1,0,2,0,3
83789,190,22355,28775,68255,0,0,1,0,1
83790,190,22356,28918;29129,68255,0,0,2,0,2
83791,190,22357,25097,68620,0,0,1,0,1
83792,190,22358,25125,68620,0,0,1,0,1
83793,190,22359,25433,68620,0,0,1,0,1
83794,190,22360,25234,68620,0,0,1,0,1
83795,190,22361,25493,68620,0,0,1,0,1
83796,190,22362,24925,68620,0,0,0,1,1
83797,190,22363,25308,68620,0,0,1,0,1
83798,190,22366,26099,68620,0,0,1,0,1
83799,190,22369,26296,68620,0,0,1,0,1
83800,190,22371,26241,68620,0,0,1,0,1
83801,190,22372,26228;26396,68620,0,0,2,0,2
83802,190,22373,26415,68620,0,0,1,0,1
83803,190,22374,26459,68620,0,0,1,0,1
83804,190,22375,26460,68620,0,0,1,0,1
83805,190,22376,26567,68620,0,0,1,0,1
83806,190,22377,26605,68620,0,0,1,0,1
83807,190,22378,26270,68620,0,0,1,0,1
83808,190,22379,26409,68620,0,0,1,0,1
83809,190,22380,27123;27457;29916;30239;30856,68620,1,2,2,0,5
83810,190,22381,26611,68620,0,0,1,0,1
83811,190,22382,27016,68620,0,0,1,0,1
83812,190,22386,27334,68620,0,0,1,0,1
83813,190,22387,27436,68620,0,0,1,0,1
83814,190,22389,27569,68620,0,0,1,0,1
83815,190,22392,27382,68620,0,0,1,0,1
83816,190,22393,27442,68620,0,0,1,0,1
83817,190,22396,27558,68620,0,0,1,0,1
83818,190,22397,27770,68620,0,0,1,0,1
83819,190,22398,27913,68620,0,0,1,0,1
83820,190,22399,28248;28302;30382;30981,68620,1,1,2,0,4
83821,190,22400,28067;28209,68620,0,0,2,0,2
83822,190,22401,28171,68620,0,0,1,0,1
83823,190,22402,28144;28637,68620,0,0,2,0,2
83824,190,22403,28265;28389;30288,68620,0,1,2,0,3
83825,190,22405,28443;28566,68620,0,0,2,0,2
83826,190,22406,28337,68620,0,0,1,0,1
83827,190,22407,28530;28633,68620,0,0,2,0,2
83828,190,22408,28531;29180,68620,0,0,2,0,2
83829,190,22409,28419;28533;30568,68620,0,1,2,0,3
83830,190,22410,28164;28542,68620,0,0,2,0,2
83831,190,22411,28208,68620,0,0,1,0,1
83832,190,22412,28569,68620,0,0,1,0,1
83833,190,22413,28660;29134,68620,0,0,2,0,2
83834,190,22414,28502,68620,0,0,1,0,1
83835,190,22415,28684;28701,68620,0,0,2,0,2
83836,190,22416,28703,68620,0,0,1,0,1
83837,190,22417,28725;29014;31015,68620,1,0,2,0,3
83838,190,22418,28794,68620,0,0,1,0,1
83839,190,22419,28417;28757,68620,0,0,2,0,2
83840,190,22420,28609;28805,68620,0,0,2,0,2
83841,190,22421,28802;28849,68620,0,0,2,0,2
83842,190,22422,28639;28887,68620,0,0,2,0,2
83843,190,22423,28910;28984;30750,68620,1,0,2,0,3
83844,190,22424,28914,68620,0,0,1,0,1
83845,190,22425,28951;29371,68620,0,0,2,0,2
83846,190,22426,28962;29273,68620,0,0,2,0,2
83847,190,22427,28942;28970;30921,68620,1,0,2,0,3
83848,190,22428,28992;29193,68620,0,0,2,0,2
83849,190,22429,28925;29007,68620,0,0,2,0,2
83850,190,22430,29005;29009,68620,0,0,2,0,2
83851,190,22431,28621,68620,0,0,1,0,1
83852,190,22432,28598;29018,68620,0,0,2,0,2
83853,190,22433,29024;29336,68620,0,0,2,0,2
83854,190,22435,29034;29036,68620,0,0,2,0,2
83855,190,22436,28909;29084,68620,0,0,2,0,2
83856,190,22437,28931;29089,68620,0,0,2,0,2
83857,190,22438,29115;29120;31016,68620,1,0,2,0,3
83858,190,22439,25529,68985,0,0,1,0,1
83859,190,22441,25590,68985,0,0,1,0,1
83860,190,22442,25149,68985,0,0,1,0,1
83861,190,22443,25847,68985,0,0,1,0,1
83862,190,22444,25754,68985,0,0,1,0,1
83863,190,22445,25857,68985,0,0,1,0,1
83864,190,22446,25477,68985,0,0,1,0,1
83865,190,22447,26027,68985,0,0,1,0,1
83866,190,22448,26078,68985,0,0,1,0,1
83867,190,22449,26105,68985,0,0,1,0,1
83868,190,22451,26394,68985,0,0,1,0,1
83869,190,22453,26380,68985,0,0,1,0,1
83870,190,22454,26340,68985,0,0,1,0,1
83871,190,22455,26640,68985,0,0,1,0,1
83872,190,22456,26755,68985,0,0,1,0,1
83873,190,22457,26737,68985,0,0,1,0,1
83874,190,22458,26796,68985,0,0,1,0,1
83875,190,22459,27241,68985,0,0,1,0,1
83876,190,22460,26960,68985,0,0,1,0,1
83877,190,22461,27210,68985,0,0,1,0,1
83878,190,22462,27069,68985,0,0,1,0,1
83879,190,22463,27691,68985,0,0,1,0,1
83880,190,22464,27707,68985,0,0,1,0,1
83881,190,22465,27786;28352;30471;30564;30901,68985,1,2,2,0,5
83882,190,22466,27806,68985,0,0,1,0,1
83883,190,22467,27485,68985,0,0,1,0,1
83884,190,22468,27893,68985,0,0,1,0,1
83885,190,22469,27976;28027;30710,68985,1,0,2,0,3
83886,190,22470,28034,68985,0,0,1,0,1
83887,190,22472,28039,68985,0,0,1,0,1
83888,190,22473,28201;28219;30019;30892,68985,1,1,2,0,4
83889,190,22474,28104,68985,0,0,1,0,1
83890,190,22475,28355;28557,68985,0,0,2,0,2
83891,190,22476,28364;30096,68985,0,1,1,0,2
83892,190,22477,28202;28281;30633,68985,0,1,2,0,3
83893,190,22478,28189,68985,0,0,1,0,1
83894,190,22480,28460,68985,0,0,1,0,1
83895,190,22481,28468,68985,0,0,1,0,1
83896,190,22482,28539,68985,0,0,1,0,1
83897,190,22483,28541;28848;30486;31011,68985,1,1,2,0,4
83898,190,22484,28568;28630;30291;31085,68985,1,1,2,0,4
83899,190,22485,28625;28671;31083,68985,1,0,2,0,3
83900,190,22486,28702,68985,0,0,1,0,1
83901,190,22487,28721;29165;31099,68985,1,0,2,0,3
83902,190,22488,28801,68985,0,0,1,0,1
83903,190,22489,28819;29095,68985,0,0,2,0,2
83904,190,22490,28871;29200,68985,0,0,2,0,2
83905,190,22491,28905;28991,68985,0,0,2,0,2
83906,190,22492,28835;28938,68985,0,0,2,0,2
83907,190,22493,28949;29564,68985,0,0,2,0,2
83908,190,22494,28953;29341,68985,0,0,2,0,2
83909,190,22495,28961;29306,68985,0,0,2,0,2
83910,190,22496,28806;28978,68985,0,0,2,0,2
83911,190,22497,28999;29012,68985,0,0,2,0,2
83912,190,22498,29017;29374,68985,0,0,2,0,2
83913,190,22499,28860;29020,68985,0,0,2,0,2
83914,190,22500,29040;29367,68985,0,0,2,0,2
83915,190,22501,29078;29448,68985,0,0,2,0,2
83916,190,22502,29087,68985,0,0,1,0,1
83917,190,22503,29097;29461,68985,0,0,2,0,2
83918,190,22504,29104;29347,68985,0,0,2,0,2
83919,190,22505,29116,68985,0,0,1,0,1
83920,190,22506,29117,68985,0,0,1,0,1
83921,190,22507,28879;29125;31017,68985,1,0,2,0,3
83922,190,22508,29128,68985,0,0,1,0,1
83923,190,22509,29130;29516,68985,0,0,2,0,2
83924,190,22510,29132,68985,0,0,1,0,1
83925,190,22511,29135;29475,68985,0,0,2,0,2
83926,190,22512,28912,68985,0,0,1,0,1
83927,190,22513,29163;29501,68985,0,0,2,0,2
83928,190,22514,29171;29213,68985,0,0,2,0,2
83929,190,22515,29146;29224,68985,0,0,2,0,2
83930,190,22516,29242;29244,68985,0,0,2,0,2
83931,190,22517,29225;29243,68985,0,0,2,0,2
83932,190,22518,29263,68985,0,0,1,0,1
83933,190,22519,29265;29438,68985,0,0,2,0,2
83934,190,22520,29238;29279,68985,0,0,2,0,2
83935,190,22521,29282;29526,68985,0,0,2,0,2
83936,190,22522,29167;29295,68985,0,0,2,0,2
83937,190,22523,25557,69350,0,0,1,0,1
83938,190,22524,25325,69350,0,0,1,0,1
83939,190,22525,25588,69350,0,0,1,0,1
83940,190,22526,25674,69350,0,0,1,0,1
83941,190,22527,25736,69350,0,0,1,0,1
83942,190,22528,26167,69350,0,0,1,0,1
83943,190,22529,26277,69350,0,0,1,0,1
83944,190,22530,26317,69350,0,0,1,0,1
83945,190,22531,26119,69350,0,0,1,0,1
83946,190,22532,26383,69350,0,0,1,0,1
83947,190,22533,26569,69350,0,0,1,0,1
83948,190,22534,26545,69350,0,0,1,0,1
83949,190,22535,26506,69350,0,0,1,0,1
83950,190,22536,26712,69350,0,0,1,0,1
83951,190,22537,26829,69350,0,0,1,0,1
83952,190,22538,26846,69350,0,0,1,0,1
83953,190,22539,26896,69350,0,0,1,0,1
83954,190,22540,26557,69350,0,0,1,0,1
83955,190,22541,26693,69350,0,0,1,0,1
83956,190,22542,26938,69350,0,0,1,0,1
83957,190,22543,26860,69350,0,0,1,0,1
83958,190,22544,27010,69350,0,0,1,0,1
83959,190,22545,27106,69350,0,0,1,0,1
83960,190,22546,27190,69350,0,0,1,0,1
83961,190,22547,27208,69350,0,0,1,0,1
83962,190,22548,27276,69350,0,0,1,0,1
83963,190,22549,27328,69350,0,0,1,0,1
83964,190,22550,27117,69350,0,0,1,0,1
83965,190,22551,27182,69350,0,0,1,0,1
83966,190,22552,27195,69350,0,0,1,0,1
83967,190,22553,27667,69350,0,0,1,0,1
83968,190,22554,27826,69350,0,0,1,0,1
83969,190,22555,27859,69350,0,0,1,0,1
83970,190,22556,28229,69350,0,0,1,0,1
83971,190,22557,28420;28561;30910,69350,1,0,2,0,3
83972,190,22558,28490;28592;30999,69350,1,0,2,0,3
83973,190,22559,28509;28674,69350,0,0,2,0,2
83974,190,22560,28724;29006;30844,69350,1,0,2,0,3
83975,190,22561,28733,69350,0,0,1,0,1
83976,190,22562,28767;28777,69350,0,0,2,0,2
83977,190,22563,28808;29442,69350,0,0,2,0,2
83978,190,22564,28700;28851,69350,0,0,2,0,2
83979,190,22565,28866;29381,69350,0,0,2,0,2
83980,190,22566,28927;29155,69350,0,0,2,0,2
83981,190,22567,28943;29131,69350,0,0,2,0,2
83982,190,22568,28727;28966,69350,0,0,2,0,2
83983,190,22569,28990;29190,69350,0,0,2,0,2
83984,190,22570,29032;29288,69350,0,0,2,0,2
83985,190,22571,29035;29327,69350,0,0,2,0,2
83986,190,22572,29046;29048,69350,0,0,2,0,2
83987,190,22573,29058;29229,69350,0,0,2,0,2
83988,190,22574,28873;29098;30847,69350,1,0,2,0,3
83989,190,22575,29105,69350,0,0,1,0,1
83990,190,22576,28932,69350,0,0,1,0,1
83991,190,22577,29142,69350,0,0,1,0,1
83992,190,22578,28778;29183,69350,0,0,2,0,2
83993,190,22579,29214,69350,0,0,1,0,1
83994,190,22580,29270;29284;31020,69350,1,0,2,0,3
83995,190,22581,29286;29549,69350,0,0,2,0,2
83996,190,22582,29338;29350,69350,0,0,2,0,2
83997,190,22583,29340;29352,69350,0,0,2,0,2
83998,190,22584,29355,69350,0,0,1,0,1
83999,190,22585,28950;29362,69350,0,0,2,0,2
84000,200,12642,27007;27135;29196;29294;30313;30584,30660,0,1,5,0,6
84001,200,13737,23377,34675,0,0,0,1,1
84002,200,14173,23512,36135,0,0,0,1,1
84003,200,14700,23344;23960,37960,0,0,0,2,2
84004,200,15152,24235,39785,0,0,0,1,1
84005,200,15157,23588;24343,39785,0,0,0,2,2
84006,200,15176,25024;25076,39785,0,0,0,2,2
84007,200,15350,24770;25005,40515,0,0,0,2,2
84008,200,15402,22945;23107,40880,0,0,0,2,2
84009,200,15406,23688,40880,0,0,0,1,1
84010,200,15497,22953;23182,41245,0,0,0,2,2
84011,200,15536,25742;26481,41245,0,0,1,1,2
84012,200,15564,25014;25055,41245,0,0,0,2,2
84013,200,15648,24830;24905,41610,0,0,0,2,2
84014,200,15709,23968;24944,41975,0,0,0,2,2
84015,200,16150,25255,43435,0,0,0,1,1
84016,200,16151,22261,43435,0,0,0,1,1
84017,200,16251,25669;26111,43800,0,0,1,1,2
84018,200,16258,22266,43800,0,0,0,1,1
84019,200,16265,22474,43800,0,0,0,1,1
84020,200,16276,22680,43800,0,0,0,1,1
84021,200,16285,26507,43800,0,0,1,0,1
84022,200,16288,26563;26567,43800,0,0,2,0,2
84023,200,16314,24647;25083,44165,0,0,0,2,2
84024,200,16353,25957;26027,44165,0,0,0,2,2
84025,200,16406,25556,44530,0,0,0,1,1
84026,200,16415,22273,44530,0,0,0,1,1
84027,200,16444,22567,44530,0,0,0,1,1
84028,200,16508,25272,44895,0,0,0,1,1
84029,200,16527,23856;27776,44895,0,0,1,1,2
84030,200,16540,22461,44895,0,0,0,1,1
84031,200,16546,23011,44895,0,0,0,1,1
84032,200,16554,22695,44895,0,0,0,1,1
84033,200,16623,22688,45260,0,0,0,1,1
84034,200,16630,22741,45260,0,0,0,1,1
84035,200,16711,25231;25408,45625,0,0,0,2,2
84036,200,16739,22624,45625,0,0,0,1,1
84037,200,16745,23068,45625,0,0,0,1,1
84038,200,16752,23178,45625,0,0,0,1,1
84039,200,16757,23027;23169,45625,0,0,0,2,2
84040,200,16760,26763;27005;29289,45625,0,0,3,0,3
84041,200,16821,22205,45990,0,0,0,1,1
84042,200,16832,22738,45990,0,0,0,1,1
84043,200,16833,22709,45990,0,0,0,1,1
84044,200,16842,22994,45990,0,0,0,1,1
84045,200,16851,23324,45990,0,0,0,1,1
84046,200,16852,23296;26943,45990,0,0,1,1,2
84047,200,16853,22891,45990,0,0,0,1,1
84048,200,16854,23103,45990,0,0,0,1,1
84049,200,16862,23023,45990,0,0,0,1,1
84050,200,16920,22777,46355,0,0,0,1,1
84051,200,16930,22852,46355,0,0,0,1,1
84052,200,16932,25900;26032;26451;28972;29955;31274;31446;31687,46355,1,2,3,2,8
84053,200,16934,22966,46355,0,0,0,1,1
84054,200,16939,23181,46355,0,0,0,1,1
84055,200,16940,22922,46355,0,0,0,1,1
84056,200,16944,23040,46355,0,0,0,1,1
84057,200,16945,23006,46355,0,0,0,1,1
84058,200,16946,23269,46355,0,0,0,1,1
84059,200,16951,23093,46355,0,0,0,1,1
84060,200,17023,26619,46720,0,0,1,0,1
84061,200,17028,23038,46720,0,0,0,1,1
84062,200,17030,23226,46720,0,0,0,1,1
84063,200,17039,23171,46720,0,0,0,1,1
84064,200,17041,23094,46720,0,0,0,1,1
84065,200,17046,22977,46720,0,0,0,1,1
84066,200,17051,23311,46720,0,0,0,1,1
84067,200,17053,23260,46720,0,0,0,1,1
84068,200,17055,23528,46720,0,0,0,1,1
84069,200,17057,23290,46720,0,0,0,1,1
84070,200,17059,23570,46720,0,0,0,1,1
84071,200,17060,23157,46720,0,0,0,1,1
84072,200,17061,23232,46720,0,0,0,1,1
84073,200,17128,22722,47085,0,0,0,1,1
84074,200,17129,22941,47085,0,0,0,1,1
84075,200,17132,22859,47085,0,0,0,1,1
84076,200,17135,23527,47085,0,0,0,1,1
84077,200,17136,22969,47085,0,0,0,1,1
84078,200,17138,23049,47085,0,0,0,1,1
84079,200,17140,23074,47085,0,0,0,1,1
84080,200,17141,23354,47085,0,0,0,1,1
84081,200,17145,23208,47085,0,0,0,1,1
84082,200,17146,23209,47085,0,0,0,1,1
84083,200,17148,23212,47085,0,0,0,1,1
84084,200,17151,23283,47085,0,0,0,1,1
84085,200,17152,23105;23289,47085,0,0,0,2,2
84086,200,17155,23541,47085,0,0,0,1,1
84087,200,17157,23639,47085,0,0,0,1,1
84088,200,17158,23396,47085,0,0,0,1,1
84089,200,17160,23339;23816,47085,0,0,0,2,2
84090,200,17203,22282,47450,0,0,0,1,1
84091,200,17213,22405,47450,0,0,0,1,1
84092,200,17219,22971,47450,0,0,0,1,1
84093,200,17226,23058,47450,0,0,0,1,1
84094,200,17229,22882,47450,0,0,0,1,1
84095,200,17231,26210,47450,0,0,1,0,1
84096,200,17236,23280,47450,0,0,0,1,1
84097,200,17238,23518,47450,0,0,0,1,1
84098,200,17242,22861;23206,47450,0,0,0,2,2
84099,200,17245,23272,47450,0,0,0,1,1
84100,200,17246,23288,47450,0,0,0,1,1
84101,200,17249,23323,47450,0,0,0,1,1
84102,200,17250,23328,47450,0,0,0,1,1
84103,200,17251,23592,47450,0,0,0,1,1
84104,200,17252,23684,47450,0,0,0,1,1
84105,200,17253,23386;23544,47450,0,0,0,2,2
84106,200,17254,23424,47450,0,0,0,1,1
84107,200,17325,24209,47815,0,0,0,1,1
84108,200,17326,23443,47815,0,0,0,1,1
84109,200,17330,23715,47815,0,0,0,1,1
84110,200,17333,23609,47815,0,0,0,1,1
84111,200,17334,23596,47815,0,0,0,1,1
84112,200,17335,23369,47815,0,0,0,1,1
84113,200,17340,23422,47815,0,0,0,1,1
84114,200,17342,23533,47815,0,0,0,1,1
84115,200,17344,23414,47815,0,0,0,1,1
84116,200,17348,23559,47815,0,0,0,1,1
84117,200,17349,23385,47815,0,0,0,1,1
84118,200,17350,23881,47815,0,0,0,1,1
84119,200,17351,23713,47815,0,0,0,1,1
84120,200,17352,23297,47815,0,0,0,1,1
84121,200,17353,23585,47815,0,0,0,1,1
84122,200,17357,22992;23428,47815,0,0,0,2,2
84123,200,17358,23642,47815,0,0,0,1,1
84124,200,17410,22897,48180,0,0,0,1,1
84125,200,17414,22840,48180,0,0,0,1,1
84126,200,17418,23110,48180,0,0,0,1,1
84127,200,17421,23758,48180,0,0,0,1,1
84128,200,17422,23042,48180,0,0,0,1,1
84129,200,17428,23233,48180,0,0,0,1,1
84130,200,17431,23526,48180,0,0,0,1,1
84131,200,17433,23453,48180,0,0,0,1,1
84132,200,17434,23483,48180,0,0,0,1,1
84133,200,17435,23434;23605,48180,0,0,0,2,2
84134,200,17436,23520;23671,48180,0,0,0,2,2
84135,200,17437,23488,48180,0,0,0,1,1
84136,200,17438,23840,48180,0,0,0,1,1
84137,200,17439,23490;23536,48180,0,0,0,2,2
84138,200,17443,23561,48180,0,0,0,1,1
84139,200,17445,23786,48180,0,0,0,1,1
84140,200,17446,23883,48180,0,0,0,1,1
84141,200,17448,23368;23606,48180,0,0,0,2,2
84142,200,17449,23608,48180,0,0,0,1,1
84143,200,17451,23638;23654,48180,0,0,0,2,2
84144,200,17452,23657,48180,0,0,0,1,1
84145,200,17453,23645;23658,48180,0,0,0,2,2
84146,200,17496,22905,48545,0,0,0,1,1
84147,200,17512,26945;27126;29710,48545,0,0,3,0,3
84148,200,17514,23063,48545,0,0,0,1,1
84149,200,17516,23158,48545,0,0,0,1,1
84150,200,17517,23191,48545,0,0,0,1,1
84151,200,17519,23607;23791,48545,0,0,0,2,2
84152,200,17520,23584;23631,48545,0,0,0,2,2
84153,200,17522,23392,48545,0,0,0,1,1
84154,200,17525,23429,48545,0,0,0,1,1
84155,200,17526,23065,48545,0,0,0,1,1
84156,200,17528,23815,48545,0,0,0,1,1
84157,200,17531,23565,48545,0,0,0,1,1
84158,200,17532,23922,48545,0,0,0,1,1
84159,200,17533,23626;23890,48545,0,0,0,2,2
84160,200,17534,23655;24018,48545,0,0,0,2,2
84161,200,17535,23886,48545,0,0,0,1,1
84162,200,17536,24035,48545,0,0,0,1,1
84163,200,17541,23967,48545,0,0,0,1,1
84164,200,17586,22394,48910,0,0,0,1,1
84165,200,17589,23101,48910,0,0,0,1,1
84166,200,17600,23391,48910,0,0,0,1,1
84167,200,17607,23234;23441,48910,0,0,0,2,2
84168,200,17610,23480,48910,0,0,0,1,1
84169,200,17611,23331,48910,0,0,0,1,1
84170,200,17613,28189;28588,48910,0,0,2,0,2
84171,200,17614,23240,48910,0,0,0,1,1
84172,200,17615,23445,48910,0,0,0,1,1
84173,200,17616,23465,48910,0,0,0,1,1
84174,200,17621,23917;24036,48910,0,0,0,2,2
84175,200,17624,23617,48910,0,0,0,1,1
84176,200,17627,23649,48910,0,0,0,1,1
84177,200,17628,23652,48910,0,0,0,1,1
84178,200,17629,23905,48910,0,0,0,1,1
84179,200,17630,23939,48910,0,0,0,1,1
84180,200,17632,23728,48910,0,0,0,1,1
84181,200,17636,23535;24015,48910,0,0,0,2,2
84182,200,17638,24000,48910,0,0,0,1,1
84183,200,17639,23828,48910,0,0,0,1,1
84184,200,17640,24029,48910,0,0,0,1,1
84185,200,17643,23612,48910,0,0,0,1,1
84186,200,17685,22926,49275,0,0,0,1,1
84187,200,17689,23079;23365,49275,0,0,0,2,2
84188,200,17691,23404,49275,0,0,0,1,1
84189,200,17692,23763,49275,0,0,0,1,1
84190,200,17695,23937,49275,0,0,0,1,1
84191,200,17696,23511,49275,0,0,0,1,1
84192,200,17700,23779,49275,0,0,0,1,1
84193,200,17701,23771,49275,0,0,0,1,1
84194,200,17705,23502,49275,0,0,0,1,1
84195,200,17706,23666,49275,0,0,0,1,1
84196,200,17707,24092,49275,0,0,0,1,1
84197,200,17709,24242;28418;30387;30990;31496;31658,49275,1,2,2,1,6
84198,200,17710,23694,49275,0,0,0,1,1
84199,200,17711,23706,49275,0,0,0,1,1
84200,200,17712,23711;24064,49275,0,0,0,2,2
84201,200,17713,24047,49275,0,0,0,1,1
84202,200,17716,23761;23766,49275,0,0,0,2,2
84203,200,17718,27212,49275,0,0,1,0,1
84204,200,17719,23826,49275,0,0,0,1,1
84205,200,17720,23899,49275,0,0,0,1,1
84206,200,17721,23863;24276,49275,0,0,0,2,2
84207,200,17724,24151,49275,0,0,0,1,1
84208,200,17726,23906,49275,0,0,0,1,1
84209,200,17727,23431;23912,49275,0,0,0,2,2
84210,200,17728,23774,49275,0,0,0,1,1
84211,200,17730,23988,49275,0,0,0,1,1
84212,200,17757,25053,49640,0,0,0,1,1
84213,200,17762,22490,49640,0,0,0,1,1
84214,200,17779,23399,49640,0,0,0,1,1
84215,200,17780,23245,49640,0,0,0,1,1
84216,200,17781,23410,49640,0,0,0,1,1
84217,200,17782,23646,49640,0,0,0,1,1
84218,200,17785,23802,49640,0,0,0,1,1
84219,200,17786,23872,49640,0,0,0,1,1
84220,200,17788,23580;24135,49640,0,0,0,2,2
84221,200,17792,23701,49640,0,0,0,1,1
84222,200,17796,23845,49640,0,0,0,1,1
84223,200,17797,23835,49640,0,0,0,1,1
84224,200,17798,28011;28177;30280,49640,0,0,3,0,3
84225,200,17799,23860;23910,49640,0,0,0,2,2
84226,200,17800,23900,49640,0,0,0,1,1
84227,200,17802,23778,49640,0,0,0,1,1
84228,200,17804,24033,49640,0,0,0,1,1
84229,200,17807,24052;24291,49640,0,0,0,2,2
84230,200,17808,23790;24420,49640,0,0,0,2,2
84231,200,17810,24408,49640,0,0,0,1,1
84232,200,17811,24354;24503,49640,0,0,0,2,2
84233,200,17855,22975,50005,0,0,0,1,1
84234,200,17856,22364,50005,0,0,0,1,1
84235,200,17862,23116,50005,0,0,0,1,1
84236,200,17865,24073,50005,0,0,0,1,1
84237,200,17868,23471,50005,0,0,0,1,1
84238,200,17870,23492,50005,0,0,0,1,1
84239,200,17871,23510,50005,0,0,0,1,1
84240,200,17872,23516,50005,0,0,0,1,1
84241,200,17876,23995,50005,0,0,0,1,1
84242,200,17877,23675,50005,0,0,0,1,1
84243,200,17878,23613;23876;27139,50005,0,0,1,2,3
84244,200,17880,23679,50005,0,0,0,1,1
84245,200,17882,23822;24025,50005,0,0,0,2,2
84246,200,17883,23797,50005,0,0,0,1,1
84247,200,17884,23851,50005,0,0,0,1,1
84248,200,17887,24105;24295,50005,0,0,0,2,2
84249,200,17891,23986;24407;27685,50005,0,0,1,2,3
84250,200,17893,24041,50005,0,0,0,1,1
84251,200,17896,23697,50005,0,0,0,1,1
84252,200,17897,24001;24273,50005,0,0,0,2,2
84253,200,17899,23925;24077,50005,0,0,0,2,2
84254,200,17901,24104,50005,0,0,0,1,1
84255,200,17903,24432,50005,0,0,0,1,1
84256,200,17904,24267,50005,0,0,0,1,1
84257,200,17905,24186,50005,0,0,0,1,1
84258,200,17906,24200,50005,0,0,0,1,1
84259,200,17935,22735,50370,0,0,0,1,1
84260,200,17952,23036,50370,0,0,0,1,1
84261,200,17955,23569,50370,0,0,0,1,1
84262,200,17957,23231,50370,0,0,0,1,1
84263,200,17960,23970;24088,50370,0,0,0,2,2
84264,200,17962,26796;27136,50370,0,0,2,0,2
84265,200,17963,23818;23834,50370,0,0,0,2,2
84266,200,17966,23228,50370,0,0,0,1,1
84267,200,17968,26446;26573,50370,0,0,2,0,2
84268,200,17969,23993;24102,50370,0,0,0,2,2
84269,200,17971,23979,50370,0,0,0,1,1
84270,200,17973,24302,50370,0,0,0,1,1
84271,200,17974,27482;27957;30545;30956;31120,50370,0,3,2,0,5
84272,200,17976,23594;23806,50370,0,0,0,2,2
84273,200,17977,23824,50370,0,0,0,1,1
84274,200,17978,23839,50370,0,0,0,1,1
84275,200,17980,23708,50370,0,0,0,1,1
84276,200,17982,24214;24378,50370,0,0,0,2,2
84277,200,17983,23887,50370,0,0,0,1,1
84278,200,17984,24216,50370,0,0,0,1,1
84279,200,17985,23913;24045,50370,0,0,0,2,2
84280,200,17986,23923;23942,50370,0,0,0,2,2
84281,200,17987,24296,50370,0,0,0,1,1
84282,200,17988,24228,50370,0,0,0,1,1
84283,200,17989,23985;24350,50370,0,0,0,2,2
84284,200,17990,23930,50370,0,0,0,1,1
84285,200,17991,24173,50370,0,0,0,1,1
84286,200,17992,24010,50370,0,0,0,1,1
84287,200,17993,24061,50370,0,0,0,1,1
84288,200,17996,24224;24445,50370,0,0,0,2,2
84289,200,18000,24294;24401,50370,0,0,0,2,2
84290,200,18001,24163;24349,50370,0,0,0,2,2
84291,200,18002,24385,50370,0,0,0,1,1
84292,200,18003,24167,50370,0,0,0,1,1
84293,200,18005,24197;24520,50370,0,0,0,2,2
84294,200,18006,24266;24370,50370,0,0,0,2,2
84295,200,18007,24367,50370,0,0,0,1,1
84296,200,18009,24289,50370,0,0,0,1,1
84297,200,18010,24308,50370,0,0,0,1,1
84298,200,18011,24009;24313,50370,0,0,0,2,2
84299,200,18054,22801,50735,0,0,0,1,1
84300,200,18057,23205,50735,0,0,0,1,1
84301,200,18059,23619,50735,0,0,0,1,1
84302,200,18068,23460,50735,0,0,0,1,1
84303,200,18074,27845;28030;29934,50735,0,0,3,0,3
84304,200,18075,24377;24509,50735,0,0,0,2,2
84305,200,18076,24411;24447,50735,0,0,0,2,2
84306,200,18080,24188,50735,0,0,0,1,1
84307,200,18083,24126,50735,0,0,0,1,1
84308,200,18084,23891;24153,50735,0,0,0,2,2
84309,200,18086,23924;24248,50735,0,0,0,2,2
84310,200,18088,23948,50735,0,0,0,1,1
84311,200,18089,24526,50735,0,0,0,1,1
84312,200,18091,24051,50735,0,0,0,1,1
84313,200,18092,24381,50735,0,0,0,1,1
84314,200,18094,23833,50735,0,0,0,1,1
84315,200,18095,24241,50735,0,0,0,1,1
84316,200,18097,24157,50735,0,0,0,1,1
84317,200,18098,24502,50735,0,0,0,1,1
84318,200,18099,24281,50735,0,0,0,1,1
84319,200,18101,24723;28680,50735,0,0,1,1,2
84320,200,18102,24031,50735,0,0,0,1,1
84321,200,18103,23952,50735,0,0,0,1,1
84322,200,18104,24644,50735,0,0,0,1,1
84323,200,18105,24363;24609,50735,0,0,0,2,2
84324,200,18106,24103,50735,0,0,0,1,1
84325,200,18108,23944;24244,50735,0,0,0,2,2
84326,200,18109,24467;24717,50735,0,0,0,2,2
84327,200,18110,24177,50735,0,0,0,1,1
84328,200,18111,24597,50735,0,0,0,1,1
84329,200,18112,24458,50735,0,0,0,1,1
84330,200,18114,24523;24662,50735,0,0,0,2,2
84331,200,18117,24040;24379,50735,0,0,0,2,2
84332,200,18118,24743,50735,0,0,0,1,1
84333,200,18119,24409,50735,0,0,0,1,1
84334,200,18160,23282,51100,0,0,0,1,1
84335,200,18168,23515,51100,0,0,0,1,1
84336,200,18173,24006,51100,0,0,0,1,1
84337,200,18176,24005,51100,0,0,0,1,1
84338,200,18177,24178,51100,0,0,0,1,1
84339,200,18178,23566;23754,51100,0,0,0,2,2
84340,200,18179,23789,51100,0,0,0,1,1
84341,200,18180,24642,51100,0,0,0,1,1
84342,200,18181,23896;24150,51100,0,0,0,2,2
84343,200,18183,24140,51100,0,0,0,1,1
84344,200,18184,24270,51100,0,0,0,1,1
84345,200,18185,23505;24008,51100,0,0,0,2,2
84346,200,18190,24021,51100,0,0,0,1,1
84347,200,18193,24180;24537,51100,0,0,0,2,2
84348,200,18196,24234;24316,51100,0,0,0,2,2
84349,200,18197,24380,51100,0,0,0,1,1
84350,200,18199,24062,51100,0,0,0,1,1
84351,200,18201,24475;24753,51100,0,0,0,2,2
84352,200,18202,23901,51100,0,0,0,1,1
84353,200,18203,24404,51100,0,0,0,1,1
84354,200,18204,24425,51100,0,0,0,1,1
84355,200,18206,24451,51100,0,0,0,1,1
84356,200,18209,23982,51100,0,0,0,1,1
84357,200,18210,24760,51100,0,0,0,1,1
84358,200,18211,24506,51100,0,0,0,1,1
84359,200,18212,24721,51100,0,0,0,1,1
84360,200,18213,24528,51100,0,0,0,1,1
84361,200,18245,23000,51465,0,0,0,1,1
84362,200,18254,23300,51465,0,0,0,1,1
84363,200,18255,23444,51465,0,0,0,1,1
84364,200,18259,23624,51465,0,0,0,1,1
84365,200,18261,23750,51465,0,0,0,1,1
84366,200,18262,23803,51465,0,0,0,1,1
84367,200,18263,24171,51465,0,0,0,1,1
84368,200,18267,23695;23733,51465,0,0,0,2,2
84369,200,18268,23956,51465,0,0,0,1,1
84370,200,18270,24395,51465,0,0,0,1,1
84371,200,18272,24172,51465,0,0,0,1,1
84372,200,18273,23678,51465,0,0,0,1,1
84373,200,18274,23878,51465,0,0,0,1,1
84374,200,18278,24624,51465,0,0,0,1,1
84375,200,18279,24067;24114,51465,0,0,0,2,2
84376,200,18280,24120;24374,51465,0,0,0,2,2
84377,200,18281,24815,51465,0,0,0,1,1
84378,200,18282,24191,51465,0,0,0,1,1
84379,200,18283,24190,51465,0,0,0,1,1
84380,200,18285,24108,51465,0,0,0,1,1
84381,200,18286,24581,51465,0,0,0,1,1
84382,200,18287,24333;24400,51465,0,0,0,2,2
84383,200,18288,24339,51465,0,0,0,1,1
84384,200,18289,24421,51465,0,0,0,1,1
84385,200,18292,24446;24966,51465,0,0,0,2,2
84386,200,18293,24950,51465,0,0,0,1,1
84387,200,18294,24436;24949,51465,0,0,0,2,2
84388,200,18297,24277;24603,51465,0,0,0,2,2
84389,200,18301,24612,51465,0,0,0,1,1
84390,200,18302,24680,51465,0,0,0,1,1
84391,200,18303,24874,51465,0,0,0,1,1
84392,200,18304,24758,51465,0,0,0,1,1
84393,200,18305,24510,51465,0,0,0,1,1
84394,200,18306,24571;24844,51465,0,0,0,2,2
84395,200,18307,24937;25169,51465,0,0,0,2,2
84396,200,18308,24693,51465,0,0,0,1,1
84397,200,18346,23164,51830,0,0,0,1,1
84398,200,18357,23751,51830,0,0,0,1,1
84399,200,18359,23681;23936,51830,0,0,0,2,2
84400,200,18362,23884;24065,51830,0,0,0,2,2
84401,200,18364,24133,51830,0,0,0,1,1
84402,200,18365,23793,51830,0,0,0,1,1
84403,200,18368,24604,51830,0,0,0,1,1
84404,200,18370,24661;24883,51830,0,0,0,2,2
84405,200,18371,24115;24279,51830,0,0,0,2,2
84406,200,18372,24131,51830,0,0,0,1,1
84407,200,18374,24139,51830,0,0,0,1,1
84408,200,18376,24185;24306,51830,0,0,0,2,2
84409,200,18378,24207,51830,0,0,0,1,1
84410,200,18379,24504,51830,0,0,0,1,1
84411,200,18380,24360,51830,0,0,0,1,1
84412,200,18381,24479,51830,0,0,0,1,1
84413,200,18382,24326,51830,0,0,0,1,1
84414,200,18384,24675;24854,51830,0,0,0,2,2
84415,200,18385,24324;24424,51830,0,0,0,2,2
84416,200,18386,24690,51830,0,0,0,1,1
84417,200,18388,24534,51830,0,0,0,1,1
84418,200,18389,24414;24542,51830,0,0,0,2,2
84419,200,18392,24560;24886,51830,0,0,0,2,2
84420,200,18393,24711,51830,0,0,0,1,1
84421,200,18394,24595,51830,0,0,0,1,1
84422,200,18395,24551;24602,51830,0,0,0,2,2
84423,200,18396,24867,51830,0,0,0,1,1
84424,200,18397,24850,51830,0,0,0,1,1
84425,200,18399,24664,51830,0,0,0,1,1
84426,200,18401,24692,51830,0,0,0,1,1
84427,200,18402,24116;24550,51830,0,0,0,2,2
84428,200,18404,24745,51830,0,0,0,1,1
84429,200,18405,24969,51830,0,0,0,1,1
84430,200,18439,22984;23873,52195,0,0,0,2,2
84431,200,18440,23310,52195,0,0,0,1,1
84432,200,18443,23430,52195,0,0,0,1,1
84433,200,18447,23808;24312,52195,0,0,0,2,2
84434,200,18452,24364,52195,0,0,0,1,1
84435,200,18454,23864,52195,0,0,0,1,1
84436,200,18455,24060,52195,0,0,0,1,1
84437,200,18458,23413,52195,0,0,0,1,1
84438,200,18459,23961;24246;27491,52195,0,0,1,2,3
84439,200,18460,24372,52195,0,0,0,1,1
84440,200,18461,28140;30371;30970;31312;31967,52195,1,2,2,0,5
84441,200,18462,24174;24393,52195,0,0,0,2,2
84442,200,18463,24175;24222,52195,0,0,0,2,2
84443,200,18464,24388,52195,0,0,0,1,1
84444,200,18465,24243,52195,0,0,0,1,1
84445,200,18467,24573,52195,0,0,0,1,1
84446,200,18468,24299,52195,0,0,0,1,1
84447,200,18469,24184,52195,0,0,0,1,1
84448,200,18470,24978,52195,0,0,0,1,1
84449,200,18471,24726,52195,0,0,0,1,1
84450,200,18473,24586,52195,0,0,0,1,1
84451,200,18474,24784,52195,0,0,0,1,1
84452,200,18475,24527,52195,0,0,0,1,1
84453,200,18476,24535;25127,52195,0,0,0,2,2
84454,200,18477,24342;24552,52195,0,0,0,2,2
84455,200,18478,24473;24668,52195,0,0,0,2,2
84456,200,18479,24329;24585,52195,0,0,0,2,2
84457,200,18480,24466;24587,52195,0,0,0,2,2
84458,200,18485,24454;24702,52195,0,0,0,2,2
84459,200,18486,29209,52195,0,0,1,0,1
84460,200,18487,24258;24630,52195,0,0,0,2,2
84461,200,18488,24639,52195,0,0,0,1,1
84462,200,18490,24923,52195,0,0,0,1,1
84463,200,18491,25057,52195,0,0,0,1,1
84464,200,18492,24859,52195,0,0,0,1,1
84465,200,18493,24718,52195,0,0,0,1,1
84466,200,18494,24728,52195,0,0,0,1,1
84467,200,18496,24548;24736,52195,0,0,0,2,2
84468,200,18497,24449;24757,52195,0,0,0,2,2
84469,200,18498,24747,52195,0,0,0,1,1
84470,200,18499,24765;24822,52195,0,0,0,2,2
84471,200,18500,24771,52195,0,0,0,1,1
84472,200,18501,25101;25170,52195,0,0,0,2,2
84473,200,18502,24657;25071,52195,0,0,0,2,2
84474,200,18503,24480;24829,52195,0,0,0,2,2
84475,200,18504,24418;25084,52195,0,0,0,2,2
84476,200,18505,25094,52195,0,0,0,1,1
84477,200,18527,22711,52560,0,0,0,1,1
84478,200,18540,23370,52560,0,0,0,1,1
84479,200,18543,23497,52560,0,0,0,1,1
84480,200,18544,23589,52560,0,0,0,1,1
84481,200,18547,24255,52560,0,0,0,1,1
84482,200,18549,24158,52560,0,0,0,1,1
84483,200,18550,24334,52560,0,0,0,1,1
84484,200,18551,23702;24057,52560,0,0,0,2,2
84485,200,18554,23871,52560,0,0,0,1,1
84486,200,18555,24441,52560,0,0,0,1,1
84487,200,18556,24249;24840,52560,0,0,0,2,2
84488,200,18557,24741,52560,0,0,0,1,1
84489,200,18559,23773,52560,0,0,0,1,1
84490,200,18560,24320;24477,52560,0,0,0,2,2
84491,200,18561,24483;24906,52560,0,0,0,2,2
84492,200,18562,24078;24410,52560,0,0,0,2,2
84493,200,18563,24412;24708,52560,0,0,0,2,2
84494,200,18564,24464,52560,0,0,0,1,1
84495,200,18565,24269;24870,52560,0,0,0,2,2
84496,200,18566,24478;24557,52560,0,0,0,2,2
84497,200,18567,24778,52560,0,0,0,1,1
84498,200,18568,24907;29027;31278,52560,0,1,1,1,3
84499,200,18569,24799,52560,0,0,0,1,1
84500,200,18572,24319;24606;28769,52560,0,0,1,2,3
84501,200,18573,24428;24863,52560,0,0,0,2,2
84502,200,18575,24616;24986,52560,0,0,0,2,2
84503,200,18576,24532,52560,0,0,0,1,1
84504,200,18577,24740,52560,0,0,0,1,1
84505,200,18578,24789;25002,52560,0,0,0,2,2
84506,200,18579,24794,52560,0,0,0,1,1
84507,200,18582,24762;24809,52560,0,0,0,2,2
84508,200,18584,25315,52560,0,0,0,1,1
84509,200,18585,24667;24838,52560,0,0,0,2,2
84510,200,18587,25144,52560,0,0,0,1,1
84511,200,18589,24943;25276,52560,0,0,0,2,2
84512,200,18590,24988;25192,52560,0,0,0,2,2
84513,200,18621,23004,52925,0,0,0,1,1
84514,200,18633,23378,52925,0,0,0,1,1
84515,200,18635,23452,52925,0,0,0,1,1
84516,200,18636,23820;24159,52925,0,0,0,2,2
84517,200,18639,23852,52925,0,0,0,1,1
84518,200,18641,24271,52925,0,0,0,1,1
84519,200,18642,24028,52925,0,0,0,1,1
84520,200,18643,24665;24759,52925,0,0,0,2,2
84521,200,18644,24391,52925,0,0,0,1,1
84522,200,18645,23641;24098,52925,0,0,0,2,2
84523,200,18647,24666,52925,0,0,0,1,1
84524,200,18648,24176,52925,0,0,0,1,1
84525,200,18649,24230,52925,0,0,0,1,1
84526,200,18650,24027;24390,52925,0,0,0,2,2
84527,200,18652,24429;24598,52925,0,0,0,2,2
84528,200,18653,24704,52925,0,0,0,1,1
84529,200,18655,25159,52925,0,0,0,1,1
84530,200,18656,25226,52925,0,0,0,1,1
84531,200,18657,24515;25018,52925,0,0,0,2,2
84532,200,18659,24525,52925,0,0,0,1,1
84533,200,18660,24533,52925,0,0,0,1,1
84534,200,18661,24565,52925,0,0,0,1,1
84535,200,18663,24576,52925,0,0,0,1,1
84536,200,18664,24643;25099,52925,0,0,0,2,2
84537,200,18668,24715,52925,0,0,0,1,1
84538,200,18669,24669,52925,0,0,0,1,1
84539,200,18671,24336;24700,52925,0,0,0,2,2
84540,200,18672,24934,52925,0,0,0,1,1
84541,200,18674,24508;24713,52925,0,0,0,2,2
84542,200,18675,24769,52925,0,0,0,1,1
84543,200,18676,24819;25112,52925,0,0,0,2,2
84544,200,18677,24684;24827,52925,0,0,0,2,2
84545,200,18678,25013,52925,0,0,0,1,1
84546,200,18679,25146;25413,52925,0,0,0,2,2
84547,200,18681,24851,52925,0,0,0,1,1
84548,200,18682,25122;25289;29210,52925,0,0,1,2,3
84549,200,18683,25225;25427,52925,0,0,0,2,2
84550,200,18684,24970;25264,52925,0,0,0,2,2
84551,200,18685,25409,52925,0,0,0,1,1
84552,200,18686,24954,52925,0,0,0,1,1
84553,200,18687,24556;24959,52925,0,0,0,2,2
84554,200,18688,24688,52925,0,0,0,1,1
84555,200,18689,25278,52925,0,0,0,1,1
84556,200,18691,25070,52925,0,0,0,1,1
84557,200,18693,25082;25304,52925,0,0,0,2,2
84558,200,18735,23865,53290,0,0,0,1,1
84559,200,18738,23783,53290,0,0,0,1,1
84560,200,18742,23926,53290,0,0,0,1,1
84561,200,18743,24164,53290,0,0,0,1,1
84562,200,18745,24109,53290,0,0,0,1,1
84563,200,18748,24170,53290,0,0,0,1,1
84564,200,18749,24849,53290,0,0,0,1,1
84565,200,18750,24238,53290,0,0,0,1,1
84566,200,18751,24531,53290,0,0,0,1,1
84567,200,18752,24156;24226,53290,0,0,0,2,2
84568,200,18755,24433,53290,0,0,0,1,1
84569,200,18757,24462;24735,53290,0,0,0,2,2
84570,200,18759,24536,53290,0,0,0,1,1
84571,200,18760,24359,53290,0,0,0,1,1
84572,200,18761,24780,53290,0,0,0,1,1
84573,200,18762,24577;24600,53290,0,0,0,2,2
84574,200,18763,24635;24982,53290,0,0,0,2,2
84575,200,18764,24796,53290,0,0,0,1,1
84576,200,18765,24683,53290,0,0,0,1,1
84577,200,18766,24257;24697,53290,0,0,0,2,2
84578,200,18767,24725;25365,53290,0,0,0,2,2
84579,200,18768,24733;28937,53290,0,0,1,1,2
84580,200,18769,24804,53290,0,0,0,1,1
84581,200,18770,24633;25183,53290,0,0,0,2,2
84582,200,18772,24800,53290,0,0,0,1,1
84583,200,18774,24818,53290,0,0,0,1,1
84584,200,18777,24837;25310,53290,0,0,0,2,2
84585,200,18778,24847,53290,0,0,0,1,1
84586,200,18779,25063,53290,0,0,0,1,1
84587,200,18780,24677;25319,53290,0,0,0,2,2
84588,200,18783,24366,53290,0,0,0,1,1
84589,200,18786,25209;25451,53290,0,0,0,2,2
84590,200,18787,24991;25060,53290,0,0,0,2,2
84591,200,18789,25020,53290,0,0,0,1,1
84592,200,18790,25388,53290,0,0,0,1,1
84593,200,18792,24802;25109,53290,0,0,0,2,2
84594,200,18793,25114;25527,53290,0,0,0,2,2
84595,200,18794,25140;25303,53290,0,0,0,2,2
84596,200,18796,24836;25120,53290,0,0,0,2,2
84597,200,18797,25134;25454;28855,53290,0,0,1,2,3
84598,200,18798,25512,53290,0,0,0,1,1
84599,200,18799,25519;25535,53290,0,0,0,2,2
84600,200,18800,25160;25180,53290,0,0,0,2,2
84601,200,18839,24194,53655,0,0,0,1,1
84602,200,18840,23946,53655,0,0,0,1,1
84603,200,18842,24371;24499,53655,0,0,0,2,2
84604,200,18844,24358;24484,53655,0,0,0,2,2
84605,200,18845,24106;24179,53655,0,0,0,2,2
84606,200,18846,24623,53655,0,0,0,1,1
84607,200,18847,24712;25067,53655,0,0,0,2,2
84608,200,18848,24086,53655,0,0,0,1,1
84609,200,18849,24357,53655,0,0,0,1,1
84610,200,18850,24247,53655,0,0,0,1,1
84611,200,18854,24405,53655,0,0,0,1,1
84612,200,18855,24219,53655,0,0,0,1,1
84613,200,18856,24427,53655,0,0,0,1,1
84614,200,18857,24806;25001,53655,0,0,0,2,2
84615,200,18859,24567;24653,53655,0,0,0,2,2
84616,200,18860,24137;24601,53655,0,0,0,2,2
84617,200,18862,24376,53655,0,0,0,1,1
84618,200,18863,25265,53655,0,0,0,1,1
84619,200,18864,24942,53655,0,0,0,1,1
84620,200,18866,24720,53655,0,0,0,1,1
84621,200,18867,24396;24732,53655,0,0,0,2,2
84622,200,18869,25025,53655,0,0,0,1,1
84623,200,18871,24403;24841,53655,0,0,0,2,2
84624,200,18873,25216;25327,53655,0,0,0,2,2
84625,200,18874,24896;24975,53655,0,0,0,2,2
84626,200,18876,24590;25102,53655,0,0,0,2,2
84627,200,18879,25030;25384,53655,0,0,0,2,2
84628,200,18880,24880,53655,0,0,0,1,1
84629,200,18881,24999,53655,0,0,0,1,1
84630,200,18882,25087,53655,0,0,0,1,1
84631,200,18883,25428,53655,0,0,0,1,1
84632,200,18884,25866,53655,0,0,0,1,1
84633,200,18885,24948;25316,53655,0,0,0,2,2
84634,200,18887,25347;25621,53655,0,0,0,2,2
84635,200,18888,25044;25186,53655,0,0,0,2,2
84636,200,18889,25043;25194,53655,0,0,0,2,2
84637,200,18890,25530,53655,0,0,0,1,1
84638,200,18891,25560,53655,0,0,0,1,1
84639,200,18892,25417;25589;28547;30829,53655,0,1,1,2,4
84640,200,18893,25421;25543,53655,0,0,0,2,2
84641,200,18894,25111;25582,53655,0,0,0,2,2
84642,200,18895,24960;25295,53655,0,0,0,2,2
84643,200,18896,25306,53655,0,0,0,1,1
84644,200,18897,25631,53655,0,0,0,1,1
84645,200,18898,25296;25568,53655,0,0,0,2,2
84646,200,18927,24016;24154,54020,0,0,0,2,2
84647,200,18930,23987;24208,54020,0,0,0,2,2
84648,200,18933,24032;24287,54020,0,0,0,2,2
84649,200,18935,24145;24331,54020,0,0,0,2,2
84650,200,18937,24196,54020,0,0,0,1,1
84651,200,18938,24205,54020,0,0,0,1,1
84652,200,18939,24068;24330,54020,0,0,0,2,2
84653,200,18940,24618,54020,0,0,0,1,1
84654,200,18941,24240;27329;29986,54020,0,0,2,1,3
84655,200,18943,24056;24286,54020,0,0,0,2,2
84656,200,18946,24011;24406,54020,0,0,0,2,2
84657,200,18947,24685,54020,0,0,0,1,1
84658,200,18948,24423;24751,54020,0,0,0,2,2
84659,200,18949,24455,54020,0,0,0,1,1
84660,200,18950,24914,54020,0,0,0,1,1
84661,200,18951,24486,54020,0,0,0,1,1
84662,200,18953,24614;24622,54020,0,0,0,2,2
84663,200,18954,24979,54020,0,0,0,1,1
84664,200,18955,24671,54020,0,0,0,1,1
84665,200,18957,24918;25008,54020,0,0,0,2,2
84666,200,18958,24772,54020,0,0,0,1,1
84667,200,18959,24584;24705,54020,0,0,0,2,2
84668,200,18960,24500;24781,54020,0,0,0,2,2
84669,200,18961,24797,54020,0,0,0,1,1
84670,200,18962,24808,54020,0,0,0,1,1
84671,200,18964,24887;25236,54020,0,0,0,2,2
84672,200,18965,24947,54020,0,0,0,1,1
84673,200,18966,24977;25010,54020,0,0,0,2,2
84674,200,18967,24894;25155,54020,0,0,0,2,2
84675,200,18969,25612;25692,54020,0,0,0,2,2
84676,200,18971,25009,54020,0,0,0,1,1
84677,200,18972,24544;25080,54020,0,0,0,2,2
84678,200,18973,25104,54020,0,0,0,1,1
84679,200,18975,25500;25521,54020,0,0,0,2,2
84680,200,18976,25168,54020,0,0,0,1,1
84681,200,18977,24983;25177,54020,0,0,0,2,2
84682,200,18978,24263;24872,54020,0,0,0,2,2
84683,200,18980,24911;25167,54020,0,0,0,2,2
84684,200,18981,25726,54020,0,0,0,1,1
84685,200,18982,24775;25246,54020,0,0,0,2,2
84686,200,18983,25174;25242,54020,0,0,0,2,2
84687,200,18984,25275,54020,0,0,0,1,1
84688,200,18986,25426,54020,0,0,0,1,1
84689,200,18987,25321,54020,0,0,0,1,1
84690,200,18988,24569;25322,54020,0,0,0,2,2
84691,200,18990,25515;25635,54020,0,0,0,2,2
84692,200,18991,25487,54020,0,0,0,1,1
84693,200,18992,25329;25555,54020,0,0,0,2,2
84694,200,18993,25048;25330,54020,0,0,0,2,2
84695,200,18994,25207;25336,54020,0,0,0,2,2
84696,200,18995,25338,54020,0,0,0,1,1
84697,200,18996,25185;25356,54020,0,0,0,2,2
84698,200,18998,25220;25382,54020,0,0,0,2,2
84699,200,18999,25221;25390,54020,0,0,0,2,2
84700,200,19000,25423,54020,0,0,0,1,1
84701,200,19001,25400;25407,54020,0,0,0,2,2
84702,200,19030,23918;24394,54385,0,0,0,2,2
84703,200,19031,23966,54385,0,0,0,1,1
84704,200,19041,24352;24365,54385,0,0,0,2,2
84705,200,19043,24437;24608,54385,0,0,0,2,2
84706,200,19044,24239,54385,0,0,0,1,1
84707,200,19045,24456,54385,0,0,0,1,1
84708,200,19046,24335,54385,0,0,0,1,1
84709,200,19052,24714;25205,54385,0,0,0,2,2
84710,200,19053,25164,54385,0,0,0,1,1
84711,200,19054,24786,54385,0,0,0,1,1
84712,200,19055,24926;28255,54385,0,0,1,1,2
84713,200,19056,25012;25353,54385,0,0,0,2,2
84714,200,19057,24826;28770;30484,54385,0,0,2,1,3
84715,200,19058,24860,54385,0,0,0,1,1
84716,200,19060,24868;25040,54385,0,0,0,2,2
84717,200,19062,24472,54385,0,0,0,1,1
84718,200,19063,25302;25457,54385,0,0,0,2,2
84719,200,19065,25230,54385,0,0,0,1,1
84720,200,19066,25163,54385,0,0,0,1,1
84721,200,19068,25228;25484,54385,0,0,0,2,2
84722,200,19069,24821,54385,0,0,0,1,1
84723,200,19071,25606;29044;31454,54385,0,1,1,1,3
84724,200,19072,24992;25156,54385,0,0,0,2,2
84725,200,19074,24574;25215,54385,0,0,0,2,2
84726,200,19075,24791;25411,54385,0,0,0,2,2
84727,200,19076,25532,54385,0,0,0,1,1
84728,200,19077,25538,54385,0,0,0,1,1
84729,200,19078,24834;25250,54385,0,0,0,2,2
84730,200,19079,25254;25499,54385,0,0,0,2,2
84731,200,19080,25575,54385,0,0,0,1,1
84732,200,19081,25292,54385,0,0,0,1,1
84733,200,19083,25796;25877,54385,0,0,0,2,2
84734,200,19084,24660;25299,54385,0,0,0,2,2
84735,200,19085,25108;25350,54385,0,0,0,2,2
84736,200,19086,25377,54385,0,0,0,1,1
84737,200,19089,25046;25494,54385,0,0,0,2,2
84738,200,19090,25520;25655,54385,0,0,0,2,2
84739,200,19091,25649,54385,0,0,0,1,1
84740,200,19092,25305;25467,54385,0,0,0,2,2
84741,200,19093,25483,54385,0,0,0,1,1
84742,200,19095,25498;25714,54385,0,0,0,2,2
84743,200,19120,23780,54750,0,0,0,1,1
84744,200,19128,24341,54750,0,0,0,1,1
84745,200,19129,24471,54750,0,0,0,1,1
84746,200,19131,25019,54750,0,0,0,1,1
84747,200,19133,25000,54750,0,0,0,1,1
84748,200,19134,24488;24994,54750,0,0,0,2,2
84749,200,19136,25113,54750,0,0,0,1,1
84750,200,19137,24767;24858,54750,0,0,0,2,2
84751,200,19138,24773;24941,54750,0,0,0,2,2
84752,200,19139,24801;24813,54750,0,0,0,2,2
84753,200,19140,24460;24846,54750,0,0,0,2,2
84754,200,19142,24922;25116,54750,0,0,0,2,2
84755,200,19144,24898,54750,0,0,0,1,1
84756,200,19148,25028,54750,0,0,0,1,1
84757,200,19149,25026;25029,54750,0,0,0,2,2
84758,200,19150,24615;24792,54750,0,0,0,2,2
84759,200,19151,25607,54750,0,0,0,1,1
84760,200,19152,25633,54750,0,0,0,1,1
84761,200,19154,25348;25551,54750,0,0,0,2,2
84762,200,19155,25152;25153,54750,0,0,0,2,2
84763,200,19156,24995;25583,54750,0,0,0,2,2
84764,200,19157,25369;25641,54750,0,0,0,2,2
84765,200,19160,25822;28957,54750,0,0,1,1,2
84766,200,19161,25751;28714,54750,0,0,1,1,2
84767,200,19162,25184;25284,54750,0,0,0,2,2
84768,200,19165,25488;25818,54750,0,0,0,2,2
84769,200,19166,25425;25802,54750,0,0,0,2,2
84770,200,19167,25446,54750,0,0,0,1,1
84771,200,19168,25195;25567,54750,0,0,0,2,2
84772,200,19169,25481;25788;29219,54750,0,0,1,2,3
84773,200,19170,25490,54750,0,0,0,1,1
84774,200,19171,25752;25814;29754,54750,0,0,1,2,3
84775,200,19173,25525;25883,54750,0,0,0,2,2
84776,200,19174,25745,54750,0,0,0,1,1
84777,200,19175,25547;25603,54750,0,0,0,2,2
84778,200,19177,25559,54750,0,0,0,1,1
84779,200,19178,25554;25591,54750,0,0,0,2,2
84780,200,19179,25452;25601,54750,0,0,0,2,2
84781,200,19180,25613;25897,54750,0,0,0,2,2
84782,200,19206,23305,55115,0,0,0,1,1
84783,200,19209,23390,55115,0,0,0,1,1
84784,200,19210,23548,55115,0,0,0,1,1
84785,200,19219,24253,55115,0,0,0,1,1
84786,200,19220,24280,55115,0,0,0,1,1
84787,200,19223,24709;24843,55115,0,0,0,2,2
84788,200,19226,24494,55115,0,0,0,1,1
84789,200,19228,24223,55115,0,0,0,1,1
84790,200,19230,27718;27780;29930;30535;30694;31111;31887,55115,1,3,3,0,7
84791,200,19234,24107;24865,55115,0,0,0,2,2
84792,200,19235,24659;25036,55115,0,0,0,2,2
84793,200,19236,24687,55115,0,0,0,1,1
84794,200,19237,24375;24547,55115,0,0,0,2,2
84795,200,19238,24873;25158,55115,0,0,0,2,2
84796,200,19239,25232,55115,0,0,0,1,1
84797,200,19240,24764,55115,0,0,0,1,1
84798,200,19241,25078,55115,0,0,0,1,1
84799,200,19242,24716;25162,55115,0,0,0,2,2
84800,200,19243,24774;25394,55115,0,0,0,2,2
84801,200,19244,25523;25773,55115,0,0,0,2,2
84802,200,19245,25233,55115,0,0,0,1,1
84803,200,19246,25513,55115,0,0,0,1,1
84804,200,19247,25065,55115,0,0,0,1,1
84805,200,19248,25172;25286,55115,0,0,0,2,2
84806,200,19249,25293,55115,0,0,0,1,1
84807,200,19250,25712,55115,0,0,0,1,1
84808,200,19251,25332,55115,0,0,0,1,1
84809,200,19252,25349,55115,0,0,0,1,1
84810,200,19253,25257;25640;29394,55115,0,0,1,2,3
84811,200,19254,25748,55115,0,0,0,1,1
84812,200,19255,25727,55115,0,0,0,1,1
84813,200,19256,25815;25831,55115,0,0,0,2,2
84814,200,19257,25166;25511,55115,0,0,0,2,2
84815,200,19259,25129;25422,55115,0,0,0,2,2
84816,200,19260,25718,55115,0,0,0,1,1
84817,200,19261,25444,55115,0,0,0,1,1
84818,200,19262,25757,55115,0,0,0,1,1
84819,200,19263,25825;25935,55115,0,0,0,2,2
84820,200,19264,24831;25464,55115,0,0,0,2,2
84821,200,19266,25469,55115,0,0,0,1,1
84822,200,19267,25480;25531,55115,0,0,0,2,2
84823,200,19268,25930;25939,55115,0,0,0,2,2
84824,200,19270,25917,55115,0,0,0,1,1
84825,200,19271,25518,55115,0,0,0,1,1
84826,200,19272,25553;25628,55115,0,0,0,2,2
84827,200,19273,25565,55115,0,0,0,1,1
84828,200,19275,25505;25571,55115,0,0,0,2,2
84829,200,19276,25614;25890,55115,0,0,0,2,2
84830,200,19277,25617;25626,55115,0,0,0,2,2
84831,200,19278,25643;25876;28726,55115,0,0,1,2,3
84832,200,19279,25671;25786,55115,0,0,0,2,2
84833,200,19281,25719;25769,55115,0,0,0,2,2
84834,200,19282,25760;25810,55115,0,0,0,2,2
84835,200,19284,25886,55115,0,0,0,1,1
84836,200,19311,23672,55480,0,0,0,1,1
84837,200,19317,24168,55480,0,0,0,1,1
84838,200,19318,24119,55480,0,0,0,1,1
84839,200,19321,24679,55480,0,0,0,1,1
84840,200,19322,24066,55480,0,0,0,1,1
84841,200,19325,24742;25313,55480,0,0,0,2,2
84842,200,19327,25373,55480,0,0,0,1,1
84843,200,19331,24884,55480,0,0,0,1,1
84844,200,19332,24766;25017,55480,0,0,0,2,2
84845,200,19334,24967;25290;28850,55480,0,0,1,2,3
84846,200,19336,25161,55480,0,0,0,1,1
84847,200,19337,25031,55480,0,0,0,1,1
84848,200,19338,24908,55480,0,0,0,1,1
84849,200,19341,25516,55480,0,0,0,1,1
84850,200,19342,25091;25578,55480,0,0,0,2,2
84851,200,19343,25474,55480,0,0,0,1,1
84852,200,19344,24939,55480,0,0,0,1,1
84853,200,19345,25279;25507,55480,0,0,0,2,2
84854,200,19346,25049;25323,55480,0,0,0,2,2
84855,200,19347,25179;25463,55480,0,0,0,2,2
84856,200,19348,25975,55480,0,0,0,1,1
84857,200,19349,25381;25662,55480,0,0,0,2,2
84858,200,19350,25858,55480,0,0,0,1,1
84859,200,19351,25618,55480,0,0,0,1,1
84860,200,19352,25506;25684,55480,0,0,0,2,2
84861,200,19353,25472;25689,55480,0,0,0,2,2
84862,200,19354,25846,55480,0,0,0,1,1
84863,200,19355,25544;26037,55480,0,0,0,2,2
84864,200,19356,25466,55480,0,0,0,1,1
84865,200,19357,25570;26036,55480,0,0,0,2,2
84866,200,19358,25736;25981;29149;29589;31697,55480,1,0,2,2,5
84867,200,19359,25759,55480,0,0,0,1,1
84868,200,19360,25300;25741;28290,55480,0,0,1,2,3
84869,200,19361,25697;25755,55480,0,0,0,2,2
84870,200,19362,25758;26016,55480,0,0,0,2,2
84871,200,19363,25219;25761,55480,0,0,0,2,2
84872,200,19364,25764,55480,0,0,0,1,1
84873,200,19365,25768;25962,55480,0,0,0,2,2
84874,200,19366,25800;26000;28889,55480,0,0,1,2,3
84875,200,19388,23440,55845,0,0,0,1,1
84876,200,19390,23467;23720,55845,0,0,0,2,2
84877,200,19397,24529,55845,0,0,0,1,1
84878,200,19398,24323;24417,55845,0,0,0,2,2
84879,200,19401,24814;25066,55845,0,0,0,2,2
84880,200,19403,24904,55845,0,0,0,1,1
84881,200,19405,24634;25540,55845,0,0,0,2,2
84882,200,19409,24958,55845,0,0,0,1,1
84883,200,19410,24513;24776,55845,0,0,0,2,2
84884,200,19411,25453;28620,55845,0,0,1,1,2
84885,200,19412,25128;25189,55845,0,0,0,2,2
84886,200,19413,25054,55845,0,0,0,1,1
84887,200,19414,24805;25514,55845,0,0,0,2,2
84888,200,19418,25392;25717,55845,0,0,0,2,2
84889,200,19419,25412;25675,55845,0,0,0,2,2
84890,200,19420,25375;26005,55845,0,0,0,2,2
84891,200,19422,25178;25335,55845,0,0,0,2,2
84892,200,19423,25608,55845,0,0,0,1,1
84893,200,19424,25376;25672,55845,0,0,0,2,2
84894,200,19425,25440;25579,55845,0,0,0,2,2
84895,200,19426,25489,55845,0,0,0,1,1
84896,200,19427,25243;25462,55845,0,0,0,2,2
84897,200,19429,25294;25596;28383;30385,55845,0,0,2,2,4
84898,200,19431,25564;25665,55845,0,0,0,2,2
84899,200,19433,26138,55845,0,0,1,0,1
84900,200,19434,25573;25634,55845,0,0,0,2,2
84901,200,19435,25598;25920,55845,0,0,0,2,2
84902,200,19436,25609;25813,55845,0,0,0,2,2
84903,200,19437,25778,55845,0,0,0,1,1
84904,200,19438,25652;25762,55845,0,0,0,2,2
84905,200,19440,25619;25680,55845,0,0,0,2,2
84906,200,19441,25585;25708,55845,0,0,0,2,2
84907,200,19442,25740;26046;29234;29486;29836;31462;31549;31861,55845,1,2,3,2,8
84908,200,19443,25442;25746,55845,0,0,0,2,2
84909,200,19444,25777;26098,55845,0,0,0,2,2
84910,200,19445,25420;25783;28868,55845,0,0,1,2,3
84911,200,19446,25431;25833;28720,55845,0,0,1,2,3
84912,200,19449,25853;25882,55845,0,0,0,2,2
84913,200,19450,25859;26021,55845,0,0,0,2,2
84914,200,19451,25982;26122,55845,0,0,1,1,2
84915,200,19452,25794;25958,55845,0,0,0,2,2
84916,200,19465,22213,56210,0,0,0,1,1
84917,200,19482,23059,56210,0,0,0,1,1
84918,200,19485,23145,56210,0,0,0,1,1
84919,200,19494,24148;24450,56210,0,0,0,2,2
84920,200,19502,24892;25364,56210,0,0,0,2,2
84921,200,19503,25574,56210,0,0,0,1,1
84922,200,19504,24803,56210,0,0,0,1,1
84923,200,19505,24985;25032,56210,0,0,0,2,2
84924,200,19507,25504,56210,0,0,0,1,1
84925,200,19508,25743,56210,0,0,0,1,1
84926,200,19509,25093;25298,56210,0,0,0,2,2
84927,200,19511,25600,56210,0,0,0,1,1
84928,200,19512,25214,56210,0,0,0,1,1
84929,200,19513,25241;25569,56210,0,0,0,2,2
84930,200,19514,25318;25907,56210,0,0,0,2,2
84931,200,19516,25366;25829,56210,0,0,0,2,2
84932,200,19517,25297;25491,56210,0,0,0,2,2
84933,200,19518,25576;25879,56210,0,0,0,2,2
84934,200,19519,25326;25441,56210,0,0,0,2,2
84935,200,19523,25418;25678,56210,0,0,0,2,2
84936,200,19524,25851;26134;29675,56210,0,0,2,1,3
84937,200,19525,25497;25836,56210,0,0,0,2,2
84938,200,19526,25696;25819;29221,56210,0,0,1,2,3
84939,200,19529,25711;26018,56210,0,0,0,2,2
84940,200,19530,26023,56210,0,0,0,1,1
84941,200,19531,25945;25996,56210,0,0,0,2,2
84942,200,19532,25849,56210,0,0,0,1,1
84943,200,19533,25827;26050,56210,0,0,0,2,2
84944,200,19534,25685;25867,56210,0,0,0,2,2
84945,200,19535,25869;25941;29480;29755;31881,56210,1,0,2,2,5
84946,200,19536,25534,56210,0,0,0,1,1
84947,200,19539,25896;29057,56210,0,0,1,1,2
84948,200,19541,26083,56210,0,0,0,1,1
84949,200,19542,25918;29059;31364;31539,56210,0,2,1,1,4
84950,200,19543,25922;26225,56210,0,0,1,1,2
84951,200,19544,25932;26265,56210,0,0,1,1,2
84952,200,19546,26199,56210,0,0,1,0,1
84953,200,19547,25782;25967;29757,56210,0,0,1,2,3
84954,200,19548,25828;25980,56210,0,0,0,2,2
84955,200,19550,25988;26273,56210,0,0,1,1,2
84956,200,19551,25368;25998,56210,0,0,0,2,2
84957,200,19553,22370,56575,0,0,0,1,1
84958,200,19585,24442;24632,56575,0,0,0,2,2
84959,200,19587,24495,56575,0,0,0,1,1
84960,200,19590,24686;24701,56575,0,0,0,2,2
84961,200,19591,24869;25561,56575,0,0,0,2,2
84962,200,19594,24936;25646,56575,0,0,0,2,2
84963,200,19595,25213;25274,56575,0,0,0,2,2
84964,200,19596,24881;28075,56575,0,0,1,1,2
84965,200,19597,24993,56575,0,0,0,1,1
84966,200,19599,25069,56575,0,0,0,1,1
84967,200,19600,25658,56575,0,0,0,1,1
84968,200,19603,25395;25709,56575,0,0,0,2,2
84969,200,19604,25435;25739,56575,0,0,0,2,2
84970,200,19606,25363,56575,0,0,0,1,1
84971,200,19607,25362,56575,0,0,0,1,1
84972,200,19608,25410;25855;29835,56575,0,0,1,2,3
84973,200,19609,25438;25482,56575,0,0,0,2,2
84974,200,19610,25979;26091;28976,56575,0,0,1,2,3
84975,200,19611,25839,56575,0,0,0,1,1
84976,200,19612,25244;25683,56575,0,0,0,2,2
84977,200,19613,25503;25804,56575,0,0,0,2,2
84978,200,19614,25724;25914,56575,0,0,0,2,2
84979,200,19616,26163,56575,0,0,1,0,1
84980,200,19618,25616,56575,0,0,0,1,1
84981,200,19619,26080,56575,0,0,0,1,1
84982,200,19620,25629,56575,0,0,0,1,1
84983,200,19621,25638;26071;29236;31100;31931,56575,1,1,1,2,5
84984,200,19622,26082,56575,0,0,0,1,1
84985,200,19623,25550;25657,56575,0,0,0,2,2
84986,200,19624,25750;25991,56575,0,0,0,2,2
84987,200,19625,25912;26047,56575,0,0,0,2,2
84988,200,19626,25817;25999,56575,0,0,0,2,2
84989,200,19627,25732;29585,56575,0,0,1,1,2
84990,200,19628,26106,56575,0,0,1,0,1
84991,200,19629,26107;29674,56575,0,0,2,0,2
84992,200,19631,25854;25993,56575,0,0,0,2,2
84993,200,19632,25990;26048,56575,0,0,0,2,2
84994,200,19633,26061;29070;29153;29401,56575,0,0,3,1,4
84995,200,19634,26069,56575,0,0,0,1,1
84996,200,19635,26188;26195;29597;29839,56575,0,0,4,0,4
84997,200,19636,26087;29837;31640;31798;31956,56575,3,0,1,1,5
84998,200,19637,25965;26256,56575,0,0,1,1,2
84999,200,19656,23545,56940,0,0,0,1,1
85000,200,19664,23882,56940,0,0,0,1,1
85001,200,19666,24558,56940,0,0,0,1,1
85002,200,19669,24673;25107,56940,0,0,0,2,2
85003,200,19673,24853;24996,56940,0,0,0,2,2
85004,200,19675,25074,56940,0,0,0,1,1
85005,200,19678,25007,56940,0,0,0,1,1
85006,200,19679,25206;25374;28690;31256;31430;31828,56940,1,2,1,2,6
85007,200,19680,25240,56940,0,0,0,1,1
85008,200,19682,24663;25182,56940,0,0,0,2,2
85009,200,19683,24899,56940,0,0,0,1,1
85010,200,19684,24783;25211,56940,0,0,0,2,2
85011,200,19685,25262;25351,56940,0,0,0,2,2
85012,200,19686,25720,56940,0,0,0,1,1
85013,200,19687,25414;25885,56940,0,0,0,2,2
85014,200,19688,25749;25891,56940,0,0,0,2,2
85015,200,19689,25637,56940,0,0,0,1,1
85016,200,19690,25807,56940,0,0,0,1,1
85017,200,19691,25653;28711,56940,0,0,1,1,2
85018,200,19692,25636;25903,56940,0,0,0,2,2
85019,200,19693,25175;25486,56940,0,0,0,2,2
85020,200,19694,25577;25747,56940,0,0,0,2,2
85021,200,19695,25738,56940,0,0,0,1,1
85022,200,19696,25204;25728,56940,0,0,0,2,2
85023,200,19698,26179;28747,56940,0,0,2,0,2
85024,200,19699,25789;25928,56940,0,0,0,2,2
85025,200,19702,25841,56940,0,0,0,1,1
85026,200,19703,25842,56940,0,0,0,1,1
85027,200,19704,25862,56940,0,0,0,1,1
85028,200,19705,25924,56940,0,0,0,1,1
85029,200,19707,26227;29082;31621,56940,1,0,2,0,3
85030,200,19708,25933,56940,0,0,0,1,1
85031,200,19709,26127;26146;30026,56940,0,0,3,0,3
85032,200,19710,26410,56940,0,0,1,0,1
85033,200,19712,25972,56940,0,0,0,1,1
85034,200,19713,26002;26034;30102,56940,0,0,1,2,3
85035,200,19714,26102,56940,0,0,1,0,1
85036,200,19716,26406,56940,0,0,1,0,1
85037,200,19717,26070;26285,56940,0,0,1,1,2
85038,200,19718,25792;26101,56940,0,0,1,1,2
85039,200,19719,26233,56940,0,0,1,0,1
85040,200,19721,25688;25850,56940,0,0,0,2,2
85041,200,19724,25677;26150,56940,0,0,1,1,2
85042,200,19726,26171,56940,0,0,1,0,1
85043,200,19727,25960,56940,0,0,0,1,1
85044,200,19728,26011;26192,56940,0,0,1,1,2
85045,200,19736,22930,57305,0,0,0,1,1
85046,200,19742,22923,57305,0,0,0,1,1
85047,200,19760,23501,57305,0,0,0,1,1
85048,200,19767,24917,57305,0,0,0,1,1
85049,200,19769,24785;24862,57305,0,0,0,2,2
85050,200,19770,25052,57305,0,0,0,1,1
85051,200,19771,24744;25147,57305,0,0,0,2,2
85052,200,19772,25461;25539,57305,0,0,0,2,2
85053,200,19773,25197;25386,57305,0,0,0,2,2
85054,200,19774,25458,57305,0,0,0,1,1
85055,200,19776,25247;25587,57305,0,0,0,2,2
85056,200,19777,25037,57305,0,0,0,1,1
85057,200,19779,25648;25812,57305,0,0,0,2,2
85058,200,19783,25615;25623;29304;31937,57305,1,0,1,2,4
85059,200,19784,25478;25632,57305,0,0,0,2,2
85060,200,19785,25664;25695,57305,0,0,0,2,2
85061,200,19786,25715,57305,0,0,0,1,1
85062,200,19787,25357;25781,57305,0,0,0,2,2
85063,200,19788,25681;25733,57305,0,0,0,2,2
85064,200,19790,25763,57305,0,0,0,1,1
85065,200,19791,25548;25845,57305,0,0,0,2,2
85066,200,19792,25852;25997,57305,0,0,0,2,2
85067,200,19793,25840;25861;28792;30746;31169;31438;31518;31674,57305,1,4,1,2,8
85068,200,19795,25892,57305,0,0,0,1,1
85069,200,19796,25911;26183,57305,0,0,1,1,2
85070,200,19797,25919;26278,57305,0,0,1,1,2
85071,200,19798,25776;26085,57305,0,0,0,2,2
85072,200,19799,26280,57305,0,0,1,0,1
85073,200,19800,25393;25989,57305,0,0,0,2,2
85074,200,19801,26095,57305,0,0,0,1,1
85075,200,19803,25969;26264;29761;31796,57305,1,0,2,1,4
85076,200,19804,26019,57305,0,0,0,1,1
85077,200,19805,26065;26249,57305,0,0,1,1,2
85078,200,19806,26145;26388,57305,0,0,2,0,2
85079,200,19807,26160;26676,57305,0,0,2,0,2
85080,200,19808,26186;26312,57305,0,0,2,0,2
85081,200,19809,26187;26417,57305,0,0,2,0,2
85082,200,19810,26156;26197,57305,0,0,2,0,2
85083,200,19811,25915;26211,57305,0,0,1,1,2
85084,200,19813,26166;26235,57305,0,0,2,0,2
85085,200,19814,26025;26239;30103,57305,0,0,2,1,3
85086,200,19815,26536;26599;29423,57305,0,0,3,0,3
85087,200,19824,22510,57670,0,0,0,1,1
85088,200,19830,23155,57670,0,0,0,1,1
85089,200,19834,23363,57670,0,0,0,1,1
85090,200,19837,23406;23581,57670,0,0,0,2,2
85091,200,19840,23819,57670,0,0,0,1,1
85092,200,19844,24596,57670,0,0,0,1,1
85093,200,19852,24607;24913,57670,0,0,0,2,2
85094,200,19858,24807;25406,57670,0,0,0,2,2
85095,200,19859,25003;25176,57670,0,0,0,2,2
85096,200,19860,25133;25235,57670,0,0,0,2,2
85097,200,19865,25263,57670,0,0,0,1,1
85098,200,19866,25334;25552,57670,0,0,0,2,2
85099,200,19867,25404;25416,57670,0,0,0,2,2
85100,200,19868,25432;25528,57670,0,0,0,2,2
85101,200,19869,25456,57670,0,0,0,1,1
85102,200,19871,25650,57670,0,0,0,1,1
85103,200,19872,25345;25622;29045;30923;31691;31849,57670,2,1,1,2,6
85104,200,19873,25625,57670,0,0,0,1,1
85105,200,19874,25660;26152,57670,0,0,1,1,2
85106,200,19875,25661;26275,57670,0,0,1,1,2
85107,200,19876,25705;25923,57670,0,0,0,2,2
85108,200,19878,25753;25942,57670,0,0,0,2,2
85109,200,19879,25937;26377,57670,0,0,1,1,2
85110,200,19880,25399;25775,57670,0,0,0,2,2
85111,200,19881,25594;25791;28869,57670,0,0,1,2,3
85112,200,19884,26010;26096,57670,0,0,0,2,2
85113,200,19886,25968;26274;29251,57670,0,0,2,1,3
85114,200,19887,25888;25949;28882,57670,0,0,1,2,3
85115,200,19888,26153;28981;29079;31456;31620,57670,1,1,3,0,5
85116,200,19889,26045;26117,57670,0,0,1,1,2
85117,200,19890,26104;26125,57670,0,0,2,0,2
85118,200,19892,26132;26133,57670,0,0,2,0,2
85119,200,19893,25970;26136,57670,0,0,1,1,2
85120,200,19894,26131;26162,57670,0,0,2,0,2
85121,200,19895,26869;29874,57670,0,0,2,0,2
85122,200,19896,26208,57670,0,0,1,0,1
85123,200,19897,25737;25806;28955;31529,57670,0,1,1,2,4
85124,200,19898,26247,57670,0,0,1,0,1
85125,200,19899,26251;26456,57670,0,0,2,0,2
85126,200,19900,26253;26477,57670,0,0,2,0,2
85127,200,19901,26429;26711,57670,0,0,2,0,2
85128,200,19902,26258;26561;29420,57670,0,0,3,0,3
85129,200,19903,26248;26528;29517;30105,57670,0,0,4,0,4
85130,200,19904,26066;26291,57670,0,0,1,1,2
85131,200,19905,26426;26631;29857,57670,0,0,3,0,3
85132,200,19906,26600;29771,57670,0,0,2,0,2
85133,200,19907,26309;26335,57670,0,0,2,0,2
85134,200,19908,26407;28758,57670,0,0,2,0,2
85135,200,19909,26167;26667,57670,0,0,2,0,2
85136,200,19910,26257;26589,57670,0,0,2,0,2
85137,200,19911,26411;26431,57670,0,0,2,0,2
85138,200,19933,23538,58035,0,0,0,1,1
85139,200,19937,24397,58035,0,0,0,1,1
85140,200,19942,24434;25006,58035,0,0,0,2,2
85141,200,19943,25023,58035,0,0,0,1,1
85142,200,19944,24076,58035,0,0,0,1,1
85143,200,19945,24517,58035,0,0,0,1,1
85144,200,19948,24656,58035,0,0,0,1,1
85145,200,19951,25064,58035,0,0,0,1,1
85146,200,19953,25419,58035,0,0,0,1,1
85147,200,19955,25199;25253,58035,0,0,0,2,2
85148,200,19956,25834,58035,0,0,0,1,1
85149,200,19958,25105,58035,0,0,0,1,1
85150,200,19959,25291;25434;27725;31027,58035,0,1,1,2,4
85151,200,19960,25103,58035,0,0,0,1,1
85152,200,19961,25856;26039,58035,0,0,0,2,2
85153,200,19963,25546;28780;29668;31092;31517,58035,0,2,2,1,5
85154,200,19965,25157;25287,58035,0,0,0,2,2
85155,200,19967,25927;26148;29594,58035,0,0,2,1,3
85156,200,19968,25955,58035,0,0,0,1,1
85157,200,19969,25361;25784,58035,0,0,0,2,2
85158,200,19971,26879;26887;30121,58035,0,0,3,0,3
85159,200,19972,25835,58035,0,0,0,1,1
85160,200,19975,25437;25880;29055;31538,58035,0,1,1,2,4
85161,200,19976,25647;25983,58035,0,0,0,2,2
85162,200,19977,25906;26143,58035,0,0,1,1,2
85163,200,19978,25693;25951,58035,0,0,0,2,2
85164,200,19979,25961;26290;29169;29253,58035,0,0,3,1,4
85165,200,19980,25694;25703,58035,0,0,0,2,2
85166,200,19982,26220;26314,58035,0,0,2,0,2
85167,200,19983,26172;26341,58035,0,0,2,0,2
85168,200,19984,26112;26519;30488,58035,0,1,2,0,3
85169,200,19985,26121;26175,58035,0,0,2,0,2
85170,200,19986,26394;26538,58035,0,0,2,0,2
85171,200,19987,26177;26331;29846,58035,0,0,3,0,3
85172,200,19988,25976,58035,0,0,0,1,1
85173,200,19989,26215,58035,0,0,1,0,1
85174,200,19991,26263;26750;29960,58035,0,0,3,0,3
85175,200,19992,25889;26269;29506,58035,0,0,2,1,3
85176,200,19993,26717;26741,58035,0,0,2,0,2
85177,200,19994,26485,58035,0,0,1,0,1
85178,200,19995,26327;26334;29170,58035,0,0,3,0,3
85179,200,19996,26307,58035,0,0,1,0,1
85180,200,19998,26094;26330,58035,0,0,1,1,2
85181,200,19999,26508;28586;29344,58035,0,0,3,0,3
85182,200,20000,26356;29257,58035,0,0,2,0,2
85183,200,20001,26397,58035,0,0,1,0,1
85184,200,20002,26416;26702,58035,0,0,2,0,2
85185,200,20003,26422,58035,0,0,1,0,1
85186,200,20004,26781,58035,0,0,1,0,1
85187,200,20005,26129;26267,58035,0,0,2,0,2
85188,200,20006,26448,58035,0,0,1,0,1
85189,200,20007,26219;26565,58035,0,0,2,0,2
85190,200,20008,26383;26479,58035,0,0,2,0,2
85191,200,20009,26493;29849;31478;31641;31799,58035,2,1,2,0,5
85192,200,20012,23239,58400,0,0,0,1,1
85193,200,20014,22457,58400,0,0,0,1,1
85194,200,20015,22919,58400,0,0,0,1,1
85195,200,20024,23692,58400,0,0,0,1,1
85196,200,20025,23081,58400,0,0,0,1,1
85197,200,20033,24452,58400,0,0,0,1,1
85198,200,20039,24649;25136,58400,0,0,0,2,2
85199,200,20040,25256,58400,0,0,0,1,1
85200,200,20041,25077,58400,0,0,0,1,1
85201,200,20042,25092;25280,58400,0,0,0,2,2
85202,200,20044,25630,58400,0,0,0,1,1
85203,200,20045,25342;25389,58400,0,0,0,2,2
85204,200,20047,25270,58400,0,0,0,1,1
85205,200,20051,25808,58400,0,0,0,1,1
85206,200,20053,25089;25592,58400,0,0,0,2,2
85207,200,20054,25639;26189,58400,0,0,1,1,2
85208,200,20055,25201;25721,58400,0,0,0,2,2
85209,200,20056,26008;30200,58400,0,0,1,1,2
85210,200,20059,25926;26035;29060;31183,58400,0,1,1,2,4
85211,200,20060,26055;26155,58400,0,0,1,1,2
85212,200,20061,26435,58400,0,0,1,0,1
85213,200,20062,26137;26222,58400,0,0,2,0,2
85214,200,20063,25624;26090;28896,58400,0,0,1,2,3
85215,200,20065,25838;26193,58400,0,0,1,1,2
85216,200,20067,25931;26190,58400,0,0,1,1,2
85217,200,20068,26009,58400,0,0,0,1,1
85218,200,20069,26421;26575,58400,0,0,2,0,2
85219,200,20070,26300;26390,58400,0,0,2,0,2
85220,200,20071,26645;26646;30205,58400,0,0,3,0,3
85221,200,20072,26349;26495;29850,58400,0,0,3,0,3
85222,200,20073,26128;26345,58400,0,0,2,0,2
85223,200,20074,26550;26634;30204,58400,0,0,3,0,3
85224,200,20075,26469;26691;29529,58400,0,0,3,0,3
85225,200,20076,26643;26731;29108;29867;30036,58400,0,0,5,0,5
85226,200,20077,26718;26740,58400,0,0,2,0,2
85227,200,20078,26399;26708;29106,58400,0,0,3,0,3
85228,200,20079,26541;26672;29264,58400,0,0,3,0,3
85229,200,20080,26404;26518;30029,58400,0,0,3,0,3
85230,200,20081,26794,58400,0,0,1,0,1
85231,200,20083,26484;26492,58400,0,0,2,0,2
85232,200,20084,26505;26514,58400,0,0,2,0,2
85233,200,20085,26802;26812,58400,0,0,2,0,2
85234,200,20086,26715;26776,58400,0,0,2,0,2
85235,200,20087,26546;26780;30399,58400,0,0,3,0,3
85236,200,20088,26232;26551;30579,58400,0,1,2,0,3
85237,200,20089,26552;26761,58400,0,0,2,0,2
85238,200,20090,26097;26653,58400,0,0,1,1,2
85239,200,20091,26784;26912;30489,58400,0,1,2,0,3
85240,200,20103,23351,58765,0,0,0,1,1
85241,200,20104,23637,58765,0,0,0,1,1
85242,200,20106,23519,58765,0,0,0,1,1
85243,200,20108,23568,58765,0,0,0,1,1
85244,200,20115,24282,58765,0,0,0,1,1
85245,200,20118,24811,58765,0,0,0,1,1
85246,200,20120,24839,58765,0,0,0,1,1
85247,200,20126,25224;25687,58765,0,0,0,2,2
85248,200,20130,25119;25611,58765,0,0,0,2,2
85249,200,20131,25344;25403;28528,58765,0,0,1,2,3
85250,200,20135,25141;25217,58765,0,0,0,2,2
85251,200,20136,25667;25860,58765,0,0,0,2,2
85252,200,20138,26118;26154,58765,0,0,2,0,2
85253,200,20140,26093,58765,0,0,0,1,1
85254,200,20142,25772;25913,58765,0,0,0,2,2
85255,200,20143,25987;26209,58765,0,0,1,1,2
85256,200,20144,25744;25985;28968;29062;30749;31531;31686,58765,1,2,2,2,7
85257,200,20145,26428,58765,0,0,1,0,1
85258,200,20147,25936;26185,58765,0,0,1,1,2
85259,200,20150,25984;26212,58765,0,0,1,1,2
85260,200,20153,25954;26252;29952,58765,0,0,2,1,3
85261,200,20154,25809;26295,58765,0,0,1,1,2
85262,200,20155,26779;30113;30398;31806,58765,1,0,3,0,4
85263,200,20156,26279;26564,58765,0,0,2,0,2
85264,200,20157,25994;26398;30578,58765,0,1,1,1,3
85265,200,20158,26357;26365,58765,0,0,2,0,2
85266,200,20159,26368;26401,58765,0,0,2,0,2
85267,200,20160,26385;26724;30295,58765,0,0,3,0,3
85268,200,20161,26402;26529,58765,0,0,2,0,2
85269,200,20162,26765;26948;29443,58765,0,0,3,0,3
85270,200,20163,26612;30396,58765,0,0,2,0,2
85271,200,20164,26149;26468,58765,0,0,2,0,2
85272,200,20165,26437,58765,0,0,1,0,1
85273,200,20167,26332;26674;29776,58765,0,0,3,0,3
85274,200,20168,26523;26560,58765,0,0,2,0,2
85275,200,20169,25878;26501,58765,0,0,1,1,2
85276,200,20170,26503,58765,0,0,1,0,1
85277,200,20171,26053;28582;30998;31587,58765,1,1,1,1,4
85278,200,20172,26496;26706,58765,0,0,2,0,2
85279,200,20174,26587;26790;29540,58765,0,0,3,0,3
85280,200,20176,26432;26583,58765,0,0,2,0,2
85281,200,20177,26840,58765,0,0,1,0,1
85282,200,20178,26592;26759,58765,0,0,2,0,2
85283,200,20179,26598,58765,0,0,1,0,1
85284,200,20180,26804;30298,58765,0,0,2,0,2
85285,200,20181,26549;26675;29620,58765,0,0,3,0,3
85286,200,20182,26644;26681,58765,0,0,2,0,2
85287,200,20183,26695;26923;29554,58765,0,0,3,0,3
85288,200,20184,26683;26713;29621,58765,0,0,3,0,3
85289,200,20185,26506;26714;29866,58765,0,0,3,0,3
85290,200,20186,22739,59130,0,0,0,1,1
85291,200,20203,24043,59130,0,0,0,1,1
85292,200,20206,24122,59130,0,0,0,1,1
85293,200,20208,24399;24540,59130,0,0,0,2,2
85294,200,20210,24498,59130,0,0,0,1,1
85295,200,20215,25106,59130,0,0,0,1,1
85296,200,20216,25198,59130,0,0,0,1,1
85297,200,20217,24893;25110,59130,0,0,0,2,2
85298,200,20218,25035;25352,59130,0,0,0,2,2
85299,200,20219,25282,59130,0,0,0,1,1
85300,200,20220,25383;25659;28939,59130,0,0,1,2,3
85301,200,20221,25691,59130,0,0,0,1,1
85302,200,20222,25974;26052,59130,0,0,0,2,2
85303,200,20223,25566,59130,0,0,0,1,1
85304,200,20224,25686;25798,59130,0,0,0,2,2
85305,200,20225,25771;25823;29308,59130,0,0,1,2,3
85306,200,20226,26245;26246,59130,0,0,2,0,2
85307,200,20229,25964;26043,59130,0,0,0,2,2
85308,200,20230,26013,59130,0,0,0,1,1
85309,200,20231,26284;26333;29256,59130,0,0,3,0,3
85310,200,20232,25899;26038,59130,0,0,0,2,2
85311,200,20233,26014;26184,59130,0,0,1,1,2
85312,200,20234,26072;26440,59130,0,0,1,1,2
85313,200,20237,25898;26115;28811;31009;31440,59130,0,2,2,1,5
85314,200,20238,26140;26374;29847,59130,0,0,3,0,3
85315,200,20239,26214;26281,59130,0,0,2,0,2
85316,200,20240,26597;26698;30035,59130,0,0,3,0,3
85317,200,20241,26126;26553,59130,0,0,2,0,2
85318,200,20242,26229;26570,59130,0,0,2,0,2
85319,200,20244,26320;26664;30206,59130,0,0,3,0,3
85320,200,20245,26084;26321,59130,0,0,1,1,2
85321,200,20246,26343;26656,59130,0,0,2,0,2
85322,200,20248,26283;26453,59130,0,0,2,0,2
85323,200,20249,26703;26775;30109,59130,0,0,3,0,3
85324,200,20251,26319;26466,59130,0,0,2,0,2
85325,200,20252,26277;26753,59130,0,0,2,0,2
85326,200,20254,26384;26490,59130,0,0,2,0,2
85327,200,20255,26351;30106,59130,0,0,2,0,2
85328,200,20256,26196;26542,59130,0,0,2,0,2
85329,200,20257,26556;26777,59130,0,0,2,0,2
85330,200,20258,26483;26798;30115,59130,0,0,3,0,3
85331,200,20259,26591;26705;29530;30580,59130,0,1,3,0,4
85332,200,20260,26392;26601;29269,59130,0,0,3,0,3
85333,200,20261,26608;27050,59130,0,0,2,0,2
85334,200,20264,26678;27042,59130,0,0,2,0,2
85335,200,20265,26354;26686;29862;31885,59130,1,0,3,0,4
85336,200,20266,26200;26487,59130,0,0,2,0,2
85337,200,20268,26729;26928;29556,59130,0,0,3,0,3
85338,200,20269,26867;27018,59130,0,0,2,0,2
85339,200,20270,26430;26787,59130,0,0,2,0,2
85340,200,20271,26737;27000;30125,59130,0,0,3,0,3
85341,200,20272,26461;26800;29542,59130,0,0,3,0,3
85342,200,20281,23265,59495,0,0,0,1,1
85343,200,20305,25610;25730,59495,0,0,0,2,2
85344,200,20311,25341;25731,59495,0,0,0,2,2
85345,200,20314,25865;26306;29088;30846;31541,59495,0,2,2,1,5
85346,200,20315,26243;26412;29765,59495,0,0,3,0,3
85347,200,20318,25605;25947,59495,0,0,0,2,2
85348,200,20319,25820;26003,59495,0,0,0,2,2
85349,200,20320,26088,59495,0,0,0,1,1
85350,200,20321,26041,59495,0,0,0,1,1
85351,200,20322,26100,59495,0,0,0,1,1
85352,200,20323,26116,59495,0,0,1,0,1
85353,200,20326,26180;26244,59495,0,0,2,0,2
85354,200,20327,26064;26255;29841;31883,59495,1,0,2,1,4
85355,200,20328,26268;26926;29790;30124;30212,59495,0,0,5,0,5
85356,200,20329,26434,59495,0,0,1,0,1
85357,200,20330,26337;26994,59495,0,0,2,0,2
85358,200,20331,26181;26361,59495,0,0,2,0,2
85359,200,20332,26369;26395,59495,0,0,2,0,2
85360,200,20333,26491,59495,0,0,1,0,1
85361,200,20336,26454;26544;29339,59495,0,0,3,0,3
85362,200,20338,26288;26482;29096;29342;31554;31629,59495,1,1,4,0,6
85363,200,20339,26806;26939;29883;30301,59495,0,0,4,0,4
85364,200,20340,30217,59495,0,0,1,0,1
85365,200,20342,26522;26658,59495,0,0,2,0,2
85366,200,20343,26261;26526,59495,0,0,2,0,2
85367,200,20344,26636;26660,59495,0,0,2,0,2
85368,200,20345,26403;26548;29519;29853,59495,0,0,4,0,4
85369,200,20346,26856;26885,59495,0,0,2,0,2
85370,200,20347,26655;26877;29551;30300,59495,0,0,4,0,4
85371,200,20348,26443;26657;28826;29618;31267,59495,0,1,4,0,5
85372,200,20349,26669;29353;29775,59495,0,0,3,0,3
85373,200,20350,26966;27060;30129,59495,0,0,3,0,3
85374,200,20351,26568;26719,59495,0,0,2,0,2
85375,200,20352,26848;27089;30307,59495,0,0,3,0,3
85376,200,20353,26801;27065;29707;30051,59495,0,0,4,0,4
85377,200,20354,26617;26919,59495,0,0,2,0,2
85378,200,20355,26386;26754;30397,59495,0,0,3,0,3
85379,200,20356,26442;26825,59495,0,0,2,0,2
85380,200,20357,26827;27043,59495,0,0,2,0,2
85381,200,20358,26828;27086,59495,0,0,2,0,2
85382,200,20359,26830;26969;29884,59495,0,0,3,0,3
85383,200,20360,26850;27023,59495,0,0,2,0,2
85384,200,20361,26767;29109;30112,59495,0,0,3,0,3
85385,200,20362,27109;27154;29715;30226,59495,0,0,4,0,4
85386,200,20363,26545;26904,59495,0,0,2,0,2
85387,200,20370,23086,59860,0,0,0,1,1
85388,200,20377,23517,59860,0,0,0,1,1
85389,200,20383,24824,59860,0,0,0,1,1
85390,200,20385,25081,59860,0,0,0,1,1
85391,200,20387,25047;25396,59860,0,0,0,2,2
85392,200,20391,26031,59860,0,0,0,1,1
85393,200,20392,25872;26062;29054;31767,59860,1,0,1,2,4
85394,200,20394,25904;26164,59860,0,0,1,1,2
85395,200,20395,26012;26176,59860,0,0,1,1,2
85396,200,20396,26058;26489,59860,0,0,1,1,2
85397,200,20397,26060;26216;28983,59860,0,0,2,1,3
85398,200,20398,25946;26079,59860,0,0,0,2,2
85399,200,20399,25894;26272;29678,59860,0,0,2,1,3
85400,200,20401,26413;29954,59860,0,0,2,0,2
85401,200,20402,26223;26638;29271;29858,59860,0,0,4,0,4
85402,200,20404,26614,59860,0,0,1,0,1
85403,200,20405,26206;26350,59860,0,0,2,0,2
85404,200,20408,26317;26621,59860,0,0,2,0,2
85405,200,20409,26504,59860,0,0,1,0,1
85406,200,20410,26525;26920,59860,0,0,2,0,2
85407,200,20411,26990;27059;30216,59860,0,0,3,0,3
85408,200,20412,26488;26559;29521;29958,59860,0,0,4,0,4
85409,200,20413,26588;26635;29614,59860,0,0,3,0,3
85410,200,20414,26623;26971,59860,0,0,2,0,2
85411,200,20415,26509;26940,59860,0,0,2,0,2
85412,200,20416,26173;26742,59860,0,0,2,0,2
85413,200,20418,26735;29692;30037,59860,0,0,3,0,3
85414,200,20419,26743;26760,59860,0,0,2,0,2
85415,200,20420,26818,59860,0,0,1,0,1
85416,200,20421,26562;26785;30114,59860,0,0,3,0,3
85417,200,20422,26355;26744;29868;30110,59860,0,0,4,0,4
85418,200,20423,26772;26805;29280,59860,0,0,3,0,3
85419,200,20424,26704;29544,59860,0,0,2,0,2
85420,200,20425,27158;27207,59860,0,0,2,0,2
85421,200,20426,26826;27083,59860,0,0,2,0,2
85422,200,20427,26459;27052;29561;30218,59860,0,0,4,0,4
85423,200,20428,27181;27227,59860,0,0,2,0,2
85424,200,20430,26851;30506;30671,59860,0,2,1,0,3
85425,200,20431,26973;27221,59860,0,0,2,0,2
85426,200,20432,26866;27076,59860,0,0,2,0,2
85427,200,20434,26894;27104;30309,59860,0,0,3,0,3
85428,200,20435,26521;26905,59860,0,0,2,0,2
85429,200,20436,26755;27179;29902;30501;30585,59860,0,2,3,0,5
85430,200,20437,26927;27141,59860,0,0,2,0,2
85431,200,20438,26935;27131;30056,59860,0,0,3,0,3
85432,200,20439,26936;26946,59860,0,0,2,0,2
85433,200,20440,26622;26965;29558,59860,0,0,3,0,3
85434,200,20441,26838;27053;29969;30128;31723,59860,1,0,4,0,5
85435,200,20442,26987;27171;29977,59860,0,0,3,0,3
85436,200,20443,27219;27321;30064;30407;30502;30660,59860,0,2,4,0,6
85437,200,20446,23499,60225,0,0,0,1,1
85438,200,20447,23996,60225,0,0,0,1,1
85439,200,20455,25229,60225,0,0,0,1,1
85440,200,20458,26139;26168;28745;30199;31514,60225,0,1,4,0,5
85441,200,20460,25765;25875;29756,60225,0,0,1,2,3
85442,200,20462,25863;25881,60225,0,0,0,2,2
85443,200,20464,26089;26147,60225,0,0,1,1,2
85444,200,20465,26201;26414;30395,60225,0,0,3,0,3
85445,200,20466,26271;26881;30753,60225,0,1,2,0,3
85446,200,20467,26316;26450,60225,0,0,2,0,2
85447,200,20470,26405;26975;30044;30303,60225,0,0,4,0,4
85448,200,20471,26771;29628,60225,0,0,2,0,2
85449,200,20472,26748;26774,60225,0,0,2,0,2
85450,200,20473,26347;26618,60225,0,0,2,0,2
85451,200,20474,26512;26964,60225,0,0,2,0,2
85452,200,20475,26427;26579;30202,60225,0,0,3,0,3
85453,200,20477,26739;26747;30296,60225,0,0,3,0,3
85454,200,20479,26515;26651,60225,0,0,2,0,2
85455,200,20480,26641;26868,60225,0,0,2,0,2
85456,200,20481,26472;26952,60225,0,0,2,0,2
85457,200,20482,26534;26722;30294,60225,0,0,3,0,3
85458,200,20483,26728;27066;30052,60225,0,0,3,0,3
85459,200,20484,26746;27092,60225,0,0,2,0,2
85460,200,20485,26465;26773,60225,0,0,2,0,2
85461,200,20486,26630;26810,60225,0,0,2,0,2
85462,200,20487,25959;26694;28760,60225,0,0,2,1,3
85463,200,20488,26733;26843;30118,60225,0,0,3,0,3
85464,200,20489,26937;27047;30582,60225,0,1,2,0,3
85465,200,20490,26693;26853,60225,0,0,2,0,2
85466,200,20491,26607;26979,60225,0,0,2,0,2
85467,200,20492,26391;26864;29283,60225,0,0,3,0,3
85468,200,20493,27125;27258;29909;29983,60225,0,0,4,0,4
85469,200,20494,26895;30042;30211;30657,60225,0,1,3,0,4
85470,200,20495,26110;26958;30656,60225,0,1,2,0,3
85471,200,20496,26992;27359;29571;30235,60225,0,0,4,0,4
85472,200,20497,27006;27325;30325;30664,60225,0,1,3,0,4
85473,200,20498,26997;27260,60225,0,0,2,0,2
85474,200,20499,27009;30126,60225,0,0,2,0,2
85475,200,20500,26757;27024;30047,60225,0,0,3,0,3
85476,200,20501,26896;27120;29898,60225,0,0,3,0,3
85477,200,20502,26944;27073;30131,60225,0,0,3,0,3
85478,200,20503,26751;29798;30132,60225,0,0,3,0,3
85479,200,20504,27085;27209,60225,0,0,2,0,2
85480,200,20505,26845;27100;30134;31962,60225,1,0,3,0,4
85481,200,20512,23553,60590,0,0,0,1,1
85482,200,20513,23567;23943,60590,0,0,0,2,2
85483,200,20515,23893,60590,0,0,0,1,1
85484,200,20519,23846,60590,0,0,0,1,1
85485,200,20521,24054,60590,0,0,0,1,1
85486,200,20526,24189,60590,0,0,0,1,1
85487,200,20530,25307,60590,0,0,0,1,1
85488,200,20539,25259,60590,0,0,0,1,1
85489,200,20541,25251;25277,60590,0,0,0,2,2
85490,200,20542,25492;25821,60590,0,0,0,2,2
85491,200,20545,26054;26242;29487;31103,60590,0,1,2,1,4
85492,200,20547,25701;25830;28475,60590,0,0,1,2,3
85493,200,20548,26234;29502,60590,0,0,2,0,2
85494,200,20553,26015;26582;30203,60590,0,0,2,1,3
85495,200,20554,26310;26344;29763,60590,0,0,3,0,3
85496,200,20555,26044;26530;29767,60590,0,0,2,1,3
85497,200,20556,26205;26342,60590,0,0,2,0,2
85498,200,20557,26250;26262,60590,0,0,2,0,2
85499,200,20559,26114;26303;28979,60590,0,0,3,0,3
85500,200,20560,26666;26723;29527,60590,0,0,3,0,3
85501,200,20561,26099;26462,60590,0,0,1,1,2
85502,200,20562,26463;26961,60590,0,0,2,0,2
85503,200,20565,26604;26977,60590,0,0,2,0,2
85504,200,20566,26938;27142;29021;30058,60590,0,0,4,0,4
85505,200,20567,26322;26338,60590,0,0,2,0,2
85506,200,20568,26647,60590,0,0,1,0,1
85507,200,20569,26581;26663,60590,0,0,2,0,2
85508,200,20570,27242;29807,60590,0,0,2,0,2
85509,200,20571,26460;26677,60590,0,0,2,0,2
85510,200,20572,26858;29022;31619;31690,60590,2,0,2,0,4
85511,200,20574,26022;26764;29626;30297,60590,0,0,3,1,4
85512,200,20575,26788;26942;29965;30043,60590,0,0,4,0,4
85513,200,20576,26824;26837,60590,0,0,2,0,2
85514,200,20578,27235;27248;30409,60590,0,0,3,0,3
85515,200,20579,26917;29701,60590,0,0,2,0,2
85516,200,20580,26524;26934,60590,0,0,2,0,2
85517,200,20581,26949;27161;29192;30403,60590,0,0,4,0,4
85518,200,20582,26882;30210,60590,0,0,2,0,2
85519,200,20585,26799;27262;30231,60590,0,0,3,0,3
85520,200,20586,27115;30496,60590,0,1,1,0,2
85521,200,20587,26611;27055;30219,60590,0,0,3,0,3
85522,200,20588,27119;27190;30055;30224;30405,60590,0,0,5,0,5
85523,200,20589,26254;26855,60590,0,0,2,0,2
85524,200,20590,27128;27215,60590,0,0,2,0,2
85525,200,20591,27078;27138,60590,0,0,2,0,2
85526,200,20592,27147;27203;30317;30755,60590,0,1,3,0,4
85527,200,20601,23895;24002,60955,0,0,0,2,2
85528,200,20605,24220,60955,0,0,0,1,1
85529,200,20613,24755,60955,0,0,0,1,1
85530,200,20619,25130,60955,0,0,0,1,1
85531,200,20620,25200;27732;29929,60955,0,0,2,1,3
85532,200,20621,25056;25599,60955,0,0,0,2,2
85533,200,20628,25465;25790,60955,0,0,0,2,2
85534,200,20629,26174;26346,60955,0,0,2,0,2
85535,200,20630,26006;26068,60955,0,0,0,2,2
85536,200,20632,25824;25905;29143,60955,0,0,1,2,3
85537,200,20633,25706;26024,60955,0,0,0,2,2
85538,200,20634,26956;26991;29557;29792;30302,60955,0,0,5,0,5
85539,200,20635,26370;26778;29870,60955,0,0,3,0,3
85540,200,20636,26198;26348,60955,0,0,2,0,2
85541,200,20637,26498;26847,60955,0,0,2,0,2
85542,200,20638,26891;27088,60955,0,0,2,0,2
85543,200,20641,26932;30213,60955,0,0,2,0,2
85544,200,20642,26615;26998,60955,0,0,2,0,2
85545,200,20644,26874;30120,60955,0,0,2,0,2
85546,200,20645,26584;26688,60955,0,0,2,0,2
85547,200,20647,26595;26710;29178;29855;31283;31546,60955,0,2,4,0,6
85548,200,20648,26690;26738,60955,0,0,2,0,2
85549,200,20649,26606;26978,60955,0,0,2,0,2
85550,200,20650,26649;26986;30045,60955,0,0,3,0,3
85551,200,20652,26793;26861,60955,0,0,2,0,2
85552,200,20653,26819;26916;30116,60955,0,0,3,0,3
85553,200,20654,26727;27031,60955,0,0,2,0,2
85554,200,20655,26833;27244;30067;30587,60955,0,1,3,0,4
85555,200,20656,26900;27301;30070;30233,60955,0,0,4,0,4
85556,200,20658,26955;27196;29903;30316;31480;31958,60955,1,1,4,0,6
85557,200,20659,26875;27144;30059,60955,0,0,3,0,3
85558,200,20660,27352;29126,60955,0,0,2,0,2
85559,200,20661,27547;30341,60955,0,0,2,0,2
85560,200,20662,26586;26871;29876,60955,0,0,3,0,3
85561,200,20663,26629;26929;29882,60955,0,0,3,0,3
85562,200,20664,27057;30492,60955,0,1,1,0,2
85563,200,20665,27002;27077,60955,0,0,2,0,2
85564,200,20666,26968;27082,60955,0,0,2,0,2
85565,200,20667,26665;27224;30139;30320;30408,60955,0,0,5,0,5
85566,200,20668,26720;27096,60955,0,0,2,0,2
85567,200,20669,26970;27103,60955,0,0,2,0,2
85568,200,20670,26791;27113;29450;29971;31290;31714,60955,1,1,4,0,6
85569,200,20671,27252;27511;30161;30599,60955,0,1,3,0,4
85570,200,20672,27101;27118;30136;30498,60955,0,1,3,0,4
85571,200,20673,26988;27145;29713;30060,60955,0,0,4,0,4
85572,200,20674,26983;27146,60955,0,0,2,0,2
85573,200,20675,26996;27149;30138,60955,0,0,3,0,3
85574,200,20676,27150;27542;30162;30767,60955,0,1,3,0,4
85575,200,20677,27177,60955,0,0,1,0,1
85576,200,20678,27093;27280,60955,0,0,2,0,2
85577,200,20681,27211;27273,60955,0,0,2,0,2
85578,200,20682,27277;27425;29463;29655,60955,0,0,4,0,4
85579,200,20686,23201,61320,0,0,0,1,1
85580,200,20690,23092,61320,0,0,0,1,1
85581,200,20691,23366,61320,0,0,0,1,1
85582,200,20695,23892,61320,0,0,0,1,1
85583,200,20697,24315;24415,61320,0,0,0,2,2
85584,200,20699,24094,61320,0,0,0,1,1
85585,200,20703,24848,61320,0,0,0,1,1
85586,200,20709,25283,61320,0,0,0,1,1
85587,200,20711,25281,61320,0,0,0,1,1
85588,200,20713,25848,61320,0,0,0,1,1
85589,200,20715,25774;25787,61320,0,0,0,2,2
85590,200,20716,25805;26067;29318,61320,0,0,1,2,3
85591,200,20718,26165,61320,0,0,1,0,1
85592,200,20723,26473;26692;29864,61320,0,0,3,0,3
85593,200,20724,26151;26393;29512,61320,0,0,3,0,3
85594,200,20726,26474;26909,61320,0,0,2,0,2
85595,200,20729,26659,61320,0,0,1,0,1
85596,200,20730,26661;27017;30127;30305,61320,0,0,4,0,4
85597,200,20732,26336;26687;29863;30108,61320,0,0,4,0,4
85598,200,20733,26439;26633;29525;29616,61320,0,0,4,0,4
85599,200,20734,26697;26981,61320,0,0,2,0,2
85600,200,20736,26566;26836;29788,61320,0,0,3,0,3
85601,200,20737,26880;27163,61320,0,0,2,0,2
85602,200,20739,26876;29877;31957,61320,1,0,2,0,3
85603,200,20740,26993;30598,61320,0,1,1,0,2
85604,200,20741,26931;27011;29791,61320,0,0,3,0,3
85605,200,20742,26957;27019;30306,61320,0,0,3,0,3
85606,200,20743,26789;27026,61320,0,0,2,0,2
85607,200,20744,27038,61320,0,0,1,0,1
85608,200,20745,27049;27350;30234,61320,0,0,3,0,3
85609,200,20746,27127;30225;30499;31725,61320,1,1,2,0,4
85610,200,20747,26832;27068;29787,61320,0,0,3,0,3
85611,200,20748,27410;27859;29723;30760,61320,0,1,3,0,4
85612,200,20749,26884;27081;29799;30053,61320,0,0,4,0,4
85613,200,20750,26716;27284,61320,0,0,2,0,2
85614,200,20751,27110;27367,61320,0,0,2,0,2
85615,200,20752,26815;27114;30223,61320,0,0,3,0,3
85616,200,20753,27033;27175;30754,61320,0,1,2,0,3
85617,200,20754,27137;27200;30500,61320,0,1,2,0,3
85618,200,20755,27585,61320,0,0,1,0,1
85619,200,20756,27306;27360;29809;30662,61320,0,1,3,0,4
85620,200,20757,27217;27338;30318,61320,0,0,3,0,3
85621,200,20758,27166;27263,61320,0,0,2,0,2
85622,200,20759,27279;27488;30674;31023,61320,0,2,2,0,4
85623,200,20760,27476;30764,61320,0,1,1,0,2
85624,200,20761,27239;27591,61320,0,0,2,0,2
85625,200,20762,27313;30663,61320,0,1,1,0,2
85626,200,20763,27106;27497;29817;30765,61320,0,1,3,0,4
85627,200,20764,27332;30326;30589,61320,0,1,2,0,3
85628,200,20765,27130;27397,61320,0,0,2,0,2
85629,200,20766,27201;27337;30412;30756,61320,0,1,3,0,4
85630,200,20768,27353;30666,61320,0,1,1,0,2
85631,200,20769,27253;27546;30518,61320,0,1,2,0,3
85632,200,20770,27362;27380;29810,61320,0,0,3,0,3
85633,200,20771,27354;27365,61320,0,0,2,0,2
85634,200,20772,27371;30667,61320,0,1,1,0,2
85635,200,20773,27183;27373,61320,0,0,2,0,2
85636,200,20774,23307,61685,0,0,0,1,1
85637,200,20785,23935,61685,0,0,0,1,1
85638,200,20790,24626,61685,0,0,0,1,1
85639,200,20799,25460,61685,0,0,0,1,1
85640,200,20801,25620,61685,0,0,0,1,1
85641,200,20803,25710,61685,0,0,0,1,1
85642,200,20805,25735;25832,61685,0,0,0,2,2
85643,200,20807,25780;26033,61685,0,0,0,2,2
85644,200,20808,25873,61685,0,0,0,1,1
85645,200,20810,26902;30581,61685,0,1,1,0,2
85646,200,20812,26297;26452,61685,0,0,2,0,2
85647,200,20813,26457;26533,61685,0,0,2,0,2
85648,200,20814,26325;26648,61685,0,0,2,0,2
85649,200,20815,26259;26613,61685,0,0,2,0,2
85650,200,20817,27061,61685,0,0,1,0,1
85651,200,20818,26511;27022,61685,0,0,2,0,2
85652,200,20819,26292;26903,61685,0,0,2,0,2
85653,200,20821,26603;26768,61685,0,0,2,0,2
85654,200,20822,26749,61685,0,0,1,0,1
85655,200,20823,26276;26517,61685,0,0,2,0,2
85656,200,20824,26654;27155,61685,0,0,2,0,2
85657,200,20825,26668;26721,61685,0,0,2,0,2
85658,200,20826,26364;26786,61685,0,0,2,0,2
85659,200,20827,26758;26795,61685,0,0,2,0,2
85660,200,20829,27230;29907,61685,0,0,2,0,2
85661,200,20830,26520;26807;29010;29785,61685,0,0,4,0,4
85662,200,20831,27267;27595;31025;31106,61685,0,2,2,0,4
85663,200,20832,26821;26933,61685,0,0,2,0,2
85664,200,20833,26809;27001;30304,61685,0,0,3,0,3
85665,200,20834,27626;27968;29739,61685,0,0,3,0,3
85666,200,20835,26999;27441;30332;30507,61685,0,1,3,0,4
85667,200,20836,27366;27445,61685,0,0,2,0,2
85668,200,20837,27041;27051,61685,0,0,2,0,2
85669,200,20838,27044;27429;30075,61685,0,0,3,0,3
85670,200,20840,27122;27459;30334,61685,0,0,3,0,3
85671,200,20841,27176;27375;30236;30668,61685,0,1,3,0,4
85672,200,20842,27124;27178;29378;29649,61685,0,0,4,0,4
85673,200,20843,27452;27472;30597;30673,61685,0,2,2,0,4
85674,200,20844,26989;27287;29456,61685,0,0,3,0,3
85675,200,20845,27458;29917,61685,0,0,2,0,2
85676,200,20846,27293;27673;30936,61685,0,1,2,0,3
85677,200,20847,27720;27721;30690;31203,61685,0,2,2,0,4
85678,200,20848,27311;30588,61685,0,1,1,0,2
85679,200,20849,27080;27320;30144,61685,0,0,3,0,3
85680,200,20850,27241;27323;30071;30145;31644,61685,1,0,4,0,5
85681,200,20851,27189;27540;31024,61685,0,1,2,0,3
85682,200,20852,27650;27654;30171;30432,61685,0,0,4,0,4
85683,200,20853,27288;27347;29570;30665,61685,0,1,3,0,4
85684,200,20854,27314;27369;30411,61685,0,0,3,0,3
85685,200,20855,27129;27679;30608,61685,0,1,2,0,3
85686,200,20856,27414;27450;30150,61685,0,0,3,0,3
85687,200,20857,27087;27394;30416;30592;30757,61685,0,2,3,0,5
85688,200,20865,23991,62050,0,0,0,1,1
85689,200,20866,24014,62050,0,0,0,1,1
85690,200,20869,24463,62050,0,0,0,1,1
85691,200,20872,24256,62050,0,0,0,1,1
85692,200,20874,24101,62050,0,0,0,1,1
85693,200,20882,25447;25468,62050,0,0,0,2,2
85694,200,20884,24900;25651,62050,0,0,0,2,2
85695,200,20886,24972,62050,0,0,0,1,1
85696,200,20891,25045;25143,62050,0,0,0,2,2
85697,200,20896,25385;25584,62050,0,0,0,2,2
85698,200,20897,25508,62050,0,0,0,1,1
85699,200,20898,25597;25698,62050,0,0,0,2,2
85700,200,20900,25337;25517,62050,0,0,0,2,2
85701,200,20901,25934;26170,62050,0,0,1,1,2
85702,200,20902,25887;26362,62050,0,0,1,1,2
85703,200,20903,25793;25973,62050,0,0,0,2,2
85704,200,20904,25916;26301,62050,0,0,1,1,2
85705,200,20906,26500;26699,62050,0,0,2,0,2
85706,200,20907,26108;26213;29500,62050,0,0,3,0,3
85707,200,20912,26418;26888,62050,0,0,2,0,2
85708,200,20913,26547;27343,62050,0,0,2,0,2
85709,200,20914,26652;26914;28836;31443,62050,0,1,3,0,4
85710,200,20916,26976;27174;30063;30228,62050,0,0,4,0,4
85711,200,20917,26632;27027;29705;30048,62050,0,0,4,0,4
85712,200,20918,27246;27340,62050,0,0,2,0,2
85713,200,20919,26921;27062;29292,62050,0,0,3,0,3
85714,200,20920,26732;27218,62050,0,0,2,0,2
85715,200,20921,27465;30336;31199,62050,0,1,2,0,3
85716,200,20922,27037;27268,62050,0,0,2,0,2
85717,200,20923,26822;27054;30583,62050,0,1,2,0,3
85718,200,20924,26854;27063,62050,0,0,2,0,2
85719,200,20926,27197;27281;30586,62050,0,1,2,0,3
85720,200,20927,27396;27495;30329,62050,0,0,3,0,3
85721,200,20928,27572;30164;30426;30678,62050,0,1,3,0,4
85722,200,20929,27255;30068,62050,0,0,2,0,2
85723,200,20930,27173;27302;29978;30062,62050,0,0,4,0,4
85724,200,20931,27303;27796;30265,62050,0,0,3,0,3
85725,200,20932,27270;27589,62050,0,0,2,0,2
85726,200,20933,27386;27487;30512;30857,62050,0,2,2,0,4
85727,200,20934,27295;27696;30687,62050,0,1,2,0,3
85728,200,20935,27809;30088;30266;30784,62050,0,1,3,0,4
85729,200,20936,27251;27424;30670;30762,62050,0,2,2,0,4
85730,200,20937,27519;27830;29208,62050,0,0,3,0,3
85731,200,20940,27289;27484;29729;30156;30338,62050,0,0,5,0,5
85732,200,20941,27793;30944,62050,0,1,1,0,2
85733,200,20942,27478;30510,62050,0,1,1,0,2
85734,200,20943,27745;27795;29931;30439;30872,62050,0,1,4,0,5
85735,200,20944,27647;27805;30355;30783;31031,62050,0,2,3,0,5
85736,200,20945,27304;27538,62050,0,0,2,0,2
85737,200,20946,27545;27807;30538;31567,62050,1,1,2,0,4
85738,200,20947,27563;27649;30685,62050,0,1,2,0,3
85739,200,20949,23618;23738,62415,0,0,0,2,2
85740,200,20951,23874,62415,0,0,0,1,1
85741,200,20956,23997,62415,0,0,0,1,1
85742,200,20958,24285,62415,0,0,0,1,1
85743,200,20963,24738,62415,0,0,0,1,1
85744,200,20966,24974;25372,62415,0,0,0,2,2
85745,200,20970,24879;25273,62415,0,0,0,2,2
85746,200,20973,25676;25779,62415,0,0,0,2,2
85747,200,20976,25921;26628,62415,0,0,1,1,2
85748,200,20980,26159;26286,62415,0,0,2,0,2
85749,200,20981,26478;26841;29963;30040,62415,0,0,4,0,4
85750,200,20983,25826;26293,62415,0,0,1,1,2
85751,200,20986,26464;27034;29643;29795,62415,0,0,4,0,4
85752,200,20987,26543;26911,62415,0,0,2,0,2
85753,200,20988,26371;26662,62415,0,0,2,0,2
85754,200,20990,26835;26995,62415,0,0,2,0,2
85755,200,20991,26907;26924,62415,0,0,2,0,2
85756,200,20992,26580;27020,62415,0,0,2,0,2
85757,200,20993,26381;26898,62415,0,0,2,0,2
85758,200,20994,27121;27165;29453;29716;31197,62415,0,1,4,0,5
85759,200,20995,27152;27222;30065;30319,62415,0,0,4,0,4
85760,200,20997,27206;27416;29811,62415,0,0,3,0,3
85761,200,20998,27214;27238;30229,62415,0,0,3,0,3
85762,200,20999,27254;27372;30328,62415,0,0,3,0,3
85763,200,21000,27266;27444;30238,62415,0,0,3,0,3
85764,200,21001,27326;27408,62415,0,0,2,0,2
85765,200,21002,27513;27577;30248;30428;30679;30933,62415,0,2,4,0,6
85766,200,21003,27393;27434;30415,62415,0,0,3,0,3
85767,200,21004,27191;27400;30330;30593;30758,62415,0,2,3,0,5
85768,200,21005,27413;27515;30761,62415,0,1,2,0,3
85769,200,21006,27614;27810,62415,0,0,2,0,2
85770,200,21007,27573;30247;30427,62415,0,0,3,0,3
85771,200,21008,27828;30616,62415,0,1,1,0,2
85772,200,21009,27735;27893;30436;30534,62415,0,1,3,0,4
85773,200,21010,27480;30241,62415,0,0,2,0,2
85774,200,21011,27494;27657;30420;30514,62415,0,1,3,0,4
85775,200,21012,27388;27510;30422;30676,62415,0,1,3,0,4
85776,200,21013,26513;27226;30321,62415,0,0,3,0,3
85777,200,21014,27512;27639;30605;30935,62415,0,2,2,0,4
85778,200,21015,27162;27521;30339,62415,0,0,3,0,3
85779,200,21016,27534;30243;30515;30600;31380,62415,0,3,2,0,5
85780,200,21017,27536;27688;30528;30938;31202;31382,62415,0,4,2,0,6
85781,200,21018,27272;27551;29576;30519,62415,0,1,3,0,4
85782,200,21019,27714;30005;30435,62415,0,0,3,0,3
85783,200,21020,27319;27568;31481,62415,0,1,2,0,3
85784,200,21021,27623;30001;30253,62415,0,0,3,0,3
85785,200,21022,27440;27632;30254;30524,62415,0,1,3,0,4
85786,200,21023,27800;27922;30446,62415,0,0,3,0,3
85787,200,21024,27569;27646;30773,62415,0,1,2,0,3
85788,200,21027,23992,62780,0,0,0,1,1
85789,200,21032,24260;24678,62780,0,0,0,2,2
85790,200,21037,25068,62780,0,0,0,1,1
85791,200,21038,28511,62780,0,0,1,0,1
85792,200,21041,25193,62780,0,0,0,1,1
85793,200,21047,25309,62780,0,0,0,1,1
85794,200,21052,26289;26328;29953;31722,62780,1,0,3,0,4
85795,200,21055,26537,62780,0,0,1,0,1
85796,200,21056,26578;26671;30292,62780,0,0,3,0,3
85797,200,21057,26577;26736,62780,0,0,2,0,2
85798,200,21058,27153;30406,62780,0,0,2,0,2
85799,200,21059,26574;26782,62780,0,0,2,0,2
85800,200,21060,26808;27029,62780,0,0,2,0,2
85801,200,21061,27502,62780,0,0,1,0,1
85802,200,21063,27261;27432,62780,0,0,2,0,2
85803,200,21065,27025;27187;30315,62780,0,0,3,0,3
85804,200,21066,26962;27102;30135,62780,0,0,3,0,3
85805,200,21067,27012;27098;30404;30494;30659,62780,0,2,3,0,5
85806,200,21068,27225;27346,62780,0,0,2,0,2
85807,200,21069,27231;27317;30143;30324,62780,0,0,4,0,4
85808,200,21070,27205;27330;29202;31548;31623,62780,1,1,3,0,5
85809,200,21071,27290;27336;30141,62780,0,0,3,0,3
85810,200,21073,27341;27443;29297;30508;30595;30855,62780,0,3,3,0,6
85811,200,21074,27454;27600;30429,62780,0,0,3,0,3
85812,200,21075,27134;30312;31966,62780,1,0,2,0,3
85813,200,21076,27223;27379;30669,62780,0,1,2,0,3
85814,200,21077,27269;27604;30523,62780,0,1,2,0,3
85815,200,21079,27015;27411;30149,62780,0,0,3,0,3
85816,200,21080,27419;27560,62780,0,0,2,0,2
85817,200,21081,27586;29924;30167;30343;30603;30682;30770,62780,0,3,4,0,7
85818,200,21082,27460;27466;30335;30509,62780,0,1,3,0,4
85819,200,21084,27426;27490;29815;30242,62780,0,0,4,0,4
85820,200,21085,27705;27822;30530;31026;31108;31298;31383,62780,0,5,2,0,7
85821,200,21086,27504;27709,62780,0,0,2,0,2
85822,200,21087,27483;27556,62780,0,0,2,0,2
85823,200,21088,27580;30166;30861,62780,0,1,2,0,3
85824,200,21089,27186;27582;30249;30769,62780,0,1,3,0,4
85825,200,21090,27606;27695;30174,62780,0,0,3,0,3
85826,200,21091,27768;30779,62780,0,1,1,0,2
85827,200,21093,27653;27866,62780,0,0,2,0,2
85828,200,21094,27890;30619;31036,62780,0,2,1,0,3
85829,200,21095,27690;27699;30529;30688,62780,0,2,2,0,4
85830,200,21096,27740;28005;30550,62780,0,1,2,0,3
85831,200,21097,27486;27722;30175;30868;31724,62780,1,1,3,0,5
85832,200,21098,27564;27723;30609;31204,62780,0,2,2,0,4
85833,200,21099,27733;27838;31208,62780,0,1,2,0,3
85834,200,21101,23451,63145,0,0,0,1,1
85835,200,21106,23817,63145,0,0,0,1,1
85836,200,21109,23674,63145,0,0,0,1,1
85837,200,21113,24113,63145,0,0,0,1,1
85838,200,21118,24793;24902,63145,0,0,0,2,2
85839,200,21122,25387;25699,63145,0,0,0,2,2
85840,200,21127,25785;26204,63145,0,0,1,1,2
85841,200,21136,26532;26535,63145,0,0,2,0,2
85842,200,21138,26685;26872,63145,0,0,2,0,2
85843,200,21139,26470;26770,63145,0,0,2,0,2
85844,200,21141,27199;27275;29808,63145,0,0,3,0,3
85845,200,21142,26626;26814;30299,63145,0,0,3,0,3
85846,200,21143,27036;27220,63145,0,0,2,0,2
85847,200,21145,27355;29988;30147,63145,0,0,3,0,3
85848,200,21146,26480;27048;29892;30491,63145,0,1,3,0,4
85849,200,21147,26637;27032;30852,63145,0,1,2,0,3
85850,200,21148,26745;27067,63145,0,0,2,0,2
85851,200,21150,27014;27596;29389;30522;30862,63145,0,2,3,0,5
85852,200,21151,27775;27811;31114,63145,0,1,2,0,3
85853,200,21152,27143;29803,63145,0,0,2,0,2
85854,200,21153,26846;27169;31198,63145,0,1,2,0,3
85855,200,21154,27195;27415;30594,63145,0,1,2,0,3
85856,200,21155,27198;27448;30596;31295,63145,0,2,2,0,4
85857,200,21157,27151;27236;29806;30322;30503,63145,0,1,4,0,5
85858,200,21158,27557;29735;30425;30768;30859,63145,0,2,3,0,5
85859,200,21159,27333;27621,63145,0,0,2,0,2
85860,200,21161,27727;27767;30693;30943,63145,0,2,2,0,4
85861,200,21162,27208;27392;29127;30591,63145,0,1,3,0,4
85862,200,21163,27395;27620;30256;30527;31200,63145,0,2,3,0,5
85863,200,21164,27611;30430;30604,63145,0,1,2,0,3
85864,200,21165,27496;30929,63145,0,1,1,0,2
85865,200,21166,27391;27652;30172,63145,0,0,3,0,3
85866,200,21167,27285;27470,63145,0,0,2,0,2
85867,200,21168,27506;27917;30704,63145,0,1,2,0,3
85868,200,21169,27531;27932;30794;30953;31302,63145,0,3,2,0,5
85869,200,21170,27567;27748;30611;30692;31482,63145,0,3,2,0,5
85870,200,21171,27541;27579;30165;30521,63145,0,1,3,0,4
85871,200,21172,27592;27940;29938,63145,0,0,3,0,3
85872,200,21173,27594;27910;30949,63145,0,1,2,0,3
85873,200,21174,27610;28098;30369,63145,0,0,3,0,3
85874,200,21175,27612;27909;30621;30701,63145,0,2,2,0,4
85875,200,21176,27492;30158,63145,0,0,2,0,2
85876,200,21177,27010;27648;30864;31297,63145,0,2,2,0,4
85877,200,21178,27439;27661;30774,63145,0,1,2,0,3
85878,200,21179,27662,63145,0,0,1,0,1
85879,200,21180,27665;27790;30352;31030,63145,0,1,3,0,4
85880,200,21181,27771;27942;30878;30955,63145,0,2,2,0,4
85881,200,21182,27792;30009,63145,0,0,2,0,2
85882,200,21183,27701;27985;30184;30547;30711,63145,0,2,3,0,5
85883,200,21184,27607;27777;30351;30780;31029,63145,0,2,3,0,5
85884,200,21185,28013;28031;31045;31807,63145,1,1,2,0,4
85885,200,21186,27783;27945;30014;31041,63145,0,1,3,0,4
85886,200,21187,27801;27941;30448;30795,63145,0,1,3,0,4
85887,200,21189,23854,63510,0,0,0,1,1
85888,200,21191,24195,63510,0,0,0,1,1
85889,200,21193,24049;24419,63510,0,0,0,2,2
85890,200,21196,24327,63510,0,0,0,1,1
85891,200,21197,24125;24166,63510,0,0,0,2,2
85892,200,21202,24524,63510,0,0,0,1,1
85893,200,21205,24909;25223,63510,0,0,0,2,2
85894,200,21206,25663,63510,0,0,0,1,1
85895,200,21211,25495,63510,0,0,0,1,1
85896,200,21220,26389;26555,63510,0,0,2,0,2
85897,200,21221,25953;26218;29164,63510,0,0,2,1,3
85898,200,21222,26042;29760,63510,0,0,1,1,2
85899,200,21225,26324;26910;30402,63510,0,0,3,0,3
85900,200,21227,26558;26620;29348;30849;31193,63510,0,2,3,0,5
85901,200,21228,26378;26680,63510,0,0,2,0,2
85902,200,21230,26967;27368,63510,0,0,2,0,2
85903,200,21232,26974;27435,63510,0,0,2,0,2
85904,200,21233,27489;29730;30513,63510,0,1,2,0,3
85905,200,21234,26857;27278,63510,0,0,2,0,2
85906,200,21235,27243;27605;30169,63510,0,0,3,0,3
85907,200,21236,27548;30858;31646,63510,1,1,1,0,3
85908,200,21238,27193;27300,63510,0,0,2,0,2
85909,200,21239,27307;27989;30549;30628;30712,63510,0,3,2,0,5
85910,200,21241,27467;30154;30419,63510,0,0,3,0,3
85911,200,21242,27700;27731;30940,63510,0,1,2,0,3
85912,200,21243,27446;29991,63510,0,0,2,0,2
85913,200,21244,27463;27651;29742;30082,63510,0,0,4,0,4
85914,200,21245,27468;27637;30337,63510,0,0,3,0,3
85915,200,21246,27627;28083;29748;30885,63510,0,1,3,0,4
85916,200,21247,27508;27628;29578;30431;30771,63510,0,1,4,0,5
85917,200,21249,27383;27537;30516;30601;30930,63510,0,3,2,0,5
85918,200,21250,27455;30928,63510,0,1,1,0,2
85919,200,21251,27561;30520,63510,0,1,1,0,2
85920,200,21252,27587;28099;30808,63510,0,1,2,0,3
85921,200,21253,27599;27962;30089;30708;31042;31304,63510,0,3,3,0,6
85922,200,21254,27550;27816;30356;30539;30697,63510,0,2,3,0,5
85923,200,21255,27774,63510,0,0,1,0,1
85924,200,21256,27412;27672,63510,0,0,2,0,2
85925,200,21257,27675;30606;30866,63510,0,2,1,0,3
85926,200,21258,27684;28129;29944;30187;30631;31895,63510,1,1,4,0,6
85927,200,21259,27687;30776,63510,0,1,1,0,2
85928,200,21260,27697;27706,63510,0,0,2,0,2
85929,200,21262,27328;27613;30081;31893,63510,1,0,3,0,4
85930,200,21263,27911;30445;30622;30791,63510,0,2,2,0,4
85931,200,21264,27761;28412,63510,0,0,2,0,2
85932,200,21265,27772;28038;30552;30801;31046;31308,63510,0,4,2,0,6
85933,200,21266,27784;28145;30971,63510,0,1,2,0,3
85934,200,21267,27802;28160;31129,63510,0,1,2,0,3
85935,200,21268,27348;27803;30010;30354;30696;30782,63510,0,2,4,0,6
85936,200,21269,27821;29933;30615,63510,0,1,2,0,3
85937,200,21270,27713;27833;30873,63510,0,1,2,0,3
85938,200,21271,27849;28306;30728;31228,63510,0,2,2,0,4
85939,200,21272,27861;27908,63510,0,0,2,0,2
85940,200,21273,27863;28103;30720;31571,63510,1,1,2,0,4
85941,200,21274,27565;27876;30699;31483,63510,0,2,2,0,4
85942,200,21275,27643;27877;30269,63510,0,0,3,0,3
85943,200,21276,27880;28158,63510,0,0,2,0,2
85944,200,21277,27813;27881;29583;30700;30790;31117,63510,0,3,3,0,6
85945,200,21278,27274;27737;29822;30261,63510,0,0,4,0,4
85946,200,21279,27554;27925;30272;30626;30952,63510,0,2,3,0,5
85947,200,21281,24181,63875,0,0,0,1,1
85948,200,21282,23812,63875,0,0,0,1,1
85949,200,21284,24136,63875,0,0,0,1,1
85950,200,21285,24268,63875,0,0,0,1,1
85951,200,21288,24518;24952,63875,0,0,0,2,2
85952,200,21289,24206,63875,0,0,0,1,1
85953,200,21291,24578,63875,0,0,0,1,1
85954,200,21296,24706;24798,63875,0,0,0,2,2
85955,200,21302,25100,63875,0,0,0,1,1
85956,200,21309,25977;26230;29409,63875,0,0,2,1,3
85957,200,21314,26221;26445,63875,0,0,2,0,2
85958,200,21318,26531,63875,0,0,1,0,1
85959,200,21321,26425;26682;29777,63875,0,0,3,0,3
85960,200,21322,27071;27099;29801;30495,63875,0,1,3,0,4
85961,200,21324,26419;27090,63875,0,0,2,0,2
85962,200,21326,27204;27257,63875,0,0,2,0,2
85963,200,21328,27292;27297;30142;30323;30410;30504,63875,0,1,5,0,6
85964,200,21330,27339;27635,63875,0,0,2,0,2
85965,200,21331,27345;27608,63875,0,0,2,0,2
85966,200,21332,27105;27358;29460,63875,0,0,3,0,3
85967,200,21334,27622;28117,63875,0,0,2,0,2
85968,200,21335,27456;27584;30250;30602;30681,63875,0,2,3,0,5
85969,200,21336,27378;27420;30148;30237;30505;30590,63875,0,2,4,0,6
85970,200,21337,27433;27698,63875,0,0,2,0,2
85971,200,21339,27827;27958;30707;30879;30957,63875,0,3,2,0,5
85972,200,21340,27509;27570;30677,63875,0,1,2,0,3
85973,200,21341,27826;27971;31387,63875,0,1,2,0,3
85974,200,21342,28259;30282;30380;30725,63875,0,1,3,0,4
85975,200,21343,27619;30344;30684,63875,0,1,2,0,3
85976,200,21344,27056;27574;30860,63875,0,1,2,0,3
85977,200,21345,27634;27961;30363,63875,0,0,3,0,3
85978,200,21346,27924;31386,63875,0,1,1,0,2
85979,200,21347,27712;27787;30263;31113,63875,0,1,3,0,4
85980,200,21348,27671;28021;30366;31123,63875,0,1,3,0,4
85981,200,21349,27664;27711;30434,63875,0,0,3,0,3
85982,200,21350,27744;27799,63875,0,0,2,0,2
85983,200,21351,27524;27755;31110,63875,0,1,2,0,3
85984,200,21352,27387;28064;30453;31485,63875,0,1,3,0,4
85985,200,21353,27715;27773,63875,0,0,2,0,2
85986,200,21354,27841;27905;31119,63875,0,1,2,0,3
85987,200,21355,27764;27944,63875,0,0,2,0,2
85988,200,21356,27836;27862;31568,63875,1,0,2,0,3
85989,200,21357,27887,63875,0,0,1,0,1
85990,200,21358,27885;27972;30450;30881,63875,0,1,3,0,4
85991,200,21360,27726;27916;30183;30703;31964,63875,1,1,3,0,5
85992,200,21361,28119;30887,63875,0,1,1,0,2
85993,200,21362,27808;27969;30880,63875,0,1,2,0,3
85994,200,21363,27575;27979,63875,0,0,2,0,2
85995,200,21364,27883;28018;30713;30961,63875,0,2,2,0,4
85996,200,21365,28106;28273;30467;30979;31225,63875,0,2,3,0,5
85997,200,21366,27782;27936;30705;30877;31210,63875,0,3,2,0,5
85998,200,21368,24121,64240,0,0,0,1,1
85999,200,21371,24303,64240,0,0,0,1,1
86000,200,21377,24095,64240,0,0,0,1,1
86001,200,21378,24730,64240,0,0,0,1,1
86002,200,21381,25004,64240,0,0,0,1,1
86003,200,21388,25118,64240,0,0,0,1,1
86004,200,21391,25448;25471,64240,0,0,0,2,2
86005,200,21394,25545,64240,0,0,0,1,1
86006,200,21396,25704,64240,0,0,0,1,1
86007,200,21403,26217,64240,0,0,1,0,1
86008,200,21408,26455;26783;29696,64240,0,0,3,0,3
86009,200,21411,26379;26709,64240,0,0,2,0,2
86010,200,21414,26960;27132;30311,64240,0,0,3,0,3
86011,200,21415,26865;26870;30119,64240,0,0,3,0,3
86012,200,21416,27028;27370;29989;30414;30927,64240,0,1,4,0,5
86013,200,21418,27133;29973;30057,64240,0,0,3,0,3
86014,200,21419,26540;27030;30490;30851,64240,0,2,2,0,4
86015,200,21422,27237;27363;30327;30413,64240,0,0,4,0,4
86016,200,21423,27271;29199;30232;31698,64240,1,0,3,0,4
86017,200,21425,27418;27427;30417,64240,0,0,3,0,3
86018,200,21426,27518;27730;30259;30533;30869,64240,0,2,3,0,5
86019,200,21427,27072;27544;30517,64240,0,1,2,0,3
86020,200,21428,27308;27555;30424,64240,0,0,3,0,3
86021,200,21429,27315;27666;29579;31792,64240,1,0,3,0,4
86022,200,21430,27640;27781;31112,64240,0,1,2,0,3
86023,200,21431,27532;27837;30786,64240,0,1,2,0,3
86024,200,21432,27743;28090;30805,64240,0,1,2,0,3
86025,200,21433,27750;30612;30942;31205,64240,0,3,1,0,4
86026,200,21434,27931;28093;30806;31125,64240,0,2,2,0,4
86027,200,21435,27399;27763;30262,64240,0,0,3,0,3
86028,200,21436,27779;27950;30274;30449,64240,0,0,4,0,4
86029,200,21437,27461;27798;30353;30781,64240,0,1,3,0,4
86030,200,21438,27854;27855;30441;30542;30698,64240,0,2,3,0,5
86031,200,21439,27819;28220;30635,64240,0,1,2,0,3
86032,200,21440,28124;30888;31128,64240,0,2,1,0,3
86033,200,21441,27899;30444,64240,0,0,2,0,2
86034,200,21442,28051;28344;30900;31233,64240,0,2,2,0,4
86035,200,21443,27934;28060;30277;30629;30965;31218,64240,0,3,3,0,6
86036,200,21444,28155;31051;31316;31394,64240,0,3,1,0,4
86037,200,21445,27949;28274,64240,0,0,2,0,2
86038,200,21446,27758;27914;30623;30702;30792;30950;31038,64240,0,5,2,0,7
86039,200,21447,27952;28441,64240,0,0,2,0,2
86040,200,21448,28172;30890;31132,64240,0,2,1,0,3
86041,200,21449,27747;27984;30958;31044;31212,64240,0,3,2,0,5
86042,200,21450,27655;27995,64240,0,0,2,0,2
86043,200,21452,27525;28041;30716;31391,64240,0,2,2,0,4
86044,200,21454,28055;28319;31064;31328,64240,0,2,2,0,4
86045,200,21455,28042;28058;31727,64240,1,0,2,0,3
86046,200,21456,28310;30562;31063;31326;31402,64240,0,4,1,0,5
86047,200,21457,28072;28197,64240,0,0,2,0,2
86048,200,21458,28079;28347;31578,64240,1,0,2,0,3
86049,200,21459,27898;28092,64240,0,0,2,0,2
86050,200,21460,28100;28390;31143;31493;31811,64240,1,2,2,0,5
86051,200,21462,28118;30556,64240,0,1,1,0,2
86052,200,21463,27736;28125;30459;31050,64240,0,1,3,0,4
86053,200,21466,23965,64605,0,0,0,1,1
86054,200,21468,24211,64605,0,0,0,1,1
86055,200,21472,24221,64605,0,0,0,1,1
86056,200,21474,24885,64605,0,0,0,1,1
86057,200,21475,24882,64605,0,0,0,1,1
86058,200,21476,24648;24727,64605,0,0,0,2,2
86059,200,21478,24763,64605,0,0,0,1,1
86060,200,21484,25285;25702,64605,0,0,0,2,2
86061,200,21485,25563,64605,0,0,0,1,1
86062,200,21489,25864;26471,64605,0,0,1,1,2
86063,200,21497,26679,64605,0,0,1,0,1
86064,200,21498,27249;27356,64605,0,0,2,0,2
86065,200,21500,26650;27021,64605,0,0,2,0,2
86066,200,21501,27035;27184;30926,64605,0,1,2,0,3
86067,200,21503,27216;30240,64605,0,0,2,0,2
86068,200,21505,27324;27581;30680,64605,0,1,2,0,3
86069,200,21506,27107;27625;30345,64605,0,0,3,0,3
86070,200,21507,27351;27618;30251;31381,64605,0,1,3,0,4
86071,200,21508,27228;27539;30931,64605,0,1,2,0,3
86072,200,21509,27516;27900;30360;31037;31301,64605,0,2,3,0,5
86073,200,21510,28020;28050;30964;31217;31570,64605,1,2,2,0,5
86074,200,21511,27530;27578,64605,0,0,2,0,2
86075,200,21512,27609;27933;30627;30876;30954;31569;31726,64605,2,3,2,0,7
86076,200,21513,27641;27703;30349;30778,64605,0,1,3,0,4
86077,200,21514,27751;28123;31311,64605,0,1,2,0,3
86078,200,21515,27453;27742;30350;30437;31028,64605,0,1,4,0,5
86079,200,21516,28161;28252;30560;30637;30897;31058;31400,64605,0,5,2,0,7
86080,200,21517,27692;28130;30632;30811;30969,64605,0,3,2,0,5
86081,200,21518,27794;27903;30948,64605,0,1,2,0,3
86082,200,21519,27667;27823;31032;31115,64605,0,2,2,0,4
86083,200,21520,27844;28214;30463;30893;31729,64605,1,1,3,0,5
86084,200,21521,27857;30358;30442;30787;31034,64605,0,2,3,0,5
86085,200,21522,28104;28284;30381;30561;31325,64605,0,2,3,0,5
86086,200,21523,27766;28275;30817;30898,64605,0,2,2,0,4
86087,200,21524,27906;28135;30460,64605,0,0,3,0,3
86088,200,21525,28054;28115;30554,64605,0,1,2,0,3
86089,200,21526,27422;27964;30364;30796,64605,0,1,3,0,4
86090,200,21528,27939;28358;31234,64605,0,1,2,0,3
86091,200,21529,27469;28022;30714;31215,64605,0,2,2,0,4
86092,200,21530,28047;28268;30285;31139,64605,0,1,3,0,4
86093,200,21531,27889;28056;30092;30186;30452;31048,64605,0,1,5,0,6
86094,200,21532,28062;28146;29941;30717,64605,0,1,3,0,4
86095,200,21533,28065;28076;30454;31124,64605,0,1,3,0,4
86096,200,21534,28081;28095;30456;31392;31487,64605,0,2,3,0,5
86097,200,21535,28032;28133;30721,64605,0,1,2,0,3
86098,200,21536,28138;28471;30734;31500,64605,0,2,2,0,4
86099,200,21537,28141;28299,64605,0,0,2,0,2
86100,200,21538,28200;31055,64605,0,1,1,0,2
86101,200,21539,28170;28207;31395,64605,0,1,2,0,3
86102,200,21540,28080;28175;30804,64605,0,1,2,0,3
86103,200,21541,28271;28543,64605,0,0,2,0,2
86104,200,21542,28199;28372,64605,0,0,2,0,2
86105,200,21543,28506;28544;31745;31818,64605,2,0,2,0,4
86106,200,21544,28431;30195,64605,0,0,2,0,2
86107,200,21545,28007;28329;30639;31230,64605,0,2,2,0,4
86108,200,21546,28174;28227;30896,64605,0,1,2,0,3
86109,200,21547,24448,64970,0,0,0,1,1
86110,200,21548,24465,64970,0,0,0,1,1
86111,200,21549,24072,64970,0,0,0,1,1
86112,200,21550,24617,64970,0,0,0,1,1
86113,200,21551,24443,64970,0,0,0,1,1
86114,200,21555,24903,64970,0,0,0,1,1
86115,200,21558,24987,64970,0,0,0,1,1
86116,200,21559,25340,64970,0,0,0,1,1
86117,200,21560,25445;25496,64970,0,0,0,2,2
86118,200,21563,25690,64970,0,0,0,1,1
86119,200,21570,25844,64970,0,0,0,1,1
86120,200,21575,26852;30209;30401,64970,0,0,3,0,3
86121,200,21576,26915;27437;29573;30151;30418;30672;30763;31561,64970,0,3,5,0,8
86122,200,21577,27094,64970,0,0,1,0,1
86123,200,21578,26282;26627,64970,0,0,2,0,2
86124,200,21580,27259;27636;29926;30863;31201,64970,0,2,3,0,5
86125,200,21581,27597;27603;29818;30683;30934,64970,0,2,3,0,5
86126,200,21583,27364;27507,64970,0,0,2,0,2
86127,200,21584,27404;27756;30613,64970,0,1,2,0,3
86128,200,21585,27438;27479;29918;29995;30511,64970,0,1,4,0,5
86129,200,21586,27229;27451,64970,0,0,2,0,2
86130,200,21587,27629;27851;29935;30874;31959,64970,1,1,3,0,5
86131,200,21588,27503;28033;30715;31216,64970,0,2,2,0,4
86132,200,21589,27559;27865;30788,64970,0,1,2,0,3
86133,200,21590,27562;27724;29664;30531;30691,64970,0,2,3,0,5
86134,200,21592,27553;27668;30346;30686;30775;31107,64970,0,3,3,0,6
86135,200,21593,27660;28198;30376,64970,0,0,3,0,3
86136,200,21594,28006,64970,0,0,1,0,1
86137,200,21595,27499;28019;31647,64970,1,0,2,0,3
86138,200,21596,27689;27864,64970,0,0,2,0,2
86139,200,21597,27500;27789;30264;30536;30695;30871,64970,0,3,3,0,6
86140,200,21598,27602;27867;30543,64970,0,1,2,0,3
86141,200,21599,27868;30544;30789,64970,0,2,1,0,3
86142,200,21600,27769;27872,64970,0,0,2,0,2
86143,200,21601,27873;28184,64970,0,0,2,0,2
86144,200,21602,27938;28173;30722;31052,64970,0,2,2,0,4
86145,200,21603,27943;28485;30908;31076,64970,0,2,2,0,4
86146,200,21604,27951;28180;30373;30461,64970,0,0,4,0,4
86147,200,21605,27956;28534,64970,0,0,2,0,2
86148,200,21606,27970;28057;29940;31309,64970,0,1,3,0,4
86149,200,21607,27974;28110;30370;31220;31393;31728,64970,1,2,3,0,6
86150,200,21608,27998;28139;30094;30188;31649,64970,1,0,4,0,5
86151,200,21609,27717,64970,0,0,1,0,1
86152,200,21610,27856;28045;30618;30947;31299,64970,0,3,2,0,5
86153,200,21611,28540;28652;30645;31152,64970,0,2,2,0,4
86154,200,21612,28052;28416;31144,64970,0,1,2,0,3
86155,200,21613,27804;28053;30367;30451;30883;31047,64970,0,2,4,0,6
86156,200,21614,28068;28218;31489,64970,0,1,2,0,3
86157,200,21615,28097;30368;30967;31219;31488,64970,0,3,2,0,5
86158,200,21616,28105;28479,64970,0,0,2,0,2
86159,200,21618,28112,64970,0,0,1,0,1
86160,200,21619,28163;28221;30378;30895;31056,64970,0,2,3,0,5
86161,200,21620,27960;28238;30636;30978;31322,64970,0,3,2,0,5
86162,200,21621,28246;28518;30909,64970,0,1,2,0,3
86163,200,21622,28254;28423;30194;30289;30566,64970,0,1,4,0,5
86164,200,21623,28264;28337;30284;31323,64970,0,1,3,0,4
86165,200,21624,28142;31313,64970,0,1,1,0,2
86166,200,21625,28295;30190,64970,0,0,2,0,2
86167,200,21626,28311;28578,64970,0,0,2,0,2
86168,200,21628,24651,65335,0,0,0,1,1
86169,200,21629,24855,65335,0,0,0,1,1
86170,200,21634,24910,65335,0,0,0,1,1
86171,200,21636,24891,65335,0,0,0,1,1
86172,200,21637,25011,65335,0,0,0,1,1
86173,200,21639,25380,65335,0,0,0,1,1
86174,200,21642,25627;25767,65335,0,0,0,2,2
86175,200,21645,25868,65335,0,0,0,1,1
86176,200,21649,26135,65335,0,0,1,0,1
86177,200,21651,26305;26527;29173,65335,0,0,3,0,3
86178,200,21653,26624;26878,65335,0,0,2,0,2
86179,200,21656,26366;26616,65335,0,0,2,0,2
86180,200,21660,27164,65335,0,0,1,0,1
86181,200,21663,27045;27409;30759,65335,0,1,2,0,3
86182,200,21672,28363;30384;30640;31235;31330,65335,0,3,2,0,5
86183,200,21673,27309;27694;29927;30348;30777;31643,65335,1,1,4,0,6
86184,200,21674,27824;28217;30894;30976;31321,65335,0,3,2,0,5
86185,200,21675,27527;27834,65335,0,0,2,0,2
86186,200,21676,27846;27853;29666;31563,65335,0,1,3,0,4
86187,200,21678,27892;28084,65335,0,0,2,0,2
86188,200,21679,27566;27901,65335,0,0,2,0,2
86189,200,21680,27878;27915;30271;30951;31385,65335,0,2,3,0,5
86190,200,21681,28003;30798;30959;31306,65335,0,3,1,0,4
86191,200,21683,28297;30980,65335,0,1,1,0,2
86192,200,21684,28049;28280,65335,0,0,2,0,2
86193,200,21685,27850;27966;31043;31305,65335,0,2,2,0,4
86194,200,21686,28326;30984,65335,0,1,1,0,2
86195,200,21687,28230;30815;31057,65335,0,2,1,0,3
86196,200,21688,28371;28466;30473,65335,0,0,3,0,3
86197,200,21689,28464;31244;31499,65335,0,2,1,0,3
86198,200,21690,28334;30820;31655;31810,65335,2,1,1,0,4
86199,200,21691,28178;28524;30737;31079;31151;31410,65335,0,4,2,0,6
86200,200,21692,27860,65335,0,0,1,0,1
86201,200,21693,28153;28377;30824;31237;31403,65335,0,3,2,0,5
86202,200,21694,28239;30465;30816;31731,65335,1,1,2,0,4
86203,200,21695,28241;28301,65335,0,0,2,0,2
86204,200,21696,27919;28245;30379,65335,0,0,3,0,3
86205,200,21697,28251;28375;30987;31492,65335,0,2,2,0,4
86206,200,21698,28122;28257;31127,65335,0,1,2,0,3
86207,200,21699,28187;28258;30638;31138;31575,65335,1,2,2,0,5
86208,200,21700,28270;28279;31061;31226,65335,0,2,2,0,4
86209,200,21701,28151;28294;30726,65335,0,1,2,0,3
86210,200,21702,28082;28303;30021;31062;31809,65335,1,1,3,0,5
86211,200,21703,28341;28643,65335,0,0,2,0,2
86212,200,21704,28349;28616;31082,65335,0,1,2,0,3
86213,200,21705,28307;30287,65335,0,0,2,0,2
86214,200,21707,28365;28644;30741,65335,0,1,2,0,3
86215,200,21708,28367;28677;31594;31667,65335,2,0,2,0,4
86216,200,21709,28256;28595;30290;31417;31506,65335,0,2,3,0,5
86217,200,21710,28401;28679;31596,65335,1,0,2,0,3
86218,200,21711,28386;28626;31331,65335,0,1,2,0,3
86219,200,21712,28213;28393;31238;31494,65335,0,2,2,0,4
86220,200,21713,28395;28482;30907;31075;31583;31814,65335,2,2,2,0,6
86221,200,21714,28656;30834;31162;31254;31508,65335,0,4,1,0,5
86222,200,21716,24637,65700,0,0,0,1,1
86223,200,21719,24682,65700,0,0,0,1,1
86224,200,21720,24461,65700,0,0,0,1,1
86225,200,21722,24956,65700,0,0,0,1,1
86226,200,21723,24989,65700,0,0,0,1,1
86227,200,21725,25041,65700,0,0,0,1,1
86228,200,21726,24779,65700,0,0,0,1,1
86229,200,21728,25312,65700,0,0,0,1,1
86230,200,21730,25331,65700,0,0,0,1,1
86231,200,21734,25115,65700,0,0,0,1,1
86232,200,21738,25971,65700,0,0,0,1,1
86233,200,21739,26231;26287,65700,0,0,2,0,2
86234,200,21747,27417;31105,65700,0,1,1,0,2
86235,200,21748,27839;30268;30945;31384,65700,0,2,2,0,4
86236,200,21750,27778;30008,65700,0,0,2,0,2
86237,200,21751,27523;30423,65700,0,0,2,0,2
86238,200,21753,27601;28017,65700,0,0,2,0,2
86239,200,21754,27310;27644;30525;30772,65700,0,2,2,0,4
86240,200,21758,27894;30537,65700,0,1,1,0,2
86241,200,21759,27852;30180;30617;30875,65700,0,2,2,0,4
86242,200,21761,27988;27992,65700,0,0,2,0,2
86243,200,21762,28002;28015;30960;31307,65700,0,2,2,0,4
86244,200,21763,28457;28476;31406;31739,65700,1,1,2,0,4
86245,200,21764,28012;28192;30973,65700,0,1,2,0,3
86246,200,21765,27702;28044;30553;30882;30963,65700,0,3,2,0,5
86247,200,21766,28048;28458,65700,0,0,2,0,2
86248,200,21768,28206;28500;31742,65700,1,0,2,0,3
86249,200,21769,28240;28267;31398;31650;31732,65700,2,1,2,0,5
86250,200,21770,28433;31580,65700,1,0,1,0,2
86251,200,21772,28493,65700,0,0,1,0,1
86252,200,21773,28094;28292,65700,0,0,2,0,2
86253,200,21774,28309;28601;31157;31750;31820,65700,2,1,2,0,5
86254,200,21776,28380;28638,65700,0,0,2,0,2
86255,200,21777,27963;28388;30565,65700,0,1,2,0,3
86256,200,21778,28171;28405;31069,65700,0,1,2,0,3
86257,200,21779,27959;28411,65700,0,0,2,0,2
86258,200,21781,28289;28576;31155,65700,0,1,2,0,3
86259,200,21782,28440;28579;31241;31898,65700,1,1,2,0,4
86260,200,21783,27904;28445;30196;31072,65700,0,1,3,0,4
86261,200,21784,28450;28560;30996,65700,0,1,2,0,3
86262,200,21785,28451;28600;30911;31749;31819,65700,2,1,2,0,5
86263,200,21786,28435;28452;30731;30905;31146;31581;31738,65700,2,3,2,0,7
86264,200,21787,28721;28730;30573;30745;31003;31432,65700,0,4,2,0,6
86265,200,21788,28456;30643;31498,65700,0,2,1,0,3
86266,200,21789,28467;31245;31335;31582,65700,1,2,1,0,4
86267,200,21790,28498;28550;31504,65700,0,1,2,0,3
86268,200,21791,28474;28607;30479;31250,65700,0,1,3,0,4
86269,200,21792,24559,66065,0,0,0,1,1
86270,200,21794,24876,66065,0,0,0,1,1
86271,200,21795,25137;25533,66065,0,0,0,2,2
86272,200,21797,25248,66065,0,0,0,1,1
86273,200,21799,25429,66065,0,0,0,1,1
86274,200,21804,25642;25943,66065,0,0,0,2,2
86275,200,21809,26020;26142,66065,0,0,1,1,2
86276,200,21811,26182;26294,66065,0,0,2,0,2
86277,200,21813,25929;25995,66065,0,0,0,2,2
86278,200,21814,26510;26572,66065,0,0,2,0,2
86279,200,21818,26673,66065,0,0,1,0,1
86280,200,21820,26302;26458,66065,0,0,2,0,2
86281,200,21821,26817;27403,66065,0,0,2,0,2
86282,200,21825,27316,66065,0,0,1,0,1
86283,200,21826,26951;27299;30661,66065,0,1,2,0,3
86284,200,21828,26930;27168,66065,0,0,2,0,2
86285,200,21829,27831;29746;30540;31033,66065,0,2,2,0,4
86286,200,21831,27240,66065,0,0,1,0,1
86287,200,21833,27256;27357,66065,0,0,2,0,2
86288,200,21834,27814;30785,66065,0,1,1,0,2
86289,200,21835,27946,66065,0,0,1,0,1
86290,200,21836,27897;29826,66065,0,0,2,0,2
86291,200,21837,27074;27250,66065,0,0,2,0,2
86292,200,21838,26892;27449;29992;31296,66065,0,1,3,0,4
86293,200,21839,27543;27642;29921;30244,66065,0,0,4,0,4
86294,200,21840,27576;29469;30342;30932,66065,0,1,3,0,4
86295,200,21843,27953;28113;30810;30886,66065,0,2,2,0,4
86296,200,21844,27659;27670;30865,66065,0,1,2,0,3
86297,200,21845,27954,66065,0,0,1,0,1
86298,200,21847,28162;28410;30193;31812,66065,1,0,3,0,4
86299,200,21849,27757;27842;30178;30438;30870,66065,0,1,4,0,5
86300,200,21850,28036;30962;31390,66065,0,2,1,0,3
86301,200,21851,27923;31039,66065,0,1,1,0,2
86302,200,21852,27754;28316;31577,66065,1,0,2,0,3
86303,200,21854,28037;28182;30189;30281;30972;31053,66065,0,2,4,0,6
86304,200,21856,28492;28628;30474;30993;31149,66065,0,2,3,0,5
86305,200,21857,27896;28261;30283,66065,0,0,3,0,3
86306,200,21858,28278;28551;30468,66065,0,0,3,0,3
86307,200,21859,28091;30455;30719;31648,66065,1,1,2,0,4
86308,200,21860,28165;28247;30889;31130;31572,66065,1,2,2,0,5
86309,200,21862,28154;28320;30899;31141,66065,0,2,2,0,4
86310,200,21863,27955;28313;30982;31229;31327,66065,0,3,2,0,5
86311,200,21864,28188;28308;30374;31134;31396,66065,0,2,3,0,5
86312,200,21865,28131;28328;31654,66065,1,0,2,0,3
86313,200,21866,27993;28330;30985;31066;31231,66065,0,3,2,0,5
86314,200,21867,28338;28361;30986,66065,0,1,2,0,3
86315,200,21868,28286;30819,66065,0,1,1,0,2
86316,200,21869,28196;28369;31068;31236;31736,66065,1,2,2,0,5
86317,200,21870,28059;28399;30903;31333;31495,66065,0,3,2,0,5
86318,200,21872,28343;28448;31405,66065,0,1,2,0,3
86319,200,21873,28459,66065,0,0,1,0,1
86320,200,21874,28478;28827;31171,66065,0,1,2,0,3
86321,200,21876,28666;28788;30123;31428,66065,0,1,3,0,4
86322,200,21877,28515;28818;31352;31675,66065,1,1,2,0,4
86323,200,21878,28519;28779;31261;31605,66065,1,1,2,0,4
86324,200,21879,28575;30569;30830,66065,0,2,1,0,3
86325,200,21880,28580;28581;30648;31414,66065,0,2,2,0,4
86326,200,21883,24493,66430,0,0,0,1,1
86327,200,21885,24538,66430,0,0,0,1,1
86328,200,21887,24646,66430,0,0,0,1,1
86329,200,21890,24951,66430,0,0,0,1,1
86330,200,21891,24599,66430,0,0,0,1,1
86331,200,21896,25580,66430,0,0,0,1,1
86332,200,21900,25901;25909,66430,0,0,0,2,2
86333,200,21902,26040;26311,66430,0,0,1,1,2
86334,200,21903,25843,66430,0,0,0,1,1
86335,200,21906,26486;26762;29432;29869,66430,0,0,4,0,4
86336,200,21911,26236;26358,66430,0,0,2,0,2
86337,200,21913,27322;27832;31207,66430,0,1,2,0,3
86338,200,21914,27818;30614,66430,0,1,1,0,2
86339,200,21915,27407;27680;30257;30867;30937,66430,0,2,3,0,5
86340,200,21916,27535;27829;30267;30357,66430,0,0,4,0,4
86341,200,21918,27498;28016;30276;30800,66430,0,1,3,0,4
86342,200,21919,27526;27987;30548;30797;31213;31388,66430,0,4,2,0,6
86343,200,21923,27389;27682;30347,66430,0,0,3,0,3
86344,200,21925,28179;28226;30724,66430,0,1,2,0,3
86345,200,21926,27913;28008;30365;30551;30799;31389,66430,0,3,3,0,6
86346,200,21927,28010;28066;30278;31486,66430,0,1,3,0,4
86347,200,21929,27882;28340;31232,66430,0,1,2,0,3
86348,200,21930,27765;27907;30620,66430,0,1,2,0,3
86349,200,21932,28029;28283;31324,66430,0,1,2,0,3
86350,200,21934,28085;28087;30016,66430,0,0,3,0,3
86351,200,21935,28096;30457;30807;30966;31310,66430,0,3,2,0,5
86352,200,21936,28086;28150;30372;31968,66430,1,0,3,0,4
86353,200,21939,28089;28152;30558;31315,66430,0,2,2,0,4
86354,200,21940,28262;28567;30997,66430,0,1,2,0,3
86355,200,21941,28688;28862;30920;31269;31445;31610,66430,1,3,2,0,6
86356,200,21942,28109;28181;30462,66430,0,0,3,0,3
86357,200,21943,28211;28469;30826;30906,66430,0,2,2,0,4
86358,200,21944,28212;28263;31401,66430,0,1,2,0,3
86359,200,21945,28232;28585;31249;31588,66430,1,1,2,0,4
86360,200,21946,28149;28266;31060;31652,66430,1,1,2,0,4
86361,200,21947,28296;28481;31074;31246,66430,0,2,2,0,4
86362,200,21948,28336;28764;30840;31435,66430,0,2,2,0,4
86363,200,21949,28697;31087;31599,66430,1,1,1,0,3
86364,200,21950,28204;28397;31332,66430,0,1,2,0,3
86365,200,21951,28422;28538;30197;31338;31503,66430,0,2,3,0,5
86366,200,21953,28430;28444;31071;31242;31659,66430,1,2,2,0,5
86367,200,21954,28107;28454;31813,66430,1,0,2,0,3
86368,200,21955,28462;31243;31334;31740,66430,1,2,1,0,4
86369,200,21956,28486;28919;31526,66430,0,1,2,0,3
86370,200,21957,28323;28487;31077,66430,0,1,2,0,3
86371,200,21958,28489;28556;30477;30647;31080;31247,66430,0,3,3,0,6
86372,200,21959,28505;28659;30480,66430,0,0,3,0,3
86373,200,21960,28537;28738;30837;31259,66430,0,2,2,0,4
86374,200,21961,28512;31409;31815,66430,1,1,1,0,3
86375,200,21962,28342;28432;30730;30904;31145,66430,0,3,2,0,5
86376,200,21963,28488,66430,0,0,1,0,1
86377,200,21964,28553;28908;31271;31680,66430,1,1,2,0,4
86378,200,21965,28549;28716;31088;31431,66430,0,2,2,0,4
86379,200,21966,28577,66430,0,0,1,0,1
86380,200,21967,28587;28705;31510,66430,0,1,2,0,3
86381,200,21968,28589;31156;31341,66430,0,2,1,0,3
86382,200,21969,28772;31515,66430,0,1,1,0,2
86383,200,21970,28623;28885;31760,66430,1,0,2,0,3
86384,200,21971,28351;28640;30833;30914;31253;31344,66430,0,4,2,0,6
86385,200,21972,28651;28814;30653;31264,66430,0,2,2,0,4
86386,200,21973,28667;28713;30391;31825,66430,1,0,3,0,4
86387,200,21974,28668;29026,66430,0,0,2,0,2
86388,200,21975,28564;28672,66430,0,0,2,0,2
86389,200,21976,24496,66795,0,0,0,1,1
86390,200,21978,24901,66795,0,0,0,1,1
86391,200,21979,24731;25131,66795,0,0,0,2,2
86392,200,21980,25142,66795,0,0,0,1,1
86393,200,21981,24945,66795,0,0,0,1,1
86394,200,21983,25320,66795,0,0,0,1,1
86395,200,21984,25707,66795,0,0,0,1,1
86396,200,21985,25079,66795,0,0,0,1,1
86397,200,21991,26191,66795,0,0,1,0,1
86398,200,21997,26081;26157,66795,0,0,1,1,2
86399,200,22000,26766;27084;30493,66795,0,1,2,0,3
86400,200,22001,26769,66795,0,0,1,0,1
86401,200,22002,26539;26576,66795,0,0,2,0,2
86402,200,22008,27616;28025,66795,0,0,2,0,2
86403,200,22011,27588;27677;30607,66795,0,1,2,0,3
86404,200,22013,27752;28028,66795,0,0,2,0,2
86405,200,22014,27112;27140;30310,66795,0,0,3,0,3
86406,200,22015,28325;30563;30983,66795,0,2,1,0,3
86407,200,22017,27978;28102;31126,66795,0,1,2,0,3
86408,200,22018,27825;27994,66795,0,0,2,0,2
86409,200,22019,28078;30803,66795,0,1,1,0,2
86410,200,22020,28137;30557;30812,66795,0,2,1,0,3
86411,200,22021,28046;28312,66795,0,0,2,0,2
86412,200,22022,28126,66795,0,0,1,0,1
86413,200,22023,27920;28043;30362;30624,66795,0,1,3,0,4
86414,200,22024,28237;30977;31574;31730,66795,2,1,1,0,4
86415,200,22025,28088;28570;31412;31505,66795,0,2,2,0,4
86416,200,22026,27848;28243;30466;31399,66795,0,1,3,0,4
86417,200,22027,28136;28282;31653,66795,1,0,2,0,3
86418,200,22028,28376;28514;30388;31078;31662,66795,1,1,3,0,5
86419,200,22029,28322;30469;30729,66795,0,1,2,0,3
86420,200,22031,28491;28689;30392;31598;31669;31827,66795,3,0,3,0,6
86421,200,22032,28437;28558;30478;31248;31746,66795,1,1,3,0,5
86422,200,22033,28442;30472;30991;31899,66795,1,1,2,0,4
86423,200,22034,28495;30475;30567;30827;31407;31502,66795,0,4,2,0,6
86424,200,22035,28501;28856,66795,0,0,2,0,2
86425,200,22036,28545;28895;31270;31761;31916,66795,2,1,2,0,5
86426,200,22037,28554;28929;31613;31683;31840,66795,3,0,2,0,5
86427,200,22038,28676;28810;30652;31008;31520,66795,0,3,2,0,5
86428,200,22039,28014;28606;30831,66795,0,1,2,0,3
86429,200,22040,29002;29015,66795,0,0,2,0,2
86430,200,22041,28610;28634;31158;31664,66795,1,1,2,0,4
86431,200,22042,28888;28995,66795,0,0,2,0,2
86432,200,22043,28661;28798,66795,0,0,2,0,2
86433,200,22044,28682;28817;30574,66795,0,1,2,0,3
86434,200,22045,28670;28755,66795,0,0,2,0,2
86435,200,22046,28673;28872;31522,66795,0,1,2,0,3
86436,200,22047,28683;28947,66795,0,0,2,0,2
86437,200,22048,28622;28712;31165,66795,0,1,2,0,3
86438,200,22049,28717;28893;31095;31177;31612;31915,66795,2,2,2,0,6
86439,200,22050,28735;28743;30650;31004;31513,66795,0,3,2,0,5
86440,200,22051,28250;28753;30839;31090;31604;31672;31755,66795,3,2,2,0,7
86441,200,22052,28759;31006;31831,66795,1,1,1,0,3
86442,200,22053,28761;28831,66795,0,0,2,0,2
86443,200,22054,24610,67160,0,0,0,1,1
86444,200,22055,24389,67160,0,0,0,1,1
86445,200,22057,25033,67160,0,0,0,1,1
86446,200,22058,24641,67160,0,0,0,1,1
86447,200,22059,24852,67160,0,0,0,1,1
86448,200,22062,25449,67160,0,0,0,1,1
86449,200,22063,25191,67160,0,0,0,1,1
86450,200,22064,25716,67160,0,0,0,1,1
86451,200,22068,26059;26092,67160,0,0,0,2,2
86452,200,22069,25679,67160,0,0,0,1,1
86453,200,22081,26863,67160,0,0,1,0,1
86454,200,22082,26883;27091;29897;30222;30658,67160,0,1,4,0,5
86455,200,22083,26947;27159;30853,67160,0,1,2,0,3
86456,200,22085,27188;27473,67160,0,0,2,0,2
86457,200,22088,27464;27753,67160,0,0,2,0,2
86458,200,22089,27342;27361,67160,0,0,2,0,2
86459,200,22091,27656;27921;30012;30625;30793;31960,67160,1,2,3,0,6
86460,200,22092,27729;30532;30610,67160,0,2,1,0,3
86461,200,22094,27716;27982;31122,67160,0,1,2,0,3
86462,200,22095,27305;27719;30939,67160,0,1,2,0,3
86463,200,22096,27991;31214,67160,0,1,1,0,2
86464,200,22097,27788;28194;30975;31135;31319,67160,0,3,2,0,5
86465,200,22098,27847,67160,0,0,1,0,1
86466,200,22099,27975,67160,0,0,1,0,1
86467,200,22100,27973;28591;31415;31589,67160,1,1,2,0,4
86468,200,22102,28244;28650;30916;31086,67160,0,2,2,0,4
86469,200,22103,28223;28413;31070;31579,67160,1,1,2,0,4
86470,200,22104,28233;28318,67160,0,0,2,0,2
86471,200,22105,28253;28304;31059;31651,67160,1,1,2,0,4
86472,200,22107,28641;28663;30198;31427;31593;31906,67160,2,1,3,0,6
86473,200,22108,27875;28203;30634,67160,0,1,2,0,3
86474,200,22109,28366;31491,67160,0,1,1,0,2
86475,200,22110,28321;28483,67160,0,0,2,0,2
86476,200,22111,28327;28611;30571,67160,0,1,2,0,3
86477,200,22112,28333;28426;31240,67160,0,1,2,0,3
86478,200,22113,28359;28404;31067;31490,67160,0,2,2,0,4
86479,200,22114,28971,67160,0,0,1,0,1
86480,200,22115,28249;28425;30097,67160,0,0,3,0,3
86481,200,22116,28428,67160,0,0,1,0,1
86482,200,22117,28166;28465;30733;31073;31741,67160,1,2,2,0,5
86483,200,22118,28504;28898;30654;31525;31839,67160,1,2,2,0,5
86484,200,22119,29013;31098;31536,67160,0,2,1,0,3
86485,200,22120,28526;28822;31441;31758,67160,1,1,2,0,4
86486,200,22121,27835;28168;31131;31221,67160,0,2,2,0,4
86487,200,22122,28513;28573;31661,67160,1,0,2,0,3
86488,200,22123,28231;28597;31418,67160,0,1,2,0,3
86489,200,22124,28627;28732;30918;31433,67160,0,2,2,0,4
86490,200,22125,28332;28636;30740;31423;31665;31904,67160,2,2,2,0,6
86491,200,22126,28392;28691,67160,0,0,2,0,2
86492,200,22127,28994;31096;31360,67160,0,2,1,0,3
86493,200,22128,28715;31258,67160,0,1,1,0,2
86494,200,22129,28954;31684,67160,1,0,1,0,2
86495,200,22130,28740;28865;31175,67160,0,1,2,0,3
86496,200,22131,28741;28776;31516;31673;31834,67160,2,1,2,0,5
86497,200,22132,28765;31007,67160,0,1,1,0,2
86498,200,22133,28496;28790;31262,67160,0,1,2,0,3
86499,200,22134,28532;28803,67160,0,0,2,0,2
86500,200,22135,28839;29085;30655;31851,67160,1,1,2,0,4
86501,200,22136,25042,67525,0,0,0,1,1
86502,200,22137,25058,67525,0,0,0,1,1
86503,200,22138,25237,67525,0,0,0,1,1
86504,200,22139,24592,67525,0,0,0,1,1
86505,200,22140,25358,67525,0,0,0,1,1
86506,200,22145,25908,67525,0,0,0,1,1
86507,200,22153,26823,67525,0,0,1,0,1
86508,200,22155,27247;27598,67525,0,0,2,0,2
86509,200,22156,27291;27686,67525,0,0,2,0,2
86510,200,22158,27296,67525,0,0,1,0,1
86511,200,22159,27298,67525,0,0,1,0,1
86512,200,22160,27382;27501;30159;30675;30766,67525,0,2,3,0,5
86513,200,22161,27493,67525,0,0,1,0,1
86514,200,22162,27552;27739;30941;31109,67525,0,2,2,0,4
86515,200,22163,27423,67525,0,0,1,0,1
86516,200,22164,27475;27645,67525,0,0,2,0,2
86517,200,22165,27693;27884;31209,67525,0,1,2,0,3
86518,200,22166,28035,67525,0,0,1,0,1
86519,200,22167,27912;28101;30555,67525,0,1,2,0,3
86520,200,22168,27967;28073;30546;31121,67525,0,2,2,0,4
86521,200,22170,28216;30377;30814,67525,0,1,2,0,3
86522,200,22171,28134;28438,67525,0,0,2,0,2
86523,200,22173,28604;31342;31419;31663,67525,1,2,1,0,4
86524,200,22174,28368;30823;31735,67525,1,1,1,0,3
86525,200,22175,28186;28407;29667;31054;31133,67525,0,2,3,0,5
86526,200,22176,28381;28409;31239,67525,0,1,2,0,3
86527,200,22177,28477;28497;30994;31336;31408,67525,0,3,2,0,5
86528,200,22178,28148;28484;29947;30644;31501,67525,0,2,3,0,5
86529,200,22179,28510;28824;31010;31836,67525,1,1,2,0,4
86530,200,22180,28796,67525,0,0,1,0,1
86531,200,22181,28242;28324;30192;31065,67525,0,1,3,0,4
86532,200,22182,28260;28574;31413;31586,67525,1,1,2,0,4
86533,200,22183,28473;28619;31421,67525,0,1,2,0,3
86534,200,22184,28647;28669;30742;31666,67525,1,1,2,0,4
86535,200,22185,28648;28662;30915,67525,0,1,2,0,3
86536,200,22186,28675;29063;31184;31455,67525,0,2,2,0,4
86537,200,22187,28156;28678;30481;31595;31826,67525,2,0,3,0,5
86538,200,22188,28731;28749;31166;31671,67525,1,1,2,0,4
86539,200,22189,28394;28752;30101;30919;31434,67525,0,2,3,0,5
86540,200,22190,28763;30483;30651;31167,67525,0,2,2,0,4
86541,200,22191,28774;31260;31349;31833,67525,1,2,1,0,4
86542,200,22192,28782;29083,67525,0,0,2,0,2
86543,200,22193,28956;29186,67525,0,0,2,0,2
86544,200,22194,28812;30485;31912,67525,1,0,2,0,3
86545,200,22195,28748;29011;31014;31765,67525,1,1,2,0,4
86546,200,22196,28841;29112;31925,67525,1,0,2,0,3
86547,200,22197,28434;28846;31093;31608,67525,1,1,2,0,4
86548,200,22198,28870;29023;30394;31354,67525,0,1,3,0,4
86549,200,22199,28596;28875,67525,0,0,2,0,2
86550,200,22200,28645;28878;31837,67525,1,0,2,0,3
86551,200,22201,28844;28883;31759,67525,1,0,2,0,3
86552,200,22202,28608;28891;31524,67525,0,1,2,0,3
86553,200,22203,28892;29110;31368,67525,0,1,2,0,3
86554,200,22204,28897;29111;31178,67525,0,1,2,0,3
86555,200,22205,28902;28940,67525,0,0,2,0,2
86556,200,22206,28911;29136;31282;31855,67525,1,1,2,0,4
86557,200,22207,28913;29068;30845;31366,67525,0,2,2,0,4
86558,200,22208,29047;29185;30577;31858,67525,1,1,2,0,4
86559,200,22209,28906;28923;31179;31762,67525,1,1,2,0,4
86560,200,22210,28926;29176,67525,0,0,2,0,2
86561,200,22211,25151,67890,0,0,0,1,1
86562,200,22212,25874;25902,67890,0,0,0,2,2
86563,200,22213,25992,67890,0,0,0,1,1
86564,200,22223,26842;27172;30854,67890,0,1,2,0,3
86565,200,22225,26893;26913,67890,0,0,2,0,2
86566,200,22226,27265,67890,0,0,1,0,1
86567,200,22227,27381,67890,0,0,1,0,1
86568,200,22232,27895;28193;30974;31222;31318,67890,0,3,2,0,5
86569,200,22233,28116,67890,0,0,1,0,1
86570,200,22235,28167;28234,67890,0,0,2,0,2
86571,200,22236,28159;28183,67890,0,0,2,0,2
86572,200,22238,28314;28681;30743;31345,67890,0,2,2,0,4
86573,200,22239,28339;30470;30821,67890,0,1,2,0,3
86574,200,22240,27879;27929;31035;31484,67890,0,2,2,0,4
86575,200,22241,28384;28480;30641;30988;31404;31656,67890,1,3,2,0,6
86576,200,22242,28387;28781;31437,67890,0,1,2,0,3
86577,200,22243,28205;28523;30828;30995;31150,67890,0,3,2,0,5
86578,200,22244,28709;30649;31346;31511,67890,0,3,1,0,4
86579,200,22245,28398;28449;31660,67890,1,0,2,0,3
86580,200,22246,28157;28415;30559,67890,0,1,2,0,3
86581,200,22247,28527;28642;31160;31424,67890,0,2,2,0,4
86582,200,22249,28009,67890,0,0,1,0,1
86583,200,22250,28522;28658;31426;31905,67890,1,1,2,0,4
86584,200,22251,28348;28525;30476;31744;31816;31901,67890,3,0,3,0,6
86585,200,22252,28548;28734,67890,0,0,2,0,2
86586,200,22253,28472;28555;30735;31148;31900,67890,1,2,2,0,5
86587,200,22254,28559;28602;30912;31751,67890,1,1,2,0,4
86588,200,22255,28613;28710,67890,0,0,2,0,2
86589,200,22256,28605;28686;31001;31420,67890,0,2,2,0,4
86590,200,22257,28529;28618,67890,0,0,2,0,2
86591,200,22258,28718;29042;31181;31848;31922,67890,2,1,2,0,5
86592,200,22259,28746;29197;31018;31859,67890,1,1,2,0,4
86593,200,22260,28754;29207;31700,67890,1,0,2,0,3
86594,200,22261,28784;28853;31350,67890,0,1,2,0,3
86595,200,22262,28583;29123;31773,67890,1,0,2,0,3
86596,200,22263,28843;29195,67890,0,0,2,0,2
86597,200,22264,28694;28852;31678,67890,1,0,2,0,3
86598,200,22265,28859;28873;31353;31609,67890,1,1,2,0,4
86599,200,22266,29188;29281;31371,67890,0,1,2,0,3
86600,200,22267,28801;28876;31176;31355,67890,0,2,2,0,4
86601,200,22268,28756;28881,67890,0,0,2,0,2
86602,200,22269,28900;29204;31624,67890,1,0,2,0,3
86603,200,22270,28901;29148,67890,0,0,2,0,2
86604,200,22271,28816;28907;31607,67890,1,0,2,0,3
86605,200,22272,28797;28948;31263;31909,67890,1,1,2,0,4
86606,200,22273,28997;29232,67890,0,0,2,0,2
86607,200,22274,29000,67890,0,0,1,0,1
86608,200,22275,24973,68255,0,0,0,1,1
86609,200,22276,25202,68255,0,0,0,1,1
86610,200,22277,25405,68255,0,0,0,1,1
86611,200,22278,25354,68255,0,0,0,1,1
86612,200,22279,25378,68255,0,0,0,1,1
86613,200,22280,25510,68255,0,0,0,1,1
86614,200,22281,25436,68255,0,0,0,1,1
86615,200,22282,25644,68255,0,0,0,1,1
86616,200,22283,25713;26075,68255,0,0,0,2,2
86617,200,22285,25522,68255,0,0,0,1,1
86618,200,22286,26007,68255,0,0,0,1,1
86619,200,22287,25816,68255,0,0,0,1,1
86620,200,22294,26901,68255,0,0,1,0,1
86621,200,22301,27447,68255,0,0,1,0,1
86622,200,22306,27471,68255,0,0,1,0,1
86623,200,22311,27870,68255,0,0,1,0,1
86624,200,22313,27981;28646;31161;31425;31824,68255,1,2,2,0,5
86625,200,22314,28169;28516;31743,68255,1,0,2,0,3
86626,200,22317,28350;28427;31497,68255,0,1,2,0,3
86627,200,22318,28373,68255,0,0,1,0,1
86628,200,22319,28224,68255,0,0,1,0,1
86629,200,22320,28565;31340,68255,0,1,1,0,2
86630,200,22321,28617;31159;31752,68255,1,1,1,0,3
86631,200,22322,28562;28722;30482;30917;31347;31601;31829,68255,2,2,3,0,7
86632,200,22324,28629;30739;30832;31084;31592,68255,1,3,1,0,5
86633,200,22325,28360;28612;31251;31507,68255,0,2,2,0,4
86634,200,22326,28880;30487;31094;31679,68255,1,1,2,0,4
86635,200,22327,28649;28936;31527,68255,0,1,2,0,3
86636,200,22328,28708;28723;30572;31164;31600,68255,1,2,2,0,5
86637,200,22329,28287;28729;30744;30836;31348;31907,68255,1,3,2,0,6
86638,200,22331,28766;29030;31451;31845,68255,1,1,2,0,4
86639,200,22332,28864;29121;31696,68255,1,0,2,0,3
86640,200,22333,28800;29172;31856,68255,1,0,2,0,3
86641,200,22335,28693;28890;31611;31838,68255,2,0,2,0,4
86642,200,22336,28904;29075,68255,0,0,2,0,2
86643,200,22337,29159;29217,68255,0,0,2,0,2
86644,200,22338,28863;28921;30748;30842;31914,68255,1,2,2,0,5
86645,200,22339,28922;28965;31358;31763,68255,1,1,2,0,4
86646,200,22340,28867;28964;31012,68255,0,1,2,0,3
86647,200,22341,29090;29122;31185;31543;31854,68255,1,2,2,0,5
86648,200,22342,28986;29316;31467,68255,0,1,2,0,3
86649,200,22343,28807;28924;31681,68255,1,0,2,0,3
86650,200,22344,28996;29175,68255,0,0,2,0,2
86651,200,22345,29066;31768;31850,68255,2,0,1,0,3
86652,200,22346,28861;29031;31452;31537;31766;31846,68255,2,2,2,0,6
86653,200,22347,29038;29354;31631,68255,1,0,2,0,3
86654,200,22348,29049;29237;31463,68255,0,1,2,0,3
86655,200,22349,29157;29359;30752;31286,68255,0,2,2,0,4
86656,200,22350,29080;29166;31923,68255,1,0,2,0,3
86657,200,22351,29093;29298;31191;31465;31864;31936,68255,2,2,2,0,6
86658,200,22352,28946;29351,68255,0,0,2,0,2
86659,200,22353,29118,68255,0,0,1,0,1
86660,200,22354,29119;29345;31101,68255,0,1,2,0,3
86661,200,22355,28775;29184;31774,68255,1,0,2,0,3
86662,200,22356,28918;29129,68255,0,0,2,0,2
86663,200,22357,25097,68620,0,0,0,1,1
86664,200,22358,25125,68620,0,0,0,1,1
86665,200,22359,25433,68620,0,0,0,1,1
86666,200,22360,25234,68620,0,0,0,1,1
86667,200,22362,24925,68620,0,0,0,1,1
86668,200,22363,25308,68620,0,0,0,1,1
86669,200,22369,26260;26296,68620,0,0,2,0,2
86670,200,22371,26241,68620,0,0,1,0,1
86671,200,22372,26228;26396,68620,0,0,2,0,2
86672,200,22373,26415;26725,68620,0,0,2,0,2
86673,200,22377,26605,68620,0,0,1,0,1
86674,200,22378,26270,68620,0,0,1,0,1
86675,200,22379,26409,68620,0,0,1,0,1
86676,200,22380,27123;27457;29916;30239;30856,68620,0,1,4,0,5
86677,200,22386,27111;27334,68620,0,0,2,0,2
86678,200,22387,27436,68620,0,0,1,0,1
86679,200,22399,28302;30382;30981;31140;31227,68620,0,3,2,0,5
86680,200,22400,28067;28209;31223;31573,68620,1,1,2,0,4
86681,200,22402,28144;28637,68620,0,0,2,0,2
86682,200,22403,28265;28389;30288;31142,68620,0,1,3,0,4
86683,200,22405,28443;28566;31748,68620,1,0,2,0,3
86684,200,22407,28530;28633;31343,68620,0,1,2,0,3
86685,200,22408,29114;29180;31547;31857,68620,1,1,2,0,4
86686,200,22409,28419;28533;30568,68620,0,1,2,0,3
86687,200,22410,28164;28542;31153;31584,68620,1,1,2,0,4
86688,200,22411,28190;28208;29751;30723;31317;31397,68620,0,3,3,0,6
86689,200,22412,28569,68620,0,0,1,0,1
86690,200,22413,28660;29134,68620,0,0,2,0,2
86691,200,22414,28502;28624;30913;31822,68620,1,1,2,0,4
86692,200,22415,28684;28701;31257;31754,68620,1,1,2,0,4
86693,200,22416,28703,68620,0,0,1,0,1
86694,200,22417,29014;31015,68620,0,1,1,0,2
86695,200,22418,28794;31351;31519,68620,0,2,1,0,3
86696,200,22419,28417;28757;31756,68620,1,0,2,0,3
86697,200,22420,28609;28805,68620,0,0,2,0,2
86698,200,22421,28802;28849,68620,0,0,2,0,2
86699,200,22422,28639;28887;31523,68620,0,1,2,0,3
86700,200,22423,28910;28984;30750,68620,0,1,2,0,3
86701,200,22424,28914;31272;31357,68620,0,2,1,0,3
86702,200,22425,28951;29371;31287,68620,0,1,2,0,3
86703,200,22426,28739;28962;31685,68620,1,0,2,0,3
86704,200,22427,28942;28970;30921;31614;31841,68620,2,1,2,0,5
86705,200,22428,28992;29193,68620,0,0,2,0,2
86706,200,22429,28925;29007;31359;31682,68620,1,1,2,0,4
86707,200,22430,29005;29009,68620,0,0,2,0,2
86708,200,22432,29018,68620,0,0,1,0,1
86709,200,22433,29024;29336;31628,68620,1,0,2,0,3
86710,200,22435,29034;29036;31453,68620,0,1,2,0,3
86711,200,22436,28909;29084,68620,0,0,2,0,2
86712,200,22437,28931;29089;31280;31693,68620,1,1,2,0,4
86713,200,22438,29115;29120;31016,68620,0,1,2,0,3
86714,200,22439,25529,68985,0,0,0,1,1
86715,200,22441,25590,68985,0,0,0,1,1
86716,200,22442,25149,68985,0,0,0,1,1
86717,200,22443,25847,68985,0,0,0,1,1
86718,200,22444,25754,68985,0,0,0,1,1
86719,200,22445,25857,68985,0,0,0,1,1
86720,200,22446,25477;25799,68985,0,0,0,2,2
86721,200,22453,26380,68985,0,0,1,0,1
86722,200,22454,26340,68985,0,0,1,0,1
86723,200,22455,26640,68985,0,0,1,0,1
86724,200,22461,27210,68985,0,0,1,0,1
86725,200,22462,27069,68985,0,0,1,0,1
86726,200,22463,27691,68985,0,0,1,0,1
86727,200,22464,27707;28143;31314,68985,0,1,2,0,3
86728,200,22465,27786;28352;30471;30564;30901,68985,0,2,3,0,5
86729,200,22466,27806;31206,68985,0,1,1,0,2
86730,200,22467,27485,68985,0,0,1,0,1
86731,200,22468,28298;30727;31576,68985,1,1,1,0,3
86732,200,22469,27976;28027;30710,68985,0,1,2,0,3
86733,200,22470,28034;28070;30718;30802;30884,68985,0,3,2,0,5
86734,200,22473,28201;28219;30019;30892;31136,68985,0,2,3,0,5
86735,200,22475,28355;28557,68985,0,0,2,0,2
86736,200,22476,28364;31734,68985,1,0,1,0,2
86737,200,22477,28202;30633;31320,68985,0,2,1,0,3
86738,200,22480,28460;28793;31908,68985,1,0,2,0,3
86739,200,22481,28468;28593;30570;31081;31416,68985,0,3,2,0,5
86740,200,22482,28539;31339;31817,68985,1,1,1,0,3
86741,200,22483,28848;30486;31011;31174;31444;31521;31913,68985,1,4,2,0,7
86742,200,22484,28630;30291;31085,68985,0,1,2,0,3
86743,200,22485,28625;28671;31083;31422;31823,68985,1,2,2,0,5
86744,200,22486,28702,68985,0,0,1,0,1
86745,200,22487,29065;29165;31099,68985,0,1,2,0,3
86746,200,22489,28819;29095,68985,0,0,2,0,2
86747,200,22490,28871;29200,68985,0,0,2,0,2
86748,200,22491,28905;28991,68985,0,0,2,0,2
86749,200,22492,28835;28938;31528,68985,0,1,2,0,3
86750,200,22493,28949;29564,68985,0,0,2,0,2
86751,200,22494,29341,68985,0,0,1,0,1
86752,200,22495,28961;29306;31707,68985,1,0,2,0,3
86753,200,22496,28806;28978;31764,68985,1,0,2,0,3
86754,200,22497,28999;29012;31277,68985,0,1,2,0,3
86755,200,22498,29017;29374,68985,0,0,2,0,2
86756,200,22499,28860;29020;31920,68985,1,0,2,0,3
86757,200,22501,29078;29448,68985,0,0,2,0,2
86758,200,22502,29028;30576;31921,68985,1,1,1,0,3
86759,200,22503,29097;29461;31195;31291,68985,0,2,2,0,4
86760,200,22504,29104;29347,68985,0,0,2,0,2
86761,200,22505,28854;29116;31771;31926,68985,2,0,2,0,4
86762,200,22506,29117;31281;31542;31695;31772;31853,68985,3,2,1,0,6
86763,200,22507,28879;29125;31017,68985,0,1,2,0,3
86764,200,22509,29130;29516,68985,0,0,2,0,2
86765,200,22510,28837;29132;31929,68985,1,0,2,0,3
86766,200,22511,29135;29475,68985,0,0,2,0,2
86767,200,22512,28912;29091,68985,0,0,2,0,2
86768,200,22513,29163;29501,68985,0,0,2,0,2
86769,200,22514,28941;29213;31188;31776,68985,1,1,2,0,4
86770,200,22515,29146;29224;31186;31544,68985,0,2,2,0,4
86771,200,22516,29242;29244,68985,0,0,2,0,2
86772,200,22517,29225;29331;31860,68985,1,0,2,0,3
86773,200,22518,29263;29490;31376;31472,68985,0,2,2,0,4
86774,200,22519,29265;29438,68985,0,0,2,0,2
86775,200,22520,29238;31372;31702;31932,68985,2,1,1,0,4
86776,200,22521,29282;29526,68985,0,0,2,0,2
86777,200,22522,29167;29295;31552,68985,0,1,2,0,3
86778,200,22523,25557,69350,0,0,0,1,1
86779,200,22524,25325,69350,0,0,0,1,1
86780,200,22525,25588;26194,69350,0,0,1,1,2
86781,200,22526,25674,69350,0,0,0,1,1
86782,200,22531,26119,69350,0,0,1,0,1
86783,200,22533,26569,69350,0,0,1,0,1
86784,200,22537,26829,69350,0,0,1,0,1
86785,200,22540,26557,69350,0,0,1,0,1
86786,200,22543,26860,69350,0,0,1,0,1
86787,200,22548,27276,69350,0,0,1,0,1
86788,200,22550,27117,69350,0,0,1,0,1
86789,200,22551,27182;27402,69350,0,0,2,0,2
86790,200,22556,28229,69350,0,0,1,0,1
86791,200,22557,28420;28561;30910;31411,69350,0,2,2,0,4
86792,200,22558,28592;30999;31590;31903,69350,2,1,1,0,4
86793,200,22559,28621;28674;31255,69350,0,1,2,0,3
86794,200,22560,28724;29006;30844,69350,0,1,2,0,3
86795,200,22561,28858,69350,0,0,1,0,1
86796,200,22562,28767;28777;31168;31832,69350,1,1,2,0,4
86797,200,22563,29442;31944,69350,1,0,1,0,2
86798,200,22564,28700;28851;31677,69350,1,0,2,0,3
86799,200,22565,29161;29381,69350,0,0,2,0,2
86800,200,22566,28927;29155;31187;31545,69350,0,2,2,0,4
86801,200,22567,28943;29131;31928,69350,1,0,2,0,3
86802,200,22568,28727;31670,69350,1,0,1,0,2
86803,200,22569,28840;28990;31843,69350,1,0,2,0,3
86804,200,22570,29162;29288;31705,69350,1,0,2,0,3
86805,200,22571,29035;29327;31940,69350,1,0,2,0,3
86806,200,22572,29046;29048;31692,69350,1,0,2,0,3
86807,200,22573,28932;29058;31363,69350,0,1,2,0,3
86808,200,22574,28808;29098;30847;31457;31694;31924,69350,2,2,2,0,6
86809,200,22575,29105;31852,69350,1,0,1,0,2
86810,200,22577,29142;29367,69350,0,0,2,0,2
86811,200,22578,28778;29183;31370;31459,69350,0,2,2,0,4
86812,200,22579,29214;29250,69350,0,0,2,0,2
86813,200,22580,29284;29449;31020;31284;31551;31863,69350,1,3,2,0,6
86814,200,22581,29286;29549,69350,0,0,2,0,2
86815,200,22582,29338;29350,69350,0,0,2,0,2
86816,200,22583,29340;29352,69350,0,0,2,0,2
86817,200,22584,29355;29386,69350,0,0,2,0,2
86818,200,22585,28950;29362;31708,69350,1,0,2,0,3
86819,200,22586,25367,69715,0,0,0,1,1
86820,200,22587,25837,69715,0,0,0,1,1
86821,200,22588,26026,69715,0,0,0,1,1
86822,200,22593,26433;26444,69715,0,0,2,0,2
86823,200,22601,26980,69715,0,0,1,0,1
86824,200,22602,27097;27377,69715,0,0,2,0,2
86825,200,22603,27108,69715,0,0,1,0,1
86826,200,22605,27335,69715,0,0,1,0,1
86827,200,22607,27004,69715,0,0,1,0,1
86828,200,22608,27638;28111;30093;30630;30809;30968;31049,69715,0,4,3,0,7
86829,200,22610,27571;27840;30541;30946;31116,69715,0,3,2,0,5
86830,200,22612,27886;28345;30822;31733,69715,1,1,2,0,4
86831,200,22613,27918;28285;30818,69715,0,1,2,0,3
86832,200,22614,27965;28024;30275;30709,69715,0,1,3,0,4
86833,200,22616,28385;30989;31657,69715,1,1,1,0,3
86834,200,22617,28074,69715,0,0,1,0,1
86835,200,22618,28121,69715,0,0,1,0,1
86836,200,22621,28357;30383;30902;31897,69715,1,1,2,0,4
86837,200,22622,28429;28768;31436;31757,69715,1,1,2,0,4
86838,200,22625,28507;28687;31163;31597;31668;31753,69715,3,1,2,0,6
86839,200,22626,28536;28809,69715,0,0,2,0,2
86840,200,22627,28470,69715,0,0,1,0,1
86841,200,22628,28235;28584;31137;31224,69715,0,2,2,0,4
86842,200,22629,28665;28750;31089;31830,69715,1,1,2,0,4
86843,200,22630,28762;28977;31532;31688,69715,1,1,2,0,4
86844,200,22631,28603;28795;30738;31000;31591,69715,1,2,2,0,5
86845,200,22632,28903;28980;31449;31533,69715,0,2,2,0,4
86846,200,22633,29008;31013;31362,69715,0,2,1,0,3
86847,200,22634,28944,69715,0,0,1,0,1
86848,200,22635,28958;29268;30848;31019,69715,0,2,2,0,4
86849,200,22636,29072;31770,69715,1,0,1,0,2
86850,200,22637,29001;29019;31361;31534;31617,69715,1,2,2,0,5
86851,200,22638,29025,69715,0,0,1,0,1
86852,200,22639,29029;29672,69715,0,0,2,0,2
86853,200,22640,28615;29033;31279,69715,0,1,2,0,3
86854,200,22641,29662,69715,0,0,1,0,1
86855,200,22642,28631;29041;30922;31847,69715,1,1,2,0,4
86856,200,22643,29099;29231;31777,69715,1,0,2,0,3
86857,200,22644,29285;29302;31706,69715,1,0,2,0,3
86858,200,22645,29102;29619,69715,0,0,2,0,2
86859,200,22646,29137;29328;31021;31941,69715,1,1,2,0,4
86860,200,22647,29151;29562;31473,69715,0,1,2,0,3
86861,200,22648,29171,69715,0,0,1,0,1
86862,200,22649,29154;29194;31775,69715,1,0,2,0,3
86863,200,22650,29201;29252,69715,0,0,2,0,2
86864,200,22651,29211;29488;31946,69715,1,0,2,0,3
86865,200,22652,29156;29218,69715,0,0,2,0,2
86866,200,22653,29273;29706,69715,0,0,2,0,2
86867,200,22654,29241;29300,69715,0,0,2,0,2
86868,200,22655,29312;29385,69715,0,0,2,0,2
86869,200,22656,29313;29700,69715,0,0,2,0,2
86870,200,22657,29467;31558,69715,0,1,1,0,2
86871,200,22658,29382;29569;31637;31716,69715,2,0,2,0,4
86872,200,22659,29412;29734,69715,0,0,2,0,2
86873,200,22660,29497;29747;31379,69715,0,1,2,0,3
86874,200,22661,29439;29726;31951,69715,1,0,2,0,3
86875,200,22662,29144;29447;31374,69715,0,1,2,0,3
86876,200,22663,29245;29455;31557,69715,0,1,2,0,3
86877,200,22664,29466;29745;31952,69715,1,0,2,0,3
86878,200,22665,29681;31564,69715,0,1,1,0,2
86879,200,22666,25509,70080,0,0,0,1,1
86880,200,22667,25910,70080,0,0,0,1,1
86881,200,22668,25766,70080,0,0,0,1,1
86882,200,22669,26124;26376,70080,0,0,2,0,2
86883,200,22671,26298;26639,70080,0,0,2,0,2
86884,200,22672,25978,70080,0,0,0,1,1
86885,200,22673,26585,70080,0,0,1,0,1
86886,200,22674,26689,70080,0,0,1,0,1
86887,200,22675,27633,70080,0,0,1,0,1
86888,200,22679,27312,70080,0,0,1,0,1
86889,200,22685,27926;28001,70080,0,0,2,0,2
86890,200,22689,28185,70080,0,0,1,0,1
86891,200,22690,27986;28195;30813;30891,70080,0,2,2,0,4
86892,200,22692,28305,70080,0,0,1,0,1
86893,200,22693,28406;28614;30390;31252;31821,70080,1,1,3,0,5
86894,200,22694,28535,70080,0,0,1,0,1
86895,200,22695,28509,70080,0,0,1,0,1
86896,200,22696,28568,70080,0,0,1,0,1
86897,200,22697,28362,70080,0,0,1,0,1
86898,200,22698,28654;28959;31530,70080,0,1,2,0,3
86899,200,22699,28834;28966;31173;31268,70080,0,2,2,0,4
86900,200,22700,28728;28974,70080,0,0,2,0,2
86901,200,22702,28830;29335;31943,70080,1,0,2,0,3
86902,200,22703,28930;29272;30924,70080,0,1,2,0,3
86903,200,22704,28813;28933,70080,0,0,2,0,2
86904,200,22705,28899;28998;31097;31844,70080,1,1,2,0,4
86905,200,22706,28704;29050,70080,0,0,2,0,2
86906,200,22707,28664;29052,70080,0,0,2,0,2
86907,200,22708,28894;29056;31182,70080,0,1,2,0,3
86908,200,22709,29064;31365,70080,0,1,1,0,2
86909,200,22710,29240;29419,70080,0,0,2,0,2
86910,200,22711,29076;29415;31289;31787,70080,1,1,2,0,4
86911,200,22712,29128;29191;31927,70080,1,0,2,0,3
86912,200,22713,29147;29266,70080,0,0,2,0,2
86913,200,22714,29239;29633,70080,0,0,2,0,2
86914,200,22715,29387;29484,70080,0,0,2,0,2
86915,200,22716,29301;29361;31632;31866,70080,2,0,2,0,4
86916,200,22717,29150;29322;31779,70080,1,0,2,0,3
86917,200,22718,29471,70080,0,0,1,0,1
86918,200,22719,29360,70080,0,0,1,0,1
86919,200,22720,29311;29366;31553;31938,70080,1,1,2,0,4
86920,200,22721,29369;29601,70080,0,0,2,0,2
86921,200,22722,29397;29592,70080,0,0,2,0,2
86922,200,22723,29429;29640,70080,0,0,2,0,2
86923,200,22724,29444;29493;31635,70080,1,0,2,0,3
86924,200,22725,29457;29690,70080,0,0,2,0,2
86925,200,22726,29695;29797;31954,70080,1,0,2,0,3
86926,200,22727,29552;29687,70080,0,0,2,0,2
86927,200,22728,29575;29637,70080,0,0,2,0,2
86928,200,22729,29577;29793,70080,0,0,2,0,2
86929,200,22730,25795,70445,0,0,0,1,1
86930,200,22732,25986,70445,0,0,0,1,1
86931,200,22733,25581,70445,0,0,0,1,1
86932,200,22734,26237,70445,0,0,1,0,1
86933,200,22735,26123,70445,0,0,1,0,1
86934,200,22738,26420,70445,0,0,1,0,1
86935,200,22740,26820;27232,70445,0,0,2,0,2
86936,200,22741,26834,70445,0,0,1,0,1
86937,200,22743,27374,70445,0,0,1,0,1
86938,200,22747,27593;27928;31040,70445,0,1,2,0,3
86939,200,22748,27728,70445,0,0,1,0,1
86940,200,22749,27674;27888;31118;31300,70445,0,2,2,0,4
86941,200,22754,27935;28026;30273;31303,70445,0,1,3,0,4
86942,200,22756,28077,70445,0,0,1,0,1
86943,200,22757,27902,70445,0,0,1,0,1
86944,200,22758,28061,70445,0,0,1,0,1
86945,200,22759,28463;28698;30732;30825;30992;31147,70445,0,4,2,0,6
86946,200,22760,28520,70445,0,0,1,0,1
86947,200,22761,28552;28572;30646;31585,70445,1,1,2,0,4
86948,200,22762,28655;28982;31276;31616,70445,1,1,2,0,4
86949,200,22763,28823;31835,70445,1,0,1,0,2
86950,200,22764,28421;28737,70445,0,0,2,0,2
86951,200,22765,28773;28884;31356,70445,0,1,2,0,3
86952,200,22766,28787,70445,0,0,1,0,1
86953,200,22767,28789;28857;31606,70445,1,0,2,0,3
86954,200,22768,28828;28989,70445,0,0,2,0,2
86955,200,22769,29040;29177;31369;31458;31622,70445,1,2,2,0,5
86956,200,22770,28920;28934;31180,70445,0,1,2,0,3
86957,200,22771,28975;28993;31448,70445,0,1,2,0,3
86958,200,22773,29215;31189,70445,0,1,1,0,2
86959,200,22774,28786;29061,70445,0,0,2,0,2
86960,200,22775,29092;29431,70445,0,0,2,0,2
86961,200,22777,29752,70445,0,0,1,0,1
86962,200,22778,29396,70445,0,0,1,0,1
86963,200,22779,29198;29848;31884,70445,1,0,2,0,3
86964,200,22780,29223;31461,70445,0,1,1,0,2
86965,200,22781,29230;29686;31878,70445,1,0,2,0,3
86966,200,22782,29139;29275;31703;31778;31862,70445,3,0,2,0,5
86967,200,22783,29290;29802,70445,0,0,2,0,2
86968,200,22784,29307;29610,70445,0,0,2,0,2
86969,200,22785,29325;29708,70445,0,0,2,0,2
86970,200,22786,29600;31468;31630;31782,70445,2,1,1,0,4
86971,200,22788,29711;31477,70445,0,1,1,0,2
86972,200,22789,29356;29413,70445,0,0,2,0,2
86973,200,22790,29416;29560,70445,0,0,2,0,2
86974,200,22791,29428;29728,70445,0,0,2,0,2
86975,200,22792,29435;29650,70445,0,0,2,0,2
86976,200,22793,29261;29458;31375,70445,0,1,2,0,3
86977,200,22794,29465;29804,70445,0,0,2,0,2
86978,200,22795,29485;29547,70445,0,0,2,0,2
86979,200,22796,29496;29503;31636,70445,1,0,2,0,3
86980,200,22797,29709,70445,0,0,1,0,1
86981,200,22798,29522;29605,70445,0,0,2,0,2
86982,200,22799,29550;29595,70445,0,0,2,0,2
86983,200,22800,29572;29832;31294,70445,0,1,2,0,3
86984,200,22801,29580;29774;31797,70445,1,0,2,0,3
86985,200,22802,29588;31947,70445,1,0,1,0,2
86986,200,22803,29278;29603,70445,0,0,2,0,2
86987,200,22804,29612;29671;31293;31718,70445,1,1,2,0,4
86988,200,22805,29635;29750,70445,0,0,2,0,2
86989,200,22806,29510;29653;31562,70445,0,1,2,0,3
86990,200,22807,25944,70810,0,0,0,1,1
86991,200,22808,25952,70810,0,0,0,1,1
86992,200,22812,26207,70810,0,0,1,0,1
86993,200,22813,26056,70810,0,0,0,1,1
86994,200,22815,26004,70810,0,0,0,1,1
86995,200,22816,26313,70810,0,0,1,0,1
86996,200,22818,26363,70810,0,0,1,0,1
86997,200,22820,26684,70810,0,0,1,0,1
86998,200,22821,26449,70810,0,0,1,0,1
86999,200,22823,26326,70810,0,0,1,0,1
87000,200,22825,26590,70810,0,0,1,0,1
87001,200,22826,26959,70810,0,0,1,0,1
87002,200,22827,26797,70810,0,0,1,0,1
87003,200,22829,27064,70810,0,0,1,0,1
87004,200,22830,27180,70810,0,0,1,0,1
87005,200,22831,26886,70810,0,0,1,0,1
87006,200,22834,27710;27947;30706;31211,70810,0,2,2,0,4
87007,200,22835,27615,70810,0,0,1,0,1
87008,200,22838,27785,70810,0,0,1,0,1
87009,200,22839,28023,70810,0,0,1,0,1
87010,200,22840,28225;28335;31329,70810,0,1,2,0,3
87011,200,22842,28424;28744;30838;31005;31603,70810,1,2,2,0,5
87012,200,22843,28446,70810,0,0,1,0,1
87013,200,22844,28453,70810,0,0,1,0,1
87014,200,22845,28541,70810,0,0,1,0,1
87015,200,22846,28563;31154;31747;31902,70810,2,1,1,0,4
87016,200,22847,28791,70810,0,0,1,0,1
87017,200,22849,28706;28742;31512,70810,0,1,2,0,3
87018,200,22850,28847,70810,0,0,1,0,1
87019,200,22851,28877;29376;31556;31785,70810,1,1,2,0,4
87020,200,22852,29053;29235;31625;31701,70810,2,0,2,0,4
87021,200,22854,28969;31273;31917,70810,1,1,1,0,3
87022,200,22855,29113;29408,70810,0,0,2,0,2
87023,200,22857,29124,70810,0,0,1,0,1
87024,200,22858,29160;29479,70810,0,0,2,0,2
87025,200,22859,28508;28531;30736;31337,70810,0,2,2,0,4
87026,200,22860,29189;29260,70810,0,0,2,0,2
87027,200,22861,29246;29406,70810,0,0,2,0,2
87028,200,22862,29258;29483,70810,0,0,2,0,2
87029,200,22863,29274;29740,70810,0,0,2,0,2
87030,200,22864,29321;29636;31794,70810,1,0,2,0,3
87031,200,22865,29324;29357,70810,0,0,2,0,2
87032,200,22866,29303;29370;31633;31868,70810,2,0,2,0,4
87033,200,22867,29543;31715,70810,1,0,1,0,2
87034,200,22868,29233;29380,70810,0,0,2,0,2
87035,200,22869,28866,70810,0,0,1,0,1
87036,200,22870,29400;29780,70810,0,0,2,0,2
87037,200,22871,29495,70810,0,0,1,0,1
87038,200,22872,29422,70810,0,0,1,0,1
87039,200,22873,29388;29433;31709,70810,1,0,2,0,3
87040,200,22874,29684,70810,0,0,1,0,1
87041,200,22875,29365;29838,70810,0,0,2,0,2
87042,200,22876,29509,70810,0,0,1,0,1
87043,200,22877,29073;29511;31377,70810,0,1,2,0,3
87044,200,22878,29305;29515;31196;31560;31790,70810,1,2,2,0,5
87045,200,22879,29524;29699,70810,0,0,2,0,2
87046,200,22880,29368;31194;31783;31867,70810,2,1,1,0,4
87047,200,22881,29587,70810,0,0,1,0,1
87048,200,22882,29673,70810,0,0,1,0,1
87049,200,22883,29606;31948,70810,1,0,1,0,2
87050,200,22884,29611;29624;31717,70810,1,0,2,0,3
87051,200,22885,29567;29615;31378,70810,0,1,2,0,3
87052,200,22886,29568;29630,70810,0,0,2,0,2
87053,200,22887,29642;29979,70810,0,0,2,0,2
87054,200,22888,29648;30013,70810,0,0,2,0,2
87055,200,22889,29507;29652,70810,0,0,2,0,2
87056,200,22890,29722;29987,70810,0,0,2,0,2
87057,200,22891,29724,70810,0,0,1,0,1
87058,200,22892,29632;29731,70810,0,0,2,0,2
87059,200,22893,26202,71175,0,0,1,0,1
87060,200,22894,25770,71175,0,0,0,1,1
87061,200,22895,26073;26304,71175,0,0,1,1,2
87062,200,22897,26120;26144,71175,0,0,2,0,2
87063,200,22899,26467;26476,71175,0,0,2,0,2
87064,200,22900,26497,71175,0,0,1,0,1
87065,200,22902,26752,71175,0,0,1,0,1
87066,200,22904,26811,71175,0,0,1,0,1
87067,200,22905,26839,71175,0,0,1,0,1
87068,200,22906,26756,71175,0,0,1,0,1
87069,200,22907,27003,71175,0,0,1,0,1
87070,200,22908,26954,71175,0,0,1,0,1
87071,200,22909,27016,71175,0,0,1,0,1
87072,200,22910,27058,71175,0,0,1,0,1
87073,200,22913,27234,71175,0,0,1,0,1
87074,200,22914,27264,71175,0,0,1,0,1
87075,200,22916,27213,71175,0,0,1,0,1
87076,200,22917,27283;27528,71175,0,0,2,0,2
87077,200,22919,27481,71175,0,0,1,0,1
87078,200,22920,27658,71175,0,0,1,0,1
87079,200,22922,27815;27871;30443,71175,0,0,3,0,3
87080,200,22923,27996,71175,0,0,1,0,1
87081,200,22928,28215,71175,0,0,1,0,1
87082,200,22929,28288;28439,71175,0,0,2,0,2
87083,200,22930,28248,71175,0,0,1,0,1
87084,200,22931,28354;28928;30843,71175,0,1,2,0,3
87085,200,22932,28414;28599;31737,71175,1,0,2,0,3
87086,200,22933,28210,71175,0,0,1,0,1
87087,200,22934,28317,71175,0,0,1,0,1
87088,200,22935,28685;30835;31002;31429;31509,71175,0,4,1,0,5
87089,200,22937,28874,71175,0,0,1,0,1
87090,200,22938,28935;29411;31712,71175,1,0,2,0,3
87091,200,22939,29037;29404,71175,0,0,2,0,2
87092,200,22940,29206;29427;31788,71175,1,0,2,0,3
87093,200,22941,29158;29287;31464;31704;31934,71175,2,1,2,0,5
87094,200,22942,29181;29205;31460;31699,71175,1,1,2,0,4
87095,200,22943,29003,71175,0,0,1,0,1
87096,200,22944,29077;29277,71175,0,0,2,0,2
87097,200,22945,29296;29459,71175,0,0,2,0,2
87098,200,22947,29320;29698,71175,0,0,2,0,2
87099,200,22948,29333;29647;31475,71175,0,1,2,0,3
87100,200,22949,28963;29358;31285,71175,0,1,2,0,3
87101,200,22950,29426;31470;31713,71175,1,1,1,0,3
87102,200,22951,29220;29445;31102;31872,71175,1,1,2,0,4
87103,200,22952,29418;29491;31104,71175,0,1,2,0,3
87104,200,22953,29492;30084,71175,0,0,2,0,2
87105,200,22954,29513;29994,71175,0,0,2,0,2
87106,200,22955,29203;29523,71175,0,0,2,0,2
87107,200,22956,29405;29534;30850,71175,0,1,2,0,3
87108,200,22957,29393;31710;31870,71175,2,0,1,0,3
87109,200,22958,29546;29781,71175,0,0,2,0,2
87110,200,22959,29559;29887,71175,0,0,2,0,2
87111,200,22960,29565,71175,0,0,1,0,1
87112,200,22961,29584;29617,71175,0,0,2,0,2
87113,200,22962,29591;29970,71175,0,0,2,0,2
87114,200,22963,29332;29622,71175,0,0,2,0,2
87115,200,22964,29634;29959,71175,0,0,2,0,2
87116,200,22965,29680;29812,71175,0,0,2,0,2
87117,200,22966,29688,71175,0,0,1,0,1
87118,200,22967,29691;29893,71175,0,0,2,0,2
87119,200,22968,29741,71175,0,0,1,0,1
87120,200,22969,29744;30091,71175,0,0,2,0,2
87121,200,22970,29639;29759,71175,0,0,2,0,2
87122,200,22971,29473;29794,71175,0,0,2,0,2
87123,200,22972,29383;29823,71175,0,0,2,0,2
87124,200,22973,29829;29889,71175,0,0,2,0,2
87125,200,22974,29363;29834;31955,71175,1,0,2,0,3
87126,200,22975,26109,71540,0,0,1,0,1
87127,200,22976,26203;26571,71540,0,0,2,0,2
87128,200,22977,25925,71540,0,0,0,1,1
87129,200,22978,25956,71540,0,0,0,1,1
87130,200,22979,25950,71540,0,0,0,1,1
87131,200,22980,26299,71540,0,0,1,0,1
87132,200,22981,26353,71540,0,0,1,0,1
87133,200,22985,26700;27116;30497,71540,0,1,2,0,3
87134,200,22987,26906,71540,0,0,1,0,1
87135,200,22989,26502,71540,0,0,1,0,1
87136,200,22991,27160,71540,0,0,1,0,1
87137,200,22993,27331,71540,0,0,1,0,1
87138,200,22995,27095,71540,0,0,1,0,1
87139,200,22996,27406,71540,0,0,1,0,1
87140,200,22999,27999,71540,0,0,1,0,1
87141,200,23000,27759,71540,0,0,1,0,1
87142,200,23001,28277,71540,0,0,1,0,1
87143,200,23003,28293,71540,0,0,1,0,1
87144,200,23004,28845,71540,0,0,1,0,1
87145,200,23005,28598,71540,0,0,1,0,1
87146,200,23007,28408,71540,0,0,1,0,1
87147,200,23008,28751,71540,0,0,1,0,1
87148,200,23009,28804;28916;31170;31439;31911,71540,1,2,2,0,5
87149,200,23010,28917;29228,71540,0,0,2,0,2
87150,200,23011,28985;29248;31373;31550;31933,71540,1,2,2,0,5
87151,200,23012,28521,71540,0,0,1,0,1
87152,200,23013,29032;29255;31190;31626,71540,1,1,2,0,4
87153,200,23014,28820;29016;30575;30747;31265;31676,71540,1,3,2,0,6
87154,200,23015,29067;29247,71540,0,0,2,0,2
87155,200,23016,29074;29101;30751,71540,0,1,2,0,3
87156,200,23017,29081;29145;31930,71540,1,0,2,0,3
87157,200,23018,29086;29454;31634,71540,1,0,2,0,3
87158,200,23019,29222;29828,71540,0,0,2,0,2
87159,200,23020,29226;29391,71540,0,0,2,0,2
87160,200,23021,29243,71540,0,0,1,0,1
87161,200,23022,29464;31873,71540,1,0,1,0,2
87162,200,23023,28953,71540,0,0,1,0,1
87163,200,23024,29392;29407;31711,71540,1,0,2,0,3
87164,200,23025,29446;29660,71540,0,0,2,0,2
87165,200,23026,29291;29452;31935,71540,1,0,2,0,3
87166,200,23027,29293,71540,0,0,1,0,1
87167,200,23028,29477;30096,71540,0,0,2,0,2
87168,200,23029,29498;29764,71540,0,0,2,0,2
87169,200,23030,29520;29599,71540,0,0,2,0,2
87170,200,23031,29535;29693,71540,0,0,2,0,2
87171,200,23032,29536;29661,71540,0,0,2,0,2
87172,200,23033,29598;29894,71540,0,0,2,0,2
87173,200,23034,29990;30006,71540,0,0,2,0,2
87174,200,23035,29267;29665;31877,71540,1,0,2,0,3
87175,200,23036,29725;30002,71540,0,0,2,0,2
87176,200,23037,29727;30046,71540,0,0,2,0,2
87177,200,23038,29586;29768;31953,71540,1,0,2,0,3
87178,200,23039,29878;31720,71540,1,0,1,0,2
87179,200,23040,29784,71540,0,0,1,0,1
87180,200,23041,29825;29865,71540,0,0,2,0,2
87181,200,23042,29831;29912,71540,0,0,2,0,2
87182,200,23043,30099,71540,0,0,1,0,1
87183,200,23044,29821;29856,71540,0,0,2,0,2
87184,200,23045,29873;29922,71540,0,0,2,0,2
87185,200,23046,29881;29911,71540,0,0,2,0,2
87186,200,23047,29885;29899;31801,71540,1,0,2,0,3
87187,200,23048,29913;30098;31805,71540,1,0,2,0,3
87188,200,23049,30031,71540,0,0,1,0,1
87189,200,23050,29766;29932,71540,0,0,2,0,2
87190,200,23051,29604;29943,71540,0,0,2,0,2
87191,200,23052,26375,71905,0,0,1,0,1
87192,200,23053,26696,71905,0,0,1,0,1
87193,200,23054,26323,71905,0,0,1,0,1
87194,200,23056,26359,71905,0,0,1,0,1
87195,200,23058,26625,71905,0,0,1,0,1
87196,200,23059,26318,71905,0,0,1,0,1
87197,200,23060,26972,71905,0,0,1,0,1
87198,200,23061,26984,71905,0,0,1,0,1
87199,200,23062,27156,71905,0,0,1,0,1
87200,200,23064,27401,71905,0,0,1,0,1
87201,200,23065,27529,71905,0,0,1,0,1
87202,200,23066,27549,71905,0,0,1,0,1
87203,200,23067,27583,71905,0,0,1,0,1
87204,200,23071,28004,71905,0,0,1,0,1
87205,200,23072,27762;28222;31808,71905,1,0,2,0,3
87206,200,23073,28236,71905,0,0,1,0,1
87207,200,23074,27704;27770;30433;30689,71905,0,1,3,0,4
87208,200,23075,28127,71905,0,0,1,0,1
87209,200,23077,28356,71905,0,0,1,0,1
87210,200,23078,28382,71905,0,0,1,0,1
87211,200,23080,28374,71905,0,0,1,0,1
87212,200,23081,28379;28825,71905,0,0,2,0,2
87213,200,23083,28396,71905,0,0,1,0,1
87214,200,23086,28499,71905,0,0,1,0,1
87215,200,23087,28632;28799;30841;31910,71905,1,1,2,0,4
87216,200,23088,28821;28833;31266,71905,0,1,2,0,3
87217,200,23089,29051;29377;30925;31869,71905,1,1,2,0,4
87218,200,23090,29229,71905,0,0,1,0,1
87219,200,23091,28815;29069;31367;31540;31769,71905,1,2,2,0,5
87220,200,23092,29133;29326;31780;31939,71905,2,0,2,0,4
87221,200,23093,29174;29262;31627,71905,1,0,2,0,3
87222,200,23094,28987;29187;31450;31689;31842,71905,2,1,2,0,5
87223,200,23095,29190,71905,0,0,1,0,1
87224,200,23096,29249;29641,71905,0,0,2,0,2
87225,200,23097,29259;29555,71905,0,0,2,0,2
87226,200,23098,29279,71905,0,0,1,0,1
87227,200,23099,29299;29373;31555;31784,71905,1,1,2,0,4
87228,200,23100,29179;29314;31466,71905,0,1,2,0,3
87229,200,23101,29375;29504,71905,0,0,2,0,2
87230,200,23102,29414,71905,0,0,1,0,1
87231,200,23103,29424;29472,71905,0,0,2,0,2
87232,200,23104,29436;29753,71905,0,0,2,0,2
87233,200,23105,29440;29689,71905,0,0,2,0,2
87234,200,23106,29474;29645,71905,0,0,2,0,2
87235,200,23107,29379;29481;31022;31945,71905,1,1,2,0,4
87236,200,23108,29337;29494;31559,71905,0,1,2,0,3
87237,200,23109,29531;29928;31886,71905,1,0,2,0,3
87238,200,23110,29334;29539,71905,0,0,2,0,2
87239,200,23111,29545;29658;31949,71905,1,0,2,0,3
87240,200,23112,29553;29738,71905,0,0,2,0,2
87241,200,23113,29212;29590,71905,0,0,2,0,2
87242,200,23114,29607;29670;31474;31876,71905,1,1,2,0,4
87243,200,23115,29613;29789,71905,0,0,2,0,2
87244,200,23116,29625;29842,71905,0,0,2,0,2
87245,200,23117,29323;29631,71905,0,0,2,0,2
87246,200,23118,29644;29872,71905,0,0,2,0,2
87247,200,23119,29646;30074,71905,0,0,2,0,2
87248,200,23120,29581;29651;31476,71905,0,1,2,0,3
87249,200,23121,29638;29685;31565;31950,71905,1,1,2,0,4
87250,200,23122,29702;29770,71905,0,0,2,0,2
87251,200,23123,29533;29712,71905,0,0,2,0,2
87252,200,23124,29669;29714;31879,71905,1,0,2,0,3
87253,200,23125,29736;29833;31795;31880,71905,2,0,2,0,4
87254,200,23126,29773;30163,71905,0,0,2,0,2
87255,200,23127,29782;30215,71905,0,0,2,0,2
87256,200,23128,29816;29819,71905,0,0,2,0,2
87257,200,23129,29769;29820;31638,71905,1,0,2,0,3
87258,200,23130,29852;30032,71905,0,0,2,0,2
87259,200,23131,29861;30104,71905,0,0,2,0,2
87260,200,23132,29875;30179,71905,0,0,2,0,2
87261,200,23133,29548;29879,71905,0,0,2,0,2
87262,200,23134,29888;29946;31721,71905,1,0,2,0,3
87263,200,23135,29398;29890;31800,71905,1,0,2,0,3
87264,200,23136,29900;29961,71905,0,0,2,0,2
87265,200,23137,29905,71905,0,0,1,0,1
87266,200,23138,29937;30073;31961,71905,1,0,2,0,3
87267,200,23139,29949;30260,71905,0,0,2,0,2
87268,200,23140,29950;29951,71905,0,0,2,0,2
87269,200,23141,30023;30107,71905,0,0,2,0,2
87270,200,23142,29980,71905,0,0,1,0,1
87271,200,23143,29602,71905,0,0,1,0,1
87272,200,23144,29999;30208,71905,0,0,2,0,2
87273,200,23145,29805;30004;31803,71905,1,0,2,0,3
87274,200,23146,26339,72270,0,0,1,0,1
87275,200,23147,26367,72270,0,0,1,0,1
87276,200,23148,26400,72270,0,0,1,0,1
87277,200,23149,26074,72270,0,0,0,1,1
87278,200,23151,26610,72270,0,0,1,0,1
87279,200,23152,26803,72270,0,0,1,0,1
87280,200,23153,26438,72270,0,0,1,0,1
87281,200,23154,26602,72270,0,0,1,0,1
87282,200,23155,26925,72270,0,0,1,0,1
87283,200,23156,26982,72270,0,0,1,0,1
87284,200,23157,27286,72270,0,0,1,0,1
87285,200,23158,26859,72270,0,0,1,0,1
87286,200,23159,26593,72270,0,0,1,0,1
87287,200,23160,26734,72270,0,0,1,0,1
87288,200,23161,26918,72270,0,0,1,0,1
87289,200,23162,27282,72270,0,0,1,0,1
87290,200,23163,27384,72270,0,0,1,0,1
87291,200,23166,26950,72270,0,0,1,0,1
87292,200,23167,27590,72270,0,0,1,0,1
87293,200,23168,27631,72270,0,0,1,0,1
87294,200,23169,27385,72270,0,0,1,0,1
87295,200,23171,27681,72270,0,0,1,0,1
87296,200,23172,27749,72270,0,0,1,0,1
87297,200,23173,27514,72270,0,0,1,0,1
87298,200,23174,27390,72270,0,0,1,0,1
87299,200,23175,27327,72270,0,0,1,0,1
87300,200,23176,27797,72270,0,0,1,0,1
87301,200,23177,27676,72270,0,0,1,0,1
87302,200,23178,28108,72270,0,0,1,0,1
87303,200,23179,28315,72270,0,0,1,0,1
87304,200,23180,28503,72270,0,0,1,0,1
87305,200,23181,28594,72270,0,0,1,0,1
87306,200,23182,28455;28736;31602,72270,1,0,2,0,3
87307,200,23183,28461;28771;31091,72270,0,1,2,0,3
87308,200,23184,28692;28832;31172;31442,72270,0,2,2,0,4
87309,200,23185,29566;31875,72270,1,0,1,0,2
87310,200,23186,28886,72270,0,0,1,0,1
87311,200,23187,28785;28960;31615,72270,1,0,2,0,3
87312,200,23188,28696,72270,0,0,1,0,1
87313,200,23189,29004;31535;31618;31919,72270,2,1,1,0,4
87314,200,23190,28988,72270,0,0,1,0,1
87315,200,23191,29094,72270,0,0,1,0,1
87316,200,23192,29107,72270,0,0,1,0,1
87317,200,23193,28967,72270,0,0,1,0,1
87318,200,23194,28707,72270,0,0,1,0,1
87319,200,23195,29227;29317;31865,72270,1,0,2,0,3
87320,200,23196,29141;29329;31942,72270,1,0,2,0,3
87321,200,23197,29343;29451;31781,72270,1,0,2,0,3
87322,200,23198,29182;29656,72270,0,0,2,0,2
87323,200,23199,29399;29437;31471,72270,0,1,2,0,3
87324,200,23200,29071;29310,72270,0,0,2,0,2
87325,200,23201,29430;29676,72270,0,0,2,0,2
87326,200,23202,29434;29609,72270,0,0,2,0,2
87327,200,23203,29910,72270,0,0,1,0,1
87328,200,23204,29574;29891;31642,72270,1,0,2,0,3
87329,200,23205,29254;29718,72270,0,0,2,0,2
87330,200,23206,29720;30252,72270,0,0,2,0,2
87331,200,23207,29721;30017;31891,72270,1,0,2,0,3
87332,200,23208,29732;29948,72270,0,0,2,0,2
87333,200,23209,29138;29737;31566;31719,72270,1,1,2,0,4
87334,200,23210,29779,72270,0,0,1,0,1
87335,200,23211,29800;30077,72270,0,0,2,0,2
87336,200,23212,29854,72270,0,0,1,0,1
87337,200,23213,29859;30011,72270,0,0,2,0,2
87338,200,23214,29895;30375,72270,0,0,2,0,2
87339,200,23215,29901;30079;31892,72270,1,0,2,0,3
87340,200,23216,29677;29904;31802,72270,1,0,2,0,3
87341,200,23217,29906,72270,0,0,1,0,1
87342,200,23218,29914;29915,72270,0,0,2,0,2
87343,200,23219,29772;29974;31890,72270,1,0,2,0,3
87344,200,23220,29975;30191,72270,0,0,2,0,2
87345,200,23221,29981;30137;31963,72270,1,0,2,0,3
87346,200,23222,29985;30117;31894,72270,1,0,2,0,3
87347,200,23223,29997;30020,72270,0,0,2,0,2
87348,200,23224,29518;30025,72270,0,0,2,0,2
87349,200,23225,30027;30361,72270,0,0,2,0,2
87350,200,23226,30028;30393,72270,0,0,2,0,2
87351,200,23227,29957;30041,72270,0,0,2,0,2
87352,200,23228,30061,72270,0,0,1,0,1
87353,200,23229,30072;30279,72270,0,0,2,0,2
87354,200,23230,30078;30230,72270,0,0,2,0,2
87355,200,23231,30085;30386,72270,0,0,2,0,2
87356,200,23232,30087;30359,72270,0,0,2,0,2
87357,200,23233,30100;30286,72270,0,0,2,0,2
87358,200,23234,26499,72635,0,0,1,0,1
87359,200,23236,26831,72635,0,0,1,0,1
87360,200,23237,26899,72635,0,0,1,0,1
87361,200,23238,26941,72635,0,0,1,0,1
87362,200,23239,26712,72635,0,0,1,0,1
87363,200,23240,27192,72635,0,0,1,0,1
87364,200,23241,27233,72635,0,0,1,0,1
87365,200,23243,27170,72635,0,0,1,0,1
87366,200,23244,27349,72635,0,0,1,0,1
87367,200,23245,27474,72635,0,0,1,0,1
87368,200,23246,27734,72635,0,0,1,0,1
87369,200,23247,27663,72635,0,0,1,0,1
87370,200,23248,27930,72635,0,0,1,0,1
87371,200,23249,27820,72635,0,0,1,0,1
87372,200,23250,27869,72635,0,0,1,0,1
87373,200,23252,28346,72635,0,0,1,0,1
87374,200,23253,28353,72635,0,0,1,0,1
87375,200,23254,28128,72635,0,0,1,0,1
87376,200,23255,28391;28403;30642,72635,0,1,2,0,3
87377,200,23256,28447,72635,0,0,1,0,1
87378,200,23258,28490,72635,0,0,1,0,1
87379,200,23259,28494,72635,0,0,1,0,1
87380,200,23260,28000,72635,0,0,1,0,1
87381,200,23261,28653,72635,0,0,1,0,1
87382,200,23262,28695,72635,0,0,1,0,1
87383,200,23263,28783;29309;31192,72635,0,1,2,0,3
87384,200,23264,28842,72635,0,0,1,0,1
87385,200,23265,28733,72635,0,0,1,0,1
87386,200,23266,29100,72635,0,0,1,0,1
87387,200,23267,28838;28973;31275;31447;31918,72635,1,2,2,0,5
87388,200,23268,29276;29703,72635,0,0,2,0,2
87389,200,23269,29319;29582;31793,72635,1,0,2,0,3
87390,200,23270,29384;29596,72635,0,0,2,0,2
87391,200,23271,29537,72635,0,0,1,0,1
87392,200,23272,29421;29659;31292,72635,0,1,2,0,3
87393,200,23273,29462;29743,72635,0,0,2,0,2
87394,200,23274,29470,72635,0,0,1,0,1
87395,200,23275,29476;29478,72635,0,0,2,0,2
87396,200,23276,29482;29657,72635,0,0,2,0,2
87397,200,23277,29489,72635,0,0,1,0,1
87398,200,23278,29499;29830;31639,72635,1,0,2,0,3
87399,200,23279,29505,72635,0,0,1,0,1
87400,200,23280,29425;29508,72635,0,0,2,0,2
87401,200,23281,29541;29796,72635,0,0,2,0,2
87402,200,23282,29663,72635,0,0,1,0,1
87403,200,23283,29364;29608,72635,0,0,2,0,2
87404,200,23284,29654;29976,72635,0,0,2,0,2
87405,200,23285,30018,72635,0,0,1,0,1
87406,200,23286,29441,72635,0,0,1,0,1
87407,200,23287,29168,72635,0,0,1,0,1
87408,200,23288,29814;30173,72635,0,0,2,0,2
87409,200,23289,29824;29993,72635,0,0,2,0,2
87410,200,23290,29843;29972;31889,72635,1,0,2,0,3
87411,200,23291,29851;31479,72635,0,1,1,0,2
87412,200,23292,29719;29871,72635,0,0,2,0,2
87413,200,23293,29886;30153,72635,0,0,2,0,2
87414,200,23294,29749;29908,72635,0,0,2,0,2
87415,200,23295,29623;29919,72635,0,0,2,0,2
87416,200,23296,29925,72635,0,0,1,0,1
87417,200,23297,29942;30152,72635,0,0,2,0,2
87418,200,23298,29964,72635,0,0,1,0,1
87419,200,23299,29758;29967;31888,72635,1,0,2,0,3
87420,200,23300,29968;30270;31896,72635,1,0,2,0,3
87421,200,23301,29982,72635,0,0,1,0,1
87422,200,23302,29998;30447,72635,0,0,2,0,2
87423,200,23303,29395;30000,72635,0,0,2,0,2
87424,200,23304,30038;30255;31965,72635,1,0,2,0,3
87425,200,23305,30054;30177;31645,72635,1,0,2,0,3
87426,200,23306,30111;30331,72635,0,0,2,0,2
87427,200,23307,30168;30308,72635,0,0,2,0,2
87428,200,23308,30176;30227,72635,0,0,2,0,2
87429,200,23309,30181;30340,72635,0,0,2,0,2
87430,200,23310,26029,73000,0,0,0,1,1
87431,200,23311,26707,73000,0,0,1,0,1
87432,200,23312,26844,73000,0,0,1,0,1
87433,200,23313,26890,73000,0,0,1,0,1
87434,200,23314,27013,73000,0,0,1,0,1
87435,200,23315,27046,73000,0,0,1,0,1
87436,200,23316,27462,73000,0,0,1,0,1
87437,200,23318,27344,73000,0,0,1,0,1
87438,200,23319,27318,73000,0,0,1,0,1
87439,200,23320,27617,73000,0,0,1,0,1
87440,200,23321,27522,73000,0,0,1,0,1
87441,200,23322,27669,73000,0,0,1,0,1
87442,200,23323,27683,73000,0,0,1,0,1
87443,200,23324,27843,73000,0,0,1,0,1
87444,200,23325,27948,73000,0,0,1,0,1
87445,200,23326,27983,73000,0,0,1,0,1
87446,200,23327,27997,73000,0,0,1,0,1
87447,200,23328,27817,73000,0,0,1,0,1
87448,200,23329,27858,73000,0,0,1,0,1
87449,200,23330,28281,73000,0,0,1,0,1
87450,200,23331,28269,73000,0,0,1,0,1
87451,200,23332,28276,73000,0,0,1,0,1
87452,200,23333,28291,73000,0,0,1,0,1
87453,200,23334,27980,73000,0,0,1,0,1
87454,200,23335,28071,73000,0,0,1,0,1
87455,200,23336,28402,73000,0,0,1,0,1
87456,200,23337,28132,73000,0,0,1,0,1
87457,200,23338,28517,73000,0,0,1,0,1
87458,200,23339,28571,73000,0,0,1,0,1
87459,200,23340,28378,73000,0,0,1,0,1
87460,200,23341,28635,73000,0,0,1,0,1
87461,200,23342,28400,73000,0,0,1,0,1
87462,200,23343,28436,73000,0,0,1,0,1
87463,200,23344,28945;29410;31871,73000,1,0,2,0,3
87464,200,23345,28915,73000,0,0,1,0,1
87465,200,23346,28725,73000,0,0,1,0,1
87466,200,23347,29103;29402;31288;31469;31786,73000,1,2,2,0,5
87467,200,23348,29140;29152,73000,0,0,2,0,2
87468,200,23349,29270,73000,0,0,1,0,1
87469,200,23350,29330,73000,0,0,1,0,1
87470,200,23351,29403;29514;31789,73000,1,0,2,0,3
87471,200,23352,29417;29627,73000,0,0,2,0,2
87472,200,23353,29528;29682;31874,73000,1,0,2,0,3
87473,200,23354,29390;29532;31791,73000,1,0,2,0,3
87474,200,23355,29043;29538,73000,0,0,2,0,2
87475,200,23356,29372,73000,0,0,1,0,1
87476,200,23357,29563;30024,73000,0,0,2,0,2
87477,200,23358,29468,73000,0,0,1,0,1
87478,200,23359,29629,73000,0,0,1,0,1
87479,200,23360,29039,73000,0,0,1,0,1
87480,200,23361,29679,73000,0,0,1,0,1
87481,200,23362,29694;29762,73000,0,0,2,0,2
87482,200,23363,29860,73000,0,0,1,0,1
87483,200,23364,29216;29717,73000,0,0,2,0,2
87484,200,23365,29733;30003,73000,0,0,2,0,2
87485,200,23366,29683;29778,73000,0,0,2,0,2
87486,200,23367,29783,73000,0,0,1,0,1
87487,200,23368,29697;29786,73000,0,0,2,0,2
87488,200,23369,29704;29813,73000,0,0,2,0,2
87489,200,23370,29840;31882,73000,1,0,1,0,2
87490,200,23371,29844,73000,0,0,1,0,1
87491,200,23372,29845;30333,73000,0,0,2,0,2
87492,200,23373,29880;30083,73000,0,0,2,0,2
87493,200,23374,29920,73000,0,0,1,0,1
87494,200,23375,29936;30389,73000,0,0,2,0,2
87495,200,23376,29827;29939,73000,0,0,2,0,2
87496,200,23377,29945;30086,73000,0,0,2,0,2
87497,200,23378,30007;30258,73000,0,0,2,0,2
87498,200,23379,30015,73000,0,0,1,0,1
87499,200,23380,29593;30022,73000,0,0,2,0,2
87500,200,23381,30030;30146,73000,0,0,2,0,2
87501,200,23382,29984;30033;31804,73000,1,0,2,0,3
87502,200,23383,29962;30034,73000,0,0,2,0,2
87503,200,23384,30039;30207,73000,0,0,2,0,2
87504,200,23385,30066;30440,73000,0,0,2,0,2
87505,200,23386,29956;30080,73000,0,0,2,0,2
87506,200,23387,30095;30214,73000,0,0,2,0,2
87507,200,23388,29966;30122,73000,0,0,2,0,2
87508,200,23389,30130;30421,73000,0,0,2,0,2
87509,200,23390,30133;30526,73000,0,1,1,0,2
87510,200,23391,30140;30314,73000,0,0,2,0,2
87511,200,23392,30049;30157,73000,0,0,2,0,2
87512,200,23393,29896;30160,73000,0,0,2,0,2
87513,200,23394,30170,73000,0,0,1,0,1
87514,200,23395,30182,73000,0,0,1,0,1
87515,200,23396,30185;30464,73000,0,0,2,0,2
87516,200,23397,30076;30201,73000,0,0,2,0,2
87517,200,23398,30220;30400,73000,0,0,2,0,2
87518,200,23399,29996;30221,73000,0,0,2,0,2
87519,200,23400,30245;30458,73000,0,0,2,0,2
87520,200,23401,30155;30246,73000,0,0,2,0,2
